,Unnamed: 0,parameter,counts,counts_H,counts_NH,p_from_H,p_from_NH,priority
0,11,은/Josa,19690,7739,11951,0.08603979104145826,0.1327550589750994,0.6069578466226511
1,15,없다/Adjective,16914,5001,11913,0.05560742469712127,0.13233301494924365,0.7043277758070238
2,18,있다/Adjective,13419,8187,5232,0.09101922863176616,0.05813101135076301,0.6101050748938073
3,19,좋다/Adjective,13043,9370,3673,0.10416805601867288,0.040816099868944224,0.7183930077436173
4,20,이/Determiner,12373,4495,7878,0.04998332777592531,0.08751860325640286,0.6367089630647378
5,22,재밌다/Adjective,11789,9955,1834,0.1106702234078026,0.020391390301872543,0.8444312494698448
6,23,?/Punctuation,11319,3302,8017,0.03672335222852062,0.08906239587729625,0.7082781164413817
7,24,정말/Noun,10702,7082,3620,0.07873735689674335,0.04022745951709279,0.6617454681367969
8,25,것/Noun,10293,4088,6205,0.045459597643659005,0.06893755969701681,0.6028368794326241
9,30,적/Suffix,9003,5486,3517,0.06099811048127154,0.03908349807858904,0.6093524380761969
10,32,아니다/Adjective,8754,3210,5544,0.035700789151939534,0.061596214931473374,0.6333104866346813
11,34,!/Punctuation,8565,6415,2150,0.07132377459153051,0.02390101956951509,0.7489784004670169
12,38,만/Josa,7745,2412,5333,0.026831165944203626,0.05925275994580066,0.6885732730794061
13,40,만들다/Verb,7199,2506,4693,0.02787595865288429,0.05214465003665119,0.6518960966800944
14,43,과/Josa,6768,4231,2537,0.0470490163387796,0.028199204780203917,0.6251477541371159
15,44,최고/Noun,6671,6143,528,0.06830054462598642,0.005886403518514404,0.9208514465597362
16,46,이다/Verb,6524,4043,2481,0.04495943092141825,0.02757724516315333,0.6197118332311465
17,47,왜/Noun,6247,2241,4006,0.024930532399688784,0.04451453830604856,0.6412678085481031
18,48,스토리/Noun,6075,2176,3899,0.02420806935645215,0.04332615118061263,0.6418106995884774
19,50,생각/Noun,6005,3771,2234,0.04193620095587418,0.02483395899509096,0.6279766860949209
20,51,~/Punctuation,6003,4016,1987,0.0446593308880738,0.022090672827028587,0.6689988339163752
21,55,감동/Noun,5597,4442,1155,0.049394242525286215,0.012850129945134276,0.7936394497051992
22,56,..../Punctuation,5580,2218,3362,0.024674891630543514,0.0373620027099669,0.6025089605734767
23,57,1/Number,5284,1409,3875,0.015683005446259866,0.043059597059019517,0.7333459500378501
24,62,아깝다/Adjective,5167,374,4793,0.004179170834722685,0.0532552922099558,0.9276175730598026
25,64,드라마/Noun,5005,3017,1988,0.03355562965432922,0.022101779248761638,0.6027972027972028
26,66,때/Noun,4940,3220,1720,0.03581193731243748,0.01912525822430529,0.6518218623481782
27,69,재미있다/Adjective,4787,4102,685,0.04561520506835612,0.007630111730602634,0.8569041153123041
28,72,감독/Noun,4688,1515,3173,0.016861175947538068,0.0352628890024212,0.6768344709897611
29,73,ㅋㅋ/KoreanParticle,4594,2777,1817,0.03088807380237857,0.02020258113241076,0.6044841097083152
30,74,재미/Noun,4538,1752,2786,0.01949538735133934,0.03096470379173238,0.6139268400176289
31,75,내용/Noun,4529,1407,3122,0.015660775814160276,0.03469646149403585,0.6893353941267388
32,76,뭐/Noun,4491,831,3660,0.009258641769478715,0.04067171638641463,0.8149632598530394
33,77,못/VerbPrefix,4418,1474,2944,0.0164054684894965,0.032719518425553665,0.666364870982345
34,78,그냥/Noun,4406,1187,3219,0.013215516283205513,0.035773784402141316,0.7305946436677259
35,81,게/Josa,4340,1723,2617,0.0191730576858953,0.0290877185188476,0.6029953917050691
36,82,주다/Verb,4321,1728,2593,0.01922863176614427,0.028821164397254493,0.6000925711640824
37,83,안/VerbPrefix,4262,1318,2944,0.014671557185728575,0.032719518425553665,0.6907555138432661
38,84,재미없다/Adjective,4205,307,3898,0.0034344781593864623,0.04331504475887958,0.9269916765755052
39,85,자다/Verb,4114,2658,1456,0.029565410692453036,0.01619316288678114,0.6460865337870686
40,86,좀/Noun,4111,1455,2656,0.0161942869845504,0.029520868966436395,0.6460715154463634
41,88,지루하다/Adjective,4057,872,3185,0.009714349227520284,0.03539616606321775,0.7850628543258565
42,91,!!/Punctuation,4005,3088,917,0.03434478159386462,0.010206801572669318,0.7710362047440699
43,92,시간/Noun,3956,1077,2879,0.01199288651772813,0.03199760101290566,0.7277553083923155
44,94,쓰레기/Noun,3739,209,3530,0.002345226186506613,0.03922788156111864,0.9441027012570206
45,96,수/Noun,3698,2475,1223,0.027531399355340668,0.013605366622981408,0.6692806922660898
46,99,그렇다/Adjective,3501,1397,2104,0.01554962765366233,0.02339012416979497,0.6009711510996858
47,101,아/Exclamation,3469,1327,2142,0.014771590530176725,0.023812168195650726,0.6174690112424329
48,104,작품/Noun,3308,2050,1258,0.02280760253417806,0.01399409138363802,0.6197097944377267
49,105,다시/Noun,3289,2763,526,0.03073246637768145,0.005864190675048313,0.8400729705077531
50,106,10/Number,3248,2158,1090,0.02400800266755585,0.012128212532486284,0.6644088669950738
51,107,마지막/Noun,3201,2151,1050,0.02393019895520729,0.011683955663164441,0.6719775070290535
52,109,사랑/Noun,3190,2523,667,0.0280649105257308,0.0074301961394078065,0.7909090909090909
53,110,잘/VerbPrefix,3151,2150,1001,0.023919084139157498,0.011139740998245185,0.682323072040622
54,114,요/Josa,3013,1950,1063,0.02169612092919862,0.01182833914569404,0.6471954862263525
55,116,이다/Adjective,2942,2200,742,0.02447482494164721,0.00826317776938626,0.7477906186267845
56,117,나/Josa,2916,1029,1887,0.011459375347338,0.020980030653723985,0.647119341563786
57,123,주인공/Noun,2708,1083,1625,0.012059575414026896,0.018070148159665917,0.6000738552437223
58,124,안되다/Adjective,2683,658,2025,0.0073357785928642874,0.022512716852884338,0.7547521431233694
59,130,중/Suffix,2597,1568,1029,0.017450261198177167,0.011450720806770473,0.6037735849056604
60,131,지금/Noun,2596,1843,753,0.020506835611870625,0.008385348408449766,0.7099383667180277
61,132,ㅠㅠ/KoreanParticle,2589,1842,747,0.020495720795820828,0.008318709878051491,0.7114716106604867
62,133,최악/Noun,2549,32,2517,0.00037790374569300877,0.027977076345542997,0.9874460572773636
63,134,지/Josa,2511,993,1518,0.011059241969545405,0.01688176103422999,0.6045400238948626
64,136,걸/Noun,2493,777,1716,0.008658441702789819,0.01908083253737311,0.6883273164861613
65,137,3/Number,2481,918,1563,0.010225630765810827,0.017381550012217063,0.6299879081015719
66,139,연출/Noun,2454,975,1479,0.010859175280649105,0.016448610586641196,0.6026894865525673
67,140,별로/Noun,2438,320,2118,0.0035789707680337892,0.023545614074057617,0.8687448728465955
68,141,끝/Noun,2438,862,1576,0.009603201067022341,0.01752593349474666,0.6464315012305168
69,142,돈/Noun,2433,279,2154,0.00312326330999222,0.023945445256447283,0.8853267570900123
70,147,그리고/Conjunction,2339,1419,920,0.01579415360675781,0.010240120837868457,0.6066695168875588
71,148,역시/Noun,2323,1623,700,0.01806157608091586,0.007796708056598325,0.6986655187257856
72,149,넘다/Verb,2286,1520,766,0.01691675002778704,0.008529731890979364,0.6649168853893264
73,150,개/Noun,2277,671,1606,0.007480271201511616,0.017859126146738045,0.7053140096618358
74,151,명작/Noun,2259,1976,283,0.02198510614649328,0.0031653301939181234,0.8747233289065959
75,153,남다/Verb,2231,1452,779,0.016160942536401022,0.008674115373508963,0.6508292245629762
76,154,이런/Modifier,2201,819,1382,0.009125263976881185,0.015371287678535732,0.6278964107223989
77,157,^^/Punctuation,2162,1921,241,0.021373791263754584,0.002698860481130189,0.8885291396854764
78,158,라고/Josa,2147,777,1370,0.008658441702789819,0.015238010617739176,0.6380996739636703
79,159,괜찮다/Adjective,2129,1444,685,0.01607202400800267,0.007630111730602634,0.6782527007984971
80,160,ㅡㅡ/KoreanParticle,2128,211,1917,0.002367455818606202,0.021313223305715362,0.9008458646616542
81,163,버리다/Verb,2073,660,1413,0.007358008224963877,0.015715586752260157,0.6816208393632417
82,164,느끼다/Verb,2066,1442,624,0.016049794375903082,0.006952620004886826,0.6979670861568248
83,166,때문/Noun,2060,810,1250,0.009025230632433032,0.013905240009773652,0.6067961165048543
84,167,!!!/Punctuation,2038,1392,646,0.01549405357341336,0.007196961283013839,0.6830225711481845
85,168,또/Noun,2013,1348,665,0.01500500166722241,0.007407983295941714,0.6696472925981123
86,170,해주다/Verb,1945,1324,621,0.014738246082027343,0.0069193007396876885,0.680719794344473
87,171,여자/Noun,1944,757,1187,0.008436145381793929,0.01320553544059175,0.61059670781893
88,172,난/Noun,1928,1196,732,0.013315549627653665,0.0081521135520558,0.6203319502074689
89,173,꼭/Noun,1920,1594,326,0.017739246415471824,0.003642906328439104,0.8302083333333333
90,177,아름답다/Adjective,1901,1659,242,0.01846170945870846,0.0027099669028632354,0.8726985796948974
91,181,마음/Noun,1810,1497,313,0.016661109258641768,0.003498522845909505,0.8270718232044199
92,182,인생/Noun,1810,1304,506,0.014515949761031457,0.005642062240387392,0.7204419889502762
93,185,기억/Noun,1794,1237,557,0.01377125708569523,0.00620848974877274,0.6895206243032329
94,188,끄다/Verb,1754,541,1213,0.006035345115038346,0.013494302405650948,0.6915621436716077
95,189,아쉽다/Adjective,1746,1186,560,0.013204401467155718,0.006241809013971878,0.6792668957617412
96,191,ㅎㅎ/KoreanParticle,1744,1498,246,0.01667222407469156,0.00275439258979542,0.8589449541284404
97,194,못/Noun,1720,544,1176,0.0060686895631877295,0.013083364801528243,0.6837209302325581
98,195,소재/Noun,1714,594,1120,0.006624430365677447,0.012461405184477666,0.6534422403733956
99,196,이나/Josa,1704,527,1177,0.005879737690341225,0.013094471223261291,0.6907276995305164
100,197,어리다/Verb,1690,1270,420,0.014138046015338444,0.004686909971345432,0.7514792899408284
101,198,재다/Verb,1675,1417,258,0.01577192397465822,0.0028876696505919725,0.8459701492537314
102,200,뻔하다/Adjective,1670,457,1213,0.005101700566855619,0.013494302405650948,0.7263473053892215
103,201,애/Noun,1670,576,1094,0.006424363676781149,0.012172638219418469,0.6550898203592814
104,202,수준/Noun,1658,273,1385,0.003056574413693453,0.01540460694373487,0.8353437876960192
105,203,맞다/Verb,1649,477,1172,0.005323996887851506,0.01303893911459606,0.7107337780473014
106,204,한번/Noun,1640,1136,504,0.012648660664666,0.0056198493969213,0.6926829268292682
107,206,네/Josa,1608,469,1139,0.005235078359453151,0.01267242719740554,0.7083333333333334
108,210,현실/Noun,1587,1041,546,0.011592753139935534,0.0060863191097092345,0.6559546313799622
109,211,전개/Noun,1586,418,1168,0.004668222740913638,0.012994513427663876,0.7364438839848676
110,212,매력/Noun,1586,1153,433,0.012837612537512505,0.004831293453875031,0.7269861286254728
111,214,되어다/Verb,1577,1073,504,0.011948427253528954,0.0056198493969213,0.6804058338617628
112,215,가슴/Noun,1575,1376,199,0.01531621651661665,0.002232390768342256,0.8736507936507937
113,216,낮다/Adjective,1560,1254,306,0.013960208958541736,0.0034207778937781824,0.8038461538461539
114,217,말다/Verb,1559,338,1221,0.0037790374569300882,0.013583153779515316,0.7831943553559975
115,219,~~/Punctuation,1556,1038,518,0.011559408691786151,0.005775339301183945,0.6670951156812339
116,220,야/Josa,1543,373,1170,0.00416805601867289,0.013016726271129968,0.7582631237848347
117,222,높다/Adjective,1536,327,1209,0.003656774480382349,0.013449876718718765,0.787109375
118,223,님/Suffix,1536,948,588,0.010559075247304657,0.006552788822497168,0.6171875
119,225,가장/Noun,1534,1006,528,0.011203734578192731,0.005886403518514404,0.6558018252933507
120,226,;;/Punctuation,1523,373,1150,0.00416805601867289,0.012794597836469045,0.7550886408404465
121,228,슬프다/Adjective,1504,1292,212,0.014382571968433922,0.002376774250871854,0.8590425531914894
122,229,??/Punctuation,1503,455,1048,0.0050794709347560295,0.01166174281969835,0.697272122421823
123,231,멋지다/Adjective,1475,1271,204,0.01414916083138824,0.0022879228770074857,0.8616949152542372
124,235,음악/Noun,1452,1077,375,0.01199288651772813,0.00418712099335836,0.7417355371900827
125,237,성/Suffix,1445,496,949,0.005535178392797599,0.010562207068126793,0.6567474048442906
126,239,유치하다/Adjective,1442,282,1160,0.003156607758141603,0.012905662053799508,0.8044382801664355
127,240,아이/Noun,1436,944,492,0.01051461598310548,0.005486572336124747,0.6573816155988857
128,241,죽다/Verb,1435,475,960,0.005301767255751918,0.010684377707190298,0.6689895470383276
129,244,솔직하다/Adjective,1420,500,920,0.005579637656996777,0.010240120837868457,0.647887323943662
130,247,무슨/Noun,1408,215,1193,0.00241191508280538,0.013272173970990026,0.8473011363636364
131,248,추천/Noun,1403,1037,366,0.011548293875736356,0.004087163197760945,0.7391304347826086
132,249,만/Noun,1401,947,454,0.010547960431254862,0.0050645283102689976,0.6759457530335474
133,250,냐/Josa,1392,169,1223,0.0019006335445148387,0.013605366622981408,0.8785919540229885
134,251,인지/Josa,1383,425,958,0.004746026453262197,0.010662164863724205,0.6926970354302241
135,252,쓰다/Verb,1383,430,953,0.0048016005335111715,0.010606632755058977,0.6890817064352857
136,253,게/Noun,1380,485,895,0.005412915416249861,0.009962460294542305,0.6485507246376812
137,254,눈물/Noun,1378,1156,222,0.012870956985661888,0.0024878384682023146,0.8388969521044993
138,255,인가/Josa,1378,446,932,0.004979437590307881,0.010373397898665008,0.6763425253991292
139,257,번/Noun,1370,945,425,0.010525730799155274,0.004742442080010663,0.6897810218978102
140,259,ㅠ/KoreanParticle,1361,899,462,0.01001444926086473,0.005153379684133366,0.6605437178545187
141,261,저/Determiner,1355,471,884,0.00525730799155274,0.009840289655478798,0.6523985239852399
142,262,우리/Noun,1346,996,350,0.011092586417694788,0.003909460450032209,0.7399702823179792
143,263,인간/Noun,1346,839,507,0.00934756029787707,0.005653168662120438,0.6233283803863299
144,264,네/Suffix,1337,913,424,0.010170056685561854,0.004731335658277615,0.6828721017202692
145,268,속/Noun,1307,819,488,0.009125263976881185,0.005442146649192564,0.6266258607498087
146,270,허다/Verb,1294,206,1088,0.0023118817383572304,0.01210599968902019,0.8408037094281299
147,272,원작/Noun,1275,429,846,0.004790485717461376,0.009418245629623049,0.6635294117647059
148,273,짜증나다/Adjective,1251,81,1170,0.0009225297321329332,0.013016726271129968,0.9352517985611509
149,277,코미디/Noun,1235,485,750,0.005412915416249861,0.008352029143250627,0.6072874493927125
150,278,찍다/Verb,1231,259,972,0.002900966988996332,0.01081765476798685,0.7896019496344435
151,282,기대하다/Adjective,1222,341,881,0.003812381905079471,0.00980697039027966,0.7209492635024549
152,284,여운/Noun,1210,1139,71,0.012682005112815385,0.0008107687865123613,0.9413223140495868
153,286,움/Noun,1204,432,772,0.00482383016561076,0.00859637042137764,0.6411960132890365
154,288,전혀/Noun,1199,338,861,0.0037790374569300882,0.00958484195561874,0.7180984153461217
155,289,기대/Noun,1198,745,453,0.008302767589196399,0.005053421888535951,0.6218697829716193
156,291,모두/Noun,1194,810,384,0.009025230632433032,0.004287078788955775,0.6783919597989949
157,292,대박/Noun,1180,975,205,0.010859175280649105,0.002299029298740532,0.826271186440678
158,293,대한/Noun,1173,715,458,0.00796932310770257,0.005108953997201182,0.6095481670929241
159,295,씨/Suffix,1170,706,464,0.00786928976325442,0.005175592527599458,0.6034188034188034
160,297,별/Noun,1164,304,860,0.003401133711237079,0.009573735533885692,0.7388316151202751
161,298,이쁘다/Adjective,1161,733,428,0.008169389796598866,0.0047757613452098,0.6313522825150732
162,299,계속/Noun,1161,707,454,0.007880404579304213,0.0050645283102689976,0.6089577950043066
163,300,굿/Noun,1156,1072,84,0.011937312437479159,0.00095515226904196,0.9273356401384084
164,303,모습/Noun,1142,842,300,0.009380904746026451,0.003354139363379907,0.7373029772329247
165,304,별/Modifier,1142,316,826,0.0035345115038346118,0.009196117194962126,0.7232924693520141
166,305,미치다/Adjective,1139,415,724,0.004634878292764255,0.00806326217819143,0.6356453028972783
167,309,치다/Verb,1122,345,777,0.0038568411692786494,0.00865190253004287,0.6925133689839572
168,310,실망/Noun,1118,115,1003,0.001300433477825942,0.011161953841711278,0.8971377459749553
169,313,요/Noun,1099,666,433,0.007424697121262644,0.004831293453875031,0.6060054595086443
170,315,일본/Noun,1098,391,707,0.004368122707569189,0.007874453008729647,0.6438979963570127
171,316,시키다/Verb,1097,384,713,0.0042903189952206286,0.007941091539127924,0.649954421148587
172,317,보지/Noun,1094,324,770,0.003623430032232967,0.008574157577911549,0.7038391224862889
173,318,진심/Noun,1094,415,679,0.004634878292764255,0.007563473200204358,0.6206581352833638
174,319,건지다/Verb,1093,195,898,0.002189618761809492,0.009995779559741442,0.8215919487648673
175,325,일/Modifier,1074,387,687,0.004323663443370012,0.007652324574068727,0.6396648044692738
176,326,제목/Noun,1073,405,668,0.004523730132266311,0.007441302561140851,0.6225535880708295
177,327,귀엽다/Adjective,1069,881,188,0.009814382571968434,0.0021102201292787486,0.8241347053320861
178,331,대단하다/Adjective,1057,751,306,0.008369456485495166,0.0034207778937781824,0.7105014191106906
179,335,뿐/Noun,1051,311,740,0.0034789374235856397,0.008240964925920167,0.7040913415794482
180,338,ㅎ/KoreanParticle,1048,840,208,0.009358675113926865,0.00233234856393967,0.8015267175572519
181,339,;/Punctuation,1045,287,758,0.0032121818383905746,0.008440880517114994,0.7253588516746412
182,340,표현/Noun,1042,681,361,0.00759141936200956,0.004031631089095715,0.6535508637236085
183,341,OO/Alpha,1033,220,813,0.0024674891630543515,0.009051733712432529,0.7870280735721199
184,343,가족/Noun,1031,710,321,0.007913749027453596,0.0035873742197738727,0.6886517943743938
185,345,잔잔하다/Adjective,1023,897,126,0.009992219628765144,0.001421621981829894,0.8768328445747801
186,347,요즘/Noun,1013,643,370,0.0071690563521173735,0.00413158888469313,0.6347482724580454
187,349,점도/Noun,1011,91,920,0.001033677892630877,0.010240120837868457,0.9099901088031652
188,352,용/Noun,999,295,704,0.003301100366788929,0.00784113374353051,0.7047047047047047
189,353,떨어지다/Verb,997,207,790,0.0023229965544070245,0.00879628601257247,0.7923771313941825
190,354,ㅜㅜ/KoreanParticle,996,633,363,0.007057908191619429,0.004053843932561807,0.6355421686746988
191,355,모든/Noun,986,630,356,0.007024563743470045,0.003976098980430485,0.6389452332657201
192,356,4/Number,981,333,648,0.0037234633766811158,0.007219174126479932,0.6605504587155964
193,358,급/Noun,974,237,737,0.002656441035900856,0.00820764566072103,0.7566735112936345
194,359,웃다/Verb,974,598,376,0.006668889629876626,0.004198227415091406,0.6139630390143738
195,361,조금/Noun,967,582,385,0.006491052573079916,0.00429818521068882,0.6018614270941055
196,362,특히/Adverb,966,665,301,0.007413582305212848,0.0033652457851129523,0.6884057971014492
197,364,빠지다/Verb,964,602,362,0.006713348894075803,0.0040427375108287615,0.6244813278008299
198,366,개인/Noun,957,633,324,0.007057908191619429,0.003620693484973011,0.6614420062695925
199,369,공포/Noun,951,319,632,0.0035678559519839955,0.007041471378751194,0.6645636172450052
200,370,짜다/Verb,947,361,586,0.00403467822607536,0.006530575979031076,0.6187961985216474
201,372,건/Noun,932,292,640,0.0032677559186395466,0.0071303227526155625,0.6866952789699571
202,373,한테/Josa,931,317,614,0.0035456263198844064,0.006841555787556365,0.6595059076262084
203,374,작가/Noun,929,209,720,0.002345226186506613,0.008018836491259245,0.77502691065662
204,375,이유/Noun,928,364,564,0.00406802267422474,0.006286234700904063,0.6077586206896551
205,376,나름/Noun,923,600,323,0.006691119261976214,0.003609587063239965,0.6500541711809318
206,379,욕/Noun,910,166,744,0.0018672890963654552,0.00828539061285235,0.8175824175824176
207,380,차라리/Noun,909,59,850,0.0006780037790374569,0.00946267131655523,0.935093509350935
208,381,이상하다/Adjective,909,232,677,0.002600866955651884,0.007541260356738266,0.7447744774477447
209,382,노래/Noun,909,604,305,0.006735578526175392,0.0034096714720451365,0.6644664466446645
210,383,깊다/Adjective,907,808,99,0.009003001000333445,0.0011217485950376508,0.8908489525909592
211,385,짱/Noun,905,842,63,0.009380904746026451,0.0007219174126479931,0.9303867403314916
212,386,중간/Noun,905,328,577,0.0036678892964321437,0.0064306181834336605,0.6375690607734806
213,387,울다/Verb,900,695,205,0.00774702678670668,0.002299029298740532,0.7722222222222223
214,388,알바/Noun,897,104,793,0.001178170501278204,0.008829605277771607,0.8840579710144928
215,390,0/Number,888,77,811,0.0008780704679337558,0.009029520868966436,0.9132882882882885
216,392,따뜻하다/Adjective,884,833,51,0.009280871401578305,0.0005886403518514405,0.9423076923076924
217,393,느껴지다/Verb,884,553,331,0.0061687229076358785,0.0036984384371043337,0.6255656108597285
218,394,삶/Noun,883,770,113,0.008580637990441259,0.0012772384993002955,0.8720271800679502
219,397,...../Punctuation,877,327,550,0.003656774480382349,0.006130744796641418,0.6271379703534777
220,398,제/Noun,874,553,321,0.0061687229076358785,0.0035873742197738727,0.6327231121281465
221,399,오랜/Modifier,870,699,171,0.007791486050905858,0.0019214109598169665,0.8034482758620691
222,400,기/Noun,869,240,629,0.0026897854840502392,0.007008152113552056,0.7238204833141542
223,401,예쁘다/Adjective,865,571,294,0.006368789596532178,0.00328750083298163,0.6601156069364161
224,403,당시/Noun,862,550,312,0.006135378459486495,0.003487416424176459,0.6380510440835266
225,404,빼다/Verb,861,250,611,0.002800933644548183,0.006808236522357226,0.7096399535423926
226,405,점수/Noun,857,271,586,0.0030343447815938647,0.006530575979031076,0.6837806301050176
227,409,놈/Noun,846,250,596,0.002800933644548183,0.006641640196361536,0.7044917257683215
228,410,아직도/Adverb,841,631,210,0.00703567855951984,0.002354561407405762,0.7502972651605232
229,411,어설프다/Adjective,834,79,755,0.0009003001000333445,0.008407561251915855,0.9052757793764988
230,412,막장/Noun,834,144,690,0.001622763143269979,0.007685643839267866,0.8273381294964028
231,416,훌륭하다/Adjective,825,663,162,0.007391352673113259,0.001821453164219552,0.8036363636363636
232,417,세상/Noun,824,533,291,0.00594642658663999,0.003254181567782492,0.6468446601941747
233,420,공포영화/Noun,809,293,516,0.003278870734689341,0.005753126457717852,0.6378244746600742
234,422,도대체/Noun,805,101,704,0.0011448260531288204,0.00784113374353051,0.8745341614906832
235,424,힘들다/Adjective,799,310,489,0.0034678226075358447,0.005453253070925609,0.6120150187734669
236,425,앞/Noun,797,485,312,0.005412915416249861,0.003487416424176459,0.6085319949811794
237,426,생각나다/Verb,795,647,148,0.00721351561631655,0.001665963259956907,0.8138364779874214
238,427,류/Noun,790,141,649,0.0015894186951205956,0.007230280548212976,0.8215189873417722
239,431,절대/Noun,787,263,524,0.0029454262531955103,0.005841977831582221,0.6658195679796697
240,433,뭘/Noun,782,175,607,0.001967322440813605,0.006763810835425043,0.7762148337595908
241,434,잇다/Verb,780,524,256,0.0058463932421918404,0.00286545680712588,0.6717948717948717
242,437,물/Noun,777,295,482,0.003301100366788929,0.005375508118794287,0.6203346203346203
243,440,써다/Verb,768,243,525,0.0027231299321996217,0.005853084253315267,0.68359375
244,441,수작/Noun,766,696,70,0.007758141602756475,0.0007996623647793153,0.908616187989556
245,442,엄청/Adverb,766,465,301,0.0051906190952539745,0.0033652457851129523,0.6070496083550914
246,443,걍/Adverb,765,208,557,0.002334111370456819,0.00620848974877274,0.7281045751633987
247,444,설정/Noun,762,139,623,0.0015671890630210071,0.0069415135831537795,0.8175853018372703
248,445,초반/Noun,761,265,496,0.0029676558852950985,0.005530998023056932,0.6517739816031537
249,448,놓다/Verb,755,225,530,0.0025230632433033235,0.005908616361980497,0.7019867549668874
250,449,필요없다/Adjective,754,630,124,0.007024563743470045,0.0013994091383638019,0.8355437665782494
251,451,신선하다/Adjective,748,507,241,0.0056574413693453365,0.002698860481130189,0.6778074866310161
252,452,싫다/Adjective,746,130,616,0.0014671557185728574,0.0068637686310224575,0.8257372654155496
253,453,시나리오/Noun,742,207,535,0.0023229965544070245,0.005964148470645727,0.7210242587601078
254,454,딱/Adverb,742,251,491,0.002812048460597977,0.005475465914391701,0.6617250673854448
255,458,출연/Noun,740,226,514,0.0025341780593531177,0.00573091361425176,0.6945945945945946
256,461,멋있다/Adjective,732,615,117,0.0068578415027231296,0.0013216641862324795,0.8401639344262295
257,462,관객/Noun,732,188,544,0.002111815049460932,0.006064106266243142,0.7431693989071039
258,465,가지/Noun,725,278,447,0.003112148493942425,0.004986783358137676,0.616551724137931
259,466,노잼/Noun,724,17,707,0.00021118150494609317,0.007874453008729647,0.9765193370165746
260,468,뭔/Modifier,722,104,618,0.001178170501278204,0.006885981474488549,0.8559556786703602
261,469,분위기/Noun,721,443,278,0.004946093142158497,0.003109798085252893,0.6144244105409153
262,470,답답하다/Adjective,719,131,588,0.001478270534622652,0.006552788822497168,0.8178025034770514
263,471,아프다/Adjective,719,559,160,0.006235411803934645,0.0017992403207534593,0.7774687065368567
264,472,시대/Noun,719,474,245,0.005290652439702123,0.0027432861680623736,0.6592489568845619
265,474,장난/Noun,714,182,532,0.002045126153162165,0.005930829205446589,0.7450980392156863
266,475,죽이다/Verb,713,198,515,0.002222963209958875,0.005742020035984807,0.7223001402524544
267,477,최고다/Noun,711,679,32,0.007569189729909971,0.0003776183389235656,0.9549929676511956
268,478,스럽다/Adjective,711,238,473,0.00266755585195065,0.0052755503231968716,0.6652601969057665
269,480,OOO/Alpha,708,91,617,0.001033677892630877,0.006874875052755503,0.8714689265536724
270,481,결국/Adverb,708,253,455,0.0028342780926975657,0.005075634732002044,0.6426553672316384
271,482,지루함/Noun,707,100,607,0.0011337112370790265,0.006763810835425043,0.8585572842998586
272,483,추억/Noun,707,576,131,0.006424363676781149,0.0014771540904951245,0.8147100424328148
273,484,나쁘다/Adjective,707,269,438,0.003012115149494276,0.004886825562540261,0.6195190947666195
274,486,소리/Noun,705,202,503,0.0022674224741580525,0.005608742975188254,0.7134751773049646
275,489,이딴/Modifier,703,26,677,0.00031121484939424253,0.007541260356738266,0.9630156472261736
276,490,더럽다/Adjective,701,81,620,0.0009225297321329332,0.00690819431795464,0.8844507845934381
277,493,마다/Josa,694,480,214,0.005357341336000889,0.0023989870943379463,0.69164265129683
278,494,살/Noun,690,420,270,0.004690452373013226,0.003020946711388525,0.6086956521739131
279,495,인상/Noun,689,547,142,0.006102034011337114,0.0015993247295586306,0.7939042089985486
280,496,이지만/Josa,687,427,260,0.0047682560853617864,0.0029098824940580643,0.6215429403202329
281,497,어이없다/Adjective,686,55,631,0.0006335445148382794,0.007030364957018148,0.9198250728862972
282,498,오늘/Noun,685,462,223,0.005157274647104589,0.002498944889935361,0.6744525547445256
283,499,감정/Noun,684,445,239,0.004968322774258086,0.0026766476376640968,0.6505847953216374
284,501,부족하다/Adjective,681,215,466,0.00241191508280538,0.0051978053710655505,0.6842878120411159
285,503,전/Modifier,680,199,481,0.0022340780260086696,0.005364401697061241,0.7073529411764706
286,504,정신/Noun,678,183,495,0.0020562409692119594,0.0055198916013238855,0.7300884955752213
287,505,엔딩/Noun,678,431,247,0.004812715349560965,0.002765499011528466,0.6356932153392331
288,507,접/Noun,676,122,554,0.0013782371901745027,0.006175170483573602,0.8195266272189349
289,509,잊다/Verb,674,570,104,0.0063576747804823825,0.001177280703702881,0.8456973293768546
290,510,졸작/Noun,672,34,638,0.0004001333777925976,0.007108109909149471,0.949404761904762
291,511,제발/Noun,671,179,492,0.002011781705012782,0.005486572336124747,0.7332339791356185
292,512,자신/Noun,671,422,249,0.004712682005112816,0.002787711854994558,0.6289120715350224
293,514,아무리/Adverb,666,114,552,0.0012893186617761474,0.00615295764010751,0.8288288288288288
294,515,그저/Adverb,666,221,445,0.002478603979104145,0.004964570514671583,0.6681681681681682
295,517,♥/Foreign,660,651,9,0.007257974880515727,0.00012217063906350652,0.9863636363636364
296,519,킬링타임/Noun,659,186,473,0.0020895854173613427,0.0052755503231968716,0.7177541729893778
297,520,~~~/Punctuation,657,400,257,0.004468156052017339,0.002876563228858926,0.60882800608828
298,521,함께/Adverb,656,544,112,0.0060686895631877295,0.0012661320775672494,0.8292682926829268
299,522,그렇게/Adverb,656,251,405,0.002812048460597977,0.00452031364534974,0.6173780487804879
300,525,캐스팅/Noun,653,219,434,0.002456374347004557,0.0048423998756080755,0.664624808575804
301,527,대해/Noun,651,506,145,0.005646326553295543,0.001632643994757769,0.7772657450076805
302,529,어색하다/Adjective,642,123,519,0.001389352006224297,0.0057864457229169905,0.8084112149532711
303,530,포스터/Noun,642,205,437,0.002300766922307436,0.0048757191408072146,0.6806853582554517
304,531,적다/Verb,641,432,209,0.00482383016561076,0.002343454985672716,0.6739469578783152
305,532,몰입도/Noun,638,412,226,0.004601533844614872,0.0025322641551344988,0.64576802507837
306,534,엉/Exclamation,636,103,533,0.0011670556852284096,0.005941935627179635,0.8380503144654088
307,535,쓸다/Verb,636,162,474,0.0018228298321662773,0.005286656744929919,0.7452830188679245
308,536,자/Suffix,632,213,419,0.002389685450705791,0.004675803549612386,0.6629746835443038
309,537,갈수록/Noun,631,192,439,0.002156274313660109,0.004897931984273306,0.6957210776545166
310,539,개연/Noun,630,55,575,0.0006335445148382794,0.00640840533996757,0.9126984126984128
311,540,망하다/Adjective,630,89,541,0.0010114482605312882,0.0060307870010440036,0.8587301587301587
312,541,애니메이션/Noun,630,418,212,0.004668222740913638,0.002376774250871854,0.6634920634920635
313,546,!!!!/Punctuation,622,460,162,0.005135045015005002,0.001821453164219552,0.7395498392282959
314,549,문제/Noun,619,201,418,0.002256307658108259,0.00466469712787934,0.6752827140549273
315,550,진부하다/Adjective,618,109,509,0.0012337445815271755,0.005675381505586529,0.8236245954692557
316,552,이름/Noun,617,239,378,0.002678670668000445,0.004220440258557497,0.6126418152350082
317,553,지/Modifier,617,246,371,0.002756474380349005,0.004142695306426175,0.6012965964343598
318,554,하/Exclamation,614,213,401,0.002389685450705791,0.004475887958417557,0.6530944625407166
319,555,ㅠㅠㅠ/KoreanParticle,611,496,115,0.005535178392797599,0.0012994513427663874,0.8117839607201309
320,557,나가다/Verb,610,191,419,0.0021451594976103147,0.004675803549612386,0.6868852459016394
321,558,충격/Noun,610,399,211,0.004457041235967545,0.0023656678291388076,0.6540983606557377
322,560,맘/Noun,609,373,236,0.00416805601867289,0.0026433283724649594,0.6124794745484401
323,562,유쾌하다/Adjective,603,554,49,0.006179837723685673,0.0005664275083853486,0.9187396351575456
324,563,머리/Noun,603,235,368,0.002634211403801267,0.004109376041227037,0.6102819237147595
325,565,보단/Josa,600,239,361,0.002678670668000445,0.004031631089095715,0.6016666666666667
326,566,완벽하다/Adjective,599,512,87,0.00571301544959431,0.0009884715342410985,0.8547579298831386
327,567,질/Noun,599,104,495,0.001178170501278204,0.0055198916013238855,0.8263772954924875
328,574,놀라다/Verb,594,366,228,0.00409025230632433,0.002554476998600591,0.6161616161616161
329,575,적/Noun,593,406,187,0.004534844948316105,0.002099113707545703,0.684654300168634
330,578,강추/Noun,590,547,43,0.006102034011337114,0.0004997889779870722,0.9271186440677966
331,579,행복하다/Adjective,590,524,66,0.0058463932421918404,0.0007552366778471312,0.8881355932203391
332,580,얘기/Noun,590,217,373,0.0024341447149049678,0.004164908149892268,0.6322033898305085
333,581,대/Foreign,587,217,370,0.0024341447149049678,0.00413158888469313,0.6303236797274276
334,583,장르/Noun,583,201,382,0.002256307658108259,0.004264865945489682,0.6552315608919382
335,585,더빙/Noun,582,150,432,0.0016894520395687453,0.004820187032141985,0.7422680412371134
336,589,주연/Noun,577,225,352,0.0025230632433033235,0.0039316732934983,0.6100519930675911
337,590,얼굴/Noun,576,199,377,0.0022340780260086696,0.004209333836824453,0.6545138888888888
338,593,즐겁다/Adjective,573,495,78,0.005524063576747805,0.0008885137386436838,0.8638743455497382
339,596,웃기/Noun,571,344,227,0.003845726353228854,0.0025433705768675447,0.6024518388791593
340,597,머/Noun,570,97,473,0.0011003667889296432,0.0052755503231968716,0.8298245614035088
341,599,비/Noun,563,225,338,0.0025230632433033235,0.003776183389235656,0.6003552397868561
342,601,꽤/Noun,562,441,121,0.00492386351005891,0.001366089873164664,0.7846975088967971
343,603,짜증/Noun,558,23,535,0.00027787040124485944,0.005964148470645727,0.9587813620071683
344,604,9/Number,557,382,175,0.00426808936312104,0.00196583664674915,0.6858168761220825
345,605,매우/Noun,557,343,214,0.0038346115371790603,0.0023989870943379463,0.6157989228007181
346,606,ㅡ/KoreanParticle,556,157,399,0.0017672557519173055,0.004453675114951465,0.7176258992805755
347,607,날/Noun,556,337,219,0.003767922640880293,0.0024545192030031764,0.6061151079136691
348,608,ㅎㅎㅎ/KoreanParticle,555,434,121,0.004846059797710348,0.001366089873164664,0.781981981981982
349,610,너무나/Adverb,552,365,187,0.004079137490274536,0.002099113707545703,0.6612318840579711
350,611,이리/Adverb,552,199,353,0.0022340780260086696,0.003942779715231347,0.6394927536231884
351,612,진/Noun,552,216,336,0.002423029898855174,0.0037539705457695642,0.6086956521739131
352,614,???/Punctuation,551,142,409,0.0016005335111703902,0.004564739332281925,0.7422867513611615
353,615,두/Noun,551,362,189,0.004045793042125153,0.002121326551011795,0.6569872958257713
354,617,새롭다/Adjective,549,377,172,0.004212515282872069,0.0019325173815500122,0.6867030965391621
355,619,건가/Noun,546,124,422,0.0014004668222740914,0.004709122814811524,0.7728937728937729
356,620,아직/Adverb,546,363,183,0.004056907858174947,0.0020546880206135185,0.6648351648351648
357,621,생기다/Verb,545,190,355,0.00213404468156052,0.003964992558697439,0.6513761467889908
358,624,멀다/Adjective,544,178,366,0.0020006668889629878,0.004087163197760945,0.6727941176470589
359,625,작/Modifier,544,183,361,0.0020562409692119594,0.004031631089095715,0.6636029411764706
360,626,소름/Noun,540,437,103,0.004879404245859731,0.001166174281969835,0.8092592592592592
361,627,심하다/Adjective,539,81,458,0.0009225297321329332,0.005108953997201182,0.8497217068645642
362,628,충분하다/Adjective,539,414,125,0.004623763476714461,0.001410515560096848,0.7680890538033395
363,629,불쌍하다/Adjective,539,206,333,0.0023118817383572304,0.0037206512805704256,0.6178107606679035
364,630,글/Noun,538,195,343,0.002189618761809492,0.0038317154979008857,0.6375464684014871
365,631,식/Suffix,534,210,324,0.002356341002556408,0.003620693484973011,0.6067415730337079
366,632,걸작/Noun,533,459,74,0.005123930198955207,0.0008440880517114996,0.8611632270168855
367,633,그나마/Adverb,532,40,492,0.0004668222740913638,0.005486572336124747,0.924812030075188
368,634,억지/Noun,527,72,455,0.0008224963876847838,0.005075634732002044,0.8633776091081594
369,635,대체/Noun,527,89,438,0.0010114482605312882,0.004886825562540261,0.8311195445920304
370,638,시절/Noun,526,397,129,0.004434811603867956,0.0014549412470290322,0.7547528517110266
371,640,존나/Noun,525,122,403,0.0013782371901745027,0.004498100801883649,0.7676190476190476
372,641,약간/Noun,525,357,168,0.003990218961876181,0.001888091694617828,0.68
373,642,역사/Noun,525,318,207,0.0035567411359342,0.002321242142206624,0.6057142857142858
374,643,궁금하다/Adjective,524,199,325,0.0022340780260086696,0.003631799906706057,0.6202290076335878
375,646,실화/Noun,522,331,191,0.0037012337445815275,0.0021435393944778877,0.6340996168582376
376,650,해도/Noun,520,170,350,0.0019117483605646328,0.003909460450032209,0.6730769230769231
377,651,아무/Modifier,518,169,349,0.0019006335445148387,0.0038983540282991626,0.6737451737451737
378,654,B/Alpha,514,133,381,0.001500500166722241,0.004253759523756636,0.7412451361867705
379,655,한마디/Noun,514,156,358,0.0017561409358675113,0.003998311823896578,0.6964980544747081
380,659,순수하다/Adjective,506,433,73,0.004834944981660554,0.0008329816299784535,0.8557312252964426
381,660,휴/Exclamation,506,86,420,0.0009781038123819054,0.004686909971345432,0.8300395256916996
382,661,자기/Noun,506,160,346,0.001800600200066689,0.0038650347631000244,0.6837944664031621
383,662,누가/Noun,504,180,324,0.0020228965210625765,0.003620693484973011,0.6428571428571429
384,665,상당하다/Adjective,503,306,197,0.003423363343336668,0.0022101779248761637,0.6083499005964215
385,670,만점/Noun,501,423,78,0.00472379682116261,0.0008885137386436838,0.844311377245509
386,671,초딩/Noun,501,192,309,0.002156274313660109,0.003454097158977321,0.6167664670658682
387,675,간만/Noun,496,400,96,0.004468156052017339,0.0010884293298385123,0.8064516129032258
388,679,필요하다/Adjective,494,325,169,0.003634544848282761,0.0018991981163508738,0.6578947368421053
389,681,만나다/Verb,491,299,192,0.003345559630988107,0.0021546458162109328,0.6089613034623218
390,683,라도/Josa,488,145,343,0.0016338779593197733,0.0038317154979008857,0.7028688524590164
391,684,~!/Punctuation,487,385,102,0.0043014338112704244,0.001155067860236789,0.7905544147843943
392,685,CG/Alpha,487,126,361,0.0014226964543736804,0.004031631089095715,0.7412731006160165
393,686,굉장하다/Adjective,486,338,148,0.0037790374569300882,0.001665963259956907,0.6954732510288066
394,687,전체/Noun,486,158,328,0.0017783705679671,0.003665119171905196,0.6748971193415638
395,690,뿐/Suffix,482,150,332,0.0016894520395687453,0.0037095448588373796,0.6887966804979253
396,691,감성/Noun,482,311,171,0.0034789374235856397,0.0019214109598169665,0.6452282157676349
397,692,다음/Noun,482,299,183,0.003345559630988107,0.0020546880206135185,0.6203319502074689
398,693,사회/Noun,481,337,144,0.003767922640880293,0.0016215375730247227,0.7006237006237006
399,694,오/Modifier,481,187,294,0.0021007002334111373,0.00328750083298163,0.6112266112266113
400,695,네이버/Noun,480,179,301,0.002011781705012782,0.0033652457851129523,0.6270833333333333
401,697,발연기/Noun,477,34,443,0.0004001333777925976,0.004942357671205491,0.9287211740041929
402,698,무슨/Modifier,476,124,352,0.0014004668222740914,0.0039316732934983,0.7394957983193278
403,699,그런/Modifier,475,189,286,0.002122929865510726,0.003198649459117261,0.6021052631578947
404,701,당하다/Adjective,473,184,289,0.002067355785261754,0.0032319687243164,0.6109936575052854
405,704,따르다/Verb,470,174,296,0.0019562076247638107,0.0033097136764477218,0.6297872340425532
406,707,ㅉㅉ/KoreanParticle,466,72,394,0.0008224963876847838,0.004398143006286235,0.8454935622317596
407,708,이르다/Verb,466,177,289,0.001989552072913193,0.0032319687243164,0.6201716738197425
408,710,꿈/Noun,465,353,112,0.003945759697677003,0.0012661320775672494,0.7591397849462366
409,711,돌리다/Verb,463,161,302,0.0018117150161164836,0.0033763522068459982,0.652267818574514
410,714,에요/Josa,461,357,104,0.003990218961876181,0.001177280703702881,0.7744034707158352
411,715,나이/Noun,460,314,146,0.0035122818717350226,0.001643750416490815,0.6826086956521739
412,718,이/Foreign,458,326,132,0.0036456596643325546,0.0014882605122281704,0.7117903930131004
413,722,;;;/Punctuation,457,106,351,0.0012004001333777929,0.003920566871765255,0.7680525164113785
414,723,사랑스럽다/Adjective,456,433,23,0.004834944981660554,0.00027766054332615115,0.949561403508772
415,724,돋다/Verb,454,348,106,0.003890185617428032,0.0011994935471689732,0.7665198237885462
416,725,교훈/Noun,454,274,180,0.003067689229743248,0.0020213687554143807,0.6035242290748899
417,726,엄청나다/Adjective,453,290,163,0.003245526286539958,0.0018325595859525977,0.6401766004415012
418,728,소설/Noun,449,173,276,0.001945092808714016,0.003087585241786801,0.6146993318485523
419,730,이라도/Josa,446,106,340,0.0012004001333777929,0.0037983962327017475,0.7623318385650224
420,732,감사하다/Verb,445,404,41,0.004512615316216518,0.00047757613452098,0.907865168539326
421,733,바라다/Verb,444,271,173,0.0030343447815938647,0.0019436238032830586,0.6103603603603603
422,734,힘/Noun,443,266,177,0.002978770701344893,0.0019880494902152425,0.6004514672686229
423,736,시즌/Noun,442,315,127,0.003523396687784817,0.00143272840356294,0.7126696832579186
424,741,방송/Noun,436,131,305,0.001478270534622652,0.0034096714720451365,0.6995412844036697
425,742,지나다/Verb,435,309,126,0.003456707791486051,0.001421621981829894,0.7103448275862069
426,746,삼류/Noun,433,33,400,0.00038901856174280313,0.004464781536684511,0.9237875288683602
427,747,몇번/Noun,431,334,97,0.0037345781927309103,0.0010995357515715587,0.7749419953596288
428,748,진정하다/Adjective,431,313,118,0.0035011670556852285,0.0013327706079655256,0.7262180974477959
429,751,독특하다/Adjective,429,293,136,0.003278870734689341,0.0015326861991603546,0.6829836829836831
430,752,잡다/Verb,429,149,280,0.0016783372235189508,0.003132010928718985,0.6526806526806527
431,753,죽/Noun,428,138,290,0.0015560742469712125,0.0032430751460494453,0.677570093457944
432,754,....../Punctuation,427,155,272,0.001745026119817717,0.0030431595548546173,0.6370023419203747
433,758,여주/Noun,424,130,294,0.0014671557185728574,0.00328750083298163,0.6933962264150944
434,759,담다/Verb,424,278,146,0.003112148493942425,0.001643750416490815,0.6556603773584906
435,760,가볍다/Adjective,423,287,136,0.0032121818383905746,0.0015326861991603546,0.6784869976359338
436,762,질질/Noun,419,72,347,0.0008224963876847838,0.0038761411848330703,0.8281622911694511
437,763,전부/Noun,418,133,285,0.001500500166722241,0.003187543037384216,0.6818181818181818
438,764,바/Noun,418,165,253,0.001856174280315661,0.0028321375419267424,0.6052631578947368
439,765,줄거리/Noun,417,136,281,0.0015338446148716238,0.0031431173504520315,0.6738609112709832
440,770,점주/Noun,415,98,317,0.0011114816049794377,0.003542948532841689,0.763855421686747
441,771,실제/Noun,415,250,165,0.002800933644548183,0.0018547724294186894,0.6024096385542169
442,773,망치다/Verb,414,42,372,0.0004890519061909527,0.004153801728159222,0.8985507246376812
443,774,답/Noun,413,100,313,0.0011337112370790265,0.003498522845909505,0.7578692493946732
444,775,넘치다/Adjective,412,298,114,0.003334444814938313,0.0012883449210333415,0.7233009708737864
445,777,성하다/Adjective,410,37,373,0.0004334778259419807,0.004164908149892268,0.9097560975609756
446,779,낭비/Noun,408,8,400,0.00011114816049794375,0.004464781536684511,0.9803921568627452
447,780,뜨다/Verb,408,147,261,0.0016561075914193618,0.0029209889157911107,0.6397058823529411
448,783,각본/Noun,407,121,286,0.0013671223741247086,0.003198649459117261,0.7027027027027027
449,785,맞추다/Verb,404,109,295,0.0012337445815271755,0.0032986072547146763,0.7301980198019802
450,786,재/Noun,401,255,146,0.002856507724797155,0.001643750416490815,0.6359102244389028
451,791,순간/Noun,397,263,134,0.0029454262531955103,0.0015104733556942625,0.6624685138539043
452,792,어른/Noun,397,249,148,0.0027898188284983887,0.001665963259956907,0.6272040302267002
453,793,평론가/Noun,397,239,158,0.002678670668000445,0.0017770274772873676,0.6020151133501259
454,794,갑자기/Noun,396,103,293,0.0011670556852284096,0.003276394411248584,0.73989898989899
455,795,제작/Noun,396,143,253,0.0016116483272201846,0.0028321375419267424,0.6388888888888888
456,797,이하/Noun,395,34,361,0.0004001333777925976,0.004031631089095715,0.9139240506329114
457,800,기다리다/Verb,392,279,113,0.00312326330999222,0.0012772384993002955,0.7117346938775511
458,801,간다/Noun,392,151,241,0.0017005668556185395,0.002698860481130189,0.6147959183673469
459,802,너무하다/Adjective,390,50,340,0.0005779704345893076,0.0037983962327017475,0.8717948717948718
460,803,의도/Noun,390,66,324,0.0007558074913860174,0.003620693484973011,0.8307692307692308
461,804,발/Noun,390,81,309,0.0009225297321329332,0.003454097158977321,0.7923076923076923
462,805,영/Noun,390,107,283,0.001211514949427587,0.0031653301939181234,0.7256410256410256
463,807,밑/Noun,388,119,269,0.0013448927420251196,0.0030098402896554786,0.6932989690721649
464,809,땜/Noun,387,126,261,0.0014226964543736804,0.0029209889157911107,0.6744186046511628
465,810,넣다/Verb,385,86,299,0.0009781038123819054,0.00334303294164686,0.7766233766233767
466,811,아버지/Noun,385,261,124,0.002923196621095921,0.0013994091383638019,0.6779220779220779
467,815,오글거리다/Verb,384,63,321,0.0007224630432366343,0.0035873742197738727,0.8359375
468,816,보내다/Verb,384,257,127,0.0028787373568967428,0.00143272840356294,0.6692708333333334
469,817,만들어지다/Verb,384,249,135,0.0027898188284983887,0.0015215797774273086,0.6484375
470,818,한편/Noun,384,232,152,0.002600866955651884,0.0017103889468890912,0.6041666666666666
471,821,굳다/Adjective,381,349,32,0.0039013004334778256,0.0003776183389235656,0.9160104986876642
472,824,볼때/Noun,380,276,104,0.0030899188618428363,0.001177280703702881,0.7263157894736842
473,825,바꾸다/Verb,379,143,236,0.0016116483272201846,0.0026433283724649594,0.6226912928759895
474,830,10년/Number,376,276,100,0.0030899188618428363,0.0011328550167706971,0.7340425531914894
475,834,첨/Adverb,374,111,263,0.0012559742136267645,0.002943201759257202,0.7032085561497327
476,835,막/Noun,373,133,240,0.001500500166722241,0.002687754059397144,0.6434316353887399
477,839,그때/Noun,371,269,102,0.003012115149494276,0.001155067860236789,0.7250673854447439
478,840,항상/Noun,371,247,124,0.0027675891963988,0.0013994091383638019,0.6657681940700808
479,842,좀비/Noun,370,127,243,0.0014338112704234743,0.0027210733245962818,0.6567567567567567
480,844,치고/Josa,368,112,256,0.0012670890296765588,0.00286545680712588,0.6956521739130435
481,846,뻔/Noun,367,98,269,0.0011114816049794377,0.0030098402896554786,0.7329700272479565
482,849,거지/Noun,366,99,267,0.001122596421029232,0.002987627446189387,0.7295081967213115
483,850,곳/Noun,365,245,120,0.002745359564299211,0.0013549834514316175,0.6712328767123288
484,855,짱/Suffix,361,320,41,0.0035789707680337892,0.00047757613452098,0.8864265927977839
485,856,성/Modifier,361,130,231,0.0014671557185728574,0.002587796263799729,0.6398891966759003
486,857,진행/Noun,360,97,263,0.0011003667889296432,0.002943201759257202,0.7305555555555555
487,862,이에요/Josa,358,286,72,0.0032010670223407804,0.0008218752082454075,0.7988826815642458
488,863,더욱/Noun,358,281,77,0.0031454929420918084,0.0008774073169106378,0.7849162011173184
489,864,tv/Alpha,358,103,255,0.0011670556852284096,0.0028543503853928343,0.7122905027932961
490,865,낫다/Noun,358,124,234,0.0014004668222740914,0.002621115528998867,0.6536312849162011
491,866,탄탄하다/Adjective,357,320,37,0.0035789707680337892,0.0004331504475887958,0.8963585434173671
492,867,돋보이다/Verb,357,275,82,0.003078804045793042,0.000932939425575868,0.7703081232492998
493,870,어이/Noun,355,29,326,0.0003445592975436257,0.003642906328439104,0.9183098591549296
494,871,상미/Noun,355,237,118,0.002656441035900856,0.0013327706079655256,0.6676056338028169
495,872,래/Josa,355,138,217,0.0015560742469712125,0.0024323063595370845,0.6112676056338028
496,874,참고/Noun,354,65,289,0.0007446926753362233,0.0032319687243164,0.8163841807909604
497,875,불편하다/Adjective,354,99,255,0.001122596421029232,0.0028543503853928343,0.7203389830508474
498,876,중국/Noun,354,122,232,0.0013782371901745027,0.002598902685532775,0.655367231638418
499,879,몇/Noun,353,222,131,0.00248971879515394,0.0014771540904951245,0.6288951841359773
500,880,흐르다/Verb,352,282,70,0.003156607758141603,0.0007996623647793153,0.8011363636363636
501,881,그녀/Noun,352,266,86,0.002978770701344893,0.000977365112508052,0.7556818181818182
502,882,억지스럽다/Adjective,351,50,301,0.0005779704345893076,0.0033652457851129523,0.8575498575498576
503,883,걸리다/Verb,351,96,255,0.0010892519728798488,0.0028543503853928343,0.7264957264957265
504,884,끼다/Verb,351,101,250,0.0011448260531288204,0.0027988182767276037,0.7122507122507122
505,886,즐기다/Verb,350,239,111,0.002678670668000445,0.0012550256558342032,0.6828571428571428
506,890,거기/Noun,348,120,228,0.0013560075580749138,0.002554476998600591,0.6551724137931034
507,892,점점/Noun,347,138,209,0.0015560742469712125,0.002343454985672716,0.6023054755043228
508,894,이냐/Josa,345,47,298,0.0005446259864399244,0.003331926519913814,0.8637681159420291
509,896,허무하다/Adjective,344,85,259,0.0009669889963321108,0.0028987760723250184,0.7529069767441859
510,897,어디서/Adverb,343,123,220,0.001389352006224297,0.0024656256247362228,0.641399416909621
511,899,술/Noun,342,58,284,0.0006668889629876625,0.0031764366156511693,0.8304093567251462
512,900,전형/Noun,342,64,278,0.0007335778592864287,0.003109798085252893,0.8128654970760234
513,901,똑같다/Adjective,341,86,255,0.0009781038123819054,0.0028543503853928343,0.7478005865102639
514,902,편집/Noun,340,103,237,0.0011670556852284096,0.002654434794198005,0.6970588235294117
515,904,잠/Noun,339,82,257,0.0009336445481827276,0.002876563228858926,0.7581120943952803
516,906,사건/Noun,337,130,207,0.0014671557185728574,0.002321242142206624,0.6142433234421365
517,908,화보/Noun,335,124,211,0.0014004668222740914,0.0023656678291388076,0.6298507462686567
518,910,화이팅/Noun,334,296,38,0.0033122151828387236,0.0004442568693218419,0.8862275449101796
519,911,때리다/Verb,334,116,218,0.0013115482938757365,0.0024434127812701305,0.6526946107784432
520,912,짧다/Adjective,334,217,117,0.0024341447149049678,0.0013216641862324795,0.6497005988023952
521,915,식상하다/Adjective,333,37,296,0.0004334778259419807,0.0033097136764477218,0.8888888888888888
522,916,마르다/Adjective,333,116,217,0.0013115482938757365,0.0024323063595370845,0.6516516516516516
523,921,꿀잼/Noun,330,316,14,0.0035345115038346118,0.00017770274772873674,0.9575757575757576
524,922,똥/Noun,330,29,301,0.0003445592975436257,0.0033652457851129523,0.912121212121212
525,923,그게/Noun,330,91,239,0.001033677892630877,0.0026766476376640968,0.7242424242424242
526,926,가지다/Verb,329,198,131,0.002222963209958875,0.0014771540904951245,0.6018237082066871
527,928,중반/Noun,328,125,203,0.0014115816383238858,0.0022768164552744398,0.6189024390243902
528,929,취향/Noun,328,127,201,0.0014338112704234743,0.0022546036118083475,0.6128048780487805
529,931,-_-/Punctuation,327,38,289,0.000444592641991775,0.0032319687243164,0.8837920489296636
530,932,개그/Noun,327,99,228,0.001122596421029232,0.002554476998600591,0.6972477064220184
531,933,싸우다/Verb,327,124,203,0.0014004668222740914,0.0022768164552744398,0.6207951070336392
532,938,엉망/Noun,326,22,304,0.000266755585195065,0.0033985650503120905,0.9325153374233128
533,939,병맛/Noun,326,57,269,0.0006557741469378681,0.0030098402896554786,0.8251533742331288
534,940,티/Noun,325,91,234,0.001033677892630877,0.002621115528998867,0.72
535,941,적당하다/Adjective,325,106,219,0.0012004001333777929,0.0024545192030031764,0.6738461538461539
536,942,복수/Noun,325,128,197,0.0014449260864732687,0.0022101779248761637,0.6061538461538462
537,944,뛰어나다/Adjective,324,238,86,0.00266755585195065,0.000977365112508052,0.7345679012345679
538,945,관/Noun,324,221,103,0.002478603979104145,0.001166174281969835,0.6820987654320988
539,946,걸다/Verb,324,116,208,0.0013115482938757365,0.00233234856393967,0.6419753086419753
540,947,ㄷㄷ/KoreanParticle,324,200,124,0.002245192842058464,0.0013994091383638019,0.6172839506172839
541,951,지겹다/Adjective,323,29,294,0.0003445592975436257,0.00328750083298163,0.9102167182662538
542,952,미화/Noun,323,44,279,0.0005112815382905413,0.003120904506985939,0.8637770897832817
543,953,~!!/Punctuation,323,253,70,0.0028342780926975657,0.0007996623647793153,0.7832817337461301
544,954,흥미/Noun,323,125,198,0.0014115816383238858,0.002221284346609209,0.6130030959752322
545,958,헐다/Verb,322,92,230,0.0010447927086806713,0.002576689842066683,0.7142857142857143
546,962,흥미진진/Noun,321,276,45,0.0030899188618428363,0.0005220018214531642,0.8598130841121495
547,967,훈훈하다/Adjective,319,281,38,0.0031454929420918084,0.0004442568693218419,0.8808777429467085
548,969,잘만/Noun,318,239,79,0.002678670668000445,0.0008996201603767299,0.7515723270440252
549,970,에겐/Josa,317,194,123,0.0021785039457596976,0.0013883027166307562,0.61198738170347
550,972,만으로도/Josa,316,285,31,0.003189952206290986,0.00036651191719051963,0.9018987341772152
551,973,낫다/Verb,316,91,225,0.001033677892630877,0.0025211577334014533,0.7120253164556962
552,974,나르다/Verb,316,224,92,0.002511948427253529,0.0010440036429063284,0.7088607594936709
553,975,학교/Noun,316,192,124,0.002156274313660109,0.0013994091383638019,0.6075949367088608
554,976,비추다/Verb,315,48,267,0.0005557408024897189,0.002987627446189387,0.8476190476190476
555,977,괜히/Adverb,315,80,235,0.0009114149160831386,0.002632221950731913,0.7460317460317459
556,978,또한/Noun,315,208,107,0.002334111370456819,0.0012105999689020189,0.6603174603174603
557,979,과거/Noun,315,196,119,0.0022007335778592863,0.0013438770296985718,0.6222222222222222
558,982,그래픽/Noun,314,78,236,0.00088918528398355,0.0026433283724649594,0.7515923566878981
559,983,ost/Alpha,313,265,48,0.0029676558852950985,0.0005553210866523023,0.8466453674121406
560,984,그냥/Modifier,313,87,226,0.0009892186284316995,0.0025322641551344988,0.7220447284345048
561,985,이라니/Josa,313,116,197,0.0013115482938757365,0.0022101779248761637,0.6293929712460063
562,987,그만/Adverb,312,21,291,0.00025564076914527065,0.003254181567782492,0.9326923076923076
563,988,장/Suffix,312,89,223,0.0010114482605312882,0.002498944889935361,0.7147435897435898
564,989,20/Number,312,211,101,0.002367455818606202,0.0011439614385037428,0.6762820512820513
565,990,바보/Noun,311,85,226,0.0009669889963321108,0.0025322641551344988,0.7266881028938906
566,991,성우/Noun,310,70,240,0.0008002667555851951,0.002687754059397144,0.7741935483870968
567,992,봣/Noun,308,207,101,0.0023229965544070245,0.0011439614385037428,0.6720779220779219
568,993,소중하다/Adjective,307,226,81,0.0025341780593531177,0.000921833003842822,0.7361563517915309
569,994,죽음/Noun,307,206,101,0.0023118817383572304,0.0011439614385037428,0.6710097719869706
570,995,대한민국/Noun,307,185,122,0.002078470601311548,0.0013771962948977098,0.6026058631921825
571,997,유치/Noun,306,21,285,0.00025564076914527065,0.003187543037384216,0.931372549019608
572,999,도저히/Noun,305,26,279,0.00031121484939424253,0.003120904506985939,0.9147540983606556
573,1000,한심하다/Adjective,305,33,272,0.00038901856174280313,0.0030431595548546173,0.8918032786885246
574,1001,식/Noun,305,72,233,0.0008224963876847838,0.002610009107265821,0.7639344262295082
575,1002,속편/Noun,305,99,206,0.001122596421029232,0.002310135720473578,0.6754098360655738
576,1006,역겹다/Adjective,304,37,267,0.0004334778259419807,0.002987627446189387,0.8782894736842105
577,1007,울/Noun,304,228,76,0.002556407691452707,0.0008663008951775916,0.75
578,1008,무조건/Noun,304,193,111,0.0021673891297099034,0.0012550256558342032,0.6348684210526315
579,1009,닿다/Verb,303,192,111,0.002156274313660109,0.0012550256558342032,0.6336633663366337
580,1010,전달/Noun,303,115,188,0.001300433477825942,0.0021102201292787486,0.6204620462046204
581,1011,땐/Noun,303,183,120,0.0020562409692119594,0.0013549834514316175,0.6039603960396039
582,1016,천재/Noun,301,236,65,0.002645326219851061,0.0007441302561140852,0.7840531561461794
583,1018,억지로/Noun,300,42,258,0.0004890519061909527,0.0028876696505919725,0.86
584,1019,우연히/Adverb,300,258,42,0.0028898521729465373,0.0004886825562540262,0.86
585,1020,심리/Noun,300,207,93,0.0023229965544070245,0.0010551100646393743,0.69
586,1021,화가/Noun,299,75,224,0.0008558408358341669,0.0025100513116684065,0.7491638795986622
587,1022,강하다/Adjective,299,187,112,0.0021007002334111373,0.0012661320775672494,0.6254180602006689
588,1023,댓글/Noun,297,75,222,0.0008558408358341669,0.0024878384682023146,0.7474747474747475
589,1026,속/Modifier,296,73,223,0.0008336112037345782,0.002498944889935361,0.7533783783783784
590,1027,아무/Noun,296,116,180,0.0013115482938757365,0.0020213687554143807,0.6081081081081081
591,1029,개다/Verb,295,73,222,0.0008336112037345782,0.0024878384682023146,0.7525423728813561
592,1030,새끼/Noun,295,80,215,0.0009114149160831386,0.0024100935160709922,0.7288135593220338
593,1031,척/Noun,294,58,236,0.0006668889629876625,0.0026433283724649594,0.8027210884353742
594,1032,예고편/Noun,294,69,225,0.0007891519395354007,0.0025211577334014533,0.7653061224489796
595,1033,다가/Noun,293,91,202,0.001033677892630877,0.0022657100335413943,0.6894197952218429
596,1034,최근/Noun,293,195,98,0.002189618761809492,0.0011106421733046046,0.6655290102389079
597,1038,현/Modifier,292,181,111,0.00203401133711237,0.0012550256558342032,0.6198630136986302
598,1039,good/Alpha,291,213,78,0.002389685450705791,0.0008885137386436838,0.7319587628865979
599,1040,어느/Modifier,291,104,187,0.001178170501278204,0.002099113707545703,0.6426116838487973
600,1042,잊혀지다/Verb,289,255,34,0.002856507724797155,0.00039983118238965764,0.8823529411764706
601,1043,불륜/Noun,289,75,214,0.0008558408358341669,0.0023989870943379463,0.740484429065744
602,1044,젠/Noun,289,80,209,0.0009114149160831386,0.002343454985672716,0.7231833910034602
603,1046,대작/Noun,288,231,57,0.0025897521396020893,0.0006552788822497168,0.8020833333333334
604,1047,짐/Noun,288,189,99,0.002122929865510726,0.0011217485950376508,0.65625
605,1048,다니다/Verb,288,105,183,0.0011892853173279985,0.0020546880206135185,0.6354166666666666
606,1053,미안하다/Adjective,287,74,213,0.0008447260197843727,0.0023878806726049,0.7421602787456446
607,1056,열/Noun,286,78,208,0.00088918528398355,0.00233234856393967,0.7272727272727273
608,1059,2시간/Number,285,95,190,0.0010781371568300542,0.002132432972744841,0.6666666666666666
609,1064,게임/Noun,284,97,187,0.0011003667889296432,0.002099113707545703,0.6584507042253521
610,1065,행동/Noun,284,103,181,0.0011670556852284096,0.0020324751771474267,0.6373239436619719
611,1068,실망하다/Adjective,283,60,223,0.0006891185950872514,0.002498944889935361,0.7879858657243817
612,1069,짓/Noun,283,70,213,0.0008002667555851951,0.0023878806726049,0.7526501766784452
613,1070,환상/Noun,283,207,76,0.0023229965544070245,0.0008663008951775916,0.7314487632508834
614,1071,여/Noun,283,178,105,0.0020006668889629878,0.001188387125435927,0.6289752650176679
615,1073,오래/Adverb,282,230,52,0.0025786373235522947,0.0005997467735844866,0.8156028368794326
616,1077,그닥/Noun,280,25,255,0.00030010003334444816,0.0028543503853928343,0.9107142857142856
617,1078,귀신/Noun,280,71,209,0.0008113815716349895,0.002343454985672716,0.7464285714285714
618,1079,전설/Noun,280,175,105,0.001967322440813605,0.001188387125435927,0.625
619,1082,산/Noun,279,67,212,0.0007669223074358119,0.002376774250871854,0.7598566308243727
620,1083,총/Modifier,279,87,192,0.0009892186284316995,0.0021546458162109328,0.6881720430107527
621,1084,회/Noun,279,177,102,0.001989552072913193,0.001155067860236789,0.6344086021505376
622,1085,빠져들다/Verb,278,264,14,0.002956541069245304,0.00017770274772873674,0.9496402877697842
623,1086,흘리다/Verb,278,211,67,0.002367455818606202,0.0007663430995801773,0.7589928057553957
624,1087,전작/Noun,277,72,205,0.0008224963876847838,0.002299029298740532,0.740072202166065
625,1088,총/Noun,277,85,192,0.0009669889963321108,0.0021546458162109328,0.6931407942238267
626,1090,♡/Foreign,276,264,12,0.002956541069245304,0.00015548990426264466,0.9565217391304348
627,1091,돌아가다/Verb,276,167,109,0.0018784039124152493,0.0012328128123681114,0.605072463768116
628,1092,현재/Noun,275,205,70,0.002300766922307436,0.0007996623647793153,0.7454545454545455
629,1096,쩔다/Verb,274,216,58,0.002423029898855174,0.0006663853039827628,0.7883211678832117
630,1097,여전하다/Adjective,274,191,83,0.0021451594976103147,0.000944045847308914,0.6970802919708029
631,1098,울/Modifier,274,178,96,0.0020006668889629878,0.0010884293298385123,0.6496350364963503
632,1099,제작비/Noun,273,38,235,0.000444592641991775,0.002632221950731913,0.8608058608058609
633,1100,영원하다/Adjective,273,231,42,0.0025897521396020893,0.0004886825562540262,0.8461538461538461
634,1101,예요/Josa,273,206,67,0.0023118817383572304,0.0007663430995801773,0.7545787545787546
635,1102,스러운/Josa,273,89,184,0.0010114482605312882,0.002065794442346565,0.6739926739926739
636,1103,다행/Noun,273,104,169,0.001178170501278204,0.0018991981163508738,0.6190476190476191
637,1104,흠/Noun,272,105,167,0.0011892853173279985,0.0018769852728847821,0.6139705882352942
638,1106,통해/Noun,271,217,54,0.0024341447149049678,0.0006219596170505788,0.8007380073800738
639,1107,잘생기다/Adjective,271,198,73,0.002222963209958875,0.0008329816299784535,0.7306273062730627
640,1108,노/Noun,271,96,175,0.0010892519728798488,0.00196583664674915,0.6457564575645757
641,1114,망작/Noun,268,16,252,0.0002000666888962988,0.002821031120193696,0.9402985074626866
642,1118,가끔/Noun,267,174,93,0.0019562076247638107,0.0010551100646393743,0.651685393258427
643,1119,만의/Josa,267,167,100,0.0018784039124152493,0.0011328550167706971,0.6254681647940075
644,1120,드럽다/Adjective,266,24,242,0.0002889852172946538,0.0027099669028632354,0.9097744360902256
645,1121,동화/Noun,266,189,77,0.002122929865510726,0.0008774073169106378,0.7105263157894737
646,1122,80년/Number,266,82,184,0.0009336445481827276,0.002065794442346565,0.6917293233082706
647,1123,:/Punctuation,266,106,160,0.0012004001333777929,0.0017992403207534593,0.6015037593984962
648,1127,100/Number,265,171,94,0.001922863176614427,0.0010662164863724202,0.6452830188679245
649,1128,묘사/Noun,265,170,95,0.0019117483605646328,0.0010773229081054666,0.6415094339622641
650,1130,예산/Noun,264,65,199,0.0007446926753362233,0.002232390768342256,0.7537878787878788
651,1131,으/Adverb,263,97,166,0.0011003667889296432,0.001865878851151736,0.6311787072243346
652,1132,여러/Modifier,263,165,98,0.001856174280315661,0.0011106421733046046,0.6273764258555133
653,1136,채널/Noun,262,82,180,0.0009336445481827276,0.0020213687554143807,0.6870229007633588
654,1137,살인/Noun,262,97,165,0.0011003667889296432,0.0018547724294186894,0.6297709923664122
655,1138,멍청하다/Adjective,260,38,222,0.000444592641991775,0.0024878384682023146,0.8538461538461538
656,1139,강/Noun,260,197,63,0.002211848393909081,0.0007219174126479931,0.7576923076923077
657,1147,졸라/Noun,258,75,183,0.0008558408358341669,0.0020546880206135185,0.7093023255813954
658,1148,프로그램/Noun,258,102,156,0.0011559408691786152,0.0017548146338212756,0.6046511627906976
659,1150,개/Suffix,257,79,178,0.0009003001000333445,0.001999155911948289,0.6926070038910506
660,1157,외/Noun,256,70,186,0.0008002667555851951,0.0020880072858126568,0.7265625
661,1158,서로/Noun,256,161,95,0.0018117150161164836,0.0010773229081054666,0.62890625
662,1161,낚/Noun,254,20,234,0.00024452595309547634,0.002621115528998867,0.9212598425196852
663,1162,경찰/Noun,254,98,156,0.0011114816049794377,0.0017548146338212756,0.6141732283464567
664,1164,모/Noun,253,66,187,0.0007558074913860174,0.002099113707545703,0.7391304347826086
665,1167,끌다/Verb,252,68,184,0.0007780371234856063,0.002065794442346565,0.7301587301587301
666,1168,런가/Noun,252,97,155,0.0011003667889296432,0.0017437082120882294,0.6150793650793651
667,1169,반개/Noun,251,5,246,7.780371234856063e-05,0.00275439258979542,0.9800796812749004
668,1170,짱/VerbPrefix,251,225,26,0.0025230632433033235,0.00031097980852528933,0.896414342629482
669,1171,지루/Noun,250,21,229,0.00025564076914527065,0.002565583420333637,0.9159999999999999
670,1173,황당하다/Adjective,249,38,211,0.000444592641991775,0.0023656678291388076,0.8473895582329317
671,1176,약하다/Adjective,248,71,177,0.0008113815716349895,0.0019880494902152425,0.7137096774193549
672,1177,흔하다/Adjective,248,92,156,0.0010447927086806713,0.0017548146338212756,0.6290322580645161
673,1181,졸리다/Verb,247,27,220,0.00032232966544403684,0.0024656256247362228,0.8906882591093117
674,1182,용도/Noun,247,57,190,0.0006557741469378681,0.002132432972744841,0.7692307692307693
675,1183,희망/Noun,246,210,36,0.002356341002556408,0.0004220440258557498,0.8536585365853658
676,1186,위대하다/Adjective,245,185,60,0.002078470601311548,0.0006885981474488549,0.7551020408163265
677,1187,청춘/Noun,245,172,73,0.0019339779926642211,0.0008329816299784535,0.7020408163265306
678,1188,......./Punctuation,245,81,164,0.0009225297321329332,0.001843666007685644,0.6693877551020408
679,1189,다만/Noun,245,160,85,0.001800600200066689,0.0009662586907750061,0.6530612244897959
680,1190,상상력/Noun,245,158,87,0.0017783705679671,0.0009884715342410985,0.6448979591836734
681,1191,너무나도/Adverb,245,151,94,0.0017005668556185395,0.0010662164863724202,0.6163265306122448
682,1193,깊이/Noun,244,172,72,0.0019339779926642211,0.0008218752082454075,0.7049180327868853
683,1199,cg/Alpha,243,62,181,0.0007113482271868402,0.0020324751771474267,0.7448559670781894
684,1202,기세/Noun,242,7,235,0.0001000333444481494,0.002632221950731913,0.9710743801652892
685,1208,형님/Noun,241,155,86,0.001745026119817717,0.000977365112508052,0.6431535269709544
686,1209,깔다/Verb,241,91,150,0.001033677892630877,0.0016881761034229991,0.6224066390041494
687,1213,노출/Noun,240,57,183,0.0006557741469378681,0.0020546880206135185,0.7625
688,1214,다시다/Verb,240,72,168,0.0008224963876847838,0.001888091694617828,0.7
689,1215,카메라/Noun,240,73,167,0.0008336112037345782,0.0018769852728847821,0.6958333333333333
690,1216,살아가다/Verb,239,217,22,0.0024341447149049678,0.00026655412159310506,0.9079497907949792
691,1217,미래/Noun,239,164,75,0.0018450594642658664,0.0008551944734445456,0.6861924686192469
692,1220,쏘다/Verb,238,76,162,0.0008669556518839612,0.001821453164219552,0.6806722689075629
693,1221,체/Noun,238,92,146,0.0010447927086806713,0.001643750416490815,0.6134453781512605
694,1224,대안/Noun,237,199,38,0.0022340780260086696,0.0004442568693218419,0.8396624472573839
695,1226,산만하다/Adjective,236,19,217,0.0002334111370456819,0.0024323063595370845,0.9194915254237288
696,1227,능력/Noun,236,81,155,0.0009225297321329332,0.0017437082120882294,0.6567796610169492
697,1228,미소/Noun,235,212,23,0.002378570634655997,0.00027766054332615115,0.9021276595744679
698,1229,결론/Noun,235,63,172,0.0007224630432366343,0.0019325173815500122,0.7319148936170212
699,1230,반/Noun,235,83,152,0.0009447593642325221,0.0017103889468890912,0.6468085106382979
700,1231,치/Noun,235,90,145,0.0010225630765810826,0.001632643994757769,0.6170212765957447
701,1233,설레다/Adjective,234,212,22,0.002378570634655997,0.00026655412159310506,0.9059829059829059
702,1234,독립영화/Noun,234,75,159,0.0008558408358341669,0.0017881338990204136,0.6794871794871795
703,1236,OST/Alpha,233,191,42,0.0021451594976103147,0.0004886825562540262,0.8197424892703863
704,1237,잘못/Noun,233,83,150,0.0009447593642325221,0.0016881761034229991,0.6437768240343348
705,1242,지나치다/Verb,230,55,175,0.0006335445148382794,0.00196583664674915,0.7608695652173914
706,1243,리얼/Noun,230,156,74,0.0017561409358675113,0.0008440880517114996,0.6782608695652174
707,1244,평생/Noun,230,147,83,0.0016561075914193618,0.000944045847308914,0.6391304347826087
708,1247,젊다/Adjective,229,158,71,0.0017783705679671,0.0008107687865123613,0.6899563318777293
709,1249,왠만하다/Adjective,228,20,208,0.00024452595309547634,0.00233234856393967,0.912280701754386
710,1250,멋/Noun,228,174,54,0.0019562076247638107,0.0006219596170505788,0.7631578947368421
711,1251,범인/Noun,228,62,166,0.0007113482271868402,0.001865878851151736,0.7280701754385965
712,1252,되게/Adverb,227,149,78,0.0016783372235189508,0.0008885137386436838,0.6563876651982379
713,1253,어린이/Noun,227,87,140,0.0009892186284316995,0.0015771118860925387,0.6167400881057269
714,1256,박수/Noun,226,151,75,0.0017005668556185395,0.0008551944734445456,0.668141592920354
715,1260,손발/Noun,225,22,203,0.000266755585195065,0.0022768164552744398,0.9022222222222224
716,1261,고생/Noun,225,87,138,0.0009892186284316995,0.0015548990426264464,0.6133333333333333
717,1262,고맙다/Adjective,224,180,44,0.0020228965210625765,0.0005108953997201182,0.8035714285714286
718,1264,졸다/Verb,223,13,210,0.00016672224074691566,0.002354561407405762,0.9417040358744396
719,1265,굳이/Noun,223,45,178,0.0005223963543403357,0.001999155911948289,0.7982062780269058
720,1266,로맨틱/Noun,223,141,82,0.0015894186951205956,0.000932939425575868,0.6322869955156951
721,1271,거지같다/Adjective,222,19,203,0.0002334111370456819,0.0022768164552744398,0.9144144144144144
722,1272,떠오르다/Verb,222,164,58,0.0018450594642658664,0.0006663853039827628,0.7387387387387387
723,1273,밤/Noun,222,158,64,0.0017783705679671,0.0007330238343810393,0.7117117117117117
724,1274,심심하다/Adjective,221,88,133,0.0010003334444814939,0.0014993669339612163,0.6018099547511312
725,1277,별루/Noun,220,12,208,0.00015560742469712126,0.00233234856393967,0.9454545454545454
726,1278,슬픔/Noun,220,192,28,0.002156274313660109,0.0003331926519913814,0.8727272727272727
727,1279,용이/Noun,220,69,151,0.0007891519395354007,0.0016992825251560453,0.6863636363636364
728,1280,차/Noun,220,84,136,0.0009558741802823164,0.0015326861991603546,0.6181818181818182
729,1284,포장/Noun,219,20,199,0.00024452595309547634,0.002232390768342256,0.9086757990867579
730,1285,주기/Noun,219,40,179,0.0004668222740913638,0.0020102623336813344,0.817351598173516
731,1286,시도/Noun,219,57,162,0.0006557741469378681,0.001821453164219552,0.7397260273972602
732,1287,ㅅㅂ/KoreanParticle,218,20,198,0.00024452595309547634,0.002221284346609209,0.908256880733945
733,1288,아침/Noun,218,56,162,0.0006446593308880737,0.001821453164219552,0.7431192660550459
734,1292,늙다/Verb,217,85,132,0.0009669889963321108,0.0014882605122281704,0.6082949308755761
735,1297,광고/Noun,216,47,169,0.0005446259864399244,0.0018991981163508738,0.7824074074074074
736,1300,짱/Modifier,215,181,34,0.00203401133711237,0.00039983118238965764,0.8418604651162791
737,1301,진실/Noun,215,142,73,0.0016005335111703902,0.0008329816299784535,0.6604651162790698
738,1305,암/Noun,214,59,155,0.0006780037790374569,0.0017437082120882294,0.7242990654205608
739,1306,흐름/Noun,214,83,131,0.0009447593642325221,0.0014771540904951245,0.6121495327102804
740,1309,눈물나다/Verb,213,183,30,0.0020562409692119594,0.0003554054954574735,0.8591549295774648
741,1312,성도/Noun,212,25,187,0.00030010003334444816,0.002099113707545703,0.8820754716981132
742,1313,한계/Noun,212,38,174,0.000444592641991775,0.0019547302250161047,0.8207547169811321
743,1314,그럭저럭/Adverb,212,52,160,0.0006002000666888963,0.0017992403207534593,0.7547169811320755
744,1315,전/Foreign,212,157,55,0.0017672557519173055,0.0006330660387836247,0.7405660377358491
745,1316,조차/Josa,212,56,156,0.0006446593308880737,0.0017548146338212756,0.7358490566037735
746,1317,챙기다/Verb,212,145,67,0.0016338779593197733,0.0007663430995801773,0.6839622641509434
747,1318,심/Noun,212,73,139,0.0008336112037345782,0.0015660054643594926,0.6556603773584906
748,1319,빠르다/Adjective,212,128,84,0.0014449260864732687,0.00095515226904196,0.6037735849056604
749,1323,~^^/Punctuation,211,202,9,0.0022674224741580525,0.00012217063906350652,0.957345971563981
750,1324,진정/Noun,211,146,65,0.0016449927753695677,0.0007441302561140852,0.6919431279620853
751,1325,..?/Punctuation,211,82,129,0.0009336445481827276,0.0014549412470290322,0.6113744075829384
752,1326,웬만하다/Adjective,211,83,128,0.0009447593642325221,0.0014438348252959862,0.6066350710900474
753,1329,깔끔하다/Adjective,210,167,43,0.0018784039124152493,0.0004997889779870722,0.7952380952380952
754,1330,살짝/Noun,210,140,70,0.0015783038790708015,0.0007996623647793153,0.6666666666666666
755,1333,발견/Noun,209,175,34,0.001967322440813605,0.00039983118238965764,0.8373205741626795
756,1334,리뷰/Noun,209,80,129,0.0009114149160831386,0.0014549412470290322,0.6172248803827751
757,1335,일어나다/Verb,209,129,80,0.0014560409025230633,0.000910726582109776,0.6172248803827751
758,1339,개도/Noun,208,25,183,0.00030010003334444816,0.0020546880206135185,0.8798076923076923
759,1340,쩐다/Noun,208,145,63,0.0016338779593197733,0.0007219174126479931,0.6971153846153846
760,1341,범죄/Noun,208,72,136,0.0008224963876847838,0.0015326861991603546,0.6538461538461539
761,1344,짱짱/Noun,207,199,8,0.0022340780260086696,0.00011106421733046048,0.961352657004831
762,1345,부족/Noun,207,29,178,0.0003445592975436257,0.001999155911948289,0.8599033816425121
763,1346,지난/Noun,207,159,48,0.0017894853840168946,0.0005553210866523023,0.7681159420289855
764,1347,20년/Number,207,142,65,0.0016005335111703902,0.0007441302561140852,0.6859903381642513
765,1348,야/Exclamation,207,66,141,0.0007558074913860174,0.0015882183078255846,0.6811594202898551
766,1349,오락/Noun,207,125,82,0.0014115816383238858,0.000932939425575868,0.6038647342995169
767,1352,대충/Noun,206,37,169,0.0004334778259419807,0.0018991981163508738,0.8203883495145631
768,1353,영환/Noun,206,64,142,0.0007335778592864287,0.0015993247295586306,0.6893203883495146
769,1360,감탄/Noun,205,177,28,0.001989552072913193,0.0003331926519913814,0.8634146341463415
770,1361,빨/Noun,205,54,151,0.0006224296987884852,0.0016992825251560453,0.7365853658536585
771,1362,자연/Noun,205,142,63,0.0016005335111703902,0.0007219174126479931,0.6926829268292682
772,1363,커플/Noun,205,141,64,0.0015894186951205956,0.0007330238343810393,0.6878048780487804
773,1364,시선/Noun,205,141,64,0.0015894186951205956,0.0007330238343810393,0.6878048780487804
774,1365,정서/Noun,205,76,129,0.0008669556518839612,0.0014549412470290322,0.6292682926829268
775,1366,정말로/Adverb,205,125,80,0.0014115816383238858,0.000910726582109776,0.6097560975609756
776,1367,시청자/Noun,204,41,163,0.0004779370901411582,0.0018325595859525977,0.7990196078431373
777,1368,홍보/Noun,204,43,161,0.0005001667222407468,0.0018103467424865054,0.7892156862745098
778,1369,담기다/Verb,204,160,44,0.001800600200066689,0.0005108953997201182,0.7843137254901961
779,1370,몸매/Noun,204,67,137,0.0007669223074358119,0.0015437926208934005,0.6715686274509803
780,1371,우울하다/Adjective,204,123,81,0.001389352006224297,0.000921833003842822,0.6029411764705882
781,1375,아오/Exclamation,203,29,174,0.0003445592975436257,0.0019547302250161047,0.8571428571428571
782,1378,울리다/Verb,202,175,27,0.001967322440813605,0.00032208623025833537,0.8663366336633663
783,1379,지르다/Verb,202,42,160,0.0004890519061909527,0.0017992403207534593,0.7920792079207921
784,1380,소름끼치다/Verb,202,155,47,0.001745026119817717,0.0005442146649192564,0.7673267326732673
785,1383,일상/Noun,201,154,47,0.0017339113037679224,0.0005442146649192564,0.7661691542288557
786,1384,포기/Noun,201,56,145,0.0006446593308880737,0.001632643994757769,0.7213930348258707
787,1385,코드/Noun,201,76,125,0.0008669556518839612,0.001410515560096848,0.6218905472636815
788,1386,첨/Noun,201,77,124,0.0008780704679337558,0.0013994091383638019,0.6169154228855721
789,1388,접다/Verb,199,22,177,0.000266755585195065,0.0019880494902152425,0.8894472361809045
790,1389,30분/Number,199,51,148,0.000589085250639102,0.001665963259956907,0.7437185929648241
791,1390,에서의/Josa,199,143,56,0.0016116483272201846,0.0006441724605166707,0.7185929648241206
792,1393,이따위/Modifier,198,8,190,0.00011114816049794375,0.002132432972744841,0.9595959595959596
793,1394,눈빛/Noun,198,175,23,0.001967322440813605,0.00027766054332615115,0.8838383838383839
794,1395,10분/Number,198,36,162,0.00042236300989218633,0.001821453164219552,0.8181818181818182
795,1396,보라/Noun,198,64,134,0.0007335778592864287,0.0015104733556942625,0.6767676767676768
796,1397,끼리/Noun,198,71,127,0.0008113815716349895,0.00143272840356294,0.6414141414141414
797,1398,사극/Noun,198,123,75,0.001389352006224297,0.0008551944734445456,0.6212121212121212
798,1401,말로/Noun,197,140,57,0.0015783038790708015,0.0006552788822497168,0.7106598984771574
799,1404,뜬금/Noun,196,17,179,0.00021118150494609317,0.0020102623336813344,0.9132653061224488
800,1405,핵/Noun,196,37,159,0.0004334778259419807,0.0017881338990204136,0.8112244897959183
801,1406,상처/Noun,196,143,53,0.0016116483272201846,0.0006108531953175326,0.7295918367346939
802,1407,실감/Noun,196,128,68,0.0014449260864732687,0.0007774495213132232,0.6530612244897959
803,1414,끌/Noun,195,22,173,0.000266755585195065,0.0019436238032830586,0.8871794871794871
804,1415,힐링/Noun,195,171,24,0.001922863176614427,0.0002887669650591972,0.8769230769230769
805,1416,혹시/Noun,195,48,147,0.0005557408024897189,0.0016548568382238609,0.7538461538461538
806,1417,막판/Noun,195,58,137,0.0006668889629876625,0.0015437926208934005,0.7025641025641025
807,1418,빛/Noun,195,127,68,0.0014338112704234743,0.0007774495213132232,0.6512820512820513
808,1421,무겁다/Adjective,194,158,36,0.0017783705679671,0.0004220440258557498,0.8144329896907216
809,1422,우정/Noun,194,143,51,0.0016116483272201846,0.0005886403518514405,0.7371134020618557
810,1423,해피엔딩/Noun,194,138,56,0.0015560742469712125,0.0006441724605166707,0.711340206185567
811,1424,죄/Noun,194,67,127,0.0007669223074358119,0.00143272840356294,0.6546391752577321
812,1430,참다/Verb,193,36,157,0.00042236300989218633,0.0017659210555543215,0.8134715025906736
813,1437,몰다/Verb,192,64,128,0.0007335778592864287,0.0014438348252959862,0.6666666666666666
814,1439,아련하다/Adjective,191,184,7,0.002067355785261754,9.995779559741441e-05,0.9633507853403142
815,1440,보아/Noun,191,134,57,0.0015116149827720349,0.0006552788822497168,0.7015706806282722
816,1441,게다가/Noun,191,58,133,0.0006668889629876625,0.0014993669339612163,0.6963350785340314
817,1442,만큼/Noun,191,115,76,0.001300433477825942,0.0008663008951775916,0.6020942408376964
818,1444,개판/Noun,190,8,182,0.00011114816049794375,0.0020435815988804726,0.9578947368421052
819,1445,뭐임/Noun,190,15,175,0.00018895187284650438,0.00196583664674915,0.9210526315789472
820,1446,나머지/Noun,190,38,152,0.000444592641991775,0.0017103889468890912,0.8
821,1447,벌써/Noun,190,146,44,0.0016449927753695677,0.0005108953997201182,0.7684210526315789
822,1448,조폭/Noun,190,58,132,0.0006668889629876625,0.0014882605122281704,0.6947368421052632
823,1449,간/Noun,190,72,118,0.0008224963876847838,0.0013327706079655256,0.6210526315789474
824,1450,이기/Noun,190,114,76,0.0012893186617761474,0.0008663008951775916,0.6
825,1453,소장/Noun,189,173,16,0.001945092808714016,0.00019991559119482882,0.9153439153439152
826,1454,비극/Noun,189,143,46,0.0016116483272201846,0.0005331082431862101,0.7566137566137566
827,1455,까지는/Josa,189,51,138,0.000589085250639102,0.0015548990426264464,0.7301587301587301
828,1456,주/Noun,189,73,116,0.0008336112037345782,0.0013105577644994335,0.6137566137566137
829,1460,벗다/Verb,188,41,147,0.0004779370901411582,0.0016548568382238609,0.7819148936170213
830,1461,난해하다/Adjective,188,45,143,0.0005223963543403357,0.001610431151291677,0.7606382978723404
831,1462,섹스/Noun,188,51,137,0.000589085250639102,0.0015437926208934005,0.7287234042553191
832,1463,부끄럽다/Adjective,188,65,123,0.0007446926753362233,0.0013883027166307562,0.6542553191489362
833,1464,등장인물/Noun,188,69,119,0.0007891519395354007,0.0013438770296985718,0.6329787234042553
834,1467,형편/Noun,187,18,169,0.0002222963209958875,0.0018991981163508738,0.9037433155080212
835,1468,본방/Noun,187,166,21,0.0018672890963654552,0.0002554476998600591,0.8877005347593583
836,1469,감명/Noun,187,164,23,0.0018450594642658664,0.00027766054332615115,0.8770053475935828
837,1470,뮤지컬/Noun,187,117,70,0.0013226631099255307,0.0007996623647793153,0.6256684491978609
838,1473,펑펑/Noun,186,179,7,0.002011781705012782,9.995779559741441e-05,0.9623655913978496
839,1474,끝내다/Verb,186,63,123,0.0007224630432366343,0.0013883027166307562,0.6612903225806451
840,1475,의문/Noun,186,67,119,0.0007669223074358119,0.0013438770296985718,0.6397849462365591
841,1476,이연걸/Noun,186,117,69,0.0013226631099255307,0.0007885559430462694,0.6290322580645161
842,1482,그다지/Noun,185,18,167,0.0002222963209958875,0.0018769852728847821,0.9027027027027028
843,1483,토/Noun,185,44,141,0.0005112815382905413,0.0015882183078255846,0.7621621621621621
844,1484,떼다/Verb,185,140,45,0.0015783038790708015,0.0005220018214531642,0.7567567567567568
845,1485,인가요/Josa,185,57,128,0.0006557741469378681,0.0014438348252959862,0.6918918918918919
846,1486,결과/Noun,185,64,121,0.0007335778592864287,0.001366089873164664,0.6540540540540539
847,1487,불가/Noun,184,41,143,0.0004779370901411582,0.001610431151291677,0.7771739130434783
848,1488,자유/Noun,184,128,56,0.0014449260864732687,0.0006441724605166707,0.6956521739130435
849,1489,암튼/Adverb,184,123,61,0.001389352006224297,0.0006997045691819009,0.6684782608695652
850,1490,새벽/Noun,184,122,62,0.0013782371901745027,0.000710810990914947,0.6630434782608695
851,1491,꼴/Noun,183,23,160,0.00027787040124485944,0.0017992403207534593,0.8743169398907104
852,1492,표절/Noun,183,24,159,0.0002889852172946538,0.0017881338990204136,0.8688524590163934
853,1493,행복/Noun,183,153,30,0.0017227964877181282,0.0003554054954574735,0.8360655737704918
854,1494,딱하다/Adjective,183,31,152,0.00036678892964321435,0.0017103889468890912,0.8306010928961749
855,1495,지도/Noun,183,60,123,0.0006891185950872514,0.0013883027166307562,0.6721311475409836
856,1496,느와르/Noun,183,123,60,0.001389352006224297,0.0006885981474488549,0.6721311475409836
857,1498,글쎄/Noun,182,21,161,0.00025564076914527065,0.0018103467424865054,0.8846153846153846
858,1499,색다르다/Adjective,182,141,41,0.0015894186951205956,0.00047757613452098,0.7747252747252747
859,1500,기본/Noun,182,50,132,0.0005779704345893076,0.0014882605122281704,0.7252747252747253
860,1501,오버/Noun,182,51,131,0.000589085250639102,0.0014771540904951245,0.7197802197802198
861,1502,차이/Noun,182,68,114,0.0007780371234856063,0.0012883449210333415,0.6263736263736264
862,1506,에만/Josa,181,44,137,0.0005112815382905413,0.0015437926208934005,0.7569060773480663
863,1507,에게는/Josa,181,120,61,0.0013560075580749138,0.0006997045691819009,0.6629834254143646
864,1508,따위/Noun,181,63,118,0.0007224630432366343,0.0013327706079655256,0.6519337016574586
865,1509,가면/Noun,181,65,116,0.0007446926753362233,0.0013105577644994335,0.6408839779005525
866,1514,쓰래/Noun,180,10,170,0.0001333777925975325,0.00191030453808392,0.9444444444444444
867,1515,불쾌하다/Adjective,180,23,157,0.00027787040124485944,0.0017659210555543215,0.8722222222222222
868,1516,느리다/Adjective,180,42,138,0.0004890519061909527,0.0015548990426264464,0.7666666666666667
869,1517,까진/Josa,180,62,118,0.0007113482271868402,0.0013327706079655256,0.6555555555555556
870,1518,악당/Noun,180,65,115,0.0007446926753362233,0.0012994513427663874,0.6388888888888888
871,1521,싸다/Verb,179,41,138,0.0004779370901411582,0.0015548990426264464,0.770949720670391
872,1522,촌스럽다/Adjective,179,50,129,0.0005779704345893076,0.0014549412470290322,0.7206703910614525
873,1523,모/Modifier,179,67,112,0.0007669223074358119,0.0012661320775672494,0.6256983240223464
874,1531,그렇다고/Conjunction,178,34,144,0.0004001333777925976,0.0016215375730247227,0.8089887640449438
875,1532,그걸/Adverb,178,70,108,0.0008002667555851951,0.0012217063906350652,0.6067415730337079
876,1536,이제야/Noun,177,157,20,0.0017672557519173055,0.00024434127812701304,0.8870056497175142
877,1537,적절하다/Adjective,177,137,40,0.0015449594309214182,0.000466469712787934,0.7740112994350282
878,1538,깨닫다/Verb,177,133,44,0.001500500166722241,0.0005108953997201182,0.7514124293785308
879,1539,반복/Noun,177,68,109,0.0007780371234856063,0.0012328128123681114,0.615819209039548
880,1540,공/Modifier,177,70,107,0.0008002667555851951,0.0012105999689020189,0.6045197740112994
881,1543,오그라들다/Verb,176,19,157,0.0002334111370456819,0.0017659210555543215,0.8920454545454546
882,1544,긴장/Noun,176,134,42,0.0015116149827720349,0.0004886825562540262,0.7613636363636364
883,1545,게이/Noun,176,47,129,0.0005446259864399244,0.0014549412470290322,0.7329545454545454
884,1546,어쩔/Adverb,176,57,119,0.0006557741469378681,0.0013438770296985718,0.6761363636363636
885,1547,외국/Noun,176,57,119,0.0006557741469378681,0.0013438770296985718,0.6761363636363636
886,1550,언제나/Adverb,175,128,47,0.0014449260864732687,0.0005442146649192564,0.7314285714285714
887,1551,북한/Noun,175,65,110,0.0007446926753362233,0.0012439192341011573,0.6285714285714286
888,1554,열정/Noun,174,148,26,0.0016672224074691564,0.00031097980852528933,0.8505747126436781
889,1555,소소하다/Adjective,174,143,31,0.0016116483272201846,0.00036651191719051963,0.8218390804597702
890,1556,빛나다/Verb,174,131,43,0.001478270534622652,0.0004997889779870722,0.7528735632183908
891,1557,이루다/Verb,174,126,48,0.0014226964543736804,0.0005553210866523023,0.7241379310344828
892,1559,아픔/Noun,173,146,27,0.0016449927753695677,0.00032208623025833537,0.8439306358381503
893,1560,창/Noun,173,31,142,0.00036678892964321435,0.0015993247295586306,0.8208092485549133
894,1561,선생님/Noun,173,129,44,0.0014560409025230633,0.0005108953997201182,0.7456647398843931
895,1562,병/Noun,173,51,122,0.000589085250639102,0.0013771962948977098,0.7052023121387283
896,1563,쇼/Noun,173,55,118,0.0006335445148382794,0.0013327706079655256,0.6820809248554913
897,1565,강렬하다/Adjective,172,147,25,0.0016561075914193618,0.0002998733867922433,0.8546511627906976
898,1566,화나다/Verb,172,30,142,0.00035567411359342004,0.0015993247295586306,0.8255813953488372
899,1567,짝/Noun,172,34,138,0.0004001333777925976,0.0015548990426264464,0.8023255813953488
900,1568,양/Modifier,172,52,120,0.0006002000666888963,0.0013549834514316175,0.6976744186046512
901,1569,디즈니/Noun,172,114,58,0.0012893186617761474,0.0006663853039827628,0.6627906976744186
902,1574,질리/Noun,171,160,11,0.001800600200066689,0.0001443834825295986,0.935672514619883
903,1575,쩝/Adverb,171,28,143,0.0003334444814938313,0.001610431151291677,0.8362573099415205
904,1576,극치/Noun,171,28,143,0.0003334444814938313,0.001610431151291677,0.8362573099415205
905,1577,까지도/Josa,171,135,36,0.0015227297988218294,0.0004220440258557498,0.7894736842105263
906,1578,밥/Noun,171,47,124,0.0005446259864399244,0.0013994091383638019,0.7251461988304093
907,1579,희생/Noun,171,112,59,0.0012670890296765588,0.0006774917257158089,0.6549707602339181
908,1583,찡하다/Adjective,170,165,5,0.001856174280315661,7.774495213132233e-05,0.9705882352941176
909,1584,주기도/Noun,170,6,164,8.891852839835501e-05,0.001843666007685644,0.9647058823529412
910,1585,노답/Noun,170,14,156,0.00017783705679671002,0.0017548146338212756,0.9176470588235294
911,1586,빡치다/Adjective,170,27,143,0.00032232966544403684,0.001610431151291677,0.8411764705882353
912,1587,남편/Noun,170,55,115,0.0006335445148382794,0.0012994513427663874,0.6764705882352942
913,1588,분노/Noun,170,67,103,0.0007669223074358119,0.001166174281969835,0.6058823529411764
914,1593,죄다/Adverb,169,19,150,0.0002334111370456819,0.0016881761034229991,0.8875739644970414
915,1594,싸구려/Noun,169,21,148,0.00025564076914527065,0.001665963259956907,0.8757396449704142
916,1595,때우다/Verb,169,36,133,0.00042236300989218633,0.0014993669339612163,0.7869822485207101
917,1596,에로/Josa,169,39,130,0.00045570745804156943,0.0014660476687620785,0.7692307692307693
918,1597,마저/Josa,169,51,118,0.000589085250639102,0.0013327706079655256,0.6982248520710059
919,1598,헐리우드/Noun,169,52,117,0.0006002000666888963,0.0013216641862324795,0.6923076923076923
920,1601,섬세하다/Adjective,168,146,22,0.0016449927753695677,0.00026655412159310506,0.8690476190476191
921,1602,풋풋하다/Adjective,168,144,24,0.001622763143269979,0.0002887669650591972,0.8571428571428571
922,1603,어머니/Noun,168,123,45,0.001389352006224297,0.0005220018214531642,0.7321428571428571
923,1604,=/Punctuation,168,55,113,0.0006335445148382794,0.0012772384993002955,0.6726190476190477
924,1605,청소년/Noun,168,62,106,0.0007113482271868402,0.0011994935471689732,0.6309523809523809
925,1606,시각/Noun,168,102,66,0.0011559408691786152,0.0007552366778471312,0.6071428571428571
926,1611,제로/Noun,167,16,151,0.0002000666888962988,0.0016992825251560453,0.9041916167664672
927,1612,유발/Noun,167,21,146,0.00025564076914527065,0.001643750416490815,0.8742514970059879
928,1613,필름/Noun,167,34,133,0.0004001333777925976,0.0014993669339612163,0.7964071856287425
929,1614,조절/Noun,167,40,127,0.0004668222740913638,0.00143272840356294,0.7604790419161677
930,1615,놓치다/Verb,167,125,42,0.0014115816383238858,0.0004886825562540262,0.7485029940119761
931,1616,본인/Noun,167,56,111,0.0006446593308880737,0.0012550256558342032,0.6646706586826348
932,1617,_/Punctuation,167,106,61,0.0012004001333777929,0.0006997045691819009,0.6347305389221557
933,1618,싸움/Noun,167,66,101,0.0007558074913860174,0.0011439614385037428,0.6047904191616766
934,1622,미드/Noun,166,111,55,0.0012559742136267645,0.0006330660387836247,0.6686746987951807
935,1623,실력/Noun,166,57,109,0.0006557741469378681,0.0012328128123681114,0.6566265060240963
936,1627,조잡하다/Adjective,165,7,158,0.0001000333444481494,0.0017770274772873676,0.9575757575757576
937,1628,호러/Noun,165,58,107,0.0006668889629876625,0.0012105999689020189,0.6484848484848484
938,1629,방금/Noun,165,104,61,0.001178170501278204,0.0006997045691819009,0.6303030303030303
939,1630,금/Noun,165,61,104,0.0007002334111370457,0.001177280703702881,0.6303030303030303
940,1631,라인/Noun,165,63,102,0.0007224630432366343,0.001155067860236789,0.6181818181818182
941,1636,굿굿/Noun,164,161,3,0.0018117150161164836,5.553210866523024e-05,0.9817073170731708
942,1637,좋아지다/Verb,164,134,30,0.0015116149827720349,0.0003554054954574735,0.8170731707317073
943,1638,통쾌하다/Adjective,164,128,36,0.0014449260864732687,0.0004220440258557498,0.7804878048780488
944,1639,심각하다/Adjective,164,43,121,0.0005001667222407468,0.001366089873164664,0.7378048780487805
945,1640,맨날/Adverb,164,58,106,0.0006668889629876625,0.0011994935471689732,0.6463414634146342
946,1641,쫌/Noun,164,59,105,0.0006780037790374569,0.001188387125435927,0.6402439024390244
947,1646,어휴/Exclamation,163,21,142,0.00025564076914527065,0.0015993247295586306,0.8711656441717791
948,1647,실패/Noun,163,27,136,0.00032232966544403684,0.0015326861991603546,0.8343558282208589
949,1648,아줌마/Noun,163,46,117,0.00053351117039013,0.0013216641862324795,0.7177914110429447
950,1649,닮다/Verb,163,99,64,0.001122596421029232,0.0007330238343810393,0.6073619631901841
951,1654,다가오다/Verb,162,132,30,0.0014893853506724466,0.0003554054954574735,0.8148148148148148
952,1655,은근/Noun,162,127,35,0.0014338112704234743,0.0004109376041227037,0.7839506172839507
953,1656,심장/Noun,162,126,36,0.0014226964543736804,0.0004220440258557498,0.7777777777777778
954,1657,바라보다/Verb,162,126,36,0.0014226964543736804,0.0004220440258557498,0.7777777777777778
955,1658,씁쓸하다/Adjective,162,120,42,0.0013560075580749138,0.0004886825562540262,0.7407407407407407
956,1659,편하다/Adjective,162,108,54,0.0012226297654773814,0.0006219596170505788,0.6666666666666666
957,1660,따라가다/Verb,162,56,106,0.0006446593308880737,0.0011994935471689732,0.654320987654321
958,1661,조합/Noun,162,98,64,0.0011114816049794377,0.0007330238343810393,0.6049382716049383
959,1666,없어지다/Verb,161,37,124,0.0004334778259419807,0.0013994091383638019,0.7701863354037267
960,1667,숨다/Verb,161,121,40,0.0013671223741247086,0.000466469712787934,0.7515527950310559
961,1671,1시간/Number,160,35,125,0.0004112481938423919,0.001410515560096848,0.78125
962,1672,늦다/Verb,160,123,37,0.001389352006224297,0.0004331504475887958,0.76875
963,1673,아이돌/Noun,160,54,106,0.0006224296987884852,0.0011994935471689732,0.6625
964,1674,한국인/Noun,160,57,103,0.0006557741469378681,0.001166174281969835,0.64375
965,1675,입다/Verb,160,59,101,0.0006780037790374569,0.0011439614385037428,0.63125
966,1676,히어로/Noun,160,97,63,0.0011003667889296432,0.0007219174126479931,0.60625
967,1680,명품/Noun,159,135,24,0.0015227297988218294,0.0002887669650591972,0.8490566037735849
968,1681,존경/Noun,159,126,33,0.0014226964543736804,0.00038872476065661166,0.7924528301886793
969,1682,더불다/Verb,159,117,42,0.0013226631099255307,0.0004886825562540262,0.7358490566037735
970,1683,신나다/Adjective,159,111,48,0.0012559742136267645,0.0005553210866523023,0.6981132075471698
971,1686,시트콤/Noun,158,109,49,0.0012337445815271755,0.0005664275083853486,0.689873417721519
972,1687,어쩔/Modifier,158,50,108,0.0005779704345893076,0.0012217063906350652,0.6835443037974683
973,1688,성/Noun,158,56,102,0.0006446593308880737,0.001155067860236789,0.6455696202531646
974,1689,대부분/Noun,158,60,98,0.0006891185950872514,0.0011106421733046046,0.620253164556962
975,1693,짠하다/Adjective,157,146,11,0.0016449927753695677,0.0001443834825295986,0.929936305732484
976,1694,푹/Noun,157,137,20,0.0015449594309214182,0.00024434127812701304,0.8726114649681529
977,1695,만족/Noun,157,113,44,0.0012782038457263534,0.0005108953997201182,0.7197452229299363
978,1696,이니/Josa,157,56,101,0.0006446593308880737,0.0011439614385037428,0.643312101910828
979,1697,주말/Noun,157,99,58,0.001122596421029232,0.0006663853039827628,0.6305732484076433
980,1698,신분/Noun,157,99,58,0.001122596421029232,0.0006663853039827628,0.6305732484076433
981,1699,쵝오/Noun,156,151,5,0.0017005668556185395,7.774495213132233e-05,0.9679487179487181
982,1703,거슬리다/Verb,155,35,120,0.0004112481938423919,0.0013549834514316175,0.7741935483870968
983,1704,전개도/Noun,155,54,101,0.0006224296987884852,0.0011439614385037428,0.6516129032258065
984,1705,30/Number,155,98,57,0.0011114816049794377,0.0006552788822497168,0.6322580645161291
985,1709,짝퉁/Noun,154,7,147,0.0001000333444481494,0.0016548568382238609,0.9545454545454546
986,1710,개뿔/Noun,154,7,147,0.0001000333444481494,0.0016548568382238609,0.9545454545454546
987,1711,양심/Noun,154,28,126,0.0003334444814938313,0.001421621981829894,0.8181818181818182
988,1712,????/Punctuation,154,36,118,0.00042236300989218633,0.0013327706079655256,0.7662337662337663
989,1713,누군가/Noun,154,118,36,0.001333777925975325,0.0004220440258557498,0.7662337662337663
990,1714,그거/Noun,154,45,109,0.0005223963543403357,0.0012328128123681114,0.7077922077922078
991,1715,개념/Noun,154,49,105,0.0005668556185395131,0.001188387125435927,0.6818181818181818
992,1716,이자/Noun,154,103,51,0.0011670556852284096,0.0005886403518514405,0.6688311688311688
993,1717,시원하다/Adjective,154,103,51,0.0011670556852284096,0.0005886403518514405,0.6688311688311688
994,1718,으로만/Josa,154,55,99,0.0006335445148382794,0.0011217485950376508,0.6428571428571429
995,1719,끼/Noun,154,58,96,0.0006668889629876625,0.0010884293298385123,0.6233766233766234
996,1720,돌아오다/Verb,154,93,61,0.0010559075247304657,0.0006997045691819009,0.6038961038961039
997,1721,민망하다/Adjective,153,16,137,0.0002000666888962988,0.0015437926208934005,0.8954248366013072
998,1722,망/Noun,153,19,134,0.0002334111370456819,0.0015104733556942625,0.8758169934640523
999,1723,연예인/Noun,153,27,126,0.00032232966544403684,0.001421621981829894,0.8235294117647058
1000,1724,도안/Noun,153,38,115,0.000444592641991775,0.0012994513427663874,0.7516339869281046
1001,1725,해내다/Verb,153,114,39,0.0012893186617761474,0.000455363291054888,0.7450980392156863
1002,1726,가요/Noun,153,39,114,0.00045570745804156943,0.0012883449210333415,0.7450980392156863
1003,1727,전반/Noun,153,49,104,0.0005668556185395131,0.001177280703702881,0.6797385620915033
1004,1728,진리/Noun,153,101,52,0.0011448260531288204,0.0005997467735844866,0.6601307189542484
1005,1729,이정/Noun,153,60,93,0.0006891185950872514,0.0010551100646393743,0.6078431372549019
1006,1733,돌아보다/Verb,152,143,9,0.0016116483272201846,0.00012217063906350652,0.9407894736842104
1007,1734,의외로/Adverb,152,129,23,0.0014560409025230633,0.00027766054332615115,0.8486842105263158
1008,1735,여행/Noun,152,104,48,0.001178170501278204,0.0005553210866523023,0.6842105263157895
1009,1736,향/Noun,152,100,52,0.0011337112370790265,0.0005997467735844866,0.6578947368421053
1010,1737,19/Number,152,56,96,0.0006446593308880737,0.0010884293298385123,0.631578947368421
1011,1740,찝찝하다/Adjective,151,30,121,0.00035567411359342004,0.001366089873164664,0.8013245033112583
1012,1741,사기/Noun,151,33,118,0.00038901856174280313,0.0013327706079655256,0.7814569536423841
1013,1742,과장/Noun,151,51,100,0.000589085250639102,0.0011328550167706971,0.6622516556291391
1014,1750,라지/Noun,150,18,132,0.0002222963209958875,0.0014882605122281704,0.88
1015,1751,날리다/Verb,150,30,120,0.00035567411359342004,0.0013549834514316175,0.8
1016,1752,갈등/Noun,150,95,55,0.0010781371568300542,0.0006330660387836247,0.6333333333333333
1017,1761,낭비하다/Adjective,149,2,147,4.445926419917751e-05,0.0016548568382238609,0.9865771812080536
1018,1762,단연/Noun,149,128,21,0.0014449260864732687,0.0002554476998600591,0.8590604026845637
1019,1763,무척/Noun,149,114,35,0.0012893186617761474,0.0004109376041227037,0.7651006711409396
1020,1764,성장/Noun,149,110,39,0.00124485939757697,0.000455363291054888,0.7382550335570469
1021,1765,......../Punctuation,149,45,104,0.0005223963543403357,0.001177280703702881,0.6979865771812079
1022,1766,번째/Suffix,149,95,54,0.0010781371568300542,0.0006219596170505788,0.6375838926174496
1023,1767,초등학생/Noun,149,56,93,0.0006446593308880737,0.0010551100646393743,0.6241610738255033
1024,1768,연속/Noun,149,59,90,0.0006780037790374569,0.0010217907994402363,0.6040268456375839
1025,1775,이도/Noun,148,5,143,7.780371234856063e-05,0.001610431151291677,0.9662162162162162
1026,1776,상/Noun,148,44,104,0.0005112815382905413,0.001177280703702881,0.7027027027027027
1027,1777,피해자/Noun,148,44,104,0.0005112815382905413,0.001177280703702881,0.7027027027027027
1028,1778,감히/Noun,148,97,51,0.0011003667889296432,0.0005886403518514405,0.6554054054054054
1029,1779,뒷/Modifier,148,53,95,0.0006113148827386907,0.0010773229081054666,0.6418918918918919
1030,1781,꽝/Noun,147,8,139,0.00011114816049794375,0.0015660054643594926,0.9455782312925172
1031,1782,라이/Noun,147,28,119,0.0003334444814938313,0.0013438770296985718,0.8095238095238095
1032,1783,편견/Noun,147,103,44,0.0011670556852284096,0.0005108953997201182,0.7006802721088435
1033,1784,베스트/Noun,147,97,50,0.0011003667889296432,0.0005775339301183945,0.6598639455782312
1034,1789,사수/Noun,146,132,14,0.0014893853506724466,0.00017770274772873674,0.9041095890410958
1035,1790,허세/Noun,146,18,128,0.0002222963209958875,0.0014438348252959862,0.8767123287671232
1036,1791,와우/Noun,146,125,21,0.0014115816383238858,0.0002554476998600591,0.8561643835616438
1037,1792,명성/Noun,146,25,121,0.00030010003334444816,0.001366089873164664,0.8287671232876712
1038,1793,얘/Noun,146,40,106,0.0004668222740913638,0.0011994935471689732,0.726027397260274
1039,1794,올라가다/Verb,146,98,48,0.0011114816049794377,0.0005553210866523023,0.6712328767123288
1040,1795,확/Noun,146,50,96,0.0005779704345893076,0.0010884293298385123,0.6575342465753424
1041,1803,개막/Noun,145,9,136,0.00012226297654773814,0.0015326861991603546,0.9379310344827586
1042,1804,생생하다/Adjective,145,134,11,0.0015116149827720349,0.0001443834825295986,0.9241379310344828
1043,1805,^/Punctuation,145,102,43,0.0011559408691786152,0.0004997889779870722,0.7034482758620689
1044,1806,연결/Noun,145,50,95,0.0005779704345893076,0.0010773229081054666,0.6551724137931034
1045,1809,뭉클하다/Adjective,144,139,5,0.0015671890630210071,7.774495213132233e-05,0.9652777777777778
1046,1810,마이너스/Noun,144,7,137,0.0001000333444481494,0.0015437926208934005,0.9513888888888888
1047,1811,밋밋하다/Adjective,144,18,126,0.0002222963209958875,0.001421621981829894,0.875
1048,1812,묘/Noun,144,118,26,0.001333777925975325,0.00031097980852528933,0.8194444444444444
1049,1813,...?/Punctuation,144,54,90,0.0006224296987884852,0.0010217907994402363,0.625
1050,1814,만큼은/Josa,144,90,54,0.0010225630765810826,0.0006219596170505788,0.625
1051,1815,쪽/Noun,144,57,87,0.0006557741469378681,0.0009884715342410985,0.6041666666666666
1052,1817,저/Modifier,143,26,117,0.00031121484939424253,0.0013216641862324795,0.8181818181818182
1053,1818,풍경/Noun,143,101,42,0.0011448260531288204,0.0004886825562540262,0.7062937062937062
1054,1819,처/Noun,143,44,99,0.0005112815382905413,0.0011217485950376508,0.6923076923076923
1055,1820,드물다/Adjective,143,98,45,0.0011114816049794377,0.0005220018214531642,0.6853146853146853
1056,1821,무언가/Noun,143,97,46,0.0011003667889296432,0.0005331082431862101,0.6783216783216783
1057,1824,ㅉㅉㅉ/KoreanParticle,142,15,127,0.00018895187284650438,0.00143272840356294,0.8943661971830986
1058,1825,싸이코/Noun,142,29,113,0.0003445592975436257,0.0012772384993002955,0.7957746478873241
1059,1826,만들기/Noun,142,30,112,0.00035567411359342004,0.0012661320775672494,0.7887323943661971
1060,1827,자연스럽다/Adjective,142,112,30,0.0012670890296765588,0.0003554054954574735,0.7887323943661971
1061,1828,복잡하다/Adjective,142,92,50,0.0010447927086806713,0.0005775339301183945,0.647887323943662
1062,1829,개성/Noun,142,87,55,0.0009892186284316995,0.0006330660387836247,0.6126760563380281
1063,1831,달달/Noun,141,125,16,0.0014115816383238858,0.00019991559119482882,0.8865248226950354
1064,1832,어린시절/Noun,141,123,18,0.001389352006224297,0.00022212843466092096,0.8723404255319149
1065,1833,정체/Noun,141,30,111,0.00035567411359342004,0.0012550256558342032,0.7872340425531915
1066,1834,막장드라마/Noun,141,32,109,0.00037790374569300877,0.0012328128123681114,0.7730496453900709
1067,1835,왠/Modifier,141,33,108,0.00038901856174280313,0.0012217063906350652,0.7659574468085106
1068,1836,마이클/Noun,141,91,50,0.001033677892630877,0.0005775339301183945,0.6453900709219859
1069,1842,♥♥/Foreign,140,140,0,0.0015783038790708015,2.2212843466092093e-05,1.0
1070,1843,숨기다/Verb,140,114,26,0.0012893186617761474,0.00031097980852528933,0.8142857142857143
1071,1844,세월/Noun,140,105,35,0.0011892853173279985,0.0004109376041227037,0.75
1072,1845,캐리/Noun,140,104,36,0.001178170501278204,0.0004220440258557498,0.7428571428571429
1073,1846,변화/Noun,140,91,49,0.001033677892630877,0.0005664275083853486,0.65
1074,1847,빨다/Verb,140,54,86,0.0006224296987884852,0.000977365112508052,0.6142857142857143
1075,1852,일품/Noun,139,126,13,0.0014226964543736804,0.0001665963259956907,0.9064748201438848
1076,1853,젠장/Noun,139,22,117,0.000266755585195065,0.0013216641862324795,0.8417266187050358
1077,1854,기회/Noun,139,106,33,0.0012004001333777929,0.00038872476065661166,0.7625899280575541
1078,1855,카리스마/Noun,139,105,34,0.0011892853173279985,0.00039983118238965764,0.7553956834532374
1079,1856,남아/Noun,139,97,42,0.0011003667889296432,0.0004886825562540262,0.6978417266187049
1080,1858,아/Noun,138,27,111,0.00032232966544403684,0.0012550256558342032,0.8043478260869565
1081,1859,칼/Noun,138,41,97,0.0004779370901411582,0.0010995357515715587,0.7028985507246377
1082,1860,신경/Noun,138,42,96,0.0004890519061909527,0.0010884293298385123,0.6956521739130435
1083,1861,자살/Noun,138,43,95,0.0005001667222407468,0.0010773229081054666,0.6884057971014492
1084,1862,오빠/Noun,138,95,43,0.0010781371568300542,0.0004997889779870722,0.6884057971014492
1085,1863,맨/Modifier,138,51,87,0.000589085250639102,0.0009884715342410985,0.6304347826086957
1086,1864,면서/Noun,138,84,54,0.0009558741802823164,0.0006219596170505788,0.6086956521739131
1087,1869,포르노/Noun,137,16,121,0.0002000666888962988,0.001366089873164664,0.8832116788321168
1088,1870,C/Alpha,137,16,121,0.0002000666888962988,0.001366089873164664,0.8832116788321168
1089,1871,응원/Noun,137,116,21,0.0013115482938757365,0.0002554476998600591,0.8467153284671532
1090,1872,겨/Noun,137,26,111,0.00031121484939424253,0.0012550256558342032,0.8102189781021898
1091,1873,압권/Noun,137,111,26,0.0012559742136267645,0.00031097980852528933,0.8102189781021898
1092,1874,다양하다/Adjective,137,99,38,0.001122596421029232,0.0004442568693218419,0.7226277372262774
1093,1875,모으다/Verb,137,39,98,0.00045570745804156943,0.0011106421733046046,0.7153284671532847
1094,1876,형사/Noun,137,43,94,0.0005001667222407468,0.0010662164863724202,0.6861313868613139
1095,1877,만해/Noun,137,91,46,0.001033677892630877,0.0005331082431862101,0.6642335766423357
1096,1878,",,,,/Punctuation",137,50,87,0.0005779704345893076,0.0009884715342410985,0.635036496350365
1097,1879,잠깐/Noun,137,52,85,0.0006002000666888963,0.0009662586907750061,0.6204379562043796
1098,1886,시시하다/Adjective,136,23,113,0.00027787040124485944,0.0012772384993002955,0.8308823529411765
1099,1887,세번/Noun,136,110,26,0.00124485939757697,0.00031097980852528933,0.8088235294117647
1100,1888,냥/Josa,136,31,105,0.00036678892964321435,0.001188387125435927,0.7720588235294118
1101,1889,만에/Josa,136,101,35,0.0011448260531288204,0.0004109376041227037,0.7426470588235294
1102,1890,내면/Noun,136,99,37,0.001122596421029232,0.0004331504475887958,0.7279411764705882
1103,1891,성격/Noun,136,41,95,0.0004779370901411582,0.0010773229081054666,0.6985294117647058
1104,1892,선물/Noun,136,95,41,0.0010781371568300542,0.00047757613452098,0.6985294117647058
1105,1893,동시/Noun,136,90,46,0.0010225630765810826,0.0005331082431862101,0.6617647058823529
1106,1897,에로영화/Noun,135,22,113,0.000266755585195065,0.0012772384993002955,0.837037037037037
1107,1898,겨우/Noun,135,22,113,0.000266755585195065,0.0012772384993002955,0.837037037037037
1108,1899,추하다/Adjective,135,108,27,0.0012226297654773814,0.00032208623025833537,0.8
1109,1900,적임/Noun,135,96,39,0.0010892519728798488,0.000455363291054888,0.7111111111111111
1110,1901,만족하다/Adjective,135,93,42,0.0010559075247304657,0.0004886825562540262,0.6888888888888889
1111,1902,형제/Noun,135,91,44,0.001033677892630877,0.0005108953997201182,0.674074074074074
1112,1903,조용하다/Adjective,135,90,45,0.0010225630765810826,0.0005220018214531642,0.6666666666666666
1113,1904,할머니/Noun,135,87,48,0.0009892186284316995,0.0005553210866523023,0.6444444444444445
1114,1910,야동/Noun,134,25,109,0.00030010003334444816,0.0012328128123681114,0.8134328358208955
1115,1911,롭고/Josa,134,108,26,0.0012226297654773814,0.00031097980852528933,0.8059701492537313
1116,1912,당/Suffix,134,44,90,0.0005112815382905413,0.0010217907994402363,0.6716417910447762
1117,1913,[/Punctuation,134,44,90,0.0005112815382905413,0.0010217907994402363,0.6716417910447762
1118,1914,스럽지/Josa,134,87,47,0.0009892186284316995,0.0005442146649192564,0.6492537313432836
1119,1915,멈추다/Verb,134,84,50,0.0009558741802823164,0.0005775339301183945,0.6268656716417911
1120,1924,투자/Noun,133,20,113,0.00024452595309547634,0.0012772384993002955,0.849624060150376
1121,1925,레전드/Noun,133,108,25,0.0012226297654773814,0.0002998733867922433,0.8120300751879699
1122,1926,지우다/Verb,133,30,103,0.00035567411359342004,0.001166174281969835,0.7744360902255639
1123,1927,고통/Noun,133,95,38,0.0010781371568300542,0.0004442568693218419,0.7142857142857143
1124,1928,비현실적/Noun,133,41,92,0.0004779370901411582,0.0010440036429063284,0.6917293233082706
1125,1929,욕망/Noun,133,90,43,0.0010225630765810826,0.0004997889779870722,0.6766917293233082
1126,1930,쉬/Noun,133,90,43,0.0010225630765810826,0.0004997889779870722,0.6766917293233082
1127,1931,방영/Noun,133,85,48,0.0009669889963321108,0.0005553210866523023,0.6390977443609023
1128,1932,영혼/Noun,133,82,51,0.0009336445481827276,0.0005886403518514405,0.6165413533834586
1129,1937,진하다/Adjective,132,119,13,0.0013448927420251196,0.0001665963259956907,0.9015151515151516
1130,1938,초등학교/Noun,132,99,33,0.001122596421029232,0.00038872476065661166,0.75
1131,1939,학년/Noun,132,96,36,0.0010892519728798488,0.0004220440258557498,0.7272727272727273
1132,1940,로그인/Noun,132,41,91,0.0004779370901411582,0.0010328972211732824,0.6893939393939394
1133,1941,베/Noun,132,45,87,0.0005223963543403357,0.0009884715342410985,0.6590909090909091
1134,1942,을/Foreign,132,45,87,0.0005223963543403357,0.0009884715342410985,0.6590909090909091
1135,1943,특수/Noun,132,48,84,0.0005557408024897189,0.00095515226904196,0.6363636363636364
1136,1944,감안/Noun,132,51,81,0.000589085250639102,0.000921833003842822,0.6136363636363636
1137,1950,M/Alpha,131,5,126,7.780371234856063e-05,0.001421621981829894,0.9618320610687024
1138,1951,잠들다/Verb,131,17,114,0.00021118150494609317,0.0012883449210333415,0.8702290076335878
1139,1952,감흥/Noun,131,19,112,0.0002334111370456819,0.0012661320775672494,0.8549618320610687
1140,1953,붙이다/Verb,131,21,110,0.00025564076914527065,0.0012439192341011573,0.8396946564885496
1141,1954,부럽다/Adjective,131,106,25,0.0012004001333777929,0.0002998733867922433,0.8091603053435115
1142,1955,설득/Noun,131,30,101,0.00035567411359342004,0.0011439614385037428,0.7709923664122137
1143,1956,따로/Adverb,131,31,100,0.00036678892964321435,0.0011328550167706971,0.7633587786259542
1144,1957,]/Punctuation,131,38,93,0.000444592641991775,0.0010551100646393743,0.7099236641221374
1145,1958,끝내주다/Adjective,131,91,40,0.001033677892630877,0.000466469712787934,0.6946564885496184
1146,1959,놀랍다/Adjective,131,91,40,0.001033677892630877,0.000466469712787934,0.6946564885496184
1147,1960,권/Suffix,131,84,47,0.0009558741802823164,0.0005442146649192564,0.6412213740458015
1148,1964,반하다/Adjective,130,112,18,0.0012670890296765588,0.00022212843466092096,0.8615384615384616
1149,1965,점준/Noun,130,23,107,0.00027787040124485944,0.0012105999689020189,0.823076923076923
1150,1966,인지도/Noun,130,26,104,0.00031121484939424253,0.001177280703702881,0.8
1151,1967,x/Alpha,130,34,96,0.0004001333777925976,0.0010884293298385123,0.7384615384615385
1152,1968,루/Noun,130,36,94,0.00042236300989218633,0.0010662164863724202,0.7230769230769231
1153,1969,기발하다/Adjective,130,92,38,0.0010447927086806713,0.0004442568693218419,0.7076923076923077
1154,1970,최강/Noun,130,88,42,0.0010003334444814939,0.0004886825562540262,0.676923076923077
1155,1971,주성치/Noun,130,81,49,0.0009225297321329332,0.0005664275083853486,0.6230769230769231
1156,1975,안습/Noun,129,16,113,0.0002000666888962988,0.0012772384993002955,0.875968992248062
1157,1976,우려/Noun,129,18,111,0.0002222963209958875,0.0012550256558342032,0.8604651162790697
1158,1977,기만/Noun,129,25,104,0.00030010003334444816,0.001177280703702881,0.8062015503875969
1159,1978,조작/Noun,129,25,104,0.00030010003334444816,0.001177280703702881,0.8062015503875969
1160,1979,고르다/Verb,129,29,100,0.0003445592975436257,0.0011328550167706971,0.7751937984496124
1161,1980,오랫/Modifier,129,97,32,0.0011003667889296432,0.0003776183389235656,0.751937984496124
1162,1981,스트레스/Noun,129,35,94,0.0004112481938423919,0.0010662164863724202,0.7286821705426356
1163,1982,색감/Noun,129,91,38,0.001033677892630877,0.0004442568693218419,0.7054263565891473
1164,1988,공짜/Noun,128,5,123,7.780371234856063e-05,0.0013883027166307562,0.9609375
1165,1989,18/Number,128,28,100,0.0003334444814938313,0.0011328550167706971,0.78125
1166,1990,놀다/Verb,128,36,92,0.00042236300989218633,0.0010440036429063284,0.71875
1167,1991,아무렇다/Adjective,128,37,91,0.0004334778259419807,0.0010328972211732824,0.7109375
1168,1992,데리/Noun,128,41,87,0.0004779370901411582,0.0009884715342410985,0.6796875
1169,1993,포인트/Noun,128,42,86,0.0004890519061909527,0.000977365112508052,0.671875
1170,1994,ㄱ/KoreanParticle,128,45,83,0.0005223963543403357,0.000944045847308914,0.6484375
1171,1995,저러다/Verb,128,45,83,0.0005223963543403357,0.000944045847308914,0.6484375
1172,1996,갑/Noun,128,83,45,0.0009447593642325221,0.0005220018214531642,0.6484375
1173,2001,정신병/Noun,127,21,106,0.00025564076914527065,0.0011994935471689732,0.8346456692913385
1174,2002,깨우다/Verb,127,105,22,0.0011892853173279985,0.00026655412159310506,0.8267716535433071
1175,2003,아예/Noun,127,26,101,0.00031121484939424253,0.0011439614385037428,0.7952755905511811
1176,2004,여러가지/Noun,127,95,32,0.0010781371568300542,0.0003776183389235656,0.7480314960629921
1177,2005,미가/Noun,127,94,33,0.00106702234078026,0.00038872476065661166,0.7401574803149606
1178,2006,넘어가다/Verb,127,40,87,0.0004668222740913638,0.0009884715342410985,0.6850393700787402
1179,2015,틈/Noun,126,106,20,0.0012004001333777929,0.00024434127812701304,0.8412698412698413
1180,2016,;;;;/Punctuation,126,26,100,0.00031121484939424253,0.0011328550167706971,0.7936507936507936
1181,2017,껏/Noun,126,28,98,0.0003334444814938313,0.0011106421733046046,0.7777777777777778
1182,2018,위로/Noun,126,91,35,0.001033677892630877,0.0004109376041227037,0.7222222222222222
1183,2019,전쟁영화/Noun,126,88,38,0.0010003334444814939,0.0004442568693218419,0.6984126984126984
1184,2020,보고오다/Verb,126,78,48,0.00088918528398355,0.0005553210866523023,0.6190476190476191
1185,2021,잔/Noun,126,49,77,0.0005668556185395131,0.0008774073169106378,0.6111111111111112
1186,2027,효/Noun,125,24,101,0.0002889852172946538,0.0011439614385037428,0.8079999999999999
1187,2028,용기/Noun,125,98,27,0.0011114816049794377,0.00032208623025833537,0.784
1188,2029,뜨겁다/Adjective,125,97,28,0.0011003667889296432,0.0003331926519913814,0.7759999999999999
1189,2030,패/Noun,125,38,87,0.000444592641991775,0.0009884715342410985,0.696
1190,2031,공포물/Noun,125,40,85,0.0004668222740913638,0.0009662586907750061,0.68
1191,2032,근래/Noun,125,84,41,0.0009558741802823164,0.00047757613452098,0.672
1192,2033,수고/Noun,125,82,43,0.0009336445481827276,0.0004997889779870722,0.6559999999999999
1193,2034,만남/Noun,125,80,45,0.0009114149160831386,0.0005220018214531642,0.64
1194,2039,말아먹다/Verb,124,12,112,0.00015560742469712126,0.0012661320775672494,0.9032258064516128
1195,2040,운명/Noun,124,93,31,0.0010559075247304657,0.00036651191719051963,0.75
1196,2041,연인/Noun,124,91,33,0.001033677892630877,0.00038872476065661166,0.7338709677419355
1197,2042,이용/Noun,124,38,86,0.000444592641991775,0.000977365112508052,0.6935483870967742
1198,2043,",./Punctuation",124,41,83,0.0004779370901411582,0.000944045847308914,0.6693548387096774
1199,2044,007/Number,124,79,45,0.0009003001000333445,0.0005220018214531642,0.6370967741935484
1200,2045,DVD/Alpha,124,79,45,0.0009003001000333445,0.0005220018214531642,0.6370967741935484
1201,2046,거짓말/Noun,124,46,78,0.00053351117039013,0.0008885137386436838,0.6290322580645161
1202,2047,영화계/Noun,124,47,77,0.0005446259864399244,0.0008774073169106378,0.6209677419354839
1203,2053,썩다/Verb,123,33,90,0.00038901856174280313,0.0010217907994402363,0.7317073170731707
1204,2054,확인/Noun,123,35,88,0.0004112481938423919,0.0009995779559741444,0.7154471544715447
1205,2055,해결/Noun,123,42,81,0.0004890519061909527,0.000921833003842822,0.6585365853658537
1206,2056,군/Noun,123,46,77,0.00053351117039013,0.0008774073169106378,0.6260162601626016
1207,2064,았/Noun,122,13,109,0.00016672224074691566,0.0012328128123681114,0.8934426229508197
1208,2065,번은/Noun,122,102,20,0.0011559408691786152,0.00024434127812701304,0.8360655737704918
1209,2066,설마/Noun,122,22,100,0.000266755585195065,0.0011328550167706971,0.819672131147541
1210,2067,결코/Noun,122,91,31,0.001033677892630877,0.00036651191719051963,0.7459016393442623
1211,2068,원/Noun,122,31,91,0.00036678892964321435,0.0010328972211732824,0.7459016393442623
1212,2069,잖다/Verb,122,34,88,0.0004001333777925976,0.0009995779559741444,0.7213114754098361
1213,2070,갠/Noun,122,84,38,0.0009558741802823164,0.0004442568693218419,0.6885245901639344
1214,2071,갖추다/Verb,122,82,40,0.0009336445481827276,0.000466469712787934,0.6721311475409836
1215,2072,전에/Foreign,122,79,43,0.0009003001000333445,0.0004997889779870722,0.6475409836065574
1216,2078,낮추다/Verb,121,16,105,0.0002000666888962988,0.001188387125435927,0.8677685950413223
1217,2079,셈/Noun,121,20,101,0.00024452595309547634,0.0011439614385037428,0.8347107438016529
1218,2080,변태/Noun,121,21,100,0.00025564076914527065,0.0011328550167706971,0.8264462809917356
1219,2081,심지어/Noun,121,31,90,0.00036678892964321435,0.0010217907994402363,0.743801652892562
1220,2082,자르다/Verb,121,40,81,0.0004668222740913638,0.000921833003842822,0.6694214876033058
1221,2086,잔뜩/Noun,120,15,105,0.00018895187284650438,0.001188387125435927,0.875
1222,2087,5분/Number,120,18,102,0.0002222963209958875,0.001155067860236789,0.85
1223,2088,크리스마스/Noun,120,89,31,0.0010114482605312882,0.00036651191719051963,0.7416666666666667
1224,2089,X/Alpha,120,31,89,0.00036678892964321435,0.0010106843777071904,0.7416666666666667
1225,2090,스런/Josa,120,39,81,0.00045570745804156943,0.000921833003842822,0.675
1226,2091,여러/Noun,120,79,41,0.0009003001000333445,0.00047757613452098,0.6583333333333333
1227,2092,넘기다/Verb,120,43,77,0.0005001667222407468,0.0008774073169106378,0.6416666666666667
1228,2093,편도/Noun,120,77,43,0.0008780704679337558,0.0004997889779870722,0.6416666666666667
1229,2094,이래서/Josa,120,46,74,0.00053351117039013,0.0008440880517114996,0.6166666666666667
1230,2100,전율/Noun,119,110,9,0.00124485939757697,0.00012217063906350652,0.9243697478991596
1231,2101,둘째/Noun,119,14,105,0.00017783705679671002,0.001188387125435927,0.8823529411764706
1232,2102,려고/Noun,119,23,96,0.00027787040124485944,0.0010884293298385123,0.8067226890756303
1233,2103,아동/Noun,119,28,91,0.0003334444814938313,0.0010328972211732824,0.7647058823529411
1234,2104,그립다/Adjective,119,86,33,0.0009781038123819054,0.00038872476065661166,0.7226890756302521
1235,2105,탓/Noun,119,35,84,0.0004112481938423919,0.00095515226904196,0.7058823529411765
1236,2106,뛰어넘다/Verb,119,83,36,0.0009447593642325221,0.0004220440258557498,0.6974789915966386
1237,2107,제외/Noun,119,43,76,0.0005001667222407468,0.0008663008951775916,0.6386554621848739
1238,2108,자주/Noun,119,76,43,0.0008669556518839612,0.0004997889779870722,0.6386554621848739
1239,2116,오빠/Suffix,118,106,12,0.0012004001333777929,0.00015548990426264466,0.8983050847457628
1240,2117,작위/Noun,118,17,101,0.00021118150494609317,0.0011439614385037428,0.8559322033898306
1241,2118,대본/Noun,118,24,94,0.0002889852172946538,0.0010662164863724202,0.7966101694915254
1242,2119,부모님/Noun,118,89,29,0.0010114482605312882,0.00034429907372442745,0.7542372881355932
1243,2120,톰/Noun,118,83,35,0.0009447593642325221,0.0004109376041227037,0.7033898305084746
1244,2121,두번째/Noun,118,81,37,0.0009225297321329332,0.0004331504475887958,0.6864406779661016
1245,2122,에나/Josa,118,38,80,0.000444592641991775,0.000910726582109776,0.6779661016949152
1246,2123,짜임새/Noun,118,71,47,0.0008113815716349895,0.0005442146649192564,0.6016949152542372
1247,2126,:)/Punctuation,117,114,3,0.0012893186617761474,5.553210866523024e-05,0.9743589743589745
1248,2127,한개/Modifier,117,10,107,0.0001333777925975325,0.0012105999689020189,0.9145299145299144
1249,2128,애쓰다/Verb,117,25,92,0.00030010003334444816,0.0010440036429063284,0.7863247863247863
1250,2129,하나같이/Adverb,117,28,89,0.0003334444814938313,0.0010106843777071904,0.7606837606837606
1251,2130,가족영화/Noun,117,77,40,0.0008780704679337558,0.000466469712787934,0.6581196581196581
1252,2131,케릭/Noun,117,44,73,0.0005112815382905413,0.0008329816299784535,0.6239316239316239
1253,2132,사상/Noun,117,46,71,0.00053351117039013,0.0008107687865123613,0.6068376068376068
1254,2139,그만/Modifier,116,9,107,0.00012226297654773814,0.0012105999689020189,0.9224137931034484
1255,2140,하자/Noun,116,24,92,0.0002889852172946538,0.0010440036429063284,0.7931034482758621
1256,2141,정작/Noun,116,29,87,0.0003445592975436257,0.0009884715342410985,0.75
1257,2142,거나/Noun,116,33,83,0.00038901856174280313,0.000944045847308914,0.7155172413793104
1258,2143,신의/Noun,116,79,37,0.0009003001000333445,0.0004331504475887958,0.6810344827586207
1259,2144,장가/Noun,116,37,79,0.0004334778259419807,0.0008996201603767299,0.6810344827586207
1260,2145,무료/Noun,116,40,76,0.0004668222740913638,0.0008663008951775916,0.6551724137931034
1261,2146,예/Noun,116,40,76,0.0004668222740913638,0.0008663008951775916,0.6551724137931034
1262,2147,꺼/Suffix,116,40,76,0.0004668222740913638,0.0008663008951775916,0.6551724137931034
1263,2152,대놓고/Adverb,115,17,98,0.00021118150494609317,0.0011106421733046046,0.8521739130434782
1264,2153,ㅠㅜ/KoreanParticle,115,89,26,0.0010114482605312882,0.00031097980852528933,0.7739130434782608
1265,2154,소년/Noun,115,84,31,0.0009558741802823164,0.00036651191719051963,0.7304347826086957
1266,2155,열연/Noun,115,80,35,0.0009114149160831386,0.0004109376041227037,0.6956521739130435
1267,2156,성은/Noun,115,36,79,0.00042236300989218633,0.0008996201603767299,0.6869565217391305
1268,2157,목적/Noun,115,37,78,0.0004334778259419807,0.0008885137386436838,0.6782608695652174
1269,2158,충실하다/Adjective,115,77,38,0.0008780704679337558,0.0004442568693218419,0.6695652173913044
1270,2159,의심/Noun,115,40,75,0.0004668222740913638,0.0008551944734445456,0.6521739130434783
1271,2160,메/Noun,115,75,40,0.0008558408358341669,0.000466469712787934,0.6521739130434783
1272,2161,낫/Noun,115,43,72,0.0005001667222407468,0.0008218752082454075,0.6260869565217392
1273,2162,으리/Noun,115,71,44,0.0008113815716349895,0.0005108953997201182,0.6173913043478261
1274,2166,힘내다/Verb,114,95,19,0.0010781371568300542,0.000233234856393967,0.8333333333333334
1275,2167,겪다/Verb,114,87,27,0.0009892186284316995,0.00032208623025833537,0.7631578947368421
1276,2168,씹다/Verb,114,31,83,0.00036678892964321435,0.000944045847308914,0.7280701754385965
1277,2169,패러디/Noun,114,36,78,0.00042236300989218633,0.0008885137386436838,0.6842105263157895
1278,2170,꿈꾸다/Verb,114,77,37,0.0008780704679337558,0.0004331504475887958,0.6754385964912281
1279,2171,새다/Verb,114,42,72,0.0004890519061909527,0.0008218752082454075,0.631578947368421
1280,2172,the/Alpha,114,71,43,0.0008113815716349895,0.0004997889779870722,0.6228070175438597
1281,2173,구나/Noun,114,44,70,0.0005112815382905413,0.0007996623647793153,0.6140350877192983
1282,2174,15/Number,114,45,69,0.0005223963543403357,0.0007885559430462694,0.6052631578947368
1283,2181,20분/Number,113,18,95,0.0002222963209958875,0.0010773229081054666,0.8407079646017699
1284,2182,ㅜㅜㅜ/KoreanParticle,113,83,30,0.0009447593642325221,0.0003554054954574735,0.7345132743362832
1285,2183,..;;/Punctuation,113,31,82,0.00036678892964321435,0.000932939425575868,0.7256637168141593
1286,2188,명화/Noun,112,90,22,0.0010225630765810826,0.00026655412159310506,0.8035714285714286
1287,2189,값/Noun,112,27,85,0.00032232966544403684,0.0009662586907750061,0.7589285714285714
1288,2190,감각/Noun,112,73,39,0.0008336112037345782,0.000455363291054888,0.6517857142857143
1289,2191,부부/Noun,112,68,44,0.0007780371234856063,0.0005108953997201182,0.6071428571428571
1290,2198,낚였다/Noun,111,2,109,4.445926419917751e-05,0.0012328128123681114,0.981981981981982
1291,2199,참나/Noun,111,10,101,0.0001333777925975325,0.0011439614385037428,0.90990990990991
1292,2200,오래전/Adverb,111,85,26,0.0009669889963321108,0.00031097980852528933,0.7657657657657657
1293,2201,!!!!!/Punctuation,111,81,30,0.0009225297321329332,0.0003554054954574735,0.7297297297297297
1294,2202,뇌/Noun,111,37,74,0.0004334778259419807,0.0008440880517114996,0.6666666666666666
1295,2203,시기/Noun,111,68,43,0.0007780371234856063,0.0004997889779870722,0.6126126126126126
1296,2204,앉다/Verb,111,44,67,0.0005112815382905413,0.0007663430995801773,0.6036036036036037
1297,2208,울컥/Adverb,110,108,2,0.0012226297654773814,4.4425686932184186e-05,0.9818181818181818
1298,2209,짜지다/Verb,110,12,98,0.00015560742469712126,0.0011106421733046046,0.8909090909090909
1299,2210,신파/Noun,110,16,94,0.0002000666888962988,0.0010662164863724202,0.8545454545454545
1300,2211,첫사랑/Noun,110,90,20,0.0010225630765810826,0.00024434127812701304,0.8181818181818182
1301,2212,업다/Verb,110,29,81,0.0003445592975436257,0.000921833003842822,0.7363636363636363
1302,2213,몇몇/Noun,110,33,77,0.00038901856174280313,0.0008774073169106378,0.7
1303,2214,모양/Noun,110,36,74,0.00042236300989218633,0.0008440880517114996,0.6727272727272727
1304,2215,70년/Number,110,37,73,0.0004334778259419807,0.0008329816299784535,0.6636363636363637
1305,2216,담배/Noun,110,40,70,0.0004668222740913638,0.0007996623647793153,0.6363636363636364
1306,2217,할아버지/Noun,110,67,43,0.0007669223074358119,0.0004997889779870722,0.6090909090909091
1307,2218,탑/Noun,110,66,44,0.0007558074913860174,0.0005108953997201182,0.6
1308,2221,한숨/Noun,109,12,97,0.00015560742469712126,0.0010995357515715587,0.8899082568807339
1309,2222,시끄럽다/Adjective,109,15,94,0.00018895187284650438,0.0010662164863724202,0.8623853211009175
1310,2223,세련되다/Adjective,109,94,15,0.00106702234078026,0.0001888091694617828,0.8623853211009175
1311,2224,고전/Noun,109,80,29,0.0009114149160831386,0.00034429907372442745,0.7339449541284404
1312,2225,삭제/Noun,109,31,78,0.00036678892964321435,0.0008885137386436838,0.7155963302752294
1313,2226,빵빵/Noun,109,77,32,0.0008780704679337558,0.0003776183389235656,0.7064220183486238
1314,2227,졸/Noun,109,33,76,0.00038901856174280313,0.0008663008951775916,0.6972477064220184
1315,2228,철/Noun,109,35,74,0.0004112481938423919,0.0008440880517114996,0.6788990825688074
1316,2233,.^^/Punctuation,108,97,11,0.0011003667889296432,0.0001443834825295986,0.8981481481481481
1317,2234,말고는/Josa,108,11,97,0.0001444926086473269,0.0010995357515715587,0.8981481481481481
1318,2235,십/Modifier,108,76,32,0.0008669556518839612,0.0003776183389235656,0.7037037037037037
1319,2236,그만큼/Adverb,108,76,32,0.0008669556518839612,0.0003776183389235656,0.7037037037037037
1320,2237,최대/Noun,108,37,71,0.0004334778259419807,0.0008107687865123613,0.6574074074074074
1321,2238,언니/Noun,108,69,39,0.0007891519395354007,0.000455363291054888,0.6388888888888888
1322,2239,화의/Noun,108,39,69,0.00045570745804156943,0.0007885559430462694,0.6388888888888888
1323,2240,마이/Noun,108,40,68,0.0004668222740913638,0.0007774495213132232,0.6296296296296297
1324,2241,탈/Noun,108,40,68,0.0004668222740913638,0.0007774495213132232,0.6296296296296297
1325,2242,누나/Noun,108,65,43,0.0007446926753362233,0.0004997889779870722,0.6018518518518519
1326,2243,포스/Noun,108,65,43,0.0007446926753362233,0.0004997889779870722,0.6018518518518519
1327,2248,빈약하다/Adjective,107,12,95,0.00015560742469712126,0.0010773229081054666,0.8878504672897196
1328,2249,떨다/Verb,107,36,71,0.00042236300989218633,0.0008107687865123613,0.6635514018691588
1329,2253,어처구니/Noun,106,11,95,0.0001444926086473269,0.0010773229081054666,0.8962264150943396
1330,2254,..^^/Punctuation,106,92,14,0.0010447927086806713,0.00017770274772873674,0.8679245283018868
1331,2255,중독/Noun,106,87,19,0.0009892186284316995,0.000233234856393967,0.8207547169811321
1332,2256,폐지/Noun,106,30,76,0.00035567411359342004,0.0008663008951775916,0.7169811320754716
1333,2257,치밀하다/Adjective,106,73,33,0.0008336112037345782,0.00038872476065661166,0.6886792452830188
1334,2258,흑/Adverb,106,72,34,0.0008224963876847838,0.00039983118238965764,0.6792452830188679
1335,2263,선동/Noun,105,10,95,0.0001333777925975325,0.0010773229081054666,0.9047619047619048
1336,2264,팔이/Noun,105,11,94,0.0001444926086473269,0.0010662164863724202,0.8952380952380953
1337,2265,여름/Noun,105,85,20,0.0009669889963321108,0.00024434127812701304,0.8095238095238095
1338,2266,안감/Noun,105,22,83,0.000266755585195065,0.000944045847308914,0.7904761904761904
1339,2267,늘어지다/Verb,105,24,81,0.0002889852172946538,0.000921833003842822,0.7714285714285715
1340,2268,또다른/Modifier,105,78,27,0.00088918528398355,0.00032208623025833537,0.7428571428571429
1341,2269,중학교/Noun,105,77,28,0.0008780704679337558,0.0003331926519913814,0.7333333333333333
1342,2270,바탕/Noun,105,73,32,0.0008336112037345782,0.0003776183389235656,0.6952380952380952
1343,2271,목숨/Noun,105,70,35,0.0008002667555851951,0.0004109376041227037,0.6666666666666666
1344,2272,잡/Noun,105,36,69,0.00042236300989218633,0.0007885559430462694,0.6571428571428571
1345,2273,버전/Noun,105,38,67,0.000444592641991775,0.0007663430995801773,0.6380952380952379
1346,2280,끼우다/Verb,104,10,94,0.0001333777925975325,0.0010662164863724202,0.903846153846154
1347,2281,메이드/Noun,104,91,13,0.001033677892630877,0.0001665963259956907,0.875
1348,2282,캬/Noun,104,89,15,0.0010114482605312882,0.0001888091694617828,0.8557692307692307
1349,2283,어쩌/Noun,104,16,88,0.0002000666888962988,0.0009995779559741444,0.8461538461538461
1350,2284,구리/Noun,104,16,88,0.0002000666888962988,0.0009995779559741444,0.8461538461538461
1351,2285,호구/Noun,104,17,87,0.00021118150494609317,0.0009884715342410985,0.8365384615384616
1352,2286,부터가/Josa,104,22,82,0.000266755585195065,0.000932939425575868,0.7884615384615384
1353,2287,하아/Exclamation,104,23,81,0.00027787040124485944,0.000921833003842822,0.7788461538461539
1354,2288,~!!!/Punctuation,104,79,25,0.0009003001000333445,0.0002998733867922433,0.7596153846153846
1355,2289,반갑다/Adjective,104,73,31,0.0008336112037345782,0.00036651191719051963,0.7019230769230769
1356,2290,장국영/Noun,104,73,31,0.0008336112037345782,0.00036651191719051963,0.7019230769230769
1357,2291,졸리/Noun,104,33,71,0.00038901856174280313,0.0008107687865123613,0.6826923076923077
1358,2292,표현/Modifier,104,68,36,0.0007780371234856063,0.0004220440258557498,0.6538461538461539
1359,2293,야구/Noun,104,66,38,0.0007558074913860174,0.0004442568693218419,0.6346153846153846
1360,2294,틱/Suffix,104,39,65,0.00045570745804156943,0.0007441302561140852,0.625
1361,2295,고등학교/Noun,104,65,39,0.0007446926753362233,0.000455363291054888,0.625
1362,2296,따름/Noun,104,41,63,0.0004779370901411582,0.0007219174126479931,0.6057692307692307
1363,2302,내놓다/Verb,103,23,80,0.00027787040124485944,0.000910726582109776,0.7766990291262136
1364,2303,이어서/Josa,103,75,28,0.0008558408358341669,0.0003331926519913814,0.7281553398058253
1365,2304,벌다/Verb,103,29,74,0.0003445592975436257,0.0008440880517114996,0.7184466019417476
1366,2305,로버트/Noun,103,70,33,0.0008002667555851951,0.00038872476065661166,0.6796116504854369
1367,2306,보이지/Noun,103,36,67,0.00042236300989218633,0.0007663430995801773,0.6504854368932039
1368,2307,막다/Verb,103,38,65,0.000444592641991775,0.0007441302561140852,0.6310679611650486
1369,2308,배경음악/Noun,103,64,39,0.0007335778592864287,0.000455363291054888,0.6213592233009708
1370,2309,욕심/Noun,103,39,64,0.00045570745804156943,0.0007330238343810393,0.6213592233009708
1371,2310,웃/Noun,103,64,39,0.0007335778592864287,0.000455363291054888,0.6213592233009708
1372,2314,빵점/Noun,102,2,100,4.445926419917751e-05,0.0011328550167706971,0.9803921568627452
1373,2315,하품/Noun,102,2,100,4.445926419917751e-05,0.0011328550167706971,0.9803921568627452
1374,2316,편안하다/Adjective,102,90,12,0.0010225630765810826,0.00015548990426264466,0.8823529411764706
1375,2317,지경/Noun,102,14,88,0.00017783705679671002,0.0009995779559741444,0.8627450980392157
1376,2318,재미나/Noun,102,87,15,0.0009892186284316995,0.0001888091694617828,0.8529411764705882
1377,2319,조화/Noun,102,82,20,0.0009336445481827276,0.00024434127812701304,0.8039215686274509
1378,2320,곡/Noun,102,78,24,0.00088918528398355,0.0002887669650591972,0.7647058823529411
1379,2321,팔/Modifier,102,24,78,0.0002889852172946538,0.0008885137386436838,0.7647058823529411
1380,2322,로코/Noun,102,75,27,0.0008558408358341669,0.00032208623025833537,0.7352941176470589
1381,2323,숨/Noun,102,75,27,0.0008558408358341669,0.00032208623025833537,0.7352941176470589
1382,2324,곱다/Adjective,102,69,33,0.0007891519395354007,0.00038872476065661166,0.6764705882352942
1383,2325,절정/Noun,102,64,38,0.0007335778592864287,0.0004442568693218419,0.6274509803921569
1384,2326,클레멘타인/Noun,102,39,63,0.00045570745804156943,0.0007219174126479931,0.6176470588235294
1385,2327,끊다/Verb,102,39,63,0.00045570745804156943,0.0007219174126479931,0.6176470588235294
1386,2328,헤어지다/Verb,102,62,40,0.0007113482271868402,0.000466469712787934,0.6078431372549019
1387,2332,인내심/Noun,101,8,93,0.00011114816049794375,0.0010551100646393743,0.9207920792079208
1388,2333,잠시/Noun,101,75,26,0.0008558408358341669,0.00031097980852528933,0.7425742574257426
1389,2334,묻히다/Verb,101,68,33,0.0007780371234856063,0.00038872476065661166,0.6732673267326733
1390,2335,사운드/Noun,101,67,34,0.0007669223074358119,0.00039983118238965764,0.6633663366336634
1391,2336,그동안/Noun,101,65,36,0.0007446926753362233,0.0004220440258557498,0.6435643564356436
1392,2337,린다/Noun,101,64,37,0.0007335778592864287,0.0004331504475887958,0.6336633663366337
1393,2338,조니뎁/Noun,101,63,38,0.0007224630432366343,0.0004442568693218419,0.6237623762376238
1394,2339,틴/Noun,101,40,61,0.0004668222740913638,0.0006997045691819009,0.6039603960396039
1395,2351,앞뒤/Noun,100,11,89,0.0001444926086473269,0.0010106843777071904,0.89
1396,2352,울면/Noun,100,87,13,0.0009892186284316995,0.0001665963259956907,0.87
1397,2353,플롯/Noun,100,29,71,0.0003445592975436257,0.0008107687865123613,0.71
1398,2354,일본인/Noun,100,30,70,0.00035567411359342004,0.0007996623647793153,0.7
1399,2355,........./Punctuation,100,31,69,0.00036678892964321435,0.0007885559430462694,0.69
1400,2356,상관없다/Adjective,100,34,66,0.0004001333777925976,0.0007552366778471312,0.66
1401,2357,만이/Noun,100,37,63,0.0004334778259419807,0.0007219174126479931,0.63
1402,2364,손색/Noun,99,90,9,0.0010225630765810826,0.00012217063906350652,0.9090909090909092
1403,2365,그만하다/Adjective,99,19,80,0.0002334111370456819,0.000910726582109776,0.8080808080808081
1404,2366,현대/Noun,99,72,27,0.0008224963876847838,0.00032208623025833537,0.7272727272727273
1405,2367,끔찍하다/Adjective,99,28,71,0.0003334444814938313,0.0008107687865123613,0.7171717171717171
1406,2368,꼬/Noun,99,31,68,0.00036678892964321435,0.0007774495213132232,0.6868686868686869
1407,2369,케빈/Noun,99,66,33,0.0007558074913860174,0.00038872476065661166,0.6666666666666666
1408,2370,공간/Noun,99,65,34,0.0007446926753362233,0.00039983118238965764,0.6565656565656566
1409,2371,착각/Noun,99,34,65,0.0004001333777925976,0.0007441302561140852,0.6565656565656566
1410,2372,돼지/Noun,99,35,64,0.0004112481938423919,0.0007330238343810393,0.6464646464646465
1411,2381,어디가/Noun,98,16,82,0.0002000666888962988,0.000932939425575868,0.8367346938775511
1412,2382,우뢰매/Noun,98,18,80,0.0002222963209958875,0.000910726582109776,0.8163265306122449
1413,2383,토록/Josa,98,72,26,0.0008224963876847838,0.00031097980852528933,0.7346938775510204
1414,2384,실패하다/Adjective,98,28,70,0.0003334444814938313,0.0007996623647793153,0.7142857142857143
1415,2385,박진/Noun,98,65,33,0.0007446926753362233,0.00038872476065661166,0.6632653061224489
1416,2386,겉/Noun,98,35,63,0.0004112481938423919,0.0007219174126479931,0.6428571428571429
1417,2392,디워/Noun,97,10,87,0.0001333777925975325,0.0009884715342410985,0.8969072164948454
1418,2393,낚시/Noun,97,11,86,0.0001444926086473269,0.000977365112508052,0.8865979381443299
1419,2394,부실하다/Adjective,97,13,84,0.00016672224074691566,0.00095515226904196,0.865979381443299
1420,2395,쓸데없이/Adverb,97,14,83,0.00017783705679671002,0.000944045847308914,0.8556701030927835
1421,2396,사투리/Noun,97,23,74,0.00027787040124485944,0.0008440880517114996,0.7628865979381443
1422,2397,교과서/Noun,97,73,24,0.0008336112037345782,0.0002887669650591972,0.7525773195876289
1423,2398,밝다/Verb,97,71,26,0.0008113815716349895,0.00031097980852528933,0.7319587628865979
1424,2399,이군/Noun,97,33,64,0.00038901856174280313,0.0007330238343810393,0.6597938144329897
1425,2405,자고/Noun,96,11,85,0.0001444926086473269,0.0009662586907750061,0.8854166666666666
1426,2406,심형래/Noun,96,13,83,0.00016672224074691566,0.000944045847308914,0.8645833333333334
1427,2407,여친/Noun,96,23,73,0.00027787040124485944,0.0008329816299784535,0.7604166666666666
1428,2408,제임스/Noun,96,70,26,0.0008002667555851951,0.00031097980852528933,0.7291666666666666
1429,2409,일부러/Noun,96,28,68,0.0003334444814938313,0.0007774495213132232,0.7083333333333334
1430,2410,유덕화/Noun,96,66,30,0.0007558074913860174,0.0003554054954574735,0.6875
1431,2411,호기심/Noun,96,30,66,0.00035567411359342004,0.0007552366778471312,0.6875
1432,2412,너무도/Adverb,96,63,33,0.0007224630432366343,0.00038872476065661166,0.65625
1433,2413,대결/Noun,96,61,35,0.0007002334111370457,0.0004109376041227037,0.6354166666666666
1434,2414,대통령/Noun,96,38,58,0.000444592641991775,0.0006663853039827628,0.6041666666666666
1435,2419,체적/Noun,95,10,85,0.0001333777925975325,0.0009662586907750061,0.8947368421052632
1436,2420,이만/Noun,95,82,13,0.0009336445481827276,0.0001665963259956907,0.8631578947368421
1437,2421,팔/Noun,95,16,79,0.0002000666888962988,0.0008996201603767299,0.8315789473684211
1438,2422,듭니/Noun,95,77,18,0.0008780704679337558,0.00022212843466092096,0.8105263157894737
1439,2423,여자애/Noun,95,21,74,0.00025564076914527065,0.0008440880517114996,0.7789473684210526
1440,2424,던데/Noun,95,26,69,0.00031121484939424253,0.0007885559430462694,0.7263157894736842
1441,2425,당황/Noun,95,26,69,0.00031121484939424253,0.0007885559430462694,0.7263157894736842
1442,2426,꽃/Noun,95,68,27,0.0007780371234856063,0.00032208623025833537,0.7157894736842105
1443,2427,에다/Josa,95,28,67,0.0003334444814938313,0.0007663430995801773,0.7052631578947368
1444,2428,평균/Noun,95,28,67,0.0003334444814938313,0.0007663430995801773,0.7052631578947368
1445,2429,조카/Noun,95,66,29,0.0007558074913860174,0.00034429907372442745,0.6947368421052632
1446,2430,100%/Number,95,62,33,0.0007113482271868402,0.00038872476065661166,0.6526315789473685
1447,2431,겁/Noun,95,33,62,0.00038901856174280313,0.000710810990914947,0.6526315789473685
1448,2432,선정/Noun,95,33,62,0.00038901856174280313,0.000710810990914947,0.6526315789473685
1449,2433,잡고/Noun,95,38,57,0.000444592641991775,0.0006552788822497168,0.6
1450,2441,겨울/Noun,94,77,17,0.0008780704679337558,0.0002110220129278749,0.8191489361702128
1451,2442,말투/Noun,94,24,70,0.0002889852172946538,0.0007996623647793153,0.7446808510638298
1452,2443,상실/Noun,94,24,70,0.0002889852172946538,0.0007996623647793153,0.7446808510638298
1453,2444,ㅈ/KoreanParticle,94,27,67,0.00032232966544403684,0.0007663430995801773,0.7127659574468085
1454,2445,베드/Noun,94,29,65,0.0003445592975436257,0.0007441302561140852,0.6914893617021277
1455,2446,에게도/Josa,94,65,29,0.0007446926753362233,0.00034429907372442745,0.6914893617021277
1456,2447,루즈/Noun,94,34,60,0.0004001333777925976,0.0006885981474488549,0.6382978723404256
1457,2448,난리/Noun,94,34,60,0.0004001333777925976,0.0006885981474488549,0.6382978723404256
1458,2449,주지/Noun,94,36,58,0.00042236300989218633,0.0006663853039827628,0.6170212765957447
1459,2455,류작/Noun,93,5,88,7.780371234856063e-05,0.0009995779559741444,0.946236559139785
1460,2456,도무지/Noun,93,7,86,0.0001000333444481494,0.000977365112508052,0.9247311827956988
1461,2457,I/Alpha,93,76,17,0.0008669556518839612,0.0002110220129278749,0.8172043010752689
1462,2458,녹다/Verb,93,76,17,0.0008669556518839612,0.0002110220129278749,0.8172043010752689
1463,2459,성의/Noun,93,23,70,0.00027787040124485944,0.0007996623647793153,0.7526881720430108
1464,2460,차갑다/Adjective,93,68,25,0.0007780371234856063,0.0002998733867922433,0.7311827956989247
1465,2461,애초/Noun,93,30,63,0.00035567411359342004,0.0007219174126479931,0.6774193548387096
1466,2462,반대/Noun,93,32,61,0.00037790374569300877,0.0006997045691819009,0.6559139784946236
1467,2463,거치다/Verb,93,61,32,0.0007002334111370457,0.0003776183389235656,0.6559139784946236
1468,2464,무난/Noun,93,34,59,0.0004001333777925976,0.0006774917257158089,0.6344086021505376
1469,2465,단체/Noun,93,34,59,0.0004001333777925976,0.0006774917257158089,0.6344086021505376
1470,2473,수입/Noun,92,12,80,0.00015560742469712126,0.000910726582109776,0.8695652173913043
1471,2474,처절하다/Adjective,92,74,18,0.0008447260197843727,0.00022212843466092096,0.8043478260869565
1472,2475,딴/Modifier,92,19,73,0.0002334111370456819,0.0008329816299784535,0.7934782608695652
1473,2476,컨셉/Noun,92,20,72,0.00024452595309547634,0.0008218752082454075,0.7826086956521741
1474,2477,고프다/Adjective,92,71,21,0.0008113815716349895,0.0002554476998600591,0.7717391304347826
1475,2478,절/Noun,92,23,69,0.00027787040124485944,0.0007885559430462694,0.75
1476,2479,드디어/Adverb,92,68,24,0.0007780371234856063,0.0002887669650591972,0.7391304347826086
1477,2480,흥/Noun,92,66,26,0.0007558074913860174,0.00031097980852528933,0.7173913043478259
1478,2481,반드시/Noun,92,65,27,0.0007446926753362233,0.00032208623025833537,0.7065217391304348
1479,2482,진수/Noun,92,64,28,0.0007335778592864287,0.0003331926519913814,0.6956521739130435
1480,2483,쥐다/Verb,92,34,58,0.0004001333777925976,0.0006663853039827628,0.6304347826086957
1481,2484,13/Number,92,34,58,0.0004001333777925976,0.0006663853039827628,0.6304347826086957
1482,2485,대사도/Noun,92,35,57,0.0004112481938423919,0.0006552788822497168,0.6195652173913043
1483,2495,웰/Noun,91,86,5,0.0009781038123819054,7.774495213132233e-05,0.9450549450549449
1484,2496,어우러지다/Verb,91,85,6,0.0009669889963321108,8.885137386436837e-05,0.934065934065934
1485,2497,만드/Noun,91,14,77,0.00017783705679671002,0.0008774073169106378,0.8461538461538461
1486,2498,혐오/Noun,91,15,76,0.00018895187284650438,0.0008663008951775916,0.8351648351648352
1487,2499,명대사/Noun,91,72,19,0.0008224963876847838,0.000233234856393967,0.7912087912087912
1488,2500,살인마/Noun,91,21,70,0.00025564076914527065,0.0007996623647793153,0.7692307692307693
1489,2501,실수/Noun,91,25,66,0.00030010003334444816,0.0007552366778471312,0.7252747252747253
1490,2502,베리/Noun,91,65,26,0.0007446926753362233,0.00031097980852528933,0.7142857142857143
1491,2503,비중/Noun,91,30,61,0.00035567411359342004,0.0006997045691819009,0.6703296703296703
1492,2504,무게/Noun,91,60,31,0.0006891185950872514,0.00036651191719051963,0.6593406593406593
1493,2505,잭/Noun,91,60,31,0.0006891185950872514,0.00036651191719051963,0.6593406593406593
1494,2506,붙다/Verb,91,31,60,0.00036678892964321435,0.0006885981474488549,0.6593406593406593
1495,2507,........../Punctuation,91,34,57,0.0004001333777925976,0.0006552788822497168,0.6263736263736264
1496,2508,영향/Noun,91,56,35,0.0006446593308880737,0.0004109376041227037,0.6153846153846154
1497,2514,계기/Noun,90,72,18,0.0008224963876847838,0.00022212843466092096,0.8
1498,2515,논리/Noun,90,20,70,0.00024452595309547634,0.0007996623647793153,0.7777777777777778
1499,2516,최고봉/Noun,90,68,22,0.0007780371234856063,0.00026655412159310506,0.7555555555555555
1500,2517,운/Noun,90,65,25,0.0007446926753362233,0.0002998733867922433,0.7222222222222222
1501,2518,어떻/Modifier,90,25,65,0.00030010003334444816,0.0007441302561140852,0.7222222222222222
1502,2519,레/Noun,90,25,65,0.00030010003334444816,0.0007441302561140852,0.7222222222222222
1503,2520,암/Modifier,90,26,64,0.00031121484939424253,0.0007330238343810393,0.7111111111111111
1504,2521,매일/Noun,90,62,28,0.0007113482271868402,0.0003331926519913814,0.6888888888888889
1505,2522,쿡/Noun,90,30,60,0.00035567411359342004,0.0006885981474488549,0.6666666666666666
1506,2523,깍/Adverb,90,31,59,0.00036678892964321435,0.0006774917257158089,0.6555555555555556
1507,2524,및/Noun,90,31,59,0.00036678892964321435,0.0006774917257158089,0.6555555555555556
1508,2525,데뷔/Noun,90,59,31,0.0006780037790374569,0.00036651191719051963,0.6555555555555556
1509,2526,걱정/Noun,90,58,32,0.0006668889629876625,0.0003776183389235656,0.6444444444444445
1510,2527,다/Noun,90,33,57,0.00038901856174280313,0.0006552788822497168,0.6333333333333333
1511,2528,여자친구/Noun,90,33,57,0.00038901856174280313,0.0006552788822497168,0.6333333333333333
1512,2529,동성애/Noun,90,35,55,0.0004112481938423919,0.0006330660387836247,0.6111111111111112
1513,2535,게뭐/Noun,89,7,82,0.0001000333444481494,0.000932939425575868,0.9213483146067416
1514,2536,감사/Noun,89,78,11,0.00088918528398355,0.0001443834825295986,0.8764044943820225
1515,2537,빨갱이/Noun,89,18,71,0.0002222963209958875,0.0008107687865123613,0.797752808988764
1516,2538,ㅉ/KoreanParticle,89,18,71,0.0002222963209958875,0.0008107687865123613,0.797752808988764
1517,2539,강력/Noun,89,70,19,0.0008002667555851951,0.000233234856393967,0.7865168539325843
1518,2540,아무튼/Adverb,89,62,27,0.0007113482271868402,0.00032208623025833537,0.6966292134831461
1519,2541,섞다/Verb,89,28,61,0.0003334444814938313,0.0006997045691819009,0.6853932584269663
1520,2542,박중훈/Noun,89,58,31,0.0006668889629876625,0.00036651191719051963,0.651685393258427
1521,2543,폭발/Noun,89,58,31,0.0006668889629876625,0.00036651191719051963,0.651685393258427
1522,2544,각색/Noun,89,32,57,0.00037790374569300877,0.0006552788822497168,0.6404494382022472
1523,2545,포/Noun,89,33,56,0.00038901856174280313,0.0006441724605166707,0.6292134831460674
1524,2546,dvd/Alpha,89,56,33,0.0006446593308880737,0.00038872476065661166,0.6292134831460674
1525,2547,부작/Noun,89,55,34,0.0006335445148382794,0.00039983118238965764,0.6179775280898876
1526,2548,ㄴ/KoreanParticle,89,34,55,0.0004001333777925976,0.0006330660387836247,0.6179775280898876
1527,2549,필/Noun,89,35,54,0.0004112481938423919,0.0006219596170505788,0.6067415730337079
1528,2557,개그맨/Noun,88,4,84,6.668889629876625e-05,0.00095515226904196,0.9545454545454546
1529,2558,마음속/Noun,88,83,5,0.0009447593642325221,7.774495213132233e-05,0.9431818181818182
1530,2559,ㅄ/KoreanParticle,88,15,73,0.00018895187284650438,0.0008329816299784535,0.8295454545454546
1531,2560,동심/Noun,88,64,24,0.0007335778592864287,0.0002887669650591972,0.7272727272727273
1532,2561,폴/Noun,88,64,24,0.0007335778592864287,0.0002887669650591972,0.7272727272727273
1533,2562,피해/Noun,88,24,64,0.0002889852172946538,0.0007330238343810393,0.7272727272727273
1534,2563,에이/Noun,88,26,62,0.00031121484939424253,0.000710810990914947,0.7045454545454546
1535,2564,만화책/Noun,88,26,62,0.00031121484939424253,0.000710810990914947,0.7045454545454546
1536,2565,?.../Punctuation,88,30,58,0.00035567411359342004,0.0006663853039827628,0.6590909090909091
1537,2566,출신/Noun,88,33,55,0.00038901856174280313,0.0006330660387836247,0.625
1538,2567,ㅣ/KoreanParticle,88,34,54,0.0004001333777925976,0.0006219596170505788,0.6136363636363636
1539,2568,끝내/Noun,88,34,54,0.0004001333777925976,0.0006219596170505788,0.6136363636363636
1540,2569,부정/Noun,88,54,34,0.0006224296987884852,0.00039983118238965764,0.6136363636363636
1541,2577,♥♥♥/Foreign,87,86,1,0.0009781038123819054,3.331926519913814e-05,0.9885057471264368
1542,2578,어거지/Noun,87,8,79,0.00011114816049794375,0.0008996201603767299,0.9080459770114944
1543,2579,난잡하다/Adjective,87,8,79,0.00011114816049794375,0.0008996201603767299,0.9080459770114944
1544,2580,발음/Noun,87,17,70,0.00021118150494609317,0.0007996623647793153,0.8045977011494253
1545,2581,듣기/Noun,87,21,66,0.00025564076914527065,0.0007552366778471312,0.7586206896551724
1546,2582,친/Noun,87,25,62,0.00030010003334444816,0.000710810990914947,0.7126436781609196
1547,2583,무한/Noun,87,60,27,0.0006891185950872514,0.00032208623025833537,0.6896551724137931
1548,2584,배신/Noun,87,32,55,0.00037790374569300877,0.0006330660387836247,0.632183908045977
1549,2585,알아보다/Verb,87,33,54,0.00038901856174280313,0.0006219596170505788,0.6206896551724138
1550,2586,하니/Noun,87,34,53,0.0004001333777925976,0.0006108531953175326,0.6091954022988506
1551,2596,토나오다/Verb,86,4,82,6.668889629876625e-05,0.000932939425575868,0.9534883720930232
1552,2597,별하나/Noun,86,4,82,6.668889629876625e-05,0.000932939425575868,0.9534883720930232
1553,2598,다세포/Noun,86,8,78,0.00011114816049794375,0.0008885137386436838,0.9069767441860463
1554,2599,개콘/Noun,86,9,77,0.00012226297654773814,0.0008774073169106378,0.8953488372093024
1555,2600,황당/Noun,86,9,77,0.00012226297654773814,0.0008774073169106378,0.8953488372093024
1556,2601,영화감독/Noun,86,14,72,0.00017783705679671002,0.0008218752082454075,0.8372093023255814
1557,2602,언니/Suffix,86,70,16,0.0008002667555851951,0.00019991559119482882,0.813953488372093
1558,2603,최소한/Noun,86,18,68,0.0002222963209958875,0.0007774495213132232,0.7906976744186046
1559,2604,컴퓨터/Noun,86,20,66,0.00024452595309547634,0.0007552366778471312,0.7674418604651163
1560,2605,경우/Noun,86,27,59,0.00032232966544403684,0.0006774917257158089,0.686046511627907
1561,2606,해리포터/Noun,86,57,29,0.0006557741469378681,0.00034429907372442745,0.6627906976744186
1562,2607,추/Noun,86,56,30,0.0006446593308880737,0.0003554054954574735,0.6511627906976745
1563,2608,나레이션/Noun,86,30,56,0.00035567411359342004,0.0006441724605166707,0.6511627906976745
1564,2609,손가락/Noun,86,53,33,0.0006113148827386907,0.00038872476065661166,0.6162790697674418
1565,2610,거장/Noun,86,52,34,0.0006002000666888963,0.00039983118238965764,0.6046511627906976
1566,2621,겉멋/Noun,85,7,78,0.0001000333444481494,0.0008885137386436838,0.9176470588235294
1567,2622,싫어지다/Adjective,85,9,76,0.00012226297654773814,0.0008663008951775916,0.8941176470588236
1568,2623,압도/Noun,85,75,10,0.0008558408358341669,0.00013327706079655256,0.8823529411764706
1569,2624,담담하다/Adjective,85,71,14,0.0008113815716349895,0.00017770274772873674,0.8352941176470589
1570,2625,누군지/Adverb,85,21,64,0.00025564076914527065,0.0007330238343810393,0.7529411764705882
1571,2626,딱/VerbPrefix,85,23,62,0.00027787040124485944,0.000710810990914947,0.7294117647058823
1572,2627,정말/Exclamation,85,60,25,0.0006891185950872514,0.0002998733867922433,0.7058823529411765
1573,2628,여인/Noun,85,57,28,0.0006557741469378681,0.0003331926519913814,0.6705882352941176
1574,2629,환경/Noun,85,55,30,0.0006335445148382794,0.0003554054954574735,0.6470588235294118
1575,2630,곧/Noun,85,54,31,0.0006224296987884852,0.00036651191719051963,0.6352941176470588
1576,2631,ㄷ/KoreanParticle,85,54,31,0.0006224296987884852,0.00036651191719051963,0.6352941176470588
1577,2632,찌질하다/Adjective,85,33,52,0.00038901856174280313,0.0005997467735844866,0.611764705882353
1578,2633,누르다/Verb,85,34,51,0.0004001333777925976,0.0005886403518514405,0.6
1579,2636,깨알/Noun,84,76,8,0.0008669556518839612,0.00011106421733046048,0.9047619047619048
1580,2637,민폐/Noun,84,11,73,0.0001444926086473269,0.0008329816299784535,0.8690476190476191
1581,2638,쓸데없다/Adjective,84,14,70,0.00017783705679671002,0.0007996623647793153,0.8333333333333334
1582,2639,부리다/Verb,84,17,67,0.00021118150494609317,0.0007663430995801773,0.7976190476190477
1583,2640,이루어지다/Verb,84,66,18,0.0007558074913860174,0.00022212843466092096,0.7857142857142857
1584,2641,--/Punctuation,84,19,65,0.0002334111370456819,0.0007441302561140852,0.7738095238095238
1585,2642,어쩌면/Noun,84,62,22,0.0007113482271868402,0.00026655412159310506,0.7380952380952381
1586,2643,임창정/Noun,84,58,26,0.0006668889629876625,0.00031097980852528933,0.6904761904761905
1587,2644,화일/Noun,84,26,58,0.00031121484939424253,0.0006663853039827628,0.6904761904761905
1588,2645,성적/Noun,84,32,52,0.00037790374569300877,0.0005997467735844866,0.6190476190476191
1589,2654,..!/Punctuation,83,74,9,0.0008447260197843727,0.00012217063906350652,0.891566265060241
1590,2655,흉내/Noun,83,11,72,0.0001444926086473269,0.0008218752082454075,0.8674698795180723
1591,2656,달콤하다/Adjective,83,68,15,0.0007780371234856063,0.0001888091694617828,0.8192771084337349
1592,2657,방해/Noun,83,18,65,0.0002222963209958875,0.0007441302561140852,0.7831325301204819
1593,2658,김치/Noun,83,22,61,0.000266755585195065,0.0006997045691819009,0.7349397590361446
1594,2659,분량/Noun,83,25,58,0.00030010003334444816,0.0006663853039827628,0.6987951807228916
1595,2660,향수/Noun,83,57,26,0.0006557741469378681,0.00031097980852528933,0.6867469879518072
1596,2661,코메디/Noun,83,27,56,0.00032232966544403684,0.0006441724605166707,0.6746987951807228
1597,2662,사/Noun,83,56,27,0.0006446593308880737,0.00032208623025833537,0.6746987951807228
1598,2663,매/Noun,83,53,30,0.0006113148827386907,0.0003554054954574735,0.6385542168674698
1599,2664,판이/Noun,83,33,50,0.00038901856174280313,0.0005775339301183945,0.6024096385542169
1600,2672,명복/Noun,82,74,8,0.0008447260197843727,0.00011106421733046048,0.902439024390244
1601,2673,거품/Noun,82,12,70,0.00015560742469712126,0.0007996623647793153,0.8536585365853658
1602,2674,동영상/Noun,82,12,70,0.00015560742469712126,0.0007996623647793153,0.8536585365853658
1603,2675,고뇌/Noun,82,57,25,0.0006557741469378681,0.0002998733867922433,0.6951219512195121
1604,2676,늘리다/Verb,82,25,57,0.00030010003334444816,0.0006552788822497168,0.6951219512195121
1605,2677,능/Noun,82,55,27,0.0006335445148382794,0.00032208623025833537,0.6707317073170732
1606,2678,흡입/Noun,82,53,29,0.0006113148827386907,0.00034429907372442745,0.6463414634146342
1607,2679,윌리스/Noun,82,29,53,0.0003445592975436257,0.0006108531953175326,0.6463414634146342
1608,2680,때매/Noun,82,30,52,0.00035567411359342004,0.0005997467735844866,0.6341463414634146
1609,2681,인도/Noun,82,51,31,0.000589085250639102,0.00036651191719051963,0.6219512195121951
1610,2682,잡히다/Verb,82,31,51,0.00036678892964321435,0.0005886403518514405,0.6219512195121951
1611,2683,매끄럽다/Adjective,82,32,50,0.00037790374569300877,0.0005775339301183945,0.6097560975609756
1612,2684,든지/Josa,82,32,50,0.00037790374569300877,0.0005775339301183945,0.6097560975609756
1613,2693,탁월하다/Adjective,81,73,8,0.0008336112037345782,0.00011106421733046048,0.9012345679012346
1614,2694,도데/Noun,81,8,73,0.00011114816049794375,0.0008329816299784535,0.9012345679012346
1615,2695,짜리/Foreign,81,12,69,0.00015560742469712126,0.0007885559430462694,0.8518518518518519
1616,2696,속지/Noun,81,13,68,0.00016672224074691566,0.0007774495213132232,0.8395061728395061
1617,2697,역량/Noun,81,13,68,0.00016672224074691566,0.0007774495213132232,0.8395061728395061
1618,2698,배급사/Noun,81,15,66,0.00018895187284650438,0.0007552366778471312,0.8148148148148148
1619,2699,징그럽다/Adjective,81,17,64,0.00021118150494609317,0.0007330238343810393,0.7901234567901234
1620,2700,이해도/Noun,81,17,64,0.00021118150494609317,0.0007330238343810393,0.7901234567901234
1621,2701,염/Noun,81,60,21,0.0006891185950872514,0.0002554476998600591,0.7407407407407407
1622,2702,몽환/Noun,81,59,22,0.0006780037790374569,0.00026655412159310506,0.7283950617283951
1623,2703,박다/Verb,81,22,59,0.000266755585195065,0.0006774917257158089,0.7283950617283951
1624,2704,짜이다/Verb,81,56,25,0.0006446593308880737,0.0002998733867922433,0.6913580246913579
1625,2705,약/Modifier,81,26,55,0.00031121484939424253,0.0006330660387836247,0.6790123456790124
1626,2706,그렇지만/Conjunction,81,55,26,0.0006335445148382794,0.00031097980852528933,0.6790123456790124
1627,2707,옴/Noun,81,26,55,0.00031121484939424253,0.0006330660387836247,0.6790123456790124
1628,2708,실험/Noun,81,29,52,0.0003445592975436257,0.0005997467735844866,0.6419753086419753
1629,2709,극복/Noun,81,51,30,0.000589085250639102,0.0003554054954574735,0.6296296296296297
1630,2710,사용/Noun,81,31,50,0.00036678892964321435,0.0005775339301183945,0.6172839506172839
1631,2711,1회/Number,81,49,32,0.0005668556185395131,0.0003776183389235656,0.6049382716049383
1632,2722,담백하다/Adjective,80,75,5,0.0008558408358341669,7.774495213132233e-05,0.9375
1633,2723,삶다/Verb,80,68,12,0.0007780371234856063,0.00015548990426264466,0.85
1634,2724,가히/Adverb,80,68,12,0.0007780371234856063,0.00015548990426264466,0.85
1635,2725,지리다/Verb,80,63,17,0.0007224630432366343,0.0002110220129278749,0.7875
1636,2726,킬링/Noun,80,22,58,0.000266755585195065,0.0006663853039827628,0.725
1637,2727,장점/Noun,80,23,57,0.00027787040124485944,0.0006552788822497168,0.7125
1638,2728,등록/Noun,80,23,57,0.00027787040124485944,0.0006552788822497168,0.7125
1639,2729,망가지다/Verb,80,26,54,0.00031121484939424253,0.0006219596170505788,0.675
1640,2730,하정우/Noun,80,53,27,0.0006113148827386907,0.00032208623025833537,0.6625
1641,2731,미녀/Noun,80,30,50,0.00035567411359342004,0.0005775339301183945,0.625
1642,2732,독일/Noun,80,48,32,0.0005557408024897189,0.0003776183389235656,0.6
1643,2744,완벽/Noun,79,71,8,0.0008113815716349895,0.00011106421733046048,0.8987341772151899
1644,2745,그럴듯하다/Adjective,79,8,71,0.00011114816049794375,0.0008107687865123613,0.8987341772151899
1645,2746,의외/Noun,79,65,14,0.0007446926753362233,0.00017770274772873674,0.8227848101265823
1646,2747,딱/Modifier,79,16,63,0.0002000666888962988,0.0007219174126479931,0.7974683544303798
1647,2748,분장/Noun,79,17,62,0.00021118150494609317,0.000710810990914947,0.7848101265822784
1648,2749,언젠가/Adverb,79,59,20,0.0006780037790374569,0.00024434127812701304,0.7468354430379747
1649,2750,파다/Verb,79,24,55,0.0002889852172946538,0.0006330660387836247,0.6962025316455697
1650,2751,샘/Noun,79,53,26,0.0006113148827386907,0.00031097980852528933,0.6708860759493671
1651,2752,중딩/Noun,79,27,52,0.00032232966544403684,0.0005997467735844866,0.6582278481012658
1652,2753,정상/Noun,79,27,52,0.00032232966544403684,0.0005997467735844866,0.6582278481012658
1653,2754,에다가/Josa,79,29,50,0.0003445592975436257,0.0005775339301183945,0.6329113924050633
1654,2755,라기/Josa,79,30,49,0.00035567411359342004,0.0005664275083853486,0.620253164556962
1655,2756,미도/Noun,79,48,31,0.0005557408024897189,0.00036651191719051963,0.6075949367088608
1656,2757,of/Alpha,79,48,31,0.0005557408024897189,0.00036651191719051963,0.6075949367088608
1657,2762,위트/Noun,78,66,12,0.0007558074913860174,0.00015548990426264466,0.8461538461538461
1658,2763,치유/Noun,78,66,12,0.0007558074913860174,0.00015548990426264466,0.8461538461538461
1659,2764,아치/Noun,78,14,64,0.00017783705679671002,0.0007330238343810393,0.8205128205128205
1660,2765,만도/Josa,78,15,63,0.00018895187284650438,0.0007219174126479931,0.8076923076923077
1661,2766,애절하다/Adjective,78,62,16,0.0007113482271868402,0.00019991559119482882,0.7948717948717948
1662,2767,알려지다/Verb,78,58,20,0.0006668889629876625,0.00024434127812701304,0.7435897435897436
1663,2768,이구만/Josa,78,20,58,0.00024452595309547634,0.0006663853039827628,0.7435897435897436
1664,2769,왜곡/Noun,78,22,56,0.000266755585195065,0.0006441724605166707,0.7179487179487181
1665,2770,상어/Noun,78,25,53,0.00030010003334444816,0.0006108531953175326,0.6794871794871795
1666,2771,절망/Noun,78,53,25,0.0006113148827386907,0.0002998733867922433,0.6794871794871795
1667,2772,서부/Noun,78,50,28,0.0005779704345893076,0.0003331926519913814,0.6410256410256411
1668,2773,허허/Adverb,78,29,49,0.0003445592975436257,0.0005664275083853486,0.6282051282051282
1669,2774,계시다/Adjective,78,49,29,0.0005668556185395131,0.00034429907372442745,0.6282051282051282
1670,2775,칠/Modifier,78,29,49,0.0003445592975436257,0.0005664275083853486,0.6282051282051282
1671,2776,라스트/Noun,78,48,30,0.0005557408024897189,0.0003554054954574735,0.6153846153846154
1672,2777,컷/Noun,78,30,48,0.00035567411359342004,0.0005553210866523023,0.6153846153846154
1673,2778,무리/Noun,78,30,48,0.00035567411359342004,0.0005553210866523023,0.6153846153846154
1674,2779,한순간/Noun,78,48,30,0.0005557408024897189,0.0003554054954574735,0.6153846153846154
1675,2780,서도/Noun,78,47,31,0.0005446259864399244,0.00036651191719051963,0.6025641025641025
1676,2781,최소/Noun,78,47,31,0.0005446259864399244,0.00036651191719051963,0.6025641025641025
1677,2785,뒤죽박죽/Noun,77,9,68,0.00012226297654773814,0.0007774495213132232,0.8831168831168831
1678,2786,절제/Noun,77,64,13,0.0007335778592864287,0.0001665963259956907,0.8311688311688312
1679,2787,소화/Noun,77,62,15,0.0007113482271868402,0.0001888091694617828,0.8051948051948052
1680,2788,떠올리다/Verb,77,62,15,0.0007113482271868402,0.0001888091694617828,0.8051948051948052
1681,2789,찬양/Noun,77,19,58,0.0002334111370456819,0.0006663853039827628,0.7532467532467533
1682,2790,내일/Noun,77,56,21,0.0006446593308880737,0.0002554476998600591,0.7272727272727273
1683,2791,닥/Noun,77,21,56,0.00025564076914527065,0.0006441724605166707,0.7272727272727273
1684,2792,난무/Noun,77,22,55,0.000266755585195065,0.0006330660387836247,0.7142857142857143
1685,2793,낼/Noun,77,53,24,0.0006113148827386907,0.0002887669650591972,0.6883116883116883
1686,2794,동네/Noun,77,29,48,0.0003445592975436257,0.0005553210866523023,0.6233766233766234
1687,2806,매미/Noun,76,4,72,6.668889629876625e-05,0.0008218752082454075,0.9473684210526316
1688,2807,뜬금없이/Adverb,76,4,72,6.668889629876625e-05,0.0008218752082454075,0.9473684210526316
1689,2808,미스/Noun,76,13,63,0.00016672224074691566,0.0007219174126479931,0.8289473684210527
1690,2809,욕먹다/Verb,76,13,63,0.00016672224074691566,0.0007219174126479931,0.8289473684210527
1691,2810,보임/Noun,76,16,60,0.0002000666888962988,0.0006885981474488549,0.7894736842105263
1692,2811,버티다/Verb,76,17,59,0.00021118150494609317,0.0006774917257158089,0.7763157894736842
1693,2812,전성기/Noun,76,59,17,0.0006780037790374569,0.0002110220129278749,0.7763157894736842
1694,2813,ㅎㄷㄷ/KoreanParticle,76,55,21,0.0006335445148382794,0.0002554476998600591,0.7236842105263158
1695,2814,범/Noun,76,22,54,0.000266755585195065,0.0006219596170505788,0.7105263157894737
1696,2815,달라지다/Verb,76,53,23,0.0006113148827386907,0.00027766054332615115,0.6973684210526315
1697,2816,리가/Noun,76,24,52,0.0002889852172946538,0.0005997467735844866,0.6842105263157895
1698,2817,년도/Noun,76,25,51,0.00030010003334444816,0.0005886403518514405,0.6710526315789473
1699,2818,각자/Noun,76,50,26,0.0005779704345893076,0.00031097980852528933,0.6578947368421053
1700,2819,그대/Noun,76,50,26,0.0005779704345893076,0.00031097980852528933,0.6578947368421053
1701,2820,하라/Noun,76,28,48,0.0003334444814938313,0.0005553210866523023,0.631578947368421
1702,2821,글자/Noun,76,28,48,0.0003334444814938313,0.0005553210866523023,0.631578947368421
1703,2822,하고는/Josa,76,29,47,0.0003445592975436257,0.0005442146649192564,0.618421052631579
1704,2823,절대로/Noun,76,29,47,0.0003445592975436257,0.0005442146649192564,0.618421052631579
1705,2824,끼치다/Verb,76,46,30,0.00053351117039013,0.0003554054954574735,0.6052631578947368
1706,2825,형식/Noun,76,30,46,0.00035567411359342004,0.0005331082431862101,0.6052631578947368
1707,2834,과대/Noun,75,5,70,7.780371234856063e-05,0.0007996623647793153,0.9333333333333332
1708,2835,도중/Noun,75,7,68,0.0001000333444481494,0.0007774495213132232,0.9066666666666666
1709,2836,따분하다/Adjective,75,8,67,0.00011114816049794375,0.0007663430995801773,0.8933333333333333
1710,2837,여신/Noun,75,61,14,0.0007002334111370457,0.00017770274772873674,0.8133333333333334
1711,2838,낭만/Noun,75,57,18,0.0006557741469378681,0.00022212843466092096,0.76
1712,2839,선사/Noun,75,54,21,0.0006224296987884852,0.0002554476998600591,0.72
1713,2840,꺼지다/Verb,75,24,51,0.0002889852172946538,0.0005886403518514405,0.68
1714,2841,폭풍/Noun,75,51,24,0.000589085250639102,0.0002887669650591972,0.68
1715,2842,공룡/Noun,75,26,49,0.00031121484939424253,0.0005664275083853486,0.6533333333333333
1716,2843,급하다/Adjective,75,26,49,0.00031121484939424253,0.0005664275083853486,0.6533333333333333
1717,2844,잔혹하다/Adjective,75,48,27,0.0005557408024897189,0.00032208623025833537,0.64
1718,2845,빠/Noun,75,27,48,0.00032232966544403684,0.0005553210866523023,0.64
1719,2846,소통/Noun,75,47,28,0.0005446259864399244,0.0003331926519913814,0.6266666666666667
1720,2847,추가/Noun,75,28,47,0.0003334444814938313,0.0005442146649192564,0.6266666666666667
1721,2848,년전/Noun,75,45,30,0.0005223963543403357,0.0003554054954574735,0.6
1722,2849,식이/Noun,75,30,45,0.00035567411359342004,0.0005220018214531642,0.6
1723,2850,1년/Number,75,45,30,0.0005223963543403357,0.0003554054954574735,0.6
1724,2851,축구/Noun,75,30,45,0.00035567411359342004,0.0005220018214531642,0.6
1725,2858,바닥/Noun,74,9,65,0.00012226297654773814,0.0007441302561140852,0.8783783783783784
1726,2859,졸업/Noun,74,14,60,0.00017783705679671002,0.0006885981474488549,0.8108108108108109
1727,2860,어지럽다/Adjective,74,16,58,0.0002000666888962988,0.0006663853039827628,0.7837837837837838
1728,2861,EBS/Alpha,74,57,17,0.0006557741469378681,0.0002110220129278749,0.7702702702702703
1729,2862,끊기다/Verb,74,17,57,0.00021118150494609317,0.0006552788822497168,0.7702702702702703
1730,2863,웬/Noun,74,19,55,0.0002334111370456819,0.0006330660387836247,0.7432432432432432
1731,2864,지나/Noun,74,53,21,0.0006113148827386907,0.0002554476998600591,0.7162162162162162
1732,2865,딸리다/Verb,74,22,52,0.000266755585195065,0.0005997467735844866,0.7027027027027027
1733,2866,드니/Noun,74,51,23,0.000589085250639102,0.00027766054332615115,0.6891891891891891
1734,2867,한가지/Noun,74,23,51,0.00027787040124485944,0.0005886403518514405,0.6891891891891891
1735,2868,거짓/Noun,74,24,50,0.0002889852172946538,0.0005775339301183945,0.6756756756756757
1736,2869,송강호/Noun,74,50,24,0.0005779704345893076,0.0002887669650591972,0.6756756756756757
1737,2870,재난/Noun,74,25,49,0.00030010003334444816,0.0005664275083853486,0.6621621621621622
1738,2871,워낙/Noun,74,49,25,0.0005668556185395131,0.0002998733867922433,0.6621621621621622
1739,2872,a/Alpha,74,48,26,0.0005557408024897189,0.00031097980852528933,0.6486486486486487
1740,2873,가나/Noun,74,27,47,0.00032232966544403684,0.0005442146649192564,0.6351351351351351
1741,2874,일주일/Noun,74,47,27,0.0005446259864399244,0.00032208623025833537,0.6351351351351351
1742,2875,범죄자/Noun,74,28,46,0.0003334444814938313,0.0005331082431862101,0.6216216216216216
1743,2876,부탁/Noun,74,29,45,0.0003445592975436257,0.0005220018214531642,0.6081081081081081
1744,2877,이안/Noun,74,29,45,0.0003445592975436257,0.0005220018214531642,0.6081081081081081
1745,2878,캐릭/Noun,74,29,45,0.0003445592975436257,0.0005220018214531642,0.6081081081081081
1746,2879,생명/Noun,74,45,29,0.0005223963543403357,0.00034429907372442745,0.6081081081081081
1747,2889,애잔하다/Adjective,73,69,4,0.0007891519395354007,6.663853039827628e-05,0.9452054794520548
1748,2890,애매하다/Adjective,73,12,61,0.00015560742469712126,0.0006997045691819009,0.8356164383561644
1749,2891,이별/Noun,73,57,16,0.0006557741469378681,0.00019991559119482882,0.7808219178082192
1750,2892,쟁이/Suffix,73,19,54,0.0002334111370456819,0.0006219596170505788,0.7397260273972602
1751,2893,쌍/Noun,73,21,52,0.00025564076914527065,0.0005997467735844866,0.7123287671232876
1752,2894,부인/Noun,73,21,52,0.00025564076914527065,0.0005997467735844866,0.7123287671232876
1753,2895,원숭이/Noun,73,22,51,0.000266755585195065,0.0005886403518514405,0.6986301369863014
1754,2896,단편/Noun,73,22,51,0.000266755585195065,0.0005886403518514405,0.6986301369863014
1755,2897,시종일관/Noun,73,22,51,0.000266755585195065,0.0005886403518514405,0.6986301369863014
1756,2898,깡패/Noun,73,23,50,0.00027787040124485944,0.0005775339301183945,0.6849315068493149
1757,2899,신하균/Noun,73,50,23,0.0005779704345893076,0.00027766054332615115,0.6849315068493149
1758,2900,본격/Noun,73,23,50,0.00027787040124485944,0.0005775339301183945,0.6849315068493149
1759,2901,에서나/Josa,73,24,49,0.0002889852172946538,0.0005664275083853486,0.6712328767123288
1760,2902,광기/Noun,73,49,24,0.0005668556185395131,0.0002887669650591972,0.6712328767123288
1761,2903,처리/Noun,73,25,48,0.00030010003334444816,0.0005553210866523023,0.6575342465753424
1762,2904,만세/Noun,73,48,25,0.0005557408024897189,0.0002998733867922433,0.6575342465753424
1763,2905,낮/Noun,73,47,26,0.0005446259864399244,0.00031097980852528933,0.6438356164383562
1764,2906,블랙코미디/Noun,73,46,27,0.00053351117039013,0.00032208623025833537,0.6301369863013698
1765,2907,솔/Noun,73,27,46,0.00032232966544403684,0.0005331082431862101,0.6301369863013698
1766,2908,로움/Noun,73,44,29,0.0005112815382905413,0.00034429907372442745,0.6027397260273972
1767,2921,답답/Noun,72,2,70,4.445926419917751e-05,0.0007996623647793153,0.9722222222222222
1768,2922,Good/Alpha,72,69,3,0.0007891519395354007,5.553210866523024e-05,0.9583333333333334
1769,2923,어색/Noun,72,3,69,5.5574080248971876e-05,0.0007885559430462694,0.9583333333333334
1770,2924,명불허전/Noun,72,64,8,0.0007335778592864287,0.00011106421733046048,0.8888888888888888
1771,2925,비록/Noun,72,64,8,0.0007335778592864287,0.00011106421733046048,0.8888888888888888
1772,2926,애틋하다/Adjective,72,61,11,0.0007002334111370457,0.0001443834825295986,0.8472222222222222
1773,2927,광구/Noun,72,12,60,0.00015560742469712126,0.0006885981474488549,0.8333333333333334
1774,2928,쓴다/Verb,72,12,60,0.00015560742469712126,0.0006885981474488549,0.8333333333333334
1775,2929,짜릿하다/Adjective,72,59,13,0.0006780037790374569,0.0001665963259956907,0.8194444444444444
1776,2930,땀/Noun,72,58,14,0.0006668889629876625,0.00017770274772873674,0.8055555555555556
1777,2931,배꼽/Noun,72,58,14,0.0006668889629876625,0.00017770274772873674,0.8055555555555556
1778,2932,뎅/Noun,72,57,15,0.0006557741469378681,0.0001888091694617828,0.7916666666666666
1779,2933,누나/Suffix,72,56,16,0.0006446593308880737,0.00019991559119482882,0.7777777777777778
1780,2934,아무나/Noun,72,17,55,0.00021118150494609317,0.0006330660387836247,0.7638888888888888
1781,2935,기획/Noun,72,22,50,0.000266755585195065,0.0005775339301183945,0.6944444444444444
1782,2936,호흡/Noun,72,49,23,0.0005668556185395131,0.00027766054332615115,0.6805555555555556
1783,2937,고전/Modifier,72,49,23,0.0005668556185395131,0.00027766054332615115,0.6805555555555556
1784,2938,대부/Noun,72,46,26,0.00053351117039013,0.00031097980852528933,0.6388888888888888
1785,2939,일지/Noun,72,46,26,0.00053351117039013,0.00031097980852528933,0.6388888888888888
1786,2940,못자다/Verb,72,26,46,0.00031121484939424253,0.0005331082431862101,0.6388888888888888
1787,2941,구분/Noun,72,27,45,0.00032232966544403684,0.0005220018214531642,0.625
1788,2942,이지/Noun,72,27,45,0.00032232966544403684,0.0005220018214531642,0.625
1789,2943,수록/Noun,72,44,28,0.0005112815382905413,0.0003331926519913814,0.6111111111111112
1790,2944,풀/Noun,72,28,44,0.0003334444814938313,0.0005108953997201182,0.6111111111111112
1791,2945,본질/Noun,72,44,28,0.0005112815382905413,0.0003331926519913814,0.6111111111111112
1792,2953,아마추어/Noun,71,5,66,7.780371234856063e-05,0.0007552366778471312,0.9295774647887324
1793,2954,케미/Noun,71,66,5,0.0007558074913860174,7.774495213132233e-05,0.9295774647887324
1794,2955,오글오글/Adverb,71,6,65,8.891852839835501e-05,0.0007441302561140852,0.9154929577464788
1795,2956,...^^/Punctuation,71,65,6,0.0007446926753362233,8.885137386436837e-05,0.9154929577464788
1796,2957,쓸쓸하다/Adjective,71,63,8,0.0007224630432366343,0.00011106421733046048,0.8873239436619719
1797,2958,15년/Number,71,60,11,0.0006891185950872514,0.0001443834825295986,0.8450704225352113
1798,2959,고인/Noun,71,60,11,0.0006891185950872514,0.0001443834825295986,0.8450704225352113
1799,2960,데리다/Verb,71,12,59,0.00015560742469712126,0.0006774917257158089,0.8309859154929577
1800,2961,제작자/Noun,71,12,59,0.00015560742469712126,0.0006774917257158089,0.8309859154929577
1801,2962,정점/Noun,71,55,16,0.0006335445148382794,0.00019991559119482882,0.7746478873239436
1802,2963,상식/Noun,71,16,55,0.0002000666888962988,0.0006330660387836247,0.7746478873239436
1803,2964,명장/Noun,71,52,19,0.0006002000666888963,0.000233234856393967,0.7323943661971831
1804,2965,ㅜㅠ/KoreanParticle,71,50,21,0.0005779704345893076,0.0002554476998600591,0.7042253521126759
1805,2966,고증/Noun,71,21,50,0.00025564076914527065,0.0005775339301183945,0.7042253521126759
1806,2967,괴롭다/Adjective,71,22,49,0.000266755585195065,0.0005664275083853486,0.6901408450704225
1807,2968,살이/Noun,71,45,26,0.0005223963543403357,0.00031097980852528933,0.6338028169014085
1808,2969,회사/Noun,71,26,45,0.00031121484939424253,0.0005220018214531642,0.6338028169014085
1809,2970,커버/Noun,71,44,27,0.0005112815382905413,0.00032208623025833537,0.6197183098591549
1810,2971,별거/Noun,71,28,43,0.0003334444814938313,0.0004997889779870722,0.6056338028169014
1811,2972,합/Noun,71,28,43,0.0003334444814938313,0.0004997889779870722,0.6056338028169014
1812,2984,진창/Noun,70,4,66,6.668889629876625e-05,0.0007552366778471312,0.9428571428571428
1813,2985,돌려주다/Verb,70,6,64,8.891852839835501e-05,0.0007330238343810393,0.9142857142857144
1814,2986,찬사/Noun,70,61,9,0.0007002334111370457,0.00012217063906350652,0.8714285714285714
1815,2987,you/Alpha,70,59,11,0.0006780037790374569,0.0001443834825295986,0.8428571428571429
1816,2988,일반인/Noun,70,11,59,0.0001444926086473269,0.0006774917257158089,0.8428571428571429
1817,2989,의심스럽다/Adjective,70,11,59,0.0001444926086473269,0.0006774917257158089,0.8428571428571429
1818,2990,티나/Noun,70,14,56,0.00017783705679671002,0.0006441724605166707,0.8
1819,2991,피아노/Noun,70,56,14,0.0006446593308880737,0.00017770274772873674,0.8
1820,2992,이기도/Josa,70,55,15,0.0006335445148382794,0.0001888091694617828,0.7857142857142857
1821,2993,90분/Number,70,15,55,0.00018895187284650438,0.0006330660387836247,0.7857142857142857
1822,2994,미스터리/Noun,70,17,53,0.00021118150494609317,0.0006108531953175326,0.7571428571428571
1823,2995,믿음/Noun,70,52,18,0.0006002000666888963,0.00022212843466092096,0.7428571428571429
1824,2996,디테일/Noun,70,50,20,0.0005779704345893076,0.00024434127812701304,0.7142857142857143
1825,2997,닥치고/Noun,70,49,21,0.0005668556185395131,0.0002554476998600591,0.7
1826,2998,위험하다/Adjective,70,22,48,0.000266755585195065,0.0005553210866523023,0.6857142857142857
1827,2999,멜로영화/Noun,70,46,24,0.00053351117039013,0.0002887669650591972,0.6571428571428571
1828,3000,오로지/Adverb,70,24,46,0.0002889852172946538,0.0005331082431862101,0.6571428571428571
1829,3001,스필버그/Noun,70,46,24,0.00053351117039013,0.0002887669650591972,0.6571428571428571
1830,3002,놀란/Noun,70,46,24,0.00053351117039013,0.0002887669650591972,0.6571428571428571
1831,3003,업/Noun,70,26,44,0.00031121484939424253,0.0005108953997201182,0.6285714285714286
1832,3004,남자배우/Noun,70,28,42,0.0003334444814938313,0.0004886825562540262,0.6
1833,3018,수면제/Noun,69,3,66,5.5574080248971876e-05,0.0007552366778471312,0.9565217391304348
1834,3019,짬뽕/Noun,69,4,65,6.668889629876625e-05,0.0007441302561140852,0.9420289855072465
1835,3020,비호감/Noun,69,7,62,0.0001000333444481494,0.000710810990914947,0.8985507246376812
1836,3021,명연기/Noun,69,61,8,0.0007002334111370457,0.00011106421733046048,0.8840579710144928
1837,3022,꿀/Noun,69,61,8,0.0007002334111370457,0.00011106421733046048,0.8840579710144928
1838,3023,국어/Noun,69,9,60,0.00012226297654773814,0.0006885981474488549,0.8695652173913043
1839,3024,전문/Noun,69,13,56,0.00016672224074691566,0.0006441724605166707,0.8115942028985508
1840,3025,많아지다/Verb,69,55,14,0.0006335445148382794,0.00017770274772873674,0.7971014492753623
1841,3026,순수/Noun,69,54,15,0.0006224296987884852,0.0001888091694617828,0.7826086956521741
1842,3027,초월/Noun,69,53,16,0.0006113148827386907,0.00019991559119482882,0.7681159420289855
1843,3028,연관/Noun,69,16,53,0.0002000666888962988,0.0006108531953175326,0.7681159420289855
1844,3029,출연자/Noun,69,17,52,0.00021118150494609317,0.0005997467735844866,0.7536231884057971
1845,3030,저지르다/Verb,69,18,51,0.0002222963209958875,0.0005886403518514405,0.7391304347826086
1846,3031,혁명/Noun,69,50,19,0.0005779704345893076,0.000233234856393967,0.7246376811594203
1847,3032,하나님/Noun,69,48,21,0.0005557408024897189,0.0002554476998600591,0.6956521739130435
1848,3033,마찬가지/Noun,69,21,48,0.00025564076914527065,0.0005553210866523023,0.6956521739130435
1849,3034,스포츠/Noun,69,47,22,0.0005446259864399244,0.00026655412159310506,0.6811594202898551
1850,3035,가까이/Noun,69,47,22,0.0005446259864399244,0.00026655412159310506,0.6811594202898551
1851,3036,빌다/Verb,69,46,23,0.00053351117039013,0.00027766054332615115,0.6666666666666666
1852,3037,엽기/Noun,69,26,43,0.00031121484939424253,0.0004997889779870722,0.6231884057971014
1853,3038,계/Noun,69,26,43,0.00031121484939424253,0.0004997889779870722,0.6231884057971014
1854,3039,선수/Noun,69,42,27,0.0004890519061909527,0.00032208623025833537,0.6086956521739131
1855,3040,홀로/Noun,69,42,27,0.0004890519061909527,0.00032208623025833537,0.6086956521739131
1856,3052,~~^^/Punctuation,68,65,3,0.0007446926753362233,5.553210866523024e-05,0.9558823529411764
1857,3053,유아/Noun,68,8,60,0.00011114816049794375,0.0006885981474488549,0.8823529411764706
1858,3054,게스트/Noun,68,10,58,0.0001333777925975325,0.0006663853039827628,0.8529411764705882
1859,3055,대박나다/Verb,68,58,10,0.0006668889629876625,0.00013327706079655256,0.8529411764705882
1860,3056,알파/Noun,68,56,12,0.0006446593308880737,0.00015548990426264466,0.8235294117647058
1861,3057,세대/Noun,68,54,14,0.0006224296987884852,0.00017770274772873674,0.7941176470588235
1862,3058,즐거움/Noun,68,53,15,0.0006113148827386907,0.0001888091694617828,0.7794117647058824
1863,3059,고문/Noun,68,15,53,0.00018895187284650438,0.0006108531953175326,0.7794117647058824
1864,3060,연습/Noun,68,16,52,0.0002000666888962988,0.0005997467735844866,0.7647058823529411
1865,3061,40분/Number,68,16,52,0.0002000666888962988,0.0005997467735844866,0.7647058823529411
1866,3062,숨막히다/Adjective,68,52,16,0.0006002000666888963,0.00019991559119482882,0.7647058823529411
1867,3063,무식하다/Adjective,68,17,51,0.00021118150494609317,0.0005886403518514405,0.75
1868,3064,떡/Noun,68,19,49,0.0002334111370456819,0.0005664275083853486,0.7205882352941176
1869,3065,농담/Noun,68,19,49,0.0002334111370456819,0.0005664275083853486,0.7205882352941176
1870,3066,미스테리/Noun,68,19,49,0.0002334111370456819,0.0005664275083853486,0.7205882352941176
1871,3067,로빈/Noun,68,48,20,0.0005557408024897189,0.00024434127812701304,0.7058823529411765
1872,3068,미학/Noun,68,48,20,0.0005557408024897189,0.00024434127812701304,0.7058823529411765
1873,3069,뺏다/Verb,68,20,48,0.00024452595309547634,0.0005553210866523023,0.7058823529411765
1874,3070,쏟다/Verb,68,46,22,0.00053351117039013,0.00026655412159310506,0.6764705882352942
1875,3071,타란티노/Noun,68,45,23,0.0005223963543403357,0.00027766054332615115,0.6617647058823529
1876,3072,반영/Noun,68,44,24,0.0005112815382905413,0.0002887669650591972,0.6470588235294118
1877,3073,자세하다/Adjective,68,44,24,0.0005112815382905413,0.0002887669650591972,0.6470588235294118
1878,3074,세트/Noun,68,25,43,0.00030010003334444816,0.0004997889779870722,0.6323529411764706
1879,3075,위주/Noun,68,25,43,0.00030010003334444816,0.0004997889779870722,0.6323529411764706
1880,3076,다른사람/Noun,68,25,43,0.00030010003334444816,0.0004997889779870722,0.6323529411764706
1881,3077,쭉/Noun,68,43,25,0.0005001667222407468,0.0002998733867922433,0.6323529411764706
1882,3087,굿굿굿/Noun,67,67,0,0.0007669223074358119,2.2212843466092093e-05,1.0
1883,3088,부자연스럽다/Adjective,67,8,59,0.00011114816049794375,0.0006774917257158089,0.8805970149253731
1884,3089,~~!!/Punctuation,67,55,12,0.0006335445148382794,0.00015548990426264466,0.8208955223880597
1885,3090,강간/Noun,67,12,55,0.00015560742469712126,0.0006330660387836247,0.8208955223880597
1886,3091,뭣/Noun,67,15,52,0.00018895187284650438,0.0005997467735844866,0.7761194029850746
1887,3092,한동안/Adverb,67,51,16,0.000589085250639102,0.00019991559119482882,0.7611940298507462
1888,3093,까지만/Josa,67,16,51,0.0002000666888962988,0.0005886403518514405,0.7611940298507462
1889,3094,간지/Noun,67,50,17,0.0005779704345893076,0.0002110220129278749,0.746268656716418
1890,3095,외국인/Noun,67,18,49,0.0002222963209958875,0.0005664275083853486,0.7313432835820896
1891,3096,ㅈㄴ/KoreanParticle,67,18,49,0.0002222963209958875,0.0005664275083853486,0.7313432835820896
1892,3097,s/Alpha,67,47,20,0.0005446259864399244,0.00024434127812701304,0.7014925373134329
1893,3098,마저도/Josa,67,21,46,0.00025564076914527065,0.0005331082431862101,0.6865671641791045
1894,3099,칭찬/Noun,67,22,45,0.000266755585195065,0.0005220018214531642,0.6716417910447762
1895,3100,리도/Noun,67,22,45,0.000266755585195065,0.0005220018214531642,0.6716417910447762
1896,3101,유치원/Noun,67,22,45,0.000266755585195065,0.0005220018214531642,0.6716417910447762
1897,3102,권력/Noun,67,44,23,0.0005112815382905413,0.00027766054332615115,0.6567164179104478
1898,3103,데이빗/Noun,67,43,24,0.0005001667222407468,0.0002887669650591972,0.6417910447761194
1899,3104,원/Suffix,67,25,42,0.00030010003334444816,0.0004886825562540262,0.6268656716417911
1900,3105,능가/Noun,67,42,25,0.0004890519061909527,0.0002998733867922433,0.6268656716417911
1901,3106,우린/Noun,67,42,25,0.0004890519061909527,0.0002998733867922433,0.6268656716417911
1902,3107,데이/Noun,67,42,25,0.0004890519061909527,0.0002998733867922433,0.6268656716417911
1903,3108,문/Noun,67,26,41,0.00031121484939424253,0.00047757613452098,0.6119402985074627
1904,3109,나로/Noun,67,26,41,0.00031121484939424253,0.00047757613452098,0.6119402985074627
1905,3115,떨어뜨리다/Verb,66,4,62,6.668889629876625e-05,0.000710810990914947,0.9393939393939394
1906,3116,칠하다/Adjective,66,8,58,0.00011114816049794375,0.0006663853039827628,0.8787878787878788
1907,3117,영구/Noun,66,10,56,0.0001333777925975325,0.0006441724605166707,0.8484848484848485
1908,3118,디카프리오/Noun,66,56,10,0.0006446593308880737,0.00013327706079655256,0.8484848484848485
1909,3119,콩/Noun,66,10,56,0.0001333777925975325,0.0006441724605166707,0.8484848484848485
1910,3120,화중/Noun,66,54,12,0.0006224296987884852,0.00015548990426264466,0.8181818181818182
1911,3121,한석규/Noun,66,54,12,0.0006224296987884852,0.00015548990426264466,0.8181818181818182
1912,3122,외롭다/Adjective,66,49,17,0.0005668556185395131,0.0002110220129278749,0.7424242424242424
1913,3123,머릿속/Noun,66,47,19,0.0005446259864399244,0.000233234856393967,0.7121212121212122
1914,3124,상징/Noun,66,45,21,0.0005223963543403357,0.0002554476998600591,0.6818181818181818
1915,3125,커서/Noun,66,44,22,0.0005112815382905413,0.00026655412159310506,0.6666666666666666
1916,3126,이따/Noun,66,23,43,0.00027787040124485944,0.0004997889779870722,0.6515151515151515
1917,3127,억울하다/Adjective,66,23,43,0.00027787040124485944,0.0004997889779870722,0.6515151515151515
1918,3128,견디다/Verb,66,24,42,0.0002889852172946538,0.0004886825562540262,0.6363636363636364
1919,3129,포함/Noun,66,24,42,0.0002889852172946538,0.0004886825562540262,0.6363636363636364
1920,3130,강아지/Noun,66,41,25,0.0004779370901411582,0.0002998733867922433,0.6212121212121212
1921,3131,호불호/Noun,66,41,25,0.0004779370901411582,0.0002998733867922433,0.6212121212121212
1922,3142,빠순이/Noun,65,5,60,7.780371234856063e-05,0.0006885981474488549,0.9230769230769232
1923,3143,적당/Noun,65,9,56,0.00012226297654773814,0.0006441724605166707,0.8615384615384616
1924,3144,아우/Noun,65,10,55,0.0001333777925975325,0.0006330660387836247,0.8461538461538461
1925,3145,다시금/Noun,65,54,11,0.0006224296987884852,0.0001443834825295986,0.8307692307692308
1926,3146,마누라/Noun,65,12,53,0.00015560742469712126,0.0006108531953175326,0.8153846153846154
1927,3147,미스캐스팅/Noun,65,12,53,0.00015560742469712126,0.0006108531953175326,0.8153846153846154
1928,3148,올려주다/Verb,65,51,14,0.000589085250639102,0.00017770274772873674,0.7846153846153846
1929,3149,시체/Noun,65,16,49,0.0002000666888962988,0.0005664275083853486,0.7538461538461538
1930,3150,죄송하다/Adjective,65,17,48,0.00021118150494609317,0.0005553210866523023,0.7384615384615385
1931,3151,거임/Noun,65,18,47,0.0002222963209958875,0.0005442146649192564,0.7230769230769231
1932,3152,마다/Noun,65,45,20,0.0005223963543403357,0.00024434127812701304,0.6923076923076923
1933,3153,안쓰럽다/Adjective,65,22,43,0.000266755585195065,0.0004997889779870722,0.6615384615384615
1934,3154,차승원/Noun,65,43,22,0.0005001667222407468,0.00026655412159310506,0.6615384615384615
1935,3155,백인/Noun,65,22,43,0.000266755585195065,0.0004997889779870722,0.6615384615384615
1936,3156,도와주다/Verb,65,23,42,0.00027787040124485944,0.0004886825562540262,0.6461538461538462
1937,3157,구만/Noun,65,23,42,0.00027787040124485944,0.0004886825562540262,0.6461538461538462
1938,3158,.........../Punctuation,65,24,41,0.0002889852172946538,0.00047757613452098,0.6307692307692307
1939,3159,인식/Noun,65,26,39,0.00031121484939424253,0.000455363291054888,0.6
1940,3168,역작/Noun,64,59,5,0.0006780037790374569,7.774495213132233e-05,0.921875
1941,3169,싱겁다/Adjective,64,7,57,0.0001000333444481494,0.0006552788822497168,0.890625
1942,3170,치노/Noun,64,53,11,0.0006113148827386907,0.0001443834825295986,0.828125
1943,3171,잘나가다/Verb,64,11,53,0.0001444926086473269,0.0006108531953175326,0.828125
1944,3172,뒤늦다/Adjective,64,52,12,0.0006002000666888963,0.00015548990426264466,0.8125
1945,3173,납득/Noun,64,12,52,0.00015560742469712126,0.0005997467735844866,0.8125
1946,3174,조차/Noun,64,13,51,0.00016672224074691566,0.0005886403518514405,0.796875
1947,3175,사람과/Noun,64,51,13,0.000589085250639102,0.0001665963259956907,0.796875
1948,3176,클래식/Noun,64,50,14,0.0005779704345893076,0.00017770274772873674,0.78125
1949,3177,...!/Punctuation,64,48,16,0.0005557408024897189,0.00019991559119482882,0.75
1950,3178,재방/Noun,64,48,16,0.0005557408024897189,0.00019991559119482882,0.75
1951,3179,우드/Noun,64,48,16,0.0005557408024897189,0.00019991559119482882,0.75
1952,3180,두렵다/Adjective,64,48,16,0.0005557408024897189,0.00019991559119482882,0.75
1953,3181,떨리다/Verb,64,47,17,0.0005446259864399244,0.0002110220129278749,0.734375
1954,3182,차리다/Verb,64,17,47,0.00021118150494609317,0.0005442146649192564,0.734375
1955,3183,!!!!!!/Punctuation,64,47,17,0.0005446259864399244,0.0002110220129278749,0.734375
1956,3184,찍/Noun,64,18,46,0.0002222963209958875,0.0005331082431862101,0.71875
1957,3185,신화/Noun,64,46,18,0.00053351117039013,0.00022212843466092096,0.71875
1958,3186,난후/Noun,64,44,20,0.0005112815382905413,0.00024434127812701304,0.6875
1959,3187,발랄하다/Adjective,64,44,20,0.0005112815382905413,0.00024434127812701304,0.6875
1960,3188,스펙/Noun,64,43,21,0.0005001667222407468,0.0002554476998600591,0.671875
1961,3189,인걸/Josa,64,22,42,0.000266755585195065,0.0004886825562540262,0.65625
1962,3190,세계관/Noun,64,22,42,0.000266755585195065,0.0004886825562540262,0.65625
1963,3191,찌르다/Verb,64,22,42,0.000266755585195065,0.0004886825562540262,0.65625
1964,3192,화질/Noun,64,23,41,0.00027787040124485944,0.00047757613452098,0.640625
1965,3193,설/Noun,64,24,40,0.0002889852172946538,0.000466469712787934,0.625
1966,3204,4.44/Number,63,9,54,0.00012226297654773814,0.0006219596170505788,0.8571428571428571
1967,3205,-_-;;/Punctuation,63,9,54,0.00012226297654773814,0.0006219596170505788,0.8571428571428571
1968,3206,재앙/Noun,63,10,53,0.0001333777925975325,0.0006108531953175326,0.8412698412698413
1969,3207,해지/Noun,63,51,12,0.000589085250639102,0.00015548990426264466,0.8095238095238095
1970,3208,다치다/Verb,63,16,47,0.0002000666888962988,0.0005442146649192564,0.7460317460317459
1971,3209,허무/Noun,63,16,47,0.0002000666888962988,0.0005442146649192564,0.7460317460317459
1972,3210,앙/Adverb,63,45,18,0.0005223963543403357,0.00022212843466092096,0.7142857142857143
1973,3211,승부/Noun,63,18,45,0.0002222963209958875,0.0005220018214531642,0.7142857142857143
1974,3212,김희선/Noun,63,20,43,0.00024452595309547634,0.0004997889779870722,0.6825396825396826
1975,3213,벌어지다/Verb,63,42,21,0.0004890519061909527,0.0002554476998600591,0.6666666666666666
1976,3214,첨으로/Adverb,63,22,41,0.000266755585195065,0.00047757613452098,0.6507936507936508
1977,3215,만화가/Noun,63,22,41,0.000266755585195065,0.00047757613452098,0.6507936507936508
1978,3216,작화/Noun,63,40,23,0.0004668222740913638,0.00027766054332615115,0.6349206349206349
1979,3217,거듭/Noun,63,40,23,0.0004668222740913638,0.00027766054332615115,0.6349206349206349
1980,3218,메이/Noun,63,40,23,0.0004668222740913638,0.00027766054332615115,0.6349206349206349
1981,3219,오직/Noun,63,24,39,0.0002889852172946538,0.000455363291054888,0.6190476190476191
1982,3220,강동원/Noun,63,39,24,0.00045570745804156943,0.0002887669650591972,0.6190476190476191
1983,3231,bb/Alpha,62,59,3,0.0006780037790374569,5.553210866523024e-05,0.9516129032258064
1984,3232,에로물/Noun,62,6,56,8.891852839835501e-05,0.0006441724605166707,0.9032258064516128
1985,3233,살때/Noun,62,54,8,0.0006224296987884852,0.00011106421733046048,0.8709677419354839
1986,3234,알바생/Noun,62,8,54,0.00011114816049794375,0.0006219596170505788,0.8709677419354839
1987,3235,벅차다/Adjective,62,53,9,0.0006113148827386907,0.00012217063906350652,0.8548387096774194
1988,3236,로운/Josa,62,51,11,0.000589085250639102,0.0001443834825295986,0.8225806451612904
1989,3237,^-^/Punctuation,62,50,12,0.0005779704345893076,0.00015548990426264466,0.8064516129032258
1990,3238,꼽/Noun,62,49,13,0.0005668556185395131,0.0001665963259956907,0.7903225806451613
1991,3239,관대하다/Adjective,62,14,48,0.00017783705679671002,0.0005553210866523023,0.7741935483870968
1992,3240,뿌리다/Verb,62,14,48,0.00017783705679671002,0.0005553210866523023,0.7741935483870968
1993,3241,페이크/Noun,62,14,48,0.00017783705679671002,0.0005553210866523023,0.7741935483870968
1994,3242,망치/Noun,62,16,46,0.0002000666888962988,0.0005331082431862101,0.7419354838709677
1995,3243,올레/Noun,62,16,46,0.0002000666888962988,0.0005331082431862101,0.7419354838709677
1996,3244,강요/Noun,62,16,46,0.0002000666888962988,0.0005331082431862101,0.7419354838709677
1997,3245,밀다/Verb,62,17,45,0.00021118150494609317,0.0005220018214531642,0.7258064516129032
1998,3246,다섯/Determiner,62,45,17,0.0005223963543403357,0.0002110220129278749,0.7258064516129032
1999,3247,짜내다/Verb,62,18,44,0.0002222963209958875,0.0005108953997201182,0.7096774193548387
2000,3248,가짜/Noun,62,19,43,0.0002334111370456819,0.0004997889779870722,0.6935483870967742
2001,3249,소품/Noun,62,20,42,0.00024452595309547634,0.0004886825562540262,0.6774193548387096
2002,3250,아담/Noun,62,42,20,0.0004890519061909527,0.00024434127812701304,0.6774193548387096
2003,3251,다녀오다/Verb,62,42,20,0.0004890519061909527,0.00024434127812701304,0.6774193548387096
2004,3252,만난/Noun,62,41,21,0.0004779370901411582,0.0002554476998600591,0.6612903225806451
2005,3253,원조/Noun,62,41,21,0.0004779370901411582,0.0002554476998600591,0.6612903225806451
2006,3254,구석/Noun,62,21,41,0.00025564076914527065,0.00047757613452098,0.6612903225806451
2007,3255,드러내다/Verb,62,40,22,0.0004668222740913638,0.00026655412159310506,0.6451612903225806
2008,3256,섬뜩하다/Adjective,62,39,23,0.00045570745804156943,0.00027766054332615115,0.6290322580645161
2009,3257,흑백/Noun,62,38,24,0.000444592641991775,0.0002887669650591972,0.6129032258064516
2010,3258,가라/Noun,62,24,38,0.0002889852172946538,0.0004442568693218419,0.6129032258064516
2011,3259,행/Noun,62,38,24,0.000444592641991775,0.0002887669650591972,0.6129032258064516
2012,3260,철저하다/Adjective,62,24,38,0.0002889852172946538,0.0004442568693218419,0.6129032258064516
2013,3261,지지/Noun,62,24,38,0.0002889852172946538,0.0004442568693218419,0.6129032258064516
2014,3273,두고두고/Noun,61,55,6,0.0006335445148382794,8.885137386436837e-05,0.9016393442622952
2015,3274,짱짱맨/Noun,61,52,9,0.0006002000666888963,0.00012217063906350652,0.8524590163934426
2016,3275,관리/Noun,61,11,50,0.0001444926086473269,0.0005775339301183945,0.819672131147541
2017,3276,창피하다/Adjective,61,12,49,0.00015560742469712126,0.0005664275083853486,0.8032786885245902
2018,3277,과도/Noun,61,15,46,0.00018895187284650438,0.0005331082431862101,0.7540983606557377
2019,3278,싸하다/Adjective,61,15,46,0.00018895187284650438,0.0005331082431862101,0.7540983606557377
2020,3279,남친/Noun,61,16,45,0.0002000666888962988,0.0005220018214531642,0.7377049180327869
2021,3280,공연/Noun,61,45,16,0.0005223963543403357,0.00019991559119482882,0.7377049180327869
2022,3281,떠들다/Verb,61,17,44,0.00021118150494609317,0.0005108953997201182,0.7213114754098361
2023,3282,방황/Noun,61,43,18,0.0005001667222407468,0.00022212843466092096,0.7049180327868853
2024,3283,덩어리/Noun,61,18,43,0.0002222963209958875,0.0004997889779870722,0.7049180327868853
2025,3284,태국/Noun,61,18,43,0.0002222963209958875,0.0004997889779870722,0.7049180327868853
2026,3285,밝혀지다/Verb,61,19,42,0.0002334111370456819,0.0004886825562540262,0.6885245901639344
2027,3286,톤/Noun,61,20,41,0.00024452595309547634,0.00047757613452098,0.6721311475409836
2028,3287,타인/Noun,61,41,20,0.0004779370901411582,0.00024434127812701304,0.6721311475409836
2029,3288,음향/Noun,61,20,41,0.00024452595309547634,0.00047757613452098,0.6721311475409836
2030,3289,볼라/Noun,61,21,40,0.00025564076914527065,0.000466469712787934,0.6557377049180327
2031,3290,지내다/Verb,61,40,21,0.0004668222740913638,0.0002554476998600591,0.6557377049180327
2032,3291,택시/Noun,61,23,38,0.00027787040124485944,0.0004442568693218419,0.6229508196721312
2033,3292,특집/Noun,61,23,38,0.00027787040124485944,0.0004442568693218419,0.6229508196721312
2034,3293,여지/Noun,61,37,24,0.0004334778259419807,0.0002887669650591972,0.6065573770491803
2035,3307,OOOO/Alpha,60,2,58,4.445926419917751e-05,0.0006663853039827628,0.9666666666666668
2036,3308,쯧쯧/Noun,60,3,57,5.5574080248971876e-05,0.0006552788822497168,0.95
2037,3309,모욕/Noun,60,4,56,6.668889629876625e-05,0.0006441724605166707,0.9333333333333332
2038,3310,홧팅/Noun,60,56,4,0.0006446593308880737,6.663853039827628e-05,0.9333333333333332
2039,3311,심사/Noun,60,5,55,7.780371234856063e-05,0.0006330660387836247,0.9166666666666666
2040,3312,울림/Noun,60,55,5,0.0006335445148382794,7.774495213132233e-05,0.9166666666666666
2041,3313,고독/Noun,60,51,9,0.000589085250639102,0.00012217063906350652,0.85
2042,3314,깨달음/Noun,60,49,11,0.0005668556185395131,0.0001443834825295986,0.8166666666666667
2043,3315,어째/Noun,60,12,48,0.00015560742469712126,0.0005553210866523023,0.8
2044,3316,상큼/Noun,60,48,12,0.0005557408024897189,0.00015548990426264466,0.8
2045,3317,..!!/Punctuation,60,47,13,0.0005446259864399244,0.0001665963259956907,0.7833333333333333
2046,3318,젊은이/Noun,60,47,13,0.0005446259864399244,0.0001665963259956907,0.7833333333333333
2047,3319,자랑/Noun,60,14,46,0.00017783705679671002,0.0005331082431862101,0.7666666666666667
2048,3320,맙시/Noun,60,15,45,0.00018895187284650438,0.0005220018214531642,0.75
2049,3321,짙다/Adjective,60,44,16,0.0005112815382905413,0.00019991559119482882,0.7333333333333333
2050,3322,ㅂ/KoreanParticle,60,18,42,0.0002222963209958875,0.0004886825562540262,0.7
2051,3323,사과/Noun,60,18,42,0.0002222963209958875,0.0004886825562540262,0.7
2052,3324,떄/Noun,60,41,19,0.0004779370901411582,0.000233234856393967,0.6833333333333333
2053,3325,신비/Noun,60,41,19,0.0004779370901411582,0.000233234856393967,0.6833333333333333
2054,3326,백배/Noun,60,40,20,0.0004668222740913638,0.00024434127812701304,0.6666666666666666
2055,3327,다이하드/Noun,60,21,39,0.00025564076914527065,0.000455363291054888,0.65
2056,3328,에바/Noun,60,22,38,0.000266755585195065,0.0004442568693218419,0.6333333333333333
2057,3329,유익하다/Adjective,60,37,23,0.0004334778259419807,0.00027766054332615115,0.6166666666666667
2058,3330,애니매이션/Noun,60,37,23,0.0004334778259419807,0.00027766054332615115,0.6166666666666667
2059,3331,김혜수/Noun,60,36,24,0.00042236300989218633,0.0002887669650591972,0.6
2060,3332,덮다/Verb,60,24,36,0.0002889852172946538,0.0004220440258557498,0.6
2061,3333,슨/Noun,60,36,24,0.00042236300989218633,0.0002887669650591972,0.6
2062,3350,볼일/Noun,59,3,56,5.5574080248971876e-05,0.0006441724605166707,0.9491525423728814
2063,3351,미달/Noun,59,4,55,6.668889629876625e-05,0.0006330660387836247,0.9322033898305084
2064,3352,거북하다/Adjective,59,5,54,7.780371234856063e-05,0.0006219596170505788,0.9152542372881356
2065,3353,군더더기/Noun,59,54,5,0.0006224296987884852,7.774495213132233e-05,0.9152542372881356
2066,3354,bad/Alpha,59,5,54,7.780371234856063e-05,0.0006219596170505788,0.9152542372881356
2067,3355,모독/Noun,59,7,52,0.0001000333444481494,0.0005997467735844866,0.8813559322033898
2068,3356,폼/Noun,59,11,48,0.0001444926086473269,0.0005553210866523023,0.8135593220338984
2069,3357,먹기/Noun,59,11,48,0.0001444926086473269,0.0005553210866523023,0.8135593220338984
2070,3358,천사/Noun,59,48,11,0.0005557408024897189,0.0001443834825295986,0.8135593220338984
2071,3359,부담/Noun,59,46,13,0.00053351117039013,0.0001665963259956907,0.7796610169491526
2072,3360,엔딩크레딧/Noun,59,46,13,0.00053351117039013,0.0001665963259956907,0.7796610169491526
2073,3361,누님/Noun,59,45,14,0.0005223963543403357,0.00017770274772873674,0.7627118644067796
2074,3362,칠/Noun,59,14,45,0.00017783705679671002,0.0005220018214531642,0.7627118644067796
2075,3363,짓/VerbPrefix,59,15,44,0.00018895187284650438,0.0005108953997201182,0.7457627118644068
2076,3364,반감/Noun,59,15,44,0.00018895187284650438,0.0005108953997201182,0.7457627118644068
2077,3365,성형/Noun,59,16,43,0.0002000666888962988,0.0004997889779870722,0.7288135593220338
2078,3366,뉴스/Noun,59,17,42,0.00021118150494609317,0.0004886825562540262,0.7118644067796609
2079,3367,떡밥/Noun,59,18,41,0.0002222963209958875,0.00047757613452098,0.6949152542372882
2080,3368,인연/Noun,59,40,19,0.0004668222740913638,0.000233234856393967,0.6779661016949152
2081,3369,고작/Noun,59,19,40,0.0002334111370456819,0.000466469712787934,0.6779661016949152
2082,3370,눈치/Noun,59,19,40,0.0002334111370456819,0.000466469712787934,0.6779661016949152
2083,3371,찾아오다/Verb,59,38,21,0.000444592641991775,0.0002554476998600591,0.6440677966101694
2084,3372,토니/Noun,59,37,22,0.0004334778259419807,0.00026655412159310506,0.6271186440677966
2085,3373,스콧/Noun,59,37,22,0.0004334778259419807,0.00026655412159310506,0.6271186440677966
2086,3374,테이큰/Noun,59,36,23,0.00042236300989218633,0.00027766054332615115,0.6101694915254238
2087,3375,리기/Noun,59,36,23,0.00042236300989218633,0.00027766054332615115,0.6101694915254238
2088,3395,새록새록/Noun,58,57,1,0.0006557741469378681,3.331926519913814e-05,0.9827586206896552
2089,3396,우롱/Noun,58,3,55,5.5574080248971876e-05,0.0006330660387836247,0.9482758620689656
2090,3397,개똥/Noun,58,4,54,6.668889629876625e-05,0.0006219596170505788,0.9310344827586208
2091,3398,진영화/Noun,58,53,5,0.0006113148827386907,7.774495213132233e-05,0.913793103448276
2092,3399,아기자기하다/Adjective,58,51,7,0.000589085250639102,9.995779559741441e-05,0.8793103448275862
2093,3400,렉/Noun,58,8,50,0.00011114816049794375,0.0005775339301183945,0.8620689655172413
2094,3401,기쁘다/Adjective,58,49,9,0.0005668556185395131,0.00012217063906350652,0.8448275862068966
2095,3402,남고/Noun,58,48,10,0.0005557408024897189,0.00013327706079655256,0.8275862068965517
2096,3403,문득/Noun,58,47,11,0.0005446259864399244,0.0001443834825295986,0.8103448275862069
2097,3404,성장하다/Adjective,58,44,14,0.0005112815382905413,0.00017770274772873674,0.7586206896551724
2098,3405,향기/Noun,58,44,14,0.0005112815382905413,0.00017770274772873674,0.7586206896551724
2099,3406,왕조현/Noun,58,43,15,0.0005001667222407468,0.0001888091694617828,0.7413793103448276
2100,3407,타이틀/Noun,58,15,43,0.00018895187284650438,0.0004997889779870722,0.7413793103448276
2101,3408,사이코/Noun,58,15,43,0.00018895187284650438,0.0004997889779870722,0.7413793103448276
2102,3409,벌/Noun,58,16,42,0.0002000666888962988,0.0004886825562540262,0.7241379310344828
2103,3410,기승/Noun,58,16,42,0.0002000666888962988,0.0004886825562540262,0.7241379310344828
2104,3411,습/Noun,58,41,17,0.0004779370901411582,0.0002110220129278749,0.7068965517241379
2105,3412,레이첼/Noun,58,40,18,0.0004668222740913638,0.00022212843466092096,0.6896551724137931
2106,3413,영활/Noun,58,18,40,0.0002222963209958875,0.000466469712787934,0.6896551724137931
2107,3414,".""/Punctuation",58,40,18,0.0004668222740913638,0.00022212843466092096,0.6896551724137931
2108,3415,디테/Noun,58,39,19,0.00045570745804156943,0.000233234856393967,0.6724137931034483
2109,3416,썩/Noun,58,19,39,0.0002334111370456819,0.000455363291054888,0.6724137931034483
2110,3417,피곤하다/Adjective,58,20,38,0.00024452595309547634,0.0004442568693218419,0.6551724137931034
2111,3418,어떠하다/Adjective,58,38,20,0.000444592641991775,0.00024434127812701304,0.6551724137931034
2112,3419,양/Suffix,58,37,21,0.0004334778259419807,0.0002554476998600591,0.6379310344827587
2113,3420,...(/Punctuation,58,21,37,0.00025564076914527065,0.0004331504475887958,0.6379310344827587
2114,3421,지켜보다/Verb,58,37,21,0.0004334778259419807,0.0002554476998600591,0.6379310344827587
2115,3422,평화/Noun,58,36,22,0.00042236300989218633,0.00026655412159310506,0.6206896551724138
2116,3423,합치다/Verb,58,23,35,0.00027787040124485944,0.0004109376041227037,0.603448275862069
2117,3424,황정민/Noun,58,35,23,0.0004112481938423919,0.00027766054332615115,0.603448275862069
2118,3436,반도/Noun,57,2,55,4.445926419917751e-05,0.0006330660387836247,0.9649122807017544
2119,3437,커녕/Noun,57,3,54,5.5574080248971876e-05,0.0006219596170505788,0.9473684210526316
2120,3438,헛웃음/Noun,57,4,53,6.668889629876625e-05,0.0006108531953175326,0.9298245614035088
2121,3439,차분하다/Adjective,57,48,9,0.0005557408024897189,0.00012217063906350652,0.8421052631578947
2122,3440,어지간하다/Adjective,57,11,46,0.0001444926086473269,0.0005331082431862101,0.8070175438596491
2123,3441,압/Noun,57,46,11,0.00053351117039013,0.0001443834825295986,0.8070175438596491
2124,3442,학창시절/Noun,57,44,13,0.0005112815382905413,0.0001665963259956907,0.7719298245614035
2125,3443,더욱더/Noun,57,44,13,0.0005112815382905413,0.0001665963259956907,0.7719298245614035
2126,3444,주온/Noun,57,14,43,0.00017783705679671002,0.0004997889779870722,0.7543859649122807
2127,3445,적극/Noun,57,42,15,0.0004890519061909527,0.0001888091694617828,0.7368421052631579
2128,3446,새삼/Noun,57,41,16,0.0004779370901411582,0.00019991559119482882,0.7192982456140351
2129,3447,환자/Noun,57,18,39,0.0002222963209958875,0.000455363291054888,0.6842105263157895
2130,3448,쎄다/Adjective,57,18,39,0.0002222963209958875,0.000455363291054888,0.6842105263157895
2131,3449,미장센/Noun,57,38,19,0.000444592641991775,0.000233234856393967,0.6666666666666666
2132,3450,각각/Noun,57,38,19,0.000444592641991775,0.000233234856393967,0.6666666666666666
2133,3451,대학생/Noun,57,20,37,0.00024452595309547634,0.0004331504475887958,0.6491228070175439
2134,3452,겨울왕국/Noun,57,37,20,0.0004334778259419807,0.00024434127812701304,0.6491228070175439
2135,3453,내려가다/Verb,57,20,37,0.00024452595309547634,0.0004331504475887958,0.6491228070175439
2136,3454,청년/Noun,57,37,20,0.0004334778259419807,0.00024434127812701304,0.6491228070175439
2137,3455,5년/Number,57,36,21,0.00042236300989218633,0.0002554476998600591,0.631578947368421
2138,3456,T/Alpha,57,36,21,0.00042236300989218633,0.0002554476998600591,0.631578947368421
2139,3457,스파이/Noun,57,36,21,0.00042236300989218633,0.0002554476998600591,0.631578947368421
2140,3458,오지/Noun,57,22,35,0.000266755585195065,0.0004109376041227037,0.6140350877192983
2141,3459,신세계/Noun,57,35,22,0.0004112481938423919,0.00026655412159310506,0.6140350877192983
2142,3478,원주율/Noun,56,2,54,4.445926419917751e-05,0.0006219596170505788,0.9642857142857144
2143,3479,난국/Noun,56,2,54,4.445926419917751e-05,0.0006219596170505788,0.9642857142857144
2144,3480,묵직하다/Adjective,56,49,7,0.0005668556185395131,9.995779559741441e-05,0.875
2145,3481,오랫동안/Adverb,56,49,7,0.0005668556185395131,9.995779559741441e-05,0.875
2146,3482,손꼽다/Verb,56,45,11,0.0005223963543403357,0.0001443834825295986,0.8035714285714286
2147,3483,절반/Noun,56,11,45,0.0001444926086473269,0.0005220018214531642,0.8035714285714286
2148,3484,비싸다/Adjective,56,11,45,0.0001444926086473269,0.0005220018214531642,0.8035714285714286
2149,3485,아이고/Exclamation,56,12,44,0.00015560742469712126,0.0005108953997201182,0.7857142857142857
2150,3486,에드/Noun,56,44,12,0.0005112815382905413,0.00015548990426264466,0.7857142857142857
2151,3487,!~/Punctuation,56,43,13,0.0005001667222407468,0.0001665963259956907,0.7678571428571429
2152,3488,의견/Noun,56,15,41,0.00018895187284650438,0.00047757613452098,0.7321428571428571
2153,3489,덤/Noun,56,40,16,0.0004668222740913638,0.00019991559119482882,0.7142857142857143
2154,3490,싸이코패스/Noun,56,16,40,0.0002000666888962988,0.000466469712787934,0.7142857142857143
2155,3491,집안/Noun,56,16,40,0.0002000666888962988,0.000466469712787934,0.7142857142857143
2156,3492,귀찮다/Adjective,56,17,39,0.00021118150494609317,0.000455363291054888,0.6964285714285714
2157,3493,유행/Noun,56,17,39,0.00021118150494609317,0.000455363291054888,0.6964285714285714
2158,3494,공식/Noun,56,17,39,0.00021118150494609317,0.000455363291054888,0.6964285714285714
2159,3495,사장/Noun,56,18,38,0.0002222963209958875,0.0004442568693218419,0.6785714285714286
2160,3496,빼놓다/Verb,56,38,18,0.000444592641991775,0.00022212843466092096,0.6785714285714286
2161,3497,방향/Noun,56,18,38,0.0002222963209958875,0.0004442568693218419,0.6785714285714286
2162,3498,영웅본색/Noun,56,19,37,0.0002334111370456819,0.0004331504475887958,0.6607142857142857
2163,3499,대하/Noun,56,37,19,0.0004334778259419807,0.000233234856393967,0.6607142857142857
2164,3500,크레딧/Noun,56,37,19,0.0004334778259419807,0.000233234856393967,0.6607142857142857
2165,3501,펼치다/Verb,56,37,19,0.0004334778259419807,0.000233234856393967,0.6607142857142857
2166,3502,추악하다/Adjective,56,36,20,0.00042236300989218633,0.00024434127812701304,0.6428571428571429
2167,3503,사무라이/Noun,56,20,36,0.00024452595309547634,0.0004220440258557498,0.6428571428571429
2168,3504,잘나다/Adjective,56,20,36,0.00024452595309547634,0.0004220440258557498,0.6428571428571429
2169,3505,주관/Noun,56,20,36,0.00024452595309547634,0.0004220440258557498,0.6428571428571429
2170,3506,고해/Noun,56,20,36,0.00024452595309547634,0.0004220440258557498,0.6428571428571429
2171,3507,유혹/Noun,56,20,36,0.00024452595309547634,0.0004220440258557498,0.6428571428571429
2172,3508,적나라하다/Adjective,56,35,21,0.0004112481938423919,0.0002554476998600591,0.625
2173,3509,장혁/Noun,56,35,21,0.0004112481938423919,0.0002554476998600591,0.625
2174,3510,콜린/Noun,56,35,21,0.0004112481938423919,0.0002554476998600591,0.625
2175,3511,옮기다/Verb,56,22,34,0.000266755585195065,0.00039983118238965764,0.6071428571428571
2176,3512,전지현/Noun,56,22,34,0.000266755585195065,0.00039983118238965764,0.6071428571428571
2177,3513,눕다/Verb,56,22,34,0.000266755585195065,0.00039983118238965764,0.6071428571428571
2178,3514,박찬욱/Noun,56,22,34,0.000266755585195065,0.00039983118238965764,0.6071428571428571
2179,3532,따스하다/Adjective,55,54,1,0.0006224296987884852,3.331926519913814e-05,0.9818181818181818
2180,3533,만족스럽다/Adjective,55,50,5,0.0005779704345893076,7.774495213132233e-05,0.9090909090909092
2181,3534,흠잡다/Adjective,55,50,5,0.0005779704345893076,7.774495213132233e-05,0.9090909090909092
2182,3535,투성이/Noun,55,6,49,8.891852839835501e-05,0.0005664275083853486,0.8909090909090909
2183,3536,어정쩡하다/Adjective,55,6,49,8.891852839835501e-05,0.0005664275083853486,0.8909090909090909
2184,3537,정화/Noun,55,47,8,0.0005446259864399244,0.00011106421733046048,0.8545454545454545
2185,3538,도망가다/Verb,55,9,46,0.00012226297654773814,0.0005331082431862101,0.8363636363636363
2186,3539,멀쩡하다/Adjective,55,11,44,0.0001444926086473269,0.0005108953997201182,0.8
2187,3540,출현/Noun,55,13,42,0.00016672224074691566,0.0004886825562540262,0.7636363636363637
2188,3541,덜하다/Adjective,55,41,14,0.0004779370901411582,0.00017770274772873674,0.7454545454545455
2189,3542,꼬이다/Adjective,55,15,40,0.00018895187284650438,0.000466469712787934,0.7272727272727273
2190,3543,촌/Noun,55,38,17,0.000444592641991775,0.0002110220129278749,0.6909090909090909
2191,3544,러셀/Noun,55,38,17,0.000444592641991775,0.0002110220129278749,0.6909090909090909
2192,3545,..;/Punctuation,55,17,38,0.00021118150494609317,0.0004442568693218419,0.6909090909090909
2193,3546,하고프다/Verb,55,37,18,0.0004334778259419807,0.00022212843466092096,0.6727272727272727
2194,3547,지독하다/Adjective,55,37,18,0.0004334778259419807,0.00022212843466092096,0.6727272727272727
2195,3548,is/Alpha,55,37,18,0.0004334778259419807,0.00022212843466092096,0.6727272727272727
2196,3549,가식/Noun,55,20,35,0.00024452595309547634,0.0004109376041227037,0.6363636363636364
2197,3550,재방송/Noun,55,35,20,0.0004112481938423919,0.00024434127812701304,0.6363636363636364
2198,3551,다크나이트/Noun,55,35,20,0.0004112481938423919,0.00024434127812701304,0.6363636363636364
2199,3552,끝판/Noun,55,20,35,0.00024452595309547634,0.0004109376041227037,0.6363636363636364
2200,3553,신부/Noun,55,35,20,0.0004112481938423919,0.00024434127812701304,0.6363636363636364
2201,3554,번역/Noun,55,20,35,0.00024452595309547634,0.0004109376041227037,0.6363636363636364
2202,3555,작년/Noun,55,35,20,0.0004112481938423919,0.00024434127812701304,0.6363636363636364
2203,3568,외로움/Noun,54,52,2,0.0006002000666888963,4.4425686932184186e-05,0.9629629629629628
2204,3569,흑역사/Noun,54,2,52,4.445926419917751e-05,0.0005997467735844866,0.9629629629629628
2205,3570,개꿀잼/Noun,54,51,3,0.000589085250639102,5.553210866523024e-05,0.9444444444444444
2206,3571,쪽팔리다/Verb,54,6,48,8.891852839835501e-05,0.0005553210866523023,0.8888888888888888
2207,3572,3분/Number,54,8,46,0.00011114816049794375,0.0005331082431862101,0.8518518518518519
2208,3573,주행/Noun,54,46,8,0.00053351117039013,0.00011106421733046048,0.8518518518518519
2209,3574,온갖/Noun,54,9,45,0.00012226297654773814,0.0005220018214531642,0.8333333333333334
2210,3575,대역/Noun,54,10,44,0.0001333777925975325,0.0005108953997201182,0.8148148148148148
2211,3576,색채/Noun,54,43,11,0.0005001667222407468,0.0001443834825295986,0.7962962962962963
2212,3577,개발/Noun,54,12,42,0.00015560742469712126,0.0004886825562540262,0.7777777777777778
2213,3578,전라도/Noun,54,12,42,0.00015560742469712126,0.0004886825562540262,0.7777777777777778
2214,3579,차마/Noun,54,13,41,0.00016672224074691566,0.00047757613452098,0.7592592592592593
2215,3580,구경/Noun,54,13,41,0.00016672224074691566,0.00047757613452098,0.7592592592592593
2216,3581,관람객/Noun,54,14,40,0.00017783705679671002,0.000466469712787934,0.7407407407407407
2217,3582,혀/Noun,54,14,40,0.00017783705679671002,0.000466469712787934,0.7407407407407407
2218,3583,일찍/Noun,54,39,15,0.00045570745804156943,0.0001888091694617828,0.7222222222222222
2219,3584,피디/Noun,54,15,39,0.00018895187284650438,0.000455363291054888,0.7222222222222222
2220,3585,본성/Noun,54,38,16,0.000444592641991775,0.00019991559119482882,0.7037037037037037
2221,3586,말리다/Verb,54,16,38,0.0002000666888962988,0.0004442568693218419,0.7037037037037037
2222,3587,절절/Noun,54,38,16,0.000444592641991775,0.00019991559119482882,0.7037037037037037
2223,3588,기용/Noun,54,16,38,0.0002000666888962988,0.0004442568693218419,0.7037037037037037
2224,3589,살기/Noun,54,38,16,0.000444592641991775,0.00019991559119482882,0.7037037037037037
2225,3590,크리스/Noun,54,38,16,0.000444592641991775,0.00019991559119482882,0.7037037037037037
2226,3591,팍팍/Adverb,54,17,37,0.00021118150494609317,0.0004331504475887958,0.6851851851851852
2227,3592,거야/Eomi,54,17,37,0.00021118150494609317,0.0004331504475887958,0.6851851851851852
2228,3593,차태현/Noun,54,37,17,0.0004334778259419807,0.0002110220129278749,0.6851851851851852
2229,3594,그나저나/Adverb,54,35,19,0.0004112481938423919,0.000233234856393967,0.6481481481481481
2230,3595,권/Noun,54,35,19,0.0004112481938423919,0.000233234856393967,0.6481481481481481
2231,3596,가기/Noun,54,20,34,0.00024452595309547634,0.00039983118238965764,0.6296296296296297
2232,3597,잭슨/Noun,54,34,20,0.0004001333777925976,0.00024434127812701304,0.6296296296296297
2233,3598,거대하다/Adjective,54,34,20,0.0004001333777925976,0.00024434127812701304,0.6296296296296297
2234,3599,버그/Noun,54,34,20,0.0004001333777925976,0.00024434127812701304,0.6296296296296297
2235,3600,밟다/Verb,54,21,33,0.00025564076914527065,0.00038872476065661166,0.6111111111111112
2236,3601,상관/Noun,54,21,33,0.00025564076914527065,0.00038872476065661166,0.6111111111111112
2237,3602,격/Noun,54,21,33,0.00025564076914527065,0.00038872476065661166,0.6111111111111112
2238,3603,다운로드/Noun,54,21,33,0.00025564076914527065,0.00038872476065661166,0.6111111111111112
2239,3617,헛/Noun,53,5,48,7.780371234856063e-05,0.0005553210866523023,0.9056603773584906
2240,3618,팝콘/Noun,53,6,47,8.891852839835501e-05,0.0005442146649192564,0.8867924528301887
2241,3619,흐지부지/Noun,53,6,47,8.891852839835501e-05,0.0005442146649192564,0.8867924528301887
2242,3620,납치/Noun,53,7,46,0.0001000333444481494,0.0005331082431862101,0.8679245283018868
2243,3621,오유/Noun,53,7,46,0.0001000333444481494,0.0005331082431862101,0.8679245283018868
2244,3622,서정/Noun,53,45,8,0.0005223963543403357,0.00011106421733046048,0.8490566037735849
2245,3623,c/Alpha,53,8,45,0.00011114816049794375,0.0005220018214531642,0.8490566037735849
2246,3624,^^*/Punctuation,53,45,8,0.0005223963543403357,0.00011106421733046048,0.8490566037735849
2247,3625,클라라/Noun,53,9,44,0.00012226297654773814,0.0005108953997201182,0.8301886792452831
2248,3626,최민식/Noun,53,42,11,0.0004890519061909527,0.0001443834825295986,0.7924528301886793
2249,3627,벌리다/Verb,53,11,42,0.0001444926086473269,0.0004886825562540262,0.7924528301886793
2250,3628,살인자/Noun,53,11,42,0.0001444926086473269,0.0004886825562540262,0.7924528301886793
2251,3629,옛/Modifier,53,41,12,0.0004779370901411582,0.00015548990426264466,0.7735849056603774
2252,3630,나머진/Noun,53,12,41,0.00015560742469712126,0.00047757613452098,0.7735849056603774
2253,3631,눈요기/Noun,53,12,41,0.00015560742469712126,0.00047757613452098,0.7735849056603774
2254,3632,깨끗하다/Adjective,53,40,13,0.0004668222740913638,0.0001665963259956907,0.7547169811320755
2255,3633,재치/Noun,53,39,14,0.00045570745804156943,0.00017770274772873674,0.7358490566037735
2256,3634,한국어/Noun,53,14,39,0.00017783705679671002,0.000455363291054888,0.7358490566037735
2257,3635,께서/Josa,53,38,15,0.000444592641991775,0.0001888091694617828,0.7169811320754716
2258,3636,이외/Noun,53,15,38,0.00018895187284650438,0.0004442568693218419,0.7169811320754716
2259,3637,조차도/Josa,53,15,38,0.00018895187284650438,0.0004442568693218419,0.7169811320754716
2260,3638,정석/Noun,53,37,16,0.0004334778259419807,0.00019991559119482882,0.6981132075471698
2261,3639,movie/Alpha,53,37,16,0.0004334778259419807,0.00019991559119482882,0.6981132075471698
2262,3640,틀림없다/Adjective,53,37,16,0.0004334778259419807,0.00019991559119482882,0.6981132075471698
2263,3641,네/Modifier,53,16,37,0.0002000666888962988,0.0004331504475887958,0.6981132075471698
2264,3642,예고/Noun,53,16,37,0.0002000666888962988,0.0004331504475887958,0.6981132075471698
2265,3643,저렇다/Adjective,53,16,37,0.0002000666888962988,0.0004331504475887958,0.6981132075471698
2266,3644,멘탈/Noun,53,16,37,0.0002000666888962988,0.0004331504475887958,0.6981132075471698
2267,3645,1분/Number,53,17,36,0.00021118150494609317,0.0004220440258557498,0.6792452830188679
2268,3646,무의미하다/Adjective,53,17,36,0.00021118150494609317,0.0004220440258557498,0.6792452830188679
2269,3647,★/Foreign,53,35,18,0.0004112481938423919,0.00022212843466092096,0.660377358490566
2270,3648,잘알다/Verb,53,35,18,0.0004112481938423919,0.00022212843466092096,0.660377358490566
2271,3649,부터/Foreign,53,35,18,0.0004112481938423919,0.00022212843466092096,0.660377358490566
2272,3650,레옹/Noun,53,18,35,0.0002222963209958875,0.0004109376041227037,0.660377358490566
2273,3651,신도/Noun,53,18,35,0.0002222963209958875,0.0004109376041227037,0.660377358490566
2274,3652,볼걸/Noun,53,18,35,0.0002222963209958875,0.0004109376041227037,0.660377358490566
2275,3653,일리/Noun,53,34,19,0.0004001333777925976,0.000233234856393967,0.6415094339622641
2276,3654,긴박/Noun,53,19,34,0.0002334111370456819,0.00039983118238965764,0.6415094339622641
2277,3655,이의/Noun,53,33,20,0.00038901856174280313,0.00024434127812701304,0.6226415094339622
2278,3656,꼽히다/Verb,53,33,20,0.00038901856174280313,0.00024434127812701304,0.6226415094339622
2279,3657,태도/Noun,53,20,33,0.00024452595309547634,0.00038872476065661166,0.6226415094339622
2280,3658,감옥/Noun,53,21,32,0.00025564076914527065,0.0003776183389235656,0.6037735849056604
2281,3659,할배/Noun,53,21,32,0.00025564076914527065,0.0003776183389235656,0.6037735849056604
2282,3660,사귀다/Verb,53,21,32,0.00025564076914527065,0.0003776183389235656,0.6037735849056604
2283,3679,...;;/Punctuation,52,4,48,6.668889629876625e-05,0.0005553210866523023,0.9230769230769232
2284,3680,ㅗ/KoreanParticle,52,7,45,0.0001000333444481494,0.0005220018214531642,0.8653846153846154
2285,3681,엉터리/Noun,52,7,45,0.0001000333444481494,0.0005220018214531642,0.8653846153846154
2286,3682,성찰/Noun,52,43,9,0.0005001667222407468,0.00012217063906350652,0.8269230769230769
2287,3683,모방/Noun,52,10,42,0.0001333777925975325,0.0004886825562540262,0.8076923076923077
2288,3684,매주/Adverb,52,42,10,0.0004890519061909527,0.00013327706079655256,0.8076923076923077
2289,3685,파라/Noun,52,11,41,0.0001444926086473269,0.00047757613452098,0.7884615384615384
2290,3686,더니/Noun,52,11,41,0.0001444926086473269,0.00047757613452098,0.7884615384615384
2291,3687,안남/Noun,52,13,39,0.00016672224074691566,0.000455363291054888,0.75
2292,3688,어쩌다/Adverb,52,13,39,0.00016672224074691566,0.000455363291054888,0.75
2293,3689,노튼/Noun,52,38,14,0.000444592641991775,0.00017770274772873674,0.7307692307692307
2294,3690,베이/Noun,52,38,14,0.000444592641991775,0.00017770274772873674,0.7307692307692307
2295,3691,!?/Punctuation,52,15,37,0.00018895187284650438,0.0004331504475887958,0.7115384615384616
2296,3692,펼쳐지다/Verb,52,37,15,0.0004334778259419807,0.0001888091694617828,0.7115384615384616
2297,3693,고어/Noun,52,16,36,0.0002000666888962988,0.0004220440258557498,0.6923076923076923
2298,3694,어딜/Adverb,52,17,35,0.00021118150494609317,0.0004109376041227037,0.6730769230769231
2299,3695,빨갛다/Adjective,52,35,17,0.0004112481938423919,0.0002110220129278749,0.6730769230769231
2300,3696,수없이/Adverb,52,17,35,0.00021118150494609317,0.0004109376041227037,0.6730769230769231
2301,3697,몇개/Noun,52,18,34,0.0002222963209958875,0.00039983118238965764,0.6538461538461539
2302,3698,조명/Noun,52,34,18,0.0004001333777925976,0.00022212843466092096,0.6538461538461539
2303,3699,주네/Noun,52,34,18,0.0004001333777925976,0.00022212843466092096,0.6538461538461539
2304,3700,금지/Noun,52,19,33,0.0002334111370456819,0.00038872476065661166,0.6346153846153846
2305,3701,예수/Noun,52,19,33,0.0002334111370456819,0.00038872476065661166,0.6346153846153846
2306,3702,커피/Noun,52,33,19,0.00038901856174280313,0.000233234856393967,0.6346153846153846
2307,3703,불만/Noun,52,20,32,0.00024452595309547634,0.0003776183389235656,0.6153846153846154
2308,3704,장이/Suffix,52,20,32,0.00024452595309547634,0.0003776183389235656,0.6153846153846154
2309,3705,헉/Adverb,52,20,32,0.00024452595309547634,0.0003776183389235656,0.6153846153846154
2310,3706,MBC/Alpha,52,20,32,0.00024452595309547634,0.0003776183389235656,0.6153846153846154
2311,3707,성유리/Noun,52,32,20,0.00037790374569300877,0.00024434127812701304,0.6153846153846154
2312,3721,어수선하다/Adjective,51,3,48,5.5574080248971876e-05,0.0005553210866523023,0.9411764705882352
2313,3722,저급하다/Adjective,51,5,46,7.780371234856063e-05,0.0005331082431862101,0.9019607843137256
2314,3723,씨발/Noun,51,5,46,7.780371234856063e-05,0.0005331082431862101,0.9019607843137256
2315,3724,가관/Noun,51,6,45,8.891852839835501e-05,0.0005220018214531642,0.8823529411764706
2316,3725,불필요하다/Adjective,51,7,44,0.0001000333444481494,0.0005108953997201182,0.8627450980392157
2317,3726,.!/Punctuation,51,44,7,0.0005112815382905413,9.995779559741441e-05,0.8627450980392157
2318,3727,양반/Noun,51,8,43,0.00011114816049794375,0.0004997889779870722,0.8431372549019608
2319,3728,파이팅/Noun,51,42,9,0.0004890519061909527,0.00012217063906350652,0.8235294117647058
2320,3729,뚝뚝/Noun,51,9,42,0.00012226297654773814,0.0004886825562540262,0.8235294117647058
2321,3730,땡/Noun,51,9,42,0.00012226297654773814,0.0004886825562540262,0.8235294117647058
2322,3731,모두/Modifier,51,40,11,0.0004668222740913638,0.0001443834825295986,0.7843137254901961
2323,3732,잠자다/Verb,51,11,40,0.0001444926086473269,0.000466469712787934,0.7843137254901961
2324,3733,덜덜/Noun,51,40,11,0.0004668222740913638,0.0001443834825295986,0.7843137254901961
2325,3734,먼지/Noun,51,12,39,0.00015560742469712126,0.000455363291054888,0.7647058823529411
2326,3735,임청하/Noun,51,39,12,0.00045570745804156943,0.00015548990426264466,0.7647058823529411
2327,3736,다니엘/Noun,51,39,12,0.00045570745804156943,0.00015548990426264466,0.7647058823529411
2328,3737,불과하다/Adjective,51,14,37,0.00017783705679671002,0.0004331504475887958,0.7254901960784313
2329,3738,피식/Adverb,51,15,36,0.00018895187284650438,0.0004220440258557498,0.7058823529411765
2330,3739,텐데/Eomi,51,16,35,0.0002000666888962988,0.0004109376041227037,0.6862745098039216
2331,3740,마틴/Noun,51,35,16,0.0004112481938423919,0.00019991559119482882,0.6862745098039216
2332,3741,첩보/Noun,51,35,16,0.0004112481938423919,0.00019991559119482882,0.6862745098039216
2333,3742,취급/Noun,51,17,34,0.00021118150494609317,0.00039983118238965764,0.6666666666666666
2334,3743,허구/Noun,51,18,33,0.0002222963209958875,0.00038872476065661166,0.6470588235294118
2335,3744,vs/Alpha,51,18,33,0.0002222963209958875,0.00038872476065661166,0.6470588235294118
2336,3745,흔적/Noun,51,18,33,0.0002222963209958875,0.00038872476065661166,0.6470588235294118
2337,3746,7.5/Number,51,33,18,0.00038901856174280313,0.00022212843466092096,0.6470588235294118
2338,3747,리스/Noun,51,32,19,0.00037790374569300877,0.000233234856393967,0.6274509803921569
2339,3748,이은주/Noun,51,32,19,0.00037790374569300877,0.000233234856393967,0.6274509803921569
2340,3749,7년/Number,51,31,20,0.00036678892964321435,0.00024434127812701304,0.6078431372549019
2341,3750,생기/Noun,51,20,31,0.00024452595309547634,0.00036651191719051963,0.6078431372549019
2342,3751,와중/Noun,51,20,31,0.00024452595309547634,0.00036651191719051963,0.6078431372549019
2343,3766,어중간하다/Adjective,50,2,48,4.445926419917751e-05,0.0005553210866523023,0.96
2344,3767,어쩌라고/Adverb,50,3,47,5.5574080248971876e-05,0.0005442146649192564,0.94
2345,3768,극혐/Noun,50,5,45,7.780371234856063e-05,0.0005220018214531642,0.9
2346,3769,전해지다/Verb,50,43,7,0.0005001667222407468,9.995779559741441e-05,0.86
2347,3770,재수없다/Adjective,50,8,42,0.00011114816049794375,0.0004886825562540262,0.84
2348,3771,위원회/Noun,50,8,42,0.00011114816049794375,0.0004886825562540262,0.84
2349,3772,어의/Noun,50,9,41,0.00012226297654773814,0.00047757613452098,0.82
2350,3773,절묘하다/Adjective,50,39,11,0.00045570745804156943,0.0001443834825295986,0.78
2351,3774,먹히다/Verb,50,12,38,0.00015560742469712126,0.0004442568693218419,0.76
2352,3775,연주/Noun,50,38,12,0.000444592641991775,0.00015548990426264466,0.76
2353,3776,이연희/Noun,50,37,13,0.0004334778259419807,0.0001665963259956907,0.74
2354,3777,생존/Noun,50,36,14,0.00042236300989218633,0.00017770274772873674,0.72
2355,3778,망설이다/Verb,50,36,14,0.00042236300989218633,0.00017770274772873674,0.72
2356,3779,원피스/Noun,50,36,14,0.00042236300989218633,0.00017770274772873674,0.72
2357,3780,역다/Adjective,50,14,36,0.00017783705679671002,0.0004220440258557498,0.72
2358,3781,여기저기/Noun,50,14,36,0.00017783705679671002,0.0004220440258557498,0.72
2359,3782,에드워드/Noun,50,35,15,0.0004112481938423919,0.0001888091694617828,0.7
2360,3783,고스/Noun,50,35,15,0.0004112481938423919,0.0001888091694617828,0.7
2361,3784,강력하다/Adjective,50,34,16,0.0004001333777925976,0.00019991559119482882,0.68
2362,3785,오우삼/Noun,50,17,33,0.00021118150494609317,0.00038872476065661166,0.66
2363,3786,안성기/Noun,50,33,17,0.00038901856174280313,0.0002110220129278749,0.66
2364,3787,까지/Foreign,50,17,33,0.00021118150494609317,0.00038872476065661166,0.66
2365,3788,전도연/Noun,50,33,17,0.00038901856174280313,0.0002110220129278749,0.66
2366,3789,엿보다/Verb,50,33,17,0.00038901856174280313,0.0002110220129278749,0.66
2367,3790,영광/Noun,50,33,17,0.00038901856174280313,0.0002110220129278749,0.66
2368,3791,바쁘다/Adjective,50,17,33,0.00021118150494609317,0.00038872476065661166,0.66
2369,3792,전화/Noun,50,17,33,0.00021118150494609317,0.00038872476065661166,0.66
2370,3793,닷/Noun,50,33,17,0.00038901856174280313,0.0002110220129278749,0.66
2371,3794,증명/Noun,50,18,32,0.0002222963209958875,0.0003776183389235656,0.64
2372,3795,구도/Noun,50,18,32,0.0002222963209958875,0.0003776183389235656,0.64
2373,3796,종합/Noun,50,18,32,0.0002222963209958875,0.0003776183389235656,0.64
2374,3797,검사/Noun,50,19,31,0.0002334111370456819,0.00036651191719051963,0.62
2375,3798,소지섭/Noun,50,31,19,0.00036678892964321435,0.000233234856393967,0.62
2376,3799,추구/Noun,50,31,19,0.00036678892964321435,0.000233234856393967,0.62
2377,3800,로버츠/Noun,50,30,20,0.00035567411359342004,0.00024434127812701304,0.6
2378,3801,카메론/Noun,50,30,20,0.00035567411359342004,0.00024434127812701304,0.6
2379,3802,장근석/Noun,50,20,30,0.00024452595309547634,0.0003554054954574735,0.6
2380,3803,언론/Noun,50,30,20,0.00035567411359342004,0.00024434127812701304,0.6
2381,3804,구혜선/Noun,50,20,30,0.00024452595309547634,0.0003554054954574735,0.6
2382,3819,2.22/Number,49,0,49,2.2229632099588756e-05,0.0005664275083853486,1.0
2383,3820,선율/Noun,49,47,2,0.0005446259864399244,4.4425686932184186e-05,0.9591836734693876
2384,3821,접함/Noun,49,3,46,5.5574080248971876e-05,0.0005331082431862101,0.9387755102040816
2385,3822,김구라/Noun,49,3,46,5.5574080248971876e-05,0.0005331082431862101,0.9387755102040816
2386,3823,지저분하다/Adjective,49,3,46,5.5574080248971876e-05,0.0005331082431862101,0.9387755102040816
2387,3824,배속/Noun,49,4,45,6.668889629876625e-05,0.0005220018214531642,0.9183673469387756
2388,3825,유쾌/Noun,49,45,4,0.0005223963543403357,6.663853039827628e-05,0.9183673469387756
2389,3826,전락/Noun,49,5,44,7.780371234856063e-05,0.0005108953997201182,0.8979591836734694
2390,3827,뽕짝/Noun,49,5,44,7.780371234856063e-05,0.0005108953997201182,0.8979591836734694
2391,3828,부드럽다/Adjective,49,43,6,0.0005001667222407468,8.885137386436837e-05,0.8775510204081632
2392,3829,사기꾼/Noun,49,6,43,8.891852839835501e-05,0.0004997889779870722,0.8775510204081632
2393,3830,스킵/Noun,49,6,43,8.891852839835501e-05,0.0004997889779870722,0.8775510204081632
2394,3831,무리수/Noun,49,6,43,8.891852839835501e-05,0.0004997889779870722,0.8775510204081632
2395,3832,두려움/Noun,49,43,6,0.0005001667222407468,8.885137386436837e-05,0.8775510204081632
2396,3833,재주/Noun,49,8,41,0.00011114816049794375,0.00047757613452098,0.8367346938775511
2397,3834,감기/Noun,49,9,40,0.00012226297654773814,0.000466469712787934,0.8163265306122449
2398,3835,애로/Noun,49,9,40,0.00012226297654773814,0.000466469712787934,0.8163265306122449
2399,3836,시스/Noun,49,40,9,0.0004668222740913638,0.00012217063906350652,0.8163265306122449
2400,3837,록키/Noun,49,39,10,0.00045570745804156943,0.00013327706079655256,0.7959183673469388
2401,3838,The/Alpha,49,39,10,0.00045570745804156943,0.00013327706079655256,0.7959183673469388
2402,3839,스키/Noun,49,38,11,0.000444592641991775,0.0001443834825295986,0.7755102040816326
2403,3840,한두/Modifier,49,11,38,0.0001444926086473269,0.0004442568693218419,0.7755102040816326
2404,3841,흉내내/Noun,49,12,37,0.00015560742469712126,0.0004331504475887958,0.7551020408163265
2405,3842,뜯다/Verb,49,12,37,0.00015560742469712126,0.0004331504475887958,0.7551020408163265
2406,3843,튀어나오다/Verb,49,12,37,0.00015560742469712126,0.0004331504475887958,0.7551020408163265
2407,3844,경의/Noun,49,36,13,0.00042236300989218633,0.0001665963259956907,0.7346938775510204
2408,3845,간직/Noun,49,36,13,0.00042236300989218633,0.0001665963259956907,0.7346938775510204
2409,3846,무색/Noun,49,15,34,0.00018895187284650438,0.00039983118238965764,0.6938775510204082
2410,3847,이탈리아/Noun,49,33,16,0.00038901856174280313,0.00019991559119482882,0.6734693877551021
2411,3848,고치다/Verb,49,16,33,0.0002000666888962988,0.00038872476065661166,0.6734693877551021
2412,3849,충/Noun,49,16,33,0.0002000666888962988,0.00038872476065661166,0.6734693877551021
2413,3850,목사/Noun,49,32,17,0.00037790374569300877,0.0002110220129278749,0.6530612244897959
2414,3851,이웃/Noun,49,17,32,0.00021118150494609317,0.0003776183389235656,0.6530612244897959
2415,3852,셋/Noun,49,17,32,0.00021118150494609317,0.0003776183389235656,0.6530612244897959
2416,3853,일생/Noun,49,32,17,0.00037790374569300877,0.0002110220129278749,0.6530612244897959
2417,3854,홍/Noun,49,18,31,0.0002222963209958875,0.00036651191719051963,0.6326530612244898
2418,3855,학살/Noun,49,18,31,0.0002222963209958875,0.00036651191719051963,0.6326530612244898
2419,3856,저절로/Noun,49,30,19,0.00035567411359342004,0.000233234856393967,0.6122448979591837
2420,3857,로망/Noun,49,30,19,0.00035567411359342004,0.000233234856393967,0.6122448979591837
2421,3880,내보내다/Verb,48,1,47,3.334444814938313e-05,0.0005442146649192564,0.9791666666666666
2422,3881,주옥/Noun,48,47,1,0.0005446259864399244,3.331926519913814e-05,0.9791666666666666
2423,3882,파워레인저/Noun,48,5,43,7.780371234856063e-05,0.0004997889779870722,0.8958333333333334
2424,3883,엉엉/Noun,48,41,7,0.0004779370901411582,9.995779559741441e-05,0.8541666666666666
2425,3884,이예/Noun,48,40,8,0.0004668222740913638,0.00011106421733046048,0.8333333333333334
2426,3885,그땐/Noun,48,40,8,0.0004668222740913638,0.00011106421733046048,0.8333333333333334
2427,3886,이혼/Noun,48,8,40,0.00011114816049794375,0.000466469712787934,0.8333333333333334
2428,3887,나빠지다/Verb,48,9,39,0.00012226297654773814,0.000455363291054888,0.8125
2429,3888,과잉/Noun,48,9,39,0.00012226297654773814,0.000455363291054888,0.8125
2430,3889,카피/Noun,48,9,39,0.00012226297654773814,0.000455363291054888,0.8125
2431,3890,노골/Noun,48,11,37,0.0001444926086473269,0.0004331504475887958,0.7708333333333334
2432,3891,젖다/Verb,48,36,12,0.00042236300989218633,0.00015548990426264466,0.75
2433,3892,8.5/Number,48,36,12,0.00042236300989218633,0.00015548990426264466,0.75
2434,3893,미국인/Noun,48,13,35,0.00016672224074691566,0.0004109376041227037,0.7291666666666666
2435,3894,품다/Verb,48,35,13,0.0004112481938423919,0.0001665963259956907,0.7291666666666666
2436,3895,려/Noun,48,13,35,0.00016672224074691566,0.0004109376041227037,0.7291666666666666
2437,3896,대고/Noun,48,14,34,0.00017783705679671002,0.00039983118238965764,0.7083333333333334
2438,3897,화판/Noun,48,14,34,0.00017783705679671002,0.00039983118238965764,0.7083333333333334
2439,3898,대감/Noun,48,14,34,0.00017783705679671002,0.00039983118238965764,0.7083333333333334
2440,3899,흥분/Noun,48,34,14,0.0004001333777925976,0.00017770274772873674,0.7083333333333334
2441,3900,마케팅/Noun,48,15,33,0.00018895187284650438,0.00038872476065661166,0.6875
2442,3901,한정/Noun,48,32,16,0.00037790374569300877,0.00019991559119482882,0.6666666666666666
2443,3902,아이러니/Noun,48,31,17,0.00036678892964321435,0.0002110220129278749,0.6458333333333334
2444,3903,따라오다/Verb,48,31,17,0.00036678892964321435,0.0002110220129278749,0.6458333333333334
2445,3904,송혜교/Noun,48,17,31,0.00021118150494609317,0.00036651191719051963,0.6458333333333334
2446,3905,신세경/Noun,48,17,31,0.00021118150494609317,0.00036651191719051963,0.6458333333333334
2447,3906,위기/Noun,48,17,31,0.00021118150494609317,0.00036651191719051963,0.6458333333333334
2448,3907,침묵/Noun,48,30,18,0.00035567411359342004,0.00022212843466092096,0.625
2449,3908,송지효/Noun,48,30,18,0.00035567411359342004,0.00022212843466092096,0.625
2450,3909,일요일/Noun,48,30,18,0.00035567411359342004,0.00022212843466092096,0.625
2451,3910,주원/Noun,48,30,18,0.00035567411359342004,0.00022212843466092096,0.625
2452,3911,저주/Noun,48,18,30,0.0002222963209958875,0.0003554054954574735,0.625
2453,3912,마르/Noun,48,29,19,0.0003445592975436257,0.000233234856393967,0.6041666666666666
2454,3913,지고/Noun,48,29,19,0.0003445592975436257,0.000233234856393967,0.6041666666666666
2455,3914,고자/Noun,48,19,29,0.0002334111370456819,0.00034429907372442745,0.6041666666666666
2456,3932,조악하다/Adjective,47,1,46,3.334444814938313e-05,0.0005331082431862101,0.9787234042553192
2457,3933,낚였/Noun,47,1,46,3.334444814938313e-05,0.0005331082431862101,0.9787234042553192
2458,3934,졸잼/Noun,47,43,4,0.0005001667222407468,6.663853039827628e-05,0.9148936170212766
2459,3935,클리셰/Noun,47,5,42,7.780371234856063e-05,0.0004886825562540262,0.8936170212765957
2460,3936,이스트/Noun,47,41,6,0.0004779370901411582,8.885137386436837e-05,0.8723404255319149
2461,3937,구역/Noun,47,8,39,0.00011114816049794375,0.000455363291054888,0.8297872340425532
2462,3938,구려/Noun,47,8,39,0.00011114816049794375,0.000455363291054888,0.8297872340425532
2463,3939,만날/Noun,47,38,9,0.000444592641991775,0.00012217063906350652,0.8085106382978723
2464,3940,대가리/Noun,47,9,38,0.00012226297654773814,0.0004442568693218419,0.8085106382978723
2465,3941,인척/Noun,47,10,37,0.0001333777925975325,0.0004331504475887958,0.7872340425531915
2466,3942,환장하다/Adjective,47,10,37,0.0001333777925975325,0.0004331504475887958,0.7872340425531915
2467,3943,-_-;/Punctuation,47,12,35,0.00015560742469712126,0.0004109376041227037,0.7446808510638298
2468,3944,타령/Noun,47,12,35,0.00015560742469712126,0.0004109376041227037,0.7446808510638298
2469,3945,하드/Noun,47,13,34,0.00016672224074691566,0.00039983118238965764,0.7234042553191491
2470,3946,면도/Noun,47,33,14,0.00038901856174280313,0.00017770274772873674,0.7021276595744681
2471,3947,붉다/Adjective,47,33,14,0.00038901856174280313,0.00017770274772873674,0.7021276595744681
2472,3948,조승우/Noun,47,33,14,0.00038901856174280313,0.00017770274772873674,0.7021276595744681
2473,3949,별다르다/Adjective,47,14,33,0.00017783705679671002,0.00038872476065661166,0.7021276595744681
2474,3950,시사/Noun,47,33,14,0.00038901856174280313,0.00017770274772873674,0.7021276595744681
2475,3951,도라에몽/Noun,47,33,14,0.00038901856174280313,0.00017770274772873674,0.7021276595744681
2476,3952,오페라/Noun,47,33,14,0.00038901856174280313,0.00017770274772873674,0.7021276595744681
2477,3953,신념/Noun,47,32,15,0.00037790374569300877,0.0001888091694617828,0.6808510638297872
2478,3954,아이언맨/Noun,47,32,15,0.00037790374569300877,0.0001888091694617828,0.6808510638297872
2479,3955,애국심/Noun,47,15,32,0.00018895187284650438,0.0003776183389235656,0.6808510638297872
2480,3956,작/Foreign,47,15,32,0.00018895187284650438,0.0003776183389235656,0.6808510638297872
2481,3957,미이라/Noun,47,15,32,0.00018895187284650438,0.0003776183389235656,0.6808510638297872
2482,3958,드래곤볼/Noun,47,15,32,0.00018895187284650438,0.0003776183389235656,0.6808510638297872
2483,3959,전이/Noun,47,31,16,0.00036678892964321435,0.00019991559119482882,0.6595744680851063
2484,3960,크루즈/Noun,47,31,16,0.00036678892964321435,0.00019991559119482882,0.6595744680851063
2485,3961,김명민/Noun,47,30,17,0.00035567411359342004,0.0002110220129278749,0.6382978723404256
2486,3962,웅장/Noun,47,30,17,0.00035567411359342004,0.0002110220129278749,0.6382978723404256
2487,3963,지브리/Noun,47,30,17,0.00035567411359342004,0.0002110220129278749,0.6382978723404256
2488,3964,홍금보/Noun,47,30,17,0.00035567411359342004,0.0002110220129278749,0.6382978723404256
2489,3965,쩜/Noun,47,29,18,0.0003445592975436257,0.00022212843466092096,0.6170212765957447
2490,3966,2015년/Number,47,29,18,0.0003445592975436257,0.00022212843466092096,0.6170212765957447
2491,3967,부여/Noun,47,18,29,0.0002222963209958875,0.00034429907372442745,0.6170212765957447
2492,3968,뻥/Noun,47,18,29,0.0002222963209958875,0.00034429907372442745,0.6170212765957447
2493,3969,국적/Noun,47,29,18,0.0003445592975436257,0.00022212843466092096,0.6170212765957447
2494,3970,독립/Noun,47,29,18,0.0003445592975436257,0.00022212843466092096,0.6170212765957447
2495,3971,메인/Noun,47,18,29,0.0002222963209958875,0.00034429907372442745,0.6170212765957447
2496,3972,밧다/Verb,47,29,18,0.0003445592975436257,0.00022212843466092096,0.6170212765957447
2497,3973,보고서/Noun,47,29,18,0.0003445592975436257,0.00022212843466092096,0.6170212765957447
2498,3974,자의/Noun,47,29,18,0.0003445592975436257,0.00022212843466092096,0.6170212765957447
2499,3998,남발/Noun,46,2,44,4.445926419917751e-05,0.0005108953997201182,0.9565217391304348
2500,3999,용가리/Noun,46,5,41,7.780371234856063e-05,0.00047757613452098,0.8913043478260869
2501,4000,배드/Noun,46,6,40,8.891852839835501e-05,0.000466469712787934,0.8695652173913043
2502,4001,재탕/Noun,46,6,40,8.891852839835501e-05,0.000466469712787934,0.8695652173913043
2503,4002,증말/Noun,46,7,39,0.0001000333444481494,0.000455363291054888,0.8478260869565217
2504,4003,우왕/Noun,46,39,7,0.00045570745804156943,9.995779559741441e-05,0.8478260869565217
2505,4004,재료/Noun,46,7,39,0.0001000333444481494,0.000455363291054888,0.8478260869565217
2506,4005,즐/Noun,46,7,39,0.0001000333444481494,0.000455363291054888,0.8478260869565217
2507,4006,덴젤/Noun,46,38,8,0.000444592641991775,0.00011106421733046048,0.8260869565217391
2508,4007,풍부하다/Adjective,46,37,9,0.0004334778259419807,0.00012217063906350652,0.8043478260869565
2509,4008,벗기다/Verb,46,9,37,0.00012226297654773814,0.0004331504475887958,0.8043478260869565
2510,4009,정당화/Noun,46,9,37,0.00012226297654773814,0.0004331504475887958,0.8043478260869565
2511,4010,저희/Noun,46,34,12,0.0004001333777925976,0.00015548990426264466,0.7391304347826086
2512,4011,땜시/Noun,46,12,34,0.00015560742469712126,0.00039983118238965764,0.7391304347826086
2513,4012,줄이다/Verb,46,13,33,0.00016672224074691566,0.00038872476065661166,0.7173913043478259
2514,4013,특징/Noun,46,13,33,0.00016672224074691566,0.00038872476065661166,0.7173913043478259
2515,4014,태양/Noun,46,33,13,0.00038901856174280313,0.0001665963259956907,0.7173913043478259
2516,4015,조정/Noun,46,13,33,0.00016672224074691566,0.00038872476065661166,0.7173913043478259
2517,4016,정통/Noun,46,32,14,0.00037790374569300877,0.00017770274772873674,0.6956521739130435
2518,4017,역쉬/Noun,46,31,15,0.00036678892964321435,0.0001888091694617828,0.6739130434782609
2519,4018,나와라/Noun,46,31,15,0.00036678892964321435,0.0001888091694617828,0.6739130434782609
2520,4019,6년/Number,46,31,15,0.00036678892964321435,0.0001888091694617828,0.6739130434782609
2521,4020,지원/Noun,46,16,30,0.0002000666888962988,0.0003554054954574735,0.6521739130434783
2522,4021,KBS/Alpha,46,30,16,0.00035567411359342004,0.00019991559119482882,0.6521739130434783
2523,4022,저기/Noun,46,16,30,0.0002000666888962988,0.0003554054954574735,0.6521739130434783
2524,4023,최선/Noun,46,30,16,0.00035567411359342004,0.00019991559119482882,0.6521739130434783
2525,4024,부자/Noun,46,17,29,0.00021118150494609317,0.00034429907372442745,0.6304347826086957
2526,4025,하나요/Noun,46,17,29,0.00021118150494609317,0.00034429907372442745,0.6304347826086957
2527,4026,만듬/Noun,46,17,29,0.00021118150494609317,0.00034429907372442745,0.6304347826086957
2528,4027,줄리/Noun,46,29,17,0.0003445592975436257,0.0002110220129278749,0.6304347826086957
2529,4028,헷갈리다/Adjective,46,18,28,0.0002222963209958875,0.0003331926519913814,0.6086956521739131
2530,4029,주먹/Noun,46,18,28,0.0002222963209958875,0.0003331926519913814,0.6086956521739131
2531,4030,환타지/Noun,46,18,28,0.0002222963209958875,0.0003331926519913814,0.6086956521739131
2532,4051,최하/Noun,45,3,42,5.5574080248971876e-05,0.0004886825562540262,0.9333333333333332
2533,4052,어처구니없다/Adjective,45,3,42,5.5574080248971876e-05,0.0004886825562540262,0.9333333333333332
2534,4053,글쎄요/Noun,45,3,42,5.5574080248971876e-05,0.0004886825562540262,0.9333333333333332
2535,4054,흐뭇하다/Adjective,45,42,3,0.0004890519061909527,5.553210866523024e-05,0.9333333333333332
2536,4055,대략/Noun,45,5,40,7.780371234856063e-05,0.000466469712787934,0.8888888888888888
2537,4056,곁/Noun,45,40,5,0.0004668222740913638,7.774495213132233e-05,0.8888888888888888
2538,4057,성함/Noun,45,6,39,8.891852839835501e-05,0.000455363291054888,0.8666666666666667
2539,4058,팔다/Verb,45,7,38,0.0001000333444481494,0.0004442568693218419,0.8444444444444444
2540,4059,간첩/Noun,45,10,35,0.0001333777925975325,0.0004109376041227037,0.7777777777777778
2541,4060,구성은/Noun,45,10,35,0.0001333777925975325,0.0004109376041227037,0.7777777777777778
2542,4061,온몸/Noun,45,34,11,0.0004001333777925976,0.0001443834825295986,0.7555555555555555
2543,4062,수치/Noun,45,11,34,0.0001444926086473269,0.00039983118238965764,0.7555555555555555
2544,4063,행크스/Noun,45,34,11,0.0004001333777925976,0.0001443834825295986,0.7555555555555555
2545,4064,12년/Number,45,33,12,0.00038901856174280313,0.00015548990426264466,0.7333333333333333
2546,4065,직원/Noun,45,12,33,0.00015560742469712126,0.00038872476065661166,0.7333333333333333
2547,4066,도입/Noun,45,12,33,0.00015560742469712126,0.00038872476065661166,0.7333333333333333
2548,4067,모호하다/Adjective,45,13,32,0.00016672224074691566,0.0003776183389235656,0.7111111111111111
2549,4068,감수성/Noun,45,31,14,0.00036678892964321435,0.00017770274772873674,0.6888888888888889
2550,4069,게리/Noun,45,31,14,0.00036678892964321435,0.00017770274772873674,0.6888888888888889
2551,4070,박사/Noun,45,30,15,0.00035567411359342004,0.0001888091694617828,0.6666666666666666
2552,4071,김태희/Noun,45,16,29,0.0002000666888962988,0.00034429907372442745,0.6444444444444445
2553,4072,활용/Noun,45,16,29,0.0002000666888962988,0.00034429907372442745,0.6444444444444445
2554,4073,민/Noun,45,29,16,0.0003445592975436257,0.00019991559119482882,0.6444444444444445
2555,4074,고백/Noun,45,28,17,0.0003334444814938313,0.0002110220129278749,0.6222222222222222
2556,4075,남매/Noun,45,28,17,0.0003334444814938313,0.0002110220129278749,0.6222222222222222
2557,4076,그로/Noun,45,28,17,0.0003334444814938313,0.0002110220129278749,0.6222222222222222
2558,4077,총알/Noun,45,17,28,0.00021118150494609317,0.0003331926519913814,0.6222222222222222
2559,4078,부탁드리다/Adjective,45,28,17,0.0003334444814938313,0.0002110220129278749,0.6222222222222222
2560,4079,수위/Noun,45,17,28,0.00021118150494609317,0.0003331926519913814,0.6222222222222222
2561,4080,삐/Noun,45,17,28,0.00021118150494609317,0.0003331926519913814,0.6222222222222222
2562,4081,시민/Noun,45,17,28,0.00021118150494609317,0.0003331926519913814,0.6222222222222222
2563,4082,긋다/Verb,45,18,27,0.0002222963209958875,0.00032208623025833537,0.6
2564,4083,존내/Noun,45,18,27,0.0002222963209958875,0.00032208623025833537,0.6
2565,4102,♥♥♥♥/Foreign,44,44,0,0.0005112815382905413,2.2212843466092093e-05,1.0
2566,4103,자위/Noun,44,2,42,4.445926419917751e-05,0.0004886825562540262,0.9545454545454546
2567,4104,용두사미/Noun,44,2,42,4.445926419917751e-05,0.0004886825562540262,0.9545454545454546
2568,4105,모야/Noun,44,3,41,5.5574080248971876e-05,0.00047757613452098,0.9318181818181818
2569,4106,앞서/Noun,44,41,3,0.0004779370901411582,5.553210866523024e-05,0.9318181818181818
2570,4107,구역질/Noun,44,3,41,5.5574080248971876e-05,0.00047757613452098,0.9318181818181818
2571,4108,삼가다/Verb,44,39,5,0.00045570745804156943,7.774495213132233e-05,0.8863636363636364
2572,4109,뽕/Noun,44,6,38,8.891852839835501e-05,0.0004442568693218419,0.8636363636363636
2573,4110,느슨하다/Adjective,44,7,37,0.0001000333444481494,0.0004331504475887958,0.8409090909090909
2574,4111,코스프레/Noun,44,7,37,0.0001000333444481494,0.0004331504475887958,0.8409090909090909
2575,4112,노리다/Verb,44,7,37,0.0001000333444481494,0.0004331504475887958,0.8409090909090909
2576,4113,등급/Noun,44,8,36,0.00011114816049794375,0.0004220440258557498,0.8181818181818182
2577,4114,가을/Noun,44,36,8,0.00042236300989218633,0.00011106421733046048,0.8181818181818182
2578,4115,노말/Noun,44,8,36,0.00011114816049794375,0.0004220440258557498,0.8181818181818182
2579,4116,ㅂㅅ/KoreanParticle,44,8,36,0.00011114816049794375,0.0004220440258557498,0.8181818181818182
2580,4117,펭귄/Noun,44,36,8,0.00042236300989218633,0.00011106421733046048,0.8181818181818182
2581,4118,에러/Noun,44,9,35,0.00012226297654773814,0.0004109376041227037,0.7954545454545454
2582,4119,드립/Noun,44,9,35,0.00012226297654773814,0.0004109376041227037,0.7954545454545454
2583,4120,구리다/Adjective,44,9,35,0.00012226297654773814,0.0004109376041227037,0.7954545454545454
2584,4121,읍/Noun,44,9,35,0.00012226297654773814,0.0004109376041227037,0.7954545454545454
2585,4122,섭외/Noun,44,9,35,0.00012226297654773814,0.0004109376041227037,0.7954545454545454
2586,4123,15분/Number,44,10,34,0.0001333777925975325,0.00039983118238965764,0.7727272727272727
2587,4124,중국인/Noun,44,10,34,0.0001333777925975325,0.00039983118238965764,0.7727272727272727
2588,4125,에여/Josa,44,34,10,0.0004001333777925976,0.00013327706079655256,0.7727272727272727
2589,4126,병원/Noun,44,11,33,0.0001444926086473269,0.00038872476065661166,0.75
2590,4127,불후/Noun,44,32,12,0.00037790374569300877,0.00015548990426264466,0.7272727272727273
2591,4128,성숙하다/Adjective,44,32,12,0.00037790374569300877,0.00015548990426264466,0.7272727272727273
2592,4129,해안가/Noun,44,12,32,0.00015560742469712126,0.0003776183389235656,0.7272727272727273
2593,4130,똑바로/Noun,44,13,31,0.00016672224074691566,0.00036651191719051963,0.7045454545454546
2594,4131,구멍/Noun,44,13,31,0.00016672224074691566,0.00036651191719051963,0.7045454545454546
2595,4132,워커/Noun,44,31,13,0.00036678892964321435,0.0001665963259956907,0.7045454545454546
2596,4133,낙/Noun,44,31,13,0.00036678892964321435,0.0001665963259956907,0.7045454545454546
2597,4134,레오/Noun,44,31,13,0.00036678892964321435,0.0001665963259956907,0.7045454545454546
2598,4135,부재/Noun,44,13,31,0.00016672224074691566,0.00036651191719051963,0.7045454545454546
2599,4136,인터뷰/Noun,44,13,31,0.00016672224074691566,0.00036651191719051963,0.7045454545454546
2600,4137,가져오다/Verb,44,14,30,0.00017783705679671002,0.0003554054954574735,0.6818181818181818
2601,4138,아무래도/Adverb,44,14,30,0.00017783705679671002,0.0003554054954574735,0.6818181818181818
2602,4139,북/Noun,44,14,30,0.00017783705679671002,0.0003554054954574735,0.6818181818181818
2603,4140,절실/Noun,44,30,14,0.00035567411359342004,0.00017770274772873674,0.6818181818181818
2604,4141,비롯/Noun,44,29,15,0.0003445592975436257,0.0001888091694617828,0.6590909090909091
2605,4142,지존/Noun,44,29,15,0.0003445592975436257,0.0001888091694617828,0.6590909090909091
2606,4143,슬래셔/Noun,44,15,29,0.00018895187284650438,0.00034429907372442745,0.6590909090909091
2607,4144,걸치다/Verb,44,15,29,0.00018895187284650438,0.00034429907372442745,0.6590909090909091
2608,4145,무적/Noun,44,16,28,0.0002000666888962988,0.0003331926519913814,0.6363636363636364
2609,4146,지금껏/Noun,44,28,16,0.0003334444814938313,0.00019991559119482882,0.6363636363636364
2610,4147,숲/Noun,44,27,17,0.00032232966544403684,0.0002110220129278749,0.6136363636363636
2611,4148,신민아/Noun,44,27,17,0.00032232966544403684,0.0002110220129278749,0.6136363636363636
2612,4149,양동근/Noun,44,17,27,0.00021118150494609317,0.00032208623025833537,0.6136363636363636
2613,4171,곱씹다/Verb,43,42,1,0.0004890519061909527,3.331926519913814e-05,0.9767441860465116
2614,4172,very/Alpha,43,42,1,0.0004890519061909527,3.331926519913814e-05,0.9767441860465116
2615,4173,실종/Noun,43,1,42,3.334444814938313e-05,0.0004886825562540262,0.9767441860465116
2616,4174,나발/Noun,43,2,41,4.445926419917751e-05,0.00047757613452098,0.9534883720930232
2617,4175,리즈시절/Noun,43,40,3,0.0004668222740913638,5.553210866523024e-05,0.9302325581395348
2618,4176,미묘하다/Adjective,43,39,4,0.00045570745804156943,6.663853039827628e-05,0.9069767441860463
2619,4177,허무맹랑/Noun,43,6,37,8.891852839835501e-05,0.0004331504475887958,0.8604651162790697
2620,4178,실소/Noun,43,7,36,0.0001000333444481494,0.0004220440258557498,0.8372093023255814
2621,4179,요약/Noun,43,8,35,0.00011114816049794375,0.0004109376041227037,0.813953488372093
2622,4180,8년/Number,43,35,8,0.0004112481938423919,0.00011106421733046048,0.813953488372093
2623,4181,비명/Noun,43,8,35,0.00011114816049794375,0.0004109376041227037,0.813953488372093
2624,4182,PD/Alpha,43,8,35,0.00011114816049794375,0.0004109376041227037,0.813953488372093
2625,4183,말기/Noun,43,9,34,0.00012226297654773814,0.00039983118238965764,0.7906976744186046
2626,4184,훈남/Noun,43,34,9,0.0004001333777925976,0.00012217063906350652,0.7906976744186046
2627,4185,콤비/Noun,43,33,10,0.00038901856174280313,0.00013327706079655256,0.7674418604651163
2628,4186,박해일/Noun,43,32,11,0.00037790374569300877,0.0001443834825295986,0.7441860465116279
2629,4187,정도/Foreign,43,11,32,0.0001444926086473269,0.0003776183389235656,0.7441860465116279
2630,4188,자랑스럽다/Adjective,43,32,11,0.00037790374569300877,0.0001443834825295986,0.7441860465116279
2631,4189,이념/Noun,43,31,12,0.00036678892964321435,0.00015548990426264466,0.7209302325581395
2632,4190,낯/Noun,43,12,31,0.00015560742469712126,0.00036651191719051963,0.7209302325581395
2633,4191,명도/Noun,43,12,31,0.00015560742469712126,0.00036651191719051963,0.7209302325581395
2634,4192,크리스토퍼/Noun,43,31,12,0.00036678892964321435,0.00015548990426264466,0.7209302325581395
2635,4193,일도/Noun,43,13,30,0.00016672224074691566,0.0003554054954574735,0.6976744186046512
2636,4194,거만/Noun,43,13,30,0.00016672224074691566,0.0003554054954574735,0.6976744186046512
2637,4195,에게서/Josa,43,30,13,0.00035567411359342004,0.0001665963259956907,0.6976744186046512
2638,4196,미국영화/Noun,43,13,30,0.00016672224074691566,0.0003554054954574735,0.6976744186046512
2639,4197,뮤직비디오/Noun,43,13,30,0.00016672224074691566,0.0003554054954574735,0.6976744186046512
2640,4198,모티브/Noun,43,13,30,0.00016672224074691566,0.0003554054954574735,0.6976744186046512
2641,4199,요구/Noun,43,13,30,0.00016672224074691566,0.0003554054954574735,0.6976744186046512
2642,4200,만/Foreign,43,14,29,0.00017783705679671002,0.00034429907372442745,0.6744186046511628
2643,4201,깨지다/Verb,43,14,29,0.00017783705679671002,0.00034429907372442745,0.6744186046511628
2644,4202,호강/Noun,43,29,14,0.0003445592975436257,0.00017770274772873674,0.6744186046511628
2645,4203,뉴욕/Noun,43,29,14,0.0003445592975436257,0.00017770274772873674,0.6744186046511628
2646,4204,끊임없다/Adjective,43,29,14,0.0003445592975436257,0.00017770274772873674,0.6744186046511628
2647,4205,남지/Noun,43,15,28,0.00018895187284650438,0.0003331926519913814,0.6511627906976745
2648,4206,옹/Noun,43,28,15,0.0003334444814938313,0.0001888091694617828,0.6511627906976745
2649,4207,교수/Noun,43,15,28,0.00018895187284650438,0.0003331926519913814,0.6511627906976745
2650,4208,학원/Noun,43,15,28,0.00018895187284650438,0.0003331926519913814,0.6511627906976745
2651,4209,2003년/Number,43,28,15,0.0003334444814938313,0.0001888091694617828,0.6511627906976745
2652,4210,혹평/Noun,43,28,15,0.0003334444814938313,0.0001888091694617828,0.6511627906976745
2653,4211,쫓다/Verb,43,15,28,0.00018895187284650438,0.0003331926519913814,0.6511627906976745
2654,4212,지니다/Verb,43,27,16,0.00032232966544403684,0.00019991559119482882,0.627906976744186
2655,4213,꺼리다/Verb,43,16,27,0.0002000666888962988,0.00032208623025833537,0.627906976744186
2656,4214,그/Modifier,43,16,27,0.0002000666888962988,0.00032208623025833537,0.627906976744186
2657,4215,라마/Noun,43,16,27,0.0002000666888962988,0.00032208623025833537,0.627906976744186
2658,4216,저번/Noun,43,17,26,0.00021118150494609317,0.00031097980852528933,0.6046511627906976
2659,4217,쓰러지다/Verb,43,17,26,0.00021118150494609317,0.00031097980852528933,0.6046511627906976
2660,4218,은퇴/Noun,43,17,26,0.00021118150494609317,0.00031097980852528933,0.6046511627906976
2661,4219,주목/Noun,43,26,17,0.00031121484939424253,0.0002110220129278749,0.6046511627906976
2662,4220,종류/Noun,43,26,17,0.00031121484939424253,0.0002110220129278749,0.6046511627906976
2663,4221,벽/Noun,43,26,17,0.00031121484939424253,0.0002110220129278749,0.6046511627906976
2664,4242,도통/Noun,42,1,41,3.334444814938313e-05,0.00047757613452098,0.9761904761904762
2665,4243,남아돌다/Verb,42,1,41,3.334444814938313e-05,0.00047757613452098,0.9761904761904762
2666,4244,저급/Noun,42,2,40,4.445926419917751e-05,0.000466469712787934,0.9523809523809524
2667,4245,귀요미/Noun,42,38,4,0.000444592641991775,6.663853039827628e-05,0.9047619047619048
2668,4246,화만/Noun,42,4,38,6.668889629876625e-05,0.0004442568693218419,0.9047619047619048
2669,4247,에든/Josa,42,37,5,0.0004334778259419807,7.774495213132233e-05,0.8809523809523809
2670,4248,집어넣다/Verb,42,5,37,7.780371234856063e-05,0.0004331504475887958,0.8809523809523809
2671,4249,미안/Noun,42,6,36,8.891852839835501e-05,0.0004220440258557498,0.8571428571428571
2672,4250,이준기/Noun,42,35,7,0.0004112481938423919,9.995779559741441e-05,0.8333333333333334
2673,4251,망상/Noun,42,8,34,0.00011114816049794375,0.00039983118238965764,0.8095238095238095
2674,4252,눈뜨다/Verb,42,8,34,0.00011114816049794375,0.00039983118238965764,0.8095238095238095
2675,4253,찜찜하다/Adjective,42,8,34,0.00011114816049794375,0.00039983118238965764,0.8095238095238095
2676,4254,매혹/Noun,42,33,9,0.00038901856174280313,0.00012217063906350652,0.7857142857142857
2677,4255,경계/Noun,42,33,9,0.00038901856174280313,0.00012217063906350652,0.7857142857142857
2678,4256,상치/Noun,42,33,9,0.00038901856174280313,0.00012217063906350652,0.7857142857142857
2679,4257,진짜진짜/Noun,42,33,9,0.00038901856174280313,0.00012217063906350652,0.7857142857142857
2680,4258,자유롭다/Adjective,42,33,9,0.00038901856174280313,0.00012217063906350652,0.7857142857142857
2681,4259,사춘기/Noun,42,32,10,0.00037790374569300877,0.00013327706079655256,0.7619047619047619
2682,4260,앵글/Noun,42,10,32,0.0001333777925975325,0.0003776183389235656,0.7619047619047619
2683,4261,내기/Noun,42,11,31,0.0001444926086473269,0.00036651191719051963,0.7380952380952381
2684,4262,원인/Noun,42,11,31,0.0001444926086473269,0.00036651191719051963,0.7380952380952381
2685,4263,..??/Punctuation,42,11,31,0.0001444926086473269,0.00036651191719051963,0.7380952380952381
2686,4264,박신양/Noun,42,30,12,0.00035567411359342004,0.00015548990426264466,0.7142857142857143
2687,4265,덕후/Noun,42,12,30,0.00015560742469712126,0.0003554054954574735,0.7142857142857143
2688,4266,4년/Number,42,29,13,0.0003445592975436257,0.0001665963259956907,0.6904761904761905
2689,4267,주상욱/Noun,42,13,29,0.00016672224074691566,0.00034429907372442745,0.6904761904761905
2690,4268,강제/Noun,42,13,29,0.00016672224074691566,0.00034429907372442745,0.6904761904761905
2691,4269,유아인/Noun,42,28,14,0.0003334444814938313,0.00017770274772873674,0.6666666666666666
2692,4270,............/Punctuation,42,14,28,0.00017783705679671002,0.0003331926519913814,0.6666666666666666
2693,4271,원표/Noun,42,28,14,0.0003334444814938313,0.00017770274772873674,0.6666666666666666
2694,4272,가르다/Verb,42,28,14,0.0003334444814938313,0.00017770274772873674,0.6666666666666666
2695,4273,도하/Noun,42,27,15,0.00032232966544403684,0.0001888091694617828,0.6428571428571429
2696,4274,3년/Number,42,27,15,0.00032232966544403684,0.0001888091694617828,0.6428571428571429
2697,4275,그딴/Modifier,42,15,27,0.00018895187284650438,0.00032208623025833537,0.6428571428571429
2698,4276,권하다/Verb,42,15,27,0.00018895187284650438,0.00032208623025833537,0.6428571428571429
2699,4277,아프리카/Noun,42,26,16,0.00031121484939424253,0.00019991559119482882,0.6190476190476191
2700,4278,강지환/Noun,42,26,16,0.00031121484939424253,0.00019991559119482882,0.6190476190476191
2701,4306,서프라이즈/Noun,41,2,39,4.445926419917751e-05,0.000455363291054888,0.951219512195122
2702,4307,존잼/Noun,41,39,2,0.00045570745804156943,4.4425686932184186e-05,0.951219512195122
2703,4308,가슴속/Noun,41,39,2,0.00045570745804156943,4.4425686932184186e-05,0.951219512195122
2704,4309,우리네/Noun,41,39,2,0.00045570745804156943,4.4425686932184186e-05,0.951219512195122
2705,4310,소박하다/Adjective,41,38,3,0.000444592641991775,5.553210866523024e-05,0.9268292682926829
2706,4311,짓거리/Noun,41,4,37,6.668889629876625e-05,0.0004331504475887958,0.902439024390244
2707,4312,희망이/Noun,41,36,5,0.00042236300989218633,7.774495213132233e-05,0.8780487804878049
2708,4313,예수님/Noun,41,35,6,0.0004112481938423919,8.885137386436837e-05,0.8536585365853658
2709,4314,충무로/Noun,41,8,33,0.00011114816049794375,0.00038872476065661166,0.8048780487804879
2710,4315,기쁨/Noun,41,33,8,0.00038901856174280313,0.00011106421733046048,0.8048780487804879
2711,4316,두근거리다/Adjective,41,33,8,0.00038901856174280313,0.00011106421733046048,0.8048780487804879
2712,4317,시보/Noun,41,33,8,0.00038901856174280313,0.00011106421733046048,0.8048780487804879
2713,4318,쏙/Noun,41,32,9,0.00037790374569300877,0.00012217063906350652,0.7804878048780488
2714,4319,쌈/Noun,41,9,32,0.00012226297654773814,0.0003776183389235656,0.7804878048780488
2715,4320,멘붕/Noun,41,9,32,0.00012226297654773814,0.0003776183389235656,0.7804878048780488
2716,4321,선하다/Adjective,41,32,9,0.00037790374569300877,0.00012217063906350652,0.7804878048780488
2717,4322,조조/Noun,41,10,31,0.0001333777925975325,0.00036651191719051963,0.7560975609756098
2718,4323,꼴리다/Verb,41,10,31,0.0001333777925975325,0.00036651191719051963,0.7560975609756098
2719,4324,행위/Noun,41,11,30,0.0001444926086473269,0.0003554054954574735,0.7317073170731707
2720,4325,유오성/Noun,41,12,29,0.00015560742469712126,0.00034429907372442745,0.7073170731707317
2721,4326,미흡하다/Adjective,41,12,29,0.00015560742469712126,0.00034429907372442745,0.7073170731707317
2722,4327,^^;/Punctuation,41,29,12,0.0003445592975436257,0.00015548990426264466,0.7073170731707317
2723,4328,오타쿠/Noun,41,12,29,0.00015560742469712126,0.00034429907372442745,0.7073170731707317
2724,4329,어우/Noun,41,12,29,0.00015560742469712126,0.00034429907372442745,0.7073170731707317
2725,4330,피터/Noun,41,29,12,0.0003445592975436257,0.00015548990426264466,0.7073170731707317
2726,4331,쓰기/Noun,41,12,29,0.00015560742469712126,0.00034429907372442745,0.7073170731707317
2727,4332,파고들다/Verb,41,29,12,0.0003445592975436257,0.00015548990426264466,0.7073170731707317
2728,4333,웹툰/Noun,41,12,29,0.00015560742469712126,0.00034429907372442745,0.7073170731707317
2729,4334,이러하다/Adjective,41,29,12,0.0003445592975436257,0.00015548990426264466,0.7073170731707317
2730,4335,->/Punctuation,41,13,28,0.00016672224074691566,0.0003331926519913814,0.6829268292682927
2731,4336,임신/Noun,41,13,28,0.00016672224074691566,0.0003331926519913814,0.6829268292682927
2732,4337,맷/Noun,41,28,13,0.0003334444814938313,0.0001665963259956907,0.6829268292682927
2733,4338,50년/Number,41,28,13,0.0003334444814938313,0.0001665963259956907,0.6829268292682927
2734,4339,디지다/Verb,41,13,28,0.00016672224074691566,0.0003331926519913814,0.6829268292682927
2735,4340,수십/Modifier,41,28,13,0.0003334444814938313,0.0001665963259956907,0.6829268292682927
2736,4341,차이다/Verb,41,13,28,0.00016672224074691566,0.0003331926519913814,0.6829268292682927
2737,4342,2012년/Number,41,14,27,0.00017783705679671002,0.00032208623025833537,0.6585365853658537
2738,4343,언급/Noun,41,14,27,0.00017783705679671002,0.00032208623025833537,0.6585365853658537
2739,4344,통수/Noun,41,14,27,0.00017783705679671002,0.00032208623025833537,0.6585365853658537
2740,4345,대로/Noun,41,14,27,0.00017783705679671002,0.00032208623025833537,0.6585365853658537
2741,4346,부턴/Josa,41,14,27,0.00017783705679671002,0.00032208623025833537,0.6585365853658537
2742,4347,it/Alpha,41,27,14,0.00032232966544403684,0.00017770274772873674,0.6585365853658537
2743,4348,황비홍/Noun,41,26,15,0.00031121484939424253,0.0001888091694617828,0.6341463414634146
2744,4349,해피/Noun,41,26,15,0.00031121484939424253,0.0001888091694617828,0.6341463414634146
2745,4350,지역/Noun,41,15,26,0.00018895187284650438,0.00031097980852528933,0.6341463414634146
2746,4351,궁/Noun,41,15,26,0.00018895187284650438,0.00031097980852528933,0.6341463414634146
2747,4352,날아가다/Verb,41,16,25,0.0002000666888962988,0.0002998733867922433,0.6097560975609756
2748,4353,@/Punctuation,41,16,25,0.0002000666888962988,0.0002998733867922433,0.6097560975609756
2749,4354,레드/Noun,41,25,16,0.00030010003334444816,0.00019991559119482882,0.6097560975609756
2750,4355,압박/Noun,41,16,25,0.0002000666888962988,0.0002998733867922433,0.6097560975609756
2751,4376,위원/Noun,40,2,38,4.445926419917751e-05,0.0004442568693218419,0.95
2752,4377,찡/Adverb,40,37,3,0.0004334778259419807,5.553210866523024e-05,0.925
2753,4378,!^^/Punctuation,40,36,4,0.00042236300989218633,6.663853039827628e-05,0.9
2754,4379,상투/Noun,40,4,36,6.668889629876625e-05,0.0004220440258557498,0.9
2755,4380,마인드/Noun,40,5,35,7.780371234856063e-05,0.0004109376041227037,0.875
2756,4381,오인혜/Noun,40,5,35,7.780371234856063e-05,0.0004109376041227037,0.875
2757,4382,시리다/Adjective,40,35,5,0.0004112481938423919,7.774495213132233e-05,0.875
2758,4383,신파극/Noun,40,7,33,0.0001000333444481494,0.00038872476065661166,0.825
2759,4384,추락/Noun,40,7,33,0.0001000333444481494,0.00038872476065661166,0.825
2760,4385,이라곤/Josa,40,7,33,0.0001000333444481494,0.00038872476065661166,0.825
2761,4386,여정/Noun,40,32,8,0.00037790374569300877,0.00011106421733046048,0.8
2762,4387,귀가/Noun,40,32,8,0.00037790374569300877,0.00011106421733046048,0.8
2763,4388,증/Noun,40,8,32,0.00011114816049794375,0.0003776183389235656,0.8
2764,4389,어느새다/Adjective,40,32,8,0.00037790374569300877,0.00011106421733046048,0.8
2765,4390,이러니/Conjunction,40,8,32,0.00011114816049794375,0.0003776183389235656,0.8
2766,4391,강조/Noun,40,8,32,0.00011114816049794375,0.0003776183389235656,0.8
2767,4392,남자라면/Noun,40,32,8,0.00037790374569300877,0.00011106421733046048,0.8
2768,4393,ebs/Alpha,40,31,9,0.00036678892964321435,0.00012217063906350652,0.775
2769,4394,불법/Noun,40,9,31,0.00012226297654773814,0.00036651191719051963,0.775
2770,4395,저렴하다/Adjective,40,9,31,0.00012226297654773814,0.00036651191719051963,0.775
2771,4396,방이/Noun,40,30,10,0.00035567411359342004,0.00013327706079655256,0.75
2772,4397,곳곳/Noun,40,30,10,0.00035567411359342004,0.00013327706079655256,0.75
2773,4398,경이/Noun,40,30,10,0.00035567411359342004,0.00013327706079655256,0.75
2774,4399,옹박/Noun,40,10,30,0.0001333777925975325,0.0003554054954574735,0.75
2775,4400,자제/Noun,40,10,30,0.0001333777925975325,0.0003554054954574735,0.75
2776,4401,빼/Noun,40,11,29,0.0001444926086473269,0.00034429907372442745,0.725
2777,4402,우월/Noun,40,11,29,0.0001444926086473269,0.00034429907372442745,0.725
2778,4403,~~!/Punctuation,40,29,11,0.0003445592975436257,0.0001443834825295986,0.725
2779,4404,획/Noun,40,29,11,0.0003445592975436257,0.0001443834825295986,0.725
2780,4405,수업/Noun,40,29,11,0.0003445592975436257,0.0001443834825295986,0.725
2781,4406,호러물/Noun,40,11,29,0.0001444926086473269,0.00034429907372442745,0.725
2782,4407,유명/Noun,40,11,29,0.0001444926086473269,0.00034429907372442745,0.725
2783,4408,우디/Noun,40,28,12,0.0003334444814938313,0.00015548990426264466,0.7
2784,4409,승화/Noun,40,28,12,0.0003334444814938313,0.00015548990426264466,0.7
2785,4410,교감/Noun,40,28,12,0.0003334444814938313,0.00015548990426264466,0.7
2786,4411,외우다/Verb,40,28,12,0.0003334444814938313,0.00015548990426264466,0.7
2787,4412,퀴어/Noun,40,28,12,0.0003334444814938313,0.00015548990426264466,0.7
2788,4413,쫒다/Verb,40,13,27,0.00016672224074691566,0.00032208623025833537,0.675
2789,4414,수정/Noun,40,13,27,0.00016672224074691566,0.00032208623025833537,0.675
2790,4415,저녁/Noun,40,13,27,0.00016672224074691566,0.00032208623025833537,0.675
2791,4416,전의/Noun,40,26,14,0.00031121484939424253,0.00017770274772873674,0.65
2792,4417,상의/Noun,40,26,14,0.00031121484939424253,0.00017770274772873674,0.65
2793,4418,독창/Noun,40,14,26,0.00017783705679671002,0.00031097980852528933,0.65
2794,4419,매트릭스/Noun,40,26,14,0.00031121484939424253,0.00017770274772873674,0.65
2795,4420,버젼/Noun,40,15,25,0.00018895187284650438,0.0002998733867922433,0.625
2796,4421,김강우/Noun,40,24,16,0.0002889852172946538,0.00019991559119482882,0.6
2797,4422,런닝맨/Noun,40,16,24,0.0002000666888962988,0.0002887669650591972,0.6
2798,4423,리오/Noun,40,24,16,0.0002889852172946538,0.00019991559119482882,0.6
2799,4424,금방/Noun,40,24,16,0.0002889852172946538,0.00019991559119482882,0.6
2800,4425,정재영/Noun,40,24,16,0.0002889852172946538,0.00019991559119482882,0.6
2801,4426,건드리다/Verb,40,16,24,0.0002000666888962988,0.0002887669650591972,0.6
2802,4449,투자자/Noun,39,0,39,2.2229632099588756e-05,0.000455363291054888,1.0
2803,4450,졸음/Noun,39,1,38,3.334444814938313e-05,0.0004442568693218419,0.9743589743589745
2804,4451,쓰레기통/Noun,39,1,38,3.334444814938313e-05,0.0004442568693218419,0.9743589743589745
2805,4452,문성우/Noun,39,2,37,4.445926419917751e-05,0.0004331504475887958,0.9487179487179488
2806,4453,환불/Noun,39,3,36,5.5574080248971876e-05,0.0004220440258557498,0.9230769230769232
2807,4454,황홀하다/Adjective,39,36,3,0.00042236300989218633,5.553210866523024e-05,0.9230769230769232
2808,4455,뭡/Noun,39,4,35,6.668889629876625e-05,0.0004109376041227037,0.8974358974358975
2809,4456,은은하다/Adjective,39,35,4,0.0004112481938423919,6.663853039827628e-05,0.8974358974358975
2810,4457,에서야/Josa,39,35,4,0.0004112481938423919,6.663853039827628e-05,0.8974358974358975
2811,4458,후지/Noun,39,4,35,6.668889629876625e-05,0.0004109376041227037,0.8974358974358975
2812,4459,우익/Noun,39,5,34,7.780371234856063e-05,0.00039983118238965764,0.8717948717948718
2813,4460,엉덩이/Noun,39,6,33,8.891852839835501e-05,0.00038872476065661166,0.8461538461538461
2814,4461,에릭/Noun,39,33,6,0.00038901856174280313,8.885137386436837e-05,0.8461538461538461
2815,4462,불면증/Noun,39,7,32,0.0001000333444481494,0.0003776183389235656,0.8205128205128205
2816,4463,찌푸리다/Verb,39,7,32,0.0001000333444481494,0.0003776183389235656,0.8205128205128205
2817,4464,구라/Noun,39,7,32,0.0001000333444481494,0.0003776183389235656,0.8205128205128205
2818,4465,젊음/Noun,39,31,8,0.00036678892964321435,0.00011106421733046048,0.7948717948717948
2819,4466,놀이/Suffix,39,8,31,0.00011114816049794375,0.00036651191719051963,0.7948717948717948
2820,4467,파이다/Verb,39,31,8,0.00036678892964321435,0.00011106421733046048,0.7948717948717948
2821,4468,울음/Noun,39,31,8,0.00036678892964321435,0.00011106421733046048,0.7948717948717948
2822,4469,헤어/Noun,39,30,9,0.00035567411359342004,0.00012217063906350652,0.7692307692307693
2823,4470,mbc/Alpha,39,9,30,0.00012226297654773814,0.0003554054954574735,0.7692307692307693
2824,4471,루이스/Noun,39,29,10,0.0003445592975436257,0.00013327706079655256,0.7435897435897436
2825,4472,에일리언/Noun,39,11,28,0.0001444926086473269,0.0003331926519913814,0.7179487179487181
2826,4473,전기/Noun,39,11,28,0.0001444926086473269,0.0003331926519913814,0.7179487179487181
2827,4474,극한/Noun,39,28,11,0.0003334444814938313,0.0001443834825295986,0.7179487179487181
2828,4475,우아하다/Adjective,39,28,11,0.0003334444814938313,0.0001443834825295986,0.7179487179487181
2829,4476,묘미/Noun,39,28,11,0.0003334444814938313,0.0001443834825295986,0.7179487179487181
2830,4477,관계자/Noun,39,11,28,0.0001444926086473269,0.0003331926519913814,0.7179487179487181
2831,4478,로그/Noun,39,11,28,0.0001444926086473269,0.0003331926519913814,0.7179487179487181
2832,4479,사나이/Noun,39,27,12,0.00032232966544403684,0.00015548990426264466,0.6923076923076923
2833,4480,오류/Noun,39,12,27,0.00015560742469712126,0.00032208623025833537,0.6923076923076923
2834,4481,이민정/Noun,39,27,12,0.00032232966544403684,0.00015548990426264466,0.6923076923076923
2835,4482,완/Noun,39,27,12,0.00032232966544403684,0.00015548990426264466,0.6923076923076923
2836,4483,한쪽/Noun,39,12,27,0.00015560742469712126,0.00032208623025833537,0.6923076923076923
2837,4484,활약/Noun,39,27,12,0.00032232966544403684,0.00015548990426264466,0.6923076923076923
2838,4485,필수/Noun,39,27,12,0.00032232966544403684,0.00015548990426264466,0.6923076923076923
2839,4486,제시/Noun,39,27,12,0.00032232966544403684,0.00015548990426264466,0.6923076923076923
2840,4487,찢다/Verb,39,13,26,0.00016672224074691566,0.00031097980852528933,0.6666666666666666
2841,4488,때메/Noun,39,13,26,0.00016672224074691566,0.00031097980852528933,0.6666666666666666
2842,4489,가사/Noun,39,26,13,0.00031121484939424253,0.0001665963259956907,0.6666666666666666
2843,4490,기간/Noun,39,26,13,0.00031121484939424253,0.0001665963259956907,0.6666666666666666
2844,4491,in/Alpha,39,26,13,0.00031121484939424253,0.0001665963259956907,0.6666666666666666
2845,4492,핸드폰/Noun,39,13,26,0.00016672224074691566,0.00031097980852528933,0.6666666666666666
2846,4493,멍청이/Noun,39,13,26,0.00016672224074691566,0.00031097980852528933,0.6666666666666666
2847,4494,사라/Noun,39,26,13,0.00031121484939424253,0.0001665963259956907,0.6666666666666666
2848,4495,쿠/Noun,39,26,13,0.00031121484939424253,0.0001665963259956907,0.6666666666666666
2849,4496,수다/Noun,39,14,25,0.00017783705679671002,0.0002998733867922433,0.6410256410256411
2850,4497,에의/Josa,39,25,14,0.00030010003334444816,0.00017770274772873674,0.6410256410256411
2851,4498,불러일으키다/Verb,39,25,14,0.00030010003334444816,0.00017770274772873674,0.6410256410256411
2852,4499,내겐/Noun,39,25,14,0.00030010003334444816,0.00017770274772873674,0.6410256410256411
2853,4500,크로우/Noun,39,25,14,0.00030010003334444816,0.00017770274772873674,0.6410256410256411
2854,4501,로렌스/Noun,39,25,14,0.00030010003334444816,0.00017770274772873674,0.6410256410256411
2855,4502,다음주/Noun,39,25,14,0.00030010003334444816,0.00017770274772873674,0.6410256410256411
2856,4503,불리다/Verb,39,24,15,0.0002889852172946538,0.0001888091694617828,0.6153846153846154
2857,4504,예매/Noun,39,15,24,0.00018895187284650438,0.0002887669650591972,0.6153846153846154
2858,4505,폭/Noun,39,24,15,0.0002889852172946538,0.0001888091694617828,0.6153846153846154
2859,4506,연장/Noun,39,15,24,0.00018895187284650438,0.0002887669650591972,0.6153846153846154
2860,4507,시르다/Adjective,39,15,24,0.00018895187284650438,0.0002887669650591972,0.6153846153846154
2861,4534,안질리다/Verb,38,37,1,0.0004334778259419807,3.331926519913814e-05,0.9736842105263158
2862,4535,아리다/Adjective,38,36,2,0.00042236300989218633,4.4425686932184186e-05,0.9473684210526316
2863,4536,자빠지다/Verb,38,3,35,5.5574080248971876e-05,0.0004109376041227037,0.9210526315789472
2864,4537,무니/Noun,38,5,33,7.780371234856063e-05,0.00038872476065661166,0.8684210526315791
2865,4538,불친절하다/Adjective,38,5,33,7.780371234856063e-05,0.00038872476065661166,0.8684210526315791
2866,4539,은지/Noun,38,5,33,7.780371234856063e-05,0.00038872476065661166,0.8684210526315791
2867,4540,거창하다/Adjective,38,5,33,7.780371234856063e-05,0.00038872476065661166,0.8684210526315791
2868,4541,깝/Noun,38,6,32,8.891852839835501e-05,0.0003776183389235656,0.8421052631578947
2869,4542,0.5/Number,38,6,32,8.891852839835501e-05,0.0003776183389235656,0.8421052631578947
2870,4543,허탈하다/Adjective,38,7,31,0.0001000333444481494,0.00036651191719051963,0.8157894736842105
2871,4544,!!!!!!!/Punctuation,38,31,7,0.00036678892964321435,9.995779559741441e-05,0.8157894736842105
2872,4545,현대인/Noun,38,31,7,0.00036678892964321435,9.995779559741441e-05,0.8157894736842105
2873,4546,화평/Noun,38,9,29,0.00012226297654773814,0.00034429907372442745,0.7631578947368421
2874,4547,살아오다/Verb,38,29,9,0.0003445592975436257,0.00012217063906350652,0.7631578947368421
2875,4548,까먹다/Verb,38,9,29,0.00012226297654773814,0.00034429907372442745,0.7631578947368421
2876,4549,치열하다/Adjective,38,28,10,0.0003334444814938313,0.00013327706079655256,0.7368421052631579
2877,4550,제작사/Noun,38,10,28,0.0001333777925975325,0.0003331926519913814,0.7368421052631579
2878,4551,경쾌하다/Adjective,38,28,10,0.0003334444814938313,0.00013327706079655256,0.7368421052631579
2879,4552,연령/Noun,38,10,28,0.0001333777925975325,0.0003331926519913814,0.7368421052631579
2880,4553,F/Alpha,38,11,27,0.0001444926086473269,0.00032208623025833537,0.7105263157894737
2881,4554,간의/Noun,38,27,11,0.00032232966544403684,0.0001443834825295986,0.7105263157894737
2882,4555,생략/Noun,38,11,27,0.0001444926086473269,0.00032208623025833537,0.7105263157894737
2883,4556,14년/Number,38,27,11,0.00032232966544403684,0.0001443834825295986,0.7105263157894737
2884,4557,가버리다/Verb,38,12,26,0.00015560742469712126,0.00031097980852528933,0.6842105263157895
2885,4558,미만/Noun,38,12,26,0.00015560742469712126,0.00031097980852528933,0.6842105263157895
2886,4559,전세계/Noun,38,26,12,0.00031121484939424253,0.00015548990426264466,0.6842105263157895
2887,4560,질주/Noun,38,25,13,0.00030010003334444816,0.0001665963259956907,0.6578947368421053
2888,4561,아카데미/Noun,38,25,13,0.00030010003334444816,0.0001665963259956907,0.6578947368421053
2889,4562,부수/Noun,38,13,25,0.00016672224074691566,0.0002998733867922433,0.6578947368421053
2890,4563,동의/Noun,38,13,25,0.00016672224074691566,0.0002998733867922433,0.6578947368421053
2891,4564,청/Noun,38,13,25,0.00016672224074691566,0.0002998733867922433,0.6578947368421053
2892,4565,멍하다/Adjective,38,25,13,0.00030010003334444816,0.0001665963259956907,0.6578947368421053
2893,4566,물어보다/Verb,38,13,25,0.00016672224074691566,0.0002998733867922433,0.6578947368421053
2894,4567,빅뱅/Noun,38,24,14,0.0002889852172946538,0.00017770274772873674,0.631578947368421
2895,4568,레인/Noun,38,14,24,0.00017783705679671002,0.0002887669650591972,0.631578947368421
2896,4569,훈련/Noun,38,14,24,0.00017783705679671002,0.0002887669650591972,0.631578947368421
2897,4570,"..,/Punctuation",38,14,24,0.00017783705679671002,0.0002887669650591972,0.631578947368421
2898,4571,법칙/Noun,38,14,24,0.00017783705679671002,0.0002887669650591972,0.631578947368421
2899,4572,삼다/Verb,38,14,24,0.00017783705679671002,0.0002887669650591972,0.631578947368421
2900,4573,보장/Noun,38,24,14,0.0002889852172946538,0.00017770274772873674,0.631578947368421
2901,4574,마마/Noun,38,14,24,0.00017783705679671002,0.0002887669650591972,0.631578947368421
2902,4575,케이트/Noun,38,23,15,0.00027787040124485944,0.0001888091694617828,0.6052631578947368
2903,4576,얽히다/Verb,38,23,15,0.00027787040124485944,0.0001888091694617828,0.6052631578947368
2904,4577,직장/Noun,38,23,15,0.00027787040124485944,0.0001888091694617828,0.6052631578947368
2905,4578,로마/Noun,38,15,23,0.00018895187284650438,0.00027766054332615115,0.6052631578947368
2906,4579,트릭/Noun,38,23,15,0.00027787040124485944,0.0001888091694617828,0.6052631578947368
2907,4580,현빈/Noun,38,23,15,0.00027787040124485944,0.0001888091694617828,0.6052631578947368
2908,4581,허영/Noun,38,15,23,0.00018895187284650438,0.00027766054332615115,0.6052631578947368
2909,4602,찬란/Noun,37,0,37,2.2229632099588756e-05,0.0004331504475887958,1.0
2910,4603,채플린/Noun,37,34,3,0.0004001333777925976,5.553210866523024e-05,0.9189189189189191
2911,4604,대책/Noun,37,3,34,5.5574080248971876e-05,0.00039983118238965764,0.9189189189189191
2912,4605,날로/Noun,37,3,34,5.5574080248971876e-05,0.00039983118238965764,0.9189189189189191
2913,4606,개잼/Noun,37,33,4,0.00038901856174280313,6.663853039827628e-05,0.8918918918918919
2914,4607,워싱턴/Noun,37,33,4,0.00038901856174280313,6.663853039827628e-05,0.8918918918918919
2915,4608,꾹/Noun,37,4,33,6.668889629876625e-05,0.00038872476065661166,0.8918918918918919
2916,4609,거뭐/Noun,37,5,32,7.780371234856063e-05,0.0003776183389235656,0.8648648648648649
2917,4610,설레임/Noun,37,32,5,0.00037790374569300877,7.774495213132233e-05,0.8648648648648649
2918,4611,습작/Noun,37,5,32,7.780371234856063e-05,0.0003776183389235656,0.8648648648648649
2919,4612,신들리다/Adjective,37,32,5,0.00037790374569300877,7.774495213132233e-05,0.8648648648648649
2920,4613,두근두근/Adverb,37,31,6,0.00036678892964321435,8.885137386436837e-05,0.8378378378378378
2921,4614,뇌리/Noun,37,31,6,0.00036678892964321435,8.885137386436837e-05,0.8378378378378378
2922,4615,패턴/Noun,37,6,31,8.891852839835501e-05,0.00036651191719051963,0.8378378378378378
2923,4616,공개/Noun,37,6,31,8.891852839835501e-05,0.00036651191719051963,0.8378378378378378
2924,4617,동아리/Noun,37,6,31,8.891852839835501e-05,0.00036651191719051963,0.8378378378378378
2925,4618,몰락/Noun,37,7,30,0.0001000333444481494,0.0003554054954574735,0.8108108108108109
2926,4619,옹호/Noun,37,7,30,0.0001000333444481494,0.0003554054954574735,0.8108108108108109
2927,4620,껄/Noun,37,7,30,0.0001000333444481494,0.0003554054954574735,0.8108108108108109
2928,4621,오로라/Noun,37,7,30,0.0001000333444481494,0.0003554054954574735,0.8108108108108109
2929,4622,신비롭다/Adjective,37,30,7,0.00035567411359342004,9.995779559741441e-05,0.8108108108108109
2930,4623,이라고는/Josa,37,8,29,0.00011114816049794375,0.00034429907372442745,0.7837837837837838
2931,4624,넋/Noun,37,29,8,0.0003445592975436257,0.00011106421733046048,0.7837837837837838
2932,4625,눈부시다/Adjective,37,29,8,0.0003445592975436257,0.00011106421733046048,0.7837837837837838
2933,4626,서우/Noun,37,8,29,0.00011114816049794375,0.00034429907372442745,0.7837837837837838
2934,4627,라곤/Josa,37,8,29,0.00011114816049794375,0.00034429907372442745,0.7837837837837838
2935,4628,닦다/Verb,37,8,29,0.00011114816049794375,0.00034429907372442745,0.7837837837837838
2936,4629,강호동/Noun,37,9,28,0.00012226297654773814,0.0003331926519913814,0.7567567567567568
2937,4630,탕웨이/Noun,37,28,9,0.0003334444814938313,0.00012217063906350652,0.7567567567567568
2938,4631,유도/Noun,37,9,28,0.00012226297654773814,0.0003331926519913814,0.7567567567567568
2939,4632,고질라/Noun,37,9,28,0.00012226297654773814,0.0003331926519913814,0.7567567567567568
2940,4633,엠마/Noun,37,28,9,0.0003334444814938313,0.00012217063906350652,0.7567567567567568
2941,4634,이남/Noun,37,28,9,0.0003334444814938313,0.00012217063906350652,0.7567567567567568
2942,4635,켄/Noun,37,28,9,0.0003334444814938313,0.00012217063906350652,0.7567567567567568
2943,4636,오랜/Adverb,37,27,10,0.00032232966544403684,0.00013327706079655256,0.7297297297297297
2944,4637,.!!/Punctuation,37,27,10,0.00032232966544403684,0.00013327706079655256,0.7297297297297297
2945,4638,근거/Noun,37,10,27,0.0001333777925975325,0.00032208623025833537,0.7297297297297297
2946,4639,브래드피트/Noun,37,27,10,0.00032232966544403684,0.00013327706079655256,0.7297297297297297
2947,4640,엑소시스트/Noun,37,10,27,0.0001333777925975325,0.00032208623025833537,0.7297297297297297
2948,4641,예의/Noun,37,11,26,0.0001444926086473269,0.00031097980852528933,0.7027027027027027
2949,4642,수술/Noun,37,11,26,0.0001444926086473269,0.00031097980852528933,0.7027027027027027
2950,4643,힙합/Noun,37,11,26,0.0001444926086473269,0.00031097980852528933,0.7027027027027027
2951,4644,............./Punctuation,37,11,26,0.0001444926086473269,0.00031097980852528933,0.7027027027027027
2952,4645,마초/Noun,37,11,26,0.0001444926086473269,0.00031097980852528933,0.7027027027027027
2953,4646,부담스럽다/Adjective,37,11,26,0.0001444926086473269,0.00031097980852528933,0.7027027027027027
2954,4647,소문/Noun,37,11,26,0.0001444926086473269,0.00031097980852528933,0.7027027027027027
2955,4648,사서/Noun,37,26,11,0.00031121484939424253,0.0001443834825295986,0.7027027027027027
2956,4649,변호사/Noun,37,26,11,0.00031121484939424253,0.0001443834825295986,0.7027027027027027
2957,4650,신선/Noun,37,25,12,0.00030010003334444816,0.00015548990426264466,0.6756756756756757
2958,4651,성향/Noun,37,12,25,0.00015560742469712126,0.0002998733867922433,0.6756756756756757
2959,4652,육체/Noun,37,13,24,0.00016672224074691566,0.0002887669650591972,0.6486486486486487
2960,4653,신현준/Noun,37,14,23,0.00017783705679671002,0.00027766054332615115,0.6216216216216216
2961,4654,진의/Noun,37,14,23,0.00017783705679671002,0.00027766054332615115,0.6216216216216216
2962,4655,유작/Noun,37,14,23,0.00017783705679671002,0.00027766054332615115,0.6216216216216216
2963,4656,간절하다/Adjective,37,23,14,0.00027787040124485944,0.00017770274772873674,0.6216216216216216
2964,4657,안경/Noun,37,14,23,0.00017783705679671002,0.00027766054332615115,0.6216216216216216
2965,4658,라지/Josa,37,14,23,0.00017783705679671002,0.00027766054332615115,0.6216216216216216
2966,4659,히트/Noun,37,23,14,0.00027787040124485944,0.00017770274772873674,0.6216216216216216
2967,4660,거울/Noun,37,23,14,0.00027787040124485944,0.00017770274772873674,0.6216216216216216
2968,4661,까지의/Josa,37,23,14,0.00027787040124485944,0.00017770274772873674,0.6216216216216216
2969,4694,낚임/Noun,36,0,36,2.2229632099588756e-05,0.0004220440258557498,1.0
2970,4695,되돌아보다/Verb,36,35,1,0.0004112481938423919,3.331926519913814e-05,0.9722222222222222
2971,4696,보고/Foreign,36,3,33,5.5574080248971876e-05,0.00038872476065661166,0.9166666666666666
2972,4697,치기/Noun,36,3,33,5.5574080248971876e-05,0.00038872476065661166,0.9166666666666666
2973,4698,큐브/Noun,36,4,32,6.668889629876625e-05,0.0003776183389235656,0.8888888888888888
2974,4699,욤/Noun,36,31,5,0.00036678892964321435,7.774495213132233e-05,0.8611111111111112
2975,4700,허니/Noun,36,31,5,0.00036678892964321435,7.774495213132233e-05,0.8611111111111112
2976,4701,100분/Number,36,5,31,7.780371234856063e-05,0.00036651191719051963,0.8611111111111112
2977,4702,발암/Noun,36,5,31,7.780371234856063e-05,0.00036651191719051963,0.8611111111111112
2978,4703,엑스트라/Noun,36,6,30,8.891852839835501e-05,0.0003554054954574735,0.8333333333333334
2979,4704,서극/Noun,36,7,29,0.0001000333444481494,0.00034429907372442745,0.8055555555555556
2980,4705,멋대로/Noun,36,7,29,0.0001000333444481494,0.00034429907372442745,0.8055555555555556
2981,4706,평이하다/Adjective,36,7,29,0.0001000333444481494,0.00034429907372442745,0.8055555555555556
2982,4707,내러티브/Noun,36,8,28,0.00011114816049794375,0.0003331926519913814,0.7777777777777778
2983,4708,볼껄/Noun,36,8,28,0.00011114816049794375,0.0003331926519913814,0.7777777777777778
2984,4709,t/Alpha,36,28,8,0.0003334444814938313,0.00011106421733046048,0.7777777777777778
2985,4710,하차/Noun,36,8,28,0.00011114816049794375,0.0003331926519913814,0.7777777777777778
2986,4711,!!!!!!!!/Punctuation,36,28,8,0.0003334444814938313,0.00011106421733046048,0.7777777777777778
2987,4712,꽉/Noun,36,28,8,0.0003334444814938313,0.00011106421733046048,0.7777777777777778
2988,4713,역사왜곡/Noun,36,9,27,0.00012226297654773814,0.00032208623025833537,0.75
2989,4714,자신감/Noun,36,9,27,0.00012226297654773814,0.00032208623025833537,0.75
2990,4715,진화/Noun,36,26,10,0.00031121484939424253,0.00013327706079655256,0.7222222222222222
2991,4716,자본주의/Noun,36,26,10,0.00031121484939424253,0.00013327706079655256,0.7222222222222222
2992,4717,줄리엣/Noun,36,26,10,0.00031121484939424253,0.00013327706079655256,0.7222222222222222
2993,4718,다가가다/Verb,36,26,10,0.00031121484939424253,0.00013327706079655256,0.7222222222222222
2994,4719,지진희/Noun,36,10,26,0.0001333777925975325,0.00031097980852528933,0.7222222222222222
2995,4720,수애/Noun,36,25,11,0.00030010003334444816,0.0001443834825295986,0.6944444444444444
2996,4721,정신차리다/Adjective,36,11,25,0.0001444926086473269,0.0002998733867922433,0.6944444444444444
2997,4722,먹이다/Verb,36,12,24,0.00015560742469712126,0.0002887669650591972,0.6666666666666666
2998,4723,어찌나/Adverb,36,24,12,0.0002889852172946538,0.00015548990426264466,0.6666666666666666
2999,4724,문근영/Noun,36,24,12,0.0002889852172946538,0.00015548990426264466,0.6666666666666666
3000,4725,호평/Noun,36,12,24,0.00015560742469712126,0.0002887669650591972,0.6666666666666666
3001,4726,호소/Noun,36,13,23,0.00016672224074691566,0.00027766054332615115,0.6388888888888888
3002,4727,신은경/Noun,36,13,23,0.00016672224074691566,0.00027766054332615115,0.6388888888888888
3003,4728,일대기/Noun,36,23,13,0.00027787040124485944,0.0001665963259956907,0.6388888888888888
3004,4729,투표/Noun,36,13,23,0.00016672224074691566,0.00027766054332615115,0.6388888888888888
3005,4730,판치다/Verb,36,13,23,0.00016672224074691566,0.00027766054332615115,0.6388888888888888
3006,4731,휘/Noun,36,13,23,0.00016672224074691566,0.00027766054332615115,0.6388888888888888
3007,4732,놀람/Noun,36,22,14,0.000266755585195065,0.00017770274772873674,0.6111111111111112
3008,4733,런닝/Noun,36,14,22,0.00017783705679671002,0.00026655412159310506,0.6111111111111112
3009,4734,오리/Noun,36,14,22,0.00017783705679671002,0.00026655412159310506,0.6111111111111112
3010,4735,김하늘/Noun,36,22,14,0.000266755585195065,0.00017770274772873674,0.6111111111111112
3011,4736,"?""/Punctuation",36,14,22,0.00017783705679671002,0.00026655412159310506,0.6111111111111112
3012,4766,♡♡/Foreign,35,35,0,0.0004112481938423919,2.2212843466092093e-05,1.0
3013,4767,최저/Noun,35,1,34,3.334444814938313e-05,0.00039983118238965764,0.9714285714285714
3014,4768,나열/Noun,35,2,33,4.445926419917751e-05,0.00038872476065661166,0.9428571428571428
3015,4769,알맹이/Noun,35,2,33,4.445926419917751e-05,0.00038872476065661166,0.9428571428571428
3016,4770,정신건강/Noun,35,3,32,5.5574080248971876e-05,0.0003776183389235656,0.9142857142857144
3017,4771,도아/Noun,35,3,32,5.5574080248971876e-05,0.0003776183389235656,0.9142857142857144
3018,4772,건강하다/Adjective,35,31,4,0.00036678892964321435,6.663853039827628e-05,0.8857142857142857
3019,4773,^_^/Punctuation,35,30,5,0.00035567411359342004,7.774495213132233e-05,0.8571428571428571
3020,4774,선전/Noun,35,5,30,7.780371234856063e-05,0.0003554054954574735,0.8571428571428571
3021,4775,구매/Noun,35,29,6,0.0003445592975436257,8.885137386436837e-05,0.8285714285714286
3022,4776,진솔하다/Adjective,35,29,6,0.0003445592975436257,8.885137386436837e-05,0.8285714285714286
3023,4777,이나마/Josa,35,29,6,0.0003445592975436257,8.885137386436837e-05,0.8285714285714286
3024,4778,어물/Noun,35,6,29,8.891852839835501e-05,0.00034429907372442745,0.8285714285714286
3025,4779,찰리/Noun,35,28,7,0.0003334444814938313,9.995779559741441e-05,0.8
3026,4780,합리화/Noun,35,7,28,0.0001000333444481494,0.0003331926519913814,0.8
3027,4781,작정/Noun,35,8,27,0.00011114816049794375,0.00032208623025833537,0.7714285714285715
3028,4782,데이먼/Noun,35,27,8,0.00032232966544403684,0.00011106421733046048,0.7714285714285715
3029,4783,잡지/Noun,35,8,27,0.00011114816049794375,0.00032208623025833537,0.7714285714285715
3030,4784,갑갑하다/Adjective,35,8,27,0.00011114816049794375,0.00032208623025833537,0.7714285714285715
3031,4785,인내/Noun,35,9,26,0.00012226297654773814,0.00031097980852528933,0.7428571428571429
3032,4786,미군/Noun,35,9,26,0.00012226297654773814,0.00031097980852528933,0.7428571428571429
3033,4787,발톱/Noun,35,9,26,0.00012226297654773814,0.00031097980852528933,0.7428571428571429
3034,4788,괴롭히다/Verb,35,9,26,0.00012226297654773814,0.00031097980852528933,0.7428571428571429
3035,4789,과도/Josa,35,26,9,0.00031121484939424253,0.00012217063906350652,0.7428571428571429
3036,4790,악몽/Noun,35,9,26,0.00012226297654773814,0.00031097980852528933,0.7428571428571429
3037,4791,ㄴㄴ/KoreanParticle,35,9,26,0.00012226297654773814,0.00031097980852528933,0.7428571428571429
3038,4792,보스/Noun,35,9,26,0.00012226297654773814,0.00031097980852528933,0.7428571428571429
3039,4793,띄우다/Verb,35,9,26,0.00012226297654773814,0.00031097980852528933,0.7428571428571429
3040,4794,치밀다/Verb,35,9,26,0.00012226297654773814,0.00031097980852528933,0.7428571428571429
3041,4795,광주/Noun,35,9,26,0.00012226297654773814,0.00031097980852528933,0.7428571428571429
3042,4796,혼나다/Verb,35,10,25,0.0001333777925975325,0.0002998733867922433,0.7142857142857143
3043,4797,태우다/Verb,35,10,25,0.0001333777925975325,0.0002998733867922433,0.7142857142857143
3044,4798,엘/Noun,35,25,10,0.00030010003334444816,0.00013327706079655256,0.7142857142857143
3045,4799,잣/Noun,35,10,25,0.0001333777925975325,0.0002998733867922433,0.7142857142857143
3046,4800,마구/Noun,35,10,25,0.0001333777925975325,0.0002998733867922433,0.7142857142857143
3047,4801,설치다/Adjective,35,10,25,0.0001333777925975325,0.0002998733867922433,0.7142857142857143
3048,4802,스포일러/Noun,35,24,11,0.0002889852172946538,0.0001443834825295986,0.6857142857142857
3049,4803,여자도/Noun,35,11,24,0.0001444926086473269,0.0002887669650591972,0.6857142857142857
3050,4804,쌓이다/Verb,35,11,24,0.0001444926086473269,0.0002887669650591972,0.6857142857142857
3051,4805,흘러나오다/Verb,35,23,12,0.00027787040124485944,0.00015548990426264466,0.6571428571428571
3052,4806,스티브/Noun,35,23,12,0.00027787040124485944,0.00015548990426264466,0.6571428571428571
3053,4807,이분/Noun,35,23,12,0.00027787040124485944,0.00015548990426264466,0.6571428571428571
3054,4808,한국말/Noun,35,12,23,0.00015560742469712126,0.00027766054332615115,0.6571428571428571
3055,4809,로우/Noun,35,23,12,0.00027787040124485944,0.00015548990426264466,0.6571428571428571
3056,4810,족/Noun,35,12,23,0.00015560742469712126,0.00027766054332615115,0.6571428571428571
3057,4811,듯이/Noun,35,12,23,0.00015560742469712126,0.00027766054332615115,0.6571428571428571
3058,4812,캐서린/Noun,35,12,23,0.00015560742469712126,0.00027766054332615115,0.6571428571428571
3059,4813,이완/Noun,35,22,13,0.000266755585195065,0.0001665963259956907,0.6285714285714286
3060,4814,주의자/Noun,35,13,22,0.00016672224074691566,0.00026655412159310506,0.6285714285714286
3061,4815,리들리/Noun,35,21,14,0.00025564076914527065,0.00017770274772873674,0.6
3062,4816,직전/Noun,35,14,21,0.00017783705679671002,0.0002554476998600591,0.6
3063,4817,엇음/Noun,35,14,21,0.00017783705679671002,0.0002554476998600591,0.6
3064,4818,낭/Noun,35,14,21,0.00017783705679671002,0.0002554476998600591,0.6
3065,4819,사이/Modifier,35,21,14,0.00025564076914527065,0.00017770274772873674,0.6
3066,4820,기독교인/Noun,35,14,21,0.00017783705679671002,0.0002554476998600591,0.6
3067,4821,프로젝트/Noun,35,14,21,0.00017783705679671002,0.0002554476998600591,0.6
3068,4822,~~~~~~/Punctuation,35,14,21,0.00017783705679671002,0.0002554476998600591,0.6
3069,4823,한지민/Noun,35,21,14,0.00025564076914527065,0.00017770274772873674,0.6
3070,4847,퉤/Noun,34,2,32,4.445926419917751e-05,0.0003776183389235656,0.9411764705882352
3071,4848,만큼도/Josa,34,2,32,4.445926419917751e-05,0.0003776183389235656,0.9411764705882352
3072,4849,박신혜/Noun,34,31,3,0.00036678892964321435,5.553210866523024e-05,0.9117647058823528
3073,4850,자질/Noun,34,3,31,5.5574080248971876e-05,0.00036651191719051963,0.9117647058823528
3074,4851,...;;;/Punctuation,34,3,31,5.5574080248971876e-05,0.00036651191719051963,0.9117647058823528
3075,4852,공효진/Noun,34,30,4,0.00035567411359342004,6.663853039827628e-05,0.8823529411764706
3076,4853,톰크루즈/Noun,34,29,5,0.0003445592975436257,7.774495213132233e-05,0.8529411764705882
3077,4854,맑은/Noun,34,29,5,0.0003445592975436257,7.774495213132233e-05,0.8529411764705882
3078,4855,칠이/Noun,34,5,29,7.780371234856063e-05,0.00034429907372442745,0.8529411764705882
3079,4856,동호/Noun,34,5,29,7.780371234856063e-05,0.00034429907372442745,0.8529411764705882
3080,4857,이동욱/Noun,34,29,5,0.0003445592975436257,7.774495213132233e-05,0.8529411764705882
3081,4858,동기/Noun,34,6,28,8.891852839835501e-05,0.0003331926519913814,0.8235294117647058
3082,4859,~!!!!/Punctuation,34,27,7,0.00032232966544403684,9.995779559741441e-05,0.7941176470588235
3083,4860,가시/Noun,34,27,7,0.00032232966544403684,9.995779559741441e-05,0.7941176470588235
3084,4861,급전/Noun,34,7,27,0.0001000333444481494,0.00032208623025833537,0.7941176470588235
3085,4862,또한/Modifier,34,27,7,0.00032232966544403684,9.995779559741441e-05,0.7941176470588235
3086,4863,고려/Noun,34,7,27,0.0001000333444481494,0.00032208623025833537,0.7941176470588235
3087,4864,지다/Noun,34,27,7,0.00032232966544403684,9.995779559741441e-05,0.7941176470588235
3088,4865,카타르/Noun,34,27,7,0.00032232966544403684,9.995779559741441e-05,0.7941176470588235
3089,4866,숭고하다/Adjective,34,27,7,0.00032232966544403684,9.995779559741441e-05,0.7941176470588235
3090,4867,화이/Noun,34,27,7,0.00032232966544403684,9.995779559741441e-05,0.7941176470588235
3091,4868,뺨/Noun,34,8,26,0.00011114816049794375,0.00031097980852528933,0.7647058823529411
3092,4869,아웃/Noun,34,8,26,0.00011114816049794375,0.00031097980852528933,0.7647058823529411
3093,4870,출연료/Noun,34,8,26,0.00011114816049794375,0.00031097980852528933,0.7647058823529411
3094,4871,흥겹다/Adjective,34,26,8,0.00031121484939424253,0.00011106421733046048,0.7647058823529411
3095,4872,비급/Noun,34,8,26,0.00011114816049794375,0.00031097980852528933,0.7647058823529411
3096,4873,통한/Noun,34,26,8,0.00031121484939424253,0.00011106421733046048,0.7647058823529411
3097,4874,저예산영화/Noun,34,8,26,0.00011114816049794375,0.00031097980852528933,0.7647058823529411
3098,4875,멜깁슨/Noun,34,26,8,0.00031121484939424253,0.00011106421733046048,0.7647058823529411
3099,4876,어딨다/Verb,34,8,26,0.00011114816049794375,0.00031097980852528933,0.7647058823529411
3100,4877,행운/Noun,34,25,9,0.00030010003334444816,0.00012217063906350652,0.7352941176470589
3101,4878,도망/Noun,34,9,25,0.00012226297654773814,0.0002998733867922433,0.7352941176470589
3102,4879,린치/Noun,34,25,9,0.00030010003334444816,0.00012217063906350652,0.7352941176470589
3103,4880,잘쓰다/Verb,34,9,25,0.00012226297654773814,0.0002998733867922433,0.7352941176470589
3104,4881,또다시/Adverb,34,25,9,0.00030010003334444816,0.00012217063906350652,0.7352941176470589
3105,4882,처참하다/Adjective,34,9,25,0.00012226297654773814,0.0002998733867922433,0.7352941176470589
3106,4883,두/Modifier,34,9,25,0.00012226297654773814,0.0002998733867922433,0.7352941176470589
3107,4884,흐/Noun,34,25,9,0.00030010003334444816,0.00012217063906350652,0.7352941176470589
3108,4885,속도/Noun,34,10,24,0.0001333777925975325,0.0002887669650591972,0.7058823529411765
3109,4886,일본어/Noun,34,10,24,0.0001333777925975325,0.0002887669650591972,0.7058823529411765
3110,4887,털리다/Verb,34,10,24,0.0001333777925975325,0.0002887669650591972,0.7058823529411765
3111,4888,나아가다/Verb,34,24,10,0.0002889852172946538,0.00013327706079655256,0.7058823529411765
3112,4889,질투/Noun,34,24,10,0.0002889852172946538,0.00013327706079655256,0.7058823529411765
3113,4890,사이코패스/Noun,34,10,24,0.0001333777925975325,0.0002887669650591972,0.7058823529411765
3114,4891,2010년/Number,34,10,24,0.0001333777925975325,0.0002887669650591972,0.7058823529411765
3115,4892,김남길/Noun,34,24,10,0.0002889852172946538,0.00013327706079655256,0.7058823529411765
3116,4893,스치다/Verb,34,24,10,0.0002889852172946538,0.00013327706079655256,0.7058823529411765
3117,4894,파일/Noun,34,23,11,0.00027787040124485944,0.0001443834825295986,0.6764705882352942
3118,4895,S/Alpha,34,23,11,0.00027787040124485944,0.0001443834825295986,0.6764705882352942
3119,4896,떼/Noun,34,11,23,0.0001444926086473269,0.00027766054332615115,0.6764705882352942
3120,4897,토미/Noun,34,23,11,0.00027787040124485944,0.0001443834825295986,0.6764705882352942
3121,4898,?'/Punctuation,34,12,22,0.00015560742469712126,0.00026655412159310506,0.6470588235294118
3122,4899,페이지/Noun,34,22,12,0.000266755585195065,0.00015548990426264466,0.6470588235294118
3123,4900,중이/Noun,34,22,12,0.000266755585195065,0.00015548990426264466,0.6470588235294118
3124,4901,좌절/Noun,34,22,12,0.000266755585195065,0.00015548990426264466,0.6470588235294118
3125,4902,...!!/Punctuation,34,22,12,0.000266755585195065,0.00015548990426264466,0.6470588235294118
3126,4903,아르/Noun,34,22,12,0.000266755585195065,0.00015548990426264466,0.6470588235294118
3127,4904,프레데터/Noun,34,12,22,0.00015560742469712126,0.00026655412159310506,0.6470588235294118
3128,4905,고찰/Noun,34,22,12,0.000266755585195065,0.00015548990426264466,0.6470588235294118
3129,4906,고개/Noun,34,12,22,0.00015560742469712126,0.00026655412159310506,0.6470588235294118
3130,4907,고소영/Noun,34,12,22,0.00015560742469712126,0.00026655412159310506,0.6470588235294118
3131,4908,여우/Noun,34,22,12,0.000266755585195065,0.00015548990426264466,0.6470588235294118
3132,4909,안목/Noun,34,12,22,0.00015560742469712126,0.00026655412159310506,0.6470588235294118
3133,4910,이슈/Noun,34,13,21,0.00016672224074691566,0.0002554476998600591,0.6176470588235294
3134,4911,브리/Noun,34,21,13,0.00025564076914527065,0.0001665963259956907,0.6176470588235294
3135,4912,거대/Noun,34,13,21,0.00016672224074691566,0.0002554476998600591,0.6176470588235294
3136,4913,개독/Noun,34,13,21,0.00016672224074691566,0.0002554476998600591,0.6176470588235294
3137,4914,남자친구/Noun,34,21,13,0.00025564076914527065,0.0001665963259956907,0.6176470588235294
3138,4915,라며/Noun,34,13,21,0.00016672224074691566,0.0002554476998600591,0.6176470588235294
3139,4916,플레이/Noun,34,13,21,0.00016672224074691566,0.0002554476998600591,0.6176470588235294
3140,4956,!!^^/Punctuation,33,33,0,0.00038901856174280313,2.2212843466092093e-05,1.0
3141,4957,앓이/Noun,33,33,0,0.00038901856174280313,2.2212843466092093e-05,1.0
3142,4958,서세원/Noun,33,1,32,3.334444814938313e-05,0.0003776183389235656,0.9696969696969696
3143,4959,모처럼/Noun,33,32,1,0.00037790374569300877,3.331926519913814e-05,0.9696969696969696
3144,4960,알차다/Adjective,33,31,2,0.00036678892964321435,4.4425686932184186e-05,0.9393939393939394
3145,4961,조아/Adverb,33,31,2,0.00036678892964321435,4.4425686932184186e-05,0.9393939393939394
3146,4962,국뽕/Noun,33,3,30,5.5574080248971876e-05,0.0003554054954574735,0.9090909090909092
3147,4963,듣보잡/Noun,33,3,30,5.5574080248971876e-05,0.0003554054954574735,0.9090909090909092
3148,4964,best/Alpha,33,30,3,0.00035567411359342004,5.553210866523024e-05,0.9090909090909092
3149,4965,혹성탈출/Noun,33,6,27,8.891852839835501e-05,0.00032208623025833537,0.8181818181818182
3150,4966,어줍다/Adjective,33,6,27,8.891852839835501e-05,0.00032208623025833537,0.8181818181818182
3151,4967,매회/Adverb,33,27,6,0.00032232966544403684,8.885137386436837e-05,0.8181818181818182
3152,4968,놀이/Noun,33,7,26,0.0001000333444481494,0.00031097980852528933,0.7878787878787878
3153,4969,각인/Noun,33,26,7,0.00031121484939424253,9.995779559741441e-05,0.7878787878787878
3154,4970,공격/Noun,33,7,26,0.0001000333444481494,0.00031097980852528933,0.7878787878787878
3155,4971,사랑과전쟁/Noun,33,8,25,0.00011114816049794375,0.0002998733867922433,0.7575757575757576
3156,4972,마련/Noun,33,25,8,0.00030010003334444816,0.00011106421733046048,0.7575757575757576
3157,4973,발레/Noun,33,25,8,0.00030010003334444816,0.00011106421733046048,0.7575757575757576
3158,4974,해대/Noun,33,8,25,0.00011114816049794375,0.0002998733867922433,0.7575757575757576
3159,4975,전결/Noun,33,8,25,0.00011114816049794375,0.0002998733867922433,0.7575757575757576
3160,4976,진구/Noun,33,24,9,0.0002889852172946538,0.00012217063906350652,0.7272727272727273
3161,4977,서서히/Noun,33,24,9,0.0002889852172946538,0.00012217063906350652,0.7272727272727273
3162,4978,갑작스럽다/Adjective,33,9,24,0.00012226297654773814,0.0002887669650591972,0.7272727272727273
3163,4979,자아내다/Verb,33,24,9,0.0002889852172946538,0.00012217063906350652,0.7272727272727273
3164,4980,대의/Foreign,33,24,9,0.0002889852172946538,0.00012217063906350652,0.7272727272727273
3165,4981,대도/Noun,33,9,24,0.00012226297654773814,0.0002887669650591972,0.7272727272727273
3166,4982,나이트/Noun,33,10,23,0.0001333777925975325,0.00027766054332615115,0.696969696969697
3167,4983,얼른/Noun,33,23,10,0.00027787040124485944,0.00013327706079655256,0.696969696969697
3168,4984,재회/Noun,33,23,10,0.00027787040124485944,0.00013327706079655256,0.696969696969697
3169,4985,좌파/Noun,33,10,23,0.0001333777925975325,0.00027766054332615115,0.696969696969697
3170,4986,회장/Noun,33,10,23,0.0001333777925975325,0.00027766054332615115,0.696969696969697
3171,4987,돌아다니다/Verb,33,10,23,0.0001333777925975325,0.00027766054332615115,0.696969696969697
3172,4988,부러/Noun,33,23,10,0.00027787040124485944,0.00013327706079655256,0.696969696969697
3173,4989,승/Noun,33,11,22,0.0001444926086473269,0.00026655412159310506,0.6666666666666666
3174,4990,…/Punctuation,33,11,22,0.0001444926086473269,0.00026655412159310506,0.6666666666666666
3175,4991,후유증/Noun,33,22,11,0.000266755585195065,0.0001443834825295986,0.6666666666666666
3176,4992,안녕/Noun,33,22,11,0.000266755585195065,0.0001443834825295986,0.6666666666666666
3177,4993,에게나/Josa,33,22,11,0.000266755585195065,0.0001443834825295986,0.6666666666666666
3178,4994,효민/Noun,33,11,22,0.0001444926086473269,0.00026655412159310506,0.6666666666666666
3179,4995,피우다/Verb,33,11,22,0.0001444926086473269,0.00026655412159310506,0.6666666666666666
3180,4996,까지가/Josa,33,11,22,0.0001444926086473269,0.00026655412159310506,0.6666666666666666
3181,4997,케이스/Noun,33,11,22,0.0001444926086473269,0.00026655412159310506,0.6666666666666666
3182,4998,낯선/Noun,33,22,11,0.000266755585195065,0.0001443834825295986,0.6666666666666666
3183,4999,과제/Noun,33,12,21,0.00015560742469712126,0.0002554476998600591,0.6363636363636364
3184,5000,괴수/Noun,33,12,21,0.00015560742469712126,0.0002554476998600591,0.6363636363636364
3185,5001,장인/Noun,33,21,12,0.00025564076914527065,0.00015548990426264466,0.6363636363636364
3186,5002,미로/Noun,33,12,21,0.00015560742469712126,0.0002554476998600591,0.6363636363636364
3187,5003,시청율/Noun,33,12,21,0.00015560742469712126,0.0002554476998600591,0.6363636363636364
3188,5004,탕/Noun,33,12,21,0.00015560742469712126,0.0002554476998600591,0.6363636363636364
3189,5005,지성/Noun,33,21,12,0.00025564076914527065,0.00015548990426264466,0.6363636363636364
3190,5006,↓/Foreign,33,12,21,0.00015560742469712126,0.0002554476998600591,0.6363636363636364
3191,5007,만으로는/Josa,33,13,20,0.00016672224074691566,0.00024434127812701304,0.6060606060606061
3192,5008,대만/Noun,33,13,20,0.00016672224074691566,0.00024434127812701304,0.6060606060606061
3193,5009,신뢰/Noun,33,13,20,0.00016672224074691566,0.00024434127812701304,0.6060606060606061
3194,5010,人/Foreign,33,13,20,0.00016672224074691566,0.00024434127812701304,0.6060606060606061
3195,5011,고정/Noun,33,20,13,0.00024452595309547634,0.0001665963259956907,0.6060606060606061
3196,5012,서방/Noun,33,13,20,0.00016672224074691566,0.00024434127812701304,0.6060606060606061
3197,5013,2회/Number,33,20,13,0.00024452595309547634,0.0001665963259956907,0.6060606060606061
3198,5051,보석같다/Adjective,32,31,1,0.00036678892964321435,3.331926519913814e-05,0.96875
3199,5052,명곡/Noun,32,30,2,0.00035567411359342004,4.4425686932184186e-05,0.9375
3200,5053,유행어/Noun,32,2,30,4.445926419917751e-05,0.0003554054954574735,0.9375
3201,5054,AV/Alpha,32,2,30,4.445926419917751e-05,0.0003554054954574735,0.9375
3202,5055,얄팍하다/Adjective,32,2,30,4.445926419917751e-05,0.0003554054954574735,0.9375
3203,5056,></Punctuation,32,30,2,0.00035567411359342004,4.4425686932184186e-05,0.9375
3204,5057,썰렁하다/Adjective,32,3,29,5.5574080248971876e-05,0.00034429907372442745,0.90625
3205,5058,Very/Alpha,32,29,3,0.0003445592975436257,5.553210866523024e-05,0.90625
3206,5059,테스트/Noun,32,3,29,5.5574080248971876e-05,0.00034429907372442745,0.90625
3207,5060,love/Alpha,32,28,4,0.0003334444814938313,6.663853039827628e-05,0.875
3208,5061,괴작/Noun,32,4,28,6.668889629876625e-05,0.0003331926519913814,0.875
3209,5062,보석/Noun,32,28,4,0.0003334444814938313,6.663853039827628e-05,0.875
3210,5063,되새기다/Verb,32,28,4,0.0003334444814938313,6.663853039827628e-05,0.875
3211,5064,참혹하다/Adjective,32,27,5,0.00032232966544403684,7.774495213132233e-05,0.84375
3212,5065,어필/Noun,32,5,27,7.780371234856063e-05,0.00032208623025833537,0.84375
3213,5066,슈스케/Noun,32,5,27,7.780371234856063e-05,0.00032208623025833537,0.84375
3214,5067,마주/Noun,32,27,5,0.00032232966544403684,7.774495213132233e-05,0.84375
3215,5068,변명/Noun,32,6,26,8.891852839835501e-05,0.00031097980852528933,0.8125
3216,5069,감독판/Noun,32,26,6,0.00031121484939424253,8.885137386436837e-05,0.8125
3217,5070,아리/Noun,32,26,6,0.00031121484939424253,8.885137386436837e-05,0.8125
3218,5071,침몰/Noun,32,6,26,8.891852839835501e-05,0.00031097980852528933,0.8125
3219,5072,뽀로로/Noun,32,7,25,0.0001000333444481494,0.0002998733867922433,0.78125
3220,5073,맛깔나다/Adjective,32,25,7,0.00030010003334444816,9.995779559741441e-05,0.78125
3221,5074,토요명화/Noun,32,25,7,0.00030010003334444816,9.995779559741441e-05,0.78125
3222,5075,사소하다/Adjective,32,25,7,0.00030010003334444816,9.995779559741441e-05,0.78125
3223,5076,된장/Noun,32,8,24,0.00011114816049794375,0.0002887669650591972,0.75
3224,5077,쌍욕/Noun,32,8,24,0.00011114816049794375,0.0002887669650591972,0.75
3225,5078,어쨋/Noun,32,24,8,0.0002889852172946538,0.00011106421733046048,0.75
3226,5079,안달/Noun,32,8,24,0.00011114816049794375,0.0002887669650591972,0.75
3227,5080,취미/Noun,32,8,24,0.00011114816049794375,0.0002887669650591972,0.75
3228,5081,튀기다/Verb,32,8,24,0.00011114816049794375,0.0002887669650591972,0.75
3229,5082,my/Alpha,32,23,9,0.00027787040124485944,0.00012217063906350652,0.71875
3230,5083,콘서트/Noun,32,23,9,0.00027787040124485944,0.00012217063906350652,0.71875
3231,5084,토마스/Noun,32,23,9,0.00027787040124485944,0.00012217063906350652,0.71875
3232,5085,희극/Noun,32,22,10,0.000266755585195065,0.00013327706079655256,0.6875
3233,5086,싸/VerbPrefix,32,10,22,0.0001333777925975325,0.00026655412159310506,0.6875
3234,5087,압축/Noun,32,10,22,0.0001333777925975325,0.00026655412159310506,0.6875
3235,5088,아랫/Modifier,32,22,10,0.000266755585195065,0.00013327706079655256,0.6875
3236,5089,통일/Noun,32,22,10,0.000266755585195065,0.00013327706079655256,0.6875
3237,5090,me/Alpha,32,22,10,0.000266755585195065,0.00013327706079655256,0.6875
3238,5091,일베/Noun,32,10,22,0.0001333777925975325,0.00026655412159310506,0.6875
3239,5092,원빈/Noun,32,22,10,0.000266755585195065,0.00013327706079655256,0.6875
3240,5093,다한/Noun,32,10,22,0.0001333777925975325,0.00026655412159310506,0.6875
3241,5094,녹화/Noun,32,21,11,0.00025564076914527065,0.0001443834825295986,0.65625
3242,5095,기차/Noun,32,21,11,0.00025564076914527065,0.0001443834825295986,0.65625
3243,5096,주지훈/Noun,32,21,11,0.00025564076914527065,0.0001443834825295986,0.65625
3244,5097,공리/Noun,32,21,11,0.00025564076914527065,0.0001443834825295986,0.65625
3245,5098,정답/Noun,32,21,11,0.00025564076914527065,0.0001443834825295986,0.65625
3246,5099,최지우/Noun,32,21,11,0.00025564076914527065,0.0001443834825295986,0.65625
3247,5100,즘/Noun,32,11,21,0.0001444926086473269,0.0002554476998600591,0.65625
3248,5101,치르다/Verb,32,11,21,0.0001444926086473269,0.0002554476998600591,0.65625
3249,5102,벌이다/Verb,32,11,21,0.0001444926086473269,0.0002554476998600591,0.65625
3250,5103,치가/Noun,32,11,21,0.0001444926086473269,0.0002554476998600591,0.65625
3251,5104,무작정/Noun,32,11,21,0.0001444926086473269,0.0002554476998600591,0.65625
3252,5105,뱉다/Verb,32,11,21,0.0001444926086473269,0.0002554476998600591,0.65625
3253,5106,학/Noun,32,12,20,0.00015560742469712126,0.00024434127812701304,0.625
3254,5107,~~~~~~~/Punctuation,32,12,20,0.00015560742469712126,0.00024434127812701304,0.625
3255,5108,휴머니즘/Noun,32,20,12,0.00024452595309547634,0.00015548990426264466,0.625
3256,5109,트와일라잇/Noun,32,12,20,0.00015560742469712126,0.00024434127812701304,0.625
3257,5110,과감/Noun,32,12,20,0.00015560742469712126,0.00024434127812701304,0.625
3258,5111,크리/Noun,32,20,12,0.00024452595309547634,0.00015548990426264466,0.625
3259,5112,디스/Noun,32,12,20,0.00015560742469712126,0.00024434127812701304,0.625
3260,5113,동원/Noun,32,12,20,0.00015560742469712126,0.00024434127812701304,0.625
3261,5114,어벤져스/Noun,32,20,12,0.00024452595309547634,0.00015548990426264466,0.625
3262,5115,줄알/Noun,32,12,20,0.00015560742469712126,0.00024434127812701304,0.625
3263,5116,송중기/Noun,32,20,12,0.00024452595309547634,0.00015548990426264466,0.625
3264,5141,안듬/Noun,31,1,30,3.334444814938313e-05,0.0003554054954574735,0.967741935483871
3265,5142,참내/Noun,31,1,30,3.334444814938313e-05,0.0003554054954574735,0.967741935483871
3266,5143,이상형/Noun,31,28,3,0.0003334444814938313,5.553210866523024e-05,0.9032258064516128
3267,5144,못지않다/Adjective,31,28,3,0.0003334444814938313,5.553210866523024e-05,0.9032258064516128
3268,5145,그만두다/Verb,31,3,28,5.5574080248971876e-05,0.0003331926519913814,0.9032258064516128
3269,5146,잘맞다/Adjective,31,27,4,0.00032232966544403684,6.663853039827628e-05,0.8709677419354839
3270,5147,수습/Noun,31,4,27,6.668889629876625e-05,0.00032208623025833537,0.8709677419354839
3271,5148,발악/Noun,31,4,27,6.668889629876625e-05,0.00032208623025833537,0.8709677419354839
3272,5149,랍시고/Noun,31,4,27,6.668889629876625e-05,0.00032208623025833537,0.8709677419354839
3273,5150,자마자/Noun,31,5,26,7.780371234856063e-05,0.00031097980852528933,0.8387096774193549
3274,5151,공존/Noun,31,26,5,0.00031121484939424253,7.774495213132233e-05,0.8387096774193549
3275,5152,팬심/Noun,31,5,26,7.780371234856063e-05,0.00031097980852528933,0.8387096774193549
3276,5153,제이/Noun,31,26,5,0.00031121484939424253,7.774495213132233e-05,0.8387096774193549
3277,5154,봣던/Noun,31,25,6,0.00030010003334444816,8.885137386436837e-05,0.8064516129032258
3278,5155,통틀어/Noun,31,25,6,0.00030010003334444816,8.885137386436837e-05,0.8064516129032258
3279,5156,메리/Noun,31,25,6,0.00030010003334444816,8.885137386436837e-05,0.8064516129032258
3280,5157,쪽바리/Noun,31,6,25,8.891852839835501e-05,0.0002998733867922433,0.8064516129032258
3281,5158,결제/Noun,31,6,25,8.891852839835501e-05,0.0002998733867922433,0.8064516129032258
3282,5159,서인국/Noun,31,25,6,0.00030010003334444816,8.885137386436837e-05,0.8064516129032258
3283,5160,으로/Foreign,31,7,24,0.0001000333444481494,0.0002887669650591972,0.7741935483870968
3284,5161,히치콕/Noun,31,24,7,0.0002889852172946538,9.995779559741441e-05,0.7741935483870968
3285,5162,클린트/Noun,31,24,7,0.0002889852172946538,9.995779559741441e-05,0.7741935483870968
3286,5163,윌리엄스/Noun,31,24,7,0.0002889852172946538,9.995779559741441e-05,0.7741935483870968
3287,5164,혼/Noun,31,24,7,0.0002889852172946538,9.995779559741441e-05,0.7741935483870968
3288,5165,때론/Noun,31,24,7,0.0002889852172946538,9.995779559741441e-05,0.7741935483870968
3289,5166,기막히다/Adjective,31,23,8,0.00027787040124485944,0.00011106421733046048,0.7419354838709677
3290,5167,크리스틴/Noun,31,23,8,0.00027787040124485944,0.00011106421733046048,0.7419354838709677
3291,5168,부대/Noun,31,8,23,0.00011114816049794375,0.00027766054332615115,0.7419354838709677
3292,5169,이틀/Noun,31,23,8,0.00027787040124485944,0.00011106421733046048,0.7419354838709677
3293,5170,봣음/Noun,31,23,8,0.00027787040124485944,0.00011106421733046048,0.7419354838709677
3294,5171,욕설/Noun,31,8,23,0.00011114816049794375,0.00027766054332615115,0.7419354838709677
3295,5172,하필/Noun,31,9,22,0.00012226297654773814,0.00026655412159310506,0.7096774193548387
3296,5173,희한하다/Adjective,31,9,22,0.00012226297654773814,0.00026655412159310506,0.7096774193548387
3297,5174,윤계상/Noun,31,22,9,0.000266755585195065,0.00012217063906350652,0.7096774193548387
3298,5175,미니/Noun,31,22,9,0.000266755585195065,0.00012217063906350652,0.7096774193548387
3299,5176,대면/Noun,31,9,22,0.00012226297654773814,0.00026655412159310506,0.7096774193548387
3300,5177,약자/Noun,31,22,9,0.000266755585195065,0.00012217063906350652,0.7096774193548387
3301,5178,1억/Number,31,9,22,0.00012226297654773814,0.00026655412159310506,0.7096774193548387
3302,5179,사다코/Noun,31,9,22,0.00012226297654773814,0.00026655412159310506,0.7096774193548387
3303,5180,공상/Noun,31,9,22,0.00012226297654773814,0.00026655412159310506,0.7096774193548387
3304,5181,엑/Exclamation,31,9,22,0.00012226297654773814,0.00026655412159310506,0.7096774193548387
3305,5182,미개하다/Adjective,31,9,22,0.00012226297654773814,0.00026655412159310506,0.7096774193548387
3306,5183,....?/Punctuation,31,10,21,0.0001333777925975325,0.0002554476998600591,0.6774193548387096
3307,5184,츠/Noun,31,21,10,0.00025564076914527065,0.00013327706079655256,0.6774193548387096
3308,5185,인셉션/Noun,31,21,10,0.00025564076914527065,0.00013327706079655256,0.6774193548387096
3309,5186,스트립/Noun,31,21,10,0.00025564076914527065,0.00013327706079655256,0.6774193548387096
3310,5187,큰일/Noun,31,10,21,0.0001333777925975325,0.0002554476998600591,0.6774193548387096
3311,5188,오우/Noun,31,21,10,0.00025564076914527065,0.00013327706079655256,0.6774193548387096
3312,5189,무장/Noun,31,10,21,0.0001333777925975325,0.0002554476998600591,0.6774193548387096
3313,5190,끊어지다/Verb,31,10,21,0.0001333777925975325,0.0002554476998600591,0.6774193548387096
3314,5191,미남/Noun,31,21,10,0.00025564076914527065,0.00013327706079655256,0.6774193548387096
3315,5192,부류/Noun,31,10,21,0.0001333777925975325,0.0002554476998600591,0.6774193548387096
3316,5193,내주다/Verb,31,21,10,0.00025564076914527065,0.00013327706079655256,0.6774193548387096
3317,5194,마저/Noun,31,11,20,0.0001444926086473269,0.00024434127812701304,0.6451612903225806
3318,5195,라고는/Josa,31,11,20,0.0001444926086473269,0.00024434127812701304,0.6451612903225806
3319,5196,인증/Noun,31,11,20,0.0001444926086473269,0.00024434127812701304,0.6451612903225806
3320,5197,나인/Noun,31,20,11,0.00024452595309547634,0.0001443834825295986,0.6451612903225806
3321,5198,그런대로/Adverb,31,11,20,0.0001444926086473269,0.00024434127812701304,0.6451612903225806
3322,5199,",../Punctuation",31,11,20,0.0001444926086473269,0.00024434127812701304,0.6451612903225806
3323,5200,필립/Noun,31,20,11,0.00024452595309547634,0.0001443834825295986,0.6451612903225806
3324,5201,뎁/Noun,31,20,11,0.00024452595309547634,0.0001443834825295986,0.6451612903225806
3325,5202,써주다/Verb,31,11,20,0.0001444926086473269,0.00024434127812701304,0.6451612903225806
3326,5203,난이/Noun,31,20,11,0.00024452595309547634,0.0001443834825295986,0.6451612903225806
3327,5204,7~8/Number,31,20,11,0.00024452595309547634,0.0001443834825295986,0.6451612903225806
3328,5205,맞먹다/Verb,31,12,19,0.00015560742469712126,0.000233234856393967,0.6129032258064516
3329,5206,불꽃/Noun,31,19,12,0.0002334111370456819,0.00015548990426264466,0.6129032258064516
3330,5207,악의/Noun,31,19,12,0.0002334111370456819,0.00015548990426264466,0.6129032258064516
3331,5208,미스터/Noun,31,19,12,0.0002334111370456819,0.00015548990426264466,0.6129032258064516
3332,5247,난감하다/Adjective,30,1,29,3.334444814938313e-05,0.00034429907372442745,0.9666666666666668
3333,5248,흠뻑/Noun,30,29,1,0.0003445592975436257,3.331926519913814e-05,0.9666666666666668
3334,5249,난방/Noun,30,1,29,3.334444814938313e-05,0.00034429907372442745,0.9666666666666668
3335,5250,한물가다/Verb,30,2,28,4.445926419917751e-05,0.0003331926519913814,0.9333333333333332
3336,5251,중구/Noun,30,2,28,4.445926419917751e-05,0.0003331926519913814,0.9333333333333332
3337,5252,더러워지다/Verb,30,2,28,4.445926419917751e-05,0.0003331926519913814,0.9333333333333332
3338,5253,유승준/Noun,30,3,27,5.5574080248971876e-05,0.00032208623025833537,0.9
3339,5254,망신/Noun,30,3,27,5.5574080248971876e-05,0.00032208623025833537,0.9
3340,5255,인간미/Noun,30,26,4,0.00031121484939424253,6.663853039827628e-05,0.8666666666666667
3341,5256,무책임하다/Adjective,30,4,26,6.668889629876625e-05,0.00031097980852528933,0.8666666666666667
3342,5257,안남다/Adjective,30,4,26,6.668889629876625e-05,0.00031097980852528933,0.8666666666666667
3343,5258,진실되다/Adjective,30,26,4,0.00031121484939424253,6.663853039827628e-05,0.8666666666666667
3344,5259,괴/Noun,30,4,26,6.668889629876625e-05,0.00031097980852528933,0.8666666666666667
3345,5260,무표정/Noun,30,5,25,7.780371234856063e-05,0.0002998733867922433,0.8333333333333334
3346,5261,거도/Noun,30,6,24,8.891852839835501e-05,0.0002887669650591972,0.8
3347,5262,영화음악/Noun,30,24,6,0.0002889852172946538,8.885137386436837e-05,0.8
3348,5263,걸레/Noun,30,6,24,8.891852839835501e-05,0.0002887669650591972,0.8
3349,5264,ㅁㅊ/KoreanParticle,30,6,24,8.891852839835501e-05,0.0002887669650591972,0.8
3350,5265,쬐다/Verb,30,6,24,8.891852839835501e-05,0.0002887669650591972,0.8
3351,5266,잠수함/Noun,30,24,6,0.0002889852172946538,8.885137386436837e-05,0.8
3352,5267,관성/Noun,30,6,24,8.891852839835501e-05,0.0002887669650591972,0.8
3353,5268,으으/Exclamation,30,6,24,8.891852839835501e-05,0.0002887669650591972,0.8
3354,5269,패기/Noun,30,6,24,8.891852839835501e-05,0.0002887669650591972,0.8
3355,5270,진주/Noun,30,24,6,0.0002889852172946538,8.885137386436837e-05,0.8
3356,5271,은희/Noun,30,7,23,0.0001000333444481494,0.00027766054332615115,0.7666666666666667
3357,5272,미루다/Verb,30,23,7,0.00027787040124485944,9.995779559741441e-05,0.7666666666666667
3358,5273,피하/Noun,30,7,23,0.0001000333444481494,0.00027766054332615115,0.7666666666666667
3359,5274,여고괴담/Noun,30,7,23,0.0001000333444481494,0.00027766054332615115,0.7666666666666667
3360,5275,콧물/Noun,30,23,7,0.00027787040124485944,9.995779559741441e-05,0.7666666666666667
3361,5276,오점/Noun,30,8,22,0.00011114816049794375,0.00026655412159310506,0.7333333333333333
3362,5277,기념/Noun,30,8,22,0.00011114816049794375,0.00026655412159310506,0.7333333333333333
3363,5278,and/Alpha,30,22,8,0.000266755585195065,0.00011106421733046048,0.7333333333333333
3364,5279,토이스토리/Noun,30,22,8,0.000266755585195065,0.00011106421733046048,0.7333333333333333
3365,5280,교차/Noun,30,22,8,0.000266755585195065,0.00011106421733046048,0.7333333333333333
3366,5281,나마/Josa,30,22,8,0.000266755585195065,0.00011106421733046048,0.7333333333333333
3367,5282,평범/Noun,30,8,22,0.00011114816049794375,0.00026655412159310506,0.7333333333333333
3368,5283,무능하다/Adjective,30,9,21,0.00012226297654773814,0.0002554476998600591,0.7
3369,5284,아야/Noun,30,9,21,0.00012226297654773814,0.0002554476998600591,0.7
3370,5285,작업/Noun,30,9,21,0.00012226297654773814,0.0002554476998600591,0.7
3371,5286,처벌/Noun,30,9,21,0.00012226297654773814,0.0002554476998600591,0.7
3372,5287,구해/Noun,30,21,9,0.00025564076914527065,0.00012217063906350652,0.7
3373,5288,의존/Noun,30,9,21,0.00012226297654773814,0.0002554476998600591,0.7
3374,5289,에너지/Noun,30,20,10,0.00024452595309547634,0.00013327706079655256,0.6666666666666666
3375,5290,sbs/Alpha,30,10,20,0.0001333777925975325,0.00024434127812701304,0.6666666666666666
3376,5291,안정/Noun,30,20,10,0.00024452595309547634,0.00013327706079655256,0.6666666666666666
3377,5292,지능/Noun,30,10,20,0.0001333777925975325,0.00024434127812701304,0.6666666666666666
3378,5293,조재현/Noun,30,20,10,0.00024452595309547634,0.00013327706079655256,0.6666666666666666
3379,5294,축/Noun,30,10,20,0.0001333777925975325,0.00024434127812701304,0.6666666666666666
3380,5295,간접/Noun,30,20,10,0.00024452595309547634,0.00013327706079655256,0.6666666666666666
3381,5296,정적/Noun,30,20,10,0.00024452595309547634,0.00013327706079655256,0.6666666666666666
3382,5297,로드무비/Noun,30,20,10,0.00024452595309547634,0.00013327706079655256,0.6666666666666666
3383,5298,이종석/Noun,30,19,11,0.0002334111370456819,0.0001443834825295986,0.6333333333333333
3384,5299,갱/Noun,30,11,19,0.0001444926086473269,0.000233234856393967,0.6333333333333333
3385,5300,도감/Noun,30,19,11,0.0002334111370456819,0.0001443834825295986,0.6333333333333333
3386,5301,모델/Noun,30,11,19,0.0001444926086473269,0.000233234856393967,0.6333333333333333
3387,5302,웨슬리/Noun,30,11,19,0.0001444926086473269,0.000233234856393967,0.6333333333333333
3388,5303,모자/Noun,30,19,11,0.0002334111370456819,0.0001443834825295986,0.6333333333333333
3389,5304,쾌감/Noun,30,19,11,0.0002334111370456819,0.0001443834825295986,0.6333333333333333
3390,5305,안티/Noun,30,11,19,0.0001444926086473269,0.000233234856393967,0.6333333333333333
3391,5306,데이트/Noun,30,11,19,0.0001444926086473269,0.000233234856393967,0.6333333333333333
3392,5307,최진실/Noun,30,19,11,0.0002334111370456819,0.0001443834825295986,0.6333333333333333
3393,5308,속상하다/Adjective,30,19,11,0.0002334111370456819,0.0001443834825295986,0.6333333333333333
3394,5309,나비효과/Noun,30,12,18,0.00015560742469712126,0.00022212843466092096,0.6
3395,5310,무심하다/Adjective,30,12,18,0.00015560742469712126,0.00022212843466092096,0.6
3396,5311,두뇌/Noun,30,18,12,0.0002222963209958875,0.00015548990426264466,0.6
3397,5312,스토리텔링/Noun,30,12,18,0.00015560742469712126,0.00022212843466092096,0.6
3398,5313,평작/Noun,30,12,18,0.00015560742469712126,0.00022212843466092096,0.6
3399,5314,묶다/Verb,30,12,18,0.00015560742469712126,0.00022212843466092096,0.6
3400,5315,헛소리/Noun,30,12,18,0.00015560742469712126,0.00022212843466092096,0.6
3401,5316,일본애니/Noun,30,18,12,0.0002222963209958875,0.00015548990426264466,0.6
3402,5317,대니/Noun,30,18,12,0.0002222963209958875,0.00015548990426264466,0.6
3403,5318,출동/Noun,30,12,18,0.00015560742469712126,0.00022212843466092096,0.6
3404,5319,하여간/Adverb,30,12,18,0.00015560742469712126,0.00022212843466092096,0.6
3405,5320,시스템/Noun,30,18,12,0.0002222963209958875,0.00015548990426264466,0.6
3406,5321,유해진/Noun,30,18,12,0.0002222963209958875,0.00015548990426264466,0.6
3407,5322,가문/Noun,30,12,18,0.00015560742469712126,0.00022212843466092096,0.6
3408,5323,초능력/Noun,30,12,18,0.00015560742469712126,0.00022212843466092096,0.6
3409,5324,그룹/Noun,30,12,18,0.00015560742469712126,0.00022212843466092096,0.6
3410,5325,이승기/Noun,30,18,12,0.0002222963209958875,0.00015548990426264466,0.6
3411,5358,주고/Foreign,29,1,28,3.334444814938313e-05,0.0003331926519913814,0.9655172413793104
3412,5359,맑다/Adjective,29,28,1,0.0003334444814938313,3.331926519913814e-05,0.9655172413793104
3413,5360,남아도/Noun,29,2,27,4.445926419917751e-05,0.00032208623025833537,0.9310344827586208
3414,5361,간신히/Adverb,29,2,27,4.445926419917751e-05,0.00032208623025833537,0.9310344827586208
3415,5362,거중/Noun,29,2,27,4.445926419917751e-05,0.00032208623025833537,0.9310344827586208
3416,5363,성질/Noun,29,2,27,4.445926419917751e-05,0.00032208623025833537,0.9310344827586208
3417,5364,MC/Alpha,29,3,26,5.5574080248971876e-05,0.00031097980852528933,0.8965517241379308
3418,5365,입가/Noun,29,26,3,0.00031121484939424253,5.553210866523024e-05,0.8965517241379308
3419,5366,취지/Noun,29,3,26,5.5574080248971876e-05,0.00031097980852528933,0.8965517241379308
3420,5367,말장난/Noun,29,3,26,5.5574080248971876e-05,0.00031097980852528933,0.8965517241379308
3421,5368,나소/Noun,29,4,25,6.668889629876625e-05,0.0002998733867922433,0.8620689655172413
3422,5369,두서/Noun,29,4,25,6.668889629876625e-05,0.0002998733867922433,0.8620689655172413
3423,5370,"..,,/Punctuation",29,4,25,6.668889629876625e-05,0.0002998733867922433,0.8620689655172413
3424,5371,백미/Noun,29,25,4,0.00030010003334444816,6.663853039827628e-05,0.8620689655172413
3425,5372,미성년/Noun,29,4,25,6.668889629876625e-05,0.0002998733867922433,0.8620689655172413
3426,5373,잡아먹다/Verb,29,4,25,6.668889629876625e-05,0.0002998733867922433,0.8620689655172413
3427,5374,성냥/Noun,29,4,25,6.668889629876625e-05,0.0002998733867922433,0.8620689655172413
3428,5375,전파/Noun,29,4,25,6.668889629876625e-05,0.0002998733867922433,0.8620689655172413
3429,5376,틀어놓다/Verb,29,5,24,7.780371234856063e-05,0.0002887669650591972,0.8275862068965517
3430,5377,김규리/Noun,29,5,24,7.780371234856063e-05,0.0002887669650591972,0.8275862068965517
3431,5378,돌이키다/Verb,29,24,5,0.0002889852172946538,7.774495213132233e-05,0.8275862068965517
3432,5379,눈알/Noun,29,5,24,7.780371234856063e-05,0.0002887669650591972,0.8275862068965517
3433,5380,좆/Noun,29,5,24,7.780371234856063e-05,0.0002887669650591972,0.8275862068965517
3434,5381,으로의/Josa,29,24,5,0.0002889852172946538,7.774495213132233e-05,0.8275862068965517
3435,5382,똥폼/Noun,29,5,24,7.780371234856063e-05,0.0002887669650591972,0.8275862068965517
3436,5383,통쾌/Noun,29,23,6,0.00027787040124485944,8.885137386436837e-05,0.7931034482758621
3437,5384,퍼펙트/Noun,29,23,6,0.00027787040124485944,8.885137386436837e-05,0.7931034482758621
3438,5385,’/Punctuation,29,6,23,8.891852839835501e-05,0.00027766054332615115,0.7931034482758621
3439,5386,오늘날/Noun,29,23,6,0.00027787040124485944,8.885137386436837e-05,0.7931034482758621
3440,5387,깜찍하다/Adjective,29,23,6,0.00027787040124485944,8.885137386436837e-05,0.7931034482758621
3441,5388,사납다/Adjective,29,6,23,8.891852839835501e-05,0.00027766054332615115,0.7931034482758621
3442,5389,대치/Noun,29,7,22,0.0001000333444481494,0.00026655412159310506,0.7586206896551724
3443,5390,엇어/Noun,29,22,7,0.000266755585195065,9.995779559741441e-05,0.7586206896551724
3444,5391,별반/Noun,29,7,22,0.0001000333444481494,0.00026655412159310506,0.7586206896551724
3445,5392,단막극/Noun,29,7,22,0.0001000333444481494,0.00026655412159310506,0.7586206896551724
3446,5393,조롱/Noun,29,7,22,0.0001000333444481494,0.00026655412159310506,0.7586206896551724
3447,5394,",.../Punctuation",29,7,22,0.0001000333444481494,0.00026655412159310506,0.7586206896551724
3448,5395,운전/Noun,29,7,22,0.0001000333444481494,0.00026655412159310506,0.7586206896551724
3449,5396,가왜/Noun,29,7,22,0.0001000333444481494,0.00026655412159310506,0.7586206896551724
3450,5397,사전/Noun,29,22,7,0.000266755585195065,9.995779559741441e-05,0.7586206896551724
3451,5398,몬/Noun,29,7,22,0.0001000333444481494,0.00026655412159310506,0.7586206896551724
3452,5399,찌들다/Verb,29,22,7,0.000266755585195065,9.995779559741441e-05,0.7586206896551724
3453,5400,인공/Noun,29,8,21,0.00011114816049794375,0.0002554476998600591,0.7241379310344828
3454,5401,뮤직/Noun,29,21,8,0.00025564076914527065,0.00011106421733046048,0.7241379310344828
3455,5402,사례/Noun,29,8,21,0.00011114816049794375,0.0002554476998600591,0.7241379310344828
3456,5403,신기/Noun,29,8,21,0.00011114816049794375,0.0002554476998600591,0.7241379310344828
3457,5404,-.-/Punctuation,29,8,21,0.00011114816049794375,0.0002554476998600591,0.7241379310344828
3458,5405,영화니/Noun,29,8,21,0.00011114816049794375,0.0002554476998600591,0.7241379310344828
3459,5406,☆/Foreign,29,21,8,0.00025564076914527065,0.00011106421733046048,0.7241379310344828
3460,5407,당한/Noun,29,8,21,0.00011114816049794375,0.0002554476998600591,0.7241379310344828
3461,5408,사로자다/Verb,29,21,8,0.00025564076914527065,0.00011106421733046048,0.7241379310344828
3462,5409,길들이다/Verb,29,21,8,0.00025564076914527065,0.00011106421733046048,0.7241379310344828
3463,5410,연민/Noun,29,20,9,0.00024452595309547634,0.00012217063906350652,0.6896551724137931
3464,5411,금발/Noun,29,9,20,0.00012226297654773814,0.00024434127812701304,0.6896551724137931
3465,5412,치중/Noun,29,9,20,0.00012226297654773814,0.00024434127812701304,0.6896551724137931
3466,5413,가위/Noun,29,9,20,0.00012226297654773814,0.00024434127812701304,0.6896551724137931
3467,5414,짝사랑/Noun,29,20,9,0.00024452595309547634,0.00012217063906350652,0.6896551724137931
3468,5415,거들다/Verb,29,9,20,0.00012226297654773814,0.00024434127812701304,0.6896551724137931
3469,5416,보물/Noun,29,20,9,0.00024452595309547634,0.00012217063906350652,0.6896551724137931
3470,5417,17/Number,29,19,10,0.0002334111370456819,0.00013327706079655256,0.6551724137931034
3471,5418,여실히/Noun,29,10,19,0.0001333777925975325,0.000233234856393967,0.6551724137931034
3472,5419,타잔/Noun,29,10,19,0.0001333777925975325,0.000233234856393967,0.6551724137931034
3473,5420,토르/Noun,29,19,10,0.0002334111370456819,0.00013327706079655256,0.6551724137931034
3474,5421,무도/Noun,29,10,19,0.0001333777925975325,0.000233234856393967,0.6551724137931034
3475,5422,이성/Noun,29,19,10,0.0002334111370456819,0.00013327706079655256,0.6551724137931034
3476,5423,시원/Noun,29,19,10,0.0002334111370456819,0.00013327706079655256,0.6551724137931034
3477,5424,보호/Noun,29,19,10,0.0002334111370456819,0.00013327706079655256,0.6551724137931034
3478,5425,오기/Noun,29,10,19,0.0001333777925975325,0.000233234856393967,0.6551724137931034
3479,5426,시킴/Noun,29,10,19,0.0001333777925975325,0.000233234856393967,0.6551724137931034
3480,5427,해달라다/Verb,29,10,19,0.0001333777925975325,0.000233234856393967,0.6551724137931034
3481,5428,폭탄/Noun,29,10,19,0.0001333777925975325,0.000233234856393967,0.6551724137931034
3482,5429,파트너/Noun,29,11,18,0.0001444926086473269,0.00022212843466092096,0.6206896551724138
3483,5430,우울증/Noun,29,11,18,0.0001444926086473269,0.00022212843466092096,0.6206896551724138
3484,5431,어깨/Noun,29,18,11,0.0002222963209958875,0.0001443834825295986,0.6206896551724138
3485,5432,어울림/Noun,29,18,11,0.0002222963209958875,0.0001443834825295986,0.6206896551724138
3486,5433,힐/Noun,29,11,18,0.0001444926086473269,0.00022212843466092096,0.6206896551724138
3487,5434,홈/Noun,29,11,18,0.0001444926086473269,0.00022212843466092096,0.6206896551724138
3488,5435,병사/Noun,29,11,18,0.0001444926086473269,0.00022212843466092096,0.6206896551724138
3489,5436,라이브/Noun,29,18,11,0.0002222963209958875,0.0001443834825295986,0.6206896551724138
3490,5437,클루니/Noun,29,18,11,0.0002222963209958875,0.0001443834825295986,0.6206896551724138
3491,5438,어긋나다/Verb,29,11,18,0.0001444926086473269,0.00022212843466092096,0.6206896551724138
3492,5439,한몫/Noun,29,18,11,0.0002222963209958875,0.0001443834825295986,0.6206896551724138
3493,5440,영호/Noun,29,18,11,0.0002222963209958875,0.0001443834825295986,0.6206896551724138
3494,5441,이라기/Josa,29,11,18,0.0001444926086473269,0.00022212843466092096,0.6206896551724138
3495,5442,벨/Modifier,29,11,18,0.0001444926086473269,0.00022212843466092096,0.6206896551724138
3496,5480,구림/Noun,28,0,28,2.2229632099588756e-05,0.0003331926519913814,1.0
3497,5481,당췌/Noun,28,1,27,3.334444814938313e-05,0.00032208623025833537,0.9642857142857144
3498,5482,물결/Noun,28,26,2,0.00031121484939424253,4.4425686932184186e-05,0.9285714285714286
3499,5483,날림/Noun,28,3,25,5.5574080248971876e-05,0.0002998733867922433,0.8928571428571429
3500,5484,배슬기/Noun,28,3,25,5.5574080248971876e-05,0.0002998733867922433,0.8928571428571429
3501,5485,통찰/Noun,28,24,4,0.0002889852172946538,6.663853039827628e-05,0.8571428571428571
3502,5486,천박하다/Adjective,28,4,24,6.668889629876625e-05,0.0002887669650591972,0.8571428571428571
3503,5487,이면/Foreign,28,4,24,6.668889629876625e-05,0.0002887669650591972,0.8571428571428571
3504,5488,추잡하다/Adjective,28,4,24,6.668889629876625e-05,0.0002887669650591972,0.8571428571428571
3505,5489,결과물/Noun,28,4,24,6.668889629876625e-05,0.0002887669650591972,0.8571428571428571
3506,5490,로맨스영화/Noun,28,24,4,0.0002889852172946538,6.663853039827628e-05,0.8571428571428571
3507,5491,늘어놓다/Verb,28,4,24,6.668889629876625e-05,0.0002887669650591972,0.8571428571428571
3508,5492,봣습니/Noun,28,24,4,0.0002889852172946538,6.663853039827628e-05,0.8571428571428571
3509,5493,진부/Noun,28,5,23,7.780371234856063e-05,0.00027766054332615115,0.8214285714285714
3510,5494,심은하/Noun,28,23,5,0.00027787040124485944,7.774495213132233e-05,0.8214285714285714
3511,5495,농락/Noun,28,5,23,7.780371234856063e-05,0.00027766054332615115,0.8214285714285714
3512,5496,오열/Noun,28,23,5,0.00027787040124485944,7.774495213132233e-05,0.8214285714285714
3513,5497,주어지다/Verb,28,23,5,0.00027787040124485944,7.774495213132233e-05,0.8214285714285714
3514,5498,지못미/Noun,28,5,23,7.780371234856063e-05,0.00027766054332615115,0.8214285714285714
3515,5499,i/Alpha,28,22,6,0.000266755585195065,8.885137386436837e-05,0.7857142857142857
3516,5500,해설/Noun,28,6,22,8.891852839835501e-05,0.00026655412159310506,0.7857142857142857
3517,5501,좌좀/Noun,28,6,22,8.891852839835501e-05,0.00026655412159310506,0.7857142857142857
3518,5502,남겨지다/Verb,28,22,6,0.000266755585195065,8.885137386436837e-05,0.7857142857142857
3519,5503,‘/Foreign,28,6,22,8.891852839835501e-05,0.00026655412159310506,0.7857142857142857
3520,5504,아키라/Noun,28,21,7,0.00025564076914527065,9.995779559741441e-05,0.75
3521,5505,폭파/Noun,28,7,21,0.0001000333444481494,0.0002554476998600591,0.75
3522,5506,빠져나오다/Verb,28,21,7,0.00025564076914527065,9.995779559741441e-05,0.75
3523,5507,소유/Noun,28,21,7,0.00025564076914527065,9.995779559741441e-05,0.75
3524,5508,파멸/Noun,28,21,7,0.00025564076914527065,9.995779559741441e-05,0.75
3525,5509,보상/Noun,28,7,21,0.0001000333444481494,0.0002554476998600591,0.75
3526,5510,짐작/Noun,28,7,21,0.0001000333444481494,0.0002554476998600591,0.75
3527,5511,감우성/Noun,28,21,7,0.00025564076914527065,9.995779559741441e-05,0.75
3528,5512,후의/Noun,28,21,7,0.00025564076914527065,9.995779559741441e-05,0.75
3529,5513,거여/Noun,28,7,21,0.0001000333444481494,0.0002554476998600591,0.75
3530,5514,오묘하다/Adjective,28,21,7,0.00025564076914527065,9.995779559741441e-05,0.75
3531,5515,조커/Noun,28,21,7,0.00025564076914527065,9.995779559741441e-05,0.75
3532,5516,타이밍/Noun,28,7,21,0.0001000333444481494,0.0002554476998600591,0.75
3533,5517,스탤론/Noun,28,20,8,0.00024452595309547634,0.00011106421733046048,0.7142857142857143
3534,5518,느끼하다/Adjective,28,8,20,0.00011114816049794375,0.00024434127812701304,0.7142857142857143
3535,5519,시바/Noun,28,8,20,0.00011114816049794375,0.00024434127812701304,0.7142857142857143
3536,5520,고집/Noun,28,8,20,0.00011114816049794375,0.00024434127812701304,0.7142857142857143
3537,5521,이민호/Noun,28,20,8,0.00024452595309547634,0.00011106421733046048,0.7142857142857143
3538,5522,동참/Noun,28,8,20,0.00011114816049794375,0.00024434127812701304,0.7142857142857143
3539,5523,이모/Noun,28,20,8,0.00024452595309547634,0.00011106421733046048,0.7142857142857143
3540,5524,반면/Noun,28,8,20,0.00011114816049794375,0.00024434127812701304,0.7142857142857143
3541,5525,장만옥/Noun,28,20,8,0.00024452595309547634,0.00011106421733046048,0.7142857142857143
3542,5526,늑대인간/Noun,28,8,20,0.00011114816049794375,0.00024434127812701304,0.7142857142857143
3543,5527,이리저리/Adverb,28,8,20,0.00011114816049794375,0.00024434127812701304,0.7142857142857143
3544,5528,말리/Noun,28,8,20,0.00011114816049794375,0.00024434127812701304,0.7142857142857143
3545,5529,어메이징/Noun,28,19,9,0.0002334111370456819,0.00012217063906350652,0.6785714285714286
3546,5530,24/Number,28,19,9,0.0002334111370456819,0.00012217063906350652,0.6785714285714286
3547,5531,퀸/Noun,28,19,9,0.0002334111370456819,0.00012217063906350652,0.6785714285714286
3548,5532,예정/Noun,28,19,9,0.0002334111370456819,0.00012217063906350652,0.6785714285714286
3549,5533,노무/Noun,28,9,19,0.00012226297654773814,0.000233234856393967,0.6785714285714286
3550,5534,자료/Noun,28,19,9,0.0002334111370456819,0.00012217063906350652,0.6785714285714286
3551,5535,덤덤하다/Adjective,28,19,9,0.0002334111370456819,0.00012217063906350652,0.6785714285714286
3552,5536,권리/Noun,28,19,9,0.0002334111370456819,0.00012217063906350652,0.6785714285714286
3553,5537,스콜/Noun,28,19,9,0.0002334111370456819,0.00012217063906350652,0.6785714285714286
3554,5538,눈감다/Verb,28,9,19,0.00012226297654773814,0.000233234856393967,0.6785714285714286
3555,5539,o/Alpha,28,19,9,0.0002334111370456819,0.00012217063906350652,0.6785714285714286
3556,5540,화장/Noun,28,9,19,0.00012226297654773814,0.000233234856393967,0.6785714285714286
3557,5541,부리/Noun,28,10,18,0.0001333777925975325,0.00022212843466092096,0.6428571428571429
3558,5542,장담/Noun,28,18,10,0.0002222963209958875,0.00013327706079655256,0.6428571428571429
3559,5543,왕따/Noun,28,10,18,0.0001333777925975325,0.00022212843466092096,0.6428571428571429
3560,5544,이야말로/Josa,28,18,10,0.0002222963209958875,0.00013327706079655256,0.6428571428571429
3561,5545,서사시/Noun,28,18,10,0.0002222963209958875,0.00013327706079655256,0.6428571428571429
3562,5546,오디션/Noun,28,10,18,0.0001333777925975325,0.00022212843466092096,0.6428571428571429
3563,5547,아이리스/Noun,28,10,18,0.0001333777925975325,0.00022212843466092096,0.6428571428571429
3564,5548,군데/Noun,28,10,18,0.0001333777925975325,0.00022212843466092096,0.6428571428571429
3565,5549,지은/Noun,28,10,18,0.0001333777925975325,0.00022212843466092096,0.6428571428571429
3566,5550,타이타닉/Noun,28,18,10,0.0002222963209958875,0.00013327706079655256,0.6428571428571429
3567,5551,지난/Modifier,28,18,10,0.0002222963209958875,0.00013327706079655256,0.6428571428571429
3568,5552,우베/Noun,28,10,18,0.0001333777925975325,0.00022212843466092096,0.6428571428571429
3569,5553,인사/Noun,28,18,10,0.0002222963209958875,0.00013327706079655256,0.6428571428571429
3570,5554,붙잡다/Verb,28,17,11,0.00021118150494609317,0.0001443834825295986,0.6071428571428571
3571,5555,끓다/Verb,28,17,11,0.00021118150494609317,0.0001443834825295986,0.6071428571428571
3572,5556,고급/Noun,28,17,11,0.00021118150494609317,0.0001443834825295986,0.6071428571428571
3573,5557,털다/Verb,28,11,17,0.0001444926086473269,0.0002110220129278749,0.6071428571428571
3574,5558,물들다/Verb,28,17,11,0.00021118150494609317,0.0001443834825295986,0.6071428571428571
3575,5559,제레미/Noun,28,17,11,0.00021118150494609317,0.0001443834825295986,0.6071428571428571
3576,5560,수년/Noun,28,17,11,0.00021118150494609317,0.0001443834825295986,0.6071428571428571
3577,5561,엄태웅/Noun,28,11,17,0.0001444926086473269,0.0002110220129278749,0.6071428571428571
3578,5562,다나/Noun,28,11,17,0.0001444926086473269,0.0002110220129278749,0.6071428571428571
3579,5563,나오니/Noun,28,11,17,0.0001444926086473269,0.0002110220129278749,0.6071428571428571
3580,5564,모니카/Noun,28,11,17,0.0001444926086473269,0.0002110220129278749,0.6071428571428571
3581,5565,결투/Noun,28,17,11,0.00021118150494609317,0.0001443834825295986,0.6071428571428571
3582,5566,미련/Noun,28,11,17,0.0001444926086473269,0.0002110220129278749,0.6071428571428571
3583,5610,에혀/Noun,27,1,26,3.334444814938313e-05,0.00031097980852528933,0.9629629629629628
3584,5611,술함/Noun,27,3,24,5.5574080248971876e-05,0.0002887669650591972,0.8888888888888888
3585,5612,댓글알바/Noun,27,3,24,5.5574080248971876e-05,0.0002887669650591972,0.8888888888888888
3586,5613,초보/Noun,27,3,24,5.5574080248971876e-05,0.0002887669650591972,0.8888888888888888
3587,5614,쉣/Noun,27,3,24,5.5574080248971876e-05,0.0002887669650591972,0.8888888888888888
3588,5615,맡기다/Verb,27,3,24,5.5574080248971876e-05,0.0002887669650591972,0.8888888888888888
3589,5616,허망/Noun,27,4,23,6.668889629876625e-05,0.00027766054332615115,0.8518518518518519
3590,5617,오오/Exclamation,27,23,4,0.00027787040124485944,6.663853039827628e-05,0.8518518518518519
3591,5618,맥락/Noun,27,4,23,6.668889629876625e-05,0.00027766054332615115,0.8518518518518519
3592,5619,그리움/Noun,27,23,4,0.00027787040124485944,6.663853039827628e-05,0.8518518518518519
3593,5620,경지/Noun,27,23,4,0.00027787040124485944,6.663853039827628e-05,0.8518518518518519
3594,5621,제한/Noun,27,4,23,6.668889629876625e-05,0.00027766054332615115,0.8518518518518519
3595,5622,사하나/Noun,27,23,4,0.00027787040124485944,6.663853039827628e-05,0.8518518518518519
3596,5623,푸른/Noun,27,23,4,0.00027787040124485944,6.663853039827628e-05,0.8518518518518519
3597,5624,알아주다/Verb,27,22,5,0.000266755585195065,7.774495213132233e-05,0.8148148148148148
3598,5625,이정현/Noun,27,22,5,0.000266755585195065,7.774495213132233e-05,0.8148148148148148
3599,5626,전용/Noun,27,5,22,7.780371234856063e-05,0.00026655412159310506,0.8148148148148148
3600,5627,가상하다/Adjective,27,5,22,7.780371234856063e-05,0.00026655412159310506,0.8148148148148148
3601,5628,맙소사/Exclamation,27,5,22,7.780371234856063e-05,0.00026655412159310506,0.8148148148148148
3602,5629,훼손/Noun,27,5,22,7.780371234856063e-05,0.00026655412159310506,0.8148148148148148
3603,5630,av/Alpha,27,5,22,7.780371234856063e-05,0.00026655412159310506,0.8148148148148148
3604,5631,자칫/Noun,27,22,5,0.000266755585195065,7.774495213132233e-05,0.8148148148148148
3605,5632,궁금/Noun,27,5,22,7.780371234856063e-05,0.00026655412159310506,0.8148148148148148
3606,5633,--;/Punctuation,27,5,22,7.780371234856063e-05,0.00026655412159310506,0.8148148148148148
3607,5634,자비/Noun,27,21,6,0.00025564076914527065,8.885137386436837e-05,0.7777777777777778
3608,5635,본받다/Verb,27,21,6,0.00025564076914527065,8.885137386436837e-05,0.7777777777777778
3609,5636,웨스턴/Noun,27,21,6,0.00025564076914527065,8.885137386436837e-05,0.7777777777777778
3610,5637,피라냐/Noun,27,6,21,8.891852839835501e-05,0.0002554476998600591,0.7777777777777778
3611,5638,비노/Noun,27,21,6,0.00025564076914527065,8.885137386436837e-05,0.7777777777777778
3612,5639,헌신/Noun,27,21,6,0.00025564076914527065,8.885137386436837e-05,0.7777777777777778
3613,5640,탐욕/Noun,27,21,6,0.00025564076914527065,8.885137386436837e-05,0.7777777777777778
3614,5641,슬슬/Noun,27,6,21,8.891852839835501e-05,0.0002554476998600591,0.7777777777777778
3615,5642,평화롭다/Adjective,27,21,6,0.00025564076914527065,8.885137386436837e-05,0.7777777777777778
3616,5643,숨쉬다/Verb,27,21,6,0.00025564076914527065,8.885137386436837e-05,0.7777777777777778
3617,5644,박유천/Noun,27,21,6,0.00025564076914527065,8.885137386436837e-05,0.7777777777777778
3618,5645,삘/Noun,27,6,21,8.891852839835501e-05,0.0002554476998600591,0.7777777777777778
3619,5646,과언/Noun,27,21,6,0.00025564076914527065,8.885137386436837e-05,0.7777777777777778
3620,5647,지껄이다/Verb,27,7,20,0.0001000333444481494,0.00024434127812701304,0.7407407407407407
3621,5648,좌/Noun,27,20,7,0.00024452595309547634,9.995779559741441e-05,0.7407407407407407
3622,5649,용하다/Adjective,27,7,20,0.0001000333444481494,0.00024434127812701304,0.7407407407407407
3623,5650,컬/Noun,27,20,7,0.00024452595309547634,9.995779559741441e-05,0.7407407407407407
3624,5651,침대/Noun,27,7,20,0.0001000333444481494,0.00024434127812701304,0.7407407407407407
3625,5652,조선족/Noun,27,7,20,0.0001000333444481494,0.00024434127812701304,0.7407407407407407
3626,5653,성장기/Noun,27,20,7,0.00024452595309547634,9.995779559741441e-05,0.7407407407407407
3627,5654,브로디/Noun,27,7,20,0.0001000333444481494,0.00024434127812701304,0.7407407407407407
3628,5655,치부/Noun,27,20,7,0.00024452595309547634,9.995779559741441e-05,0.7407407407407407
3629,5656,치우다/Verb,27,7,20,0.0001000333444481494,0.00024434127812701304,0.7407407407407407
3630,5657,사이트/Noun,27,7,20,0.0001000333444481494,0.00024434127812701304,0.7407407407407407
3631,5658,구입/Noun,27,20,7,0.00024452595309547634,9.995779559741441e-05,0.7407407407407407
3632,5659,자리/Suffix,27,7,20,0.0001000333444481494,0.00024434127812701304,0.7407407407407407
3633,5660,평타/Noun,27,7,20,0.0001000333444481494,0.00024434127812701304,0.7407407407407407
3634,5661,모니터/Noun,27,7,20,0.0001000333444481494,0.00024434127812701304,0.7407407407407407
3635,5662,일방/Noun,27,7,20,0.0001000333444481494,0.00024434127812701304,0.7407407407407407
3636,5663,가나다/Noun,27,7,20,0.0001000333444481494,0.00024434127812701304,0.7407407407407407
3637,5664,허준/Noun,27,20,7,0.00024452595309547634,9.995779559741441e-05,0.7407407407407407
3638,5665,레저/Noun,27,19,8,0.0002334111370456819,0.00011106421733046048,0.7037037037037037
3639,5666,패스/Noun,27,8,19,0.00011114816049794375,0.000233234856393967,0.7037037037037037
3640,5667,오싹하다/Adjective,27,19,8,0.0002334111370456819,0.00011106421733046048,0.7037037037037037
3641,5668,석/Noun,27,8,19,0.00011114816049794375,0.000233234856393967,0.7037037037037037
3642,5669,종종/Noun,27,19,8,0.0002334111370456819,0.00011106421733046048,0.7037037037037037
3643,5670,쌓다/Verb,27,8,19,0.00011114816049794375,0.000233234856393967,0.7037037037037037
3644,5671,모자라/Noun,27,8,19,0.00011114816049794375,0.000233234856393967,0.7037037037037037
3645,5672,기절/Noun,27,8,19,0.00011114816049794375,0.000233234856393967,0.7037037037037037
3646,5673,깔깔/Noun,27,18,9,0.0002222963209958875,0.00012217063906350652,0.6666666666666666
3647,5674,질린다/Verb,27,9,18,0.00012226297654773814,0.00022212843466092096,0.6666666666666666
3648,5675,팬티/Noun,27,9,18,0.00012226297654773814,0.00022212843466092096,0.6666666666666666
3649,5676,솜씨/Noun,27,18,9,0.0002222963209958875,0.00012217063906350652,0.6666666666666666
3650,5677,치닫다/Verb,27,9,18,0.00012226297654773814,0.00022212843466092096,0.6666666666666666
3651,5678,이브/Noun,27,18,9,0.0002222963209958875,0.00012217063906350652,0.6666666666666666
3652,5679,최강희/Noun,27,18,9,0.0002222963209958875,0.00012217063906350652,0.6666666666666666
3653,5680,고릴라/Noun,27,9,18,0.00012226297654773814,0.00022212843466092096,0.6666666666666666
3654,5681,꺄/Noun,27,18,9,0.0002222963209958875,0.00012217063906350652,0.6666666666666666
3655,5682,리치/Noun,27,18,9,0.0002222963209958875,0.00012217063906350652,0.6666666666666666
3656,5683,괜찬/Noun,27,18,9,0.0002222963209958875,0.00012217063906350652,0.6666666666666666
3657,5684,난생/Noun,27,9,18,0.00012226297654773814,0.00022212843466092096,0.6666666666666666
3658,5685,삼촌/Noun,27,9,18,0.00012226297654773814,0.00022212843466092096,0.6666666666666666
3659,5686,투쟁/Noun,27,18,9,0.0002222963209958875,0.00012217063906350652,0.6666666666666666
3660,5687,피어/Noun,27,18,9,0.0002222963209958875,0.00012217063906350652,0.6666666666666666
3661,5688,모드/Noun,27,10,17,0.0001333777925975325,0.0002110220129278749,0.6296296296296297
3662,5689,사가/Noun,27,17,10,0.00021118150494609317,0.00013327706079655256,0.6296296296296297
3663,5690,............../Punctuation,27,10,17,0.0001333777925975325,0.0002110220129278749,0.6296296296296297
3664,5691,아일랜드/Noun,27,17,10,0.00021118150494609317,0.00013327706079655256,0.6296296296296297
3665,5692,피어스/Noun,27,17,10,0.00021118150494609317,0.00013327706079655256,0.6296296296296297
3666,5693,자시다/Verb,27,10,17,0.0001333777925975325,0.0002110220129278749,0.6296296296296297
3667,5694,어쩐지/Noun,27,10,17,0.0001333777925975325,0.0002110220129278749,0.6296296296296297
3668,5695,차인표/Noun,27,10,17,0.0001333777925975325,0.0002110220129278749,0.6296296296296297
3669,5696,근육/Noun,27,17,10,0.00021118150494609317,0.00013327706079655256,0.6296296296296297
3670,5753,안드로메다/Noun,26,0,26,2.2229632099588756e-05,0.00031097980852528933,1.0
3671,5754,돌림/Noun,26,1,25,3.334444814938313e-05,0.0002998733867922433,0.9615384615384616
3672,5755,불우/Noun,26,1,25,3.334444814938313e-05,0.0002998733867922433,0.9615384615384616
3673,5756,녹이다/Verb,26,25,1,0.00030010003334444816,3.331926519913814e-05,0.9615384615384616
3674,5757,한시/Noun,26,25,1,0.00030010003334444816,3.331926519913814e-05,0.9615384615384616
3675,5758,무리하다/Adjective,26,1,25,3.334444814938313e-05,0.0002998733867922433,0.9615384615384616
3676,5759,맘대로/Adverb,26,2,24,4.445926419917751e-05,0.0002887669650591972,0.9230769230769232
3677,5760,싸가지/Noun,26,2,24,4.445926419917751e-05,0.0002887669650591972,0.9230769230769232
3678,5761,니미/Noun,26,2,24,4.445926419917751e-05,0.0002887669650591972,0.9230769230769232
3679,5762,!!!!!!!!!/Punctuation,26,23,3,0.00027787040124485944,5.553210866523024e-05,0.8846153846153846
3680,5763,해학/Noun,26,23,3,0.00027787040124485944,5.553210866523024e-05,0.8846153846153846
3681,5764,정신병원/Noun,26,3,23,5.5574080248971876e-05,0.00027766054332615115,0.8846153846153846
3682,5765,괴상하다/Adjective,26,4,22,6.668889629876625e-05,0.00026655412159310506,0.8461538461538461
3683,5766,。/Foreign,26,22,4,0.000266755585195065,6.663853039827628e-05,0.8461538461538461
3684,5767,저건/Noun,26,4,22,6.668889629876625e-05,0.00026655412159310506,0.8461538461538461
3685,5768,사랑받다/Verb,26,22,4,0.000266755585195065,6.663853039827628e-05,0.8461538461538461
3686,5769,비용/Noun,26,4,22,6.668889629876625e-05,0.00026655412159310506,0.8461538461538461
3687,5770,침략/Noun,26,4,22,6.668889629876625e-05,0.00026655412159310506,0.8461538461538461
3688,5771,매년/Noun,26,22,4,0.000266755585195065,6.663853039827628e-05,0.8461538461538461
3689,5772,하루하루/Noun,26,22,4,0.000266755585195065,6.663853039827628e-05,0.8461538461538461
3690,5773,걸왜/Noun,26,4,22,6.668889629876625e-05,0.00026655412159310506,0.8461538461538461
3691,5774,절용/Noun,26,4,22,6.668889629876625e-05,0.00026655412159310506,0.8461538461538461
3692,5775,9년/Number,26,22,4,0.000266755585195065,6.663853039827628e-05,0.8461538461538461
3693,5776,장진영/Noun,26,21,5,0.00025564076914527065,7.774495213132233e-05,0.8076923076923077
3694,5777,드라마틱하다/Adjective,26,21,5,0.00025564076914527065,7.774495213132233e-05,0.8076923076923077
3695,5778,쯧/Adverb,26,5,21,7.780371234856063e-05,0.0002554476998600591,0.8076923076923077
3696,5779,류덕환/Noun,26,21,5,0.00025564076914527065,7.774495213132233e-05,0.8076923076923077
3697,5780,징징대다/Adjective,26,5,21,7.780371234856063e-05,0.0002554476998600591,0.8076923076923077
3698,5781,만원/Noun,26,5,21,7.780371234856063e-05,0.0002554476998600591,0.8076923076923077
3699,5782,나열하다/Adjective,26,5,21,7.780371234856063e-05,0.0002554476998600591,0.8076923076923077
3700,5783,피터팬/Noun,26,21,5,0.00025564076914527065,7.774495213132233e-05,0.8076923076923077
3701,5784,답습/Noun,26,5,21,7.780371234856063e-05,0.0002554476998600591,0.8076923076923077
3702,5785,싸이/Noun,26,6,20,8.891852839835501e-05,0.00024434127812701304,0.7692307692307693
3703,5786,코너/Noun,26,6,20,8.891852839835501e-05,0.00024434127812701304,0.7692307692307693
3704,5787,50분/Number,26,6,20,8.891852839835501e-05,0.00024434127812701304,0.7692307692307693
3705,5788,편지/Noun,26,20,6,0.00024452595309547634,8.885137386436837e-05,0.7692307692307693
3706,5789,봉준호/Noun,26,20,6,0.00024452595309547634,8.885137386436837e-05,0.7692307692307693
3707,5790,퇴보하다/Adjective,26,6,20,8.891852839835501e-05,0.00024434127812701304,0.7692307692307693
3708,5791,z/Alpha,26,6,20,8.891852839835501e-05,0.00024434127812701304,0.7692307692307693
3709,5792,한잔/Noun,26,20,6,0.00024452595309547634,8.885137386436837e-05,0.7692307692307693
3710,5793,쌤/Noun,26,20,6,0.00024452595309547634,8.885137386436837e-05,0.7692307692307693
3711,5794,살해/Noun,26,6,20,8.891852839835501e-05,0.00024434127812701304,0.7692307692307693
3712,5795,하든/Noun,26,6,20,8.891852839835501e-05,0.00024434127812701304,0.7692307692307693
3713,5796,주어/Noun,26,20,6,0.00024452595309547634,8.885137386436837e-05,0.7692307692307693
3714,5797,흐흐/Noun,26,19,7,0.0002334111370456819,9.995779559741441e-05,0.7307692307692307
3715,5798,진도/Noun,26,7,19,0.0001000333444481494,0.000233234856393967,0.7307692307692307
3716,5799,ㅈㄹ/KoreanParticle,26,7,19,0.0001000333444481494,0.000233234856393967,0.7307692307692307
3717,5800,메릴/Noun,26,19,7,0.0002334111370456819,9.995779559741441e-05,0.7307692307692307
3718,5801,주제곡/Noun,26,19,7,0.0002334111370456819,9.995779559741441e-05,0.7307692307692307
3719,5802,심심/Noun,26,7,19,0.0001000333444481494,0.000233234856393967,0.7307692307692307
3720,5803,선입견/Noun,26,19,7,0.0002334111370456819,9.995779559741441e-05,0.7307692307692307
3721,5804,형태/Noun,26,19,7,0.0002334111370456819,9.995779559741441e-05,0.7307692307692307
3722,5805,한수/Noun,26,19,7,0.0002334111370456819,9.995779559741441e-05,0.7307692307692307
3723,5806,재벌/Noun,26,7,19,0.0001000333444481494,0.000233234856393967,0.7307692307692307
3724,5807,부영/Noun,26,18,8,0.0002222963209958875,0.00011106421733046048,0.6923076923076923
3725,5808,.............../Punctuation,26,8,18,0.00011114816049794375,0.00022212843466092096,0.6923076923076923
3726,5809,닌자/Noun,26,8,18,0.00011114816049794375,0.00022212843466092096,0.6923076923076923
3727,5810,얕다/Adjective,26,8,18,0.00011114816049794375,0.00022212843466092096,0.6923076923076923
3728,5811,1.2/Number,26,18,8,0.0002222963209958875,0.00011106421733046048,0.6923076923076923
3729,5812,잘리다/Verb,26,8,18,0.00011114816049794375,0.00022212843466092096,0.6923076923076923
3730,5813,기네/Noun,26,8,18,0.00011114816049794375,0.00022212843466092096,0.6923076923076923
3731,5814,맞서다/Verb,26,18,8,0.0002222963209958875,0.00011106421733046048,0.6923076923076923
3732,5815,나뉘다/Verb,26,17,9,0.00021118150494609317,0.00012217063906350652,0.6538461538461539
3733,5816,키스신/Noun,26,17,9,0.00021118150494609317,0.00012217063906350652,0.6538461538461539
3734,5817,반지의제왕/Noun,26,17,9,0.00021118150494609317,0.00012217063906350652,0.6538461538461539
3735,5818,올인/Noun,26,17,9,0.00021118150494609317,0.00012217063906350652,0.6538461538461539
3736,5819,so/Alpha,26,17,9,0.00021118150494609317,0.00012217063906350652,0.6538461538461539
3737,5820,회의/Noun,26,9,17,0.00012226297654773814,0.0002110220129278749,0.6538461538461539
3738,5821,어요/Noun,26,17,9,0.00021118150494609317,0.00012217063906350652,0.6538461538461539
3739,5822,시간여행/Noun,26,17,9,0.00021118150494609317,0.00012217063906350652,0.6538461538461539
3740,5823,김래원/Noun,26,17,9,0.00021118150494609317,0.00012217063906350652,0.6538461538461539
3741,5824,원한/Noun,26,9,17,0.00012226297654773814,0.0002110220129278749,0.6538461538461539
3742,5825,해리/Noun,26,17,9,0.00021118150494609317,0.00012217063906350652,0.6538461538461539
3743,5826,수지/Noun,26,17,9,0.00021118150494609317,0.00012217063906350652,0.6538461538461539
3744,5827,여고생/Noun,26,10,16,0.0001333777925975325,0.00019991559119482882,0.6153846153846154
3745,5828,디아즈/Noun,26,10,16,0.0001333777925975325,0.00019991559119482882,0.6153846153846154
3746,5829,순정/Noun,26,16,10,0.0002000666888962988,0.00013327706079655256,0.6153846153846154
3747,5830,위선/Noun,26,10,16,0.0001333777925975325,0.00019991559119482882,0.6153846153846154
3748,5831,no/Alpha,26,10,16,0.0001333777925975325,0.00019991559119482882,0.6153846153846154
3749,5832,98년/Number,26,16,10,0.0002000666888962988,0.00013327706079655256,0.6153846153846154
3750,5833,맛보다/Verb,26,16,10,0.0002000666888962988,0.00013327706079655256,0.6153846153846154
3751,5834,유이/Noun,26,16,10,0.0002000666888962988,0.00013327706079655256,0.6153846153846154
3752,5835,앨리스/Noun,26,16,10,0.0002000666888962988,0.00013327706079655256,0.6153846153846154
3753,5836,씻다/Verb,26,10,16,0.0001333777925975325,0.00019991559119482882,0.6153846153846154
3754,5837,이뿌다/Adjective,26,16,10,0.0002000666888962988,0.00013327706079655256,0.6153846153846154
3755,5838,질감/Noun,26,10,16,0.0001333777925975325,0.00019991559119482882,0.6153846153846154
3756,5839,잉여/Noun,26,10,16,0.0001333777925975325,0.00019991559119482882,0.6153846153846154
3757,5840,돕다/Verb,26,10,16,0.0001333777925975325,0.00019991559119482882,0.6153846153846154
3758,5841,알고싶다/Noun,26,10,16,0.0001333777925975325,0.00019991559119482882,0.6153846153846154
3759,5842,추적/Noun,26,10,16,0.0001333777925975325,0.00019991559119482882,0.6153846153846154
3760,5843,블루레이/Noun,26,16,10,0.0002000666888962988,0.00013327706079655256,0.6153846153846154
3761,5844,부각/Noun,26,10,16,0.0001333777925975325,0.00019991559119482882,0.6153846153846154
3762,5845,이요원/Noun,26,10,16,0.0001333777925975325,0.00019991559119482882,0.6153846153846154
3763,5890,Bad/Alpha,25,1,24,3.334444814938313e-05,0.0002887669650591972,0.96
3764,5891,꾸밈/Noun,25,24,1,0.0002889852172946538,3.331926519913814e-05,0.96
3765,5892,쏠쏠하다/Adjective,25,24,1,0.0002889852172946538,3.331926519913814e-05,0.96
3766,5893,기부/Noun,25,1,24,3.334444814938313e-05,0.0002887669650591972,0.96
3767,5894,ㅅㄱ/KoreanParticle,25,2,23,4.445926419917751e-05,0.00027766054332615115,0.92
3768,5895,인피니트/Noun,25,23,2,0.00027787040124485944,4.4425686932184186e-05,0.92
3769,5896,부실/Noun,25,2,23,4.445926419917751e-05,0.00027766054332615115,0.92
3770,5897,오래오래/Noun,25,23,2,0.00027787040124485944,4.4425686932184186e-05,0.92
3771,5898,탄탄/Noun,25,23,2,0.00027787040124485944,4.4425686932184186e-05,0.92
3772,5899,조잡/Noun,25,2,23,4.445926419917751e-05,0.00027766054332615115,0.92
3773,5900,지망/Noun,25,3,22,5.5574080248971876e-05,0.00026655412159310506,0.88
3774,5901,예상외/Noun,25,22,3,0.000266755585195065,5.553210866523024e-05,0.88
3775,5902,클릭/Noun,25,3,22,5.5574080248971876e-05,0.00026655412159310506,0.88
3776,5903,?./Punctuation,25,3,22,5.5574080248971876e-05,0.00026655412159310506,0.88
3777,5904,같잖다/Adjective,25,3,22,5.5574080248971876e-05,0.00026655412159310506,0.88
3778,5905,ㅡㅡㅋ/KoreanParticle,25,4,21,6.668889629876625e-05,0.0002554476998600591,0.84
3779,5906,윽/Noun,25,4,21,6.668889629876625e-05,0.0002554476998600591,0.84
3780,5907,훌륭/Noun,25,21,4,0.00025564076914527065,6.663853039827628e-05,0.84
3781,5908,엠씨/Noun,25,4,21,6.668889629876625e-05,0.0002554476998600591,0.84
3782,5909,쿠바/Noun,25,21,4,0.00025564076914527065,6.663853039827628e-05,0.84
3783,5910,축복/Noun,25,21,4,0.00025564076914527065,6.663853039827628e-05,0.84
3784,5911,온건/Noun,25,4,21,6.668889629876625e-05,0.0002554476998600591,0.84
3785,5912,4000원/Number,25,4,21,6.668889629876625e-05,0.0002554476998600591,0.84
3786,5913,붕/Noun,25,4,21,6.668889629876625e-05,0.0002554476998600591,0.84
3787,5914,...-_-/Punctuation,25,5,20,7.780371234856063e-05,0.00024434127812701304,0.8
3788,5915,양산/Noun,25,5,20,7.780371234856063e-05,0.00024434127812701304,0.8
3789,5916,슬로우/Noun,25,5,20,7.780371234856063e-05,0.00024434127812701304,0.8
3790,5917,바램/Noun,25,20,5,0.00024452595309547634,7.774495213132233e-05,0.8
3791,5918,쩔어요/Noun,25,20,5,0.00024452595309547634,7.774495213132233e-05,0.8
3792,5919,썅/Noun,25,5,20,7.780371234856063e-05,0.00024434127812701304,0.8
3793,5920,-_/Punctuation,25,5,20,7.780371234856063e-05,0.00024434127812701304,0.8
3794,5921,아이디/Noun,25,5,20,7.780371234856063e-05,0.00024434127812701304,0.8
3795,5922,따오다/Verb,25,5,20,7.780371234856063e-05,0.00024434127812701304,0.8
3796,5923,97년/Number,25,20,5,0.00024452595309547634,7.774495213132233e-05,0.8
3797,5924,소방관/Noun,25,20,5,0.00024452595309547634,7.774495213132233e-05,0.8
3798,5925,붕괴/Noun,25,5,20,7.780371234856063e-05,0.00024434127812701304,0.8
3799,5926,멸망/Noun,25,6,19,8.891852839835501e-05,0.000233234856393967,0.76
3800,5927,된장녀/Noun,25,6,19,8.891852839835501e-05,0.000233234856393967,0.76
3801,5928,진가/Noun,25,19,6,0.0002334111370456819,8.885137386436837e-05,0.76
3802,5929,고갈/Noun,25,6,19,8.891852839835501e-05,0.000233234856393967,0.76
3803,5930,브금/Noun,25,19,6,0.0002334111370456819,8.885137386436837e-05,0.76
3804,5931,서양인/Noun,25,6,19,8.891852839835501e-05,0.000233234856393967,0.76
3805,5932,요란하다/Adjective,25,6,19,8.891852839835501e-05,0.000233234856393967,0.76
3806,5933,억압/Noun,25,19,6,0.0002334111370456819,8.885137386436837e-05,0.76
3807,5934,김승우/Noun,25,6,19,8.891852839835501e-05,0.000233234856393967,0.76
3808,5935,1980년/Number,25,6,19,8.891852839835501e-05,0.000233234856393967,0.76
3809,5936,자전거/Noun,25,19,6,0.0002334111370456819,8.885137386436837e-05,0.76
3810,5937,껍데기/Noun,25,7,18,0.0001000333444481494,0.00022212843466092096,0.72
3811,5938,정상인/Noun,25,7,18,0.0001000333444481494,0.00022212843466092096,0.72
3812,5939,멘트/Noun,25,7,18,0.0001000333444481494,0.00022212843466092096,0.72
3813,5940,k/Alpha,25,7,18,0.0001000333444481494,0.00022212843466092096,0.72
3814,5941,분투/Noun,25,7,18,0.0001000333444481494,0.00022212843466092096,0.72
3815,5942,첩보물/Noun,25,18,7,0.0002222963209958875,9.995779559741441e-05,0.72
3816,5943,건달/Noun,25,7,18,0.0001000333444481494,0.00022212843466092096,0.72
3817,5944,윤발/Noun,25,7,18,0.0001000333444481494,0.00022212843466092096,0.72
3818,5945,제국주의/Noun,25,7,18,0.0001000333444481494,0.00022212843466092096,0.72
3819,5946,바사/Noun,25,7,18,0.0001000333444481494,0.00022212843466092096,0.72
3820,5947,애국/Noun,25,7,18,0.0001000333444481494,0.00022212843466092096,0.72
3821,5948,집합/Noun,25,8,17,0.00011114816049794375,0.0002110220129278749,0.68
3822,5949,삼국지/Noun,25,8,17,0.00011114816049794375,0.0002110220129278749,0.68
3823,5950,별개/Noun,25,8,17,0.00011114816049794375,0.0002110220129278749,0.68
3824,5951,분류/Noun,25,8,17,0.00011114816049794375,0.0002110220129278749,0.68
3825,5952,마셈/Noun,25,8,17,0.00011114816049794375,0.0002110220129278749,0.68
3826,5953,단말/Noun,25,8,17,0.00011114816049794375,0.0002110220129278749,0.68
3827,5954,러브레터/Noun,25,17,8,0.00021118150494609317,0.00011106421733046048,0.68
3828,5955,헌/Modifier,25,17,8,0.00021118150494609317,0.00011106421733046048,0.68
3829,5956,중견/Noun,25,8,17,0.00011114816049794375,0.0002110220129278749,0.68
3830,5957,박스/Noun,25,8,17,0.00011114816049794375,0.0002110220129278749,0.68
3831,5958,구지/Noun,25,8,17,0.00011114816049794375,0.0002110220129278749,0.68
3832,5959,No/Alpha,25,8,17,0.00011114816049794375,0.0002110220129278749,0.68
3833,5960,프리드/Noun,25,17,8,0.00021118150494609317,0.00011106421733046048,0.68
3834,5961,베를린/Noun,25,17,8,0.00021118150494609317,0.00011106421733046048,0.68
3835,5962,내지/Noun,25,8,17,0.00011114816049794375,0.0002110220129278749,0.68
3836,5963,제적/Noun,25,8,17,0.00011114816049794375,0.0002110220129278749,0.68
3837,5964,본드/Noun,25,17,8,0.00021118150494609317,0.00011106421733046048,0.68
3838,5965,알렉스/Noun,25,17,8,0.00021118150494609317,0.00011106421733046048,0.68
3839,5966,친일/Noun,25,8,17,0.00011114816049794375,0.0002110220129278749,0.68
3840,5967,귀하다/Adjective,25,17,8,0.00021118150494609317,0.00011106421733046048,0.68
3841,5968,고루/Noun,25,8,17,0.00011114816049794375,0.0002110220129278749,0.68
3842,5969,회복/Noun,25,17,8,0.00021118150494609317,0.00011106421733046048,0.68
3843,5970,좌빨/Noun,25,9,16,0.00012226297654773814,0.00019991559119482882,0.64
3844,5971,인위/Noun,25,9,16,0.00012226297654773814,0.00019991559119482882,0.64
3845,5972,스토/Noun,25,9,16,0.00012226297654773814,0.00019991559119482882,0.64
3846,5973,건조하다/Adjective,25,16,9,0.0002000666888962988,0.00012217063906350652,0.64
3847,5974,벌레/Noun,25,9,16,0.00012226297654773814,0.00019991559119482882,0.64
3848,5975,중요성/Noun,25,16,9,0.0002000666888962988,0.00012217063906350652,0.64
3849,5976,...!!!/Punctuation,25,16,9,0.0002000666888962988,0.00012217063906350652,0.64
3850,5977,에게만/Josa,25,9,16,0.00012226297654773814,0.00019991559119482882,0.64
3851,5978,당대/Noun,25,16,9,0.0002000666888962988,0.00012217063906350652,0.64
3852,5979,인칭/Noun,25,9,16,0.00012226297654773814,0.00019991559119482882,0.64
3853,5980,내버리다/Verb,25,9,16,0.00012226297654773814,0.00019991559119482882,0.64
3854,5981,폭소/Noun,25,9,16,0.00012226297654773814,0.00019991559119482882,0.64
3855,5982,대구/Noun,25,16,9,0.0002000666888962988,0.00012217063906350652,0.64
3856,5983,괴기/Noun,25,9,16,0.00012226297654773814,0.00019991559119482882,0.64
3857,5984,이어서/Adverb,25,16,9,0.0002000666888962988,0.00012217063906350652,0.64
3858,5985,사나/Noun,25,16,9,0.0002000666888962988,0.00012217063906350652,0.64
3859,5986,마력/Noun,25,16,9,0.0002000666888962988,0.00012217063906350652,0.64
3860,5987,인정받다/Verb,25,9,16,0.00012226297654773814,0.00019991559119482882,0.64
3861,5988,퍼지다/Verb,25,16,9,0.0002000666888962988,0.00012217063906350652,0.64
3862,5989,2%/Number,25,16,9,0.0002000666888962988,0.00012217063906350652,0.64
3863,5990,방사/Noun,25,9,16,0.00012226297654773814,0.00019991559119482882,0.64
3864,5991,세월호/Noun,25,16,9,0.0002000666888962988,0.00012217063906350652,0.64
3865,5992,타락하다/Adjective,25,15,10,0.00018895187284650438,0.00013327706079655256,0.6
3866,5993,토비/Noun,25,15,10,0.00018895187284650438,0.00013327706079655256,0.6
3867,5994,통속/Noun,25,10,15,0.0001333777925975325,0.0001888091694617828,0.6
3868,5995,펜/Noun,25,10,15,0.0001333777925975325,0.0001888091694617828,0.6
3869,5996,이정진/Noun,25,10,15,0.0001333777925975325,0.0001888091694617828,0.6
3870,5997,요원/Noun,25,15,10,0.00018895187284650438,0.00013327706079655256,0.6
3871,5998,장백지/Noun,25,10,15,0.0001333777925975325,0.0001888091694617828,0.6
3872,5999,스틸/Noun,25,10,15,0.0001333777925975325,0.0001888091694617828,0.6
3873,6000,덧/Noun,25,15,10,0.00018895187284650438,0.00013327706079655256,0.6
3874,6001,마동석/Noun,25,10,15,0.0001333777925975325,0.0001888091694617828,0.6
3875,6002,해주/Noun,25,15,10,0.00018895187284650438,0.00013327706079655256,0.6
3876,6003,조건/Noun,25,15,10,0.00018895187284650438,0.00013327706079655256,0.6
3877,6004,얹다/Verb,25,10,15,0.0001333777925975325,0.0001888091694617828,0.6
3878,6005,오가다/Verb,25,15,10,0.00018895187284650438,0.00013327706079655256,0.6
3879,6006,가가/Noun,25,15,10,0.00018895187284650438,0.00013327706079655256,0.6
3880,6007,이준/Noun,25,15,10,0.00018895187284650438,0.00013327706079655256,0.6
3881,6049,♡♡♡/Foreign,24,24,0,0.0002889852172946538,2.2212843466092093e-05,1.0
3882,6050,乃/Foreign,24,24,0,0.0002889852172946538,2.2212843466092093e-05,1.0
3883,6051,낚였어/Noun,24,0,24,2.2229632099588756e-05,0.0002887669650591972,1.0
3884,6052,관광/Noun,24,0,24,2.2229632099588756e-05,0.0002887669650591972,1.0
3885,6053,조치/Noun,24,1,23,3.334444814938313e-05,0.00027766054332615115,0.9583333333333334
3886,6054,맥빠지다/Adjective,24,1,23,3.334444814938313e-05,0.00027766054332615115,0.9583333333333334
3887,6055,빠르기/Noun,24,1,23,3.334444814938313e-05,0.00027766054332615115,0.9583333333333334
3888,6056,학예회/Noun,24,1,23,3.334444814938313e-05,0.00027766054332615115,0.9583333333333334
3889,6057,오그/Noun,24,1,23,3.334444814938313e-05,0.00027766054332615115,0.9583333333333334
3890,6058,반점/Noun,24,2,22,4.445926419917751e-05,0.00026655412159310506,0.9166666666666666
3891,6059,심금/Noun,24,22,2,0.000266755585195065,4.4425686932184186e-05,0.9166666666666666
3892,6060,닭살/Noun,24,2,22,4.445926419917751e-05,0.00026655412159310506,0.9166666666666666
3893,6061,전범/Noun,24,2,22,4.445926419917751e-05,0.00026655412159310506,0.9166666666666666
3894,6062,상쾌하다/Adjective,24,22,2,0.000266755585195065,4.4425686932184186e-05,0.9166666666666666
3895,6063,날카롭다/Adjective,24,22,2,0.000266755585195065,4.4425686932184186e-05,0.9166666666666666
3896,6064,소외/Noun,24,22,2,0.000266755585195065,4.4425686932184186e-05,0.9166666666666666
3897,6065,수면/Noun,24,2,22,4.445926419917751e-05,0.00026655412159310506,0.9166666666666666
3898,6066,방어율/Noun,24,2,22,4.445926419917751e-05,0.00026655412159310506,0.9166666666666666
3899,6067,구지성/Noun,24,2,22,4.445926419917751e-05,0.00026655412159310506,0.9166666666666666
3900,6068,뿐더러/Noun,24,3,21,5.5574080248971876e-05,0.0002554476998600591,0.875
3901,6069,거참/Noun,24,3,21,5.5574080248971876e-05,0.0002554476998600591,0.875
3902,6070,오래도록/Adverb,24,21,3,0.00025564076914527065,5.553210866523024e-05,0.875
3903,6071,캡틴/Noun,24,21,3,0.00025564076914527065,5.553210866523024e-05,0.875
3904,6072,어렷을때/Noun,24,21,3,0.00025564076914527065,5.553210866523024e-05,0.875
3905,6073,와나/Noun,24,4,20,6.668889629876625e-05,0.00024434127812701304,0.8333333333333334
3906,6074,대륙/Noun,24,4,20,6.668889629876625e-05,0.00024434127812701304,0.8333333333333334
3907,6075,브라질/Noun,24,20,4,0.00024452595309547634,6.663853039827628e-05,0.8333333333333334
3908,6076,실적/Noun,24,20,4,0.00024452595309547634,6.663853039827628e-05,0.8333333333333334
3909,6077,죽겠네/Noun,24,4,20,6.668889629876625e-05,0.00024434127812701304,0.8333333333333334
3910,6078,문명/Noun,24,20,4,0.00024452595309547634,6.663853039827628e-05,0.8333333333333334
3911,6079,장창/Noun,24,4,20,6.668889629876625e-05,0.00024434127812701304,0.8333333333333334
3912,6080,13년/Number,24,20,4,0.00024452595309547634,6.663853039827628e-05,0.8333333333333334
3913,6081,올려놓다/Verb,24,5,19,7.780371234856063e-05,0.000233234856393967,0.7916666666666666
3914,6082,흐리다/Verb,24,5,19,7.780371234856063e-05,0.000233234856393967,0.7916666666666666
3915,6083,렌트/Noun,24,5,19,7.780371234856063e-05,0.000233234856393967,0.7916666666666666
3916,6084,반의/Noun,24,5,19,7.780371234856063e-05,0.000233234856393967,0.7916666666666666
3917,6085,스무살/Noun,24,19,5,0.0002334111370456819,7.774495213132233e-05,0.7916666666666666
3918,6086,저능/Noun,24,5,19,7.780371234856063e-05,0.000233234856393967,0.7916666666666666
3919,6087,으악/Adverb,24,5,19,7.780371234856063e-05,0.000233234856393967,0.7916666666666666
3920,6088,박정희/Noun,24,5,19,7.780371234856063e-05,0.000233234856393967,0.7916666666666666
3921,6089,놔두다/Verb,24,5,19,7.780371234856063e-05,0.000233234856393967,0.7916666666666666
3922,6090,아따/Noun,24,5,19,7.780371234856063e-05,0.000233234856393967,0.7916666666666666
3923,6091,상속/Noun,24,19,5,0.0002334111370456819,7.774495213132233e-05,0.7916666666666666
3924,6092,진상/Noun,24,5,19,7.780371234856063e-05,0.000233234856393967,0.7916666666666666
3925,6093,적합하다/Adjective,24,5,19,7.780371234856063e-05,0.000233234856393967,0.7916666666666666
3926,6094,조디/Noun,24,19,5,0.0002334111370456819,7.774495213132233e-05,0.7916666666666666
3927,6095,액/Noun,24,5,19,7.780371234856063e-05,0.000233234856393967,0.7916666666666666
3928,6096,피고/Noun,24,6,18,8.891852839835501e-05,0.00022212843466092096,0.75
3929,6097,앵/Adverb,24,6,18,8.891852839835501e-05,0.00022212843466092096,0.75
3930,6098,가두다/Verb,24,6,18,8.891852839835501e-05,0.00022212843466092096,0.75
3931,6099,엠비씨/Noun,24,6,18,8.891852839835501e-05,0.00022212843466092096,0.75
3932,6100,하찮다/Adjective,24,6,18,8.891852839835501e-05,0.00022212843466092096,0.75
3933,6101,진국/Noun,24,18,6,0.0002222963209958875,8.885137386436837e-05,0.75
3934,6102,소비/Noun,24,6,18,8.891852839835501e-05,0.00022212843466092096,0.75
3935,6103,아주아주/Adverb,24,18,6,0.0002222963209958875,8.885137386436837e-05,0.75
3936,6104,ㅅㅅ/KoreanParticle,24,6,18,8.891852839835501e-05,0.00022212843466092096,0.75
3937,6105,축하/Noun,24,18,6,0.0002222963209958875,8.885137386436837e-05,0.75
3938,6106,게다/Noun,24,6,18,8.891852839835501e-05,0.00022212843466092096,0.75
3939,6107,이경영/Noun,24,6,18,8.891852839835501e-05,0.00022212843466092096,0.75
3940,6108,도배/Noun,24,7,17,0.0001000333444481494,0.0002110220129278749,0.7083333333333334
3941,6109,녹음/Noun,24,7,17,0.0001000333444481494,0.0002110220129278749,0.7083333333333334
3942,6110,존예/Noun,24,17,7,0.00021118150494609317,9.995779559741441e-05,0.7083333333333334
3943,6111,박살/Noun,24,7,17,0.0001000333444481494,0.0002110220129278749,0.7083333333333334
3944,6112,기기/Noun,24,7,17,0.0001000333444481494,0.0002110220129278749,0.7083333333333334
3945,6113,계단/Noun,24,17,7,0.00021118150494609317,9.995779559741441e-05,0.7083333333333334
3946,6114,명언/Noun,24,17,7,0.00021118150494609317,9.995779559741441e-05,0.7083333333333334
3947,6115,..!!!/Punctuation,24,17,7,0.00021118150494609317,9.995779559741441e-05,0.7083333333333334
3948,6116,브라이언/Noun,24,17,7,0.00021118150494609317,9.995779559741441e-05,0.7083333333333334
3949,6117,퀴/Noun,24,7,17,0.0001000333444481494,0.0002110220129278749,0.7083333333333334
3950,6118,90/Number,24,7,17,0.0001000333444481494,0.0002110220129278749,0.7083333333333334
3951,6119,완존/Noun,24,17,7,0.00021118150494609317,9.995779559741441e-05,0.7083333333333334
3952,6120,".,./Punctuation",24,7,17,0.0001000333444481494,0.0002110220129278749,0.7083333333333334
3953,6121,눈물샘/Noun,24,17,7,0.00021118150494609317,9.995779559741441e-05,0.7083333333333334
3954,6122,민호/Noun,24,17,7,0.00021118150494609317,9.995779559741441e-05,0.7083333333333334
3955,6123,장선우/Noun,24,7,17,0.0001000333444481494,0.0002110220129278749,0.7083333333333334
3956,6124,창문/Noun,24,7,17,0.0001000333444481494,0.0002110220129278749,0.7083333333333334
3957,6125,이빨/Noun,24,7,17,0.0001000333444481494,0.0002110220129278749,0.7083333333333334
3958,6126,파치노/Noun,24,17,7,0.00021118150494609317,9.995779559741441e-05,0.7083333333333334
3959,6127,낡다/Adjective,24,7,17,0.0001000333444481494,0.0002110220129278749,0.7083333333333334
3960,6128,초라하다/Adjective,24,7,17,0.0001000333444481494,0.0002110220129278749,0.7083333333333334
3961,6129,해소/Noun,24,17,7,0.00021118150494609317,9.995779559741441e-05,0.7083333333333334
3962,6130,이문식/Noun,24,7,17,0.0001000333444481494,0.0002110220129278749,0.7083333333333334
3963,6131,이뤄지다/Verb,24,17,7,0.00021118150494609317,9.995779559741441e-05,0.7083333333333334
3964,6132,스티븐시걸/Noun,24,8,16,0.00011114816049794375,0.00019991559119482882,0.6666666666666666
3965,6133,비우다/Verb,24,8,16,0.00011114816049794375,0.00019991559119482882,0.6666666666666666
3966,6134,부조리/Noun,24,16,8,0.0002000666888962988,0.00011106421733046048,0.6666666666666666
3967,6135,대립/Noun,24,16,8,0.0002000666888962988,0.00011106421733046048,0.6666666666666666
3968,6136,스님/Noun,24,16,8,0.0002000666888962988,0.00011106421733046048,0.6666666666666666
3969,6137,장영/Noun,24,16,8,0.0002000666888962988,0.00011106421733046048,0.6666666666666666
3970,6138,분노하다/Adjective,24,8,16,0.00011114816049794375,0.00019991559119482882,0.6666666666666666
3971,6139,월드컵/Noun,24,16,8,0.0002000666888962988,0.00011106421733046048,0.6666666666666666
3972,6140,?????/Punctuation,24,8,16,0.00011114816049794375,0.00019991559119482882,0.6666666666666666
3973,6141,쇼킹/Noun,24,16,8,0.0002000666888962988,0.00011106421733046048,0.6666666666666666
3974,6142,문구/Noun,24,8,16,0.00011114816049794375,0.00019991559119482882,0.6666666666666666
3975,6143,야쿠자/Noun,24,8,16,0.00011114816049794375,0.00019991559119482882,0.6666666666666666
3976,6144,택/Noun,24,8,16,0.00011114816049794375,0.00019991559119482882,0.6666666666666666
3977,6145,호랑이/Noun,24,16,8,0.0002000666888962988,0.00011106421733046048,0.6666666666666666
3978,6146,빈틈/Noun,24,16,8,0.0002000666888962988,0.00011106421733046048,0.6666666666666666
3979,6147,리차드/Noun,24,16,8,0.0002000666888962988,0.00011106421733046048,0.6666666666666666
3980,6148,움직임/Noun,24,16,8,0.0002000666888962988,0.00011106421733046048,0.6666666666666666
3981,6149,유준상/Noun,24,8,16,0.00011114816049794375,0.00019991559119482882,0.6666666666666666
3982,6150,류승룡/Noun,24,16,8,0.0002000666888962988,0.00011106421733046048,0.6666666666666666
3983,6151,캐다/Verb,24,9,15,0.00012226297654773814,0.0001888091694617828,0.625
3984,6152,안개/Noun,24,15,9,0.00018895187284650438,0.00012217063906350652,0.625
3985,6153,햇던/Noun,24,9,15,0.00012226297654773814,0.0001888091694617828,0.625
3986,6154,유승호/Noun,24,9,15,0.00012226297654773814,0.0001888091694617828,0.625
3987,6155,그리스/Noun,24,9,15,0.00012226297654773814,0.0001888091694617828,0.625
3988,6156,숀펜/Noun,24,15,9,0.00018895187284650438,0.00012217063906350652,0.625
3989,6157,지워지다/Verb,24,15,9,0.00018895187284650438,0.00012217063906350652,0.625
3990,6158,독도/Noun,24,15,9,0.00018895187284650438,0.00012217063906350652,0.625
3991,6159,외다/Verb,24,9,15,0.00012226297654773814,0.0001888091694617828,0.625
3992,6160,닳다/Verb,24,9,15,0.00012226297654773814,0.0001888091694617828,0.625
3993,6161,재일/Noun,24,15,9,0.00018895187284650438,0.00012217063906350652,0.625
3994,6162,김윤석/Noun,24,15,9,0.00018895187284650438,0.00012217063906350652,0.625
3995,6163,장미/Noun,24,15,9,0.00018895187284650438,0.00012217063906350652,0.625
3996,6164,교사/Noun,24,9,15,0.00012226297654773814,0.0001888091694617828,0.625
3997,6225,포근하다/Adjective,23,23,0,0.00027787040124485944,2.2212843466092093e-05,1.0
3998,6226,물체/Noun,23,0,23,2.2229632099588756e-05,0.00027766054332615115,1.0
3999,6227,긴급/Noun,23,1,22,3.334444814938313e-05,0.00026655412159310506,0.9565217391304348
4000,6228,난감/Noun,23,1,22,3.334444814938313e-05,0.00026655412159310506,0.9565217391304348
4001,6229,추강/Noun,23,22,1,0.000266755585195065,3.331926519913814e-05,0.9565217391304348
4002,6230,잡탕/Noun,23,1,22,3.334444814938313e-05,0.00026655412159310506,0.9565217391304348
4003,6231,꼽는/Noun,23,22,1,0.000266755585195065,3.331926519913814e-05,0.9565217391304348
4004,6232,못만드/Noun,23,2,21,4.445926419917751e-05,0.0002554476998600591,0.9130434782608696
4005,6233,박영화/Noun,23,21,2,0.00025564076914527065,4.4425686932184186e-05,0.9130434782608696
4006,6234,바람나다/Verb,23,2,21,4.445926419917751e-05,0.0002554476998600591,0.9130434782608696
4007,6235,존잘/Noun,23,20,3,0.00024452595309547634,5.553210866523024e-05,0.8695652173913043
4008,6236,경력/Noun,23,3,20,5.5574080248971876e-05,0.00024434127812701304,0.8695652173913043
4009,6237,11년/Number,23,20,3,0.00024452595309547634,5.553210866523024e-05,0.8695652173913043
4010,6238,나대다/Verb,23,3,20,5.5574080248971876e-05,0.00024434127812701304,0.8695652173913043
4011,6239,-;/Punctuation,23,3,20,5.5574080248971876e-05,0.00024434127812701304,0.8695652173913043
4012,6240,^.^/Punctuation,23,20,3,0.00024452595309547634,5.553210866523024e-05,0.8695652173913043
4013,6241,노아/Noun,23,3,20,5.5574080248971876e-05,0.00024434127812701304,0.8695652173913043
4014,6242,욧/Noun,23,20,3,0.00024452595309547634,5.553210866523024e-05,0.8695652173913043
4015,6243,스며들다/Verb,23,20,3,0.00024452595309547634,5.553210866523024e-05,0.8695652173913043
4016,6244,호프/Noun,23,20,3,0.00024452595309547634,5.553210866523024e-05,0.8695652173913043
4017,6245,직장인/Noun,23,20,3,0.00024452595309547634,5.553210866523024e-05,0.8695652173913043
4018,6246,볼바/Noun,23,3,20,5.5574080248971876e-05,0.00024434127812701304,0.8695652173913043
4019,6247,반쪽/Noun,23,3,20,5.5574080248971876e-05,0.00024434127812701304,0.8695652173913043
4020,6248,꾸역꾸역/Adverb,23,3,20,5.5574080248971876e-05,0.00024434127812701304,0.8695652173913043
4021,6249,데드/Noun,23,4,19,6.668889629876625e-05,0.000233234856393967,0.8260869565217391
4022,6250,파탄/Noun,23,4,19,6.668889629876625e-05,0.000233234856393967,0.8260869565217391
4023,6251,사골/Noun,23,4,19,6.668889629876625e-05,0.000233234856393967,0.8260869565217391
4024,6252,동양인/Noun,23,4,19,6.668889629876625e-05,0.000233234856393967,0.8260869565217391
4025,6253,요가/Noun,23,4,19,6.668889629876625e-05,0.000233234856393967,0.8260869565217391
4026,6254,잼남/Noun,23,19,4,0.0002334111370456819,6.663853039827628e-05,0.8260869565217391
4027,6255,후진/Noun,23,4,19,6.668889629876625e-05,0.000233234856393967,0.8260869565217391
4028,6256,킹왕짱/Noun,23,19,4,0.0002334111370456819,6.663853039827628e-05,0.8260869565217391
4029,6257,갈망/Noun,23,19,4,0.0002334111370456819,6.663853039827628e-05,0.8260869565217391
4030,6258,구식/Noun,23,4,19,6.668889629876625e-05,0.000233234856393967,0.8260869565217391
4031,6259,세심/Noun,23,19,4,0.0002334111370456819,6.663853039827628e-05,0.8260869565217391
4032,6260,추상/Noun,23,4,19,6.668889629876625e-05,0.000233234856393967,0.8260869565217391
4033,6261,남우/Noun,23,19,4,0.0002334111370456819,6.663853039827628e-05,0.8260869565217391
4034,6262,밍밍/Noun,23,4,19,6.668889629876625e-05,0.000233234856393967,0.8260869565217391
4035,6263,?;;/Punctuation,23,4,19,6.668889629876625e-05,0.000233234856393967,0.8260869565217391
4036,6264,보너스/Noun,23,18,5,0.0002222963209958875,7.774495213132233e-05,0.7826086956521741
4037,6265,수호/Noun,23,18,5,0.0002222963209958875,7.774495213132233e-05,0.7826086956521741
4038,6266,토요일/Noun,23,18,5,0.0002222963209958875,7.774495213132233e-05,0.7826086956521741
4039,6267,람/Noun,23,5,18,7.780371234856063e-05,0.00022212843466092096,0.7826086956521741
4040,6268,화신/Noun,23,5,18,7.780371234856063e-05,0.00022212843466092096,0.7826086956521741
4041,6269,저학년/Noun,23,5,18,7.780371234856063e-05,0.00022212843466092096,0.7826086956521741
4042,6270,유부녀/Noun,23,5,18,7.780371234856063e-05,0.00022212843466092096,0.7826086956521741
4043,6271,기다림/Noun,23,18,5,0.0002222963209958875,7.774495213132233e-05,0.7826086956521741
4044,6272,왕국/Noun,23,5,18,7.780371234856063e-05,0.00022212843466092096,0.7826086956521741
4045,6273,불신/Noun,23,5,18,7.780371234856063e-05,0.00022212843466092096,0.7826086956521741
4046,6274,에반게리온/Noun,23,17,6,0.00021118150494609317,8.885137386436837e-05,0.7391304347826086
4047,6275,나탈리/Noun,23,17,6,0.00021118150494609317,8.885137386436837e-05,0.7391304347826086
4048,6276,온통/Noun,23,6,17,8.891852839835501e-05,0.0002110220129278749,0.7391304347826086
4049,6277,현상/Noun,23,6,17,8.891852839835501e-05,0.0002110220129278749,0.7391304347826086
4050,6278,25년/Number,23,17,6,0.00021118150494609317,8.885137386436837e-05,0.7391304347826086
4051,6279,뵙다/Verb,23,17,6,0.00021118150494609317,8.885137386436837e-05,0.7391304347826086
4052,6280,단조롭다/Adjective,23,6,17,8.891852839835501e-05,0.0002110220129278749,0.7391304347826086
4053,6281,나른하다/Adjective,23,17,6,0.00021118150494609317,8.885137386436837e-05,0.7391304347826086
4054,6282,후배/Noun,23,6,17,8.891852839835501e-05,0.0002110220129278749,0.7391304347826086
4055,6283,탱/Adverb,23,6,17,8.891852839835501e-05,0.0002110220129278749,0.7391304347826086
4056,6284,긁다/Verb,23,6,17,8.891852839835501e-05,0.0002110220129278749,0.7391304347826086
4057,6285,이기심/Noun,23,17,6,0.00021118150494609317,8.885137386436837e-05,0.7391304347826086
4058,6286,레고/Noun,23,17,6,0.00021118150494609317,8.885137386436837e-05,0.7391304347826086
4059,6287,?..../Punctuation,23,6,17,8.891852839835501e-05,0.0002110220129278749,0.7391304347826086
4060,6288,함축/Noun,23,17,6,0.00021118150494609317,8.885137386436837e-05,0.7391304347826086
4061,6289,쭈욱/Noun,23,17,6,0.00021118150494609317,8.885137386436837e-05,0.7391304347826086
4062,6290,먹고살다/Verb,23,7,16,0.0001000333444481494,0.00019991559119482882,0.6956521739130435
4063,6291,길거리/Noun,23,7,16,0.0001000333444481494,0.00019991559119482882,0.6956521739130435
4064,6292,오덕/Noun,23,7,16,0.0001000333444481494,0.00019991559119482882,0.6956521739130435
4065,6293,태권도/Noun,23,7,16,0.0001000333444481494,0.00019991559119482882,0.6956521739130435
4066,6294,lt/Alpha,23,16,7,0.0002000666888962988,9.995779559741441e-05,0.6956521739130435
4067,6295,송윤아/Noun,23,16,7,0.0002000666888962988,9.995779559741441e-05,0.6956521739130435
4068,6296,사신/Noun,23,7,16,0.0001000333444481494,0.00019991559119482882,0.6956521739130435
4069,6297,영화광/Noun,23,7,16,0.0001000333444481494,0.00019991559119482882,0.6956521739130435
4070,6298,고아라/Noun,23,16,7,0.0002000666888962988,9.995779559741441e-05,0.6956521739130435
4071,6299,건너/Noun,23,7,16,0.0001000333444481494,0.00019991559119482882,0.6956521739130435
4072,6300,반미/Noun,23,7,16,0.0001000333444481494,0.00019991559119482882,0.6956521739130435
4073,6301,인격/Noun,23,7,16,0.0001000333444481494,0.00019991559119482882,0.6956521739130435
4074,6302,에잇/Exclamation,23,7,16,0.0001000333444481494,0.00019991559119482882,0.6956521739130435
4075,6303,동정/Noun,23,7,16,0.0001000333444481494,0.00019991559119482882,0.6956521739130435
4076,6304,지하/Noun,23,7,16,0.0001000333444481494,0.00019991559119482882,0.6956521739130435
4077,6305,시위/Noun,23,7,16,0.0001000333444481494,0.00019991559119482882,0.6956521739130435
4078,6306,싱크로/Noun,23,15,8,0.00018895187284650438,0.00011106421733046048,0.6521739130434783
4079,6307,심판/Noun,23,8,15,0.00011114816049794375,0.0001888091694617828,0.6521739130434783
4080,6308,잘나오다/Verb,23,8,15,0.00011114816049794375,0.0001888091694617828,0.6521739130434783
4081,6309,리그/Noun,23,8,15,0.00011114816049794375,0.0001888091694617828,0.6521739130434783
4082,6310,꽃미남/Noun,23,15,8,0.00018895187284650438,0.00011106421733046048,0.6521739130434783
4083,6311,김수미/Noun,23,8,15,0.00011114816049794375,0.0001888091694617828,0.6521739130434783
4084,6312,치킨/Noun,23,8,15,0.00011114816049794375,0.0001888091694617828,0.6521739130434783
4085,6313,윤시윤/Noun,23,15,8,0.00018895187284650438,0.00011106421733046048,0.6521739130434783
4086,6314,gt/Alpha,23,15,8,0.00018895187284650438,0.00011106421733046048,0.6521739130434783
4087,6315,광해/Noun,23,15,8,0.00018895187284650438,0.00011106421733046048,0.6521739130434783
4088,6316,기선/Noun,23,8,15,0.00011114816049794375,0.0001888091694617828,0.6521739130434783
4089,6317,여서/Noun,23,15,8,0.00018895187284650438,0.00011106421733046048,0.6521739130434783
4090,6318,경/Noun,23,15,8,0.00018895187284650438,0.00011106421733046048,0.6521739130434783
4091,6319,에밀리/Noun,23,15,8,0.00018895187284650438,0.00011106421733046048,0.6521739130434783
4092,6320,페/Noun,23,15,8,0.00018895187284650438,0.00011106421733046048,0.6521739130434783
4093,6321,연락/Noun,23,15,8,0.00018895187284650438,0.00011106421733046048,0.6521739130434783
4094,6322,XX/Alpha,23,8,15,0.00011114816049794375,0.0001888091694617828,0.6521739130434783
4095,6323,밑바닥/Noun,23,8,15,0.00011114816049794375,0.0001888091694617828,0.6521739130434783
4096,6324,이자벨/Noun,23,15,8,0.00018895187284650438,0.00011106421733046048,0.6521739130434783
4097,6325,설리/Noun,23,15,8,0.00018895187284650438,0.00011106421733046048,0.6521739130434783
4098,6326,도망치다/Verb,23,8,15,0.00011114816049794375,0.0001888091694617828,0.6521739130434783
4099,6327,꼬집다/Verb,23,15,8,0.00018895187284650438,0.00011106421733046048,0.6521739130434783
4100,6328,라이더/Noun,23,15,8,0.00018895187284650438,0.00011106421733046048,0.6521739130434783
4101,6329,신앙/Noun,23,15,8,0.00018895187284650438,0.00011106421733046048,0.6521739130434783
4102,6330,들려주다/Verb,23,15,8,0.00018895187284650438,0.00011106421733046048,0.6521739130434783
4103,6331,6.5/Number,23,8,15,0.00011114816049794375,0.0001888091694617828,0.6521739130434783
4104,6332,뛰어다니다/Verb,23,8,15,0.00011114816049794375,0.0001888091694617828,0.6521739130434783
4105,6333,성폭행/Noun,23,8,15,0.00011114816049794375,0.0001888091694617828,0.6521739130434783
4106,6334,제주도/Noun,23,14,9,0.00017783705679671002,0.00012217063906350652,0.6086956521739131
4107,6335,둘리/Noun,23,14,9,0.00017783705679671002,0.00012217063906350652,0.6086956521739131
4108,6336,해운대/Noun,23,14,9,0.00017783705679671002,0.00012217063906350652,0.6086956521739131
4109,6337,그로테스크/Noun,23,14,9,0.00017783705679671002,0.00012217063906350652,0.6086956521739131
4110,6338,다케시/Noun,23,14,9,0.00017783705679671002,0.00012217063906350652,0.6086956521739131
4111,6339,상자/Noun,23,9,14,0.00012226297654773814,0.00017770274772873674,0.6086956521739131
4112,6340,내려오다/Verb,23,14,9,0.00017783705679671002,0.00012217063906350652,0.6086956521739131
4113,6341,햇음/Noun,23,9,14,0.00012226297654773814,0.00017770274772873674,0.6086956521739131
4114,6342,성기/Noun,23,9,14,0.00012226297654773814,0.00017770274772873674,0.6086956521739131
4115,6343,야수/Noun,23,14,9,0.00017783705679671002,0.00012217063906350652,0.6086956521739131
4116,6344,재생/Noun,23,9,14,0.00012226297654773814,0.00017770274772873674,0.6086956521739131
4117,6345,슬레/Noun,23,9,14,0.00012226297654773814,0.00017770274772873674,0.6086956521739131
4118,6346,테러리스트/Noun,23,9,14,0.00012226297654773814,0.00017770274772873674,0.6086956521739131
4119,6347,이불/Noun,23,14,9,0.00017783705679671002,0.00012217063906350652,0.6086956521739131
4120,6348,앗/Noun,23,14,9,0.00017783705679671002,0.00012217063906350652,0.6086956521739131
4121,6349,아유/Noun,23,9,14,0.00012226297654773814,0.00017770274772873674,0.6086956521739131
4122,6350,강소라/Noun,23,9,14,0.00012226297654773814,0.00017770274772873674,0.6086956521739131
4123,6402,뭘말/Noun,22,0,22,2.2229632099588756e-05,0.00026655412159310506,1.0
4124,6403,어장/Noun,22,0,22,2.2229632099588756e-05,0.00026655412159310506,1.0
4125,6404,엇/Noun,22,21,1,0.00025564076914527065,3.331926519913814e-05,0.9545454545454546
4126,6405,멀미/Noun,22,1,21,3.334444814938313e-05,0.0002554476998600591,0.9545454545454546
4127,6406,비약/Noun,22,1,21,3.334444814938313e-05,0.0002554476998600591,0.9545454545454546
4128,6407,뭉클/Noun,22,21,1,0.00025564076914527065,3.331926519913814e-05,0.9545454545454546
4129,6408,그이/Noun,22,1,21,3.334444814938313e-05,0.0002554476998600591,0.9545454545454546
4130,6409,면상/Noun,22,2,20,4.445926419917751e-05,0.00024434127812701304,0.9090909090909092
4131,6410,시시/Noun,22,2,20,4.445926419917751e-05,0.00024434127812701304,0.9090909090909092
4132,6411,레즈비언/Noun,22,2,20,4.445926419917751e-05,0.00024434127812701304,0.9090909090909092
4133,6412,주님/Noun,22,20,2,0.00024452595309547634,4.4425686932184186e-05,0.9090909090909092
4134,6413,막무가내/Noun,22,2,20,4.445926419917751e-05,0.00024434127812701304,0.9090909090909092
4135,6414,연출자/Noun,22,2,20,4.445926419917751e-05,0.00024434127812701304,0.9090909090909092
4136,6415,장사/Noun,22,2,20,4.445926419917751e-05,0.00024434127812701304,0.9090909090909092
4137,6416,..;;;/Punctuation,22,2,20,4.445926419917751e-05,0.00024434127812701304,0.9090909090909092
4138,6417,에/Noun,22,3,19,5.5574080248971876e-05,0.000233234856393967,0.8636363636363636
4139,6418,쟤/Noun,22,3,19,5.5574080248971876e-05,0.000233234856393967,0.8636363636363636
4140,6419,공익/Noun,22,3,19,5.5574080248971876e-05,0.000233234856393967,0.8636363636363636
4141,6420,쯤/Foreign,22,3,19,5.5574080248971876e-05,0.000233234856393967,0.8636363636363636
4142,6421,저그/Noun,22,3,19,5.5574080248971876e-05,0.000233234856393967,0.8636363636363636
4143,6422,고사/Noun,22,3,19,5.5574080248971876e-05,0.000233234856393967,0.8636363636363636
4144,6423,바하/Noun,22,4,18,6.668889629876625e-05,0.00022212843466092096,0.8181818181818182
4145,6424,악행/Noun,22,4,18,6.668889629876625e-05,0.00022212843466092096,0.8181818181818182
4146,6425,쫙/Noun,22,18,4,0.0002222963209958875,6.663853039827628e-05,0.8181818181818182
4147,6426,윤진서/Noun,22,4,18,6.668889629876625e-05,0.00022212843466092096,0.8181818181818182
4148,6427,연설/Noun,22,18,4,0.0002222963209958875,6.663853039827628e-05,0.8181818181818182
4149,6428,가시다/Verb,22,18,4,0.0002222963209958875,6.663853039827628e-05,0.8181818181818182
4150,6429,",,,,,/Punctuation",22,4,18,6.668889629876625e-05,0.00022212843466092096,0.8181818181818182
4151,6430,꼴다/Verb,22,4,18,6.668889629876625e-05,0.00022212843466092096,0.8181818181818182
4152,6431,최수종/Noun,22,18,4,0.0002222963209958875,6.663853039827628e-05,0.8181818181818182
4153,6432,베드씬/Noun,22,4,18,6.668889629876625e-05,0.00022212843466092096,0.8181818181818182
4154,6433,대인/Noun,22,18,4,0.0002222963209958875,6.663853039827628e-05,0.8181818181818182
4155,6434,쿵푸팬더/Noun,22,4,18,6.668889629876625e-05,0.00022212843466092096,0.8181818181818182
4156,6435,민주화/Noun,22,4,18,6.668889629876625e-05,0.00022212843466092096,0.8181818181818182
4157,6436,미숙/Noun,22,4,18,6.668889629876625e-05,0.00022212843466092096,0.8181818181818182
4158,6437,소유진/Noun,22,4,18,6.668889629876625e-05,0.00022212843466092096,0.8181818181818182
4159,6438,일관/Noun,22,4,18,6.668889629876625e-05,0.00022212843466092096,0.8181818181818182
4160,6439,월화/Noun,22,17,5,0.00021118150494609317,7.774495213132233e-05,0.7727272727272727
4161,6440,위성/Noun,22,5,17,7.780371234856063e-05,0.0002110220129278749,0.7727272727272727
4162,6441,외로/Noun,22,17,5,0.00021118150494609317,7.774495213132233e-05,0.7727272727272727
4163,6442,초콜릿/Noun,22,17,5,0.00021118150494609317,7.774495213132233e-05,0.7727272727272727
4164,6443,김민희/Noun,22,17,5,0.00021118150494609317,7.774495213132233e-05,0.7727272727272727
4165,6444,나잇/Noun,22,5,17,7.780371234856063e-05,0.0002110220129278749,0.7727272727272727
4166,6445,낯설다/Adjective,22,17,5,0.00021118150494609317,7.774495213132233e-05,0.7727272727272727
4167,6446,라기보단/Josa,22,5,17,7.780371234856063e-05,0.0002110220129278749,0.7727272727272727
4168,6447,치우치다/Verb,22,5,17,7.780371234856063e-05,0.0002110220129278749,0.7727272727272727
4169,6448,냉소/Noun,22,17,5,0.00021118150494609317,7.774495213132233e-05,0.7727272727272727
4170,6449,하하/Exclamation,22,5,17,7.780371234856063e-05,0.0002110220129278749,0.7727272727272727
4171,6450,40년/Number,22,17,5,0.00021118150494609317,7.774495213132233e-05,0.7727272727272727
4172,6451,변질/Noun,22,5,17,7.780371234856063e-05,0.0002110220129278749,0.7727272727272727
4173,6452,마녀사냥/Noun,22,17,5,0.00021118150494609317,7.774495213132233e-05,0.7727272727272727
4174,6453,쨩/Suffix,22,17,5,0.00021118150494609317,7.774495213132233e-05,0.7727272727272727
4175,6454,연구/Noun,22,5,17,7.780371234856063e-05,0.0002110220129278749,0.7727272727272727
4176,6455,종교영화/Noun,22,6,16,8.891852839835501e-05,0.00019991559119482882,0.7272727272727273
4177,6456,조선시대/Noun,22,6,16,8.891852839835501e-05,0.00019991559119482882,0.7272727272727273
4178,6457,비틀즈/Noun,22,16,6,0.0002000666888962988,8.885137386436837e-05,0.7272727272727273
4179,6458,배달/Noun,22,6,16,8.891852839835501e-05,0.00019991559119482882,0.7272727272727273
4180,6459,입맛/Noun,22,6,16,8.891852839835501e-05,0.00019991559119482882,0.7272727272727273
4181,6460,사태/Noun,22,6,16,8.891852839835501e-05,0.00019991559119482882,0.7272727272727273
4182,6461,울버린/Noun,22,6,16,8.891852839835501e-05,0.00019991559119482882,0.7272727272727273
4183,6462,바이올린/Noun,22,16,6,0.0002000666888962988,8.885137386436837e-05,0.7272727272727273
4184,6463,ㅇㅅㅇ/KoreanParticle,22,16,6,0.0002000666888962988,8.885137386436837e-05,0.7272727272727273
4185,6464,마시다/Verb,22,6,16,8.891852839835501e-05,0.00019991559119482882,0.7272727272727273
4186,6465,간지나다/Verb,22,16,6,0.0002000666888962988,8.885137386436837e-05,0.7272727272727273
4187,6466,이지나/Noun,22,16,6,0.0002000666888962988,8.885137386436837e-05,0.7272727272727273
4188,6467,올바르다/Adjective,22,16,6,0.0002000666888962988,8.885137386436837e-05,0.7272727272727273
4189,6468,95년/Number,22,15,7,0.00018895187284650438,9.995779559741441e-05,0.6818181818181818
4190,6469,털/Noun,22,7,15,0.0001000333444481494,0.0001888091694617828,0.6818181818181818
4191,6470,서바이벌/Noun,22,7,15,0.0001000333444481494,0.0001888091694617828,0.6818181818181818
4192,6471,김윤진/Noun,22,7,15,0.0001000333444481494,0.0001888091694617828,0.6818181818181818
4193,6472,E/Alpha,22,7,15,0.0001000333444481494,0.0001888091694617828,0.6818181818181818
4194,6473,청춘영화/Noun,22,15,7,0.00018895187284650438,9.995779559741441e-05,0.6818181818181818
4195,6474,무덤/Noun,22,7,15,0.0001000333444481494,0.0001888091694617828,0.6818181818181818
4196,6475,심해/Noun,22,7,15,0.0001000333444481494,0.0001888091694617828,0.6818181818181818
4197,6476,덜다/Verb,22,7,15,0.0001000333444481494,0.0001888091694617828,0.6818181818181818
4198,6477,무고/Noun,22,7,15,0.0001000333444481494,0.0001888091694617828,0.6818181818181818
4199,6478,지라/Noun,22,15,7,0.00018895187284650438,9.995779559741441e-05,0.6818181818181818
4200,6479,보영/Noun,22,15,7,0.00018895187284650438,9.995779559741441e-05,0.6818181818181818
4201,6480,그따위/Noun,22,7,15,0.0001000333444481494,0.0001888091694617828,0.6818181818181818
4202,6481,헌터/Noun,22,7,15,0.0001000333444481494,0.0001888091694617828,0.6818181818181818
4203,6482,지상파/Noun,22,15,7,0.00018895187284650438,9.995779559741441e-05,0.6818181818181818
4204,6483,동화책/Noun,22,15,7,0.00018895187284650438,9.995779559741441e-05,0.6818181818181818
4205,6484,엑소/Noun,22,15,7,0.00018895187284650438,9.995779559741441e-05,0.6818181818181818
4206,6485,시어머니/Noun,22,7,15,0.0001000333444481494,0.0001888091694617828,0.6818181818181818
4207,6486,개월/Noun,22,15,7,0.00018895187284650438,9.995779559741441e-05,0.6818181818181818
4208,6487,조니/Noun,22,7,15,0.0001000333444481494,0.0001888091694617828,0.6818181818181818
4209,6488,싸지르다/Verb,22,7,15,0.0001000333444481494,0.0001888091694617828,0.6818181818181818
4210,6489,뱀/Noun,22,7,15,0.0001000333444481494,0.0001888091694617828,0.6818181818181818
4211,6490,저격/Noun,22,15,7,0.00018895187284650438,9.995779559741441e-05,0.6818181818181818
4212,6491,~~!!!/Punctuation,22,15,7,0.00018895187284650438,9.995779559741441e-05,0.6818181818181818
4213,6492,번방/Noun,22,15,7,0.00018895187284650438,9.995779559741441e-05,0.6818181818181818
4214,6493,박한별/Noun,22,8,14,0.00011114816049794375,0.00017770274772873674,0.6363636363636364
4215,6494,이진/Noun,22,8,14,0.00011114816049794375,0.00017770274772873674,0.6363636363636364
4216,6495,제시카알바/Noun,22,8,14,0.00011114816049794375,0.00017770274772873674,0.6363636363636364
4217,6496,환희/Noun,22,14,8,0.00017783705679671002,0.00011106421733046048,0.6363636363636364
4218,6497,인간성/Noun,22,14,8,0.00017783705679671002,0.00011106421733046048,0.6363636363636364
4219,6498,십대/Noun,22,8,14,0.00011114816049794375,0.00017770274772873674,0.6363636363636364
4220,6499,이슬람/Noun,22,14,8,0.00017783705679671002,0.00011106421733046048,0.6363636363636364
4221,6500,병자/Noun,22,8,14,0.00011114816049794375,0.00017770274772873674,0.6363636363636364
4222,6501,개쩌/Noun,22,14,8,0.00017783705679671002,0.00011106421733046048,0.6363636363636364
4223,6502,결/Noun,22,8,14,0.00011114816049794375,0.00017770274772873674,0.6363636363636364
4224,6503,마는/Noun,22,8,14,0.00011114816049794375,0.00017770274772873674,0.6363636363636364
4225,6504,산타/Noun,22,14,8,0.00017783705679671002,0.00011106421733046048,0.6363636363636364
4226,6505,달인/Noun,22,8,14,0.00011114816049794375,0.00017770274772873674,0.6363636363636364
4227,6506,금은/Noun,22,14,8,0.00017783705679671002,0.00011106421733046048,0.6363636363636364
4228,6507,조르다/Verb,22,8,14,0.00011114816049794375,0.00017770274772873674,0.6363636363636364
4229,6508,this/Alpha,22,14,8,0.00017783705679671002,0.00011106421733046048,0.6363636363636364
4230,6509,이상우/Noun,22,14,8,0.00017783705679671002,0.00011106421733046048,0.6363636363636364
4231,6510,숀/Noun,22,14,8,0.00017783705679671002,0.00011106421733046048,0.6363636363636364
4232,6511,무명/Noun,22,8,14,0.00011114816049794375,0.00017770274772873674,0.6363636363636364
4233,6512,불안/Noun,22,14,8,0.00017783705679671002,0.00011106421733046048,0.6363636363636364
4234,6513,유명배우/Noun,22,8,14,0.00011114816049794375,0.00017770274772873674,0.6363636363636364
4235,6514,모리/Noun,22,14,8,0.00017783705679671002,0.00011106421733046048,0.6363636363636364
4236,6515,배제/Noun,22,8,14,0.00011114816049794375,0.00017770274772873674,0.6363636363636364
4237,6516,어게인/Noun,22,14,8,0.00017783705679671002,0.00011106421733046048,0.6363636363636364
4238,6517,대답/Noun,22,14,8,0.00017783705679671002,0.00011106421733046048,0.6363636363636364
4239,6518,몸짓/Noun,22,14,8,0.00017783705679671002,0.00011106421733046048,0.6363636363636364
4240,6519,카페/Noun,22,14,8,0.00017783705679671002,0.00011106421733046048,0.6363636363636364
4241,6520,스미스/Noun,22,8,14,0.00011114816049794375,0.00017770274772873674,0.6363636363636364
4242,6521,물리/Noun,22,8,14,0.00011114816049794375,0.00017770274772873674,0.6363636363636364
4243,6580,박현지/Noun,21,0,21,2.2229632099588756e-05,0.0002554476998600591,1.0
4244,6581,유머러스하다/Adjective,21,21,0,0.00025564076914527065,2.2212843466092093e-05,1.0
4245,6582,똥망/Noun,21,0,21,2.2229632099588756e-05,0.0002554476998600591,1.0
4246,6583,이수근/Noun,21,0,21,2.2229632099588756e-05,0.0002554476998600591,1.0
4247,6584,재즈/Noun,21,20,1,0.00024452595309547634,3.331926519913814e-05,0.9523809523809524
4248,6585,인내력/Noun,21,1,20,3.334444814938313e-05,0.00024434127812701304,0.9523809523809524
4249,6586,입력/Noun,21,1,20,3.334444814938313e-05,0.00024434127812701304,0.9523809523809524
4250,6587,조장/Noun,21,1,20,3.334444814938313e-05,0.00024434127812701304,0.9523809523809524
4251,6588,봣어/Noun,21,20,1,0.00024452595309547634,3.331926519913814e-05,0.9523809523809524
4252,6589,김현주/Noun,21,20,1,0.00024452595309547634,3.331926519913814e-05,0.9523809523809524
4253,6590,후레쉬맨/Noun,21,1,20,3.334444814938313e-05,0.00024434127812701304,0.9523809523809524
4254,6591,접영/Noun,21,1,20,3.334444814938313e-05,0.00024434127812701304,0.9523809523809524
4255,6592,멎다/Verb,21,20,1,0.00024452595309547634,3.331926519913814e-05,0.9523809523809524
4256,6593,개망작/Noun,21,1,20,3.334444814938313e-05,0.00024434127812701304,0.9523809523809524
4257,6594,긴지/Noun,21,1,20,3.334444814938313e-05,0.00024434127812701304,0.9523809523809524
4258,6595,퇴보/Noun,21,2,19,4.445926419917751e-05,0.000233234856393967,0.9047619047619048
4259,6596,우스꽝스럽다/Adjective,21,2,19,4.445926419917751e-05,0.000233234856393967,0.9047619047619048
4260,6597,귓가/Noun,21,19,2,0.0002334111370456819,4.4425686932184186e-05,0.9047619047619048
4261,6598,협박/Noun,21,2,19,4.445926419917751e-05,0.000233234856393967,0.9047619047619048
4262,6599,과분/Noun,21,2,19,4.445926419917751e-05,0.000233234856393967,0.9047619047619048
4263,6600,훌쩍/Noun,21,19,2,0.0002334111370456819,4.4425686932184186e-05,0.9047619047619048
4264,6601,탱고/Noun,21,19,2,0.0002334111370456819,4.4425686932184186e-05,0.9047619047619048
4265,6602,핑계/Noun,21,2,19,4.445926419917751e-05,0.000233234856393967,0.9047619047619048
4266,6603,개떡같다/Adjective,21,2,19,4.445926419917751e-05,0.000233234856393967,0.9047619047619048
4267,6604,이래도/Josa,21,2,19,4.445926419917751e-05,0.000233234856393967,0.9047619047619048
4268,6605,..-_-/Punctuation,21,3,18,5.5574080248971876e-05,0.00022212843466092096,0.8571428571428571
4269,6606,99년/Number,21,18,3,0.0002222963209958875,5.553210866523024e-05,0.8571428571428571
4270,6607,참패/Noun,21,3,18,5.5574080248971876e-05,0.00022212843466092096,0.8571428571428571
4271,6608,성지순례/Noun,21,3,18,5.5574080248971876e-05,0.00022212843466092096,0.8571428571428571
4272,6609,문채원/Noun,21,18,3,0.0002222963209958875,5.553210866523024e-05,0.8571428571428571
4273,6610,저따위/Noun,21,3,18,5.5574080248971876e-05,0.00022212843466092096,0.8571428571428571
4274,6611,매료/Noun,21,18,3,0.0002222963209958875,5.553210866523024e-05,0.8571428571428571
4275,6612,조국/Noun,21,18,3,0.0002222963209958875,5.553210866523024e-05,0.8571428571428571
4276,6613,장동민/Noun,21,18,3,0.0002222963209958875,5.553210866523024e-05,0.8571428571428571
4277,6614,하모니/Noun,21,18,3,0.0002222963209958875,5.553210866523024e-05,0.8571428571428571
4278,6615,장황하다/Adjective,21,3,18,5.5574080248971876e-05,0.00022212843466092096,0.8571428571428571
4279,6616,진실하다/Adjective,21,18,3,0.0002222963209958875,5.553210866523024e-05,0.8571428571428571
4280,6617,하트/Noun,21,18,3,0.0002222963209958875,5.553210866523024e-05,0.8571428571428571
4281,6618,둔갑/Noun,21,3,18,5.5574080248971876e-05,0.00022212843466092096,0.8571428571428571
4282,6619,꾀/Noun,21,18,3,0.0002222963209958875,5.553210866523024e-05,0.8571428571428571
4283,6620,끼들/Adverb,21,3,18,5.5574080248971876e-05,0.00022212843466092096,0.8571428571428571
4284,6621,으로부터/Josa,21,18,3,0.0002222963209958875,5.553210866523024e-05,0.8571428571428571
4285,6622,강원도/Noun,21,3,18,5.5574080248971876e-05,0.00022212843466092096,0.8571428571428571
4286,6623,한층/Noun,21,18,3,0.0002222963209958875,5.553210866523024e-05,0.8571428571428571
4287,6624,마스터피스/Noun,21,18,3,0.0002222963209958875,5.553210866523024e-05,0.8571428571428571
4288,6625,굵다/Adjective,21,17,4,0.00021118150494609317,6.663853039827628e-05,0.8095238095238095
4289,6626,하다못해/Adverb,21,4,17,6.668889629876625e-05,0.0002110220129278749,0.8095238095238095
4290,6627,방지/Noun,21,4,17,6.668889629876625e-05,0.0002110220129278749,0.8095238095238095
4291,6628,가다가/Noun,21,4,17,6.668889629876625e-05,0.0002110220129278749,0.8095238095238095
4292,6629,범작/Noun,21,4,17,6.668889629876625e-05,0.0002110220129278749,0.8095238095238095
4293,6630,시원시원하다/Adjective,21,17,4,0.00021118150494609317,6.663853039827628e-05,0.8095238095238095
4294,6631,어쩌구/Noun,21,4,17,6.668889629876625e-05,0.0002110220129278749,0.8095238095238095
4295,6632,오오오/Noun,21,17,4,0.00021118150494609317,6.663853039827628e-05,0.8095238095238095
4296,6633,눈살/Noun,21,4,17,6.668889629876625e-05,0.0002110220129278749,0.8095238095238095
4297,6634,미셸/Noun,21,17,4,0.00021118150494609317,6.663853039827628e-05,0.8095238095238095
4298,6635,줄라/Noun,21,4,17,6.668889629876625e-05,0.0002110220129278749,0.8095238095238095
4299,6636,편향/Noun,21,4,17,6.668889629876625e-05,0.0002110220129278749,0.8095238095238095
4300,6637,긴장도/Noun,21,4,17,6.668889629876625e-05,0.0002110220129278749,0.8095238095238095
4301,6638,동떨어지다/Adjective,21,4,17,6.668889629876625e-05,0.0002110220129278749,0.8095238095238095
4302,6639,뚝/Noun,21,5,16,7.780371234856063e-05,0.00019991559119482882,0.7619047619047619
4303,6640,트루/Noun,21,5,16,7.780371234856063e-05,0.00019991559119482882,0.7619047619047619
4304,6641,재림/Noun,21,5,16,7.780371234856063e-05,0.00019991559119482882,0.7619047619047619
4305,6642,레즈/Noun,21,5,16,7.780371234856063e-05,0.00019991559119482882,0.7619047619047619
4306,6643,오죽하다/Adjective,21,5,16,7.780371234856063e-05,0.00019991559119482882,0.7619047619047619
4307,6644,파도/Noun,21,16,5,0.0002000666888962988,7.774495213132233e-05,0.7619047619047619
4308,6645,젖/Noun,21,5,16,7.780371234856063e-05,0.00019991559119482882,0.7619047619047619
4309,6646,결여/Noun,21,5,16,7.780371234856063e-05,0.00019991559119482882,0.7619047619047619
4310,6647,절때/Noun,21,5,16,7.780371234856063e-05,0.00019991559119482882,0.7619047619047619
4311,6648,“/Foreign,21,5,16,7.780371234856063e-05,0.00019991559119482882,0.7619047619047619
4312,6649,콩가루/Noun,21,5,16,7.780371234856063e-05,0.00019991559119482882,0.7619047619047619
4313,6650,쌩뚱맞/Noun,21,5,16,7.780371234856063e-05,0.00019991559119482882,0.7619047619047619
4314,6651,댄서/Noun,21,5,16,7.780371234856063e-05,0.00019991559119482882,0.7619047619047619
4315,6652,느님/Noun,21,16,5,0.0002000666888962988,7.774495213132233e-05,0.7619047619047619
4316,6653,짚다/Verb,21,15,6,0.00018895187284650438,8.885137386436837e-05,0.7142857142857143
4317,6654,인용/Noun,21,6,15,8.891852839835501e-05,0.0001888091694617828,0.7142857142857143
4318,6655,음모론/Noun,21,6,15,8.891852839835501e-05,0.0001888091694617828,0.7142857142857143
4319,6656,!!!!!!!!!!!/Punctuation,21,15,6,0.00018895187284650438,8.885137386436837e-05,0.7142857142857143
4320,6657,재연/Noun,21,6,15,8.891852839835501e-05,0.0001888091694617828,0.7142857142857143
4321,6658,작고/Noun,21,6,15,8.891852839835501e-05,0.0001888091694617828,0.7142857142857143
4322,6659,대서/Noun,21,6,15,8.891852839835501e-05,0.0001888091694617828,0.7142857142857143
4323,6660,걸음/Noun,21,15,6,0.00018895187284650438,8.885137386436837e-05,0.7142857142857143
4324,6661,지향/Noun,21,6,15,8.891852839835501e-05,0.0001888091694617828,0.7142857142857143
4325,6662,보람/Noun,21,15,6,0.00018895187284650438,8.885137386436837e-05,0.7142857142857143
4326,6663,강우석/Noun,21,6,15,8.891852839835501e-05,0.0001888091694617828,0.7142857142857143
4327,6664,일진/Noun,21,6,15,8.891852839835501e-05,0.0001888091694617828,0.7142857142857143
4328,6665,금도/Noun,21,15,6,0.00018895187284650438,8.885137386436837e-05,0.7142857142857143
4329,6666,다짐/Noun,21,15,6,0.00018895187284650438,8.885137386436837e-05,0.7142857142857143
4330,6667,화재/Noun,21,6,15,8.891852839835501e-05,0.0001888091694617828,0.7142857142857143
4331,6668,ㅇㅋ/KoreanParticle,21,6,15,8.891852839835501e-05,0.0001888091694617828,0.7142857142857143
4332,6669,명분/Noun,21,6,15,8.891852839835501e-05,0.0001888091694617828,0.7142857142857143
4333,6670,영애/Noun,21,15,6,0.00018895187284650438,8.885137386436837e-05,0.7142857142857143
4334,6671,무었/Noun,21,15,6,0.00018895187284650438,8.885137386436837e-05,0.7142857142857143
4335,6672,에이미/Noun,21,14,7,0.00017783705679671002,9.995779559741441e-05,0.6666666666666666
4336,6673,악녀/Noun,21,7,14,0.0001000333444481494,0.00017770274772873674,0.6666666666666666
4337,6674,싱어/Noun,21,14,7,0.00017783705679671002,9.995779559741441e-05,0.6666666666666666
4338,6675,수능/Noun,21,14,7,0.00017783705679671002,9.995779559741441e-05,0.6666666666666666
4339,6676,시가/Noun,21,14,7,0.00017783705679671002,9.995779559741441e-05,0.6666666666666666
4340,6677,괴담/Noun,21,7,14,0.0001000333444481494,0.00017770274772873674,0.6666666666666666
4341,6678,일제/Noun,21,7,14,0.0001000333444481494,0.00017770274772873674,0.6666666666666666
4342,6679,****/Punctuation,21,14,7,0.00017783705679671002,9.995779559741441e-05,0.6666666666666666
4343,6680,푸하하하/Noun,21,7,14,0.0001000333444481494,0.00017770274772873674,0.6666666666666666
4344,6681,재수/Noun,21,7,14,0.0001000333444481494,0.00017770274772873674,0.6666666666666666
4345,6682,김민준/Noun,21,7,14,0.0001000333444481494,0.00017770274772873674,0.6666666666666666
4346,6683,둘이서/Noun,21,7,14,0.0001000333444481494,0.00017770274772873674,0.6666666666666666
4347,6684,핸드/Noun,21,7,14,0.0001000333444481494,0.00017770274772873674,0.6666666666666666
4348,6685,제격/Noun,21,14,7,0.00017783705679671002,9.995779559741441e-05,0.6666666666666666
4349,6686,정녕/Noun,21,7,14,0.0001000333444481494,0.00017770274772873674,0.6666666666666666
4350,6687,을해/Noun,21,7,14,0.0001000333444481494,0.00017770274772873674,0.6666666666666666
4351,6688,근대/Noun,21,14,7,0.00017783705679671002,9.995779559741441e-05,0.6666666666666666
4352,6689,쑤다/Verb,21,7,14,0.0001000333444481494,0.00017770274772873674,0.6666666666666666
4353,6690,동경/Noun,21,14,7,0.00017783705679671002,9.995779559741441e-05,0.6666666666666666
4354,6691,사업/Noun,21,7,14,0.0001000333444481494,0.00017770274772873674,0.6666666666666666
4355,6692,베토벤/Noun,21,14,7,0.00017783705679671002,9.995779559741441e-05,0.6666666666666666
4356,6693,런/Noun,21,14,7,0.00017783705679671002,9.995779559741441e-05,0.6666666666666666
4357,6694,넘버/Noun,21,14,7,0.00017783705679671002,9.995779559741441e-05,0.6666666666666666
4358,6695,댓글달다/Verb,21,7,14,0.0001000333444481494,0.00017770274772873674,0.6666666666666666
4359,6696,차기작/Noun,21,14,7,0.00017783705679671002,9.995779559741441e-05,0.6666666666666666
4360,6697,훅/Noun,21,7,14,0.0001000333444481494,0.00017770274772873674,0.6666666666666666
4361,6698,주요/Modifier,21,7,14,0.0001000333444481494,0.00017770274772873674,0.6666666666666666
4362,6699,나래/Noun,21,7,14,0.0001000333444481494,0.00017770274772873674,0.6666666666666666
4363,6700,한결같다/Adjective,21,7,14,0.0001000333444481494,0.00017770274772873674,0.6666666666666666
4364,6701,연평해전/Noun,21,7,14,0.0001000333444481494,0.00017770274772873674,0.6666666666666666
4365,6702,잊어버리다/Verb,21,14,7,0.00017783705679671002,9.995779559741441e-05,0.6666666666666666
4366,6703,어이없이/Adverb,21,7,14,0.0001000333444481494,0.00017770274772873674,0.6666666666666666
4367,6704,쿠엔틴/Noun,21,13,8,0.00016672224074691566,0.00011106421733046048,0.6190476190476191
4368,6705,염정아/Noun,21,13,8,0.00016672224074691566,0.00011106421733046048,0.6190476190476191
4369,6706,오드리/Noun,21,13,8,0.00016672224074691566,0.00011106421733046048,0.6190476190476191
4370,6707,빨르다/Adjective,21,8,13,0.00011114816049794375,0.0001665963259956907,0.6190476190476191
4371,6708,테마/Noun,21,8,13,0.00011114816049794375,0.0001665963259956907,0.6190476190476191
4372,6709,문소리/Noun,21,13,8,0.00016672224074691566,0.00011106421733046048,0.6190476190476191
4373,6710,소녀시대/Noun,21,8,13,0.00011114816049794375,0.0001665963259956907,0.6190476190476191
4374,6711,상도/Noun,21,13,8,0.00016672224074691566,0.00011106421733046048,0.6190476190476191
4375,6712,똥꼬/Noun,21,8,13,0.00011114816049794375,0.0001665963259956907,0.6190476190476191
4376,6713,백프로/Noun,21,8,13,0.00011114816049794375,0.0001665963259956907,0.6190476190476191
4377,6714,................./Punctuation,21,8,13,0.00011114816049794375,0.0001665963259956907,0.6190476190476191
4378,6715,not/Alpha,21,13,8,0.00016672224074691566,0.00011106421733046048,0.6190476190476191
4379,6716,리프/Noun,21,8,13,0.00011114816049794375,0.0001665963259956907,0.6190476190476191
4380,6717,식구/Noun,21,8,13,0.00011114816049794375,0.0001665963259956907,0.6190476190476191
4381,6718,대들다/Verb,21,8,13,0.00011114816049794375,0.0001665963259956907,0.6190476190476191
4382,6719,이제훈/Noun,21,13,8,0.00016672224074691566,0.00011106421733046048,0.6190476190476191
4383,6720,냥/Noun,21,8,13,0.00011114816049794375,0.0001665963259956907,0.6190476190476191
4384,6721,벨루치/Noun,21,8,13,0.00011114816049794375,0.0001665963259956907,0.6190476190476191
4385,6722,호주/Noun,21,8,13,0.00011114816049794375,0.0001665963259956907,0.6190476190476191
4386,6723,여군/Noun,21,8,13,0.00011114816049794375,0.0001665963259956907,0.6190476190476191
4387,6724,눈앞/Noun,21,13,8,0.00016672224074691566,0.00011106421733046048,0.6190476190476191
4388,6725,교도소/Noun,21,8,13,0.00011114816049794375,0.0001665963259956907,0.6190476190476191
4389,6787,낭패/Noun,20,0,20,2.2229632099588756e-05,0.00024434127812701304,1.0
4390,6788,낚시질/Noun,20,0,20,2.2229632099588756e-05,0.00024434127812701304,1.0
4391,6789,GOOD/Alpha,20,19,1,0.0002334111370456819,3.331926519913814e-05,0.95
4392,6790,맛없다/Adjective,20,1,19,3.334444814938313e-05,0.000233234856393967,0.95
4393,6791,자연스레/Adverb,20,19,1,0.0002334111370456819,3.331926519913814e-05,0.95
4394,6792,^^~/Punctuation,20,19,1,0.0002334111370456819,3.331926519913814e-05,0.95
4395,6793,우기다/Verb,20,1,19,3.334444814938313e-05,0.000233234856393967,0.95
4396,6794,어따/Exclamation,20,1,19,3.334444814938313e-05,0.000233234856393967,0.95
4397,6795,잔치/Noun,20,1,19,3.334444814938313e-05,0.000233234856393967,0.95
4398,6796,무미건조하다/Adjective,20,1,19,3.334444814938313e-05,0.000233234856393967,0.95
4399,6797,꽉차다/Verb,20,18,2,0.0002222963209958875,4.4425686932184186e-05,0.9
4400,6798,기한/Noun,20,2,18,4.445926419917751e-05,0.00022212843466092096,0.9
4401,6799,뷁/Noun,20,2,18,4.445926419917751e-05,0.00022212843466092096,0.9
4402,6800,보다/Foreign,20,2,18,4.445926419917751e-05,0.00022212843466092096,0.9
4403,6801,노소/Noun,20,18,2,0.0002222963209958875,4.4425686932184186e-05,0.9
4404,6802,한구석/Noun,20,18,2,0.0002222963209958875,4.4425686932184186e-05,0.9
4405,6803,유년/Noun,20,18,2,0.0002222963209958875,4.4425686932184186e-05,0.9
4406,6804,mc/Alpha,20,2,18,4.445926419917751e-05,0.00022212843466092096,0.9
4407,6805,양키/Noun,20,2,18,4.445926419917751e-05,0.00022212843466092096,0.9
4408,6806,미워하다/Adjective,20,17,3,0.00021118150494609317,5.553210866523024e-05,0.85
4409,6807,고추/Noun,20,3,17,5.5574080248971876e-05,0.0002110220129278749,0.85
4410,6808,박진영/Noun,20,3,17,5.5574080248971876e-05,0.0002110220129278749,0.85
4411,6809,>_</Punctuation,20,17,3,0.00021118150494609317,5.553210866523024e-05,0.85
4412,6810,자국/Noun,20,3,17,5.5574080248971876e-05,0.0002110220129278749,0.85
4413,6811,쫄깃/Noun,20,17,3,0.00021118150494609317,5.553210866523024e-05,0.85
4414,6812,테일러/Noun,20,17,3,0.00021118150494609317,5.553210866523024e-05,0.85
4415,6813,명백하다/Adjective,20,3,17,5.5574080248971876e-05,0.0002110220129278749,0.85
4416,6814,드릅/Noun,20,3,17,5.5574080248971876e-05,0.0002110220129278749,0.85
4417,6815,탈락/Noun,20,3,17,5.5574080248971876e-05,0.0002110220129278749,0.85
4418,6816,나위/Noun,20,17,3,0.00021118150494609317,5.553210866523024e-05,0.85
4419,6817,삼천포/Noun,20,3,17,5.5574080248971876e-05,0.0002110220129278749,0.85
4420,6818,섹/Noun,20,3,17,5.5574080248971876e-05,0.0002110220129278749,0.85
4421,6819,...;/Punctuation,20,3,17,5.5574080248971876e-05,0.0002110220129278749,0.85
4422,6820,떨구다/Verb,20,3,17,5.5574080248971876e-05,0.0002110220129278749,0.85
4423,6821,마더/Noun,20,17,3,0.00021118150494609317,5.553210866523024e-05,0.85
4424,6822,It/Alpha,20,17,3,0.00021118150494609317,5.553210866523024e-05,0.85
4425,6823,생동감/Noun,20,16,4,0.0002000666888962988,6.663853039827628e-05,0.8
4426,6824,CF/Alpha,20,4,16,6.668889629876625e-05,0.00019991559119482882,0.8
4427,6825,더러/Noun,20,4,16,6.668889629876625e-05,0.00019991559119482882,0.8
4428,6826,친일파/Noun,20,4,16,6.668889629876625e-05,0.00019991559119482882,0.8
4429,6827,쫓기다/Verb,20,4,16,6.668889629876625e-05,0.00019991559119482882,0.8
4430,6828,부진하다/Adjective,20,4,16,6.668889629876625e-05,0.00019991559119482882,0.8
4431,6829,교묘하다/Adjective,20,4,16,6.668889629876625e-05,0.00019991559119482882,0.8
4432,6830,우물/Noun,20,4,16,6.668889629876625e-05,0.00019991559119482882,0.8
4433,6831,읍니/Noun,20,16,4,0.0002000666888962988,6.663853039827628e-05,0.8
4434,6832,허비하다/Adjective,20,4,16,6.668889629876625e-05,0.00019991559119482882,0.8
4435,6833,수식어/Noun,20,16,4,0.0002000666888962988,6.663853039827628e-05,0.8
4436,6834,기름/Noun,20,4,16,6.668889629876625e-05,0.00019991559119482882,0.8
4437,6835,박용우/Noun,20,16,4,0.0002000666888962988,6.663853039827628e-05,0.8
4438,6836,나하/Noun,20,4,16,6.668889629876625e-05,0.00019991559119482882,0.8
4439,6837,람사/Noun,20,16,4,0.0002000666888962988,6.663853039827628e-05,0.8
4440,6838,앞두다/Verb,20,16,4,0.0002000666888962988,6.663853039827628e-05,0.8
4441,6839,서글프다/Adjective,20,16,4,0.0002000666888962988,6.663853039827628e-05,0.8
4442,6840,학적/Noun,20,4,16,6.668889629876625e-05,0.00019991559119482882,0.8
4443,6841,월요일/Noun,20,16,4,0.0002000666888962988,6.663853039827628e-05,0.8
4444,6842,프랭크/Noun,20,16,4,0.0002000666888962988,6.663853039827628e-05,0.8
4445,6843,총기/Noun,20,15,5,0.00018895187284650438,7.774495213132233e-05,0.75
4446,6844,시계/Noun,20,5,15,7.780371234856063e-05,0.0001888091694617828,0.75
4447,6845,소리내다/Verb,20,15,5,0.00018895187284650438,7.774495213132233e-05,0.75
4448,6846,머리카락/Noun,20,5,15,7.780371234856063e-05,0.0001888091694617828,0.75
4449,6847,가르침/Noun,20,15,5,0.00018895187284650438,7.774495213132233e-05,0.75
4450,6848,짜장면/Noun,20,5,15,7.780371234856063e-05,0.0001888091694617828,0.75
4451,6849,여사/Noun,20,15,5,0.00018895187284650438,7.774495213132233e-05,0.75
4452,6850,합작/Noun,20,5,15,7.780371234856063e-05,0.0001888091694617828,0.75
4453,6851,무심코/Noun,20,15,5,0.00018895187284650438,7.774495213132233e-05,0.75
4454,6852,전무후무/Noun,20,15,5,0.00018895187284650438,7.774495213132233e-05,0.75
4455,6853,시달리다/Verb,20,5,15,7.780371234856063e-05,0.0001888091694617828,0.75
4456,6854,관해/Noun,20,15,5,0.00018895187284650438,7.774495213132233e-05,0.75
4457,6855,ever/Alpha,20,15,5,0.00018895187284650438,7.774495213132233e-05,0.75
4458,6856,얄밉다/Adjective,20,15,5,0.00018895187284650438,7.774495213132233e-05,0.75
4459,6857,오만하다/Adjective,20,5,15,7.780371234856063e-05,0.0001888091694617828,0.75
4460,6858,노릇/Noun,20,5,15,7.780371234856063e-05,0.0001888091694617828,0.75
4461,6859,경상도/Noun,20,5,15,7.780371234856063e-05,0.0001888091694617828,0.75
4462,6860,학대/Noun,20,5,15,7.780371234856063e-05,0.0001888091694617828,0.75
4463,6861,.~/Punctuation,20,15,5,0.00018895187284650438,7.774495213132233e-05,0.75
4464,6862,연예/Noun,20,5,15,7.780371234856063e-05,0.0001888091694617828,0.75
4465,6863,세금/Noun,20,5,15,7.780371234856063e-05,0.0001888091694617828,0.75
4466,6864,순정만화/Noun,20,5,15,7.780371234856063e-05,0.0001888091694617828,0.75
4467,6865,이로/Noun,20,14,6,0.00017783705679671002,8.885137386436837e-05,0.7
4468,6866,몰려오다/Verb,20,6,14,8.891852839835501e-05,0.00017770274772873674,0.7
4469,6867,벨라/Noun,20,6,14,8.891852839835501e-05,0.00017770274772873674,0.7
4470,6868,번하다/Adjective,20,6,14,8.891852839835501e-05,0.00017770274772873674,0.7
4471,6869,폰부스/Noun,20,6,14,8.891852839835501e-05,0.00017770274772873674,0.7
4472,6870,유희/Noun,20,14,6,0.00017783705679671002,8.885137386436837e-05,0.7
4473,6871,잡스/Noun,20,6,14,8.891852839835501e-05,0.00017770274772873674,0.7
4474,6872,쿵푸/Noun,20,6,14,8.891852839835501e-05,0.00017770274772873674,0.7
4475,6873,사토시/Noun,20,14,6,0.00017783705679671002,8.885137386436837e-05,0.7
4476,6874,무성영화/Noun,20,14,6,0.00017783705679671002,8.885137386436837e-05,0.7
4477,6875,인데/Foreign,20,6,14,8.891852839835501e-05,0.00017770274772873674,0.7
4478,6876,안에/Foreign,20,6,14,8.891852839835501e-05,0.00017770274772873674,0.7
4479,6877,리플/Noun,20,6,14,8.891852839835501e-05,0.00017770274772873674,0.7
4480,6878,신비하다/Adjective,20,14,6,0.00017783705679671002,8.885137386436837e-05,0.7
4481,6879,켈리/Noun,20,14,6,0.00017783705679671002,8.885137386436837e-05,0.7
4482,6880,페미니즘/Noun,20,6,14,8.891852839835501e-05,0.00017770274772873674,0.7
4483,6881,몰아치다/Verb,20,14,6,0.00017783705679671002,8.885137386436837e-05,0.7
4484,6882,티라노/Noun,20,6,14,8.891852839835501e-05,0.00017770274772873674,0.7
4485,6883,다섯손가락/Noun,20,14,6,0.00017783705679671002,8.885137386436837e-05,0.7
4486,6884,SM/Alpha,20,6,14,8.891852839835501e-05,0.00017770274772873674,0.7
4487,6885,서툴다/Adjective,20,14,6,0.00017783705679671002,8.885137386436837e-05,0.7
4488,6886,불멸/Noun,20,14,6,0.00017783705679671002,8.885137386436837e-05,0.7
4489,6887,은애/Noun,20,6,14,8.891852839835501e-05,0.00017770274772873674,0.7
4490,6888,허각/Noun,20,14,6,0.00017783705679671002,8.885137386436837e-05,0.7
4491,6889,원망/Noun,20,6,14,8.891852839835501e-05,0.00017770274772873674,0.7
4492,6890,송새벽/Noun,20,6,14,8.891852839835501e-05,0.00017770274772873674,0.7
4493,6891,울부짖다/Verb,20,14,6,0.00017783705679671002,8.885137386436837e-05,0.7
4494,6892,꽁/Adverb,20,6,14,8.891852839835501e-05,0.00017770274772873674,0.7
4495,6893,한치/Noun,20,6,14,8.891852839835501e-05,0.00017770274772873674,0.7
4496,6894,즈음/Noun,20,14,6,0.00017783705679671002,8.885137386436837e-05,0.7
4497,6895,pd/Alpha,20,6,14,8.891852839835501e-05,0.00017770274772873674,0.7
4498,6896,마돈나/Noun,20,6,14,8.891852839835501e-05,0.00017770274772873674,0.7
4499,6897,스티/Noun,20,7,13,0.0001000333444481494,0.0001665963259956907,0.65
4500,6898,김주혁/Noun,20,13,7,0.00016672224074691566,9.995779559741441e-05,0.65
4501,6899,고함/Noun,20,7,13,0.0001000333444481494,0.0001665963259956907,0.65
4502,6900,밸런스/Noun,20,7,13,0.0001000333444481494,0.0001665963259956907,0.65
4503,6901,판도/Noun,20,13,7,0.00016672224074691566,9.995779559741441e-05,0.65
4504,6902,연대기/Noun,20,13,7,0.00016672224074691566,9.995779559741441e-05,0.65
4505,6903,신들/Noun,20,7,13,0.0001000333444481494,0.0001665963259956907,0.65
4506,6904,소라/Noun,20,7,13,0.0001000333444481494,0.0001665963259956907,0.65
4507,6905,어스/Noun,20,13,7,0.00016672224074691566,9.995779559741441e-05,0.65
4508,6906,모범/Noun,20,13,7,0.00016672224074691566,9.995779559741441e-05,0.65
4509,6907,부각시키다/Verb,20,7,13,0.0001000333444481494,0.0001665963259956907,0.65
4510,6908,다우니/Noun,20,13,7,0.00016672224074691566,9.995779559741441e-05,0.65
4511,6909,탐험/Noun,20,7,13,0.0001000333444481494,0.0001665963259956907,0.65
4512,6910,대다수/Noun,20,7,13,0.0001000333444481494,0.0001665963259956907,0.65
4513,6911,이크/Noun,20,7,13,0.0001000333444481494,0.0001665963259956907,0.65
4514,6912,대중성/Noun,20,7,13,0.0001000333444481494,0.0001665963259956907,0.65
4515,6913,부천/Noun,20,13,7,0.00016672224074691566,9.995779559741441e-05,0.65
4516,6914,13일/Number,20,7,13,0.0001000333444481494,0.0001665963259956907,0.65
4517,6915,김창완/Noun,20,7,13,0.0001000333444481494,0.0001665963259956907,0.65
4518,6916,미지/Noun,20,13,7,0.00016672224074691566,9.995779559741441e-05,0.65
4519,6917,탐정/Noun,20,7,13,0.0001000333444481494,0.0001665963259956907,0.65
4520,6918,아이템/Noun,20,7,13,0.0001000333444481494,0.0001665963259956907,0.65
4521,6919,존트라볼타/Noun,20,13,7,0.00016672224074691566,9.995779559741441e-05,0.65
4522,6920,류승완/Noun,20,8,12,0.00011114816049794375,0.00015548990426264466,0.6
4523,6921,甲/Foreign,20,12,8,0.00015560742469712126,0.00011106421733046048,0.6
4524,6922,사람인/Noun,20,8,12,0.00011114816049794375,0.00015548990426264466,0.6
4525,6923,헤매다/Verb,20,8,12,0.00011114816049794375,0.00015548990426264466,0.6
4526,6924,주문/Noun,20,8,12,0.00011114816049794375,0.00015548990426264466,0.6
4527,6925,스웨덴/Noun,20,12,8,0.00015560742469712126,0.00011106421733046048,0.6
4528,6926,겄/Noun,20,8,12,0.00011114816049794375,0.00015548990426264466,0.6
4529,6927,존쿠삭/Noun,20,12,8,0.00015560742469712126,0.00011106421733046048,0.6
4530,6928,top/Alpha,20,12,8,0.00015560742469712126,0.00011106421733046048,0.6
4531,6929,고난/Noun,20,12,8,0.00015560742469712126,0.00011106421733046048,0.6
4532,6930,숫자/Noun,20,12,8,0.00015560742469712126,0.00011106421733046048,0.6
4533,6931,원스/Noun,20,12,8,0.00015560742469712126,0.00011106421733046048,0.6
4534,6932,록/Noun,20,12,8,0.00015560742469712126,0.00011106421733046048,0.6
4535,6933,비둘기/Noun,20,8,12,0.00011114816049794375,0.00015548990426264466,0.6
4536,6934,김옥빈/Noun,20,12,8,0.00015560742469712126,0.00011106421733046048,0.6
4537,6935,리처드/Noun,20,12,8,0.00015560742469712126,0.00011106421733046048,0.6
4538,6936,천년/Noun,20,12,8,0.00015560742469712126,0.00011106421733046048,0.6
4539,6937,김청기/Noun,20,8,12,0.00011114816049794375,0.00015548990426264466,0.6
4540,6938,아씨/Noun,20,8,12,0.00011114816049794375,0.00015548990426264466,0.6
4541,6939,고본/Noun,20,8,12,0.00011114816049794375,0.00015548990426264466,0.6
4542,6940,강예원/Noun,20,8,12,0.00011114816049794375,0.00015548990426264466,0.6
4543,6941,개운하다/Adjective,20,8,12,0.00011114816049794375,0.00015548990426264466,0.6
4544,6942,구속/Noun,20,8,12,0.00011114816049794375,0.00015548990426264466,0.6
4545,6943,네요/Eomi,20,12,8,0.00015560742469712126,0.00011106421733046048,0.6
4546,6944,up/Alpha,20,12,8,0.00015560742469712126,0.00011106421733046048,0.6
4547,6945,위협/Noun,20,8,12,0.00011114816049794375,0.00015548990426264466,0.6
4548,6946,담당/Noun,20,8,12,0.00011114816049794375,0.00015548990426264466,0.6
4549,6947,전체관람가/Noun,20,8,12,0.00011114816049794375,0.00015548990426264466,0.6
4550,6948,익숙해지다/Verb,20,12,8,0.00015560742469712126,0.00011106421733046048,0.6
4551,6998,영점/Noun,19,0,19,2.2229632099588756e-05,0.000233234856393967,1.0
4552,6999,해롭다/Adjective,19,0,19,2.2229632099588756e-05,0.000233234856393967,1.0
4553,7000,맘에듬/Noun,19,19,0,0.0002334111370456819,2.2212843466092093e-05,1.0
4554,7001,쒸레기/Noun,19,0,19,2.2229632099588756e-05,0.000233234856393967,1.0
4555,7002,빼어나다/Adjective,19,18,1,0.0002222963209958875,3.331926519913814e-05,0.9473684210526316
4556,7003,발정/Noun,19,1,18,3.334444814938313e-05,0.00022212843466092096,0.9473684210526316
4557,7004,~~~^^/Punctuation,19,18,1,0.0002222963209958875,3.331926519913814e-05,0.9473684210526316
4558,7005,ㅆㄹㄱ/KoreanParticle,19,1,18,3.334444814938313e-05,0.00022212843466092096,0.9473684210526316
4559,7006,빈약/Noun,19,1,18,3.334444814938313e-05,0.00022212843466092096,0.9473684210526316
4560,7007,상쾌/Noun,19,18,1,0.0002222963209958875,3.331926519913814e-05,0.9473684210526316
4561,7008,짜증스럽다/Adjective,19,1,18,3.334444814938313e-05,0.00022212843466092096,0.9473684210526316
4562,7009,냉혹하다/Adjective,19,18,1,0.0002222963209958875,3.331926519913814e-05,0.9473684210526316
4563,7010,짜깁다/Verb,19,1,18,3.334444814938313e-05,0.00022212843466092096,0.9473684210526316
4564,7011,Ost/Alpha,19,18,1,0.0002222963209958875,3.331926519913814e-05,0.9473684210526316
4565,7012,재밌엇음/Noun,19,18,1,0.0002222963209958875,3.331926519913814e-05,0.9473684210526316
4566,7013,진전/Noun,19,1,18,3.334444814938313e-05,0.00022212843466092096,0.9473684210526316
4567,7014,발성/Noun,19,1,18,3.334444814938313e-05,0.00022212843466092096,0.9473684210526316
4568,7015,우웩/Noun,19,1,18,3.334444814938313e-05,0.00022212843466092096,0.9473684210526316
4569,7016,남다르다/Adjective,19,17,2,0.00021118150494609317,4.4425686932184186e-05,0.8947368421052632
4570,7017,최상/Noun,19,17,2,0.00021118150494609317,4.4425686932184186e-05,0.8947368421052632
4571,7018,80%/Number,19,2,17,4.445926419917751e-05,0.0002110220129278749,0.8947368421052632
4572,7019,9~10/Number,19,2,17,4.445926419917751e-05,0.0002110220129278749,0.8947368421052632
4573,7020,완소/Noun,19,17,2,0.00021118150494609317,4.4425686932184186e-05,0.8947368421052632
4574,7021,다인/Noun,19,2,17,4.445926419917751e-05,0.0002110220129278749,0.8947368421052632
4575,7022,생뚱맞/Noun,19,2,17,4.445926419917751e-05,0.0002110220129278749,0.8947368421052632
4576,7023,이글/Noun,19,2,17,4.445926419917751e-05,0.0002110220129278749,0.8947368421052632
4577,7024,툭툭/Noun,19,3,16,5.5574080248971876e-05,0.00019991559119482882,0.8421052631578947
4578,7025,실천/Noun,19,16,3,0.0002000666888962988,5.553210866523024e-05,0.8421052631578947
4579,7026,관우/Noun,19,3,16,5.5574080248971876e-05,0.00019991559119482882,0.8421052631578947
4580,7027,망정/Noun,19,3,16,5.5574080248971876e-05,0.00019991559119482882,0.8421052631578947
4581,7028,고질/Noun,19,3,16,5.5574080248971876e-05,0.00019991559119482882,0.8421052631578947
4582,7029,김혜선/Noun,19,3,16,5.5574080248971876e-05,0.00019991559119482882,0.8421052631578947
4583,7030,때로는/Noun,19,16,3,0.0002000666888962988,5.553210866523024e-05,0.8421052631578947
4584,7031,안중근/Noun,19,3,16,5.5574080248971876e-05,0.00019991559119482882,0.8421052631578947
4585,7032,호연/Noun,19,16,3,0.0002000666888962988,5.553210866523024e-05,0.8421052631578947
4586,7033,박시후/Noun,19,16,3,0.0002000666888962988,5.553210866523024e-05,0.8421052631578947
4587,7034,이쯤/Noun,19,3,16,5.5574080248971876e-05,0.00019991559119482882,0.8421052631578947
4588,7035,천천히/Adverb,19,16,3,0.0002000666888962988,5.553210866523024e-05,0.8421052631578947
4589,7036,애비/Noun,19,3,16,5.5574080248971876e-05,0.00019991559119482882,0.8421052631578947
4590,7037,알아듣다/Verb,19,3,16,5.5574080248971876e-05,0.00019991559119482882,0.8421052631578947
4591,7038,멜로디/Noun,19,15,4,0.00018895187284650438,6.663853039827628e-05,0.7894736842105263
4592,7039,지게/Noun,19,15,4,0.00018895187284650438,6.663853039827628e-05,0.7894736842105263
4593,7040,오래간만/Adverb,19,15,4,0.00018895187284650438,6.663853039827628e-05,0.7894736842105263
4594,7041,맴도/Noun,19,15,4,0.00018895187284650438,6.663853039827628e-05,0.7894736842105263
4595,7042,소스/Noun,19,4,15,6.668889629876625e-05,0.0001888091694617828,0.7894736842105263
4596,7043,................/Punctuation,19,4,15,6.668889629876625e-05,0.0001888091694617828,0.7894736842105263
4597,7044,수영/Noun,19,15,4,0.00018895187284650438,6.663853039827628e-05,0.7894736842105263
4598,7045,짝짝/Noun,19,15,4,0.00018895187284650438,6.663853039827628e-05,0.7894736842105263
4599,7046,”/Foreign,19,4,15,6.668889629876625e-05,0.0001888091694617828,0.7894736842105263
4600,7047,창의/Noun,19,15,4,0.00018895187284650438,6.663853039827628e-05,0.7894736842105263
4601,7048,액션연기/Noun,19,15,4,0.00018895187284650438,6.663853039827628e-05,0.7894736842105263
4602,7049,천/Noun,19,14,5,0.00017783705679671002,7.774495213132233e-05,0.7368421052631579
4603,7050,도의/Noun,19,14,5,0.00017783705679671002,7.774495213132233e-05,0.7368421052631579
4604,7051,추모/Noun,19,14,5,0.00017783705679671002,7.774495213132233e-05,0.7368421052631579
4605,7052,육/Modifier,19,5,14,7.780371234856063e-05,0.00017770274772873674,0.7368421052631579
4606,7053,제라드/Noun,19,14,5,0.00017783705679671002,7.774495213132233e-05,0.7368421052631579
4607,7054,자도/Noun,19,5,14,7.780371234856063e-05,0.00017770274772873674,0.7368421052631579
4608,7055,덩/Noun,19,5,14,7.780371234856063e-05,0.00017770274772873674,0.7368421052631579
4609,7056,슴가/Noun,19,5,14,7.780371234856063e-05,0.00017770274772873674,0.7368421052631579
4610,7057,90%/Number,19,5,14,7.780371234856063e-05,0.00017770274772873674,0.7368421052631579
4611,7058,샹/Noun,19,5,14,7.780371234856063e-05,0.00017770274772873674,0.7368421052631579
4612,7059,쾌락/Noun,19,14,5,0.00017783705679671002,7.774495213132233e-05,0.7368421052631579
4613,7060,김고은/Noun,19,5,14,7.780371234856063e-05,0.00017770274772873674,0.7368421052631579
4614,7061,흑백영화/Noun,19,14,5,0.00017783705679671002,7.774495213132233e-05,0.7368421052631579
4615,7062,퓨전/Noun,19,5,14,7.780371234856063e-05,0.00017770274772873674,0.7368421052631579
4616,7063,박진희/Noun,19,14,5,0.00017783705679671002,7.774495213132233e-05,0.7368421052631579
4617,7064,한판/Noun,19,5,14,7.780371234856063e-05,0.00017770274772873674,0.7368421052631579
4618,7065,새기다/Verb,19,14,5,0.00017783705679671002,7.774495213132233e-05,0.7368421052631579
4619,7066,난생처음/Noun,19,5,14,7.780371234856063e-05,0.00017770274772873674,0.7368421052631579
4620,7067,금성무/Noun,19,14,5,0.00017783705679671002,7.774495213132233e-05,0.7368421052631579
4621,7068,세련/Noun,19,14,5,0.00017783705679671002,7.774495213132233e-05,0.7368421052631579
4622,7069,재활용/Noun,19,5,14,7.780371234856063e-05,0.00017770274772873674,0.7368421052631579
4623,7070,진호/Noun,19,5,14,7.780371234856063e-05,0.00017770274772873674,0.7368421052631579
4624,7071,스승/Noun,19,14,5,0.00017783705679671002,7.774495213132233e-05,0.7368421052631579
4625,7072,~./Punctuation,19,14,5,0.00017783705679671002,7.774495213132233e-05,0.7368421052631579
4626,7073,인질/Noun,19,5,14,7.780371234856063e-05,0.00017770274772873674,0.7368421052631579
4627,7074,별것/Noun,19,5,14,7.780371234856063e-05,0.00017770274772873674,0.7368421052631579
4628,7075,휼륭하다/Adjective,19,14,5,0.00017783705679671002,7.774495213132233e-05,0.7368421052631579
4629,7076,민간인/Noun,19,5,14,7.780371234856063e-05,0.00017770274772873674,0.7368421052631579
4630,7077,샤말란/Noun,19,5,14,7.780371234856063e-05,0.00017770274772873674,0.7368421052631579
4631,7078,다분하다/Adjective,19,5,14,7.780371234856063e-05,0.00017770274772873674,0.7368421052631579
4632,7079,Z/Alpha,19,5,14,7.780371234856063e-05,0.00017770274772873674,0.7368421052631579
4633,7080,바가지/Noun,19,6,13,8.891852839835501e-05,0.0001665963259956907,0.6842105263157895
4634,7081,이처럼/Noun,19,13,6,0.00016672224074691566,8.885137386436837e-05,0.6842105263157895
4635,7082,가필드/Noun,19,13,6,0.00016672224074691566,8.885137386436837e-05,0.6842105263157895
4636,7083,for/Alpha,19,13,6,0.00016672224074691566,8.885137386436837e-05,0.6842105263157895
4637,7084,사고방식/Noun,19,6,13,8.891852839835501e-05,0.0001665963259956907,0.6842105263157895
4638,7085,허락/Noun,19,6,13,8.891852839835501e-05,0.0001665963259956907,0.6842105263157895
4639,7086,조한선/Noun,19,6,13,8.891852839835501e-05,0.0001665963259956907,0.6842105263157895
4640,7087,톡톡/Noun,19,13,6,0.00016672224074691566,8.885137386436837e-05,0.6842105263157895
4641,7088,넨/Noun,19,13,6,0.00016672224074691566,8.885137386436837e-05,0.6842105263157895
4642,7089,포스트/Noun,19,6,13,8.891852839835501e-05,0.0001665963259956907,0.6842105263157895
4643,7090,특정/Noun,19,6,13,8.891852839835501e-05,0.0001665963259956907,0.6842105263157895
4644,7091,후보/Noun,19,6,13,8.891852839835501e-05,0.0001665963259956907,0.6842105263157895
4645,7092,애환/Noun,19,13,6,0.00016672224074691566,8.885137386436837e-05,0.6842105263157895
4646,7093,순식간/Noun,19,6,13,8.891852839835501e-05,0.0001665963259956907,0.6842105263157895
4647,7094,싸인/Noun,19,13,6,0.00016672224074691566,8.885137386436837e-05,0.6842105263157895
4648,7095,영역/Noun,19,13,6,0.00016672224074691566,8.885137386436837e-05,0.6842105263157895
4649,7096,구로/Noun,19,13,6,0.00016672224074691566,8.885137386436837e-05,0.6842105263157895
4650,7097,생방송/Noun,19,6,13,8.891852839835501e-05,0.0001665963259956907,0.6842105263157895
4651,7098,며느리/Noun,19,6,13,8.891852839835501e-05,0.0001665963259956907,0.6842105263157895
4652,7099,업그레이드/Noun,19,13,6,0.00016672224074691566,8.885137386436837e-05,0.6842105263157895
4653,7100,곽지민/Noun,19,6,13,8.891852839835501e-05,0.0001665963259956907,0.6842105263157895
4654,7101,영리하다/Adjective,19,13,6,0.00016672224074691566,8.885137386436837e-05,0.6842105263157895
4655,7102,킹콩/Noun,19,6,13,8.891852839835501e-05,0.0001665963259956907,0.6842105263157895
4656,7103,해치다/Verb,19,6,13,8.891852839835501e-05,0.0001665963259956907,0.6842105263157895
4657,7104,별그대/Noun,19,13,6,0.00016672224074691566,8.885137386436837e-05,0.6842105263157895
4658,7105,스페셜/Noun,19,6,13,8.891852839835501e-05,0.0001665963259956907,0.6842105263157895
4659,7106,자꾸만/Noun,19,13,6,0.00016672224074691566,8.885137386436837e-05,0.6842105263157895
4660,7107,올리비아/Noun,19,12,7,0.00015560742469712126,9.995779559741441e-05,0.631578947368421
4661,7108,성욕/Noun,19,7,12,0.0001000333444481494,0.00015548990426264466,0.631578947368421
4662,7109,승자/Noun,19,12,7,0.00015560742469712126,9.995779559741441e-05,0.631578947368421
4663,7110,예나/Noun,19,12,7,0.00015560742469712126,9.995779559741441e-05,0.631578947368421
4664,7111,와이/Modifier,19,12,7,0.00015560742469712126,9.995779559741441e-05,0.631578947368421
4665,7112,100년/Number,19,12,7,0.00015560742469712126,9.995779559741441e-05,0.631578947368421
4666,7113,바디/Noun,19,7,12,0.0001000333444481494,0.00015548990426264466,0.631578947368421
4667,7114,대강/Noun,19,7,12,0.0001000333444481494,0.00015548990426264466,0.631578947368421
4668,7115,썸/Noun,19,7,12,0.0001000333444481494,0.00015548990426264466,0.631578947368421
4669,7116,여럿/Noun,19,7,12,0.0001000333444481494,0.00015548990426264466,0.631578947368421
4670,7117,만치/Josa,19,12,7,0.00015560742469712126,9.995779559741441e-05,0.631578947368421
4671,7118,주식/Noun,19,12,7,0.00015560742469712126,9.995779559741441e-05,0.631578947368421
4672,7119,뒤집어지다/Verb,19,12,7,0.00015560742469712126,9.995779559741441e-05,0.631578947368421
4673,7120,당기다/Verb,19,7,12,0.0001000333444481494,0.00015548990426264466,0.631578947368421
4674,7121,딸아이/Noun,19,12,7,0.00015560742469712126,9.995779559741441e-05,0.631578947368421
4675,7122,개구리/Noun,19,7,12,0.0001000333444481494,0.00015548990426264466,0.631578947368421
4676,7123,몰리다/Verb,19,7,12,0.0001000333444481494,0.00015548990426264466,0.631578947368421
4677,7124,스나입스/Noun,19,7,12,0.0001000333444481494,0.00015548990426264466,0.631578947368421
4678,7125,일류/Noun,19,7,12,0.0001000333444481494,0.00015548990426264466,0.631578947368421
4679,7126,이미숙/Noun,19,12,7,0.00015560742469712126,9.995779559741441e-05,0.631578947368421
4680,7127,거북/Noun,19,7,12,0.0001000333444481494,0.00015548990426264466,0.631578947368421
4681,7128,원본/Noun,19,12,7,0.00015560742469712126,9.995779559741441e-05,0.631578947368421
4682,7129,돌고래/Noun,19,12,7,0.00015560742469712126,9.995779559741441e-05,0.631578947368421
4683,7130,작성/Noun,19,7,12,0.0001000333444481494,0.00015548990426264466,0.631578947368421
4684,7131,케로로/Noun,19,12,7,0.00015560742469712126,9.995779559741441e-05,0.631578947368421
4685,7132,외계/Noun,19,7,12,0.0001000333444481494,0.00015548990426264466,0.631578947368421
4686,7133,우주선/Noun,19,7,12,0.0001000333444481494,0.00015548990426264466,0.631578947368421
4687,7134,달린다/Noun,19,7,12,0.0001000333444481494,0.00015548990426264466,0.631578947368421
4688,7135,상대로/Noun,19,7,12,0.0001000333444481494,0.00015548990426264466,0.631578947368421
4689,7136,꺾다/Verb,19,7,12,0.0001000333444481494,0.00015548990426264466,0.631578947368421
4690,7137,4회/Number,19,7,12,0.0001000333444481494,0.00015548990426264466,0.631578947368421
4691,7138,넘어지다/Verb,19,7,12,0.0001000333444481494,0.00015548990426264466,0.631578947368421
4692,7139,터널/Noun,19,12,7,0.00015560742469712126,9.995779559741441e-05,0.631578947368421
4693,7140,다물다/Verb,19,12,7,0.00015560742469712126,9.995779559741441e-05,0.631578947368421
4694,7141,28/Number,19,12,7,0.00015560742469712126,9.995779559741441e-05,0.631578947368421
4695,7200,늦추다/Verb,18,18,0,0.0002222963209958875,2.2212843466092093e-05,1.0
4696,7201,다려지다/Verb,18,18,0,0.0002222963209958875,2.2212843466092093e-05,1.0
4697,7202,보고또보고/Noun,18,18,0,0.0002222963209958875,2.2212843466092093e-05,1.0
4698,7203,김준호/Noun,18,0,18,2.2229632099588756e-05,0.00022212843466092096,1.0
4699,7204,오광록/Noun,18,0,18,2.2229632099588756e-05,0.00022212843466092096,1.0
4700,7205,놨/Noun,18,0,18,2.2229632099588756e-05,0.00022212843466092096,1.0
4701,7206,굿잡/Noun,18,17,1,0.00021118150494609317,3.331926519913814e-05,0.9444444444444444
4702,7207,여비/Noun,18,1,17,3.334444814938313e-05,0.0002110220129278749,0.9444444444444444
4703,7208,여균동/Noun,18,1,17,3.334444814938313e-05,0.0002110220129278749,0.9444444444444444
4704,7209,혈압/Noun,18,1,17,3.334444814938313e-05,0.0002110220129278749,0.9444444444444444
4705,7210,평온하다/Adjective,18,17,1,0.00021118150494609317,3.331926519913814e-05,0.9444444444444444
4706,7211,불법체류자/Noun,18,1,17,3.334444814938313e-05,0.0002110220129278749,0.9444444444444444
4707,7212,출품/Noun,18,1,17,3.334444814938313e-05,0.0002110220129278749,0.9444444444444444
4708,7213,발가락/Noun,18,1,17,3.334444814938313e-05,0.0002110220129278749,0.9444444444444444
4709,7214,좀해/Noun,18,2,16,4.445926419917751e-05,0.00019991559119482882,0.8888888888888888
4710,7215,성해/Noun,18,2,16,4.445926419917751e-05,0.00019991559119482882,0.8888888888888888
4711,7216,충돌/Noun,18,16,2,0.0002000666888962988,4.4425686932184186e-05,0.8888888888888888
4712,7217,+_+/Punctuation,18,16,2,0.0002000666888962988,4.4425686932184186e-05,0.8888888888888888
4713,7218,신랄하다/Adjective,18,16,2,0.0002000666888962988,4.4425686932184186e-05,0.8888888888888888
4714,7219,졸귀/Noun,18,16,2,0.0002000666888962988,4.4425686932184186e-05,0.8888888888888888
4715,7220,만만하다/Adjective,18,2,16,4.445926419917751e-05,0.00019991559119482882,0.8888888888888888
4716,7221,엘렌/Noun,18,16,2,0.0002000666888962988,4.4425686932184186e-05,0.8888888888888888
4717,7222,테잎/Noun,18,16,2,0.0002000666888962988,4.4425686932184186e-05,0.8888888888888888
4718,7223,가차/Noun,18,2,16,4.445926419917751e-05,0.00019991559119482882,0.8888888888888888
4719,7224,테이프/Noun,18,16,2,0.0002000666888962988,4.4425686932184186e-05,0.8888888888888888
4720,7225,갈팡질팡/Noun,18,2,16,4.445926419917751e-05,0.00019991559119482882,0.8888888888888888
4721,7226,신발/Noun,18,2,16,4.445926419917751e-05,0.00019991559119482882,0.8888888888888888
4722,7227,용인/Noun,18,2,16,4.445926419917751e-05,0.00019991559119482882,0.8888888888888888
4723,7228,....;;/Punctuation,18,2,16,4.445926419917751e-05,0.00019991559119482882,0.8888888888888888
4724,7229,불과/Noun,18,2,16,4.445926419917751e-05,0.00019991559119482882,0.8888888888888888
4725,7230,전설의고향/Noun,18,2,16,4.445926419917751e-05,0.00019991559119482882,0.8888888888888888
4726,7231,혁신/Noun,18,16,2,0.0002000666888962988,4.4425686932184186e-05,0.8888888888888888
4727,7232,444/Number,18,2,16,4.445926419917751e-05,0.00019991559119482882,0.8888888888888888
4728,7233,비로소/Noun,18,16,2,0.0002000666888962988,4.4425686932184186e-05,0.8888888888888888
4729,7234,윗/Modifier,18,3,15,5.5574080248971876e-05,0.0001888091694617828,0.8333333333333334
4730,7235,장비/Noun,18,3,15,5.5574080248971876e-05,0.0001888091694617828,0.8333333333333334
4731,7236,니콜슨/Noun,18,15,3,0.00018895187284650438,5.553210866523024e-05,0.8333333333333334
4732,7237,부풀리다/Verb,18,3,15,5.5574080248971876e-05,0.0001888091694617828,0.8333333333333334
4733,7238,5~6/Number,18,3,15,5.5574080248971876e-05,0.0001888091694617828,0.8333333333333334
4734,7239,산뜻하다/Adjective,18,15,3,0.00018895187284650438,5.553210866523024e-05,0.8333333333333334
4735,7240,칙칙하다/Adjective,18,3,15,5.5574080248971876e-05,0.0001888091694617828,0.8333333333333334
4736,7241,더군다나/Noun,18,3,15,5.5574080248971876e-05,0.0001888091694617828,0.8333333333333334
4737,7242,교통사고/Noun,18,3,15,5.5574080248971876e-05,0.0001888091694617828,0.8333333333333334
4738,7243,레기/Noun,18,3,15,5.5574080248971876e-05,0.0001888091694617828,0.8333333333333334
4739,7244,통제/Noun,18,14,4,0.00017783705679671002,6.663853039827628e-05,0.7777777777777778
4740,7245,기능/Noun,18,4,14,6.668889629876625e-05,0.00017770274772873674,0.7777777777777778
4741,7246,주걸륜/Noun,18,4,14,6.668889629876625e-05,0.00017770274772873674,0.7777777777777778
4742,7247,천지/Noun,18,4,14,6.668889629876625e-05,0.00017770274772873674,0.7777777777777778
4743,7248,매기/Noun,18,4,14,6.668889629876625e-05,0.00017770274772873674,0.7777777777777778
4744,7249,폭동/Noun,18,4,14,6.668889629876625e-05,0.00017770274772873674,0.7777777777777778
4745,7250,엇갈리다/Verb,18,14,4,0.00017783705679671002,6.663853039827628e-05,0.7777777777777778
4746,7251,김소연/Noun,18,14,4,0.00017783705679671002,6.663853039827628e-05,0.7777777777777778
4747,7252,17년/Number,18,14,4,0.00017783705679671002,6.663853039827628e-05,0.7777777777777778
4748,7253,권장/Noun,18,4,14,6.668889629876625e-05,0.00017770274772873674,0.7777777777777778
4749,7254,나무라다/Verb,18,14,4,0.00017783705679671002,6.663853039827628e-05,0.7777777777777778
4750,7255,SBS/Alpha,18,4,14,6.668889629876625e-05,0.00017770274772873674,0.7777777777777778
4751,7256,전화하다/Adjective,18,4,14,6.668889629876625e-05,0.00017770274772873674,0.7777777777777778
4752,7257,김동욱/Noun,18,14,4,0.00017783705679671002,6.663853039827628e-05,0.7777777777777778
4753,7258,무관심/Noun,18,14,4,0.00017783705679671002,6.663853039827628e-05,0.7777777777777778
4754,7259,사운드트랙/Noun,18,14,4,0.00017783705679671002,6.663853039827628e-05,0.7777777777777778
4755,7260,황우슬혜/Noun,18,4,14,6.668889629876625e-05,0.00017770274772873674,0.7777777777777778
4756,7261,무한도전/Noun,18,4,14,6.668889629876625e-05,0.00017770274772873674,0.7777777777777778
4757,7262,리얼리즘/Noun,18,14,4,0.00017783705679671002,6.663853039827628e-05,0.7777777777777778
4758,7263,천정명/Noun,18,4,14,6.668889629876625e-05,0.00017770274772873674,0.7777777777777778
4759,7264,상한/Noun,18,5,13,7.780371234856063e-05,0.0001665963259956907,0.7222222222222222
4760,7265,식겁하다/Adjective,18,5,13,7.780371234856063e-05,0.0001665963259956907,0.7222222222222222
4761,7266,해품달/Noun,18,13,5,0.00016672224074691566,7.774495213132233e-05,0.7222222222222222
4762,7267,쥬/Noun,18,13,5,0.00016672224074691566,7.774495213132233e-05,0.7222222222222222
4763,7268,....!/Punctuation,18,13,5,0.00016672224074691566,7.774495213132233e-05,0.7222222222222222
4764,7269,능청/Noun,18,13,5,0.00016672224074691566,7.774495213132233e-05,0.7222222222222222
4765,7270,자화상/Noun,18,13,5,0.00016672224074691566,7.774495213132233e-05,0.7222222222222222
4766,7271,화살/Noun,18,5,13,7.780371234856063e-05,0.0001665963259956907,0.7222222222222222
4767,7272,강수연/Noun,18,5,13,7.780371234856063e-05,0.0001665963259956907,0.7222222222222222
4768,7273,국회의원/Noun,18,5,13,7.780371234856063e-05,0.0001665963259956907,0.7222222222222222
4769,7274,드라큐라/Noun,18,13,5,0.00016672224074691566,7.774495213132233e-05,0.7222222222222222
4770,7275,페넬로페/Noun,18,13,5,0.00016672224074691566,7.774495213132233e-05,0.7222222222222222
4771,7276,막말/Noun,18,5,13,7.780371234856063e-05,0.0001665963259956907,0.7222222222222222
4772,7277,누굴/Noun,18,5,13,7.780371234856063e-05,0.0001665963259956907,0.7222222222222222
4773,7278,훗날/Noun,18,13,5,0.00016672224074691566,7.774495213132233e-05,0.7222222222222222
4774,7279,풋/Noun,18,5,13,7.780371234856063e-05,0.0001665963259956907,0.7222222222222222
4775,7280,우주전쟁/Noun,18,5,13,7.780371234856063e-05,0.0001665963259956907,0.7222222222222222
4776,7281,키이라/Noun,18,13,5,0.00016672224074691566,7.774495213132233e-05,0.7222222222222222
4777,7282,곤란하다/Adjective,18,5,13,7.780371234856063e-05,0.0001665963259956907,0.7222222222222222
4778,7283,절규/Noun,18,13,5,0.00016672224074691566,7.774495213132233e-05,0.7222222222222222
4779,7284,정우/Noun,18,13,5,0.00016672224074691566,7.774495213132233e-05,0.7222222222222222
4780,7285,경향/Noun,18,5,13,7.780371234856063e-05,0.0001665963259956907,0.7222222222222222
4781,7286,가든/Noun,18,5,13,7.780371234856063e-05,0.0001665963259956907,0.7222222222222222
4782,7287,싸대기/Noun,18,5,13,7.780371234856063e-05,0.0001665963259956907,0.7222222222222222
4783,7288,복잡/Noun,18,13,5,0.00016672224074691566,7.774495213132233e-05,0.7222222222222222
4784,7289,이필/Noun,18,13,5,0.00016672224074691566,7.774495213132233e-05,0.7222222222222222
4785,7290,공자/Noun,18,13,5,0.00016672224074691566,7.774495213132233e-05,0.7222222222222222
4786,7291,치매/Noun,18,5,13,7.780371234856063e-05,0.0001665963259956907,0.7222222222222222
4787,7292,친근하다/Adjective,18,13,5,0.00016672224074691566,7.774495213132233e-05,0.7222222222222222
4788,7293,정교하다/Adjective,18,13,5,0.00016672224074691566,7.774495213132233e-05,0.7222222222222222
4789,7294,고서/Noun,18,5,13,7.780371234856063e-05,0.0001665963259956907,0.7222222222222222
4790,7295,주저/Noun,18,13,5,0.00016672224074691566,7.774495213132233e-05,0.7222222222222222
4791,7296,.;;/Punctuation,18,5,13,7.780371234856063e-05,0.0001665963259956907,0.7222222222222222
4792,7297,열차/Noun,18,5,13,7.780371234856063e-05,0.0001665963259956907,0.7222222222222222
4793,7298,이득/Noun,18,5,13,7.780371234856063e-05,0.0001665963259956907,0.7222222222222222
4794,7299,라네/Josa,18,6,12,8.891852839835501e-05,0.00015548990426264466,0.6666666666666666
4795,7300,내부/Noun,18,12,6,0.00015560742469712126,8.885137386436837e-05,0.6666666666666666
4796,7301,천원/Noun,18,6,12,8.891852839835501e-05,0.00015548990426264466,0.6666666666666666
4797,7302,악령/Noun,18,6,12,8.891852839835501e-05,0.00015548990426264466,0.6666666666666666
4798,7303,가오/Noun,18,6,12,8.891852839835501e-05,0.00015548990426264466,0.6666666666666666
4799,7304,투모로우/Noun,18,6,12,8.891852839835501e-05,0.00015548990426264466,0.6666666666666666
4800,7305,딱지/Noun,18,6,12,8.891852839835501e-05,0.00015548990426264466,0.6666666666666666
4801,7306,짤/Noun,18,6,12,8.891852839835501e-05,0.00015548990426264466,0.6666666666666666
4802,7307,강의/Noun,18,12,6,0.00015560742469712126,8.885137386436837e-05,0.6666666666666666
4803,7308,대우/Noun,18,12,6,0.00015560742469712126,8.885137386436837e-05,0.6666666666666666
4804,7309,고마/Noun,18,6,12,8.891852839835501e-05,0.00015548990426264466,0.6666666666666666
4805,7310,종편/Noun,18,12,6,0.00015560742469712126,8.885137386436837e-05,0.6666666666666666
4806,7311,미지근하다/Adjective,18,6,12,8.891852839835501e-05,0.00015548990426264466,0.6666666666666666
4807,7312,자부/Noun,18,12,6,0.00015560742469712126,8.885137386436837e-05,0.6666666666666666
4808,7313,세뇌/Noun,18,6,12,8.891852839835501e-05,0.00015548990426264466,0.6666666666666666
4809,7314,정사씬/Noun,18,6,12,8.891852839835501e-05,0.00015548990426264466,0.6666666666666666
4810,7315,오만/Noun,18,6,12,8.891852839835501e-05,0.00015548990426264466,0.6666666666666666
4811,7316,더더/Noun,18,12,6,0.00015560742469712126,8.885137386436837e-05,0.6666666666666666
4812,7317,김사랑/Noun,18,6,12,8.891852839835501e-05,0.00015548990426264466,0.6666666666666666
4813,7318,가져가다/Verb,18,6,12,8.891852839835501e-05,0.00015548990426264466,0.6666666666666666
4814,7319,140/Number,18,12,6,0.00015560742469712126,8.885137386436837e-05,0.6666666666666666
4815,7320,베니/Noun,18,12,6,0.00015560742469712126,8.885137386436837e-05,0.6666666666666666
4816,7321,"~""/Punctuation",18,12,6,0.00015560742469712126,8.885137386436837e-05,0.6666666666666666
4817,7322,추격자/Noun,18,6,12,8.891852839835501e-05,0.00015548990426264466,0.6666666666666666
4818,7323,건데/Noun,18,6,12,8.891852839835501e-05,0.00015548990426264466,0.6666666666666666
4819,7324,주니어/Noun,18,12,6,0.00015560742469712126,8.885137386436837e-05,0.6666666666666666
4820,7325,날수/Noun,18,12,6,0.00015560742469712126,8.885137386436837e-05,0.6666666666666666
4821,7326,핀처/Noun,18,12,6,0.00015560742469712126,8.885137386436837e-05,0.6666666666666666
4822,7327,김대중/Noun,18,6,12,8.891852839835501e-05,0.00015548990426264466,0.6666666666666666
4823,7328,삽질/Noun,18,6,12,8.891852839835501e-05,0.00015548990426264466,0.6666666666666666
4824,7329,위험/Noun,18,6,12,8.891852839835501e-05,0.00015548990426264466,0.6666666666666666
4825,7330,기해/Noun,18,6,12,8.891852839835501e-05,0.00015548990426264466,0.6666666666666666
4826,7331,정당하다/Adjective,18,6,12,8.891852839835501e-05,0.00015548990426264466,0.6666666666666666
4827,7332,정준/Noun,18,12,6,0.00015560742469712126,8.885137386436837e-05,0.6666666666666666
4828,7333,심각/Noun,18,12,6,0.00015560742469712126,8.885137386436837e-05,0.6666666666666666
4829,7334,2등/Number,18,7,11,0.0001000333444481494,0.0001443834825295986,0.6111111111111112
4830,7335,이나라/Noun,18,11,7,0.0001444926086473269,9.995779559741441e-05,0.6111111111111112
4831,7336,웬/Modifier,18,7,11,0.0001000333444481494,0.0001443834825295986,0.6111111111111112
4832,7337,80분/Number,18,7,11,0.0001000333444481494,0.0001443834825295986,0.6111111111111112
4833,7338,특선/Noun,18,11,7,0.0001444926086473269,9.995779559741441e-05,0.6111111111111112
4834,7339,비됴/Noun,18,7,11,0.0001000333444481494,0.0001443834825295986,0.6111111111111112
4835,7340,돌프/Noun,18,7,11,0.0001000333444481494,0.0001443834825295986,0.6111111111111112
4836,7341,노다메/Noun,18,11,7,0.0001444926086473269,9.995779559741441e-05,0.6111111111111112
4837,7342,장기/Noun,18,7,11,0.0001000333444481494,0.0001443834825295986,0.6111111111111112
4838,7343,오후/Noun,18,11,7,0.0001444926086473269,9.995779559741441e-05,0.6111111111111112
4839,7344,힐러리/Noun,18,11,7,0.0001444926086473269,9.995779559741441e-05,0.6111111111111112
4840,7345,선교/Noun,18,7,11,0.0001000333444481494,0.0001443834825295986,0.6111111111111112
4841,7346,바지/Noun,18,11,7,0.0001444926086473269,9.995779559741441e-05,0.6111111111111112
4842,7347,나오미/Noun,18,11,7,0.0001444926086473269,9.995779559741441e-05,0.6111111111111112
4843,7348,6~7/Number,18,11,7,0.0001444926086473269,9.995779559741441e-05,0.6111111111111112
4844,7349,바이블/Noun,18,11,7,0.0001444926086473269,9.995779559741441e-05,0.6111111111111112
4845,7350,비긴/Noun,18,11,7,0.0001444926086473269,9.995779559741441e-05,0.6111111111111112
4846,7351,익/Noun,18,7,11,0.0001000333444481494,0.0001443834825295986,0.6111111111111112
4847,7352,할리/Noun,18,11,7,0.0001444926086473269,9.995779559741441e-05,0.6111111111111112
4848,7353,여백/Noun,18,11,7,0.0001444926086473269,9.995779559741441e-05,0.6111111111111112
4849,7354,매드/Noun,18,11,7,0.0001444926086473269,9.995779559741441e-05,0.6111111111111112
4850,7355,쟁쟁/Noun,18,7,11,0.0001000333444481494,0.0001443834825295986,0.6111111111111112
4851,7356,왜캐/Noun,18,7,11,0.0001000333444481494,0.0001443834825295986,0.6111111111111112
4852,7357,제리/Noun,18,11,7,0.0001444926086473269,9.995779559741441e-05,0.6111111111111112
4853,7358,샷/Noun,18,7,11,0.0001000333444481494,0.0001443834825295986,0.6111111111111112
4854,7359,홍경인/Noun,18,7,11,0.0001000333444481494,0.0001443834825295986,0.6111111111111112
4855,7360,라기보다는/Josa,18,7,11,0.0001000333444481494,0.0001443834825295986,0.6111111111111112
4856,7361,현우/Noun,18,11,7,0.0001444926086473269,9.995779559741441e-05,0.6111111111111112
4857,7362,왈/Noun,18,7,11,0.0001000333444481494,0.0001443834825295986,0.6111111111111112
4858,7363,죄악/Noun,18,7,11,0.0001000333444481494,0.0001443834825295986,0.6111111111111112
4859,7364,곱/Noun,18,7,11,0.0001000333444481494,0.0001443834825295986,0.6111111111111112
4860,7365,닮음/Noun,18,11,7,0.0001444926086473269,9.995779559741441e-05,0.6111111111111112
4861,7366,오컬트/Noun,18,7,11,0.0001000333444481494,0.0001443834825295986,0.6111111111111112
4862,7367,상사/Noun,18,7,11,0.0001000333444481494,0.0001443834825295986,0.6111111111111112
4863,7368,날아다니다/Verb,18,7,11,0.0001000333444481494,0.0001443834825295986,0.6111111111111112
4864,7369,달래다/Verb,18,11,7,0.0001444926086473269,9.995779559741441e-05,0.6111111111111112
4865,7370,갈아타다/Verb,18,7,11,0.0001000333444481494,0.0001443834825295986,0.6111111111111112
4866,7371,유감/Noun,18,7,11,0.0001000333444481494,0.0001443834825295986,0.6111111111111112
4867,7372,남여/Noun,18,11,7,0.0001444926086473269,9.995779559741441e-05,0.6111111111111112
4868,7373,초대/Noun,18,11,7,0.0001444926086473269,9.995779559741441e-05,0.6111111111111112
4869,7374,달러/Noun,18,7,11,0.0001000333444481494,0.0001443834825295986,0.6111111111111112
4870,7375,날때/Noun,18,11,7,0.0001444926086473269,9.995779559741441e-05,0.6111111111111112
4871,7376,차카/Noun,18,7,11,0.0001000333444481494,0.0001443834825295986,0.6111111111111112
4872,7377,불가하다/Adjective,18,7,11,0.0001000333444481494,0.0001443834825295986,0.6111111111111112
4873,7378,무모하다/Adjective,18,11,7,0.0001444926086473269,9.995779559741441e-05,0.6111111111111112
4874,7379,씩/Adverb,18,7,11,0.0001000333444481494,0.0001443834825295986,0.6111111111111112
4875,7452,패륜/Noun,17,0,17,2.2229632099588756e-05,0.0002110220129278749,1.0
4876,7453,김대희/Noun,17,0,17,2.2229632099588756e-05,0.0002110220129278749,1.0
4877,7454,이러니까/Conjunction,17,0,17,2.2229632099588756e-05,0.0002110220129278749,1.0
4878,7455,*^^*/Punctuation,17,17,0,0.00021118150494609317,2.2212843466092093e-05,1.0
4879,7456,숙면/Noun,17,0,17,2.2229632099588756e-05,0.0002110220129278749,1.0
4880,7457,클레이/Noun,17,17,0,0.00021118150494609317,2.2212843466092093e-05,1.0
4881,7458,조음/Noun,17,17,0,0.00021118150494609317,2.2212843466092093e-05,1.0
4882,7459,8~10/Number,17,0,17,2.2229632099588756e-05,0.0002110220129278749,1.0
4883,7460,0.1/Number,17,1,16,3.334444814938313e-05,0.00019991559119482882,0.9411764705882352
4884,7461,하락/Noun,17,1,16,3.334444814938313e-05,0.00019991559119482882,0.9411764705882352
4885,7462,죄송/Noun,17,1,16,3.334444814938313e-05,0.00019991559119482882,0.9411764705882352
4886,7463,ㅡㅡㅡ/KoreanParticle,17,1,16,3.334444814938313e-05,0.00019991559119482882,0.9411764705882352
4887,7464,임성한/Noun,17,1,16,3.334444814938313e-05,0.00019991559119482882,0.9411764705882352
4888,7465,데려오다/Verb,17,1,16,3.334444814938313e-05,0.00019991559119482882,0.9411764705882352
4889,7466,눈시울/Noun,17,16,1,0.0002000666888962988,3.331926519913814e-05,0.9411764705882352
4890,7467,끓이다/Verb,17,1,16,3.334444814938313e-05,0.00019991559119482882,0.9411764705882352
4891,7468,원주고/Noun,17,1,16,3.334444814938313e-05,0.00019991559119482882,0.9411764705882352
4892,7469,고리타분하다/Adjective,17,2,15,4.445926419917751e-05,0.0001888091694617828,0.8823529411764706
4893,7470,훈녀/Noun,17,15,2,0.00018895187284650438,4.4425686932184186e-05,0.8823529411764706
4894,7471,궁합/Noun,17,15,2,0.00018895187284650438,4.4425686932184186e-05,0.8823529411764706
4895,7472,작자/Noun,17,2,15,4.445926419917751e-05,0.0001888091694617828,0.8823529411764706
4896,7473,암만/Noun,17,2,15,4.445926419917751e-05,0.0001888091694617828,0.8823529411764706
4897,7474,폐/Noun,17,2,15,4.445926419917751e-05,0.0001888091694617828,0.8823529411764706
4898,7475,신음/Noun,17,2,15,4.445926419917751e-05,0.0001888091694617828,0.8823529411764706
4899,7476,랄프/Noun,17,15,2,0.00018895187284650438,4.4425686932184186e-05,0.8823529411764706
4900,7477,쨋/Noun,17,15,2,0.00018895187284650438,4.4425686932184186e-05,0.8823529411764706
4901,7478,로더/Noun,17,2,15,4.445926419917751e-05,0.0001888091694617828,0.8823529411764706
4902,7479,bbb/Alpha,17,15,2,0.00018895187284650438,4.4425686932184186e-05,0.8823529411764706
4903,7480,야망/Noun,17,15,2,0.00018895187284650438,4.4425686932184186e-05,0.8823529411764706
4904,7481,파란만장하다/Adjective,17,15,2,0.00018895187284650438,4.4425686932184186e-05,0.8823529411764706
4905,7482,or/Alpha,17,2,15,4.445926419917751e-05,0.0001888091694617828,0.8823529411764706
4906,7483,서른/Noun,17,15,2,0.00018895187284650438,4.4425686932184186e-05,0.8823529411764706
4907,7484,앞세우다/Verb,17,2,15,4.445926419917751e-05,0.0001888091694617828,0.8823529411764706
4908,7485,심플/Noun,17,14,3,0.00017783705679671002,5.553210866523024e-05,0.8235294117647058
4909,7486,단면/Noun,17,14,3,0.00017783705679671002,5.553210866523024e-05,0.8235294117647058
4910,7487,사지/Noun,17,3,14,5.5574080248971876e-05,0.00017770274772873674,0.8235294117647058
4911,7488,딘/Noun,17,14,3,0.00017783705679671002,5.553210866523024e-05,0.8235294117647058
4912,7489,심보/Noun,17,3,14,5.5574080248971876e-05,0.00017770274772873674,0.8235294117647058
4913,7490,악어/Noun,17,3,14,5.5574080248971876e-05,0.00017770274772873674,0.8235294117647058
4914,7491,거저/Noun,17,3,14,5.5574080248971876e-05,0.00017770274772873674,0.8235294117647058
4915,7492,상위/Noun,17,14,3,0.00017783705679671002,5.553210866523024e-05,0.8235294117647058
4916,7493,생생/Noun,17,14,3,0.00017783705679671002,5.553210866523024e-05,0.8235294117647058
4917,7494,앤드류/Noun,17,14,3,0.00017783705679671002,5.553210866523024e-05,0.8235294117647058
4918,7495,폐인/Noun,17,14,3,0.00017783705679671002,5.553210866523024e-05,0.8235294117647058
4919,7496,ok/Alpha,17,3,14,5.5574080248971876e-05,0.00017770274772873674,0.8235294117647058
4920,7497,시리/Noun,17,14,3,0.00017783705679671002,5.553210866523024e-05,0.8235294117647058
4921,7498,제멋대로/Noun,17,3,14,5.5574080248971876e-05,0.00017770274772873674,0.8235294117647058
4922,7499,서비스/Noun,17,3,14,5.5574080248971876e-05,0.00017770274772873674,0.8235294117647058
4923,7500,쏠리다/Verb,17,3,14,5.5574080248971876e-05,0.00017770274772873674,0.8235294117647058
4924,7501,꽥꽥/Adverb,17,3,14,5.5574080248971876e-05,0.00017770274772873674,0.8235294117647058
4925,7502,빙빙/Noun,17,3,14,5.5574080248971876e-05,0.00017770274772873674,0.8235294117647058
4926,7503,뮤/Noun,17,14,3,0.00017783705679671002,5.553210866523024e-05,0.8235294117647058
4927,7504,쑤시다/Verb,17,3,14,5.5574080248971876e-05,0.00017770274772873674,0.8235294117647058
4928,7505,저희/Modifier,17,14,3,0.00017783705679671002,5.553210866523024e-05,0.8235294117647058
4929,7506,일색/Noun,17,3,14,5.5574080248971876e-05,0.00017770274772873674,0.8235294117647058
4930,7507,진진/Noun,17,14,3,0.00017783705679671002,5.553210866523024e-05,0.8235294117647058
4931,7508,배급/Noun,17,3,14,5.5574080248971876e-05,0.00017770274772873674,0.8235294117647058
4932,7509,운지/Noun,17,3,14,5.5574080248971876e-05,0.00017770274772873674,0.8235294117647058
4933,7510,토크/Noun,17,4,13,6.668889629876625e-05,0.0001665963259956907,0.7647058823529411
4934,7511,교/Noun,17,4,13,6.668889629876625e-05,0.0001665963259956907,0.7647058823529411
4935,7512,커트/Noun,17,13,4,0.00016672224074691566,6.663853039827628e-05,0.7647058823529411
4936,7513,우상/Noun,17,13,4,0.00016672224074691566,6.663853039827628e-05,0.7647058823529411
4937,7514,웠/Noun,17,13,4,0.00016672224074691566,6.663853039827628e-05,0.7647058823529411
4938,7515,미생/Noun,17,13,4,0.00016672224074691566,6.663853039827628e-05,0.7647058823529411
4939,7516,1998년/Number,17,13,4,0.00016672224074691566,6.663853039827628e-05,0.7647058823529411
4940,7517,내사/Noun,17,13,4,0.00016672224074691566,6.663853039827628e-05,0.7647058823529411
4941,7518,토시/Noun,17,4,13,6.668889629876625e-05,0.0001665963259956907,0.7647058823529411
4942,7519,아비/Noun,17,4,13,6.668889629876625e-05,0.0001665963259956907,0.7647058823529411
4943,7520,웨스/Noun,17,13,4,0.00016672224074691566,6.663853039827628e-05,0.7647058823529411
4944,7521,붙이/Noun,17,4,13,6.668889629876625e-05,0.0001665963259956907,0.7647058823529411
4945,7522,넘사벽/Noun,17,13,4,0.00016672224074691566,6.663853039827628e-05,0.7647058823529411
4946,7523,--;;/Punctuation,17,4,13,6.668889629876625e-05,0.0001665963259956907,0.7647058823529411
4947,7524,맘마미아/Noun,17,4,13,6.668889629876625e-05,0.0001665963259956907,0.7647058823529411
4948,7525,처지다/Verb,17,4,13,6.668889629876625e-05,0.0001665963259956907,0.7647058823529411
4949,7526,쉰/Noun,17,13,4,0.00016672224074691566,6.663853039827628e-05,0.7647058823529411
4950,7527,뽑히다/Verb,17,4,13,6.668889629876625e-05,0.0001665963259956907,0.7647058823529411
4951,7528,거려/Noun,17,4,13,6.668889629876625e-05,0.0001665963259956907,0.7647058823529411
4952,7529,..~/Punctuation,17,13,4,0.00016672224074691566,6.663853039827628e-05,0.7647058823529411
4953,7530,기립박수/Noun,17,13,4,0.00016672224074691566,6.663853039827628e-05,0.7647058823529411
4954,7531,래서/Noun,17,4,13,6.668889629876625e-05,0.0001665963259956907,0.7647058823529411
4955,7532,만능/Noun,17,13,4,0.00016672224074691566,6.663853039827628e-05,0.7647058823529411
4956,7533,마당/Noun,17,4,13,6.668889629876625e-05,0.0001665963259956907,0.7647058823529411
4957,7534,시궁창/Noun,17,4,13,6.668889629876625e-05,0.0001665963259956907,0.7647058823529411
4958,7535,발랄/Noun,17,13,4,0.00016672224074691566,6.663853039827628e-05,0.7647058823529411
4959,7536,항/Noun,17,4,13,6.668889629876625e-05,0.0001665963259956907,0.7647058823529411
4960,7537,시원찮다/Adjective,17,4,13,6.668889629876625e-05,0.0001665963259956907,0.7647058823529411
4961,7538,릴/Noun,17,5,12,7.780371234856063e-05,0.00015548990426264466,0.7058823529411765
4962,7539,연쇄/Noun,17,5,12,7.780371234856063e-05,0.00015548990426264466,0.7058823529411765
4963,7540,회수/Noun,17,5,12,7.780371234856063e-05,0.00015548990426264466,0.7058823529411765
4964,7541,소금/Noun,17,5,12,7.780371234856063e-05,0.00015548990426264466,0.7058823529411765
4965,7542,아가씨/Noun,17,5,12,7.780371234856063e-05,0.00015548990426264466,0.7058823529411765
4966,7543,머임/Noun,17,5,12,7.780371234856063e-05,0.00015548990426264466,0.7058823529411765
4967,7544,위엄/Noun,17,5,12,7.780371234856063e-05,0.00015548990426264466,0.7058823529411765
4968,7545,스탭/Noun,17,12,5,0.00015560742469712126,7.774495213132233e-05,0.7058823529411765
4969,7546,다행하다/Adjective,17,12,5,0.00015560742469712126,7.774495213132233e-05,0.7058823529411765
4970,7547,비위/Noun,17,5,12,7.780371234856063e-05,0.00015548990426264466,0.7058823529411765
4971,7548,특수부대/Noun,17,5,12,7.780371234856063e-05,0.00015548990426264466,0.7058823529411765
4972,7549,신영화/Noun,17,5,12,7.780371234856063e-05,0.00015548990426264466,0.7058823529411765
4973,7550,더럽히다/Verb,17,5,12,7.780371234856063e-05,0.00015548990426264466,0.7058823529411765
4974,7551,은밀/Noun,17,5,12,7.780371234856063e-05,0.00015548990426264466,0.7058823529411765
4975,7552,요한/Noun,17,12,5,0.00015560742469712126,7.774495213132233e-05,0.7058823529411765
4976,7553,p/Alpha,17,5,12,7.780371234856063e-05,0.00015548990426264466,0.7058823529411765
4977,7554,어쩌다가/Noun,17,5,12,7.780371234856063e-05,0.00015548990426264466,0.7058823529411765
4978,7555,아버/Noun,17,5,12,7.780371234856063e-05,0.00015548990426264466,0.7058823529411765
4979,7556,뒷모습/Noun,17,12,5,0.00015560742469712126,7.774495213132233e-05,0.7058823529411765
4980,7557,우습다/Adjective,17,5,12,7.780371234856063e-05,0.00015548990426264466,0.7058823529411765
4981,7558,................../Punctuation,17,5,12,7.780371234856063e-05,0.00015548990426264466,0.7058823529411765
4982,7559,당첨/Noun,17,5,12,7.780371234856063e-05,0.00015548990426264466,0.7058823529411765
4983,7560,물어/Noun,17,5,12,7.780371234856063e-05,0.00015548990426264466,0.7058823529411765
4984,7561,9.5/Number,17,12,5,0.00015560742469712126,7.774495213132233e-05,0.7058823529411765
4985,7562,종결/Noun,17,5,12,7.780371234856063e-05,0.00015548990426264466,0.7058823529411765
4986,7563,드럼/Noun,17,12,5,0.00015560742469712126,7.774495213132233e-05,0.7058823529411765
4987,7564,영화제작/Noun,17,5,12,7.780371234856063e-05,0.00015548990426264466,0.7058823529411765
4988,7565,입술/Noun,17,5,12,7.780371234856063e-05,0.00015548990426264466,0.7058823529411765
4989,7566,졋/Noun,17,5,12,7.780371234856063e-05,0.00015548990426264466,0.7058823529411765
4990,7567,맴/Noun,17,12,5,0.00015560742469712126,7.774495213132233e-05,0.7058823529411765
4991,7568,아부/Noun,17,5,12,7.780371234856063e-05,0.00015548990426264466,0.7058823529411765
4992,7569,전기영/Noun,17,12,5,0.00015560742469712126,7.774495213132233e-05,0.7058823529411765
4993,7570,윤제문/Noun,17,12,5,0.00015560742469712126,7.774495213132233e-05,0.7058823529411765
4994,7571,라가/Noun,17,5,12,7.780371234856063e-05,0.00015548990426264466,0.7058823529411765
4995,7572,해바라기/Noun,17,5,12,7.780371234856063e-05,0.00015548990426264466,0.7058823529411765
4996,7573,이보영/Noun,17,12,5,0.00015560742469712126,7.774495213132233e-05,0.7058823529411765
4997,7574,클로즈업/Noun,17,5,12,7.780371234856063e-05,0.00015548990426264466,0.7058823529411765
4998,7575,!!!!!!!!!!!!!!/Punctuation,17,11,6,0.0001444926086473269,8.885137386436837e-05,0.6470588235294118
4999,7576,92년/Number,17,11,6,0.0001444926086473269,8.885137386436837e-05,0.6470588235294118
5000,7577,판빙빙/Noun,17,6,11,8.891852839835501e-05,0.0001443834825295986,0.6470588235294118
5001,7578,끝없이/Adverb,17,11,6,0.0001444926086473269,8.885137386436837e-05,0.6470588235294118
5002,7579,영향력/Noun,17,11,6,0.0001444926086473269,8.885137386436837e-05,0.6470588235294118
5003,7580,한류/Noun,17,6,11,8.891852839835501e-05,0.0001443834825295986,0.6470588235294118
5004,7581,몇몇/Modifier,17,6,11,8.891852839835501e-05,0.0001443834825295986,0.6470588235294118
5005,7582,내심/Noun,17,6,11,8.891852839835501e-05,0.0001443834825295986,0.6470588235294118
5006,7583,도발/Noun,17,6,11,8.891852839835501e-05,0.0001443834825295986,0.6470588235294118
5007,7584,어나/Modifier,17,6,11,8.891852839835501e-05,0.0001443834825295986,0.6470588235294118
5008,7585,서영희/Noun,17,11,6,0.0001444926086473269,8.885137386436837e-05,0.6470588235294118
5009,7586,세계대전/Noun,17,6,11,8.891852839835501e-05,0.0001443834825295986,0.6470588235294118
5010,7587,투신/Noun,17,11,6,0.0001444926086473269,8.885137386436837e-05,0.6470588235294118
5011,7588,VOD/Alpha,17,6,11,8.891852839835501e-05,0.0001443834825295986,0.6470588235294118
5012,7589,민감하다/Adjective,17,6,11,8.891852839835501e-05,0.0001443834825295986,0.6470588235294118
5013,7590,정경호/Noun,17,11,6,0.0001444926086473269,8.885137386436837e-05,0.6470588235294118
5014,7591,You/Alpha,17,11,6,0.0001444926086473269,8.885137386436837e-05,0.6470588235294118
5015,7592,휴대폰/Noun,17,6,11,8.891852839835501e-05,0.0001443834825295986,0.6470588235294118
5016,7593,인디영화/Noun,17,6,11,8.891852839835501e-05,0.0001443834825295986,0.6470588235294118
5017,7594,94년/Number,17,11,6,0.0001444926086473269,8.885137386436837e-05,0.6470588235294118
5018,7595,가격/Noun,17,6,11,8.891852839835501e-05,0.0001443834825295986,0.6470588235294118
5019,7596,사투/Noun,17,11,6,0.0001444926086473269,8.885137386436837e-05,0.6470588235294118
5020,7597,초한지/Noun,17,11,6,0.0001444926086473269,8.885137386436837e-05,0.6470588235294118
5021,7598,십/Noun,17,6,11,8.891852839835501e-05,0.0001443834825295986,0.6470588235294118
5022,7599,훨신/Noun,17,6,11,8.891852839835501e-05,0.0001443834825295986,0.6470588235294118
5023,7600,장안/Noun,17,6,11,8.891852839835501e-05,0.0001443834825295986,0.6470588235294118
5024,7601,자동/Noun,17,6,11,8.891852839835501e-05,0.0001443834825295986,0.6470588235294118
5025,7602,대명사/Noun,17,11,6,0.0001444926086473269,8.885137386436837e-05,0.6470588235294118
5026,7603,이명박/Noun,17,6,11,8.891852839835501e-05,0.0001443834825295986,0.6470588235294118
5027,7604,은영/Noun,17,6,11,8.891852839835501e-05,0.0001443834825295986,0.6470588235294118
5028,7605,사색/Noun,17,11,6,0.0001444926086473269,8.885137386436837e-05,0.6470588235294118
5029,7606,요괴/Noun,17,11,6,0.0001444926086473269,8.885137386436837e-05,0.6470588235294118
5030,7607,발킬머/Noun,17,11,6,0.0001444926086473269,8.885137386436837e-05,0.6470588235294118
5031,7608,하녀/Noun,17,6,11,8.891852839835501e-05,0.0001443834825295986,0.6470588235294118
5032,7609,디지털/Noun,17,6,11,8.891852839835501e-05,0.0001443834825295986,0.6470588235294118
5033,7610,옆집/Noun,17,6,11,8.891852839835501e-05,0.0001443834825295986,0.6470588235294118
5034,7611,후후/Exclamation,17,11,6,0.0001444926086473269,8.885137386436837e-05,0.6470588235294118
5035,7612,차이나다/Verb,17,6,11,8.891852839835501e-05,0.0001443834825295986,0.6470588235294118
5036,7613,뒷이야기/Noun,17,11,6,0.0001444926086473269,8.885137386436837e-05,0.6470588235294118
5037,7614,김지수/Noun,17,11,6,0.0001444926086473269,8.885137386436837e-05,0.6470588235294118
5038,7615,올드/Noun,17,6,11,8.891852839835501e-05,0.0001443834825295986,0.6470588235294118
5039,7616,툭/Noun,17,6,11,8.891852839835501e-05,0.0001443834825295986,0.6470588235294118
5040,7617,일로/Noun,17,6,11,8.891852839835501e-05,0.0001443834825295986,0.6470588235294118
5041,7618,사이먼/Noun,17,11,6,0.0001444926086473269,8.885137386436837e-05,0.6470588235294118
5042,7619,카이/Noun,17,11,6,0.0001444926086473269,8.885137386436837e-05,0.6470588235294118
5043,7700,ㅁㅈㅎ/KoreanParticle,16,0,16,2.2229632099588756e-05,0.00019991559119482882,1.0
5044,7701,이뭐병/Noun,16,0,16,2.2229632099588756e-05,0.00019991559119482882,1.0
5045,7702,코끝/Noun,16,16,0,0.0002000666888962988,2.2212843466092093e-05,1.0
5046,7703,루고/Noun,16,0,16,2.2229632099588756e-05,0.00019991559119482882,1.0
5047,7704,감격/Noun,16,16,0,0.0002000666888962988,2.2212843466092093e-05,1.0
5048,7705,bbbb/Alpha,16,16,0,0.0002000666888962988,2.2212843466092093e-05,1.0
5049,7706,박하/Noun,16,16,0,0.0002000666888962988,2.2212843466092093e-05,1.0
5050,7707,좆망/Noun,16,1,15,3.334444814938313e-05,0.0001888091694617828,0.9375
5051,7708,찰스/Noun,16,15,1,0.00018895187284650438,3.331926519913814e-05,0.9375
5052,7709,상술/Noun,16,1,15,3.334444814938313e-05,0.0001888091694617828,0.9375
5053,7710,넘침/Noun,16,15,1,0.00018895187284650438,3.331926519913814e-05,0.9375
5054,7711,공군/Noun,16,1,15,3.334444814938313e-05,0.0001888091694617828,0.9375
5055,7712,모도/Noun,16,15,1,0.00018895187284650438,3.331926519913814e-05,0.9375
5056,7713,짱깨/Noun,16,1,15,3.334444814938313e-05,0.0001888091694617828,0.9375
5057,7714,씌우다/Verb,16,1,15,3.334444814938313e-05,0.0001888091694617828,0.9375
5058,7715,am/Alpha,16,15,1,0.00018895187284650438,3.331926519913814e-05,0.9375
5059,7716,빙자/Noun,16,1,15,3.334444814938313e-05,0.0001888091694617828,0.9375
5060,7717,윤재/Noun,16,1,15,3.334444814938313e-05,0.0001888091694617828,0.9375
5061,7718,얼렁뚱땅/Noun,16,1,15,3.334444814938313e-05,0.0001888091694617828,0.9375
5062,7719,하비에르/Noun,16,15,1,0.00018895187284650438,3.331926519913814e-05,0.9375
5063,7720,표지/Noun,16,2,14,4.445926419917751e-05,0.00017770274772873674,0.875
5064,7721,부추기다/Verb,16,2,14,4.445926419917751e-05,0.00017770274772873674,0.875
5065,7722,전과/Noun,16,14,2,0.00017783705679671002,4.4425686932184186e-05,0.875
5066,7723,우수/Noun,16,14,2,0.00017783705679671002,4.4425686932184186e-05,0.875
5067,7724,샤크/Noun,16,2,14,4.445926419917751e-05,0.00017770274772873674,0.875
5068,7725,과소/Noun,16,14,2,0.00017783705679671002,4.4425686932184186e-05,0.875
5069,7726,신중하다/Adjective,16,2,14,4.445926419917751e-05,0.00017770274772873674,0.875
5070,7727,유부/Noun,16,2,14,4.445926419917751e-05,0.00017770274772873674,0.875
5071,7728,돌아이/Noun,16,2,14,4.445926419917751e-05,0.00017770274772873674,0.875
5072,7729,!!!!!!!!!!/Punctuation,16,14,2,0.00017783705679671002,4.4425686932184186e-05,0.875
5073,7730,프렌즈/Noun,16,14,2,0.00017783705679671002,4.4425686932184186e-05,0.875
5074,7731,사죄/Noun,16,2,14,4.445926419917751e-05,0.00017770274772873674,0.875
5075,7732,어렴풋이/Adverb,16,14,2,0.00017783705679671002,4.4425686932184186e-05,0.875
5076,7733,막연하다/Adjective,16,14,2,0.00017783705679671002,4.4425686932184186e-05,0.875
5077,7734,값지다/Adjective,16,14,2,0.00017783705679671002,4.4425686932184186e-05,0.875
5078,7735,수박/Noun,16,2,14,4.445926419917751e-05,0.00017770274772873674,0.875
5079,7736,찌꺼기/Noun,16,2,14,4.445926419917751e-05,0.00017770274772873674,0.875
5080,7737,사먹다/Verb,16,2,14,4.445926419917751e-05,0.00017770274772873674,0.875
5081,7738,벗/Noun,16,2,14,4.445926419917751e-05,0.00017770274772873674,0.875
5082,7739,타겟/Noun,16,2,14,4.445926419917751e-05,0.00017770274772873674,0.875
5083,7740,직설/Noun,16,14,2,0.00017783705679671002,4.4425686932184186e-05,0.875
5084,7741,볼품/Noun,16,2,14,4.445926419917751e-05,0.00017770274772873674,0.875
5085,7742,sm/Alpha,16,2,14,4.445926419917751e-05,0.00017770274772873674,0.875
5086,7743,쓰시/Noun,16,3,13,5.5574080248971876e-05,0.0001665963259956907,0.8125
5087,7744,야마카시/Noun,16,3,13,5.5574080248971876e-05,0.0001665963259956907,0.8125
5088,7745,훈훈/Noun,16,13,3,0.00016672224074691566,5.553210866523024e-05,0.8125
5089,7746,지리하다/Adjective,16,3,13,5.5574080248971876e-05,0.0001665963259956907,0.8125
5090,7747,김아중/Noun,16,13,3,0.00016672224074691566,5.553210866523024e-05,0.8125
5091,7748,연성/Noun,16,3,13,5.5574080248971876e-05,0.0001665963259956907,0.8125
5092,7749,여학생/Noun,16,3,13,5.5574080248971876e-05,0.0001665963259956907,0.8125
5093,7750,찔끔/Adverb,16,13,3,0.00016672224074691566,5.553210866523024e-05,0.8125
5094,7751,개무시/Noun,16,3,13,5.5574080248971876e-05,0.0001665963259956907,0.8125
5095,7752,하트넷/Noun,16,13,3,0.00016672224074691566,5.553210866523024e-05,0.8125
5096,7753,;;;;;;/Punctuation,16,3,13,5.5574080248971876e-05,0.0001665963259956907,0.8125
5097,7754,입사/Noun,16,3,13,5.5574080248971876e-05,0.0001665963259956907,0.8125
5098,7755,지혜/Noun,16,13,3,0.00016672224074691566,5.553210866523024e-05,0.8125
5099,7756,살의/Noun,16,13,3,0.00016672224074691566,5.553210866523024e-05,0.8125
5100,7757,리나/Noun,16,3,13,5.5574080248971876e-05,0.0001665963259956907,0.8125
5101,7758,황정음/Noun,16,13,3,0.00016672224074691566,5.553210866523024e-05,0.8125
5102,7759,강정/Noun,16,3,13,5.5574080248971876e-05,0.0001665963259956907,0.8125
5103,7760,방화/Noun,16,3,13,5.5574080248971876e-05,0.0001665963259956907,0.8125
5104,7761,색기/Noun,16,3,13,5.5574080248971876e-05,0.0001665963259956907,0.8125
5105,7762,현기증/Noun,16,13,3,0.00016672224074691566,5.553210866523024e-05,0.8125
5106,7763,갈피/Noun,16,3,13,5.5574080248971876e-05,0.0001665963259956907,0.8125
5107,7764,차려/Noun,16,3,13,5.5574080248971876e-05,0.0001665963259956907,0.8125
5108,7765,이시영/Noun,16,13,3,0.00016672224074691566,5.553210866523024e-05,0.8125
5109,7766,퇴/Noun,16,3,13,5.5574080248971876e-05,0.0001665963259956907,0.8125
5110,7767,불허/Noun,16,13,3,0.00016672224074691566,5.553210866523024e-05,0.8125
5111,7768,배틀로얄/Noun,16,3,13,5.5574080248971876e-05,0.0001665963259956907,0.8125
5112,7769,국민학교/Noun,16,13,3,0.00016672224074691566,5.553210866523024e-05,0.8125
5113,7770,무당/Noun,16,3,13,5.5574080248971876e-05,0.0001665963259956907,0.8125
5114,7771,유동근/Noun,16,13,3,0.00016672224074691566,5.553210866523024e-05,0.8125
5115,7772,매염방/Noun,16,12,4,0.00015560742469712126,6.663853039827628e-05,0.75
5116,7773,꼬박꼬박/Noun,16,12,4,0.00015560742469712126,6.663853039827628e-05,0.75
5117,7774,넘버원/Noun,16,12,4,0.00015560742469712126,6.663853039827628e-05,0.75
5118,7775,쥑/Noun,16,12,4,0.00015560742469712126,6.663853039827628e-05,0.75
5119,7776,사무엘/Noun,16,12,4,0.00015560742469712126,6.663853039827628e-05,0.75
5120,7777,be/Alpha,16,12,4,0.00015560742469712126,6.663853039827628e-05,0.75
5121,7778,자폐/Noun,16,4,12,6.668889629876625e-05,0.00015548990426264466,0.75
5122,7779,빠돌이/Noun,16,4,12,6.668889629876625e-05,0.00015548990426264466,0.75
5123,7780,세기말/Noun,16,12,4,0.00015560742469712126,6.663853039827628e-05,0.75
5124,7781,김지운/Noun,16,12,4,0.00015560742469712126,6.663853039827628e-05,0.75
5125,7782,럼/Noun,16,4,12,6.668889629876625e-05,0.00015548990426264466,0.75
5126,7783,_-/Punctuation,16,4,12,6.668889629876625e-05,0.00015548990426264466,0.75
5127,7784,화구/Noun,16,4,12,6.668889629876625e-05,0.00015548990426264466,0.75
5128,7785,가물가물/Adverb,16,12,4,0.00015560742469712126,6.663853039827628e-05,0.75
5129,7786,1995년/Number,16,12,4,0.00015560742469712126,6.663853039827628e-05,0.75
5130,7787,-_-;;;/Punctuation,16,4,12,6.668889629876625e-05,0.00015548990426264466,0.75
5131,7788,한채영/Noun,16,4,12,6.668889629876625e-05,0.00015548990426264466,0.75
5132,7789,연속극/Noun,16,4,12,6.668889629876625e-05,0.00015548990426264466,0.75
5133,7790,뜻밖/Noun,16,12,4,0.00015560742469712126,6.663853039827628e-05,0.75
5134,7791,손녀/Noun,16,4,12,6.668889629876625e-05,0.00015548990426264466,0.75
5135,7792,상품/Noun,16,4,12,6.668889629876625e-05,0.00015548990426264466,0.75
5136,7793,장엄하다/Adjective,16,12,4,0.00015560742469712126,6.663853039827628e-05,0.75
5137,7794,꼽으라/Noun,16,12,4,0.00015560742469712126,6.663853039827628e-05,0.75
5138,7795,앙상블/Noun,16,12,4,0.00015560742469712126,6.663853039827628e-05,0.75
5139,7796,피닉스/Noun,16,12,4,0.00015560742469712126,6.663853039827628e-05,0.75
5140,7797,건축/Noun,16,12,4,0.00015560742469712126,6.663853039827628e-05,0.75
5141,7798,알콩달콩/Noun,16,12,4,0.00015560742469712126,6.663853039827628e-05,0.75
5142,7799,개쩜/Noun,16,12,4,0.00015560742469712126,6.663853039827628e-05,0.75
5143,7800,두기/Noun,16,12,4,0.00015560742469712126,6.663853039827628e-05,0.75
5144,7801,...??/Punctuation,16,4,12,6.668889629876625e-05,0.00015548990426264466,0.75
5145,7802,시내/Noun,16,4,12,6.668889629876625e-05,0.00015548990426264466,0.75
5146,7803,김상경/Noun,16,12,4,0.00015560742469712126,6.663853039827628e-05,0.75
5147,7804,우기/Noun,16,4,12,6.668889629876625e-05,0.00015548990426264466,0.75
5148,7805,숙제/Noun,16,12,4,0.00015560742469712126,6.663853039827628e-05,0.75
5149,7806,"...""/Punctuation",16,4,12,6.668889629876625e-05,0.00015548990426264466,0.75
5150,7807,설계/Noun,16,4,12,6.668889629876625e-05,0.00015548990426264466,0.75
5151,7808,베댓/Noun,16,4,12,6.668889629876625e-05,0.00015548990426264466,0.75
5152,7809,불편/Noun,16,4,12,6.668889629876625e-05,0.00015548990426264466,0.75
5153,7810,코메/Noun,16,4,12,6.668889629876625e-05,0.00015548990426264466,0.75
5154,7811,바리/Noun,16,4,12,6.668889629876625e-05,0.00015548990426264466,0.75
5155,7812,파커/Noun,16,12,4,0.00015560742469712126,6.663853039827628e-05,0.75
5156,7813,십분/Noun,16,4,12,6.668889629876625e-05,0.00015548990426264466,0.75
5157,7814,바둑/Noun,16,4,12,6.668889629876625e-05,0.00015548990426264466,0.75
5158,7815,제압/Noun,16,4,12,6.668889629876625e-05,0.00015548990426264466,0.75
5159,7816,집어치우다/Verb,16,4,12,6.668889629876625e-05,0.00015548990426264466,0.75
5160,7817,치의/Noun,16,12,4,0.00015560742469712126,6.663853039827628e-05,0.75
5161,7818,간혹/Noun,16,5,11,7.780371234856063e-05,0.0001443834825295986,0.6875
5162,7819,힘차다/Adjective,16,5,11,7.780371234856063e-05,0.0001443834825295986,0.6875
5163,7820,맥과이어/Noun,16,11,5,0.0001444926086473269,7.774495213132233e-05,0.6875
5164,7821,쉐프/Noun,16,5,11,7.780371234856063e-05,0.0001443834825295986,0.6875
5165,7822,민영화/Noun,16,11,5,0.0001444926086473269,7.774495213132233e-05,0.6875
5166,7823,외설/Noun,16,5,11,7.780371234856063e-05,0.0001443834825295986,0.6875
5167,7824,도서관/Noun,16,11,5,0.0001444926086473269,7.774495213132233e-05,0.6875
5168,7825,나마/Noun,16,11,5,0.0001444926086473269,7.774495213132233e-05,0.6875
5169,7826,후딱/Adverb,16,11,5,0.0001444926086473269,7.774495213132233e-05,0.6875
5170,7827,도둑질/Noun,16,5,11,7.780371234856063e-05,0.0001443834825295986,0.6875
5171,7828,일과/Noun,16,11,5,0.0001444926086473269,7.774495213132233e-05,0.6875
5172,7829,다다/Noun,16,5,11,7.780371234856063e-05,0.0001443834825295986,0.6875
5173,7830,혼합/Noun,16,5,11,7.780371234856063e-05,0.0001443834825295986,0.6875
5174,7831,끈끈/Noun,16,11,5,0.0001444926086473269,7.774495213132233e-05,0.6875
5175,7832,사위/Noun,16,5,11,7.780371234856063e-05,0.0001443834825295986,0.6875
5176,7833,타고나다/Verb,16,11,5,0.0001444926086473269,7.774495213132233e-05,0.6875
5177,7834,TOP/Alpha,16,11,5,0.0001444926086473269,7.774495213132233e-05,0.6875
5178,7835,괴리감/Noun,16,5,11,7.780371234856063e-05,0.0001443834825295986,0.6875
5179,7836,지로/Noun,16,5,11,7.780371234856063e-05,0.0001443834825295986,0.6875
5180,7837,확장/Noun,16,11,5,0.0001444926086473269,7.774495213132233e-05,0.6875
5181,7838,김민정/Noun,16,11,5,0.0001444926086473269,7.774495213132233e-05,0.6875
5182,7839,세포/Noun,16,11,5,0.0001444926086473269,7.774495213132233e-05,0.6875
5183,7840,시티/Noun,16,11,5,0.0001444926086473269,7.774495213132233e-05,0.6875
5184,7841,이영애/Noun,16,11,5,0.0001444926086473269,7.774495213132233e-05,0.6875
5185,7842,줄어들다/Verb,16,11,5,0.0001444926086473269,7.774495213132233e-05,0.6875
5186,7843,대회/Noun,16,5,11,7.780371234856063e-05,0.0001443834825295986,0.6875
5187,7844,똥파리/Noun,16,5,11,7.780371234856063e-05,0.0001443834825295986,0.6875
5188,7845,극우/Noun,16,5,11,7.780371234856063e-05,0.0001443834825295986,0.6875
5189,7846,곽경택/Noun,16,5,11,7.780371234856063e-05,0.0001443834825295986,0.6875
5190,7847,세로/Noun,16,5,11,7.780371234856063e-05,0.0001443834825295986,0.6875
5191,7848,수출/Noun,16,5,11,7.780371234856063e-05,0.0001443834825295986,0.6875
5192,7849,쌀/Noun,16,11,5,0.0001444926086473269,7.774495213132233e-05,0.6875
5193,7850,겜/Noun,16,11,5,0.0001444926086473269,7.774495213132233e-05,0.6875
5194,7851,고정관념/Noun,16,11,5,0.0001444926086473269,7.774495213132233e-05,0.6875
5195,7852,치도/Noun,16,11,5,0.0001444926086473269,7.774495213132233e-05,0.6875
5196,7853,민중/Noun,16,11,5,0.0001444926086473269,7.774495213132233e-05,0.6875
5197,7854,고하/Noun,16,5,11,7.780371234856063e-05,0.0001443834825295986,0.6875
5198,7855,23/Number,16,11,5,0.0001444926086473269,7.774495213132233e-05,0.6875
5199,7856,으아아/Exclamation,16,5,11,7.780371234856063e-05,0.0001443834825295986,0.6875
5200,7857,오마이갓/Noun,16,5,11,7.780371234856063e-05,0.0001443834825295986,0.6875
5201,7858,효과음/Noun,16,5,11,7.780371234856063e-05,0.0001443834825295986,0.6875
5202,7859,모조리/Noun,16,5,11,7.780371234856063e-05,0.0001443834825295986,0.6875
5203,7860,쇼생크탈출/Noun,16,11,5,0.0001444926086473269,7.774495213132233e-05,0.6875
5204,7861,닐/Noun,16,10,6,0.0001333777925975325,8.885137386436837e-05,0.625
5205,7862,여느/Noun,16,10,6,0.0001333777925975325,8.885137386436837e-05,0.625
5206,7863,깨우치다/Verb,16,10,6,0.0001333777925975325,8.885137386436837e-05,0.625
5207,7864,밭/Noun,16,10,6,0.0001333777925975325,8.885137386436837e-05,0.625
5208,7865,안전/Noun,16,6,10,8.891852839835501e-05,0.00013327706079655256,0.625
5209,7866,라디오스타/Noun,16,6,10,8.891852839835501e-05,0.00013327706079655256,0.625
5210,7867,억/Suffix,16,10,6,0.0001333777925975325,8.885137386436837e-05,0.625
5211,7868,정무문/Noun,16,10,6,0.0001333777925975325,8.885137386436837e-05,0.625
5212,7869,오시/Noun,16,6,10,8.891852839835501e-05,0.00013327706079655256,0.625
5213,7870,였음/Eomi,16,6,10,8.891852839835501e-05,0.00013327706079655256,0.625
5214,7871,차용/Noun,16,6,10,8.891852839835501e-05,0.00013327706079655256,0.625
5215,7872,라디오/Noun,16,10,6,0.0001333777925975325,8.885137386436837e-05,0.625
5216,7873,내포/Noun,16,10,6,0.0001333777925975325,8.885137386436837e-05,0.625
5217,7874,병들다/Verb,16,6,10,8.891852839835501e-05,0.00013327706079655256,0.625
5218,7875,마법사/Noun,16,10,6,0.0001333777925975325,8.885137386436837e-05,0.625
5219,7876,소지/Noun,16,6,10,8.891852839835501e-05,0.00013327706079655256,0.625
5220,7877,포켓몬스터/Noun,16,10,6,0.0001333777925975325,8.885137386436837e-05,0.625
5221,7878,어르신/Noun,16,10,6,0.0001333777925975325,8.885137386436837e-05,0.625
5222,7879,가방/Noun,16,6,10,8.891852839835501e-05,0.00013327706079655256,0.625
5223,7880,미사/Noun,16,10,6,0.0001333777925975325,8.885137386436837e-05,0.625
5224,7881,샤론/Noun,16,6,10,8.891852839835501e-05,0.00013327706079655256,0.625
5225,7882,메이킹/Noun,16,6,10,8.891852839835501e-05,0.00013327706079655256,0.625
5226,7883,복습/Noun,16,10,6,0.0001333777925975325,8.885137386436837e-05,0.625
5227,7884,죄인/Noun,16,6,10,8.891852839835501e-05,0.00013327706079655256,0.625
5228,7885,점줄/Noun,16,6,10,8.891852839835501e-05,0.00013327706079655256,0.625
5229,7886,소심하다/Adjective,16,6,10,8.891852839835501e-05,0.00013327706079655256,0.625
5230,7887,v/Alpha,16,6,10,8.891852839835501e-05,0.00013327706079655256,0.625
5231,7888,뮬란/Noun,16,10,6,0.0001333777925975325,8.885137386436837e-05,0.625
5232,7889,찍어내다/Verb,16,6,10,8.891852839835501e-05,0.00013327706079655256,0.625
5233,7890,저스틴/Noun,16,6,10,8.891852839835501e-05,0.00013327706079655256,0.625
5234,7891,요시/Noun,16,6,10,8.891852839835501e-05,0.00013327706079655256,0.625
5235,7892,도리/Noun,16,10,6,0.0001333777925975325,8.885137386436837e-05,0.625
5236,7893,각종/Noun,16,10,6,0.0001333777925975325,8.885137386436837e-05,0.625
5237,7894,도달/Noun,16,6,10,8.891852839835501e-05,0.00013327706079655256,0.625
5238,7895,거꾸로/Noun,16,6,10,8.891852839835501e-05,0.00013327706079655256,0.625
5239,7896,슬/Noun,16,10,6,0.0001333777925975325,8.885137386436837e-05,0.625
5240,7897,알라/Noun,16,10,6,0.0001333777925975325,8.885137386436837e-05,0.625
5241,7898,라던가/Josa,16,6,10,8.891852839835501e-05,0.00013327706079655256,0.625
5242,7899,폭스/Noun,16,10,6,0.0001333777925975325,8.885137386436837e-05,0.625
5243,7900,사탄/Noun,16,6,10,8.891852839835501e-05,0.00013327706079655256,0.625
5244,7901,약해지다/Verb,16,6,10,8.891852839835501e-05,0.00013327706079655256,0.625
5245,7902,저걸/Noun,16,6,10,8.891852839835501e-05,0.00013327706079655256,0.625
5246,7903,엘/Josa,16,10,6,0.0001333777925975325,8.885137386436837e-05,0.625
5247,7904,자임/Noun,16,6,10,8.891852839835501e-05,0.00013327706079655256,0.625
5248,7905,앨런/Noun,16,10,6,0.0001333777925975325,8.885137386436837e-05,0.625
5249,7906,랫/Noun,16,6,10,8.891852839835501e-05,0.00013327706079655256,0.625
5250,7907,딸도/Noun,16,6,10,8.891852839835501e-05,0.00013327706079655256,0.625
5251,7908,외도/Noun,16,6,10,8.891852839835501e-05,0.00013327706079655256,0.625
5252,7909,후련하다/Adjective,16,10,6,0.0001333777925975325,8.885137386436837e-05,0.625
5253,7910,출생/Noun,16,6,10,8.891852839835501e-05,0.00013327706079655256,0.625
5254,7911,차고/Noun,16,6,10,8.891852839835501e-05,0.00013327706079655256,0.625
5255,7985,다임/Noun,15,0,15,2.2229632099588756e-05,0.0001888091694617828,1.0
5256,7986,감회/Noun,15,15,0,0.00018895187284650438,2.2212843466092093e-05,1.0
5257,7987,리좀/Noun,15,0,15,2.2229632099588756e-05,0.0001888091694617828,1.0
5258,7988,이상자/Noun,15,0,15,2.2229632099588756e-05,0.0001888091694617828,1.0
5259,7989,이수정/Noun,15,0,15,2.2229632099588756e-05,0.0001888091694617828,1.0
5260,7990,어루만지다/Verb,15,15,0,0.00018895187284650438,2.2212843466092093e-05,1.0
5261,7991,보다가/Foreign,15,0,15,2.2229632099588756e-05,0.0001888091694617828,1.0
5262,7992,왕정/Noun,15,0,15,2.2229632099588756e-05,0.0001888091694617828,1.0
5263,7993,폭풍눈물/Noun,15,15,0,0.00018895187284650438,2.2212843466092093e-05,1.0
5264,7994,착오/Noun,15,0,15,2.2229632099588756e-05,0.0001888091694617828,1.0
5265,7995,밋/Noun,15,15,0,0.00018895187284650438,2.2212843466092093e-05,1.0
5266,7996,대자연/Noun,15,15,0,0.00018895187284650438,2.2212843466092093e-05,1.0
5267,7997,중국산/Noun,15,0,15,2.2229632099588756e-05,0.0001888091694617828,1.0
5268,7998,잼슴/Noun,15,14,1,0.00017783705679671002,3.331926519913814e-05,0.9333333333333332
5269,7999,설마설마/Adverb,15,1,14,3.334444814938313e-05,0.00017770274772873674,0.9333333333333332
5270,8000,핫세/Noun,15,14,1,0.00017783705679671002,3.331926519913814e-05,0.9333333333333332
5271,8001,넣기/Noun,15,1,14,3.334444814938313e-05,0.00017770274772873674,0.9333333333333332
5272,8002,음미/Noun,15,14,1,0.00017783705679671002,3.331926519913814e-05,0.9333333333333332
5273,8003,boring/Alpha,15,1,14,3.334444814938313e-05,0.00017770274772873674,0.9333333333333332
5274,8004,아포칼립토/Noun,15,1,14,3.334444814938313e-05,0.00017770274772873674,0.9333333333333332
5275,8005,잘봣어/Noun,15,14,1,0.00017783705679671002,3.331926519913814e-05,0.9333333333333332
5276,8006,신소율/Noun,15,1,14,3.334444814938313e-05,0.00017770274772873674,0.9333333333333332
5277,8007,더티/Noun,15,1,14,3.334444814938313e-05,0.00017770274772873674,0.9333333333333332
5278,8008,무능력하다/Adjective,15,1,14,3.334444814938313e-05,0.00017770274772873674,0.9333333333333332
5279,8009,대소/Noun,15,14,1,0.00017783705679671002,3.331926519913814e-05,0.9333333333333332
5280,8010,성관계/Noun,15,1,14,3.334444814938313e-05,0.00017770274772873674,0.9333333333333332
5281,8011,핥다/Verb,15,1,14,3.334444814938313e-05,0.00017770274772873674,0.9333333333333332
5282,8012,보듬다/Verb,15,14,1,0.00017783705679671002,3.331926519913814e-05,0.9333333333333332
5283,8013,Best/Alpha,15,14,1,0.00017783705679671002,3.331926519913814e-05,0.9333333333333332
5284,8014,반했어/Noun,15,14,1,0.00017783705679671002,3.331926519913814e-05,0.9333333333333332
5285,8015,호모/Noun,15,1,14,3.334444814938313e-05,0.00017770274772873674,0.9333333333333332
5286,8016,로치/Noun,15,14,1,0.00017783705679671002,3.331926519913814e-05,0.9333333333333332
5287,8017,아른거리다/Verb,15,14,1,0.00017783705679671002,3.331926519913814e-05,0.9333333333333332
5288,8018,리슨/Noun,15,13,2,0.00016672224074691566,4.4425686932184186e-05,0.8666666666666667
5289,8019,참되다/Adjective,15,13,2,0.00016672224074691566,4.4425686932184186e-05,0.8666666666666667
5290,8020,아청법/Noun,15,2,13,4.445926419917751e-05,0.0001665963259956907,0.8666666666666667
5291,8021,편승/Noun,15,2,13,4.445926419917751e-05,0.0001665963259956907,0.8666666666666667
5292,8022,도현/Noun,15,2,13,4.445926419917751e-05,0.0001665963259956907,0.8666666666666667
5293,8023,버겁다/Adjective,15,2,13,4.445926419917751e-05,0.0001665963259956907,0.8666666666666667
5294,8024,잡다하다/Adjective,15,2,13,4.445926419917751e-05,0.0001665963259956907,0.8666666666666667
5295,8025,귀여니/Noun,15,2,13,4.445926419917751e-05,0.0001665963259956907,0.8666666666666667
5296,8026,오지랖/Noun,15,2,13,4.445926419917751e-05,0.0001665963259956907,0.8666666666666667
5297,8027,노년/Noun,15,13,2,0.00016672224074691566,4.4425686932184186e-05,0.8666666666666667
5298,8028,헬/Noun,15,2,13,4.445926419917751e-05,0.0001665963259956907,0.8666666666666667
5299,8029,조사/Noun,15,2,13,4.445926419917751e-05,0.0001665963259956907,0.8666666666666667
5300,8030,나니아/Noun,15,13,2,0.00016672224074691566,4.4425686932184186e-05,0.8666666666666667
5301,8031,위력/Noun,15,13,2,0.00016672224074691566,4.4425686932184186e-05,0.8666666666666667
5302,8032,우어/Noun,15,13,2,0.00016672224074691566,4.4425686932184186e-05,0.8666666666666667
5303,8033,쒯/Noun,15,2,13,4.445926419917751e-05,0.0001665963259956907,0.8666666666666667
5304,8034,투영/Noun,15,13,2,0.00016672224074691566,4.4425686932184186e-05,0.8666666666666667
5305,8035,임상수/Noun,15,2,13,4.445926419917751e-05,0.0001665963259956907,0.8666666666666667
5306,8036,워스트/Noun,15,2,13,4.445926419917751e-05,0.0001665963259956907,0.8666666666666667
5307,8037,히로/Noun,15,13,2,0.00016672224074691566,4.4425686932184186e-05,0.8666666666666667
5308,8038,박아/Noun,15,2,13,4.445926419917751e-05,0.0001665963259956907,0.8666666666666667
5309,8039,도신/Noun,15,2,13,4.445926419917751e-05,0.0001665963259956907,0.8666666666666667
5310,8040,사족/Noun,15,2,13,4.445926419917751e-05,0.0001665963259956907,0.8666666666666667
5311,8041,챔피언/Noun,15,13,2,0.00016672224074691566,4.4425686932184186e-05,0.8666666666666667
5312,8042,무차별/Noun,15,2,13,4.445926419917751e-05,0.0001665963259956907,0.8666666666666667
5313,8043,;;;;;/Punctuation,15,2,13,4.445926419917751e-05,0.0001665963259956907,0.8666666666666667
5314,8044,발매/Noun,15,13,2,0.00016672224074691566,4.4425686932184186e-05,0.8666666666666667
5315,8045,독수리/Noun,15,2,13,4.445926419917751e-05,0.0001665963259956907,0.8666666666666667
5316,8046,무관/Noun,15,2,13,4.445926419917751e-05,0.0001665963259956907,0.8666666666666667
5317,8047,연예계/Noun,15,2,13,4.445926419917751e-05,0.0001665963259956907,0.8666666666666667
5318,8048,소망/Noun,15,13,2,0.00016672224074691566,4.4425686932184186e-05,0.8666666666666667
5319,8049,차예련/Noun,15,2,13,4.445926419917751e-05,0.0001665963259956907,0.8666666666666667
5320,8050,안무/Noun,15,2,13,4.445926419917751e-05,0.0001665963259956907,0.8666666666666667
5321,8051,장학우/Noun,15,12,3,0.00015560742469712126,5.553210866523024e-05,0.8
5322,8052,분만/Noun,15,3,12,5.5574080248971876e-05,0.00015548990426264466,0.8
5323,8053,누드/Noun,15,3,12,5.5574080248971876e-05,0.00015548990426264466,0.8
5324,8054,다지/Noun,15,3,12,5.5574080248971876e-05,0.00015548990426264466,0.8
5325,8055,자칭/Noun,15,3,12,5.5574080248971876e-05,0.00015548990426264466,0.8
5326,8056,R/Alpha,15,12,3,0.00015560742469712126,5.553210866523024e-05,0.8
5327,8057,능력자/Noun,15,3,12,5.5574080248971876e-05,0.00015548990426264466,0.8
5328,8058,꿀잼임/Noun,15,12,3,0.00015560742469712126,5.553210866523024e-05,0.8
5329,8059,잠기다/Verb,15,12,3,0.00015560742469712126,5.553210866523024e-05,0.8
5330,8060,인양/Noun,15,3,12,5.5574080248971876e-05,0.00015548990426264466,0.8
5331,8061,지수/Noun,15,3,12,5.5574080248971876e-05,0.00015548990426264466,0.8
5332,8062,눈가/Noun,15,12,3,0.00015560742469712126,5.553210866523024e-05,0.8
5333,8063,카펜터/Noun,15,3,12,5.5574080248971876e-05,0.00015548990426264466,0.8
5334,8064,오버액션/Noun,15,3,12,5.5574080248971876e-05,0.00015548990426264466,0.8
5335,8065,가려진/Noun,15,12,3,0.00015560742469712126,5.553210866523024e-05,0.8
5336,8066,that/Alpha,15,12,3,0.00015560742469712126,5.553210866523024e-05,0.8
5337,8067,맴돈다/Verb,15,12,3,0.00015560742469712126,5.553210866523024e-05,0.8
5338,8068,노부/Noun,15,12,3,0.00015560742469712126,5.553210866523024e-05,0.8
5339,8069,정준하/Noun,15,3,12,5.5574080248971876e-05,0.00015548990426264466,0.8
5340,8070,사치/Noun,15,3,12,5.5574080248971876e-05,0.00015548990426264466,0.8
5341,8071,갈구다/Verb,15,12,3,0.00015560742469712126,5.553210866523024e-05,0.8
5342,8072,폭행/Noun,15,3,12,5.5574080248971876e-05,0.00015548990426264466,0.8
5343,8073,선명하다/Adjective,15,12,3,0.00015560742469712126,5.553210866523024e-05,0.8
5344,8074,황진이/Noun,15,12,3,0.00015560742469712126,5.553210866523024e-05,0.8
5345,8075,장하다/Adjective,15,3,12,5.5574080248971876e-05,0.00015548990426264466,0.8
5346,8076,티켓/Noun,15,3,12,5.5574080248971876e-05,0.00015548990426264466,0.8
5347,8077,장님/Noun,15,12,3,0.00015560742469712126,5.553210866523024e-05,0.8
5348,8078,세밀/Noun,15,12,3,0.00015560742469712126,5.553210866523024e-05,0.8
5349,8079,각본가/Noun,15,3,12,5.5574080248971876e-05,0.00015548990426264466,0.8
5350,8080,뿅/Adverb,15,12,3,0.00015560742469712126,5.553210866523024e-05,0.8
5351,8081,깊숙하다/Adjective,15,12,3,0.00015560742469712126,5.553210866523024e-05,0.8
5352,8082,버릇/Noun,15,4,11,6.668889629876625e-05,0.0001443834825295986,0.7333333333333333
5353,8083,혼신/Noun,15,11,4,0.0001444926086473269,6.663853039827628e-05,0.7333333333333333
5354,8084,토리/Noun,15,4,11,6.668889629876625e-05,0.0001443834825295986,0.7333333333333333
5355,8085,웅/Noun,15,11,4,0.0001444926086473269,6.663853039827628e-05,0.7333333333333333
5356,8086,로멘틱/Noun,15,11,4,0.0001444926086473269,6.663853039827628e-05,0.7333333333333333
5357,8087,격정/Noun,15,11,4,0.0001444926086473269,6.663853039827628e-05,0.7333333333333333
5358,8088,커다랗다/Adjective,15,11,4,0.0001444926086473269,6.663853039827628e-05,0.7333333333333333
5359,8089,불문/Noun,15,4,11,6.668889629876625e-05,0.0001443834825295986,0.7333333333333333
5360,8090,료/Noun,15,4,11,6.668889629876625e-05,0.0001443834825295986,0.7333333333333333
5361,8091,가발/Noun,15,4,11,6.668889629876625e-05,0.0001443834825295986,0.7333333333333333
5362,8092,걸어가다/Verb,15,11,4,0.0001444926086473269,6.663853039827628e-05,0.7333333333333333
5363,8093,고조/Noun,15,11,4,0.0001444926086473269,6.663853039827628e-05,0.7333333333333333
5364,8094,단언컨대/Noun,15,11,4,0.0001444926086473269,6.663853039827628e-05,0.7333333333333333
5365,8095,바람직하다/Adjective,15,11,4,0.0001444926086473269,6.663853039827628e-05,0.7333333333333333
5366,8096,꿈속/Noun,15,11,4,0.0001444926086473269,6.663853039827628e-05,0.7333333333333333
5367,8097,매달리다/Verb,15,4,11,6.668889629876625e-05,0.0001443834825295986,0.7333333333333333
5368,8098,모음/Noun,15,4,11,6.668889629876625e-05,0.0001443834825295986,0.7333333333333333
5369,8099,88년/Number,15,11,4,0.0001444926086473269,6.663853039827628e-05,0.7333333333333333
5370,8100,발끝/Noun,15,4,11,6.668889629876625e-05,0.0001443834825295986,0.7333333333333333
5371,8101,데스티네이션/Noun,15,4,11,6.668889629876625e-05,0.0001443834825295986,0.7333333333333333
5372,8102,편협/Noun,15,4,11,6.668889629876625e-05,0.0001443834825295986,0.7333333333333333
5373,8103,이하나/Noun,15,11,4,0.0001444926086473269,6.663853039827628e-05,0.7333333333333333
5374,8104,우애/Noun,15,11,4,0.0001444926086473269,6.663853039827628e-05,0.7333333333333333
5375,8105,썰전/Noun,15,4,11,6.668889629876625e-05,0.0001443834825295986,0.7333333333333333
5376,8106,비스트/Noun,15,11,4,0.0001444926086473269,6.663853039827628e-05,0.7333333333333333
5377,8107,are/Alpha,15,11,4,0.0001444926086473269,6.663853039827628e-05,0.7333333333333333
5378,8108,멘타리/Noun,15,4,11,6.668889629876625e-05,0.0001443834825295986,0.7333333333333333
5379,8109,깨달/Noun,15,11,4,0.0001444926086473269,6.663853039827628e-05,0.7333333333333333
5380,8110,쓸모없다/Adjective,15,4,11,6.668889629876625e-05,0.0001443834825295986,0.7333333333333333
5381,8111,루나/Noun,15,4,11,6.668889629876625e-05,0.0001443834825295986,0.7333333333333333
5382,8112,체감/Noun,15,11,4,0.0001444926086473269,6.663853039827628e-05,0.7333333333333333
5383,8113,생명력/Noun,15,11,4,0.0001444926086473269,6.663853039827628e-05,0.7333333333333333
5384,8114,|/Punctuation,15,4,11,6.668889629876625e-05,0.0001443834825295986,0.7333333333333333
5385,8115,켜/Noun,15,4,11,6.668889629876625e-05,0.0001443834825295986,0.7333333333333333
5386,8116,갈아/Adverb,15,4,11,6.668889629876625e-05,0.0001443834825295986,0.7333333333333333
5387,8117,뇨/Noun,15,4,11,6.668889629876625e-05,0.0001443834825295986,0.7333333333333333
5388,8118,샤이니/Noun,15,11,4,0.0001444926086473269,6.663853039827628e-05,0.7333333333333333
5389,8119,....;;;/Punctuation,15,4,11,6.668889629876625e-05,0.0001443834825295986,0.7333333333333333
5390,8120,부처/Noun,15,4,11,6.668889629876625e-05,0.0001443834825295986,0.7333333333333333
5391,8121,유전자/Noun,15,4,11,6.668889629876625e-05,0.0001443834825295986,0.7333333333333333
5392,8122,이기주의/Noun,15,4,11,6.668889629876625e-05,0.0001443834825295986,0.7333333333333333
5393,8123,를/Foreign,15,11,4,0.0001444926086473269,6.663853039827628e-05,0.7333333333333333
5394,8124,포맷/Noun,15,4,11,6.668889629876625e-05,0.0001443834825295986,0.7333333333333333
5395,8125,3시/Number,15,11,4,0.0001444926086473269,6.663853039827628e-05,0.7333333333333333
5396,8126,간결하다/Adjective,15,11,4,0.0001444926086473269,6.663853039827628e-05,0.7333333333333333
5397,8127,해체/Noun,15,4,11,6.668889629876625e-05,0.0001443834825295986,0.7333333333333333
5398,8128,모녀/Noun,15,5,10,7.780371234856063e-05,0.00013327706079655256,0.6666666666666666
5399,8129,책보/Noun,15,10,5,0.0001333777925975325,7.774495213132233e-05,0.6666666666666666
5400,8130,소림사/Noun,15,5,10,7.780371234856063e-05,0.00013327706079655256,0.6666666666666666
5401,8131,미스터빈/Noun,15,10,5,0.0001333777925975325,7.774495213132233e-05,0.6666666666666666
5402,8132,팝/Noun,15,5,10,7.780371234856063e-05,0.00013327706079655256,0.6666666666666666
5403,8133,출근/Noun,15,10,5,0.0001333777925975325,7.774495213132233e-05,0.6666666666666666
5404,8134,독특/Noun,15,10,5,0.0001333777925975325,7.774495213132233e-05,0.6666666666666666
5405,8135,스턴트맨/Noun,15,5,10,7.780371234856063e-05,0.00013327706079655256,0.6666666666666666
5406,8136,갈기/Noun,15,5,10,7.780371234856063e-05,0.00013327706079655256,0.6666666666666666
5407,8137,분야/Noun,15,5,10,7.780371234856063e-05,0.00013327706079655256,0.6666666666666666
5408,8138,아야세/Noun,15,10,5,0.0001333777925975325,7.774495213132233e-05,0.6666666666666666
5409,8139,프로도/Noun,15,5,10,7.780371234856063e-05,0.00013327706079655256,0.6666666666666666
5410,8140,타임슬립/Noun,15,5,10,7.780371234856063e-05,0.00013327706079655256,0.6666666666666666
5411,8141,은주/Noun,15,10,5,0.0001333777925975325,7.774495213132233e-05,0.6666666666666666
5412,8142,세운/Noun,15,5,10,7.780371234856063e-05,0.00013327706079655256,0.6666666666666666
5413,8143,일상생활/Noun,15,10,5,0.0001333777925975325,7.774495213132233e-05,0.6666666666666666
5414,8144,29/Number,15,5,10,7.780371234856063e-05,0.00013327706079655256,0.6666666666666666
5415,8145,박상민/Noun,15,5,10,7.780371234856063e-05,0.00013327706079655256,0.6666666666666666
5416,8146,무참/Noun,15,5,10,7.780371234856063e-05,0.00013327706079655256,0.6666666666666666
5417,8147,상류층/Noun,15,5,10,7.780371234856063e-05,0.00013327706079655256,0.6666666666666666
5418,8148,투니버스/Noun,15,5,10,7.780371234856063e-05,0.00013327706079655256,0.6666666666666666
5419,8149,심은경/Noun,15,10,5,0.0001333777925975325,7.774495213132233e-05,0.6666666666666666
5420,8150,천하다/Adjective,15,5,10,7.780371234856063e-05,0.00013327706079655256,0.6666666666666666
5421,8151,시오/Noun,15,10,5,0.0001333777925975325,7.774495213132233e-05,0.6666666666666666
5422,8152,동일/Noun,15,5,10,7.780371234856063e-05,0.00013327706079655256,0.6666666666666666
5423,8153,슬랩/Noun,15,5,10,7.780371234856063e-05,0.00013327706079655256,0.6666666666666666
5424,8154,손님/Noun,15,5,10,7.780371234856063e-05,0.00013327706079655256,0.6666666666666666
5425,8155,니야/Noun,15,5,10,7.780371234856063e-05,0.00013327706079655256,0.6666666666666666
5426,8156,설치/Noun,15,5,10,7.780371234856063e-05,0.00013327706079655256,0.6666666666666666
5427,8157,고든/Noun,15,10,5,0.0001333777925975325,7.774495213132233e-05,0.6666666666666666
5428,8158,뚫리다/Verb,15,5,10,7.780371234856063e-05,0.00013327706079655256,0.6666666666666666
5429,8159,철철/Noun,15,10,5,0.0001333777925975325,7.774495213132233e-05,0.6666666666666666
5430,8160,고리/Noun,15,10,5,0.0001333777925975325,7.774495213132233e-05,0.6666666666666666
5431,8161,93년/Number,15,10,5,0.0001333777925975325,7.774495213132233e-05,0.6666666666666666
5432,8162,잘해야/Noun,15,10,5,0.0001333777925975325,7.774495213132233e-05,0.6666666666666666
5433,8163,ㅕ/KoreanParticle,15,5,10,7.780371234856063e-05,0.00013327706079655256,0.6666666666666666
5434,8164,로랑/Noun,15,10,5,0.0001333777925975325,7.774495213132233e-05,0.6666666666666666
5435,8165,캐리비안/Noun,15,10,5,0.0001333777925975325,7.774495213132233e-05,0.6666666666666666
5436,8166,모토/Noun,15,10,5,0.0001333777925975325,7.774495213132233e-05,0.6666666666666666
5437,8167,돌파/Noun,15,10,5,0.0001333777925975325,7.774495213132233e-05,0.6666666666666666
5438,8168,거미/Noun,15,5,10,7.780371234856063e-05,0.00013327706079655256,0.6666666666666666
5439,8169,명치/Noun,15,5,10,7.780371234856063e-05,0.00013327706079655256,0.6666666666666666
5440,8170,진중하다/Adjective,15,10,5,0.0001333777925975325,7.774495213132233e-05,0.6666666666666666
5441,8171,89년/Number,15,10,5,0.0001333777925975325,7.774495213132233e-05,0.6666666666666666
5442,8172,매국노/Noun,15,5,10,7.780371234856063e-05,0.00013327706079655256,0.6666666666666666
5443,8173,컨텐츠/Noun,15,5,10,7.780371234856063e-05,0.00013327706079655256,0.6666666666666666
5444,8174,시나/Noun,15,5,10,7.780371234856063e-05,0.00013327706079655256,0.6666666666666666
5445,8175,비열하다/Adjective,15,10,5,0.0001333777925975325,7.774495213132233e-05,0.6666666666666666
5446,8176,what/Alpha,15,5,10,7.780371234856063e-05,0.00013327706079655256,0.6666666666666666
5447,8177,거두다/Verb,15,10,5,0.0001333777925975325,7.774495213132233e-05,0.6666666666666666
5448,8178,노리/Noun,15,5,10,7.780371234856063e-05,0.00013327706079655256,0.6666666666666666
5449,8179,지아/Noun,15,6,9,8.891852839835501e-05,0.00012217063906350652,0.6
5450,8180,멍하니/Noun,15,6,9,8.891852839835501e-05,0.00012217063906350652,0.6
5451,8181,말론/Noun,15,9,6,0.00012226297654773814,8.885137386436837e-05,0.6
5452,8182,베이비/Noun,15,6,9,8.891852839835501e-05,0.00012217063906350652,0.6
5453,8183,군요/Eomi,15,9,6,0.00012226297654773814,8.885137386436837e-05,0.6
5454,8184,...'/Punctuation,15,6,9,8.891852839835501e-05,0.00012217063906350652,0.6
5455,8185,놈놈놈/Noun,15,6,9,8.891852839835501e-05,0.00012217063906350652,0.6
5456,8186,쓸리다/Verb,15,6,9,8.891852839835501e-05,0.00012217063906350652,0.6
5457,8187,서리/Noun,15,9,6,0.00012226297654773814,8.885137386436837e-05,0.6
5458,8188,어드벤처/Noun,15,9,6,0.00012226297654773814,8.885137386436837e-05,0.6
5459,8189,충성/Noun,15,9,6,0.00012226297654773814,8.885137386436837e-05,0.6
5460,8190,맹목/Noun,15,9,6,0.00012226297654773814,8.885137386436837e-05,0.6
5461,8191,루카스/Noun,15,6,9,8.891852839835501e-05,0.00012217063906350652,0.6
5462,8192,어도/Noun,15,9,6,0.00012226297654773814,8.885137386436837e-05,0.6
5463,8193,기울이다/Verb,15,9,6,0.00012226297654773814,8.885137386436837e-05,0.6
5464,8194,코끼리/Noun,15,6,9,8.891852839835501e-05,0.00012217063906350652,0.6
5465,8195,여성부/Noun,15,6,9,8.891852839835501e-05,0.00012217063906350652,0.6
5466,8196,제보/Noun,15,9,6,0.00012226297654773814,8.885137386436837e-05,0.6
5467,8197,포로/Noun,15,6,9,8.891852839835501e-05,0.00012217063906350652,0.6
5468,8198,믹스/Noun,15,9,6,0.00012226297654773814,8.885137386436837e-05,0.6
5469,8199,복고/Noun,15,6,9,8.891852839835501e-05,0.00012217063906350652,0.6
5470,8200,우에노/Noun,15,6,9,8.891852839835501e-05,0.00012217063906350652,0.6
5471,8201,우울함/Noun,15,6,9,8.891852839835501e-05,0.00012217063906350652,0.6
5472,8202,맴돌다/Verb,15,9,6,0.00012226297654773814,8.885137386436837e-05,0.6
5473,8203,화법/Noun,15,6,9,8.891852839835501e-05,0.00012217063906350652,0.6
5474,8204,국가대표/Noun,15,6,9,8.891852839835501e-05,0.00012217063906350652,0.6
5475,8205,ㅑ/KoreanParticle,15,9,6,0.00012226297654773814,8.885137386436837e-05,0.6
5476,8206,권위/Noun,15,9,6,0.00012226297654773814,8.885137386436837e-05,0.6
5477,8207,트럭/Noun,15,6,9,8.891852839835501e-05,0.00012217063906350652,0.6
5478,8208,♬/Foreign,15,9,6,0.00012226297654773814,8.885137386436837e-05,0.6
5479,8209,로티/Noun,15,9,6,0.00012226297654773814,8.885137386436837e-05,0.6
5480,8210,빌어먹을/Noun,15,6,9,8.891852839835501e-05,0.00012217063906350652,0.6
5481,8211,소림축구/Noun,15,6,9,8.891852839835501e-05,0.00012217063906350652,0.6
5482,8212,무사/Noun,15,9,6,0.00012226297654773814,8.885137386436837e-05,0.6
5483,8213,보도/Noun,15,9,6,0.00012226297654773814,8.885137386436837e-05,0.6
5484,8214,자만/Noun,15,6,9,8.891852839835501e-05,0.00012217063906350652,0.6
5485,8215,키키/Noun,15,9,6,0.00012226297654773814,8.885137386436837e-05,0.6
5486,8216,20%/Number,15,6,9,8.891852839835501e-05,0.00012217063906350652,0.6
5487,8217,무용/Noun,15,9,6,0.00012226297654773814,8.885137386436837e-05,0.6
5488,8218,모임/Noun,15,6,9,8.891852839835501e-05,0.00012217063906350652,0.6
5489,8219,멜라/Noun,15,9,6,0.00012226297654773814,8.885137386436837e-05,0.6
5490,8220,몹시/Noun,15,9,6,0.00012226297654773814,8.885137386436837e-05,0.6
5491,8221,똑/Noun,15,9,6,0.00012226297654773814,8.885137386436837e-05,0.6
5492,8222,몰이/Noun,15,6,9,8.891852839835501e-05,0.00012217063906350652,0.6
5493,8223,일본만화/Noun,15,9,6,0.00012226297654773814,8.885137386436837e-05,0.6
5494,8224,레미제라블/Noun,15,9,6,0.00012226297654773814,8.885137386436837e-05,0.6
5495,8225,백만/Noun,15,6,9,8.891852839835501e-05,0.00012217063906350652,0.6
5496,8226,라울/Noun,15,6,9,8.891852839835501e-05,0.00012217063906350652,0.6
5497,8227,삼키다/Verb,15,9,6,0.00012226297654773814,8.885137386436837e-05,0.6
5498,8228,이유리/Noun,15,9,6,0.00012226297654773814,8.885137386436837e-05,0.6
5499,8229,라운드/Noun,15,6,9,8.891852839835501e-05,0.00012217063906350652,0.6
5500,8230,로드리게즈/Noun,15,9,6,0.00012226297654773814,8.885137386436837e-05,0.6
5501,8231,랜드/Noun,15,6,9,8.891852839835501e-05,0.00012217063906350652,0.6
5502,8296,조이다/Verb,14,14,0,0.00017783705679671002,2.2212843466092093e-05,1.0
5503,8297,밥맛/Noun,14,0,14,2.2229632099588756e-05,0.00017770274772873674,1.0
5504,8298,분신사바/Noun,14,0,14,2.2229632099588756e-05,0.00017770274772873674,1.0
5505,8299,혐/Noun,14,0,14,2.2229632099588756e-05,0.00017770274772873674,1.0
5506,8300,짱개/Noun,14,0,14,2.2229632099588756e-05,0.00017770274772873674,1.0
5507,8301,잘봣습니/Noun,14,14,0,0.00017783705679671002,2.2212843466092093e-05,1.0
5508,8302,햇살/Noun,14,14,0,0.00017783705679671002,2.2212843466092093e-05,1.0
5509,8303,영아/Noun,14,0,14,2.2229632099588756e-05,0.00017770274772873674,1.0
5510,8304,..-/Punctuation,14,0,14,2.2229632099588756e-05,0.00017770274772873674,1.0
5511,8305,졸림/Noun,14,0,14,2.2229632099588756e-05,0.00017770274772873674,1.0
5512,8306,..-_-;;/Punctuation,14,0,14,2.2229632099588756e-05,0.00017770274772873674,1.0
5513,8307,심슨/Noun,14,14,0,0.00017783705679671002,2.2212843466092093e-05,1.0
5514,8308,빠져듬/Noun,14,14,0,0.00017783705679671002,2.2212843466092093e-05,1.0
5515,8309,최선정/Noun,14,0,14,2.2229632099588756e-05,0.00017770274772873674,1.0
5516,8310,홍석천/Noun,14,0,14,2.2229632099588756e-05,0.00017770274772873674,1.0
5517,8311,어쩌자/Noun,14,0,14,2.2229632099588756e-05,0.00017770274772873674,1.0
5518,8312,성준/Noun,14,13,1,0.00016672224074691566,3.331926519913814e-05,0.9285714285714286
5519,8313,으뜸/Noun,14,13,1,0.00016672224074691566,3.331926519913814e-05,0.9285714285714286
5520,8314,독보/Noun,14,13,1,0.00016672224074691566,3.331926519913814e-05,0.9285714285714286
5521,8315,옷벗다/Verb,14,1,13,3.334444814938313e-05,0.0001665963259956907,0.9285714285714286
5522,8316,소송/Noun,14,1,13,3.334444814938313e-05,0.0001665963259956907,0.9285714285714286
5523,8317,인간관계/Noun,14,13,1,0.00016672224074691566,3.331926519913814e-05,0.9285714285714286
5524,8318,탁재훈/Noun,14,1,13,3.334444814938313e-05,0.0001665963259956907,0.9285714285714286
5525,8319,케이온/Noun,14,13,1,0.00016672224074691566,3.331926519913814e-05,0.9285714285714286
5526,8320,인간극장/Noun,14,1,13,3.334444814938313e-05,0.0001665963259956907,0.9285714285714286
5527,8321,무조/Noun,14,13,1,0.00016672224074691566,3.331926519913814e-05,0.9285714285714286
5528,8322,박예진/Noun,14,1,13,3.334444814938313e-05,0.0001665963259956907,0.9285714285714286
5529,8323,강츄/Noun,14,13,1,0.00016672224074691566,3.331926519913814e-05,0.9285714285714286
5530,8324,표방/Noun,14,1,13,3.334444814938313e-05,0.0001665963259956907,0.9285714285714286
5531,8325,더스틴/Noun,14,13,1,0.00016672224074691566,3.331926519913814e-05,0.9285714285714286
5532,8326,현저/Noun,14,1,13,3.334444814938313e-05,0.0001665963259956907,0.9285714285714286
5533,8327,주몽/Noun,14,13,1,0.00016672224074691566,3.331926519913814e-05,0.9285714285714286
5534,8328,강인하다/Adjective,14,13,1,0.00016672224074691566,3.331926519913814e-05,0.9285714285714286
5535,8329,호프만/Noun,14,13,1,0.00016672224074691566,3.331926519913814e-05,0.9285714285714286
5536,8330,불명/Noun,14,1,13,3.334444814938313e-05,0.0001665963259956907,0.9285714285714286
5537,8331,16년/Number,14,13,1,0.00016672224074691566,3.331926519913814e-05,0.9285714285714286
5538,8332,민주/Noun,14,1,13,3.334444814938313e-05,0.0001665963259956907,0.9285714285714286
5539,8333,산만/Noun,14,1,13,3.334444814938313e-05,0.0001665963259956907,0.9285714285714286
5540,8334,모시다/Verb,14,1,13,3.334444814938313e-05,0.0001665963259956907,0.9285714285714286
5541,8335,노민우/Noun,14,13,1,0.00016672224074691566,3.331926519913814e-05,0.9285714285714286
5542,8336,삽입곡/Noun,14,13,1,0.00016672224074691566,3.331926519913814e-05,0.9285714285714286
5543,8337,외전/Noun,14,1,13,3.334444814938313e-05,0.0001665963259956907,0.9285714285714286
5544,8338,반말/Noun,14,1,13,3.334444814938313e-05,0.0001665963259956907,0.9285714285714286
5545,8339,유사라/Noun,14,1,13,3.334444814938313e-05,0.0001665963259956907,0.9285714285714286
5546,8340,능욕/Noun,14,1,13,3.334444814938313e-05,0.0001665963259956907,0.9285714285714286
5547,8341,마담/Noun,14,2,12,4.445926419917751e-05,0.00015548990426264466,0.8571428571428571
5548,8342,주입/Noun,14,2,12,4.445926419917751e-05,0.00015548990426264466,0.8571428571428571
5549,8343,탄도/Noun,14,12,2,0.00015560742469712126,4.4425686932184186e-05,0.8571428571428571
5550,8344,오로라공주/Noun,14,2,12,4.445926419917751e-05,0.00015548990426264466,0.8571428571428571
5551,8345,소란/Noun,14,2,12,4.445926419917751e-05,0.00015548990426264466,0.8571428571428571
5552,8346,무렵/Noun,14,12,2,0.00015560742469712126,4.4425686932184186e-05,0.8571428571428571
5553,8347,연말/Noun,14,12,2,0.00015560742469712126,4.4425686932184186e-05,0.8571428571428571
5554,8348,주룩주룩/Noun,14,12,2,0.00015560742469712126,4.4425686932184186e-05,0.8571428571428571
5555,8349,폴리스스토리/Noun,14,12,2,0.00015560742469712126,4.4425686932184186e-05,0.8571428571428571
5556,8350,8천원/Number,14,2,12,4.445926419917751e-05,0.00015548990426264466,0.8571428571428571
5557,8351,스탭들/Noun,14,2,12,4.445926419917751e-05,0.00015548990426264466,0.8571428571428571
5558,8352,로다주/Noun,14,12,2,0.00015560742469712126,4.4425686932184186e-05,0.8571428571428571
5559,8353,힛걸/Noun,14,12,2,0.00015560742469712126,4.4425686932184186e-05,0.8571428571428571
5560,8354,늙은이/Noun,14,2,12,4.445926419917751e-05,0.00015548990426264466,0.8571428571428571
5561,8355,작작하다/Adjective,14,2,12,4.445926419917751e-05,0.00015548990426264466,0.8571428571428571
5562,8356,끼어들다/Verb,14,2,12,4.445926419917751e-05,0.00015548990426264466,0.8571428571428571
5563,8357,화이자/Noun,14,12,2,0.00015560742469712126,4.4425686932184186e-05,0.8571428571428571
5564,8358,로군/Josa,14,2,12,4.445926419917751e-05,0.00015548990426264466,0.8571428571428571
5565,8359,포트/Noun,14,12,2,0.00015560742469712126,4.4425686932184186e-05,0.8571428571428571
5566,8360,엑소시즘/Noun,14,2,12,4.445926419917751e-05,0.00015548990426264466,0.8571428571428571
5567,8361,감탄사/Noun,14,12,2,0.00015560742469712126,4.4425686932184186e-05,0.8571428571428571
5568,8362,노출하다/Adjective,14,2,12,4.445926419917751e-05,0.00015548990426264466,0.8571428571428571
5569,8363,왜봄/Noun,14,2,12,4.445926419917751e-05,0.00015548990426264466,0.8571428571428571
5570,8364,ㅗㅗ/KoreanParticle,14,2,12,4.445926419917751e-05,0.00015548990426264466,0.8571428571428571
5571,8365,겨냥/Noun,14,2,12,4.445926419917751e-05,0.00015548990426264466,0.8571428571428571
5572,8366,내리막/Noun,14,2,12,4.445926419917751e-05,0.00015548990426264466,0.8571428571428571
5573,8367,따먹다/Verb,14,2,12,4.445926419917751e-05,0.00015548990426264466,0.8571428571428571
5574,8368,뻘/Noun,14,2,12,4.445926419917751e-05,0.00015548990426264466,0.8571428571428571
5575,8369,메우다/Verb,14,2,12,4.445926419917751e-05,0.00015548990426264466,0.8571428571428571
5576,8370,부제/Noun,14,2,12,4.445926419917751e-05,0.00015548990426264466,0.8571428571428571
5577,8371,휘두르다/Verb,14,2,12,4.445926419917751e-05,0.00015548990426264466,0.8571428571428571
5578,8372,일어서다/Verb,14,12,2,0.00015560742469712126,4.4425686932184186e-05,0.8571428571428571
5579,8373,핵꿀잼/Noun,14,12,2,0.00015560742469712126,4.4425686932184186e-05,0.8571428571428571
5580,8374,회한/Noun,14,12,2,0.00015560742469712126,4.4425686932184186e-05,0.8571428571428571
5581,8375,벌이/Noun,14,2,12,4.445926419917751e-05,0.00015548990426264466,0.8571428571428571
5582,8376,치장/Noun,14,2,12,4.445926419917751e-05,0.00015548990426264466,0.8571428571428571
5583,8377,야호/Noun,14,12,2,0.00015560742469712126,4.4425686932184186e-05,0.8571428571428571
5584,8378,우왕좌왕/Noun,14,2,12,4.445926419917751e-05,0.00015548990426264466,0.8571428571428571
5585,8379,교체/Noun,14,2,12,4.445926419917751e-05,0.00015548990426264466,0.8571428571428571
5586,8380,지도자/Noun,14,12,2,0.00015560742469712126,4.4425686932184186e-05,0.8571428571428571
5587,8381,서늘하다/Adjective,14,12,2,0.00015560742469712126,4.4425686932184186e-05,0.8571428571428571
5588,8382,막심/Noun,14,3,11,5.5574080248971876e-05,0.0001443834825295986,0.7857142857142857
5589,8383,붐/Noun,14,3,11,5.5574080248971876e-05,0.0001443834825295986,0.7857142857142857
5590,8384,오늘이/Noun,14,11,3,0.0001444926086473269,5.553210866523024e-05,0.7857142857142857
5591,8385,복장/Noun,14,3,11,5.5574080248971876e-05,0.0001443834825295986,0.7857142857142857
5592,8386,>.</Punctuation,14,11,3,0.0001444926086473269,5.553210866523024e-05,0.7857142857142857
5593,8387,상기/Noun,14,11,3,0.0001444926086473269,5.553210866523024e-05,0.7857142857142857
5594,8388,조형기/Noun,14,3,11,5.5574080248971876e-05,0.0001443834825295986,0.7857142857142857
5595,8389,불량/Noun,14,3,11,5.5574080248971876e-05,0.0001443834825295986,0.7857142857142857
5596,8390,가만있다/Verb,14,3,11,5.5574080248971876e-05,0.0001443834825295986,0.7857142857142857
5597,8391,수목/Noun,14,11,3,0.0001444926086473269,5.553210866523024e-05,0.7857142857142857
5598,8392,번개/Noun,14,11,3,0.0001444926086473269,5.553210866523024e-05,0.7857142857142857
5599,8393,미술관/Noun,14,11,3,0.0001444926086473269,5.553210866523024e-05,0.7857142857142857
5600,8394,정려원/Noun,14,11,3,0.0001444926086473269,5.553210866523024e-05,0.7857142857142857
5601,8395,오마주/Noun,14,3,11,5.5574080248971876e-05,0.0001443834825295986,0.7857142857142857
5602,8396,뽀뽀/Noun,14,3,11,5.5574080248971876e-05,0.0001443834825295986,0.7857142857142857
5603,8397,닷/Modifier,14,11,3,0.0001444926086473269,5.553210866523024e-05,0.7857142857142857
5604,8398,느릿느릿/Noun,14,3,11,5.5574080248971876e-05,0.0001443834825295986,0.7857142857142857
5605,8399,오즈/Noun,14,11,3,0.0001444926086473269,5.553210866523024e-05,0.7857142857142857
5606,8400,푼/Noun,14,3,11,5.5574080248971876e-05,0.0001443834825295986,0.7857142857142857
5607,8401,지니/Noun,14,11,3,0.0001444926086473269,5.553210866523024e-05,0.7857142857142857
5608,8402,개밥/Noun,14,3,11,5.5574080248971876e-05,0.0001443834825295986,0.7857142857142857
5609,8403,이색/Noun,14,11,3,0.0001444926086473269,5.553210866523024e-05,0.7857142857142857
5610,8404,오리엔탈리즘/Noun,14,3,11,5.5574080248971876e-05,0.0001443834825295986,0.7857142857142857
5611,8405,젬/Noun,14,11,3,0.0001444926086473269,5.553210866523024e-05,0.7857142857142857
5612,8406,브라보/Noun,14,11,3,0.0001444926086473269,5.553210866523024e-05,0.7857142857142857
5613,8407,작작/Noun,14,3,11,5.5574080248971876e-05,0.0001443834825295986,0.7857142857142857
5614,8408,이듬/Noun,14,3,11,5.5574080248971876e-05,0.0001443834825295986,0.7857142857142857
5615,8409,지긋지긋하다/Adjective,14,3,11,5.5574080248971876e-05,0.0001443834825295986,0.7857142857142857
5616,8410,시초/Noun,14,11,3,0.0001444926086473269,5.553210866523024e-05,0.7857142857142857
5617,8411,청순/Noun,14,11,3,0.0001444926086473269,5.553210866523024e-05,0.7857142857142857
5618,8412,.................../Punctuation,14,3,11,5.5574080248971876e-05,0.0001443834825295986,0.7857142857142857
5619,8413,맹/Noun,14,3,11,5.5574080248971876e-05,0.0001443834825295986,0.7857142857142857
5620,8414,비상/Noun,14,3,11,5.5574080248971876e-05,0.0001443834825295986,0.7857142857142857
5621,8415,리버/Noun,14,11,3,0.0001444926086473269,5.553210866523024e-05,0.7857142857142857
5622,8416,불평/Noun,14,11,3,0.0001444926086473269,5.553210866523024e-05,0.7857142857142857
5623,8417,머레이/Noun,14,11,3,0.0001444926086473269,5.553210866523024e-05,0.7857142857142857
5624,8418,주름/Noun,14,3,11,5.5574080248971876e-05,0.0001443834825295986,0.7857142857142857
5625,8419,대머리/Noun,14,3,11,5.5574080248971876e-05,0.0001443834825295986,0.7857142857142857
5626,8420,저조하다/Adjective,14,11,3,0.0001444926086473269,5.553210866523024e-05,0.7857142857142857
5627,8421,노숙자/Noun,14,3,11,5.5574080248971876e-05,0.0001443834825295986,0.7857142857142857
5628,8422,점차/Noun,14,11,3,0.0001444926086473269,5.553210866523024e-05,0.7857142857142857
5629,8423,적용/Noun,14,3,11,5.5574080248971876e-05,0.0001443834825295986,0.7857142857142857
5630,8424,몽골/Noun,14,3,11,5.5574080248971876e-05,0.0001443834825295986,0.7857142857142857
5631,8425,난장판/Noun,14,3,11,5.5574080248971876e-05,0.0001443834825295986,0.7857142857142857
5632,8426,시인/Noun,14,11,3,0.0001444926086473269,5.553210866523024e-05,0.7857142857142857
5633,8427,몰락하다/Adjective,14,3,11,5.5574080248971876e-05,0.0001443834825295986,0.7857142857142857
5634,8428,할인/Noun,14,3,11,5.5574080248971876e-05,0.0001443834825295986,0.7857142857142857
5635,8429,결승전/Noun,14,3,11,5.5574080248971876e-05,0.0001443834825295986,0.7857142857142857
5636,8430,헬렌/Noun,14,11,3,0.0001444926086473269,5.553210866523024e-05,0.7857142857142857
5637,8431,밨/Noun,14,11,3,0.0001444926086473269,5.553210866523024e-05,0.7857142857142857
5638,8432,무례하다/Adjective,14,3,11,5.5574080248971876e-05,0.0001443834825295986,0.7857142857142857
5639,8433,호호/Noun,14,11,3,0.0001444926086473269,5.553210866523024e-05,0.7857142857142857
5640,8434,연쇄살인/Noun,14,3,11,5.5574080248971876e-05,0.0001443834825295986,0.7857142857142857
5641,8435,찌라시/Noun,14,3,11,5.5574080248971876e-05,0.0001443834825295986,0.7857142857142857
5642,8436,~~!!!!/Punctuation,14,11,3,0.0001444926086473269,5.553210866523024e-05,0.7857142857142857
5643,8437,갈증/Noun,14,10,4,0.0001333777925975325,6.663853039827628e-05,0.7142857142857143
5644,8438,무식/Noun,14,4,10,6.668889629876625e-05,0.00013327706079655256,0.7142857142857143
5645,8439,역경/Noun,14,10,4,0.0001333777925975325,6.663853039827628e-05,0.7142857142857143
5646,8440,태권브이/Noun,14,4,10,6.668889629876625e-05,0.00013327706079655256,0.7142857142857143
5647,8441,발달/Noun,14,10,4,0.0001333777925975325,6.663853039827628e-05,0.7142857142857143
5648,8442,센세이션/Noun,14,10,4,0.0001333777925975325,6.663853039827628e-05,0.7142857142857143
5649,8443,개입/Noun,14,4,10,6.668889629876625e-05,0.00013327706079655256,0.7142857142857143
5650,8444,의무/Noun,14,10,4,0.0001333777925975325,6.663853039827628e-05,0.7142857142857143
5651,8445,퍽/Noun,14,4,10,6.668889629876625e-05,0.00013327706079655256,0.7142857142857143
5652,8446,줄기/Noun,14,10,4,0.0001333777925975325,6.663853039827628e-05,0.7142857142857143
5653,8447,다섯/Modifier,14,10,4,0.0001333777925975325,6.663853039827628e-05,0.7142857142857143
5654,8448,애니스톤/Noun,14,4,10,6.668889629876625e-05,0.00013327706079655256,0.7142857142857143
5655,8449,?!!/Punctuation,14,4,10,6.668889629876625e-05,0.00013327706079655256,0.7142857142857143
5656,8450,김재원/Noun,14,10,4,0.0001333777925975325,6.663853039827628e-05,0.7142857142857143
5657,8451,조미료/Noun,14,4,10,6.668889629876625e-05,0.00013327706079655256,0.7142857142857143
5658,8452,수상한/Noun,14,10,4,0.0001333777925975325,6.663853039827628e-05,0.7142857142857143
5659,8453,흠/Exclamation,14,4,10,6.668889629876625e-05,0.00013327706079655256,0.7142857142857143
5660,8454,타의/Noun,14,10,4,0.0001333777925975325,6.663853039827628e-05,0.7142857142857143
5661,8455,이만/Modifier,14,10,4,0.0001333777925975325,6.663853039827628e-05,0.7142857142857143
5662,8456,리듬/Noun,14,10,4,0.0001333777925975325,6.663853039827628e-05,0.7142857142857143
5663,8457,르노/Noun,14,4,10,6.668889629876625e-05,0.00013327706079655256,0.7142857142857143
5664,8458,정규/Noun,14,10,4,0.0001333777925975325,6.663853039827628e-05,0.7142857142857143
5665,8459,레디/Noun,14,4,10,6.668889629876625e-05,0.00013327706079655256,0.7142857142857143
5666,8460,덕화/Noun,14,10,4,0.0001333777925975325,6.663853039827628e-05,0.7142857142857143
5667,8461,혼돈/Noun,14,10,4,0.0001333777925975325,6.663853039827628e-05,0.7142857142857143
5668,8462,박철수/Noun,14,4,10,6.668889629876625e-05,0.00013327706079655256,0.7142857142857143
5669,8463,드라큘라/Noun,14,4,10,6.668889629876625e-05,0.00013327706079655256,0.7142857142857143
5670,8464,흡혈귀/Noun,14,4,10,6.668889629876625e-05,0.00013327706079655256,0.7142857142857143
5671,8465,가중/Noun,14,4,10,6.668889629876625e-05,0.00013327706079655256,0.7142857142857143
5672,8466,메가박스/Noun,14,10,4,0.0001333777925975325,6.663853039827628e-05,0.7142857142857143
5673,8467,학원물/Noun,14,4,10,6.668889629876625e-05,0.00013327706079655256,0.7142857142857143
5674,8468,앗다/Verb,14,4,10,6.668889629876625e-05,0.00013327706079655256,0.7142857142857143
5675,8469,상실하다/Adjective,14,4,10,6.668889629876625e-05,0.00013327706079655256,0.7142857142857143
5676,8470,치자/Noun,14,4,10,6.668889629876625e-05,0.00013327706079655256,0.7142857142857143
5677,8471,셜록홈즈/Noun,14,10,4,0.0001333777925975325,6.663853039827628e-05,0.7142857142857143
5678,8472,에고/Noun,14,4,10,6.668889629876625e-05,0.00013327706079655256,0.7142857142857143
5679,8473,이벤트/Noun,14,4,10,6.668889629876625e-05,0.00013327706079655256,0.7142857142857143
5680,8474,굴욕/Noun,14,4,10,6.668889629876625e-05,0.00013327706079655256,0.7142857142857143
5681,8475,사이비/Noun,14,4,10,6.668889629876625e-05,0.00013327706079655256,0.7142857142857143
5682,8476,시련/Noun,14,10,4,0.0001333777925975325,6.663853039827628e-05,0.7142857142857143
5683,8477,면모/Noun,14,10,4,0.0001333777925975325,6.663853039827628e-05,0.7142857142857143
5684,8478,대적/Noun,14,4,10,6.668889629876625e-05,0.00013327706079655256,0.7142857142857143
5685,8479,아우르다/Verb,14,10,4,0.0001333777925975325,6.663853039827628e-05,0.7142857142857143
5686,8480,우디앨런/Noun,14,10,4,0.0001333777925975325,6.663853039827628e-05,0.7142857142857143
5687,8481,미쉘/Noun,14,10,4,0.0001333777925975325,6.663853039827628e-05,0.7142857142857143
5688,8482,이수경/Noun,14,10,4,0.0001333777925975325,6.663853039827628e-05,0.7142857142857143
5689,8483,랬/Noun,14,4,10,6.668889629876625e-05,0.00013327706079655256,0.7142857142857143
5690,8484,1시/Number,14,4,10,6.668889629876625e-05,0.00013327706079655256,0.7142857142857143
5691,8485,사채/Noun,14,4,10,6.668889629876625e-05,0.00013327706079655256,0.7142857142857143
5692,8486,유학/Noun,14,9,5,0.00012226297654773814,7.774495213132233e-05,0.6428571428571429
5693,8487,허탈/Noun,14,5,9,7.780371234856063e-05,0.00012217063906350652,0.6428571428571429
5694,8488,리턴즈/Noun,14,9,5,0.00012226297654773814,7.774495213132233e-05,0.6428571428571429
5695,8489,간수/Noun,14,5,9,7.780371234856063e-05,0.00012217063906350652,0.6428571428571429
5696,8490,사만/Noun,14,9,5,0.00012226297654773814,7.774495213132233e-05,0.6428571428571429
5697,8491,아앙/Noun,14,5,9,7.780371234856063e-05,0.00012217063906350652,0.6428571428571429
5698,8492,엑스/Noun,14,5,9,7.780371234856063e-05,0.00012217063906350652,0.6428571428571429
5699,8493,부들/Noun,14,5,9,7.780371234856063e-05,0.00012217063906350652,0.6428571428571429
5700,8494,.;/Punctuation,14,5,9,7.780371234856063e-05,0.00012217063906350652,0.6428571428571429
5701,8495,락스/Noun,14,9,5,0.00012226297654773814,7.774495213132233e-05,0.6428571428571429
5702,8496,돈좀/Noun,14,5,9,7.780371234856063e-05,0.00012217063906350652,0.6428571428571429
5703,8497,할리웃/Noun,14,5,9,7.780371234856063e-05,0.00012217063906350652,0.6428571428571429
5704,8498,매장/Noun,14,5,9,7.780371234856063e-05,0.00012217063906350652,0.6428571428571429
5705,8499,극히/Noun,14,5,9,7.780371234856063e-05,0.00012217063906350652,0.6428571428571429
5706,8500,이참/Noun,14,5,9,7.780371234856063e-05,0.00012217063906350652,0.6428571428571429
5707,8501,시대극/Noun,14,5,9,7.780371234856063e-05,0.00012217063906350652,0.6428571428571429
5708,8502,실로/Noun,14,9,5,0.00012226297654773814,7.774495213132233e-05,0.6428571428571429
5709,8503,본영/Noun,14,9,5,0.00012226297654773814,7.774495213132233e-05,0.6428571428571429
5710,8504,뺴/Noun,14,5,9,7.780371234856063e-05,0.00012217063906350652,0.6428571428571429
5711,8505,소동/Noun,14,5,9,7.780371234856063e-05,0.00012217063906350652,0.6428571428571429
5712,8506,구심/Noun,14,5,9,7.780371234856063e-05,0.00012217063906350652,0.6428571428571429
5713,8507,기지/Noun,14,9,5,0.00012226297654773814,7.774495213132233e-05,0.6428571428571429
5714,8508,요리사/Noun,14,5,9,7.780371234856063e-05,0.00012217063906350652,0.6428571428571429
5715,8509,아이언/Noun,14,9,5,0.00012226297654773814,7.774495213132233e-05,0.6428571428571429
5716,8510,배부르다/Adjective,14,9,5,0.00012226297654773814,7.774495213132233e-05,0.6428571428571429
5717,8511,!!!!!!!!!!!!/Punctuation,14,9,5,0.00012226297654773814,7.774495213132233e-05,0.6428571428571429
5718,8512,감초/Noun,14,9,5,0.00012226297654773814,7.774495213132233e-05,0.6428571428571429
5719,8513,품격/Noun,14,9,5,0.00012226297654773814,7.774495213132233e-05,0.6428571428571429
5720,8514,하치/Noun,14,9,5,0.00012226297654773814,7.774495213132233e-05,0.6428571428571429
5721,8515,몽/Noun,14,5,9,7.780371234856063e-05,0.00012217063906350652,0.6428571428571429
5722,8516,안이/Noun,14,9,5,0.00012226297654773814,7.774495213132233e-05,0.6428571428571429
5723,8517,볼맛/Noun,14,5,9,7.780371234856063e-05,0.00012217063906350652,0.6428571428571429
5724,8518,련/Noun,14,9,5,0.00012226297654773814,7.774495213132233e-05,0.6428571428571429
5725,8519,북괴/Noun,14,5,9,7.780371234856063e-05,0.00012217063906350652,0.6428571428571429
5726,8520,안타/Noun,14,5,9,7.780371234856063e-05,0.00012217063906350652,0.6428571428571429
5727,8521,오감/Noun,14,9,5,0.00012226297654773814,7.774495213132233e-05,0.6428571428571429
5728,8522,임산부/Noun,14,5,9,7.780371234856063e-05,0.00012217063906350652,0.6428571428571429
5729,8523,..................../Punctuation,14,5,9,7.780371234856063e-05,0.00012217063906350652,0.6428571428571429
5730,8524,달이/Noun,14,9,5,0.00012226297654773814,7.774495213132233e-05,0.6428571428571429
5731,8525,댓/Noun,14,5,9,7.780371234856063e-05,0.00012217063906350652,0.6428571428571429
5732,8526,친하다/Adjective,14,5,9,7.780371234856063e-05,0.00012217063906350652,0.6428571428571429
5733,8527,부유하다/Adjective,14,9,5,0.00012226297654773814,7.774495213132233e-05,0.6428571428571429
5734,8528,비서/Noun,14,5,9,7.780371234856063e-05,0.00012217063906350652,0.6428571428571429
5735,8529,거물/Noun,14,9,5,0.00012226297654773814,7.774495213132233e-05,0.6428571428571429
5736,8530,편의점/Noun,14,5,9,7.780371234856063e-05,0.00012217063906350652,0.6428571428571429
5737,8531,셀/Noun,14,9,5,0.00012226297654773814,7.774495213132233e-05,0.6428571428571429
5738,8532,CSI/Alpha,14,9,5,0.00012226297654773814,7.774495213132233e-05,0.6428571428571429
5739,8533,아베/Noun,14,5,9,7.780371234856063e-05,0.00012217063906350652,0.6428571428571429
5740,8534,절도/Noun,14,5,9,7.780371234856063e-05,0.00012217063906350652,0.6428571428571429
5741,8535,파고/Noun,14,5,9,7.780371234856063e-05,0.00012217063906350652,0.6428571428571429
5742,8536,후진국/Noun,14,5,9,7.780371234856063e-05,0.00012217063906350652,0.6428571428571429
5743,8537,도구/Noun,14,5,9,7.780371234856063e-05,0.00012217063906350652,0.6428571428571429
5744,8538,낙태/Noun,14,5,9,7.780371234856063e-05,0.00012217063906350652,0.6428571428571429
5745,8539,유키/Noun,14,9,5,0.00012226297654773814,7.774495213132233e-05,0.6428571428571429
5746,8540,에피/Noun,14,9,5,0.00012226297654773814,7.774495213132233e-05,0.6428571428571429
5747,8541,보성/Noun,14,9,5,0.00012226297654773814,7.774495213132233e-05,0.6428571428571429
5748,8542,수두/Noun,14,5,9,7.780371234856063e-05,0.00012217063906350652,0.6428571428571429
5749,8543,친숙하다/Adjective,14,9,5,0.00012226297654773814,7.774495213132233e-05,0.6428571428571429
5750,8544,애국가/Noun,14,5,9,7.780371234856063e-05,0.00012217063906350652,0.6428571428571429
5751,8545,테러범/Noun,14,5,9,7.780371234856063e-05,0.00012217063906350652,0.6428571428571429
5752,8546,무진장/Noun,14,5,9,7.780371234856063e-05,0.00012217063906350652,0.6428571428571429
5753,8547,난리치다/Verb,14,5,9,7.780371234856063e-05,0.00012217063906350652,0.6428571428571429
5754,8548,송/Noun,14,9,5,0.00012226297654773814,7.774495213132233e-05,0.6428571428571429
5755,8549,잘해주다/Verb,14,9,5,0.00012226297654773814,7.774495213132233e-05,0.6428571428571429
5756,8550,본연/Noun,14,9,5,0.00012226297654773814,7.774495213132233e-05,0.6428571428571429
5757,8551,탐구/Noun,14,9,5,0.00012226297654773814,7.774495213132233e-05,0.6428571428571429
5758,8552,일어나지/Noun,14,9,5,0.00012226297654773814,7.774495213132233e-05,0.6428571428571429
5759,8553,골든/Noun,14,9,5,0.00012226297654773814,7.774495213132233e-05,0.6428571428571429
5760,8554,로이/Noun,14,5,9,7.780371234856063e-05,0.00012217063906350652,0.6428571428571429
5761,8690,휴지통/Noun,13,0,13,2.2229632099588756e-05,0.0001665963259956907,1.0
5762,8691,동남아/Noun,13,0,13,2.2229632099588756e-05,0.0001665963259956907,1.0
5763,8692,we/Alpha,13,13,0,0.00016672224074691566,2.2212843466092093e-05,1.0
5764,8693,저리다/Adjective,13,13,0,0.00016672224074691566,2.2212843466092093e-05,1.0
5765,8694,졷/Noun,13,0,13,2.2229632099588756e-05,0.0001665963259956907,1.0
5766,8695,이화영/Noun,13,0,13,2.2229632099588756e-05,0.0001665963259956907,1.0
5767,8696,라그/Noun,13,0,13,2.2229632099588756e-05,0.0001665963259956907,1.0
5768,8697,정윤희/Noun,13,13,0,0.00016672224074691566,2.2212843466092093e-05,1.0
5769,8698,정도껏해/Noun,13,0,13,2.2229632099588756e-05,0.0001665963259956907,1.0
5770,8699,나사/Noun,13,0,13,2.2229632099588756e-05,0.0001665963259956907,1.0
5771,8700,이상준/Noun,13,0,13,2.2229632099588756e-05,0.0001665963259956907,1.0
5772,8701,죽도/Noun,13,0,13,2.2229632099588756e-05,0.0001665963259956907,1.0
5773,8702,아려/Noun,13,13,0,0.00016672224074691566,2.2212843466092093e-05,1.0
5774,8703,댕기/Noun,13,0,13,2.2229632099588756e-05,0.0001665963259956907,1.0
5775,8704,지스토리/Noun,13,0,13,2.2229632099588756e-05,0.0001665963259956907,1.0
5776,8705,씩씩하다/Adjective,13,13,0,0.00016672224074691566,2.2212843466092093e-05,1.0
5777,8706,모욕감/Noun,13,0,13,2.2229632099588756e-05,0.0001665963259956907,1.0
5778,8707,질색/Noun,13,0,13,2.2229632099588756e-05,0.0001665963259956907,1.0
5779,8708,최우식/Noun,13,13,0,0.00016672224074691566,2.2212843466092093e-05,1.0
5780,8709,오호/Exclamation,13,12,1,0.00015560742469712126,3.331926519913814e-05,0.9230769230769232
5781,8710,무뇌/Noun,13,1,12,3.334444814938313e-05,0.00015548990426264466,0.9230769230769232
5782,8711,전날/Noun,13,12,1,0.00015560742469712126,3.331926519913814e-05,0.9230769230769232
5783,8712,잠듬/Noun,13,1,12,3.334444814938313e-05,0.00015548990426264466,0.9230769230769232
5784,8713,사뭇/Noun,13,12,1,0.00015560742469712126,3.331926519913814e-05,0.9230769230769232
5785,8714,ㅅㄲ/KoreanParticle,13,1,12,3.334444814938313e-05,0.00015548990426264466,0.9230769230769232
5786,8715,life/Alpha,13,12,1,0.00015560742469712126,3.331926519913814e-05,0.9230769230769232
5787,8716,상남자/Noun,13,12,1,0.00015560742469712126,3.331926519913814e-05,0.9230769230769232
5788,8717,툭하면/Noun,13,1,12,3.334444814938313e-05,0.00015548990426264466,0.9230769230769232
5789,8718,Cg/Alpha,13,1,12,3.334444814938313e-05,0.00015548990426264466,0.9230769230769232
5790,8719,이창동/Noun,13,12,1,0.00015560742469712126,3.331926519913814e-05,0.9230769230769232
5791,8720,노망/Noun,13,1,12,3.334444814938313e-05,0.00015548990426264466,0.9230769230769232
5792,8721,로빈윌리엄스/Noun,13,12,1,0.00015560742469712126,3.331926519913814e-05,0.9230769230769232
5793,8722,박기웅/Noun,13,12,1,0.00015560742469712126,3.331926519913814e-05,0.9230769230769232
5794,8723,한스/Noun,13,12,1,0.00015560742469712126,3.331926519913814e-05,0.9230769230769232
5795,8724,괜춘/Noun,13,12,1,0.00015560742469712126,3.331926519913814e-05,0.9230769230769232
5796,8725,아낌없이/Adverb,13,12,1,0.00015560742469712126,3.331926519913814e-05,0.9230769230769232
5797,8726,잘껄/Noun,13,1,12,3.334444814938313e-05,0.00015548990426264466,0.9230769230769232
5798,8727,미끼/Noun,13,1,12,3.334444814938313e-05,0.00015548990426264466,0.9230769230769232
5799,8728,밋밋/Noun,13,1,12,3.334444814938313e-05,0.00015548990426264466,0.9230769230769232
5800,8729,휴그랜트/Noun,13,12,1,0.00015560742469712126,3.331926519913814e-05,0.9230769230769232
5801,8730,분단/Noun,13,12,1,0.00015560742469712126,3.331926519913814e-05,0.9230769230769232
5802,8731,on/Alpha,13,12,1,0.00015560742469712126,3.331926519913814e-05,0.9230769230769232
5803,8732,타오르다/Verb,13,12,1,0.00015560742469712126,3.331926519913814e-05,0.9230769230769232
5804,8733,퉷/Noun,13,1,12,3.334444814938313e-05,0.00015548990426264466,0.9230769230769232
5805,8734,삭막하다/Adjective,13,12,1,0.00015560742469712126,3.331926519913814e-05,0.9230769230769232
5806,8735,쯔쯔/Noun,13,1,12,3.334444814938313e-05,0.00015548990426264466,0.9230769230769232
5807,8736,로건/Noun,13,12,1,0.00015560742469712126,3.331926519913814e-05,0.9230769230769232
5808,8737,따분함/Noun,13,1,12,3.334444814938313e-05,0.00015548990426264466,0.9230769230769232
5809,8738,바르뎀/Noun,13,12,1,0.00015560742469712126,3.331926519913814e-05,0.9230769230769232
5810,8739,쯧/Exclamation,13,2,11,4.445926419917751e-05,0.0001443834825295986,0.8461538461538461
5811,8740,쯧쯧/Exclamation,13,2,11,4.445926419917751e-05,0.0001443834825295986,0.8461538461538461
5812,8741,기껏/Noun,13,2,11,4.445926419917751e-05,0.0001443834825295986,0.8461538461538461
5813,8742,하기는/Adverb,13,2,11,4.445926419917751e-05,0.0001443834825295986,0.8461538461538461
5814,8743,.!!!/Punctuation,13,11,2,0.0001444926086473269,4.4425686932184186e-05,0.8461538461538461
5815,8744,별도/Noun,13,2,11,4.445926419917751e-05,0.0001443834825295986,0.8461538461538461
5816,8745,캠코더/Noun,13,2,11,4.445926419917751e-05,0.0001443834825295986,0.8461538461538461
5817,8746,방구/Noun,13,2,11,4.445926419917751e-05,0.0001443834825295986,0.8461538461538461
5818,8747,요런/Noun,13,11,2,0.0001444926086473269,4.4425686932184186e-05,0.8461538461538461
5819,8748,분전/Noun,13,2,11,4.445926419917751e-05,0.0001443834825295986,0.8461538461538461
5820,8749,부당하다/Adjective,13,11,2,0.0001444926086473269,4.4425686932184186e-05,0.8461538461538461
5821,8750,당근/Noun,13,11,2,0.0001444926086473269,4.4425686932184186e-05,0.8461538461538461
5822,8751,독립영화관/Noun,13,11,2,0.0001444926086473269,4.4425686932184186e-05,0.8461538461538461
5823,8752,농촌/Noun,13,11,2,0.0001444926086473269,4.4425686932184186e-05,0.8461538461538461
5824,8753,델피/Noun,13,11,2,0.0001444926086473269,4.4425686932184186e-05,0.8461538461538461
5825,8754,은정/Noun,13,2,11,4.445926419917751e-05,0.0001443834825295986,0.8461538461538461
5826,8755,지모/Noun,13,11,2,0.0001444926086473269,4.4425686932184186e-05,0.8461538461538461
5827,8756,캠/Noun,13,2,11,4.445926419917751e-05,0.0001443834825295986,0.8461538461538461
5828,8757,반한/Noun,13,11,2,0.0001444926086473269,4.4425686932184186e-05,0.8461538461538461
5829,8758,빽/Noun,13,2,11,4.445926419917751e-05,0.0001443834825295986,0.8461538461538461
5830,8759,래미/Noun,13,2,11,4.445926419917751e-05,0.0001443834825295986,0.8461538461538461
5831,8760,브랜든/Noun,13,11,2,0.0001444926086473269,4.4425686932184186e-05,0.8461538461538461
5832,8761,깍/Noun,13,2,11,4.445926419917751e-05,0.0001443834825295986,0.8461538461538461
5833,8762,애착/Noun,13,11,2,0.0001444926086473269,4.4425686932184186e-05,0.8461538461538461
5834,8763,재밌슴/Noun,13,11,2,0.0001444926086473269,4.4425686932184186e-05,0.8461538461538461
5835,8764,핑/Noun,13,11,2,0.0001444926086473269,4.4425686932184186e-05,0.8461538461538461
5836,8765,극악/Noun,13,2,11,4.445926419917751e-05,0.0001443834825295986,0.8461538461538461
5837,8766,해피앤딩/Noun,13,11,2,0.0001444926086473269,4.4425686932184186e-05,0.8461538461538461
5838,8767,기인/Noun,13,2,11,4.445926419917751e-05,0.0001443834825295986,0.8461538461538461
5839,8768,돈벌이/Noun,13,2,11,4.445926419917751e-05,0.0001443834825295986,0.8461538461538461
5840,8769,정감/Noun,13,11,2,0.0001444926086473269,4.4425686932184186e-05,0.8461538461538461
5841,8770,흡인/Noun,13,11,2,0.0001444926086473269,4.4425686932184186e-05,0.8461538461538461
5842,8771,삼각관계/Noun,13,2,11,4.445926419917751e-05,0.0001443834825295986,0.8461538461538461
5843,8772,특촬물/Noun,13,2,11,4.445926419917751e-05,0.0001443834825295986,0.8461538461538461
5844,8773,디도/Noun,13,2,11,4.445926419917751e-05,0.0001443834825295986,0.8461538461538461
5845,8774,야심/Noun,13,2,11,4.445926419917751e-05,0.0001443834825295986,0.8461538461538461
5846,8775,블레어/Noun,13,2,11,4.445926419917751e-05,0.0001443834825295986,0.8461538461538461
5847,8776,부리고/Noun,13,2,11,4.445926419917751e-05,0.0001443834825295986,0.8461538461538461
5848,8777,반대편/Noun,13,11,2,0.0001444926086473269,4.4425686932184186e-05,0.8461538461538461
5849,8778,습니/Noun,13,11,2,0.0001444926086473269,4.4425686932184186e-05,0.8461538461538461
5850,8779,무스/Noun,13,11,2,0.0001444926086473269,4.4425686932184186e-05,0.8461538461538461
5851,8780,REC/Alpha,13,2,11,4.445926419917751e-05,0.0001443834825295986,0.8461538461538461
5852,8781,꼽는다/Noun,13,11,2,0.0001444926086473269,4.4425686932184186e-05,0.8461538461538461
5853,8782,정은지/Noun,13,11,2,0.0001444926086473269,4.4425686932184186e-05,0.8461538461538461
5854,8783,분발/Noun,13,2,11,4.445926419917751e-05,0.0001443834825295986,0.8461538461538461
5855,8784,4~5/Number,13,2,11,4.445926419917751e-05,0.0001443834825295986,0.8461538461538461
5856,8785,애매모호하다/Adjective,13,2,11,4.445926419917751e-05,0.0001443834825295986,0.8461538461538461
5857,8786,업자/Noun,13,2,11,4.445926419917751e-05,0.0001443834825295986,0.8461538461538461
5858,8787,버프/Noun,13,2,11,4.445926419917751e-05,0.0001443834825295986,0.8461538461538461
5859,8788,코비/Noun,13,11,2,0.0001444926086473269,4.4425686932184186e-05,0.8461538461538461
5860,8789,썸띵/Noun,13,2,11,4.445926419917751e-05,0.0001443834825295986,0.8461538461538461
5861,8790,김정훈/Noun,13,3,10,5.5574080248971876e-05,0.00013327706079655256,0.7692307692307693
5862,8791,소감/Noun,13,3,10,5.5574080248971876e-05,0.00013327706079655256,0.7692307692307693
5863,8792,외로워/Noun,13,10,3,0.0001333777925975325,5.553210866523024e-05,0.7692307692307693
5864,8793,imdb/Alpha,13,3,10,5.5574080248971876e-05,0.00013327706079655256,0.7692307692307693
5865,8794,!!!!!!!!!!!!!/Punctuation,13,10,3,0.0001333777925975325,5.553210866523024e-05,0.7692307692307693
5866,8795,점령/Noun,13,3,10,5.5574080248971876e-05,0.00013327706079655256,0.7692307692307693
5867,8796,캠프/Noun,13,3,10,5.5574080248971876e-05,0.00013327706079655256,0.7692307692307693
5868,8797,숨소리/Noun,13,10,3,0.0001333777925975325,5.553210866523024e-05,0.7692307692307693
5869,8798,거림/Noun,13,10,3,0.0001333777925975325,5.553210866523024e-05,0.7692307692307693
5870,8799,도쿄/Noun,13,10,3,0.0001333777925975325,5.553210866523024e-05,0.7692307692307693
5871,8800,....^^/Punctuation,13,10,3,0.0001333777925975325,5.553210866523024e-05,0.7692307692307693
5872,8801,욥/Noun,13,10,3,0.0001333777925975325,5.553210866523024e-05,0.7692307692307693
5873,8802,인주/Noun,13,3,10,5.5574080248971876e-05,0.00013327706079655256,0.7692307692307693
5874,8803,평가절하/Noun,13,10,3,0.0001333777925975325,5.553210866523024e-05,0.7692307692307693
5875,8804,노홍철/Noun,13,10,3,0.0001333777925975325,5.553210866523024e-05,0.7692307692307693
5876,8805,굴곡/Noun,13,3,10,5.5574080248971876e-05,0.00013327706079655256,0.7692307692307693
5877,8806,소문나다/Verb,13,3,10,5.5574080248971876e-05,0.00013327706079655256,0.7692307692307693
5878,8807,십자/Noun,13,3,10,5.5574080248971876e-05,0.00013327706079655256,0.7692307692307693
5879,8808,쩔/Noun,13,10,3,0.0001333777925975325,5.553210866523024e-05,0.7692307692307693
5880,8809,맛깔/Noun,13,10,3,0.0001333777925975325,5.553210866523024e-05,0.7692307692307693
5881,8810,서유리/Noun,13,3,10,5.5574080248971876e-05,0.00013327706079655256,0.7692307692307693
5882,8811,햐/Noun,13,3,10,5.5574080248971876e-05,0.00013327706079655256,0.7692307692307693
5883,8812,끝임/Noun,13,3,10,5.5574080248971876e-05,0.00013327706079655256,0.7692307692307693
5884,8813,복사/Noun,13,3,10,5.5574080248971876e-05,0.00013327706079655256,0.7692307692307693
5885,8814,조미/Noun,13,10,3,0.0001333777925975325,5.553210866523024e-05,0.7692307692307693
5886,8815,수염/Noun,13,3,10,5.5574080248971876e-05,0.00013327706079655256,0.7692307692307693
5887,8816,빡/Noun,13,3,10,5.5574080248971876e-05,0.00013327706079655256,0.7692307692307693
5888,8817,카렐/Noun,13,10,3,0.0001333777925975325,5.553210866523024e-05,0.7692307692307693
5889,8818,간의/Foreign,13,10,3,0.0001333777925975325,5.553210866523024e-05,0.7692307692307693
5890,8819,이재은/Noun,13,3,10,5.5574080248971876e-05,0.00013327706079655256,0.7692307692307693
5891,8820,배출/Noun,13,10,3,0.0001333777925975325,5.553210866523024e-05,0.7692307692307693
5892,8821,누리/Noun,13,10,3,0.0001333777925975325,5.553210866523024e-05,0.7692307692307693
5893,8822,비겁하다/Adjective,13,3,10,5.5574080248971876e-05,0.00013327706079655256,0.7692307692307693
5894,8823,부들부들/Noun,13,3,10,5.5574080248971876e-05,0.00013327706079655256,0.7692307692307693
5895,8824,수트/Noun,13,10,3,0.0001333777925975325,5.553210866523024e-05,0.7692307692307693
5896,8825,뻑/Noun,13,3,10,5.5574080248971876e-05,0.00013327706079655256,0.7692307692307693
5897,8826,기수/Noun,13,3,10,5.5574080248971876e-05,0.00013327706079655256,0.7692307692307693
5898,8827,스럽지도/Josa,13,3,10,5.5574080248971876e-05,0.00013327706079655256,0.7692307692307693
5899,8828,예언/Noun,13,10,3,0.0001333777925975325,5.553210866523024e-05,0.7692307692307693
5900,8829,120/Number,13,3,10,5.5574080248971876e-05,0.00013327706079655256,0.7692307692307693
5901,8830,넘어오다/Verb,13,3,10,5.5574080248971876e-05,0.00013327706079655256,0.7692307692307693
5902,8831,히트치다/Verb,13,3,10,5.5574080248971876e-05,0.00013327706079655256,0.7692307692307693
5903,8832,고창석/Noun,13,3,10,5.5574080248971876e-05,0.00013327706079655256,0.7692307692307693
5904,8833,조로/Noun,13,3,10,5.5574080248971876e-05,0.00013327706079655256,0.7692307692307693
5905,8834,안대/Noun,13,3,10,5.5574080248971876e-05,0.00013327706079655256,0.7692307692307693
5906,8835,선장/Noun,13,10,3,0.0001333777925975325,5.553210866523024e-05,0.7692307692307693
5907,8836,시적/Noun,13,10,3,0.0001333777925975325,5.553210866523024e-05,0.7692307692307693
5908,8837,방송사/Noun,13,3,10,5.5574080248971876e-05,0.00013327706079655256,0.7692307692307693
5909,8838,국경/Noun,13,10,3,0.0001333777925975325,5.553210866523024e-05,0.7692307692307693
5910,8839,버디/Noun,13,10,3,0.0001333777925975325,5.553210866523024e-05,0.7692307692307693
5911,8840,신체/Noun,13,3,10,5.5574080248971876e-05,0.00013327706079655256,0.7692307692307693
5912,8841,마리옹/Noun,13,10,3,0.0001333777925975325,5.553210866523024e-05,0.7692307692307693
5913,8842,만끽/Noun,13,10,3,0.0001333777925975325,5.553210866523024e-05,0.7692307692307693
5914,8843,봉하/Noun,13,10,3,0.0001333777925975325,5.553210866523024e-05,0.7692307692307693
5915,8844,재개/Noun,13,10,3,0.0001333777925975325,5.553210866523024e-05,0.7692307692307693
5916,8845,살찌다/Adjective,13,3,10,5.5574080248971876e-05,0.00013327706079655256,0.7692307692307693
5917,8846,무의식/Noun,13,10,3,0.0001333777925975325,5.553210866523024e-05,0.7692307692307693
5918,8847,워킹/Noun,13,3,10,5.5574080248971876e-05,0.00013327706079655256,0.7692307692307693
5919,8848,우산/Noun,13,10,3,0.0001333777925975325,5.553210866523024e-05,0.7692307692307693
5920,8849,1960년/Number,13,3,10,5.5574080248971876e-05,0.00013327706079655256,0.7692307692307693
5921,8850,영원/Noun,13,10,3,0.0001333777925975325,5.553210866523024e-05,0.7692307692307693
5922,8851,마리아/Noun,13,10,3,0.0001333777925975325,5.553210866523024e-05,0.7692307692307693
5923,8852,계절/Noun,13,10,3,0.0001333777925975325,5.553210866523024e-05,0.7692307692307693
5924,8853,최루성/Noun,13,4,9,6.668889629876625e-05,0.00012217063906350652,0.6923076923076923
5925,8854,손길/Noun,13,9,4,0.00012226297654773814,6.663853039827628e-05,0.6923076923076923
5926,8855,한고은/Noun,13,4,9,6.668889629876625e-05,0.00012217063906350652,0.6923076923076923
5927,8856,문란하다/Adjective,13,4,9,6.668889629876625e-05,0.00012217063906350652,0.6923076923076923
5928,8857,꺅/Adverb,13,9,4,0.00012226297654773814,6.663853039827628e-05,0.6923076923076923
5929,8858,이영환/Noun,13,4,9,6.668889629876625e-05,0.00012217063906350652,0.6923076923076923
5930,8859,미취/Noun,13,4,9,6.668889629876625e-05,0.00012217063906350652,0.6923076923076923
5931,8860,갑옷/Noun,13,4,9,6.668889629876625e-05,0.00012217063906350652,0.6923076923076923
5932,8861,가르시아/Noun,13,9,4,0.00012226297654773814,6.663853039827628e-05,0.6923076923076923
5933,8862,이어도/Noun,13,9,4,0.00012226297654773814,6.663853039827628e-05,0.6923076923076923
5934,8863,천안함/Noun,13,4,9,6.668889629876625e-05,0.00012217063906350652,0.6923076923076923
5935,8864,하류/Noun,13,4,9,6.668889629876625e-05,0.00012217063906350652,0.6923076923076923
5936,8865,나미/Noun,13,4,9,6.668889629876625e-05,0.00012217063906350652,0.6923076923076923
5937,8866,엿/Noun,13,4,9,6.668889629876625e-05,0.00012217063906350652,0.6923076923076923
5938,8867,아찔하다/Adjective,13,9,4,0.00012226297654773814,6.663853039827628e-05,0.6923076923076923
5939,8868,소신/Noun,13,9,4,0.00012226297654773814,6.663853039827628e-05,0.6923076923076923
5940,8869,엘리/Noun,13,9,4,0.00012226297654773814,6.663853039827628e-05,0.6923076923076923
5941,8870,로미오/Noun,13,9,4,0.00012226297654773814,6.663853039827628e-05,0.6923076923076923
5942,8871,이씨/Noun,13,4,9,6.668889629876625e-05,0.00012217063906350652,0.6923076923076923
5943,8872,모모/Noun,13,4,9,6.668889629876625e-05,0.00012217063906350652,0.6923076923076923
5944,8873,비율/Noun,13,4,9,6.668889629876625e-05,0.00012217063906350652,0.6923076923076923
5945,8874,게이트/Noun,13,9,4,0.00012226297654773814,6.663853039827628e-05,0.6923076923076923
5946,8875,5.5/Number,13,4,9,6.668889629876625e-05,0.00012217063906350652,0.6923076923076923
5947,8876,고대/Noun,13,9,4,0.00012226297654773814,6.663853039827628e-05,0.6923076923076923
5948,8877,인가/Foreign,13,9,4,0.00012226297654773814,6.663853039827628e-05,0.6923076923076923
5949,8878,첩혈쌍웅/Noun,13,9,4,0.00012226297654773814,6.663853039827628e-05,0.6923076923076923
5950,8879,무쟈/Noun,13,4,9,6.668889629876625e-05,0.00012217063906350652,0.6923076923076923
5951,8880,왕가네/Noun,13,4,9,6.668889629876625e-05,0.00012217063906350652,0.6923076923076923
5952,8881,gg/Alpha,13,4,9,6.668889629876625e-05,0.00012217063906350652,0.6923076923076923
5953,8882,가출/Noun,13,4,9,6.668889629876625e-05,0.00012217063906350652,0.6923076923076923
5954,8883,캔디/Noun,13,9,4,0.00012226297654773814,6.663853039827628e-05,0.6923076923076923
5955,8884,취업/Noun,13,9,4,0.00012226297654773814,6.663853039827628e-05,0.6923076923076923
5956,8885,장통/Noun,13,9,4,0.00012226297654773814,6.663853039827628e-05,0.6923076923076923
5957,8886,조온나/Noun,13,4,9,6.668889629876625e-05,0.00012217063906350652,0.6923076923076923
5958,8887,설교/Noun,13,4,9,6.668889629876625e-05,0.00012217063906350652,0.6923076923076923
5959,8888,애증/Noun,13,9,4,0.00012226297654773814,6.663853039827628e-05,0.6923076923076923
5960,8889,빼앗다/Verb,13,4,9,6.668889629876625e-05,0.00012217063906350652,0.6923076923076923
5961,8890,강인/Noun,13,4,9,6.668889629876625e-05,0.00012217063906350652,0.6923076923076923
5962,8891,약점/Noun,13,4,9,6.668889629876625e-05,0.00012217063906350652,0.6923076923076923
5963,8892,올라서다/Verb,13,9,4,0.00012226297654773814,6.663853039827628e-05,0.6923076923076923
5964,8893,BEST/Alpha,13,9,4,0.00012226297654773814,6.663853039827628e-05,0.6923076923076923
5965,8894,왜냐하면/Adverb,13,9,4,0.00012226297654773814,6.663853039827628e-05,0.6923076923076923
5966,8895,훑다/Verb,13,4,9,6.668889629876625e-05,0.00012217063906350652,0.6923076923076923
5967,8896,동해/Noun,13,4,9,6.668889629876625e-05,0.00012217063906350652,0.6923076923076923
5968,8897,휴일/Noun,13,9,4,0.00012226297654773814,6.663853039827628e-05,0.6923076923076923
5969,8898,주된/Modifier,13,4,9,6.668889629876625e-05,0.00012217063906350652,0.6923076923076923
5970,8899,불사신/Noun,13,4,9,6.668889629876625e-05,0.00012217063906350652,0.6923076923076923
5971,8900,선악/Noun,13,9,4,0.00012226297654773814,6.663853039827628e-05,0.6923076923076923
5972,8901,공평하다/Adjective,13,9,4,0.00012226297654773814,6.663853039827628e-05,0.6923076923076923
5973,8902,신경안/Noun,13,4,9,6.668889629876625e-05,0.00012217063906350652,0.6923076923076923
5974,8903,성취/Noun,13,9,4,0.00012226297654773814,6.663853039827628e-05,0.6923076923076923
5975,8904,근원/Noun,13,9,4,0.00012226297654773814,6.663853039827628e-05,0.6923076923076923
5976,8905,민아/Noun,13,9,4,0.00012226297654773814,6.663853039827628e-05,0.6923076923076923
5977,8906,알렌/Noun,13,9,4,0.00012226297654773814,6.663853039827628e-05,0.6923076923076923
5978,8907,광수/Noun,13,4,9,6.668889629876625e-05,0.00012217063906350652,0.6923076923076923
5979,8908,시급하다/Adjective,13,4,9,6.668889629876625e-05,0.00012217063906350652,0.6923076923076923
5980,8909,남극/Noun,13,9,4,0.00012226297654773814,6.663853039827628e-05,0.6923076923076923
5981,8910,절벽/Noun,13,4,9,6.668889629876625e-05,0.00012217063906350652,0.6923076923076923
5982,8911,브레드/Noun,13,4,9,6.668889629876625e-05,0.00012217063906350652,0.6923076923076923
5983,8912,실현/Noun,13,9,4,0.00012226297654773814,6.663853039827628e-05,0.6923076923076923
5984,8913,아부지/Noun,13,9,4,0.00012226297654773814,6.663853039827628e-05,0.6923076923076923
5985,8914,27/Number,13,9,4,0.00012226297654773814,6.663853039827628e-05,0.6923076923076923
5986,8915,노출씬/Noun,13,4,9,6.668889629876625e-05,0.00012217063906350652,0.6923076923076923
5987,8916,달려들다/Verb,13,4,9,6.668889629876625e-05,0.00012217063906350652,0.6923076923076923
5988,8917,문어/Noun,13,4,9,6.668889629876625e-05,0.00012217063906350652,0.6923076923076923
5989,8918,동반/Noun,13,9,4,0.00012226297654773814,6.663853039827628e-05,0.6923076923076923
5990,8919,♪/Foreign,13,9,4,0.00012226297654773814,6.663853039827628e-05,0.6923076923076923
5991,8920,최다니엘/Noun,13,9,4,0.00012226297654773814,6.663853039827628e-05,0.6923076923076923
5992,8921,차량/Noun,13,4,9,6.668889629876625e-05,0.00012217063906350652,0.6923076923076923
5993,8922,주도/Noun,13,4,9,6.668889629876625e-05,0.00012217063906350652,0.6923076923076923
5994,8923,히든싱어/Noun,13,9,4,0.00012226297654773814,6.663853039827628e-05,0.6923076923076923
5995,8924,마자/Noun,13,4,9,6.668889629876625e-05,0.00012217063906350652,0.6923076923076923
5996,8925,시공간/Noun,13,9,4,0.00012226297654773814,6.663853039827628e-05,0.6923076923076923
5997,8926,신작/Noun,13,4,9,6.668889629876625e-05,0.00012217063906350652,0.6923076923076923
5998,8927,기여/Noun,13,9,4,0.00012226297654773814,6.663853039827628e-05,0.6923076923076923
5999,8928,른/Noun,13,9,4,0.00012226297654773814,6.663853039827628e-05,0.6923076923076923
6000,8929,수백/Modifier,13,4,9,6.668889629876625e-05,0.00012217063906350652,0.6923076923076923
6001,8930,무덥다/Adjective,13,9,4,0.00012226297654773814,6.663853039827628e-05,0.6923076923076923
6002,8931,김인권/Noun,13,4,9,6.668889629876625e-05,0.00012217063906350652,0.6923076923076923
6003,8932,성별/Noun,13,4,9,6.668889629876625e-05,0.00012217063906350652,0.6923076923076923
6004,8933,오징어/Noun,13,4,9,6.668889629876625e-05,0.00012217063906350652,0.6923076923076923
6005,8934,허드/Noun,13,4,9,6.668889629876625e-05,0.00012217063906350652,0.6923076923076923
6006,8935,치정/Noun,13,4,9,6.668889629876625e-05,0.00012217063906350652,0.6923076923076923
6007,8936,회도/Noun,13,9,4,0.00012226297654773814,6.663853039827628e-05,0.6923076923076923
6008,8937,구가/Noun,13,4,9,6.668889629876625e-05,0.00012217063906350652,0.6923076923076923
6009,8938,에어컨/Noun,13,5,8,7.780371234856063e-05,0.00011106421733046048,0.6153846153846154
6010,8939,최면/Noun,13,5,8,7.780371234856063e-05,0.00011106421733046048,0.6153846153846154
6011,8940,더락/Noun,13,8,5,0.00011114816049794375,7.774495213132233e-05,0.6153846153846154
6012,8941,찾아내다/Verb,13,8,5,0.00011114816049794375,7.774495213132233e-05,0.6153846153846154
6013,8942,자리다/Adjective,13,8,5,0.00011114816049794375,7.774495213132233e-05,0.6153846153846154
6014,8943,힝/Noun,13,8,5,0.00011114816049794375,7.774495213132233e-05,0.6153846153846154
6015,8944,으이/Adverb,13,5,8,7.780371234856063e-05,0.00011106421733046048,0.6153846153846154
6016,8945,스시/Noun,13,8,5,0.00011114816049794375,7.774495213132233e-05,0.6153846153846154
6017,8946,비도/Noun,13,8,5,0.00011114816049794375,7.774495213132233e-05,0.6153846153846154
6018,8947,특공대/Noun,13,5,8,7.780371234856063e-05,0.00011106421733046048,0.6153846153846154
6019,8948,고다르/Noun,13,8,5,0.00011114816049794375,7.774495213132233e-05,0.6153846153846154
6020,8949,아나운서/Noun,13,5,8,7.780371234856063e-05,0.00011106421733046048,0.6153846153846154
6021,8950,저주받다/Verb,13,5,8,7.780371234856063e-05,0.00011106421733046048,0.6153846153846154
6022,8951,정면/Noun,13,8,5,0.00011114816049794375,7.774495213132233e-05,0.6153846153846154
6023,8952,썸머/Noun,13,8,5,0.00011114816049794375,7.774495213132233e-05,0.6153846153846154
6024,8953,조성/Noun,13,5,8,7.780371234856063e-05,0.00011106421733046048,0.6153846153846154
6025,8954,모에/Noun,13,5,8,7.780371234856063e-05,0.00011106421733046048,0.6153846153846154
6026,8955,범죄물/Noun,13,5,8,7.780371234856063e-05,0.00011106421733046048,0.6153846153846154
6027,8956,엇을/Noun,13,5,8,7.780371234856063e-05,0.00011106421733046048,0.6153846153846154
6028,8957,해군/Noun,13,8,5,0.00011114816049794375,7.774495213132233e-05,0.6153846153846154
6029,8958,아우라/Noun,13,5,8,7.780371234856063e-05,0.00011106421733046048,0.6153846153846154
6030,8959,마나/Noun,13,5,8,7.780371234856063e-05,0.00011106421733046048,0.6153846153846154
6031,8960,구별/Noun,13,5,8,7.780371234856063e-05,0.00011106421733046048,0.6153846153846154
6032,8961,>./Punctuation,13,8,5,0.00011114816049794375,7.774495213132233e-05,0.6153846153846154
6033,8962,중립/Noun,13,5,8,7.780371234856063e-05,0.00011106421733046048,0.6153846153846154
6034,8963,멕시코/Noun,13,5,8,7.780371234856063e-05,0.00011106421733046048,0.6153846153846154
6035,8964,솔직/Noun,13,8,5,0.00011114816049794375,7.774495213132233e-05,0.6153846153846154
6036,8965,언덕/Noun,13,8,5,0.00011114816049794375,7.774495213132233e-05,0.6153846153846154
6037,8966,오케스트라/Noun,13,8,5,0.00011114816049794375,7.774495213132233e-05,0.6153846153846154
6038,8967,해병대/Noun,13,5,8,7.780371234856063e-05,0.00011106421733046048,0.6153846153846154
6039,8968,아악/Noun,13,5,8,7.780371234856063e-05,0.00011106421733046048,0.6153846153846154
6040,8969,필드/Noun,13,5,8,7.780371234856063e-05,0.00011106421733046048,0.6153846153846154
6041,8970,머랄/Noun,13,5,8,7.780371234856063e-05,0.00011106421733046048,0.6153846153846154
6042,8971,프로포즈/Noun,13,8,5,0.00011114816049794375,7.774495213132233e-05,0.6153846153846154
6043,8972,드레스/Noun,13,5,8,7.780371234856063e-05,0.00011106421733046048,0.6153846153846154
6044,8973,골고루/Adverb,13,8,5,0.00011114816049794375,7.774495213132233e-05,0.6153846153846154
6045,8974,건아/Noun,13,5,8,7.780371234856063e-05,0.00011106421733046048,0.6153846153846154
6046,8975,재목/Noun,13,5,8,7.780371234856063e-05,0.00011106421733046048,0.6153846153846154
6047,8976,난도질/Noun,13,5,8,7.780371234856063e-05,0.00011106421733046048,0.6153846153846154
6048,8977,km/Alpha,13,5,8,7.780371234856063e-05,0.00011106421733046048,0.6153846153846154
6049,8978,에이즈/Noun,13,5,8,7.780371234856063e-05,0.00011106421733046048,0.6153846153846154
6050,8979,소속/Noun,13,5,8,7.780371234856063e-05,0.00011106421733046048,0.6153846153846154
6051,8980,관찰/Noun,13,8,5,0.00011114816049794375,7.774495213132233e-05,0.6153846153846154
6052,8981,벨소리/Noun,13,5,8,7.780371234856063e-05,0.00011106421733046048,0.6153846153846154
6053,8982,전우치/Noun,13,8,5,0.00011114816049794375,7.774495213132233e-05,0.6153846153846154
6054,8983,FBI/Alpha,13,5,8,7.780371234856063e-05,0.00011106421733046048,0.6153846153846154
6055,8984,라이벌/Noun,13,8,5,0.00011114816049794375,7.774495213132233e-05,0.6153846153846154
6056,8985,방문/Noun,13,5,8,7.780371234856063e-05,0.00011106421733046048,0.6153846153846154
6057,8986,떳떳하다/Adjective,13,8,5,0.00011114816049794375,7.774495213132233e-05,0.6153846153846154
6058,8987,어느덧다/Adjective,13,8,5,0.00011114816049794375,7.774495213132233e-05,0.6153846153846154
6059,8988,브리트니/Noun,13,8,5,0.00011114816049794375,7.774495213132233e-05,0.6153846153846154
6060,8989,로망스/Noun,13,8,5,0.00011114816049794375,7.774495213132233e-05,0.6153846153846154
6061,8990,돌보다/Verb,13,8,5,0.00011114816049794375,7.774495213132233e-05,0.6153846153846154
6062,8991,아지/Noun,13,5,8,7.780371234856063e-05,0.00011106421733046048,0.6153846153846154
6063,8992,타카/Noun,13,8,5,0.00011114816049794375,7.774495213132233e-05,0.6153846153846154
6064,8993,바이/Noun,13,8,5,0.00011114816049794375,7.774495213132233e-05,0.6153846153846154
6065,8994,몇십/Modifier,13,5,8,7.780371234856063e-05,0.00011106421733046048,0.6153846153846154
6066,8995,사탕/Noun,13,5,8,7.780371234856063e-05,0.00011106421733046048,0.6153846153846154
6067,8996,무너/Noun,13,5,8,7.780371234856063e-05,0.00011106421733046048,0.6153846153846154
6068,8997,??????/Punctuation,13,5,8,7.780371234856063e-05,0.00011106421733046048,0.6153846153846154
6069,8998,참가자/Noun,13,5,8,7.780371234856063e-05,0.00011106421733046048,0.6153846153846154
6070,8999,창의력/Noun,13,5,8,7.780371234856063e-05,0.00011106421733046048,0.6153846153846154
6071,9000,산악/Noun,13,8,5,0.00011114816049794375,7.774495213132233e-05,0.6153846153846154
6072,9001,하진/Noun,13,8,5,0.00011114816049794375,7.774495213132233e-05,0.6153846153846154
6073,9002,밨는데/Noun,13,8,5,0.00011114816049794375,7.774495213132233e-05,0.6153846153846154
6074,9003,양자경/Noun,13,8,5,0.00011114816049794375,7.774495213132233e-05,0.6153846153846154
6075,9004,가만/Adverb,13,5,8,7.780371234856063e-05,0.00011106421733046048,0.6153846153846154
6076,9005,맨몸/Noun,13,8,5,0.00011114816049794375,7.774495213132233e-05,0.6153846153846154
6077,9006,오전/Noun,13,5,8,7.780371234856063e-05,0.00011106421733046048,0.6153846153846154
6078,9007,해당/Noun,13,5,8,7.780371234856063e-05,0.00011106421733046048,0.6153846153846154
6079,9008,수의/Noun,13,5,8,7.780371234856063e-05,0.00011106421733046048,0.6153846153846154
6080,9009,타이/Noun,13,8,5,0.00011114816049794375,7.774495213132233e-05,0.6153846153846154
6081,9010,박지성/Noun,13,8,5,0.00011114816049794375,7.774495213132233e-05,0.6153846153846154
6082,9011,대체로/Noun,13,5,8,7.780371234856063e-05,0.00011106421733046048,0.6153846153846154
6083,9012,ㅊ/KoreanParticle,13,8,5,0.00011114816049794375,7.774495213132233e-05,0.6153846153846154
6084,9013,차례/Noun,13,5,8,7.780371234856063e-05,0.00011106421733046048,0.6153846153846154
6085,9014,동굴/Noun,13,5,8,7.780371234856063e-05,0.00011106421733046048,0.6153846153846154
6086,9015,눈썹/Noun,13,5,8,7.780371234856063e-05,0.00011106421733046048,0.6153846153846154
6087,9016,코미/Noun,13,8,5,0.00011114816049794375,7.774495213132233e-05,0.6153846153846154
6088,9017,원주민/Noun,13,5,8,7.780371234856063e-05,0.00011106421733046048,0.6153846153846154
6089,9114,달콤/Noun,12,12,0,0.00015560742469712126,2.2212843466092093e-05,1.0
6090,9115,아동학대/Noun,12,0,12,2.2229632099588756e-05,0.00015548990426264466,1.0
6091,9116,함량/Noun,12,0,12,2.2229632099588756e-05,0.00015548990426264466,1.0
6092,9117,언플/Noun,12,0,12,2.2229632099588756e-05,0.00015548990426264466,1.0
6093,9118,알몸/Noun,12,0,12,2.2229632099588756e-05,0.00015548990426264466,1.0
6094,9119,뭐/Exclamation,12,0,12,2.2229632099588756e-05,0.00015548990426264466,1.0
6095,9120,박시환/Noun,12,0,12,2.2229632099588756e-05,0.00015548990426264466,1.0
6096,9121,넘겨보다/Verb,12,0,12,2.2229632099588756e-05,0.00015548990426264466,1.0
6097,9122,예스/Noun,12,12,0,0.00015560742469712126,2.2212843466092093e-05,1.0
6098,9123,허접스럽다/Adjective,12,0,12,2.2229632099588756e-05,0.00015548990426264466,1.0
6099,9124,붙여넣기/Noun,12,0,12,2.2229632099588756e-05,0.00015548990426264466,1.0
6100,9125,횡설수설/Noun,12,0,12,2.2229632099588756e-05,0.00015548990426264466,1.0
6101,9126,故/Foreign,12,12,0,0.00015560742469712126,2.2212843466092093e-05,1.0
6102,9127,아이폰/Noun,12,0,12,2.2229632099588756e-05,0.00015548990426264466,1.0
6103,9128,게머/Noun,12,0,12,2.2229632099588756e-05,0.00015548990426264466,1.0
6104,9129,요점/Noun,12,0,12,2.2229632099588756e-05,0.00015548990426264466,1.0
6105,9130,쵝/Noun,12,12,0,0.00015560742469712126,2.2212843466092093e-05,1.0
6106,9131,정색/Noun,12,0,12,2.2229632099588756e-05,0.00015548990426264466,1.0
6107,9132,가지가지/Noun,12,0,12,2.2229632099588756e-05,0.00015548990426264466,1.0
6108,9133,화남/Noun,12,0,12,2.2229632099588756e-05,0.00015548990426264466,1.0
6109,9134,다망/Noun,12,0,12,2.2229632099588756e-05,0.00015548990426264466,1.0
6110,9135,서동요/Noun,12,11,1,0.0001444926086473269,3.331926519913814e-05,0.9166666666666666
6111,9136,에구/Exclamation,12,1,11,3.334444814938313e-05,0.0001443834825295986,0.9166666666666666
6112,9137,샬롯/Noun,12,11,1,0.0001444926086473269,3.331926519913814e-05,0.9166666666666666
6113,9138,화표/Noun,12,1,11,3.334444814938313e-05,0.0001443834825295986,0.9166666666666666
6114,9139,국물/Noun,12,1,11,3.334444814938313e-05,0.0001443834825295986,0.9166666666666666
6115,9140,겉도/Noun,12,1,11,3.334444814938313e-05,0.0001443834825295986,0.9166666666666666
6116,9141,온갖/Modifier,12,1,11,3.334444814938313e-05,0.0001443834825295986,0.9166666666666666
6117,9142,참상/Noun,12,11,1,0.0001444926086473269,3.331926519913814e-05,0.9166666666666666
6118,9143,챙/Noun,12,1,11,3.334444814938313e-05,0.0001443834825295986,0.9166666666666666
6119,9144,쉴드/Noun,12,1,11,3.334444814938313e-05,0.0001443834825295986,0.9166666666666666
6120,9145,비범하다/Adjective,12,11,1,0.0001444926086473269,3.331926519913814e-05,0.9166666666666666
6121,9146,갈비/Noun,12,1,11,3.334444814938313e-05,0.0001443834825295986,0.9166666666666666
6122,9147,~^/Punctuation,12,11,1,0.0001444926086473269,3.331926519913814e-05,0.9166666666666666
6123,9148,콩콩/Adverb,12,1,11,3.334444814938313e-05,0.0001443834825295986,0.9166666666666666
6124,9149,퇴마록/Noun,12,1,11,3.334444814938313e-05,0.0001443834825295986,0.9166666666666666
6125,9150,색안경/Noun,12,11,1,0.0001444926086473269,3.331926519913814e-05,0.9166666666666666
6126,9151,똥칠/Noun,12,1,11,3.334444814938313e-05,0.0001443834825295986,0.9166666666666666
6127,9152,장대/Noun,12,11,1,0.0001444926086473269,3.331926519913814e-05,0.9166666666666666
6128,9153,~*/Punctuation,12,11,1,0.0001444926086473269,3.331926519913814e-05,0.9166666666666666
6129,9154,My/Alpha,12,11,1,0.0001444926086473269,3.331926519913814e-05,0.9166666666666666
6130,9155,가까워지다/Verb,12,11,1,0.0001444926086473269,3.331926519913814e-05,0.9166666666666666
6131,9156,취재/Noun,12,1,11,3.334444814938313e-05,0.0001443834825295986,0.9166666666666666
6132,9157,시망/Noun,12,1,11,3.334444814938313e-05,0.0001443834825295986,0.9166666666666666
6133,9158,퉤퉤/Noun,12,1,11,3.334444814938313e-05,0.0001443834825295986,0.9166666666666666
6134,9159,유식/Noun,12,1,11,3.334444814938313e-05,0.0001443834825295986,0.9166666666666666
6135,9160,글썽/Noun,12,11,1,0.0001444926086473269,3.331926519913814e-05,0.9166666666666666
6136,9161,뻘짓/Noun,12,1,11,3.334444814938313e-05,0.0001443834825295986,0.9166666666666666
6137,9162,세도/Noun,12,1,11,3.334444814938313e-05,0.0001443834825295986,0.9166666666666666
6138,9163,초강추/Noun,12,11,1,0.0001444926086473269,3.331926519913814e-05,0.9166666666666666
6139,9164,친자/Noun,12,1,11,3.334444814938313e-05,0.0001443834825295986,0.9166666666666666
6140,9165,아이큐/Noun,12,1,11,3.334444814938313e-05,0.0001443834825295986,0.9166666666666666
6141,9166,마구잡이/Noun,12,1,11,3.334444814938313e-05,0.0001443834825295986,0.9166666666666666
6142,9167,위노나/Noun,12,11,1,0.0001444926086473269,3.331926519913814e-05,0.9166666666666666
6143,9168,개떡/Noun,12,1,11,3.334444814938313e-05,0.0001443834825295986,0.9166666666666666
6144,9169,당혹스럽다/Adjective,12,1,11,3.334444814938313e-05,0.0001443834825295986,0.9166666666666666
6145,9170,10억/Number,12,1,11,3.334444814938313e-05,0.0001443834825295986,0.9166666666666666
6146,9171,삼생이/Noun,12,1,11,3.334444814938313e-05,0.0001443834825295986,0.9166666666666666
6147,9172,뿌듯하다/Adjective,12,11,1,0.0001444926086473269,3.331926519913814e-05,0.9166666666666666
6148,9173,얼척/Noun,12,1,11,3.334444814938313e-05,0.0001443834825295986,0.9166666666666666
6149,9174,어정쩡/Adverb,12,1,11,3.334444814938313e-05,0.0001443834825295986,0.9166666666666666
6150,9175,미녀삼총사/Noun,12,1,11,3.334444814938313e-05,0.0001443834825295986,0.9166666666666666
6151,9176,봣네/Noun,12,11,1,0.0001444926086473269,3.331926519913814e-05,0.9166666666666666
6152,9177,11시/Number,12,11,1,0.0001444926086473269,3.331926519913814e-05,0.9166666666666666
6153,9178,눈꼽/Noun,12,1,11,3.334444814938313e-05,0.0001443834825295986,0.9166666666666666
6154,9179,화병/Noun,12,2,10,4.445926419917751e-05,0.00013327706079655256,0.8333333333333334
6155,9180,법적/Noun,12,2,10,4.445926419917751e-05,0.00013327706079655256,0.8333333333333334
6156,9181,캡/Noun,12,10,2,0.0001333777925975325,4.4425686932184186e-05,0.8333333333333334
6157,9182,",,,,,,/Punctuation",12,2,10,4.445926419917751e-05,0.00013327706079655256,0.8333333333333334
6158,9183,재일교포/Noun,12,10,2,0.0001333777925975325,4.4425686932184186e-05,0.8333333333333334
6159,9184,소속사/Noun,12,2,10,4.445926419917751e-05,0.00013327706079655256,0.8333333333333334
6160,9185,중단/Noun,12,2,10,4.445926419917751e-05,0.00013327706079655256,0.8333333333333334
6161,9186,손목/Noun,12,2,10,4.445926419917751e-05,0.00013327706079655256,0.8333333333333334
6162,9187,무인/Noun,12,10,2,0.0001333777925975325,4.4425686932184186e-05,0.8333333333333334
6163,9188,불사조/Noun,12,2,10,4.445926419917751e-05,0.00013327706079655256,0.8333333333333334
6164,9189,고소하다/Adjective,12,2,10,4.445926419917751e-05,0.00013327706079655256,0.8333333333333334
6165,9190,비긴즈/Noun,12,10,2,0.0001333777925975325,4.4425686932184186e-05,0.8333333333333334
6166,9191,직시/Noun,12,10,2,0.0001333777925975325,4.4425686932184186e-05,0.8333333333333334
6167,9192,84년/Number,12,10,2,0.0001333777925975325,4.4425686932184186e-05,0.8333333333333334
6168,9193,메르스/Noun,12,10,2,0.0001333777925975325,4.4425686932184186e-05,0.8333333333333334
6169,9194,르네젤위거/Noun,12,10,2,0.0001333777925975325,4.4425686932184186e-05,0.8333333333333334
6170,9195,후벼파다/Verb,12,10,2,0.0001333777925975325,4.4425686932184186e-05,0.8333333333333334
6171,9196,징기스칸/Noun,12,2,10,4.445926419917751e-05,0.00013327706079655256,0.8333333333333334
6172,9197,급작/Noun,12,2,10,4.445926419917751e-05,0.00013327706079655256,0.8333333333333334
6173,9198,김동완/Noun,12,10,2,0.0001333777925975325,4.4425686932184186e-05,0.8333333333333334
6174,9199,린지/Noun,12,2,10,4.445926419917751e-05,0.00013327706079655256,0.8333333333333334
6175,9200,애뜻/Noun,12,10,2,0.0001333777925975325,4.4425686932184186e-05,0.8333333333333334
6176,9201,라푼젤/Noun,12,10,2,0.0001333777925975325,4.4425686932184186e-05,0.8333333333333334
6177,9202,내적/Noun,12,10,2,0.0001333777925975325,4.4425686932184186e-05,0.8333333333333334
6178,9203,어후/Noun,12,2,10,4.445926419917751e-05,0.00013327706079655256,0.8333333333333334
6179,9204,아키/Noun,12,10,2,0.0001333777925975325,4.4425686932184186e-05,0.8333333333333334
6180,9205,마부/Noun,12,10,2,0.0001333777925975325,4.4425686932184186e-05,0.8333333333333334
6181,9206,스푼/Noun,12,2,10,4.445926419917751e-05,0.00013327706079655256,0.8333333333333334
6182,9207,정치가/Noun,12,10,2,0.0001333777925975325,4.4425686932184186e-05,0.8333333333333334
6183,9208,음슴다/Verb,12,2,10,4.445926419917751e-05,0.00013327706079655256,0.8333333333333334
6184,9209,훗/Noun,12,10,2,0.0001333777925975325,4.4425686932184186e-05,0.8333333333333334
6185,9210,더러/Josa,12,2,10,4.445926419917751e-05,0.00013327706079655256,0.8333333333333334
6186,9211,골빈/Noun,12,2,10,4.445926419917751e-05,0.00013327706079655256,0.8333333333333334
6187,9212,~~~!/Punctuation,12,10,2,0.0001333777925975325,4.4425686932184186e-05,0.8333333333333334
6188,9213,기질/Noun,12,2,10,4.445926419917751e-05,0.00013327706079655256,0.8333333333333334
6189,9214,들뜨다/Adjective,12,10,2,0.0001333777925975325,4.4425686932184186e-05,0.8333333333333334
6190,9215,최시원/Noun,12,2,10,4.445926419917751e-05,0.00013327706079655256,0.8333333333333334
6191,9216,부하/Noun,12,2,10,4.445926419917751e-05,0.00013327706079655256,0.8333333333333334
6192,9217,허리/Noun,12,2,10,4.445926419917751e-05,0.00013327706079655256,0.8333333333333334
6193,9218,인과/Noun,12,2,10,4.445926419917751e-05,0.00013327706079655256,0.8333333333333334
6194,9219,수채화/Noun,12,10,2,0.0001333777925975325,4.4425686932184186e-05,0.8333333333333334
6195,9220,팬더/Noun,12,2,10,4.445926419917751e-05,0.00013327706079655256,0.8333333333333334
6196,9221,본래/Noun,12,2,10,4.445926419917751e-05,0.00013327706079655256,0.8333333333333334
6197,9222,해답/Noun,12,10,2,0.0001333777925975325,4.4425686932184186e-05,0.8333333333333334
6198,9223,제자리/Noun,12,2,10,4.445926419917751e-05,0.00013327706079655256,0.8333333333333334
6199,9224,테드/Noun,12,10,2,0.0001333777925975325,4.4425686932184186e-05,0.8333333333333334
6200,9225,신물/Noun,12,2,10,4.445926419917751e-05,0.00013327706079655256,0.8333333333333334
6201,9226,볼빠/Noun,12,2,10,4.445926419917751e-05,0.00013327706079655256,0.8333333333333334
6202,9227,역행/Noun,12,2,10,4.445926419917751e-05,0.00013327706079655256,0.8333333333333334
6203,9228,당초/Noun,12,2,10,4.445926419917751e-05,0.00013327706079655256,0.8333333333333334
6204,9229,고요하다/Adjective,12,10,2,0.0001333777925975325,4.4425686932184186e-05,0.8333333333333334
6205,9230,킥/Noun,12,2,10,4.445926419917751e-05,0.00013327706079655256,0.8333333333333334
6206,9231,제이크/Noun,12,10,2,0.0001333777925975325,4.4425686932184186e-05,0.8333333333333334
6207,9232,연달/Noun,12,10,2,0.0001333777925975325,4.4425686932184186e-05,0.8333333333333334
6208,9233,강박증/Noun,12,9,3,0.00012226297654773814,5.553210866523024e-05,0.75
6209,9234,연재/Noun,12,9,3,0.00012226297654773814,5.553210866523024e-05,0.75
6210,9235,대로의/Josa,12,9,3,0.00012226297654773814,5.553210866523024e-05,0.75
6211,9236,암담하다/Adjective,12,3,9,5.5574080248971876e-05,0.00012217063906350652,0.75
6212,9237,왓으/Noun,12,9,3,0.00012226297654773814,5.553210866523024e-05,0.75
6213,9238,가상/Noun,12,9,3,0.00012226297654773814,5.553210866523024e-05,0.75
6214,9239,So/Alpha,12,9,3,0.00012226297654773814,5.553210866523024e-05,0.75
6215,9240,이래저래/Adverb,12,3,9,5.5574080248971876e-05,0.00012217063906350652,0.75
6216,9241,순전하다/Adjective,12,3,9,5.5574080248971876e-05,0.00012217063906350652,0.75
6217,9242,라이어/Noun,12,3,9,5.5574080248971876e-05,0.00012217063906350652,0.75
6218,9243,배치/Noun,12,9,3,0.00012226297654773814,5.553210866523024e-05,0.75
6219,9244,축소/Noun,12,9,3,0.00012226297654773814,5.553210866523024e-05,0.75
6220,9245,다듬어지다/Verb,12,9,3,0.00012226297654773814,5.553210866523024e-05,0.75
6221,9246,내년/Noun,12,9,3,0.00012226297654773814,5.553210866523024e-05,0.75
6222,9247,윌리암스/Noun,12,9,3,0.00012226297654773814,5.553210866523024e-05,0.75
6223,9248,해명/Noun,12,3,9,5.5574080248971876e-05,0.00012217063906350652,0.75
6224,9249,연연하다/Adjective,12,9,3,0.00012226297654773814,5.553210866523024e-05,0.75
6225,9250,정심/Noun,12,3,9,5.5574080248971876e-05,0.00012217063906350652,0.75
6226,9251,엘리자베스/Noun,12,9,3,0.00012226297654773814,5.553210866523024e-05,0.75
6227,9252,홍어/Noun,12,3,9,5.5574080248971876e-05,0.00012217063906350652,0.75
6228,9253,무법자/Noun,12,9,3,0.00012226297654773814,5.553210866523024e-05,0.75
6229,9254,여름방학/Noun,12,9,3,0.00012226297654773814,5.553210866523024e-05,0.75
6230,9255,사냥꾼/Noun,12,3,9,5.5574080248971876e-05,0.00012217063906350652,0.75
6231,9256,쇼핑/Noun,12,3,9,5.5574080248971876e-05,0.00012217063906350652,0.75
6232,9257,사무/Noun,12,3,9,5.5574080248971876e-05,0.00012217063906350652,0.75
6233,9258,깽/Noun,12,3,9,5.5574080248971876e-05,0.00012217063906350652,0.75
6234,9259,애물/Noun,12,3,9,5.5574080248971876e-05,0.00012217063906350652,0.75
6235,9260,헬드/Noun,12,3,9,5.5574080248971876e-05,0.00012217063906350652,0.75
6236,9261,쩌네/Noun,12,9,3,0.00012226297654773814,5.553210866523024e-05,0.75
6237,9262,고대로/Noun,12,3,9,5.5574080248971876e-05,0.00012217063906350652,0.75
6238,9263,덤앤더머/Noun,12,9,3,0.00012226297654773814,5.553210866523024e-05,0.75
6239,9264,호들갑/Noun,12,3,9,5.5574080248971876e-05,0.00012217063906350652,0.75
6240,9265,포토/Noun,12,3,9,5.5574080248971876e-05,0.00012217063906350652,0.75
6241,9266,격투기/Noun,12,3,9,5.5574080248971876e-05,0.00012217063906350652,0.75
6242,9267,서편제/Noun,12,9,3,0.00012226297654773814,5.553210866523024e-05,0.75
6243,9268,부질없다/Adjective,12,3,9,5.5574080248971876e-05,0.00012217063906350652,0.75
6244,9269,100회/Number,12,3,9,5.5574080248971876e-05,0.00012217063906350652,0.75
6245,9270,야경/Noun,12,3,9,5.5574080248971876e-05,0.00012217063906350652,0.75
6246,9271,고만/Modifier,12,3,9,5.5574080248971876e-05,0.00012217063906350652,0.75
6247,9272,",..../Punctuation",12,3,9,5.5574080248971876e-05,0.00012217063906350652,0.75
6248,9273,전역/Noun,12,9,3,0.00012226297654773814,5.553210866523024e-05,0.75
6249,9274,분도/Noun,12,9,3,0.00012226297654773814,5.553210866523024e-05,0.75
6250,9275,아대/Noun,12,3,9,5.5574080248971876e-05,0.00012217063906350652,0.75
6251,9276,즐감/Noun,12,9,3,0.00012226297654773814,5.553210866523024e-05,0.75
6252,9277,김소현/Noun,12,9,3,0.00012226297654773814,5.553210866523024e-05,0.75
6253,9278,아따맘마/Noun,12,9,3,0.00012226297654773814,5.553210866523024e-05,0.75
6254,9279,고장/Noun,12,3,9,5.5574080248971876e-05,0.00012217063906350652,0.75
6255,9280,차기/Noun,12,9,3,0.00012226297654773814,5.553210866523024e-05,0.75
6256,9281,김범/Noun,12,3,9,5.5574080248971876e-05,0.00012217063906350652,0.75
6257,9282,찰나/Noun,12,9,3,0.00012226297654773814,5.553210866523024e-05,0.75
6258,9283,부러지다/Verb,12,3,9,5.5574080248971876e-05,0.00012217063906350652,0.75
6259,9284,찰리채플린/Noun,12,9,3,0.00012226297654773814,5.553210866523024e-05,0.75
6260,9285,나락/Noun,12,3,9,5.5574080248971876e-05,0.00012217063906350652,0.75
6261,9286,로스/Noun,12,9,3,0.00012226297654773814,5.553210866523024e-05,0.75
6262,9287,풍운/Noun,12,3,9,5.5574080248971876e-05,0.00012217063906350652,0.75
6263,9288,일종/Noun,12,3,9,5.5574080248971876e-05,0.00012217063906350652,0.75
6264,9289,저딴/Modifier,12,3,9,5.5574080248971876e-05,0.00012217063906350652,0.75
6265,9290,생기지/Noun,12,3,9,5.5574080248971876e-05,0.00012217063906350652,0.75
6266,9291,~~~!!!/Punctuation,12,9,3,0.00012226297654773814,5.553210866523024e-05,0.75
6267,9292,크리스천/Noun,12,9,3,0.00012226297654773814,5.553210866523024e-05,0.75
6268,9293,10초/Number,12,3,9,5.5574080248971876e-05,0.00012217063906350652,0.75
6269,9294,스킬/Noun,12,3,9,5.5574080248971876e-05,0.00012217063906350652,0.75
6270,9295,노노/Noun,12,3,9,5.5574080248971876e-05,0.00012217063906350652,0.75
6271,9296,에프/Noun,12,9,3,0.00012226297654773814,5.553210866523024e-05,0.75
6272,9297,조보아/Noun,12,9,3,0.00012226297654773814,5.553210866523024e-05,0.75
6273,9298,교실/Noun,12,9,3,0.00012226297654773814,5.553210866523024e-05,0.75
6274,9299,만회/Noun,12,3,9,5.5574080248971876e-05,0.00012217063906350652,0.75
6275,9300,구먼/Noun,12,3,9,5.5574080248971876e-05,0.00012217063906350652,0.75
6276,9301,서막/Noun,12,9,3,0.00012226297654773814,5.553210866523024e-05,0.75
6277,9302,선진국/Noun,12,9,3,0.00012226297654773814,5.553210866523024e-05,0.75
6278,9303,전의/Foreign,12,9,3,0.00012226297654773814,5.553210866523024e-05,0.75
6279,9304,올린다/Noun,12,9,3,0.00012226297654773814,5.553210866523024e-05,0.75
6280,9305,천만다행/Noun,12,3,9,5.5574080248971876e-05,0.00012217063906350652,0.75
6281,9306,오연서/Noun,12,9,3,0.00012226297654773814,5.553210866523024e-05,0.75
6282,9307,입문/Noun,12,9,3,0.00012226297654773814,5.553210866523024e-05,0.75
6283,9308,가죽/Noun,12,3,9,5.5574080248971876e-05,0.00012217063906350652,0.75
6284,9309,인제/Noun,12,3,9,5.5574080248971876e-05,0.00012217063906350652,0.75
6285,9310,류현경/Noun,12,9,3,0.00012226297654773814,5.553210866523024e-05,0.75
6286,9311,4시간/Number,12,9,3,0.00012226297654773814,5.553210866523024e-05,0.75
6287,9312,논스톱/Noun,12,9,3,0.00012226297654773814,5.553210866523024e-05,0.75
6288,9313,작일/Noun,12,3,9,5.5574080248971876e-05,0.00012217063906350652,0.75
6289,9314,007시/Number,12,9,3,0.00012226297654773814,5.553210866523024e-05,0.75
6290,9315,전태일/Noun,12,9,3,0.00012226297654773814,5.553210866523024e-05,0.75
6291,9316,원수/Noun,12,3,9,5.5574080248971876e-05,0.00012217063906350652,0.75
6292,9317,눈동자/Noun,12,9,3,0.00012226297654773814,5.553210866523024e-05,0.75
6293,9318,심취/Noun,12,8,4,0.00011114816049794375,6.663853039827628e-05,0.6666666666666666
6294,9319,리플리/Noun,12,8,4,0.00011114816049794375,6.663853039827628e-05,0.6666666666666666
6295,9320,안내상/Noun,12,4,8,6.668889629876625e-05,0.00011106421733046048,0.6666666666666666
6296,9321,글로리아/Noun,12,8,4,0.00011114816049794375,6.663853039827628e-05,0.6666666666666666
6297,9322,만으론/Josa,12,4,8,6.668889629876625e-05,0.00011106421733046048,0.6666666666666666
6298,9323,사적/Noun,12,8,4,0.00011114816049794375,6.663853039827628e-05,0.6666666666666666
6299,9324,격인/Noun,12,4,8,6.668889629876625e-05,0.00011106421733046048,0.6666666666666666
6300,9325,입증/Noun,12,4,8,6.668889629876625e-05,0.00011106421733046048,0.6666666666666666
6301,9326,케인/Noun,12,8,4,0.00011114816049794375,6.663853039827628e-05,0.6666666666666666
6302,9327,시크릿/Noun,12,8,4,0.00011114816049794375,6.663853039827628e-05,0.6666666666666666
6303,9328,미라/Noun,12,4,8,6.668889629876625e-05,0.00011106421733046048,0.6666666666666666
6304,9329,퍼레이드/Noun,12,4,8,6.668889629876625e-05,0.00011106421733046048,0.6666666666666666
6305,9330,아이콘/Noun,12,4,8,6.668889629876625e-05,0.00011106421733046048,0.6666666666666666
6306,9331,처럼/Foreign,12,4,8,6.668889629876625e-05,0.00011106421733046048,0.6666666666666666
6307,9332,필자/Noun,12,4,8,6.668889629876625e-05,0.00011106421733046048,0.6666666666666666
6308,9333,우결/Noun,12,4,8,6.668889629876625e-05,0.00011106421733046048,0.6666666666666666
6309,9334,어떨/Modifier,12,8,4,0.00011114816049794375,6.663853039827628e-05,0.6666666666666666
6310,9335,아마존/Noun,12,8,4,0.00011114816049794375,6.663853039827628e-05,0.6666666666666666
6311,9336,다다르다/Verb,12,8,4,0.00011114816049794375,6.663853039827628e-05,0.6666666666666666
6312,9337,갖은/Noun,12,4,8,6.668889629876625e-05,0.00011106421733046048,0.6666666666666666
6313,9338,전생/Noun,12,8,4,0.00011114816049794375,6.663853039827628e-05,0.6666666666666666
6314,9339,모차르트/Noun,12,8,4,0.00011114816049794375,6.663853039827628e-05,0.6666666666666666
6315,9340,밀러/Noun,12,8,4,0.00011114816049794375,6.663853039827628e-05,0.6666666666666666
6316,9341,병헌/Noun,12,8,4,0.00011114816049794375,6.663853039827628e-05,0.6666666666666666
6317,9342,미란다/Noun,12,8,4,0.00011114816049794375,6.663853039827628e-05,0.6666666666666666
6318,9343,무지개/Noun,12,8,4,0.00011114816049794375,6.663853039827628e-05,0.6666666666666666
6319,9344,곤충/Noun,12,8,4,0.00011114816049794375,6.663853039827628e-05,0.6666666666666666
6320,9345,부패/Noun,12,8,4,0.00011114816049794375,6.663853039827628e-05,0.6666666666666666
6321,9346,대를/Foreign,12,8,4,0.00011114816049794375,6.663853039827628e-05,0.6666666666666666
6322,9347,진영/Noun,12,8,4,0.00011114816049794375,6.663853039827628e-05,0.6666666666666666
6323,9348,못난이/Noun,12,8,4,0.00011114816049794375,6.663853039827628e-05,0.6666666666666666
6324,9349,앤디/Noun,12,8,4,0.00011114816049794375,6.663853039827628e-05,0.6666666666666666
6325,9350,설원/Noun,12,8,4,0.00011114816049794375,6.663853039827628e-05,0.6666666666666666
6326,9351,뒷맛/Noun,12,4,8,6.668889629876625e-05,0.00011106421733046048,0.6666666666666666
6327,9352,맘껏/Noun,12,8,4,0.00011114816049794375,6.663853039827628e-05,0.6666666666666666
6328,9353,리틀/Noun,12,8,4,0.00011114816049794375,6.663853039827628e-05,0.6666666666666666
6329,9354,할로윈/Noun,12,4,8,6.668889629876625e-05,0.00011106421733046048,0.6666666666666666
6330,9355,여장/Noun,12,4,8,6.668889629876625e-05,0.00011106421733046048,0.6666666666666666
6331,9356,너머/Noun,12,8,4,0.00011114816049794375,6.663853039827628e-05,0.6666666666666666
6332,9357,되다/Adjective,12,4,8,6.668889629876625e-05,0.00011106421733046048,0.6666666666666666
6333,9358,우리엄마/Noun,12,8,4,0.00011114816049794375,6.663853039827628e-05,0.6666666666666666
6334,9359,임원희/Noun,12,4,8,6.668889629876625e-05,0.00011106421733046048,0.6666666666666666
6335,9360,흥얼거리다/Verb,12,8,4,0.00011114816049794375,6.663853039827628e-05,0.6666666666666666
6336,9361,자이언트/Noun,12,8,4,0.00011114816049794375,6.663853039827628e-05,0.6666666666666666
6337,9362,ㄱㄱㄱ/KoreanParticle,12,4,8,6.668889629876625e-05,0.00011106421733046048,0.6666666666666666
6338,9363,박근혜/Noun,12,8,4,0.00011114816049794375,6.663853039827628e-05,0.6666666666666666
6339,9364,버러지/Noun,12,4,8,6.668889629876625e-05,0.00011106421733046048,0.6666666666666666
6340,9365,특이/Noun,12,8,4,0.00011114816049794375,6.663853039827628e-05,0.6666666666666666
6341,9366,부서지다/Verb,12,4,8,6.668889629876625e-05,0.00011106421733046048,0.6666666666666666
6342,9367,우스/Noun,12,4,8,6.668889629876625e-05,0.00011106421733046048,0.6666666666666666
6343,9368,컬트영화/Noun,12,8,4,0.00011114816049794375,6.663853039827628e-05,0.6666666666666666
6344,9369,대견하다/Adjective,12,4,8,6.668889629876625e-05,0.00011106421733046048,0.6666666666666666
6345,9370,조의/Noun,12,8,4,0.00011114816049794375,6.663853039827628e-05,0.6666666666666666
6346,9371,파란/Noun,12,8,4,0.00011114816049794375,6.663853039827628e-05,0.6666666666666666
6347,9372,닐슨/Noun,12,8,4,0.00011114816049794375,6.663853039827628e-05,0.6666666666666666
6348,9373,인조/Noun,12,4,8,6.668889629876625e-05,0.00011106421733046048,0.6666666666666666
6349,9374,렌스/Noun,12,8,4,0.00011114816049794375,6.663853039827628e-05,0.6666666666666666
6350,9375,넬/Noun,12,8,4,0.00011114816049794375,6.663853039827628e-05,0.6666666666666666
6351,9376,모하/Noun,12,4,8,6.668889629876625e-05,0.00011106421733046048,0.6666666666666666
6352,9377,과장하다/Adjective,12,4,8,6.668889629876625e-05,0.00011106421733046048,0.6666666666666666
6353,9378,재결합/Noun,12,4,8,6.668889629876625e-05,0.00011106421733046048,0.6666666666666666
6354,9379,셜록/Noun,12,8,4,0.00011114816049794375,6.663853039827628e-05,0.6666666666666666
6355,9380,잡혀가다/Verb,12,4,8,6.668889629876625e-05,0.00011106421733046048,0.6666666666666666
6356,9381,각도/Noun,12,4,8,6.668889629876625e-05,0.00011106421733046048,0.6666666666666666
6357,9382,티아라/Noun,12,4,8,6.668889629876625e-05,0.00011106421733046048,0.6666666666666666
6358,9383,행성/Noun,12,4,8,6.668889629876625e-05,0.00011106421733046048,0.6666666666666666
6359,9384,런던/Noun,12,8,4,0.00011114816049794375,6.663853039827628e-05,0.6666666666666666
6360,9385,미노/Noun,12,4,8,6.668889629876625e-05,0.00011106421733046048,0.6666666666666666
6361,9386,미켈슨/Noun,12,8,4,0.00011114816049794375,6.663853039827628e-05,0.6666666666666666
6362,9387,사로잡히다/Verb,12,4,8,6.668889629876625e-05,0.00011106421733046048,0.6666666666666666
6363,9388,도자기/Noun,12,4,8,6.668889629876625e-05,0.00011106421733046048,0.6666666666666666
6364,9389,기와/Noun,12,8,4,0.00011114816049794375,6.663853039827628e-05,0.6666666666666666
6365,9390,홀리/Noun,12,4,8,6.668889629876625e-05,0.00011106421733046048,0.6666666666666666
6366,9391,솟다/Verb,12,8,4,0.00011114816049794375,6.663853039827628e-05,0.6666666666666666
6367,9392,일말/Noun,12,4,8,6.668889629876625e-05,0.00011106421733046048,0.6666666666666666
6368,9393,일부분/Noun,12,8,4,0.00011114816049794375,6.663853039827628e-05,0.6666666666666666
6369,9394,간호사/Noun,12,8,4,0.00011114816049794375,6.663853039827628e-05,0.6666666666666666
6370,9395,사촌동생/Noun,12,4,8,6.668889629876625e-05,0.00011106421733046048,0.6666666666666666
6371,9396,히히히/Noun,12,4,8,6.668889629876625e-05,0.00011106421733046048,0.6666666666666666
6372,9397,드뎌/Noun,12,8,4,0.00011114816049794375,6.663853039827628e-05,0.6666666666666666
6373,9398,문장/Noun,12,4,8,6.668889629876625e-05,0.00011106421733046048,0.6666666666666666
6374,9399,한껏/Adverb,12,8,4,0.00011114816049794375,6.663853039827628e-05,0.6666666666666666
6375,9400,33/Number,12,4,8,6.668889629876625e-05,0.00011106421733046048,0.6666666666666666
6376,9401,이주승/Noun,12,8,4,0.00011114816049794375,6.663853039827628e-05,0.6666666666666666
6377,9402,전병/Noun,12,4,8,6.668889629876625e-05,0.00011106421733046048,0.6666666666666666
6378,9403,스텔론/Noun,12,8,4,0.00011114816049794375,6.663853039827628e-05,0.6666666666666666
6379,9404,나리/Noun,12,4,8,6.668889629876625e-05,0.00011106421733046048,0.6666666666666666
6380,9405,종료/Noun,12,4,8,6.668889629876625e-05,0.00011106421733046048,0.6666666666666666
6381,9406,소나기/Noun,12,8,4,0.00011114816049794375,6.663853039827628e-05,0.6666666666666666
6382,9407,명과/Noun,12,8,4,0.00011114816049794375,6.663853039827628e-05,0.6666666666666666
6383,9408,기함/Noun,12,4,8,6.668889629876625e-05,0.00011106421733046048,0.6666666666666666
6384,9409,가세/Noun,12,4,8,6.668889629876625e-05,0.00011106421733046048,0.6666666666666666
6385,9410,다이아몬드/Noun,12,8,4,0.00011114816049794375,6.663853039827628e-05,0.6666666666666666
6386,9411,양쪽/Noun,12,4,8,6.668889629876625e-05,0.00011106421733046048,0.6666666666666666
6387,9412,히데/Noun,12,4,8,6.668889629876625e-05,0.00011106421733046048,0.6666666666666666
6388,9413,남궁민/Noun,12,8,4,0.00011114816049794375,6.663853039827628e-05,0.6666666666666666
6389,9414,김지영/Noun,12,4,8,6.668889629876625e-05,0.00011106421733046048,0.6666666666666666
6390,9415,주더/Noun,12,4,8,6.668889629876625e-05,0.00011106421733046048,0.6666666666666666
6391,9416,팔레스타인/Noun,12,8,4,0.00011114816049794375,6.663853039827628e-05,0.6666666666666666
6392,9417,필연/Noun,12,8,4,0.00011114816049794375,6.663853039827628e-05,0.6666666666666666
6393,9418,순풍/Noun,12,8,4,0.00011114816049794375,6.663853039827628e-05,0.6666666666666666
6394,9419,이중성/Noun,12,4,8,6.668889629876625e-05,0.00011106421733046048,0.6666666666666666
6395,9420,강박/Noun,12,4,8,6.668889629876625e-05,0.00011106421733046048,0.6666666666666666
6396,9421,트리오/Noun,12,8,4,0.00011114816049794375,6.663853039827628e-05,0.6666666666666666
6397,9422,엠버/Noun,12,4,8,6.668889629876625e-05,0.00011106421733046048,0.6666666666666666
6398,9423,유독/Noun,12,4,8,6.668889629876625e-05,0.00011106421733046048,0.6666666666666666
6399,9424,색즉시공/Noun,12,4,8,6.668889629876625e-05,0.00011106421733046048,0.6666666666666666
6400,9594,쨔응/Noun,11,11,0,0.0001444926086473269,2.2212843466092093e-05,1.0
6401,9595,깝깝/Noun,11,0,11,2.2229632099588756e-05,0.0001443834825295986,1.0
6402,9596,고은아/Noun,11,0,11,2.2229632099588756e-05,0.0001443834825295986,1.0
6403,9597,애하/Noun,11,0,11,2.2229632099588756e-05,0.0001443834825295986,1.0
6404,9598,폭도/Noun,11,0,11,2.2229632099588756e-05,0.0001443834825295986,1.0
6405,9599,티남/Noun,11,0,11,2.2229632099588756e-05,0.0001443834825295986,1.0
6406,9600,찍지마라/Noun,11,0,11,2.2229632099588756e-05,0.0001443834825295986,1.0
6407,9601,아하/Exclamation,11,0,11,2.2229632099588756e-05,0.0001443834825295986,1.0
6408,9602,500/Number,11,0,11,2.2229632099588756e-05,0.0001443834825295986,1.0
6409,9603,청소년기/Noun,11,11,0,0.0001444926086473269,2.2212843466092093e-05,1.0
6410,9604,손은서/Noun,11,0,11,2.2229632099588756e-05,0.0001443834825295986,1.0
6411,9605,유사/Noun,11,0,11,2.2229632099588756e-05,0.0001443834825295986,1.0
6412,9606,울화통/Noun,11,0,11,2.2229632099588756e-05,0.0001443834825295986,1.0
6413,9607,부릉부릉/Adverb,11,0,11,2.2229632099588756e-05,0.0001443834825295986,1.0
6414,9608,편파/Noun,11,0,11,2.2229632099588756e-05,0.0001443834825295986,1.0
6415,9609,과욕/Noun,11,0,11,2.2229632099588756e-05,0.0001443834825295986,1.0
6416,9610,싱그럽다/Adjective,11,11,0,0.0001444926086473269,2.2212843466092093e-05,1.0
6417,9611,탈세/Noun,11,0,11,2.2229632099588756e-05,0.0001443834825295986,1.0
6418,9612,까비/Noun,11,0,11,2.2229632099588756e-05,0.0001443834825295986,1.0
6419,9613,추기경/Noun,11,11,0,0.0001444926086473269,2.2212843466092093e-05,1.0
6420,9614,휴식/Noun,11,11,0,0.0001444926086473269,2.2212843466092093e-05,1.0
6421,9615,배종옥/Noun,11,11,0,0.0001444926086473269,2.2212843466092093e-05,1.0
6422,9616,노랑/Noun,11,0,11,2.2229632099588756e-05,0.0001443834825295986,1.0
6423,9617,말좀/Noun,11,0,11,2.2229632099588756e-05,0.0001443834825295986,1.0
6424,9618,후광/Noun,11,0,11,2.2229632099588756e-05,0.0001443834825295986,1.0
6425,9619,복수초/Noun,11,0,11,2.2229632099588756e-05,0.0001443834825295986,1.0
6426,9620,ㅠㅠㅜ/KoreanParticle,11,11,0,0.0001444926086473269,2.2212843466092093e-05,1.0
6427,9621,아나킨/Noun,11,11,0,0.0001444926086473269,2.2212843466092093e-05,1.0
6428,9622,윌슨/Noun,11,11,0,0.0001444926086473269,2.2212843466092093e-05,1.0
6429,9623,별루임/Noun,11,0,11,2.2229632099588756e-05,0.0001443834825295986,1.0
6430,9624,짱짱걸/Noun,11,10,1,0.0001333777925975325,3.331926519913814e-05,0.9090909090909092
6431,9625,벤허/Noun,11,10,1,0.0001333777925975325,3.331926519913814e-05,0.9090909090909092
6432,9626,애매/Noun,11,1,10,3.334444814938313e-05,0.00013327706079655256,0.9090909090909092
6433,9627,울트라/Noun,11,1,10,3.334444814938313e-05,0.00013327706079655256,0.9090909090909092
6434,9628,오바이트/Noun,11,1,10,3.334444814938313e-05,0.00013327706079655256,0.9090909090909092
6435,9629,구토/Noun,11,1,10,3.334444814938313e-05,0.00013327706079655256,0.9090909090909092
6436,9630,갓파더/Noun,11,1,10,3.334444814938313e-05,0.00013327706079655256,0.9090909090909092
6437,9631,덱스터/Noun,11,10,1,0.0001333777925975325,3.331926519913814e-05,0.9090909090909092
6438,9632,페미/Noun,11,1,10,3.334444814938313e-05,0.00013327706079655256,0.9090909090909092
6439,9633,4천원/Number,11,1,10,3.334444814938313e-05,0.00013327706079655256,0.9090909090909092
6440,9634,입담/Noun,11,10,1,0.0001333777925975325,3.331926519913814e-05,0.9090909090909092
6441,9635,알라딘/Noun,11,10,1,0.0001333777925975325,3.331926519913814e-05,0.9090909090909092
6442,9636,감금/Noun,11,1,10,3.334444814938313e-05,0.00013327706079655256,0.9090909090909092
6443,9637,수신료/Noun,11,1,10,3.334444814938313e-05,0.00013327706079655256,0.9090909090909092
6444,9638,소모/Noun,11,1,10,3.334444814938313e-05,0.00013327706079655256,0.9090909090909092
6445,9639,없슴/Noun,11,1,10,3.334444814938313e-05,0.00013327706079655256,0.9090909090909092
6446,9640,프로파간다/Noun,11,1,10,3.334444814938313e-05,0.00013327706079655256,0.9090909090909092
6447,9641,다이빙/Noun,11,1,10,3.334444814938313e-05,0.00013327706079655256,0.9090909090909092
6448,9642,유물/Noun,11,1,10,3.334444814938313e-05,0.00013327706079655256,0.9090909090909092
6449,9643,、/Foreign,11,10,1,0.0001333777925975325,3.331926519913814e-05,0.9090909090909092
6450,9644,먹듯/Noun,11,1,10,3.334444814938313e-05,0.00013327706079655256,0.9090909090909092
6451,9645,고역/Noun,11,1,10,3.334444814938313e-05,0.00013327706079655256,0.9090909090909092
6452,9646,개폼/Noun,11,1,10,3.334444814938313e-05,0.00013327706079655256,0.9090909090909092
6453,9647,골다/Verb,11,1,10,3.334444814938313e-05,0.00013327706079655256,0.9090909090909092
6454,9648,워터/Noun,11,1,10,3.334444814938313e-05,0.00013327706079655256,0.9090909090909092
6455,9649,world/Alpha,11,10,1,0.0001333777925975325,3.331926519913814e-05,0.9090909090909092
6456,9650,석양/Noun,11,10,1,0.0001333777925975325,3.331926519913814e-05,0.9090909090909092
6457,9651,이지현/Noun,11,1,10,3.334444814938313e-05,0.00013327706079655256,0.9090909090909092
6458,9652,징징거리다/Adjective,11,1,10,3.334444814938313e-05,0.00013327706079655256,0.9090909090909092
6459,9653,비키니/Noun,11,1,10,3.334444814938313e-05,0.00013327706079655256,0.9090909090909092
6460,9654,답시고/Noun,11,1,10,3.334444814938313e-05,0.00013327706079655256,0.9090909090909092
6461,9655,(-/Punctuation,11,1,10,3.334444814938313e-05,0.00013327706079655256,0.9090909090909092
6462,9656,압니/Noun,11,10,1,0.0001333777925975325,3.331926519913814e-05,0.9090909090909092
6463,9657,OTL/Alpha,11,1,10,3.334444814938313e-05,0.00013327706079655256,0.9090909090909092
6464,9658,퉁/Noun,11,1,10,3.334444814938313e-05,0.00013327706079655256,0.9090909090909092
6465,9659,오지호/Noun,11,1,10,3.334444814938313e-05,0.00013327706079655256,0.9090909090909092
6466,9660,KTX/Alpha,11,1,10,3.334444814938313e-05,0.00013327706079655256,0.9090909090909092
6467,9661,동행/Noun,11,10,1,0.0001333777925975325,3.331926519913814e-05,0.9090909090909092
6468,9662,8~9/Number,11,10,1,0.0001333777925975325,3.331926519913814e-05,0.9090909090909092
6469,9663,게이물/Noun,11,1,10,3.334444814938313e-05,0.00013327706079655256,0.9090909090909092
6470,9664,오분/Noun,11,1,10,3.334444814938313e-05,0.00013327706079655256,0.9090909090909092
6471,9665,개망/Noun,11,1,10,3.334444814938313e-05,0.00013327706079655256,0.9090909090909092
6472,9666,극화/Noun,11,1,10,3.334444814938313e-05,0.00013327706079655256,0.9090909090909092
6473,9667,킬러조/Noun,11,1,10,3.334444814938313e-05,0.00013327706079655256,0.9090909090909092
6474,9668,마음껏/Noun,11,10,1,0.0001333777925975325,3.331926519913814e-05,0.9090909090909092
6475,9669,팔고/Noun,11,1,10,3.334444814938313e-05,0.00013327706079655256,0.9090909090909092
6476,9670,OUT/Alpha,11,1,10,3.334444814938313e-05,0.00013327706079655256,0.9090909090909092
6477,9671,제안/Noun,11,1,10,3.334444814938313e-05,0.00013327706079655256,0.9090909090909092
6478,9672,착신아리/Noun,11,1,10,3.334444814938313e-05,0.00013327706079655256,0.9090909090909092
6479,9673,다스베이더/Noun,11,10,1,0.0001333777925975325,3.331926519913814e-05,0.9090909090909092
6480,9674,!!!^^/Punctuation,11,10,1,0.0001333777925975325,3.331926519913814e-05,0.9090909090909092
6481,9675,반함/Noun,11,10,1,0.0001333777925975325,3.331926519913814e-05,0.9090909090909092
6482,9676,엇습/Noun,11,10,1,0.0001333777925975325,3.331926519913814e-05,0.9090909090909092
6483,9677,궈/Noun,11,1,10,3.334444814938313e-05,0.00013327706079655256,0.9090909090909092
6484,9678,어릴떄/Noun,11,10,1,0.0001333777925975325,3.331926519913814e-05,0.9090909090909092
6485,9679,퀼리티/Noun,11,1,10,3.334444814938313e-05,0.00013327706079655256,0.9090909090909092
6486,9680,판정/Noun,11,2,9,4.445926419917751e-05,0.00012217063906350652,0.8181818181818182
6487,9681,구사/Noun,11,2,9,4.445926419917751e-05,0.00012217063906350652,0.8181818181818182
6488,9682,가려지다/Verb,11,9,2,0.00012226297654773814,4.4425686932184186e-05,0.8181818181818182
6489,9683,메리다/Noun,11,2,9,4.445926419917751e-05,0.00012217063906350652,0.8181818181818182
6490,9684,비디오테잎/Noun,11,9,2,0.00012226297654773814,4.4425686932184186e-05,0.8181818181818182
6491,9685,관통/Noun,11,9,2,0.00012226297654773814,4.4425686932184186e-05,0.8181818181818182
6492,9686,간지럽다/Adjective,11,2,9,4.445926419917751e-05,0.00012217063906350652,0.8181818181818182
6493,9687,광신도/Noun,11,2,9,4.445926419917751e-05,0.00012217063906350652,0.8181818181818182
6494,9688,34/Number,11,9,2,0.00012226297654773814,4.4425686932184186e-05,0.8181818181818182
6495,9689,윤/Noun,11,9,2,0.00012226297654773814,4.4425686932184186e-05,0.8181818181818182
6496,9690,깡통/Noun,11,2,9,4.445926419917751e-05,0.00012217063906350652,0.8181818181818182
6497,9691,70분/Number,11,2,9,4.445926419917751e-05,0.00012217063906350652,0.8181818181818182
6498,9692,계약/Noun,11,2,9,4.445926419917751e-05,0.00012217063906350652,0.8181818181818182
6499,9693,타락/Noun,11,2,9,4.445926419917751e-05,0.00012217063906350652,0.8181818181818182
6500,9694,분간/Noun,11,2,9,4.445926419917751e-05,0.00012217063906350652,0.8181818181818182
6501,9695,죤나/Noun,11,2,9,4.445926419917751e-05,0.00012217063906350652,0.8181818181818182
6502,9696,민망/Noun,11,2,9,4.445926419917751e-05,0.00012217063906350652,0.8181818181818182
6503,9697,축제/Noun,11,9,2,0.00012226297654773814,4.4425686932184186e-05,0.8181818181818182
6504,9698,방학/Noun,11,9,2,0.00012226297654773814,4.4425686932184186e-05,0.8181818181818182
6505,9699,되찾다/Verb,11,9,2,0.00012226297654773814,4.4425686932184186e-05,0.8181818181818182
6506,9700,음울하다/Adjective,11,9,2,0.00012226297654773814,4.4425686932184186e-05,0.8181818181818182
6507,9701,한주/Noun,11,9,2,0.00012226297654773814,4.4425686932184186e-05,0.8181818181818182
6508,9702,...................../Punctuation,11,2,9,4.445926419917751e-05,0.00012217063906350652,0.8181818181818182
6509,9703,들려오다/Verb,11,9,2,0.00012226297654773814,4.4425686932184186e-05,0.8181818181818182
6510,9704,취소/Noun,11,2,9,4.445926419917751e-05,0.00012217063906350652,0.8181818181818182
6511,9705,린즈링/Noun,11,2,9,4.445926419917751e-05,0.00012217063906350652,0.8181818181818182
6512,9706,동거/Noun,11,2,9,4.445926419917751e-05,0.00012217063906350652,0.8181818181818182
6513,9707,버틀러/Noun,11,9,2,0.00012226297654773814,4.4425686932184186e-05,0.8181818181818182
6514,9708,염병/Noun,11,2,9,4.445926419917751e-05,0.00012217063906350652,0.8181818181818182
6515,9709,80~90년/Number,11,2,9,4.445926419917751e-05,0.00012217063906350652,0.8181818181818182
6516,9710,센터/Noun,11,2,9,4.445926419917751e-05,0.00012217063906350652,0.8181818181818182
6517,9711,관계도/Noun,11,2,9,4.445926419917751e-05,0.00012217063906350652,0.8181818181818182
6518,9712,스탠리/Noun,11,9,2,0.00012226297654773814,4.4425686932184186e-05,0.8181818181818182
6519,9713,선교사/Noun,11,9,2,0.00012226297654773814,4.4425686932184186e-05,0.8181818181818182
6520,9714,양익준/Noun,11,9,2,0.00012226297654773814,4.4425686932184186e-05,0.8181818181818182
6521,9715,무민/Noun,11,9,2,0.00012226297654773814,4.4425686932184186e-05,0.8181818181818182
6522,9716,자지/Noun,11,2,9,4.445926419917751e-05,0.00012217063906350652,0.8181818181818182
6523,9717,go/Alpha,11,9,2,0.00012226297654773814,4.4425686932184186e-05,0.8181818181818182
6524,9718,랑께/Josa,11,2,9,4.445926419917751e-05,0.00012217063906350652,0.8181818181818182
6525,9719,서론/Noun,11,2,9,4.445926419917751e-05,0.00012217063906350652,0.8181818181818182
6526,9720,환각/Noun,11,2,9,4.445926419917751e-05,0.00012217063906350652,0.8181818181818182
6527,9721,미미하다/Adjective,11,2,9,4.445926419917751e-05,0.00012217063906350652,0.8181818181818182
6528,9722,고립/Noun,11,9,2,0.00012226297654773814,4.4425686932184186e-05,0.8181818181818182
6529,9723,저딴/Noun,11,2,9,4.445926419917751e-05,0.00012217063906350652,0.8181818181818182
6530,9724,사발/Noun,11,2,9,4.445926419917751e-05,0.00012217063906350652,0.8181818181818182
6531,9725,바스코/Noun,11,2,9,4.445926419917751e-05,0.00012217063906350652,0.8181818181818182
6532,9726,셰익스피어/Noun,11,9,2,0.00012226297654773814,4.4425686932184186e-05,0.8181818181818182
6533,9727,쿵후/Noun,11,2,9,4.445926419917751e-05,0.00012217063906350652,0.8181818181818182
6534,9728,난해/Noun,11,2,9,4.445926419917751e-05,0.00012217063906350652,0.8181818181818182
6535,9729,바퀴벌레/Noun,11,2,9,4.445926419917751e-05,0.00012217063906350652,0.8181818181818182
6536,9730,know/Alpha,11,9,2,0.00012226297654773814,4.4425686932184186e-05,0.8181818181818182
6537,9731,질렌할/Noun,11,9,2,0.00012226297654773814,4.4425686932184186e-05,0.8181818181818182
6538,9732,리다/Noun,11,2,9,4.445926419917751e-05,0.00012217063906350652,0.8181818181818182
6539,9733,연출가/Noun,11,2,9,4.445926419917751e-05,0.00012217063906350652,0.8181818181818182
6540,9734,호빗/Noun,11,9,2,0.00012226297654773814,4.4425686932184186e-05,0.8181818181818182
6541,9735,의욕/Noun,11,2,9,4.445926419917751e-05,0.00012217063906350652,0.8181818181818182
6542,9736,was/Alpha,11,9,2,0.00012226297654773814,4.4425686932184186e-05,0.8181818181818182
6543,9737,기무라/Noun,11,9,2,0.00012226297654773814,4.4425686932184186e-05,0.8181818181818182
6544,9738,안봣/Noun,11,9,2,0.00012226297654773814,4.4425686932184186e-05,0.8181818181818182
6545,9739,브랜드/Noun,11,9,2,0.00012226297654773814,4.4425686932184186e-05,0.8181818181818182
6546,9740,버킷리스트/Noun,11,9,2,0.00012226297654773814,4.4425686932184186e-05,0.8181818181818182
6547,9741,요인/Noun,11,2,9,4.445926419917751e-05,0.00012217063906350652,0.8181818181818182
6548,9742,"...,/Punctuation",11,2,9,4.445926419917751e-05,0.00012217063906350652,0.8181818181818182
6549,9743,무신론자/Noun,11,2,9,4.445926419917751e-05,0.00012217063906350652,0.8181818181818182
6550,9744,레슬링/Noun,11,2,9,4.445926419917751e-05,0.00012217063906350652,0.8181818181818182
6551,9745,노처녀/Noun,11,2,9,4.445926419917751e-05,0.00012217063906350652,0.8181818181818182
6552,9746,조엘/Noun,11,2,9,4.445926419917751e-05,0.00012217063906350652,0.8181818181818182
6553,9747,無/Foreign,11,2,9,4.445926419917751e-05,0.00012217063906350652,0.8181818181818182
6554,9748,쪽지/Noun,11,9,2,0.00012226297654773814,4.4425686932184186e-05,0.8181818181818182
6555,9749,형용/Noun,11,9,2,0.00012226297654773814,4.4425686932184186e-05,0.8181818181818182
6556,9750,zzz/Alpha,11,2,9,4.445926419917751e-05,0.00012217063906350652,0.8181818181818182
6557,9751,남북/Noun,11,9,2,0.00012226297654773814,4.4425686932184186e-05,0.8181818181818182
6558,9752,왕년/Noun,11,2,9,4.445926419917751e-05,0.00012217063906350652,0.8181818181818182
6559,9753,4월/Number,11,9,2,0.00012226297654773814,4.4425686932184186e-05,0.8181818181818182
6560,9754,댕/Noun,11,2,9,4.445926419917751e-05,0.00012217063906350652,0.8181818181818182
6561,9755,번지르르하다/Adjective,11,2,9,4.445926419917751e-05,0.00012217063906350652,0.8181818181818182
6562,9756,평보/Noun,11,2,9,4.445926419917751e-05,0.00012217063906350652,0.8181818181818182
6563,9757,김원효/Noun,11,2,9,4.445926419917751e-05,0.00012217063906350652,0.8181818181818182
6564,9758,사유/Noun,11,9,2,0.00012226297654773814,4.4425686932184186e-05,0.8181818181818182
6565,9759,행각/Noun,11,2,9,4.445926419917751e-05,0.00012217063906350652,0.8181818181818182
6566,9760,수치심/Noun,11,2,9,4.445926419917751e-05,0.00012217063906350652,0.8181818181818182
6567,9761,욜라/Noun,11,2,9,4.445926419917751e-05,0.00012217063906350652,0.8181818181818182
6568,9762,승희/Noun,11,2,9,4.445926419917751e-05,0.00012217063906350652,0.8181818181818182
6569,9763,오케이/Noun,11,2,9,4.445926419917751e-05,0.00012217063906350652,0.8181818181818182
6570,9764,팬텀/Noun,11,9,2,0.00012226297654773814,4.4425686932184186e-05,0.8181818181818182
6571,9765,하비/Noun,11,9,2,0.00012226297654773814,4.4425686932184186e-05,0.8181818181818182
6572,9766,김성수/Noun,11,2,9,4.445926419917751e-05,0.00012217063906350652,0.8181818181818182
6573,9767,달튼/Noun,11,9,2,0.00012226297654773814,4.4425686932184186e-05,0.8181818181818182
6574,9768,발라/Noun,11,2,9,4.445926419917751e-05,0.00012217063906350652,0.8181818181818182
6575,9769,박준형/Noun,11,2,9,4.445926419917751e-05,0.00012217063906350652,0.8181818181818182
6576,9770,불급/Noun,11,2,9,4.445926419917751e-05,0.00012217063906350652,0.8181818181818182
6577,9771,진지희/Noun,11,2,9,4.445926419917751e-05,0.00012217063906350652,0.8181818181818182
6578,9772,횟수/Noun,11,2,9,4.445926419917751e-05,0.00012217063906350652,0.8181818181818182
6579,9773,악플달다/Verb,11,9,2,0.00012226297654773814,4.4425686932184186e-05,0.8181818181818182
6580,9774,2.2/Number,11,2,9,4.445926419917751e-05,0.00012217063906350652,0.8181818181818182
6581,9775,레젼드/Noun,11,9,2,0.00012226297654773814,4.4425686932184186e-05,0.8181818181818182
6582,9776,김꽃비/Noun,11,2,9,4.445926419917751e-05,0.00012217063906350652,0.8181818181818182
6583,9777,무성의/Noun,11,2,9,4.445926419917751e-05,0.00012217063906350652,0.8181818181818182
6584,9778,일본사람/Noun,11,2,9,4.445926419917751e-05,0.00012217063906350652,0.8181818181818182
6585,9779,r/Alpha,11,3,8,5.5574080248971876e-05,0.00011106421733046048,0.7272727272727273
6586,9780,독고/Noun,11,8,3,0.00011114816049794375,5.553210866523024e-05,0.7272727272727273
6587,9781,나왓으/Noun,11,8,3,0.00011114816049794375,5.553210866523024e-05,0.7272727272727273
6588,9782,바티칸/Noun,11,3,8,5.5574080248971876e-05,0.00011106421733046048,0.7272727272727273
6589,9783,후퇴/Noun,11,3,8,5.5574080248971876e-05,0.00011106421733046048,0.7272727272727273
6590,9784,CD/Alpha,11,8,3,0.00011114816049794375,5.553210866523024e-05,0.7272727272727273
6591,9785,NG/Alpha,11,8,3,0.00011114816049794375,5.553210866523024e-05,0.7272727272727273
6592,9786,".,../Punctuation",11,3,8,5.5574080248971876e-05,0.00011106421733046048,0.7272727272727273
6593,9787,팝핀현준/Noun,11,3,8,5.5574080248971876e-05,0.00011106421733046048,0.7272727272727273
6594,9788,불협화음/Noun,11,3,8,5.5574080248971876e-05,0.00011106421733046048,0.7272727272727273
6595,9789,카터/Noun,11,8,3,0.00011114816049794375,5.553210866523024e-05,0.7272727272727273
6596,9790,뚜껑/Noun,11,3,8,5.5574080248971876e-05,0.00011106421733046048,0.7272727272727273
6597,9791,당사자/Noun,11,8,3,0.00011114816049794375,5.553210866523024e-05,0.7272727272727273
6598,9792,브란도/Noun,11,8,3,0.00011114816049794375,5.553210866523024e-05,0.7272727272727273
6599,9793,에르/Noun,11,8,3,0.00011114816049794375,5.553210866523024e-05,0.7272727272727273
6600,9794,참가/Noun,11,3,8,5.5574080248971876e-05,0.00011106421733046048,0.7272727272727273
6601,9795,승승장구/Noun,11,8,3,0.00011114816049794375,5.553210866523024e-05,0.7272727272727273
6602,9796,딥블루씨/Noun,11,3,8,5.5574080248971876e-05,0.00011106421733046048,0.7272727272727273
6603,9797,변경/Noun,11,3,8,5.5574080248971876e-05,0.00011106421733046048,0.7272727272727273
6604,9798,유효하다/Adjective,11,8,3,0.00011114816049794375,5.553210866523024e-05,0.7272727272727273
6605,9799,고달프다/Adjective,11,8,3,0.00011114816049794375,5.553210866523024e-05,0.7272727272727273
6606,9800,대조/Noun,11,8,3,0.00011114816049794375,5.553210866523024e-05,0.7272727272727273
6607,9801,근친상간/Noun,11,3,8,5.5574080248971876e-05,0.00011106421733046048,0.7272727272727273
6608,9802,충전/Noun,11,3,8,5.5574080248971876e-05,0.00011106421733046048,0.7272727272727273
6609,9803,추리물/Noun,11,3,8,5.5574080248971876e-05,0.00011106421733046048,0.7272727272727273
6610,9804,지오/Noun,11,8,3,0.00011114816049794375,5.553210866523024e-05,0.7272727272727273
6611,9805,들것/Noun,11,3,8,5.5574080248971876e-05,0.00011106421733046048,0.7272727272727273
6612,9806,근처/Noun,11,8,3,0.00011114816049794375,5.553210866523024e-05,0.7272727272727273
6613,9807,쉬리/Noun,11,3,8,5.5574080248971876e-05,0.00011106421733046048,0.7272727272727273
6614,9808,건너다/Verb,11,3,8,5.5574080248971876e-05,0.00011106421733046048,0.7272727272727273
6615,9809,로리타/Noun,11,3,8,5.5574080248971876e-05,0.00011106421733046048,0.7272727272727273
6616,9810,감방/Noun,11,3,8,5.5574080248971876e-05,0.00011106421733046048,0.7272727272727273
6617,9811,쑈/Noun,11,3,8,5.5574080248971876e-05,0.00011106421733046048,0.7272727272727273
6618,9812,피라미드/Noun,11,3,8,5.5574080248971876e-05,0.00011106421733046048,0.7272727272727273
6619,9813,마사미/Noun,11,8,3,0.00011114816049794375,5.553210866523024e-05,0.7272727272727273
6620,9814,개차반/Noun,11,3,8,5.5574080248971876e-05,0.00011106421733046048,0.7272727272727273
6621,9815,하드코어/Noun,11,3,8,5.5574080248971876e-05,0.00011106421733046048,0.7272727272727273
6622,9816,계몽/Noun,11,8,3,0.00011114816049794375,5.553210866523024e-05,0.7272727272727273
6623,9817,고구마/Noun,11,8,3,0.00011114816049794375,5.553210866523024e-05,0.7272727272727273
6624,9818,뭐길/Noun,11,3,8,5.5574080248971876e-05,0.00011106421733046048,0.7272727272727273
6625,9819,왓츠/Noun,11,8,3,0.00011114816049794375,5.553210866523024e-05,0.7272727272727273
6626,9820,꿀잠/Noun,11,3,8,5.5574080248971876e-05,0.00011106421733046048,0.7272727272727273
6627,9821,경기도/Noun,11,8,3,0.00011114816049794375,5.553210866523024e-05,0.7272727272727273
6628,9822,여분/Noun,11,3,8,5.5574080248971876e-05,0.00011106421733046048,0.7272727272727273
6629,9823,연작/Noun,11,8,3,0.00011114816049794375,5.553210866523024e-05,0.7272727272727273
6630,9824,전인/Noun,11,8,3,0.00011114816049794375,5.553210866523024e-05,0.7272727272727273
6631,9825,수첩/Noun,11,3,8,5.5574080248971876e-05,0.00011106421733046048,0.7272727272727273
6632,9826,려원/Noun,11,8,3,0.00011114816049794375,5.553210866523024e-05,0.7272727272727273
6633,9827,나이틀리/Noun,11,8,3,0.00011114816049794375,5.553210866523024e-05,0.7272727272727273
6634,9828,외침/Noun,11,8,3,0.00011114816049794375,5.553210866523024e-05,0.7272727272727273
6635,9829,시력/Noun,11,3,8,5.5574080248971876e-05,0.00011106421733046048,0.7272727272727273
6636,9830,밀고/Noun,11,3,8,5.5574080248971876e-05,0.00011106421733046048,0.7272727272727273
6637,9831,졸지/Noun,11,3,8,5.5574080248971876e-05,0.00011106421733046048,0.7272727272727273
6638,9832,패틴슨/Noun,11,3,8,5.5574080248971876e-05,0.00011106421733046048,0.7272727272727273
6639,9833,영국영화/Noun,11,8,3,0.00011114816049794375,5.553210866523024e-05,0.7272727272727273
6640,9834,이자스민/Noun,11,3,8,5.5574080248971876e-05,0.00011106421733046048,0.7272727272727273
6641,9835,합성/Noun,11,3,8,5.5574080248971876e-05,0.00011106421733046048,0.7272727272727273
6642,9836,대루/Noun,11,3,8,5.5574080248971876e-05,0.00011106421733046048,0.7272727272727273
6643,9837,뿜었다/Noun,11,3,8,5.5574080248971876e-05,0.00011106421733046048,0.7272727272727273
6644,9838,뻣뻣하다/Adjective,11,3,8,5.5574080248971876e-05,0.00011106421733046048,0.7272727272727273
6645,9839,각시탈/Noun,11,8,3,0.00011114816049794375,5.553210866523024e-05,0.7272727272727273
6646,9840,500원/Number,11,3,8,5.5574080248971876e-05,0.00011106421733046048,0.7272727272727273
6647,9841,하염없이/Adverb,11,8,3,0.00011114816049794375,5.553210866523024e-05,0.7272727272727273
6648,9842,이태임/Noun,11,3,8,5.5574080248971876e-05,0.00011106421733046048,0.7272727272727273
6649,9843,엽/Noun,11,8,3,0.00011114816049794375,5.553210866523024e-05,0.7272727272727273
6650,9844,박은혜/Noun,11,3,8,5.5574080248971876e-05,0.00011106421733046048,0.7272727272727273
6651,9845,상하/Noun,11,3,8,5.5574080248971876e-05,0.00011106421733046048,0.7272727272727273
6652,9846,This/Alpha,11,8,3,0.00011114816049794375,5.553210866523024e-05,0.7272727272727273
6653,9847,히로스에/Noun,11,3,8,5.5574080248971876e-05,0.00011106421733046048,0.7272727272727273
6654,9848,양은/Noun,11,3,8,5.5574080248971876e-05,0.00011106421733046048,0.7272727272727273
6655,9849,자서전/Noun,11,3,8,5.5574080248971876e-05,0.00011106421733046048,0.7272727272727273
6656,9850,고이/Noun,11,3,8,5.5574080248971876e-05,0.00011106421733046048,0.7272727272727273
6657,9851,콱/Noun,11,3,8,5.5574080248971876e-05,0.00011106421733046048,0.7272727272727273
6658,9852,이중인격/Noun,11,3,8,5.5574080248971876e-05,0.00011106421733046048,0.7272727272727273
6659,9853,허공/Noun,11,3,8,5.5574080248971876e-05,0.00011106421733046048,0.7272727272727273
6660,9854,임요환/Noun,11,3,8,5.5574080248971876e-05,0.00011106421733046048,0.7272727272727273
6661,9855,스리/Noun,11,8,3,0.00011114816049794375,5.553210866523024e-05,0.7272727272727273
6662,9856,가레스/Noun,11,3,8,5.5574080248971876e-05,0.00011106421733046048,0.7272727272727273
6663,9857,트렁크/Noun,11,3,8,5.5574080248971876e-05,0.00011106421733046048,0.7272727272727273
6664,9858,골든타임/Noun,11,3,8,5.5574080248971876e-05,0.00011106421733046048,0.7272727272727273
6665,9859,얼간이/Noun,11,3,8,5.5574080248971876e-05,0.00011106421733046048,0.7272727272727273
6666,9860,씩/Foreign,11,3,8,5.5574080248971876e-05,0.00011106421733046048,0.7272727272727273
6667,9861,섭섭하다/Adjective,11,8,3,0.00011114816049794375,5.553210866523024e-05,0.7272727272727273
6668,9862,여타/Noun,11,8,3,0.00011114816049794375,5.553210866523024e-05,0.7272727272727273
6669,9863,효율/Noun,11,3,8,5.5574080248971876e-05,0.00011106421733046048,0.7272727272727273
6670,9864,미처/Noun,11,8,3,0.00011114816049794375,5.553210866523024e-05,0.7272727272727273
6671,9865,하울/Noun,11,8,3,0.00011114816049794375,5.553210866523024e-05,0.7272727272727273
6672,9866,애처롭다/Adjective,11,8,3,0.00011114816049794375,5.553210866523024e-05,0.7272727272727273
6673,9867,꼬띠/Noun,11,8,3,0.00011114816049794375,5.553210866523024e-05,0.7272727272727273
6674,9868,숭배/Noun,11,3,8,5.5574080248971876e-05,0.00011106421733046048,0.7272727272727273
6675,9869,비키/Noun,11,3,8,5.5574080248971876e-05,0.00011106421733046048,0.7272727272727273
6676,9870,꾼/Noun,11,8,3,0.00011114816049794375,5.553210866523024e-05,0.7272727272727273
6677,9871,열망/Noun,11,8,3,0.00011114816049794375,5.553210866523024e-05,0.7272727272727273
6678,9872,추적자/Noun,11,8,3,0.00011114816049794375,5.553210866523024e-05,0.7272727272727273
6679,9873,또래/Noun,11,8,3,0.00011114816049794375,5.553210866523024e-05,0.7272727272727273
6680,9874,원장/Noun,11,3,8,5.5574080248971876e-05,0.00011106421733046048,0.7272727272727273
6681,9875,빙/Noun,11,3,8,5.5574080248971876e-05,0.00011106421733046048,0.7272727272727273
6682,9876,지식인/Noun,11,8,3,0.00011114816049794375,5.553210866523024e-05,0.7272727272727273
6683,9877,정수/Noun,11,8,3,0.00011114816049794375,5.553210866523024e-05,0.7272727272727273
6684,9878,미치광이/Noun,11,3,8,5.5574080248971876e-05,0.00011106421733046048,0.7272727272727273
6685,9879,쵸/VerbPrefix,11,8,3,0.00011114816049794375,5.553210866523024e-05,0.7272727272727273
6686,9880,화끈/Noun,11,8,3,0.00011114816049794375,5.553210866523024e-05,0.7272727272727273
6687,9881,증인/Noun,11,3,8,5.5574080248971876e-05,0.00011106421733046048,0.7272727272727273
6688,9882,악순환/Noun,11,8,3,0.00011114816049794375,5.553210866523024e-05,0.7272727272727273
6689,9883,최상급/Noun,11,8,3,0.00011114816049794375,5.553210866523024e-05,0.7272727272727273
6690,9884,유주/Noun,11,8,3,0.00011114816049794375,5.553210866523024e-05,0.7272727272727273
6691,9885,이제일/Noun,11,8,3,0.00011114816049794375,5.553210866523024e-05,0.7272727272727273
6692,9886,안심/Noun,11,8,3,0.00011114816049794375,5.553210866523024e-05,0.7272727272727273
6693,9887,쿵/Noun,11,8,3,0.00011114816049794375,5.553210866523024e-05,0.7272727272727273
6694,9888,고간/Noun,11,3,8,5.5574080248971876e-05,0.00011106421733046048,0.7272727272727273
6695,9889,김태우/Noun,11,8,3,0.00011114816049794375,5.553210866523024e-05,0.7272727272727273
6696,9890,이종혁/Noun,11,8,3,0.00011114816049794375,5.553210866523024e-05,0.7272727272727273
6697,9891,서른/Modifier,11,8,3,0.00011114816049794375,5.553210866523024e-05,0.7272727272727273
6698,9892,아이거/Noun,11,7,4,0.0001000333444481494,6.663853039827628e-05,0.6363636363636364
6699,9893,골드버그/Noun,11,7,4,0.0001000333444481494,6.663853039827628e-05,0.6363636363636364
6700,9894,명함/Noun,11,7,4,0.0001000333444481494,6.663853039827628e-05,0.6363636363636364
6701,9895,껌/Noun,11,7,4,0.0001000333444481494,6.663853039827628e-05,0.6363636363636364
6702,9896,쪼개다/Verb,11,4,7,6.668889629876625e-05,9.995779559741441e-05,0.6363636363636364
6703,9897,1997년/Number,11,7,4,0.0001000333444481494,6.663853039827628e-05,0.6363636363636364
6704,9898,차오르다/Verb,11,7,4,0.0001000333444481494,6.663853039827628e-05,0.6363636363636364
6705,9899,겟/Noun,11,4,7,6.668889629876625e-05,9.995779559741441e-05,0.6363636363636364
6706,9900,감수/Noun,11,4,7,6.668889629876625e-05,9.995779559741441e-05,0.6363636363636364
6707,9901,득/Noun,11,4,7,6.668889629876625e-05,9.995779559741441e-05,0.6363636363636364
6708,9902,이지훈/Noun,11,4,7,6.668889629876625e-05,9.995779559741441e-05,0.6363636363636364
6709,9903,었/Noun,11,7,4,0.0001000333444481494,6.663853039827628e-05,0.6363636363636364
6710,9904,출중하다/Adjective,11,7,4,0.0001000333444481494,6.663853039827628e-05,0.6363636363636364
6711,9905,견줄만/Noun,11,7,4,0.0001000333444481494,6.663853039827628e-05,0.6363636363636364
6712,9906,비감/Noun,11,4,7,6.668889629876625e-05,9.995779559741441e-05,0.6363636363636364
6713,9907,건네다/Verb,11,7,4,0.0001000333444481494,6.663853039827628e-05,0.6363636363636364
6714,9908,정지/Noun,11,7,4,0.0001000333444481494,6.663853039827628e-05,0.6363636363636364
6715,9909,임무/Noun,11,4,7,6.668889629876625e-05,9.995779559741441e-05,0.6363636363636364
6716,9910,산트/Noun,11,7,4,0.0001000333444481494,6.663853039827628e-05,0.6363636363636364
6717,9911,열등감/Noun,11,4,7,6.668889629876625e-05,9.995779559741441e-05,0.6363636363636364
6718,9912,헛점/Noun,11,4,7,6.668889629876625e-05,9.995779559741441e-05,0.6363636363636364
6719,9913,솔솔/Noun,11,4,7,6.668889629876625e-05,9.995779559741441e-05,0.6363636363636364
6720,9914,천장/Noun,11,7,4,0.0001000333444481494,6.663853039827628e-05,0.6363636363636364
6721,9915,우치/Noun,11,7,4,0.0001000333444481494,6.663853039827628e-05,0.6363636363636364
6722,9916,화비/Noun,11,4,7,6.668889629876625e-05,9.995779559741441e-05,0.6363636363636364
6723,9917,뚱뚱하다/Adjective,11,4,7,6.668889629876625e-05,9.995779559741441e-05,0.6363636363636364
6724,9918,본드걸/Noun,11,7,4,0.0001000333444481494,6.663853039827628e-05,0.6363636363636364
6725,9919,집시/Noun,11,7,4,0.0001000333444481494,6.663853039827628e-05,0.6363636363636364
6726,9920,퀄러티/Noun,11,7,4,0.0001000333444481494,6.663853039827628e-05,0.6363636363636364
6727,9921,분열/Noun,11,4,7,6.668889629876625e-05,9.995779559741441e-05,0.6363636363636364
6728,9922,후우/Exclamation,11,4,7,6.668889629876625e-05,9.995779559741441e-05,0.6363636363636364
6729,9923,배창호/Noun,11,7,4,0.0001000333444481494,6.663853039827628e-05,0.6363636363636364
6730,9924,팝송/Noun,11,4,7,6.668889629876625e-05,9.995779559741441e-05,0.6363636363636364
6731,9925,열악하다/Adjective,11,4,7,6.668889629876625e-05,9.995779559741441e-05,0.6363636363636364
6732,9926,악랄하다/Adjective,11,7,4,0.0001000333444481494,6.663853039827628e-05,0.6363636363636364
6733,9927,오멘/Noun,11,7,4,0.0001000333444481494,6.663853039827628e-05,0.6363636363636364
6734,9928,머시/Noun,11,7,4,0.0001000333444481494,6.663853039827628e-05,0.6363636363636364
6735,9929,열광/Noun,11,7,4,0.0001000333444481494,6.663853039827628e-05,0.6363636363636364
6736,9930,아보/Noun,11,4,7,6.668889629876625e-05,9.995779559741441e-05,0.6363636363636364
6737,9931,숨기/Noun,11,4,7,6.668889629876625e-05,9.995779559741441e-05,0.6363636363636364
6738,9932,퍼/PreEomi,11,4,7,6.668889629876625e-05,9.995779559741441e-05,0.6363636363636364
6739,9933,러쉬/Noun,11,7,4,0.0001000333444481494,6.663853039827628e-05,0.6363636363636364
6740,9934,반올림/Noun,11,4,7,6.668889629876625e-05,9.995779559741441e-05,0.6363636363636364
6741,9935,이하고/Josa,11,4,7,6.668889629876625e-05,9.995779559741441e-05,0.6363636363636364
6742,9936,종자/Noun,11,4,7,6.668889629876625e-05,9.995779559741441e-05,0.6363636363636364
6743,9937,더구나/Noun,11,4,7,6.668889629876625e-05,9.995779559741441e-05,0.6363636363636364
6744,9938,톰슨/Noun,11,7,4,0.0001000333444481494,6.663853039827628e-05,0.6363636363636364
6745,9939,사이드/Noun,11,7,4,0.0001000333444481494,6.663853039827628e-05,0.6363636363636364
6746,9940,가트/Noun,11,7,4,0.0001000333444481494,6.663853039827628e-05,0.6363636363636364
6747,9941,일제시대/Noun,11,7,4,0.0001000333444481494,6.663853039827628e-05,0.6363636363636364
6748,9942,씨부리다/Verb,11,4,7,6.668889629876625e-05,9.995779559741441e-05,0.6363636363636364
6749,9943,다리다/Verb,11,4,7,6.668889629876625e-05,9.995779559741441e-05,0.6363636363636364
6750,9944,총각/Noun,11,4,7,6.668889629876625e-05,9.995779559741441e-05,0.6363636363636364
6751,9945,자서/Noun,11,4,7,6.668889629876625e-05,9.995779559741441e-05,0.6363636363636364
6752,9946,쿄코/Noun,11,4,7,6.668889629876625e-05,9.995779559741441e-05,0.6363636363636364
6753,9947,롤러코스터/Noun,11,7,4,0.0001000333444481494,6.663853039827628e-05,0.6363636363636364
6754,9948,세영/Noun,11,4,7,6.668889629876625e-05,9.995779559741441e-05,0.6363636363636364
6755,9949,호수/Noun,11,7,4,0.0001000333444481494,6.663853039827628e-05,0.6363636363636364
6756,9950,장고/Noun,11,7,4,0.0001000333444481494,6.663853039827628e-05,0.6363636363636364
6757,9951,간장/Noun,11,4,7,6.668889629876625e-05,9.995779559741441e-05,0.6363636363636364
6758,9952,으로서는/Josa,11,4,7,6.668889629876625e-05,9.995779559741441e-05,0.6363636363636364
6759,9953,수상작/Noun,11,7,4,0.0001000333444481494,6.663853039827628e-05,0.6363636363636364
6760,9954,거북이/Noun,11,7,4,0.0001000333444481494,6.663853039827628e-05,0.6363636363636364
6761,9955,맨오브스틸/Noun,11,4,7,6.668889629876625e-05,9.995779559741441e-05,0.6363636363636364
6762,9956,매니저/Noun,11,4,7,6.668889629876625e-05,9.995779559741441e-05,0.6363636363636364
6763,9957,김일성/Noun,11,4,7,6.668889629876625e-05,9.995779559741441e-05,0.6363636363636364
6764,9958,ㄲ/KoreanParticle,11,4,7,6.668889629876625e-05,9.995779559741441e-05,0.6363636363636364
6765,9959,앓다/Verb,11,7,4,0.0001000333444481494,6.663853039827628e-05,0.6363636363636364
6766,9960,퍼시픽림/Noun,11,4,7,6.668889629876625e-05,9.995779559741441e-05,0.6363636363636364
6767,9961,전원/Noun,11,4,7,6.668889629876625e-05,9.995779559741441e-05,0.6363636363636364
6768,9962,샤넬/Noun,11,4,7,6.668889629876625e-05,9.995779559741441e-05,0.6363636363636364
6769,9963,60분/Number,11,4,7,6.668889629876625e-05,9.995779559741441e-05,0.6363636363636364
6770,9964,심혜진/Noun,11,4,7,6.668889629876625e-05,9.995779559741441e-05,0.6363636363636364
6771,9965,제기/Noun,11,4,7,6.668889629876625e-05,9.995779559741441e-05,0.6363636363636364
6772,9966,도우/Noun,11,7,4,0.0001000333444481494,6.663853039827628e-05,0.6363636363636364
6773,9967,에두/Noun,11,4,7,6.668889629876625e-05,9.995779559741441e-05,0.6363636363636364
6774,9968,스트/Noun,11,4,7,6.668889629876625e-05,9.995779559741441e-05,0.6363636363636364
6775,9969,창고/Noun,11,4,7,6.668889629876625e-05,9.995779559741441e-05,0.6363636363636364
6776,9970,도심/Noun,11,7,4,0.0001000333444481494,6.663853039827628e-05,0.6363636363636364
6777,9971,메가폰/Noun,11,4,7,6.668889629876625e-05,9.995779559741441e-05,0.6363636363636364
6778,9972,카밀라/Noun,11,4,7,6.668889629876625e-05,9.995779559741441e-05,0.6363636363636364
6779,9973,계승/Noun,11,7,4,0.0001000333444481494,6.663853039827628e-05,0.6363636363636364
6780,9974,김새론/Noun,11,7,4,0.0001000333444481494,6.663853039827628e-05,0.6363636363636364
6781,9975,한지혜/Noun,11,7,4,0.0001000333444481494,6.663853039827628e-05,0.6363636363636364
6782,9976,부도/Noun,11,7,4,0.0001000333444481494,6.663853039827628e-05,0.6363636363636364
6783,9977,아아/Exclamation,11,4,7,6.668889629876625e-05,9.995779559741441e-05,0.6363636363636364
6784,9978,민정/Noun,11,4,7,6.668889629876625e-05,9.995779559741441e-05,0.6363636363636364
6785,9979,만발/Noun,11,4,7,6.668889629876625e-05,9.995779559741441e-05,0.6363636363636364
6786,9980,82년/Number,11,7,4,0.0001000333444481494,6.663853039827628e-05,0.6363636363636364
6787,9981,모가지/Noun,11,4,7,6.668889629876625e-05,9.995779559741441e-05,0.6363636363636364
6788,9982,왼쪽/Noun,11,4,7,6.668889629876625e-05,9.995779559741441e-05,0.6363636363636364
6789,9983,트랩/Noun,11,4,7,6.668889629876625e-05,9.995779559741441e-05,0.6363636363636364
6790,9984,맹인/Noun,11,7,4,0.0001000333444481494,6.663853039827628e-05,0.6363636363636364
6791,9985,보완/Noun,11,4,7,6.668889629876625e-05,9.995779559741441e-05,0.6363636363636364
6792,9986,거인/Noun,11,4,7,6.668889629876625e-05,9.995779559741441e-05,0.6363636363636364
6793,9987,포세이돈/Noun,11,7,4,0.0001000333444481494,6.663853039827628e-05,0.6363636363636364
6794,9988,마감/Noun,11,4,7,6.668889629876625e-05,9.995779559741441e-05,0.6363636363636364
6795,9989,캐나다/Noun,11,4,7,6.668889629876625e-05,9.995779559741441e-05,0.6363636363636364
6796,9990,코멘트/Noun,11,7,4,0.0001000333444481494,6.663853039827628e-05,0.6363636363636364
6797,9991,오라/Noun,11,4,7,6.668889629876625e-05,9.995779559741441e-05,0.6363636363636364
6798,9992,현혹/Noun,11,4,7,6.668889629876625e-05,9.995779559741441e-05,0.6363636363636364
6799,9993,부시다/Verb,11,4,7,6.668889629876625e-05,9.995779559741441e-05,0.6363636363636364
6800,9994,고니/Noun,11,7,4,0.0001000333444481494,6.663853039827628e-05,0.6363636363636364
6801,9995,설사/Noun,11,4,7,6.668889629876625e-05,9.995779559741441e-05,0.6363636363636364
6802,9996,토로/Noun,11,7,4,0.0001000333444481494,6.663853039827628e-05,0.6363636363636364
6803,9997,****)/Punctuation,11,7,4,0.0001000333444481494,6.663853039827628e-05,0.6363636363636364
6804,9998,일그러지다/Verb,11,7,4,0.0001000333444481494,6.663853039827628e-05,0.6363636363636364
6805,9999,성실하다/Adjective,11,4,7,6.668889629876625e-05,9.995779559741441e-05,0.6363636363636364
6806,10000,튼튼하다/Adjective,11,7,4,0.0001000333444481494,6.663853039827628e-05,0.6363636363636364
6807,10001,룬드/Noun,11,7,4,0.0001000333444481494,6.663853039827628e-05,0.6363636363636364
6808,10002,저하/Noun,11,4,7,6.668889629876625e-05,9.995779559741441e-05,0.6363636363636364
6809,10003,주소/Noun,11,7,4,0.0001000333444481494,6.663853039827628e-05,0.6363636363636364
6810,10004,괴물영화/Noun,11,7,4,0.0001000333444481494,6.663853039827628e-05,0.6363636363636364
6811,10005,빈자리/Noun,11,7,4,0.0001000333444481494,6.663853039827628e-05,0.6363636363636364
6812,10006,오도/Noun,11,7,4,0.0001000333444481494,6.663853039827628e-05,0.6363636363636364
6813,10007,마린/Noun,11,4,7,6.668889629876625e-05,9.995779559741441e-05,0.6363636363636364
6814,10008,뉘/Noun,11,4,7,6.668889629876625e-05,9.995779559741441e-05,0.6363636363636364
6815,10009,cctv/Alpha,11,4,7,6.668889629876625e-05,9.995779559741441e-05,0.6363636363636364
6816,10010,딸내미/Noun,11,4,7,6.668889629876625e-05,9.995779559741441e-05,0.6363636363636364
6817,10011,비견/Noun,11,7,4,0.0001000333444481494,6.663853039827628e-05,0.6363636363636364
6818,10146,의젖/Noun,10,0,10,2.2229632099588756e-05,0.00013327706079655256,1.0
6819,10147,본전/Noun,10,0,10,2.2229632099588756e-05,0.00013327706079655256,1.0
6820,10148,forever/Alpha,10,10,0,0.0001333777925975325,2.2212843466092093e-05,1.0
6821,10149,로고/Noun,10,0,10,2.2229632099588756e-05,0.00013327706079655256,1.0
6822,10150,정겨운/Noun,10,10,0,0.0001333777925975325,2.2212843466092093e-05,1.0
6823,10151,검증/Noun,10,0,10,2.2229632099588756e-05,0.00013327706079655256,1.0
6824,10152,마틸다/Noun,10,10,0,0.0001333777925975325,2.2212843466092093e-05,1.0
6825,10153,주르륵/Noun,10,10,0,0.0001333777925975325,2.2212843466092093e-05,1.0
6826,10154,쟈니/Noun,10,10,0,0.0001333777925975325,2.2212843466092093e-05,1.0
6827,10155,소나/Noun,10,0,10,2.2229632099588756e-05,0.00013327706079655256,1.0
6828,10156,에스티/Noun,10,10,0,0.0001333777925975325,2.2212843466092093e-05,1.0
6829,10157,trash/Alpha,10,0,10,2.2229632099588756e-05,0.00013327706079655256,1.0
6830,10158,벅차오르다/Adjective,10,10,0,0.0001333777925975325,2.2212843466092093e-05,1.0
6831,10159,증발/Noun,10,0,10,2.2229632099588756e-05,0.00013327706079655256,1.0
6832,10160,제데로/Adverb,10,0,10,2.2229632099588756e-05,0.00013327706079655256,1.0
6833,10161,비디오영화/Noun,10,0,10,2.2229632099588756e-05,0.00013327706079655256,1.0
6834,10162,욱일승천기/Noun,10,0,10,2.2229632099588756e-05,0.00013327706079655256,1.0
6835,10163,베르세르크/Noun,10,10,0,0.0001333777925975325,2.2212843466092093e-05,1.0
6836,10164,미자/Noun,10,10,0,0.0001333777925975325,2.2212843466092093e-05,1.0
6837,10165,숨죽/Noun,10,10,0,0.0001333777925975325,2.2212843466092093e-05,1.0
6838,10166,안재욱/Noun,10,10,0,0.0001333777925975325,2.2212843466092093e-05,1.0
6839,10167,8.0/Number,10,10,0,0.0001333777925975325,2.2212843466092093e-05,1.0
6840,10168,아낌없다/Adjective,10,10,0,0.0001333777925975325,2.2212843466092093e-05,1.0
6841,10169,떡칠/Noun,10,0,10,2.2229632099588756e-05,0.00013327706079655256,1.0
6842,10170,부조화/Noun,10,0,10,2.2229632099588756e-05,0.00013327706079655256,1.0
6843,10171,great/Alpha,10,10,0,0.0001333777925975325,2.2212843466092093e-05,1.0
6844,10172,베끼기/Noun,10,0,10,2.2229632099588756e-05,0.00013327706079655256,1.0
6845,10173,마음씨/Noun,10,10,0,0.0001333777925975325,2.2212843466092093e-05,1.0
6846,10174,송희진/Noun,10,0,10,2.2229632099588756e-05,0.00013327706079655256,1.0
6847,10175,정선희/Noun,10,0,10,2.2229632099588756e-05,0.00013327706079655256,1.0
6848,10176,:-)/Punctuation,10,10,0,0.0001333777925975325,2.2212843466092093e-05,1.0
6849,10177,불체/Noun,10,0,10,2.2229632099588756e-05,0.00013327706079655256,1.0
6850,10178,집기/Noun,10,0,10,2.2229632099588756e-05,0.00013327706079655256,1.0
6851,10179,존멋/Noun,10,10,0,0.0001333777925975325,2.2212843466092093e-05,1.0
6852,10180,♥♥♥♥♥/Foreign,10,10,0,0.0001333777925975325,2.2212843466092093e-05,1.0
6853,10181,~!^^/Punctuation,10,10,0,0.0001333777925975325,2.2212843466092093e-05,1.0
6854,10182,생쇼/Noun,10,0,10,2.2229632099588756e-05,0.00013327706079655256,1.0
6855,10183,이지마/Noun,10,0,10,2.2229632099588756e-05,0.00013327706079655256,1.0
6856,10184,영문/Noun,10,0,10,2.2229632099588756e-05,0.00013327706079655256,1.0
6857,10185,차만/Noun,10,0,10,2.2229632099588756e-05,0.00013327706079655256,1.0
6858,10186,벡터맨/Noun,10,0,10,2.2229632099588756e-05,0.00013327706079655256,1.0
6859,10187,ㅗㅗㅗ/KoreanParticle,10,0,10,2.2229632099588756e-05,0.00013327706079655256,1.0
6860,10188,ㅠㅜㅠ/KoreanParticle,10,10,0,0.0001333777925975325,2.2212843466092093e-05,1.0
6861,10189,윤제균/Noun,10,0,10,2.2229632099588756e-05,0.00013327706079655256,1.0
6862,10190,우연찮/Noun,10,10,0,0.0001333777925975325,2.2212843466092093e-05,1.0
6863,10191,루비/Noun,10,1,9,3.334444814938313e-05,0.00012217063906350652,0.9
6864,10192,안면/Noun,10,1,9,3.334444814938313e-05,0.00012217063906350652,0.9
6865,10193,공사/Noun,10,1,9,3.334444814938313e-05,0.00012217063906350652,0.9
6866,10194,이기만/Noun,10,1,9,3.334444814938313e-05,0.00012217063906350652,0.9
6867,10195,하희라/Noun,10,1,9,3.334444814938313e-05,0.00012217063906350652,0.9
6868,10196,사살/Noun,10,1,9,3.334444814938313e-05,0.00012217063906350652,0.9
6869,10197,차도/Noun,10,1,9,3.334444814938313e-05,0.00012217063906350652,0.9
6870,10198,맘속/Noun,10,9,1,0.00012226297654773814,3.331926519913814e-05,0.9
6871,10199,고삐/Noun,10,1,9,3.334444814938313e-05,0.00012217063906350652,0.9
6872,10200,도용/Noun,10,1,9,3.334444814938313e-05,0.00012217063906350652,0.9
6873,10201,쉴드치다/Verb,10,1,9,3.334444814938313e-05,0.00012217063906350652,0.9
6874,10202,몰살/Noun,10,1,9,3.334444814938313e-05,0.00012217063906350652,0.9
6875,10203,모시/Noun,10,9,1,0.00012226297654773814,3.331926519913814e-05,0.9
6876,10204,이데올로기/Noun,10,9,1,0.00012226297654773814,3.331926519913814e-05,0.9
6877,10205,왈칵/Noun,10,9,1,0.00012226297654773814,3.331926519913814e-05,0.9
6878,10206,박서준/Noun,10,9,1,0.00012226297654773814,3.331926519913814e-05,0.9
6879,10207,익살스럽다/Adjective,10,9,1,0.00012226297654773814,3.331926519913814e-05,0.9
6880,10208,지민/Noun,10,9,1,0.00012226297654773814,3.331926519913814e-05,0.9
6881,10209,기획사/Noun,10,1,9,3.334444814938313e-05,0.00012217063906350652,0.9
6882,10210,대게/Noun,10,9,1,0.00012226297654773814,3.331926519913814e-05,0.9
6883,10211,하향/Noun,10,1,9,3.334444814938313e-05,0.00012217063906350652,0.9
6884,10212,0%/Number,10,1,9,3.334444814938313e-05,0.00012217063906350652,0.9
6885,10213,ㅜㅠㅠ/KoreanParticle,10,9,1,0.00012226297654773814,3.331926519913814e-05,0.9
6886,10214,엠/Noun,10,1,9,3.334444814938313e-05,0.00012217063906350652,0.9
6887,10215,...-_-;/Punctuation,10,1,9,3.334444814938313e-05,0.00012217063906350652,0.9
6888,10216,발단/Noun,10,1,9,3.334444814938313e-05,0.00012217063906350652,0.9
6889,10217,줏대/Noun,10,1,9,3.334444814938313e-05,0.00012217063906350652,0.9
6890,10218,비밥/Noun,10,9,1,0.00012226297654773814,3.331926519913814e-05,0.9
6891,10219,처분/Noun,10,1,9,3.334444814938313e-05,0.00012217063906350652,0.9
6892,10220,통렬/Noun,10,9,1,0.00012226297654773814,3.331926519913814e-05,0.9
6893,10221,지리멸렬하다/Adjective,10,1,9,3.334444814938313e-05,0.00012217063906350652,0.9
6894,10222,^^!/Punctuation,10,9,1,0.00012226297654773814,3.331926519913814e-05,0.9
6895,10223,2~3/Number,10,1,9,3.334444814938313e-05,0.00012217063906350652,0.9
6896,10224,그루지/Noun,10,1,9,3.334444814938313e-05,0.00012217063906350652,0.9
6897,10225,타지/Noun,10,9,1,0.00012226297654773814,3.331926519913814e-05,0.9
6898,10226,추잡/Noun,10,1,9,3.334444814938313e-05,0.00012217063906350652,0.9
6899,10227,사회생활/Noun,10,9,1,0.00012226297654773814,3.331926519913814e-05,0.9
6900,10228,120분/Number,10,1,9,3.334444814938313e-05,0.00012217063906350652,0.9
6901,10229,단서/Noun,10,1,9,3.334444814938313e-05,0.00012217063906350652,0.9
6902,10230,전주/Noun,10,9,1,0.00012226297654773814,3.331926519913814e-05,0.9
6903,10231,캐스퍼/Noun,10,9,1,0.00012226297654773814,3.331926519913814e-05,0.9
6904,10232,구제/Noun,10,1,9,3.334444814938313e-05,0.00012217063906350652,0.9
6905,10233,70%/Number,10,1,9,3.334444814938313e-05,0.00012217063906350652,0.9
6906,10234,처녀/Noun,10,1,9,3.334444814938313e-05,0.00012217063906350652,0.9
6907,10235,조만간/Noun,10,9,1,0.00012226297654773814,3.331926519913814e-05,0.9
6908,10236,장구/Noun,10,1,9,3.334444814938313e-05,0.00012217063906350652,0.9
6909,10237,육성/Noun,10,1,9,3.334444814938313e-05,0.00012217063906350652,0.9
6910,10238,개꿀/Noun,10,9,1,0.00012226297654773814,3.331926519913814e-05,0.9
6911,10239,스톰/Noun,10,1,9,3.334444814938313e-05,0.00012217063906350652,0.9
6912,10240,봣더/Noun,10,1,9,3.334444814938313e-05,0.00012217063906350652,0.9
6913,10241,공략/Noun,10,1,9,3.334444814938313e-05,0.00012217063906350652,0.9
6914,10242,개간/Noun,10,9,1,0.00012226297654773814,3.331926519913814e-05,0.9
6915,10243,딸년/Noun,10,1,9,3.334444814938313e-05,0.00012217063906350652,0.9
6916,10244,러블리/Noun,10,9,1,0.00012226297654773814,3.331926519913814e-05,0.9
6917,10245,구숙정/Noun,10,9,1,0.00012226297654773814,3.331926519913814e-05,0.9
6918,10246,레나/Noun,10,9,1,0.00012226297654773814,3.331926519913814e-05,0.9
6919,10247,자금/Noun,10,1,9,3.334444814938313e-05,0.00012217063906350652,0.9
6920,10248,！/Foreign,10,9,1,0.00012226297654773814,3.331926519913814e-05,0.9
6921,10249,단조/Noun,10,1,9,3.334444814938313e-05,0.00012217063906350652,0.9
6922,10250,결재/Noun,10,1,9,3.334444814938313e-05,0.00012217063906350652,0.9
6923,10251,다작/Noun,10,1,9,3.334444814938313e-05,0.00012217063906350652,0.9
6924,10252,하위/Noun,10,1,9,3.334444814938313e-05,0.00012217063906350652,0.9
6925,10253,메이퀸/Noun,10,9,1,0.00012226297654773814,3.331926519913814e-05,0.9
6926,10254,꿈틀/Noun,10,9,1,0.00012226297654773814,3.331926519913814e-05,0.9
6927,10255,백조/Noun,10,9,1,0.00012226297654773814,3.331926519913814e-05,0.9
6928,10256,존엄/Noun,10,9,1,0.00012226297654773814,3.331926519913814e-05,0.9
6929,10257,은지원/Noun,10,2,8,4.445926419917751e-05,0.00011106421733046048,0.8
6930,10258,대응/Noun,10,2,8,4.445926419917751e-05,0.00011106421733046048,0.8
6931,10259,성숙/Noun,10,8,2,0.00011114816049794375,4.4425686932184186e-05,0.8
6932,10260,키도/Noun,10,2,8,4.445926419917751e-05,0.00011106421733046048,0.8
6933,10261,일지매/Noun,10,8,2,0.00011114816049794375,4.4425686932184186e-05,0.8
6934,10262,위반/Noun,10,2,8,4.445926419917751e-05,0.00011106421733046048,0.8
6935,10263,전투력/Noun,10,2,8,4.445926419917751e-05,0.00011106421733046048,0.8
6936,10264,정해/Noun,10,2,8,4.445926419917751e-05,0.00011106421733046048,0.8
6937,10265,위장/Noun,10,2,8,4.445926419917751e-05,0.00011106421733046048,0.8
6938,10266,다모/Noun,10,8,2,0.00011114816049794375,4.4425686932184186e-05,0.8
6939,10267,J/Alpha,10,2,8,4.445926419917751e-05,0.00011106421733046048,0.8
6940,10268,자시/Noun,10,2,8,4.445926419917751e-05,0.00011106421733046048,0.8
6941,10269,매춘부/Noun,10,2,8,4.445926419917751e-05,0.00011106421733046048,0.8
6942,10270,ㅠㅜㅜ/KoreanParticle,10,8,2,0.00011114816049794375,4.4425686932184186e-05,0.8
6943,10271,!!~~/Punctuation,10,8,2,0.00011114816049794375,4.4425686932184186e-05,0.8
6944,10272,죄값/Noun,10,2,8,4.445926419917751e-05,0.00011106421733046048,0.8
6945,10273,사형수/Noun,10,2,8,4.445926419917751e-05,0.00011106421733046048,0.8
6946,10274,줄평/Noun,10,2,8,4.445926419917751e-05,0.00011106421733046048,0.8
6947,10275,퇴색/Noun,10,2,8,4.445926419917751e-05,0.00011106421733046048,0.8
6948,10276,카톡/Noun,10,2,8,4.445926419917751e-05,0.00011106421733046048,0.8
6949,10277,신경질/Noun,10,2,8,4.445926419917751e-05,0.00011106421733046048,0.8
6950,10278,조던/Noun,10,8,2,0.00011114816049794375,4.4425686932184186e-05,0.8
6951,10279,객/Noun,10,2,8,4.445926419917751e-05,0.00011106421733046048,0.8
6952,10280,홍은희/Noun,10,2,8,4.445926419917751e-05,0.00011106421733046048,0.8
6953,10281,한다해/Noun,10,2,8,4.445926419917751e-05,0.00011106421733046048,0.8
6954,10282,개그콘서트/Noun,10,2,8,4.445926419917751e-05,0.00011106421733046048,0.8
6955,10283,구태의연하다/Adjective,10,2,8,4.445926419917751e-05,0.00011106421733046048,0.8
6956,10284,구두/Noun,10,8,2,0.00011114816049794375,4.4425686932184186e-05,0.8
6957,10285,박희순/Noun,10,8,2,0.00011114816049794375,4.4425686932184186e-05,0.8
6958,10286,무분별/Noun,10,2,8,4.445926419917751e-05,0.00011106421733046048,0.8
6959,10287,리즈중/Noun,10,8,2,0.00011114816049794375,4.4425686932184186e-05,0.8
6960,10288,유전/Noun,10,8,2,0.00011114816049794375,4.4425686932184186e-05,0.8
6961,10289,송재림/Noun,10,8,2,0.00011114816049794375,4.4425686932184186e-05,0.8
6962,10290,명탐정코난/Noun,10,8,2,0.00011114816049794375,4.4425686932184186e-05,0.8
6963,10291,집합소/Noun,10,2,8,4.445926419917751e-05,0.00011106421733046048,0.8
6964,10292,평면/Noun,10,2,8,4.445926419917751e-05,0.00011106421733046048,0.8
6965,10293,느닷없다/Adjective,10,2,8,4.445926419917751e-05,0.00011106421733046048,0.8
6966,10294,빠리/Noun,10,2,8,4.445926419917751e-05,0.00011106421733046048,0.8
6967,10295,과격하다/Adjective,10,2,8,4.445926419917751e-05,0.00011106421733046048,0.8
6968,10296,희생양/Noun,10,2,8,4.445926419917751e-05,0.00011106421733046048,0.8
6969,10297,짤/Suffix,10,2,8,4.445926419917751e-05,0.00011106421733046048,0.8
6970,10298,맞짱/Noun,10,2,8,4.445926419917751e-05,0.00011106421733046048,0.8
6971,10299,고시/Noun,10,2,8,4.445926419917751e-05,0.00011106421733046048,0.8
6972,10300,구시대/Noun,10,2,8,4.445926419917751e-05,0.00011106421733046048,0.8
6973,10301,코스모스/Noun,10,8,2,0.00011114816049794375,4.4425686932184186e-05,0.8
6974,10302,낌/Noun,10,8,2,0.00011114816049794375,4.4425686932184186e-05,0.8
6975,10303,가해/Noun,10,2,8,4.445926419917751e-05,0.00011106421733046048,0.8
6976,10304,찐빵/Noun,10,2,8,4.445926419917751e-05,0.00011106421733046048,0.8
6977,10305,뮤지션/Noun,10,8,2,0.00011114816049794375,4.4425686932184186e-05,0.8
6978,10306,이덕화/Noun,10,8,2,0.00011114816049794375,4.4425686932184186e-05,0.8
6979,10307,달기/Noun,10,2,8,4.445926419917751e-05,0.00011106421733046048,0.8
6980,10308,뚱땡이/Noun,10,2,8,4.445926419917751e-05,0.00011106421733046048,0.8
6981,10309,날짜/Noun,10,2,8,4.445926419917751e-05,0.00011106421733046048,0.8
6982,10310,with/Alpha,10,8,2,0.00011114816049794375,4.4425686932184186e-05,0.8
6983,10311,왜그러지/Noun,10,8,2,0.00011114816049794375,4.4425686932184186e-05,0.8
6984,10312,지휘/Noun,10,8,2,0.00011114816049794375,4.4425686932184186e-05,0.8
6985,10313,공이/Noun,10,2,8,4.445926419917751e-05,0.00011106421733046048,0.8
6986,10314,구만/Eomi,10,2,8,4.445926419917751e-05,0.00011106421733046048,0.8
6987,10315,계보/Noun,10,2,8,4.445926419917751e-05,0.00011106421733046048,0.8
6988,10316,퇴화/Noun,10,2,8,4.445926419917751e-05,0.00011106421733046048,0.8
6989,10317,김갑수/Noun,10,8,2,0.00011114816049794375,4.4425686932184186e-05,0.8
6990,10318,족하/Noun,10,2,8,4.445926419917751e-05,0.00011106421733046048,0.8
6991,10319,현수/Noun,10,2,8,4.445926419917751e-05,0.00011106421733046048,0.8
6992,10320,Top/Alpha,10,8,2,0.00011114816049794375,4.4425686932184186e-05,0.8
6993,10321,우파/Noun,10,8,2,0.00011114816049794375,4.4425686932184186e-05,0.8
6994,10322,ktx/Alpha,10,2,8,4.445926419917751e-05,0.00011106421733046048,0.8
6995,10323,거론/Noun,10,2,8,4.445926419917751e-05,0.00011106421733046048,0.8
6996,10324,IMDB/Alpha,10,2,8,4.445926419917751e-05,0.00011106421733046048,0.8
6997,10325,골로/Noun,10,2,8,4.445926419917751e-05,0.00011106421733046048,0.8
6998,10326,1000만/Number,10,2,8,4.445926419917751e-05,0.00011106421733046048,0.8
6999,10327,치욕/Noun,10,2,8,4.445926419917751e-05,0.00011106421733046048,0.8
7000,10328,개개인/Noun,10,8,2,0.00011114816049794375,4.4425686932184186e-05,0.8
7001,10329,에코/Noun,10,2,8,4.445926419917751e-05,0.00011106421733046048,0.8
7002,10330,재연배우/Noun,10,2,8,4.445926419917751e-05,0.00011106421733046048,0.8
7003,10331,8회/Number,10,8,2,0.00011114816049794375,4.4425686932184186e-05,0.8
7004,10332,개신교/Noun,10,2,8,4.445926419917751e-05,0.00011106421733046048,0.8
7005,10333,미아/Noun,10,8,2,0.00011114816049794375,4.4425686932184186e-05,0.8
7006,10334,낙하산/Noun,10,2,8,4.445926419917751e-05,0.00011106421733046048,0.8
7007,10335,중국사람/Noun,10,2,8,4.445926419917751e-05,0.00011106421733046048,0.8
7008,10336,로보트/Noun,10,2,8,4.445926419917751e-05,0.00011106421733046048,0.8
7009,10337,장관/Noun,10,8,2,0.00011114816049794375,4.4425686932184186e-05,0.8
7010,10338,썻/Noun,10,2,8,4.445926419917751e-05,0.00011106421733046048,0.8
7011,10339,대식/Foreign,10,2,8,4.445926419917751e-05,0.00011106421733046048,0.8
7012,10340,끈질기다/Adjective,10,8,2,0.00011114816049794375,4.4425686932184186e-05,0.8
7013,10341,방귀/Noun,10,2,8,4.445926419917751e-05,0.00011106421733046048,0.8
7014,10342,치즈/Noun,10,8,2,0.00011114816049794375,4.4425686932184186e-05,0.8
7015,10343,피에르/Noun,10,8,2,0.00011114816049794375,4.4425686932184186e-05,0.8
7016,10344,왕창/Noun,10,2,8,4.445926419917751e-05,0.00011106421733046048,0.8
7017,10345,클리/Noun,10,2,8,4.445926419917751e-05,0.00011106421733046048,0.8
7018,10346,개멋/Noun,10,8,2,0.00011114816049794375,4.4425686932184186e-05,0.8
7019,10347,쭈쭈/Noun,10,2,8,4.445926419917751e-05,0.00011106421733046048,0.8
7020,10348,26/Number,10,8,2,0.00011114816049794375,4.4425686932184186e-05,0.8
7021,10349,드라마스페셜/Noun,10,2,8,4.445926419917751e-05,0.00011106421733046048,0.8
7022,10350,추측/Noun,10,8,2,0.00011114816049794375,4.4425686932184186e-05,0.8
7023,10351,폭팔/Noun,10,8,2,0.00011114816049794375,4.4425686932184186e-05,0.8
7024,10352,쥐뿔/Noun,10,2,8,4.445926419917751e-05,0.00011106421733046048,0.8
7025,10353,데미/Noun,10,2,8,4.445926419917751e-05,0.00011106421733046048,0.8
7026,10354,테두리/Noun,10,2,8,4.445926419917751e-05,0.00011106421733046048,0.8
7027,10355,건방지다/Adjective,10,2,8,4.445926419917751e-05,0.00011106421733046048,0.8
7028,10356,♡♡♡♡/Foreign,10,8,2,0.00011114816049794375,4.4425686932184186e-05,0.8
7029,10357,부다/Noun,10,2,8,4.445926419917751e-05,0.00011106421733046048,0.8
7030,10358,질풍/Noun,10,8,2,0.00011114816049794375,4.4425686932184186e-05,0.8
7031,10359,동포/Noun,10,8,2,0.00011114816049794375,4.4425686932184186e-05,0.8
7032,10360,따라다니다/Verb,10,2,8,4.445926419917751e-05,0.00011106421733046048,0.8
7033,10361,전무하다/Adjective,10,2,8,4.445926419917751e-05,0.00011106421733046048,0.8
7034,10362,과유/Noun,10,2,8,4.445926419917751e-05,0.00011106421733046048,0.8
7035,10363,자의식/Noun,10,2,8,4.445926419917751e-05,0.00011106421733046048,0.8
7036,10364,합창/Noun,10,8,2,0.00011114816049794375,4.4425686932184186e-05,0.8
7037,10365,위태/Noun,10,8,2,0.00011114816049794375,4.4425686932184186e-05,0.8
7038,10366,이슬/Noun,10,8,2,0.00011114816049794375,4.4425686932184186e-05,0.8
7039,10367,튀어/Noun,10,2,8,4.445926419917751e-05,0.00011106421733046048,0.8
7040,10368,순박하다/Adjective,10,8,2,0.00011114816049794375,4.4425686932184186e-05,0.8
7041,10369,쩍/Noun,10,2,8,4.445926419917751e-05,0.00011106421733046048,0.8
7042,10370,슈트/Noun,10,3,7,5.5574080248971876e-05,9.995779559741441e-05,0.7
7043,10371,정선경/Noun,10,3,7,5.5574080248971876e-05,9.995779559741441e-05,0.7
7044,10372,통과/Noun,10,7,3,0.0001000333444481494,5.553210866523024e-05,0.7
7045,10373,웃음소리/Noun,10,3,7,5.5574080248971876e-05,9.995779559741441e-05,0.7
7046,10374,댜/Noun,10,7,3,0.0001000333444481494,5.553210866523024e-05,0.7
7047,10375,고귀하다/Adjective,10,7,3,0.0001000333444481494,5.553210866523024e-05,0.7
7048,10376,촌티/Noun,10,3,7,5.5574080248971876e-05,9.995779559741441e-05,0.7
7049,10377,파이어/Noun,10,7,3,0.0001000333444481494,5.553210866523024e-05,0.7
7050,10378,김정태/Noun,10,7,3,0.0001000333444481494,5.553210866523024e-05,0.7
7051,10379,파업/Noun,10,3,7,5.5574080248971876e-05,9.995779559741441e-05,0.7
7052,10380,월터/Noun,10,7,3,0.0001000333444481494,5.553210866523024e-05,0.7
7053,10381,가드/Noun,10,3,7,5.5574080248971876e-05,9.995779559741441e-05,0.7
7054,10382,패션왕/Noun,10,3,7,5.5574080248971876e-05,9.995779559741441e-05,0.7
7055,10383,킨/Noun,10,7,3,0.0001000333444481494,5.553210866523024e-05,0.7
7056,10384,니드/Noun,10,7,3,0.0001000333444481494,5.553210866523024e-05,0.7
7057,10385,미신/Noun,10,3,7,5.5574080248971876e-05,9.995779559741441e-05,0.7
7058,10386,김석훈/Noun,10,3,7,5.5574080248971876e-05,9.995779559741441e-05,0.7
7059,10387,실재/Noun,10,7,3,0.0001000333444481494,5.553210866523024e-05,0.7
7060,10388,부작용/Noun,10,3,7,5.5574080248971876e-05,9.995779559741441e-05,0.7
7061,10389,베닝/Noun,10,7,3,0.0001000333444481494,5.553210866523024e-05,0.7
7062,10390,백수/Noun,10,3,7,5.5574080248971876e-05,9.995779559741441e-05,0.7
7063,10391,네러티브/Noun,10,3,7,5.5574080248971876e-05,9.995779559741441e-05,0.7
7064,10392,정신분열증/Noun,10,3,7,5.5574080248971876e-05,9.995779559741441e-05,0.7
7065,10393,신의한수/Noun,10,7,3,0.0001000333444481494,5.553210866523024e-05,0.7
7066,10394,옥상/Noun,10,7,3,0.0001000333444481494,5.553210866523024e-05,0.7
7067,10395,노조미/Noun,10,7,3,0.0001000333444481494,5.553210866523024e-05,0.7
7068,10396,day/Alpha,10,7,3,0.0001000333444481494,5.553210866523024e-05,0.7
7069,10397,헤치다/Verb,10,7,3,0.0001000333444481494,5.553210866523024e-05,0.7
7070,10398,모양새/Noun,10,3,7,5.5574080248971876e-05,9.995779559741441e-05,0.7
7071,10399,자평/Noun,10,3,7,5.5574080248971876e-05,9.995779559741441e-05,0.7
7072,10400,잦다/Verb,10,3,7,5.5574080248971876e-05,9.995779559741441e-05,0.7
7073,10401,딧/Noun,10,7,3,0.0001000333444481494,5.553210866523024e-05,0.7
7074,10402,??../Punctuation,10,3,7,5.5574080248971876e-05,9.995779559741441e-05,0.7
7075,10403,롯/Noun,10,7,3,0.0001000333444481494,5.553210866523024e-05,0.7
7076,10404,이성민/Noun,10,7,3,0.0001000333444481494,5.553210866523024e-05,0.7
7077,10405,1.5/Number,10,3,7,5.5574080248971876e-05,9.995779559741441e-05,0.7
7078,10406,마우스/Noun,10,3,7,5.5574080248971876e-05,9.995779559741441e-05,0.7
7079,10407,닥터후/Noun,10,7,3,0.0001000333444481494,5.553210866523024e-05,0.7
7080,10408,갈리/Noun,10,7,3,0.0001000333444481494,5.553210866523024e-05,0.7
7081,10409,시온/Noun,10,7,3,0.0001000333444481494,5.553210866523024e-05,0.7
7082,10410,점퍼/Noun,10,3,7,5.5574080248971876e-05,9.995779559741441e-05,0.7
7083,10411,연정훈/Noun,10,7,3,0.0001000333444481494,5.553210866523024e-05,0.7
7084,10412,명목/Noun,10,3,7,5.5574080248971876e-05,9.995779559741441e-05,0.7
7085,10413,하의/Noun,10,3,7,5.5574080248971876e-05,9.995779559741441e-05,0.7
7086,10414,듯해/Noun,10,7,3,0.0001000333444481494,5.553210866523024e-05,0.7
7087,10415,군단/Noun,10,3,7,5.5574080248971876e-05,9.995779559741441e-05,0.7
7088,10416,조성하/Noun,10,3,7,5.5574080248971876e-05,9.995779559741441e-05,0.7
7089,10417,과학자/Noun,10,3,7,5.5574080248971876e-05,9.995779559741441e-05,0.7
7090,10418,all/Alpha,10,7,3,0.0001000333444481494,5.553210866523024e-05,0.7
7091,10419,행세/Noun,10,3,7,5.5574080248971876e-05,9.995779559741441e-05,0.7
7092,10420,실어/Noun,10,7,3,0.0001000333444481494,5.553210866523024e-05,0.7
7093,10421,말세/Noun,10,3,7,5.5574080248971876e-05,9.995779559741441e-05,0.7
7094,10422,이산/Noun,10,3,7,5.5574080248971876e-05,9.995779559741441e-05,0.7
7095,10423,.-/Punctuation,10,3,7,5.5574080248971876e-05,9.995779559741441e-05,0.7
7096,10424,북극/Noun,10,7,3,0.0001000333444481494,5.553210866523024e-05,0.7
7097,10425,불상/Noun,10,3,7,5.5574080248971876e-05,9.995779559741441e-05,0.7
7098,10426,달랑/Noun,10,3,7,5.5574080248971876e-05,9.995779559741441e-05,0.7
7099,10427,은교/Noun,10,3,7,5.5574080248971876e-05,9.995779559741441e-05,0.7
7100,10428,헤어스타일/Noun,10,3,7,5.5574080248971876e-05,9.995779559741441e-05,0.7
7101,10429,램버트/Noun,10,7,3,0.0001000333444481494,5.553210866523024e-05,0.7
7102,10430,쌩/Noun,10,3,7,5.5574080248971876e-05,9.995779559741441e-05,0.7
7103,10431,투혼/Noun,10,3,7,5.5574080248971876e-05,9.995779559741441e-05,0.7
7104,10432,로고/Josa,10,3,7,5.5574080248971876e-05,9.995779559741441e-05,0.7
7105,10433,그래비티/Noun,10,7,3,0.0001000333444481494,5.553210866523024e-05,0.7
7106,10434,격추/Noun,10,3,7,5.5574080248971876e-05,9.995779559741441e-05,0.7
7107,10435,불쌍타/Noun,10,3,7,5.5574080248971876e-05,9.995779559741441e-05,0.7
7108,10436,률/Noun,10,3,7,5.5574080248971876e-05,9.995779559741441e-05,0.7
7109,10437,비장하다/Adjective,10,7,3,0.0001000333444481494,5.553210866523024e-05,0.7
7110,10438,임마/Noun,10,3,7,5.5574080248971876e-05,9.995779559741441e-05,0.7
7111,10439,12월/Number,10,7,3,0.0001000333444481494,5.553210866523024e-05,0.7
7112,10440,징징/Noun,10,3,7,5.5574080248971876e-05,9.995779559741441e-05,0.7
7113,10441,공권력/Noun,10,7,3,0.0001000333444481494,5.553210866523024e-05,0.7
7114,10442,쪼/Noun,10,7,3,0.0001000333444481494,5.553210866523024e-05,0.7
7115,10443,죵/Noun,10,3,7,5.5574080248971876e-05,9.995779559741441e-05,0.7
7116,10444,일수록/Josa,10,3,7,5.5574080248971876e-05,9.995779559741441e-05,0.7
7117,10445,모텔/Noun,10,3,7,5.5574080248971876e-05,9.995779559741441e-05,0.7
7118,10446,잠재우다/Verb,10,3,7,5.5574080248971876e-05,9.995779559741441e-05,0.7
7119,10447,분신/Noun,10,3,7,5.5574080248971876e-05,9.995779559741441e-05,0.7
7120,10448,기생/Noun,10,3,7,5.5574080248971876e-05,9.995779559741441e-05,0.7
7121,10449,인가가/Josa,10,7,3,0.0001000333444481494,5.553210866523024e-05,0.7
7122,10450,볼륨/Noun,10,3,7,5.5574080248971876e-05,9.995779559741441e-05,0.7
7123,10451,로구나/Josa,10,3,7,5.5574080248971876e-05,9.995779559741441e-05,0.7
7124,10452,해서웨이/Noun,10,7,3,0.0001000333444481494,5.553210866523024e-05,0.7
7125,10453,초원/Noun,10,7,3,0.0001000333444481494,5.553210866523024e-05,0.7
7126,10454,자괴/Noun,10,3,7,5.5574080248971876e-05,9.995779559741441e-05,0.7
7127,10455,매진/Noun,10,7,3,0.0001000333444481494,5.553210866523024e-05,0.7
7128,10456,상호/Noun,10,7,3,0.0001000333444481494,5.553210866523024e-05,0.7
7129,10457,스타크래프트/Noun,10,7,3,0.0001000333444481494,5.553210866523024e-05,0.7
7130,10458,시각장애인/Noun,10,7,3,0.0001000333444481494,5.553210866523024e-05,0.7
7131,10459,인원/Noun,10,3,7,5.5574080248971876e-05,9.995779559741441e-05,0.7
7132,10460,격렬하다/Adjective,10,7,3,0.0001000333444481494,5.553210866523024e-05,0.7
7133,10461,허수아비/Noun,10,3,7,5.5574080248971876e-05,9.995779559741441e-05,0.7
7134,10462,스칼렛요한슨/Noun,10,7,3,0.0001000333444481494,5.553210866523024e-05,0.7
7135,10463,연도/Noun,10,7,3,0.0001000333444481494,5.553210866523024e-05,0.7
7136,10464,급격하다/Adjective,10,3,7,5.5574080248971876e-05,9.995779559741441e-05,0.7
7137,10465,물든/Noun,10,7,3,0.0001000333444481494,5.553210866523024e-05,0.7
7138,10466,리모컨/Noun,10,3,7,5.5574080248971876e-05,9.995779559741441e-05,0.7
7139,10467,비고/Noun,10,7,3,0.0001000333444481494,5.553210866523024e-05,0.7
7140,10468,one/Alpha,10,7,3,0.0001000333444481494,5.553210866523024e-05,0.7
7141,10469,서너/Modifier,10,7,3,0.0001000333444481494,5.553210866523024e-05,0.7
7142,10470,레아/Noun,10,7,3,0.0001000333444481494,5.553210866523024e-05,0.7
7143,10471,필리핀/Noun,10,3,7,5.5574080248971876e-05,9.995779559741441e-05,0.7
7144,10472,ET/Alpha,10,7,3,0.0001000333444481494,5.553210866523024e-05,0.7
7145,10473,비포/Noun,10,7,3,0.0001000333444481494,5.553210866523024e-05,0.7
7146,10474,오맹달/Noun,10,7,3,0.0001000333444481494,5.553210866523024e-05,0.7
7147,10475,좌익/Noun,10,3,7,5.5574080248971876e-05,9.995779559741441e-05,0.7
7148,10476,리브스/Noun,10,7,3,0.0001000333444481494,5.553210866523024e-05,0.7
7149,10477,덧글/Noun,10,3,7,5.5574080248971876e-05,9.995779559741441e-05,0.7
7150,10478,150/Number,10,3,7,5.5574080248971876e-05,9.995779559741441e-05,0.7
7151,10479,선호/Noun,10,7,3,0.0001000333444481494,5.553210866523024e-05,0.7
7152,10480,맞이/Noun,10,7,3,0.0001000333444481494,5.553210866523024e-05,0.7
7153,10481,방한/Noun,10,3,7,5.5574080248971876e-05,9.995779559741441e-05,0.7
7154,10482,크레이븐/Noun,10,7,3,0.0001000333444481494,5.553210866523024e-05,0.7
7155,10483,이효리/Noun,10,3,7,5.5574080248971876e-05,9.995779559741441e-05,0.7
7156,10484,자잘하다/Adjective,10,7,3,0.0001000333444481494,5.553210866523024e-05,0.7
7157,10485,방향성/Noun,10,3,7,5.5574080248971876e-05,9.995779559741441e-05,0.7
7158,10486,피스/Noun,10,7,3,0.0001000333444481494,5.553210866523024e-05,0.7
7159,10487,돌대가리/Noun,10,3,7,5.5574080248971876e-05,9.995779559741441e-05,0.7
7160,10488,의료/Noun,10,7,3,0.0001000333444481494,5.553210866523024e-05,0.7
7161,10489,실비/Noun,10,7,3,0.0001000333444481494,5.553210866523024e-05,0.7
7162,10490,코트/Noun,10,7,3,0.0001000333444481494,5.553210866523024e-05,0.7
7163,10491,지평/Noun,10,7,3,0.0001000333444481494,5.553210866523024e-05,0.7
7164,10492,ㆍ/Foreign,10,7,3,0.0001000333444481494,5.553210866523024e-05,0.7
7165,10493,로지/Noun,10,3,7,5.5574080248971876e-05,9.995779559741441e-05,0.7
7166,10494,열매/Noun,10,7,3,0.0001000333444481494,5.553210866523024e-05,0.7
7167,10495,안재모/Noun,10,7,3,0.0001000333444481494,5.553210866523024e-05,0.7
7168,10496,마츠코/Noun,10,3,7,5.5574080248971876e-05,9.995779559741441e-05,0.7
7169,10497,로페즈/Noun,10,3,7,5.5574080248971876e-05,9.995779559741441e-05,0.7
7170,10498,일일이/Noun,10,3,7,5.5574080248971876e-05,9.995779559741441e-05,0.7
7171,10499,배신자/Noun,10,3,7,5.5574080248971876e-05,9.995779559741441e-05,0.7
7172,10500,이주/Noun,10,7,3,0.0001000333444481494,5.553210866523024e-05,0.7
7173,10501,간판/Noun,10,3,7,5.5574080248971876e-05,9.995779559741441e-05,0.7
7174,10502,연애시대/Noun,10,7,3,0.0001000333444481494,5.553210866523024e-05,0.7
7175,10503,러브액츄얼리/Noun,10,7,3,0.0001000333444481494,5.553210866523024e-05,0.7
7176,10504,로비/Noun,10,3,7,5.5574080248971876e-05,9.995779559741441e-05,0.7
7177,10505,주드로/Noun,10,7,3,0.0001000333444481494,5.553210866523024e-05,0.7
7178,10506,히로인/Noun,10,3,7,5.5574080248971876e-05,9.995779559741441e-05,0.7
7179,10507,What/Alpha,10,3,7,5.5574080248971876e-05,9.995779559741441e-05,0.7
7180,10508,LA/Alpha,10,7,3,0.0001000333444481494,5.553210866523024e-05,0.7
7181,10509,박재정/Noun,10,3,7,5.5574080248971876e-05,9.995779559741441e-05,0.7
7182,10510,눈망울/Noun,10,7,3,0.0001000333444481494,5.553210866523024e-05,0.7
7183,10511,중국무협/Noun,10,3,7,5.5574080248971876e-05,9.995779559741441e-05,0.7
7184,10512,이용철/Noun,10,7,3,0.0001000333444481494,5.553210866523024e-05,0.7
7185,10513,포레스트검프/Noun,10,7,3,0.0001000333444481494,5.553210866523024e-05,0.7
7186,10514,정당성/Noun,10,3,7,5.5574080248971876e-05,9.995779559741441e-05,0.7
7187,10515,김신/Noun,10,3,7,5.5574080248971876e-05,9.995779559741441e-05,0.7
7188,10516,걔/Noun,10,3,7,5.5574080248971876e-05,9.995779559741441e-05,0.7
7189,10517,똥개/Noun,10,3,7,5.5574080248971876e-05,9.995779559741441e-05,0.7
7190,10518,아름/Noun,10,7,3,0.0001000333444481494,5.553210866523024e-05,0.7
7191,10519,개지/Noun,10,3,7,5.5574080248971876e-05,9.995779559741441e-05,0.7
7192,10520,'./Punctuation,10,7,3,0.0001000333444481494,5.553210866523024e-05,0.7
7193,10521,거고/Eomi,10,3,7,5.5574080248971876e-05,9.995779559741441e-05,0.7
7194,10522,떠나가다/Verb,10,7,3,0.0001000333444481494,5.553210866523024e-05,0.7
7195,10523,라오스/Noun,10,7,3,0.0001000333444481494,5.553210866523024e-05,0.7
7196,10524,공항/Noun,10,7,3,0.0001000333444481494,5.553210866523024e-05,0.7
7197,10525,아이엠/Noun,10,7,3,0.0001000333444481494,5.553210866523024e-05,0.7
7198,10526,더듬다/Verb,10,7,3,0.0001000333444481494,5.553210866523024e-05,0.7
7199,10527,깜빡/Noun,10,4,6,6.668889629876625e-05,8.885137386436837e-05,0.6
7200,10528,풍/Noun,10,4,6,6.668889629876625e-05,8.885137386436837e-05,0.6
7201,10529,김씨/Noun,10,4,6,6.668889629876625e-05,8.885137386436837e-05,0.6
7202,10530,좌석/Noun,10,4,6,6.668889629876625e-05,8.885137386436837e-05,0.6
7203,10531,바다로/Noun,10,4,6,6.668889629876625e-05,8.885137386436837e-05,0.6
7204,10532,가의/Noun,10,6,4,8.891852839835501e-05,6.663853039827628e-05,0.6
7205,10533,익스트림/Noun,10,4,6,6.668889629876625e-05,8.885137386436837e-05,0.6
7206,10534,익숙/Noun,10,6,4,8.891852839835501e-05,6.663853039827628e-05,0.6
7207,10535,멀어지다/Verb,10,4,6,6.668889629876625e-05,8.885137386436837e-05,0.6
7208,10536,막걸리/Noun,10,6,4,8.891852839835501e-05,6.663853039827628e-05,0.6
7209,10537,두산/Noun,10,6,4,8.891852839835501e-05,6.663853039827628e-05,0.6
7210,10538,소시오패스/Noun,10,4,6,6.668889629876625e-05,8.885137386436837e-05,0.6
7211,10539,김현중/Noun,10,4,6,6.668889629876625e-05,8.885137386436837e-05,0.6
7212,10540,베스트셀러/Noun,10,4,6,6.668889629876625e-05,8.885137386436837e-05,0.6
7213,10541,헛된/Noun,10,4,6,6.668889629876625e-05,8.885137386436837e-05,0.6
7214,10542,서두/Noun,10,4,6,6.668889629876625e-05,8.885137386436837e-05,0.6
7215,10543,세미/Noun,10,6,4,8.891852839835501e-05,6.663853039827628e-05,0.6
7216,10544,개구/Noun,10,4,6,6.668889629876625e-05,8.885137386436837e-05,0.6
7217,10545,자단/Noun,10,6,4,8.891852839835501e-05,6.663853039827628e-05,0.6
7218,10546,수퍼맨/Noun,10,6,4,8.891852839835501e-05,6.663853039827628e-05,0.6
7219,10547,1:1/Number,10,4,6,6.668889629876625e-05,8.885137386436837e-05,0.6
7220,10548,묵묵하다/Adjective,10,6,4,8.891852839835501e-05,6.663853039827628e-05,0.6
7221,10549,붓다/Verb,10,6,4,8.891852839835501e-05,6.663853039827628e-05,0.6
7222,10550,로또/Noun,10,4,6,6.668889629876625e-05,8.885137386436837e-05,0.6
7223,10551,코치/Noun,10,4,6,6.668889629876625e-05,8.885137386436837e-05,0.6
7224,10552,보험/Noun,10,6,4,8.891852839835501e-05,6.663853039827628e-05,0.6
7225,10553,블런트/Noun,10,6,4,8.891852839835501e-05,6.663853039827628e-05,0.6
7226,10554,메멘토/Noun,10,6,4,8.891852839835501e-05,6.663853039827628e-05,0.6
7227,10555,ㅏㅇ/KoreanParticle,10,6,4,8.891852839835501e-05,6.663853039827628e-05,0.6
7228,10556,번영/Noun,10,6,4,8.891852839835501e-05,6.663853039827628e-05,0.6
7229,10557,헐리우드영화/Noun,10,6,4,8.891852839835501e-05,6.663853039827628e-05,0.6
7230,10558,천배/Noun,10,6,4,8.891852839835501e-05,6.663853039827628e-05,0.6
7231,10559,제품/Noun,10,4,6,6.668889629876625e-05,8.885137386436837e-05,0.6
7232,10560,김소은/Noun,10,6,4,8.891852839835501e-05,6.663853039827628e-05,0.6
7233,10561,총잡이/Noun,10,4,6,6.668889629876625e-05,8.885137386436837e-05,0.6
7234,10562,침착하다/Adjective,10,6,4,8.891852839835501e-05,6.663853039827628e-05,0.6
7235,10563,마트/Noun,10,4,6,6.668889629876625e-05,8.885137386436837e-05,0.6
7236,10564,snl/Alpha,10,4,6,6.668889629876625e-05,8.885137386436837e-05,0.6
7237,10565,공통점/Noun,10,4,6,6.668889629876625e-05,8.885137386436837e-05,0.6
7238,10566,육감/Noun,10,4,6,6.668889629876625e-05,8.885137386436837e-05,0.6
7239,10567,칸타빌레/Noun,10,6,4,8.891852839835501e-05,6.663853039827628e-05,0.6
7240,10568,터치/Noun,10,6,4,8.891852839835501e-05,6.663853039827628e-05,0.6
7241,10569,블랙홀/Noun,10,6,4,8.891852839835501e-05,6.663853039827628e-05,0.6
7242,10570,해골/Noun,10,4,6,6.668889629876625e-05,8.885137386436837e-05,0.6
7243,10571,복제인간/Noun,10,6,4,8.891852839835501e-05,6.663853039827628e-05,0.6
7244,10572,30초/Number,10,4,6,6.668889629876625e-05,8.885137386436837e-05,0.6
7245,10573,매직/Noun,10,4,6,6.668889629876625e-05,8.885137386436837e-05,0.6
7246,10574,상일/Noun,10,4,6,6.668889629876625e-05,8.885137386436837e-05,0.6
7247,10575,3.14/Number,10,4,6,6.668889629876625e-05,8.885137386436837e-05,0.6
7248,10576,**/Punctuation,10,6,4,8.891852839835501e-05,6.663853039827628e-05,0.6
7249,10577,백야/Noun,10,4,6,6.668889629876625e-05,8.885137386436837e-05,0.6
7250,10578,단비/Noun,10,6,4,8.891852839835501e-05,6.663853039827628e-05,0.6
7251,10579,배리/Noun,10,4,6,6.668889629876625e-05,8.885137386436837e-05,0.6
7252,10580,패널/Noun,10,4,6,6.668889629876625e-05,8.885137386436837e-05,0.6
7253,10581,올리버스톤/Noun,10,6,4,8.891852839835501e-05,6.663853039827628e-05,0.6
7254,10582,한경직/Noun,10,4,6,6.668889629876625e-05,8.885137386436837e-05,0.6
7255,10583,신사/Noun,10,4,6,6.668889629876625e-05,8.885137386436837e-05,0.6
7256,10584,부끄러움/Noun,10,4,6,6.668889629876625e-05,8.885137386436837e-05,0.6
7257,10585,격감/Noun,10,6,4,8.891852839835501e-05,6.663853039827628e-05,0.6
7258,10586,자장가/Noun,10,4,6,6.668889629876625e-05,8.885137386436837e-05,0.6
7259,10587,...???/Punctuation,10,6,4,8.891852839835501e-05,6.663853039827628e-05,0.6
7260,10588,핵폭탄/Noun,10,4,6,6.668889629876625e-05,8.885137386436837e-05,0.6
7261,10589,진입/Noun,10,4,6,6.668889629876625e-05,8.885137386436837e-05,0.6
7262,10590,투명인간/Noun,10,4,6,6.668889629876625e-05,8.885137386436837e-05,0.6
7263,10591,기만/Modifier,10,4,6,6.668889629876625e-05,8.885137386436837e-05,0.6
7264,10592,1월/Number,10,6,4,8.891852839835501e-05,6.663853039827628e-05,0.6
7265,10593,유희왕/Noun,10,4,6,6.668889629876625e-05,8.885137386436837e-05,0.6
7266,10594,예견/Noun,10,6,4,8.891852839835501e-05,6.663853039827628e-05,0.6
7267,10595,프라임/Noun,10,6,4,8.891852839835501e-05,6.663853039827628e-05,0.6
7268,10596,부숴/Noun,10,4,6,6.668889629876625e-05,8.885137386436837e-05,0.6
7269,10597,실시간/Noun,10,6,4,8.891852839835501e-05,6.663853039827628e-05,0.6
7270,10598,딴다/Adjective,10,6,4,8.891852839835501e-05,6.663853039827628e-05,0.6
7271,10599,트롤/Noun,10,6,4,8.891852839835501e-05,6.663853039827628e-05,0.6
7272,10600,참사/Noun,10,4,6,6.668889629876625e-05,8.885137386436837e-05,0.6
7273,10601,허상/Noun,10,4,6,6.668889629876625e-05,8.885137386436837e-05,0.6
7274,10602,이민자/Noun,10,6,4,8.891852839835501e-05,6.663853039827628e-05,0.6
7275,10603,프로필/Noun,10,4,6,6.668889629876625e-05,8.885137386436837e-05,0.6
7276,10604,도어/Noun,10,6,4,8.891852839835501e-05,6.663853039827628e-05,0.6
7277,10605,피자/Noun,10,4,6,6.668889629876625e-05,8.885137386436837e-05,0.6
7278,10606,이두/Noun,10,4,6,6.668889629876625e-05,8.885137386436837e-05,0.6
7279,10607,이자나/Josa,10,4,6,6.668889629876625e-05,8.885137386436837e-05,0.6
7280,10608,여리다/Adjective,10,4,6,6.668889629876625e-05,8.885137386436837e-05,0.6
7281,10609,??!!/Punctuation,10,4,6,6.668889629876625e-05,8.885137386436837e-05,0.6
7282,10610,언더월드/Noun,10,4,6,6.668889629876625e-05,8.885137386436837e-05,0.6
7283,10611,쿵푸허슬/Noun,10,6,4,8.891852839835501e-05,6.663853039827628e-05,0.6
7284,10612,비정하다/Adjective,10,6,4,8.891852839835501e-05,6.663853039827628e-05,0.6
7285,10613,순애보/Noun,10,6,4,8.891852839835501e-05,6.663853039827628e-05,0.6
7286,10614,관용/Noun,10,4,6,6.668889629876625e-05,8.885137386436837e-05,0.6
7287,10615,교복/Noun,10,6,4,8.891852839835501e-05,6.663853039827628e-05,0.6
7288,10616,텔/Noun,10,4,6,6.668889629876625e-05,8.885137386436837e-05,0.6
7289,10617,나단/Noun,10,6,4,8.891852839835501e-05,6.663853039827628e-05,0.6
7290,10618,전남편/Noun,10,4,6,6.668889629876625e-05,8.885137386436837e-05,0.6
7291,10619,김유정/Noun,10,4,6,6.668889629876625e-05,8.885137386436837e-05,0.6
7292,10620,ㅜㅡ/KoreanParticle,10,4,6,6.668889629876625e-05,8.885137386436837e-05,0.6
7293,10621,인구/Noun,10,4,6,6.668889629876625e-05,8.885137386436837e-05,0.6
7294,10622,날아오다/Verb,10,4,6,6.668889629876625e-05,8.885137386436837e-05,0.6
7295,10623,5위안/Number,10,6,4,8.891852839835501e-05,6.663853039827628e-05,0.6
7296,10624,척도/Noun,10,4,6,6.668889629876625e-05,8.885137386436837e-05,0.6
7297,10625,자수/Noun,10,6,4,8.891852839835501e-05,6.663853039827628e-05,0.6
7298,10626,임펙트/Noun,10,6,4,8.891852839835501e-05,6.663853039827628e-05,0.6
7299,10627,기점/Noun,10,6,4,8.891852839835501e-05,6.663853039827628e-05,0.6
7300,10628,수리/Noun,10,4,6,6.668889629876625e-05,8.885137386436837e-05,0.6
7301,10629,복지/Noun,10,6,4,8.891852839835501e-05,6.663853039827628e-05,0.6
7302,10630,장도/Noun,10,4,6,6.668889629876625e-05,8.885137386436837e-05,0.6
7303,10631,탈옥/Noun,10,6,4,8.891852839835501e-05,6.663853039827628e-05,0.6
7304,10632,장병/Noun,10,4,6,6.668889629876625e-05,8.885137386436837e-05,0.6
7305,10633,카사노바/Noun,10,6,4,8.891852839835501e-05,6.663853039827628e-05,0.6
7306,10634,홈즈/Noun,10,6,4,8.891852839835501e-05,6.663853039827628e-05,0.6
7307,10635,내뱉다/Verb,10,4,6,6.668889629876625e-05,8.885137386436837e-05,0.6
7308,10636,도그빌/Noun,10,6,4,8.891852839835501e-05,6.663853039827628e-05,0.6
7309,10637,제타존스/Noun,10,4,6,6.668889629876625e-05,8.885137386436837e-05,0.6
7310,10638,이다해/Noun,10,6,4,8.891852839835501e-05,6.663853039827628e-05,0.6
7311,10639,몽롱/Noun,10,6,4,8.891852839835501e-05,6.663853039827628e-05,0.6
7312,10640,끈기/Noun,10,4,6,6.668889629876625e-05,8.885137386436837e-05,0.6
7313,10641,느긋하다/Adjective,10,4,6,6.668889629876625e-05,8.885137386436837e-05,0.6
7314,10642,박해진/Noun,10,6,4,8.891852839835501e-05,6.663853039827628e-05,0.6
7315,10643,카톨릭/Noun,10,4,6,6.668889629876625e-05,8.885137386436837e-05,0.6
7316,10644,여섯/Determiner,10,6,4,8.891852839835501e-05,6.663853039827628e-05,0.6
7317,10645,꽃님/Noun,10,4,6,6.668889629876625e-05,8.885137386436837e-05,0.6
7318,10646,은색/Noun,10,6,4,8.891852839835501e-05,6.663853039827628e-05,0.6
7319,10647,숟가락/Noun,10,4,6,6.668889629876625e-05,8.885137386436837e-05,0.6
7320,10648,5일/Number,10,6,4,8.891852839835501e-05,6.663853039827628e-05,0.6
7321,10649,도보/Noun,10,6,4,8.891852839835501e-05,6.663853039827628e-05,0.6
7322,10650,피아니스트/Noun,10,4,6,6.668889629876625e-05,8.885137386436837e-05,0.6
7323,10651,아영/Noun,10,6,4,8.891852839835501e-05,6.663853039827628e-05,0.6
7324,10652,MB/Alpha,10,6,4,8.891852839835501e-05,6.663853039827628e-05,0.6
7325,10653,탈북자/Noun,10,4,6,6.668889629876625e-05,8.885137386436837e-05,0.6
7326,10654,다중인격/Noun,10,4,6,6.668889629876625e-05,8.885137386436837e-05,0.6
7327,10655,이방인/Noun,10,6,4,8.891852839835501e-05,6.663853039827628e-05,0.6
7328,10656,실리다/Verb,10,6,4,8.891852839835501e-05,6.663853039827628e-05,0.6
7329,10657,김영애/Noun,10,6,4,8.891852839835501e-05,6.663853039827628e-05,0.6
7330,10658,풀풀/Adverb,10,4,6,6.668889629876625e-05,8.885137386436837e-05,0.6
7331,10659,하늘나라/Noun,10,6,4,8.891852839835501e-05,6.663853039827628e-05,0.6
7332,10660,슈퍼주니어/Noun,10,6,4,8.891852839835501e-05,6.663853039827628e-05,0.6
7333,10661,유세윤/Noun,10,4,6,6.668889629876625e-05,8.885137386436837e-05,0.6
7334,10662,내레이션/Noun,10,4,6,6.668889629876625e-05,8.885137386436837e-05,0.6
7335,10663,드라이브/Noun,10,4,6,6.668889629876625e-05,8.885137386436837e-05,0.6
7336,10664,하므다/Verb,10,4,6,6.668889629876625e-05,8.885137386436837e-05,0.6
7337,10665,챔프/Noun,10,4,6,6.668889629876625e-05,8.885137386436837e-05,0.6
7338,10666,백성/Noun,10,4,6,6.668889629876625e-05,8.885137386436837e-05,0.6
7339,10667,어바웃타임/Noun,10,6,4,8.891852839835501e-05,6.663853039827628e-05,0.6
7340,10668,하워드/Noun,10,6,4,8.891852839835501e-05,6.663853039827628e-05,0.6
7341,10669,3~4/Number,10,6,4,8.891852839835501e-05,6.663853039827628e-05,0.6
7342,10670,일본군/Noun,10,4,6,6.668889629876625e-05,8.885137386436837e-05,0.6
7343,10671,감칠맛/Noun,10,6,4,8.891852839835501e-05,6.663853039827628e-05,0.6
7344,10672,종교인/Noun,10,6,4,8.891852839835501e-05,6.663853039827628e-05,0.6
7345,10673,뻗다/Verb,10,6,4,8.891852839835501e-05,6.663853039827628e-05,0.6
7346,10674,원판/Noun,10,6,4,8.891852839835501e-05,6.663853039827628e-05,0.6
7347,10675,일침/Noun,10,6,4,8.891852839835501e-05,6.663853039827628e-05,0.6
7348,10676,UFO/Alpha,10,4,6,6.668889629876625e-05,8.885137386436837e-05,0.6
7349,10677,악하다/Adjective,10,4,6,6.668889629876625e-05,8.885137386436837e-05,0.6
7350,10678,소용/Noun,10,4,6,6.668889629876625e-05,8.885137386436837e-05,0.6
7351,10679,추종/Noun,10,6,4,8.891852839835501e-05,6.663853039827628e-05,0.6
7352,10680,사가다/Verb,10,4,6,6.668889629876625e-05,8.885137386436837e-05,0.6
7353,10681,야만/Noun,10,4,6,6.668889629876625e-05,8.885137386436837e-05,0.6
7354,10682,코리아/Noun,10,4,6,6.668889629876625e-05,8.885137386436837e-05,0.6
7355,10683,십자가/Noun,10,4,6,6.668889629876625e-05,8.885137386436837e-05,0.6
7356,10684,네네/Noun,10,4,6,6.668889629876625e-05,8.885137386436837e-05,0.6
7357,10685,룸/Noun,10,6,4,8.891852839835501e-05,6.663853039827628e-05,0.6
7358,10686,작용/Noun,10,6,4,8.891852839835501e-05,6.663853039827628e-05,0.6
7359,10687,대담하다/Adjective,10,6,4,8.891852839835501e-05,6.663853039827628e-05,0.6
7360,10688,두껍다/Adjective,10,4,6,6.668889629876625e-05,8.885137386436837e-05,0.6
7361,10689,지하실/Noun,10,6,4,8.891852839835501e-05,6.663853039827628e-05,0.6
7362,10690,정해진/Noun,10,6,4,8.891852839835501e-05,6.663853039827628e-05,0.6
7363,10691,랍니/Noun,10,6,4,8.891852839835501e-05,6.663853039827628e-05,0.6
7364,10692,찰/Noun,10,4,6,6.668889629876625e-05,8.885137386436837e-05,0.6
7365,10693,아이맥스/Noun,10,6,4,8.891852839835501e-05,6.663853039827628e-05,0.6
7366,10694,립/Noun,10,6,4,8.891852839835501e-05,6.663853039827628e-05,0.6
7367,10695,정지훈/Noun,10,6,4,8.891852839835501e-05,6.663853039827628e-05,0.6
7368,10696,내내/Foreign,10,6,4,8.891852839835501e-05,6.663853039827628e-05,0.6
7369,10697,숨바꼭질/Noun,10,4,6,6.668889629876625e-05,8.885137386436837e-05,0.6
7370,10698,",,./Punctuation",10,4,6,6.668889629876625e-05,8.885137386436837e-05,0.6
7371,10699,파이트/Noun,10,4,6,6.668889629876625e-05,8.885137386436837e-05,0.6
7372,10700,멍멍/Adverb,10,4,6,6.668889629876625e-05,8.885137386436837e-05,0.6
7373,10701,거늘/Noun,10,4,6,6.668889629876625e-05,8.885137386436837e-05,0.6
7374,10702,서투르다/Adjective,10,6,4,8.891852839835501e-05,6.663853039827628e-05,0.6
7375,10703,버무린/Noun,10,4,6,6.668889629876625e-05,8.885137386436837e-05,0.6
7376,10704,원더풀/Noun,10,6,4,8.891852839835501e-05,6.663853039827628e-05,0.6
7377,10705,아사/Noun,10,6,4,8.891852839835501e-05,6.663853039827628e-05,0.6
7378,10706,제거/Noun,10,6,4,8.891852839835501e-05,6.663853039827628e-05,0.6
7379,10707,명탐정/Noun,10,4,6,6.668889629876625e-05,8.885137386436837e-05,0.6
7380,10708,장끌/Noun,10,4,6,6.668889629876625e-05,8.885137386436837e-05,0.6
7381,10709,장화홍련/Noun,10,6,4,8.891852839835501e-05,6.663853039827628e-05,0.6
7382,10710,9.11/Number,10,6,4,8.891852839835501e-05,6.663853039827628e-05,0.6
7383,10711,순서/Noun,10,4,6,6.668889629876625e-05,8.885137386436837e-05,0.6
7384,10712,밀폐/Noun,10,6,4,8.891852839835501e-05,6.663853039827628e-05,0.6
7385,10713,일본드라마/Noun,10,6,4,8.891852839835501e-05,6.663853039827628e-05,0.6
7386,10714,엠마왓슨/Noun,10,4,6,6.668889629876625e-05,8.885137386436837e-05,0.6
