,Unnamed: 0,parameter,counts,counts_H,counts_NH,p_from_H,p_from_NH,priority
0,5,의/Josa,29457,17487,11970,0.19438701789485385,0.13296608098802729,0.593644974029942
1,10,.../Punctuation,22073,9139,12934,0.1016005335111704,0.14367267153868366,0.5859647533185339
2,11,은/Josa,19690,7739,11951,0.08603979104145826,0.1327550589750994,0.6069578466226511
3,12,도/Josa,18990,7903,11087,0.08786262087362454,0.12315911059774763,0.5838335966298052
4,15,없다/Adjective,16914,5001,11913,0.05560742469712127,0.13233301494924365,0.7043277758070238
5,18,있다/Adjective,13419,8187,5232,0.09101922863176616,0.05813101135076301,0.6101050748938073
6,19,좋다/Adjective,13043,9370,3673,0.10416805601867288,0.040816099868944224,0.7183930077436173
7,20,이/Determiner,12373,4495,7878,0.04998332777592531,0.08751860325640286,0.6367089630647378
8,22,재밌다/Adjective,11789,9955,1834,0.1106702234078026,0.020391390301872543,0.8444312494698448
9,23,?/Punctuation,11319,3302,8017,0.03672335222852062,0.08906239587729625,0.7082781164413817
10,24,정말/Noun,10702,7082,3620,0.07873735689674335,0.04022745951709279,0.6617454681367969
11,25,것/Noun,10293,4088,6205,0.045459597643659005,0.06893755969701681,0.6028368794326241
12,30,적/Suffix,9003,5486,3517,0.06099811048127154,0.03908349807858904,0.6093524380761969
13,32,아니다/Adjective,8754,3210,5544,0.035700789151939534,0.061596214931473374,0.6333104866346813
14,34,!/Punctuation,8565,6415,2150,0.07132377459153051,0.02390101956951509,0.7489784004670169
15,37,점/Noun,7843,3227,4616,0.03588974102478604,0.05128945556320665,0.5885502996302435
16,38,만/Josa,7745,2412,5333,0.026831165944203626,0.05925275994580066,0.6885732730794061
17,39,나오다/Verb,7213,2894,4319,0.03218850728020451,0.04799084830849197,0.5987799805906003
18,40,만들다/Verb,7199,2506,4693,0.02787595865288429,0.05214465003665119,0.6518960966800944
19,43,과/Josa,6768,4231,2537,0.0470490163387796,0.028199204780203917,0.6251477541371159
20,44,최고/Noun,6671,6143,528,0.06830054462598642,0.005886403518514404,0.9208514465597362
21,46,이다/Verb,6524,4043,2481,0.04495943092141825,0.02757724516315333,0.6197118332311465
22,47,왜/Noun,6247,2241,4006,0.024930532399688784,0.04451453830604856,0.6412678085481031
23,48,스토리/Noun,6075,2176,3899,0.02420806935645215,0.04332615118061263,0.6418106995884774
24,50,생각/Noun,6005,3771,2234,0.04193620095587418,0.02483395899509096,0.6279766860949209
25,51,~/Punctuation,6003,4016,1987,0.0446593308880738,0.022090672827028587,0.6689988339163752
26,55,감동/Noun,5597,4442,1155,0.049394242525286215,0.012850129945134276,0.7936394497051992
27,56,..../Punctuation,5580,2218,3362,0.024674891630543514,0.0373620027099669,0.6025089605734767
28,57,1/Number,5284,1409,3875,0.015683005446259866,0.043059597059019517,0.7333459500378501
29,60,보고/Noun,5209,3038,2171,0.0337890407913749,0.024134254425909062,0.5832213476674986
30,62,아깝다/Adjective,5167,374,4793,0.004179170834722685,0.0532552922099558,0.9276175730598026
31,64,드라마/Noun,5005,3017,1988,0.03355562965432922,0.022101779248761638,0.6027972027972028
32,66,때/Noun,4940,3220,1720,0.03581193731243748,0.01912525822430529,0.6518218623481782
33,69,재미있다/Adjective,4787,4102,685,0.04561520506835612,0.007630111730602634,0.8569041153123041
34,70,거/Noun,4783,1959,2824,0.02179615427364677,0.03138674781758813,0.5904244198201966
35,71,와/Josa,4779,2774,2005,0.03085472935422919,0.022290588418223414,0.5804561623770663
36,72,감독/Noun,4688,1515,3173,0.016861175947538068,0.0352628890024212,0.6768344709897611
37,73,ㅋㅋ/KoreanParticle,4594,2777,1817,0.03088807380237857,0.02020258113241076,0.6044841097083152
38,74,재미/Noun,4538,1752,2786,0.01949538735133934,0.03096470379173238,0.6139268400176289
39,75,내용/Noun,4529,1407,3122,0.015660775814160276,0.03469646149403585,0.6893353941267388
40,76,뭐/Noun,4491,831,3660,0.009258641769478715,0.04067171638641463,0.8149632598530394
41,77,못/VerbPrefix,4418,1474,2944,0.0164054684894965,0.032719518425553665,0.666364870982345
42,78,그냥/Noun,4406,1187,3219,0.013215516283205513,0.035773784402141316,0.7305946436677259
43,79,고/Josa,4377,1761,2616,0.019595420695787485,0.02907661209711455,0.5976696367374914
44,81,게/Josa,4340,1723,2617,0.0191730576858953,0.0290877185188476,0.6029953917050691
45,82,주다/Verb,4321,1728,2593,0.01922863176614427,0.028821164397254493,0.6000925711640824
46,83,안/VerbPrefix,4262,1318,2944,0.014671557185728575,0.032719518425553665,0.6907555138432661
47,84,재미없다/Adjective,4205,307,3898,0.0034344781593864623,0.04331504475887958,0.9269916765755052
48,85,자다/Verb,4114,2658,1456,0.029565410692453036,0.01619316288678114,0.6460865337870686
49,86,좀/Noun,4111,1455,2656,0.0161942869845504,0.029520868966436395,0.6460715154463634
50,87,그/Noun,4099,2400,1699,0.02669778815160609,0.018892023367911327,0.5855086606489388
51,88,지루하다/Adjective,4057,872,3185,0.009714349227520284,0.03539616606321775,0.7850628543258565
52,91,!!/Punctuation,4005,3088,917,0.03434478159386462,0.010206801572669318,0.7710362047440699
53,92,시간/Noun,3956,1077,2879,0.01199288651772813,0.03199760101290566,0.7277553083923155
54,93,한/Determiner,3920,1604,2316,0.01785039457596977,0.025744685577200742,0.5908163265306122
55,94,쓰레기/Noun,3739,209,3530,0.002345226186506613,0.03922788156111864,0.9441027012570206
56,96,수/Noun,3698,2475,1223,0.027531399355340668,0.013605366622981408,0.6692806922660898
57,99,그렇다/Adjective,3501,1397,2104,0.01554962765366233,0.02339012416979497,0.6009711510996858
58,101,아/Exclamation,3469,1327,2142,0.014771590530176725,0.023812168195650726,0.6174690112424329
59,102,알다/Verb,3393,1393,2000,0.015505168389463152,0.022235056309558188,0.5894488653109343
60,104,작품/Noun,3308,2050,1258,0.02280760253417806,0.01399409138363802,0.6197097944377267
61,105,다시/Noun,3289,2763,526,0.03073246637768145,0.005864190675048313,0.8400729705077531
62,106,10/Number,3248,2158,1090,0.02400800266755585,0.012128212532486284,0.6644088669950738
63,107,마지막/Noun,3201,2151,1050,0.02393019895520729,0.011683955663164441,0.6719775070290535
64,109,사랑/Noun,3190,2523,667,0.0280649105257308,0.0074301961394078065,0.7909090909090909
65,110,잘/VerbPrefix,3151,2150,1001,0.023919084139157498,0.011139740998245185,0.682323072040622
66,111,하나/Noun,3087,1267,1820,0.014104701567189062,0.020235900397609898,0.5895691609977324
67,114,요/Josa,3013,1950,1063,0.02169612092919862,0.01182833914569404,0.6471954862263525
68,116,이다/Adjective,2942,2200,742,0.02447482494164721,0.00826317776938626,0.7477906186267845
69,117,나/Josa,2916,1029,1887,0.011459375347338,0.020980030653723985,0.647119341563786
70,120,많다/Adjective,2857,1696,1161,0.01887295765255085,0.012916768475532551,0.5936296814840742
71,122,ㅋ/KoreanParticle,2712,1574,1138,0.017516950094475937,0.012661320775672492,0.5803834808259587
72,123,주인공/Noun,2708,1083,1625,0.012059575414026896,0.018070148159665917,0.6000738552437223
73,124,안되다/Adjective,2683,658,2025,0.0073357785928642874,0.022512716852884338,0.7547521431233694
74,130,중/Suffix,2597,1568,1029,0.017450261198177167,0.011450720806770473,0.6037735849056604
75,131,지금/Noun,2596,1843,753,0.020506835611870625,0.008385348408449766,0.7099383667180277
76,132,ㅠㅠ/KoreanParticle,2589,1842,747,0.020495720795820828,0.008318709878051491,0.7114716106604867
77,133,최악/Noun,2549,32,2517,0.00037790374569300877,0.027977076345542997,0.9874460572773636
78,134,지/Josa,2511,993,1518,0.011059241969545405,0.01688176103422999,0.6045400238948626
79,136,걸/Noun,2493,777,1716,0.008658441702789819,0.01908083253737311,0.6883273164861613
80,137,3/Number,2481,918,1563,0.010225630765810827,0.017381550012217063,0.6299879081015719
81,139,연출/Noun,2454,975,1479,0.010859175280649105,0.016448610586641196,0.6026894865525673
82,140,별로/Noun,2438,320,2118,0.0035789707680337892,0.023545614074057617,0.8687448728465955
83,141,끝/Noun,2438,862,1576,0.009603201067022341,0.01752593349474666,0.6464315012305168
84,142,돈/Noun,2433,279,2154,0.00312326330999222,0.023945445256447283,0.8853267570900123
85,144,좋아하다/Adjective,2390,1427,963,0.015883072135156162,0.010717696972389435,0.597071129707113
86,146,라/Josa,2373,987,1386,0.010992553073246638,0.015415713365467912,0.584070796460177
87,147,그리고/Conjunction,2339,1419,920,0.01579415360675781,0.010240120837868457,0.6066695168875588
88,148,역시/Noun,2323,1623,700,0.01806157608091586,0.007796708056598325,0.6986655187257856
89,149,넘다/Verb,2286,1520,766,0.01691675002778704,0.008529731890979364,0.6649168853893264
90,150,개/Noun,2277,671,1606,0.007480271201511616,0.017859126146738045,0.7053140096618358
91,151,명작/Noun,2259,1976,283,0.02198510614649328,0.0031653301939181234,0.8747233289065959
92,153,남다/Verb,2231,1452,779,0.016160942536401022,0.008674115373508963,0.6508292245629762
93,154,이런/Modifier,2201,819,1382,0.009125263976881185,0.015371287678535732,0.6278964107223989
94,156,이해/Noun,2164,866,1298,0.00964766033122152,0.014438348252959863,0.5998151571164511
95,157,^^/Punctuation,2162,1921,241,0.021373791263754584,0.002698860481130189,0.8885291396854764
96,158,라고/Josa,2147,777,1370,0.008658441702789819,0.015238010617739176,0.6380996739636703
97,159,괜찮다/Adjective,2129,1444,685,0.01607202400800267,0.007630111730602634,0.6782527007984971
98,160,ㅡㅡ/KoreanParticle,2128,211,1917,0.002367455818606202,0.021313223305715362,0.9008458646616542
99,162,안/Noun,2100,842,1258,0.009380904746026451,0.01399409138363802,0.599047619047619
100,163,버리다/Verb,2073,660,1413,0.007358008224963877,0.015715586752260157,0.6816208393632417
101,164,느끼다/Verb,2066,1442,624,0.016049794375903082,0.006952620004886826,0.6979670861568248
102,166,때문/Noun,2060,810,1250,0.009025230632433032,0.013905240009773652,0.6067961165048543
103,167,!!!/Punctuation,2038,1392,646,0.01549405357341336,0.007196961283013839,0.6830225711481845
104,168,또/Noun,2013,1348,665,0.01500500166722241,0.007407983295941714,0.6696472925981123
105,169,중/Noun,1957,1139,818,0.012682005112815385,0.009107265821097759,0.5820132856412877
106,170,해주다/Verb,1945,1324,621,0.014738246082027343,0.0069193007396876885,0.680719794344473
107,171,여자/Noun,1944,757,1187,0.008436145381793929,0.01320553544059175,0.61059670781893
108,172,난/Noun,1928,1196,732,0.013315549627653665,0.0081521135520558,0.6203319502074689
109,173,꼭/Noun,1920,1594,326,0.017739246415471824,0.003642906328439104,0.8302083333333333
110,175,에게/Josa,1907,1144,763,0.012737579193064357,0.008496412625780226,0.5998951232302046
111,177,아름답다/Adjective,1901,1659,242,0.01846170945870846,0.0027099669028632354,0.8726985796948974
112,181,마음/Noun,1810,1497,313,0.016661109258641768,0.003498522845909505,0.8270718232044199
113,182,인생/Noun,1810,1304,506,0.014515949761031457,0.005642062240387392,0.7204419889502762
114,185,기억/Noun,1794,1237,557,0.01377125708569523,0.00620848974877274,0.6895206243032329
115,186,부터/Josa,1791,743,1048,0.008280537957096809,0.01166174281969835,0.5851479620323842
116,187,결말/Noun,1777,729,1048,0.008124930532399691,0.01166174281969835,0.5897580191333709
117,188,끄다/Verb,1754,541,1213,0.006035345115038346,0.013494302405650948,0.6915621436716077
118,189,아쉽다/Adjective,1746,1186,560,0.013204401467155718,0.006241809013971878,0.6792668957617412
119,191,ㅎㅎ/KoreanParticle,1744,1498,246,0.01667222407469156,0.00275439258979542,0.8589449541284404
120,194,못/Noun,1720,544,1176,0.0060686895631877295,0.013083364801528243,0.6837209302325581
121,195,소재/Noun,1714,594,1120,0.006624430365677447,0.012461405184477666,0.6534422403733956
122,196,이나/Josa,1704,527,1177,0.005879737690341225,0.013094471223261291,0.6907276995305164
123,197,어리다/Verb,1690,1270,420,0.014138046015338444,0.004686909971345432,0.7514792899408284
124,198,재다/Verb,1675,1417,258,0.01577192397465822,0.0028876696505919725,0.8459701492537314
125,200,뻔하다/Adjective,1670,457,1213,0.005101700566855619,0.013494302405650948,0.7263473053892215
126,201,애/Noun,1670,576,1094,0.006424363676781149,0.012172638219418469,0.6550898203592814
127,202,수준/Noun,1658,273,1385,0.003056574413693453,0.01540460694373487,0.8353437876960192
128,203,맞다/Verb,1649,477,1172,0.005323996887851506,0.01303893911459606,0.7107337780473014
129,204,한번/Noun,1640,1136,504,0.012648660664666,0.0056198493969213,0.6926829268292682
130,206,네/Josa,1608,469,1139,0.005235078359453151,0.01267242719740554,0.7083333333333334
131,210,현실/Noun,1587,1041,546,0.011592753139935534,0.0060863191097092345,0.6559546313799622
132,211,전개/Noun,1586,418,1168,0.004668222740913638,0.012994513427663876,0.7364438839848676
133,212,매력/Noun,1586,1153,433,0.012837612537512505,0.004831293453875031,0.7269861286254728
134,214,되어다/Verb,1577,1073,504,0.011948427253528954,0.0056198493969213,0.6804058338617628
135,215,가슴/Noun,1575,1376,199,0.01531621651661665,0.002232390768342256,0.8736507936507937
136,216,낮다/Adjective,1560,1254,306,0.013960208958541736,0.0034207778937781824,0.8038461538461539
137,217,말다/Verb,1559,338,1221,0.0037790374569300882,0.013583153779515316,0.7831943553559975
138,219,~~/Punctuation,1556,1038,518,0.011559408691786151,0.005775339301183945,0.6670951156812339
139,220,야/Josa,1543,373,1170,0.00416805601867289,0.013016726271129968,0.7582631237848347
140,222,높다/Adjective,1536,327,1209,0.003656774480382349,0.013449876718718765,0.787109375
141,223,님/Suffix,1536,948,588,0.010559075247304657,0.006552788822497168,0.6171875
142,225,가장/Noun,1534,1006,528,0.011203734578192731,0.005886403518514404,0.6558018252933507
143,226,;;/Punctuation,1523,373,1150,0.00416805601867289,0.012794597836469045,0.7550886408404465
144,227,저/Noun,1522,907,615,0.010103367789263087,0.006852662209289411,0.5959264126149802
145,228,슬프다/Adjective,1504,1292,212,0.014382571968433922,0.002376774250871854,0.8590425531914894
146,229,??/Punctuation,1503,455,1048,0.0050794709347560295,0.01166174281969835,0.697272122421823
147,231,멋지다/Adjective,1475,1271,204,0.01414916083138824,0.0022879228770074857,0.8616949152542372
148,233,아/Josa,1457,606,851,0.006757808158274981,0.00947377773828828,0.5840768702814001
149,235,음악/Noun,1452,1077,375,0.01199288651772813,0.00418712099335836,0.7417355371900827
150,237,성/Suffix,1445,496,949,0.005535178392797599,0.010562207068126793,0.6567474048442906
151,239,유치하다/Adjective,1442,282,1160,0.003156607758141603,0.012905662053799508,0.8044382801664355
152,240,아이/Noun,1436,944,492,0.01051461598310548,0.005486572336124747,0.6573816155988857
153,241,죽다/Verb,1435,475,960,0.005301767255751918,0.010684377707190298,0.6689895470383276
154,244,솔직하다/Adjective,1420,500,920,0.005579637656996777,0.010240120837868457,0.647887323943662
155,247,무슨/Noun,1408,215,1193,0.00241191508280538,0.013272173970990026,0.8473011363636364
156,248,추천/Noun,1403,1037,366,0.011548293875736356,0.004087163197760945,0.7391304347826086
157,249,만/Noun,1401,947,454,0.010547960431254862,0.0050645283102689976,0.6759457530335474
158,250,냐/Josa,1392,169,1223,0.0019006335445148387,0.013605366622981408,0.8785919540229885
159,251,인지/Josa,1383,425,958,0.004746026453262197,0.010662164863724205,0.6926970354302241
160,252,쓰다/Verb,1383,430,953,0.0048016005335111715,0.010606632755058977,0.6890817064352857
161,253,게/Noun,1380,485,895,0.005412915416249861,0.009962460294542305,0.6485507246376812
162,254,눈물/Noun,1378,1156,222,0.012870956985661888,0.0024878384682023146,0.8388969521044993
163,255,인가/Josa,1378,446,932,0.004979437590307881,0.010373397898665008,0.6763425253991292
164,257,번/Noun,1370,945,425,0.010525730799155274,0.004742442080010663,0.6897810218978102
165,259,ㅠ/KoreanParticle,1361,899,462,0.01001444926086473,0.005153379684133366,0.6605437178545187
166,261,저/Determiner,1355,471,884,0.00525730799155274,0.009840289655478798,0.6523985239852399
167,262,우리/Noun,1346,996,350,0.011092586417694788,0.003909460450032209,0.7399702823179792
168,263,인간/Noun,1346,839,507,0.00934756029787707,0.005653168662120438,0.6233283803863299
169,264,네/Suffix,1337,913,424,0.010170056685561854,0.004731335658277615,0.6828721017202692
170,265,야하다/Adjective,1322,769,553,0.008569523174391464,0.006164064061840557,0.5816944024205749
171,267,지만/Josa,1312,784,528,0.00873624541513838,0.005886403518514404,0.5975609756097561
172,268,속/Noun,1307,819,488,0.009125263976881185,0.005442146649192564,0.6266258607498087
173,270,허다/Verb,1294,206,1088,0.0023118817383572304,0.01210599968902019,0.8408037094281299
174,272,원작/Noun,1275,429,846,0.004790485717461376,0.009418245629623049,0.6635294117647059
175,273,짜증나다/Adjective,1251,81,1170,0.0009225297321329332,0.013016726271129968,0.9352517985611509
176,274,그래도/Adverb,1246,736,510,0.00820273424474825,0.005686487927319576,0.5906902086677368
177,275,살다/Verb,1239,732,507,0.008158274980549073,0.005653168662120438,0.5907990314769975
178,276,뭔가/Noun,1237,502,735,0.005601867289096366,0.008185432817254937,0.5941794664510913
179,277,코미디/Noun,1235,485,750,0.005412915416249861,0.008352029143250627,0.6072874493927125
180,278,찍다/Verb,1231,259,972,0.002900966988996332,0.01081765476798685,0.7896019496344435
181,279,보이다/Verb,1231,504,727,0.005624096921195954,0.00809658144339057,0.5905767668562144
182,282,기대하다/Adjective,1222,341,881,0.003812381905079471,0.00980697039027966,0.7209492635024549
183,284,여운/Noun,1210,1139,71,0.012682005112815385,0.0008107687865123613,0.9413223140495868
184,286,움/Noun,1204,432,772,0.00482383016561076,0.00859637042137764,0.6411960132890365
185,288,전혀/Noun,1199,338,861,0.0037790374569300882,0.00958484195561874,0.7180984153461217
186,289,기대/Noun,1198,745,453,0.008302767589196399,0.005053421888535951,0.6218697829716193
187,291,모두/Noun,1194,810,384,0.009025230632433032,0.004287078788955775,0.6783919597989949
188,292,대박/Noun,1180,975,205,0.010859175280649105,0.002299029298740532,0.826271186440678
189,293,대한/Noun,1173,715,458,0.00796932310770257,0.005108953997201182,0.6095481670929241
190,295,씨/Suffix,1170,706,464,0.00786928976325442,0.005175592527599458,0.6034188034188034
191,297,별/Noun,1164,304,860,0.003401133711237079,0.009573735533885692,0.7388316151202751
192,298,이쁘다/Adjective,1161,733,428,0.008169389796598866,0.0047757613452098,0.6313522825150732
193,299,계속/Noun,1161,707,454,0.007880404579304213,0.0050645283102689976,0.6089577950043066
194,300,굿/Noun,1156,1072,84,0.011937312437479159,0.00095515226904196,0.9273356401384084
195,301,아주/Noun,1152,682,470,0.007602534178059353,0.005242231057997734,0.5920138888888888
196,303,모습/Noun,1142,842,300,0.009380904746026451,0.003354139363379907,0.7373029772329247
197,304,별/Modifier,1142,316,826,0.0035345115038346118,0.009196117194962126,0.7232924693520141
198,305,미치다/Adjective,1139,415,724,0.004634878292764255,0.00806326217819143,0.6356453028972783
199,308,전/Noun,1126,674,452,0.007513615649660998,0.0050423154668029066,0.5985790408525755
200,309,치다/Verb,1122,345,777,0.0038568411692786494,0.00865190253004287,0.6925133689839572
201,310,실망/Noun,1118,115,1003,0.001300433477825942,0.011161953841711278,0.8971377459749553
202,313,요/Noun,1099,666,433,0.007424697121262644,0.004831293453875031,0.6060054595086443
203,315,일본/Noun,1098,391,707,0.004368122707569189,0.007874453008729647,0.6438979963570127
204,316,시키다/Verb,1097,384,713,0.0042903189952206286,0.007941091539127924,0.649954421148587
205,317,보지/Noun,1094,324,770,0.003623430032232967,0.008574157577911549,0.7038391224862889
206,318,진심/Noun,1094,415,679,0.004634878292764255,0.007563473200204358,0.6206581352833638
207,319,건지다/Verb,1093,195,898,0.002189618761809492,0.009995779559741442,0.8215919487648673
208,325,일/Modifier,1074,387,687,0.004323663443370012,0.007652324574068727,0.6396648044692738
209,326,제목/Noun,1073,405,668,0.004523730132266311,0.007441302561140851,0.6225535880708295
210,327,귀엽다/Adjective,1069,881,188,0.009814382571968434,0.0021102201292787486,0.8241347053320861
211,329,몰입/Noun,1061,631,430,0.00703567855951984,0.004797974188675893,0.5947219604147032
212,331,대단하다/Adjective,1057,751,306,0.008369456485495166,0.0034207778937781824,0.7105014191106906
213,332,밖에/Josa,1056,430,626,0.0048016005335111715,0.006974832848352918,0.5928030303030303
214,335,뿐/Noun,1051,311,740,0.0034789374235856397,0.008240964925920167,0.7040913415794482
215,338,ㅎ/KoreanParticle,1048,840,208,0.009358675113926865,0.00233234856393967,0.8015267175572519
216,339,;/Punctuation,1045,287,758,0.0032121818383905746,0.008440880517114994,0.7253588516746412
217,340,표현/Noun,1042,681,361,0.00759141936200956,0.004031631089095715,0.6535508637236085
218,341,OO/Alpha,1033,220,813,0.0024674891630543515,0.009051733712432529,0.7870280735721199
219,343,가족/Noun,1031,710,321,0.007913749027453596,0.0035873742197738727,0.6886517943743938
220,345,잔잔하다/Adjective,1023,897,126,0.009992219628765144,0.001421621981829894,0.8768328445747801
221,347,요즘/Noun,1013,643,370,0.0071690563521173735,0.00413158888469313,0.6347482724580454
222,349,점도/Noun,1011,91,920,0.001033677892630877,0.010240120837868457,0.9099901088031652
223,352,용/Noun,999,295,704,0.003301100366788929,0.00784113374353051,0.7047047047047047
224,353,떨어지다/Verb,997,207,790,0.0023229965544070245,0.00879628601257247,0.7923771313941825
225,354,ㅜㅜ/KoreanParticle,996,633,363,0.007057908191619429,0.004053843932561807,0.6355421686746988
226,355,모든/Noun,986,630,356,0.007024563743470045,0.003976098980430485,0.6389452332657201
227,356,4/Number,981,333,648,0.0037234633766811158,0.007219174126479932,0.6605504587155964
228,358,급/Noun,974,237,737,0.002656441035900856,0.00820764566072103,0.7566735112936345
229,359,웃다/Verb,974,598,376,0.006668889629876626,0.004198227415091406,0.6139630390143738
230,361,조금/Noun,967,582,385,0.006491052573079916,0.00429818521068882,0.6018614270941055
231,362,특히/Adverb,966,665,301,0.007413582305212848,0.0033652457851129523,0.6884057971014492
232,364,빠지다/Verb,964,602,362,0.006713348894075803,0.0040427375108287615,0.6244813278008299
233,366,개인/Noun,957,633,324,0.007057908191619429,0.003620693484973011,0.6614420062695925
234,369,공포/Noun,951,319,632,0.0035678559519839955,0.007041471378751194,0.6645636172450052
235,370,짜다/Verb,947,361,586,0.00403467822607536,0.006530575979031076,0.6187961985216474
236,372,건/Noun,932,292,640,0.0032677559186395466,0.0071303227526155625,0.6866952789699571
237,373,한테/Josa,931,317,614,0.0035456263198844064,0.006841555787556365,0.6595059076262084
238,374,작가/Noun,929,209,720,0.002345226186506613,0.008018836491259245,0.77502691065662
239,375,이유/Noun,928,364,564,0.00406802267422474,0.006286234700904063,0.6077586206896551
240,376,나름/Noun,923,600,323,0.006691119261976214,0.003609587063239965,0.6500541711809318
241,379,욕/Noun,910,166,744,0.0018672890963654552,0.00828539061285235,0.8175824175824176
242,380,차라리/Noun,909,59,850,0.0006780037790374569,0.00946267131655523,0.935093509350935
243,381,이상하다/Adjective,909,232,677,0.002600866955651884,0.007541260356738266,0.7447744774477447
244,382,노래/Noun,909,604,305,0.006735578526175392,0.0034096714720451365,0.6644664466446645
245,383,깊다/Adjective,907,808,99,0.009003001000333445,0.0011217485950376508,0.8908489525909592
246,384,제대로/Noun,907,366,541,0.00409025230632433,0.0060307870010440036,0.5964718853362734
247,385,짱/Noun,905,842,63,0.009380904746026451,0.0007219174126479931,0.9303867403314916
248,386,중간/Noun,905,328,577,0.0036678892964321437,0.0064306181834336605,0.6375690607734806
249,387,울다/Verb,900,695,205,0.00774702678670668,0.002299029298740532,0.7722222222222223
250,388,알바/Noun,897,104,793,0.001178170501278204,0.008829605277771607,0.8840579710144928
251,390,0/Number,888,77,811,0.0008780704679337558,0.009029520868966436,0.9132882882882885
252,392,따뜻하다/Adjective,884,833,51,0.009280871401578305,0.0005886403518514405,0.9423076923076924
253,393,느껴지다/Verb,884,553,331,0.0061687229076358785,0.0036984384371043337,0.6255656108597285
254,394,삶/Noun,883,770,113,0.008580637990441259,0.0012772384993002955,0.8720271800679502
255,397,...../Punctuation,877,327,550,0.003656774480382349,0.006130744796641418,0.6271379703534777
256,398,제/Noun,874,553,321,0.0061687229076358785,0.0035873742197738727,0.6327231121281465
257,399,오랜/Modifier,870,699,171,0.007791486050905858,0.0019214109598169665,0.8034482758620691
258,400,기/Noun,869,240,629,0.0026897854840502392,0.007008152113552056,0.7238204833141542
259,401,예쁘다/Adjective,865,571,294,0.006368789596532178,0.00328750083298163,0.6601156069364161
260,402,제일/Noun,865,507,358,0.0056574413693453365,0.003998311823896578,0.5861271676300578
261,403,당시/Noun,862,550,312,0.006135378459486495,0.003487416424176459,0.6380510440835266
262,404,빼다/Verb,861,250,611,0.002800933644548183,0.006808236522357226,0.7096399535423926
263,405,점수/Noun,857,271,586,0.0030343447815938647,0.006530575979031076,0.6837806301050176
264,406,해보다/Verb,855,496,359,0.005535178392797599,0.004009418245629622,0.5801169590643275
265,409,놈/Noun,846,250,596,0.002800933644548183,0.006641640196361536,0.7044917257683215
266,410,아직도/Adverb,841,631,210,0.00703567855951984,0.002354561407405762,0.7502972651605232
267,411,어설프다/Adjective,834,79,755,0.0009003001000333445,0.008407561251915855,0.9052757793764988
268,412,막장/Noun,834,144,690,0.001622763143269979,0.007685643839267866,0.8273381294964028
269,413,력/Suffix,830,347,483,0.003879070801378237,0.005386614540527333,0.5819277108433735
270,416,훌륭하다/Adjective,825,663,162,0.007391352673113259,0.001821453164219552,0.8036363636363636
271,417,세상/Noun,824,533,291,0.00594642658663999,0.003254181567782492,0.6468446601941747
272,418,이지/Josa,815,332,483,0.003712348560631322,0.005386614540527333,0.5926380368098161
273,419,이라고/Josa,815,342,473,0.003823496721129265,0.0052755503231968716,0.5803680981595092
274,420,공포영화/Noun,809,293,516,0.003278870734689341,0.005753126457717852,0.6378244746600742
275,422,도대체/Noun,805,101,704,0.0011448260531288204,0.00784113374353051,0.8745341614906832
276,424,힘들다/Adjective,799,310,489,0.0034678226075358447,0.005453253070925609,0.6120150187734669
277,425,앞/Noun,797,485,312,0.005412915416249861,0.003487416424176459,0.6085319949811794
278,426,생각나다/Verb,795,647,148,0.00721351561631655,0.001665963259956907,0.8138364779874214
279,427,류/Noun,790,141,649,0.0015894186951205956,0.007230280548212976,0.8215189873417722
280,431,절대/Noun,787,263,524,0.0029454262531955103,0.005841977831582221,0.6658195679796697
281,433,뭘/Noun,782,175,607,0.001967322440813605,0.006763810835425043,0.7762148337595908
282,434,잇다/Verb,780,524,256,0.0058463932421918404,0.00286545680712588,0.6717948717948717
283,437,물/Noun,777,295,482,0.003301100366788929,0.005375508118794287,0.6203346203346203
284,438,제/Modifier,775,314,461,0.0035122818717350226,0.00514227326240032,0.5948387096774194
285,440,써다/Verb,768,243,525,0.0027231299321996217,0.005853084253315267,0.68359375
286,441,수작/Noun,766,696,70,0.007758141602756475,0.0007996623647793153,0.908616187989556
287,442,엄청/Adverb,766,465,301,0.0051906190952539745,0.0033652457851129523,0.6070496083550914
288,443,걍/Adverb,765,208,557,0.002334111370456819,0.00620848974877274,0.7281045751633987
289,444,설정/Noun,762,139,623,0.0015671890630210071,0.0069415135831537795,0.8175853018372703
290,445,초반/Noun,761,265,496,0.0029676558852950985,0.005530998023056932,0.6517739816031537
291,448,놓다/Verb,755,225,530,0.0025230632433033235,0.005908616361980497,0.7019867549668874
292,449,필요없다/Adjective,754,630,124,0.007024563743470045,0.0013994091383638019,0.8355437665782494
293,451,신선하다/Adjective,748,507,241,0.0056574413693453365,0.002698860481130189,0.6778074866310161
294,452,싫다/Adjective,746,130,616,0.0014671557185728574,0.0068637686310224575,0.8257372654155496
295,453,시나리오/Noun,742,207,535,0.0023229965544070245,0.005964148470645727,0.7210242587601078
296,454,딱/Adverb,742,251,491,0.002812048460597977,0.005475465914391701,0.6617250673854448
297,455,이란/Josa,742,435,307,0.004857174613760142,0.0034318843155112288,0.5862533692722371
298,458,출연/Noun,740,226,514,0.0025341780593531177,0.00573091361425176,0.6945945945945946
299,461,멋있다/Adjective,732,615,117,0.0068578415027231296,0.0013216641862324795,0.8401639344262295
300,462,관객/Noun,732,188,544,0.002111815049460932,0.006064106266243142,0.7431693989071039
301,463,한국영/Noun,731,295,436,0.003301100366788929,0.004864612719074169,0.5964432284541724
302,464,이야/Josa,730,298,432,0.003334444814938313,0.004820187032141985,0.5917808219178082
303,465,가지/Noun,725,278,447,0.003112148493942425,0.004986783358137676,0.616551724137931
304,466,노잼/Noun,724,17,707,0.00021118150494609317,0.007874453008729647,0.9765193370165746
305,468,뭔/Modifier,722,104,618,0.001178170501278204,0.006885981474488549,0.8559556786703602
306,469,분위기/Noun,721,443,278,0.004946093142158497,0.003109798085252893,0.6144244105409153
307,470,답답하다/Adjective,719,131,588,0.001478270534622652,0.006552788822497168,0.8178025034770514
308,471,아프다/Adjective,719,559,160,0.006235411803934645,0.0017992403207534593,0.7774687065368567
309,472,시대/Noun,719,474,245,0.005290652439702123,0.0027432861680623736,0.6592489568845619
310,474,장난/Noun,714,182,532,0.002045126153162165,0.005930829205446589,0.7450980392156863
311,475,죽이다/Verb,713,198,515,0.002222963209958875,0.005742020035984807,0.7223001402524544
312,477,최고다/Noun,711,679,32,0.007569189729909971,0.0003776183389235656,0.9549929676511956
313,478,스럽다/Adjective,711,238,473,0.00266755585195065,0.0052755503231968716,0.6652601969057665
314,480,OOO/Alpha,708,91,617,0.001033677892630877,0.006874875052755503,0.8714689265536724
315,481,결국/Adverb,708,253,455,0.0028342780926975657,0.005075634732002044,0.6426553672316384
316,482,지루함/Noun,707,100,607,0.0011337112370790265,0.006763810835425043,0.8585572842998586
317,483,추억/Noun,707,576,131,0.006424363676781149,0.0014771540904951245,0.8147100424328148
318,484,나쁘다/Adjective,707,269,438,0.003012115149494276,0.004886825562540261,0.6195190947666195
319,486,소리/Noun,705,202,503,0.0022674224741580525,0.005608742975188254,0.7134751773049646
320,487,니/Josa,705,294,411,0.0032899855507391353,0.004586952175748018,0.5829787234042553
321,489,이딴/Modifier,703,26,677,0.00031121484939424253,0.007541260356738266,0.9630156472261736
322,490,더럽다/Adjective,701,81,620,0.0009225297321329332,0.00690819431795464,0.8844507845934381
323,493,마다/Josa,694,480,214,0.005357341336000889,0.0023989870943379463,0.69164265129683
324,494,살/Noun,690,420,270,0.004690452373013226,0.003020946711388525,0.6086956521739131
325,495,인상/Noun,689,547,142,0.006102034011337114,0.0015993247295586306,0.7939042089985486
326,496,이지만/Josa,687,427,260,0.0047682560853617864,0.0029098824940580643,0.6215429403202329
327,497,어이없다/Adjective,686,55,631,0.0006335445148382794,0.007030364957018148,0.9198250728862972
328,498,오늘/Noun,685,462,223,0.005157274647104589,0.002498944889935361,0.6744525547445256
329,499,감정/Noun,684,445,239,0.004968322774258086,0.0026766476376640968,0.6505847953216374
330,501,부족하다/Adjective,681,215,466,0.00241191508280538,0.0051978053710655505,0.6842878120411159
331,503,전/Modifier,680,199,481,0.0022340780260086696,0.005364401697061241,0.7073529411764706
332,504,정신/Noun,678,183,495,0.0020562409692119594,0.0055198916013238855,0.7300884955752213
333,505,엔딩/Noun,678,431,247,0.004812715349560965,0.002765499011528466,0.6356932153392331
334,507,접/Noun,676,122,554,0.0013782371901745027,0.006175170483573602,0.8195266272189349
335,509,잊다/Verb,674,570,104,0.0063576747804823825,0.001177280703702881,0.8456973293768546
336,510,졸작/Noun,672,34,638,0.0004001333777925976,0.007108109909149471,0.949404761904762
337,511,제발/Noun,671,179,492,0.002011781705012782,0.005486572336124747,0.7332339791356185
338,512,자신/Noun,671,422,249,0.004712682005112816,0.002787711854994558,0.6289120715350224
339,514,아무리/Adverb,666,114,552,0.0012893186617761474,0.00615295764010751,0.8288288288288288
340,515,그저/Adverb,666,221,445,0.002478603979104145,0.004964570514671583,0.6681681681681682
341,517,♥/Foreign,660,651,9,0.007257974880515727,0.00012217063906350652,0.9863636363636364
342,519,킬링타임/Noun,659,186,473,0.0020895854173613427,0.0052755503231968716,0.7177541729893778
343,520,~~~/Punctuation,657,400,257,0.004468156052017339,0.002876563228858926,0.60882800608828
344,521,함께/Adverb,656,544,112,0.0060686895631877295,0.0012661320775672494,0.8292682926829268
345,522,그렇게/Adverb,656,251,405,0.002812048460597977,0.00452031364534974,0.6173780487804879
346,525,캐스팅/Noun,653,219,434,0.002456374347004557,0.0048423998756080755,0.664624808575804
347,526,8/Number,653,388,265,0.004334778259419807,0.0029654146027232944,0.5941807044410413
348,527,대해/Noun,651,506,145,0.005646326553295543,0.001632643994757769,0.7772657450076805
349,529,어색하다/Adjective,642,123,519,0.001389352006224297,0.0057864457229169905,0.8084112149532711
350,530,포스터/Noun,642,205,437,0.002300766922307436,0.0048757191408072146,0.6806853582554517
351,531,적다/Verb,641,432,209,0.00482383016561076,0.002343454985672716,0.6739469578783152
352,532,몰입도/Noun,638,412,226,0.004601533844614872,0.0025322641551344988,0.64576802507837
353,534,엉/Exclamation,636,103,533,0.0011670556852284096,0.005941935627179635,0.8380503144654088
354,535,쓸다/Verb,636,162,474,0.0018228298321662773,0.005286656744929919,0.7452830188679245
355,536,자/Suffix,632,213,419,0.002389685450705791,0.004675803549612386,0.6629746835443038
356,537,갈수록/Noun,631,192,439,0.002156274313660109,0.004897931984273306,0.6957210776545166
357,538,스릴/Noun,631,370,261,0.004134711570523508,0.0029209889157911107,0.5863708399366085
358,539,개연/Noun,630,55,575,0.0006335445148382794,0.00640840533996757,0.9126984126984128
359,540,망하다/Adjective,630,89,541,0.0010114482605312882,0.0060307870010440036,0.8587301587301587
360,541,애니메이션/Noun,630,418,212,0.004668222740913638,0.002376774250871854,0.6634920634920635
361,543,배경/Noun,625,369,256,0.004123596754473714,0.00286545680712588,0.5904
362,546,!!!!/Punctuation,622,460,162,0.005135045015005002,0.001821453164219552,0.7395498392282959
363,549,문제/Noun,619,201,418,0.002256307658108259,0.00466469712787934,0.6752827140549273
364,550,진부하다/Adjective,618,109,509,0.0012337445815271755,0.005675381505586529,0.8236245954692557
365,552,이름/Noun,617,239,378,0.002678670668000445,0.004220440258557497,0.6126418152350082
366,553,지/Modifier,617,246,371,0.002756474380349005,0.004142695306426175,0.6012965964343598
367,554,하/Exclamation,614,213,401,0.002389685450705791,0.004475887958417557,0.6530944625407166
368,555,ㅠㅠㅠ/KoreanParticle,611,496,115,0.005535178392797599,0.0012994513427663874,0.8117839607201309
369,557,나가다/Verb,610,191,419,0.0021451594976103147,0.004675803549612386,0.6868852459016394
370,558,충격/Noun,610,399,211,0.004457041235967545,0.0023656678291388076,0.6540983606557377
371,559,비다/Verb,610,253,357,0.0028342780926975657,0.003987205402163531,0.5852459016393443
372,560,맘/Noun,609,373,236,0.00416805601867289,0.0026433283724649594,0.6124794745484401
373,562,유쾌하다/Adjective,603,554,49,0.006179837723685673,0.0005664275083853486,0.9187396351575456
374,563,머리/Noun,603,235,368,0.002634211403801267,0.004109376041227037,0.6102819237147595
375,565,보단/Josa,600,239,361,0.002678670668000445,0.004031631089095715,0.6016666666666667
376,566,완벽하다/Adjective,599,512,87,0.00571301544959431,0.0009884715342410985,0.8547579298831386
377,567,질/Noun,599,104,495,0.001178170501278204,0.0055198916013238855,0.8263772954924875
378,574,놀라다/Verb,594,366,228,0.00409025230632433,0.002554476998600591,0.6161616161616161
379,575,적/Noun,593,406,187,0.004534844948316105,0.002099113707545703,0.684654300168634
380,578,강추/Noun,590,547,43,0.006102034011337114,0.0004997889779870722,0.9271186440677966
381,579,행복하다/Adjective,590,524,66,0.0058463932421918404,0.0007552366778471312,0.8881355932203391
382,580,얘기/Noun,590,217,373,0.0024341447149049678,0.004164908149892268,0.6322033898305085
383,581,대/Foreign,587,217,370,0.0024341447149049678,0.00413158888469313,0.6303236797274276
384,583,장르/Noun,583,201,382,0.002256307658108259,0.004264865945489682,0.6552315608919382
385,585,더빙/Noun,582,150,432,0.0016894520395687453,0.004820187032141985,0.7422680412371134
386,588,어디/Noun,579,237,342,0.002656441035900856,0.00382060907616784,0.5906735751295337
387,589,주연/Noun,577,225,352,0.0025230632433033235,0.0039316732934983,0.6100519930675911
388,590,얼굴/Noun,576,199,377,0.0022340780260086696,0.004209333836824453,0.6545138888888888
389,593,즐겁다/Adjective,573,495,78,0.005524063576747805,0.0008885137386436838,0.8638743455497382
390,594,들이다/Verb,573,233,340,0.0026119817717016785,0.0037983962327017475,0.5933682373472949
391,596,웃기/Noun,571,344,227,0.003845726353228854,0.0025433705768675447,0.6024518388791593
392,597,머/Noun,570,97,473,0.0011003667889296432,0.0052755503231968716,0.8298245614035088
393,599,비/Noun,563,225,338,0.0025230632433033235,0.003776183389235656,0.6003552397868561
394,600,여기/Noun,563,228,335,0.002556407691452707,0.003742864124036518,0.5950266429840142
395,601,꽤/Noun,562,441,121,0.00492386351005891,0.001366089873164664,0.7846975088967971
396,603,짜증/Noun,558,23,535,0.00027787040124485944,0.005964148470645727,0.9587813620071683
397,604,9/Number,557,382,175,0.00426808936312104,0.00196583664674915,0.6858168761220825
398,605,매우/Noun,557,343,214,0.0038346115371790603,0.0023989870943379463,0.6157989228007181
399,606,ㅡ/KoreanParticle,556,157,399,0.0017672557519173055,0.004453675114951465,0.7176258992805755
400,607,날/Noun,556,337,219,0.003767922640880293,0.0024545192030031764,0.6061151079136691
401,608,ㅎㅎㅎ/KoreanParticle,555,434,121,0.004846059797710348,0.001366089873164664,0.781981981981982
402,610,너무나/Adverb,552,365,187,0.004079137490274536,0.002099113707545703,0.6612318840579711
403,611,이리/Adverb,552,199,353,0.0022340780260086696,0.003942779715231347,0.6394927536231884
404,612,진/Noun,552,216,336,0.002423029898855174,0.0037539705457695642,0.6086956521739131
405,614,???/Punctuation,551,142,409,0.0016005335111703902,0.004564739332281925,0.7422867513611615
406,615,두/Noun,551,362,189,0.004045793042125153,0.002121326551011795,0.6569872958257713
407,617,새롭다/Adjective,549,377,172,0.004212515282872069,0.0019325173815500122,0.6867030965391621
408,618,전쟁/Noun,549,326,223,0.0036456596643325546,0.002498944889935361,0.5938069216757741
409,619,건가/Noun,546,124,422,0.0014004668222740914,0.004709122814811524,0.7728937728937729
410,620,아직/Adverb,546,363,183,0.004056907858174947,0.0020546880206135185,0.6648351648351648
411,621,생기다/Verb,545,190,355,0.00213404468156052,0.003964992558697439,0.6513761467889908
412,624,멀다/Adjective,544,178,366,0.0020006668889629878,0.004087163197760945,0.6727941176470589
413,625,작/Modifier,544,183,361,0.0020562409692119594,0.004031631089095715,0.6636029411764706
414,626,소름/Noun,540,437,103,0.004879404245859731,0.001166174281969835,0.8092592592592592
415,627,심하다/Adjective,539,81,458,0.0009225297321329332,0.005108953997201182,0.8497217068645642
416,628,충분하다/Adjective,539,414,125,0.004623763476714461,0.001410515560096848,0.7680890538033395
417,629,불쌍하다/Adjective,539,206,333,0.0023118817383572304,0.0037206512805704256,0.6178107606679035
418,630,글/Noun,538,195,343,0.002189618761809492,0.0038317154979008857,0.6375464684014871
419,631,식/Suffix,534,210,324,0.002356341002556408,0.003620693484973011,0.6067415730337079
420,632,걸작/Noun,533,459,74,0.005123930198955207,0.0008440880517114996,0.8611632270168855
421,633,그나마/Adverb,532,40,492,0.0004668222740913638,0.005486572336124747,0.924812030075188
422,634,억지/Noun,527,72,455,0.0008224963876847838,0.005075634732002044,0.8633776091081594
423,635,대체/Noun,527,89,438,0.0010114482605312882,0.004886825562540261,0.8311195445920304
424,638,시절/Noun,526,397,129,0.004434811603867956,0.0014549412470290322,0.7547528517110266
425,640,존나/Noun,525,122,403,0.0013782371901745027,0.004498100801883649,0.7676190476190476
426,641,약간/Noun,525,357,168,0.003990218961876181,0.001888091694617828,0.68
427,642,역사/Noun,525,318,207,0.0035567411359342,0.002321242142206624,0.6057142857142858
428,643,궁금하다/Adjective,524,199,325,0.0022340780260086696,0.003631799906706057,0.6202290076335878
429,644,분들/Suffix,524,307,217,0.0034344781593864623,0.0024323063595370845,0.5858778625954199
430,646,실화/Noun,522,331,191,0.0037012337445815275,0.0021435393944778877,0.6340996168582376
431,650,해도/Noun,520,170,350,0.0019117483605646328,0.003909460450032209,0.6730769230769231
432,651,아무/Modifier,518,169,349,0.0019006335445148387,0.0038983540282991626,0.6737451737451737
433,654,B/Alpha,514,133,381,0.001500500166722241,0.004253759523756636,0.7412451361867705
434,655,한마디/Noun,514,156,358,0.0017561409358675113,0.003998311823896578,0.6964980544747081
435,659,순수하다/Adjective,506,433,73,0.004834944981660554,0.0008329816299784535,0.8557312252964426
436,660,휴/Exclamation,506,86,420,0.0009781038123819054,0.004686909971345432,0.8300395256916996
437,661,자기/Noun,506,160,346,0.001800600200066689,0.0038650347631000244,0.6837944664031621
438,662,누가/Noun,504,180,324,0.0020228965210625765,0.003620693484973011,0.6428571428571429
439,663,급/Suffix,504,211,293,0.002367455818606202,0.003276394411248584,0.5813492063492064
440,665,상당하다/Adjective,503,306,197,0.003423363343336668,0.0022101779248761637,0.6083499005964215
441,670,만점/Noun,501,423,78,0.00472379682116261,0.0008885137386436838,0.844311377245509
442,671,초딩/Noun,501,192,309,0.002156274313660109,0.003454097158977321,0.6167664670658682
443,675,간만/Noun,496,400,96,0.004468156052017339,0.0010884293298385123,0.8064516129032258
444,679,필요하다/Adjective,494,325,169,0.003634544848282761,0.0018991981163508738,0.6578947368421053
445,681,만나다/Verb,491,299,192,0.003345559630988107,0.0021546458162109328,0.6089613034623218
446,682,자/Noun,489,199,290,0.0022340780260086696,0.0032430751460494453,0.5930470347648262
447,683,라도/Josa,488,145,343,0.0016338779593197733,0.0038317154979008857,0.7028688524590164
448,684,~!/Punctuation,487,385,102,0.0043014338112704244,0.001155067860236789,0.7905544147843943
449,685,CG/Alpha,487,126,361,0.0014226964543736804,0.004031631089095715,0.7412731006160165
450,686,굉장하다/Adjective,486,338,148,0.0037790374569300882,0.001665963259956907,0.6954732510288066
451,687,전체/Noun,486,158,328,0.0017783705679671,0.003665119171905196,0.6748971193415638
452,690,뿐/Suffix,482,150,332,0.0016894520395687453,0.0037095448588373796,0.6887966804979253
453,691,감성/Noun,482,311,171,0.0034789374235856397,0.0019214109598169665,0.6452282157676349
454,692,다음/Noun,482,299,183,0.003345559630988107,0.0020546880206135185,0.6203319502074689
455,693,사회/Noun,481,337,144,0.003767922640880293,0.0016215375730247227,0.7006237006237006
456,694,오/Modifier,481,187,294,0.0021007002334111373,0.00328750083298163,0.6112266112266113
457,695,네이버/Noun,480,179,301,0.002011781705012782,0.0033652457851129523,0.6270833333333333
458,697,발연기/Noun,477,34,443,0.0004001333777925976,0.004942357671205491,0.9287211740041929
459,698,무슨/Modifier,476,124,352,0.0014004668222740914,0.0039316732934983,0.7394957983193278
460,699,그런/Modifier,475,189,286,0.002122929865510726,0.003198649459117261,0.6021052631578947
461,700,ㅜ/KoreanParticle,474,275,199,0.003078804045793042,0.002232390768342256,0.5801687763713079
462,701,당하다/Adjective,473,184,289,0.002067355785261754,0.0032319687243164,0.6109936575052854
463,704,따르다/Verb,470,174,296,0.0019562076247638107,0.0033097136764477218,0.6297872340425532
464,707,ㅉㅉ/KoreanParticle,466,72,394,0.0008224963876847838,0.004398143006286235,0.8454935622317596
465,708,이르다/Verb,466,177,289,0.001989552072913193,0.0032319687243164,0.6201716738197425
466,710,꿈/Noun,465,353,112,0.003945759697677003,0.0012661320775672494,0.7591397849462366
467,711,돌리다/Verb,463,161,302,0.0018117150161164836,0.0033763522068459982,0.652267818574514
468,712,주제/Noun,463,191,272,0.0021451594976103147,0.0030431595548546173,0.5874730021598272
469,714,에요/Josa,461,357,104,0.003990218961876181,0.001177280703702881,0.7744034707158352
470,715,나이/Noun,460,314,146,0.0035122818717350226,0.001643750416490815,0.6826086956521739
471,718,이/Foreign,458,326,132,0.0036456596643325546,0.0014882605122281704,0.7117903930131004
472,719,터지다/Verb,458,267,191,0.0029898855173946877,0.0021435393944778877,0.5829694323144105
473,722,;;;/Punctuation,457,106,351,0.0012004001333777929,0.003920566871765255,0.7680525164113785
474,723,사랑스럽다/Adjective,456,433,23,0.004834944981660554,0.00027766054332615115,0.949561403508772
475,724,돋다/Verb,454,348,106,0.003890185617428032,0.0011994935471689732,0.7665198237885462
476,725,교훈/Noun,454,274,180,0.003067689229743248,0.0020213687554143807,0.6035242290748899
477,726,엄청나다/Adjective,453,290,163,0.003245526286539958,0.0018325595859525977,0.6401766004415012
478,728,소설/Noun,449,173,276,0.001945092808714016,0.003087585241786801,0.6146993318485523
479,730,이라도/Josa,446,106,340,0.0012004001333777929,0.0037983962327017475,0.7623318385650224
480,732,감사하다/Verb,445,404,41,0.004512615316216518,0.00047757613452098,0.907865168539326
481,733,바라다/Verb,444,271,173,0.0030343447815938647,0.0019436238032830586,0.6103603603603603
482,734,힘/Noun,443,266,177,0.002978770701344893,0.0019880494902152425,0.6004514672686229
483,736,시즌/Noun,442,315,127,0.003523396687784817,0.00143272840356294,0.7126696832579186
484,738,너/Noun,438,183,255,0.0020562409692119594,0.0028543503853928343,0.5821917808219178
485,741,방송/Noun,436,131,305,0.001478270534622652,0.0034096714720451365,0.6995412844036697
486,742,지나다/Verb,435,309,126,0.003456707791486051,0.001421621981829894,0.7103448275862069
487,743,모든/Modifier,434,259,175,0.002900966988996332,0.00196583664674915,0.5967741935483871
488,744,존재/Noun,434,257,177,0.0028787373568967428,0.0019880494902152425,0.5921658986175116
489,746,삼류/Noun,433,33,400,0.00038901856174280313,0.004464781536684511,0.9237875288683602
490,747,몇번/Noun,431,334,97,0.0037345781927309103,0.0010995357515715587,0.7749419953596288
491,748,진정하다/Adjective,431,313,118,0.0035011670556852285,0.0013327706079655256,0.7262180974477959
492,751,독특하다/Adjective,429,293,136,0.003278870734689341,0.0015326861991603546,0.6829836829836831
493,752,잡다/Verb,429,149,280,0.0016783372235189508,0.003132010928718985,0.6526806526806527
494,753,죽/Noun,428,138,290,0.0015560742469712125,0.0032430751460494453,0.677570093457944
495,754,....../Punctuation,427,155,272,0.001745026119817717,0.0030431595548546173,0.6370023419203747
496,756,+/Punctuation,426,174,252,0.0019562076247638107,0.002821031120193696,0.5915492957746479
497,758,여주/Noun,424,130,294,0.0014671557185728574,0.00328750083298163,0.6933962264150944
498,759,담다/Verb,424,278,146,0.003112148493942425,0.001643750416490815,0.6556603773584906
499,760,가볍다/Adjective,423,287,136,0.0032121818383905746,0.0015326861991603546,0.6784869976359338
500,762,질질/Noun,419,72,347,0.0008224963876847838,0.0038761411848330703,0.8281622911694511
501,763,전부/Noun,418,133,285,0.001500500166722241,0.003187543037384216,0.6818181818181818
502,764,바/Noun,418,165,253,0.001856174280315661,0.0028321375419267424,0.6052631578947368
503,765,줄거리/Noun,417,136,281,0.0015338446148716238,0.0031431173504520315,0.6738609112709832
504,770,점주/Noun,415,98,317,0.0011114816049794377,0.003542948532841689,0.763855421686747
505,771,실제/Noun,415,250,165,0.002800933644548183,0.0018547724294186894,0.6024096385542169
506,773,망치다/Verb,414,42,372,0.0004890519061909527,0.004153801728159222,0.8985507246376812
507,774,답/Noun,413,100,313,0.0011337112370790265,0.003498522845909505,0.7578692493946732
508,775,넘치다/Adjective,412,298,114,0.003334444814938313,0.0012883449210333415,0.7233009708737864
509,777,성하다/Adjective,410,37,373,0.0004334778259419807,0.004164908149892268,0.9097560975609756
510,779,낭비/Noun,408,8,400,0.00011114816049794375,0.004464781536684511,0.9803921568627452
511,780,뜨다/Verb,408,147,261,0.0016561075914193618,0.0029209889157911107,0.6397058823529411
512,781,으로도/Josa,408,240,168,0.0026897854840502392,0.001888091694617828,0.5882352941176471
513,783,각본/Noun,407,121,286,0.0013671223741247086,0.003198649459117261,0.7027027027027027
514,785,맞추다/Verb,404,109,295,0.0012337445815271755,0.0032986072547146763,0.7301980198019802
515,786,재/Noun,401,255,146,0.002856507724797155,0.001643750416490815,0.6359102244389028
516,789,성룡/Noun,398,235,163,0.002634211403801267,0.0018325595859525977,0.5904522613065326
517,791,순간/Noun,397,263,134,0.0029454262531955103,0.0015104733556942625,0.6624685138539043
518,792,어른/Noun,397,249,148,0.0027898188284983887,0.001665963259956907,0.6272040302267002
519,793,평론가/Noun,397,239,158,0.002678670668000445,0.0017770274772873676,0.6020151133501259
520,794,갑자기/Noun,396,103,293,0.0011670556852284096,0.003276394411248584,0.73989898989899
521,795,제작/Noun,396,143,253,0.0016116483272201846,0.0028321375419267424,0.6388888888888888
522,797,이하/Noun,395,34,361,0.0004001333777925976,0.004031631089095715,0.9139240506329114
523,800,기다리다/Verb,392,279,113,0.00312326330999222,0.0012772384993002955,0.7117346938775511
524,801,간다/Noun,392,151,241,0.0017005668556185395,0.002698860481130189,0.6147959183673469
525,802,너무하다/Adjective,390,50,340,0.0005779704345893076,0.0037983962327017475,0.8717948717948718
526,803,의도/Noun,390,66,324,0.0007558074913860174,0.003620693484973011,0.8307692307692308
527,804,발/Noun,390,81,309,0.0009225297321329332,0.003454097158977321,0.7923076923076923
528,805,영/Noun,390,107,283,0.001211514949427587,0.0031653301939181234,0.7256410256410256
529,807,밑/Noun,388,119,269,0.0013448927420251196,0.0030098402896554786,0.6932989690721649
530,808,TV/Alpha,388,158,230,0.0017783705679671,0.002576689842066683,0.5927835051546392
531,809,땜/Noun,387,126,261,0.0014226964543736804,0.0029209889157911107,0.6744186046511628
532,810,넣다/Verb,385,86,299,0.0009781038123819054,0.00334303294164686,0.7766233766233767
533,811,아버지/Noun,385,261,124,0.002923196621095921,0.0013994091383638019,0.6779220779220779
534,815,오글거리다/Verb,384,63,321,0.0007224630432366343,0.0035873742197738727,0.8359375
535,816,보내다/Verb,384,257,127,0.0028787373568967428,0.00143272840356294,0.6692708333333334
536,817,만들어지다/Verb,384,249,135,0.0027898188284983887,0.0015215797774273086,0.6484375
537,818,한편/Noun,384,232,152,0.002600866955651884,0.0017103889468890912,0.6041666666666666
538,819,피/Noun,384,156,228,0.0017561409358675113,0.002554476998600591,0.59375
539,821,굳다/Adjective,381,349,32,0.0039013004334778256,0.0003776183389235656,0.9160104986876642
540,824,볼때/Noun,380,276,104,0.0030899188618428363,0.001177280703702881,0.7263157894736842
541,825,바꾸다/Verb,379,143,236,0.0016116483272201846,0.0026433283724649594,0.6226912928759895
542,826,들어가다/Verb,379,156,223,0.0017561409358675113,0.002498944889935361,0.5883905013192612
543,830,10년/Number,376,276,100,0.0030899188618428363,0.0011328550167706971,0.7340425531914894
544,831,세계/Noun,376,224,152,0.002511948427253529,0.0017103889468890912,0.5957446808510638
545,834,첨/Adverb,374,111,263,0.0012559742136267645,0.002943201759257202,0.7032085561497327
546,835,막/Noun,373,133,240,0.001500500166722241,0.002687754059397144,0.6434316353887399
547,839,그때/Noun,371,269,102,0.003012115149494276,0.001155067860236789,0.7250673854447439
548,840,항상/Noun,371,247,124,0.0027675891963988,0.0013994091383638019,0.6657681940700808
549,842,좀비/Noun,370,127,243,0.0014338112704234743,0.0027210733245962818,0.6567567567567567
550,844,치고/Josa,368,112,256,0.0012670890296765588,0.00286545680712588,0.6956521739130435
551,846,뻔/Noun,367,98,269,0.0011114816049794377,0.0030098402896554786,0.7329700272479565
552,849,거지/Noun,366,99,267,0.001122596421029232,0.002987627446189387,0.7295081967213115
553,850,곳/Noun,365,245,120,0.002745359564299211,0.0013549834514316175,0.6712328767123288
554,855,짱/Suffix,361,320,41,0.0035789707680337892,0.00047757613452098,0.8864265927977839
555,856,성/Modifier,361,130,231,0.0014671557185728574,0.002587796263799729,0.6398891966759003
556,857,진행/Noun,360,97,263,0.0011003667889296432,0.002943201759257202,0.7305555555555555
557,862,이에요/Josa,358,286,72,0.0032010670223407804,0.0008218752082454075,0.7988826815642458
558,863,더욱/Noun,358,281,77,0.0031454929420918084,0.0008774073169106378,0.7849162011173184
559,864,tv/Alpha,358,103,255,0.0011670556852284096,0.0028543503853928343,0.7122905027932961
560,865,낫다/Noun,358,124,234,0.0014004668222740914,0.002621115528998867,0.6536312849162011
561,866,탄탄하다/Adjective,357,320,37,0.0035789707680337892,0.0004331504475887958,0.8963585434173671
562,867,돋보이다/Verb,357,275,82,0.003078804045793042,0.000932939425575868,0.7703081232492998
563,868,초/Noun,357,148,209,0.0016672224074691564,0.002343454985672716,0.5854341736694678
564,870,어이/Noun,355,29,326,0.0003445592975436257,0.003642906328439104,0.9183098591549296
565,871,상미/Noun,355,237,118,0.002656441035900856,0.0013327706079655256,0.6676056338028169
566,872,래/Josa,355,138,217,0.0015560742469712125,0.0024323063595370845,0.6112676056338028
567,874,참고/Noun,354,65,289,0.0007446926753362233,0.0032319687243164,0.8163841807909604
568,875,불편하다/Adjective,354,99,255,0.001122596421029232,0.0028543503853928343,0.7203389830508474
569,876,중국/Noun,354,122,232,0.0013782371901745027,0.002598902685532775,0.655367231638418
570,877,완성/Noun,354,212,142,0.002378570634655997,0.0015993247295586306,0.5988700564971752
571,879,몇/Noun,353,222,131,0.00248971879515394,0.0014771540904951245,0.6288951841359773
572,880,흐르다/Verb,352,282,70,0.003156607758141603,0.0007996623647793153,0.8011363636363636
573,881,그녀/Noun,352,266,86,0.002978770701344893,0.000977365112508052,0.7556818181818182
574,882,억지스럽다/Adjective,351,50,301,0.0005779704345893076,0.0033652457851129523,0.8575498575498576
575,883,걸리다/Verb,351,96,255,0.0010892519728798488,0.0028543503853928343,0.7264957264957265
576,884,끼다/Verb,351,101,250,0.0011448260531288204,0.0027988182767276037,0.7122507122507122
577,886,즐기다/Verb,350,239,111,0.002678670668000445,0.0012550256558342032,0.6828571428571428
578,890,거기/Noun,348,120,228,0.0013560075580749138,0.002554476998600591,0.6551724137931034
579,892,점점/Noun,347,138,209,0.0015560742469712125,0.002343454985672716,0.6023054755043228
580,894,이냐/Josa,345,47,298,0.0005446259864399244,0.003331926519913814,0.8637681159420291
581,896,허무하다/Adjective,344,85,259,0.0009669889963321108,0.0028987760723250184,0.7529069767441859
582,897,어디서/Adverb,343,123,220,0.001389352006224297,0.0024656256247362228,0.641399416909621
583,899,술/Noun,342,58,284,0.0006668889629876625,0.0031764366156511693,0.8304093567251462
584,900,전형/Noun,342,64,278,0.0007335778592864287,0.003109798085252893,0.8128654970760234
585,901,똑같다/Adjective,341,86,255,0.0009781038123819054,0.0028543503853928343,0.7478005865102639
586,902,편집/Noun,340,103,237,0.0011670556852284096,0.002654434794198005,0.6970588235294117
587,904,잠/Noun,339,82,257,0.0009336445481827276,0.002876563228858926,0.7581120943952803
588,906,사건/Noun,337,130,207,0.0014671557185728574,0.002321242142206624,0.6142433234421365
589,907,쯤/Suffix,336,199,137,0.0022340780260086696,0.0015437926208934005,0.5922619047619048
590,908,화보/Noun,335,124,211,0.0014004668222740914,0.0023656678291388076,0.6298507462686567
591,910,화이팅/Noun,334,296,38,0.0033122151828387236,0.0004442568693218419,0.8862275449101796
592,911,때리다/Verb,334,116,218,0.0013115482938757365,0.0024434127812701305,0.6526946107784432
593,912,짧다/Adjective,334,217,117,0.0024341447149049678,0.0013216641862324795,0.6497005988023952
594,915,식상하다/Adjective,333,37,296,0.0004334778259419807,0.0033097136764477218,0.8888888888888888
595,916,마르다/Adjective,333,116,217,0.0013115482938757365,0.0024323063595370845,0.6516516516516516
596,921,꿀잼/Noun,330,316,14,0.0035345115038346118,0.00017770274772873674,0.9575757575757576
597,922,똥/Noun,330,29,301,0.0003445592975436257,0.0033652457851129523,0.912121212121212
598,923,그게/Noun,330,91,239,0.001033677892630877,0.0026766476376640968,0.7242424242424242
599,926,가지다/Verb,329,198,131,0.002222963209958875,0.0014771540904951245,0.6018237082066871
600,928,중반/Noun,328,125,203,0.0014115816383238858,0.0022768164552744398,0.6189024390243902
601,929,취향/Noun,328,127,201,0.0014338112704234743,0.0022546036118083475,0.6128048780487805
602,931,-_-/Punctuation,327,38,289,0.000444592641991775,0.0032319687243164,0.8837920489296636
603,932,개그/Noun,327,99,228,0.001122596421029232,0.002554476998600591,0.6972477064220184
604,933,싸우다/Verb,327,124,203,0.0014004668222740914,0.0022768164552744398,0.6207951070336392
605,938,엉망/Noun,326,22,304,0.000266755585195065,0.0033985650503120905,0.9325153374233128
606,939,병맛/Noun,326,57,269,0.0006557741469378681,0.0030098402896554786,0.8251533742331288
607,940,티/Noun,325,91,234,0.001033677892630877,0.002621115528998867,0.72
608,941,적당하다/Adjective,325,106,219,0.0012004001333777929,0.0024545192030031764,0.6738461538461539
609,942,복수/Noun,325,128,197,0.0014449260864732687,0.0022101779248761637,0.6061538461538462
610,944,뛰어나다/Adjective,324,238,86,0.00266755585195065,0.000977365112508052,0.7345679012345679
611,945,관/Noun,324,221,103,0.002478603979104145,0.001166174281969835,0.6820987654320988
612,946,걸다/Verb,324,116,208,0.0013115482938757365,0.00233234856393967,0.6419753086419753
613,947,ㄷㄷ/KoreanParticle,324,200,124,0.002245192842058464,0.0013994091383638019,0.6172839506172839
614,948,액션영화/Noun,324,192,132,0.002156274313660109,0.0014882605122281704,0.5925925925925926
615,951,지겹다/Adjective,323,29,294,0.0003445592975436257,0.00328750083298163,0.9102167182662538
616,952,미화/Noun,323,44,279,0.0005112815382905413,0.003120904506985939,0.8637770897832817
617,953,~!!/Punctuation,323,253,70,0.0028342780926975657,0.0007996623647793153,0.7832817337461301
618,954,흥미/Noun,323,125,198,0.0014115816383238858,0.002221284346609209,0.6130030959752322
619,955,//Punctuation,323,130,193,0.0014671557185728574,0.0021657522379439787,0.5975232198142415
620,958,헐다/Verb,322,92,230,0.0010447927086806713,0.002576689842066683,0.7142857142857143
621,959,몸/Noun,322,132,190,0.0014893853506724466,0.002132432972744841,0.5900621118012422
622,962,흥미진진/Noun,321,276,45,0.0030899188618428363,0.0005220018214531642,0.8598130841121495
623,967,훈훈하다/Adjective,319,281,38,0.0031454929420918084,0.0004442568693218419,0.8808777429467085
624,968,여서/Josa,319,132,187,0.0014893853506724466,0.002099113707545703,0.5862068965517241
625,969,잘만/Noun,318,239,79,0.002678670668000445,0.0008996201603767299,0.7515723270440252
626,970,에겐/Josa,317,194,123,0.0021785039457596976,0.0013883027166307562,0.61198738170347
627,971,노력/Noun,317,132,185,0.0014893853506724466,0.002076900864079611,0.583596214511041
628,972,만으로도/Josa,316,285,31,0.003189952206290986,0.00036651191719051963,0.9018987341772152
629,973,낫다/Verb,316,91,225,0.001033677892630877,0.0025211577334014533,0.7120253164556962
630,974,나르다/Verb,316,224,92,0.002511948427253529,0.0010440036429063284,0.7088607594936709
631,975,학교/Noun,316,192,124,0.002156274313660109,0.0013994091383638019,0.6075949367088608
632,976,비추다/Verb,315,48,267,0.0005557408024897189,0.002987627446189387,0.8476190476190476
633,977,괜히/Adverb,315,80,235,0.0009114149160831386,0.002632221950731913,0.7460317460317459
634,978,또한/Noun,315,208,107,0.002334111370456819,0.0012105999689020189,0.6603174603174603
635,979,과거/Noun,315,196,119,0.0022007335778592863,0.0013438770296985718,0.6222222222222222
636,982,그래픽/Noun,314,78,236,0.00088918528398355,0.0026433283724649594,0.7515923566878981
637,983,ost/Alpha,313,265,48,0.0029676558852950985,0.0005553210866523023,0.8466453674121406
638,984,그냥/Modifier,313,87,226,0.0009892186284316995,0.0025322641551344988,0.7220447284345048
639,985,이라니/Josa,313,116,197,0.0013115482938757365,0.0022101779248761637,0.6293929712460063
640,986,무/Noun,313,127,186,0.0014338112704234743,0.0020880072858126568,0.5942492012779552
641,987,그만/Adverb,312,21,291,0.00025564076914527065,0.003254181567782492,0.9326923076923076
642,988,장/Suffix,312,89,223,0.0010114482605312882,0.002498944889935361,0.7147435897435898
643,989,20/Number,312,211,101,0.002367455818606202,0.0011439614385037428,0.6762820512820513
644,990,바보/Noun,311,85,226,0.0009669889963321108,0.0025322641551344988,0.7266881028938906
645,991,성우/Noun,310,70,240,0.0008002667555851951,0.002687754059397144,0.7741935483870968
646,992,봣/Noun,308,207,101,0.0023229965544070245,0.0011439614385037428,0.6720779220779219
647,993,소중하다/Adjective,307,226,81,0.0025341780593531177,0.000921833003842822,0.7361563517915309
648,994,죽음/Noun,307,206,101,0.0023118817383572304,0.0011439614385037428,0.6710097719869706
649,995,대한민국/Noun,307,185,122,0.002078470601311548,0.0013771962948977098,0.6026058631921825
650,997,유치/Noun,306,21,285,0.00025564076914527065,0.003187543037384216,0.931372549019608
651,999,도저히/Noun,305,26,279,0.00031121484939424253,0.003120904506985939,0.9147540983606556
652,1000,한심하다/Adjective,305,33,272,0.00038901856174280313,0.0030431595548546173,0.8918032786885246
653,1001,식/Noun,305,72,233,0.0008224963876847838,0.002610009107265821,0.7639344262295082
654,1002,속편/Noun,305,99,206,0.001122596421029232,0.002310135720473578,0.6754098360655738
655,1006,역겹다/Adjective,304,37,267,0.0004334778259419807,0.002987627446189387,0.8782894736842105
656,1007,울/Noun,304,228,76,0.002556407691452707,0.0008663008951775916,0.75
657,1008,무조건/Noun,304,193,111,0.0021673891297099034,0.0012550256558342032,0.6348684210526315
658,1009,닿다/Verb,303,192,111,0.002156274313660109,0.0012550256558342032,0.6336633663366337
659,1010,전달/Noun,303,115,188,0.001300433477825942,0.0021102201292787486,0.6204620462046204
660,1011,땐/Noun,303,183,120,0.0020562409692119594,0.0013549834514316175,0.6039603960396039
661,1016,천재/Noun,301,236,65,0.002645326219851061,0.0007441302561140852,0.7840531561461794
662,1018,억지로/Noun,300,42,258,0.0004890519061909527,0.0028876696505919725,0.86
663,1019,우연히/Adverb,300,258,42,0.0028898521729465373,0.0004886825562540262,0.86
664,1020,심리/Noun,300,207,93,0.0023229965544070245,0.0010551100646393743,0.69
665,1021,화가/Noun,299,75,224,0.0008558408358341669,0.0025100513116684065,0.7491638795986622
666,1022,강하다/Adjective,299,187,112,0.0021007002334111373,0.0012661320775672494,0.6254180602006689
667,1023,댓글/Noun,297,75,222,0.0008558408358341669,0.0024878384682023146,0.7474747474747475
668,1024,자꾸/Noun,297,119,178,0.0013448927420251196,0.001999155911948289,0.5993265993265994
669,1026,속/Modifier,296,73,223,0.0008336112037345782,0.002498944889935361,0.7533783783783784
670,1027,아무/Noun,296,116,180,0.0013115482938757365,0.0020213687554143807,0.6081081081081081
671,1029,개다/Verb,295,73,222,0.0008336112037345782,0.0024878384682023146,0.7525423728813561
672,1030,새끼/Noun,295,80,215,0.0009114149160831386,0.0024100935160709922,0.7288135593220338
673,1031,척/Noun,294,58,236,0.0006668889629876625,0.0026433283724649594,0.8027210884353742
674,1032,예고편/Noun,294,69,225,0.0007891519395354007,0.0025211577334014533,0.7653061224489796
675,1033,다가/Noun,293,91,202,0.001033677892630877,0.0022657100335413943,0.6894197952218429
676,1034,최근/Noun,293,195,98,0.002189618761809492,0.0011106421733046046,0.6655290102389079
677,1038,현/Modifier,292,181,111,0.00203401133711237,0.0012550256558342032,0.6198630136986302
678,1039,good/Alpha,291,213,78,0.002389685450705791,0.0008885137386436838,0.7319587628865979
679,1040,어느/Modifier,291,104,187,0.001178170501278204,0.002099113707545703,0.6426116838487973
680,1042,잊혀지다/Verb,289,255,34,0.002856507724797155,0.00039983118238965764,0.8823529411764706
681,1043,불륜/Noun,289,75,214,0.0008558408358341669,0.0023989870943379463,0.740484429065744
682,1044,젠/Noun,289,80,209,0.0009114149160831386,0.002343454985672716,0.7231833910034602
683,1046,대작/Noun,288,231,57,0.0025897521396020893,0.0006552788822497168,0.8020833333333334
684,1047,짐/Noun,288,189,99,0.002122929865510726,0.0011217485950376508,0.65625
685,1048,다니다/Verb,288,105,183,0.0011892853173279985,0.0020546880206135185,0.6354166666666666
686,1053,미안하다/Adjective,287,74,213,0.0008447260197843727,0.0023878806726049,0.7421602787456446
687,1056,열/Noun,286,78,208,0.00088918528398355,0.00233234856393967,0.7272727272727273
688,1059,2시간/Number,285,95,190,0.0010781371568300542,0.002132432972744841,0.6666666666666666
689,1064,게임/Noun,284,97,187,0.0011003667889296432,0.002099113707545703,0.6584507042253521
690,1065,행동/Noun,284,103,181,0.0011670556852284096,0.0020324751771474267,0.6373239436619719
691,1068,실망하다/Adjective,283,60,223,0.0006891185950872514,0.002498944889935361,0.7879858657243817
692,1069,짓/Noun,283,70,213,0.0008002667555851951,0.0023878806726049,0.7526501766784452
693,1070,환상/Noun,283,207,76,0.0023229965544070245,0.0008663008951775916,0.7314487632508834
694,1071,여/Noun,283,178,105,0.0020006668889629878,0.001188387125435927,0.6289752650176679
695,1073,오래/Adverb,282,230,52,0.0025786373235522947,0.0005997467735844866,0.8156028368794326
696,1077,그닥/Noun,280,25,255,0.00030010003334444816,0.0028543503853928343,0.9107142857142856
697,1078,귀신/Noun,280,71,209,0.0008113815716349895,0.002343454985672716,0.7464285714285714
698,1079,전설/Noun,280,175,105,0.001967322440813605,0.001188387125435927,0.625
699,1080,입/Noun,280,115,165,0.001300433477825942,0.0018547724294186894,0.5892857142857143
700,1082,산/Noun,279,67,212,0.0007669223074358119,0.002376774250871854,0.7598566308243727
701,1083,총/Modifier,279,87,192,0.0009892186284316995,0.0021546458162109328,0.6881720430107527
702,1084,회/Noun,279,177,102,0.001989552072913193,0.001155067860236789,0.6344086021505376
703,1085,빠져들다/Verb,278,264,14,0.002956541069245304,0.00017770274772873674,0.9496402877697842
704,1086,흘리다/Verb,278,211,67,0.002367455818606202,0.0007663430995801773,0.7589928057553957
705,1087,전작/Noun,277,72,205,0.0008224963876847838,0.002299029298740532,0.740072202166065
706,1088,총/Noun,277,85,192,0.0009669889963321108,0.0021546458162109328,0.6931407942238267
707,1089,유머/Noun,277,161,116,0.0018117150161164836,0.0013105577644994335,0.5812274368231047
708,1090,♡/Foreign,276,264,12,0.002956541069245304,0.00015548990426264466,0.9565217391304348
709,1091,돌아가다/Verb,276,167,109,0.0018784039124152493,0.0012328128123681114,0.605072463768116
710,1092,현재/Noun,275,205,70,0.002300766922307436,0.0007996623647793153,0.7454545454545455
711,1093,극/Suffix,275,114,161,0.0012893186617761474,0.0018103467424865054,0.5854545454545454
712,1096,쩔다/Verb,274,216,58,0.002423029898855174,0.0006663853039827628,0.7883211678832117
713,1097,여전하다/Adjective,274,191,83,0.0021451594976103147,0.000944045847308914,0.6970802919708029
714,1098,울/Modifier,274,178,96,0.0020006668889629878,0.0010884293298385123,0.6496350364963503
715,1099,제작비/Noun,273,38,235,0.000444592641991775,0.002632221950731913,0.8608058608058609
716,1100,영원하다/Adjective,273,231,42,0.0025897521396020893,0.0004886825562540262,0.8461538461538461
717,1101,예요/Josa,273,206,67,0.0023118817383572304,0.0007663430995801773,0.7545787545787546
718,1102,스러운/Josa,273,89,184,0.0010114482605312882,0.002065794442346565,0.6739926739926739
719,1103,다행/Noun,273,104,169,0.001178170501278204,0.0018991981163508738,0.6190476190476191
720,1104,흠/Noun,272,105,167,0.0011892853173279985,0.0018769852728847821,0.6139705882352942
721,1106,통해/Noun,271,217,54,0.0024341447149049678,0.0006219596170505788,0.8007380073800738
722,1107,잘생기다/Adjective,271,198,73,0.002222963209958875,0.0008329816299784535,0.7306273062730627
723,1108,노/Noun,271,96,175,0.0010892519728798488,0.00196583664674915,0.6457564575645757
724,1109,주의/Noun,271,113,158,0.0012782038457263534,0.0017770274772873676,0.5830258302583026
725,1112,아쉬움/Noun,269,159,110,0.0017894853840168946,0.0012439192341011573,0.5910780669144982
726,1114,망작/Noun,268,16,252,0.0002000666888962988,0.002821031120193696,0.9402985074626866
727,1118,가끔/Noun,267,174,93,0.0019562076247638107,0.0010551100646393743,0.651685393258427
728,1119,만의/Josa,267,167,100,0.0018784039124152493,0.0011328550167706971,0.6254681647940075
729,1120,드럽다/Adjective,266,24,242,0.0002889852172946538,0.0027099669028632354,0.9097744360902256
730,1121,동화/Noun,266,189,77,0.002122929865510726,0.0008774073169106378,0.7105263157894737
731,1122,80년/Number,266,82,184,0.0009336445481827276,0.002065794442346565,0.6917293233082706
732,1123,:/Punctuation,266,106,160,0.0012004001333777929,0.0017992403207534593,0.6015037593984962
733,1124,사라지다/Verb,266,107,159,0.001211514949427587,0.0017881338990204136,0.5977443609022557
734,1127,100/Number,265,171,94,0.001922863176614427,0.0010662164863724202,0.6452830188679245
735,1128,묘사/Noun,265,170,95,0.0019117483605646328,0.0010773229081054666,0.6415094339622641
736,1130,예산/Noun,264,65,199,0.0007446926753362233,0.002232390768342256,0.7537878787878788
737,1131,으/Adverb,263,97,166,0.0011003667889296432,0.001865878851151736,0.6311787072243346
738,1132,여러/Modifier,263,165,98,0.001856174280315661,0.0011106421733046046,0.6273764258555133
739,1136,채널/Noun,262,82,180,0.0009336445481827276,0.0020213687554143807,0.6870229007633588
740,1137,살인/Noun,262,97,165,0.0011003667889296432,0.0018547724294186894,0.6297709923664122
741,1138,멍청하다/Adjective,260,38,222,0.000444592641991775,0.0024878384682023146,0.8538461538461538
742,1139,강/Noun,260,197,63,0.002211848393909081,0.0007219174126479931,0.7576923076923077
743,1140,인하다/Adjective,260,152,108,0.001711681671668334,0.0012217063906350652,0.5846153846153846
744,1144,특유/Noun,259,151,108,0.0017005668556185395,0.0012217063906350652,0.5830115830115831
745,1147,졸라/Noun,258,75,183,0.0008558408358341669,0.0020546880206135185,0.7093023255813954
746,1148,프로그램/Noun,258,102,156,0.0011559408691786152,0.0017548146338212756,0.6046511627906976
747,1150,개/Suffix,257,79,178,0.0009003001000333445,0.001999155911948289,0.6926070038910506
748,1157,외/Noun,256,70,186,0.0008002667555851951,0.0020880072858126568,0.7265625
749,1158,서로/Noun,256,161,95,0.0018117150161164836,0.0010773229081054666,0.62890625
750,1161,낚/Noun,254,20,234,0.00024452595309547634,0.002621115528998867,0.9212598425196852
751,1162,경찰/Noun,254,98,156,0.0011114816049794377,0.0017548146338212756,0.6141732283464567
752,1164,모/Noun,253,66,187,0.0007558074913860174,0.002099113707545703,0.7391304347826086
753,1165,프로/Noun,253,104,149,0.001178170501278204,0.0016770696816899534,0.5889328063241107
754,1167,끌다/Verb,252,68,184,0.0007780371234856063,0.002065794442346565,0.7301587301587301
755,1168,런가/Noun,252,97,155,0.0011003667889296432,0.0017437082120882294,0.6150793650793651
756,1169,반개/Noun,251,5,246,7.780371234856063e-05,0.00275439258979542,0.9800796812749004
757,1170,짱/VerbPrefix,251,225,26,0.0025230632433033235,0.00031097980852528933,0.896414342629482
758,1171,지루/Noun,250,21,229,0.00025564076914527065,0.002565583420333637,0.9159999999999999
759,1173,황당하다/Adjective,249,38,211,0.000444592641991775,0.0023656678291388076,0.8473895582329317
760,1176,약하다/Adjective,248,71,177,0.0008113815716349895,0.0019880494902152425,0.7137096774193549
761,1177,흔하다/Adjective,248,92,156,0.0010447927086806713,0.0017548146338212756,0.6290322580645161
762,1181,졸리다/Verb,247,27,220,0.00032232966544403684,0.0024656256247362228,0.8906882591093117
763,1182,용도/Noun,247,57,190,0.0006557741469378681,0.002132432972744841,0.7692307692307693
764,1183,희망/Noun,246,210,36,0.002356341002556408,0.0004220440258557498,0.8536585365853658
765,1186,위대하다/Adjective,245,185,60,0.002078470601311548,0.0006885981474488549,0.7551020408163265
766,1187,청춘/Noun,245,172,73,0.0019339779926642211,0.0008329816299784535,0.7020408163265306
767,1188,......./Punctuation,245,81,164,0.0009225297321329332,0.001843666007685644,0.6693877551020408
768,1189,다만/Noun,245,160,85,0.001800600200066689,0.0009662586907750061,0.6530612244897959
769,1190,상상력/Noun,245,158,87,0.0017783705679671,0.0009884715342410985,0.6448979591836734
770,1191,너무나도/Adverb,245,151,94,0.0017005668556185395,0.0010662164863724202,0.6163265306122448
771,1193,깊이/Noun,244,172,72,0.0019339779926642211,0.0008218752082454075,0.7049180327868853
772,1199,cg/Alpha,243,62,181,0.0007113482271868402,0.0020324751771474267,0.7448559670781894
773,1200,엇/VerbPrefix,243,144,99,0.001622763143269979,0.0011217485950376508,0.5925925925925926
774,1202,기세/Noun,242,7,235,0.0001000333444481494,0.002632221950731913,0.9710743801652892
775,1208,형님/Noun,241,155,86,0.001745026119817717,0.000977365112508052,0.6431535269709544
776,1209,깔다/Verb,241,91,150,0.001033677892630877,0.0016881761034229991,0.6224066390041494
777,1210,이며/Josa,241,142,99,0.0016005335111703902,0.0011217485950376508,0.5892116182572614
778,1211,다소/Noun,241,140,101,0.0015783038790708015,0.0011439614385037428,0.5809128630705395
779,1212,께/Josa,241,140,101,0.0015783038790708015,0.0011439614385037428,0.5809128630705395
780,1213,노출/Noun,240,57,183,0.0006557741469378681,0.0020546880206135185,0.7625
781,1214,다시다/Verb,240,72,168,0.0008224963876847838,0.001888091694617828,0.7
782,1215,카메라/Noun,240,73,167,0.0008336112037345782,0.0018769852728847821,0.6958333333333333
783,1216,살아가다/Verb,239,217,22,0.0024341447149049678,0.00026655412159310506,0.9079497907949792
784,1217,미래/Noun,239,164,75,0.0018450594642658664,0.0008551944734445456,0.6861924686192469
785,1220,쏘다/Verb,238,76,162,0.0008669556518839612,0.001821453164219552,0.6806722689075629
786,1221,체/Noun,238,92,146,0.0010447927086806713,0.001643750416490815,0.6134453781512605
787,1224,대안/Noun,237,199,38,0.0022340780260086696,0.0004442568693218419,0.8396624472573839
788,1226,산만하다/Adjective,236,19,217,0.0002334111370456819,0.0024323063595370845,0.9194915254237288
789,1227,능력/Noun,236,81,155,0.0009225297321329332,0.0017437082120882294,0.6567796610169492
790,1228,미소/Noun,235,212,23,0.002378570634655997,0.00027766054332615115,0.9021276595744679
791,1229,결론/Noun,235,63,172,0.0007224630432366343,0.0019325173815500122,0.7319148936170212
792,1230,반/Noun,235,83,152,0.0009447593642325221,0.0017103889468890912,0.6468085106382979
793,1231,치/Noun,235,90,145,0.0010225630765810826,0.001632643994757769,0.6170212765957447
794,1233,설레다/Adjective,234,212,22,0.002378570634655997,0.00026655412159310506,0.9059829059829059
795,1234,독립영화/Noun,234,75,159,0.0008558408358341669,0.0017881338990204136,0.6794871794871795
796,1236,OST/Alpha,233,191,42,0.0021451594976103147,0.0004886825562540262,0.8197424892703863
797,1237,잘못/Noun,233,83,150,0.0009447593642325221,0.0016881761034229991,0.6437768240343348
798,1239,얻다/Verb,232,135,97,0.0015227297988218294,0.0010995357515715587,0.5818965517241379
799,1240,귀/Modifier,231,137,94,0.0015449594309214182,0.0010662164863724202,0.5930735930735931
800,1242,지나치다/Verb,230,55,175,0.0006335445148382794,0.00196583664674915,0.7608695652173914
801,1243,리얼/Noun,230,156,74,0.0017561409358675113,0.0008440880517114996,0.6782608695652174
802,1244,평생/Noun,230,147,83,0.0016561075914193618,0.000944045847308914,0.6391304347826087
803,1247,젊다/Adjective,229,158,71,0.0017783705679671,0.0008107687865123613,0.6899563318777293
804,1249,왠만하다/Adjective,228,20,208,0.00024452595309547634,0.00233234856393967,0.912280701754386
805,1250,멋/Noun,228,174,54,0.0019562076247638107,0.0006219596170505788,0.7631578947368421
806,1251,범인/Noun,228,62,166,0.0007113482271868402,0.001865878851151736,0.7280701754385965
807,1252,되게/Adverb,227,149,78,0.0016783372235189508,0.0008885137386436838,0.6563876651982379
808,1253,어린이/Noun,227,87,140,0.0009892186284316995,0.0015771118860925387,0.6167400881057269
809,1256,박수/Noun,226,151,75,0.0017005668556185395,0.0008551944734445456,0.668141592920354
810,1260,손발/Noun,225,22,203,0.000266755585195065,0.0022768164552744398,0.9022222222222224
811,1261,고생/Noun,225,87,138,0.0009892186284316995,0.0015548990426264464,0.6133333333333333
812,1262,고맙다/Adjective,224,180,44,0.0020228965210625765,0.0005108953997201182,0.8035714285714286
813,1264,졸다/Verb,223,13,210,0.00016672224074691566,0.002354561407405762,0.9417040358744396
814,1265,굳이/Noun,223,45,178,0.0005223963543403357,0.001999155911948289,0.7982062780269058
815,1266,로맨틱/Noun,223,141,82,0.0015894186951205956,0.000932939425575868,0.6322869955156951
816,1271,거지같다/Adjective,222,19,203,0.0002334111370456819,0.0022768164552744398,0.9144144144144144
817,1272,떠오르다/Verb,222,164,58,0.0018450594642658664,0.0006663853039827628,0.7387387387387387
818,1273,밤/Noun,222,158,64,0.0017783705679671,0.0007330238343810393,0.7117117117117117
819,1274,심심하다/Adjective,221,88,133,0.0010003334444814939,0.0014993669339612163,0.6018099547511312
820,1277,별루/Noun,220,12,208,0.00015560742469712126,0.00233234856393967,0.9454545454545454
821,1278,슬픔/Noun,220,192,28,0.002156274313660109,0.0003331926519913814,0.8727272727272727
822,1279,용이/Noun,220,69,151,0.0007891519395354007,0.0016992825251560453,0.6863636363636364
823,1280,차/Noun,220,84,136,0.0009558741802823164,0.0015326861991603546,0.6181818181818182
824,1281,스/Noun,220,131,89,0.001478270534622652,0.0010106843777071904,0.5954545454545455
825,1282,저렇게/Adverb,220,91,129,0.001033677892630877,0.0014549412470290322,0.5863636363636363
826,1284,포장/Noun,219,20,199,0.00024452595309547634,0.002232390768342256,0.9086757990867579
827,1285,주기/Noun,219,40,179,0.0004668222740913638,0.0020102623336813344,0.817351598173516
828,1286,시도/Noun,219,57,162,0.0006557741469378681,0.001821453164219552,0.7397260273972602
829,1287,ㅅㅂ/KoreanParticle,218,20,198,0.00024452595309547634,0.002221284346609209,0.908256880733945
830,1288,아침/Noun,218,56,162,0.0006446593308880737,0.001821453164219552,0.7431192660550459
831,1289,인기/Noun,218,90,128,0.0010225630765810826,0.0014438348252959862,0.5871559633027523
832,1292,늙다/Verb,217,85,132,0.0009669889963321108,0.0014882605122281704,0.6082949308755761
833,1293,줌/Noun,217,87,130,0.0009892186284316995,0.0014660476687620785,0.5990783410138248
834,1297,광고/Noun,216,47,169,0.0005446259864399244,0.0018991981163508738,0.7824074074074074
835,1300,짱/Modifier,215,181,34,0.00203401133711237,0.00039983118238965764,0.8418604651162791
836,1301,진실/Noun,215,142,73,0.0016005335111703902,0.0008329816299784535,0.6604651162790698
837,1305,암/Noun,214,59,155,0.0006780037790374569,0.0017437082120882294,0.7242990654205608
838,1306,흐름/Noun,214,83,131,0.0009447593642325221,0.0014771540904951245,0.6121495327102804
839,1309,눈물나다/Verb,213,183,30,0.0020562409692119594,0.0003554054954574735,0.8591549295774648
840,1312,성도/Noun,212,25,187,0.00030010003334444816,0.002099113707545703,0.8820754716981132
841,1313,한계/Noun,212,38,174,0.000444592641991775,0.0019547302250161047,0.8207547169811321
842,1314,그럭저럭/Adverb,212,52,160,0.0006002000666888963,0.0017992403207534593,0.7547169811320755
843,1315,전/Foreign,212,157,55,0.0017672557519173055,0.0006330660387836247,0.7405660377358491
844,1316,조차/Josa,212,56,156,0.0006446593308880737,0.0017548146338212756,0.7358490566037735
845,1317,챙기다/Verb,212,145,67,0.0016338779593197733,0.0007663430995801773,0.6839622641509434
846,1318,심/Noun,212,73,139,0.0008336112037345782,0.0015660054643594926,0.6556603773584906
847,1319,빠르다/Adjective,212,128,84,0.0014449260864732687,0.00095515226904196,0.6037735849056604
848,1323,~^^/Punctuation,211,202,9,0.0022674224741580525,0.00012217063906350652,0.957345971563981
849,1324,진정/Noun,211,146,65,0.0016449927753695677,0.0007441302561140852,0.6919431279620853
850,1325,..?/Punctuation,211,82,129,0.0009336445481827276,0.0014549412470290322,0.6113744075829384
851,1326,웬만하다/Adjective,211,83,128,0.0009447593642325221,0.0014438348252959862,0.6066350710900474
852,1329,깔끔하다/Adjective,210,167,43,0.0018784039124152493,0.0004997889779870722,0.7952380952380952
853,1330,살짝/Noun,210,140,70,0.0015783038790708015,0.0007996623647793153,0.6666666666666666
854,1333,발견/Noun,209,175,34,0.001967322440813605,0.00039983118238965764,0.8373205741626795
855,1334,리뷰/Noun,209,80,129,0.0009114149160831386,0.0014549412470290322,0.6172248803827751
856,1335,일어나다/Verb,209,129,80,0.0014560409025230633,0.000910726582109776,0.6172248803827751
857,1339,개도/Noun,208,25,183,0.00030010003334444816,0.0020546880206135185,0.8798076923076923
858,1340,쩐다/Noun,208,145,63,0.0016338779593197733,0.0007219174126479931,0.6971153846153846
859,1341,범죄/Noun,208,72,136,0.0008224963876847838,0.0015326861991603546,0.6538461538461539
860,1342,뜻/Noun,208,122,86,0.0013782371901745027,0.000977365112508052,0.5865384615384616
861,1344,짱짱/Noun,207,199,8,0.0022340780260086696,0.00011106421733046048,0.961352657004831
862,1345,부족/Noun,207,29,178,0.0003445592975436257,0.001999155911948289,0.8599033816425121
863,1346,지난/Noun,207,159,48,0.0017894853840168946,0.0005553210866523023,0.7681159420289855
864,1347,20년/Number,207,142,65,0.0016005335111703902,0.0007441302561140852,0.6859903381642513
865,1348,야/Exclamation,207,66,141,0.0007558074913860174,0.0015882183078255846,0.6811594202898551
866,1349,오락/Noun,207,125,82,0.0014115816383238858,0.000932939425575868,0.6038647342995169
867,1352,대충/Noun,206,37,169,0.0004334778259419807,0.0018991981163508738,0.8203883495145631
868,1353,영환/Noun,206,64,142,0.0007335778592864287,0.0015993247295586306,0.6893203883495146
869,1354,~~~~/Punctuation,206,123,83,0.001389352006224297,0.000944045847308914,0.5970873786407767
870,1360,감탄/Noun,205,177,28,0.001989552072913193,0.0003331926519913814,0.8634146341463415
871,1361,빨/Noun,205,54,151,0.0006224296987884852,0.0016992825251560453,0.7365853658536585
872,1362,자연/Noun,205,142,63,0.0016005335111703902,0.0007219174126479931,0.6926829268292682
873,1363,커플/Noun,205,141,64,0.0015894186951205956,0.0007330238343810393,0.6878048780487804
874,1364,시선/Noun,205,141,64,0.0015894186951205956,0.0007330238343810393,0.6878048780487804
875,1365,정서/Noun,205,76,129,0.0008669556518839612,0.0014549412470290322,0.6292682926829268
876,1366,정말로/Adverb,205,125,80,0.0014115816383238858,0.000910726582109776,0.6097560975609756
877,1367,시청자/Noun,204,41,163,0.0004779370901411582,0.0018325595859525977,0.7990196078431373
878,1368,홍보/Noun,204,43,161,0.0005001667222407468,0.0018103467424865054,0.7892156862745098
879,1369,담기다/Verb,204,160,44,0.001800600200066689,0.0005108953997201182,0.7843137254901961
880,1370,몸매/Noun,204,67,137,0.0007669223074358119,0.0015437926208934005,0.6715686274509803
881,1371,우울하다/Adjective,204,123,81,0.001389352006224297,0.000921833003842822,0.6029411764705882
882,1375,아오/Exclamation,203,29,174,0.0003445592975436257,0.0019547302250161047,0.8571428571428571
883,1378,울리다/Verb,202,175,27,0.001967322440813605,0.00032208623025833537,0.8663366336633663
884,1379,지르다/Verb,202,42,160,0.0004890519061909527,0.0017992403207534593,0.7920792079207921
885,1380,소름끼치다/Verb,202,155,47,0.001745026119817717,0.0005442146649192564,0.7673267326732673
886,1383,일상/Noun,201,154,47,0.0017339113037679224,0.0005442146649192564,0.7661691542288557
887,1384,포기/Noun,201,56,145,0.0006446593308880737,0.001632643994757769,0.7213930348258707
888,1385,코드/Noun,201,76,125,0.0008669556518839612,0.001410515560096848,0.6218905472636815
889,1386,첨/Noun,201,77,124,0.0008780704679337558,0.0013994091383638019,0.6169154228855721
890,1387,유일하다/Adjective,200,119,81,0.0013448927420251196,0.000921833003842822,0.595
891,1388,접다/Verb,199,22,177,0.000266755585195065,0.0019880494902152425,0.8894472361809045
892,1389,30분/Number,199,51,148,0.000589085250639102,0.001665963259956907,0.7437185929648241
893,1390,에서의/Josa,199,143,56,0.0016116483272201846,0.0006441724605166707,0.7185929648241206
894,1393,이따위/Modifier,198,8,190,0.00011114816049794375,0.002132432972744841,0.9595959595959596
895,1394,눈빛/Noun,198,175,23,0.001967322440813605,0.00027766054332615115,0.8838383838383839
896,1395,10분/Number,198,36,162,0.00042236300989218633,0.001821453164219552,0.8181818181818182
897,1396,보라/Noun,198,64,134,0.0007335778592864287,0.0015104733556942625,0.6767676767676768
898,1397,끼리/Noun,198,71,127,0.0008113815716349895,0.00143272840356294,0.6414141414141414
899,1398,사극/Noun,198,123,75,0.001389352006224297,0.0008551944734445456,0.6212121212121212
900,1401,말로/Noun,197,140,57,0.0015783038790708015,0.0006552788822497168,0.7106598984771574
901,1404,뜬금/Noun,196,17,179,0.00021118150494609317,0.0020102623336813344,0.9132653061224488
902,1405,핵/Noun,196,37,159,0.0004334778259419807,0.0017881338990204136,0.8112244897959183
903,1406,상처/Noun,196,143,53,0.0016116483272201846,0.0006108531953175326,0.7295918367346939
904,1407,실감/Noun,196,128,68,0.0014449260864732687,0.0007774495213132232,0.6530612244897959
905,1408,괴물/Noun,196,81,115,0.0009225297321329332,0.0012994513427663874,0.5867346938775511
906,1414,끌/Noun,195,22,173,0.000266755585195065,0.0019436238032830586,0.8871794871794871
907,1415,힐링/Noun,195,171,24,0.001922863176614427,0.0002887669650591972,0.8769230769230769
908,1416,혹시/Noun,195,48,147,0.0005557408024897189,0.0016548568382238609,0.7538461538461538
909,1417,막판/Noun,195,58,137,0.0006668889629876625,0.0015437926208934005,0.7025641025641025
910,1418,빛/Noun,195,127,68,0.0014338112704234743,0.0007774495213132232,0.6512820512820513
911,1421,무겁다/Adjective,194,158,36,0.0017783705679671,0.0004220440258557498,0.8144329896907216
912,1422,우정/Noun,194,143,51,0.0016116483272201846,0.0005886403518514405,0.7371134020618557
913,1423,해피엔딩/Noun,194,138,56,0.0015560742469712125,0.0006441724605166707,0.711340206185567
914,1424,죄/Noun,194,67,127,0.0007669223074358119,0.00143272840356294,0.6546391752577321
915,1430,참다/Verb,193,36,157,0.00042236300989218633,0.0017659210555543215,0.8134715025906736
916,1431,으론/Josa,193,112,81,0.0012670890296765588,0.000921833003842822,0.5803108808290155
917,1437,몰다/Verb,192,64,128,0.0007335778592864287,0.0014438348252959862,0.6666666666666666
918,1439,아련하다/Adjective,191,184,7,0.002067355785261754,9.995779559741441e-05,0.9633507853403142
919,1440,보아/Noun,191,134,57,0.0015116149827720349,0.0006552788822497168,0.7015706806282722
920,1441,게다가/Noun,191,58,133,0.0006668889629876625,0.0014993669339612163,0.6963350785340314
921,1442,만큼/Noun,191,115,76,0.001300433477825942,0.0008663008951775916,0.6020942408376964
922,1443,어제/Noun,191,112,79,0.0012670890296765588,0.0008996201603767299,0.5863874345549738
923,1444,개판/Noun,190,8,182,0.00011114816049794375,0.0020435815988804726,0.9578947368421052
924,1445,뭐임/Noun,190,15,175,0.00018895187284650438,0.00196583664674915,0.9210526315789472
925,1446,나머지/Noun,190,38,152,0.000444592641991775,0.0017103889468890912,0.8
926,1447,벌써/Noun,190,146,44,0.0016449927753695677,0.0005108953997201182,0.7684210526315789
927,1448,조폭/Noun,190,58,132,0.0006668889629876625,0.0014882605122281704,0.6947368421052632
928,1449,간/Noun,190,72,118,0.0008224963876847838,0.0013327706079655256,0.6210526315789474
929,1450,이기/Noun,190,114,76,0.0012893186617761474,0.0008663008951775916,0.6
930,1451,만으로/Josa,190,112,78,0.0012670890296765588,0.0008885137386436838,0.5894736842105263
931,1453,소장/Noun,189,173,16,0.001945092808714016,0.00019991559119482882,0.9153439153439152
932,1454,비극/Noun,189,143,46,0.0016116483272201846,0.0005331082431862101,0.7566137566137566
933,1455,까지는/Josa,189,51,138,0.000589085250639102,0.0015548990426264464,0.7301587301587301
934,1456,주/Noun,189,73,116,0.0008336112037345782,0.0013105577644994335,0.6137566137566137
935,1460,벗다/Verb,188,41,147,0.0004779370901411582,0.0016548568382238609,0.7819148936170213
936,1461,난해하다/Adjective,188,45,143,0.0005223963543403357,0.001610431151291677,0.7606382978723404
937,1462,섹스/Noun,188,51,137,0.000589085250639102,0.0015437926208934005,0.7287234042553191
938,1463,부끄럽다/Adjective,188,65,123,0.0007446926753362233,0.0013883027166307562,0.6542553191489362
939,1464,등장인물/Noun,188,69,119,0.0007891519395354007,0.0013438770296985718,0.6329787234042553
940,1467,형편/Noun,187,18,169,0.0002222963209958875,0.0018991981163508738,0.9037433155080212
941,1468,본방/Noun,187,166,21,0.0018672890963654552,0.0002554476998600591,0.8877005347593583
942,1469,감명/Noun,187,164,23,0.0018450594642658664,0.00027766054332615115,0.8770053475935828
943,1470,뮤지컬/Noun,187,117,70,0.0013226631099255307,0.0007996623647793153,0.6256684491978609
944,1471,올해/Noun,187,111,76,0.0012559742136267645,0.0008663008951775916,0.5935828877005348
945,1473,펑펑/Noun,186,179,7,0.002011781705012782,9.995779559741441e-05,0.9623655913978496
946,1474,끝내다/Verb,186,63,123,0.0007224630432366343,0.0013883027166307562,0.6612903225806451
947,1475,의문/Noun,186,67,119,0.0007669223074358119,0.0013438770296985718,0.6397849462365591
948,1476,이연걸/Noun,186,117,69,0.0013226631099255307,0.0007885559430462694,0.6290322580645161
949,1482,그다지/Noun,185,18,167,0.0002222963209958875,0.0018769852728847821,0.9027027027027028
950,1483,토/Noun,185,44,141,0.0005112815382905413,0.0015882183078255846,0.7621621621621621
951,1484,떼다/Verb,185,140,45,0.0015783038790708015,0.0005220018214531642,0.7567567567567568
952,1485,인가요/Josa,185,57,128,0.0006557741469378681,0.0014438348252959862,0.6918918918918919
953,1486,결과/Noun,185,64,121,0.0007335778592864287,0.001366089873164664,0.6540540540540539
954,1487,불가/Noun,184,41,143,0.0004779370901411582,0.001610431151291677,0.7771739130434783
955,1488,자유/Noun,184,128,56,0.0014449260864732687,0.0006441724605166707,0.6956521739130435
956,1489,암튼/Adverb,184,123,61,0.001389352006224297,0.0006997045691819009,0.6684782608695652
957,1490,새벽/Noun,184,122,62,0.0013782371901745027,0.000710810990914947,0.6630434782608695
958,1491,꼴/Noun,183,23,160,0.00027787040124485944,0.0017992403207534593,0.8743169398907104
959,1492,표절/Noun,183,24,159,0.0002889852172946538,0.0017881338990204136,0.8688524590163934
960,1493,행복/Noun,183,153,30,0.0017227964877181282,0.0003554054954574735,0.8360655737704918
961,1494,딱하다/Adjective,183,31,152,0.00036678892964321435,0.0017103889468890912,0.8306010928961749
962,1495,지도/Noun,183,60,123,0.0006891185950872514,0.0013883027166307562,0.6721311475409836
963,1496,느와르/Noun,183,123,60,0.001389352006224297,0.0006885981474488549,0.6721311475409836
964,1498,글쎄/Noun,182,21,161,0.00025564076914527065,0.0018103467424865054,0.8846153846153846
965,1499,색다르다/Adjective,182,141,41,0.0015894186951205956,0.00047757613452098,0.7747252747252747
966,1500,기본/Noun,182,50,132,0.0005779704345893076,0.0014882605122281704,0.7252747252747253
967,1501,오버/Noun,182,51,131,0.000589085250639102,0.0014771540904951245,0.7197802197802198
968,1502,차이/Noun,182,68,114,0.0007780371234856063,0.0012883449210333415,0.6263736263736264
969,1506,에만/Josa,181,44,137,0.0005112815382905413,0.0015437926208934005,0.7569060773480663
970,1507,에게는/Josa,181,120,61,0.0013560075580749138,0.0006997045691819009,0.6629834254143646
971,1508,따위/Noun,181,63,118,0.0007224630432366343,0.0013327706079655256,0.6519337016574586
972,1509,가면/Noun,181,65,116,0.0007446926753362233,0.0013105577644994335,0.6408839779005525
973,1514,쓰래/Noun,180,10,170,0.0001333777925975325,0.00191030453808392,0.9444444444444444
974,1515,불쾌하다/Adjective,180,23,157,0.00027787040124485944,0.0017659210555543215,0.8722222222222222
975,1516,느리다/Adjective,180,42,138,0.0004890519061909527,0.0015548990426264464,0.7666666666666667
976,1517,까진/Josa,180,62,118,0.0007113482271868402,0.0013327706079655256,0.6555555555555556
977,1518,악당/Noun,180,65,115,0.0007446926753362233,0.0012994513427663874,0.6388888888888888
978,1521,싸다/Verb,179,41,138,0.0004779370901411582,0.0015548990426264464,0.770949720670391
979,1522,촌스럽다/Adjective,179,50,129,0.0005779704345893076,0.0014549412470290322,0.7206703910614525
980,1523,모/Modifier,179,67,112,0.0007669223074358119,0.0012661320775672494,0.6256983240223464
981,1531,그렇다고/Conjunction,178,34,144,0.0004001333777925976,0.0016215375730247227,0.8089887640449438
982,1532,그걸/Adverb,178,70,108,0.0008002667555851951,0.0012217063906350652,0.6067415730337079
983,1533,기술/Noun,178,72,106,0.0008224963876847838,0.0011994935471689732,0.5955056179775281
984,1534,새/Modifier,178,74,104,0.0008447260197843727,0.001177280703702881,0.5842696629213483
985,1535,무시/Noun,178,74,104,0.0008447260197843727,0.001177280703702881,0.5842696629213483
986,1536,이제야/Noun,177,157,20,0.0017672557519173055,0.00024434127812701304,0.8870056497175142
987,1537,적절하다/Adjective,177,137,40,0.0015449594309214182,0.000466469712787934,0.7740112994350282
988,1538,깨닫다/Verb,177,133,44,0.001500500166722241,0.0005108953997201182,0.7514124293785308
989,1539,반복/Noun,177,68,109,0.0007780371234856063,0.0012328128123681114,0.615819209039548
990,1540,공/Modifier,177,70,107,0.0008002667555851951,0.0012105999689020189,0.6045197740112994
991,1543,오그라들다/Verb,176,19,157,0.0002334111370456819,0.0017659210555543215,0.8920454545454546
992,1544,긴장/Noun,176,134,42,0.0015116149827720349,0.0004886825562540262,0.7613636363636364
993,1545,게이/Noun,176,47,129,0.0005446259864399244,0.0014549412470290322,0.7329545454545454
994,1546,어쩔/Adverb,176,57,119,0.0006557741469378681,0.0013438770296985718,0.6761363636363636
995,1547,외국/Noun,176,57,119,0.0006557741469378681,0.0013438770296985718,0.6761363636363636
996,1550,언제나/Adverb,175,128,47,0.0014449260864732687,0.0005442146649192564,0.7314285714285714
997,1551,북한/Noun,175,65,110,0.0007446926753362233,0.0012439192341011573,0.6285714285714286
998,1554,열정/Noun,174,148,26,0.0016672224074691564,0.00031097980852528933,0.8505747126436781
999,1555,소소하다/Adjective,174,143,31,0.0016116483272201846,0.00036651191719051963,0.8218390804597702
1000,1556,빛나다/Verb,174,131,43,0.001478270534622652,0.0004997889779870722,0.7528735632183908
1001,1557,이루다/Verb,174,126,48,0.0014226964543736804,0.0005553210866523023,0.7241379310344828
1002,1559,아픔/Noun,173,146,27,0.0016449927753695677,0.00032208623025833537,0.8439306358381503
1003,1560,창/Noun,173,31,142,0.00036678892964321435,0.0015993247295586306,0.8208092485549133
1004,1561,선생님/Noun,173,129,44,0.0014560409025230633,0.0005108953997201182,0.7456647398843931
1005,1562,병/Noun,173,51,122,0.000589085250639102,0.0013771962948977098,0.7052023121387283
1006,1563,쇼/Noun,173,55,118,0.0006335445148382794,0.0013327706079655256,0.6820809248554913
1007,1565,강렬하다/Adjective,172,147,25,0.0016561075914193618,0.0002998733867922433,0.8546511627906976
1008,1566,화나다/Verb,172,30,142,0.00035567411359342004,0.0015993247295586306,0.8255813953488372
1009,1567,짝/Noun,172,34,138,0.0004001333777925976,0.0015548990426264464,0.8023255813953488
1010,1568,양/Modifier,172,52,120,0.0006002000666888963,0.0013549834514316175,0.6976744186046512
1011,1569,디즈니/Noun,172,114,58,0.0012893186617761474,0.0006663853039827628,0.6627906976744186
1012,1570,늘/Noun,172,101,71,0.0011448260531288204,0.0008107687865123613,0.5872093023255814
1013,1574,질리/Noun,171,160,11,0.001800600200066689,0.0001443834825295986,0.935672514619883
1014,1575,쩝/Adverb,171,28,143,0.0003334444814938313,0.001610431151291677,0.8362573099415205
1015,1576,극치/Noun,171,28,143,0.0003334444814938313,0.001610431151291677,0.8362573099415205
1016,1577,까지도/Josa,171,135,36,0.0015227297988218294,0.0004220440258557498,0.7894736842105263
1017,1578,밥/Noun,171,47,124,0.0005446259864399244,0.0013994091383638019,0.7251461988304093
1018,1579,희생/Noun,171,112,59,0.0012670890296765588,0.0006774917257158089,0.6549707602339181
1019,1583,찡하다/Adjective,170,165,5,0.001856174280315661,7.774495213132233e-05,0.9705882352941176
1020,1584,주기도/Noun,170,6,164,8.891852839835501e-05,0.001843666007685644,0.9647058823529412
1021,1585,노답/Noun,170,14,156,0.00017783705679671002,0.0017548146338212756,0.9176470588235294
1022,1586,빡치다/Adjective,170,27,143,0.00032232966544403684,0.001610431151291677,0.8411764705882353
1023,1587,남편/Noun,170,55,115,0.0006335445148382794,0.0012994513427663874,0.6764705882352942
1024,1588,분노/Noun,170,67,103,0.0007669223074358119,0.001166174281969835,0.6058823529411764
1025,1593,죄다/Adverb,169,19,150,0.0002334111370456819,0.0016881761034229991,0.8875739644970414
1026,1594,싸구려/Noun,169,21,148,0.00025564076914527065,0.001665963259956907,0.8757396449704142
1027,1595,때우다/Verb,169,36,133,0.00042236300989218633,0.0014993669339612163,0.7869822485207101
1028,1596,에로/Josa,169,39,130,0.00045570745804156943,0.0014660476687620785,0.7692307692307693
1029,1597,마저/Josa,169,51,118,0.000589085250639102,0.0013327706079655256,0.6982248520710059
1030,1598,헐리우드/Noun,169,52,117,0.0006002000666888963,0.0013216641862324795,0.6923076923076923
1031,1601,섬세하다/Adjective,168,146,22,0.0016449927753695677,0.00026655412159310506,0.8690476190476191
1032,1602,풋풋하다/Adjective,168,144,24,0.001622763143269979,0.0002887669650591972,0.8571428571428571
1033,1603,어머니/Noun,168,123,45,0.001389352006224297,0.0005220018214531642,0.7321428571428571
1034,1604,=/Punctuation,168,55,113,0.0006335445148382794,0.0012772384993002955,0.6726190476190477
1035,1605,청소년/Noun,168,62,106,0.0007113482271868402,0.0011994935471689732,0.6309523809523809
1036,1606,시각/Noun,168,102,66,0.0011559408691786152,0.0007552366778471312,0.6071428571428571
1037,1611,제로/Noun,167,16,151,0.0002000666888962988,0.0016992825251560453,0.9041916167664672
1038,1612,유발/Noun,167,21,146,0.00025564076914527065,0.001643750416490815,0.8742514970059879
1039,1613,필름/Noun,167,34,133,0.0004001333777925976,0.0014993669339612163,0.7964071856287425
1040,1614,조절/Noun,167,40,127,0.0004668222740913638,0.00143272840356294,0.7604790419161677
1041,1615,놓치다/Verb,167,125,42,0.0014115816383238858,0.0004886825562540262,0.7485029940119761
1042,1616,본인/Noun,167,56,111,0.0006446593308880737,0.0012550256558342032,0.6646706586826348
1043,1617,_/Punctuation,167,106,61,0.0012004001333777929,0.0006997045691819009,0.6347305389221557
1044,1618,싸움/Noun,167,66,101,0.0007558074913860174,0.0011439614385037428,0.6047904191616766
1045,1622,미드/Noun,166,111,55,0.0012559742136267645,0.0006330660387836247,0.6686746987951807
1046,1623,실력/Noun,166,57,109,0.0006557741469378681,0.0012328128123681114,0.6566265060240963
1047,1627,조잡하다/Adjective,165,7,158,0.0001000333444481494,0.0017770274772873676,0.9575757575757576
1048,1628,호러/Noun,165,58,107,0.0006668889629876625,0.0012105999689020189,0.6484848484848484
1049,1629,방금/Noun,165,104,61,0.001178170501278204,0.0006997045691819009,0.6303030303030303
1050,1630,금/Noun,165,61,104,0.0007002334111370457,0.001177280703702881,0.6303030303030303
1051,1631,라인/Noun,165,63,102,0.0007224630432366343,0.001155067860236789,0.6181818181818182
1052,1632,깨다/Verb,165,69,96,0.0007891519395354007,0.0010884293298385123,0.5818181818181818
1053,1636,굿굿/Noun,164,161,3,0.0018117150161164836,5.553210866523024e-05,0.9817073170731708
1054,1637,좋아지다/Verb,164,134,30,0.0015116149827720349,0.0003554054954574735,0.8170731707317073
1055,1638,통쾌하다/Adjective,164,128,36,0.0014449260864732687,0.0004220440258557498,0.7804878048780488
1056,1639,심각하다/Adjective,164,43,121,0.0005001667222407468,0.001366089873164664,0.7378048780487805
1057,1640,맨날/Adverb,164,58,106,0.0006668889629876625,0.0011994935471689732,0.6463414634146342
1058,1641,쫌/Noun,164,59,105,0.0006780037790374569,0.001188387125435927,0.6402439024390244
1059,1646,어휴/Exclamation,163,21,142,0.00025564076914527065,0.0015993247295586306,0.8711656441717791
1060,1647,실패/Noun,163,27,136,0.00032232966544403684,0.0015326861991603546,0.8343558282208589
1061,1648,아줌마/Noun,163,46,117,0.00053351117039013,0.0013216641862324795,0.7177914110429447
1062,1649,닮다/Verb,163,99,64,0.001122596421029232,0.0007330238343810393,0.6073619631901841
1063,1654,다가오다/Verb,162,132,30,0.0014893853506724466,0.0003554054954574735,0.8148148148148148
1064,1655,은근/Noun,162,127,35,0.0014338112704234743,0.0004109376041227037,0.7839506172839507
1065,1656,심장/Noun,162,126,36,0.0014226964543736804,0.0004220440258557498,0.7777777777777778
1066,1657,바라보다/Verb,162,126,36,0.0014226964543736804,0.0004220440258557498,0.7777777777777778
1067,1658,씁쓸하다/Adjective,162,120,42,0.0013560075580749138,0.0004886825562540262,0.7407407407407407
1068,1659,편하다/Adjective,162,108,54,0.0012226297654773814,0.0006219596170505788,0.6666666666666666
1069,1660,따라가다/Verb,162,56,106,0.0006446593308880737,0.0011994935471689732,0.654320987654321
1070,1661,조합/Noun,162,98,64,0.0011114816049794377,0.0007330238343810393,0.6049382716049383
1071,1666,없어지다/Verb,161,37,124,0.0004334778259419807,0.0013994091383638019,0.7701863354037267
1072,1667,숨다/Verb,161,121,40,0.0013671223741247086,0.000466469712787934,0.7515527950310559
1073,1668,ㄷㄷㄷ/KoreanParticle,161,96,65,0.0010892519728798488,0.0007441302561140852,0.5962732919254659
1074,1671,1시간/Number,160,35,125,0.0004112481938423919,0.001410515560096848,0.78125
1075,1672,늦다/Verb,160,123,37,0.001389352006224297,0.0004331504475887958,0.76875
1076,1673,아이돌/Noun,160,54,106,0.0006224296987884852,0.0011994935471689732,0.6625
1077,1674,한국인/Noun,160,57,103,0.0006557741469378681,0.001166174281969835,0.64375
1078,1675,입다/Verb,160,59,101,0.0006780037790374569,0.0011439614385037428,0.63125
1079,1676,히어로/Noun,160,97,63,0.0011003667889296432,0.0007219174126479931,0.60625
1080,1680,명품/Noun,159,135,24,0.0015227297988218294,0.0002887669650591972,0.8490566037735849
1081,1681,존경/Noun,159,126,33,0.0014226964543736804,0.00038872476065661166,0.7924528301886793
1082,1682,더불다/Verb,159,117,42,0.0013226631099255307,0.0004886825562540262,0.7358490566037735
1083,1683,신나다/Adjective,159,111,48,0.0012559742136267645,0.0005553210866523023,0.6981132075471698
1084,1684,이끌다/Verb,159,94,65,0.00106702234078026,0.0007441302561140852,0.5911949685534591
1085,1686,시트콤/Noun,158,109,49,0.0012337445815271755,0.0005664275083853486,0.689873417721519
1086,1687,어쩔/Modifier,158,50,108,0.0005779704345893076,0.0012217063906350652,0.6835443037974683
1087,1688,성/Noun,158,56,102,0.0006446593308880737,0.001155067860236789,0.6455696202531646
1088,1689,대부분/Noun,158,60,98,0.0006891185950872514,0.0011106421733046046,0.620253164556962
1089,1690,겁니다/Verb,158,93,65,0.0010559075247304657,0.0007441302561140852,0.5886075949367089
1090,1693,짠하다/Adjective,157,146,11,0.0016449927753695677,0.0001443834825295986,0.929936305732484
1091,1694,푹/Noun,157,137,20,0.0015449594309214182,0.00024434127812701304,0.8726114649681529
1092,1695,만족/Noun,157,113,44,0.0012782038457263534,0.0005108953997201182,0.7197452229299363
1093,1696,이니/Josa,157,56,101,0.0006446593308880737,0.0011439614385037428,0.643312101910828
1094,1697,주말/Noun,157,99,58,0.001122596421029232,0.0006663853039827628,0.6305732484076433
1095,1698,신분/Noun,157,99,58,0.001122596421029232,0.0006663853039827628,0.6305732484076433
1096,1699,쵝오/Noun,156,151,5,0.0017005668556185395,7.774495213132233e-05,0.9679487179487181
1097,1703,거슬리다/Verb,155,35,120,0.0004112481938423919,0.0013549834514316175,0.7741935483870968
1098,1704,전개도/Noun,155,54,101,0.0006224296987884852,0.0011439614385037428,0.6516129032258065
1099,1705,30/Number,155,98,57,0.0011114816049794377,0.0006552788822497168,0.6322580645161291
1100,1709,짝퉁/Noun,154,7,147,0.0001000333444481494,0.0016548568382238609,0.9545454545454546
1101,1710,개뿔/Noun,154,7,147,0.0001000333444481494,0.0016548568382238609,0.9545454545454546
1102,1711,양심/Noun,154,28,126,0.0003334444814938313,0.001421621981829894,0.8181818181818182
1103,1712,????/Punctuation,154,36,118,0.00042236300989218633,0.0013327706079655256,0.7662337662337663
1104,1713,누군가/Noun,154,118,36,0.001333777925975325,0.0004220440258557498,0.7662337662337663
1105,1714,그거/Noun,154,45,109,0.0005223963543403357,0.0012328128123681114,0.7077922077922078
1106,1715,개념/Noun,154,49,105,0.0005668556185395131,0.001188387125435927,0.6818181818181818
1107,1716,이자/Noun,154,103,51,0.0011670556852284096,0.0005886403518514405,0.6688311688311688
1108,1717,시원하다/Adjective,154,103,51,0.0011670556852284096,0.0005886403518514405,0.6688311688311688
1109,1718,으로만/Josa,154,55,99,0.0006335445148382794,0.0011217485950376508,0.6428571428571429
1110,1719,끼/Noun,154,58,96,0.0006668889629876625,0.0010884293298385123,0.6233766233766234
1111,1720,돌아오다/Verb,154,93,61,0.0010559075247304657,0.0006997045691819009,0.6038961038961039
1112,1721,민망하다/Adjective,153,16,137,0.0002000666888962988,0.0015437926208934005,0.8954248366013072
1113,1722,망/Noun,153,19,134,0.0002334111370456819,0.0015104733556942625,0.8758169934640523
1114,1723,연예인/Noun,153,27,126,0.00032232966544403684,0.001421621981829894,0.8235294117647058
1115,1724,도안/Noun,153,38,115,0.000444592641991775,0.0012994513427663874,0.7516339869281046
1116,1725,해내다/Verb,153,114,39,0.0012893186617761474,0.000455363291054888,0.7450980392156863
1117,1726,가요/Noun,153,39,114,0.00045570745804156943,0.0012883449210333415,0.7450980392156863
1118,1727,전반/Noun,153,49,104,0.0005668556185395131,0.001177280703702881,0.6797385620915033
1119,1728,진리/Noun,153,101,52,0.0011448260531288204,0.0005997467735844866,0.6601307189542484
1120,1729,이정/Noun,153,60,93,0.0006891185950872514,0.0010551100646393743,0.6078431372549019
1121,1730,이란/Noun,153,91,62,0.001033677892630877,0.000710810990914947,0.5947712418300654
1122,1733,돌아보다/Verb,152,143,9,0.0016116483272201846,0.00012217063906350652,0.9407894736842104
1123,1734,의외로/Adverb,152,129,23,0.0014560409025230633,0.00027766054332615115,0.8486842105263158
1124,1735,여행/Noun,152,104,48,0.001178170501278204,0.0005553210866523023,0.6842105263157895
1125,1736,향/Noun,152,100,52,0.0011337112370790265,0.0005997467735844866,0.6578947368421053
1126,1737,19/Number,152,56,96,0.0006446593308880737,0.0010884293298385123,0.631578947368421
1127,1738,레알/Noun,152,63,89,0.0007224630432366343,0.0010106843777071904,0.5855263157894737
1128,1740,찝찝하다/Adjective,151,30,121,0.00035567411359342004,0.001366089873164664,0.8013245033112583
1129,1741,사기/Noun,151,33,118,0.00038901856174280313,0.0013327706079655256,0.7814569536423841
1130,1742,과장/Noun,151,51,100,0.000589085250639102,0.0011328550167706971,0.6622516556291391
1131,1750,라지/Noun,150,18,132,0.0002222963209958875,0.0014882605122281704,0.88
1132,1751,날리다/Verb,150,30,120,0.00035567411359342004,0.0013549834514316175,0.8
1133,1752,갈등/Noun,150,95,55,0.0010781371568300542,0.0006330660387836247,0.6333333333333333
1134,1753,하나로/Noun,150,88,62,0.0010003334444814939,0.000710810990914947,0.5866666666666667
1135,1754,한참/Noun,150,62,88,0.0007113482271868402,0.0009995779559741444,0.5866666666666667
1136,1761,낭비하다/Adjective,149,2,147,4.445926419917751e-05,0.0016548568382238609,0.9865771812080536
1137,1762,단연/Noun,149,128,21,0.0014449260864732687,0.0002554476998600591,0.8590604026845637
1138,1763,무척/Noun,149,114,35,0.0012893186617761474,0.0004109376041227037,0.7651006711409396
1139,1764,성장/Noun,149,110,39,0.00124485939757697,0.000455363291054888,0.7382550335570469
1140,1765,......../Punctuation,149,45,104,0.0005223963543403357,0.001177280703702881,0.6979865771812079
1141,1766,번째/Suffix,149,95,54,0.0010781371568300542,0.0006219596170505788,0.6375838926174496
1142,1767,초등학생/Noun,149,56,93,0.0006446593308880737,0.0010551100646393743,0.6241610738255033
1143,1768,연속/Noun,149,59,90,0.0006780037790374569,0.0010217907994402363,0.6040268456375839
1144,1769,주변/Noun,149,88,61,0.0010003334444814939,0.0006997045691819009,0.5906040268456376
1145,1770,경험/Noun,149,87,62,0.0009892186284316995,0.000710810990914947,0.5838926174496645
1146,1775,이도/Noun,148,5,143,7.780371234856063e-05,0.001610431151291677,0.9662162162162162
1147,1776,상/Noun,148,44,104,0.0005112815382905413,0.001177280703702881,0.7027027027027027
1148,1777,피해자/Noun,148,44,104,0.0005112815382905413,0.001177280703702881,0.7027027027027027
1149,1778,감히/Noun,148,97,51,0.0011003667889296432,0.0005886403518514405,0.6554054054054054
1150,1779,뒷/Modifier,148,53,95,0.0006113148827386907,0.0010773229081054666,0.6418918918918919
1151,1781,꽝/Noun,147,8,139,0.00011114816049794375,0.0015660054643594926,0.9455782312925172
1152,1782,라이/Noun,147,28,119,0.0003334444814938313,0.0013438770296985718,0.8095238095238095
1153,1783,편견/Noun,147,103,44,0.0011670556852284096,0.0005108953997201182,0.7006802721088435
1154,1784,베스트/Noun,147,97,50,0.0011003667889296432,0.0005775339301183945,0.6598639455782312
1155,1785,이여/Josa,147,86,61,0.0009781038123819054,0.0006997045691819009,0.5850340136054422
1156,1789,사수/Noun,146,132,14,0.0014893853506724466,0.00017770274772873674,0.9041095890410958
1157,1790,허세/Noun,146,18,128,0.0002222963209958875,0.0014438348252959862,0.8767123287671232
1158,1791,와우/Noun,146,125,21,0.0014115816383238858,0.0002554476998600591,0.8561643835616438
1159,1792,명성/Noun,146,25,121,0.00030010003334444816,0.001366089873164664,0.8287671232876712
1160,1793,얘/Noun,146,40,106,0.0004668222740913638,0.0011994935471689732,0.726027397260274
1161,1794,올라가다/Verb,146,98,48,0.0011114816049794377,0.0005553210866523023,0.6712328767123288
1162,1795,확/Noun,146,50,96,0.0005779704345893076,0.0010884293298385123,0.6575342465753424
1163,1796,의식/Noun,146,61,85,0.0007002334111370457,0.0009662586907750061,0.5821917808219178
1164,1803,개막/Noun,145,9,136,0.00012226297654773814,0.0015326861991603546,0.9379310344827586
1165,1804,생생하다/Adjective,145,134,11,0.0015116149827720349,0.0001443834825295986,0.9241379310344828
1166,1805,^/Punctuation,145,102,43,0.0011559408691786152,0.0004997889779870722,0.7034482758620689
1167,1806,연결/Noun,145,50,95,0.0005779704345893076,0.0010773229081054666,0.6551724137931034
1168,1807,영어/Noun,145,59,86,0.0006780037790374569,0.000977365112508052,0.593103448275862
1169,1809,뭉클하다/Adjective,144,139,5,0.0015671890630210071,7.774495213132233e-05,0.9652777777777778
1170,1810,마이너스/Noun,144,7,137,0.0001000333444481494,0.0015437926208934005,0.9513888888888888
1171,1811,밋밋하다/Adjective,144,18,126,0.0002222963209958875,0.001421621981829894,0.875
1172,1812,묘/Noun,144,118,26,0.001333777925975325,0.00031097980852528933,0.8194444444444444
1173,1813,...?/Punctuation,144,54,90,0.0006224296987884852,0.0010217907994402363,0.625
1174,1814,만큼은/Josa,144,90,54,0.0010225630765810826,0.0006219596170505788,0.625
1175,1815,쪽/Noun,144,57,87,0.0006557741469378681,0.0009884715342410985,0.6041666666666666
1176,1817,저/Modifier,143,26,117,0.00031121484939424253,0.0013216641862324795,0.8181818181818182
1177,1818,풍경/Noun,143,101,42,0.0011448260531288204,0.0004886825562540262,0.7062937062937062
1178,1819,처/Noun,143,44,99,0.0005112815382905413,0.0011217485950376508,0.6923076923076923
1179,1820,드물다/Adjective,143,98,45,0.0011114816049794377,0.0005220018214531642,0.6853146853146853
1180,1821,무언가/Noun,143,97,46,0.0011003667889296432,0.0005331082431862101,0.6783216783216783
1181,1824,ㅉㅉㅉ/KoreanParticle,142,15,127,0.00018895187284650438,0.00143272840356294,0.8943661971830986
1182,1825,싸이코/Noun,142,29,113,0.0003445592975436257,0.0012772384993002955,0.7957746478873241
1183,1826,만들기/Noun,142,30,112,0.00035567411359342004,0.0012661320775672494,0.7887323943661971
1184,1827,자연스럽다/Adjective,142,112,30,0.0012670890296765588,0.0003554054954574735,0.7887323943661971
1185,1828,복잡하다/Adjective,142,92,50,0.0010447927086806713,0.0005775339301183945,0.647887323943662
1186,1829,개성/Noun,142,87,55,0.0009892186284316995,0.0006330660387836247,0.6126760563380281
1187,1831,달달/Noun,141,125,16,0.0014115816383238858,0.00019991559119482882,0.8865248226950354
1188,1832,어린시절/Noun,141,123,18,0.001389352006224297,0.00022212843466092096,0.8723404255319149
1189,1833,정체/Noun,141,30,111,0.00035567411359342004,0.0012550256558342032,0.7872340425531915
1190,1834,막장드라마/Noun,141,32,109,0.00037790374569300877,0.0012328128123681114,0.7730496453900709
1191,1835,왠/Modifier,141,33,108,0.00038901856174280313,0.0012217063906350652,0.7659574468085106
1192,1836,마이클/Noun,141,91,50,0.001033677892630877,0.0005775339301183945,0.6453900709219859
1193,1842,♥♥/Foreign,140,140,0,0.0015783038790708015,2.2212843466092093e-05,1.0
1194,1843,숨기다/Verb,140,114,26,0.0012893186617761474,0.00031097980852528933,0.8142857142857143
1195,1844,세월/Noun,140,105,35,0.0011892853173279985,0.0004109376041227037,0.75
1196,1845,캐리/Noun,140,104,36,0.001178170501278204,0.0004220440258557498,0.7428571428571429
1197,1846,변화/Noun,140,91,49,0.001033677892630877,0.0005664275083853486,0.65
1198,1847,빨다/Verb,140,54,86,0.0006224296987884852,0.000977365112508052,0.6142857142857143
1199,1848,으로써/Josa,140,83,57,0.0009447593642325221,0.0006552788822497168,0.5928571428571429
1200,1849,코난/Noun,140,82,58,0.0009336445481827276,0.0006663853039827628,0.5857142857142857
1201,1852,일품/Noun,139,126,13,0.0014226964543736804,0.0001665963259956907,0.9064748201438848
1202,1853,젠장/Noun,139,22,117,0.000266755585195065,0.0013216641862324795,0.8417266187050358
1203,1854,기회/Noun,139,106,33,0.0012004001333777929,0.00038872476065661166,0.7625899280575541
1204,1855,카리스마/Noun,139,105,34,0.0011892853173279985,0.00039983118238965764,0.7553956834532374
1205,1856,남아/Noun,139,97,42,0.0011003667889296432,0.0004886825562540262,0.6978417266187049
1206,1858,아/Noun,138,27,111,0.00032232966544403684,0.0012550256558342032,0.8043478260869565
1207,1859,칼/Noun,138,41,97,0.0004779370901411582,0.0010995357515715587,0.7028985507246377
1208,1860,신경/Noun,138,42,96,0.0004890519061909527,0.0010884293298385123,0.6956521739130435
1209,1861,자살/Noun,138,43,95,0.0005001667222407468,0.0010773229081054666,0.6884057971014492
1210,1862,오빠/Noun,138,95,43,0.0010781371568300542,0.0004997889779870722,0.6884057971014492
1211,1863,맨/Modifier,138,51,87,0.000589085250639102,0.0009884715342410985,0.6304347826086957
1212,1864,면서/Noun,138,84,54,0.0009558741802823164,0.0006219596170505788,0.6086956521739131
1213,1865,덜/Noun,138,57,81,0.0006557741469378681,0.000921833003842822,0.5869565217391305
1214,1869,포르노/Noun,137,16,121,0.0002000666888962988,0.001366089873164664,0.8832116788321168
1215,1870,C/Alpha,137,16,121,0.0002000666888962988,0.001366089873164664,0.8832116788321168
1216,1871,응원/Noun,137,116,21,0.0013115482938757365,0.0002554476998600591,0.8467153284671532
1217,1872,겨/Noun,137,26,111,0.00031121484939424253,0.0012550256558342032,0.8102189781021898
1218,1873,압권/Noun,137,111,26,0.0012559742136267645,0.00031097980852528933,0.8102189781021898
1219,1874,다양하다/Adjective,137,99,38,0.001122596421029232,0.0004442568693218419,0.7226277372262774
1220,1875,모으다/Verb,137,39,98,0.00045570745804156943,0.0011106421733046046,0.7153284671532847
1221,1876,형사/Noun,137,43,94,0.0005001667222407468,0.0010662164863724202,0.6861313868613139
1222,1877,만해/Noun,137,91,46,0.001033677892630877,0.0005331082431862101,0.6642335766423357
1223,1878,",,,,/Punctuation",137,50,87,0.0005779704345893076,0.0009884715342410985,0.635036496350365
1224,1879,잠깐/Noun,137,52,85,0.0006002000666888963,0.0009662586907750061,0.6204379562043796
1225,1880,매/Modifier,137,82,55,0.0009336445481827276,0.0006330660387836247,0.5985401459854015
1226,1881,뿐이다/Adjective,137,56,81,0.0006446593308880737,0.000921833003842822,0.5912408759124088
1227,1886,시시하다/Adjective,136,23,113,0.00027787040124485944,0.0012772384993002955,0.8308823529411765
1228,1887,세번/Noun,136,110,26,0.00124485939757697,0.00031097980852528933,0.8088235294117647
1229,1888,냥/Josa,136,31,105,0.00036678892964321435,0.001188387125435927,0.7720588235294118
1230,1889,만에/Josa,136,101,35,0.0011448260531288204,0.0004109376041227037,0.7426470588235294
1231,1890,내면/Noun,136,99,37,0.001122596421029232,0.0004331504475887958,0.7279411764705882
1232,1891,성격/Noun,136,41,95,0.0004779370901411582,0.0010773229081054666,0.6985294117647058
1233,1892,선물/Noun,136,95,41,0.0010781371568300542,0.00047757613452098,0.6985294117647058
1234,1893,동시/Noun,136,90,46,0.0010225630765810826,0.0005331082431862101,0.6617647058823529
1235,1897,에로영화/Noun,135,22,113,0.000266755585195065,0.0012772384993002955,0.837037037037037
1236,1898,겨우/Noun,135,22,113,0.000266755585195065,0.0012772384993002955,0.837037037037037
1237,1899,추하다/Adjective,135,108,27,0.0012226297654773814,0.00032208623025833537,0.8
1238,1900,적임/Noun,135,96,39,0.0010892519728798488,0.000455363291054888,0.7111111111111111
1239,1901,만족하다/Adjective,135,93,42,0.0010559075247304657,0.0004886825562540262,0.6888888888888889
1240,1902,형제/Noun,135,91,44,0.001033677892630877,0.0005108953997201182,0.674074074074074
1241,1903,조용하다/Adjective,135,90,45,0.0010225630765810826,0.0005220018214531642,0.6666666666666666
1242,1904,할머니/Noun,135,87,48,0.0009892186284316995,0.0005553210866523023,0.6444444444444445
1243,1910,야동/Noun,134,25,109,0.00030010003334444816,0.0012328128123681114,0.8134328358208955
1244,1911,롭고/Josa,134,108,26,0.0012226297654773814,0.00031097980852528933,0.8059701492537313
1245,1912,당/Suffix,134,44,90,0.0005112815382905413,0.0010217907994402363,0.6716417910447762
1246,1913,[/Punctuation,134,44,90,0.0005112815382905413,0.0010217907994402363,0.6716417910447762
1247,1914,스럽지/Josa,134,87,47,0.0009892186284316995,0.0005442146649192564,0.6492537313432836
1248,1915,멈추다/Verb,134,84,50,0.0009558741802823164,0.0005775339301183945,0.6268656716417911
1249,1916,넌/Noun,134,54,80,0.0006224296987884852,0.000910726582109776,0.5970149253731343
1250,1917,우와/Exclamation,134,80,54,0.0009114149160831386,0.0006219596170505788,0.5970149253731343
1251,1924,투자/Noun,133,20,113,0.00024452595309547634,0.0012772384993002955,0.849624060150376
1252,1925,레전드/Noun,133,108,25,0.0012226297654773814,0.0002998733867922433,0.8120300751879699
1253,1926,지우다/Verb,133,30,103,0.00035567411359342004,0.001166174281969835,0.7744360902255639
1254,1927,고통/Noun,133,95,38,0.0010781371568300542,0.0004442568693218419,0.7142857142857143
1255,1928,비현실적/Noun,133,41,92,0.0004779370901411582,0.0010440036429063284,0.6917293233082706
1256,1929,욕망/Noun,133,90,43,0.0010225630765810826,0.0004997889779870722,0.6766917293233082
1257,1930,쉬/Noun,133,90,43,0.0010225630765810826,0.0004997889779870722,0.6766917293233082
1258,1931,방영/Noun,133,85,48,0.0009669889963321108,0.0005553210866523023,0.6390977443609023
1259,1932,영혼/Noun,133,82,51,0.0009336445481827276,0.0005886403518514405,0.6165413533834586
1260,1937,진하다/Adjective,132,119,13,0.0013448927420251196,0.0001665963259956907,0.9015151515151516
1261,1938,초등학교/Noun,132,99,33,0.001122596421029232,0.00038872476065661166,0.75
1262,1939,학년/Noun,132,96,36,0.0010892519728798488,0.0004220440258557498,0.7272727272727273
1263,1940,로그인/Noun,132,41,91,0.0004779370901411582,0.0010328972211732824,0.6893939393939394
1264,1941,베/Noun,132,45,87,0.0005223963543403357,0.0009884715342410985,0.6590909090909091
1265,1942,을/Foreign,132,45,87,0.0005223963543403357,0.0009884715342410985,0.6590909090909091
1266,1943,특수/Noun,132,48,84,0.0005557408024897189,0.00095515226904196,0.6363636363636364
1267,1944,감안/Noun,132,51,81,0.000589085250639102,0.000921833003842822,0.6136363636363636
1268,1945,21/Number,132,79,53,0.0009003001000333445,0.0006108531953175326,0.5984848484848485
1269,1946,12/Number,132,54,78,0.0006224296987884852,0.0008885137386436838,0.5909090909090909
1270,1947,상업/Noun,132,55,77,0.0006335445148382794,0.0008774073169106378,0.5833333333333334
1271,1950,M/Alpha,131,5,126,7.780371234856063e-05,0.001421621981829894,0.9618320610687024
1272,1951,잠들다/Verb,131,17,114,0.00021118150494609317,0.0012883449210333415,0.8702290076335878
1273,1952,감흥/Noun,131,19,112,0.0002334111370456819,0.0012661320775672494,0.8549618320610687
1274,1953,붙이다/Verb,131,21,110,0.00025564076914527065,0.0012439192341011573,0.8396946564885496
1275,1954,부럽다/Adjective,131,106,25,0.0012004001333777929,0.0002998733867922433,0.8091603053435115
1276,1955,설득/Noun,131,30,101,0.00035567411359342004,0.0011439614385037428,0.7709923664122137
1277,1956,따로/Adverb,131,31,100,0.00036678892964321435,0.0011328550167706971,0.7633587786259542
1278,1957,]/Punctuation,131,38,93,0.000444592641991775,0.0010551100646393743,0.7099236641221374
1279,1958,끝내주다/Adjective,131,91,40,0.001033677892630877,0.000466469712787934,0.6946564885496184
1280,1959,놀랍다/Adjective,131,91,40,0.001033677892630877,0.000466469712787934,0.6946564885496184
1281,1960,권/Suffix,131,84,47,0.0009558741802823164,0.0005442146649192564,0.6412213740458015
1282,1961,그건/Adverb,131,55,76,0.0006335445148382794,0.0008663008951775916,0.5801526717557252
1283,1964,반하다/Adjective,130,112,18,0.0012670890296765588,0.00022212843466092096,0.8615384615384616
1284,1965,점준/Noun,130,23,107,0.00027787040124485944,0.0012105999689020189,0.823076923076923
1285,1966,인지도/Noun,130,26,104,0.00031121484939424253,0.001177280703702881,0.8
1286,1967,x/Alpha,130,34,96,0.0004001333777925976,0.0010884293298385123,0.7384615384615385
1287,1968,루/Noun,130,36,94,0.00042236300989218633,0.0010662164863724202,0.7230769230769231
1288,1969,기발하다/Adjective,130,92,38,0.0010447927086806713,0.0004442568693218419,0.7076923076923077
1289,1970,최강/Noun,130,88,42,0.0010003334444814939,0.0004886825562540262,0.676923076923077
1290,1971,주성치/Noun,130,81,49,0.0009225297321329332,0.0005664275083853486,0.6230769230769231
1291,1975,안습/Noun,129,16,113,0.0002000666888962988,0.0012772384993002955,0.875968992248062
1292,1976,우려/Noun,129,18,111,0.0002222963209958875,0.0012550256558342032,0.8604651162790697
1293,1977,기만/Noun,129,25,104,0.00030010003334444816,0.001177280703702881,0.8062015503875969
1294,1978,조작/Noun,129,25,104,0.00030010003334444816,0.001177280703702881,0.8062015503875969
1295,1979,고르다/Verb,129,29,100,0.0003445592975436257,0.0011328550167706971,0.7751937984496124
1296,1980,오랫/Modifier,129,97,32,0.0011003667889296432,0.0003776183389235656,0.751937984496124
1297,1981,스트레스/Noun,129,35,94,0.0004112481938423919,0.0010662164863724202,0.7286821705426356
1298,1982,색감/Noun,129,91,38,0.001033677892630877,0.0004442568693218419,0.7054263565891473
1299,1988,공짜/Noun,128,5,123,7.780371234856063e-05,0.0013883027166307562,0.9609375
1300,1989,18/Number,128,28,100,0.0003334444814938313,0.0011328550167706971,0.78125
1301,1990,놀다/Verb,128,36,92,0.00042236300989218633,0.0010440036429063284,0.71875
1302,1991,아무렇다/Adjective,128,37,91,0.0004334778259419807,0.0010328972211732824,0.7109375
1303,1992,데리/Noun,128,41,87,0.0004779370901411582,0.0009884715342410985,0.6796875
1304,1993,포인트/Noun,128,42,86,0.0004890519061909527,0.000977365112508052,0.671875
1305,1994,ㄱ/KoreanParticle,128,45,83,0.0005223963543403357,0.000944045847308914,0.6484375
1306,1995,저러다/Verb,128,45,83,0.0005223963543403357,0.000944045847308914,0.6484375
1307,1996,갑/Noun,128,83,45,0.0009447593642325221,0.0005220018214531642,0.6484375
1308,1997,바다/Noun,128,75,53,0.0008558408358341669,0.0006108531953175326,0.5859375
1309,2001,정신병/Noun,127,21,106,0.00025564076914527065,0.0011994935471689732,0.8346456692913385
1310,2002,깨우다/Verb,127,105,22,0.0011892853173279985,0.00026655412159310506,0.8267716535433071
1311,2003,아예/Noun,127,26,101,0.00031121484939424253,0.0011439614385037428,0.7952755905511811
1312,2004,여러가지/Noun,127,95,32,0.0010781371568300542,0.0003776183389235656,0.7480314960629921
1313,2005,미가/Noun,127,94,33,0.00106702234078026,0.00038872476065661166,0.7401574803149606
1314,2006,넘어가다/Verb,127,40,87,0.0004668222740913638,0.0009884715342410985,0.6850393700787402
1315,2007,김/Noun,127,52,75,0.0006002000666888963,0.0008551944734445456,0.5905511811023622
1316,2008,풍자/Noun,127,75,52,0.0008558408358341669,0.0005997467735844866,0.5905511811023622
1317,2015,틈/Noun,126,106,20,0.0012004001333777929,0.00024434127812701304,0.8412698412698413
1318,2016,;;;;/Punctuation,126,26,100,0.00031121484939424253,0.0011328550167706971,0.7936507936507936
1319,2017,껏/Noun,126,28,98,0.0003334444814938313,0.0011106421733046046,0.7777777777777778
1320,2018,위로/Noun,126,91,35,0.001033677892630877,0.0004109376041227037,0.7222222222222222
1321,2019,전쟁영화/Noun,126,88,38,0.0010003334444814939,0.0004442568693218419,0.6984126984126984
1322,2020,보고오다/Verb,126,78,48,0.00088918528398355,0.0005553210866523023,0.6190476190476191
1323,2021,잔/Noun,126,49,77,0.0005668556185395131,0.0008774073169106378,0.6111111111111112
1324,2022,녀/Noun,126,51,75,0.000589085250639102,0.0008551944734445456,0.5952380952380952
1325,2023,약/Noun,126,52,74,0.0006002000666888963,0.0008440880517114996,0.5873015873015873
1326,2027,효/Noun,125,24,101,0.0002889852172946538,0.0011439614385037428,0.8079999999999999
1327,2028,용기/Noun,125,98,27,0.0011114816049794377,0.00032208623025833537,0.784
1328,2029,뜨겁다/Adjective,125,97,28,0.0011003667889296432,0.0003331926519913814,0.7759999999999999
1329,2030,패/Noun,125,38,87,0.000444592641991775,0.0009884715342410985,0.696
1330,2031,공포물/Noun,125,40,85,0.0004668222740913638,0.0009662586907750061,0.68
1331,2032,근래/Noun,125,84,41,0.0009558741802823164,0.00047757613452098,0.672
1332,2033,수고/Noun,125,82,43,0.0009336445481827276,0.0004997889779870722,0.6559999999999999
1333,2034,만남/Noun,125,80,45,0.0009114149160831386,0.0005220018214531642,0.64
1334,2035,깜짝/Noun,125,73,52,0.0008336112037345782,0.0005997467735844866,0.584
1335,2039,말아먹다/Verb,124,12,112,0.00015560742469712126,0.0012661320775672494,0.9032258064516128
1336,2040,운명/Noun,124,93,31,0.0010559075247304657,0.00036651191719051963,0.75
1337,2041,연인/Noun,124,91,33,0.001033677892630877,0.00038872476065661166,0.7338709677419355
1338,2042,이용/Noun,124,38,86,0.000444592641991775,0.000977365112508052,0.6935483870967742
1339,2043,",./Punctuation",124,41,83,0.0004779370901411582,0.000944045847308914,0.6693548387096774
1340,2044,007/Number,124,79,45,0.0009003001000333445,0.0005220018214531642,0.6370967741935484
1341,2045,DVD/Alpha,124,79,45,0.0009003001000333445,0.0005220018214531642,0.6370967741935484
1342,2046,거짓말/Noun,124,46,78,0.00053351117039013,0.0008885137386436838,0.6290322580645161
1343,2047,영화계/Noun,124,47,77,0.0005446259864399244,0.0008774073169106378,0.6209677419354839
1344,2053,썩다/Verb,123,33,90,0.00038901856174280313,0.0010217907994402363,0.7317073170731707
1345,2054,확인/Noun,123,35,88,0.0004112481938423919,0.0009995779559741444,0.7154471544715447
1346,2055,해결/Noun,123,42,81,0.0004890519061909527,0.000921833003842822,0.6585365853658537
1347,2056,군/Noun,123,46,77,0.00053351117039013,0.0008774073169106378,0.6260162601626016
1348,2057,캐/Noun,123,50,73,0.0005779704345893076,0.0008329816299784535,0.5934959349593496
1349,2064,았/Noun,122,13,109,0.00016672224074691566,0.0012328128123681114,0.8934426229508197
1350,2065,번은/Noun,122,102,20,0.0011559408691786152,0.00024434127812701304,0.8360655737704918
1351,2066,설마/Noun,122,22,100,0.000266755585195065,0.0011328550167706971,0.819672131147541
1352,2067,결코/Noun,122,91,31,0.001033677892630877,0.00036651191719051963,0.7459016393442623
1353,2068,원/Noun,122,31,91,0.00036678892964321435,0.0010328972211732824,0.7459016393442623
1354,2069,잖다/Verb,122,34,88,0.0004001333777925976,0.0009995779559741444,0.7213114754098361
1355,2070,갠/Noun,122,84,38,0.0009558741802823164,0.0004442568693218419,0.6885245901639344
1356,2071,갖추다/Verb,122,82,40,0.0009336445481827276,0.000466469712787934,0.6721311475409836
1357,2072,전에/Foreign,122,79,43,0.0009003001000333445,0.0004997889779870722,0.6475409836065574
1358,2073,예능/Noun,122,51,71,0.000589085250639102,0.0008107687865123613,0.5819672131147541
1359,2074,점줌/Noun,122,51,71,0.000589085250639102,0.0008107687865123613,0.5819672131147541
1360,2078,낮추다/Verb,121,16,105,0.0002000666888962988,0.001188387125435927,0.8677685950413223
1361,2079,셈/Noun,121,20,101,0.00024452595309547634,0.0011439614385037428,0.8347107438016529
1362,2080,변태/Noun,121,21,100,0.00025564076914527065,0.0011328550167706971,0.8264462809917356
1363,2081,심지어/Noun,121,31,90,0.00036678892964321435,0.0010217907994402363,0.743801652892562
1364,2082,자르다/Verb,121,40,81,0.0004668222740913638,0.000921833003842822,0.6694214876033058
1365,2086,잔뜩/Noun,120,15,105,0.00018895187284650438,0.001188387125435927,0.875
1366,2087,5분/Number,120,18,102,0.0002222963209958875,0.001155067860236789,0.85
1367,2088,크리스마스/Noun,120,89,31,0.0010114482605312882,0.00036651191719051963,0.7416666666666667
1368,2089,X/Alpha,120,31,89,0.00036678892964321435,0.0010106843777071904,0.7416666666666667
1369,2090,스런/Josa,120,39,81,0.00045570745804156943,0.000921833003842822,0.675
1370,2091,여러/Noun,120,79,41,0.0009003001000333445,0.00047757613452098,0.6583333333333333
1371,2092,넘기다/Verb,120,43,77,0.0005001667222407468,0.0008774073169106378,0.6416666666666667
1372,2093,편도/Noun,120,77,43,0.0008780704679337558,0.0004997889779870722,0.6416666666666667
1373,2094,이래서/Josa,120,46,74,0.00053351117039013,0.0008440880517114996,0.6166666666666667
1374,2095,스크린/Noun,120,71,49,0.0008113815716349895,0.0005664275083853486,0.5916666666666667
1375,2100,전율/Noun,119,110,9,0.00124485939757697,0.00012217063906350652,0.9243697478991596
1376,2101,둘째/Noun,119,14,105,0.00017783705679671002,0.001188387125435927,0.8823529411764706
1377,2102,려고/Noun,119,23,96,0.00027787040124485944,0.0010884293298385123,0.8067226890756303
1378,2103,아동/Noun,119,28,91,0.0003334444814938313,0.0010328972211732824,0.7647058823529411
1379,2104,그립다/Adjective,119,86,33,0.0009781038123819054,0.00038872476065661166,0.7226890756302521
1380,2105,탓/Noun,119,35,84,0.0004112481938423919,0.00095515226904196,0.7058823529411765
1381,2106,뛰어넘다/Verb,119,83,36,0.0009447593642325221,0.0004220440258557498,0.6974789915966386
1382,2107,제외/Noun,119,43,76,0.0005001667222407468,0.0008663008951775916,0.6386554621848739
1383,2108,자주/Noun,119,76,43,0.0008669556518839612,0.0004997889779870722,0.6386554621848739
1384,2109,옷/Noun,119,48,71,0.0005557408024897189,0.0008107687865123613,0.5966386554621849
1385,2110,통/Noun,119,49,70,0.0005668556185395131,0.0007996623647793153,0.5882352941176471
1386,2116,오빠/Suffix,118,106,12,0.0012004001333777929,0.00015548990426264466,0.8983050847457628
1387,2117,작위/Noun,118,17,101,0.00021118150494609317,0.0011439614385037428,0.8559322033898306
1388,2118,대본/Noun,118,24,94,0.0002889852172946538,0.0010662164863724202,0.7966101694915254
1389,2119,부모님/Noun,118,89,29,0.0010114482605312882,0.00034429907372442745,0.7542372881355932
1390,2120,톰/Noun,118,83,35,0.0009447593642325221,0.0004109376041227037,0.7033898305084746
1391,2121,두번째/Noun,118,81,37,0.0009225297321329332,0.0004331504475887958,0.6864406779661016
1392,2122,에나/Josa,118,38,80,0.000444592641991775,0.000910726582109776,0.6779661016949152
1393,2123,짜임새/Noun,118,71,47,0.0008113815716349895,0.0005442146649192564,0.6016949152542372
1394,2126,:)/Punctuation,117,114,3,0.0012893186617761474,5.553210866523024e-05,0.9743589743589745
1395,2127,한개/Modifier,117,10,107,0.0001333777925975325,0.0012105999689020189,0.9145299145299144
1396,2128,애쓰다/Verb,117,25,92,0.00030010003334444816,0.0010440036429063284,0.7863247863247863
1397,2129,하나같이/Adverb,117,28,89,0.0003334444814938313,0.0010106843777071904,0.7606837606837606
1398,2130,가족영화/Noun,117,77,40,0.0008780704679337558,0.000466469712787934,0.6581196581196581
1399,2131,케릭/Noun,117,44,73,0.0005112815382905413,0.0008329816299784535,0.6239316239316239
1400,2132,사상/Noun,117,46,71,0.00053351117039013,0.0008107687865123613,0.6068376068376068
1401,2133,흑인/Noun,117,47,70,0.0005446259864399244,0.0007996623647793153,0.5982905982905983
1402,2139,그만/Modifier,116,9,107,0.00012226297654773814,0.0012105999689020189,0.9224137931034484
1403,2140,하자/Noun,116,24,92,0.0002889852172946538,0.0010440036429063284,0.7931034482758621
1404,2141,정작/Noun,116,29,87,0.0003445592975436257,0.0009884715342410985,0.75
1405,2142,거나/Noun,116,33,83,0.00038901856174280313,0.000944045847308914,0.7155172413793104
1406,2143,신의/Noun,116,79,37,0.0009003001000333445,0.0004331504475887958,0.6810344827586207
1407,2144,장가/Noun,116,37,79,0.0004334778259419807,0.0008996201603767299,0.6810344827586207
1408,2145,무료/Noun,116,40,76,0.0004668222740913638,0.0008663008951775916,0.6551724137931034
1409,2146,예/Noun,116,40,76,0.0004668222740913638,0.0008663008951775916,0.6551724137931034
1410,2147,꺼/Suffix,116,40,76,0.0004668222740913638,0.0008663008951775916,0.6551724137931034
1411,2152,대놓고/Adverb,115,17,98,0.00021118150494609317,0.0011106421733046046,0.8521739130434782
1412,2153,ㅠㅜ/KoreanParticle,115,89,26,0.0010114482605312882,0.00031097980852528933,0.7739130434782608
1413,2154,소년/Noun,115,84,31,0.0009558741802823164,0.00036651191719051963,0.7304347826086957
1414,2155,열연/Noun,115,80,35,0.0009114149160831386,0.0004109376041227037,0.6956521739130435
1415,2156,성은/Noun,115,36,79,0.00042236300989218633,0.0008996201603767299,0.6869565217391305
1416,2157,목적/Noun,115,37,78,0.0004334778259419807,0.0008885137386436838,0.6782608695652174
1417,2158,충실하다/Adjective,115,77,38,0.0008780704679337558,0.0004442568693218419,0.6695652173913044
1418,2159,의심/Noun,115,40,75,0.0004668222740913638,0.0008551944734445456,0.6521739130434783
1419,2160,메/Noun,115,75,40,0.0008558408358341669,0.000466469712787934,0.6521739130434783
1420,2161,낫/Noun,115,43,72,0.0005001667222407468,0.0008218752082454075,0.6260869565217392
1421,2162,으리/Noun,115,71,44,0.0008113815716349895,0.0005108953997201182,0.6173913043478261
1422,2166,힘내다/Verb,114,95,19,0.0010781371568300542,0.000233234856393967,0.8333333333333334
1423,2167,겪다/Verb,114,87,27,0.0009892186284316995,0.00032208623025833537,0.7631578947368421
1424,2168,씹다/Verb,114,31,83,0.00036678892964321435,0.000944045847308914,0.7280701754385965
1425,2169,패러디/Noun,114,36,78,0.00042236300989218633,0.0008885137386436838,0.6842105263157895
1426,2170,꿈꾸다/Verb,114,77,37,0.0008780704679337558,0.0004331504475887958,0.6754385964912281
1427,2171,새다/Verb,114,42,72,0.0004890519061909527,0.0008218752082454075,0.631578947368421
1428,2172,the/Alpha,114,71,43,0.0008113815716349895,0.0004997889779870722,0.6228070175438597
1429,2173,구나/Noun,114,44,70,0.0005112815382905413,0.0007996623647793153,0.6140350877192983
1430,2174,15/Number,114,45,69,0.0005223963543403357,0.0007885559430462694,0.6052631578947368
1431,2175,지나가다/Verb,114,68,46,0.0007780371234856063,0.0005331082431862101,0.5964912280701754
1432,2181,20분/Number,113,18,95,0.0002222963209958875,0.0010773229081054666,0.8407079646017699
1433,2182,ㅜㅜㅜ/KoreanParticle,113,83,30,0.0009447593642325221,0.0003554054954574735,0.7345132743362832
1434,2183,..;;/Punctuation,113,31,82,0.00036678892964321435,0.000932939425575868,0.7256637168141593
1435,2184,무서움/Noun,113,47,66,0.0005446259864399244,0.0007552366778471312,0.584070796460177
1436,2188,명화/Noun,112,90,22,0.0010225630765810826,0.00026655412159310506,0.8035714285714286
1437,2189,값/Noun,112,27,85,0.00032232966544403684,0.0009662586907750061,0.7589285714285714
1438,2190,감각/Noun,112,73,39,0.0008336112037345782,0.000455363291054888,0.6517857142857143
1439,2191,부부/Noun,112,68,44,0.0007780371234856063,0.0005108953997201182,0.6071428571428571
1440,2192,집착/Noun,112,45,67,0.0005223963543403357,0.0007663430995801773,0.5982142857142857
1441,2198,낚였다/Noun,111,2,109,4.445926419917751e-05,0.0012328128123681114,0.981981981981982
1442,2199,참나/Noun,111,10,101,0.0001333777925975325,0.0011439614385037428,0.90990990990991
1443,2200,오래전/Adverb,111,85,26,0.0009669889963321108,0.00031097980852528933,0.7657657657657657
1444,2201,!!!!!/Punctuation,111,81,30,0.0009225297321329332,0.0003554054954574735,0.7297297297297297
1445,2202,뇌/Noun,111,37,74,0.0004334778259419807,0.0008440880517114996,0.6666666666666666
1446,2203,시기/Noun,111,68,43,0.0007780371234856063,0.0004997889779870722,0.6126126126126126
1447,2204,앉다/Verb,111,44,67,0.0005112815382905413,0.0007663430995801773,0.6036036036036037
1448,2208,울컥/Adverb,110,108,2,0.0012226297654773814,4.4425686932184186e-05,0.9818181818181818
1449,2209,짜지다/Verb,110,12,98,0.00015560742469712126,0.0011106421733046046,0.8909090909090909
1450,2210,신파/Noun,110,16,94,0.0002000666888962988,0.0010662164863724202,0.8545454545454545
1451,2211,첫사랑/Noun,110,90,20,0.0010225630765810826,0.00024434127812701304,0.8181818181818182
1452,2212,업다/Verb,110,29,81,0.0003445592975436257,0.000921833003842822,0.7363636363636363
1453,2213,몇몇/Noun,110,33,77,0.00038901856174280313,0.0008774073169106378,0.7
1454,2214,모양/Noun,110,36,74,0.00042236300989218633,0.0008440880517114996,0.6727272727272727
1455,2215,70년/Number,110,37,73,0.0004334778259419807,0.0008329816299784535,0.6636363636363637
1456,2216,담배/Noun,110,40,70,0.0004668222740913638,0.0007996623647793153,0.6363636363636364
1457,2217,할아버지/Noun,110,67,43,0.0007669223074358119,0.0004997889779870722,0.6090909090909091
1458,2218,탑/Noun,110,66,44,0.0007558074913860174,0.0005108953997201182,0.6
1459,2221,한숨/Noun,109,12,97,0.00015560742469712126,0.0010995357515715587,0.8899082568807339
1460,2222,시끄럽다/Adjective,109,15,94,0.00018895187284650438,0.0010662164863724202,0.8623853211009175
1461,2223,세련되다/Adjective,109,94,15,0.00106702234078026,0.0001888091694617828,0.8623853211009175
1462,2224,고전/Noun,109,80,29,0.0009114149160831386,0.00034429907372442745,0.7339449541284404
1463,2225,삭제/Noun,109,31,78,0.00036678892964321435,0.0008885137386436838,0.7155963302752294
1464,2226,빵빵/Noun,109,77,32,0.0008780704679337558,0.0003776183389235656,0.7064220183486238
1465,2227,졸/Noun,109,33,76,0.00038901856174280313,0.0008663008951775916,0.6972477064220184
1466,2228,철/Noun,109,35,74,0.0004112481938423919,0.0008440880517114996,0.6788990825688074
1467,2233,.^^/Punctuation,108,97,11,0.0011003667889296432,0.0001443834825295986,0.8981481481481481
1468,2234,말고는/Josa,108,11,97,0.0001444926086473269,0.0010995357515715587,0.8981481481481481
1469,2235,십/Modifier,108,76,32,0.0008669556518839612,0.0003776183389235656,0.7037037037037037
1470,2236,그만큼/Adverb,108,76,32,0.0008669556518839612,0.0003776183389235656,0.7037037037037037
1471,2237,최대/Noun,108,37,71,0.0004334778259419807,0.0008107687865123613,0.6574074074074074
1472,2238,언니/Noun,108,69,39,0.0007891519395354007,0.000455363291054888,0.6388888888888888
1473,2239,화의/Noun,108,39,69,0.00045570745804156943,0.0007885559430462694,0.6388888888888888
1474,2240,마이/Noun,108,40,68,0.0004668222740913638,0.0007774495213132232,0.6296296296296297
1475,2241,탈/Noun,108,40,68,0.0004668222740913638,0.0007774495213132232,0.6296296296296297
1476,2242,누나/Noun,108,65,43,0.0007446926753362233,0.0004997889779870722,0.6018518518518519
1477,2243,포스/Noun,108,65,43,0.0007446926753362233,0.0004997889779870722,0.6018518518518519
1478,2244,ㅁ/KoreanParticle,108,63,45,0.0007224630432366343,0.0005220018214531642,0.5833333333333334
1479,2248,빈약하다/Adjective,107,12,95,0.00015560742469712126,0.0010773229081054666,0.8878504672897196
1480,2249,떨다/Verb,107,36,71,0.00042236300989218633,0.0008107687865123613,0.6635514018691588
1481,2250,여태/Noun,107,63,44,0.0007224630432366343,0.0005108953997201182,0.5887850467289719
1482,2251,하늘/Noun,107,63,44,0.0007224630432366343,0.0005108953997201182,0.5887850467289719
1483,2253,어처구니/Noun,106,11,95,0.0001444926086473269,0.0010773229081054666,0.8962264150943396
1484,2254,..^^/Punctuation,106,92,14,0.0010447927086806713,0.00017770274772873674,0.8679245283018868
1485,2255,중독/Noun,106,87,19,0.0009892186284316995,0.000233234856393967,0.8207547169811321
1486,2256,폐지/Noun,106,30,76,0.00035567411359342004,0.0008663008951775916,0.7169811320754716
1487,2257,치밀하다/Adjective,106,73,33,0.0008336112037345782,0.00038872476065661166,0.6886792452830188
1488,2258,흑/Adverb,106,72,34,0.0008224963876847838,0.00039983118238965764,0.6792452830188679
1489,2263,선동/Noun,105,10,95,0.0001333777925975325,0.0010773229081054666,0.9047619047619048
1490,2264,팔이/Noun,105,11,94,0.0001444926086473269,0.0010662164863724202,0.8952380952380953
1491,2265,여름/Noun,105,85,20,0.0009669889963321108,0.00024434127812701304,0.8095238095238095
1492,2266,안감/Noun,105,22,83,0.000266755585195065,0.000944045847308914,0.7904761904761904
1493,2267,늘어지다/Verb,105,24,81,0.0002889852172946538,0.000921833003842822,0.7714285714285715
1494,2268,또다른/Modifier,105,78,27,0.00088918528398355,0.00032208623025833537,0.7428571428571429
1495,2269,중학교/Noun,105,77,28,0.0008780704679337558,0.0003331926519913814,0.7333333333333333
1496,2270,바탕/Noun,105,73,32,0.0008336112037345782,0.0003776183389235656,0.6952380952380952
1497,2271,목숨/Noun,105,70,35,0.0008002667555851951,0.0004109376041227037,0.6666666666666666
1498,2272,잡/Noun,105,36,69,0.00042236300989218633,0.0007885559430462694,0.6571428571428571
1499,2273,버전/Noun,105,38,67,0.000444592641991775,0.0007663430995801773,0.6380952380952379
1500,2274,보구/Noun,105,62,43,0.0007113482271868402,0.0004997889779870722,0.5904761904761905
1501,2275,대신/Noun,105,44,61,0.0005112815382905413,0.0006997045691819009,0.580952380952381
1502,2280,끼우다/Verb,104,10,94,0.0001333777925975325,0.0010662164863724202,0.903846153846154
1503,2281,메이드/Noun,104,91,13,0.001033677892630877,0.0001665963259956907,0.875
1504,2282,캬/Noun,104,89,15,0.0010114482605312882,0.0001888091694617828,0.8557692307692307
1505,2283,어쩌/Noun,104,16,88,0.0002000666888962988,0.0009995779559741444,0.8461538461538461
1506,2284,구리/Noun,104,16,88,0.0002000666888962988,0.0009995779559741444,0.8461538461538461
1507,2285,호구/Noun,104,17,87,0.00021118150494609317,0.0009884715342410985,0.8365384615384616
1508,2286,부터가/Josa,104,22,82,0.000266755585195065,0.000932939425575868,0.7884615384615384
1509,2287,하아/Exclamation,104,23,81,0.00027787040124485944,0.000921833003842822,0.7788461538461539
1510,2288,~!!!/Punctuation,104,79,25,0.0009003001000333445,0.0002998733867922433,0.7596153846153846
1511,2289,반갑다/Adjective,104,73,31,0.0008336112037345782,0.00036651191719051963,0.7019230769230769
1512,2290,장국영/Noun,104,73,31,0.0008336112037345782,0.00036651191719051963,0.7019230769230769
1513,2291,졸리/Noun,104,33,71,0.00038901856174280313,0.0008107687865123613,0.6826923076923077
1514,2292,표현/Modifier,104,68,36,0.0007780371234856063,0.0004220440258557498,0.6538461538461539
1515,2293,야구/Noun,104,66,38,0.0007558074913860174,0.0004442568693218419,0.6346153846153846
1516,2294,틱/Suffix,104,39,65,0.00045570745804156943,0.0007441302561140852,0.625
1517,2295,고등학교/Noun,104,65,39,0.0007446926753362233,0.000455363291054888,0.625
1518,2296,따름/Noun,104,41,63,0.0004779370901411582,0.0007219174126479931,0.6057692307692307
1519,2297,드림/Noun,104,42,62,0.0004890519061909527,0.000710810990914947,0.5961538461538461
1520,2302,내놓다/Verb,103,23,80,0.00027787040124485944,0.000910726582109776,0.7766990291262136
1521,2303,이어서/Josa,103,75,28,0.0008558408358341669,0.0003331926519913814,0.7281553398058253
1522,2304,벌다/Verb,103,29,74,0.0003445592975436257,0.0008440880517114996,0.7184466019417476
1523,2305,로버트/Noun,103,70,33,0.0008002667555851951,0.00038872476065661166,0.6796116504854369
1524,2306,보이지/Noun,103,36,67,0.00042236300989218633,0.0007663430995801773,0.6504854368932039
1525,2307,막다/Verb,103,38,65,0.000444592641991775,0.0007441302561140852,0.6310679611650486
1526,2308,배경음악/Noun,103,64,39,0.0007335778592864287,0.000455363291054888,0.6213592233009708
1527,2309,욕심/Noun,103,39,64,0.00045570745804156943,0.0007330238343810393,0.6213592233009708
1528,2310,웃/Noun,103,64,39,0.0007335778592864287,0.000455363291054888,0.6213592233009708
1529,2314,빵점/Noun,102,2,100,4.445926419917751e-05,0.0011328550167706971,0.9803921568627452
1530,2315,하품/Noun,102,2,100,4.445926419917751e-05,0.0011328550167706971,0.9803921568627452
1531,2316,편안하다/Adjective,102,90,12,0.0010225630765810826,0.00015548990426264466,0.8823529411764706
1532,2317,지경/Noun,102,14,88,0.00017783705679671002,0.0009995779559741444,0.8627450980392157
1533,2318,재미나/Noun,102,87,15,0.0009892186284316995,0.0001888091694617828,0.8529411764705882
1534,2319,조화/Noun,102,82,20,0.0009336445481827276,0.00024434127812701304,0.8039215686274509
1535,2320,곡/Noun,102,78,24,0.00088918528398355,0.0002887669650591972,0.7647058823529411
1536,2321,팔/Modifier,102,24,78,0.0002889852172946538,0.0008885137386436838,0.7647058823529411
1537,2322,로코/Noun,102,75,27,0.0008558408358341669,0.00032208623025833537,0.7352941176470589
1538,2323,숨/Noun,102,75,27,0.0008558408358341669,0.00032208623025833537,0.7352941176470589
1539,2324,곱다/Adjective,102,69,33,0.0007891519395354007,0.00038872476065661166,0.6764705882352942
1540,2325,절정/Noun,102,64,38,0.0007335778592864287,0.0004442568693218419,0.6274509803921569
1541,2326,클레멘타인/Noun,102,39,63,0.00045570745804156943,0.0007219174126479931,0.6176470588235294
1542,2327,끊다/Verb,102,39,63,0.00045570745804156943,0.0007219174126479931,0.6176470588235294
1543,2328,헤어지다/Verb,102,62,40,0.0007113482271868402,0.000466469712787934,0.6078431372549019
1544,2332,인내심/Noun,101,8,93,0.00011114816049794375,0.0010551100646393743,0.9207920792079208
1545,2333,잠시/Noun,101,75,26,0.0008558408358341669,0.00031097980852528933,0.7425742574257426
1546,2334,묻히다/Verb,101,68,33,0.0007780371234856063,0.00038872476065661166,0.6732673267326733
1547,2335,사운드/Noun,101,67,34,0.0007669223074358119,0.00039983118238965764,0.6633663366336634
1548,2336,그동안/Noun,101,65,36,0.0007446926753362233,0.0004220440258557498,0.6435643564356436
1549,2337,린다/Noun,101,64,37,0.0007335778592864287,0.0004331504475887958,0.6336633663366337
1550,2338,조니뎁/Noun,101,63,38,0.0007224630432366343,0.0004442568693218419,0.6237623762376238
1551,2339,틴/Noun,101,40,61,0.0004668222740913638,0.0006997045691819009,0.6039603960396039
1552,2351,앞뒤/Noun,100,11,89,0.0001444926086473269,0.0010106843777071904,0.89
1553,2352,울면/Noun,100,87,13,0.0009892186284316995,0.0001665963259956907,0.87
1554,2353,플롯/Noun,100,29,71,0.0003445592975436257,0.0008107687865123613,0.71
1555,2354,일본인/Noun,100,30,70,0.00035567411359342004,0.0007996623647793153,0.7
1556,2355,........./Punctuation,100,31,69,0.00036678892964321435,0.0007885559430462694,0.69
1557,2356,상관없다/Adjective,100,34,66,0.0004001333777925976,0.0007552366778471312,0.66
1558,2357,만이/Noun,100,37,63,0.0004334778259419807,0.0007219174126479931,0.63
1559,2358,딱이다/Adjective,100,59,41,0.0006780037790374569,0.00047757613452098,0.59
1560,2359,그야말로/Adverb,100,59,41,0.0006780037790374569,0.00047757613452098,0.59
1561,2360,나누다/Verb,100,58,42,0.0006668889629876625,0.0004886825562540262,0.58
