,Unnamed: 0,parameter,counts,counts_H,counts_NH,p_from_H,p_from_NH,priority
0,0,./Punctuation,52431,26334,26097,0.2927197954873847,0.2898665008107688,0.5022601132917549
1,1,영화/Noun,50383,25791,24592,0.2866844503723464,0.2731513361025345,0.5118988547724431
2,2,이/Josa,38256,20012,18244,0.22245192842058464,0.20264777094115816,0.5231074864073609
3,3,보다/Verb,38094,21677,16417,0.2409580971434923,0.18235633843488305,0.5690397437916732
4,4,하다/Verb,38002,18125,19877,0.20147827053462264,0.2207845576312224,0.5230514183464028
5,5,의/Josa,29457,17487,11970,0.19438701789485385,0.13296608098802729,0.593644974029942
6,6,가/Josa,27737,12332,15405,0.13709014115816384,0.17111663964104046,0.5553953203302447
7,7,에/Josa,27391,14054,13337,0.15622985439590975,0.14814855949710126,0.5130882406629915
8,8,../Punctuation,25849,11706,14143,0.13013226631099256,0.15710033541393634,0.547139154319316
9,9,을/Josa,23027,12500,10527,0.13895743025452928,0.11693951442724185,0.5428410127241934
10,10,.../Punctuation,22073,9139,12934,0.1016005335111704,0.14367267153868366,0.5859647533185339
11,11,은/Josa,19690,7739,11951,0.08603979104145826,0.1327550589750994,0.6069578466226511
12,12,도/Josa,18990,7903,11087,0.08786262087362454,0.12315911059774763,0.5838335966298052
13,13,들/Suffix,18507,8922,9585,0.09918861842836503,0.10647726515471244,0.5179121413519209
14,14,는/Josa,18035,7669,10366,0.08526175391797265,0.11515138052822142,0.5747712780704186
15,15,없다/Adjective,16914,5001,11913,0.05560742469712127,0.13233301494924365,0.7043277758070238
16,16,를/Josa,16639,8276,8363,0.09200844726019784,0.0929052177969302,0.5026143398040748
17,17,",/Punctuation",14719,7561,7158,0.08406135378459488,0.0795219796086097,0.513689788708472
18,18,있다/Adjective,13419,8187,5232,0.09101922863176616,0.05813101135076301,0.6101050748938073
19,19,좋다/Adjective,13043,9370,3673,0.10416805601867288,0.040816099868944224,0.7183930077436173
20,20,이/Determiner,12373,4495,7878,0.04998332777592531,0.08751860325640286,0.6367089630647378
21,21,너무/Adverb,11905,6629,5276,0.0737023452261865,0.05861969390701704,0.55682486350273
22,22,재밌다/Adjective,11789,9955,1834,0.1106702234078026,0.020391390301872543,0.8444312494698448
23,23,?/Punctuation,11319,3302,8017,0.03672335222852062,0.08906239587729625,0.7082781164413817
24,24,정말/Noun,10702,7082,3620,0.07873735689674335,0.04022745951709279,0.6617454681367969
25,25,것/Noun,10293,4088,6205,0.045459597643659005,0.06893755969701681,0.6028368794326241
26,26,되다/Verb,9887,5453,4434,0.06063132155162833,0.04926808680779226,0.5515323151613231
27,27,같다/Adjective,9325,4691,4634,0.05216183172168501,0.051489371154401484,0.5030563002680966
28,28,진짜/Noun,9220,4526,4694,0.05032788707346893,0.05215575645838424,0.5091106290672451
29,29,이/Noun,9081,4359,4722,0.048471712793153265,0.05246673626690953,0.5199867855963
30,30,적/Suffix,9003,5486,3517,0.06099811048127154,0.03908349807858904,0.6093524380761969
31,31,으로/Josa,8921,4168,4753,0.046348782927642544,0.052811035340633965,0.5327878040578411
32,32,아니다/Adjective,8754,3210,5544,0.035700789151939534,0.061596214931473374,0.6333104866346813
33,33,않다/Verb,8640,4350,4290,0.048371679448705115,0.04766876207823363,0.5034722222222222
34,34,!/Punctuation,8565,6415,2150,0.07132377459153051,0.02390101956951509,0.7489784004670169
35,35,로/Josa,7951,3351,4600,0.037267978214960536,0.05111175281547791,0.5785435794239718
36,36,에서/Josa,7910,4218,3692,0.04690452373013226,0.041027121881872096,0.5332490518331227
37,37,점/Noun,7843,3227,4616,0.03588974102478604,0.05128945556320665,0.5885502996302435
38,38,만/Josa,7745,2412,5333,0.026831165944203626,0.05925275994580066,0.6885732730794061
39,39,나오다/Verb,7213,2894,4319,0.03218850728020451,0.04799084830849197,0.5987799805906003
40,40,만들다/Verb,7199,2506,4693,0.02787595865288429,0.05214465003665119,0.6518960966800944
41,41,연기/Noun,7089,4106,2983,0.0456596643325553,0.03315266887314245,0.5792072224573283
42,42,평점/Noun,7068,2994,4074,0.03329998888518395,0.045269774983895686,0.5764006791171478
43,43,과/Josa,6768,4231,2537,0.0470490163387796,0.028199204780203917,0.6251477541371159
44,44,최고/Noun,6671,6143,528,0.06830054462598642,0.005886403518514404,0.9208514465597362
45,45,한/Josa,6635,3102,3533,0.034500389018561735,0.039261200826317774,0.5324792765636774
46,46,이다/Verb,6524,4043,2481,0.04495943092141825,0.02757724516315333,0.6197118332311465
47,47,왜/Noun,6247,2241,4006,0.024930532399688784,0.04451453830604856,0.6412678085481031
48,48,스토리/Noun,6075,2176,3899,0.02420806935645215,0.04332615118061263,0.6418106995884774
49,49,인/Josa,6018,3216,2802,0.0357674780482383,0.03114240653946112,0.5343968095712861
50,50,생각/Noun,6005,3771,2234,0.04193620095587418,0.02483395899509096,0.6279766860949209
51,51,~/Punctuation,6003,4016,1987,0.0446593308880738,0.022090672827028587,0.6689988339163752
52,52,다/Josa,5815,2885,2930,0.03208847393575636,0.03256402852129101,0.5038693035253654
53,53,다/Adverb,5790,2454,3336,0.027297988218294992,0.037073235744907715,0.5761658031088083
54,54,이다/Josa,5692,2965,2727,0.03297765921973991,0.03030942490948266,0.5209065354884048
55,55,감동/Noun,5597,4442,1155,0.049394242525286215,0.012850129945134276,0.7936394497051992
56,56,..../Punctuation,5580,2218,3362,0.024674891630543514,0.0373620027099669,0.6025089605734767
57,57,1/Number,5284,1409,3875,0.015683005446259866,0.043059597059019517,0.7333459500378501
58,58,사람/Noun,5259,2583,2676,0.028731799488718464,0.02974299740109732,0.5088419851682829
59,59,이렇다/Adjective,5240,2243,2997,0.02495276203178837,0.033308158777405096,0.5719465648854962
60,60,보고/Noun,5209,3038,2171,0.0337890407913749,0.024134254425909062,0.5832213476674986
61,61,말/Noun,5179,2468,2711,0.027453595642992108,0.030131722161753926,0.5234601274377293
62,62,아깝다/Adjective,5167,374,4793,0.004179170834722685,0.0532552922099558,0.9276175730598026
63,63,더/Noun,5026,2595,2431,0.028865177281315994,0.027021924076501037,0.5163151611619579
64,64,드라마/Noun,5005,3017,1988,0.03355562965432922,0.022101779248761638,0.6027972027972028
65,65,내/Noun,4988,2441,2547,0.027153495609647662,0.028310268997534374,0.510625501202887
66,66,때/Noun,4940,3220,1720,0.03581193731243748,0.01912525822430529,0.6518218623481782
67,67,배우/Noun,4882,2357,2525,0.026219851061464933,0.02806592771940736,0.5172060630888979
68,68,ㅋㅋㅋ/KoreanParticle,4833,2528,2305,0.028120484605979768,0.02562251493813723,0.5230705565901097
69,69,재미있다/Adjective,4787,4102,685,0.04561520506835612,0.007630111730602634,0.8569041153123041
70,70,거/Noun,4783,1959,2824,0.02179615427364677,0.03138674781758813,0.5904244198201966
71,71,와/Josa,4779,2774,2005,0.03085472935422919,0.022290588418223414,0.5804561623770663
72,72,감독/Noun,4688,1515,3173,0.016861175947538068,0.0352628890024212,0.6768344709897611
73,73,ㅋㅋ/KoreanParticle,4594,2777,1817,0.03088807380237857,0.02020258113241076,0.6044841097083152
74,74,재미/Noun,4538,1752,2786,0.01949538735133934,0.03096470379173238,0.6139268400176289
75,75,내용/Noun,4529,1407,3122,0.015660775814160276,0.03469646149403585,0.6893353941267388
76,76,뭐/Noun,4491,831,3660,0.009258641769478715,0.04067171638641463,0.8149632598530394
77,77,못/VerbPrefix,4418,1474,2944,0.0164054684894965,0.032719518425553665,0.666364870982345
78,78,그냥/Noun,4406,1187,3219,0.013215516283205513,0.035773784402141316,0.7305946436677259
79,79,고/Josa,4377,1761,2616,0.019595420695787485,0.02907661209711455,0.5976696367374914
80,80,까지/Josa,4353,2076,2277,0.023096587751472712,0.025311535129611942,0.5230875258442453
81,81,게/Josa,4340,1723,2617,0.0191730576858953,0.0290877185188476,0.6029953917050691
82,82,주다/Verb,4321,1728,2593,0.01922863176614427,0.028821164397254493,0.6000925711640824
83,83,안/VerbPrefix,4262,1318,2944,0.014671557185728575,0.032719518425553665,0.6907555138432661
84,84,재미없다/Adjective,4205,307,3898,0.0034344781593864623,0.04331504475887958,0.9269916765755052
85,85,자다/Verb,4114,2658,1456,0.029565410692453036,0.01619316288678114,0.6460865337870686
86,86,좀/Noun,4111,1455,2656,0.0161942869845504,0.029520868966436395,0.6460715154463634
87,87,그/Noun,4099,2400,1699,0.02669778815160609,0.018892023367911327,0.5855086606489388
88,88,지루하다/Adjective,4057,872,3185,0.009714349227520284,0.03539616606321775,0.7850628543258565
89,89,하고/Josa,4024,1896,2128,0.021095920862509724,0.02365667829138808,0.5288270377733598
90,90,가다/Verb,4006,1941,2065,0.021596087584750474,0.022956973722206182,0.5154767848227658
91,91,!!/Punctuation,4005,3088,917,0.03434478159386462,0.010206801572669318,0.7710362047440699
92,92,시간/Noun,3956,1077,2879,0.01199288651772813,0.03199760101290566,0.7277553083923155
93,93,한/Determiner,3920,1604,2316,0.01785039457596977,0.025744685577200742,0.5908163265306122
94,94,쓰레기/Noun,3739,209,3530,0.002345226186506613,0.03922788156111864,0.9441027012570206
95,95,들다/Verb,3702,1859,1843,0.02068467266866733,0.02049134809746996,0.5021609940572663
96,96,수/Noun,3698,2475,1223,0.027531399355340668,0.013605366622981408,0.6692806922660898
97,97,모르다/Verb,3669,1654,2015,0.018406135378459487,0.02240165263555388,0.5491959662033251
98,98,싶다/Verb,3517,1833,1684,0.02039568745137268,0.01872542704191564,0.5211828262723912
99,99,그렇다/Adjective,3501,1397,2104,0.01554962765366233,0.02339012416979497,0.6009711510996858
100,100,나/Noun,3501,1853,1648,0.020617983772368568,0.018325595859525975,0.5292773493287632
101,101,아/Exclamation,3469,1327,2142,0.014771590530176725,0.023812168195650726,0.6174690112424329
102,102,알다/Verb,3393,1393,2000,0.015505168389463152,0.022235056309558188,0.5894488653109343
103,103,볼/Noun,3386,1865,1521,0.0207513615649661,0.01691508029942913,0.5507974010632014
104,104,작품/Noun,3308,2050,1258,0.02280760253417806,0.01399409138363802,0.6197097944377267
105,105,다시/Noun,3289,2763,526,0.03073246637768145,0.005864190675048313,0.8400729705077531
106,106,10/Number,3248,2158,1090,0.02400800266755585,0.012128212532486284,0.6644088669950738
107,107,마지막/Noun,3201,2151,1050,0.02393019895520729,0.011683955663164441,0.6719775070290535
108,108,보다/Josa,3196,1681,1515,0.018706235411803936,0.016848441769030855,0.5259699624530664
109,109,사랑/Noun,3190,2523,667,0.0280649105257308,0.0074301961394078065,0.7909090909090909
110,110,잘/VerbPrefix,3151,2150,1001,0.023919084139157498,0.011139740998245185,0.682323072040622
111,111,하나/Noun,3087,1267,1820,0.014104701567189062,0.020235900397609898,0.5895691609977324
112,112,오다/Verb,3064,1619,1445,0.018017116816716684,0.01607099224771763,0.5283942558746736
113,113,이렇게/Adverb,3042,1309,1733,0.014571523841280428,0.01926964170683489,0.5696909927679158
114,114,요/Josa,3013,1950,1063,0.02169612092919862,0.01182833914569404,0.6471954862263525
115,115,처음/Noun,2995,1342,1653,0.014938312770923641,0.01838112796819121,0.5519198664440734
116,116,이다/Adjective,2942,2200,742,0.02447482494164721,0.00826317776938626,0.7477906186267845
117,117,나/Josa,2916,1029,1887,0.011459375347338,0.020980030653723985,0.647119341563786
118,118,정도/Noun,2909,1293,1616,0.014393686784483715,0.0179701903640685,0.5555173599174974
119,119,2/Number,2878,1225,1653,0.0136378792930977,0.01838112796819121,0.5743571924947879
120,120,많다/Adjective,2857,1696,1161,0.01887295765255085,0.012916768475532551,0.5936296814840742
121,121,완전/Noun,2851,1545,1306,0.0171946204290319,0.014527199626824227,0.5419151175026307
122,122,ㅋ/KoreanParticle,2712,1574,1138,0.017516950094475937,0.012661320775672492,0.5803834808259587
123,123,주인공/Noun,2708,1083,1625,0.012059575414026896,0.018070148159665917,0.6000738552437223
124,124,안되다/Adjective,2683,658,2025,0.0073357785928642874,0.022512716852884338,0.7547521431233694
125,125,액션/Noun,2660,1278,1382,0.0142269645437368,0.015371287678535732,0.5195488721804511
126,126,나다/Verb,2654,1340,1314,0.014916083138824053,0.014616051000688596,0.5048982667671439
127,127,차다/Verb,2646,1269,1377,0.014126931199288654,0.015315755569870497,0.5204081632653061
128,128,인데/Josa,2629,1242,1387,0.013826831165944204,0.015426819787200959,0.5275770254849753
129,129,장면/Noun,2611,1425,1186,0.015860842503056576,0.013194429018858705,0.5457679050172348
130,130,중/Suffix,2597,1568,1029,0.017450261198177167,0.011450720806770473,0.6037735849056604
131,131,지금/Noun,2596,1843,753,0.020506835611870625,0.008385348408449766,0.7099383667180277
132,132,ㅠㅠ/KoreanParticle,2589,1842,747,0.020495720795820828,0.008318709878051491,0.7114716106604867
133,133,최악/Noun,2549,32,2517,0.00037790374569300877,0.027977076345542997,0.9874460572773636
134,134,지/Josa,2511,993,1518,0.011059241969545405,0.01688176103422999,0.6045400238948626
135,135,임/Noun,2511,1059,1452,0.01179281982883183,0.016148737199848953,0.5782556750298686
136,136,걸/Noun,2493,777,1716,0.008658441702789819,0.01908083253737311,0.6883273164861613
137,137,3/Number,2481,918,1563,0.010225630765810827,0.017381550012217063,0.6299879081015719
138,138,이야기/Noun,2465,1372,1093,0.015271757252417473,0.012161531797685421,0.5565922920892495
139,139,연출/Noun,2454,975,1479,0.010859175280649105,0.016448610586641196,0.6026894865525673
140,140,별로/Noun,2438,320,2118,0.0035789707680337892,0.023545614074057617,0.8687448728465955
141,141,끝/Noun,2438,862,1576,0.009603201067022341,0.01752593349474666,0.6464315012305168
142,142,돈/Noun,2433,279,2154,0.00312326330999222,0.023945445256447283,0.8853267570900123
143,143,느낌/Noun,2411,1154,1257,0.012848727353562298,0.013982984961904973,0.5213604313562837
144,144,좋아하다/Adjective,2390,1427,963,0.015883072135156162,0.010717696972389435,0.597071129707113
145,145,듯/Noun,2374,1137,1237,0.012659775480715792,0.013760856527244052,0.52106149957877
146,146,라/Josa,2373,987,1386,0.010992553073246638,0.015415713365467912,0.584070796460177
147,147,그리고/Conjunction,2339,1419,920,0.01579415360675781,0.010240120837868457,0.6066695168875588
148,148,역시/Noun,2323,1623,700,0.01806157608091586,0.007796708056598325,0.6986655187257856
149,149,넘다/Verb,2286,1520,766,0.01691675002778704,0.008529731890979364,0.6649168853893264
150,150,개/Noun,2277,671,1606,0.007480271201511616,0.017859126146738045,0.7053140096618358
151,151,명작/Noun,2259,1976,283,0.02198510614649328,0.0031653301939181234,0.8747233289065959
152,152,받다/Verb,2250,1080,1170,0.012026230965877514,0.013016726271129968,0.52
153,153,남다/Verb,2231,1452,779,0.016160942536401022,0.008674115373508963,0.6508292245629762
154,154,이런/Modifier,2201,819,1382,0.009125263976881185,0.015371287678535732,0.6278964107223989
155,155,그/Determiner,2183,1013,1170,0.011281538290541291,0.013016726271129968,0.5359596885020614
156,156,이해/Noun,2164,866,1298,0.00964766033122152,0.014438348252959863,0.5998151571164511
157,157,^^/Punctuation,2162,1921,241,0.021373791263754584,0.002698860481130189,0.8885291396854764
158,158,라고/Josa,2147,777,1370,0.008658441702789819,0.015238010617739176,0.6380996739636703
159,159,괜찮다/Adjective,2129,1444,685,0.01607202400800267,0.007630111730602634,0.6782527007984971
160,160,ㅡㅡ/KoreanParticle,2128,211,1917,0.002367455818606202,0.021313223305715362,0.9008458646616542
161,161,이영화/Noun,2102,1147,955,0.012770923641213738,0.01062884559852507,0.5456707897240723
162,162,안/Noun,2100,842,1258,0.009380904746026451,0.01399409138363802,0.599047619047619
163,163,버리다/Verb,2073,660,1413,0.007358008224963877,0.015715586752260157,0.6816208393632417
164,164,느끼다/Verb,2066,1442,624,0.016049794375903082,0.006952620004886826,0.6979670861568248
165,165,많이/Adverb,2064,1130,934,0.012581971768367234,0.0103956107421311,0.5474806201550387
166,166,때문/Noun,2060,810,1250,0.009025230632433032,0.013905240009773652,0.6067961165048543
167,167,!!!/Punctuation,2038,1392,646,0.01549405357341336,0.007196961283013839,0.6830225711481845
168,168,또/Noun,2013,1348,665,0.01500500166722241,0.007407983295941714,0.6696472925981123
169,169,중/Noun,1957,1139,818,0.012682005112815385,0.009107265821097759,0.5820132856412877
170,170,해주다/Verb,1945,1324,621,0.014738246082027343,0.0069193007396876885,0.680719794344473
171,171,여자/Noun,1944,757,1187,0.008436145381793929,0.01320553544059175,0.61059670781893
172,172,난/Noun,1928,1196,732,0.013315549627653665,0.0081521135520558,0.6203319502074689
173,173,꼭/Noun,1920,1594,326,0.017739246415471824,0.003642906328439104,0.8302083333333333
174,174,내/Determiner,1911,839,1072,0.00934756029787707,0.011928296941291454,0.5609628466771324
175,175,에게/Josa,1907,1144,763,0.012737579193064357,0.008496412625780226,0.5998951232302046
176,176,보기/Noun,1903,847,1056,0.009436478826275423,0.01175059419356272,0.5549132947976878
177,177,아름답다/Adjective,1901,1659,242,0.01846170945870846,0.0027099669028632354,0.8726985796948974
178,178,하/Suffix,1862,787,1075,0.008769589863287762,0.011961616206490592,0.5773361976369495
179,179,이고/Josa,1836,960,876,0.01069245303990219,0.009751438281614427,0.5228758169934641
180,180,어떻다/Adjective,1819,805,1014,0.008969656552184062,0.011284124480774784,0.5574491478834525
181,181,마음/Noun,1810,1497,313,0.016661109258641768,0.003498522845909505,0.8270718232044199
182,182,인생/Noun,1810,1304,506,0.014515949761031457,0.005642062240387392,0.7204419889502762
183,183,서/Josa,1808,876,932,0.009758808491719465,0.010373397898665008,0.5154867256637168
184,184,엔/Josa,1801,827,974,0.009214182505279538,0.010839867611452942,0.5408106607440311
185,185,기억/Noun,1794,1237,557,0.01377125708569523,0.00620848974877274,0.6895206243032329
186,186,부터/Josa,1791,743,1048,0.008280537957096809,0.01166174281969835,0.5851479620323842
187,187,결말/Noun,1777,729,1048,0.008124930532399691,0.01166174281969835,0.5897580191333709
188,188,끄다/Verb,1754,541,1213,0.006035345115038346,0.013494302405650948,0.6915621436716077
189,189,아쉽다/Adjective,1746,1186,560,0.013204401467155718,0.006241809013971878,0.6792668957617412
190,190,면/Josa,1746,896,850,0.00998110481271535,0.00946267131655523,0.5131729667812142
191,191,ㅎㅎ/KoreanParticle,1744,1498,246,0.01667222407469156,0.00275439258979542,0.8589449541284404
192,192,보여주다/Verb,1738,936,802,0.010425697454707124,0.008929563073369022,0.5385500575373993
193,193,랑/Josa,1721,744,977,0.008291652773146604,0.010873186876652079,0.5676932016269611
194,194,못/Noun,1720,544,1176,0.0060686895631877295,0.013083364801528243,0.6837209302325581
195,195,소재/Noun,1714,594,1120,0.006624430365677447,0.012461405184477666,0.6534422403733956
196,196,이나/Josa,1704,527,1177,0.005879737690341225,0.013094471223261291,0.6907276995305164
197,197,어리다/Verb,1690,1270,420,0.014138046015338444,0.004686909971345432,0.7514792899408284
198,198,재다/Verb,1675,1417,258,0.01577192397465822,0.0028876696505919725,0.8459701492537314
199,199,없이/Adverb,1675,902,773,0.010047793709014116,0.008607476843110686,0.5385074626865671
200,200,뻔하다/Adjective,1670,457,1213,0.005101700566855619,0.013494302405650948,0.7263473053892215
201,201,애/Noun,1670,576,1094,0.006424363676781149,0.012172638219418469,0.6550898203592814
202,202,수준/Noun,1658,273,1385,0.003056574413693453,0.01540460694373487,0.8353437876960192
203,203,맞다/Verb,1649,477,1172,0.005323996887851506,0.01303893911459606,0.7107337780473014
204,204,한번/Noun,1640,1136,504,0.012648660664666,0.0056198493969213,0.6926829268292682
205,205,편/Noun,1613,721,892,0.008036012004001334,0.009929141029343166,0.5530068195908245
206,206,네/Josa,1608,469,1139,0.005235078359453151,0.01267242719740554,0.7083333333333334
207,207,먹다/Verb,1594,709,885,0.007902634211403801,0.009851396077211843,0.5552070263488079
208,208,웃기다/Verb,1590,781,809,0.008702900966988997,0.009007308025500343,0.5088050314465409
209,209,라는/Josa,1588,783,805,0.008725130599088584,0.00896288233856816,0.506926952141058
210,210,현실/Noun,1587,1041,546,0.011592753139935534,0.0060863191097092345,0.6559546313799622
211,211,전개/Noun,1586,418,1168,0.004668222740913638,0.012994513427663876,0.7364438839848676
212,212,매력/Noun,1586,1153,433,0.012837612537512505,0.004831293453875031,0.7269861286254728
213,213,무섭다/Adjective,1580,677,903,0.0075469600978103814,0.010051311668406672,0.5715189873417722
214,214,되어다/Verb,1577,1073,504,0.011948427253528954,0.0056198493969213,0.6804058338617628
215,215,가슴/Noun,1575,1376,199,0.01531621651661665,0.002232390768342256,0.8736507936507937
216,216,낮다/Adjective,1560,1254,306,0.013960208958541736,0.0034207778937781824,0.8038461538461539
217,217,말다/Verb,1559,338,1221,0.0037790374569300882,0.013583153779515316,0.7831943553559975
218,218,끝나다/Verb,1557,666,891,0.007424697121262644,0.009918034607610121,0.5722543352601156
219,219,~~/Punctuation,1556,1038,518,0.011559408691786151,0.005775339301183945,0.6670951156812339
220,220,야/Josa,1543,373,1170,0.00416805601867289,0.013016726271129968,0.7582631237848347
221,221,한국/Noun,1543,817,726,0.009103034344781592,0.008085475021657523,0.5294880103694103
222,222,높다/Adjective,1536,327,1209,0.003656774480382349,0.013449876718718765,0.787109375
223,223,님/Suffix,1536,948,588,0.010559075247304657,0.006552788822497168,0.6171875
224,224,알/Noun,1535,886,649,0.009869956652217406,0.007230280548212976,0.5771986970684039
225,225,가장/Noun,1534,1006,528,0.011203734578192731,0.005886403518514404,0.6558018252933507
226,226,;;/Punctuation,1523,373,1150,0.00416805601867289,0.012794597836469045,0.7550886408404465
227,227,저/Noun,1522,907,615,0.010103367789263087,0.006852662209289411,0.5959264126149802
228,228,슬프다/Adjective,1504,1292,212,0.014382571968433922,0.002376774250871854,0.8590425531914894
229,229,??/Punctuation,1503,455,1048,0.0050794709347560295,0.01166174281969835,0.697272122421823
230,230,본/Modifier,1496,741,755,0.00825830832499722,0.008407561251915855,0.5046791443850267
231,231,멋지다/Adjective,1475,1271,204,0.01414916083138824,0.0022879228770074857,0.8616949152542372
232,232,남자/Noun,1459,711,748,0.007924863843503391,0.008329816299784536,0.5126799177518848
233,233,아/Josa,1457,606,851,0.006757808158274981,0.00947377773828828,0.5840768702814001
234,234,하지만/Conjunction,1453,772,681,0.008602867622540847,0.00758568604367045,0.5313145216792843
235,235,음악/Noun,1452,1077,375,0.01199288651772813,0.00418712099335836,0.7417355371900827
236,236,반전/Noun,1452,767,685,0.008547293542291877,0.007630111730602634,0.528236914600551
237,237,성/Suffix,1445,496,949,0.005535178392797599,0.010562207068126793,0.6567474048442906
238,238,늘다/Verb,1443,678,765,0.0075580749138601765,0.008518625469246319,0.5301455301455301
239,239,유치하다/Adjective,1442,282,1160,0.003156607758141603,0.012905662053799508,0.8044382801664355
240,240,아이/Noun,1436,944,492,0.01051461598310548,0.005486572336124747,0.6573816155988857
241,241,죽다/Verb,1435,475,960,0.005301767255751918,0.010684377707190298,0.6689895470383276
242,242,함/Noun,1425,758,667,0.008447260197843727,0.0074301961394078065,0.5319298245614035
243,243,기/Modifier,1424,720,704,0.008024897187951541,0.00784113374353051,0.5056179775280899
244,244,솔직하다/Adjective,1420,500,920,0.005579637656996777,0.010240120837868457,0.647887323943662
245,245,크다/Verb,1413,727,686,0.0081027009003001,0.00764121815233568,0.5145081387119603
246,246,줄/Noun,1411,605,806,0.006746693342225186,0.008973988760301206,0.5712260807937632
247,247,무슨/Noun,1408,215,1193,0.00241191508280538,0.013272173970990026,0.8473011363636364
248,248,추천/Noun,1403,1037,366,0.011548293875736356,0.004087163197760945,0.7391304347826086
249,249,만/Noun,1401,947,454,0.010547960431254862,0.0050645283102689976,0.6759457530335474
250,250,냐/Josa,1392,169,1223,0.0019006335445148387,0.013605366622981408,0.8785919540229885
251,251,인지/Josa,1383,425,958,0.004746026453262197,0.010662164863724205,0.6926970354302241
252,252,쓰다/Verb,1383,430,953,0.0048016005335111715,0.010606632755058977,0.6890817064352857
253,253,게/Noun,1380,485,895,0.005412915416249861,0.009962460294542305,0.6485507246376812
254,254,눈물/Noun,1378,1156,222,0.012870956985661888,0.0024878384682023146,0.8388969521044993
255,255,인가/Josa,1378,446,932,0.004979437590307881,0.010373397898665008,0.6763425253991292
256,256,도/Noun,1374,658,716,0.0073357785928642874,0.007974410804327063,0.5211062590975255
257,257,번/Noun,1370,945,425,0.010525730799155274,0.004742442080010663,0.6897810218978102
258,258,내다/Verb,1366,686,680,0.00764699344225853,0.007574579621937405,0.5021961932650073
259,259,ㅠ/KoreanParticle,1361,899,462,0.01001444926086473,0.005153379684133366,0.6605437178545187
260,260,자체/Noun,1360,582,778,0.006491052573079916,0.008663008951775917,0.5720588235294117
261,261,저/Determiner,1355,471,884,0.00525730799155274,0.009840289655478798,0.6523985239852399
262,262,우리/Noun,1346,996,350,0.011092586417694788,0.003909460450032209,0.7399702823179792
263,263,인간/Noun,1346,839,507,0.00934756029787707,0.005653168662120438,0.6233283803863299
264,264,네/Suffix,1337,913,424,0.010170056685561854,0.004731335658277615,0.6828721017202692
265,265,야하다/Adjective,1322,769,553,0.008569523174391464,0.006164064061840557,0.5816944024205749
266,266,'/Punctuation,1314,678,636,0.0075580749138601765,0.007085897065683378,0.5159817351598174
267,267,지만/Josa,1312,784,528,0.00873624541513838,0.005886403518514404,0.5975609756097561
268,268,속/Noun,1307,819,488,0.009125263976881185,0.005442146649192564,0.6266258607498087
269,269,영/Modifier,1305,619,686,0.006902300766922307,0.00764121815233568,0.5256704980842912
270,270,허다/Verb,1294,206,1088,0.0023118817383572304,0.01210599968902019,0.8408037094281299
271,271,눈/Noun,1292,674,618,0.007513615649660998,0.006885981474488549,0.521671826625387
272,272,원작/Noun,1275,429,846,0.004790485717461376,0.009418245629623049,0.6635294117647059
273,273,짜증나다/Adjective,1251,81,1170,0.0009225297321329332,0.013016726271129968,0.9352517985611509
274,274,그래도/Adverb,1246,736,510,0.00820273424474825,0.005686487927319576,0.5906902086677368
275,275,살다/Verb,1239,732,507,0.008158274980549073,0.005653168662120438,0.5907990314769975
276,276,뭔가/Noun,1237,502,735,0.005601867289096366,0.008185432817254937,0.5941794664510913
277,277,코미디/Noun,1235,485,750,0.005412915416249861,0.008352029143250627,0.6072874493927125
278,278,찍다/Verb,1231,259,972,0.002900966988996332,0.01081765476798685,0.7896019496344435
279,279,보이다/Verb,1231,504,727,0.005624096921195954,0.00809658144339057,0.5905767668562144
280,280,연기력/Noun,1225,680,545,0.007580304545959766,0.006075212687976188,0.5551020408163265
281,281,캐릭터/Noun,1225,562,663,0.0062687562520840285,0.00738577045247562,0.5412244897959184
282,282,기대하다/Adjective,1222,341,881,0.003812381905079471,0.00980697039027966,0.7209492635024549
283,283,돼다/Verb,1217,575,642,0.006413248860731355,0.007152535596081654,0.5275267050123253
284,284,여운/Noun,1210,1139,71,0.012682005112815385,0.0008107687865123613,0.9413223140495868
285,285,이상/Noun,1209,637,572,0.007102367455818606,0.006375086074768431,0.5268817204301075
286,286,움/Noun,1204,432,772,0.00482383016561076,0.00859637042137764,0.6411960132890365
287,287,이네/Josa,1200,505,695,0.005635211737245747,0.007741175947933095,0.5791666666666667
288,288,전혀/Noun,1199,338,861,0.0037790374569300882,0.00958484195561874,0.7180984153461217
289,289,기대/Noun,1198,745,453,0.008302767589196399,0.005053421888535951,0.6218697829716193
290,290,지다/Verb,1197,523,674,0.005835278426142047,0.0075079410915391285,0.5630743525480367
291,291,모두/Noun,1194,810,384,0.009025230632433032,0.004287078788955775,0.6783919597989949
292,292,대박/Noun,1180,975,205,0.010859175280649105,0.002299029298740532,0.826271186440678
293,293,대한/Noun,1173,715,458,0.00796932310770257,0.005108953997201182,0.6095481670929241
294,294,공감/Noun,1172,643,529,0.0071690563521173735,0.005897509940247452,0.5486348122866894
295,295,씨/Suffix,1170,706,464,0.00786928976325442,0.005175592527599458,0.6034188034188034
296,296,근데/Adverb,1165,632,533,0.007046793375569634,0.005941935627179635,0.5424892703862659
297,297,별/Noun,1164,304,860,0.003401133711237079,0.009573735533885692,0.7388316151202751
298,298,이쁘다/Adjective,1161,733,428,0.008169389796598866,0.0047757613452098,0.6313522825150732
299,299,계속/Noun,1161,707,454,0.007880404579304213,0.0050645283102689976,0.6089577950043066
300,300,굿/Noun,1156,1072,84,0.011937312437479159,0.00095515226904196,0.9273356401384084
301,301,아주/Noun,1152,682,470,0.007602534178059353,0.005242231057997734,0.5920138888888888
302,302,시리즈/Noun,1149,660,489,0.007358008224963877,0.005453253070925609,0.5744125326370757
303,303,모습/Noun,1142,842,300,0.009380904746026451,0.003354139363379907,0.7373029772329247
304,304,별/Modifier,1142,316,826,0.0035345115038346118,0.009196117194962126,0.7232924693520141
305,305,미치다/Adjective,1139,415,724,0.004634878292764255,0.00806326217819143,0.6356453028972783
306,306,개봉/Noun,1138,496,642,0.005535178392797599,0.007152535596081654,0.5641476274165202
307,307,에는/Josa,1137,526,611,0.005868622874291431,0.006808236522357226,0.5373790677220757
308,308,전/Noun,1126,674,452,0.007513615649660998,0.0050423154668029066,0.5985790408525755
309,309,치다/Verb,1122,345,777,0.0038568411692786494,0.00865190253004287,0.6925133689839572
310,310,실망/Noun,1118,115,1003,0.001300433477825942,0.011161953841711278,0.8971377459749553
311,311,영상/Noun,1114,626,488,0.006980104479270868,0.005442146649192564,0.5619389587073609
312,312,대/Modifier,1114,550,564,0.006135378459486495,0.006286234700904063,0.5062836624775583
313,313,요/Noun,1099,666,433,0.007424697121262644,0.004831293453875031,0.6060054595086443
314,314,내내/Noun,1099,548,551,0.006113148827386907,0.006141851218374464,0.5013648771610555
315,315,일본/Noun,1098,391,707,0.004368122707569189,0.007874453008729647,0.6438979963570127
316,316,시키다/Verb,1097,384,713,0.0042903189952206286,0.007941091539127924,0.649954421148587
317,317,보지/Noun,1094,324,770,0.003623430032232967,0.008574157577911549,0.7038391224862889
318,318,진심/Noun,1094,415,679,0.004634878292764255,0.007563473200204358,0.6206581352833638
319,319,건지다/Verb,1093,195,898,0.002189618761809492,0.009995779559741442,0.8215919487648673
320,320,부분/Noun,1092,565,527,0.006302100700233411,0.00587529709678136,0.5173992673992674
321,321,화/Suffix,1089,474,615,0.005290652439702123,0.006852662209289411,0.5647382920110193
322,322,이제/Noun,1082,522,560,0.005824163610092253,0.006241809013971878,0.5175600739371534
323,323,다른/Noun,1077,615,462,0.0068578415027231296,0.005153379684133366,0.5710306406685237
324,324,이랑/Josa,1077,470,607,0.005246193175502945,0.006763810835425043,0.5636025998142989
325,325,일/Modifier,1074,387,687,0.004323663443370012,0.007652324574068727,0.6396648044692738
326,326,제목/Noun,1073,405,668,0.004523730132266311,0.007441302561140851,0.6225535880708295
327,327,귀엽다/Adjective,1069,881,188,0.009814382571968434,0.0021102201292787486,0.8241347053320861
328,328,이라/Josa,1066,537,529,0.005990885850839169,0.005897509940247452,0.5037523452157598
329,329,몰입/Noun,1061,631,430,0.00703567855951984,0.004797974188675893,0.5947219604147032
330,330,(/Punctuation,1060,510,550,0.0056907858174947215,0.006130744796641418,0.5188679245283019
331,331,대단하다/Adjective,1057,751,306,0.008369456485495166,0.0034207778937781824,0.7105014191106906
332,332,밖에/Josa,1056,430,626,0.0048016005335111715,0.006974832848352918,0.5928030303030303
333,333,)/Punctuation,1054,502,552,0.005601867289096366,0.00615295764010751,0.523719165085389
334,334,기분/Noun,1053,521,532,0.00581304879404246,0.005930829205446589,0.5052231718898386
335,335,뿐/Noun,1051,311,740,0.0034789374235856397,0.008240964925920167,0.7040913415794482
336,336,두/Determiner,1051,585,466,0.006524397021229299,0.0051978053710655505,0.5566127497621313
337,337,무엇/Noun,1050,539,511,0.006013115482938757,0.005697594349052622,0.5133333333333333
338,338,ㅎ/KoreanParticle,1048,840,208,0.009358675113926865,0.00233234856393967,0.8015267175572519
339,339,;/Punctuation,1045,287,758,0.0032121818383905746,0.008440880517114994,0.7253588516746412
340,340,표현/Noun,1042,681,361,0.00759141936200956,0.004031631089095715,0.6535508637236085
341,341,OO/Alpha,1033,220,813,0.0024674891630543515,0.009051733712432529,0.7870280735721199
342,342,후/Noun,1032,499,533,0.005568522840946982,0.005941935627179635,0.5164728682170543
343,343,가족/Noun,1031,710,321,0.007913749027453596,0.0035873742197738727,0.6886517943743938
344,344,믿다/Verb,1028,528,500,0.0058908525063910205,0.005575423709989116,0.5136186770428015
345,345,잔잔하다/Adjective,1023,897,126,0.009992219628765144,0.001421621981829894,0.8768328445747801
346,346,처럼/Josa,1023,537,486,0.005990885850839169,0.005419933805726471,0.5249266862170088
347,347,요즘/Noun,1013,643,370,0.0071690563521173735,0.00413158888469313,0.6347482724580454
348,348,감/Noun,1013,542,471,0.0060464599310881394,0.005253337479730781,0.5350444225074038
349,349,점도/Noun,1011,91,920,0.001033677892630877,0.010240120837868457,0.9099901088031652
350,350,이/Suffix,1007,511,496,0.005701900633544515,0.005530998023056932,0.5074478649453823
351,351,긴장감/Noun,1001,507,494,0.0056574413693453365,0.005508785179590839,0.5064935064935064
352,352,용/Noun,999,295,704,0.003301100366788929,0.00784113374353051,0.7047047047047047
353,353,떨어지다/Verb,997,207,790,0.0023229965544070245,0.00879628601257247,0.7923771313941825
354,354,ㅜㅜ/KoreanParticle,996,633,363,0.007057908191619429,0.004053843932561807,0.6355421686746988
355,355,모든/Noun,986,630,356,0.007024563743470045,0.003976098980430485,0.6389452332657201
356,356,4/Number,981,333,648,0.0037234633766811158,0.007219174126479932,0.6605504587155964
357,357,이라는/Josa,981,510,471,0.0056907858174947215,0.005253337479730781,0.5198776758409785
358,358,급/Noun,974,237,737,0.002656441035900856,0.00820764566072103,0.7566735112936345
359,359,웃다/Verb,974,598,376,0.006668889629876626,0.004198227415091406,0.6139630390143738
360,360,위/Noun,973,445,528,0.004968322774258086,0.005886403518514404,0.5426515930113053
361,361,조금/Noun,967,582,385,0.006491052573079916,0.00429818521068882,0.6018614270941055
362,362,특히/Adverb,966,665,301,0.007413582305212848,0.0033652457851129523,0.6884057971014492
363,363,여/Modifier,966,412,554,0.004601533844614872,0.006175170483573602,0.5734989648033126
364,364,빠지다/Verb,964,602,362,0.006713348894075803,0.0040427375108287615,0.6244813278008299
365,365,대사/Noun,960,476,484,0.005312882071801712,0.005397720962260379,0.5041666666666667
366,366,개인/Noun,957,633,324,0.007057908191619429,0.003620693484973011,0.6614420062695925
367,367,분/Noun,957,530,427,0.005913082138490608,0.0047646549234767535,0.5538140020898642
368,368,스릴러/Noun,954,424,530,0.004734911637212404,0.005908616361980497,0.5555555555555556
369,369,공포/Noun,951,319,632,0.0035678559519839955,0.007041471378751194,0.6645636172450052
370,370,짜다/Verb,947,361,586,0.00403467822607536,0.006530575979031076,0.6187961985216474
371,371,극장/Noun,938,444,494,0.00495720795820829,0.005508785179590839,0.5266524520255863
372,372,건/Noun,932,292,640,0.0032677559186395466,0.0071303227526155625,0.6866952789699571
373,373,한테/Josa,931,317,614,0.0035456263198844064,0.006841555787556365,0.6595059076262084
374,374,작가/Noun,929,209,720,0.002345226186506613,0.008018836491259245,0.77502691065662
375,375,이유/Noun,928,364,564,0.00406802267422474,0.006286234700904063,0.6077586206896551
376,376,나름/Noun,923,600,323,0.006691119261976214,0.003609587063239965,0.6500541711809318
377,377,잼/Noun,923,524,399,0.0058463932421918404,0.004453675114951465,0.5677139761646804
378,378,시작/Noun,922,432,490,0.00482383016561076,0.0054643594926586546,0.5314533622559653
379,379,욕/Noun,910,166,744,0.0018672890963654552,0.00828539061285235,0.8175824175824176
380,380,차라리/Noun,909,59,850,0.0006780037790374569,0.00946267131655523,0.935093509350935
381,381,이상하다/Adjective,909,232,677,0.002600866955651884,0.007541260356738266,0.7447744774477447
382,382,노래/Noun,909,604,305,0.006735578526175392,0.0034096714720451365,0.6644664466446645
383,383,깊다/Adjective,907,808,99,0.009003001000333445,0.0011217485950376508,0.8908489525909592
384,384,제대로/Noun,907,366,541,0.00409025230632433,0.0060307870010440036,0.5964718853362734
385,385,짱/Noun,905,842,63,0.009380904746026451,0.0007219174126479931,0.9303867403314916
386,386,중간/Noun,905,328,577,0.0036678892964321437,0.0064306181834336605,0.6375690607734806
387,387,울다/Verb,900,695,205,0.00774702678670668,0.002299029298740532,0.7722222222222223
388,388,알바/Noun,897,104,793,0.001178170501278204,0.008829605277771607,0.8840579710144928
389,389,-/Punctuation,894,421,473,0.004701567189063021,0.0052755503231968716,0.529082774049217
390,390,0/Number,888,77,811,0.0008780704679337558,0.009029520868966436,0.9132882882882885
391,391,애니/Noun,888,446,442,0.004979437590307881,0.0049312512494724455,0.5022522522522522
392,392,따뜻하다/Adjective,884,833,51,0.009280871401578305,0.0005886403518514405,0.9423076923076924
393,393,느껴지다/Verb,884,553,331,0.0061687229076358785,0.0036984384371043337,0.6255656108597285
394,394,삶/Noun,883,770,113,0.008580637990441259,0.0012772384993002955,0.8720271800679502
395,395,에도/Josa,881,473,408,0.0052795376236523285,0.0045536329105488795,0.5368898978433598
396,396,",,/Punctuation",879,413,466,0.004612648660664666,0.0051978053710655505,0.5301478953356087
397,397,...../Punctuation,877,327,550,0.003656774480382349,0.006130744796641418,0.6271379703534777
398,398,제/Noun,874,553,321,0.0061687229076358785,0.0035873742197738727,0.6327231121281465
399,399,오랜/Modifier,870,699,171,0.007791486050905858,0.0019214109598169665,0.8034482758620691
400,400,기/Noun,869,240,629,0.0026897854840502392,0.007008152113552056,0.7238204833141542
401,401,예쁘다/Adjective,865,571,294,0.006368789596532178,0.00328750083298163,0.6601156069364161
402,402,제일/Noun,865,507,358,0.0056574413693453365,0.003998311823896578,0.5861271676300578
403,403,당시/Noun,862,550,312,0.006135378459486495,0.003487416424176459,0.6380510440835266
404,404,빼다/Verb,861,250,611,0.002800933644548183,0.006808236522357226,0.7096399535423926
405,405,점수/Noun,857,271,586,0.0030343447815938647,0.006530575979031076,0.6837806301050176
406,406,해보다/Verb,855,496,359,0.005535178392797599,0.004009418245629622,0.5801169590643275
407,407,의미/Noun,854,412,442,0.004601533844614872,0.0049312512494724455,0.5175644028103045
408,408,영화로/Noun,847,377,470,0.004212515282872069,0.005242231057997734,0.5548996458087367
409,409,놈/Noun,846,250,596,0.002800933644548183,0.006641640196361536,0.7044917257683215
410,410,아직도/Adverb,841,631,210,0.00703567855951984,0.002354561407405762,0.7502972651605232
411,411,어설프다/Adjective,834,79,755,0.0009003001000333445,0.008407561251915855,0.9052757793764988
412,412,막장/Noun,834,144,690,0.001622763143269979,0.007685643839267866,0.8273381294964028
413,413,력/Suffix,830,347,483,0.003879070801378237,0.005386614540527333,0.5819277108433735
414,414,연/Modifier,829,393,436,0.0043903523396687785,0.004864612719074169,0.525934861278649
415,415,친구/Noun,827,432,395,0.00482383016561076,0.004409249428019281,0.5223700120918985
416,416,훌륭하다/Adjective,825,663,162,0.007391352673113259,0.001821453164219552,0.8036363636363636
417,417,세상/Noun,824,533,291,0.00594642658663999,0.003254181567782492,0.6468446601941747
418,418,이지/Josa,815,332,483,0.003712348560631322,0.005386614540527333,0.5926380368098161
419,419,이라고/Josa,815,342,473,0.003823496721129265,0.0052755503231968716,0.5803680981595092
420,420,공포영화/Noun,809,293,516,0.003278870734689341,0.005753126457717852,0.6378244746600742
421,421,위해/Noun,809,386,423,0.004312548627320218,0.004720229236544571,0.5228677379480839
422,422,도대체/Noun,805,101,704,0.0011448260531288204,0.00784113374353051,0.8745341614906832
423,423,웃음/Noun,805,380,425,0.004245859731021452,0.004742442080010663,0.5279503105590062
424,424,힘들다/Adjective,799,310,489,0.0034678226075358447,0.005453253070925609,0.6120150187734669
425,425,앞/Noun,797,485,312,0.005412915416249861,0.003487416424176459,0.6085319949811794
426,426,생각나다/Verb,795,647,148,0.00721351561631655,0.001665963259956907,0.8138364779874214
427,427,류/Noun,790,141,649,0.0015894186951205956,0.007230280548212976,0.8215189873417722
428,428,로/Noun,790,335,455,0.0037456930087807045,0.005075634732002044,0.5759493670886076
429,429,7/Number,790,388,402,0.004334778259419807,0.004486994380150603,0.5088607594936709
430,430,의/Noun,788,444,344,0.00495720795820829,0.003842821919633933,0.5634517766497462
431,431,절대/Noun,787,263,524,0.0029454262531955103,0.005841977831582221,0.6658195679796697
432,432,그리다/Verb,785,442,343,0.004934978326108703,0.0038317154979008857,0.5630573248407643
433,433,뭘/Noun,782,175,607,0.001967322440813605,0.006763810835425043,0.7762148337595908
434,434,잇다/Verb,780,524,256,0.0058463932421918404,0.00286545680712588,0.6717948717948717
435,435,우리나라/Noun,778,423,355,0.00472379682116261,0.003964992558697439,0.5437017994858612
436,436,다르다/Adjective,778,400,378,0.004468156052017339,0.004220440258557497,0.5141388174807198
437,437,물/Noun,777,295,482,0.003301100366788929,0.005375508118794287,0.6203346203346203
438,438,제/Modifier,775,314,461,0.0035122818717350226,0.00514227326240032,0.5948387096774194
439,439,미국/Noun,774,361,413,0.00403467822607536,0.0046091650192141105,0.5335917312661499
440,440,써다/Verb,768,243,525,0.0027231299321996217,0.005853084253315267,0.68359375
441,441,수작/Noun,766,696,70,0.007758141602756475,0.0007996623647793153,0.908616187989556
442,442,엄청/Adverb,766,465,301,0.0051906190952539745,0.0033652457851129523,0.6070496083550914
443,443,걍/Adverb,765,208,557,0.002334111370456819,0.00620848974877274,0.7281045751633987
444,444,설정/Noun,762,139,623,0.0015671890630210071,0.0069415135831537795,0.8175853018372703
445,445,초반/Noun,761,265,496,0.0029676558852950985,0.005530998023056932,0.6517739816031537
446,446,찾다/Verb,758,431,327,0.004812715349560965,0.003654012750172149,0.5686015831134564
447,447,5/Number,758,346,412,0.0038679559853284423,0.004598058597481063,0.5435356200527705
448,448,놓다/Verb,755,225,530,0.0025230632433033235,0.005908616361980497,0.7019867549668874
449,449,필요없다/Adjective,754,630,124,0.007024563743470045,0.0013994091383638019,0.8355437665782494
450,450,일/Noun,751,400,351,0.004468156052017339,0.003920566871765255,0.5326231691078562
451,451,신선하다/Adjective,748,507,241,0.0056574413693453365,0.002698860481130189,0.6778074866310161
452,452,싫다/Adjective,746,130,616,0.0014671557185728574,0.0068637686310224575,0.8257372654155496
453,453,시나리오/Noun,742,207,535,0.0023229965544070245,0.005964148470645727,0.7210242587601078
454,454,딱/Adverb,742,251,491,0.002812048460597977,0.005475465914391701,0.6617250673854448
455,455,이란/Josa,742,435,307,0.004857174613760142,0.0034318843155112288,0.5862533692722371
456,456,사실/Noun,742,429,313,0.004790485717461376,0.003498522845909505,0.578167115902965
457,457,해/Noun,741,351,390,0.003923530065577415,0.00435371731935405,0.5263157894736842
458,458,출연/Noun,740,226,514,0.0025341780593531177,0.00573091361425176,0.6945945945945946
459,459,남/Noun,740,366,374,0.00409025230632433,0.0041760145716253135,0.5054054054054054
460,460,대다/Verb,739,359,380,0.0040124485939757705,0.00424265310202359,0.5142083897158322
461,461,멋있다/Adjective,732,615,117,0.0068578415027231296,0.0013216641862324795,0.8401639344262295
462,462,관객/Noun,732,188,544,0.002111815049460932,0.006064106266243142,0.7431693989071039
463,463,한국영/Noun,731,295,436,0.003301100366788929,0.004864612719074169,0.5964432284541724
464,464,이야/Josa,730,298,432,0.003334444814938313,0.004820187032141985,0.5917808219178082
465,465,가지/Noun,725,278,447,0.003112148493942425,0.004986783358137676,0.616551724137931
466,466,노잼/Noun,724,17,707,0.00021118150494609317,0.007874453008729647,0.9765193370165746
467,467,"""/Punctuation",724,358,366,0.0040013337779259755,0.004087163197760945,0.505524861878453
468,468,뭔/Modifier,722,104,618,0.001178170501278204,0.006885981474488549,0.8559556786703602
469,469,분위기/Noun,721,443,278,0.004946093142158497,0.003109798085252893,0.6144244105409153
470,470,답답하다/Adjective,719,131,588,0.001478270534622652,0.006552788822497168,0.8178025034770514
471,471,아프다/Adjective,719,559,160,0.006235411803934645,0.0017992403207534593,0.7774687065368567
472,472,시대/Noun,719,474,245,0.005290652439702123,0.0027432861680623736,0.6592489568845619
473,473,봄/Noun,718,398,320,0.00444592641991775,0.003576267798040827,0.5543175487465181
474,474,장난/Noun,714,182,532,0.002045126153162165,0.005930829205446589,0.7450980392156863
475,475,죽이다/Verb,713,198,515,0.002222963209958875,0.005742020035984807,0.7223001402524544
476,476,기다/Verb,712,351,361,0.003923530065577415,0.004031631089095715,0.5070224719101124
477,477,최고다/Noun,711,679,32,0.007569189729909971,0.0003776183389235656,0.9549929676511956
478,478,스럽다/Adjective,711,238,473,0.00266755585195065,0.0052755503231968716,0.6652601969057665
479,479,명/Noun,711,303,408,0.0033900188951872853,0.0045536329105488795,0.5738396624472574
480,480,OOO/Alpha,708,91,617,0.001033677892630877,0.006874875052755503,0.8714689265536724
481,481,결국/Adverb,708,253,455,0.0028342780926975657,0.005075634732002044,0.6426553672316384
482,482,지루함/Noun,707,100,607,0.0011337112370790265,0.006763810835425043,0.8585572842998586
483,483,추억/Noun,707,576,131,0.006424363676781149,0.0014771540904951245,0.8147100424328148
484,484,나쁘다/Adjective,707,269,438,0.003012115149494276,0.004886825562540261,0.6195190947666195
485,485,대/Suffix,707,376,331,0.0042014004668222745,0.0036984384371043337,0.5318246110325319
486,486,소리/Noun,705,202,503,0.0022674224741580525,0.005608742975188254,0.7134751773049646
487,487,니/Josa,705,294,411,0.0032899855507391353,0.004586952175748018,0.5829787234042553
488,488,따다/Verb,704,382,322,0.00426808936312104,0.0035984806415069195,0.5426136363636364
489,489,이딴/Modifier,703,26,677,0.00031121484939424253,0.007541260356738266,0.9630156472261736
490,490,더럽다/Adjective,701,81,620,0.0009225297321329332,0.00690819431795464,0.8844507845934381
491,491,준/Noun,699,391,308,0.004368122707569189,0.003442990737244275,0.5593705293276109
492,492,영화관/Noun,695,298,397,0.003334444814938313,0.004431462271485373,0.5712230215827339
493,493,마다/Josa,694,480,214,0.005357341336000889,0.0023989870943379463,0.69164265129683
494,494,살/Noun,690,420,270,0.004690452373013226,0.003020946711388525,0.6086956521739131
495,495,인상/Noun,689,547,142,0.006102034011337114,0.0015993247295586306,0.7939042089985486
496,496,이지만/Josa,687,427,260,0.0047682560853617864,0.0029098824940580643,0.6215429403202329
497,497,어이없다/Adjective,686,55,631,0.0006335445148382794,0.007030364957018148,0.9198250728862972
498,498,오늘/Noun,685,462,223,0.005157274647104589,0.002498944889935361,0.6744525547445256
499,499,감정/Noun,684,445,239,0.004968322774258086,0.0026766476376640968,0.6505847953216374
500,500,서다/Verb,684,373,311,0.00416805601867289,0.003476310002443413,0.5453216374269005
501,501,부족하다/Adjective,681,215,466,0.00241191508280538,0.0051978053710655505,0.6842878120411159
502,502,안타깝다/Adjective,681,384,297,0.0042903189952206286,0.003320820098180768,0.5638766519823789
503,503,전/Modifier,680,199,481,0.0022340780260086696,0.005364401697061241,0.7073529411764706
504,504,정신/Noun,678,183,495,0.0020562409692119594,0.0055198916013238855,0.7300884955752213
505,505,엔딩/Noun,678,431,247,0.004812715349560965,0.002765499011528466,0.6356932153392331
506,506,라면/Noun,678,389,289,0.004345893075469601,0.0032319687243164,0.5737463126843658
507,507,접/Noun,676,122,554,0.0013782371901745027,0.006175170483573602,0.8195266272189349
508,508,팬/Noun,676,366,310,0.00409025230632433,0.0034652035807103665,0.5414201183431953
509,509,잊다/Verb,674,570,104,0.0063576747804823825,0.001177280703702881,0.8456973293768546
510,510,졸작/Noun,672,34,638,0.0004001333777925976,0.007108109909149471,0.949404761904762
511,511,제발/Noun,671,179,492,0.002011781705012782,0.005486572336124747,0.7332339791356185
512,512,자신/Noun,671,422,249,0.004712682005112816,0.002787711854994558,0.6289120715350224
513,513,니까/Josa,668,282,386,0.003156607758141603,0.0043092916324218656,0.5778443113772455
514,514,아무리/Adverb,666,114,552,0.0012893186617761474,0.00615295764010751,0.8288288288288288
515,515,그저/Adverb,666,221,445,0.002478603979104145,0.004964570514671583,0.6681681681681682
516,516,코믹/Noun,662,371,291,0.004145826386573302,0.003254181567782492,0.5604229607250756
517,517,♥/Foreign,660,651,9,0.007257974880515727,0.00012217063906350652,0.9863636363636364
518,518,평가/Noun,660,352,308,0.00393464488162721,0.003442990737244275,0.5333333333333333
519,519,킬링타임/Noun,659,186,473,0.0020895854173613427,0.0052755503231968716,0.7177541729893778
520,520,~~~/Punctuation,657,400,257,0.004468156052017339,0.002876563228858926,0.60882800608828
521,521,함께/Adverb,656,544,112,0.0060686895631877295,0.0012661320775672494,0.8292682926829268
522,522,그렇게/Adverb,656,251,405,0.002812048460597977,0.00452031364534974,0.6173780487804879
523,523,음/Noun,654,290,364,0.003245526286539958,0.004064950354294853,0.5565749235474006
524,524,배우다/Verb,654,334,320,0.0037345781927309103,0.003576267798040827,0.5107033639143731
525,525,캐스팅/Noun,653,219,434,0.002456374347004557,0.0048423998756080755,0.664624808575804
526,526,8/Number,653,388,265,0.004334778259419807,0.0029654146027232944,0.5941807044410413
527,527,대해/Noun,651,506,145,0.005646326553295543,0.001632643994757769,0.7772657450076805
528,528,얼마나/Noun,649,330,319,0.003690118928531733,0.0035651613763077812,0.5084745762711864
529,529,어색하다/Adjective,642,123,519,0.001389352006224297,0.0057864457229169905,0.8084112149532711
530,530,포스터/Noun,642,205,437,0.002300766922307436,0.0048757191408072146,0.6806853582554517
531,531,적다/Verb,641,432,209,0.00482383016561076,0.002343454985672716,0.6739469578783152
532,532,몰입도/Noun,638,412,226,0.004601533844614872,0.0025322641551344988,0.64576802507837
533,533,뒤/Noun,637,294,343,0.0032899855507391353,0.0038317154979008857,0.5384615384615384
534,534,엉/Exclamation,636,103,533,0.0011670556852284096,0.005941935627179635,0.8380503144654088
535,535,쓸다/Verb,636,162,474,0.0018228298321662773,0.005286656744929919,0.7452830188679245
536,536,자/Suffix,632,213,419,0.002389685450705791,0.004675803549612386,0.6629746835443038
537,537,갈수록/Noun,631,192,439,0.002156274313660109,0.004897931984273306,0.6957210776545166
538,538,스릴/Noun,631,370,261,0.004134711570523508,0.0029209889157911107,0.5863708399366085
539,539,개연/Noun,630,55,575,0.0006335445148382794,0.00640840533996757,0.9126984126984128
540,540,망하다/Adjective,630,89,541,0.0010114482605312882,0.0060307870010440036,0.8587301587301587
541,541,애니메이션/Noun,630,418,212,0.004668222740913638,0.002376774250871854,0.6634920634920635
542,542,시/Modifier,626,284,342,0.003178837390241192,0.00382060907616784,0.5463258785942492
543,543,배경/Noun,625,369,256,0.004123596754473714,0.00286545680712588,0.5904
544,544,데/Noun,624,271,353,0.0030343447815938647,0.003942779715231347,0.5657051282051282
545,545,든/Josa,623,361,262,0.00403467822607536,0.002932095337524157,0.579454253611557
546,546,!!!!/Punctuation,622,460,162,0.005135045015005002,0.001821453164219552,0.7395498392282959
547,547,엄마/Noun,622,344,278,0.003845726353228854,0.003109798085252893,0.5530546623794212
548,548,티비/Noun,621,299,322,0.003345559630988107,0.0035984806415069195,0.5185185185185185
549,549,문제/Noun,619,201,418,0.002256307658108259,0.00466469712787934,0.6752827140549273
550,550,진부하다/Adjective,618,109,509,0.0012337445815271755,0.005675381505586529,0.8236245954692557
551,551,살리다/Verb,618,260,358,0.0029120818050461265,0.003998311823896578,0.5792880258899676
552,552,이름/Noun,617,239,378,0.002678670668000445,0.004220440258557497,0.6126418152350082
553,553,지/Modifier,617,246,371,0.002756474380349005,0.004142695306426175,0.6012965964343598
554,554,하/Exclamation,614,213,401,0.002389685450705791,0.004475887958417557,0.6530944625407166
555,555,ㅠㅠㅠ/KoreanParticle,611,496,115,0.005535178392797599,0.0012994513427663874,0.8117839607201309
556,556,두다/Verb,611,285,326,0.003189952206290986,0.003642906328439104,0.5335515548281505
557,557,나가다/Verb,610,191,419,0.0021451594976103147,0.004675803549612386,0.6868852459016394
558,558,충격/Noun,610,399,211,0.004457041235967545,0.0023656678291388076,0.6540983606557377
559,559,비다/Verb,610,253,357,0.0028342780926975657,0.003987205402163531,0.5852459016393443
560,560,맘/Noun,609,373,236,0.00416805601867289,0.0026433283724649594,0.6124794745484401
561,561,구성/Noun,605,285,320,0.003189952206290986,0.003576267798040827,0.5289256198347108
562,562,유쾌하다/Adjective,603,554,49,0.006179837723685673,0.0005664275083853486,0.9187396351575456
563,563,머리/Noun,603,235,368,0.002634211403801267,0.004109376041227037,0.6102819237147595
564,564,옛날/Noun,602,317,285,0.0035456263198844064,0.003187543037384216,0.5265780730897011
565,565,보단/Josa,600,239,361,0.002678670668000445,0.004031631089095715,0.6016666666666667
566,566,완벽하다/Adjective,599,512,87,0.00571301544959431,0.0009884715342410985,0.8547579298831386
567,567,질/Noun,599,104,495,0.001178170501278204,0.0055198916013238855,0.8263772954924875
568,568,여/Josa,598,263,335,0.0029454262531955103,0.003742864124036518,0.560200668896321
569,569,를/Noun,597,280,317,0.0031343781260420142,0.003542948532841689,0.5309882747068677
570,570,영화인/Noun,596,336,260,0.003756807824830499,0.0029098824940580643,0.5637583892617449
571,571,이후/Noun,596,301,295,0.003367789263087696,0.0032986072547146763,0.5050335570469798
572,572,만화/Noun,595,266,329,0.002978770701344893,0.0036762255936382423,0.5529411764705883
573,573,그래서/Adverb,595,288,307,0.003223296654440369,0.0034318843155112288,0.5159663865546219
574,574,놀라다/Verb,594,366,228,0.00409025230632433,0.002554476998600591,0.6161616161616161
575,575,적/Noun,593,406,187,0.004534844948316105,0.002099113707545703,0.684654300168634
576,576,예술/Noun,593,258,335,0.0028898521729465373,0.003742864124036518,0.5649241146711635
577,577,기도/Noun,591,342,249,0.003823496721129265,0.002787711854994558,0.5786802030456852
578,578,강추/Noun,590,547,43,0.006102034011337114,0.0004997889779870722,0.9271186440677966
579,579,행복하다/Adjective,590,524,66,0.0058463932421918404,0.0007552366778471312,0.8881355932203391
580,580,얘기/Noun,590,217,373,0.0024341447149049678,0.004164908149892268,0.6322033898305085
581,581,대/Foreign,587,217,370,0.0024341447149049678,0.00413158888469313,0.6303236797274276
582,582,후회/Noun,587,289,298,0.0032344114704901637,0.003331926519913814,0.5076660988074957
583,583,장르/Noun,583,201,382,0.002256307658108259,0.004264865945489682,0.6552315608919382
584,584,집/Noun,583,280,303,0.0031343781260420142,0.003387458628579045,0.5197255574614065
585,585,더빙/Noun,582,150,432,0.0016894520395687453,0.004820187032141985,0.7422680412371134
586,586,어울리다/Verb,581,319,262,0.0035678559519839955,0.002932095337524157,0.5490533562822719
587,587,만/Suffix,580,315,265,0.003523396687784817,0.0029654146027232944,0.5431034482758621
588,588,어디/Noun,579,237,342,0.002656441035900856,0.00382060907616784,0.5906735751295337
589,589,주연/Noun,577,225,352,0.0025230632433033235,0.0039316732934983,0.6100519930675911
590,590,얼굴/Noun,576,199,377,0.0022340780260086696,0.004209333836824453,0.6545138888888888
591,591,은/Noun,576,256,320,0.0028676225408469486,0.003576267798040827,0.5555555555555556
592,592,후반/Noun,574,266,308,0.002978770701344893,0.003442990737244275,0.5365853658536586
593,593,즐겁다/Adjective,573,495,78,0.005524063576747805,0.0008885137386436838,0.8638743455497382
594,594,들이다/Verb,573,233,340,0.0026119817717016785,0.0037983962327017475,0.5933682373472949
595,595,같이/Adverb,572,327,245,0.003656774480382349,0.0027432861680623736,0.5716783216783217
596,596,웃기/Noun,571,344,227,0.003845726353228854,0.0025433705768675447,0.6024518388791593
597,597,머/Noun,570,97,473,0.0011003667889296432,0.0052755503231968716,0.8298245614035088
598,598,집중/Noun,568,252,316,0.002823163276647772,0.003531842111108643,0.5563380281690141
599,599,비/Noun,563,225,338,0.0025230632433033235,0.003776183389235656,0.6003552397868561
600,600,여기/Noun,563,228,335,0.002556407691452707,0.003742864124036518,0.5950266429840142
601,601,꽤/Noun,562,441,121,0.00492386351005891,0.001366089873164664,0.7846975088967971
602,602,그것/Noun,559,278,281,0.003112148493942425,0.0031431173504520315,0.5026833631484794
603,603,짜증/Noun,558,23,535,0.00027787040124485944,0.005964148470645727,0.9587813620071683
604,604,9/Number,557,382,175,0.00426808936312104,0.00196583664674915,0.6858168761220825
605,605,매우/Noun,557,343,214,0.0038346115371790603,0.0023989870943379463,0.6157989228007181
606,606,ㅡ/KoreanParticle,556,157,399,0.0017672557519173055,0.004453675114951465,0.7176258992805755
607,607,날/Noun,556,337,219,0.003767922640880293,0.0024545192030031764,0.6061151079136691
608,608,ㅎㅎㅎ/KoreanParticle,555,434,121,0.004846059797710348,0.001366089873164664,0.781981981981982
609,609,읽다/Verb,555,242,313,0.0027120151161498275,0.003498522845909505,0.563963963963964
610,610,너무나/Adverb,552,365,187,0.004079137490274536,0.002099113707545703,0.6612318840579711
611,611,이리/Adverb,552,199,353,0.0022340780260086696,0.003942779715231347,0.6394927536231884
612,612,진/Noun,552,216,336,0.002423029898855174,0.0037539705457695642,0.6086956521739131
613,613,누구/Noun,552,311,241,0.0034789374235856397,0.002698860481130189,0.5634057971014492
614,614,???/Punctuation,551,142,409,0.0016005335111703902,0.004564739332281925,0.7422867513611615
615,615,두/Noun,551,362,189,0.004045793042125153,0.002121326551011795,0.6569872958257713
616,616,다운/Noun,551,275,276,0.003078804045793042,0.003087585241786801,0.5009074410163339
617,617,새롭다/Adjective,549,377,172,0.004212515282872069,0.0019325173815500122,0.6867030965391621
618,618,전쟁/Noun,549,326,223,0.0036456596643325546,0.002498944889935361,0.5938069216757741
619,619,건가/Noun,546,124,422,0.0014004668222740914,0.004709122814811524,0.7728937728937729
620,620,아직/Adverb,546,363,183,0.004056907858174947,0.0020546880206135185,0.6648351648351648
621,621,생기다/Verb,545,190,355,0.00213404468156052,0.003964992558697439,0.6513761467889908
622,622,상황/Noun,545,243,302,0.0027231299321996217,0.0033763522068459982,0.5541284403669725
623,623,언제/Noun,545,290,255,0.003245526286539958,0.0028543503853928343,0.5321100917431193
624,624,멀다/Adjective,544,178,366,0.0020006668889629878,0.004087163197760945,0.6727941176470589
625,625,작/Modifier,544,183,361,0.0020562409692119594,0.004031631089095715,0.6636029411764706
626,626,소름/Noun,540,437,103,0.004879404245859731,0.001166174281969835,0.8092592592592592
627,627,심하다/Adjective,539,81,458,0.0009225297321329332,0.005108953997201182,0.8497217068645642
628,628,충분하다/Adjective,539,414,125,0.004623763476714461,0.001410515560096848,0.7680890538033395
629,629,불쌍하다/Adjective,539,206,333,0.0023118817383572304,0.0037206512805704256,0.6178107606679035
630,630,글/Noun,538,195,343,0.002189618761809492,0.0038317154979008857,0.6375464684014871
631,631,식/Suffix,534,210,324,0.002356341002556408,0.003620693484973011,0.6067415730337079
632,632,걸작/Noun,533,459,74,0.005123930198955207,0.0008440880517114996,0.8611632270168855
633,633,그나마/Adverb,532,40,492,0.0004668222740913638,0.005486572336124747,0.924812030075188
634,634,억지/Noun,527,72,455,0.0008224963876847838,0.005075634732002044,0.8633776091081594
635,635,대체/Noun,527,89,438,0.0010114482605312882,0.004886825562540261,0.8311195445920304
636,636,다큐/Noun,527,223,304,0.0025008336112037344,0.0033985650503120905,0.5768500948766604
637,637,비슷하다/Adjective,527,264,263,0.002956541069245304,0.002943201759257202,0.5009487666034156
638,638,시절/Noun,526,397,129,0.004434811603867956,0.0014549412470290322,0.7547528517110266
639,639,등/Noun,526,266,260,0.002978770701344893,0.0029098824940580643,0.5057034220532319
640,640,존나/Noun,525,122,403,0.0013782371901745027,0.004498100801883649,0.7676190476190476
641,641,약간/Noun,525,357,168,0.003990218961876181,0.001888091694617828,0.68
642,642,역사/Noun,525,318,207,0.0035567411359342,0.002321242142206624,0.6057142857142858
643,643,궁금하다/Adjective,524,199,325,0.0022340780260086696,0.003631799906706057,0.6202290076335878
644,644,분들/Suffix,524,307,217,0.0034344781593864623,0.0024323063595370845,0.5858778625954199
645,645,밉다/Adjective,524,257,267,0.0028787373568967428,0.002987627446189387,0.5095419847328244
646,646,실화/Noun,522,331,191,0.0037012337445815275,0.0021435393944778877,0.6340996168582376
647,647,인물/Noun,521,236,285,0.002645326219851061,0.003187543037384216,0.5470249520153551
648,648,예전/Noun,521,277,244,0.003101033677892631,0.002732179746329328,0.5316698656429942
649,649,훨씬/Adverb,521,249,272,0.0027898188284983887,0.0030431595548546173,0.5220729366602687
650,650,해도/Noun,520,170,350,0.0019117483605646328,0.003909460450032209,0.6730769230769231
651,651,아무/Modifier,518,169,349,0.0019006335445148387,0.0038983540282991626,0.6737451737451737
652,652,극/Modifier,518,220,298,0.0024674891630543515,0.003331926519913814,0.5752895752895753
653,653,씬/Noun,515,279,236,0.00312326330999222,0.0026433283724649594,0.541747572815534
654,654,B/Alpha,514,133,381,0.001500500166722241,0.004253759523756636,0.7412451361867705
655,655,한마디/Noun,514,156,358,0.0017561409358675113,0.003998311823896578,0.6964980544747081
656,656,6/Number,513,237,276,0.002656441035900856,0.003087585241786801,0.5380116959064327
657,657,그대로/Noun,512,274,238,0.003067689229743248,0.0026655412159310517,0.53515625
658,658,어렵다/Adjective,511,267,244,0.0029898855173946877,0.002732179746329328,0.5225048923679061
659,659,순수하다/Adjective,506,433,73,0.004834944981660554,0.0008329816299784535,0.8557312252964426
660,660,휴/Exclamation,506,86,420,0.0009781038123819054,0.004686909971345432,0.8300395256916996
661,661,자기/Noun,506,160,346,0.001800600200066689,0.0038650347631000244,0.6837944664031621
662,662,누가/Noun,504,180,324,0.0020228965210625765,0.003620693484973011,0.6428571428571429
663,663,급/Suffix,504,211,293,0.002367455818606202,0.003276394411248584,0.5813492063492064
664,664,비교/Noun,504,220,284,0.0024674891630543515,0.0031764366156511693,0.5634920634920635
665,665,상당하다/Adjective,503,306,197,0.003423363343336668,0.0022101779248761637,0.6083499005964215
666,666,작/Noun,503,224,279,0.002511948427253529,0.003120904506985939,0.5546719681908548
667,667,",,,/Punctuation",503,232,271,0.002600866955651884,0.003032053133121571,0.5387673956262425
668,668,보/Noun,502,287,215,0.0032121818383905746,0.0024100935160709922,0.5717131474103586
669,669,니/Noun,502,220,282,0.0024674891630543515,0.003154223772185077,0.5617529880478087
670,670,만점/Noun,501,423,78,0.00472379682116261,0.0008885137386436838,0.844311377245509
671,671,초딩/Noun,501,192,309,0.002156274313660109,0.003454097158977321,0.6167664670658682
672,672,주/Modifier,501,217,284,0.0024341447149049678,0.0031764366156511693,0.5668662674650699
673,673,비디오/Noun,500,226,274,0.0025341780593531177,0.003065372398320709,0.5479999999999999
674,674,책/Noun,499,238,261,0.00266755585195065,0.0029209889157911107,0.5230460921843687
675,675,간만/Noun,496,400,96,0.004468156052017339,0.0010884293298385123,0.8064516129032258
676,676,쉬다/Verb,496,257,239,0.0028787373568967428,0.0026766476376640968,0.5181451612903226
677,677,몇/Modifier,495,218,277,0.0024452595309547628,0.0030986916635198478,0.5595959595959596
678,678,드리다/Verb,495,270,225,0.0030232299655440697,0.0025211577334014533,0.5454545454545454
679,679,필요하다/Adjective,494,325,169,0.003634544848282761,0.0018991981163508738,0.6578947368421053
680,680,부/Noun,494,227,267,0.0025452928754029127,0.002987627446189387,0.5404858299595142
681,681,만나다/Verb,491,299,192,0.003345559630988107,0.0021546458162109328,0.6089613034623218
682,682,자/Noun,489,199,290,0.0022340780260086696,0.0032430751460494453,0.5930470347648262
683,683,라도/Josa,488,145,343,0.0016338779593197733,0.0038317154979008857,0.7028688524590164
684,684,~!/Punctuation,487,385,102,0.0043014338112704244,0.001155067860236789,0.7905544147843943
685,685,CG/Alpha,487,126,361,0.0014226964543736804,0.004031631089095715,0.7412731006160165
686,686,굉장하다/Adjective,486,338,148,0.0037790374569300882,0.001665963259956907,0.6954732510288066
687,687,전체/Noun,486,158,328,0.0017783705679671,0.003665119171905196,0.6748971193415638
688,688,로맨스/Noun,486,243,243,0.0027231299321996217,0.0027210733245962818,0.5
689,689,떠나다/Verb,484,271,213,0.0030343447815938647,0.0023878806726049,0.5599173553719008
690,690,뿐/Suffix,482,150,332,0.0016894520395687453,0.0037095448588373796,0.6887966804979253
691,691,감성/Noun,482,311,171,0.0034789374235856397,0.0019214109598169665,0.6452282157676349
692,692,다음/Noun,482,299,183,0.003345559630988107,0.0020546880206135185,0.6203319502074689
693,693,사회/Noun,481,337,144,0.003767922640880293,0.0016215375730247227,0.7006237006237006
694,694,오/Modifier,481,187,294,0.0021007002334111373,0.00328750083298163,0.6112266112266113
695,695,네이버/Noun,480,179,301,0.002011781705012782,0.0033652457851129523,0.6270833333333333
696,696,아들/Noun,480,261,219,0.002923196621095921,0.0024545192030031764,0.54375
697,697,발연기/Noun,477,34,443,0.0004001333777925976,0.004942357671205491,0.9287211740041929
698,698,무슨/Modifier,476,124,352,0.0014004668222740914,0.0039316732934983,0.7394957983193278
699,699,그런/Modifier,475,189,286,0.002122929865510726,0.003198649459117261,0.6021052631578947
700,700,ㅜ/KoreanParticle,474,275,199,0.003078804045793042,0.002232390768342256,0.5801687763713079
701,701,당하다/Adjective,473,184,289,0.002067355785261754,0.0032319687243164,0.6109936575052854
702,702,네/Determiner,472,250,222,0.002800933644548183,0.0024878384682023146,0.5296610169491526
703,703,남기다/Verb,471,253,218,0.0028342780926975657,0.0024434127812701305,0.5371549893842887
704,704,따르다/Verb,470,174,296,0.0019562076247638107,0.0033097136764477218,0.6297872340425532
705,705,바로/Noun,469,253,216,0.0028342780926975657,0.0024211999378040377,0.5394456289978679
706,706,판/Noun,468,203,265,0.002278537290207847,0.0029654146027232944,0.5662393162393162
707,707,ㅉㅉ/KoreanParticle,466,72,394,0.0008224963876847838,0.004398143006286235,0.8454935622317596
708,708,이르다/Verb,466,177,289,0.001989552072913193,0.0032319687243164,0.6201716738197425
709,709,여배우/Noun,466,198,268,0.002222963209958875,0.0029987338679224327,0.575107296137339
710,710,꿈/Noun,465,353,112,0.003945759697677003,0.0012661320775672494,0.7591397849462366
711,711,돌리다/Verb,463,161,302,0.0018117150161164836,0.0033763522068459982,0.652267818574514
712,712,주제/Noun,463,191,272,0.0021451594976103147,0.0030431595548546173,0.5874730021598272
713,713,혼자/Noun,462,213,249,0.002389685450705791,0.002787711854994558,0.5389610389610391
714,714,에요/Josa,461,357,104,0.003990218961876181,0.001177280703702881,0.7744034707158352
715,715,나이/Noun,460,314,146,0.0035122818717350226,0.001643750416490815,0.6826086956521739
716,716,반/Modifier,460,206,254,0.0023118817383572304,0.002843243963659788,0.5521739130434783
717,717,보다는/Josa,459,233,226,0.0026119817717016785,0.0025322641551344988,0.5076252723311547
718,718,이/Foreign,458,326,132,0.0036456596643325546,0.0014882605122281704,0.7117903930131004
719,719,터지다/Verb,458,267,191,0.0029898855173946877,0.0021435393944778877,0.5829694323144105
720,720,코/Noun,458,203,255,0.002278537290207847,0.0028543503853928343,0.5567685589519651
721,721,화려하다/Adjective,458,251,207,0.002812048460597977,0.002321242142206624,0.5480349344978166
722,722,;;;/Punctuation,457,106,351,0.0012004001333777929,0.003920566871765255,0.7680525164113785
723,723,사랑스럽다/Adjective,456,433,23,0.004834944981660554,0.00027766054332615115,0.949561403508772
724,724,돋다/Verb,454,348,106,0.003890185617428032,0.0011994935471689732,0.7665198237885462
725,725,교훈/Noun,454,274,180,0.003067689229743248,0.0020213687554143807,0.6035242290748899
726,726,엄청나다/Adjective,453,290,163,0.003245526286539958,0.0018325595859525977,0.6401766004415012
727,727,편이/Noun,450,237,213,0.002656441035900856,0.0023878806726049,0.5266666666666666
728,728,소설/Noun,449,173,276,0.001945092808714016,0.003087585241786801,0.6146993318485523
729,729,죠/Josa,448,250,198,0.002800933644548183,0.002221284346609209,0.5580357142857143
730,730,이라도/Josa,446,106,340,0.0012004001333777929,0.0037983962327017475,0.7623318385650224
731,731,잔인하다/Adjective,446,190,256,0.00213404468156052,0.00286545680712588,0.5739910313901345
732,732,감사하다/Verb,445,404,41,0.004512615316216518,0.00047757613452098,0.907865168539326
733,733,바라다/Verb,444,271,173,0.0030343447815938647,0.0019436238032830586,0.6103603603603603
734,734,힘/Noun,443,266,177,0.002978770701344893,0.0019880494902152425,0.6004514672686229
735,735,거의/Noun,443,201,242,0.002256307658108259,0.0027099669028632354,0.54627539503386
736,736,시즌/Noun,442,315,127,0.003523396687784817,0.00143272840356294,0.7126696832579186
737,737,안보/Noun,442,216,226,0.002423029898855174,0.0025322641551344988,0.5113122171945701
738,738,너/Noun,438,183,255,0.0020562409692119594,0.0028543503853928343,0.5821917808219178
739,739,빨리/Adverb,437,191,246,0.0021451594976103147,0.00275439258979542,0.562929061784897
740,740,어/Suffix,437,220,217,0.0024674891630543515,0.0024323063595370845,0.5034324942791762
741,741,방송/Noun,436,131,305,0.001478270534622652,0.0034096714720451365,0.6995412844036697
742,742,지나다/Verb,435,309,126,0.003456707791486051,0.001421621981829894,0.7103448275862069
743,743,모든/Modifier,434,259,175,0.002900966988996332,0.00196583664674915,0.5967741935483871
744,744,존재/Noun,434,257,177,0.0028787373568967428,0.0019880494902152425,0.5921658986175116
745,745,년/Noun,434,223,211,0.0025008336112037344,0.0023656678291388076,0.5138248847926268
746,746,삼류/Noun,433,33,400,0.00038901856174280313,0.004464781536684511,0.9237875288683602
747,747,몇번/Noun,431,334,97,0.0037345781927309103,0.0010995357515715587,0.7749419953596288
748,748,진정하다/Adjective,431,313,118,0.0035011670556852285,0.0013327706079655256,0.7262180974477959
749,749,말고/Josa,431,182,249,0.002045126153162165,0.002787711854994558,0.5777262180974478
750,750,타다/Verb,431,214,217,0.0024008002667555853,0.0024323063595370845,0.5034802784222738
751,751,독특하다/Adjective,429,293,136,0.003278870734689341,0.0015326861991603546,0.6829836829836831
752,752,잡다/Verb,429,149,280,0.0016783372235189508,0.003132010928718985,0.6526806526806527
753,753,죽/Noun,428,138,290,0.0015560742469712125,0.0032430751460494453,0.677570093457944
754,754,....../Punctuation,427,155,272,0.001745026119817717,0.0030431595548546173,0.6370023419203747
755,755,당신/Noun,427,243,184,0.0027231299321996217,0.002065794442346565,0.5690866510538641
756,756,+/Punctuation,426,174,252,0.0019562076247638107,0.002821031120193696,0.5915492957746479
757,757,목소리/Noun,426,184,242,0.002067355785261754,0.0027099669028632354,0.5680751173708921
758,758,여주/Noun,424,130,294,0.0014671557185728574,0.00328750083298163,0.6933962264150944
759,759,담다/Verb,424,278,146,0.003112148493942425,0.001643750416490815,0.6556603773584906
760,760,가볍다/Adjective,423,287,136,0.0032121818383905746,0.0015326861991603546,0.6784869976359338
761,761,만하/Noun,422,212,210,0.002378570634655997,0.002354561407405762,0.5023696682464455
762,762,질질/Noun,419,72,347,0.0008224963876847838,0.0038761411848330703,0.8281622911694511
763,763,전부/Noun,418,133,285,0.001500500166722241,0.003187543037384216,0.6818181818181818
764,764,바/Noun,418,165,253,0.001856174280315661,0.0028321375419267424,0.6052631578947368
765,765,줄거리/Noun,417,136,281,0.0015338446148716238,0.0031431173504520315,0.6738609112709832
766,766,맛/Noun,417,190,227,0.00213404468156052,0.0025433705768675447,0.5443645083932853
767,767,흥미롭다/Adjective,417,215,202,0.00241191508280538,0.0022657100335413943,0.5155875299760192
768,768,신/Noun,416,182,234,0.002045126153162165,0.002621115528998867,0.5625
769,769,라니/Josa,416,226,190,0.0025341780593531177,0.002132432972744841,0.5432692307692307
770,770,점주/Noun,415,98,317,0.0011114816049794377,0.003542948532841689,0.763855421686747
771,771,실제/Noun,415,250,165,0.002800933644548183,0.0018547724294186894,0.6024096385542169
772,772,풀다/Verb,415,214,201,0.0024008002667555853,0.0022546036118083475,0.5156626506024097
773,773,망치다/Verb,414,42,372,0.0004890519061909527,0.004153801728159222,0.8985507246376812
774,774,답/Noun,413,100,313,0.0011337112370790265,0.003498522845909505,0.7578692493946732
775,775,넘치다/Adjective,412,298,114,0.003334444814938313,0.0012883449210333415,0.7233009708737864
776,776,에선/Josa,411,226,185,0.0025341780593531177,0.002076900864079611,0.5498783454987834
777,777,성하다/Adjective,410,37,373,0.0004334778259419807,0.004164908149892268,0.9097560975609756
778,778,그러나/Conjunction,409,204,205,0.002289652106257641,0.002299029298740532,0.5012224938875306
779,779,낭비/Noun,408,8,400,0.00011114816049794375,0.004464781536684511,0.9803921568627452
780,780,뜨다/Verb,408,147,261,0.0016561075914193618,0.0029209889157911107,0.6397058823529411
781,781,으로도/Josa,408,240,168,0.0026897854840502392,0.001888091694617828,0.5882352941176471
782,782,이번/Noun,408,215,193,0.00241191508280538,0.0021657522379439787,0.5269607843137255
783,783,각본/Noun,407,121,286,0.0013671223741247086,0.003198649459117261,0.7027027027027027
784,784,나라/Noun,407,193,214,0.0021673891297099034,0.0023989870943379463,0.5257985257985258
785,785,맞추다/Verb,404,109,295,0.0012337445815271755,0.0032986072547146763,0.7301980198019802
786,786,재/Noun,401,255,146,0.002856507724797155,0.001643750416490815,0.6359102244389028
787,787,필요/Noun,401,226,175,0.0025341780593531177,0.00196583664674915,0.5635910224438903
788,788,가치/Noun,401,207,194,0.0023229965544070245,0.002176858659677025,0.5162094763092271
789,789,성룡/Noun,398,235,163,0.002634211403801267,0.0018325595859525977,0.5904522613065326
790,790,란/Noun,398,215,183,0.00241191508280538,0.0020546880206135185,0.5402010050251256
791,791,순간/Noun,397,263,134,0.0029454262531955103,0.0015104733556942625,0.6624685138539043
792,792,어른/Noun,397,249,148,0.0027898188284983887,0.001665963259956907,0.6272040302267002
793,793,평론가/Noun,397,239,158,0.002678670668000445,0.0017770274772873676,0.6020151133501259
794,794,갑자기/Noun,396,103,293,0.0011670556852284096,0.003276394411248584,0.73989898989899
795,795,제작/Noun,396,143,253,0.0016116483272201846,0.0028321375419267424,0.6388888888888888
796,796,판타지/Noun,396,181,215,0.00203401133711237,0.0024100935160709922,0.5429292929292929
797,797,이하/Noun,395,34,361,0.0004001333777925976,0.004031631089095715,0.9139240506329114
798,798,선/Noun,395,188,207,0.002111815049460932,0.002321242142206624,0.5240506329113924
799,799,상영/Noun,393,197,196,0.002211848393909081,0.0021990715031431174,0.5012722646310432
800,800,기다리다/Verb,392,279,113,0.00312326330999222,0.0012772384993002955,0.7117346938775511
801,801,간다/Noun,392,151,241,0.0017005668556185395,0.002698860481130189,0.6147959183673469
802,802,너무하다/Adjective,390,50,340,0.0005779704345893076,0.0037983962327017475,0.8717948717948718
803,803,의도/Noun,390,66,324,0.0007558074913860174,0.003620693484973011,0.8307692307692308
804,804,발/Noun,390,81,309,0.0009225297321329332,0.003454097158977321,0.7923076923076923
805,805,영/Noun,390,107,283,0.001211514949427587,0.0031653301939181234,0.7256410256410256
806,806,시청률/Noun,390,206,184,0.0023118817383572304,0.002065794442346565,0.5282051282051282
807,807,밑/Noun,388,119,269,0.0013448927420251196,0.0030098402896554786,0.6932989690721649
808,808,TV/Alpha,388,158,230,0.0017783705679671,0.002576689842066683,0.5927835051546392
809,809,땜/Noun,387,126,261,0.0014226964543736804,0.0029209889157911107,0.6744186046511628
810,810,넣다/Verb,385,86,299,0.0009781038123819054,0.00334303294164686,0.7766233766233767
811,811,아버지/Noun,385,261,124,0.002923196621095921,0.0013994091383638019,0.6779220779220779
812,812,히/Adverb,385,222,163,0.00248971879515394,0.0018325595859525977,0.5766233766233766
813,813,단순하다/Adjective,385,218,167,0.0024452595309547628,0.0018769852728847821,0.5662337662337662
814,814,다른/Modifier,385,175,210,0.001967322440813605,0.002354561407405762,0.5454545454545454
815,815,오글거리다/Verb,384,63,321,0.0007224630432366343,0.0035873742197738727,0.8359375
816,816,보내다/Verb,384,257,127,0.0028787373568967428,0.00143272840356294,0.6692708333333334
817,817,만들어지다/Verb,384,249,135,0.0027898188284983887,0.0015215797774273086,0.6484375
818,818,한편/Noun,384,232,152,0.002600866955651884,0.0017103889468890912,0.6041666666666666
819,819,피/Noun,384,156,228,0.0017561409358675113,0.002554476998600591,0.59375
820,820,상/Suffix,383,204,179,0.002289652106257641,0.0020102623336813344,0.5326370757180157
821,821,굳다/Adjective,381,349,32,0.0039013004334778256,0.0003776183389235656,0.9160104986876642
822,822,요소/Noun,381,194,187,0.0021785039457596976,0.002099113707545703,0.5091863517060368
823,823,이기다/Verb,381,187,194,0.0021007002334111373,0.002176858659677025,0.5091863517060368
824,824,볼때/Noun,380,276,104,0.0030899188618428363,0.001177280703702881,0.7263157894736842
825,825,바꾸다/Verb,379,143,236,0.0016116483272201846,0.0026433283724649594,0.6226912928759895
826,826,들어가다/Verb,379,156,223,0.0017561409358675113,0.002498944889935361,0.5883905013192612
827,827,힘드다/Adjective,378,165,213,0.001856174280315661,0.0023878806726049,0.5634920634920635
828,828,화면/Noun,378,168,210,0.0018895187284650441,0.002354561407405762,0.5555555555555556
829,829,면/Noun,377,205,172,0.002300766922307436,0.0019325173815500122,0.5437665782493368
830,830,10년/Number,376,276,100,0.0030899188618428363,0.0011328550167706971,0.7340425531914894
831,831,세계/Noun,376,224,152,0.002511948427253529,0.0017103889468890912,0.5957446808510638
832,832,달다/Verb,376,176,200,0.001978437256863399,0.002243497190075301,0.5319148936170213
833,833,에서도/Josa,375,204,171,0.002289652106257641,0.0019214109598169665,0.544
834,834,첨/Adverb,374,111,263,0.0012559742136267645,0.002943201759257202,0.7032085561497327
835,835,막/Noun,373,133,240,0.001500500166722241,0.002687754059397144,0.6434316353887399
836,836,흥행/Noun,373,171,202,0.001922863176614427,0.0022657100335413943,0.5415549597855228
837,837,구/Noun,373,184,189,0.002067355785261754,0.002121326551011795,0.5067024128686327
838,838,일단/Noun,372,184,188,0.002067355785261754,0.0021102201292787486,0.5053763440860215
839,839,그때/Noun,371,269,102,0.003012115149494276,0.001155067860236789,0.7250673854447439
840,840,항상/Noun,371,247,124,0.0027675891963988,0.0013994091383638019,0.6657681940700808
841,841,갖다/Verb,371,162,209,0.0018228298321662773,0.002343454985672716,0.5633423180592992
842,842,좀비/Noun,370,127,243,0.0014338112704234743,0.0027210733245962818,0.6567567567567567
843,843,평/Noun,370,164,206,0.0018450594642658664,0.002310135720473578,0.5567567567567567
844,844,치고/Josa,368,112,256,0.0012670890296765588,0.00286545680712588,0.6956521739130435
845,845,둘/Noun,368,189,179,0.002122929865510726,0.0020102623336813344,0.5135869565217391
846,846,뻔/Noun,367,98,269,0.0011114816049794377,0.0030098402896554786,0.7329700272479565
847,847,선택/Noun,367,176,191,0.001978437256863399,0.0021435393944778877,0.5204359673024523
848,848,스타일/Noun,367,181,186,0.00203401133711237,0.0020880072858126568,0.5068119891008175
849,849,거지/Noun,366,99,267,0.001122596421029232,0.002987627446189387,0.7295081967213115
850,850,곳/Noun,365,245,120,0.002745359564299211,0.0013549834514316175,0.6712328767123288
851,851,원/Modifier,364,158,206,0.0017783705679671,0.002310135720473578,0.5659340659340659
852,852,역대/Noun,364,192,172,0.002156274313660109,0.0019325173815500122,0.5274725274725275
853,853,인거/Josa,363,176,187,0.001978437256863399,0.002099113707545703,0.5151515151515151
854,854,에서는/Josa,362,194,168,0.0021785039457596976,0.001888091694617828,0.5359116022099447
855,855,짱/Suffix,361,320,41,0.0035789707680337892,0.00047757613452098,0.8864265927977839
856,856,성/Modifier,361,130,231,0.0014671557185728574,0.002587796263799729,0.6398891966759003
857,857,진행/Noun,360,97,263,0.0011003667889296432,0.002943201759257202,0.7305555555555555
858,858,라서/Josa,360,173,187,0.001945092808714016,0.002099113707545703,0.5194444444444445
859,859,멜로/Noun,360,181,179,0.00203401133711237,0.0020102623336813344,0.5027777777777778
860,860,동안/Noun,359,206,153,0.0023118817383572304,0.0017214953686221373,0.5738161559888579
861,861,확실하다/Adjective,359,185,174,0.002078470601311548,0.0019547302250161047,0.5153203342618384
862,862,이에요/Josa,358,286,72,0.0032010670223407804,0.0008218752082454075,0.7988826815642458
863,863,더욱/Noun,358,281,77,0.0031454929420918084,0.0008774073169106378,0.7849162011173184
864,864,tv/Alpha,358,103,255,0.0011670556852284096,0.0028543503853928343,0.7122905027932961
865,865,낫다/Noun,358,124,234,0.0014004668222740914,0.002621115528998867,0.6536312849162011
866,866,탄탄하다/Adjective,357,320,37,0.0035789707680337892,0.0004331504475887958,0.8963585434173671
867,867,돋보이다/Verb,357,275,82,0.003078804045793042,0.000932939425575868,0.7703081232492998
868,868,초/Noun,357,148,209,0.0016672224074691564,0.002343454985672716,0.5854341736694678
869,869,극장판/Noun,357,194,163,0.0021785039457596976,0.0018325595859525977,0.5434173669467787
870,870,어이/Noun,355,29,326,0.0003445592975436257,0.003642906328439104,0.9183098591549296
871,871,상미/Noun,355,237,118,0.002656441035900856,0.0013327706079655256,0.6676056338028169
872,872,래/Josa,355,138,217,0.0015560742469712125,0.0024323063595370845,0.6112676056338028
873,873,가보다/Verb,355,163,192,0.0018339446482160719,0.0021546458162109328,0.5408450704225352
874,874,참고/Noun,354,65,289,0.0007446926753362233,0.0032319687243164,0.8163841807909604
875,875,불편하다/Adjective,354,99,255,0.001122596421029232,0.0028543503853928343,0.7203389830508474
876,876,중국/Noun,354,122,232,0.0013782371901745027,0.002598902685532775,0.655367231638418
877,877,완성/Noun,354,212,142,0.002378570634655997,0.0015993247295586306,0.5988700564971752
878,878,딸/Noun,354,158,196,0.0017783705679671,0.0021990715031431174,0.5536723163841808
879,879,몇/Noun,353,222,131,0.00248971879515394,0.0014771540904951245,0.6288951841359773
880,880,흐르다/Verb,352,282,70,0.003156607758141603,0.0007996623647793153,0.8011363636363636
881,881,그녀/Noun,352,266,86,0.002978770701344893,0.000977365112508052,0.7556818181818182
882,882,억지스럽다/Adjective,351,50,301,0.0005779704345893076,0.0033652457851129523,0.8575498575498576
883,883,걸리다/Verb,351,96,255,0.0010892519728798488,0.0028543503853928343,0.7264957264957265
884,884,끼다/Verb,351,101,250,0.0011448260531288204,0.0027988182767276037,0.7122507122507122
885,885,올리다/Verb,351,186,165,0.0020895854173613427,0.0018547724294186894,0.5299145299145299
886,886,즐기다/Verb,350,239,111,0.002678670668000445,0.0012550256558342032,0.6828571428571428
887,887,물론/Adverb,350,195,155,0.002189618761809492,0.0017437082120882294,0.5571428571428572
888,888,세/Noun,350,161,189,0.0018117150161164836,0.002121326551011795,0.54
889,889,세/Modifier,349,186,163,0.0020895854173613427,0.0018325595859525977,0.5329512893982808
890,890,거기/Noun,348,120,228,0.0013560075580749138,0.002554476998600591,0.6551724137931034
891,891,부르다/Verb,348,172,176,0.0019339779926642211,0.001976943068482197,0.5057471264367817
892,892,점점/Noun,347,138,209,0.0015560742469712125,0.002343454985672716,0.6023054755043228
893,893,듣다/Verb,346,185,161,0.002078470601311548,0.0018103467424865054,0.5346820809248555
894,894,이냐/Josa,345,47,298,0.0005446259864399244,0.003331926519913814,0.8637681159420291
895,895,수가/Noun,345,151,194,0.0017005668556185395,0.002176858659677025,0.5623188405797102
896,896,허무하다/Adjective,344,85,259,0.0009669889963321108,0.0028987760723250184,0.7529069767441859
897,897,어디서/Adverb,343,123,220,0.001389352006224297,0.0024656256247362228,0.641399416909621
898,898,관람/Noun,343,149,194,0.0016783372235189508,0.002176858659677025,0.5655976676384841
899,899,술/Noun,342,58,284,0.0006668889629876625,0.0031764366156511693,0.8304093567251462
900,900,전형/Noun,342,64,278,0.0007335778592864287,0.003109798085252893,0.8128654970760234
901,901,똑같다/Adjective,341,86,255,0.0009781038123819054,0.0028543503853928343,0.7478005865102639
902,902,편집/Noun,340,103,237,0.0011670556852284096,0.002654434794198005,0.6970588235294117
903,903,조/Modifier,340,169,171,0.0019006335445148387,0.0019214109598169665,0.5029411764705882
904,904,잠/Noun,339,82,257,0.0009336445481827276,0.002876563228858926,0.7581120943952803
905,905,프랑스/Noun,339,185,154,0.002078470601311548,0.0017326017903551833,0.5457227138643068
906,906,사건/Noun,337,130,207,0.0014671557185728574,0.002321242142206624,0.6142433234421365
907,907,쯤/Suffix,336,199,137,0.0022340780260086696,0.0015437926208934005,0.5922619047619048
908,908,화보/Noun,335,124,211,0.0014004668222740914,0.0023656678291388076,0.6298507462686567
909,909,잃다/Verb,335,152,183,0.001711681671668334,0.0020546880206135185,0.5462686567164179
910,910,화이팅/Noun,334,296,38,0.0033122151828387236,0.0004442568693218419,0.8862275449101796
911,911,때리다/Verb,334,116,218,0.0013115482938757365,0.0024434127812701305,0.6526946107784432
912,912,짧다/Adjective,334,217,117,0.0024341447149049678,0.0013216641862324795,0.6497005988023952
913,913,드/Noun,334,183,151,0.0020562409692119594,0.0016992825251560453,0.5479041916167665
914,914,에/Foreign,334,155,179,0.001745026119817717,0.0020102623336813344,0.5359281437125748
915,915,식상하다/Adjective,333,37,296,0.0004334778259419807,0.0033097136764477218,0.8888888888888888
916,916,마르다/Adjective,333,116,217,0.0013115482938757365,0.0024323063595370845,0.6516516516516516
917,917,리/Noun,333,148,185,0.0016672224074691564,0.002076900864079611,0.5555555555555556
918,918,메다/Verb,332,150,182,0.0016894520395687453,0.0020435815988804726,0.5481927710843374
919,919,평범하다/Adjective,332,154,178,0.0017339113037679224,0.001999155911948289,0.536144578313253
920,920,찾아보다/Verb,331,168,163,0.0018895187284650441,0.0018325595859525977,0.5075528700906344
921,921,꿀잼/Noun,330,316,14,0.0035345115038346118,0.00017770274772873674,0.9575757575757576
922,922,똥/Noun,330,29,301,0.0003445592975436257,0.0033652457851129523,0.912121212121212
923,923,그게/Noun,330,91,239,0.001033677892630877,0.0026766476376640968,0.7242424242424242
924,924,갈다/Verb,330,170,160,0.0019117483605646328,0.0017992403207534593,0.5151515151515151
925,925,아빠/Noun,330,162,168,0.0018228298321662773,0.001888091694617828,0.509090909090909
926,926,가지다/Verb,329,198,131,0.002222963209958875,0.0014771540904951245,0.6018237082066871
927,927,키/Noun,329,152,177,0.001711681671668334,0.0019880494902152425,0.5379939209726444
928,928,중반/Noun,328,125,203,0.0014115816383238858,0.0022768164552744398,0.6189024390243902
929,929,취향/Noun,328,127,201,0.0014338112704234743,0.0022546036118083475,0.6128048780487805
930,930,역/Noun,328,160,168,0.001800600200066689,0.001888091694617828,0.5121951219512195
931,931,-_-/Punctuation,327,38,289,0.000444592641991775,0.0032319687243164,0.8837920489296636
932,932,개그/Noun,327,99,228,0.001122596421029232,0.002554476998600591,0.6972477064220184
933,933,싸우다/Verb,327,124,203,0.0014004668222740914,0.0022768164552744398,0.6207951070336392
934,934,뭐라다/Verb,327,141,186,0.0015894186951205956,0.0020880072858126568,0.5688073394495413
935,935,감상/Noun,327,185,142,0.002078470601311548,0.0015993247295586306,0.5657492354740061
936,936,마무리/Noun,327,148,179,0.0016672224074691564,0.0020102623336813344,0.5474006116207951
937,937,사/Modifier,327,164,163,0.0018450594642658664,0.0018325595859525977,0.5015290519877675
938,938,엉망/Noun,326,22,304,0.000266755585195065,0.0033985650503120905,0.9325153374233128
939,939,병맛/Noun,326,57,269,0.0006557741469378681,0.0030098402896554786,0.8251533742331288
940,940,티/Noun,325,91,234,0.001033677892630877,0.002621115528998867,0.72
941,941,적당하다/Adjective,325,106,219,0.0012004001333777929,0.0024545192030031764,0.6738461538461539
942,942,복수/Noun,325,128,197,0.0014449260864732687,0.0022101779248761637,0.6061538461538462
943,943,대로/Josa,325,143,182,0.0016116483272201846,0.0020435815988804726,0.56
944,944,뛰어나다/Adjective,324,238,86,0.00266755585195065,0.000977365112508052,0.7345679012345679
945,945,관/Noun,324,221,103,0.002478603979104145,0.001166174281969835,0.6820987654320988
946,946,걸다/Verb,324,116,208,0.0013115482938757365,0.00233234856393967,0.6419753086419753
947,947,ㄷㄷ/KoreanParticle,324,200,124,0.002245192842058464,0.0013994091383638019,0.6172839506172839
948,948,액션영화/Noun,324,192,132,0.002156274313660109,0.0014882605122281704,0.5925925925925926
949,949,난/Josa,324,152,172,0.001711681671668334,0.0019325173815500122,0.5308641975308642
950,950,소/Modifier,324,169,155,0.0019006335445148387,0.0017437082120882294,0.5216049382716049
951,951,지겹다/Adjective,323,29,294,0.0003445592975436257,0.00328750083298163,0.9102167182662538
952,952,미화/Noun,323,44,279,0.0005112815382905413,0.003120904506985939,0.8637770897832817
953,953,~!!/Punctuation,323,253,70,0.0028342780926975657,0.0007996623647793153,0.7832817337461301
954,954,흥미/Noun,323,125,198,0.0014115816383238858,0.002221284346609209,0.6130030959752322
955,955,//Punctuation,323,130,193,0.0014671557185728574,0.0021657522379439787,0.5975232198142415
956,956,예상/Noun,323,138,185,0.0015560742469712125,0.002076900864079611,0.5727554179566563
957,957,자극/Noun,323,174,149,0.0019562076247638107,0.0016770696816899534,0.5386996904024768
958,958,헐다/Verb,322,92,230,0.0010447927086806713,0.002576689842066683,0.7142857142857143
959,959,몸/Noun,322,132,190,0.0014893853506724466,0.002132432972744841,0.5900621118012422
960,960,과/Noun,322,138,184,0.0015560742469712125,0.002065794442346565,0.5714285714285714
961,961,간/Suffix,322,178,144,0.0020006668889629878,0.0016215375730247227,0.5527950310559007
962,962,흥미진진/Noun,321,276,45,0.0030899188618428363,0.0005220018214531642,0.8598130841121495
963,963,거리/Noun,321,142,179,0.0016005335111703902,0.0020102623336813344,0.557632398753894
964,964,원래/Noun,321,149,172,0.0016783372235189508,0.0019325173815500122,0.5358255451713395
965,965,손/Noun,320,175,145,0.001967322440813605,0.001632643994757769,0.546875
966,966,중요하다/Adjective,320,151,169,0.0017005668556185395,0.0018991981163508738,0.528125
967,967,훈훈하다/Adjective,319,281,38,0.0031454929420918084,0.0004442568693218419,0.8808777429467085
968,968,여서/Josa,319,132,187,0.0014893853506724466,0.002099113707545703,0.5862068965517241
969,969,잘만/Noun,318,239,79,0.002678670668000445,0.0008996201603767299,0.7515723270440252
970,970,에겐/Josa,317,194,123,0.0021785039457596976,0.0013883027166307562,0.61198738170347
971,971,노력/Noun,317,132,185,0.0014893853506724466,0.002076900864079611,0.583596214511041
972,972,만으로도/Josa,316,285,31,0.003189952206290986,0.00036651191719051963,0.9018987341772152
973,973,낫다/Verb,316,91,225,0.001033677892630877,0.0025211577334014533,0.7120253164556962
974,974,나르다/Verb,316,224,92,0.002511948427253529,0.0010440036429063284,0.7088607594936709
975,975,학교/Noun,316,192,124,0.002156274313660109,0.0013994091383638019,0.6075949367088608
976,976,비추다/Verb,315,48,267,0.0005557408024897189,0.002987627446189387,0.8476190476190476
977,977,괜히/Adverb,315,80,235,0.0009114149160831386,0.002632221950731913,0.7460317460317459
978,978,또한/Noun,315,208,107,0.002334111370456819,0.0012105999689020189,0.6603174603174603
979,979,과거/Noun,315,196,119,0.0022007335778592863,0.0013438770296985718,0.6222222222222222
980,980,오/Noun,315,182,133,0.002045126153162165,0.0014993669339612163,0.5777777777777777
981,981,배/Noun,315,144,171,0.001622763143269979,0.0019214109598169665,0.5428571428571428
982,982,그래픽/Noun,314,78,236,0.00088918528398355,0.0026433283724649594,0.7515923566878981
983,983,ost/Alpha,313,265,48,0.0029676558852950985,0.0005553210866523023,0.8466453674121406
984,984,그냥/Modifier,313,87,226,0.0009892186284316995,0.0025322641551344988,0.7220447284345048
985,985,이라니/Josa,313,116,197,0.0013115482938757365,0.0022101779248761637,0.6293929712460063
986,986,무/Noun,313,127,186,0.0014338112704234743,0.0020880072858126568,0.5942492012779552
987,987,그만/Adverb,312,21,291,0.00025564076914527065,0.003254181567782492,0.9326923076923076
988,988,장/Suffix,312,89,223,0.0010114482605312882,0.002498944889935361,0.7147435897435898
989,989,20/Number,312,211,101,0.002367455818606202,0.0011439614385037428,0.6762820512820513
990,990,바보/Noun,311,85,226,0.0009669889963321108,0.0025322641551344988,0.7266881028938906
991,991,성우/Noun,310,70,240,0.0008002667555851951,0.002687754059397144,0.7741935483870968
992,992,봣/Noun,308,207,101,0.0023229965544070245,0.0011439614385037428,0.6720779220779219
993,993,소중하다/Adjective,307,226,81,0.0025341780593531177,0.000921833003842822,0.7361563517915309
994,994,죽음/Noun,307,206,101,0.0023118817383572304,0.0011439614385037428,0.6710097719869706
995,995,대한민국/Noun,307,185,122,0.002078470601311548,0.0013771962948977098,0.6026058631921825
996,996,연기자/Noun,307,153,154,0.0017227964877181282,0.0017326017903551833,0.501628664495114
997,997,유치/Noun,306,21,285,0.00025564076914527065,0.003187543037384216,0.931372549019608
998,998,나서다/Verb,306,139,167,0.0015671890630210071,0.0018769852728847821,0.5457516339869279
999,999,도저히/Noun,305,26,279,0.00031121484939424253,0.003120904506985939,0.9147540983606556
1000,1000,한심하다/Adjective,305,33,272,0.00038901856174280313,0.0030431595548546173,0.8918032786885246
1001,1001,식/Noun,305,72,233,0.0008224963876847838,0.002610009107265821,0.7639344262295082
1002,1002,속편/Noun,305,99,206,0.001122596421029232,0.002310135720473578,0.6754098360655738
1003,1003,씩/Suffix,305,164,141,0.0018450594642658664,0.0015882183078255846,0.5377049180327869
1004,1004,오히려/Noun,305,154,151,0.0017339113037679224,0.0016992825251560453,0.5049180327868853
1005,1005,한/Modifier,305,152,153,0.001711681671668334,0.0017214953686221373,0.5016393442622951
1006,1006,역겹다/Adjective,304,37,267,0.0004334778259419807,0.002987627446189387,0.8782894736842105
1007,1007,울/Noun,304,228,76,0.002556407691452707,0.0008663008951775916,0.75
1008,1008,무조건/Noun,304,193,111,0.0021673891297099034,0.0012550256558342032,0.6348684210526315
1009,1009,닿다/Verb,303,192,111,0.002156274313660109,0.0012550256558342032,0.6336633663366337
1010,1010,전달/Noun,303,115,188,0.001300433477825942,0.0021102201292787486,0.6204620462046204
1011,1011,땐/Noun,303,183,120,0.0020562409692119594,0.0013549834514316175,0.6039603960396039
1012,1012,상상/Noun,303,173,130,0.001945092808714016,0.0014660476687620785,0.570957095709571
1013,1013,고/Noun,303,152,151,0.001711681671668334,0.0016992825251560453,0.5016501650165016
1014,1014,보이/Noun,302,130,172,0.0014671557185728574,0.0019325173815500122,0.5695364238410596
1015,1015,다루다/Verb,302,158,144,0.0017783705679671,0.0016215375730247227,0.5231788079470199
1016,1016,천재/Noun,301,236,65,0.002645326219851061,0.0007441302561140852,0.7840531561461794
1017,1017,설명/Noun,301,133,168,0.001500500166722241,0.001888091694617828,0.5581395348837209
1018,1018,억지로/Noun,300,42,258,0.0004890519061909527,0.0028876696505919725,0.86
1019,1019,우연히/Adverb,300,258,42,0.0028898521729465373,0.0004886825562540262,0.86
1020,1020,심리/Noun,300,207,93,0.0023229965544070245,0.0010551100646393743,0.69
1021,1021,화가/Noun,299,75,224,0.0008558408358341669,0.0025100513116684065,0.7491638795986622
1022,1022,강하다/Adjective,299,187,112,0.0021007002334111373,0.0012661320775672494,0.6254180602006689
1023,1023,댓글/Noun,297,75,222,0.0008558408358341669,0.0024878384682023146,0.7474747474747475
1024,1024,자꾸/Noun,297,119,178,0.0013448927420251196,0.001999155911948289,0.5993265993265994
1025,1025,한다는/Modifier,297,150,147,0.0016894520395687453,0.0016548568382238609,0.5050505050505051
1026,1026,속/Modifier,296,73,223,0.0008336112037345782,0.002498944889935361,0.7533783783783784
1027,1027,아무/Noun,296,116,180,0.0013115482938757365,0.0020213687554143807,0.6081081081081081
1028,1028,타임/Noun,296,130,166,0.0014671557185728574,0.001865878851151736,0.5608108108108109
1029,1029,개다/Verb,295,73,222,0.0008336112037345782,0.0024878384682023146,0.7525423728813561
1030,1030,새끼/Noun,295,80,215,0.0009114149160831386,0.0024100935160709922,0.7288135593220338
1031,1031,척/Noun,294,58,236,0.0006668889629876625,0.0026433283724649594,0.8027210884353742
1032,1032,예고편/Noun,294,69,225,0.0007891519395354007,0.0025211577334014533,0.7653061224489796
1033,1033,다가/Noun,293,91,202,0.001033677892630877,0.0022657100335413943,0.6894197952218429
1034,1034,최근/Noun,293,195,98,0.002189618761809492,0.0011106421733046046,0.6655290102389079
1035,1035,길다/Adjective,293,136,157,0.0015338446148716238,0.0017659210555543215,0.5358361774744027
1036,1036,구/Modifier,293,152,141,0.001711681671668334,0.0015882183078255846,0.5187713310580204
1037,1037,법/Noun,293,142,151,0.0016005335111703902,0.0016992825251560453,0.5153583617747439
1038,1038,현/Modifier,292,181,111,0.00203401133711237,0.0012550256558342032,0.6198630136986302
1039,1039,good/Alpha,291,213,78,0.002389685450705791,0.0008885137386436838,0.7319587628865979
1040,1040,어느/Modifier,291,104,187,0.001178170501278204,0.002099113707545703,0.6426116838487973
1041,1041,그림/Noun,291,164,127,0.0018450594642658664,0.00143272840356294,0.5635738831615121
1042,1042,잊혀지다/Verb,289,255,34,0.002856507724797155,0.00039983118238965764,0.8823529411764706
1043,1043,불륜/Noun,289,75,214,0.0008558408358341669,0.0023989870943379463,0.740484429065744
1044,1044,젠/Noun,289,80,209,0.0009114149160831386,0.002343454985672716,0.7231833910034602
1045,1045,터/Noun,289,126,163,0.0014226964543736804,0.0018325595859525977,0.5640138408304498
1046,1046,대작/Noun,288,231,57,0.0025897521396020893,0.0006552788822497168,0.8020833333333334
1047,1047,짐/Noun,288,189,99,0.002122929865510726,0.0011217485950376508,0.65625
1048,1048,다니다/Verb,288,105,183,0.0011892853173279985,0.0020546880206135185,0.6354166666666666
1049,1049,무비/Noun,288,124,164,0.0014004668222740914,0.001843666007685644,0.5694444444444444
1050,1050,불다/Verb,288,127,161,0.0014338112704234743,0.0018103467424865054,0.5590277777777778
1051,1051,SF/Alpha,288,149,139,0.0016783372235189508,0.0015660054643594926,0.5173611111111112
1052,1052,스타/Noun,288,147,141,0.0016561075914193618,0.0015882183078255846,0.5104166666666666
1053,1053,미안하다/Adjective,287,74,213,0.0008447260197843727,0.0023878806726049,0.7421602787456446
1054,1054,촬영/Noun,287,121,166,0.0013671223741247086,0.001865878851151736,0.5783972125435539
1055,1055,전편/Noun,287,125,162,0.0014115816383238858,0.001821453164219552,0.5644599303135889
1056,1056,열/Noun,286,78,208,0.00088918528398355,0.00233234856393967,0.7272727272727273
1057,1057,90년/Number,286,134,152,0.0015116149827720349,0.0017103889468890912,0.5314685314685315
1058,1058,올/Modifier,286,136,150,0.0015338446148716238,0.0016881761034229991,0.5244755244755245
1059,1059,2시간/Number,285,95,190,0.0010781371568300542,0.002132432972744841,0.6666666666666666
1060,1060,표정/Noun,285,161,124,0.0018117150161164836,0.0013994091383638019,0.5649122807017544
1061,1061,동/Modifier,285,124,161,0.0014004668222740914,0.0018103467424865054,0.5649122807017544
1062,1062,기억나다/Verb,285,157,128,0.0017672557519173055,0.0014438348252959862,0.5508771929824562
1063,1063,아저씨/Noun,285,155,130,0.001745026119817717,0.0014660476687620785,0.543859649122807
1064,1064,게임/Noun,284,97,187,0.0011003667889296432,0.002099113707545703,0.6584507042253521
1065,1065,행동/Noun,284,103,181,0.0011670556852284096,0.0020324751771474267,0.6373239436619719
1066,1066,고/Modifier,284,123,161,0.001389352006224297,0.0018103467424865054,0.5669014084507042
1067,1067,길/Noun,284,140,144,0.0015783038790708015,0.0016215375730247227,0.5070422535211268
1068,1068,실망하다/Adjective,283,60,223,0.0006891185950872514,0.002498944889935361,0.7879858657243817
1069,1069,짓/Noun,283,70,213,0.0008002667555851951,0.0023878806726049,0.7526501766784452
1070,1070,환상/Noun,283,207,76,0.0023229965544070245,0.0008663008951775916,0.7314487632508834
1071,1071,여/Noun,283,178,105,0.0020006668889629878,0.001188387125435927,0.6289752650176679
1072,1072,메세지/Noun,283,143,140,0.0016116483272201846,0.0015771118860925387,0.5053003533568905
1073,1073,오래/Adverb,282,230,52,0.0025786373235522947,0.0005997467735844866,0.8156028368794326
1074,1074,작다/Adjective,281,156,125,0.0017561409358675113,0.001410515560096848,0.5551601423487544
1075,1075,결혼/Noun,281,130,151,0.0014671557185728574,0.0016992825251560453,0.5373665480427047
1076,1076,참신하다/Adjective,281,149,132,0.0016783372235189508,0.0014882605122281704,0.5302491103202847
1077,1077,그닥/Noun,280,25,255,0.00030010003334444816,0.0028543503853928343,0.9107142857142856
1078,1078,귀신/Noun,280,71,209,0.0008113815716349895,0.002343454985672716,0.7464285714285714
1079,1079,전설/Noun,280,175,105,0.001967322440813605,0.001188387125435927,0.625
1080,1080,입/Noun,280,115,165,0.001300433477825942,0.0018547724294186894,0.5892857142857143
1081,1081,조연/Noun,280,137,143,0.0015449594309214182,0.001610431151291677,0.5107142857142857
1082,1082,산/Noun,279,67,212,0.0007669223074358119,0.002376774250871854,0.7598566308243727
1083,1083,총/Modifier,279,87,192,0.0009892186284316995,0.0021546458162109328,0.6881720430107527
1084,1084,회/Noun,279,177,102,0.001989552072913193,0.001155067860236789,0.6344086021505376
1085,1085,빠져들다/Verb,278,264,14,0.002956541069245304,0.00017770274772873674,0.9496402877697842
1086,1086,흘리다/Verb,278,211,67,0.002367455818606202,0.0007663430995801773,0.7589928057553957
1087,1087,전작/Noun,277,72,205,0.0008224963876847838,0.002299029298740532,0.740072202166065
1088,1088,총/Noun,277,85,192,0.0009669889963321108,0.0021546458162109328,0.6931407942238267
1089,1089,유머/Noun,277,161,116,0.0018117150161164836,0.0013105577644994335,0.5812274368231047
1090,1090,♡/Foreign,276,264,12,0.002956541069245304,0.00015548990426264466,0.9565217391304348
1091,1091,돌아가다/Verb,276,167,109,0.0018784039124152493,0.0012328128123681114,0.605072463768116
1092,1092,현재/Noun,275,205,70,0.002300766922307436,0.0007996623647793153,0.7454545454545455
1093,1093,극/Suffix,275,114,161,0.0012893186617761474,0.0018103467424865054,0.5854545454545454
1094,1094,마/Noun,275,119,156,0.0013448927420251196,0.0017548146338212756,0.5672727272727273
1095,1095,진지하다/Adjective,275,145,130,0.0016338779593197733,0.0014660476687620785,0.5272727272727272
1096,1096,쩔다/Verb,274,216,58,0.002423029898855174,0.0006663853039827628,0.7883211678832117
1097,1097,여전하다/Adjective,274,191,83,0.0021451594976103147,0.000944045847308914,0.6970802919708029
1098,1098,울/Modifier,274,178,96,0.0020006668889629878,0.0010884293298385123,0.6496350364963503
1099,1099,제작비/Noun,273,38,235,0.000444592641991775,0.002632221950731913,0.8608058608058609
1100,1100,영원하다/Adjective,273,231,42,0.0025897521396020893,0.0004886825562540262,0.8461538461538461
1101,1101,예요/Josa,273,206,67,0.0023118817383572304,0.0007663430995801773,0.7545787545787546
1102,1102,스러운/Josa,273,89,184,0.0010114482605312882,0.002065794442346565,0.6739926739926739
1103,1103,다행/Noun,273,104,169,0.001178170501278204,0.0018991981163508738,0.6190476190476191
1104,1104,흠/Noun,272,105,167,0.0011892853173279985,0.0018769852728847821,0.6139705882352942
1105,1105,나중/Noun,272,151,121,0.0017005668556185395,0.001366089873164664,0.5551470588235294
1106,1106,통해/Noun,271,217,54,0.0024341447149049678,0.0006219596170505788,0.8007380073800738
1107,1107,잘생기다/Adjective,271,198,73,0.002222963209958875,0.0008329816299784535,0.7306273062730627
1108,1108,노/Noun,271,96,175,0.0010892519728798488,0.00196583664674915,0.6457564575645757
1109,1109,주의/Noun,271,113,158,0.0012782038457263534,0.0017770274772873676,0.5830258302583026
1110,1110,저런/Noun,271,141,130,0.0015894186951205956,0.0014660476687620785,0.5202952029520295
1111,1111,이미/Adverb,270,114,156,0.0012893186617761474,0.0017548146338212756,0.5777777777777777
1112,1112,아쉬움/Noun,269,159,110,0.0017894853840168946,0.0012439192341011573,0.5910780669144982
1113,1113,역할/Noun,269,128,141,0.0014449260864732687,0.0015882183078255846,0.5241635687732342
1114,1114,망작/Noun,268,16,252,0.0002000666888962988,0.002821031120193696,0.9402985074626866
1115,1115,억/Modifier,268,114,154,0.0012893186617761474,0.0017326017903551833,0.5746268656716418
1116,1116,소녀/Noun,268,117,151,0.0013226631099255307,0.0016992825251560453,0.5634328358208955
1117,1117,그런데/Conjunction,268,133,135,0.001500500166722241,0.0015215797774273086,0.503731343283582
1118,1118,가끔/Noun,267,174,93,0.0019562076247638107,0.0010551100646393743,0.651685393258427
1119,1119,만의/Josa,267,167,100,0.0018784039124152493,0.0011328550167706971,0.6254681647940075
1120,1120,드럽다/Adjective,266,24,242,0.0002889852172946538,0.0027099669028632354,0.9097744360902256
1121,1121,동화/Noun,266,189,77,0.002122929865510726,0.0008774073169106378,0.7105263157894737
1122,1122,80년/Number,266,82,184,0.0009336445481827276,0.002065794442346565,0.6917293233082706
1123,1123,:/Punctuation,266,106,160,0.0012004001333777929,0.0017992403207534593,0.6015037593984962
1124,1124,사라지다/Verb,266,107,159,0.001211514949427587,0.0017881338990204136,0.5977443609022557
1125,1125,먼저/Noun,266,153,113,0.0017227964877181282,0.0012772384993002955,0.575187969924812
1126,1126,겁나다/Verb,266,127,139,0.0014338112704234743,0.0015660054643594926,0.5225563909774437
1127,1127,100/Number,265,171,94,0.001922863176614427,0.0010662164863724202,0.6452830188679245
1128,1128,묘사/Noun,265,170,95,0.0019117483605646328,0.0010773229081054666,0.6415094339622641
1129,1129,씨/Noun,265,120,145,0.0013560075580749138,0.001632643994757769,0.5471698113207547
1130,1130,예산/Noun,264,65,199,0.0007446926753362233,0.002232390768342256,0.7537878787878788
1131,1131,으/Adverb,263,97,166,0.0011003667889296432,0.001865878851151736,0.6311787072243346
1132,1132,여러/Modifier,263,165,98,0.001856174280315661,0.0011106421733046046,0.6273764258555133
1133,1133,화/Noun,263,125,138,0.0014115816383238858,0.0015548990426264464,0.5247148288973384
1134,1134,정/Noun,263,132,131,0.0014893853506724466,0.0014771540904951245,0.5019011406844106
1135,1135,도/Foreign,263,131,132,0.001478270534622652,0.0014882605122281704,0.5019011406844106
1136,1136,채널/Noun,262,82,180,0.0009336445481827276,0.0020213687554143807,0.6870229007633588
1137,1137,살인/Noun,262,97,165,0.0011003667889296432,0.0018547724294186894,0.6297709923664122
1138,1138,멍청하다/Adjective,260,38,222,0.000444592641991775,0.0024878384682023146,0.8538461538461538
1139,1139,강/Noun,260,197,63,0.002211848393909081,0.0007219174126479931,0.7576923076923077
1140,1140,인하다/Adjective,260,152,108,0.001711681671668334,0.0012217063906350652,0.5846153846153846
1141,1141,만큼/Josa,260,150,110,0.0016894520395687453,0.0012439192341011573,0.5769230769230769
1142,1142,리메이크/Noun,260,113,147,0.0012782038457263534,0.0016548568382238609,0.5653846153846154
1143,1143,덥다/Adjective,260,123,137,0.001389352006224297,0.0015437926208934005,0.5269230769230769
1144,1144,특유/Noun,259,151,108,0.0017005668556185395,0.0012217063906350652,0.5830115830115831
1145,1145,바람/Noun,259,114,145,0.0012893186617761474,0.001632643994757769,0.5598455598455598
1146,1146,마치/Noun,259,132,127,0.0014893853506724466,0.00143272840356294,0.5096525096525096
1147,1147,졸라/Noun,258,75,183,0.0008558408358341669,0.0020546880206135185,0.7093023255813954
1148,1148,프로그램/Noun,258,102,156,0.0011559408691786152,0.0017548146338212756,0.6046511627906976
1149,1149,관계/Noun,258,137,121,0.0015449594309214182,0.001366089873164664,0.5310077519379846
1150,1150,개/Suffix,257,79,178,0.0009003001000333445,0.001999155911948289,0.6926070038910506
1151,1151,틀다/Verb,257,149,108,0.0016783372235189508,0.0012217063906350652,0.5797665369649806
1152,1152,등장/Noun,257,108,149,0.0012226297654773814,0.0016770696816899534,0.5797665369649806
1153,1153,두/Josa,257,122,135,0.0013782371901745027,0.0015215797774273086,0.5252918287937743
1154,1154,너/Modifier,257,125,132,0.0014115816383238858,0.0014882605122281704,0.5136186770428015
1155,1155,ㅇ/KoreanParticle,257,130,127,0.0014671557185728574,0.00143272840356294,0.5058365758754864
1156,1156,가능하다/Adjective,257,129,128,0.0014560409025230633,0.0014438348252959862,0.5019455252918288
1157,1157,외/Noun,256,70,186,0.0008002667555851951,0.0020880072858126568,0.7265625
1158,1158,서로/Noun,256,161,95,0.0018117150161164836,0.0010773229081054666,0.62890625
1159,1159,존/Noun,256,111,145,0.0012559742136267645,0.001632643994757769,0.56640625
1160,1160,영웅/Noun,255,121,134,0.0013671223741247086,0.0015104733556942625,0.5254901960784314
1161,1161,낚/Noun,254,20,234,0.00024452595309547634,0.002621115528998867,0.9212598425196852
1162,1162,경찰/Noun,254,98,156,0.0011114816049794377,0.0017548146338212756,0.6141732283464567
1163,1163,관심/Noun,254,132,122,0.0014893853506724466,0.0013771962948977098,0.5196850393700787
1164,1164,모/Noun,253,66,187,0.0007558074913860174,0.002099113707545703,0.7391304347826086
1165,1165,프로/Noun,253,104,149,0.001178170501278204,0.0016770696816899534,0.5889328063241107
1166,1166,안나/Noun,253,119,134,0.0013448927420251196,0.0015104733556942625,0.5296442687747036
1167,1167,끌다/Verb,252,68,184,0.0007780371234856063,0.002065794442346565,0.7301587301587301
1168,1168,런가/Noun,252,97,155,0.0011003667889296432,0.0017437082120882294,0.6150793650793651
1169,1169,반개/Noun,251,5,246,7.780371234856063e-05,0.00275439258979542,0.9800796812749004
1170,1170,짱/VerbPrefix,251,225,26,0.0025230632433033235,0.00031097980852528933,0.896414342629482
1171,1171,지루/Noun,250,21,229,0.00025564076914527065,0.002565583420333637,0.9159999999999999
1172,1172,케이블/Noun,250,126,124,0.0014226964543736804,0.0013994091383638019,0.504
1173,1173,황당하다/Adjective,249,38,211,0.000444592641991775,0.0023656678291388076,0.8473895582329317
1174,1174,착하다/Adjective,249,109,140,0.0012337445815271755,0.0015771118860925387,0.5622489959839357
1175,1175,신/Modifier,249,123,126,0.001389352006224297,0.001421621981829894,0.5060240963855421
1176,1176,약하다/Adjective,248,71,177,0.0008113815716349895,0.0019880494902152425,0.7137096774193549
1177,1177,흔하다/Adjective,248,92,156,0.0010447927086806713,0.0017548146338212756,0.6290322580645161
1178,1178,과정/Noun,248,142,106,0.0016005335111703902,0.0011994935471689732,0.5725806451612904
1179,1179,철학/Noun,248,134,114,0.0015116149827720349,0.0012883449210333415,0.5403225806451613
1180,1180,햇/Noun,248,120,128,0.0013560075580749138,0.0014438348252959862,0.5161290322580645
1181,1181,졸리다/Verb,247,27,220,0.00032232966544403684,0.0024656256247362228,0.8906882591093117
1182,1182,용도/Noun,247,57,190,0.0006557741469378681,0.002132432972744841,0.7692307692307693
1183,1183,희망/Noun,246,210,36,0.002356341002556408,0.0004220440258557498,0.8536585365853658
1184,1184,같이/Josa,246,108,138,0.0012226297654773814,0.0015548990426264464,0.5609756097560976
1185,1185,안다/Verb,246,122,124,0.0013782371901745027,0.0013994091383638019,0.5040650406504065
1186,1186,위대하다/Adjective,245,185,60,0.002078470601311548,0.0006885981474488549,0.7551020408163265
1187,1187,청춘/Noun,245,172,73,0.0019339779926642211,0.0008329816299784535,0.7020408163265306
1188,1188,......./Punctuation,245,81,164,0.0009225297321329332,0.001843666007685644,0.6693877551020408
1189,1189,다만/Noun,245,160,85,0.001800600200066689,0.0009662586907750061,0.6530612244897959
1190,1190,상상력/Noun,245,158,87,0.0017783705679671,0.0009884715342410985,0.6448979591836734
1191,1191,너무나도/Adverb,245,151,94,0.0017005668556185395,0.0010662164863724202,0.6163265306122448
1192,1192,겠다/Verb,245,116,129,0.0013115482938757365,0.0014549412470290322,0.5265306122448979
1193,1193,깊이/Noun,244,172,72,0.0019339779926642211,0.0008218752082454075,0.7049180327868853
1194,1194,생애/Noun,244,140,104,0.0015783038790708015,0.001177280703702881,0.5737704918032787
1195,1195,묻다/Verb,244,139,105,0.0015671890630210071,0.001188387125435927,0.569672131147541
1196,1196,효과/Noun,244,108,136,0.0012226297654773814,0.0015326861991603546,0.5573770491803278
1197,1197,스케일/Noun,244,134,110,0.0015116149827720349,0.0012439192341011573,0.5491803278688525
1198,1198,인정/Noun,244,121,123,0.0013671223741247086,0.0013883027166307562,0.5040983606557377
1199,1199,cg/Alpha,243,62,181,0.0007113482271868402,0.0020324751771474267,0.7448559670781894
1200,1200,엇/VerbPrefix,243,144,99,0.001622763143269979,0.0011217485950376508,0.5925925925925926
1201,1201,바뀌다/Verb,243,103,140,0.0011670556852284096,0.0015771118860925387,0.5761316872427984
1202,1202,기세/Noun,242,7,235,0.0001000333444481494,0.002632221950731913,0.9710743801652892
1203,1203,어느/Adverb,242,103,139,0.0011670556852284096,0.0015660054643594926,0.5743801652892562
1204,1204,생/Noun,242,105,137,0.0011892853173279985,0.0015437926208934005,0.5661157024793388
1205,1205,빌리다/Verb,242,107,135,0.001211514949427587,0.0015215797774273086,0.5578512396694215
1206,1206,며/Josa,242,113,129,0.0012782038457263534,0.0014549412470290322,0.5330578512396694
1207,1207,신기하다/Adjective,242,117,125,0.0013226631099255307,0.001410515560096848,0.5165289256198347
1208,1208,형님/Noun,241,155,86,0.001745026119817717,0.000977365112508052,0.6431535269709544
1209,1209,깔다/Verb,241,91,150,0.001033677892630877,0.0016881761034229991,0.6224066390041494
1210,1210,이며/Josa,241,142,99,0.0016005335111703902,0.0011217485950376508,0.5892116182572614
1211,1211,다소/Noun,241,140,101,0.0015783038790708015,0.0011439614385037428,0.5809128630705395
1212,1212,께/Josa,241,140,101,0.0015783038790708015,0.0011439614385037428,0.5809128630705395
1213,1213,노출/Noun,240,57,183,0.0006557741469378681,0.0020546880206135185,0.7625
1214,1214,다시다/Verb,240,72,168,0.0008224963876847838,0.001888091694617828,0.7
1215,1215,카메라/Noun,240,73,167,0.0008336112037345782,0.0018769852728847821,0.6958333333333333
1216,1216,살아가다/Verb,239,217,22,0.0024341447149049678,0.00026655412159310506,0.9079497907949792
1217,1217,미래/Noun,239,164,75,0.0018450594642658664,0.0008551944734445456,0.6861924686192469
1218,1218,왠지/Adverb,239,138,101,0.0015560742469712125,0.0011439614385037428,0.5774058577405857
1219,1219,태어나다/Verb,239,134,105,0.0015116149827720349,0.001188387125435927,0.5606694560669456
1220,1220,쏘다/Verb,238,76,162,0.0008669556518839612,0.001821453164219552,0.6806722689075629
1221,1221,체/Noun,238,92,146,0.0010447927086806713,0.001643750416490815,0.6134453781512605
1222,1222,단/Noun,238,107,131,0.001211514949427587,0.0014771540904951245,0.5504201680672269
1223,1223,>/Punctuation,238,120,118,0.0013560075580749138,0.0013327706079655256,0.5042016806722689
1224,1224,대안/Noun,237,199,38,0.0022340780260086696,0.0004442568693218419,0.8396624472573839
1225,1225,로는/Josa,237,110,127,0.00124485939757697,0.00143272840356294,0.5358649789029536
1226,1226,산만하다/Adjective,236,19,217,0.0002334111370456819,0.0024323063595370845,0.9194915254237288
1227,1227,능력/Noun,236,81,155,0.0009225297321329332,0.0017437082120882294,0.6567796610169492
1228,1228,미소/Noun,235,212,23,0.002378570634655997,0.00027766054332615115,0.9021276595744679
1229,1229,결론/Noun,235,63,172,0.0007224630432366343,0.0019325173815500122,0.7319148936170212
1230,1230,반/Noun,235,83,152,0.0009447593642325221,0.0017103889468890912,0.6468085106382979
1231,1231,치/Noun,235,90,145,0.0010225630765810826,0.001632643994757769,0.6170212765957447
1232,1232,시/Noun,235,111,124,0.0012559742136267645,0.0013994091383638019,0.5276595744680851
1233,1233,설레다/Adjective,234,212,22,0.002378570634655997,0.00026655412159310506,0.9059829059829059
1234,1234,독립영화/Noun,234,75,159,0.0008558408358341669,0.0017881338990204136,0.6794871794871795
1235,1235,부터/Noun,234,122,112,0.0013782371901745027,0.0012661320775672494,0.5213675213675214
1236,1236,OST/Alpha,233,191,42,0.0021451594976103147,0.0004886825562540262,0.8197424892703863
1237,1237,잘못/Noun,233,83,150,0.0009447593642325221,0.0016881761034229991,0.6437768240343348
1238,1238,네/Noun,233,103,130,0.0011670556852284096,0.0014660476687620785,0.5579399141630901
1239,1239,얻다/Verb,232,135,97,0.0015227297988218294,0.0010995357515715587,0.5818965517241379
1240,1240,귀/Modifier,231,137,94,0.0015449594309214182,0.0010662164863724202,0.5930735930735931
1241,1241,엿/Modifier,231,118,113,0.001333777925975325,0.0012772384993002955,0.5108225108225108
1242,1242,지나치다/Verb,230,55,175,0.0006335445148382794,0.00196583664674915,0.7608695652173914
1243,1243,리얼/Noun,230,156,74,0.0017561409358675113,0.0008440880517114996,0.6782608695652174
1244,1244,평생/Noun,230,147,83,0.0016561075914193618,0.000944045847308914,0.6391304347826087
1245,1245,요/Modifier,230,129,101,0.0014560409025230633,0.0011439614385037428,0.5608695652173913
1246,1246,ㅇㅇ/KoreanParticle,230,126,104,0.0014226964543736804,0.001177280703702881,0.5478260869565217
1247,1247,젊다/Adjective,229,158,71,0.0017783705679671,0.0008107687865123613,0.6899563318777293
1248,1248,원하다/Adjective,229,129,100,0.0014560409025230633,0.0011328550167706971,0.5633187772925764
1249,1249,왠만하다/Adjective,228,20,208,0.00024452595309547634,0.00233234856393967,0.912280701754386
1250,1250,멋/Noun,228,174,54,0.0019562076247638107,0.0006219596170505788,0.7631578947368421
1251,1251,범인/Noun,228,62,166,0.0007113482271868402,0.001865878851151736,0.7280701754385965
1252,1252,되게/Adverb,227,149,78,0.0016783372235189508,0.0008885137386436838,0.6563876651982379
1253,1253,어린이/Noun,227,87,140,0.0009892186284316995,0.0015771118860925387,0.6167400881057269
1254,1254,D/Alpha,227,103,124,0.0011670556852284096,0.0013994091383638019,0.5462555066079295
1255,1255,메시지/Noun,227,115,112,0.001300433477825942,0.0012661320775672494,0.5066079295154186
1256,1256,박수/Noun,226,151,75,0.0017005668556185395,0.0008551944734445456,0.668141592920354
1257,1257,고민/Noun,226,128,98,0.0014449260864732687,0.0011106421733046046,0.5663716814159292
1258,1258,얼/Noun,226,99,127,0.001122596421029232,0.00143272840356294,0.5619469026548672
1259,1259,으로는/Josa,226,119,107,0.0013448927420251196,0.0012105999689020189,0.5265486725663717
1260,1260,손발/Noun,225,22,203,0.000266755585195065,0.0022768164552744398,0.9022222222222224
1261,1261,고생/Noun,225,87,138,0.0009892186284316995,0.0015548990426264464,0.6133333333333333
1262,1262,고맙다/Adjective,224,180,44,0.0020228965210625765,0.0005108953997201182,0.8035714285714286
1263,1263,온/Noun,224,111,113,0.0012559742136267645,0.0012772384993002955,0.5044642857142857
1264,1264,졸다/Verb,223,13,210,0.00016672224074691566,0.002354561407405762,0.9417040358744396
1265,1265,굳이/Noun,223,45,178,0.0005223963543403357,0.001999155911948289,0.7982062780269058
1266,1266,로맨틱/Noun,223,141,82,0.0015894186951205956,0.000932939425575868,0.6322869955156951
1267,1267,랄/Noun,223,119,104,0.0013448927420251196,0.001177280703702881,0.5336322869955157
1268,1268,변하다/Adjective,223,114,109,0.0012893186617761474,0.0012328128123681114,0.5112107623318386
1269,1269,군/Suffix,223,112,111,0.0012670890296765588,0.0012550256558342032,0.5022421524663677
1270,1270,인/Noun,223,112,111,0.0012670890296765588,0.0012550256558342032,0.5022421524663677
1271,1271,거지같다/Adjective,222,19,203,0.0002334111370456819,0.0022768164552744398,0.9144144144144144
1272,1272,떠오르다/Verb,222,164,58,0.0018450594642658664,0.0006663853039827628,0.7387387387387387
1273,1273,밤/Noun,222,158,64,0.0017783705679671,0.0007330238343810393,0.7117117117117117
1274,1274,심심하다/Adjective,221,88,133,0.0010003334444814939,0.0014993669339612163,0.6018099547511312
1275,1275,만/Modifier,221,119,102,0.0013448927420251196,0.001155067860236789,0.5384615384615384
1276,1276,문화/Noun,221,114,107,0.0012893186617761474,0.0012105999689020189,0.5158371040723982
1277,1277,별루/Noun,220,12,208,0.00015560742469712126,0.00233234856393967,0.9454545454545454
1278,1278,슬픔/Noun,220,192,28,0.002156274313660109,0.0003331926519913814,0.8727272727272727
1279,1279,용이/Noun,220,69,151,0.0007891519395354007,0.0016992825251560453,0.6863636363636364
1280,1280,차/Noun,220,84,136,0.0009558741802823164,0.0015326861991603546,0.6181818181818182
1281,1281,스/Noun,220,131,89,0.001478270534622652,0.0010106843777071904,0.5954545454545455
1282,1282,저렇게/Adverb,220,91,129,0.001033677892630877,0.0014549412470290322,0.5863636363636363
1283,1283,사다/Verb,220,115,105,0.001300433477825942,0.001188387125435927,0.5227272727272727
1284,1284,포장/Noun,219,20,199,0.00024452595309547634,0.002232390768342256,0.9086757990867579
1285,1285,주기/Noun,219,40,179,0.0004668222740913638,0.0020102623336813344,0.817351598173516
1286,1286,시도/Noun,219,57,162,0.0006557741469378681,0.001821453164219552,0.7397260273972602
1287,1287,ㅅㅂ/KoreanParticle,218,20,198,0.00024452595309547634,0.002221284346609209,0.908256880733945
1288,1288,아침/Noun,218,56,162,0.0006446593308880737,0.001821453164219552,0.7431192660550459
1289,1289,인기/Noun,218,90,128,0.0010225630765810826,0.0014438348252959862,0.5871559633027523
1290,1290,추다/Verb,218,116,102,0.0013115482938757365,0.001155067860236789,0.5321100917431193
1291,1291,서/Modifier,218,103,115,0.0011670556852284096,0.0012994513427663874,0.5275229357798165
1292,1292,늙다/Verb,217,85,132,0.0009669889963321108,0.0014882605122281704,0.6082949308755761
1293,1293,줌/Noun,217,87,130,0.0009892186284316995,0.0014660476687620785,0.5990783410138248
1294,1294,덕분/Noun,217,122,95,0.0013782371901745027,0.0010773229081054666,0.5622119815668203
1295,1295,과연/Noun,217,113,104,0.0012782038457263534,0.001177280703702881,0.5207373271889401
1296,1296,어찌/Noun,217,110,107,0.00124485939757697,0.0012105999689020189,0.5069124423963134
1297,1297,광고/Noun,216,47,169,0.0005446259864399244,0.0018991981163508738,0.7824074074074074
1298,1298,군대/Noun,216,97,119,0.0011003667889296432,0.0013438770296985718,0.5509259259259259
1299,1299,유명하다/Adjective,216,108,108,0.0012226297654773814,0.0012217063906350652,0.5
1300,1300,짱/Modifier,215,181,34,0.00203401133711237,0.00039983118238965764,0.8418604651162791
1301,1301,진실/Noun,215,142,73,0.0016005335111703902,0.0008329816299784535,0.6604651162790698
1302,1302,이래/Josa,215,118,97,0.001333777925975325,0.0010995357515715587,0.5488372093023256
1303,1303,자막/Noun,215,101,114,0.0011448260531288204,0.0012883449210333415,0.5302325581395348
1304,1304,여성/Noun,215,106,109,0.0012004001333777929,0.0012328128123681114,0.5069767441860465
1305,1305,암/Noun,214,59,155,0.0006780037790374569,0.0017437082120882294,0.7242990654205608
1306,1306,흐름/Noun,214,83,131,0.0009447593642325221,0.0014771540904951245,0.6121495327102804
1307,1307,지키다/Verb,214,106,108,0.0012004001333777929,0.0012217063906350652,0.5046728971962616
1308,1308,성인/Noun,214,108,106,0.0012226297654773814,0.0011994935471689732,0.5046728971962616
1309,1309,눈물나다/Verb,213,183,30,0.0020562409692119594,0.0003554054954574735,0.8591549295774648
1310,1310,젤/Noun,213,123,90,0.001389352006224297,0.0010217907994402363,0.5774647887323944
1311,1311,어떤/Modifier,213,107,106,0.001211514949427587,0.0011994935471689732,0.5023474178403756
1312,1312,성도/Noun,212,25,187,0.00030010003334444816,0.002099113707545703,0.8820754716981132
1313,1313,한계/Noun,212,38,174,0.000444592641991775,0.0019547302250161047,0.8207547169811321
1314,1314,그럭저럭/Adverb,212,52,160,0.0006002000666888963,0.0017992403207534593,0.7547169811320755
1315,1315,전/Foreign,212,157,55,0.0017672557519173055,0.0006330660387836247,0.7405660377358491
1316,1316,조차/Josa,212,56,156,0.0006446593308880737,0.0017548146338212756,0.7358490566037735
1317,1317,챙기다/Verb,212,145,67,0.0016338779593197733,0.0007663430995801773,0.6839622641509434
1318,1318,심/Noun,212,73,139,0.0008336112037345782,0.0015660054643594926,0.6556603773584906
1319,1319,빠르다/Adjective,212,128,84,0.0014449260864732687,0.00095515226904196,0.6037735849056604
1320,1320,싫어하다/Adjective,212,90,122,0.0010225630765810826,0.0013771962948977098,0.5754716981132075
1321,1321,사이/Noun,212,119,93,0.0013448927420251196,0.0010551100646393743,0.5613207547169812
1322,1322,동생/Noun,212,101,111,0.0011448260531288204,0.0012550256558342032,0.5235849056603774
1323,1323,~^^/Punctuation,211,202,9,0.0022674224741580525,0.00012217063906350652,0.957345971563981
1324,1324,진정/Noun,211,146,65,0.0016449927753695677,0.0007441302561140852,0.6919431279620853
1325,1325,..?/Punctuation,211,82,129,0.0009336445481827276,0.0014549412470290322,0.6113744075829384
1326,1326,웬만하다/Adjective,211,83,128,0.0009447593642325221,0.0014438348252959862,0.6066350710900474
1327,1327,보시/Noun,211,113,98,0.0012782038457263534,0.0011106421733046046,0.5355450236966824
1328,1328,순/Noun,211,102,109,0.0011559408691786152,0.0012328128123681114,0.5165876777251185
1329,1329,깔끔하다/Adjective,210,167,43,0.0018784039124152493,0.0004997889779870722,0.7952380952380952
1330,1330,살짝/Noun,210,140,70,0.0015783038790708015,0.0007996623647793153,0.6666666666666666
1331,1331,희다/Adjective,210,96,114,0.0010892519728798488,0.0012883449210333415,0.5428571428571428
1332,1332,만이/Josa,210,112,98,0.0012670890296765588,0.0011106421733046046,0.5333333333333333
1333,1333,발견/Noun,209,175,34,0.001967322440813605,0.00039983118238965764,0.8373205741626795
1334,1334,리뷰/Noun,209,80,129,0.0009114149160831386,0.0014549412470290322,0.6172248803827751
1335,1335,일어나다/Verb,209,129,80,0.0014560409025230633,0.000910726582109776,0.6172248803827751
1336,1336,볼거리/Noun,209,93,116,0.0010559075247304657,0.0013105577644994335,0.5550239234449761
1337,1337,스럽게/Josa,209,111,98,0.0012559742136267645,0.0011106421733046046,0.5311004784688995
1338,1338,수도/Noun,209,108,101,0.0012226297654773814,0.0011439614385037428,0.5167464114832536
1339,1339,개도/Noun,208,25,183,0.00030010003334444816,0.0020546880206135185,0.8798076923076923
1340,1340,쩐다/Noun,208,145,63,0.0016338779593197733,0.0007219174126479931,0.6971153846153846
1341,1341,범죄/Noun,208,72,136,0.0008224963876847838,0.0015326861991603546,0.6538461538461539
1342,1342,뜻/Noun,208,122,86,0.0013782371901745027,0.000977365112508052,0.5865384615384616
1343,1343,첫/Noun,208,116,92,0.0013115482938757365,0.0010440036429063284,0.5576923076923077
1344,1344,짱짱/Noun,207,199,8,0.0022340780260086696,0.00011106421733046048,0.961352657004831
1345,1345,부족/Noun,207,29,178,0.0003445592975436257,0.001999155911948289,0.8599033816425121
1346,1346,지난/Noun,207,159,48,0.0017894853840168946,0.0005553210866523023,0.7681159420289855
1347,1347,20년/Number,207,142,65,0.0016005335111703902,0.0007441302561140852,0.6859903381642513
1348,1348,야/Exclamation,207,66,141,0.0007558074913860174,0.0015882183078255846,0.6811594202898551
1349,1349,오락/Noun,207,125,82,0.0014115816383238858,0.000932939425575868,0.6038647342995169
1350,1350,와는/Josa,207,118,89,0.001333777925975325,0.0010106843777071904,0.5700483091787439
1351,1351,던지다/Verb,207,110,97,0.00124485939757697,0.0010995357515715587,0.5314009661835749
1352,1352,대충/Noun,206,37,169,0.0004334778259419807,0.0018991981163508738,0.8203883495145631
1353,1353,영환/Noun,206,64,142,0.0007335778592864287,0.0015993247295586306,0.6893203883495146
1354,1354,~~~~/Punctuation,206,123,83,0.001389352006224297,0.000944045847308914,0.5970873786407767
1355,1355,로서/Noun,206,116,90,0.0013115482938757365,0.0010217907994402363,0.5631067961165048
1356,1356,찌다/Verb,206,97,109,0.0011003667889296432,0.0012328128123681114,0.529126213592233
1357,1357,퀄리티/Noun,206,109,97,0.0012337445815271755,0.0010995357515715587,0.529126213592233
1358,1358,이면/Noun,206,97,109,0.0011003667889296432,0.0012328128123681114,0.529126213592233
1359,1359,언/Modifier,206,98,108,0.0011114816049794377,0.0012217063906350652,0.5242718446601942
1360,1360,감탄/Noun,205,177,28,0.001989552072913193,0.0003331926519913814,0.8634146341463415
1361,1361,빨/Noun,205,54,151,0.0006224296987884852,0.0016992825251560453,0.7365853658536585
1362,1362,자연/Noun,205,142,63,0.0016005335111703902,0.0007219174126479931,0.6926829268292682
1363,1363,커플/Noun,205,141,64,0.0015894186951205956,0.0007330238343810393,0.6878048780487804
1364,1364,시선/Noun,205,141,64,0.0015894186951205956,0.0007330238343810393,0.6878048780487804
1365,1365,정서/Noun,205,76,129,0.0008669556518839612,0.0014549412470290322,0.6292682926829268
1366,1366,정말로/Adverb,205,125,80,0.0014115816383238858,0.000910726582109776,0.6097560975609756
1367,1367,시청자/Noun,204,41,163,0.0004779370901411582,0.0018325595859525977,0.7990196078431373
1368,1368,홍보/Noun,204,43,161,0.0005001667222407468,0.0018103467424865054,0.7892156862745098
1369,1369,담기다/Verb,204,160,44,0.001800600200066689,0.0005108953997201182,0.7843137254901961
1370,1370,몸매/Noun,204,67,137,0.0007669223074358119,0.0015437926208934005,0.6715686274509803
1371,1371,우울하다/Adjective,204,123,81,0.001389352006224297,0.000921833003842822,0.6029411764705882
1372,1372,폭력/Noun,204,94,110,0.00106702234078026,0.0012439192341011573,0.5392156862745098
1373,1373,b/Alpha,204,101,103,0.0011448260531288204,0.001166174281969835,0.5049019607843137
1374,1374,기대다/Verb,204,103,101,0.0011670556852284096,0.0011439614385037428,0.5049019607843137
1375,1375,아오/Exclamation,203,29,174,0.0003445592975436257,0.0019547302250161047,0.8571428571428571
1376,1376,뛰다/Verb,203,88,115,0.0010003334444814939,0.0012994513427663874,0.5665024630541872
1377,1377,방/Noun,203,92,111,0.0010447927086806713,0.0012550256558342032,0.5467980295566502
1378,1378,울리다/Verb,202,175,27,0.001967322440813605,0.00032208623025833537,0.8663366336633663
1379,1379,지르다/Verb,202,42,160,0.0004890519061909527,0.0017992403207534593,0.7920792079207921
1380,1380,소름끼치다/Verb,202,155,47,0.001745026119817717,0.0005442146649192564,0.7673267326732673
1381,1381,더하다/Adjective,202,117,85,0.0013226631099255307,0.0009662586907750061,0.5792079207920792
1382,1382,열심히/Adverb,202,104,98,0.001178170501278204,0.0011106421733046046,0.5148514851485149
1383,1383,일상/Noun,201,154,47,0.0017339113037679224,0.0005442146649192564,0.7661691542288557
1384,1384,포기/Noun,201,56,145,0.0006446593308880737,0.001632643994757769,0.7213930348258707
1385,1385,코드/Noun,201,76,125,0.0008669556518839612,0.001410515560096848,0.6218905472636815
1386,1386,첨/Noun,201,77,124,0.0008780704679337558,0.0013994091383638019,0.6169154228855721
1387,1387,유일하다/Adjective,200,119,81,0.0013448927420251196,0.000921833003842822,0.595
1388,1388,접다/Verb,199,22,177,0.000266755585195065,0.0019880494902152425,0.8894472361809045
1389,1389,30분/Number,199,51,148,0.000589085250639102,0.001665963259956907,0.7437185929648241
1390,1390,에서의/Josa,199,143,56,0.0016116483272201846,0.0006441724605166707,0.7185929648241206
1391,1391,일이/Noun,199,115,84,0.001300433477825942,0.00095515226904196,0.5778894472361809
1392,1392,용서/Noun,199,85,114,0.0009669889963321108,0.0012883449210333415,0.5728643216080402
1393,1393,이따위/Modifier,198,8,190,0.00011114816049794375,0.002132432972744841,0.9595959595959596
1394,1394,눈빛/Noun,198,175,23,0.001967322440813605,0.00027766054332615115,0.8838383838383839
1395,1395,10분/Number,198,36,162,0.00042236300989218633,0.001821453164219552,0.8181818181818182
1396,1396,보라/Noun,198,64,134,0.0007335778592864287,0.0015104733556942625,0.6767676767676768
1397,1397,끼리/Noun,198,71,127,0.0008113815716349895,0.00143272840356294,0.6414141414141414
1398,1398,사극/Noun,198,123,75,0.001389352006224297,0.0008551944734445456,0.6212121212121212
1399,1399,대의/Noun,198,106,92,0.0012004001333777929,0.0010440036429063284,0.5353535353535354
1400,1400,보다도/Josa,198,100,98,0.0011337112370790265,0.0011106421733046046,0.5050505050505051
1401,1401,말로/Noun,197,140,57,0.0015783038790708015,0.0006552788822497168,0.7106598984771574
1402,1402,들어오다/Verb,197,87,110,0.0009892186284316995,0.0012439192341011573,0.5583756345177665
1403,1403,형/Suffix,197,100,97,0.0011337112370790265,0.0010995357515715587,0.5076142131979695
1404,1404,뜬금/Noun,196,17,179,0.00021118150494609317,0.0020102623336813344,0.9132653061224488
1405,1405,핵/Noun,196,37,159,0.0004334778259419807,0.0017881338990204136,0.8112244897959183
1406,1406,상처/Noun,196,143,53,0.0016116483272201846,0.0006108531953175326,0.7295918367346939
1407,1407,실감/Noun,196,128,68,0.0014449260864732687,0.0007774495213132232,0.6530612244897959
1408,1408,괴물/Noun,196,81,115,0.0009225297321329332,0.0012994513427663874,0.5867346938775511
1409,1409,달/Noun,196,89,107,0.0010114482605312882,0.0012105999689020189,0.5459183673469388
1410,1410,다큐멘터리/Noun,196,92,104,0.0010447927086806713,0.001177280703702881,0.5306122448979592
1411,1411,반성/Noun,196,92,104,0.0010447927086806713,0.001177280703702881,0.5306122448979592
1412,1412,특별하다/Adjective,196,94,102,0.00106702234078026,0.001155067860236789,0.5204081632653061
1413,1413,</Punctuation,196,98,98,0.0011114816049794377,0.0011106421733046046,0.5
1414,1414,끌/Noun,195,22,173,0.000266755585195065,0.0019436238032830586,0.8871794871794871
1415,1415,힐링/Noun,195,171,24,0.001922863176614427,0.0002887669650591972,0.8769230769230769
1416,1416,혹시/Noun,195,48,147,0.0005557408024897189,0.0016548568382238609,0.7538461538461538
1417,1417,막판/Noun,195,58,137,0.0006668889629876625,0.0015437926208934005,0.7025641025641025
1418,1418,빛/Noun,195,127,68,0.0014338112704234743,0.0007774495213132232,0.6512820512820513
1419,1419,당연하다/Adjective,195,106,89,0.0012004001333777929,0.0010106843777071904,0.5435897435897435
1420,1420,연애/Noun,195,105,90,0.0011892853173279985,0.0010217907994402363,0.5384615384615384
1421,1421,무겁다/Adjective,194,158,36,0.0017783705679671,0.0004220440258557498,0.8144329896907216
1422,1422,우정/Noun,194,143,51,0.0016116483272201846,0.0005886403518514405,0.7371134020618557
1423,1423,해피엔딩/Noun,194,138,56,0.0015560742469712125,0.0006441724605166707,0.711340206185567
1424,1424,죄/Noun,194,67,127,0.0007669223074358119,0.00143272840356294,0.6546391752577321
1425,1425,하루/Noun,194,110,84,0.00124485939757697,0.00095515226904196,0.5670103092783505
1426,1426,표/Noun,194,109,85,0.0012337445815271755,0.0009662586907750061,0.5618556701030928
1427,1427,우/Adverb,194,89,105,0.0010114482605312882,0.001188387125435927,0.5412371134020618
1428,1428,크게/Noun,194,93,101,0.0010559075247304657,0.0011439614385037428,0.5206185567010311
1429,1429,내리다/Verb,194,96,98,0.0010892519728798488,0.0011106421733046046,0.5051546391752577
1430,1430,참다/Verb,193,36,157,0.00042236300989218633,0.0017659210555543215,0.8134715025906736
1431,1431,으론/Josa,193,112,81,0.0012670890296765588,0.000921833003842822,0.5803108808290155
1432,1432,남녀/Noun,193,111,82,0.0012559742136267645,0.000932939425575868,0.5751295336787565
1433,1433,정치/Noun,193,109,84,0.0012337445815271755,0.00095515226904196,0.5647668393782384
1434,1434,이어지다/Verb,193,107,86,0.001211514949427587,0.000977365112508052,0.5544041450777202
1435,1435,짓다/Verb,193,102,91,0.0011559408691786152,0.0010328972211732824,0.5284974093264249
1436,1436,감다/Verb,193,93,100,0.0010559075247304657,0.0011328550167706971,0.5181347150259067
1437,1437,몰다/Verb,192,64,128,0.0007335778592864287,0.0014438348252959862,0.6666666666666666
1438,1438,하하/Noun,192,96,96,0.0010892519728798488,0.0010884293298385123,0.5
1439,1439,아련하다/Adjective,191,184,7,0.002067355785261754,9.995779559741441e-05,0.9633507853403142
1440,1440,보아/Noun,191,134,57,0.0015116149827720349,0.0006552788822497168,0.7015706806282722
1441,1441,게다가/Noun,191,58,133,0.0006668889629876625,0.0014993669339612163,0.6963350785340314
1442,1442,만큼/Noun,191,115,76,0.001300433477825942,0.0008663008951775916,0.6020942408376964
1443,1443,어제/Noun,191,112,79,0.0012670890296765588,0.0008996201603767299,0.5863874345549738
1444,1444,개판/Noun,190,8,182,0.00011114816049794375,0.0020435815988804726,0.9578947368421052
1445,1445,뭐임/Noun,190,15,175,0.00018895187284650438,0.00196583664674915,0.9210526315789472
1446,1446,나머지/Noun,190,38,152,0.000444592641991775,0.0017103889468890912,0.8
1447,1447,벌써/Noun,190,146,44,0.0016449927753695677,0.0005108953997201182,0.7684210526315789
1448,1448,조폭/Noun,190,58,132,0.0006668889629876625,0.0014882605122281704,0.6947368421052632
1449,1449,간/Noun,190,72,118,0.0008224963876847838,0.0013327706079655256,0.6210526315789474
1450,1450,이기/Noun,190,114,76,0.0012893186617761474,0.0008663008951775916,0.6
1451,1451,만으로/Josa,190,112,78,0.0012670890296765588,0.0008885137386436838,0.5894736842105263
1452,1452,처럼/Noun,190,100,90,0.0011337112370790265,0.0010217907994402363,0.5263157894736842
1453,1453,소장/Noun,189,173,16,0.001945092808714016,0.00019991559119482882,0.9153439153439152
1454,1454,비극/Noun,189,143,46,0.0016116483272201846,0.0005331082431862101,0.7566137566137566
1455,1455,까지는/Josa,189,51,138,0.000589085250639102,0.0015548990426264464,0.7301587301587301
1456,1456,주/Noun,189,73,116,0.0008336112037345782,0.0013105577644994335,0.6137566137566137
1457,1457,안좋다/Adjective,189,81,108,0.0009225297321329332,0.0012217063906350652,0.5714285714285714
1458,1458,(?)/Punctuation,189,86,103,0.0009781038123819054,0.001166174281969835,0.544973544973545
1459,1459,만에/Foreign,189,93,96,0.0010559075247304657,0.0010884293298385123,0.5079365079365079
1460,1460,벗다/Verb,188,41,147,0.0004779370901411582,0.0016548568382238609,0.7819148936170213
1461,1461,난해하다/Adjective,188,45,143,0.0005223963543403357,0.001610431151291677,0.7606382978723404
1462,1462,섹스/Noun,188,51,137,0.000589085250639102,0.0015437926208934005,0.7287234042553191
1463,1463,부끄럽다/Adjective,188,65,123,0.0007446926753362233,0.0013883027166307562,0.6542553191489362
1464,1464,등장인물/Noun,188,69,119,0.0007891519395354007,0.0013438770296985718,0.6329787234042553
1465,1465,공부/Noun,188,83,105,0.0009447593642325221,0.001188387125435927,0.5585106382978723
1466,1466,수/Modifier,188,96,92,0.0010892519728798488,0.0010440036429063284,0.5106382978723404
1467,1467,형편/Noun,187,18,169,0.0002222963209958875,0.0018991981163508738,0.9037433155080212
1468,1468,본방/Noun,187,166,21,0.0018672890963654552,0.0002554476998600591,0.8877005347593583
1469,1469,감명/Noun,187,164,23,0.0018450594642658664,0.00027766054332615115,0.8770053475935828
1470,1470,뮤지컬/Noun,187,117,70,0.0013226631099255307,0.0007996623647793153,0.6256684491978609
1471,1471,올해/Noun,187,111,76,0.0012559742136267645,0.0008663008951775916,0.5935828877005348
1472,1472,평이/Noun,187,91,96,0.001033677892630877,0.0010884293298385123,0.5133689839572193
1473,1473,펑펑/Noun,186,179,7,0.002011781705012782,9.995779559741441e-05,0.9623655913978496
1474,1474,끝내다/Verb,186,63,123,0.0007224630432366343,0.0013883027166307562,0.6612903225806451
1475,1475,의문/Noun,186,67,119,0.0007669223074358119,0.0013438770296985718,0.6397849462365591
1476,1476,이연걸/Noun,186,117,69,0.0013226631099255307,0.0007885559430462694,0.6290322580645161
1477,1477,국민/Noun,186,106,80,0.0012004001333777929,0.000910726582109776,0.5698924731182796
1478,1478,불구/Noun,186,104,82,0.001178170501278204,0.000932939425575868,0.5591397849462365
1479,1479,이라서/Josa,186,99,87,0.001122596421029232,0.0009884715342410985,0.532258064516129
1480,1480,분/Suffix,186,99,87,0.001122596421029232,0.0009884715342410985,0.532258064516129
1481,1481,러닝/Noun,186,92,94,0.0010447927086806713,0.0010662164863724202,0.5053763440860215
1482,1482,그다지/Noun,185,18,167,0.0002222963209958875,0.0018769852728847821,0.9027027027027028
1483,1483,토/Noun,185,44,141,0.0005112815382905413,0.0015882183078255846,0.7621621621621621
1484,1484,떼다/Verb,185,140,45,0.0015783038790708015,0.0005220018214531642,0.7567567567567568
1485,1485,인가요/Josa,185,57,128,0.0006557741469378681,0.0014438348252959862,0.6918918918918919
1486,1486,결과/Noun,185,64,121,0.0007335778592864287,0.001366089873164664,0.6540540540540539
1487,1487,불가/Noun,184,41,143,0.0004779370901411582,0.001610431151291677,0.7771739130434783
1488,1488,자유/Noun,184,128,56,0.0014449260864732687,0.0006441724605166707,0.6956521739130435
1489,1489,암튼/Adverb,184,123,61,0.001389352006224297,0.0006997045691819009,0.6684782608695652
1490,1490,새벽/Noun,184,122,62,0.0013782371901745027,0.000710810990914947,0.6630434782608695
1491,1491,꼴/Noun,183,23,160,0.00027787040124485944,0.0017992403207534593,0.8743169398907104
1492,1492,표절/Noun,183,24,159,0.0002889852172946538,0.0017881338990204136,0.8688524590163934
1493,1493,행복/Noun,183,153,30,0.0017227964877181282,0.0003554054954574735,0.8360655737704918
1494,1494,딱하다/Adjective,183,31,152,0.00036678892964321435,0.0017103889468890912,0.8306010928961749
1495,1495,지도/Noun,183,60,123,0.0006891185950872514,0.0013883027166307562,0.6721311475409836
1496,1496,느와르/Noun,183,123,60,0.001389352006224297,0.0006885981474488549,0.6721311475409836
1497,1497,기적/Noun,183,104,79,0.001178170501278204,0.0008996201603767299,0.5683060109289617
1498,1498,글쎄/Noun,182,21,161,0.00025564076914527065,0.0018103467424865054,0.8846153846153846
1499,1499,색다르다/Adjective,182,141,41,0.0015894186951205956,0.00047757613452098,0.7747252747252747
1500,1500,기본/Noun,182,50,132,0.0005779704345893076,0.0014882605122281704,0.7252747252747253
1501,1501,오버/Noun,182,51,131,0.000589085250639102,0.0014771540904951245,0.7197802197802198
1502,1502,차이/Noun,182,68,114,0.0007780371234856063,0.0012883449210333415,0.6263736263736264
1503,1503,홍콩/Noun,182,82,100,0.0009336445481827276,0.0011328550167706971,0.5494505494505495
1504,1504,악역/Noun,182,94,88,0.00106702234078026,0.0009995779559741444,0.5164835164835165
1505,1505,무협/Noun,182,92,90,0.0010447927086806713,0.0010217907994402363,0.5054945054945055
1506,1506,에만/Josa,181,44,137,0.0005112815382905413,0.0015437926208934005,0.7569060773480663
1507,1507,에게는/Josa,181,120,61,0.0013560075580749138,0.0006997045691819009,0.6629834254143646
1508,1508,따위/Noun,181,63,118,0.0007224630432366343,0.0013327706079655256,0.6519337016574586
1509,1509,가면/Noun,181,65,116,0.0007446926753362233,0.0013105577644994335,0.6408839779005525
1510,1510,자식/Noun,181,83,98,0.0009447593642325221,0.0011106421733046046,0.5414364640883977
1511,1511,발전/Noun,181,83,98,0.0009447593642325221,0.0011106421733046046,0.5414364640883977
1512,1512,대가/Noun,181,89,92,0.0010114482605312882,0.0010440036429063284,0.5082872928176796
1513,1513,니/Modifier,181,92,89,0.0010447927086806713,0.0010106843777071904,0.5082872928176796
1514,1514,쓰래/Noun,180,10,170,0.0001333777925975325,0.00191030453808392,0.9444444444444444
1515,1515,불쾌하다/Adjective,180,23,157,0.00027787040124485944,0.0017659210555543215,0.8722222222222222
1516,1516,느리다/Adjective,180,42,138,0.0004890519061909527,0.0015548990426264464,0.7666666666666667
1517,1517,까진/Josa,180,62,118,0.0007113482271868402,0.0013327706079655256,0.6555555555555556
1518,1518,악당/Noun,180,65,115,0.0007446926753362233,0.0012994513427663874,0.6388888888888888
1519,1519,완전하다/Adjective,180,78,102,0.00088918528398355,0.001155067860236789,0.5666666666666667
1520,1520,세다/Verb,180,96,84,0.0010892519728798488,0.00095515226904196,0.5333333333333333
1521,1521,싸다/Verb,179,41,138,0.0004779370901411582,0.0015548990426264464,0.770949720670391
1522,1522,촌스럽다/Adjective,179,50,129,0.0005779704345893076,0.0014549412470290322,0.7206703910614525
1523,1523,모/Modifier,179,67,112,0.0007669223074358119,0.0012661320775672494,0.6256983240223464
1524,1524,많이/Modifier,179,99,80,0.001122596421029232,0.000910726582109776,0.553072625698324
1525,1525,인지/Noun,179,82,97,0.0009336445481827276,0.0010995357515715587,0.5418994413407822
1526,1526,날다/Verb,179,85,94,0.0009669889963321108,0.0010662164863724202,0.5251396648044693
1527,1527,새/Noun,179,93,86,0.0010559075247304657,0.000977365112508052,0.5195530726256983
1528,1528,시사회/Noun,179,86,93,0.0009781038123819054,0.0010551100646393743,0.5195530726256983
1529,1529,비주/Noun,179,87,92,0.0009892186284316995,0.0010440036429063284,0.5139664804469274
1530,1530,좀더/Noun,179,89,90,0.0010114482605312882,0.0010217907994402363,0.5027932960893855
1531,1531,그렇다고/Conjunction,178,34,144,0.0004001333777925976,0.0016215375730247227,0.8089887640449438
1532,1532,그걸/Adverb,178,70,108,0.0008002667555851951,0.0012217063906350652,0.6067415730337079
1533,1533,기술/Noun,178,72,106,0.0008224963876847838,0.0011994935471689732,0.5955056179775281
1534,1534,새/Modifier,178,74,104,0.0008447260197843727,0.001177280703702881,0.5842696629213483
1535,1535,무시/Noun,178,74,104,0.0008447260197843727,0.001177280703702881,0.5842696629213483
1536,1536,이제야/Noun,177,157,20,0.0017672557519173055,0.00024434127812701304,0.8870056497175142
1537,1537,적절하다/Adjective,177,137,40,0.0015449594309214182,0.000466469712787934,0.7740112994350282
1538,1538,깨닫다/Verb,177,133,44,0.001500500166722241,0.0005108953997201182,0.7514124293785308
1539,1539,반복/Noun,177,68,109,0.0007780371234856063,0.0012328128123681114,0.615819209039548
1540,1540,공/Modifier,177,70,107,0.0008002667555851951,0.0012105999689020189,0.6045197740112994
1541,1541,입장/Noun,177,83,94,0.0009447593642325221,0.0010662164863724202,0.5310734463276836
1542,1542,당/Modifier,177,87,90,0.0009892186284316995,0.0010217907994402363,0.5084745762711864
1543,1543,오그라들다/Verb,176,19,157,0.0002334111370456819,0.0017659210555543215,0.8920454545454546
1544,1544,긴장/Noun,176,134,42,0.0015116149827720349,0.0004886825562540262,0.7613636363636364
1545,1545,게이/Noun,176,47,129,0.0005446259864399244,0.0014549412470290322,0.7329545454545454
1546,1546,어쩔/Adverb,176,57,119,0.0006557741469378681,0.0013438770296985718,0.6761363636363636
1547,1547,외국/Noun,176,57,119,0.0006557741469378681,0.0013438770296985718,0.6761363636363636
1548,1548,예/Modifier,176,97,79,0.0011003667889296432,0.0008996201603767299,0.5511363636363636
1549,1549,첫/Modifier,176,88,88,0.0010003334444814939,0.0009995779559741444,0.5
1550,1550,언제나/Adverb,175,128,47,0.0014449260864732687,0.0005442146649192564,0.7314285714285714
1551,1551,북한/Noun,175,65,110,0.0007446926753362233,0.0012439192341011573,0.6285714285714286
1552,1552,과는/Josa,175,101,74,0.0011448260531288204,0.0008440880517114996,0.5771428571428572
1553,1553,그린/Noun,175,93,82,0.0010559075247304657,0.000932939425575868,0.5314285714285715
1554,1554,열정/Noun,174,148,26,0.0016672224074691564,0.00031097980852528933,0.8505747126436781
1555,1555,소소하다/Adjective,174,143,31,0.0016116483272201846,0.00036651191719051963,0.8218390804597702
1556,1556,빛나다/Verb,174,131,43,0.001478270534622652,0.0004997889779870722,0.7528735632183908
1557,1557,이루다/Verb,174,126,48,0.0014226964543736804,0.0005553210866523023,0.7241379310344828
1558,1558,불/Noun,174,77,97,0.0008780704679337558,0.0010995357515715587,0.5574712643678161
1559,1559,아픔/Noun,173,146,27,0.0016449927753695677,0.00032208623025833537,0.8439306358381503
1560,1560,창/Noun,173,31,142,0.00036678892964321435,0.0015993247295586306,0.8208092485549133
1561,1561,선생님/Noun,173,129,44,0.0014560409025230633,0.0005108953997201182,0.7456647398843931
1562,1562,병/Noun,173,51,122,0.000589085250639102,0.0013771962948977098,0.7052023121387283
1563,1563,쇼/Noun,173,55,118,0.0006335445148382794,0.0013327706079655256,0.6820809248554913
1564,1564,달라/Noun,173,81,92,0.0009225297321329332,0.0010440036429063284,0.5317919075144508
1565,1565,강렬하다/Adjective,172,147,25,0.0016561075914193618,0.0002998733867922433,0.8546511627906976
1566,1566,화나다/Verb,172,30,142,0.00035567411359342004,0.0015993247295586306,0.8255813953488372
1567,1567,짝/Noun,172,34,138,0.0004001333777925976,0.0015548990426264464,0.8023255813953488
1568,1568,양/Modifier,172,52,120,0.0006002000666888963,0.0013549834514316175,0.6976744186046512
1569,1569,디즈니/Noun,172,114,58,0.0012893186617761474,0.0006663853039827628,0.6627906976744186
1570,1570,늘/Noun,172,101,71,0.0011448260531288204,0.0008107687865123613,0.5872093023255814
1571,1571,종교/Noun,172,80,92,0.0009114149160831386,0.0010440036429063284,0.5348837209302325
1572,1572,는걸/Noun,172,81,91,0.0009225297321329332,0.0010328972211732824,0.5290697674418605
1573,1573,대화/Noun,172,86,86,0.0009781038123819054,0.000977365112508052,0.5
1574,1574,질리/Noun,171,160,11,0.001800600200066689,0.0001443834825295986,0.935672514619883
1575,1575,쩝/Adverb,171,28,143,0.0003334444814938313,0.001610431151291677,0.8362573099415205
1576,1576,극치/Noun,171,28,143,0.0003334444814938313,0.001610431151291677,0.8362573099415205
1577,1577,까지도/Josa,171,135,36,0.0015227297988218294,0.0004220440258557498,0.7894736842105263
1578,1578,밥/Noun,171,47,124,0.0005446259864399244,0.0013994091383638019,0.7251461988304093
1579,1579,희생/Noun,171,112,59,0.0012670890296765588,0.0006774917257158089,0.6549707602339181
1580,1580,채우다/Verb,171,74,97,0.0008447260197843727,0.0010995357515715587,0.5672514619883041
1581,1581,외모/Noun,171,95,76,0.0010781371568300542,0.0008663008951775916,0.5555555555555556
1582,1582,방식/Noun,171,87,84,0.0009892186284316995,0.00095515226904196,0.5087719298245614
1583,1583,찡하다/Adjective,170,165,5,0.001856174280315661,7.774495213132233e-05,0.9705882352941176
1584,1584,주기도/Noun,170,6,164,8.891852839835501e-05,0.001843666007685644,0.9647058823529412
1585,1585,노답/Noun,170,14,156,0.00017783705679671002,0.0017548146338212756,0.9176470588235294
1586,1586,빡치다/Adjective,170,27,143,0.00032232966544403684,0.001610431151291677,0.8411764705882353
1587,1587,남편/Noun,170,55,115,0.0006335445148382794,0.0012994513427663874,0.6764705882352942
1588,1588,분노/Noun,170,67,103,0.0007669223074358119,0.001166174281969835,0.6058823529411764
1589,1589,맡다/Verb,170,74,96,0.0008447260197843727,0.0010884293298385123,0.5647058823529412
1590,1590,대표/Noun,170,75,95,0.0008558408358341669,0.0010773229081054666,0.5588235294117647
1591,1591,흘러가다/Verb,170,75,95,0.0008558408358341669,0.0010773229081054666,0.5588235294117647
1592,1592,형/Noun,170,83,87,0.0009447593642325221,0.0009884715342410985,0.5117647058823529
1593,1593,죄다/Adverb,169,19,150,0.0002334111370456819,0.0016881761034229991,0.8875739644970414
1594,1594,싸구려/Noun,169,21,148,0.00025564076914527065,0.001665963259956907,0.8757396449704142
1595,1595,때우다/Verb,169,36,133,0.00042236300989218633,0.0014993669339612163,0.7869822485207101
1596,1596,에로/Josa,169,39,130,0.00045570745804156943,0.0014660476687620785,0.7692307692307693
1597,1597,마저/Josa,169,51,118,0.000589085250639102,0.0013327706079655256,0.6982248520710059
1598,1598,헐리우드/Noun,169,52,117,0.0006002000666888963,0.0013216641862324795,0.6923076923076923
1599,1599,춤/Noun,169,96,73,0.0010892519728798488,0.0008329816299784535,0.5680473372781065
1600,1600,지는/Josa,169,93,76,0.0010559075247304657,0.0008663008951775916,0.5502958579881657
1601,1601,섬세하다/Adjective,168,146,22,0.0016449927753695677,0.00026655412159310506,0.8690476190476191
1602,1602,풋풋하다/Adjective,168,144,24,0.001622763143269979,0.0002887669650591972,0.8571428571428571
1603,1603,어머니/Noun,168,123,45,0.001389352006224297,0.0005220018214531642,0.7321428571428571
1604,1604,=/Punctuation,168,55,113,0.0006335445148382794,0.0012772384993002955,0.6726190476190477
1605,1605,청소년/Noun,168,62,106,0.0007113482271868402,0.0011994935471689732,0.6309523809523809
1606,1606,시각/Noun,168,102,66,0.0011559408691786152,0.0007552366778471312,0.6071428571428571
1607,1607,왕/Noun,168,75,93,0.0008558408358341669,0.0010551100646393743,0.5535714285714286
1608,1608,로만/Noun,168,78,90,0.00088918528398355,0.0010217907994402363,0.5357142857142857
1609,1609,타/Modifier,168,80,88,0.0009114149160831386,0.0009995779559741444,0.5238095238095238
1610,1610,계/Suffix,168,84,84,0.0009558741802823164,0.00095515226904196,0.5
1611,1611,제로/Noun,167,16,151,0.0002000666888962988,0.0016992825251560453,0.9041916167664672
1612,1612,유발/Noun,167,21,146,0.00025564076914527065,0.001643750416490815,0.8742514970059879
1613,1613,필름/Noun,167,34,133,0.0004001333777925976,0.0014993669339612163,0.7964071856287425
1614,1614,조절/Noun,167,40,127,0.0004668222740913638,0.00143272840356294,0.7604790419161677
1615,1615,놓치다/Verb,167,125,42,0.0014115816383238858,0.0004886825562540262,0.7485029940119761
1616,1616,본인/Noun,167,56,111,0.0006446593308880737,0.0012550256558342032,0.6646706586826348
1617,1617,_/Punctuation,167,106,61,0.0012004001333777929,0.0006997045691819009,0.6347305389221557
1618,1618,싸움/Noun,167,66,101,0.0007558074913860174,0.0011439614385037428,0.6047904191616766
1619,1619,이미지/Noun,167,71,96,0.0008113815716349895,0.0010884293298385123,0.5748502994011976
1620,1620,이나/Noun,167,72,95,0.0008224963876847838,0.0010773229081054666,0.5688622754491018
1621,1621,열/Modifier,167,84,83,0.0009558741802823164,0.000944045847308914,0.5029940119760479
1622,1622,미드/Noun,166,111,55,0.0012559742136267645,0.0006330660387836247,0.6686746987951807
1623,1623,실력/Noun,166,57,109,0.0006557741469378681,0.0012328128123681114,0.6566265060240963
1624,1624,학생/Noun,166,95,71,0.0010781371568300542,0.0008107687865123613,0.572289156626506
1625,1625,오래되다/Adjective,166,90,76,0.0010225630765810826,0.0008663008951775916,0.5421686746987951
1626,1626,단지/Noun,166,83,83,0.0009447593642325221,0.000944045847308914,0.5
1627,1627,조잡하다/Adjective,165,7,158,0.0001000333444481494,0.0017770274772873676,0.9575757575757576
1628,1628,호러/Noun,165,58,107,0.0006668889629876625,0.0012105999689020189,0.6484848484848484
1629,1629,방금/Noun,165,104,61,0.001178170501278204,0.0006997045691819009,0.6303030303030303
1630,1630,금/Noun,165,61,104,0.0007002334111370457,0.001177280703702881,0.6303030303030303
1631,1631,라인/Noun,165,63,102,0.0007224630432366343,0.001155067860236789,0.6181818181818182
1632,1632,깨다/Verb,165,69,96,0.0007891519395354007,0.0010884293298385123,0.5818181818181818
1633,1633,비판/Noun,165,94,71,0.00106702234078026,0.0008107687865123613,0.5696969696969697
1634,1634,편의/Noun,165,73,92,0.0008336112037345782,0.0010440036429063284,0.5575757575757576
1635,1635,최/Noun,165,86,79,0.0009781038123819054,0.0008996201603767299,0.5212121212121212
1636,1636,굿굿/Noun,164,161,3,0.0018117150161164836,5.553210866523024e-05,0.9817073170731708
1637,1637,좋아지다/Verb,164,134,30,0.0015116149827720349,0.0003554054954574735,0.8170731707317073
1638,1638,통쾌하다/Adjective,164,128,36,0.0014449260864732687,0.0004220440258557498,0.7804878048780488
1639,1639,심각하다/Adjective,164,43,121,0.0005001667222407468,0.001366089873164664,0.7378048780487805
1640,1640,맨날/Adverb,164,58,106,0.0006668889629876625,0.0011994935471689732,0.6463414634146342
1641,1641,쫌/Noun,164,59,105,0.0006780037790374569,0.001188387125435927,0.6402439024390244
1642,1642,과의/Josa,164,92,72,0.0010447927086806713,0.0008218752082454075,0.5609756097560976
1643,1643,해석/Noun,164,88,76,0.0010003334444814939,0.0008663008951775916,0.5365853658536586
1644,1644,전문가/Noun,164,87,77,0.0009892186284316995,0.0008774073169106378,0.5304878048780488
1645,1645,지구/Noun,164,87,77,0.0009892186284316995,0.0008774073169106378,0.5304878048780488
1646,1646,어휴/Exclamation,163,21,142,0.00025564076914527065,0.0015993247295586306,0.8711656441717791
1647,1647,실패/Noun,163,27,136,0.00032232966544403684,0.0015326861991603546,0.8343558282208589
1648,1648,아줌마/Noun,163,46,117,0.00053351117039013,0.0013216641862324795,0.7177914110429447
1649,1649,닮다/Verb,163,99,64,0.001122596421029232,0.0007330238343810393,0.6073619631901841
1650,1650,동안/Foreign,163,70,93,0.0008002667555851951,0.0010551100646393743,0.5705521472392638
1651,1651,동물/Noun,163,92,71,0.0010447927086806713,0.0008107687865123613,0.5644171779141104
1652,1652,담/Noun,163,75,88,0.0008558408358341669,0.0009995779559741444,0.5398773006134969
1653,1653,훨/Noun,163,75,88,0.0008558408358341669,0.0009995779559741444,0.5398773006134969
1654,1654,다가오다/Verb,162,132,30,0.0014893853506724466,0.0003554054954574735,0.8148148148148148
1655,1655,은근/Noun,162,127,35,0.0014338112704234743,0.0004109376041227037,0.7839506172839507
1656,1656,심장/Noun,162,126,36,0.0014226964543736804,0.0004220440258557498,0.7777777777777778
1657,1657,바라보다/Verb,162,126,36,0.0014226964543736804,0.0004220440258557498,0.7777777777777778
1658,1658,씁쓸하다/Adjective,162,120,42,0.0013560075580749138,0.0004886825562540262,0.7407407407407407
1659,1659,편하다/Adjective,162,108,54,0.0012226297654773814,0.0006219596170505788,0.6666666666666666
1660,1660,따라가다/Verb,162,56,106,0.0006446593308880737,0.0011994935471689732,0.654320987654321
1661,1661,조합/Noun,162,98,64,0.0011114816049794377,0.0007330238343810393,0.6049382716049383
1662,1662,낳다/Verb,162,89,73,0.0010114482605312882,0.0008329816299784535,0.5493827160493827
1663,1663,방법/Noun,162,86,76,0.0009781038123819054,0.0008663008951775916,0.5308641975308642
1664,1664,돌다/Verb,162,85,77,0.0009669889963321108,0.0008774073169106378,0.5246913580246914
1665,1665,기르다/Verb,162,80,82,0.0009114149160831386,0.000932939425575868,0.5061728395061729
1666,1666,없어지다/Verb,161,37,124,0.0004334778259419807,0.0013994091383638019,0.7701863354037267
1667,1667,숨다/Verb,161,121,40,0.0013671223741247086,0.000466469712787934,0.7515527950310559
1668,1668,ㄷㄷㄷ/KoreanParticle,161,96,65,0.0010892519728798488,0.0007441302561140852,0.5962732919254659
1669,1669,즈/Modifier,161,92,69,0.0010447927086806713,0.0007885559430462694,0.5714285714285714
1670,1670,인/Suffix,161,70,91,0.0008002667555851951,0.0010328972211732824,0.5652173913043478
1671,1671,1시간/Number,160,35,125,0.0004112481938423919,0.001410515560096848,0.78125
1672,1672,늦다/Verb,160,123,37,0.001389352006224297,0.0004331504475887958,0.76875
1673,1673,아이돌/Noun,160,54,106,0.0006224296987884852,0.0011994935471689732,0.6625
1674,1674,한국인/Noun,160,57,103,0.0006557741469378681,0.001166174281969835,0.64375
1675,1675,입다/Verb,160,59,101,0.0006780037790374569,0.0011439614385037428,0.63125
1676,1676,히어로/Noun,160,97,63,0.0011003667889296432,0.0007219174126479931,0.60625
1677,1677,뽑다/Verb,160,68,92,0.0007780371234856063,0.0010440036429063284,0.575
1678,1678,악/Noun,160,74,86,0.0008447260197843727,0.000977365112508052,0.5375
1679,1679,팀/Noun,160,80,80,0.0009114149160831386,0.000910726582109776,0.5
1680,1680,명품/Noun,159,135,24,0.0015227297988218294,0.0002887669650591972,0.8490566037735849
1681,1681,존경/Noun,159,126,33,0.0014226964543736804,0.00038872476065661166,0.7924528301886793
1682,1682,더불다/Verb,159,117,42,0.0013226631099255307,0.0004886825562540262,0.7358490566037735
1683,1683,신나다/Adjective,159,111,48,0.0012559742136267645,0.0005553210866523023,0.6981132075471698
1684,1684,이끌다/Verb,159,94,65,0.00106702234078026,0.0007441302561140852,0.5911949685534591
1685,1685,꾸다/Verb,159,83,76,0.0009447593642325221,0.0008663008951775916,0.5220125786163522
1686,1686,시트콤/Noun,158,109,49,0.0012337445815271755,0.0005664275083853486,0.689873417721519
1687,1687,어쩔/Modifier,158,50,108,0.0005779704345893076,0.0012217063906350652,0.6835443037974683
1688,1688,성/Noun,158,56,102,0.0006446593308880737,0.001155067860236789,0.6455696202531646
1689,1689,대부분/Noun,158,60,98,0.0006891185950872514,0.0011106421733046046,0.620253164556962
1690,1690,겁니다/Verb,158,93,65,0.0010559075247304657,0.0007441302561140852,0.5886075949367089
1691,1691,국내/Noun,158,87,71,0.0009892186284316995,0.0008107687865123613,0.5506329113924051
1692,1692,가깝다/Adjective,158,77,81,0.0008780704679337558,0.000921833003842822,0.5126582278481012
1693,1693,짠하다/Adjective,157,146,11,0.0016449927753695677,0.0001443834825295986,0.929936305732484
1694,1694,푹/Noun,157,137,20,0.0015449594309214182,0.00024434127812701304,0.8726114649681529
1695,1695,만족/Noun,157,113,44,0.0012782038457263534,0.0005108953997201182,0.7197452229299363
1696,1696,이니/Josa,157,56,101,0.0006446593308880737,0.0011439614385037428,0.643312101910828
1697,1697,주말/Noun,157,99,58,0.001122596421029232,0.0006663853039827628,0.6305732484076433
1698,1698,신분/Noun,157,99,58,0.001122596421029232,0.0006663853039827628,0.6305732484076433
1699,1699,쵝오/Noun,156,151,5,0.0017005668556185395,7.774495213132233e-05,0.9679487179487181
1700,1700,세기/Noun,156,90,66,0.0010225630765810826,0.0007552366778471312,0.5769230769230769
1701,1701,직접/Noun,156,87,69,0.0009892186284316995,0.0007885559430462694,0.5576923076923077
1702,1702,분명/Noun,156,73,83,0.0008336112037345782,0.000944045847308914,0.532051282051282
1703,1703,거슬리다/Verb,155,35,120,0.0004112481938423919,0.0013549834514316175,0.7741935483870968
1704,1704,전개도/Noun,155,54,101,0.0006224296987884852,0.0011439614385037428,0.6516129032258065
1705,1705,30/Number,155,98,57,0.0011114816049794377,0.0006552788822497168,0.6322580645161291
1706,1706,의리/Noun,155,89,66,0.0010114482605312882,0.0007552366778471312,0.5741935483870968
1707,1707,미모/Noun,155,88,67,0.0010003334444814939,0.0007663430995801773,0.567741935483871
1708,1708,줍다/Verb,155,72,83,0.0008224963876847838,0.000944045847308914,0.535483870967742
1709,1709,짝퉁/Noun,154,7,147,0.0001000333444481494,0.0016548568382238609,0.9545454545454546
1710,1710,개뿔/Noun,154,7,147,0.0001000333444481494,0.0016548568382238609,0.9545454545454546
1711,1711,양심/Noun,154,28,126,0.0003334444814938313,0.001421621981829894,0.8181818181818182
1712,1712,????/Punctuation,154,36,118,0.00042236300989218633,0.0013327706079655256,0.7662337662337663
1713,1713,누군가/Noun,154,118,36,0.001333777925975325,0.0004220440258557498,0.7662337662337663
1714,1714,그거/Noun,154,45,109,0.0005223963543403357,0.0012328128123681114,0.7077922077922078
1715,1715,개념/Noun,154,49,105,0.0005668556185395131,0.001188387125435927,0.6818181818181818
1716,1716,이자/Noun,154,103,51,0.0011670556852284096,0.0005886403518514405,0.6688311688311688
1717,1717,시원하다/Adjective,154,103,51,0.0011670556852284096,0.0005886403518514405,0.6688311688311688
1718,1718,으로만/Josa,154,55,99,0.0006335445148382794,0.0011217485950376508,0.6428571428571429
1719,1719,끼/Noun,154,58,96,0.0006668889629876625,0.0010884293298385123,0.6233766233766234
1720,1720,돌아오다/Verb,154,93,61,0.0010559075247304657,0.0006997045691819009,0.6038961038961039
1721,1721,민망하다/Adjective,153,16,137,0.0002000666888962988,0.0015437926208934005,0.8954248366013072
1722,1722,망/Noun,153,19,134,0.0002334111370456819,0.0015104733556942625,0.8758169934640523
1723,1723,연예인/Noun,153,27,126,0.00032232966544403684,0.001421621981829894,0.8235294117647058
1724,1724,도안/Noun,153,38,115,0.000444592641991775,0.0012994513427663874,0.7516339869281046
1725,1725,해내다/Verb,153,114,39,0.0012893186617761474,0.000455363291054888,0.7450980392156863
1726,1726,가요/Noun,153,39,114,0.00045570745804156943,0.0012883449210333415,0.7450980392156863
1727,1727,전반/Noun,153,49,104,0.0005668556185395131,0.001177280703702881,0.6797385620915033
1728,1728,진리/Noun,153,101,52,0.0011448260531288204,0.0005997467735844866,0.6601307189542484
1729,1729,이정/Noun,153,60,93,0.0006891185950872514,0.0010551100646393743,0.6078431372549019
1730,1730,이란/Noun,153,91,62,0.001033677892630877,0.000710810990914947,0.5947712418300654
1731,1731,에피소드/Noun,153,70,83,0.0008002667555851951,0.000944045847308914,0.5424836601307189
1732,1732,애기/Noun,153,74,79,0.0008447260197843727,0.0008996201603767299,0.5163398692810458
1733,1733,돌아보다/Verb,152,143,9,0.0016116483272201846,0.00012217063906350652,0.9407894736842104
1734,1734,의외로/Adverb,152,129,23,0.0014560409025230633,0.00027766054332615115,0.8486842105263158
1735,1735,여행/Noun,152,104,48,0.001178170501278204,0.0005553210866523023,0.6842105263157895
1736,1736,향/Noun,152,100,52,0.0011337112370790265,0.0005997467735844866,0.6578947368421053
1737,1737,19/Number,152,56,96,0.0006446593308880737,0.0010884293298385123,0.631578947368421
1738,1738,레알/Noun,152,63,89,0.0007224630432366343,0.0010106843777071904,0.5855263157894737
1739,1739,생활/Noun,152,87,65,0.0009892186284316995,0.0007441302561140852,0.5723684210526315
1740,1740,찝찝하다/Adjective,151,30,121,0.00035567411359342004,0.001366089873164664,0.8013245033112583
1741,1741,사기/Noun,151,33,118,0.00038901856174280313,0.0013327706079655256,0.7814569536423841
1742,1742,과장/Noun,151,51,100,0.000589085250639102,0.0011328550167706971,0.6622516556291391
1743,1743,스스로/Noun,151,86,65,0.0009781038123819054,0.0007441302561140852,0.5695364238410596
1744,1744,쩌/Noun,151,79,72,0.0009003001000333445,0.0008218752082454075,0.5231788079470199
1745,1745,봣는데/Noun,151,79,72,0.0009003001000333445,0.0008218752082454075,0.5231788079470199
1746,1746,단/Modifier,151,72,79,0.0008224963876847838,0.0008996201603767299,0.5231788079470199
1747,1747,테러/Noun,151,78,73,0.00088918528398355,0.0008329816299784535,0.5165562913907285
1748,1748,가득하다/Adjective,151,76,75,0.0008669556518839612,0.0008551944734445456,0.5033112582781457
1749,1749,신다/Verb,151,76,75,0.0008669556518839612,0.0008551944734445456,0.5033112582781457
1750,1750,라지/Noun,150,18,132,0.0002222963209958875,0.0014882605122281704,0.88
1751,1751,날리다/Verb,150,30,120,0.00035567411359342004,0.0013549834514316175,0.8
1752,1752,갈등/Noun,150,95,55,0.0010781371568300542,0.0006330660387836247,0.6333333333333333
1753,1753,하나로/Noun,150,88,62,0.0010003334444814939,0.000710810990914947,0.5866666666666667
1754,1754,한참/Noun,150,62,88,0.0007113482271868402,0.0009995779559741444,0.5866666666666667
1755,1755,헐리웃/Noun,150,66,84,0.0007558074913860174,0.00095515226904196,0.56
1756,1756,막히다/Verb,150,84,66,0.0009558741802823164,0.0007552366778471312,0.56
1757,1757,로봇/Noun,150,83,67,0.0009447593642325221,0.0007663430995801773,0.5533333333333333
1758,1758,문/Modifier,150,67,83,0.0007669223074358119,0.000944045847308914,0.5533333333333333
1759,1759,유/Noun,150,68,82,0.0007780371234856063,0.000932939425575868,0.5466666666666666
1760,1760,근/Modifier,150,76,74,0.0008669556518839612,0.0008440880517114996,0.5066666666666667
1761,1761,낭비하다/Adjective,149,2,147,4.445926419917751e-05,0.0016548568382238609,0.9865771812080536
1762,1762,단연/Noun,149,128,21,0.0014449260864732687,0.0002554476998600591,0.8590604026845637
1763,1763,무척/Noun,149,114,35,0.0012893186617761474,0.0004109376041227037,0.7651006711409396
1764,1764,성장/Noun,149,110,39,0.00124485939757697,0.000455363291054888,0.7382550335570469
1765,1765,......../Punctuation,149,45,104,0.0005223963543403357,0.001177280703702881,0.6979865771812079
1766,1766,번째/Suffix,149,95,54,0.0010781371568300542,0.0006219596170505788,0.6375838926174496
1767,1767,초등학생/Noun,149,56,93,0.0006446593308880737,0.0010551100646393743,0.6241610738255033
1768,1768,연속/Noun,149,59,90,0.0006780037790374569,0.0010217907994402363,0.6040268456375839
1769,1769,주변/Noun,149,88,61,0.0010003334444814939,0.0006997045691819009,0.5906040268456376
1770,1770,경험/Noun,149,87,62,0.0009892186284316995,0.000710810990914947,0.5838926174496645
1771,1771,한데/Eomi,149,63,86,0.0007224630432366343,0.000977365112508052,0.5771812080536913
1772,1772,섹시하다/Adjective,149,84,65,0.0009558741802823164,0.0007441302561140852,0.5637583892617449
1773,1773,&/Punctuation,149,81,68,0.0009225297321329332,0.0007774495213132232,0.5436241610738255
1774,1774,오르다/Verb,149,81,68,0.0009225297321329332,0.0007774495213132232,0.5436241610738255
1775,1775,이도/Noun,148,5,143,7.780371234856063e-05,0.001610431151291677,0.9662162162162162
1776,1776,상/Noun,148,44,104,0.0005112815382905413,0.001177280703702881,0.7027027027027027
1777,1777,피해자/Noun,148,44,104,0.0005112815382905413,0.001177280703702881,0.7027027027027027
1778,1778,감히/Noun,148,97,51,0.0011003667889296432,0.0005886403518514405,0.6554054054054054
1779,1779,뒷/Modifier,148,53,95,0.0006113148827386907,0.0010773229081054666,0.6418918918918919
1780,1780,김기덕/Noun,148,63,85,0.0007224630432366343,0.0009662586907750061,0.5743243243243243
1781,1781,꽝/Noun,147,8,139,0.00011114816049794375,0.0015660054643594926,0.9455782312925172
1782,1782,라이/Noun,147,28,119,0.0003334444814938313,0.0013438770296985718,0.8095238095238095
1783,1783,편견/Noun,147,103,44,0.0011670556852284096,0.0005108953997201182,0.7006802721088435
1784,1784,베스트/Noun,147,97,50,0.0011003667889296432,0.0005775339301183945,0.6598639455782312
1785,1785,이여/Josa,147,86,61,0.0009781038123819054,0.0006997045691819009,0.5850340136054422
1786,1786,견자단/Noun,147,68,79,0.0007780371234856063,0.0008996201603767299,0.5374149659863946
1787,1787,맨/Noun,147,77,70,0.0008780704679337558,0.0007996623647793153,0.5238095238095238
1788,1788,으로서/Josa,147,76,71,0.0008669556518839612,0.0008107687865123613,0.5170068027210885
1789,1789,사수/Noun,146,132,14,0.0014893853506724466,0.00017770274772873674,0.9041095890410958
1790,1790,허세/Noun,146,18,128,0.0002222963209958875,0.0014438348252959862,0.8767123287671232
1791,1791,와우/Noun,146,125,21,0.0014115816383238858,0.0002554476998600591,0.8561643835616438
1792,1792,명성/Noun,146,25,121,0.00030010003334444816,0.001366089873164664,0.8287671232876712
1793,1793,얘/Noun,146,40,106,0.0004668222740913638,0.0011994935471689732,0.726027397260274
1794,1794,올라가다/Verb,146,98,48,0.0011114816049794377,0.0005553210866523023,0.6712328767123288
1795,1795,확/Noun,146,50,96,0.0005779704345893076,0.0010884293298385123,0.6575342465753424
1796,1796,의식/Noun,146,61,85,0.0007002334111370457,0.0009662586907750061,0.5821917808219178
1797,1797,부모/Noun,146,80,66,0.0009114149160831386,0.0007552366778471312,0.547945205479452
1798,1798,아마/Noun,146,78,68,0.00088918528398355,0.0007774495213132232,0.5342465753424658
1799,1799,검색/Noun,146,78,68,0.00088918528398355,0.0007774495213132232,0.5342465753424658
1800,1800,성공하다/Adjective,146,69,77,0.0007891519395354007,0.0008774073169106378,0.5273972602739726
1801,1801,카/Noun,146,76,70,0.0008669556518839612,0.0007996623647793153,0.5205479452054794
1802,1802,맥/Noun,146,76,70,0.0008669556518839612,0.0007996623647793153,0.5205479452054794
1803,1803,개막/Noun,145,9,136,0.00012226297654773814,0.0015326861991603546,0.9379310344827586
1804,1804,생생하다/Adjective,145,134,11,0.0015116149827720349,0.0001443834825295986,0.9241379310344828
1805,1805,^/Punctuation,145,102,43,0.0011559408691786152,0.0004997889779870722,0.7034482758620689
1806,1806,연결/Noun,145,50,95,0.0005779704345893076,0.0010773229081054666,0.6551724137931034
1807,1807,영어/Noun,145,59,86,0.0006780037790374569,0.000977365112508052,0.593103448275862
1808,1808,외계인/Noun,145,64,81,0.0007335778592864287,0.000921833003842822,0.5586206896551724
1809,1809,뭉클하다/Adjective,144,139,5,0.0015671890630210071,7.774495213132233e-05,0.9652777777777778
1810,1810,마이너스/Noun,144,7,137,0.0001000333444481494,0.0015437926208934005,0.9513888888888888
1811,1811,밋밋하다/Adjective,144,18,126,0.0002222963209958875,0.001421621981829894,0.875
1812,1812,묘/Noun,144,118,26,0.001333777925975325,0.00031097980852528933,0.8194444444444444
1813,1813,...?/Punctuation,144,54,90,0.0006224296987884852,0.0010217907994402363,0.625
1814,1814,만큼은/Josa,144,90,54,0.0010225630765810826,0.0006219596170505788,0.625
1815,1815,쪽/Noun,144,57,87,0.0006557741469378681,0.0009884715342410985,0.6041666666666666
1816,1816,오브/Noun,144,74,70,0.0008447260197843727,0.0007996623647793153,0.5138888888888888
1817,1817,저/Modifier,143,26,117,0.00031121484939424253,0.0013216641862324795,0.8181818181818182
1818,1818,풍경/Noun,143,101,42,0.0011448260531288204,0.0004886825562540262,0.7062937062937062
1819,1819,처/Noun,143,44,99,0.0005112815382905413,0.0011217485950376508,0.6923076923076923
1820,1820,드물다/Adjective,143,98,45,0.0011114816049794377,0.0005220018214531642,0.6853146853146853
1821,1821,무언가/Noun,143,97,46,0.0011003667889296432,0.0005331082431862101,0.6783216783216783
1822,1822,이보/Noun,143,79,64,0.0009003001000333445,0.0007330238343810393,0.5524475524475524
1823,1823,이든/Josa,143,77,66,0.0008780704679337558,0.0007552366778471312,0.5384615384615384
1824,1824,ㅉㅉㅉ/KoreanParticle,142,15,127,0.00018895187284650438,0.00143272840356294,0.8943661971830986
1825,1825,싸이코/Noun,142,29,113,0.0003445592975436257,0.0012772384993002955,0.7957746478873241
1826,1826,만들기/Noun,142,30,112,0.00035567411359342004,0.0012661320775672494,0.7887323943661971
1827,1827,자연스럽다/Adjective,142,112,30,0.0012670890296765588,0.0003554054954574735,0.7887323943661971
1828,1828,복잡하다/Adjective,142,92,50,0.0010447927086806713,0.0005775339301183945,0.647887323943662
1829,1829,개성/Noun,142,87,55,0.0009892186284316995,0.0006330660387836247,0.6126760563380281
1830,1830,도전/Noun,142,73,69,0.0008336112037345782,0.0007885559430462694,0.5140845070422535
1831,1831,달달/Noun,141,125,16,0.0014115816383238858,0.00019991559119482882,0.8865248226950354
1832,1832,어린시절/Noun,141,123,18,0.001389352006224297,0.00022212843466092096,0.8723404255319149
1833,1833,정체/Noun,141,30,111,0.00035567411359342004,0.0012550256558342032,0.7872340425531915
1834,1834,막장드라마/Noun,141,32,109,0.00037790374569300877,0.0012328128123681114,0.7730496453900709
1835,1835,왠/Modifier,141,33,108,0.00038901856174280313,0.0012217063906350652,0.7659574468085106
1836,1836,마이클/Noun,141,91,50,0.001033677892630877,0.0005775339301183945,0.6453900709219859
1837,1837,옆/Noun,141,63,78,0.0007224630432366343,0.0008885137386436838,0.5531914893617021
1838,1838,무지/Noun,141,77,64,0.0008780704679337558,0.0007330238343810393,0.5460992907801419
1839,1839,조/Noun,141,65,76,0.0007446926753362233,0.0008663008951775916,0.5390070921985816
1840,1840,기준/Noun,141,75,66,0.0008558408358341669,0.0007552366778471312,0.5319148936170213
1841,1841,끌리다/Verb,141,73,68,0.0008336112037345782,0.0007774495213132232,0.5177304964539007
1842,1842,♥♥/Foreign,140,140,0,0.0015783038790708015,2.2212843466092093e-05,1.0
1843,1843,숨기다/Verb,140,114,26,0.0012893186617761474,0.00031097980852528933,0.8142857142857143
1844,1844,세월/Noun,140,105,35,0.0011892853173279985,0.0004109376041227037,0.75
1845,1845,캐리/Noun,140,104,36,0.001178170501278204,0.0004220440258557498,0.7428571428571429
1846,1846,변화/Noun,140,91,49,0.001033677892630877,0.0005664275083853486,0.65
1847,1847,빨다/Verb,140,54,86,0.0006224296987884852,0.000977365112508052,0.6142857142857143
1848,1848,으로써/Josa,140,83,57,0.0009447593642325221,0.0006552788822497168,0.5928571428571429
1849,1849,코난/Noun,140,82,58,0.0009336445481827276,0.0006663853039827628,0.5857142857142857
1850,1850,이상은/Noun,140,67,73,0.0007669223074358119,0.0008329816299784535,0.5214285714285715
1851,1851,등등/Noun,140,68,72,0.0007780371234856063,0.0008218752082454075,0.5142857142857142
1852,1852,일품/Noun,139,126,13,0.0014226964543736804,0.0001665963259956907,0.9064748201438848
1853,1853,젠장/Noun,139,22,117,0.000266755585195065,0.0013216641862324795,0.8417266187050358
1854,1854,기회/Noun,139,106,33,0.0012004001333777929,0.00038872476065661166,0.7625899280575541
1855,1855,카리스마/Noun,139,105,34,0.0011892853173279985,0.00039983118238965764,0.7553956834532374
1856,1856,남아/Noun,139,97,42,0.0011003667889296432,0.0004886825562540262,0.6978417266187049
1857,1857,깎다/Verb,139,61,78,0.0007002334111370457,0.0008885137386436838,0.5611510791366906
1858,1858,아/Noun,138,27,111,0.00032232966544403684,0.0012550256558342032,0.8043478260869565
1859,1859,칼/Noun,138,41,97,0.0004779370901411582,0.0010995357515715587,0.7028985507246377
1860,1860,신경/Noun,138,42,96,0.0004890519061909527,0.0010884293298385123,0.6956521739130435
1861,1861,자살/Noun,138,43,95,0.0005001667222407468,0.0010773229081054666,0.6884057971014492
1862,1862,오빠/Noun,138,95,43,0.0010781371568300542,0.0004997889779870722,0.6884057971014492
1863,1863,맨/Modifier,138,51,87,0.000589085250639102,0.0009884715342410985,0.6304347826086957
1864,1864,면서/Noun,138,84,54,0.0009558741802823164,0.0006219596170505788,0.6086956521739131
1865,1865,덜/Noun,138,57,81,0.0006557741469378681,0.000921833003842822,0.5869565217391305
1866,1866,시청/Noun,138,74,64,0.0008447260197843727,0.0007330238343810393,0.5362318840579711
1867,1867,니깐/Josa,138,74,64,0.0008447260197843727,0.0007330238343810393,0.5362318840579711
1868,1868,얼마/Noun,138,67,71,0.0007669223074358119,0.0008107687865123613,0.5144927536231884
1869,1869,포르노/Noun,137,16,121,0.0002000666888962988,0.001366089873164664,0.8832116788321168
1870,1870,C/Alpha,137,16,121,0.0002000666888962988,0.001366089873164664,0.8832116788321168
1871,1871,응원/Noun,137,116,21,0.0013115482938757365,0.0002554476998600591,0.8467153284671532
1872,1872,겨/Noun,137,26,111,0.00031121484939424253,0.0012550256558342032,0.8102189781021898
1873,1873,압권/Noun,137,111,26,0.0012559742136267645,0.00031097980852528933,0.8102189781021898
1874,1874,다양하다/Adjective,137,99,38,0.001122596421029232,0.0004442568693218419,0.7226277372262774
1875,1875,모으다/Verb,137,39,98,0.00045570745804156943,0.0011106421733046046,0.7153284671532847
1876,1876,형사/Noun,137,43,94,0.0005001667222407468,0.0010662164863724202,0.6861313868613139
1877,1877,만해/Noun,137,91,46,0.001033677892630877,0.0005331082431862101,0.6642335766423357
1878,1878,",,,,/Punctuation",137,50,87,0.0005779704345893076,0.0009884715342410985,0.635036496350365
1879,1879,잠깐/Noun,137,52,85,0.0006002000666888963,0.0009662586907750061,0.6204379562043796
1880,1880,매/Modifier,137,82,55,0.0009336445481827276,0.0006330660387836247,0.5985401459854015
1881,1881,뿐이다/Adjective,137,56,81,0.0006446593308880737,0.000921833003842822,0.5912408759124088
1882,1882,기자/Noun,137,79,58,0.0009003001000333445,0.0006663853039827628,0.5766423357664233
1883,1883,살아나다/Verb,137,78,59,0.00088918528398355,0.0006774917257158089,0.5693430656934306
1884,1884,?!/Punctuation,137,64,73,0.0007335778592864287,0.0008329816299784535,0.5328467153284672
1885,1885,특이하다/Adjective,137,69,68,0.0007891519395354007,0.0007774495213132232,0.5036496350364964
1886,1886,시시하다/Adjective,136,23,113,0.00027787040124485944,0.0012772384993002955,0.8308823529411765
1887,1887,세번/Noun,136,110,26,0.00124485939757697,0.00031097980852528933,0.8088235294117647
1888,1888,냥/Josa,136,31,105,0.00036678892964321435,0.001188387125435927,0.7720588235294118
1889,1889,만에/Josa,136,101,35,0.0011448260531288204,0.0004109376041227037,0.7426470588235294
1890,1890,내면/Noun,136,99,37,0.001122596421029232,0.0004331504475887958,0.7279411764705882
1891,1891,성격/Noun,136,41,95,0.0004779370901411582,0.0010773229081054666,0.6985294117647058
1892,1892,선물/Noun,136,95,41,0.0010781371568300542,0.00047757613452098,0.6985294117647058
1893,1893,동시/Noun,136,90,46,0.0010225630765810826,0.0005331082431862101,0.6617647058823529
1894,1894,로써/Noun,136,70,66,0.0008002667555851951,0.0007552366778471312,0.5147058823529411
1895,1895,신고/Noun,136,66,70,0.0007558074913860174,0.0007996623647793153,0.5147058823529411
1896,1896,러브/Noun,136,69,67,0.0007891519395354007,0.0007663430995801773,0.5073529411764706
1897,1897,에로영화/Noun,135,22,113,0.000266755585195065,0.0012772384993002955,0.837037037037037
1898,1898,겨우/Noun,135,22,113,0.000266755585195065,0.0012772384993002955,0.837037037037037
1899,1899,추하다/Adjective,135,108,27,0.0012226297654773814,0.00032208623025833537,0.8
1900,1900,적임/Noun,135,96,39,0.0010892519728798488,0.000455363291054888,0.7111111111111111
1901,1901,만족하다/Adjective,135,93,42,0.0010559075247304657,0.0004886825562540262,0.6888888888888889
1902,1902,형제/Noun,135,91,44,0.001033677892630877,0.0005108953997201182,0.674074074074074
1903,1903,조용하다/Adjective,135,90,45,0.0010225630765810826,0.0005220018214531642,0.6666666666666666
1904,1904,할머니/Noun,135,87,48,0.0009892186284316995,0.0005553210866523023,0.6444444444444445
1905,1905,빈/Noun,135,57,78,0.0006557741469378681,0.0008885137386436838,0.5777777777777777
1906,1906,고양이/Noun,135,64,71,0.0007335778592864287,0.0008107687865123613,0.5259259259259259
1907,1907,아내/Noun,135,70,65,0.0008002667555851951,0.0007441302561140852,0.5185185185185185
1908,1908,참으로/Noun,135,69,66,0.0007891519395354007,0.0007552366778471312,0.5111111111111111
1909,1909,가수/Noun,135,66,69,0.0007558074913860174,0.0007885559430462694,0.5111111111111111
1910,1910,야동/Noun,134,25,109,0.00030010003334444816,0.0012328128123681114,0.8134328358208955
1911,1911,롭고/Josa,134,108,26,0.0012226297654773814,0.00031097980852528933,0.8059701492537313
1912,1912,당/Suffix,134,44,90,0.0005112815382905413,0.0010217907994402363,0.6716417910447762
1913,1913,[/Punctuation,134,44,90,0.0005112815382905413,0.0010217907994402363,0.6716417910447762
1914,1914,스럽지/Josa,134,87,47,0.0009892186284316995,0.0005442146649192564,0.6492537313432836
1915,1915,멈추다/Verb,134,84,50,0.0009558741802823164,0.0005775339301183945,0.6268656716417911
1916,1916,넌/Noun,134,54,80,0.0006224296987884852,0.000910726582109776,0.5970149253731343
1917,1917,우와/Exclamation,134,80,54,0.0009114149160831386,0.0006219596170505788,0.5970149253731343
1918,1918,인들/Josa,134,57,77,0.0006557741469378681,0.0008774073169106378,0.5746268656716418
1919,1919,정의/Noun,134,77,57,0.0008780704679337558,0.0006552788822497168,0.5746268656716418
1920,1920,분명하다/Adjective,134,71,63,0.0008113815716349895,0.0007219174126479931,0.5298507462686567
1921,1921,벗어나다/Verb,134,63,71,0.0007224630432366343,0.0008107687865123613,0.5298507462686567
1922,1922,줄다/Verb,134,64,70,0.0007335778592864287,0.0007996623647793153,0.5223880597014925
1923,1923,장/Noun,134,65,69,0.0007446926753362233,0.0007885559430462694,0.5149253731343284
1924,1924,투자/Noun,133,20,113,0.00024452595309547634,0.0012772384993002955,0.849624060150376
1925,1925,레전드/Noun,133,108,25,0.0012226297654773814,0.0002998733867922433,0.8120300751879699
1926,1926,지우다/Verb,133,30,103,0.00035567411359342004,0.001166174281969835,0.7744360902255639
1927,1927,고통/Noun,133,95,38,0.0010781371568300542,0.0004442568693218419,0.7142857142857143
1928,1928,비현실적/Noun,133,41,92,0.0004779370901411582,0.0010440036429063284,0.6917293233082706
1929,1929,욕망/Noun,133,90,43,0.0010225630765810826,0.0004997889779870722,0.6766917293233082
1930,1930,쉬/Noun,133,90,43,0.0010225630765810826,0.0004997889779870722,0.6766917293233082
1931,1931,방영/Noun,133,85,48,0.0009669889963321108,0.0005553210866523023,0.6390977443609023
1932,1932,영혼/Noun,133,82,51,0.0009336445481827276,0.0005886403518514405,0.6165413533834586
1933,1933,관점/Noun,133,77,56,0.0008780704679337558,0.0006441724605166707,0.5789473684210527
1934,1934,온/Modifier,133,61,72,0.0007002334111370457,0.0008218752082454075,0.5413533834586466
1935,1935,투/Noun,133,68,65,0.0007780371234856063,0.0007441302561140852,0.5112781954887218
1936,1936,듬/Noun,133,68,65,0.0007780371234856063,0.0007441302561140852,0.5112781954887218
1937,1937,진하다/Adjective,132,119,13,0.0013448927420251196,0.0001665963259956907,0.9015151515151516
1938,1938,초등학교/Noun,132,99,33,0.001122596421029232,0.00038872476065661166,0.75
1939,1939,학년/Noun,132,96,36,0.0010892519728798488,0.0004220440258557498,0.7272727272727273
1940,1940,로그인/Noun,132,41,91,0.0004779370901411582,0.0010328972211732824,0.6893939393939394
1941,1941,베/Noun,132,45,87,0.0005223963543403357,0.0009884715342410985,0.6590909090909091
1942,1942,을/Foreign,132,45,87,0.0005223963543403357,0.0009884715342410985,0.6590909090909091
1943,1943,특수/Noun,132,48,84,0.0005557408024897189,0.00095515226904196,0.6363636363636364
1944,1944,감안/Noun,132,51,81,0.000589085250639102,0.000921833003842822,0.6136363636363636
1945,1945,21/Number,132,79,53,0.0009003001000333445,0.0006108531953175326,0.5984848484848485
1946,1946,12/Number,132,54,78,0.0006224296987884852,0.0008885137386436838,0.5909090909090909
1947,1947,상업/Noun,132,55,77,0.0006335445148382794,0.0008774073169106378,0.5833333333333334
1948,1948,타/Noun,132,76,56,0.0008669556518839612,0.0006441724605166707,0.5757575757575758
1949,1949,의/Foreign,132,70,62,0.0008002667555851951,0.000710810990914947,0.5303030303030303
1950,1950,M/Alpha,131,5,126,7.780371234856063e-05,0.001421621981829894,0.9618320610687024
1951,1951,잠들다/Verb,131,17,114,0.00021118150494609317,0.0012883449210333415,0.8702290076335878
1952,1952,감흥/Noun,131,19,112,0.0002334111370456819,0.0012661320775672494,0.8549618320610687
1953,1953,붙이다/Verb,131,21,110,0.00025564076914527065,0.0012439192341011573,0.8396946564885496
1954,1954,부럽다/Adjective,131,106,25,0.0012004001333777929,0.0002998733867922433,0.8091603053435115
1955,1955,설득/Noun,131,30,101,0.00035567411359342004,0.0011439614385037428,0.7709923664122137
1956,1956,따로/Adverb,131,31,100,0.00036678892964321435,0.0011328550167706971,0.7633587786259542
1957,1957,]/Punctuation,131,38,93,0.000444592641991775,0.0010551100646393743,0.7099236641221374
1958,1958,끝내주다/Adjective,131,91,40,0.001033677892630877,0.000466469712787934,0.6946564885496184
1959,1959,놀랍다/Adjective,131,91,40,0.001033677892630877,0.000466469712787934,0.6946564885496184
1960,1960,권/Suffix,131,84,47,0.0009558741802823164,0.0005442146649192564,0.6412213740458015
1961,1961,그건/Adverb,131,55,76,0.0006335445148382794,0.0008663008951775916,0.5801526717557252
1962,1962,채/Noun,131,59,72,0.0006780037790374569,0.0008218752082454075,0.5496183206106869
1963,1963,일이/Modifier,131,62,69,0.0007113482271868402,0.0007885559430462694,0.5267175572519084
1964,1964,반하다/Adjective,130,112,18,0.0012670890296765588,0.00022212843466092096,0.8615384615384616
1965,1965,점준/Noun,130,23,107,0.00027787040124485944,0.0012105999689020189,0.823076923076923
1966,1966,인지도/Noun,130,26,104,0.00031121484939424253,0.001177280703702881,0.8
1967,1967,x/Alpha,130,34,96,0.0004001333777925976,0.0010884293298385123,0.7384615384615385
1968,1968,루/Noun,130,36,94,0.00042236300989218633,0.0010662164863724202,0.7230769230769231
1969,1969,기발하다/Adjective,130,92,38,0.0010447927086806713,0.0004442568693218419,0.7076923076923077
1970,1970,최강/Noun,130,88,42,0.0010003334444814939,0.0004886825562540262,0.676923076923077
1971,1971,주성치/Noun,130,81,49,0.0009225297321329332,0.0005664275083853486,0.6230769230769231
1972,1972,키우다/Verb,130,60,70,0.0006891185950872514,0.0007996623647793153,0.5384615384615384
1973,1973,배역/Noun,130,62,68,0.0007113482271868402,0.0007774495213132232,0.5230769230769231
1974,1974,악마/Noun,130,62,68,0.0007113482271868402,0.0007774495213132232,0.5230769230769231
1975,1975,안습/Noun,129,16,113,0.0002000666888962988,0.0012772384993002955,0.875968992248062
1976,1976,우려/Noun,129,18,111,0.0002222963209958875,0.0012550256558342032,0.8604651162790697
1977,1977,기만/Noun,129,25,104,0.00030010003334444816,0.001177280703702881,0.8062015503875969
1978,1978,조작/Noun,129,25,104,0.00030010003334444816,0.001177280703702881,0.8062015503875969
1979,1979,고르다/Verb,129,29,100,0.0003445592975436257,0.0011328550167706971,0.7751937984496124
1980,1980,오랫/Modifier,129,97,32,0.0011003667889296432,0.0003776183389235656,0.751937984496124
1981,1981,스트레스/Noun,129,35,94,0.0004112481938423919,0.0010662164863724202,0.7286821705426356
1982,1982,색감/Noun,129,91,38,0.001033677892630877,0.0004442568693218419,0.7054263565891473
1983,1983,결정/Noun,129,55,74,0.0006335445148382794,0.0008440880517114996,0.5736434108527132
1984,1984,자리/Noun,129,74,55,0.0008447260197843727,0.0006330660387836247,0.5736434108527132
1985,1985,놀래다/Adjective,129,56,73,0.0006446593308880737,0.0008329816299784535,0.5658914728682171
1986,1986,본적/Noun,129,70,59,0.0008002667555851951,0.0006774917257158089,0.5426356589147286
1987,1987,모자라다/Verb,129,63,66,0.0007224630432366343,0.0007552366778471312,0.5116279069767442
1988,1988,공짜/Noun,128,5,123,7.780371234856063e-05,0.0013883027166307562,0.9609375
1989,1989,18/Number,128,28,100,0.0003334444814938313,0.0011328550167706971,0.78125
1990,1990,놀다/Verb,128,36,92,0.00042236300989218633,0.0010440036429063284,0.71875
1991,1991,아무렇다/Adjective,128,37,91,0.0004334778259419807,0.0010328972211732824,0.7109375
1992,1992,데리/Noun,128,41,87,0.0004779370901411582,0.0009884715342410985,0.6796875
1993,1993,포인트/Noun,128,42,86,0.0004890519061909527,0.000977365112508052,0.671875
1994,1994,ㄱ/KoreanParticle,128,45,83,0.0005223963543403357,0.000944045847308914,0.6484375
1995,1995,저러다/Verb,128,45,83,0.0005223963543403357,0.000944045847308914,0.6484375
1996,1996,갑/Noun,128,83,45,0.0009447593642325221,0.0005220018214531642,0.6484375
1997,1997,바다/Noun,128,75,53,0.0008558408358341669,0.0006108531953175326,0.5859375
1998,1998,홍콩영화/Noun,128,59,69,0.0006780037790374569,0.0007885559430462694,0.5390625
1999,1999,교육/Noun,128,61,67,0.0007002334111370457,0.0007663430995801773,0.5234375
2000,2000,어/Noun,128,67,61,0.0007669223074358119,0.0006997045691819009,0.5234375
2001,2001,정신병/Noun,127,21,106,0.00025564076914527065,0.0011994935471689732,0.8346456692913385
2002,2002,깨우다/Verb,127,105,22,0.0011892853173279985,0.00026655412159310506,0.8267716535433071
2003,2003,아예/Noun,127,26,101,0.00031121484939424253,0.0011439614385037428,0.7952755905511811
2004,2004,여러가지/Noun,127,95,32,0.0010781371568300542,0.0003776183389235656,0.7480314960629921
2005,2005,미가/Noun,127,94,33,0.00106702234078026,0.00038872476065661166,0.7401574803149606
2006,2006,넘어가다/Verb,127,40,87,0.0004668222740913638,0.0009884715342410985,0.6850393700787402
2007,2007,김/Noun,127,52,75,0.0006002000666888963,0.0008551944734445456,0.5905511811023622
2008,2008,풍자/Noun,127,75,52,0.0008558408358341669,0.0005997467735844866,0.5905511811023622
2009,2009,냄새/Noun,127,55,72,0.0006335445148382794,0.0008218752082454075,0.5669291338582677
2010,2010,아래/Noun,127,57,70,0.0006557741469378681,0.0007996623647793153,0.5511811023622047
2011,2011,저런/Modifier,127,66,61,0.0007558074913860174,0.0006997045691819009,0.5196850393700787
2012,2012,경/Modifier,127,62,65,0.0007113482271868402,0.0007441302561140852,0.5118110236220472
2013,2013,최초/Noun,127,65,62,0.0007446926753362233,0.000710810990914947,0.5118110236220472
2014,2014,영국/Noun,127,63,64,0.0007224630432366343,0.0007330238343810393,0.5039370078740157
2015,2015,틈/Noun,126,106,20,0.0012004001333777929,0.00024434127812701304,0.8412698412698413
2016,2016,;;;;/Punctuation,126,26,100,0.00031121484939424253,0.0011328550167706971,0.7936507936507936
2017,2017,껏/Noun,126,28,98,0.0003334444814938313,0.0011106421733046046,0.7777777777777778
2018,2018,위로/Noun,126,91,35,0.001033677892630877,0.0004109376041227037,0.7222222222222222
2019,2019,전쟁영화/Noun,126,88,38,0.0010003334444814939,0.0004442568693218419,0.6984126984126984
2020,2020,보고오다/Verb,126,78,48,0.00088918528398355,0.0005553210866523023,0.6190476190476191
2021,2021,잔/Noun,126,49,77,0.0005668556185395131,0.0008774073169106378,0.6111111111111112
2022,2022,녀/Noun,126,51,75,0.000589085250639102,0.0008551944734445456,0.5952380952380952
2023,2023,약/Noun,126,52,74,0.0006002000666888963,0.0008440880517114996,0.5873015873015873
2024,2024,관련/Noun,126,57,69,0.0006557741469378681,0.0007885559430462694,0.5476190476190477
2025,2025,덕/Noun,126,61,65,0.0007002334111370457,0.0007441302561140852,0.5158730158730159
2026,2026,목/Noun,126,65,61,0.0007446926753362233,0.0006997045691819009,0.5158730158730159
2027,2027,효/Noun,125,24,101,0.0002889852172946538,0.0011439614385037428,0.8079999999999999
2028,2028,용기/Noun,125,98,27,0.0011114816049794377,0.00032208623025833537,0.784
2029,2029,뜨겁다/Adjective,125,97,28,0.0011003667889296432,0.0003331926519913814,0.7759999999999999
2030,2030,패/Noun,125,38,87,0.000444592641991775,0.0009884715342410985,0.696
2031,2031,공포물/Noun,125,40,85,0.0004668222740913638,0.0009662586907750061,0.68
2032,2032,근래/Noun,125,84,41,0.0009558741802823164,0.00047757613452098,0.672
2033,2033,수고/Noun,125,82,43,0.0009336445481827276,0.0004997889779870722,0.6559999999999999
2034,2034,만남/Noun,125,80,45,0.0009114149160831386,0.0005220018214531642,0.64
2035,2035,깜짝/Noun,125,73,52,0.0008336112037345782,0.0005997467735844866,0.584
2036,2036,우주/Noun,125,72,53,0.0008224963876847838,0.0006108531953175326,0.5760000000000001
2037,2037,달리다/Verb,125,55,70,0.0006335445148382794,0.0007996623647793153,0.56
2038,2038,나타나다/Verb,125,58,67,0.0006668889629876625,0.0007663430995801773,0.536
2039,2039,말아먹다/Verb,124,12,112,0.00015560742469712126,0.0012661320775672494,0.9032258064516128
2040,2040,운명/Noun,124,93,31,0.0010559075247304657,0.00036651191719051963,0.75
2041,2041,연인/Noun,124,91,33,0.001033677892630877,0.00038872476065661166,0.7338709677419355
2042,2042,이용/Noun,124,38,86,0.000444592641991775,0.000977365112508052,0.6935483870967742
2043,2043,",./Punctuation",124,41,83,0.0004779370901411582,0.000944045847308914,0.6693548387096774
2044,2044,007/Number,124,79,45,0.0009003001000333445,0.0005220018214531642,0.6370967741935484
2045,2045,DVD/Alpha,124,79,45,0.0009003001000333445,0.0005220018214531642,0.6370967741935484
2046,2046,거짓말/Noun,124,46,78,0.00053351117039013,0.0008885137386436838,0.6290322580645161
2047,2047,영화계/Noun,124,47,77,0.0005446259864399244,0.0008774073169106378,0.6209677419354839
2048,2048,파/Noun,124,68,56,0.0007780371234856063,0.0006441724605166707,0.5483870967741935
2049,2049,심오하다/Adjective,124,68,56,0.0007780371234856063,0.0006441724605166707,0.5483870967741935
2050,2050,물이/Noun,124,58,66,0.0006668889629876625,0.0007552366778471312,0.532258064516129
2051,2051,만은/Josa,124,59,65,0.0006780037790374569,0.0007441302561140852,0.5241935483870968
2052,2052,린/Noun,124,64,60,0.0007335778592864287,0.0006885981474488549,0.5161290322580645
2053,2053,썩다/Verb,123,33,90,0.00038901856174280313,0.0010217907994402363,0.7317073170731707
2054,2054,확인/Noun,123,35,88,0.0004112481938423919,0.0009995779559741444,0.7154471544715447
2055,2055,해결/Noun,123,42,81,0.0004890519061909527,0.000921833003842822,0.6585365853658537
2056,2056,군/Noun,123,46,77,0.00053351117039013,0.0008774073169106378,0.6260162601626016
2057,2057,캐/Noun,123,50,73,0.0005779704345893076,0.0008329816299784535,0.5934959349593496
2058,2058,만을/Josa,123,54,69,0.0006224296987884852,0.0007885559430462694,0.5609756097560976
2059,2059,리즈/Noun,123,55,68,0.0006335445148382794,0.0007774495213132232,0.5528455284552846
2060,2060,단어/Noun,123,57,66,0.0006557741469378681,0.0007552366778471312,0.5365853658536586
2061,2061,사진/Noun,123,59,64,0.0006780037790374569,0.0007330238343810393,0.5203252032520326
2062,2062,깨/Noun,123,62,61,0.0007113482271868402,0.0006997045691819009,0.5040650406504065
2063,2063,가득/Noun,123,62,61,0.0007113482271868402,0.0006997045691819009,0.5040650406504065
2064,2064,았/Noun,122,13,109,0.00016672224074691566,0.0012328128123681114,0.8934426229508197
2065,2065,번은/Noun,122,102,20,0.0011559408691786152,0.00024434127812701304,0.8360655737704918
2066,2066,설마/Noun,122,22,100,0.000266755585195065,0.0011328550167706971,0.819672131147541
2067,2067,결코/Noun,122,91,31,0.001033677892630877,0.00036651191719051963,0.7459016393442623
2068,2068,원/Noun,122,31,91,0.00036678892964321435,0.0010328972211732824,0.7459016393442623
2069,2069,잖다/Verb,122,34,88,0.0004001333777925976,0.0009995779559741444,0.7213114754098361
2070,2070,갠/Noun,122,84,38,0.0009558741802823164,0.0004442568693218419,0.6885245901639344
2071,2071,갖추다/Verb,122,82,40,0.0009336445481827276,0.000466469712787934,0.6721311475409836
2072,2072,전에/Foreign,122,79,43,0.0009003001000333445,0.0004997889779870722,0.6475409836065574
2073,2073,예능/Noun,122,51,71,0.000589085250639102,0.0008107687865123613,0.5819672131147541
2074,2074,점줌/Noun,122,51,71,0.000589085250639102,0.0008107687865123613,0.5819672131147541
2075,2075,내생/Noun,122,69,53,0.0007891519395354007,0.0006108531953175326,0.5655737704918032
2076,2076,백/Modifier,122,66,56,0.0007558074913860174,0.0006441724605166707,0.5409836065573771
2077,2077,보통/Noun,122,63,59,0.0007224630432366343,0.0006774917257158089,0.5163934426229508
2078,2078,낮추다/Verb,121,16,105,0.0002000666888962988,0.001188387125435927,0.8677685950413223
2079,2079,셈/Noun,121,20,101,0.00024452595309547634,0.0011439614385037428,0.8347107438016529
2080,2080,변태/Noun,121,21,100,0.00025564076914527065,0.0011328550167706971,0.8264462809917356
2081,2081,심지어/Noun,121,31,90,0.00036678892964321435,0.0010217907994402363,0.743801652892562
2082,2082,자르다/Verb,121,40,81,0.0004668222740913638,0.000921833003842822,0.6694214876033058
2083,2083,째/Suffix,121,69,52,0.0007891519395354007,0.0005997467735844866,0.5702479338842975
2084,2084,들어서다/Verb,121,65,56,0.0007446926753362233,0.0006441724605166707,0.5371900826446281
2085,2085,트/Noun,121,63,58,0.0007224630432366343,0.0006663853039827628,0.5206611570247934
2086,2086,잔뜩/Noun,120,15,105,0.00018895187284650438,0.001188387125435927,0.875
2087,2087,5분/Number,120,18,102,0.0002222963209958875,0.001155067860236789,0.85
2088,2088,크리스마스/Noun,120,89,31,0.0010114482605312882,0.00036651191719051963,0.7416666666666667
2089,2089,X/Alpha,120,31,89,0.00036678892964321435,0.0010106843777071904,0.7416666666666667
2090,2090,스런/Josa,120,39,81,0.00045570745804156943,0.000921833003842822,0.675
2091,2091,여러/Noun,120,79,41,0.0009003001000333445,0.00047757613452098,0.6583333333333333
2092,2092,넘기다/Verb,120,43,77,0.0005001667222407468,0.0008774073169106378,0.6416666666666667
2093,2093,편도/Noun,120,77,43,0.0008780704679337558,0.0004997889779870722,0.6416666666666667
2094,2094,이래서/Josa,120,46,74,0.00053351117039013,0.0008440880517114996,0.6166666666666667
2095,2095,스크린/Noun,120,71,49,0.0008113815716349895,0.0005664275083853486,0.5916666666666667
2096,2096,상태/Noun,120,53,67,0.0006113148827386907,0.0007663430995801773,0.5583333333333333
2097,2097,달리/Noun,120,54,66,0.0006224296987884852,0.0007552366778471312,0.55
2098,2098,국가/Noun,120,65,55,0.0007446926753362233,0.0006330660387836247,0.5416666666666666
2099,2099,ㅅ/KoreanParticle,120,56,64,0.0006446593308880737,0.0007330238343810393,0.5333333333333333
2100,2100,전율/Noun,119,110,9,0.00124485939757697,0.00012217063906350652,0.9243697478991596
2101,2101,둘째/Noun,119,14,105,0.00017783705679671002,0.001188387125435927,0.8823529411764706
2102,2102,려고/Noun,119,23,96,0.00027787040124485944,0.0010884293298385123,0.8067226890756303
2103,2103,아동/Noun,119,28,91,0.0003334444814938313,0.0010328972211732824,0.7647058823529411
2104,2104,그립다/Adjective,119,86,33,0.0009781038123819054,0.00038872476065661166,0.7226890756302521
2105,2105,탓/Noun,119,35,84,0.0004112481938423919,0.00095515226904196,0.7058823529411765
2106,2106,뛰어넘다/Verb,119,83,36,0.0009447593642325221,0.0004220440258557498,0.6974789915966386
2107,2107,제외/Noun,119,43,76,0.0005001667222407468,0.0008663008951775916,0.6386554621848739
2108,2108,자주/Noun,119,76,43,0.0008669556518839612,0.0004997889779870722,0.6386554621848739
2109,2109,옷/Noun,119,48,71,0.0005557408024897189,0.0008107687865123613,0.5966386554621849
2110,2110,통/Noun,119,49,70,0.0005668556185395131,0.0007996623647793153,0.5882352941176471
2111,2111,케/Noun,119,51,68,0.000589085250639102,0.0007774495213132232,0.5714285714285714
2112,2112,넘어서다/Verb,119,67,52,0.0007669223074358119,0.0005997467735844866,0.5630252100840336
2113,2113,기법/Noun,119,53,66,0.0006113148827386907,0.0007552366778471312,0.5546218487394958
2114,2114,의하다/Adjective,119,66,53,0.0007558074913860174,0.0006108531953175326,0.5546218487394958
2115,2115,아역/Noun,119,63,56,0.0007224630432366343,0.0006441724605166707,0.5294117647058824
2116,2116,오빠/Suffix,118,106,12,0.0012004001333777929,0.00015548990426264466,0.8983050847457628
2117,2117,작위/Noun,118,17,101,0.00021118150494609317,0.0011439614385037428,0.8559322033898306
2118,2118,대본/Noun,118,24,94,0.0002889852172946538,0.0010662164863724202,0.7966101694915254
2119,2119,부모님/Noun,118,89,29,0.0010114482605312882,0.00034429907372442745,0.7542372881355932
2120,2120,톰/Noun,118,83,35,0.0009447593642325221,0.0004109376041227037,0.7033898305084746
2121,2121,두번째/Noun,118,81,37,0.0009225297321329332,0.0004331504475887958,0.6864406779661016
2122,2122,에나/Josa,118,38,80,0.000444592641991775,0.000910726582109776,0.6779661016949152
2123,2123,짜임새/Noun,118,71,47,0.0008113815716349895,0.0005442146649192564,0.6016949152542372
2124,2124,꼬마/Noun,118,67,51,0.0007669223074358119,0.0005886403518514405,0.5677966101694916
2125,2125,매니아/Noun,118,55,63,0.0006335445148382794,0.0007219174126479931,0.5338983050847458
2126,2126,:)/Punctuation,117,114,3,0.0012893186617761474,5.553210866523024e-05,0.9743589743589745
2127,2127,한개/Modifier,117,10,107,0.0001333777925975325,0.0012105999689020189,0.9145299145299144
2128,2128,애쓰다/Verb,117,25,92,0.00030010003334444816,0.0010440036429063284,0.7863247863247863
2129,2129,하나같이/Adverb,117,28,89,0.0003334444814938313,0.0010106843777071904,0.7606837606837606
2130,2130,가족영화/Noun,117,77,40,0.0008780704679337558,0.000466469712787934,0.6581196581196581
2131,2131,케릭/Noun,117,44,73,0.0005112815382905413,0.0008329816299784535,0.6239316239316239
2132,2132,사상/Noun,117,46,71,0.00053351117039013,0.0008107687865123613,0.6068376068376068
2133,2133,흑인/Noun,117,47,70,0.0005446259864399244,0.0007996623647793153,0.5982905982905983
2134,2134,비밀/Noun,117,51,66,0.000589085250639102,0.0007552366778471312,0.5641025641025641
2135,2135,감정이입/Noun,117,53,64,0.0006113148827386907,0.0007330238343810393,0.5470085470085471
2136,2136,대중/Noun,117,54,63,0.0006224296987884852,0.0007219174126479931,0.5384615384615384
2137,2137,땅/Noun,117,62,55,0.0007113482271868402,0.0006330660387836247,0.5299145299145299
2138,2138,쥐/Noun,117,60,57,0.0006891185950872514,0.0006552788822497168,0.5128205128205128
2139,2139,그만/Modifier,116,9,107,0.00012226297654773814,0.0012105999689020189,0.9224137931034484
2140,2140,하자/Noun,116,24,92,0.0002889852172946538,0.0010440036429063284,0.7931034482758621
2141,2141,정작/Noun,116,29,87,0.0003445592975436257,0.0009884715342410985,0.75
2142,2142,거나/Noun,116,33,83,0.00038901856174280313,0.000944045847308914,0.7155172413793104
2143,2143,신의/Noun,116,79,37,0.0009003001000333445,0.0004331504475887958,0.6810344827586207
2144,2144,장가/Noun,116,37,79,0.0004334778259419807,0.0008996201603767299,0.6810344827586207
2145,2145,무료/Noun,116,40,76,0.0004668222740913638,0.0008663008951775916,0.6551724137931034
2146,2146,예/Noun,116,40,76,0.0004668222740913638,0.0008663008951775916,0.6551724137931034
2147,2147,꺼/Suffix,116,40,76,0.0004668222740913638,0.0008663008951775916,0.6551724137931034
2148,2148,워/Noun,116,49,67,0.0005668556185395131,0.0007663430995801773,0.5775862068965517
2149,2149,박/Noun,116,64,52,0.0007335778592864287,0.0005997467735844866,0.5517241379310345
2150,2150,와의/Josa,116,64,52,0.0007335778592864287,0.0005997467735844866,0.5517241379310345
2151,2151,디/Noun,116,61,55,0.0007002334111370457,0.0006330660387836247,0.5258620689655172
2152,2152,대놓고/Adverb,115,17,98,0.00021118150494609317,0.0011106421733046046,0.8521739130434782
2153,2153,ㅠㅜ/KoreanParticle,115,89,26,0.0010114482605312882,0.00031097980852528933,0.7739130434782608
2154,2154,소년/Noun,115,84,31,0.0009558741802823164,0.00036651191719051963,0.7304347826086957
2155,2155,열연/Noun,115,80,35,0.0009114149160831386,0.0004109376041227037,0.6956521739130435
2156,2156,성은/Noun,115,36,79,0.00042236300989218633,0.0008996201603767299,0.6869565217391305
2157,2157,목적/Noun,115,37,78,0.0004334778259419807,0.0008885137386436838,0.6782608695652174
2158,2158,충실하다/Adjective,115,77,38,0.0008780704679337558,0.0004442568693218419,0.6695652173913044
2159,2159,의심/Noun,115,40,75,0.0004668222740913638,0.0008551944734445456,0.6521739130434783
2160,2160,메/Noun,115,75,40,0.0008558408358341669,0.000466469712787934,0.6521739130434783
2161,2161,낫/Noun,115,43,72,0.0005001667222407468,0.0008218752082454075,0.6260869565217392
2162,2162,으리/Noun,115,71,44,0.0008113815716349895,0.0005108953997201182,0.6173913043478261
2163,2163,탄생/Noun,115,63,52,0.0007224630432366343,0.0005997467735844866,0.5478260869565217
2164,2164,무술/Noun,115,53,62,0.0006113148827386907,0.000710810990914947,0.5391304347826087
2165,2165,금보/Noun,115,58,57,0.0006668889629876625,0.0006552788822497168,0.5043478260869565
2166,2166,힘내다/Verb,114,95,19,0.0010781371568300542,0.000233234856393967,0.8333333333333334
2167,2167,겪다/Verb,114,87,27,0.0009892186284316995,0.00032208623025833537,0.7631578947368421
2168,2168,씹다/Verb,114,31,83,0.00036678892964321435,0.000944045847308914,0.7280701754385965
2169,2169,패러디/Noun,114,36,78,0.00042236300989218633,0.0008885137386436838,0.6842105263157895
2170,2170,꿈꾸다/Verb,114,77,37,0.0008780704679337558,0.0004331504475887958,0.6754385964912281
2171,2171,새다/Verb,114,42,72,0.0004890519061909527,0.0008218752082454075,0.631578947368421
2172,2172,the/Alpha,114,71,43,0.0008113815716349895,0.0004997889779870722,0.6228070175438597
2173,2173,구나/Noun,114,44,70,0.0005112815382905413,0.0007996623647793153,0.6140350877192983
2174,2174,15/Number,114,45,69,0.0005223963543403357,0.0007885559430462694,0.6052631578947368
2175,2175,지나가다/Verb,114,68,46,0.0007780371234856063,0.0005331082431862101,0.5964912280701754
2176,2176,화끈하다/Adjective,114,65,49,0.0007446926753362233,0.0005664275083853486,0.5701754385964912
2177,2177,애가/Noun,114,50,64,0.0005779704345893076,0.0007330238343810393,0.5614035087719298
2178,2178,명의/Noun,114,61,53,0.0007002334111370457,0.0006108531953175326,0.5350877192982456
2179,2179,여러분/Noun,114,58,56,0.0006668889629876625,0.0006441724605166707,0.5087719298245614
2180,2180,시점/Noun,114,58,56,0.0006668889629876625,0.0006441724605166707,0.5087719298245614
2181,2181,20분/Number,113,18,95,0.0002222963209958875,0.0010773229081054666,0.8407079646017699
2182,2182,ㅜㅜㅜ/KoreanParticle,113,83,30,0.0009447593642325221,0.0003554054954574735,0.7345132743362832
2183,2183,..;;/Punctuation,113,31,82,0.00036678892964321435,0.000932939425575868,0.7256637168141593
2184,2184,무서움/Noun,113,47,66,0.0005446259864399244,0.0007552366778471312,0.584070796460177
2185,2185,브루스/Noun,113,48,65,0.0005557408024897189,0.0007441302561140852,0.5752212389380531
2186,2186,움직이다/Verb,113,59,54,0.0006780037790374569,0.0006219596170505788,0.5221238938053098
2187,2187,블록버스터/Noun,113,58,55,0.0006668889629876625,0.0006330660387836247,0.5132743362831859
2188,2188,명화/Noun,112,90,22,0.0010225630765810826,0.00026655412159310506,0.8035714285714286
2189,2189,값/Noun,112,27,85,0.00032232966544403684,0.0009662586907750061,0.7589285714285714
2190,2190,감각/Noun,112,73,39,0.0008336112037345782,0.000455363291054888,0.6517857142857143
2191,2191,부부/Noun,112,68,44,0.0007780371234856063,0.0005108953997201182,0.6071428571428571
2192,2192,집착/Noun,112,45,67,0.0005223963543403357,0.0007663430995801773,0.5982142857142857
2193,2193,틀/Noun,112,51,61,0.000589085250639102,0.0006997045691819009,0.5446428571428571
2194,2194,주제가/Noun,112,51,61,0.000589085250639102,0.0006997045691819009,0.5446428571428571
2195,2195,골/Noun,112,51,61,0.000589085250639102,0.0006997045691819009,0.5446428571428571
2196,2196,후속작/Noun,112,53,59,0.0006113148827386907,0.0006774917257158089,0.5267857142857143
2197,2197,찾기/Noun,112,55,57,0.0006335445148382794,0.0006552788822497168,0.5089285714285714
2198,2198,낚였다/Noun,111,2,109,4.445926419917751e-05,0.0012328128123681114,0.981981981981982
2199,2199,참나/Noun,111,10,101,0.0001333777925975325,0.0011439614385037428,0.90990990990991
2200,2200,오래전/Adverb,111,85,26,0.0009669889963321108,0.00031097980852528933,0.7657657657657657
2201,2201,!!!!!/Punctuation,111,81,30,0.0009225297321329332,0.0003554054954574735,0.7297297297297297
2202,2202,뇌/Noun,111,37,74,0.0004334778259419807,0.0008440880517114996,0.6666666666666666
2203,2203,시기/Noun,111,68,43,0.0007780371234856063,0.0004997889779870722,0.6126126126126126
2204,2204,앉다/Verb,111,44,67,0.0005112815382905413,0.0007663430995801773,0.6036036036036037
2205,2205,피다/Verb,111,48,63,0.0005557408024897189,0.0007219174126479931,0.5675675675675675
2206,2206,어둡다/Adjective,111,49,62,0.0005668556185395131,0.000710810990914947,0.5585585585585585
2207,2207,모험/Noun,111,60,51,0.0006891185950872514,0.0005886403518514405,0.5405405405405406
2208,2208,울컥/Adverb,110,108,2,0.0012226297654773814,4.4425686932184186e-05,0.9818181818181818
2209,2209,짜지다/Verb,110,12,98,0.00015560742469712126,0.0011106421733046046,0.8909090909090909
2210,2210,신파/Noun,110,16,94,0.0002000666888962988,0.0010662164863724202,0.8545454545454545
2211,2211,첫사랑/Noun,110,90,20,0.0010225630765810826,0.00024434127812701304,0.8181818181818182
2212,2212,업다/Verb,110,29,81,0.0003445592975436257,0.000921833003842822,0.7363636363636363
2213,2213,몇몇/Noun,110,33,77,0.00038901856174280313,0.0008774073169106378,0.7
2214,2214,모양/Noun,110,36,74,0.00042236300989218633,0.0008440880517114996,0.6727272727272727
2215,2215,70년/Number,110,37,73,0.0004334778259419807,0.0008329816299784535,0.6636363636363637
2216,2216,담배/Noun,110,40,70,0.0004668222740913638,0.0007996623647793153,0.6363636363636364
2217,2217,할아버지/Noun,110,67,43,0.0007669223074358119,0.0004997889779870722,0.6090909090909091
2218,2218,탑/Noun,110,66,44,0.0007558074913860174,0.0005108953997201182,0.6
2219,2219,물다/Verb,110,51,59,0.000589085250639102,0.0006774917257158089,0.5363636363636364
2220,2220,타고/Noun,110,54,56,0.0006224296987884852,0.0006441724605166707,0.509090909090909
2221,2221,한숨/Noun,109,12,97,0.00015560742469712126,0.0010995357515715587,0.8899082568807339
2222,2222,시끄럽다/Adjective,109,15,94,0.00018895187284650438,0.0010662164863724202,0.8623853211009175
2223,2223,세련되다/Adjective,109,94,15,0.00106702234078026,0.0001888091694617828,0.8623853211009175
2224,2224,고전/Noun,109,80,29,0.0009114149160831386,0.00034429907372442745,0.7339449541284404
2225,2225,삭제/Noun,109,31,78,0.00036678892964321435,0.0008885137386436838,0.7155963302752294
2226,2226,빵빵/Noun,109,77,32,0.0008780704679337558,0.0003776183389235656,0.7064220183486238
2227,2227,졸/Noun,109,33,76,0.00038901856174280313,0.0008663008951775916,0.6972477064220184
2228,2228,철/Noun,109,35,74,0.0004112481938423919,0.0008440880517114996,0.6788990825688074
2229,2229,적어도/Adverb,109,63,46,0.0007224630432366343,0.0005331082431862101,0.5779816513761468
2230,2230,어쩜/Noun,109,47,62,0.0005446259864399244,0.000710810990914947,0.5688073394495413
2231,2231,거부/Noun,109,49,60,0.0005668556185395131,0.0006885981474488549,0.5504587155963303
2232,2232,11/Number,109,52,57,0.0006002000666888963,0.0006552788822497168,0.5229357798165137
2233,2233,.^^/Punctuation,108,97,11,0.0011003667889296432,0.0001443834825295986,0.8981481481481481
2234,2234,말고는/Josa,108,11,97,0.0001444926086473269,0.0010995357515715587,0.8981481481481481
2235,2235,십/Modifier,108,76,32,0.0008669556518839612,0.0003776183389235656,0.7037037037037037
2236,2236,그만큼/Adverb,108,76,32,0.0008669556518839612,0.0003776183389235656,0.7037037037037037
2237,2237,최대/Noun,108,37,71,0.0004334778259419807,0.0008107687865123613,0.6574074074074074
2238,2238,언니/Noun,108,69,39,0.0007891519395354007,0.000455363291054888,0.6388888888888888
2239,2239,화의/Noun,108,39,69,0.00045570745804156943,0.0007885559430462694,0.6388888888888888
2240,2240,마이/Noun,108,40,68,0.0004668222740913638,0.0007774495213132232,0.6296296296296297
2241,2241,탈/Noun,108,40,68,0.0004668222740913638,0.0007774495213132232,0.6296296296296297
2242,2242,누나/Noun,108,65,43,0.0007446926753362233,0.0004997889779870722,0.6018518518518519
2243,2243,포스/Noun,108,65,43,0.0007446926753362233,0.0004997889779870722,0.6018518518518519
2244,2244,ㅁ/KoreanParticle,108,63,45,0.0007224630432366343,0.0005220018214531642,0.5833333333333334
2245,2245,기독교/Noun,108,46,62,0.00053351117039013,0.000710810990914947,0.5740740740740741
2246,2246,아이디어/Noun,108,49,59,0.0005668556185395131,0.0006774917257158089,0.5462962962962963
2247,2247,sf/Alpha,108,58,50,0.0006668889629876625,0.0005775339301183945,0.5370370370370371
2248,2248,빈약하다/Adjective,107,12,95,0.00015560742469712126,0.0010773229081054666,0.8878504672897196
2249,2249,떨다/Verb,107,36,71,0.00042236300989218633,0.0008107687865123613,0.6635514018691588
2250,2250,여태/Noun,107,63,44,0.0007224630432366343,0.0005108953997201182,0.5887850467289719
2251,2251,하늘/Noun,107,63,44,0.0007224630432366343,0.0005108953997201182,0.5887850467289719
2252,2252,종영/Noun,107,60,47,0.0006891185950872514,0.0005442146649192564,0.5607476635514018
2253,2253,어처구니/Noun,106,11,95,0.0001444926086473269,0.0010773229081054666,0.8962264150943396
2254,2254,..^^/Punctuation,106,92,14,0.0010447927086806713,0.00017770274772873674,0.8679245283018868
2255,2255,중독/Noun,106,87,19,0.0009892186284316995,0.000233234856393967,0.8207547169811321
2256,2256,폐지/Noun,106,30,76,0.00035567411359342004,0.0008663008951775916,0.7169811320754716
2257,2257,치밀하다/Adjective,106,73,33,0.0008336112037345782,0.00038872476065661166,0.6886792452830188
2258,2258,흑/Adverb,106,72,34,0.0008224963876847838,0.00039983118238965764,0.6792452830188679
2259,2259,수많다/Adjective,106,61,45,0.0007002334111370457,0.0005220018214531642,0.5754716981132075
2260,2260,재능/Noun,106,47,59,0.0005446259864399244,0.0006774917257158089,0.5566037735849056
2261,2261,바르다/Verb,106,49,57,0.0005668556185395131,0.0006552788822497168,0.5377358490566038
2262,2262,A/Alpha,106,53,53,0.0006113148827386907,0.0006108531953175326,0.5
2263,2263,선동/Noun,105,10,95,0.0001333777925975325,0.0010773229081054666,0.9047619047619048
2264,2264,팔이/Noun,105,11,94,0.0001444926086473269,0.0010662164863724202,0.8952380952380953
2265,2265,여름/Noun,105,85,20,0.0009669889963321108,0.00024434127812701304,0.8095238095238095
2266,2266,안감/Noun,105,22,83,0.000266755585195065,0.000944045847308914,0.7904761904761904
2267,2267,늘어지다/Verb,105,24,81,0.0002889852172946538,0.000921833003842822,0.7714285714285715
2268,2268,또다른/Modifier,105,78,27,0.00088918528398355,0.00032208623025833537,0.7428571428571429
2269,2269,중학교/Noun,105,77,28,0.0008780704679337558,0.0003331926519913814,0.7333333333333333
2270,2270,바탕/Noun,105,73,32,0.0008336112037345782,0.0003776183389235656,0.6952380952380952
2271,2271,목숨/Noun,105,70,35,0.0008002667555851951,0.0004109376041227037,0.6666666666666666
2272,2272,잡/Noun,105,36,69,0.00042236300989218633,0.0007885559430462694,0.6571428571428571
2273,2273,버전/Noun,105,38,67,0.000444592641991775,0.0007663430995801773,0.6380952380952379
2274,2274,보구/Noun,105,62,43,0.0007113482271868402,0.0004997889779870722,0.5904761904761905
2275,2275,대신/Noun,105,44,61,0.0005112815382905413,0.0006997045691819009,0.580952380952381
2276,2276,삼/Noun,105,45,60,0.0005223963543403357,0.0006885981474488549,0.5714285714285714
2277,2277,혹은/Adverb,105,56,49,0.0006446593308880737,0.0005664275083853486,0.5333333333333333
2278,2278,마리/Noun,105,51,54,0.000589085250639102,0.0006219596170505788,0.5142857142857142
2279,2279,여기다/Verb,105,52,53,0.0006002000666888963,0.0006108531953175326,0.5047619047619047
2280,2280,끼우다/Verb,104,10,94,0.0001333777925975325,0.0010662164863724202,0.903846153846154
2281,2281,메이드/Noun,104,91,13,0.001033677892630877,0.0001665963259956907,0.875
2282,2282,캬/Noun,104,89,15,0.0010114482605312882,0.0001888091694617828,0.8557692307692307
2283,2283,어쩌/Noun,104,16,88,0.0002000666888962988,0.0009995779559741444,0.8461538461538461
2284,2284,구리/Noun,104,16,88,0.0002000666888962988,0.0009995779559741444,0.8461538461538461
2285,2285,호구/Noun,104,17,87,0.00021118150494609317,0.0009884715342410985,0.8365384615384616
2286,2286,부터가/Josa,104,22,82,0.000266755585195065,0.000932939425575868,0.7884615384615384
2287,2287,하아/Exclamation,104,23,81,0.00027787040124485944,0.000921833003842822,0.7788461538461539
2288,2288,~!!!/Punctuation,104,79,25,0.0009003001000333445,0.0002998733867922433,0.7596153846153846
2289,2289,반갑다/Adjective,104,73,31,0.0008336112037345782,0.00036651191719051963,0.7019230769230769
2290,2290,장국영/Noun,104,73,31,0.0008336112037345782,0.00036651191719051963,0.7019230769230769
2291,2291,졸리/Noun,104,33,71,0.00038901856174280313,0.0008107687865123613,0.6826923076923077
2292,2292,표현/Modifier,104,68,36,0.0007780371234856063,0.0004220440258557498,0.6538461538461539
2293,2293,야구/Noun,104,66,38,0.0007558074913860174,0.0004442568693218419,0.6346153846153846
2294,2294,틱/Suffix,104,39,65,0.00045570745804156943,0.0007441302561140852,0.625
2295,2295,고등학교/Noun,104,65,39,0.0007446926753362233,0.000455363291054888,0.625
2296,2296,따름/Noun,104,41,63,0.0004779370901411582,0.0007219174126479931,0.6057692307692307
2297,2297,드림/Noun,104,42,62,0.0004890519061909527,0.000710810990914947,0.5961538461538461
2298,2298,재난영화/Noun,104,59,45,0.0006780037790374569,0.0005220018214531642,0.5673076923076923
2299,2299,라이언/Noun,104,57,47,0.0006557741469378681,0.0005442146649192564,0.5480769230769231
2300,2300,매다/Verb,104,48,56,0.0005557408024897189,0.0006441724605166707,0.5384615384615384
2301,2301,틀리다/Verb,104,50,54,0.0005779704345893076,0.0006219596170505788,0.5192307692307693
2302,2302,내놓다/Verb,103,23,80,0.00027787040124485944,0.000910726582109776,0.7766990291262136
2303,2303,이어서/Josa,103,75,28,0.0008558408358341669,0.0003331926519913814,0.7281553398058253
2304,2304,벌다/Verb,103,29,74,0.0003445592975436257,0.0008440880517114996,0.7184466019417476
2305,2305,로버트/Noun,103,70,33,0.0008002667555851951,0.00038872476065661166,0.6796116504854369
2306,2306,보이지/Noun,103,36,67,0.00042236300989218633,0.0007663430995801773,0.6504854368932039
2307,2307,막다/Verb,103,38,65,0.000444592641991775,0.0007441302561140852,0.6310679611650486
2308,2308,배경음악/Noun,103,64,39,0.0007335778592864287,0.000455363291054888,0.6213592233009708
2309,2309,욕심/Noun,103,39,64,0.00045570745804156943,0.0007330238343810393,0.6213592233009708
2310,2310,웃/Noun,103,64,39,0.0007335778592864287,0.000455363291054888,0.6213592233009708
2311,2311,정확하다/Adjective,103,45,58,0.0005223963543403357,0.0006663853039827628,0.5631067961165048
2312,2312,30년/Number,103,57,46,0.0006557741469378681,0.0005331082431862101,0.5533980582524272
2313,2313,풍/Adverb,103,50,53,0.0005779704345893076,0.0006108531953175326,0.5145631067961165
2314,2314,빵점/Noun,102,2,100,4.445926419917751e-05,0.0011328550167706971,0.9803921568627452
2315,2315,하품/Noun,102,2,100,4.445926419917751e-05,0.0011328550167706971,0.9803921568627452
2316,2316,편안하다/Adjective,102,90,12,0.0010225630765810826,0.00015548990426264466,0.8823529411764706
2317,2317,지경/Noun,102,14,88,0.00017783705679671002,0.0009995779559741444,0.8627450980392157
2318,2318,재미나/Noun,102,87,15,0.0009892186284316995,0.0001888091694617828,0.8529411764705882
2319,2319,조화/Noun,102,82,20,0.0009336445481827276,0.00024434127812701304,0.8039215686274509
2320,2320,곡/Noun,102,78,24,0.00088918528398355,0.0002887669650591972,0.7647058823529411
2321,2321,팔/Modifier,102,24,78,0.0002889852172946538,0.0008885137386436838,0.7647058823529411
2322,2322,로코/Noun,102,75,27,0.0008558408358341669,0.00032208623025833537,0.7352941176470589
2323,2323,숨/Noun,102,75,27,0.0008558408358341669,0.00032208623025833537,0.7352941176470589
2324,2324,곱다/Adjective,102,69,33,0.0007891519395354007,0.00038872476065661166,0.6764705882352942
2325,2325,절정/Noun,102,64,38,0.0007335778592864287,0.0004442568693218419,0.6274509803921569
2326,2326,클레멘타인/Noun,102,39,63,0.00045570745804156943,0.0007219174126479931,0.6176470588235294
2327,2327,끊다/Verb,102,39,63,0.00045570745804156943,0.0007219174126479931,0.6176470588235294
2328,2328,헤어지다/Verb,102,62,40,0.0007113482271868402,0.000466469712787934,0.6078431372549019
2329,2329,만약/Noun,102,57,45,0.0006557741469378681,0.0005220018214531642,0.5588235294117647
2330,2330,빵/Noun,102,49,53,0.0005668556185395131,0.0006108531953175326,0.5196078431372549
2331,2331,호/Noun,102,50,52,0.0005779704345893076,0.0005997467735844866,0.5098039215686274
2332,2332,인내심/Noun,101,8,93,0.00011114816049794375,0.0010551100646393743,0.9207920792079208
2333,2333,잠시/Noun,101,75,26,0.0008558408358341669,0.00031097980852528933,0.7425742574257426
2334,2334,묻히다/Verb,101,68,33,0.0007780371234856063,0.00038872476065661166,0.6732673267326733
2335,2335,사운드/Noun,101,67,34,0.0007669223074358119,0.00039983118238965764,0.6633663366336634
2336,2336,그동안/Noun,101,65,36,0.0007446926753362233,0.0004220440258557498,0.6435643564356436
2337,2337,린다/Noun,101,64,37,0.0007335778592864287,0.0004331504475887958,0.6336633663366337
2338,2338,조니뎁/Noun,101,63,38,0.0007224630432366343,0.0004442568693218419,0.6237623762376238
2339,2339,틴/Noun,101,40,61,0.0004668222740913638,0.0006997045691819009,0.6039603960396039
2340,2340,탈출/Noun,101,56,45,0.0006446593308880737,0.0005220018214531642,0.5544554455445545
2341,2341,된거/Noun,101,55,46,0.0006335445148382794,0.0005331082431862101,0.5445544554455446
2342,2342,가정/Noun,101,55,46,0.0006335445148382794,0.0005331082431862101,0.5445544554455446
2343,2343,사고/Noun,101,55,46,0.0006335445148382794,0.0005331082431862101,0.5445544554455446
2344,2344,승리/Noun,101,54,47,0.0006224296987884852,0.0005442146649192564,0.5346534653465347
2345,2345,공/Noun,101,48,53,0.0005557408024897189,0.0006108531953175326,0.5247524752475248
2346,2346,성공/Noun,101,52,49,0.0006002000666888963,0.0005664275083853486,0.5148514851485149
2347,2347,귀/Noun,101,52,49,0.0006002000666888963,0.0005664275083853486,0.5148514851485149
2348,2348,제이슨/Noun,101,50,51,0.0005779704345893076,0.0005886403518514405,0.504950495049505
2349,2349,색/Noun,101,50,51,0.0005779704345893076,0.0005886403518514405,0.504950495049505
2350,2350,마냥/Noun,101,50,51,0.0005779704345893076,0.0005886403518514405,0.504950495049505
2351,2351,앞뒤/Noun,100,11,89,0.0001444926086473269,0.0010106843777071904,0.89
2352,2352,울면/Noun,100,87,13,0.0009892186284316995,0.0001665963259956907,0.87
2353,2353,플롯/Noun,100,29,71,0.0003445592975436257,0.0008107687865123613,0.71
2354,2354,일본인/Noun,100,30,70,0.00035567411359342004,0.0007996623647793153,0.7
2355,2355,........./Punctuation,100,31,69,0.00036678892964321435,0.0007885559430462694,0.69
2356,2356,상관없다/Adjective,100,34,66,0.0004001333777925976,0.0007552366778471312,0.66
2357,2357,만이/Noun,100,37,63,0.0004334778259419807,0.0007219174126479931,0.63
2358,2358,딱이다/Adjective,100,59,41,0.0006780037790374569,0.00047757613452098,0.59
2359,2359,그야말로/Adverb,100,59,41,0.0006780037790374569,0.00047757613452098,0.59
2360,2360,나누다/Verb,100,58,42,0.0006668889629876625,0.0004886825562540262,0.58
2361,2361,추리/Noun,100,43,57,0.0005001667222407468,0.0006552788822497168,0.57
2362,2362,배다/Verb,100,45,55,0.0005223963543403357,0.0006330660387836247,0.55
2363,2363,파괴/Noun,100,46,54,0.00053351117039013,0.0006219596170505788,0.54
2364,2364,손색/Noun,99,90,9,0.0010225630765810826,0.00012217063906350652,0.9090909090909092
2365,2365,그만하다/Adjective,99,19,80,0.0002334111370456819,0.000910726582109776,0.8080808080808081
2366,2366,현대/Noun,99,72,27,0.0008224963876847838,0.00032208623025833537,0.7272727272727273
2367,2367,끔찍하다/Adjective,99,28,71,0.0003334444814938313,0.0008107687865123613,0.7171717171717171
2368,2368,꼬/Noun,99,31,68,0.00036678892964321435,0.0007774495213132232,0.6868686868686869
2369,2369,케빈/Noun,99,66,33,0.0007558074913860174,0.00038872476065661166,0.6666666666666666
2370,2370,공간/Noun,99,65,34,0.0007446926753362233,0.00039983118238965764,0.6565656565656566
2371,2371,착각/Noun,99,34,65,0.0004001333777925976,0.0007441302561140852,0.6565656565656566
2372,2372,돼지/Noun,99,35,64,0.0004112481938423919,0.0007330238343810393,0.6464646464646465
2373,2373,임팩트/Noun,99,40,59,0.0004668222740913638,0.0006774917257158089,0.5959595959595959
2374,2374,영화제/Noun,99,58,41,0.0006668889629876625,0.00047757613452098,0.5858585858585859
2375,2375,정이/Noun,99,55,44,0.0006335445148382794,0.0005108953997201182,0.5555555555555556
2376,2376,터미네이터/Noun,99,53,46,0.0006113148827386907,0.0005331082431862101,0.5353535353535354
2377,2377,저리/Noun,99,51,48,0.000589085250639102,0.0005553210866523023,0.5151515151515151
2378,2378,센스/Noun,99,48,51,0.0005557408024897189,0.0005886403518514405,0.5151515151515151
2379,2379,이전/Noun,99,49,50,0.0005668556185395131,0.0005775339301183945,0.5050505050505051
2380,2380,나은/Noun,99,49,50,0.0005668556185395131,0.0005775339301183945,0.5050505050505051
2381,2381,어디가/Noun,98,16,82,0.0002000666888962988,0.000932939425575868,0.8367346938775511
2382,2382,우뢰매/Noun,98,18,80,0.0002222963209958875,0.000910726582109776,0.8163265306122449
2383,2383,토록/Josa,98,72,26,0.0008224963876847838,0.00031097980852528933,0.7346938775510204
2384,2384,실패하다/Adjective,98,28,70,0.0003334444814938313,0.0007996623647793153,0.7142857142857143
2385,2385,박진/Noun,98,65,33,0.0007446926753362233,0.00038872476065661166,0.6632653061224489
2386,2386,겉/Noun,98,35,63,0.0004112481938423919,0.0007219174126479931,0.6428571428571429
2387,2387,논/Noun,98,41,57,0.0004779370901411582,0.0006552788822497168,0.5816326530612245
2388,2388,도에/Foreign,98,53,45,0.0006113148827386907,0.0005220018214531642,0.5408163265306123
2389,2389,지치다/Verb,98,48,50,0.0005557408024897189,0.0005775339301183945,0.5102040816326531
2390,2390,뱀파이어/Noun,98,50,48,0.0005779704345893076,0.0005553210866523023,0.5102040816326531
2391,2391,도움/Noun,98,49,49,0.0005668556185395131,0.0005664275083853486,0.5
2392,2392,디워/Noun,97,10,87,0.0001333777925975325,0.0009884715342410985,0.8969072164948454
2393,2393,낚시/Noun,97,11,86,0.0001444926086473269,0.000977365112508052,0.8865979381443299
2394,2394,부실하다/Adjective,97,13,84,0.00016672224074691566,0.00095515226904196,0.865979381443299
2395,2395,쓸데없이/Adverb,97,14,83,0.00017783705679671002,0.000944045847308914,0.8556701030927835
2396,2396,사투리/Noun,97,23,74,0.00027787040124485944,0.0008440880517114996,0.7628865979381443
2397,2397,교과서/Noun,97,73,24,0.0008336112037345782,0.0002887669650591972,0.7525773195876289
2398,2398,밝다/Verb,97,71,26,0.0008113815716349895,0.00031097980852528933,0.7319587628865979
2399,2399,이군/Noun,97,33,64,0.00038901856174280313,0.0007330238343810393,0.6597938144329897
2400,2400,인터넷/Noun,97,40,57,0.0004668222740913638,0.0006552788822497168,0.5876288659793815
2401,2401,발상/Noun,97,40,57,0.0004668222740913638,0.0006552788822497168,0.5876288659793815
2402,2402,연극/Noun,97,42,55,0.0004890519061909527,0.0006330660387836247,0.5670103092783505
2403,2403,들리다/Verb,97,51,46,0.000589085250639102,0.0005331082431862101,0.5257731958762887
2404,2404,응/Noun,97,46,51,0.00053351117039013,0.0005886403518514405,0.5257731958762887
2405,2405,자고/Noun,96,11,85,0.0001444926086473269,0.0009662586907750061,0.8854166666666666
2406,2406,심형래/Noun,96,13,83,0.00016672224074691566,0.000944045847308914,0.8645833333333334
2407,2407,여친/Noun,96,23,73,0.00027787040124485944,0.0008329816299784535,0.7604166666666666
2408,2408,제임스/Noun,96,70,26,0.0008002667555851951,0.00031097980852528933,0.7291666666666666
2409,2409,일부러/Noun,96,28,68,0.0003334444814938313,0.0007774495213132232,0.7083333333333334
2410,2410,유덕화/Noun,96,66,30,0.0007558074913860174,0.0003554054954574735,0.6875
2411,2411,호기심/Noun,96,30,66,0.00035567411359342004,0.0007552366778471312,0.6875
2412,2412,너무도/Adverb,96,63,33,0.0007224630432366343,0.00038872476065661166,0.65625
2413,2413,대결/Noun,96,61,35,0.0007002334111370457,0.0004109376041227037,0.6354166666666666
2414,2414,대통령/Noun,96,38,58,0.000444592641991775,0.0006663853039827628,0.6041666666666666
2415,2415,무기/Noun,96,39,57,0.00045570745804156943,0.0006552788822497168,0.59375
2416,2416,고딩/Noun,96,40,56,0.0004668222740913638,0.0006441724605166707,0.5833333333333334
2417,2417,음식/Noun,96,40,56,0.0004668222740913638,0.0006441724605166707,0.5833333333333334
2418,2418,펴다/Verb,96,48,48,0.0005557408024897189,0.0005553210866523023,0.5
2419,2419,체적/Noun,95,10,85,0.0001333777925975325,0.0009662586907750061,0.8947368421052632
2420,2420,이만/Noun,95,82,13,0.0009336445481827276,0.0001665963259956907,0.8631578947368421
2421,2421,팔/Noun,95,16,79,0.0002000666888962988,0.0008996201603767299,0.8315789473684211
2422,2422,듭니/Noun,95,77,18,0.0008780704679337558,0.00022212843466092096,0.8105263157894737
2423,2423,여자애/Noun,95,21,74,0.00025564076914527065,0.0008440880517114996,0.7789473684210526
2424,2424,던데/Noun,95,26,69,0.00031121484939424253,0.0007885559430462694,0.7263157894736842
2425,2425,당황/Noun,95,26,69,0.00031121484939424253,0.0007885559430462694,0.7263157894736842
2426,2426,꽃/Noun,95,68,27,0.0007780371234856063,0.00032208623025833537,0.7157894736842105
2427,2427,에다/Josa,95,28,67,0.0003334444814938313,0.0007663430995801773,0.7052631578947368
2428,2428,평균/Noun,95,28,67,0.0003334444814938313,0.0007663430995801773,0.7052631578947368
2429,2429,조카/Noun,95,66,29,0.0007558074913860174,0.00034429907372442745,0.6947368421052632
2430,2430,100%/Number,95,62,33,0.0007113482271868402,0.00038872476065661166,0.6526315789473685
2431,2431,겁/Noun,95,33,62,0.00038901856174280313,0.000710810990914947,0.6526315789473685
2432,2432,선정/Noun,95,33,62,0.00038901856174280313,0.000710810990914947,0.6526315789473685
2433,2433,잡고/Noun,95,38,57,0.000444592641991775,0.0006552788822497168,0.6
2434,2434,옛/Adverb,95,54,41,0.0006224296987884852,0.00047757613452098,0.5684210526315789
2435,2435,제니퍼/Noun,95,44,51,0.0005112815382905413,0.0005886403518514405,0.5368421052631579
2436,2436,삼/Modifier,95,45,50,0.0005223963543403357,0.0005775339301183945,0.5263157894736842
2437,2437,40/Number,95,49,46,0.0005668556185395131,0.0005331082431862101,0.5157894736842106
2438,2438,아끼다/Verb,95,46,49,0.00053351117039013,0.0005664275083853486,0.5157894736842106
2439,2439,요리/Noun,95,46,49,0.00053351117039013,0.0005664275083853486,0.5157894736842106
2440,2440,의상/Noun,95,47,48,0.0005446259864399244,0.0005553210866523023,0.5052631578947369
2441,2441,겨울/Noun,94,77,17,0.0008780704679337558,0.0002110220129278749,0.8191489361702128
2442,2442,말투/Noun,94,24,70,0.0002889852172946538,0.0007996623647793153,0.7446808510638298
2443,2443,상실/Noun,94,24,70,0.0002889852172946538,0.0007996623647793153,0.7446808510638298
2444,2444,ㅈ/KoreanParticle,94,27,67,0.00032232966544403684,0.0007663430995801773,0.7127659574468085
2445,2445,베드/Noun,94,29,65,0.0003445592975436257,0.0007441302561140852,0.6914893617021277
2446,2446,에게도/Josa,94,65,29,0.0007446926753362233,0.00034429907372442745,0.6914893617021277
2447,2447,루즈/Noun,94,34,60,0.0004001333777925976,0.0006885981474488549,0.6382978723404256
2448,2448,난리/Noun,94,34,60,0.0004001333777925976,0.0006885981474488549,0.6382978723404256
2449,2449,주지/Noun,94,36,58,0.00042236300989218633,0.0006663853039827628,0.6170212765957447
2450,2450,찬/Noun,94,55,39,0.0006335445148382794,0.000455363291054888,0.5851063829787234
2451,2451,링/Noun,94,41,53,0.0004779370901411582,0.0006108531953175326,0.5638297872340425
2452,2452,니콜/Noun,94,41,53,0.0004779370901411582,0.0006108531953175326,0.5638297872340425
2453,2453,드러나다/Verb,94,51,43,0.000589085250639102,0.0004997889779870722,0.5425531914893617
2454,2454,정보/Noun,94,51,43,0.000589085250639102,0.0004997889779870722,0.5425531914893617
2455,2455,류작/Noun,93,5,88,7.780371234856063e-05,0.0009995779559741444,0.946236559139785
2456,2456,도무지/Noun,93,7,86,0.0001000333444481494,0.000977365112508052,0.9247311827956988
2457,2457,I/Alpha,93,76,17,0.0008669556518839612,0.0002110220129278749,0.8172043010752689
2458,2458,녹다/Verb,93,76,17,0.0008669556518839612,0.0002110220129278749,0.8172043010752689
2459,2459,성의/Noun,93,23,70,0.00027787040124485944,0.0007996623647793153,0.7526881720430108
2460,2460,차갑다/Adjective,93,68,25,0.0007780371234856063,0.0002998733867922433,0.7311827956989247
2461,2461,애초/Noun,93,30,63,0.00035567411359342004,0.0007219174126479931,0.6774193548387096
2462,2462,반대/Noun,93,32,61,0.00037790374569300877,0.0006997045691819009,0.6559139784946236
2463,2463,거치다/Verb,93,61,32,0.0007002334111370457,0.0003776183389235656,0.6559139784946236
2464,2464,무난/Noun,93,34,59,0.0004001333777925976,0.0006774917257158089,0.6344086021505376
2465,2465,단체/Noun,93,34,59,0.0004001333777925976,0.0006774917257158089,0.6344086021505376
2466,2466,단순/Noun,93,38,55,0.000444592641991775,0.0006330660387836247,0.5913978494623656
2467,2467,틀어주다/Verb,93,38,55,0.000444592641991775,0.0006330660387836247,0.5913978494623656
2468,2468,레이/Noun,93,54,39,0.0006224296987884852,0.000455363291054888,0.5806451612903226
2469,2469,치고는/Josa,93,40,53,0.0004668222740913638,0.0006108531953175326,0.5698924731182796
2470,2470,주윤발/Noun,93,42,51,0.0004890519061909527,0.0005886403518514405,0.5483870967741935
2471,2471,베다/Verb,93,50,43,0.0005779704345893076,0.0004997889779870722,0.5376344086021505
2472,2472,하이/Noun,93,48,45,0.0005557408024897189,0.0005220018214531642,0.5161290322580645
2473,2473,수입/Noun,92,12,80,0.00015560742469712126,0.000910726582109776,0.8695652173913043
2474,2474,처절하다/Adjective,92,74,18,0.0008447260197843727,0.00022212843466092096,0.8043478260869565
2475,2475,딴/Modifier,92,19,73,0.0002334111370456819,0.0008329816299784535,0.7934782608695652
2476,2476,컨셉/Noun,92,20,72,0.00024452595309547634,0.0008218752082454075,0.7826086956521741
2477,2477,고프다/Adjective,92,71,21,0.0008113815716349895,0.0002554476998600591,0.7717391304347826
2478,2478,절/Noun,92,23,69,0.00027787040124485944,0.0007885559430462694,0.75
2479,2479,드디어/Adverb,92,68,24,0.0007780371234856063,0.0002887669650591972,0.7391304347826086
2480,2480,흥/Noun,92,66,26,0.0007558074913860174,0.00031097980852528933,0.7173913043478259
2481,2481,반드시/Noun,92,65,27,0.0007446926753362233,0.00032208623025833537,0.7065217391304348
2482,2482,진수/Noun,92,64,28,0.0007335778592864287,0.0003331926519913814,0.6956521739130435
2483,2483,쥐다/Verb,92,34,58,0.0004001333777925976,0.0006663853039827628,0.6304347826086957
2484,2484,13/Number,92,34,58,0.0004001333777925976,0.0006663853039827628,0.6304347826086957
2485,2485,대사도/Noun,92,35,57,0.0004112481938423919,0.0006552788822497168,0.6195652173913043
2486,2486,속이다/Verb,92,37,55,0.0004334778259419807,0.0006330660387836247,0.5978260869565217
2487,2487,중심/Noun,92,38,54,0.000444592641991775,0.0006219596170505788,0.5869565217391305
2488,2488,다리/Noun,92,38,54,0.000444592641991775,0.0006219596170505788,0.5869565217391305
2489,2489,어/Eomi,92,38,54,0.000444592641991775,0.0006219596170505788,0.5869565217391305
2490,2490,빵터지다/Adjective,92,40,52,0.0004668222740913638,0.0005997467735844866,0.5652173913043478
2491,2491,푸다/Verb,92,40,52,0.0004668222740913638,0.0005997467735844866,0.5652173913043478
2492,2492,준비/Noun,92,48,44,0.0005557408024897189,0.0005108953997201182,0.5217391304347826
2493,2493,2014년/Number,92,47,45,0.0005446259864399244,0.0005220018214531642,0.5108695652173914
2494,2494,아기/Noun,92,47,45,0.0005446259864399244,0.0005220018214531642,0.5108695652173914
2495,2495,웰/Noun,91,86,5,0.0009781038123819054,7.774495213132233e-05,0.9450549450549449
2496,2496,어우러지다/Verb,91,85,6,0.0009669889963321108,8.885137386436837e-05,0.934065934065934
2497,2497,만드/Noun,91,14,77,0.00017783705679671002,0.0008774073169106378,0.8461538461538461
2498,2498,혐오/Noun,91,15,76,0.00018895187284650438,0.0008663008951775916,0.8351648351648352
2499,2499,명대사/Noun,91,72,19,0.0008224963876847838,0.000233234856393967,0.7912087912087912
2500,2500,살인마/Noun,91,21,70,0.00025564076914527065,0.0007996623647793153,0.7692307692307693
2501,2501,실수/Noun,91,25,66,0.00030010003334444816,0.0007552366778471312,0.7252747252747253
2502,2502,베리/Noun,91,65,26,0.0007446926753362233,0.00031097980852528933,0.7142857142857143
2503,2503,비중/Noun,91,30,61,0.00035567411359342004,0.0006997045691819009,0.6703296703296703
2504,2504,무게/Noun,91,60,31,0.0006891185950872514,0.00036651191719051963,0.6593406593406593
2505,2505,잭/Noun,91,60,31,0.0006891185950872514,0.00036651191719051963,0.6593406593406593
2506,2506,붙다/Verb,91,31,60,0.00036678892964321435,0.0006885981474488549,0.6593406593406593
2507,2507,........../Punctuation,91,34,57,0.0004001333777925976,0.0006552788822497168,0.6263736263736264
2508,2508,영향/Noun,91,56,35,0.0006446593308880737,0.0004109376041227037,0.6153846153846154
2509,2509,키드/Noun,91,39,52,0.00045570745804156943,0.0005997467735844866,0.5714285714285714
2510,2510,화란/Noun,91,39,52,0.00045570745804156943,0.0005997467735844866,0.5714285714285714
2511,2511,론/Noun,91,39,52,0.00045570745804156943,0.0005997467735844866,0.5714285714285714
2512,2512,의사/Noun,91,43,48,0.0005001667222407468,0.0005553210866523023,0.5274725274725275
2513,2513,기존/Noun,91,44,47,0.0005112815382905413,0.0005442146649192564,0.5164835164835165
2514,2514,계기/Noun,90,72,18,0.0008224963876847838,0.00022212843466092096,0.8
2515,2515,논리/Noun,90,20,70,0.00024452595309547634,0.0007996623647793153,0.7777777777777778
2516,2516,최고봉/Noun,90,68,22,0.0007780371234856063,0.00026655412159310506,0.7555555555555555
2517,2517,운/Noun,90,65,25,0.0007446926753362233,0.0002998733867922433,0.7222222222222222
2518,2518,어떻/Modifier,90,25,65,0.00030010003334444816,0.0007441302561140852,0.7222222222222222
2519,2519,레/Noun,90,25,65,0.00030010003334444816,0.0007441302561140852,0.7222222222222222
2520,2520,암/Modifier,90,26,64,0.00031121484939424253,0.0007330238343810393,0.7111111111111111
2521,2521,매일/Noun,90,62,28,0.0007113482271868402,0.0003331926519913814,0.6888888888888889
2522,2522,쿡/Noun,90,30,60,0.00035567411359342004,0.0006885981474488549,0.6666666666666666
2523,2523,깍/Adverb,90,31,59,0.00036678892964321435,0.0006774917257158089,0.6555555555555556
2524,2524,및/Noun,90,31,59,0.00036678892964321435,0.0006774917257158089,0.6555555555555556
2525,2525,데뷔/Noun,90,59,31,0.0006780037790374569,0.00036651191719051963,0.6555555555555556
2526,2526,걱정/Noun,90,58,32,0.0006668889629876625,0.0003776183389235656,0.6444444444444445
2527,2527,다/Noun,90,33,57,0.00038901856174280313,0.0006552788822497168,0.6333333333333333
2528,2528,여자친구/Noun,90,33,57,0.00038901856174280313,0.0006552788822497168,0.6333333333333333
2529,2529,동성애/Noun,90,35,55,0.0004112481938423919,0.0006330660387836247,0.6111111111111112
2530,2530,자동차/Noun,90,40,50,0.0004668222740913638,0.0005775339301183945,0.5555555555555556
2531,2531,앤/Noun,90,50,40,0.0005779704345893076,0.000466469712787934,0.5555555555555556
2532,2532,의지/Noun,90,49,41,0.0005668556185395131,0.00047757613452098,0.5444444444444444
2533,2533,차원/Noun,90,48,42,0.0005557408024897189,0.0004886825562540262,0.5333333333333333
2534,2534,네티즌/Noun,90,45,45,0.0005223963543403357,0.0005220018214531642,0.5
2535,2535,게뭐/Noun,89,7,82,0.0001000333444481494,0.000932939425575868,0.9213483146067416
2536,2536,감사/Noun,89,78,11,0.00088918528398355,0.0001443834825295986,0.8764044943820225
2537,2537,빨갱이/Noun,89,18,71,0.0002222963209958875,0.0008107687865123613,0.797752808988764
2538,2538,ㅉ/KoreanParticle,89,18,71,0.0002222963209958875,0.0008107687865123613,0.797752808988764
2539,2539,강력/Noun,89,70,19,0.0008002667555851951,0.000233234856393967,0.7865168539325843
2540,2540,아무튼/Adverb,89,62,27,0.0007113482271868402,0.00032208623025833537,0.6966292134831461
2541,2541,섞다/Verb,89,28,61,0.0003334444814938313,0.0006997045691819009,0.6853932584269663
2542,2542,박중훈/Noun,89,58,31,0.0006668889629876625,0.00036651191719051963,0.651685393258427
2543,2543,폭발/Noun,89,58,31,0.0006668889629876625,0.00036651191719051963,0.651685393258427
2544,2544,각색/Noun,89,32,57,0.00037790374569300877,0.0006552788822497168,0.6404494382022472
2545,2545,포/Noun,89,33,56,0.00038901856174280313,0.0006441724605166707,0.6292134831460674
2546,2546,dvd/Alpha,89,56,33,0.0006446593308880737,0.00038872476065661166,0.6292134831460674
2547,2547,부작/Noun,89,55,34,0.0006335445148382794,0.00039983118238965764,0.6179775280898876
2548,2548,ㄴ/KoreanParticle,89,34,55,0.0004001333777925976,0.0006330660387836247,0.6179775280898876
2549,2549,필/Noun,89,35,54,0.0004112481938423919,0.0006219596170505788,0.6067415730337079
2550,2550,와도/Josa,89,51,38,0.000589085250639102,0.0004442568693218419,0.5730337078651685
2551,2551,아아/Noun,89,48,41,0.0005557408024897189,0.00047757613452098,0.5393258426966292
2552,2552,ㅏ/KoreanParticle,89,47,42,0.0005446259864399244,0.0004886825562540262,0.5280898876404494
2553,2553,신인/Noun,89,47,42,0.0005446259864399244,0.0004886825562540262,0.5280898876404494
2554,2554,할리우드/Noun,89,46,43,0.00053351117039013,0.0004997889779870722,0.5168539325842697
2555,2555,과학/Noun,89,46,43,0.00053351117039013,0.0004997889779870722,0.5168539325842697
2556,2556,리얼리티/Noun,89,46,43,0.00053351117039013,0.0004997889779870722,0.5168539325842697
2557,2557,개그맨/Noun,88,4,84,6.668889629876625e-05,0.00095515226904196,0.9545454545454546
2558,2558,마음속/Noun,88,83,5,0.0009447593642325221,7.774495213132233e-05,0.9431818181818182
2559,2559,ㅄ/KoreanParticle,88,15,73,0.00018895187284650438,0.0008329816299784535,0.8295454545454546
2560,2560,동심/Noun,88,64,24,0.0007335778592864287,0.0002887669650591972,0.7272727272727273
2561,2561,폴/Noun,88,64,24,0.0007335778592864287,0.0002887669650591972,0.7272727272727273
2562,2562,피해/Noun,88,24,64,0.0002889852172946538,0.0007330238343810393,0.7272727272727273
2563,2563,에이/Noun,88,26,62,0.00031121484939424253,0.000710810990914947,0.7045454545454546
2564,2564,만화책/Noun,88,26,62,0.00031121484939424253,0.000710810990914947,0.7045454545454546
2565,2565,?.../Punctuation,88,30,58,0.00035567411359342004,0.0006663853039827628,0.6590909090909091
2566,2566,출신/Noun,88,33,55,0.00038901856174280313,0.0006330660387836247,0.625
2567,2567,ㅣ/KoreanParticle,88,34,54,0.0004001333777925976,0.0006219596170505788,0.6136363636363636
2568,2568,끝내/Noun,88,34,54,0.0004001333777925976,0.0006219596170505788,0.6136363636363636
2569,2569,부정/Noun,88,54,34,0.0006224296987884852,0.00039983118238965764,0.6136363636363636
2570,2570,아놀드/Noun,88,52,36,0.0006002000666888963,0.0004220440258557498,0.5909090909090909
2571,2571,조/Suffix,88,52,36,0.0006002000666888963,0.0004220440258557498,0.5909090909090909
2572,2572,극단/Noun,88,37,51,0.0004334778259419807,0.0005886403518514405,0.5795454545454546
2573,2573,유럽/Noun,88,42,46,0.0004890519061909527,0.0005331082431862101,0.5227272727272727
2574,2574,블랙/Noun,88,45,43,0.0005223963543403357,0.0004997889779870722,0.5113636363636364
2575,2575,리지/Noun,88,43,45,0.0005001667222407468,0.0005220018214531642,0.5113636363636364
2576,2576,보신/Noun,88,45,43,0.0005223963543403357,0.0004997889779870722,0.5113636363636364
2577,2577,♥♥♥/Foreign,87,86,1,0.0009781038123819054,3.331926519913814e-05,0.9885057471264368
2578,2578,어거지/Noun,87,8,79,0.00011114816049794375,0.0008996201603767299,0.9080459770114944
2579,2579,난잡하다/Adjective,87,8,79,0.00011114816049794375,0.0008996201603767299,0.9080459770114944
2580,2580,발음/Noun,87,17,70,0.00021118150494609317,0.0007996623647793153,0.8045977011494253
2581,2581,듣기/Noun,87,21,66,0.00025564076914527065,0.0007552366778471312,0.7586206896551724
2582,2582,친/Noun,87,25,62,0.00030010003334444816,0.000710810990914947,0.7126436781609196
2583,2583,무한/Noun,87,60,27,0.0006891185950872514,0.00032208623025833537,0.6896551724137931
2584,2584,배신/Noun,87,32,55,0.00037790374569300877,0.0006330660387836247,0.632183908045977
2585,2585,알아보다/Verb,87,33,54,0.00038901856174280313,0.0006219596170505788,0.6206896551724138
2586,2586,하니/Noun,87,34,53,0.0004001333777925976,0.0006108531953175326,0.6091954022988506
2587,2587,역사상/Noun,87,52,35,0.0006002000666888963,0.0004109376041227037,0.5977011494252874
2588,2588,파리/Noun,87,50,37,0.0005779704345893076,0.0004331504475887958,0.5747126436781609
2589,2589,요새/Noun,87,50,37,0.0005779704345893076,0.0004331504475887958,0.5747126436781609
2590,2590,인게/Josa,87,38,49,0.000444592641991775,0.0005664275083853486,0.5632183908045977
2591,2591,///Punctuation,87,47,40,0.0005446259864399244,0.000466469712787934,0.5402298850574713
2592,2592,평소/Noun,87,47,40,0.0005446259864399244,0.000466469712787934,0.5402298850574713
2593,2593,질리다/Verb,87,41,46,0.0004779370901411582,0.0005331082431862101,0.5287356321839081
2594,2594,일반/Noun,87,41,46,0.0004779370901411582,0.0005331082431862101,0.5287356321839081
2595,2595,무대/Noun,87,43,44,0.0005001667222407468,0.0005108953997201182,0.5057471264367817
2596,2596,토나오다/Verb,86,4,82,6.668889629876625e-05,0.000932939425575868,0.9534883720930232
2597,2597,별하나/Noun,86,4,82,6.668889629876625e-05,0.000932939425575868,0.9534883720930232
2598,2598,다세포/Noun,86,8,78,0.00011114816049794375,0.0008885137386436838,0.9069767441860463
2599,2599,개콘/Noun,86,9,77,0.00012226297654773814,0.0008774073169106378,0.8953488372093024
2600,2600,황당/Noun,86,9,77,0.00012226297654773814,0.0008774073169106378,0.8953488372093024
2601,2601,영화감독/Noun,86,14,72,0.00017783705679671002,0.0008218752082454075,0.8372093023255814
2602,2602,언니/Suffix,86,70,16,0.0008002667555851951,0.00019991559119482882,0.813953488372093
2603,2603,최소한/Noun,86,18,68,0.0002222963209958875,0.0007774495213132232,0.7906976744186046
2604,2604,컴퓨터/Noun,86,20,66,0.00024452595309547634,0.0007552366778471312,0.7674418604651163
2605,2605,경우/Noun,86,27,59,0.00032232966544403684,0.0006774917257158089,0.686046511627907
2606,2606,해리포터/Noun,86,57,29,0.0006557741469378681,0.00034429907372442745,0.6627906976744186
2607,2607,추/Noun,86,56,30,0.0006446593308880737,0.0003554054954574735,0.6511627906976745
2608,2608,나레이션/Noun,86,30,56,0.00035567411359342004,0.0006441724605166707,0.6511627906976745
2609,2609,손가락/Noun,86,53,33,0.0006113148827386907,0.00038872476065661166,0.6162790697674418
2610,2610,거장/Noun,86,52,34,0.0006002000666888963,0.00039983118238965764,0.6046511627906976
2611,2611,얼다/Verb,86,36,50,0.00042236300989218633,0.0005775339301183945,0.5813953488372093
2612,2612,판단/Noun,86,49,37,0.0005668556185395131,0.0004331504475887958,0.5697674418604651
2613,2613,배트맨/Noun,86,48,38,0.0005557408024897189,0.0004442568693218419,0.5581395348837209
2614,2614,심다/Verb,86,39,47,0.00045570745804156943,0.0005442146649192564,0.5465116279069767
2615,2615,스티븐/Noun,86,39,47,0.00045570745804156943,0.0005442146649192564,0.5465116279069767
2616,2616,하지원/Noun,86,46,40,0.00053351117039013,0.000466469712787934,0.5348837209302325
2617,2617,인형/Noun,86,41,45,0.0004779370901411582,0.0005220018214531642,0.5232558139534884
2618,2618,한국판/Noun,86,45,41,0.0005223963543403357,0.00047757613452098,0.5232558139534884
2619,2619,홍상수/Noun,86,44,42,0.0005112815382905413,0.0004886825562540262,0.5116279069767442
2620,2620,인류/Noun,86,44,42,0.0005112815382905413,0.0004886825562540262,0.5116279069767442
2621,2621,겉멋/Noun,85,7,78,0.0001000333444481494,0.0008885137386436838,0.9176470588235294
2622,2622,싫어지다/Adjective,85,9,76,0.00012226297654773814,0.0008663008951775916,0.8941176470588236
2623,2623,압도/Noun,85,75,10,0.0008558408358341669,0.00013327706079655256,0.8823529411764706
2624,2624,담담하다/Adjective,85,71,14,0.0008113815716349895,0.00017770274772873674,0.8352941176470589
2625,2625,누군지/Adverb,85,21,64,0.00025564076914527065,0.0007330238343810393,0.7529411764705882
2626,2626,딱/VerbPrefix,85,23,62,0.00027787040124485944,0.000710810990914947,0.7294117647058823
2627,2627,정말/Exclamation,85,60,25,0.0006891185950872514,0.0002998733867922433,0.7058823529411765
2628,2628,여인/Noun,85,57,28,0.0006557741469378681,0.0003331926519913814,0.6705882352941176
2629,2629,환경/Noun,85,55,30,0.0006335445148382794,0.0003554054954574735,0.6470588235294118
2630,2630,곧/Noun,85,54,31,0.0006224296987884852,0.00036651191719051963,0.6352941176470588
2631,2631,ㄷ/KoreanParticle,85,54,31,0.0006224296987884852,0.00036651191719051963,0.6352941176470588
2632,2632,찌질하다/Adjective,85,33,52,0.00038901856174280313,0.0005997467735844866,0.611764705882353
2633,2633,누르다/Verb,85,34,51,0.0004001333777925976,0.0005886403518514405,0.6
2634,2634,밖/Noun,85,45,40,0.0005223963543403357,0.000466469712787934,0.5294117647058824
2635,2635,션/Noun,85,43,42,0.0005001667222407468,0.0004886825562540262,0.5058823529411764
2636,2636,깨알/Noun,84,76,8,0.0008669556518839612,0.00011106421733046048,0.9047619047619048
2637,2637,민폐/Noun,84,11,73,0.0001444926086473269,0.0008329816299784535,0.8690476190476191
2638,2638,쓸데없다/Adjective,84,14,70,0.00017783705679671002,0.0007996623647793153,0.8333333333333334
2639,2639,부리다/Verb,84,17,67,0.00021118150494609317,0.0007663430995801773,0.7976190476190477
2640,2640,이루어지다/Verb,84,66,18,0.0007558074913860174,0.00022212843466092096,0.7857142857142857
2641,2641,--/Punctuation,84,19,65,0.0002334111370456819,0.0007441302561140852,0.7738095238095238
2642,2642,어쩌면/Noun,84,62,22,0.0007113482271868402,0.00026655412159310506,0.7380952380952381
2643,2643,임창정/Noun,84,58,26,0.0006668889629876625,0.00031097980852528933,0.6904761904761905
2644,2644,화일/Noun,84,26,58,0.00031121484939424253,0.0006663853039827628,0.6904761904761905
2645,2645,성적/Noun,84,32,52,0.00037790374569300877,0.0005997467735844866,0.6190476190476191
2646,2646,이니까/Josa,84,49,35,0.0005668556185395131,0.0004109376041227037,0.5833333333333334
2647,2647,연/Noun,84,49,35,0.0005668556185395131,0.0004109376041227037,0.5833333333333334
2648,2648,오프닝/Noun,84,48,36,0.0005557408024897189,0.0004220440258557498,0.5714285714285714
2649,2649,".,/Punctuation",84,47,37,0.0005446259864399244,0.0004331504475887958,0.5595238095238095
2650,2650,남성/Noun,84,45,39,0.0005223963543403357,0.000455363291054888,0.5357142857142857
2651,2651,단점/Noun,84,39,45,0.00045570745804156943,0.0005220018214531642,0.5357142857142857
2652,2652,러시아/Noun,84,43,41,0.0005001667222407468,0.00047757613452098,0.5119047619047619
2653,2653,영화사/Noun,84,42,42,0.0004890519061909527,0.0004886825562540262,0.5
2654,2654,..!/Punctuation,83,74,9,0.0008447260197843727,0.00012217063906350652,0.891566265060241
2655,2655,흉내/Noun,83,11,72,0.0001444926086473269,0.0008218752082454075,0.8674698795180723
2656,2656,달콤하다/Adjective,83,68,15,0.0007780371234856063,0.0001888091694617828,0.8192771084337349
2657,2657,방해/Noun,83,18,65,0.0002222963209958875,0.0007441302561140852,0.7831325301204819
2658,2658,김치/Noun,83,22,61,0.000266755585195065,0.0006997045691819009,0.7349397590361446
2659,2659,분량/Noun,83,25,58,0.00030010003334444816,0.0006663853039827628,0.6987951807228916
2660,2660,향수/Noun,83,57,26,0.0006557741469378681,0.00031097980852528933,0.6867469879518072
2661,2661,코메디/Noun,83,27,56,0.00032232966544403684,0.0006441724605166707,0.6746987951807228
2662,2662,사/Noun,83,56,27,0.0006446593308880737,0.00032208623025833537,0.6746987951807228
2663,2663,매/Noun,83,53,30,0.0006113148827386907,0.0003554054954574735,0.6385542168674698
2664,2664,판이/Noun,83,33,50,0.00038901856174280313,0.0005775339301183945,0.6024096385542169
2665,2665,만화영화/Noun,83,47,36,0.0005446259864399244,0.0004220440258557498,0.5662650602409639
2666,2666,무너지다/Verb,83,36,47,0.00042236300989218633,0.0005442146649192564,0.5662650602409639
2667,2667,쉽다/Adjective,83,37,46,0.0004334778259419807,0.0005331082431862101,0.5542168674698795
2668,2668,전하/Noun,83,38,45,0.000444592641991775,0.0005220018214531642,0.5421686746987951
2669,2669,널/Noun,83,42,41,0.0004890519061909527,0.00047757613452098,0.5060240963855421
2670,2670,슈퍼/Noun,83,42,41,0.0004890519061909527,0.00047757613452098,0.5060240963855421
2671,2671,키스/Noun,83,42,41,0.0004890519061909527,0.00047757613452098,0.5060240963855421
2672,2672,명복/Noun,82,74,8,0.0008447260197843727,0.00011106421733046048,0.902439024390244
2673,2673,거품/Noun,82,12,70,0.00015560742469712126,0.0007996623647793153,0.8536585365853658
2674,2674,동영상/Noun,82,12,70,0.00015560742469712126,0.0007996623647793153,0.8536585365853658
2675,2675,고뇌/Noun,82,57,25,0.0006557741469378681,0.0002998733867922433,0.6951219512195121
2676,2676,늘리다/Verb,82,25,57,0.00030010003334444816,0.0006552788822497168,0.6951219512195121
2677,2677,능/Noun,82,55,27,0.0006335445148382794,0.00032208623025833537,0.6707317073170732
2678,2678,흡입/Noun,82,53,29,0.0006113148827386907,0.00034429907372442745,0.6463414634146342
2679,2679,윌리스/Noun,82,29,53,0.0003445592975436257,0.0006108531953175326,0.6463414634146342
2680,2680,때매/Noun,82,30,52,0.00035567411359342004,0.0005997467735844866,0.6341463414634146
2681,2681,인도/Noun,82,51,31,0.000589085250639102,0.00036651191719051963,0.6219512195121951
2682,2682,잡히다/Verb,82,31,51,0.00036678892964321435,0.0005886403518514405,0.6219512195121951
2683,2683,매끄럽다/Adjective,82,32,50,0.00037790374569300877,0.0005775339301183945,0.6097560975609756
2684,2684,든지/Josa,82,32,50,0.00037790374569300877,0.0005775339301183945,0.6097560975609756
2685,2685,길이/Noun,82,49,33,0.0005668556185395131,0.00038872476065661166,0.5975609756097561
2686,2686,중년/Noun,82,48,34,0.0005557408024897189,0.00039983118238965764,0.5853658536585366
2687,2687,부족함/Noun,82,35,47,0.0004112481938423919,0.0005442146649192564,0.573170731707317
2688,2688,일으키다/Verb,82,37,45,0.0004334778259419807,0.0005220018214531642,0.5487804878048781
2689,2689,전투/Noun,82,45,37,0.0005223963543403357,0.0004331504475887958,0.5487804878048781
2690,2690,이병헌/Noun,82,39,43,0.00045570745804156943,0.0004997889779870722,0.5243902439024389
2691,2691,슴/Noun,82,39,43,0.00045570745804156943,0.0004997889779870722,0.5243902439024389
2692,2692,섞이다/Verb,82,41,41,0.0004779370901411582,0.00047757613452098,0.5
2693,2693,탁월하다/Adjective,81,73,8,0.0008336112037345782,0.00011106421733046048,0.9012345679012346
2694,2694,도데/Noun,81,8,73,0.00011114816049794375,0.0008329816299784535,0.9012345679012346
2695,2695,짜리/Foreign,81,12,69,0.00015560742469712126,0.0007885559430462694,0.8518518518518519
2696,2696,속지/Noun,81,13,68,0.00016672224074691566,0.0007774495213132232,0.8395061728395061
2697,2697,역량/Noun,81,13,68,0.00016672224074691566,0.0007774495213132232,0.8395061728395061
2698,2698,배급사/Noun,81,15,66,0.00018895187284650438,0.0007552366778471312,0.8148148148148148
2699,2699,징그럽다/Adjective,81,17,64,0.00021118150494609317,0.0007330238343810393,0.7901234567901234
2700,2700,이해도/Noun,81,17,64,0.00021118150494609317,0.0007330238343810393,0.7901234567901234
2701,2701,염/Noun,81,60,21,0.0006891185950872514,0.0002554476998600591,0.7407407407407407
2702,2702,몽환/Noun,81,59,22,0.0006780037790374569,0.00026655412159310506,0.7283950617283951
2703,2703,박다/Verb,81,22,59,0.000266755585195065,0.0006774917257158089,0.7283950617283951
2704,2704,짜이다/Verb,81,56,25,0.0006446593308880737,0.0002998733867922433,0.6913580246913579
2705,2705,약/Modifier,81,26,55,0.00031121484939424253,0.0006330660387836247,0.6790123456790124
2706,2706,그렇지만/Conjunction,81,55,26,0.0006335445148382794,0.00031097980852528933,0.6790123456790124
2707,2707,옴/Noun,81,26,55,0.00031121484939424253,0.0006330660387836247,0.6790123456790124
2708,2708,실험/Noun,81,29,52,0.0003445592975436257,0.0005997467735844866,0.6419753086419753
2709,2709,극복/Noun,81,51,30,0.000589085250639102,0.0003554054954574735,0.6296296296296297
2710,2710,사용/Noun,81,31,50,0.00036678892964321435,0.0005775339301183945,0.6172839506172839
2711,2711,1회/Number,81,49,32,0.0005668556185395131,0.0003776183389235656,0.6049382716049383
2712,2712,이소룡/Noun,81,48,33,0.0005557408024897189,0.00038872476065661166,0.5925925925925926
2713,2713,왕/Suffix,81,33,48,0.00038901856174280313,0.0005553210866523023,0.5925925925925926
2714,2714,스포/Noun,81,47,34,0.0005446259864399244,0.00039983118238965764,0.5802469135802469
2715,2715,화장실/Noun,81,34,47,0.0004001333777925976,0.0005442146649192564,0.5802469135802469
2716,2716,d/Alpha,81,35,46,0.0004112481938423919,0.0005331082431862101,0.5679012345679012
2717,2717,도시/Noun,81,46,35,0.00053351117039013,0.0004109376041227037,0.5679012345679012
2718,2718,멍/Noun,81,36,45,0.00042236300989218633,0.0005220018214531642,0.5555555555555556
2719,2719,파격/Noun,81,42,39,0.0004890519061909527,0.000455363291054888,0.5185185185185185
2720,2720,중국영화/Noun,81,39,42,0.00045570745804156943,0.0004886825562540262,0.5185185185185185
2721,2721,천국/Noun,81,40,41,0.0004668222740913638,0.00047757613452098,0.5061728395061729
2722,2722,담백하다/Adjective,80,75,5,0.0008558408358341669,7.774495213132233e-05,0.9375
2723,2723,삶다/Verb,80,68,12,0.0007780371234856063,0.00015548990426264466,0.85
2724,2724,가히/Adverb,80,68,12,0.0007780371234856063,0.00015548990426264466,0.85
2725,2725,지리다/Verb,80,63,17,0.0007224630432366343,0.0002110220129278749,0.7875
2726,2726,킬링/Noun,80,22,58,0.000266755585195065,0.0006663853039827628,0.725
2727,2727,장점/Noun,80,23,57,0.00027787040124485944,0.0006552788822497168,0.7125
2728,2728,등록/Noun,80,23,57,0.00027787040124485944,0.0006552788822497168,0.7125
2729,2729,망가지다/Verb,80,26,54,0.00031121484939424253,0.0006219596170505788,0.675
2730,2730,하정우/Noun,80,53,27,0.0006113148827386907,0.00032208623025833537,0.6625
2731,2731,미녀/Noun,80,30,50,0.00035567411359342004,0.0005775339301183945,0.625
2732,2732,독일/Noun,80,48,32,0.0005557408024897189,0.0003776183389235656,0.6
2733,2733,가리다/Verb,80,33,47,0.00038901856174280313,0.0005442146649192564,0.5875
2734,2734,마약/Noun,80,33,47,0.00038901856174280313,0.0005442146649192564,0.5875
2735,2735,은/Foreign,80,33,47,0.00038901856174280313,0.0005442146649192564,0.5875
2736,2736,군인/Noun,80,34,46,0.0004001333777925976,0.0005331082431862101,0.575
2737,2737,에서만/Josa,80,35,45,0.0004112481938423919,0.0005220018214531642,0.5625
2738,2738,버튼/Noun,80,45,35,0.0005223963543403357,0.0004109376041227037,0.5625
2739,2739,액션씬/Noun,80,42,38,0.0004890519061909527,0.0004442568693218419,0.525
2740,2740,정우성/Noun,80,39,41,0.00045570745804156943,0.00047757613452098,0.5125
2741,2741,밀려오다/Verb,80,41,39,0.0004779370901411582,0.000455363291054888,0.5125
2742,2742,오는/Modifier,80,41,39,0.0004779370901411582,0.000455363291054888,0.5125
2743,2743,천/Modifier,80,41,39,0.0004779370901411582,0.000455363291054888,0.5125
2744,2744,완벽/Noun,79,71,8,0.0008113815716349895,0.00011106421733046048,0.8987341772151899
2745,2745,그럴듯하다/Adjective,79,8,71,0.00011114816049794375,0.0008107687865123613,0.8987341772151899
2746,2746,의외/Noun,79,65,14,0.0007446926753362233,0.00017770274772873674,0.8227848101265823
2747,2747,딱/Modifier,79,16,63,0.0002000666888962988,0.0007219174126479931,0.7974683544303798
2748,2748,분장/Noun,79,17,62,0.00021118150494609317,0.000710810990914947,0.7848101265822784
2749,2749,언젠가/Adverb,79,59,20,0.0006780037790374569,0.00024434127812701304,0.7468354430379747
2750,2750,파다/Verb,79,24,55,0.0002889852172946538,0.0006330660387836247,0.6962025316455697
2751,2751,샘/Noun,79,53,26,0.0006113148827386907,0.00031097980852528933,0.6708860759493671
2752,2752,중딩/Noun,79,27,52,0.00032232966544403684,0.0005997467735844866,0.6582278481012658
2753,2753,정상/Noun,79,27,52,0.00032232966544403684,0.0005997467735844866,0.6582278481012658
2754,2754,에다가/Josa,79,29,50,0.0003445592975436257,0.0005775339301183945,0.6329113924050633
2755,2755,라기/Josa,79,30,49,0.00035567411359342004,0.0005664275083853486,0.620253164556962
2756,2756,미도/Noun,79,48,31,0.0005557408024897189,0.00036651191719051963,0.6075949367088608
2757,2757,of/Alpha,79,48,31,0.0005557408024897189,0.00036651191719051963,0.6075949367088608
2758,2758,순/Modifier,79,45,34,0.0005223963543403357,0.00039983118238965764,0.569620253164557
2759,2759,후회되다/Adjective,79,35,44,0.0004112481938423919,0.0005108953997201182,0.5569620253164557
2760,2760,유지/Noun,79,39,40,0.00045570745804156943,0.000466469712787934,0.5063291139240507
2761,2761,순위/Noun,79,39,40,0.00045570745804156943,0.000466469712787934,0.5063291139240507
2762,2762,위트/Noun,78,66,12,0.0007558074913860174,0.00015548990426264466,0.8461538461538461
2763,2763,치유/Noun,78,66,12,0.0007558074913860174,0.00015548990426264466,0.8461538461538461
2764,2764,아치/Noun,78,14,64,0.00017783705679671002,0.0007330238343810393,0.8205128205128205
2765,2765,만도/Josa,78,15,63,0.00018895187284650438,0.0007219174126479931,0.8076923076923077
2766,2766,애절하다/Adjective,78,62,16,0.0007113482271868402,0.00019991559119482882,0.7948717948717948
2767,2767,알려지다/Verb,78,58,20,0.0006668889629876625,0.00024434127812701304,0.7435897435897436
2768,2768,이구만/Josa,78,20,58,0.00024452595309547634,0.0006663853039827628,0.7435897435897436
2769,2769,왜곡/Noun,78,22,56,0.000266755585195065,0.0006441724605166707,0.7179487179487181
2770,2770,상어/Noun,78,25,53,0.00030010003334444816,0.0006108531953175326,0.6794871794871795
2771,2771,절망/Noun,78,53,25,0.0006113148827386907,0.0002998733867922433,0.6794871794871795
2772,2772,서부/Noun,78,50,28,0.0005779704345893076,0.0003331926519913814,0.6410256410256411
2773,2773,허허/Adverb,78,29,49,0.0003445592975436257,0.0005664275083853486,0.6282051282051282
2774,2774,계시다/Adjective,78,49,29,0.0005668556185395131,0.00034429907372442745,0.6282051282051282
2775,2775,칠/Modifier,78,29,49,0.0003445592975436257,0.0005664275083853486,0.6282051282051282
2776,2776,라스트/Noun,78,48,30,0.0005557408024897189,0.0003554054954574735,0.6153846153846154
2777,2777,컷/Noun,78,30,48,0.00035567411359342004,0.0005553210866523023,0.6153846153846154
2778,2778,무리/Noun,78,30,48,0.00035567411359342004,0.0005553210866523023,0.6153846153846154
2779,2779,한순간/Noun,78,48,30,0.0005557408024897189,0.0003554054954574735,0.6153846153846154
2780,2780,서도/Noun,78,47,31,0.0005446259864399244,0.00036651191719051963,0.6025641025641025
2781,2781,최소/Noun,78,47,31,0.0005446259864399244,0.00036651191719051963,0.6025641025641025
2782,2782,절로/Noun,78,45,33,0.0005223963543403357,0.00038872476065661166,0.5769230769230769
2783,2783,랑은/Josa,78,35,43,0.0004112481938423919,0.0004997889779870722,0.5512820512820513
2784,2784,들어주다/Verb,78,36,42,0.00042236300989218633,0.0004886825562540262,0.5384615384615384
2785,2785,뒤죽박죽/Noun,77,9,68,0.00012226297654773814,0.0007774495213132232,0.8831168831168831
2786,2786,절제/Noun,77,64,13,0.0007335778592864287,0.0001665963259956907,0.8311688311688312
2787,2787,소화/Noun,77,62,15,0.0007113482271868402,0.0001888091694617828,0.8051948051948052
2788,2788,떠올리다/Verb,77,62,15,0.0007113482271868402,0.0001888091694617828,0.8051948051948052
2789,2789,찬양/Noun,77,19,58,0.0002334111370456819,0.0006663853039827628,0.7532467532467533
2790,2790,내일/Noun,77,56,21,0.0006446593308880737,0.0002554476998600591,0.7272727272727273
2791,2791,닥/Noun,77,21,56,0.00025564076914527065,0.0006441724605166707,0.7272727272727273
2792,2792,난무/Noun,77,22,55,0.000266755585195065,0.0006330660387836247,0.7142857142857143
2793,2793,낼/Noun,77,53,24,0.0006113148827386907,0.0002887669650591972,0.6883116883116883
2794,2794,동네/Noun,77,29,48,0.0003445592975436257,0.0005553210866523023,0.6233766233766234
2795,2795,향연/Noun,77,32,45,0.00037790374569300877,0.0005220018214531642,0.5844155844155844
2796,2796,2년/Number,77,45,32,0.0005223963543403357,0.0003776183389235656,0.5844155844155844
2797,2797,안해/Noun,77,32,45,0.00037790374569300877,0.0005220018214531642,0.5844155844155844
2798,2798,에가/Josa,77,34,43,0.0004001333777925976,0.0004997889779870722,0.5584415584415584
2799,2799,선생/Noun,77,34,43,0.0004001333777925976,0.0004997889779870722,0.5584415584415584
2800,2800,똑같이/Adverb,77,34,43,0.0004001333777925976,0.0004997889779870722,0.5584415584415584
2801,2801,우선/Noun,77,36,41,0.00042236300989218633,0.00047757613452098,0.5324675324675324
2802,2802,모로/Noun,77,37,40,0.0004334778259419807,0.000466469712787934,0.5194805194805194
2803,2803,켜다/Verb,77,40,37,0.0004668222740913638,0.0004331504475887958,0.5194805194805194
2804,2804,버/Noun,77,37,40,0.0004334778259419807,0.000466469712787934,0.5194805194805194
2805,2805,상대/Noun,77,39,38,0.00045570745804156943,0.0004442568693218419,0.5064935064935064
2806,2806,매미/Noun,76,4,72,6.668889629876625e-05,0.0008218752082454075,0.9473684210526316
2807,2807,뜬금없이/Adverb,76,4,72,6.668889629876625e-05,0.0008218752082454075,0.9473684210526316
2808,2808,미스/Noun,76,13,63,0.00016672224074691566,0.0007219174126479931,0.8289473684210527
2809,2809,욕먹다/Verb,76,13,63,0.00016672224074691566,0.0007219174126479931,0.8289473684210527
2810,2810,보임/Noun,76,16,60,0.0002000666888962988,0.0006885981474488549,0.7894736842105263
2811,2811,버티다/Verb,76,17,59,0.00021118150494609317,0.0006774917257158089,0.7763157894736842
2812,2812,전성기/Noun,76,59,17,0.0006780037790374569,0.0002110220129278749,0.7763157894736842
2813,2813,ㅎㄷㄷ/KoreanParticle,76,55,21,0.0006335445148382794,0.0002554476998600591,0.7236842105263158
2814,2814,범/Noun,76,22,54,0.000266755585195065,0.0006219596170505788,0.7105263157894737
2815,2815,달라지다/Verb,76,53,23,0.0006113148827386907,0.00027766054332615115,0.6973684210526315
2816,2816,리가/Noun,76,24,52,0.0002889852172946538,0.0005997467735844866,0.6842105263157895
2817,2817,년도/Noun,76,25,51,0.00030010003334444816,0.0005886403518514405,0.6710526315789473
2818,2818,각자/Noun,76,50,26,0.0005779704345893076,0.00031097980852528933,0.6578947368421053
2819,2819,그대/Noun,76,50,26,0.0005779704345893076,0.00031097980852528933,0.6578947368421053
2820,2820,하라/Noun,76,28,48,0.0003334444814938313,0.0005553210866523023,0.631578947368421
2821,2821,글자/Noun,76,28,48,0.0003334444814938313,0.0005553210866523023,0.631578947368421
2822,2822,하고는/Josa,76,29,47,0.0003445592975436257,0.0005442146649192564,0.618421052631579
2823,2823,절대로/Noun,76,29,47,0.0003445592975436257,0.0005442146649192564,0.618421052631579
2824,2824,끼치다/Verb,76,46,30,0.00053351117039013,0.0003554054954574735,0.6052631578947368
2825,2825,형식/Noun,76,30,46,0.00035567411359342004,0.0005331082431862101,0.6052631578947368
2826,2826,변신/Noun,76,32,44,0.00037790374569300877,0.0005108953997201182,0.5789473684210527
2827,2827,케이/Noun,76,32,44,0.00037790374569300877,0.0005108953997201182,0.5789473684210527
2828,2828,각/Modifier,76,35,41,0.0004112481938423919,0.00047757613452098,0.5394736842105263
2829,2829,튀다/Verb,76,35,41,0.0004112481938423919,0.00047757613452098,0.5394736842105263
2830,2830,박히다/Verb,76,40,36,0.0004668222740913638,0.0004220440258557498,0.5263157894736842
2831,2831,서울/Noun,76,40,36,0.0004668222740913638,0.0004220440258557498,0.5263157894736842
2832,2832,잉/Noun,76,38,38,0.000444592641991775,0.0004442568693218419,0.5
2833,2833,우연/Noun,76,38,38,0.000444592641991775,0.0004442568693218419,0.5
2834,2834,과대/Noun,75,5,70,7.780371234856063e-05,0.0007996623647793153,0.9333333333333332
2835,2835,도중/Noun,75,7,68,0.0001000333444481494,0.0007774495213132232,0.9066666666666666
2836,2836,따분하다/Adjective,75,8,67,0.00011114816049794375,0.0007663430995801773,0.8933333333333333
2837,2837,여신/Noun,75,61,14,0.0007002334111370457,0.00017770274772873674,0.8133333333333334
2838,2838,낭만/Noun,75,57,18,0.0006557741469378681,0.00022212843466092096,0.76
2839,2839,선사/Noun,75,54,21,0.0006224296987884852,0.0002554476998600591,0.72
2840,2840,꺼지다/Verb,75,24,51,0.0002889852172946538,0.0005886403518514405,0.68
2841,2841,폭풍/Noun,75,51,24,0.000589085250639102,0.0002887669650591972,0.68
2842,2842,공룡/Noun,75,26,49,0.00031121484939424253,0.0005664275083853486,0.6533333333333333
2843,2843,급하다/Adjective,75,26,49,0.00031121484939424253,0.0005664275083853486,0.6533333333333333
2844,2844,잔혹하다/Adjective,75,48,27,0.0005557408024897189,0.00032208623025833537,0.64
2845,2845,빠/Noun,75,27,48,0.00032232966544403684,0.0005553210866523023,0.64
2846,2846,소통/Noun,75,47,28,0.0005446259864399244,0.0003331926519913814,0.6266666666666667
2847,2847,추가/Noun,75,28,47,0.0003334444814938313,0.0005442146649192564,0.6266666666666667
2848,2848,년전/Noun,75,45,30,0.0005223963543403357,0.0003554054954574735,0.6
2849,2849,식이/Noun,75,30,45,0.00035567411359342004,0.0005220018214531642,0.6
2850,2850,1년/Number,75,45,30,0.0005223963543403357,0.0003554054954574735,0.6
2851,2851,축구/Noun,75,30,45,0.00035567411359342004,0.0005220018214531642,0.6
2852,2852,아만다/Noun,75,44,31,0.0005112815382905413,0.00036651191719051963,0.5866666666666667
2853,2853,부활/Noun,75,44,31,0.0005112815382905413,0.00036651191719051963,0.5866666666666667
2854,2854,모이다/Verb,75,32,43,0.00037790374569300877,0.0004997889779870722,0.5733333333333334
2855,2855,용다/Verb,75,43,32,0.0005001667222407468,0.0003776183389235656,0.5733333333333334
2856,2856,직업/Noun,75,34,41,0.0004001333777925976,0.00047757613452098,0.5466666666666666
2857,2857,예측/Noun,75,36,39,0.00042236300989218633,0.000455363291054888,0.52
2858,2858,바닥/Noun,74,9,65,0.00012226297654773814,0.0007441302561140852,0.8783783783783784
2859,2859,졸업/Noun,74,14,60,0.00017783705679671002,0.0006885981474488549,0.8108108108108109
2860,2860,어지럽다/Adjective,74,16,58,0.0002000666888962988,0.0006663853039827628,0.7837837837837838
2861,2861,EBS/Alpha,74,57,17,0.0006557741469378681,0.0002110220129278749,0.7702702702702703
2862,2862,끊기다/Verb,74,17,57,0.00021118150494609317,0.0006552788822497168,0.7702702702702703
2863,2863,웬/Noun,74,19,55,0.0002334111370456819,0.0006330660387836247,0.7432432432432432
2864,2864,지나/Noun,74,53,21,0.0006113148827386907,0.0002554476998600591,0.7162162162162162
2865,2865,딸리다/Verb,74,22,52,0.000266755585195065,0.0005997467735844866,0.7027027027027027
2866,2866,드니/Noun,74,51,23,0.000589085250639102,0.00027766054332615115,0.6891891891891891
2867,2867,한가지/Noun,74,23,51,0.00027787040124485944,0.0005886403518514405,0.6891891891891891
2868,2868,거짓/Noun,74,24,50,0.0002889852172946538,0.0005775339301183945,0.6756756756756757
2869,2869,송강호/Noun,74,50,24,0.0005779704345893076,0.0002887669650591972,0.6756756756756757
2870,2870,재난/Noun,74,25,49,0.00030010003334444816,0.0005664275083853486,0.6621621621621622
2871,2871,워낙/Noun,74,49,25,0.0005668556185395131,0.0002998733867922433,0.6621621621621622
2872,2872,a/Alpha,74,48,26,0.0005557408024897189,0.00031097980852528933,0.6486486486486487
2873,2873,가나/Noun,74,27,47,0.00032232966544403684,0.0005442146649192564,0.6351351351351351
2874,2874,일주일/Noun,74,47,27,0.0005446259864399244,0.00032208623025833537,0.6351351351351351
2875,2875,범죄자/Noun,74,28,46,0.0003334444814938313,0.0005331082431862101,0.6216216216216216
2876,2876,부탁/Noun,74,29,45,0.0003445592975436257,0.0005220018214531642,0.6081081081081081
2877,2877,이안/Noun,74,29,45,0.0003445592975436257,0.0005220018214531642,0.6081081081081081
2878,2878,캐릭/Noun,74,29,45,0.0003445592975436257,0.0005220018214531642,0.6081081081081081
2879,2879,생명/Noun,74,45,29,0.0005223963543403357,0.00034429907372442745,0.6081081081081081
2880,2880,나타내다/Verb,74,44,30,0.0005112815382905413,0.0003554054954574735,0.5945945945945946
2881,2881,트리/Noun,74,31,43,0.00036678892964321435,0.0004997889779870722,0.581081081081081
2882,2882,류승범/Noun,74,42,32,0.0004890519061909527,0.0003776183389235656,0.5675675675675675
2883,2883,높이다/Verb,74,42,32,0.0004890519061909527,0.0003776183389235656,0.5675675675675675
2884,2884,극적/Noun,74,39,35,0.00045570745804156943,0.0004109376041227037,0.527027027027027
2885,2885,이구나/Josa,74,39,35,0.00045570745804156943,0.0004109376041227037,0.527027027027027
2886,2886,흔/Modifier,74,35,39,0.0004112481938423919,0.000455363291054888,0.527027027027027
2887,2887,존스/Noun,74,37,37,0.0004334778259419807,0.0004331504475887958,0.5
2888,2888,최후/Noun,74,37,37,0.0004334778259419807,0.0004331504475887958,0.5
2889,2889,애잔하다/Adjective,73,69,4,0.0007891519395354007,6.663853039827628e-05,0.9452054794520548
2890,2890,애매하다/Adjective,73,12,61,0.00015560742469712126,0.0006997045691819009,0.8356164383561644
2891,2891,이별/Noun,73,57,16,0.0006557741469378681,0.00019991559119482882,0.7808219178082192
2892,2892,쟁이/Suffix,73,19,54,0.0002334111370456819,0.0006219596170505788,0.7397260273972602
2893,2893,쌍/Noun,73,21,52,0.00025564076914527065,0.0005997467735844866,0.7123287671232876
2894,2894,부인/Noun,73,21,52,0.00025564076914527065,0.0005997467735844866,0.7123287671232876
2895,2895,원숭이/Noun,73,22,51,0.000266755585195065,0.0005886403518514405,0.6986301369863014
2896,2896,단편/Noun,73,22,51,0.000266755585195065,0.0005886403518514405,0.6986301369863014
2897,2897,시종일관/Noun,73,22,51,0.000266755585195065,0.0005886403518514405,0.6986301369863014
2898,2898,깡패/Noun,73,23,50,0.00027787040124485944,0.0005775339301183945,0.6849315068493149
2899,2899,신하균/Noun,73,50,23,0.0005779704345893076,0.00027766054332615115,0.6849315068493149
2900,2900,본격/Noun,73,23,50,0.00027787040124485944,0.0005775339301183945,0.6849315068493149
2901,2901,에서나/Josa,73,24,49,0.0002889852172946538,0.0005664275083853486,0.6712328767123288
2902,2902,광기/Noun,73,49,24,0.0005668556185395131,0.0002887669650591972,0.6712328767123288
2903,2903,처리/Noun,73,25,48,0.00030010003334444816,0.0005553210866523023,0.6575342465753424
2904,2904,만세/Noun,73,48,25,0.0005557408024897189,0.0002998733867922433,0.6575342465753424
2905,2905,낮/Noun,73,47,26,0.0005446259864399244,0.00031097980852528933,0.6438356164383562
2906,2906,블랙코미디/Noun,73,46,27,0.00053351117039013,0.00032208623025833537,0.6301369863013698
2907,2907,솔/Noun,73,27,46,0.00032232966544403684,0.0005331082431862101,0.6301369863013698
2908,2908,로움/Noun,73,44,29,0.0005112815382905413,0.00034429907372442745,0.6027397260273972
2909,2909,바치다/Verb,73,43,30,0.0005001667222407468,0.0003554054954574735,0.589041095890411
2910,2910,스타워즈/Noun,73,43,30,0.0005001667222407468,0.0003554054954574735,0.589041095890411
2911,2911,중학생/Noun,73,42,31,0.0004890519061909527,0.00036651191719051963,0.5753424657534246
2912,2912,50/Number,73,41,32,0.0004779370901411582,0.0003776183389235656,0.5616438356164384
2913,2913,매번/Noun,73,41,32,0.0004779370901411582,0.0003776183389235656,0.5616438356164384
2914,2914,녀석/Noun,73,33,40,0.00038901856174280313,0.000466469712787934,0.547945205479452
2915,2915,흔들다/Verb,73,39,34,0.00045570745804156943,0.00039983118238965764,0.5342465753424658
2916,2916,풀리다/Verb,73,39,34,0.00045570745804156943,0.00039983118238965764,0.5342465753424658
2917,2917,갈리다/Verb,73,38,35,0.000444592641991775,0.0004109376041227037,0.5205479452054794
2918,2918,맛있다/Adjective,73,37,36,0.0004334778259419807,0.0004220440258557498,0.5068493150684932
2919,2919,지옥/Noun,73,36,37,0.00042236300989218633,0.0004331504475887958,0.5068493150684932
2920,2920,익숙하다/Adjective,73,37,36,0.0004334778259419807,0.0004220440258557498,0.5068493150684932
2921,2921,답답/Noun,72,2,70,4.445926419917751e-05,0.0007996623647793153,0.9722222222222222
2922,2922,Good/Alpha,72,69,3,0.0007891519395354007,5.553210866523024e-05,0.9583333333333334
2923,2923,어색/Noun,72,3,69,5.5574080248971876e-05,0.0007885559430462694,0.9583333333333334
2924,2924,명불허전/Noun,72,64,8,0.0007335778592864287,0.00011106421733046048,0.8888888888888888
2925,2925,비록/Noun,72,64,8,0.0007335778592864287,0.00011106421733046048,0.8888888888888888
2926,2926,애틋하다/Adjective,72,61,11,0.0007002334111370457,0.0001443834825295986,0.8472222222222222
2927,2927,광구/Noun,72,12,60,0.00015560742469712126,0.0006885981474488549,0.8333333333333334
2928,2928,쓴다/Verb,72,12,60,0.00015560742469712126,0.0006885981474488549,0.8333333333333334
2929,2929,짜릿하다/Adjective,72,59,13,0.0006780037790374569,0.0001665963259956907,0.8194444444444444
2930,2930,땀/Noun,72,58,14,0.0006668889629876625,0.00017770274772873674,0.8055555555555556
2931,2931,배꼽/Noun,72,58,14,0.0006668889629876625,0.00017770274772873674,0.8055555555555556
2932,2932,뎅/Noun,72,57,15,0.0006557741469378681,0.0001888091694617828,0.7916666666666666
2933,2933,누나/Suffix,72,56,16,0.0006446593308880737,0.00019991559119482882,0.7777777777777778
2934,2934,아무나/Noun,72,17,55,0.00021118150494609317,0.0006330660387836247,0.7638888888888888
2935,2935,기획/Noun,72,22,50,0.000266755585195065,0.0005775339301183945,0.6944444444444444
2936,2936,호흡/Noun,72,49,23,0.0005668556185395131,0.00027766054332615115,0.6805555555555556
2937,2937,고전/Modifier,72,49,23,0.0005668556185395131,0.00027766054332615115,0.6805555555555556
2938,2938,대부/Noun,72,46,26,0.00053351117039013,0.00031097980852528933,0.6388888888888888
2939,2939,일지/Noun,72,46,26,0.00053351117039013,0.00031097980852528933,0.6388888888888888
2940,2940,못자다/Verb,72,26,46,0.00031121484939424253,0.0005331082431862101,0.6388888888888888
2941,2941,구분/Noun,72,27,45,0.00032232966544403684,0.0005220018214531642,0.625
2942,2942,이지/Noun,72,27,45,0.00032232966544403684,0.0005220018214531642,0.625
2943,2943,수록/Noun,72,44,28,0.0005112815382905413,0.0003331926519913814,0.6111111111111112
2944,2944,풀/Noun,72,28,44,0.0003334444814938313,0.0005108953997201182,0.6111111111111112
2945,2945,본질/Noun,72,44,28,0.0005112815382905413,0.0003331926519913814,0.6111111111111112
2946,2946,찾아가다/Verb,72,42,30,0.0004890519061909527,0.0003554054954574735,0.5833333333333334
2947,2947,객관/Noun,72,30,42,0.00035567411359342004,0.0004886825562540262,0.5833333333333334
2948,2948,혼란/Noun,72,33,39,0.00038901856174280313,0.000455363291054888,0.5416666666666666
2949,2949,말씀/Noun,72,38,34,0.000444592641991775,0.00039983118238965764,0.5277777777777778
2950,2950,하얗다/Adjective,72,38,34,0.000444592641991775,0.00039983118238965764,0.5277777777777778
2951,2951,비행기/Noun,72,37,35,0.0004334778259419807,0.0004109376041227037,0.5138888888888888
2952,2952,부로/Noun,72,37,35,0.0004334778259419807,0.0004109376041227037,0.5138888888888888
2953,2953,아마추어/Noun,71,5,66,7.780371234856063e-05,0.0007552366778471312,0.9295774647887324
2954,2954,케미/Noun,71,66,5,0.0007558074913860174,7.774495213132233e-05,0.9295774647887324
2955,2955,오글오글/Adverb,71,6,65,8.891852839835501e-05,0.0007441302561140852,0.9154929577464788
2956,2956,...^^/Punctuation,71,65,6,0.0007446926753362233,8.885137386436837e-05,0.9154929577464788
2957,2957,쓸쓸하다/Adjective,71,63,8,0.0007224630432366343,0.00011106421733046048,0.8873239436619719
2958,2958,15년/Number,71,60,11,0.0006891185950872514,0.0001443834825295986,0.8450704225352113
2959,2959,고인/Noun,71,60,11,0.0006891185950872514,0.0001443834825295986,0.8450704225352113
2960,2960,데리다/Verb,71,12,59,0.00015560742469712126,0.0006774917257158089,0.8309859154929577
2961,2961,제작자/Noun,71,12,59,0.00015560742469712126,0.0006774917257158089,0.8309859154929577
2962,2962,정점/Noun,71,55,16,0.0006335445148382794,0.00019991559119482882,0.7746478873239436
2963,2963,상식/Noun,71,16,55,0.0002000666888962988,0.0006330660387836247,0.7746478873239436
2964,2964,명장/Noun,71,52,19,0.0006002000666888963,0.000233234856393967,0.7323943661971831
2965,2965,ㅜㅠ/KoreanParticle,71,50,21,0.0005779704345893076,0.0002554476998600591,0.7042253521126759
2966,2966,고증/Noun,71,21,50,0.00025564076914527065,0.0005775339301183945,0.7042253521126759
2967,2967,괴롭다/Adjective,71,22,49,0.000266755585195065,0.0005664275083853486,0.6901408450704225
2968,2968,살이/Noun,71,45,26,0.0005223963543403357,0.00031097980852528933,0.6338028169014085
2969,2969,회사/Noun,71,26,45,0.00031121484939424253,0.0005220018214531642,0.6338028169014085
2970,2970,커버/Noun,71,44,27,0.0005112815382905413,0.00032208623025833537,0.6197183098591549
2971,2971,별거/Noun,71,28,43,0.0003334444814938313,0.0004997889779870722,0.6056338028169014
2972,2972,합/Noun,71,28,43,0.0003334444814938313,0.0004997889779870722,0.6056338028169014
2973,2973,돌/Noun,71,29,42,0.0003445592975436257,0.0004886825562540262,0.5915492957746479
2974,2974,안기다/Verb,71,42,29,0.0004890519061909527,0.00034429907372442745,0.5915492957746479
2975,2975,공유/Noun,71,42,29,0.0004890519061909527,0.00034429907372442745,0.5915492957746479
2976,2976,두운/Noun,71,42,29,0.0004890519061909527,0.00034429907372442745,0.5915492957746479
2977,2977,님/Noun,71,40,31,0.0004668222740913638,0.00036651191719051963,0.5633802816901409
2978,2978,기괴하다/Adjective,71,40,31,0.0004668222740913638,0.00036651191719051963,0.5633802816901409
2979,2979,노인/Noun,71,31,40,0.00036678892964321435,0.000466469712787934,0.5633802816901409
2980,2980,받아들이다/Verb,71,38,33,0.000444592641991775,0.00038872476065661166,0.5352112676056338
2981,2981,스릴러물/Noun,71,38,33,0.000444592641991775,0.00038872476065661166,0.5352112676056338
2982,2982,잔인함/Noun,71,37,34,0.0004334778259419807,0.00039983118238965764,0.5211267605633803
2983,2983,아오이/Noun,71,36,35,0.00042236300989218633,0.0004109376041227037,0.5070422535211268
2984,2984,진창/Noun,70,4,66,6.668889629876625e-05,0.0007552366778471312,0.9428571428571428
2985,2985,돌려주다/Verb,70,6,64,8.891852839835501e-05,0.0007330238343810393,0.9142857142857144
2986,2986,찬사/Noun,70,61,9,0.0007002334111370457,0.00012217063906350652,0.8714285714285714
2987,2987,you/Alpha,70,59,11,0.0006780037790374569,0.0001443834825295986,0.8428571428571429
2988,2988,일반인/Noun,70,11,59,0.0001444926086473269,0.0006774917257158089,0.8428571428571429
2989,2989,의심스럽다/Adjective,70,11,59,0.0001444926086473269,0.0006774917257158089,0.8428571428571429
2990,2990,티나/Noun,70,14,56,0.00017783705679671002,0.0006441724605166707,0.8
2991,2991,피아노/Noun,70,56,14,0.0006446593308880737,0.00017770274772873674,0.8
2992,2992,이기도/Josa,70,55,15,0.0006335445148382794,0.0001888091694617828,0.7857142857142857
2993,2993,90분/Number,70,15,55,0.00018895187284650438,0.0006330660387836247,0.7857142857142857
2994,2994,미스터리/Noun,70,17,53,0.00021118150494609317,0.0006108531953175326,0.7571428571428571
2995,2995,믿음/Noun,70,52,18,0.0006002000666888963,0.00022212843466092096,0.7428571428571429
2996,2996,디테일/Noun,70,50,20,0.0005779704345893076,0.00024434127812701304,0.7142857142857143
2997,2997,닥치고/Noun,70,49,21,0.0005668556185395131,0.0002554476998600591,0.7
2998,2998,위험하다/Adjective,70,22,48,0.000266755585195065,0.0005553210866523023,0.6857142857142857
2999,2999,멜로영화/Noun,70,46,24,0.00053351117039013,0.0002887669650591972,0.6571428571428571
3000,3000,오로지/Adverb,70,24,46,0.0002889852172946538,0.0005331082431862101,0.6571428571428571
3001,3001,스필버그/Noun,70,46,24,0.00053351117039013,0.0002887669650591972,0.6571428571428571
3002,3002,놀란/Noun,70,46,24,0.00053351117039013,0.0002887669650591972,0.6571428571428571
3003,3003,업/Noun,70,26,44,0.00031121484939424253,0.0005108953997201182,0.6285714285714286
3004,3004,남자배우/Noun,70,28,42,0.0003334444814938313,0.0004886825562540262,0.6
3005,3005,본능/Noun,70,41,29,0.0004779370901411582,0.00034429907372442745,0.5857142857142857
3006,3006,고등학생/Noun,70,40,30,0.0004668222740913638,0.0003554054954574735,0.5714285714285714
3007,3007,가르치다/Verb,70,39,31,0.00045570745804156943,0.00036651191719051963,0.5571428571428572
3008,3008,만큼이나/Josa,70,39,31,0.00045570745804156943,0.00036651191719051963,0.5571428571428572
3009,3009,아누/Noun,70,38,32,0.000444592641991775,0.0003776183389235656,0.5428571428571428
3010,3010,다해/Noun,70,32,38,0.00037790374569300877,0.0004442568693218419,0.5428571428571428
3011,3011,권상우/Noun,70,38,32,0.000444592641991775,0.0003776183389235656,0.5428571428571428
3012,3012,그치다/Verb,70,37,33,0.0004334778259419807,0.00038872476065661166,0.5285714285714286
3013,3013,가야/Noun,70,33,37,0.00038901856174280313,0.0004331504475887958,0.5285714285714286
3014,3014,실/Noun,70,37,33,0.0004334778259419807,0.00038872476065661166,0.5285714285714286
3015,3015,1등/Number,70,33,37,0.00038901856174280313,0.0004331504475887958,0.5285714285714286
3016,3016,국산/Noun,70,34,36,0.0004001333777925976,0.0004220440258557498,0.5142857142857142
3017,3017,정부/Noun,70,36,34,0.00042236300989218633,0.00039983118238965764,0.5142857142857142
3018,3018,수면제/Noun,69,3,66,5.5574080248971876e-05,0.0007552366778471312,0.9565217391304348
3019,3019,짬뽕/Noun,69,4,65,6.668889629876625e-05,0.0007441302561140852,0.9420289855072465
3020,3020,비호감/Noun,69,7,62,0.0001000333444481494,0.000710810990914947,0.8985507246376812
3021,3021,명연기/Noun,69,61,8,0.0007002334111370457,0.00011106421733046048,0.8840579710144928
3022,3022,꿀/Noun,69,61,8,0.0007002334111370457,0.00011106421733046048,0.8840579710144928
3023,3023,국어/Noun,69,9,60,0.00012226297654773814,0.0006885981474488549,0.8695652173913043
3024,3024,전문/Noun,69,13,56,0.00016672224074691566,0.0006441724605166707,0.8115942028985508
3025,3025,많아지다/Verb,69,55,14,0.0006335445148382794,0.00017770274772873674,0.7971014492753623
3026,3026,순수/Noun,69,54,15,0.0006224296987884852,0.0001888091694617828,0.7826086956521741
3027,3027,초월/Noun,69,53,16,0.0006113148827386907,0.00019991559119482882,0.7681159420289855
3028,3028,연관/Noun,69,16,53,0.0002000666888962988,0.0006108531953175326,0.7681159420289855
3029,3029,출연자/Noun,69,17,52,0.00021118150494609317,0.0005997467735844866,0.7536231884057971
3030,3030,저지르다/Verb,69,18,51,0.0002222963209958875,0.0005886403518514405,0.7391304347826086
3031,3031,혁명/Noun,69,50,19,0.0005779704345893076,0.000233234856393967,0.7246376811594203
3032,3032,하나님/Noun,69,48,21,0.0005557408024897189,0.0002554476998600591,0.6956521739130435
3033,3033,마찬가지/Noun,69,21,48,0.00025564076914527065,0.0005553210866523023,0.6956521739130435
3034,3034,스포츠/Noun,69,47,22,0.0005446259864399244,0.00026655412159310506,0.6811594202898551
3035,3035,가까이/Noun,69,47,22,0.0005446259864399244,0.00026655412159310506,0.6811594202898551
3036,3036,빌다/Verb,69,46,23,0.00053351117039013,0.00027766054332615115,0.6666666666666666
3037,3037,엽기/Noun,69,26,43,0.00031121484939424253,0.0004997889779870722,0.6231884057971014
3038,3038,계/Noun,69,26,43,0.00031121484939424253,0.0004997889779870722,0.6231884057971014
3039,3039,선수/Noun,69,42,27,0.0004890519061909527,0.00032208623025833537,0.6086956521739131
3040,3040,홀로/Noun,69,42,27,0.0004890519061909527,0.00032208623025833537,0.6086956521739131
3041,3041,애정/Noun,69,41,28,0.0004779370901411582,0.0003331926519913814,0.5942028985507246
3042,3042,정리/Noun,69,28,41,0.0003334444814938313,0.00047757613452098,0.5942028985507246
3043,3043,민족/Noun,69,40,29,0.0004668222740913638,0.00034429907372442745,0.5797101449275363
3044,3044,2000년/Number,69,29,40,0.0003445592975436257,0.000466469712787934,0.5797101449275363
3045,3045,뎀/Noun,69,38,31,0.000444592641991775,0.00036651191719051963,0.5507246376811594
3046,3046,부터는/Josa,69,32,37,0.00037790374569300877,0.0004331504475887958,0.5362318840579711
3047,3047,무어/Noun,69,32,37,0.00037790374569300877,0.0004331504475887958,0.5362318840579711
3048,3048,밀/Noun,69,37,32,0.0004334778259419807,0.0003776183389235656,0.5362318840579711
3049,3049,잃어버리다/Verb,69,32,37,0.00037790374569300877,0.0004331504475887958,0.5362318840579711
3050,3050,교회/Noun,69,36,33,0.00042236300989218633,0.00038872476065661166,0.5217391304347826
3051,3051,가능성/Noun,69,36,33,0.00042236300989218633,0.00038872476065661166,0.5217391304347826
3052,3052,~~^^/Punctuation,68,65,3,0.0007446926753362233,5.553210866523024e-05,0.9558823529411764
3053,3053,유아/Noun,68,8,60,0.00011114816049794375,0.0006885981474488549,0.8823529411764706
3054,3054,게스트/Noun,68,10,58,0.0001333777925975325,0.0006663853039827628,0.8529411764705882
3055,3055,대박나다/Verb,68,58,10,0.0006668889629876625,0.00013327706079655256,0.8529411764705882
3056,3056,알파/Noun,68,56,12,0.0006446593308880737,0.00015548990426264466,0.8235294117647058
3057,3057,세대/Noun,68,54,14,0.0006224296987884852,0.00017770274772873674,0.7941176470588235
3058,3058,즐거움/Noun,68,53,15,0.0006113148827386907,0.0001888091694617828,0.7794117647058824
3059,3059,고문/Noun,68,15,53,0.00018895187284650438,0.0006108531953175326,0.7794117647058824
3060,3060,연습/Noun,68,16,52,0.0002000666888962988,0.0005997467735844866,0.7647058823529411
3061,3061,40분/Number,68,16,52,0.0002000666888962988,0.0005997467735844866,0.7647058823529411
3062,3062,숨막히다/Adjective,68,52,16,0.0006002000666888963,0.00019991559119482882,0.7647058823529411
3063,3063,무식하다/Adjective,68,17,51,0.00021118150494609317,0.0005886403518514405,0.75
3064,3064,떡/Noun,68,19,49,0.0002334111370456819,0.0005664275083853486,0.7205882352941176
3065,3065,농담/Noun,68,19,49,0.0002334111370456819,0.0005664275083853486,0.7205882352941176
3066,3066,미스테리/Noun,68,19,49,0.0002334111370456819,0.0005664275083853486,0.7205882352941176
3067,3067,로빈/Noun,68,48,20,0.0005557408024897189,0.00024434127812701304,0.7058823529411765
3068,3068,미학/Noun,68,48,20,0.0005557408024897189,0.00024434127812701304,0.7058823529411765
3069,3069,뺏다/Verb,68,20,48,0.00024452595309547634,0.0005553210866523023,0.7058823529411765
3070,3070,쏟다/Verb,68,46,22,0.00053351117039013,0.00026655412159310506,0.6764705882352942
3071,3071,타란티노/Noun,68,45,23,0.0005223963543403357,0.00027766054332615115,0.6617647058823529
3072,3072,반영/Noun,68,44,24,0.0005112815382905413,0.0002887669650591972,0.6470588235294118
3073,3073,자세하다/Adjective,68,44,24,0.0005112815382905413,0.0002887669650591972,0.6470588235294118
3074,3074,세트/Noun,68,25,43,0.00030010003334444816,0.0004997889779870722,0.6323529411764706
3075,3075,위주/Noun,68,25,43,0.00030010003334444816,0.0004997889779870722,0.6323529411764706
3076,3076,다른사람/Noun,68,25,43,0.00030010003334444816,0.0004997889779870722,0.6323529411764706
3077,3077,쭉/Noun,68,43,25,0.0005001667222407468,0.0002998733867922433,0.6323529411764706
3078,3078,스텝/Noun,68,28,40,0.0003334444814938313,0.000466469712787934,0.5882352941176471
3079,3079,상이/Noun,68,40,28,0.0004668222740913638,0.0003331926519913814,0.5882352941176471
3080,3080,소개/Noun,68,30,38,0.00035567411359342004,0.0004442568693218419,0.5588235294117647
3081,3081,?../Punctuation,68,30,38,0.00035567411359342004,0.0004442568693218419,0.5588235294117647
3082,3082,춤추다/Verb,68,36,32,0.00042236300989218633,0.0003776183389235656,0.5294117647058824
3083,3083,기전/Noun,68,33,35,0.00038901856174280313,0.0004109376041227037,0.5147058823529411
3084,3084,암울하다/Adjective,68,35,33,0.0004112481938423919,0.00038872476065661166,0.5147058823529411
3085,3085,나무/Noun,68,34,34,0.0004001333777925976,0.00039983118238965764,0.5
3086,3086,국/Noun,68,34,34,0.0004001333777925976,0.00039983118238965764,0.5
3087,3087,굿굿굿/Noun,67,67,0,0.0007669223074358119,2.2212843466092093e-05,1.0
3088,3088,부자연스럽다/Adjective,67,8,59,0.00011114816049794375,0.0006774917257158089,0.8805970149253731
3089,3089,~~!!/Punctuation,67,55,12,0.0006335445148382794,0.00015548990426264466,0.8208955223880597
3090,3090,강간/Noun,67,12,55,0.00015560742469712126,0.0006330660387836247,0.8208955223880597
3091,3091,뭣/Noun,67,15,52,0.00018895187284650438,0.0005997467735844866,0.7761194029850746
3092,3092,한동안/Adverb,67,51,16,0.000589085250639102,0.00019991559119482882,0.7611940298507462
3093,3093,까지만/Josa,67,16,51,0.0002000666888962988,0.0005886403518514405,0.7611940298507462
3094,3094,간지/Noun,67,50,17,0.0005779704345893076,0.0002110220129278749,0.746268656716418
3095,3095,외국인/Noun,67,18,49,0.0002222963209958875,0.0005664275083853486,0.7313432835820896
3096,3096,ㅈㄴ/KoreanParticle,67,18,49,0.0002222963209958875,0.0005664275083853486,0.7313432835820896
3097,3097,s/Alpha,67,47,20,0.0005446259864399244,0.00024434127812701304,0.7014925373134329
3098,3098,마저도/Josa,67,21,46,0.00025564076914527065,0.0005331082431862101,0.6865671641791045
3099,3099,칭찬/Noun,67,22,45,0.000266755585195065,0.0005220018214531642,0.6716417910447762
3100,3100,리도/Noun,67,22,45,0.000266755585195065,0.0005220018214531642,0.6716417910447762
3101,3101,유치원/Noun,67,22,45,0.000266755585195065,0.0005220018214531642,0.6716417910447762
3102,3102,권력/Noun,67,44,23,0.0005112815382905413,0.00027766054332615115,0.6567164179104478
3103,3103,데이빗/Noun,67,43,24,0.0005001667222407468,0.0002887669650591972,0.6417910447761194
3104,3104,원/Suffix,67,25,42,0.00030010003334444816,0.0004886825562540262,0.6268656716417911
3105,3105,능가/Noun,67,42,25,0.0004890519061909527,0.0002998733867922433,0.6268656716417911
3106,3106,우린/Noun,67,42,25,0.0004890519061909527,0.0002998733867922433,0.6268656716417911
3107,3107,데이/Noun,67,42,25,0.0004890519061909527,0.0002998733867922433,0.6268656716417911
3108,3108,문/Noun,67,26,41,0.00031121484939424253,0.00047757613452098,0.6119402985074627
3109,3109,나로/Noun,67,26,41,0.00031121484939424253,0.00047757613452098,0.6119402985074627
3110,3110,지식/Noun,67,40,27,0.0004668222740913638,0.00032208623025833537,0.5970149253731343
3111,3111,베일/Noun,67,38,29,0.000444592641991775,0.00034429907372442745,0.5671641791044776
3112,3112,박보영/Noun,67,36,31,0.00042236300989218633,0.00036651191719051963,0.5373134328358209
3113,3113,쯤/Noun,67,35,32,0.0004112481938423919,0.0003776183389235656,0.5223880597014925
3114,3114,성과/Noun,67,35,32,0.0004112481938423919,0.0003776183389235656,0.5223880597014925
3115,3115,떨어뜨리다/Verb,66,4,62,6.668889629876625e-05,0.000710810990914947,0.9393939393939394
3116,3116,칠하다/Adjective,66,8,58,0.00011114816049794375,0.0006663853039827628,0.8787878787878788
3117,3117,영구/Noun,66,10,56,0.0001333777925975325,0.0006441724605166707,0.8484848484848485
3118,3118,디카프리오/Noun,66,56,10,0.0006446593308880737,0.00013327706079655256,0.8484848484848485
3119,3119,콩/Noun,66,10,56,0.0001333777925975325,0.0006441724605166707,0.8484848484848485
3120,3120,화중/Noun,66,54,12,0.0006224296987884852,0.00015548990426264466,0.8181818181818182
3121,3121,한석규/Noun,66,54,12,0.0006224296987884852,0.00015548990426264466,0.8181818181818182
3122,3122,외롭다/Adjective,66,49,17,0.0005668556185395131,0.0002110220129278749,0.7424242424242424
3123,3123,머릿속/Noun,66,47,19,0.0005446259864399244,0.000233234856393967,0.7121212121212122
3124,3124,상징/Noun,66,45,21,0.0005223963543403357,0.0002554476998600591,0.6818181818181818
3125,3125,커서/Noun,66,44,22,0.0005112815382905413,0.00026655412159310506,0.6666666666666666
3126,3126,이따/Noun,66,23,43,0.00027787040124485944,0.0004997889779870722,0.6515151515151515
3127,3127,억울하다/Adjective,66,23,43,0.00027787040124485944,0.0004997889779870722,0.6515151515151515
3128,3128,견디다/Verb,66,24,42,0.0002889852172946538,0.0004886825562540262,0.6363636363636364
3129,3129,포함/Noun,66,24,42,0.0002889852172946538,0.0004886825562540262,0.6363636363636364
3130,3130,강아지/Noun,66,41,25,0.0004779370901411582,0.0002998733867922433,0.6212121212121212
3131,3131,호불호/Noun,66,41,25,0.0004779370901411582,0.0002998733867922433,0.6212121212121212
3132,3132,드네/Noun,66,39,27,0.00045570745804156943,0.00032208623025833537,0.5909090909090909
3133,3133,장애인/Noun,66,38,28,0.000444592641991775,0.0003331926519913814,0.5757575757575758
3134,3134,반응/Noun,66,28,38,0.0003334444814938313,0.0004442568693218419,0.5757575757575758
3135,3135,부산/Noun,66,38,28,0.000444592641991775,0.0003331926519913814,0.5757575757575758
3136,3136,너희/Noun,66,29,37,0.0003445592975436257,0.0004331504475887958,0.5606060606060606
3137,3137,당장/Noun,66,36,30,0.00042236300989218633,0.0003554054954574735,0.5454545454545454
3138,3138,옳다/Adjective,66,30,36,0.00035567411359342004,0.0004220440258557498,0.5454545454545454
3139,3139,해봤다/Verb,66,35,31,0.0004112481938423919,0.00036651191719051963,0.5303030303030303
3140,3140,니콜라스/Noun,66,31,35,0.00036678892964321435,0.0004109376041227037,0.5303030303030303
3141,3141,주인/Noun,66,33,33,0.00038901856174280313,0.00038872476065661166,0.5
3142,3142,빠순이/Noun,65,5,60,7.780371234856063e-05,0.0006885981474488549,0.9230769230769232
3143,3143,적당/Noun,65,9,56,0.00012226297654773814,0.0006441724605166707,0.8615384615384616
3144,3144,아우/Noun,65,10,55,0.0001333777925975325,0.0006330660387836247,0.8461538461538461
3145,3145,다시금/Noun,65,54,11,0.0006224296987884852,0.0001443834825295986,0.8307692307692308
3146,3146,마누라/Noun,65,12,53,0.00015560742469712126,0.0006108531953175326,0.8153846153846154
3147,3147,미스캐스팅/Noun,65,12,53,0.00015560742469712126,0.0006108531953175326,0.8153846153846154
3148,3148,올려주다/Verb,65,51,14,0.000589085250639102,0.00017770274772873674,0.7846153846153846
3149,3149,시체/Noun,65,16,49,0.0002000666888962988,0.0005664275083853486,0.7538461538461538
3150,3150,죄송하다/Adjective,65,17,48,0.00021118150494609317,0.0005553210866523023,0.7384615384615385
3151,3151,거임/Noun,65,18,47,0.0002222963209958875,0.0005442146649192564,0.7230769230769231
3152,3152,마다/Noun,65,45,20,0.0005223963543403357,0.00024434127812701304,0.6923076923076923
3153,3153,안쓰럽다/Adjective,65,22,43,0.000266755585195065,0.0004997889779870722,0.6615384615384615
3154,3154,차승원/Noun,65,43,22,0.0005001667222407468,0.00026655412159310506,0.6615384615384615
3155,3155,백인/Noun,65,22,43,0.000266755585195065,0.0004997889779870722,0.6615384615384615
3156,3156,도와주다/Verb,65,23,42,0.00027787040124485944,0.0004886825562540262,0.6461538461538462
3157,3157,구만/Noun,65,23,42,0.00027787040124485944,0.0004886825562540262,0.6461538461538462
3158,3158,.........../Punctuation,65,24,41,0.0002889852172946538,0.00047757613452098,0.6307692307692307
3159,3159,인식/Noun,65,26,39,0.00031121484939424253,0.000455363291054888,0.6
3160,3160,어쨌든/Noun,65,38,27,0.000444592641991775,0.00032208623025833537,0.5846153846153846
3161,3161,동감/Noun,65,27,38,0.00032232966544403684,0.0004442568693218419,0.5846153846153846
3162,3162,일부/Noun,65,29,36,0.0003445592975436257,0.0004220440258557498,0.5538461538461539
3163,3163,어차피/Noun,65,29,36,0.0003445592975436257,0.0004220440258557498,0.5538461538461539
3164,3164,공주/Noun,65,36,29,0.00042236300989218633,0.00034429907372442745,0.5538461538461539
3165,3165,이드/Noun,65,35,30,0.0004112481938423919,0.0003554054954574735,0.5384615384615384
3166,3166,연상/Noun,65,33,32,0.00038901856174280313,0.0003776183389235656,0.5076923076923077
3167,3167,없애다/Verb,65,33,32,0.00038901856174280313,0.0003776183389235656,0.5076923076923077
3168,3168,역작/Noun,64,59,5,0.0006780037790374569,7.774495213132233e-05,0.921875
3169,3169,싱겁다/Adjective,64,7,57,0.0001000333444481494,0.0006552788822497168,0.890625
3170,3170,치노/Noun,64,53,11,0.0006113148827386907,0.0001443834825295986,0.828125
3171,3171,잘나가다/Verb,64,11,53,0.0001444926086473269,0.0006108531953175326,0.828125
3172,3172,뒤늦다/Adjective,64,52,12,0.0006002000666888963,0.00015548990426264466,0.8125
3173,3173,납득/Noun,64,12,52,0.00015560742469712126,0.0005997467735844866,0.8125
3174,3174,조차/Noun,64,13,51,0.00016672224074691566,0.0005886403518514405,0.796875
3175,3175,사람과/Noun,64,51,13,0.000589085250639102,0.0001665963259956907,0.796875
3176,3176,클래식/Noun,64,50,14,0.0005779704345893076,0.00017770274772873674,0.78125
3177,3177,...!/Punctuation,64,48,16,0.0005557408024897189,0.00019991559119482882,0.75
3178,3178,재방/Noun,64,48,16,0.0005557408024897189,0.00019991559119482882,0.75
3179,3179,우드/Noun,64,48,16,0.0005557408024897189,0.00019991559119482882,0.75
3180,3180,두렵다/Adjective,64,48,16,0.0005557408024897189,0.00019991559119482882,0.75
3181,3181,떨리다/Verb,64,47,17,0.0005446259864399244,0.0002110220129278749,0.734375
3182,3182,차리다/Verb,64,17,47,0.00021118150494609317,0.0005442146649192564,0.734375
3183,3183,!!!!!!/Punctuation,64,47,17,0.0005446259864399244,0.0002110220129278749,0.734375
3184,3184,찍/Noun,64,18,46,0.0002222963209958875,0.0005331082431862101,0.71875
3185,3185,신화/Noun,64,46,18,0.00053351117039013,0.00022212843466092096,0.71875
3186,3186,난후/Noun,64,44,20,0.0005112815382905413,0.00024434127812701304,0.6875
3187,3187,발랄하다/Adjective,64,44,20,0.0005112815382905413,0.00024434127812701304,0.6875
3188,3188,스펙/Noun,64,43,21,0.0005001667222407468,0.0002554476998600591,0.671875
3189,3189,인걸/Josa,64,22,42,0.000266755585195065,0.0004886825562540262,0.65625
3190,3190,세계관/Noun,64,22,42,0.000266755585195065,0.0004886825562540262,0.65625
3191,3191,찌르다/Verb,64,22,42,0.000266755585195065,0.0004886825562540262,0.65625
3192,3192,화질/Noun,64,23,41,0.00027787040124485944,0.00047757613452098,0.640625
3193,3193,설/Noun,64,24,40,0.0002889852172946538,0.000466469712787934,0.625
3194,3194,화하다/Adjective,64,27,37,0.00032232966544403684,0.0004331504475887958,0.578125
3195,3195,추격/Noun,64,36,28,0.00042236300989218633,0.0003331926519913814,0.5625
3196,3196,리암/Noun,64,36,28,0.00042236300989218633,0.0003331926519913814,0.5625
3197,3197,도르다/Verb,64,29,35,0.0003445592975436257,0.0004109376041227037,0.546875
3198,3198,각/Noun,64,34,30,0.0004001333777925976,0.0003554054954574735,0.53125
3199,3199,구조/Noun,64,30,34,0.00035567411359342004,0.00039983118238965764,0.53125
3200,3200,열다/Verb,64,34,30,0.0004001333777925976,0.0003554054954574735,0.53125
3201,3201,한지/Noun,64,30,34,0.00035567411359342004,0.00039983118238965764,0.53125
3202,3202,보나/Noun,64,33,31,0.00038901856174280313,0.00036651191719051963,0.515625
3203,3203,로맨틱코미디/Noun,64,32,32,0.00037790374569300877,0.0003776183389235656,0.5
3204,3204,4.44/Number,63,9,54,0.00012226297654773814,0.0006219596170505788,0.8571428571428571
3205,3205,-_-;;/Punctuation,63,9,54,0.00012226297654773814,0.0006219596170505788,0.8571428571428571
3206,3206,재앙/Noun,63,10,53,0.0001333777925975325,0.0006108531953175326,0.8412698412698413
3207,3207,해지/Noun,63,51,12,0.000589085250639102,0.00015548990426264466,0.8095238095238095
3208,3208,다치다/Verb,63,16,47,0.0002000666888962988,0.0005442146649192564,0.7460317460317459
3209,3209,허무/Noun,63,16,47,0.0002000666888962988,0.0005442146649192564,0.7460317460317459
3210,3210,앙/Adverb,63,45,18,0.0005223963543403357,0.00022212843466092096,0.7142857142857143
3211,3211,승부/Noun,63,18,45,0.0002222963209958875,0.0005220018214531642,0.7142857142857143
3212,3212,김희선/Noun,63,20,43,0.00024452595309547634,0.0004997889779870722,0.6825396825396826
3213,3213,벌어지다/Verb,63,42,21,0.0004890519061909527,0.0002554476998600591,0.6666666666666666
3214,3214,첨으로/Adverb,63,22,41,0.000266755585195065,0.00047757613452098,0.6507936507936508
3215,3215,만화가/Noun,63,22,41,0.000266755585195065,0.00047757613452098,0.6507936507936508
3216,3216,작화/Noun,63,40,23,0.0004668222740913638,0.00027766054332615115,0.6349206349206349
3217,3217,거듭/Noun,63,40,23,0.0004668222740913638,0.00027766054332615115,0.6349206349206349
3218,3218,메이/Noun,63,40,23,0.0004668222740913638,0.00027766054332615115,0.6349206349206349
3219,3219,오직/Noun,63,24,39,0.0002889852172946538,0.000455363291054888,0.6190476190476191
3220,3220,강동원/Noun,63,39,24,0.00045570745804156943,0.0002887669650591972,0.6190476190476191
3221,3221,장진/Noun,63,26,37,0.00031121484939424253,0.0004331504475887958,0.5873015873015873
3222,3222,비쥬/Noun,63,26,37,0.00031121484939424253,0.0004331504475887958,0.5873015873015873
3223,3223,3시간/Number,63,36,27,0.00042236300989218633,0.00032208623025833537,0.5714285714285714
3224,3224,섬/Noun,63,36,27,0.00042236300989218633,0.00032208623025833537,0.5714285714285714
3225,3225,깜놀/Noun,63,36,27,0.00042236300989218633,0.00032208623025833537,0.5714285714285714
3226,3226,주가/Noun,63,28,35,0.0003334444814938313,0.0004109376041227037,0.5555555555555556
3227,3227,슈퍼맨/Noun,63,28,35,0.0003334444814938313,0.0004109376041227037,0.5555555555555556
3228,3228,열자/Noun,63,28,35,0.0003334444814938313,0.0004109376041227037,0.5555555555555556
3229,3229,오해/Noun,63,34,29,0.0004001333777925976,0.00034429907372442745,0.5396825396825397
3230,3230,산다/Noun,63,32,31,0.00037790374569300877,0.00036651191719051963,0.5079365079365079
3231,3231,bb/Alpha,62,59,3,0.0006780037790374569,5.553210866523024e-05,0.9516129032258064
3232,3232,에로물/Noun,62,6,56,8.891852839835501e-05,0.0006441724605166707,0.9032258064516128
3233,3233,살때/Noun,62,54,8,0.0006224296987884852,0.00011106421733046048,0.8709677419354839
3234,3234,알바생/Noun,62,8,54,0.00011114816049794375,0.0006219596170505788,0.8709677419354839
3235,3235,벅차다/Adjective,62,53,9,0.0006113148827386907,0.00012217063906350652,0.8548387096774194
3236,3236,로운/Josa,62,51,11,0.000589085250639102,0.0001443834825295986,0.8225806451612904
3237,3237,^-^/Punctuation,62,50,12,0.0005779704345893076,0.00015548990426264466,0.8064516129032258
3238,3238,꼽/Noun,62,49,13,0.0005668556185395131,0.0001665963259956907,0.7903225806451613
3239,3239,관대하다/Adjective,62,14,48,0.00017783705679671002,0.0005553210866523023,0.7741935483870968
3240,3240,뿌리다/Verb,62,14,48,0.00017783705679671002,0.0005553210866523023,0.7741935483870968
3241,3241,페이크/Noun,62,14,48,0.00017783705679671002,0.0005553210866523023,0.7741935483870968
3242,3242,망치/Noun,62,16,46,0.0002000666888962988,0.0005331082431862101,0.7419354838709677
3243,3243,올레/Noun,62,16,46,0.0002000666888962988,0.0005331082431862101,0.7419354838709677
3244,3244,강요/Noun,62,16,46,0.0002000666888962988,0.0005331082431862101,0.7419354838709677
3245,3245,밀다/Verb,62,17,45,0.00021118150494609317,0.0005220018214531642,0.7258064516129032
3246,3246,다섯/Determiner,62,45,17,0.0005223963543403357,0.0002110220129278749,0.7258064516129032
3247,3247,짜내다/Verb,62,18,44,0.0002222963209958875,0.0005108953997201182,0.7096774193548387
3248,3248,가짜/Noun,62,19,43,0.0002334111370456819,0.0004997889779870722,0.6935483870967742
3249,3249,소품/Noun,62,20,42,0.00024452595309547634,0.0004886825562540262,0.6774193548387096
3250,3250,아담/Noun,62,42,20,0.0004890519061909527,0.00024434127812701304,0.6774193548387096
3251,3251,다녀오다/Verb,62,42,20,0.0004890519061909527,0.00024434127812701304,0.6774193548387096
3252,3252,만난/Noun,62,41,21,0.0004779370901411582,0.0002554476998600591,0.6612903225806451
3253,3253,원조/Noun,62,41,21,0.0004779370901411582,0.0002554476998600591,0.6612903225806451
3254,3254,구석/Noun,62,21,41,0.00025564076914527065,0.00047757613452098,0.6612903225806451
3255,3255,드러내다/Verb,62,40,22,0.0004668222740913638,0.00026655412159310506,0.6451612903225806
3256,3256,섬뜩하다/Adjective,62,39,23,0.00045570745804156943,0.00027766054332615115,0.6290322580645161
3257,3257,흑백/Noun,62,38,24,0.000444592641991775,0.0002887669650591972,0.6129032258064516
3258,3258,가라/Noun,62,24,38,0.0002889852172946538,0.0004442568693218419,0.6129032258064516
3259,3259,행/Noun,62,38,24,0.000444592641991775,0.0002887669650591972,0.6129032258064516
3260,3260,철저하다/Adjective,62,24,38,0.0002889852172946538,0.0004442568693218419,0.6129032258064516
3261,3261,지지/Noun,62,24,38,0.0002889852172946538,0.0004442568693218419,0.6129032258064516
3262,3262,곤/Noun,62,25,37,0.00030010003334444816,0.0004331504475887958,0.5967741935483871
3263,3263,파워/Noun,62,26,36,0.00031121484939424253,0.0004220440258557498,0.5806451612903226
3264,3264,대에/Foreign,62,26,36,0.00031121484939424253,0.0004220440258557498,0.5806451612903226
3265,3265,옥/Noun,62,36,26,0.00042236300989218633,0.00031097980852528933,0.5806451612903226
3266,3266,외면/Noun,62,35,27,0.0004112481938423919,0.00032208623025833537,0.5645161290322581
3267,3267,갓/Noun,62,28,34,0.0003334444814938313,0.00039983118238965764,0.5483870967741935
3268,3268,최민수/Noun,62,33,29,0.00038901856174280313,0.00034429907372442745,0.532258064516129
3269,3269,가게/Noun,62,30,32,0.00035567411359342004,0.0003776183389235656,0.5161290322580645
3270,3270,쏘우/Noun,62,32,30,0.00037790374569300877,0.0003554054954574735,0.5161290322580645
3271,3271,장소/Noun,62,30,32,0.00035567411359342004,0.0003776183389235656,0.5161290322580645
3272,3272,시험/Noun,62,31,31,0.00036678892964321435,0.00036651191719051963,0.5
3273,3273,두고두고/Noun,61,55,6,0.0006335445148382794,8.885137386436837e-05,0.9016393442622952
3274,3274,짱짱맨/Noun,61,52,9,0.0006002000666888963,0.00012217063906350652,0.8524590163934426
3275,3275,관리/Noun,61,11,50,0.0001444926086473269,0.0005775339301183945,0.819672131147541
3276,3276,창피하다/Adjective,61,12,49,0.00015560742469712126,0.0005664275083853486,0.8032786885245902
3277,3277,과도/Noun,61,15,46,0.00018895187284650438,0.0005331082431862101,0.7540983606557377
3278,3278,싸하다/Adjective,61,15,46,0.00018895187284650438,0.0005331082431862101,0.7540983606557377
3279,3279,남친/Noun,61,16,45,0.0002000666888962988,0.0005220018214531642,0.7377049180327869
3280,3280,공연/Noun,61,45,16,0.0005223963543403357,0.00019991559119482882,0.7377049180327869
3281,3281,떠들다/Verb,61,17,44,0.00021118150494609317,0.0005108953997201182,0.7213114754098361
3282,3282,방황/Noun,61,43,18,0.0005001667222407468,0.00022212843466092096,0.7049180327868853
3283,3283,덩어리/Noun,61,18,43,0.0002222963209958875,0.0004997889779870722,0.7049180327868853
3284,3284,태국/Noun,61,18,43,0.0002222963209958875,0.0004997889779870722,0.7049180327868853
3285,3285,밝혀지다/Verb,61,19,42,0.0002334111370456819,0.0004886825562540262,0.6885245901639344
3286,3286,톤/Noun,61,20,41,0.00024452595309547634,0.00047757613452098,0.6721311475409836
3287,3287,타인/Noun,61,41,20,0.0004779370901411582,0.00024434127812701304,0.6721311475409836
3288,3288,음향/Noun,61,20,41,0.00024452595309547634,0.00047757613452098,0.6721311475409836
3289,3289,볼라/Noun,61,21,40,0.00025564076914527065,0.000466469712787934,0.6557377049180327
3290,3290,지내다/Verb,61,40,21,0.0004668222740913638,0.0002554476998600591,0.6557377049180327
3291,3291,택시/Noun,61,23,38,0.00027787040124485944,0.0004442568693218419,0.6229508196721312
3292,3292,특집/Noun,61,23,38,0.00027787040124485944,0.0004442568693218419,0.6229508196721312
3293,3293,여지/Noun,61,37,24,0.0004334778259419807,0.0002887669650591972,0.6065573770491803
3294,3294,층/Noun,61,25,36,0.00030010003334444816,0.0004220440258557498,0.5901639344262295
3295,3295,띄다/Verb,61,25,36,0.00030010003334444816,0.0004220440258557498,0.5901639344262295
3296,3296,엄정화/Noun,61,36,25,0.00042236300989218633,0.0002998733867922433,0.5901639344262295
3297,3297,포드/Noun,61,35,26,0.0004112481938423919,0.00031097980852528933,0.5737704918032787
3298,3298,밝히다/Verb,61,26,35,0.00031121484939424253,0.0004109376041227037,0.5737704918032787
3299,3299,해오다/Verb,61,34,27,0.0004001333777925976,0.00032208623025833537,0.5573770491803278
3300,3300,언어/Noun,61,34,27,0.0004001333777925976,0.00032208623025833537,0.5573770491803278
3301,3301,킬러/Noun,61,27,34,0.00032232966544403684,0.00039983118238965764,0.5573770491803278
3302,3302,정선/Noun,61,33,28,0.00038901856174280313,0.0003331926519913814,0.5409836065573771
3303,3303,찬란하다/Adjective,61,29,32,0.0003445592975436257,0.0003776183389235656,0.5245901639344263
3304,3304,복선/Noun,61,29,32,0.0003445592975436257,0.0003776183389235656,0.5245901639344263
3305,3305,종/Noun,61,29,32,0.0003445592975436257,0.0003776183389235656,0.5245901639344263
3306,3306,엉뚱하다/Adjective,61,30,31,0.00035567411359342004,0.00036651191719051963,0.5081967213114754
3307,3307,OOOO/Alpha,60,2,58,4.445926419917751e-05,0.0006663853039827628,0.9666666666666668
3308,3308,쯧쯧/Noun,60,3,57,5.5574080248971876e-05,0.0006552788822497168,0.95
3309,3309,모욕/Noun,60,4,56,6.668889629876625e-05,0.0006441724605166707,0.9333333333333332
3310,3310,홧팅/Noun,60,56,4,0.0006446593308880737,6.663853039827628e-05,0.9333333333333332
3311,3311,심사/Noun,60,5,55,7.780371234856063e-05,0.0006330660387836247,0.9166666666666666
3312,3312,울림/Noun,60,55,5,0.0006335445148382794,7.774495213132233e-05,0.9166666666666666
3313,3313,고독/Noun,60,51,9,0.000589085250639102,0.00012217063906350652,0.85
3314,3314,깨달음/Noun,60,49,11,0.0005668556185395131,0.0001443834825295986,0.8166666666666667
3315,3315,어째/Noun,60,12,48,0.00015560742469712126,0.0005553210866523023,0.8
3316,3316,상큼/Noun,60,48,12,0.0005557408024897189,0.00015548990426264466,0.8
3317,3317,..!!/Punctuation,60,47,13,0.0005446259864399244,0.0001665963259956907,0.7833333333333333
3318,3318,젊은이/Noun,60,47,13,0.0005446259864399244,0.0001665963259956907,0.7833333333333333
3319,3319,자랑/Noun,60,14,46,0.00017783705679671002,0.0005331082431862101,0.7666666666666667
3320,3320,맙시/Noun,60,15,45,0.00018895187284650438,0.0005220018214531642,0.75
3321,3321,짙다/Adjective,60,44,16,0.0005112815382905413,0.00019991559119482882,0.7333333333333333
3322,3322,ㅂ/KoreanParticle,60,18,42,0.0002222963209958875,0.0004886825562540262,0.7
3323,3323,사과/Noun,60,18,42,0.0002222963209958875,0.0004886825562540262,0.7
3324,3324,떄/Noun,60,41,19,0.0004779370901411582,0.000233234856393967,0.6833333333333333
3325,3325,신비/Noun,60,41,19,0.0004779370901411582,0.000233234856393967,0.6833333333333333
3326,3326,백배/Noun,60,40,20,0.0004668222740913638,0.00024434127812701304,0.6666666666666666
3327,3327,다이하드/Noun,60,21,39,0.00025564076914527065,0.000455363291054888,0.65
3328,3328,에바/Noun,60,22,38,0.000266755585195065,0.0004442568693218419,0.6333333333333333
3329,3329,유익하다/Adjective,60,37,23,0.0004334778259419807,0.00027766054332615115,0.6166666666666667
3330,3330,애니매이션/Noun,60,37,23,0.0004334778259419807,0.00027766054332615115,0.6166666666666667
3331,3331,김혜수/Noun,60,36,24,0.00042236300989218633,0.0002887669650591972,0.6
3332,3332,덮다/Verb,60,24,36,0.0002889852172946538,0.0004220440258557498,0.6
3333,3333,슨/Noun,60,36,24,0.00042236300989218633,0.0002887669650591972,0.6
3334,3334,박하다/Adjective,60,35,25,0.0004112481938423919,0.0002998733867922433,0.5833333333333334
3335,3335,넹/Noun,60,25,35,0.00030010003334444816,0.0004109376041227037,0.5833333333333334
3336,3336,무간도/Noun,60,25,35,0.00030010003334444816,0.0004109376041227037,0.5833333333333334
3337,3337,조선/Noun,60,25,35,0.00030010003334444816,0.0004109376041227037,0.5833333333333334
3338,3338,주위/Noun,60,34,26,0.0004001333777925976,0.00031097980852528933,0.5666666666666667
3339,3339,인권/Noun,60,34,26,0.0004001333777925976,0.00031097980852528933,0.5666666666666667
3340,3340,집다/Verb,60,26,34,0.00031121484939424253,0.00039983118238965764,0.5666666666666667
3341,3341,도둑/Noun,60,27,33,0.00032232966544403684,0.00038872476065661166,0.55
3342,3342,자본/Noun,60,28,32,0.0003334444814938313,0.0003776183389235656,0.5333333333333333
3343,3343,혹/Noun,60,28,32,0.0003334444814938313,0.0003776183389235656,0.5333333333333333
3344,3344,차별/Noun,60,32,28,0.00037790374569300877,0.0003331926519913814,0.5333333333333333
3345,3345,침/Noun,60,28,32,0.0003334444814938313,0.0003776183389235656,0.5333333333333333
3346,3346,참여/Noun,60,29,31,0.0003445592975436257,0.00036651191719051963,0.5166666666666667
3347,3347,광/Noun,60,29,31,0.0003445592975436257,0.00036651191719051963,0.5166666666666667
3348,3348,소/Noun,60,29,31,0.0003445592975436257,0.00036651191719051963,0.5166666666666667
3349,3349,걷다/Verb,60,31,29,0.00036678892964321435,0.00034429907372442745,0.5166666666666667
3350,3350,볼일/Noun,59,3,56,5.5574080248971876e-05,0.0006441724605166707,0.9491525423728814
3351,3351,미달/Noun,59,4,55,6.668889629876625e-05,0.0006330660387836247,0.9322033898305084
3352,3352,거북하다/Adjective,59,5,54,7.780371234856063e-05,0.0006219596170505788,0.9152542372881356
3353,3353,군더더기/Noun,59,54,5,0.0006224296987884852,7.774495213132233e-05,0.9152542372881356
3354,3354,bad/Alpha,59,5,54,7.780371234856063e-05,0.0006219596170505788,0.9152542372881356
3355,3355,모독/Noun,59,7,52,0.0001000333444481494,0.0005997467735844866,0.8813559322033898
3356,3356,폼/Noun,59,11,48,0.0001444926086473269,0.0005553210866523023,0.8135593220338984
3357,3357,먹기/Noun,59,11,48,0.0001444926086473269,0.0005553210866523023,0.8135593220338984
3358,3358,천사/Noun,59,48,11,0.0005557408024897189,0.0001443834825295986,0.8135593220338984
3359,3359,부담/Noun,59,46,13,0.00053351117039013,0.0001665963259956907,0.7796610169491526
3360,3360,엔딩크레딧/Noun,59,46,13,0.00053351117039013,0.0001665963259956907,0.7796610169491526
3361,3361,누님/Noun,59,45,14,0.0005223963543403357,0.00017770274772873674,0.7627118644067796
3362,3362,칠/Noun,59,14,45,0.00017783705679671002,0.0005220018214531642,0.7627118644067796
3363,3363,짓/VerbPrefix,59,15,44,0.00018895187284650438,0.0005108953997201182,0.7457627118644068
3364,3364,반감/Noun,59,15,44,0.00018895187284650438,0.0005108953997201182,0.7457627118644068
3365,3365,성형/Noun,59,16,43,0.0002000666888962988,0.0004997889779870722,0.7288135593220338
3366,3366,뉴스/Noun,59,17,42,0.00021118150494609317,0.0004886825562540262,0.7118644067796609
3367,3367,떡밥/Noun,59,18,41,0.0002222963209958875,0.00047757613452098,0.6949152542372882
3368,3368,인연/Noun,59,40,19,0.0004668222740913638,0.000233234856393967,0.6779661016949152
3369,3369,고작/Noun,59,19,40,0.0002334111370456819,0.000466469712787934,0.6779661016949152
3370,3370,눈치/Noun,59,19,40,0.0002334111370456819,0.000466469712787934,0.6779661016949152
3371,3371,찾아오다/Verb,59,38,21,0.000444592641991775,0.0002554476998600591,0.6440677966101694
3372,3372,토니/Noun,59,37,22,0.0004334778259419807,0.00026655412159310506,0.6271186440677966
3373,3373,스콧/Noun,59,37,22,0.0004334778259419807,0.00026655412159310506,0.6271186440677966
3374,3374,테이큰/Noun,59,36,23,0.00042236300989218633,0.00027766054332615115,0.6101694915254238
3375,3375,리기/Noun,59,36,23,0.00042236300989218633,0.00027766054332615115,0.6101694915254238
3376,3376,밖에는/Josa,59,24,35,0.0002889852172946538,0.0004109376041227037,0.5932203389830508
3377,3377,스파이더맨/Noun,59,35,24,0.0004112481938423919,0.0002887669650591972,0.5932203389830508
3378,3378,나루토/Noun,59,35,24,0.0004112481938423919,0.0002887669650591972,0.5932203389830508
3379,3379,그려지다/Verb,59,35,24,0.0004112481938423919,0.0002887669650591972,0.5932203389830508
3380,3380,아이유/Noun,59,34,25,0.0004001333777925976,0.0002998733867922433,0.576271186440678
3381,3381,뒤지다/Verb,59,25,34,0.00030010003334444816,0.00039983118238965764,0.576271186440678
3382,3382,박평/Noun,59,34,25,0.0004001333777925976,0.0002998733867922433,0.576271186440678
3383,3383,기사/Noun,59,25,34,0.00030010003334444816,0.00039983118238965764,0.576271186440678
3384,3384,버스/Noun,59,33,26,0.00038901856174280313,0.00031097980852528933,0.559322033898305
3385,3385,흔들리다/Verb,59,26,33,0.00031121484939424253,0.00038872476065661166,0.559322033898305
3386,3386,불가능하다/Adjective,59,26,33,0.00031121484939424253,0.00038872476065661166,0.559322033898305
3387,3387,쓰이다/Verb,59,27,32,0.00032232966544403684,0.0003776183389235656,0.5423728813559322
3388,3388,징/Noun,59,27,32,0.00032232966544403684,0.0003776183389235656,0.5423728813559322
3389,3389,클라스/Noun,59,32,27,0.00037790374569300877,0.00032208623025833537,0.5423728813559322
3390,3390,던/Noun,59,27,32,0.00032232966544403684,0.0003776183389235656,0.5423728813559322
3391,3391,가하다/Verb,59,28,31,0.0003334444814938313,0.00036651191719051963,0.5254237288135594
3392,3392,하고도/Josa,59,29,30,0.0003445592975436257,0.0003554054954574735,0.5084745762711864
3393,3393,킹/Noun,59,29,30,0.0003445592975436257,0.0003554054954574735,0.5084745762711864
3394,3394,로드/Noun,59,30,29,0.00035567411359342004,0.00034429907372442745,0.5084745762711864
3395,3395,새록새록/Noun,58,57,1,0.0006557741469378681,3.331926519913814e-05,0.9827586206896552
3396,3396,우롱/Noun,58,3,55,5.5574080248971876e-05,0.0006330660387836247,0.9482758620689656
3397,3397,개똥/Noun,58,4,54,6.668889629876625e-05,0.0006219596170505788,0.9310344827586208
3398,3398,진영화/Noun,58,53,5,0.0006113148827386907,7.774495213132233e-05,0.913793103448276
3399,3399,아기자기하다/Adjective,58,51,7,0.000589085250639102,9.995779559741441e-05,0.8793103448275862
3400,3400,렉/Noun,58,8,50,0.00011114816049794375,0.0005775339301183945,0.8620689655172413
3401,3401,기쁘다/Adjective,58,49,9,0.0005668556185395131,0.00012217063906350652,0.8448275862068966
3402,3402,남고/Noun,58,48,10,0.0005557408024897189,0.00013327706079655256,0.8275862068965517
3403,3403,문득/Noun,58,47,11,0.0005446259864399244,0.0001443834825295986,0.8103448275862069
3404,3404,성장하다/Adjective,58,44,14,0.0005112815382905413,0.00017770274772873674,0.7586206896551724
3405,3405,향기/Noun,58,44,14,0.0005112815382905413,0.00017770274772873674,0.7586206896551724
3406,3406,왕조현/Noun,58,43,15,0.0005001667222407468,0.0001888091694617828,0.7413793103448276
3407,3407,타이틀/Noun,58,15,43,0.00018895187284650438,0.0004997889779870722,0.7413793103448276
3408,3408,사이코/Noun,58,15,43,0.00018895187284650438,0.0004997889779870722,0.7413793103448276
3409,3409,벌/Noun,58,16,42,0.0002000666888962988,0.0004886825562540262,0.7241379310344828
3410,3410,기승/Noun,58,16,42,0.0002000666888962988,0.0004886825562540262,0.7241379310344828
3411,3411,습/Noun,58,41,17,0.0004779370901411582,0.0002110220129278749,0.7068965517241379
3412,3412,레이첼/Noun,58,40,18,0.0004668222740913638,0.00022212843466092096,0.6896551724137931
3413,3413,영활/Noun,58,18,40,0.0002222963209958875,0.000466469712787934,0.6896551724137931
3414,3414,".""/Punctuation",58,40,18,0.0004668222740913638,0.00022212843466092096,0.6896551724137931
3415,3415,디테/Noun,58,39,19,0.00045570745804156943,0.000233234856393967,0.6724137931034483
3416,3416,썩/Noun,58,19,39,0.0002334111370456819,0.000455363291054888,0.6724137931034483
3417,3417,피곤하다/Adjective,58,20,38,0.00024452595309547634,0.0004442568693218419,0.6551724137931034
3418,3418,어떠하다/Adjective,58,38,20,0.000444592641991775,0.00024434127812701304,0.6551724137931034
3419,3419,양/Suffix,58,37,21,0.0004334778259419807,0.0002554476998600591,0.6379310344827587
3420,3420,...(/Punctuation,58,21,37,0.00025564076914527065,0.0004331504475887958,0.6379310344827587
3421,3421,지켜보다/Verb,58,37,21,0.0004334778259419807,0.0002554476998600591,0.6379310344827587
3422,3422,평화/Noun,58,36,22,0.00042236300989218633,0.00026655412159310506,0.6206896551724138
3423,3423,합치다/Verb,58,23,35,0.00027787040124485944,0.0004109376041227037,0.603448275862069
3424,3424,황정민/Noun,58,35,23,0.0004112481938423919,0.00027766054332615115,0.603448275862069
3425,3425,시골/Noun,58,34,24,0.0004001333777925976,0.0002887669650591972,0.5862068965517241
3426,3426,해외/Noun,58,25,33,0.00030010003334444816,0.00038872476065661166,0.5689655172413793
3427,3427,김수현/Noun,58,32,26,0.00037790374569300877,0.00031097980852528933,0.5517241379310345
3428,3428,까맣다/Adjective,58,32,26,0.00037790374569300877,0.00031097980852528933,0.5517241379310345
3429,3429,손예진/Noun,58,27,31,0.00032232966544403684,0.00036651191719051963,0.5344827586206896
3430,3430,한효주/Noun,58,27,31,0.00032232966544403684,0.00036651191719051963,0.5344827586206896
3431,3431,제시카/Noun,58,27,31,0.00032232966544403684,0.00036651191719051963,0.5344827586206896
3432,3432,맺다/Verb,58,31,27,0.00036678892964321435,0.00032208623025833537,0.5344827586206896
3433,3433,제왕/Noun,58,28,30,0.0003334444814938313,0.0003554054954574735,0.5172413793103449
3434,3434,동양/Noun,58,30,28,0.00035567411359342004,0.0003331926519913814,0.5172413793103449
3435,3435,멀리/Noun,58,29,29,0.0003445592975436257,0.00034429907372442745,0.5
3436,3436,반도/Noun,57,2,55,4.445926419917751e-05,0.0006330660387836247,0.9649122807017544
3437,3437,커녕/Noun,57,3,54,5.5574080248971876e-05,0.0006219596170505788,0.9473684210526316
3438,3438,헛웃음/Noun,57,4,53,6.668889629876625e-05,0.0006108531953175326,0.9298245614035088
3439,3439,차분하다/Adjective,57,48,9,0.0005557408024897189,0.00012217063906350652,0.8421052631578947
3440,3440,어지간하다/Adjective,57,11,46,0.0001444926086473269,0.0005331082431862101,0.8070175438596491
3441,3441,압/Noun,57,46,11,0.00053351117039013,0.0001443834825295986,0.8070175438596491
3442,3442,학창시절/Noun,57,44,13,0.0005112815382905413,0.0001665963259956907,0.7719298245614035
3443,3443,더욱더/Noun,57,44,13,0.0005112815382905413,0.0001665963259956907,0.7719298245614035
3444,3444,주온/Noun,57,14,43,0.00017783705679671002,0.0004997889779870722,0.7543859649122807
3445,3445,적극/Noun,57,42,15,0.0004890519061909527,0.0001888091694617828,0.7368421052631579
3446,3446,새삼/Noun,57,41,16,0.0004779370901411582,0.00019991559119482882,0.7192982456140351
3447,3447,환자/Noun,57,18,39,0.0002222963209958875,0.000455363291054888,0.6842105263157895
3448,3448,쎄다/Adjective,57,18,39,0.0002222963209958875,0.000455363291054888,0.6842105263157895
3449,3449,미장센/Noun,57,38,19,0.000444592641991775,0.000233234856393967,0.6666666666666666
3450,3450,각각/Noun,57,38,19,0.000444592641991775,0.000233234856393967,0.6666666666666666
3451,3451,대학생/Noun,57,20,37,0.00024452595309547634,0.0004331504475887958,0.6491228070175439
3452,3452,겨울왕국/Noun,57,37,20,0.0004334778259419807,0.00024434127812701304,0.6491228070175439
3453,3453,내려가다/Verb,57,20,37,0.00024452595309547634,0.0004331504475887958,0.6491228070175439
3454,3454,청년/Noun,57,37,20,0.0004334778259419807,0.00024434127812701304,0.6491228070175439
3455,3455,5년/Number,57,36,21,0.00042236300989218633,0.0002554476998600591,0.631578947368421
3456,3456,T/Alpha,57,36,21,0.00042236300989218633,0.0002554476998600591,0.631578947368421
3457,3457,스파이/Noun,57,36,21,0.00042236300989218633,0.0002554476998600591,0.631578947368421
3458,3458,오지/Noun,57,22,35,0.000266755585195065,0.0004109376041227037,0.6140350877192983
3459,3459,신세계/Noun,57,35,22,0.0004112481938423919,0.00026655412159310506,0.6140350877192983
3460,3460,송승헌/Noun,57,23,34,0.00027787040124485944,0.00039983118238965764,0.5964912280701754
3461,3461,쿨하다/Adjective,57,34,23,0.0004001333777925976,0.00027766054332615115,0.5964912280701754
3462,3462,색깔/Noun,57,34,23,0.0004001333777925976,0.00027766054332615115,0.5964912280701754
3463,3463,질문/Noun,57,33,24,0.00038901856174280313,0.0002887669650591972,0.5789473684210527
3464,3464,대학/Noun,57,24,33,0.0002889852172946538,0.00038872476065661166,0.5789473684210527
3465,3465,이정재/Noun,57,33,24,0.00038901856174280313,0.0002887669650591972,0.5789473684210527
3466,3466,이나/Foreign,57,25,32,0.00030010003334444816,0.0003776183389235656,0.5614035087719298
3467,3467,장애/Noun,57,25,32,0.00030010003334444816,0.0003776183389235656,0.5614035087719298
3468,3468,무리다/Adjective,57,25,32,0.00030010003334444816,0.0003776183389235656,0.5614035087719298
3469,3469,60년/Number,57,26,31,0.00031121484939424253,0.00036651191719051963,0.543859649122807
3470,3470,롱/Noun,57,31,26,0.00036678892964321435,0.00031097980852528933,0.543859649122807
3471,3471,재현/Noun,57,31,26,0.00036678892964321435,0.00031097980852528933,0.543859649122807
3472,3472,자라다/Verb,57,31,26,0.00036678892964321435,0.00031097980852528933,0.543859649122807
3473,3473,래야/Noun,57,26,31,0.00031121484939424253,0.00036651191719051963,0.543859649122807
3474,3474,설경구/Noun,57,30,27,0.00035567411359342004,0.00032208623025833537,0.5263157894736842
3475,3475,완젼/Noun,57,30,27,0.00035567411359342004,0.00032208623025833537,0.5263157894736842
3476,3476,찌/Noun,57,28,29,0.0003334444814938313,0.00034429907372442745,0.5087719298245614
3477,3477,시장/Noun,57,29,28,0.0003445592975436257,0.0003331926519913814,0.5087719298245614
3478,3478,원주율/Noun,56,2,54,4.445926419917751e-05,0.0006219596170505788,0.9642857142857144
3479,3479,난국/Noun,56,2,54,4.445926419917751e-05,0.0006219596170505788,0.9642857142857144
3480,3480,묵직하다/Adjective,56,49,7,0.0005668556185395131,9.995779559741441e-05,0.875
3481,3481,오랫동안/Adverb,56,49,7,0.0005668556185395131,9.995779559741441e-05,0.875
3482,3482,손꼽다/Verb,56,45,11,0.0005223963543403357,0.0001443834825295986,0.8035714285714286
3483,3483,절반/Noun,56,11,45,0.0001444926086473269,0.0005220018214531642,0.8035714285714286
3484,3484,비싸다/Adjective,56,11,45,0.0001444926086473269,0.0005220018214531642,0.8035714285714286
3485,3485,아이고/Exclamation,56,12,44,0.00015560742469712126,0.0005108953997201182,0.7857142857142857
3486,3486,에드/Noun,56,44,12,0.0005112815382905413,0.00015548990426264466,0.7857142857142857
3487,3487,!~/Punctuation,56,43,13,0.0005001667222407468,0.0001665963259956907,0.7678571428571429
3488,3488,의견/Noun,56,15,41,0.00018895187284650438,0.00047757613452098,0.7321428571428571
3489,3489,덤/Noun,56,40,16,0.0004668222740913638,0.00019991559119482882,0.7142857142857143
3490,3490,싸이코패스/Noun,56,16,40,0.0002000666888962988,0.000466469712787934,0.7142857142857143
3491,3491,집안/Noun,56,16,40,0.0002000666888962988,0.000466469712787934,0.7142857142857143
3492,3492,귀찮다/Adjective,56,17,39,0.00021118150494609317,0.000455363291054888,0.6964285714285714
3493,3493,유행/Noun,56,17,39,0.00021118150494609317,0.000455363291054888,0.6964285714285714
3494,3494,공식/Noun,56,17,39,0.00021118150494609317,0.000455363291054888,0.6964285714285714
3495,3495,사장/Noun,56,18,38,0.0002222963209958875,0.0004442568693218419,0.6785714285714286
3496,3496,빼놓다/Verb,56,38,18,0.000444592641991775,0.00022212843466092096,0.6785714285714286
3497,3497,방향/Noun,56,18,38,0.0002222963209958875,0.0004442568693218419,0.6785714285714286
3498,3498,영웅본색/Noun,56,19,37,0.0002334111370456819,0.0004331504475887958,0.6607142857142857
3499,3499,대하/Noun,56,37,19,0.0004334778259419807,0.000233234856393967,0.6607142857142857
3500,3500,크레딧/Noun,56,37,19,0.0004334778259419807,0.000233234856393967,0.6607142857142857
3501,3501,펼치다/Verb,56,37,19,0.0004334778259419807,0.000233234856393967,0.6607142857142857
3502,3502,추악하다/Adjective,56,36,20,0.00042236300989218633,0.00024434127812701304,0.6428571428571429
3503,3503,사무라이/Noun,56,20,36,0.00024452595309547634,0.0004220440258557498,0.6428571428571429
3504,3504,잘나다/Adjective,56,20,36,0.00024452595309547634,0.0004220440258557498,0.6428571428571429
3505,3505,주관/Noun,56,20,36,0.00024452595309547634,0.0004220440258557498,0.6428571428571429
3506,3506,고해/Noun,56,20,36,0.00024452595309547634,0.0004220440258557498,0.6428571428571429
3507,3507,유혹/Noun,56,20,36,0.00024452595309547634,0.0004220440258557498,0.6428571428571429
3508,3508,적나라하다/Adjective,56,35,21,0.0004112481938423919,0.0002554476998600591,0.625
3509,3509,장혁/Noun,56,35,21,0.0004112481938423919,0.0002554476998600591,0.625
3510,3510,콜린/Noun,56,35,21,0.0004112481938423919,0.0002554476998600591,0.625
3511,3511,옮기다/Verb,56,22,34,0.000266755585195065,0.00039983118238965764,0.6071428571428571
3512,3512,전지현/Noun,56,22,34,0.000266755585195065,0.00039983118238965764,0.6071428571428571
3513,3513,눕다/Verb,56,22,34,0.000266755585195065,0.00039983118238965764,0.6071428571428571
3514,3514,박찬욱/Noun,56,22,34,0.000266755585195065,0.00039983118238965764,0.6071428571428571
3515,3515,따지다/Verb,56,33,23,0.00038901856174280313,0.00027766054332615115,0.5892857142857143
3516,3516,훔치다/Verb,56,23,33,0.00027787040124485944,0.00038872476065661166,0.5892857142857143
3517,3517,지대/Noun,56,23,33,0.00027787040124485944,0.00038872476065661166,0.5892857142857143
3518,3518,걸이/Noun,56,23,33,0.00027787040124485944,0.00038872476065661166,0.5892857142857143
3519,3519,명/Suffix,56,24,32,0.0002889852172946538,0.0003776183389235656,0.5714285714285714
3520,3520,아바타/Noun,56,32,24,0.00037790374569300877,0.0002887669650591972,0.5714285714285714
3521,3521,회상/Noun,56,31,25,0.00036678892964321435,0.0002998733867922433,0.5535714285714286
3522,3522,공허하다/Adjective,56,31,25,0.00036678892964321435,0.0002998733867922433,0.5535714285714286
3523,3523,애인/Noun,56,26,30,0.00031121484939424253,0.0003554054954574735,0.5357142857142857
3524,3524,엑스맨/Noun,56,30,26,0.00035567411359342004,0.00031097980852528933,0.5357142857142857
3525,3525,왕자/Noun,56,30,26,0.00035567411359342004,0.00031097980852528933,0.5357142857142857
3526,3526,섹시/Noun,56,30,26,0.00035567411359342004,0.00031097980852528933,0.5357142857142857
3527,3527,부다/Adjective,56,27,29,0.00032232966544403684,0.00034429907372442745,0.5178571428571429
3528,3528,당당하다/Adjective,56,29,27,0.0003445592975436257,0.00032208623025833537,0.5178571428571429
3529,3529,유령/Noun,56,27,29,0.00032232966544403684,0.00034429907372442745,0.5178571428571429
3530,3530,열리다/Verb,56,29,27,0.0003445592975436257,0.00032208623025833537,0.5178571428571429
3531,3531,트랜스포머/Noun,56,28,28,0.0003334444814938313,0.0003331926519913814,0.5
3532,3532,따스하다/Adjective,55,54,1,0.0006224296987884852,3.331926519913814e-05,0.9818181818181818
3533,3533,만족스럽다/Adjective,55,50,5,0.0005779704345893076,7.774495213132233e-05,0.9090909090909092
3534,3534,흠잡다/Adjective,55,50,5,0.0005779704345893076,7.774495213132233e-05,0.9090909090909092
3535,3535,투성이/Noun,55,6,49,8.891852839835501e-05,0.0005664275083853486,0.8909090909090909
3536,3536,어정쩡하다/Adjective,55,6,49,8.891852839835501e-05,0.0005664275083853486,0.8909090909090909
3537,3537,정화/Noun,55,47,8,0.0005446259864399244,0.00011106421733046048,0.8545454545454545
3538,3538,도망가다/Verb,55,9,46,0.00012226297654773814,0.0005331082431862101,0.8363636363636363
3539,3539,멀쩡하다/Adjective,55,11,44,0.0001444926086473269,0.0005108953997201182,0.8
3540,3540,출현/Noun,55,13,42,0.00016672224074691566,0.0004886825562540262,0.7636363636363637
3541,3541,덜하다/Adjective,55,41,14,0.0004779370901411582,0.00017770274772873674,0.7454545454545455
3542,3542,꼬이다/Adjective,55,15,40,0.00018895187284650438,0.000466469712787934,0.7272727272727273
3543,3543,촌/Noun,55,38,17,0.000444592641991775,0.0002110220129278749,0.6909090909090909
3544,3544,러셀/Noun,55,38,17,0.000444592641991775,0.0002110220129278749,0.6909090909090909
3545,3545,..;/Punctuation,55,17,38,0.00021118150494609317,0.0004442568693218419,0.6909090909090909
3546,3546,하고프다/Verb,55,37,18,0.0004334778259419807,0.00022212843466092096,0.6727272727272727
3547,3547,지독하다/Adjective,55,37,18,0.0004334778259419807,0.00022212843466092096,0.6727272727272727
3548,3548,is/Alpha,55,37,18,0.0004334778259419807,0.00022212843466092096,0.6727272727272727
3549,3549,가식/Noun,55,20,35,0.00024452595309547634,0.0004109376041227037,0.6363636363636364
3550,3550,재방송/Noun,55,35,20,0.0004112481938423919,0.00024434127812701304,0.6363636363636364
3551,3551,다크나이트/Noun,55,35,20,0.0004112481938423919,0.00024434127812701304,0.6363636363636364
3552,3552,끝판/Noun,55,20,35,0.00024452595309547634,0.0004109376041227037,0.6363636363636364
3553,3553,신부/Noun,55,35,20,0.0004112481938423919,0.00024434127812701304,0.6363636363636364
3554,3554,번역/Noun,55,20,35,0.00024452595309547634,0.0004109376041227037,0.6363636363636364
3555,3555,작년/Noun,55,35,20,0.0004112481938423919,0.00024434127812701304,0.6363636363636364
3556,3556,스피드/Noun,55,23,32,0.00027787040124485944,0.0003776183389235656,0.5818181818181818
3557,3557,조지/Noun,55,31,24,0.00036678892964321435,0.0002887669650591972,0.5636363636363636
3558,3558,어딘가/Noun,55,31,24,0.00036678892964321435,0.0002887669650591972,0.5636363636363636
3559,3559,기타/Noun,55,30,25,0.00035567411359342004,0.0002998733867922433,0.5454545454545454
3560,3560,폰/Noun,55,25,30,0.00030010003334444816,0.0003554054954574735,0.5454545454545454
3561,3561,대상/Noun,55,25,30,0.00030010003334444816,0.0003554054954574735,0.5454545454545454
3562,3562,마디/Noun,55,25,30,0.00030010003334444816,0.0003554054954574735,0.5454545454545454
3563,3563,픽션/Noun,55,25,30,0.00030010003334444816,0.0003554054954574735,0.5454545454545454
3564,3564,람보/Noun,55,30,25,0.00035567411359342004,0.0002998733867922433,0.5454545454545454
3565,3565,지극히/Adverb,55,29,26,0.0003445592975436257,0.00031097980852528933,0.5272727272727272
3566,3566,완죤/Noun,55,28,27,0.0003334444814938313,0.00032208623025833537,0.509090909090909
3567,3567,준영/Noun,55,27,28,0.00032232966544403684,0.0003331926519913814,0.509090909090909
3568,3568,외로움/Noun,54,52,2,0.0006002000666888963,4.4425686932184186e-05,0.9629629629629628
3569,3569,흑역사/Noun,54,2,52,4.445926419917751e-05,0.0005997467735844866,0.9629629629629628
3570,3570,개꿀잼/Noun,54,51,3,0.000589085250639102,5.553210866523024e-05,0.9444444444444444
3571,3571,쪽팔리다/Verb,54,6,48,8.891852839835501e-05,0.0005553210866523023,0.8888888888888888
3572,3572,3분/Number,54,8,46,0.00011114816049794375,0.0005331082431862101,0.8518518518518519
3573,3573,주행/Noun,54,46,8,0.00053351117039013,0.00011106421733046048,0.8518518518518519
3574,3574,온갖/Noun,54,9,45,0.00012226297654773814,0.0005220018214531642,0.8333333333333334
3575,3575,대역/Noun,54,10,44,0.0001333777925975325,0.0005108953997201182,0.8148148148148148
3576,3576,색채/Noun,54,43,11,0.0005001667222407468,0.0001443834825295986,0.7962962962962963
3577,3577,개발/Noun,54,12,42,0.00015560742469712126,0.0004886825562540262,0.7777777777777778
3578,3578,전라도/Noun,54,12,42,0.00015560742469712126,0.0004886825562540262,0.7777777777777778
3579,3579,차마/Noun,54,13,41,0.00016672224074691566,0.00047757613452098,0.7592592592592593
3580,3580,구경/Noun,54,13,41,0.00016672224074691566,0.00047757613452098,0.7592592592592593
3581,3581,관람객/Noun,54,14,40,0.00017783705679671002,0.000466469712787934,0.7407407407407407
3582,3582,혀/Noun,54,14,40,0.00017783705679671002,0.000466469712787934,0.7407407407407407
3583,3583,일찍/Noun,54,39,15,0.00045570745804156943,0.0001888091694617828,0.7222222222222222
3584,3584,피디/Noun,54,15,39,0.00018895187284650438,0.000455363291054888,0.7222222222222222
3585,3585,본성/Noun,54,38,16,0.000444592641991775,0.00019991559119482882,0.7037037037037037
3586,3586,말리다/Verb,54,16,38,0.0002000666888962988,0.0004442568693218419,0.7037037037037037
3587,3587,절절/Noun,54,38,16,0.000444592641991775,0.00019991559119482882,0.7037037037037037
3588,3588,기용/Noun,54,16,38,0.0002000666888962988,0.0004442568693218419,0.7037037037037037
3589,3589,살기/Noun,54,38,16,0.000444592641991775,0.00019991559119482882,0.7037037037037037
3590,3590,크리스/Noun,54,38,16,0.000444592641991775,0.00019991559119482882,0.7037037037037037
3591,3591,팍팍/Adverb,54,17,37,0.00021118150494609317,0.0004331504475887958,0.6851851851851852
3592,3592,거야/Eomi,54,17,37,0.00021118150494609317,0.0004331504475887958,0.6851851851851852
3593,3593,차태현/Noun,54,37,17,0.0004334778259419807,0.0002110220129278749,0.6851851851851852
3594,3594,그나저나/Adverb,54,35,19,0.0004112481938423919,0.000233234856393967,0.6481481481481481
3595,3595,권/Noun,54,35,19,0.0004112481938423919,0.000233234856393967,0.6481481481481481
3596,3596,가기/Noun,54,20,34,0.00024452595309547634,0.00039983118238965764,0.6296296296296297
3597,3597,잭슨/Noun,54,34,20,0.0004001333777925976,0.00024434127812701304,0.6296296296296297
3598,3598,거대하다/Adjective,54,34,20,0.0004001333777925976,0.00024434127812701304,0.6296296296296297
3599,3599,버그/Noun,54,34,20,0.0004001333777925976,0.00024434127812701304,0.6296296296296297
3600,3600,밟다/Verb,54,21,33,0.00025564076914527065,0.00038872476065661166,0.6111111111111112
3601,3601,상관/Noun,54,21,33,0.00025564076914527065,0.00038872476065661166,0.6111111111111112
3602,3602,격/Noun,54,21,33,0.00025564076914527065,0.00038872476065661166,0.6111111111111112
3603,3603,다운로드/Noun,54,21,33,0.00025564076914527065,0.00038872476065661166,0.6111111111111112
3604,3604,밀리다/Verb,54,22,32,0.000266755585195065,0.0003776183389235656,0.5925925925925926
3605,3605,가안/Noun,54,22,32,0.000266755585195065,0.0003776183389235656,0.5925925925925926
3606,3606,호감/Noun,54,32,22,0.00037790374569300877,0.00026655412159310506,0.5925925925925926
3607,3607,마블/Noun,54,31,23,0.00036678892964321435,0.00027766054332615115,0.5740740740740741
3608,3608,막상/Noun,54,24,30,0.0002889852172946538,0.0003554054954574735,0.5555555555555556
3609,3609,픽사/Noun,54,25,29,0.00030010003334444816,0.00034429907372442745,0.5370370370370371
3610,3610,만큼의/Josa,54,29,25,0.0003445592975436257,0.0002998733867922433,0.5370370370370371
3611,3611,디젤/Noun,54,28,26,0.0003334444814938313,0.00031097980852528933,0.5185185185185185
3612,3612,ㅓ/KoreanParticle,54,26,28,0.00031121484939424253,0.0003331926519913814,0.5185185185185185
3613,3613,치료/Noun,54,26,28,0.00031121484939424253,0.0003331926519913814,0.5185185185185185
3614,3614,유지태/Noun,54,28,26,0.0003334444814938313,0.00031097980852528933,0.5185185185185185
3615,3615,냉정하다/Adjective,54,26,28,0.00031121484939424253,0.0003331926519913814,0.5185185185185185
3616,3616,중후/Noun,54,27,27,0.00032232966544403684,0.00032208623025833537,0.5
3617,3617,헛/Noun,53,5,48,7.780371234856063e-05,0.0005553210866523023,0.9056603773584906
3618,3618,팝콘/Noun,53,6,47,8.891852839835501e-05,0.0005442146649192564,0.8867924528301887
3619,3619,흐지부지/Noun,53,6,47,8.891852839835501e-05,0.0005442146649192564,0.8867924528301887
3620,3620,납치/Noun,53,7,46,0.0001000333444481494,0.0005331082431862101,0.8679245283018868
3621,3621,오유/Noun,53,7,46,0.0001000333444481494,0.0005331082431862101,0.8679245283018868
3622,3622,서정/Noun,53,45,8,0.0005223963543403357,0.00011106421733046048,0.8490566037735849
3623,3623,c/Alpha,53,8,45,0.00011114816049794375,0.0005220018214531642,0.8490566037735849
3624,3624,^^*/Punctuation,53,45,8,0.0005223963543403357,0.00011106421733046048,0.8490566037735849
3625,3625,클라라/Noun,53,9,44,0.00012226297654773814,0.0005108953997201182,0.8301886792452831
3626,3626,최민식/Noun,53,42,11,0.0004890519061909527,0.0001443834825295986,0.7924528301886793
3627,3627,벌리다/Verb,53,11,42,0.0001444926086473269,0.0004886825562540262,0.7924528301886793
3628,3628,살인자/Noun,53,11,42,0.0001444926086473269,0.0004886825562540262,0.7924528301886793
3629,3629,옛/Modifier,53,41,12,0.0004779370901411582,0.00015548990426264466,0.7735849056603774
3630,3630,나머진/Noun,53,12,41,0.00015560742469712126,0.00047757613452098,0.7735849056603774
3631,3631,눈요기/Noun,53,12,41,0.00015560742469712126,0.00047757613452098,0.7735849056603774
3632,3632,깨끗하다/Adjective,53,40,13,0.0004668222740913638,0.0001665963259956907,0.7547169811320755
3633,3633,재치/Noun,53,39,14,0.00045570745804156943,0.00017770274772873674,0.7358490566037735
3634,3634,한국어/Noun,53,14,39,0.00017783705679671002,0.000455363291054888,0.7358490566037735
3635,3635,께서/Josa,53,38,15,0.000444592641991775,0.0001888091694617828,0.7169811320754716
3636,3636,이외/Noun,53,15,38,0.00018895187284650438,0.0004442568693218419,0.7169811320754716
3637,3637,조차도/Josa,53,15,38,0.00018895187284650438,0.0004442568693218419,0.7169811320754716
3638,3638,정석/Noun,53,37,16,0.0004334778259419807,0.00019991559119482882,0.6981132075471698
3639,3639,movie/Alpha,53,37,16,0.0004334778259419807,0.00019991559119482882,0.6981132075471698
3640,3640,틀림없다/Adjective,53,37,16,0.0004334778259419807,0.00019991559119482882,0.6981132075471698
3641,3641,네/Modifier,53,16,37,0.0002000666888962988,0.0004331504475887958,0.6981132075471698
3642,3642,예고/Noun,53,16,37,0.0002000666888962988,0.0004331504475887958,0.6981132075471698
3643,3643,저렇다/Adjective,53,16,37,0.0002000666888962988,0.0004331504475887958,0.6981132075471698
3644,3644,멘탈/Noun,53,16,37,0.0002000666888962988,0.0004331504475887958,0.6981132075471698
3645,3645,1분/Number,53,17,36,0.00021118150494609317,0.0004220440258557498,0.6792452830188679
3646,3646,무의미하다/Adjective,53,17,36,0.00021118150494609317,0.0004220440258557498,0.6792452830188679
3647,3647,★/Foreign,53,35,18,0.0004112481938423919,0.00022212843466092096,0.660377358490566
3648,3648,잘알다/Verb,53,35,18,0.0004112481938423919,0.00022212843466092096,0.660377358490566
3649,3649,부터/Foreign,53,35,18,0.0004112481938423919,0.00022212843466092096,0.660377358490566
3650,3650,레옹/Noun,53,18,35,0.0002222963209958875,0.0004109376041227037,0.660377358490566
3651,3651,신도/Noun,53,18,35,0.0002222963209958875,0.0004109376041227037,0.660377358490566
3652,3652,볼걸/Noun,53,18,35,0.0002222963209958875,0.0004109376041227037,0.660377358490566
3653,3653,일리/Noun,53,34,19,0.0004001333777925976,0.000233234856393967,0.6415094339622641
3654,3654,긴박/Noun,53,19,34,0.0002334111370456819,0.00039983118238965764,0.6415094339622641
3655,3655,이의/Noun,53,33,20,0.00038901856174280313,0.00024434127812701304,0.6226415094339622
3656,3656,꼽히다/Verb,53,33,20,0.00038901856174280313,0.00024434127812701304,0.6226415094339622
3657,3657,태도/Noun,53,20,33,0.00024452595309547634,0.00038872476065661166,0.6226415094339622
3658,3658,감옥/Noun,53,21,32,0.00025564076914527065,0.0003776183389235656,0.6037735849056604
3659,3659,할배/Noun,53,21,32,0.00025564076914527065,0.0003776183389235656,0.6037735849056604
3660,3660,사귀다/Verb,53,21,32,0.00025564076914527065,0.0003776183389235656,0.6037735849056604
3661,3661,신데렐라/Noun,53,22,31,0.000266755585195065,0.00036651191719051963,0.5849056603773585
3662,3662,꺼내다/Verb,53,31,22,0.00036678892964321435,0.00026655412159310506,0.5849056603773585
3663,3663,작전/Noun,53,22,31,0.000266755585195065,0.00036651191719051963,0.5849056603773585
3664,3664,공원/Noun,53,22,31,0.000266755585195065,0.00036651191719051963,0.5849056603773585
3665,3665,어서/Noun,53,31,22,0.00036678892964321435,0.00026655412159310506,0.5849056603773585
3666,3666,프리/Noun,53,31,22,0.00036678892964321435,0.00026655412159310506,0.5849056603773585
3667,3667,당/Noun,53,30,23,0.00035567411359342004,0.00027766054332615115,0.5660377358490566
3668,3668,꾸미다/Verb,53,30,23,0.00035567411359342004,0.00027766054332615115,0.5660377358490566
3669,3669,늑대/Noun,53,24,29,0.0002889852172946538,0.00034429907372442745,0.5471698113207547
3670,3670,마법/Noun,53,29,24,0.0003445592975436257,0.0002887669650591972,0.5471698113207547
3671,3671,반지/Noun,53,29,24,0.0003445592975436257,0.0002887669650591972,0.5471698113207547
3672,3672,함부로/Noun,53,25,28,0.00030010003334444816,0.0003331926519913814,0.5283018867924528
3673,3673,외치다/Verb,53,25,28,0.00030010003334444816,0.0003331926519913814,0.5283018867924528
3674,3674,러브스토리/Noun,53,28,25,0.0003334444814938313,0.0002998733867922433,0.5283018867924528
3675,3675,마을/Noun,53,26,27,0.00031121484939424253,0.00032208623025833537,0.5094339622641509
3676,3676,기록/Noun,53,26,27,0.00031121484939424253,0.00032208623025833537,0.5094339622641509
3677,3677,크리스찬/Noun,53,27,26,0.00032232966544403684,0.00031097980852528933,0.5094339622641509
3678,3678,집단/Noun,53,27,26,0.00032232966544403684,0.00031097980852528933,0.5094339622641509
3679,3679,...;;/Punctuation,52,4,48,6.668889629876625e-05,0.0005553210866523023,0.9230769230769232
3680,3680,ㅗ/KoreanParticle,52,7,45,0.0001000333444481494,0.0005220018214531642,0.8653846153846154
3681,3681,엉터리/Noun,52,7,45,0.0001000333444481494,0.0005220018214531642,0.8653846153846154
3682,3682,성찰/Noun,52,43,9,0.0005001667222407468,0.00012217063906350652,0.8269230769230769
3683,3683,모방/Noun,52,10,42,0.0001333777925975325,0.0004886825562540262,0.8076923076923077
3684,3684,매주/Adverb,52,42,10,0.0004890519061909527,0.00013327706079655256,0.8076923076923077
3685,3685,파라/Noun,52,11,41,0.0001444926086473269,0.00047757613452098,0.7884615384615384
3686,3686,더니/Noun,52,11,41,0.0001444926086473269,0.00047757613452098,0.7884615384615384
3687,3687,안남/Noun,52,13,39,0.00016672224074691566,0.000455363291054888,0.75
3688,3688,어쩌다/Adverb,52,13,39,0.00016672224074691566,0.000455363291054888,0.75
3689,3689,노튼/Noun,52,38,14,0.000444592641991775,0.00017770274772873674,0.7307692307692307
3690,3690,베이/Noun,52,38,14,0.000444592641991775,0.00017770274772873674,0.7307692307692307
3691,3691,!?/Punctuation,52,15,37,0.00018895187284650438,0.0004331504475887958,0.7115384615384616
3692,3692,펼쳐지다/Verb,52,37,15,0.0004334778259419807,0.0001888091694617828,0.7115384615384616
3693,3693,고어/Noun,52,16,36,0.0002000666888962988,0.0004220440258557498,0.6923076923076923
3694,3694,어딜/Adverb,52,17,35,0.00021118150494609317,0.0004109376041227037,0.6730769230769231
3695,3695,빨갛다/Adjective,52,35,17,0.0004112481938423919,0.0002110220129278749,0.6730769230769231
3696,3696,수없이/Adverb,52,17,35,0.00021118150494609317,0.0004109376041227037,0.6730769230769231
3697,3697,몇개/Noun,52,18,34,0.0002222963209958875,0.00039983118238965764,0.6538461538461539
3698,3698,조명/Noun,52,34,18,0.0004001333777925976,0.00022212843466092096,0.6538461538461539
3699,3699,주네/Noun,52,34,18,0.0004001333777925976,0.00022212843466092096,0.6538461538461539
3700,3700,금지/Noun,52,19,33,0.0002334111370456819,0.00038872476065661166,0.6346153846153846
3701,3701,예수/Noun,52,19,33,0.0002334111370456819,0.00038872476065661166,0.6346153846153846
3702,3702,커피/Noun,52,33,19,0.00038901856174280313,0.000233234856393967,0.6346153846153846
3703,3703,불만/Noun,52,20,32,0.00024452595309547634,0.0003776183389235656,0.6153846153846154
3704,3704,장이/Suffix,52,20,32,0.00024452595309547634,0.0003776183389235656,0.6153846153846154
3705,3705,헉/Adverb,52,20,32,0.00024452595309547634,0.0003776183389235656,0.6153846153846154
3706,3706,MBC/Alpha,52,20,32,0.00024452595309547634,0.0003776183389235656,0.6153846153846154
3707,3707,성유리/Noun,52,32,20,0.00037790374569300877,0.00024434127812701304,0.6153846153846154
3708,3708,일수/Noun,52,31,21,0.00036678892964321435,0.0002554476998600591,0.5961538461538461
3709,3709,님들/Noun,52,21,31,0.00025564076914527065,0.00036651191719051963,0.5961538461538461
3710,3710,여유/Noun,52,31,21,0.00036678892964321435,0.0002554476998600591,0.5961538461538461
3711,3711,국제/Noun,52,30,22,0.00035567411359342004,0.00026655412159310506,0.5769230769230769
3712,3712,인도영화/Noun,52,30,22,0.00035567411359342004,0.00026655412159310506,0.5769230769230769
3713,3713,라스/Noun,52,29,23,0.0003445592975436257,0.00027766054332615115,0.5576923076923077
3714,3714,경악/Noun,52,23,29,0.00027787040124485944,0.00034429907372442745,0.5576923076923077
3715,3715,극본/Noun,52,23,29,0.00027787040124485944,0.00034429907372442745,0.5576923076923077
3716,3716,또는/Adverb,52,24,28,0.0002889852172946538,0.0003331926519913814,0.5384615384615384
3717,3717,실상/Noun,52,24,28,0.0002889852172946538,0.0003331926519913814,0.5384615384615384
3718,3718,비참하다/Adjective,52,28,24,0.0003334444814938313,0.0002887669650591972,0.5384615384615384
3719,3719,지네/Noun,52,26,26,0.00031121484939424253,0.00031097980852528933,0.5
3720,3720,끈/Noun,52,26,26,0.00031121484939424253,0.00031097980852528933,0.5
3721,3721,어수선하다/Adjective,51,3,48,5.5574080248971876e-05,0.0005553210866523023,0.9411764705882352
3722,3722,저급하다/Adjective,51,5,46,7.780371234856063e-05,0.0005331082431862101,0.9019607843137256
3723,3723,씨발/Noun,51,5,46,7.780371234856063e-05,0.0005331082431862101,0.9019607843137256
3724,3724,가관/Noun,51,6,45,8.891852839835501e-05,0.0005220018214531642,0.8823529411764706
3725,3725,불필요하다/Adjective,51,7,44,0.0001000333444481494,0.0005108953997201182,0.8627450980392157
3726,3726,.!/Punctuation,51,44,7,0.0005112815382905413,9.995779559741441e-05,0.8627450980392157
3727,3727,양반/Noun,51,8,43,0.00011114816049794375,0.0004997889779870722,0.8431372549019608
3728,3728,파이팅/Noun,51,42,9,0.0004890519061909527,0.00012217063906350652,0.8235294117647058
3729,3729,뚝뚝/Noun,51,9,42,0.00012226297654773814,0.0004886825562540262,0.8235294117647058
3730,3730,땡/Noun,51,9,42,0.00012226297654773814,0.0004886825562540262,0.8235294117647058
3731,3731,모두/Modifier,51,40,11,0.0004668222740913638,0.0001443834825295986,0.7843137254901961
3732,3732,잠자다/Verb,51,11,40,0.0001444926086473269,0.000466469712787934,0.7843137254901961
3733,3733,덜덜/Noun,51,40,11,0.0004668222740913638,0.0001443834825295986,0.7843137254901961
3734,3734,먼지/Noun,51,12,39,0.00015560742469712126,0.000455363291054888,0.7647058823529411
3735,3735,임청하/Noun,51,39,12,0.00045570745804156943,0.00015548990426264466,0.7647058823529411
3736,3736,다니엘/Noun,51,39,12,0.00045570745804156943,0.00015548990426264466,0.7647058823529411
3737,3737,불과하다/Adjective,51,14,37,0.00017783705679671002,0.0004331504475887958,0.7254901960784313
3738,3738,피식/Adverb,51,15,36,0.00018895187284650438,0.0004220440258557498,0.7058823529411765
3739,3739,텐데/Eomi,51,16,35,0.0002000666888962988,0.0004109376041227037,0.6862745098039216
3740,3740,마틴/Noun,51,35,16,0.0004112481938423919,0.00019991559119482882,0.6862745098039216
3741,3741,첩보/Noun,51,35,16,0.0004112481938423919,0.00019991559119482882,0.6862745098039216
3742,3742,취급/Noun,51,17,34,0.00021118150494609317,0.00039983118238965764,0.6666666666666666
3743,3743,허구/Noun,51,18,33,0.0002222963209958875,0.00038872476065661166,0.6470588235294118
3744,3744,vs/Alpha,51,18,33,0.0002222963209958875,0.00038872476065661166,0.6470588235294118
3745,3745,흔적/Noun,51,18,33,0.0002222963209958875,0.00038872476065661166,0.6470588235294118
3746,3746,7.5/Number,51,33,18,0.00038901856174280313,0.00022212843466092096,0.6470588235294118
3747,3747,리스/Noun,51,32,19,0.00037790374569300877,0.000233234856393967,0.6274509803921569
3748,3748,이은주/Noun,51,32,19,0.00037790374569300877,0.000233234856393967,0.6274509803921569
3749,3749,7년/Number,51,31,20,0.00036678892964321435,0.00024434127812701304,0.6078431372549019
3750,3750,생기/Noun,51,20,31,0.00024452595309547634,0.00036651191719051963,0.6078431372549019
3751,3751,와중/Noun,51,20,31,0.00024452595309547634,0.00036651191719051963,0.6078431372549019
3752,3752,장치/Noun,51,30,21,0.00035567411359342004,0.0002554476998600591,0.5882352941176471
3753,3753,밖엔/Josa,51,21,30,0.00025564076914527065,0.0003554054954574735,0.5882352941176471
3754,3754,후기/Noun,51,21,30,0.00025564076914527065,0.0003554054954574735,0.5882352941176471
3755,3755,체험/Noun,51,21,30,0.00025564076914527065,0.0003554054954574735,0.5882352941176471
3756,3756,파악/Noun,51,21,30,0.00025564076914527065,0.0003554054954574735,0.5882352941176471
3757,3757,간/Foreign,51,22,29,0.000266755585195065,0.00034429907372442745,0.5686274509803921
3758,3758,특/Noun,51,29,22,0.0003445592975436257,0.00026655412159310506,0.5686274509803921
3759,3759,누/Noun,51,22,29,0.000266755585195065,0.00034429907372442745,0.5686274509803921
3760,3760,장동건/Noun,51,22,29,0.000266755585195065,0.00034429907372442745,0.5686274509803921
3761,3761,활동/Noun,51,22,29,0.000266755585195065,0.00034429907372442745,0.5686274509803921
3762,3762,답지/Noun,51,24,27,0.0002889852172946538,0.00032208623025833537,0.5294117647058824
3763,3763,전투씬/Noun,51,25,26,0.00030010003334444816,0.00031097980852528933,0.5098039215686274
3764,3764,지인/Noun,51,26,25,0.00031121484939424253,0.0002998733867922433,0.5098039215686274
3765,3765,이/Modifier,51,26,25,0.00031121484939424253,0.0002998733867922433,0.5098039215686274
3766,3766,어중간하다/Adjective,50,2,48,4.445926419917751e-05,0.0005553210866523023,0.96
3767,3767,어쩌라고/Adverb,50,3,47,5.5574080248971876e-05,0.0005442146649192564,0.94
3768,3768,극혐/Noun,50,5,45,7.780371234856063e-05,0.0005220018214531642,0.9
3769,3769,전해지다/Verb,50,43,7,0.0005001667222407468,9.995779559741441e-05,0.86
3770,3770,재수없다/Adjective,50,8,42,0.00011114816049794375,0.0004886825562540262,0.84
3771,3771,위원회/Noun,50,8,42,0.00011114816049794375,0.0004886825562540262,0.84
3772,3772,어의/Noun,50,9,41,0.00012226297654773814,0.00047757613452098,0.82
3773,3773,절묘하다/Adjective,50,39,11,0.00045570745804156943,0.0001443834825295986,0.78
3774,3774,먹히다/Verb,50,12,38,0.00015560742469712126,0.0004442568693218419,0.76
3775,3775,연주/Noun,50,38,12,0.000444592641991775,0.00015548990426264466,0.76
3776,3776,이연희/Noun,50,37,13,0.0004334778259419807,0.0001665963259956907,0.74
3777,3777,생존/Noun,50,36,14,0.00042236300989218633,0.00017770274772873674,0.72
3778,3778,망설이다/Verb,50,36,14,0.00042236300989218633,0.00017770274772873674,0.72
3779,3779,원피스/Noun,50,36,14,0.00042236300989218633,0.00017770274772873674,0.72
3780,3780,역다/Adjective,50,14,36,0.00017783705679671002,0.0004220440258557498,0.72
3781,3781,여기저기/Noun,50,14,36,0.00017783705679671002,0.0004220440258557498,0.72
3782,3782,에드워드/Noun,50,35,15,0.0004112481938423919,0.0001888091694617828,0.7
3783,3783,고스/Noun,50,35,15,0.0004112481938423919,0.0001888091694617828,0.7
3784,3784,강력하다/Adjective,50,34,16,0.0004001333777925976,0.00019991559119482882,0.68
3785,3785,오우삼/Noun,50,17,33,0.00021118150494609317,0.00038872476065661166,0.66
3786,3786,안성기/Noun,50,33,17,0.00038901856174280313,0.0002110220129278749,0.66
3787,3787,까지/Foreign,50,17,33,0.00021118150494609317,0.00038872476065661166,0.66
3788,3788,전도연/Noun,50,33,17,0.00038901856174280313,0.0002110220129278749,0.66
3789,3789,엿보다/Verb,50,33,17,0.00038901856174280313,0.0002110220129278749,0.66
3790,3790,영광/Noun,50,33,17,0.00038901856174280313,0.0002110220129278749,0.66
3791,3791,바쁘다/Adjective,50,17,33,0.00021118150494609317,0.00038872476065661166,0.66
3792,3792,전화/Noun,50,17,33,0.00021118150494609317,0.00038872476065661166,0.66
3793,3793,닷/Noun,50,33,17,0.00038901856174280313,0.0002110220129278749,0.66
3794,3794,증명/Noun,50,18,32,0.0002222963209958875,0.0003776183389235656,0.64
3795,3795,구도/Noun,50,18,32,0.0002222963209958875,0.0003776183389235656,0.64
3796,3796,종합/Noun,50,18,32,0.0002222963209958875,0.0003776183389235656,0.64
3797,3797,검사/Noun,50,19,31,0.0002334111370456819,0.00036651191719051963,0.62
3798,3798,소지섭/Noun,50,31,19,0.00036678892964321435,0.000233234856393967,0.62
3799,3799,추구/Noun,50,31,19,0.00036678892964321435,0.000233234856393967,0.62
3800,3800,로버츠/Noun,50,30,20,0.00035567411359342004,0.00024434127812701304,0.6
3801,3801,카메론/Noun,50,30,20,0.00035567411359342004,0.00024434127812701304,0.6
3802,3802,장근석/Noun,50,20,30,0.00024452595309547634,0.0003554054954574735,0.6
3803,3803,언론/Noun,50,30,20,0.00035567411359342004,0.00024434127812701304,0.6
3804,3804,구혜선/Noun,50,20,30,0.00024452595309547634,0.0003554054954574735,0.6
3805,3805,나니/Noun,50,29,21,0.0003445592975436257,0.0002554476998600591,0.58
3806,3806,유의/Noun,50,29,21,0.0003445592975436257,0.0002554476998600591,0.58
3807,3807,역활/Noun,50,22,28,0.000266755585195065,0.0003331926519913814,0.56
3808,3808,죽지/Noun,50,28,22,0.0003334444814938313,0.00026655412159310506,0.56
3809,3809,심정/Noun,50,22,28,0.000266755585195065,0.0003331926519913814,0.56
3810,3810,멤버/Noun,50,28,22,0.0003334444814938313,0.00026655412159310506,0.56
3811,3811,댄스/Noun,50,22,28,0.000266755585195065,0.0003331926519913814,0.56
3812,3812,지적/Noun,50,28,22,0.0003334444814938313,0.00026655412159310506,0.56
3813,3813,출발/Noun,50,23,27,0.00027787040124485944,0.00032208623025833537,0.54
3814,3814,단역/Noun,50,24,26,0.0002889852172946538,0.00031097980852528933,0.52
3815,3815,스페인/Noun,50,26,24,0.00031121484939424253,0.0002887669650591972,0.52
3816,3816,서양/Noun,50,24,26,0.0002889852172946538,0.00031097980852528933,0.52
3817,3817,곰/Noun,50,26,24,0.00031121484939424253,0.0002887669650591972,0.52
3818,3818,자격/Noun,50,25,25,0.00030010003334444816,0.0002998733867922433,0.5
3819,3819,2.22/Number,49,0,49,2.2229632099588756e-05,0.0005664275083853486,1.0
3820,3820,선율/Noun,49,47,2,0.0005446259864399244,4.4425686932184186e-05,0.9591836734693876
3821,3821,접함/Noun,49,3,46,5.5574080248971876e-05,0.0005331082431862101,0.9387755102040816
3822,3822,김구라/Noun,49,3,46,5.5574080248971876e-05,0.0005331082431862101,0.9387755102040816
3823,3823,지저분하다/Adjective,49,3,46,5.5574080248971876e-05,0.0005331082431862101,0.9387755102040816
3824,3824,배속/Noun,49,4,45,6.668889629876625e-05,0.0005220018214531642,0.9183673469387756
3825,3825,유쾌/Noun,49,45,4,0.0005223963543403357,6.663853039827628e-05,0.9183673469387756
3826,3826,전락/Noun,49,5,44,7.780371234856063e-05,0.0005108953997201182,0.8979591836734694
3827,3827,뽕짝/Noun,49,5,44,7.780371234856063e-05,0.0005108953997201182,0.8979591836734694
3828,3828,부드럽다/Adjective,49,43,6,0.0005001667222407468,8.885137386436837e-05,0.8775510204081632
3829,3829,사기꾼/Noun,49,6,43,8.891852839835501e-05,0.0004997889779870722,0.8775510204081632
3830,3830,스킵/Noun,49,6,43,8.891852839835501e-05,0.0004997889779870722,0.8775510204081632
3831,3831,무리수/Noun,49,6,43,8.891852839835501e-05,0.0004997889779870722,0.8775510204081632
3832,3832,두려움/Noun,49,43,6,0.0005001667222407468,8.885137386436837e-05,0.8775510204081632
3833,3833,재주/Noun,49,8,41,0.00011114816049794375,0.00047757613452098,0.8367346938775511
3834,3834,감기/Noun,49,9,40,0.00012226297654773814,0.000466469712787934,0.8163265306122449
3835,3835,애로/Noun,49,9,40,0.00012226297654773814,0.000466469712787934,0.8163265306122449
3836,3836,시스/Noun,49,40,9,0.0004668222740913638,0.00012217063906350652,0.8163265306122449
3837,3837,록키/Noun,49,39,10,0.00045570745804156943,0.00013327706079655256,0.7959183673469388
3838,3838,The/Alpha,49,39,10,0.00045570745804156943,0.00013327706079655256,0.7959183673469388
3839,3839,스키/Noun,49,38,11,0.000444592641991775,0.0001443834825295986,0.7755102040816326
3840,3840,한두/Modifier,49,11,38,0.0001444926086473269,0.0004442568693218419,0.7755102040816326
3841,3841,흉내내/Noun,49,12,37,0.00015560742469712126,0.0004331504475887958,0.7551020408163265
3842,3842,뜯다/Verb,49,12,37,0.00015560742469712126,0.0004331504475887958,0.7551020408163265
3843,3843,튀어나오다/Verb,49,12,37,0.00015560742469712126,0.0004331504475887958,0.7551020408163265
3844,3844,경의/Noun,49,36,13,0.00042236300989218633,0.0001665963259956907,0.7346938775510204
3845,3845,간직/Noun,49,36,13,0.00042236300989218633,0.0001665963259956907,0.7346938775510204
3846,3846,무색/Noun,49,15,34,0.00018895187284650438,0.00039983118238965764,0.6938775510204082
3847,3847,이탈리아/Noun,49,33,16,0.00038901856174280313,0.00019991559119482882,0.6734693877551021
3848,3848,고치다/Verb,49,16,33,0.0002000666888962988,0.00038872476065661166,0.6734693877551021
3849,3849,충/Noun,49,16,33,0.0002000666888962988,0.00038872476065661166,0.6734693877551021
3850,3850,목사/Noun,49,32,17,0.00037790374569300877,0.0002110220129278749,0.6530612244897959
3851,3851,이웃/Noun,49,17,32,0.00021118150494609317,0.0003776183389235656,0.6530612244897959
3852,3852,셋/Noun,49,17,32,0.00021118150494609317,0.0003776183389235656,0.6530612244897959
3853,3853,일생/Noun,49,32,17,0.00037790374569300877,0.0002110220129278749,0.6530612244897959
3854,3854,홍/Noun,49,18,31,0.0002222963209958875,0.00036651191719051963,0.6326530612244898
3855,3855,학살/Noun,49,18,31,0.0002222963209958875,0.00036651191719051963,0.6326530612244898
3856,3856,저절로/Noun,49,30,19,0.00035567411359342004,0.000233234856393967,0.6122448979591837
3857,3857,로망/Noun,49,30,19,0.00035567411359342004,0.000233234856393967,0.6122448979591837
3858,3858,품/Noun,49,29,20,0.0003445592975436257,0.00024434127812701304,0.5918367346938775
3859,3859,왕가위/Noun,49,29,20,0.0003445592975436257,0.00024434127812701304,0.5918367346938775
3860,3860,아시/Noun,49,29,20,0.0003445592975436257,0.00024434127812701304,0.5918367346938775
3861,3861,락/Noun,49,20,29,0.00024452595309547634,0.00034429907372442745,0.5918367346938775
3862,3862,도로/Noun,49,20,29,0.00024452595309547634,0.00034429907372442745,0.5918367346938775
3863,3863,예술가/Noun,49,29,20,0.0003445592975436257,0.00024434127812701304,0.5918367346938775
3864,3864,초기/Noun,49,20,29,0.00024452595309547634,0.00034429907372442745,0.5918367346938775
3865,3865,직/Noun,49,20,29,0.00024452595309547634,0.00034429907372442745,0.5918367346938775
3866,3866,비슷/Noun,49,21,28,0.00025564076914527065,0.0003331926519913814,0.5714285714285714
3867,3867,말르다/Adjective,49,21,28,0.00025564076914527065,0.0003331926519913814,0.5714285714285714
3868,3868,양조위/Noun,49,28,21,0.0003334444814938313,0.0002554476998600591,0.5714285714285714
3869,3869,월/Noun,49,28,21,0.0003334444814938313,0.0002554476998600591,0.5714285714285714
3870,3870,.(/Punctuation,49,22,27,0.000266755585195065,0.00032208623025833537,0.5510204081632653
3871,3871,채다/Verb,49,22,27,0.000266755585195065,0.00032208623025833537,0.5510204081632653
3872,3872,모순/Noun,49,27,22,0.00032232966544403684,0.00026655412159310506,0.5510204081632653
3873,3873,ㅇㅇㅇ/KoreanParticle,49,26,23,0.00031121484939424253,0.00027766054332615115,0.5306122448979592
3874,3874,올라오다/Verb,49,26,23,0.00031121484939424253,0.00027766054332615115,0.5306122448979592
3875,3875,자아/Noun,49,23,26,0.00027787040124485944,0.00031097980852528933,0.5306122448979592
3876,3876,테/Noun,49,26,23,0.00031121484939424253,0.00027766054332615115,0.5306122448979592
3877,3877,양/Noun,49,23,26,0.00027787040124485944,0.00031097980852528933,0.5306122448979592
3878,3878,지배/Noun,49,25,24,0.00030010003334444816,0.0002887669650591972,0.5102040816326531
3879,3879,미야자키/Noun,49,25,24,0.00030010003334444816,0.0002887669650591972,0.5102040816326531
3880,3880,내보내다/Verb,48,1,47,3.334444814938313e-05,0.0005442146649192564,0.9791666666666666
3881,3881,주옥/Noun,48,47,1,0.0005446259864399244,3.331926519913814e-05,0.9791666666666666
3882,3882,파워레인저/Noun,48,5,43,7.780371234856063e-05,0.0004997889779870722,0.8958333333333334
3883,3883,엉엉/Noun,48,41,7,0.0004779370901411582,9.995779559741441e-05,0.8541666666666666
3884,3884,이예/Noun,48,40,8,0.0004668222740913638,0.00011106421733046048,0.8333333333333334
3885,3885,그땐/Noun,48,40,8,0.0004668222740913638,0.00011106421733046048,0.8333333333333334
3886,3886,이혼/Noun,48,8,40,0.00011114816049794375,0.000466469712787934,0.8333333333333334
3887,3887,나빠지다/Verb,48,9,39,0.00012226297654773814,0.000455363291054888,0.8125
3888,3888,과잉/Noun,48,9,39,0.00012226297654773814,0.000455363291054888,0.8125
3889,3889,카피/Noun,48,9,39,0.00012226297654773814,0.000455363291054888,0.8125
3890,3890,노골/Noun,48,11,37,0.0001444926086473269,0.0004331504475887958,0.7708333333333334
3891,3891,젖다/Verb,48,36,12,0.00042236300989218633,0.00015548990426264466,0.75
3892,3892,8.5/Number,48,36,12,0.00042236300989218633,0.00015548990426264466,0.75
3893,3893,미국인/Noun,48,13,35,0.00016672224074691566,0.0004109376041227037,0.7291666666666666
3894,3894,품다/Verb,48,35,13,0.0004112481938423919,0.0001665963259956907,0.7291666666666666
3895,3895,려/Noun,48,13,35,0.00016672224074691566,0.0004109376041227037,0.7291666666666666
3896,3896,대고/Noun,48,14,34,0.00017783705679671002,0.00039983118238965764,0.7083333333333334
3897,3897,화판/Noun,48,14,34,0.00017783705679671002,0.00039983118238965764,0.7083333333333334
3898,3898,대감/Noun,48,14,34,0.00017783705679671002,0.00039983118238965764,0.7083333333333334
3899,3899,흥분/Noun,48,34,14,0.0004001333777925976,0.00017770274772873674,0.7083333333333334
3900,3900,마케팅/Noun,48,15,33,0.00018895187284650438,0.00038872476065661166,0.6875
3901,3901,한정/Noun,48,32,16,0.00037790374569300877,0.00019991559119482882,0.6666666666666666
3902,3902,아이러니/Noun,48,31,17,0.00036678892964321435,0.0002110220129278749,0.6458333333333334
3903,3903,따라오다/Verb,48,31,17,0.00036678892964321435,0.0002110220129278749,0.6458333333333334
3904,3904,송혜교/Noun,48,17,31,0.00021118150494609317,0.00036651191719051963,0.6458333333333334
3905,3905,신세경/Noun,48,17,31,0.00021118150494609317,0.00036651191719051963,0.6458333333333334
3906,3906,위기/Noun,48,17,31,0.00021118150494609317,0.00036651191719051963,0.6458333333333334
3907,3907,침묵/Noun,48,30,18,0.00035567411359342004,0.00022212843466092096,0.625
3908,3908,송지효/Noun,48,30,18,0.00035567411359342004,0.00022212843466092096,0.625
3909,3909,일요일/Noun,48,30,18,0.00035567411359342004,0.00022212843466092096,0.625
3910,3910,주원/Noun,48,30,18,0.00035567411359342004,0.00022212843466092096,0.625
3911,3911,저주/Noun,48,18,30,0.0002222963209958875,0.0003554054954574735,0.625
3912,3912,마르/Noun,48,29,19,0.0003445592975436257,0.000233234856393967,0.6041666666666666
3913,3913,지고/Noun,48,29,19,0.0003445592975436257,0.000233234856393967,0.6041666666666666
3914,3914,고자/Noun,48,19,29,0.0002334111370456819,0.00034429907372442745,0.6041666666666666
3915,3915,이구/Noun,48,28,20,0.0003334444814938313,0.00024434127812701304,0.5833333333333334
3916,3916,후속/Noun,48,28,20,0.0003334444814938313,0.00024434127812701304,0.5833333333333334
3917,3917,쏟아지다/Verb,48,28,20,0.0003334444814938313,0.00024434127812701304,0.5833333333333334
3918,3918,째다/Verb,48,20,28,0.00024452595309547634,0.0003331926519913814,0.5833333333333334
3919,3919,물건/Noun,48,20,28,0.00024452595309547634,0.0003331926519913814,0.5833333333333334
3920,3920,유우/Noun,48,20,28,0.00024452595309547634,0.0003331926519913814,0.5833333333333334
3921,3921,로다/Josa,48,21,27,0.00025564076914527065,0.00032208623025833537,0.5625
3922,3922,불안하다/Adjective,48,27,21,0.00032232966544403684,0.0002554476998600591,0.5625
3923,3923,증거/Noun,48,21,27,0.00025564076914527065,0.00032208623025833537,0.5625
3924,3924,줄리아/Noun,48,22,26,0.000266755585195065,0.00031097980852528933,0.5416666666666666
3925,3925,극/Noun,48,22,26,0.000266755585195065,0.00031097980852528933,0.5416666666666666
3926,3926,들보/Noun,48,22,26,0.000266755585195065,0.00031097980852528933,0.5416666666666666
3927,3927,알리다/Verb,48,25,23,0.00030010003334444816,0.00027766054332615115,0.5208333333333334
3928,3928,시간대/Noun,48,23,25,0.00027787040124485944,0.0002998733867922433,0.5208333333333334
3929,3929,긍정/Noun,48,25,23,0.00030010003334444816,0.00027766054332615115,0.5208333333333334
3930,3930,토끼/Noun,48,24,24,0.0002889852172946538,0.0002887669650591972,0.5
3931,3931,고도/Noun,48,24,24,0.0002889852172946538,0.0002887669650591972,0.5
3932,3932,조악하다/Adjective,47,1,46,3.334444814938313e-05,0.0005331082431862101,0.9787234042553192
3933,3933,낚였/Noun,47,1,46,3.334444814938313e-05,0.0005331082431862101,0.9787234042553192
3934,3934,졸잼/Noun,47,43,4,0.0005001667222407468,6.663853039827628e-05,0.9148936170212766
3935,3935,클리셰/Noun,47,5,42,7.780371234856063e-05,0.0004886825562540262,0.8936170212765957
3936,3936,이스트/Noun,47,41,6,0.0004779370901411582,8.885137386436837e-05,0.8723404255319149
3937,3937,구역/Noun,47,8,39,0.00011114816049794375,0.000455363291054888,0.8297872340425532
3938,3938,구려/Noun,47,8,39,0.00011114816049794375,0.000455363291054888,0.8297872340425532
3939,3939,만날/Noun,47,38,9,0.000444592641991775,0.00012217063906350652,0.8085106382978723
3940,3940,대가리/Noun,47,9,38,0.00012226297654773814,0.0004442568693218419,0.8085106382978723
3941,3941,인척/Noun,47,10,37,0.0001333777925975325,0.0004331504475887958,0.7872340425531915
3942,3942,환장하다/Adjective,47,10,37,0.0001333777925975325,0.0004331504475887958,0.7872340425531915
3943,3943,-_-;/Punctuation,47,12,35,0.00015560742469712126,0.0004109376041227037,0.7446808510638298
3944,3944,타령/Noun,47,12,35,0.00015560742469712126,0.0004109376041227037,0.7446808510638298
3945,3945,하드/Noun,47,13,34,0.00016672224074691566,0.00039983118238965764,0.7234042553191491
3946,3946,면도/Noun,47,33,14,0.00038901856174280313,0.00017770274772873674,0.7021276595744681
3947,3947,붉다/Adjective,47,33,14,0.00038901856174280313,0.00017770274772873674,0.7021276595744681
3948,3948,조승우/Noun,47,33,14,0.00038901856174280313,0.00017770274772873674,0.7021276595744681
3949,3949,별다르다/Adjective,47,14,33,0.00017783705679671002,0.00038872476065661166,0.7021276595744681
3950,3950,시사/Noun,47,33,14,0.00038901856174280313,0.00017770274772873674,0.7021276595744681
3951,3951,도라에몽/Noun,47,33,14,0.00038901856174280313,0.00017770274772873674,0.7021276595744681
3952,3952,오페라/Noun,47,33,14,0.00038901856174280313,0.00017770274772873674,0.7021276595744681
3953,3953,신념/Noun,47,32,15,0.00037790374569300877,0.0001888091694617828,0.6808510638297872
3954,3954,아이언맨/Noun,47,32,15,0.00037790374569300877,0.0001888091694617828,0.6808510638297872
3955,3955,애국심/Noun,47,15,32,0.00018895187284650438,0.0003776183389235656,0.6808510638297872
3956,3956,작/Foreign,47,15,32,0.00018895187284650438,0.0003776183389235656,0.6808510638297872
3957,3957,미이라/Noun,47,15,32,0.00018895187284650438,0.0003776183389235656,0.6808510638297872
3958,3958,드래곤볼/Noun,47,15,32,0.00018895187284650438,0.0003776183389235656,0.6808510638297872
3959,3959,전이/Noun,47,31,16,0.00036678892964321435,0.00019991559119482882,0.6595744680851063
3960,3960,크루즈/Noun,47,31,16,0.00036678892964321435,0.00019991559119482882,0.6595744680851063
3961,3961,김명민/Noun,47,30,17,0.00035567411359342004,0.0002110220129278749,0.6382978723404256
3962,3962,웅장/Noun,47,30,17,0.00035567411359342004,0.0002110220129278749,0.6382978723404256
3963,3963,지브리/Noun,47,30,17,0.00035567411359342004,0.0002110220129278749,0.6382978723404256
3964,3964,홍금보/Noun,47,30,17,0.00035567411359342004,0.0002110220129278749,0.6382978723404256
3965,3965,쩜/Noun,47,29,18,0.0003445592975436257,0.00022212843466092096,0.6170212765957447
3966,3966,2015년/Number,47,29,18,0.0003445592975436257,0.00022212843466092096,0.6170212765957447
3967,3967,부여/Noun,47,18,29,0.0002222963209958875,0.00034429907372442745,0.6170212765957447
3968,3968,뻥/Noun,47,18,29,0.0002222963209958875,0.00034429907372442745,0.6170212765957447
3969,3969,국적/Noun,47,29,18,0.0003445592975436257,0.00022212843466092096,0.6170212765957447
3970,3970,독립/Noun,47,29,18,0.0003445592975436257,0.00022212843466092096,0.6170212765957447
3971,3971,메인/Noun,47,18,29,0.0002222963209958875,0.00034429907372442745,0.6170212765957447
3972,3972,밧다/Verb,47,29,18,0.0003445592975436257,0.00022212843466092096,0.6170212765957447
3973,3973,보고서/Noun,47,29,18,0.0003445592975436257,0.00022212843466092096,0.6170212765957447
3974,3974,자의/Noun,47,29,18,0.0003445592975436257,0.00022212843466092096,0.6170212765957447
3975,3975,겹/Noun,47,28,19,0.0003334444814938313,0.000233234856393967,0.5957446808510638
3976,3976,한글/Noun,47,28,19,0.0003334444814938313,0.000233234856393967,0.5957446808510638
3977,3977,간단하다/Adjective,47,19,28,0.0002334111370456819,0.0003331926519913814,0.5957446808510638
3978,3978,초점/Noun,47,20,27,0.00024452595309547634,0.00032208623025833537,0.5744680851063829
3979,3979,봉/Noun,47,20,27,0.00024452595309547634,0.00032208623025833537,0.5744680851063829
3980,3980,인종차별/Noun,47,20,27,0.00024452595309547634,0.00032208623025833537,0.5744680851063829
3981,3981,다크/Noun,47,26,21,0.00031121484939424253,0.0002554476998600591,0.5531914893617021
3982,3982,미리/Noun,47,21,26,0.00025564076914527065,0.00031097980852528933,0.5531914893617021
3983,3983,ㅐ/KoreanParticle,47,21,26,0.00025564076914527065,0.00031097980852528933,0.5531914893617021
3984,3984,꼬맹이/Noun,47,26,21,0.00031121484939424253,0.0002554476998600591,0.5531914893617021
3985,3985,쥬라기/Noun,47,21,26,0.00025564076914527065,0.00031097980852528933,0.5531914893617021
3986,3986,고수/Noun,47,21,26,0.00025564076914527065,0.00031097980852528933,0.5531914893617021
3987,3987,커지다/Verb,47,22,25,0.000266755585195065,0.0002998733867922433,0.5319148936170213
3988,3988,스탈/Noun,47,22,25,0.000266755585195065,0.0002998733867922433,0.5319148936170213
3989,3989,무지하다/Adjective,47,25,22,0.00030010003334444816,0.00026655412159310506,0.5319148936170213
3990,3990,비치/Noun,47,22,25,0.000266755585195065,0.0002998733867922433,0.5319148936170213
3991,3991,불쌍/Noun,47,22,25,0.000266755585195065,0.0002998733867922433,0.5319148936170213
3992,3992,배려/Noun,47,25,22,0.00030010003334444816,0.00026655412159310506,0.5319148936170213
3993,3993,열광하다/Adjective,47,22,25,0.000266755585195065,0.0002998733867922433,0.5319148936170213
3994,3994,감추다/Verb,47,24,23,0.0002889852172946538,0.00027766054332615115,0.5106382978723404
3995,3995,갓/Modifier,47,23,24,0.00027787040124485944,0.0002887669650591972,0.5106382978723404
3996,3996,~~~~~/Punctuation,47,23,24,0.00027787040124485944,0.0002887669650591972,0.5106382978723404
3997,3997,운동/Noun,47,23,24,0.00027787040124485944,0.0002887669650591972,0.5106382978723404
3998,3998,남발/Noun,46,2,44,4.445926419917751e-05,0.0005108953997201182,0.9565217391304348
3999,3999,용가리/Noun,46,5,41,7.780371234856063e-05,0.00047757613452098,0.8913043478260869
4000,4000,배드/Noun,46,6,40,8.891852839835501e-05,0.000466469712787934,0.8695652173913043
4001,4001,재탕/Noun,46,6,40,8.891852839835501e-05,0.000466469712787934,0.8695652173913043
4002,4002,증말/Noun,46,7,39,0.0001000333444481494,0.000455363291054888,0.8478260869565217
4003,4003,우왕/Noun,46,39,7,0.00045570745804156943,9.995779559741441e-05,0.8478260869565217
4004,4004,재료/Noun,46,7,39,0.0001000333444481494,0.000455363291054888,0.8478260869565217
4005,4005,즐/Noun,46,7,39,0.0001000333444481494,0.000455363291054888,0.8478260869565217
4006,4006,덴젤/Noun,46,38,8,0.000444592641991775,0.00011106421733046048,0.8260869565217391
4007,4007,풍부하다/Adjective,46,37,9,0.0004334778259419807,0.00012217063906350652,0.8043478260869565
4008,4008,벗기다/Verb,46,9,37,0.00012226297654773814,0.0004331504475887958,0.8043478260869565
4009,4009,정당화/Noun,46,9,37,0.00012226297654773814,0.0004331504475887958,0.8043478260869565
4010,4010,저희/Noun,46,34,12,0.0004001333777925976,0.00015548990426264466,0.7391304347826086
4011,4011,땜시/Noun,46,12,34,0.00015560742469712126,0.00039983118238965764,0.7391304347826086
4012,4012,줄이다/Verb,46,13,33,0.00016672224074691566,0.00038872476065661166,0.7173913043478259
4013,4013,특징/Noun,46,13,33,0.00016672224074691566,0.00038872476065661166,0.7173913043478259
4014,4014,태양/Noun,46,33,13,0.00038901856174280313,0.0001665963259956907,0.7173913043478259
4015,4015,조정/Noun,46,13,33,0.00016672224074691566,0.00038872476065661166,0.7173913043478259
4016,4016,정통/Noun,46,32,14,0.00037790374569300877,0.00017770274772873674,0.6956521739130435
4017,4017,역쉬/Noun,46,31,15,0.00036678892964321435,0.0001888091694617828,0.6739130434782609
4018,4018,나와라/Noun,46,31,15,0.00036678892964321435,0.0001888091694617828,0.6739130434782609
4019,4019,6년/Number,46,31,15,0.00036678892964321435,0.0001888091694617828,0.6739130434782609
4020,4020,지원/Noun,46,16,30,0.0002000666888962988,0.0003554054954574735,0.6521739130434783
4021,4021,KBS/Alpha,46,30,16,0.00035567411359342004,0.00019991559119482882,0.6521739130434783
4022,4022,저기/Noun,46,16,30,0.0002000666888962988,0.0003554054954574735,0.6521739130434783
4023,4023,최선/Noun,46,30,16,0.00035567411359342004,0.00019991559119482882,0.6521739130434783
4024,4024,부자/Noun,46,17,29,0.00021118150494609317,0.00034429907372442745,0.6304347826086957
4025,4025,하나요/Noun,46,17,29,0.00021118150494609317,0.00034429907372442745,0.6304347826086957
4026,4026,만듬/Noun,46,17,29,0.00021118150494609317,0.00034429907372442745,0.6304347826086957
4027,4027,줄리/Noun,46,29,17,0.0003445592975436257,0.0002110220129278749,0.6304347826086957
4028,4028,헷갈리다/Adjective,46,18,28,0.0002222963209958875,0.0003331926519913814,0.6086956521739131
4029,4029,주먹/Noun,46,18,28,0.0002222963209958875,0.0003331926519913814,0.6086956521739131
4030,4030,환타지/Noun,46,18,28,0.0002222963209958875,0.0003331926519913814,0.6086956521739131
4031,4031,격투/Noun,46,27,19,0.00032232966544403684,0.000233234856393967,0.5869565217391305
4032,4032,ㄹㅇ/KoreanParticle,46,19,27,0.0002334111370456819,0.00032208623025833537,0.5869565217391305
4033,4033,칸/Noun,46,20,26,0.00024452595309547634,0.00031097980852528933,0.5652173913043478
4034,4034,호화/Noun,46,20,26,0.00024452595309547634,0.00031097980852528933,0.5652173913043478
4035,4035,패션/Noun,46,26,20,0.00031121484939424253,0.00024434127812701304,0.5652173913043478
4036,4036,짱구/Noun,46,20,26,0.00024452595309547634,0.00031097980852528933,0.5652173913043478
4037,4037,장난감/Noun,46,21,25,0.00025564076914527065,0.0002998733867922433,0.5434782608695652
4038,4038,대비/Noun,46,25,21,0.00030010003334444816,0.0002554476998600591,0.5434782608695652
4039,4039,하디/Noun,46,21,25,0.00025564076914527065,0.0002998733867922433,0.5434782608695652
4040,4040,서스펜스/Noun,46,25,21,0.00030010003334444816,0.0002554476998600591,0.5434782608695652
4041,4041,`/Punctuation,46,21,25,0.00025564076914527065,0.0002998733867922433,0.5434782608695652
4042,4042,검다/Adjective,46,21,25,0.00025564076914527065,0.0002998733867922433,0.5434782608695652
4043,4043,으로가/Josa,46,21,25,0.00025564076914527065,0.0002998733867922433,0.5434782608695652
4044,4044,여왕/Noun,46,21,25,0.00025564076914527065,0.0002998733867922433,0.5434782608695652
4045,4045,이형/Noun,46,24,22,0.0002889852172946538,0.00026655412159310506,0.5217391304347826
4046,4046,한텐/Noun,46,22,24,0.000266755585195065,0.0002887669650591972,0.5217391304347826
4047,4047,이던/Josa,46,22,24,0.000266755585195065,0.0002887669650591972,0.5217391304347826
4048,4048,안함/Noun,46,23,23,0.00027787040124485944,0.00027766054332615115,0.5
4049,4049,전환/Noun,46,23,23,0.00027787040124485944,0.00027766054332615115,0.5
4050,4050,치면/Noun,46,23,23,0.00027787040124485944,0.00027766054332615115,0.5
4051,4051,최하/Noun,45,3,42,5.5574080248971876e-05,0.0004886825562540262,0.9333333333333332
4052,4052,어처구니없다/Adjective,45,3,42,5.5574080248971876e-05,0.0004886825562540262,0.9333333333333332
4053,4053,글쎄요/Noun,45,3,42,5.5574080248971876e-05,0.0004886825562540262,0.9333333333333332
4054,4054,흐뭇하다/Adjective,45,42,3,0.0004890519061909527,5.553210866523024e-05,0.9333333333333332
4055,4055,대략/Noun,45,5,40,7.780371234856063e-05,0.000466469712787934,0.8888888888888888
4056,4056,곁/Noun,45,40,5,0.0004668222740913638,7.774495213132233e-05,0.8888888888888888
4057,4057,성함/Noun,45,6,39,8.891852839835501e-05,0.000455363291054888,0.8666666666666667
4058,4058,팔다/Verb,45,7,38,0.0001000333444481494,0.0004442568693218419,0.8444444444444444
4059,4059,간첩/Noun,45,10,35,0.0001333777925975325,0.0004109376041227037,0.7777777777777778
4060,4060,구성은/Noun,45,10,35,0.0001333777925975325,0.0004109376041227037,0.7777777777777778
4061,4061,온몸/Noun,45,34,11,0.0004001333777925976,0.0001443834825295986,0.7555555555555555
4062,4062,수치/Noun,45,11,34,0.0001444926086473269,0.00039983118238965764,0.7555555555555555
4063,4063,행크스/Noun,45,34,11,0.0004001333777925976,0.0001443834825295986,0.7555555555555555
4064,4064,12년/Number,45,33,12,0.00038901856174280313,0.00015548990426264466,0.7333333333333333
4065,4065,직원/Noun,45,12,33,0.00015560742469712126,0.00038872476065661166,0.7333333333333333
4066,4066,도입/Noun,45,12,33,0.00015560742469712126,0.00038872476065661166,0.7333333333333333
4067,4067,모호하다/Adjective,45,13,32,0.00016672224074691566,0.0003776183389235656,0.7111111111111111
4068,4068,감수성/Noun,45,31,14,0.00036678892964321435,0.00017770274772873674,0.6888888888888889
4069,4069,게리/Noun,45,31,14,0.00036678892964321435,0.00017770274772873674,0.6888888888888889
4070,4070,박사/Noun,45,30,15,0.00035567411359342004,0.0001888091694617828,0.6666666666666666
4071,4071,김태희/Noun,45,16,29,0.0002000666888962988,0.00034429907372442745,0.6444444444444445
4072,4072,활용/Noun,45,16,29,0.0002000666888962988,0.00034429907372442745,0.6444444444444445
4073,4073,민/Noun,45,29,16,0.0003445592975436257,0.00019991559119482882,0.6444444444444445
4074,4074,고백/Noun,45,28,17,0.0003334444814938313,0.0002110220129278749,0.6222222222222222
4075,4075,남매/Noun,45,28,17,0.0003334444814938313,0.0002110220129278749,0.6222222222222222
4076,4076,그로/Noun,45,28,17,0.0003334444814938313,0.0002110220129278749,0.6222222222222222
4077,4077,총알/Noun,45,17,28,0.00021118150494609317,0.0003331926519913814,0.6222222222222222
4078,4078,부탁드리다/Adjective,45,28,17,0.0003334444814938313,0.0002110220129278749,0.6222222222222222
4079,4079,수위/Noun,45,17,28,0.00021118150494609317,0.0003331926519913814,0.6222222222222222
4080,4080,삐/Noun,45,17,28,0.00021118150494609317,0.0003331926519913814,0.6222222222222222
4081,4081,시민/Noun,45,17,28,0.00021118150494609317,0.0003331926519913814,0.6222222222222222
4082,4082,긋다/Verb,45,18,27,0.0002222963209958875,0.00032208623025833537,0.6
4083,4083,존내/Noun,45,18,27,0.0002222963209958875,0.00032208623025833537,0.6
4084,4084,노동자/Noun,45,26,19,0.00031121484939424253,0.000233234856393967,0.5777777777777777
4085,4085,영감/Noun,45,26,19,0.00031121484939424253,0.000233234856393967,0.5777777777777777
4086,4086,닫다/Verb,45,19,26,0.0002334111370456819,0.00031097980852528933,0.5777777777777777
4087,4087,법정/Noun,45,26,19,0.00031121484939424253,0.000233234856393967,0.5777777777777777
4088,4088,똑똑하다/Adjective,45,26,19,0.00031121484939424253,0.000233234856393967,0.5777777777777777
4089,4089,부디/Noun,45,25,20,0.00030010003334444816,0.00024434127812701304,0.5555555555555556
4090,4090,모성애/Noun,45,25,20,0.00030010003334444816,0.00024434127812701304,0.5555555555555556
4091,4091,이나영/Noun,45,21,24,0.00025564076914527065,0.0002887669650591972,0.5333333333333333
4092,4092,마녀/Noun,45,24,21,0.0002889852172946538,0.0002554476998600591,0.5333333333333333
4093,4093,간간히/Adverb,45,21,24,0.00025564076914527065,0.0002887669650591972,0.5333333333333333
4094,4094,극찬/Noun,45,21,24,0.00025564076914527065,0.0002887669650591972,0.5333333333333333
4095,4095,리브/Noun,45,24,21,0.0002889852172946538,0.0002554476998600591,0.5333333333333333
4096,4096,가미/Noun,45,21,24,0.00025564076914527065,0.0002887669650591972,0.5333333333333333
4097,4097,복/Noun,45,24,21,0.0002889852172946538,0.0002554476998600591,0.5333333333333333
4098,4098,어째서/Noun,45,24,21,0.0002889852172946538,0.0002554476998600591,0.5333333333333333
4099,4099,퍼스/Noun,45,22,23,0.000266755585195065,0.00027766054332615115,0.5111111111111111
4100,4100,월드/Noun,45,22,23,0.000266755585195065,0.00027766054332615115,0.5111111111111111
4101,4101,먹음/Noun,45,22,23,0.000266755585195065,0.00027766054332615115,0.5111111111111111
4102,4102,♥♥♥♥/Foreign,44,44,0,0.0005112815382905413,2.2212843466092093e-05,1.0
4103,4103,자위/Noun,44,2,42,4.445926419917751e-05,0.0004886825562540262,0.9545454545454546
4104,4104,용두사미/Noun,44,2,42,4.445926419917751e-05,0.0004886825562540262,0.9545454545454546
4105,4105,모야/Noun,44,3,41,5.5574080248971876e-05,0.00047757613452098,0.9318181818181818
4106,4106,앞서/Noun,44,41,3,0.0004779370901411582,5.553210866523024e-05,0.9318181818181818
4107,4107,구역질/Noun,44,3,41,5.5574080248971876e-05,0.00047757613452098,0.9318181818181818
4108,4108,삼가다/Verb,44,39,5,0.00045570745804156943,7.774495213132233e-05,0.8863636363636364
4109,4109,뽕/Noun,44,6,38,8.891852839835501e-05,0.0004442568693218419,0.8636363636363636
4110,4110,느슨하다/Adjective,44,7,37,0.0001000333444481494,0.0004331504475887958,0.8409090909090909
4111,4111,코스프레/Noun,44,7,37,0.0001000333444481494,0.0004331504475887958,0.8409090909090909
4112,4112,노리다/Verb,44,7,37,0.0001000333444481494,0.0004331504475887958,0.8409090909090909
4113,4113,등급/Noun,44,8,36,0.00011114816049794375,0.0004220440258557498,0.8181818181818182
4114,4114,가을/Noun,44,36,8,0.00042236300989218633,0.00011106421733046048,0.8181818181818182
4115,4115,노말/Noun,44,8,36,0.00011114816049794375,0.0004220440258557498,0.8181818181818182
4116,4116,ㅂㅅ/KoreanParticle,44,8,36,0.00011114816049794375,0.0004220440258557498,0.8181818181818182
4117,4117,펭귄/Noun,44,36,8,0.00042236300989218633,0.00011106421733046048,0.8181818181818182
4118,4118,에러/Noun,44,9,35,0.00012226297654773814,0.0004109376041227037,0.7954545454545454
4119,4119,드립/Noun,44,9,35,0.00012226297654773814,0.0004109376041227037,0.7954545454545454
4120,4120,구리다/Adjective,44,9,35,0.00012226297654773814,0.0004109376041227037,0.7954545454545454
4121,4121,읍/Noun,44,9,35,0.00012226297654773814,0.0004109376041227037,0.7954545454545454
4122,4122,섭외/Noun,44,9,35,0.00012226297654773814,0.0004109376041227037,0.7954545454545454
4123,4123,15분/Number,44,10,34,0.0001333777925975325,0.00039983118238965764,0.7727272727272727
4124,4124,중국인/Noun,44,10,34,0.0001333777925975325,0.00039983118238965764,0.7727272727272727
4125,4125,에여/Josa,44,34,10,0.0004001333777925976,0.00013327706079655256,0.7727272727272727
4126,4126,병원/Noun,44,11,33,0.0001444926086473269,0.00038872476065661166,0.75
4127,4127,불후/Noun,44,32,12,0.00037790374569300877,0.00015548990426264466,0.7272727272727273
4128,4128,성숙하다/Adjective,44,32,12,0.00037790374569300877,0.00015548990426264466,0.7272727272727273
4129,4129,해안가/Noun,44,12,32,0.00015560742469712126,0.0003776183389235656,0.7272727272727273
4130,4130,똑바로/Noun,44,13,31,0.00016672224074691566,0.00036651191719051963,0.7045454545454546
4131,4131,구멍/Noun,44,13,31,0.00016672224074691566,0.00036651191719051963,0.7045454545454546
4132,4132,워커/Noun,44,31,13,0.00036678892964321435,0.0001665963259956907,0.7045454545454546
4133,4133,낙/Noun,44,31,13,0.00036678892964321435,0.0001665963259956907,0.7045454545454546
4134,4134,레오/Noun,44,31,13,0.00036678892964321435,0.0001665963259956907,0.7045454545454546
4135,4135,부재/Noun,44,13,31,0.00016672224074691566,0.00036651191719051963,0.7045454545454546
4136,4136,인터뷰/Noun,44,13,31,0.00016672224074691566,0.00036651191719051963,0.7045454545454546
4137,4137,가져오다/Verb,44,14,30,0.00017783705679671002,0.0003554054954574735,0.6818181818181818
4138,4138,아무래도/Adverb,44,14,30,0.00017783705679671002,0.0003554054954574735,0.6818181818181818
4139,4139,북/Noun,44,14,30,0.00017783705679671002,0.0003554054954574735,0.6818181818181818
4140,4140,절실/Noun,44,30,14,0.00035567411359342004,0.00017770274772873674,0.6818181818181818
4141,4141,비롯/Noun,44,29,15,0.0003445592975436257,0.0001888091694617828,0.6590909090909091
4142,4142,지존/Noun,44,29,15,0.0003445592975436257,0.0001888091694617828,0.6590909090909091
4143,4143,슬래셔/Noun,44,15,29,0.00018895187284650438,0.00034429907372442745,0.6590909090909091
4144,4144,걸치다/Verb,44,15,29,0.00018895187284650438,0.00034429907372442745,0.6590909090909091
4145,4145,무적/Noun,44,16,28,0.0002000666888962988,0.0003331926519913814,0.6363636363636364
4146,4146,지금껏/Noun,44,28,16,0.0003334444814938313,0.00019991559119482882,0.6363636363636364
4147,4147,숲/Noun,44,27,17,0.00032232966544403684,0.0002110220129278749,0.6136363636363636
4148,4148,신민아/Noun,44,27,17,0.00032232966544403684,0.0002110220129278749,0.6136363636363636
4149,4149,양동근/Noun,44,17,27,0.00021118150494609317,0.00032208623025833537,0.6136363636363636
4150,4150,괜/Noun,44,26,18,0.00031121484939424253,0.00022212843466092096,0.5909090909090909
4151,4151,뼈/Noun,44,26,18,0.00031121484939424253,0.00022212843466092096,0.5909090909090909
4152,4152,천만/Noun,44,18,26,0.0002222963209958875,0.00031097980852528933,0.5909090909090909
4153,4153,구원/Noun,44,26,18,0.00031121484939424253,0.00022212843466092096,0.5909090909090909
4154,4154,고요/Noun,44,26,18,0.00031121484939424253,0.00022212843466092096,0.5909090909090909
4155,4155,세우다/Verb,44,18,26,0.0002222963209958875,0.00031097980852528933,0.5909090909090909
4156,4156,정사/Noun,44,19,25,0.0002334111370456819,0.0002998733867922433,0.5681818181818182
4157,4157,다기/Noun,44,19,25,0.0002334111370456819,0.0002998733867922433,0.5681818181818182
4158,4158,임권택/Noun,44,19,25,0.0002334111370456819,0.0002998733867922433,0.5681818181818182
4159,4159,대전/Noun,44,19,25,0.0002334111370456819,0.0002998733867922433,0.5681818181818182
4160,4160,16/Number,44,25,19,0.00030010003334444816,0.000233234856393967,0.5681818181818182
4161,4161,광팬/Noun,44,25,19,0.00030010003334444816,0.000233234856393967,0.5681818181818182
4162,4162,진보/Noun,44,24,20,0.0002889852172946538,0.00024434127812701304,0.5454545454545454
4163,4163,드림웍스/Noun,44,20,24,0.00024452595309547634,0.0002887669650591972,0.5454545454545454
4164,4164,유리/Noun,44,20,24,0.00024452595309547634,0.0002887669650591972,0.5454545454545454
4165,4165,실사/Noun,44,20,24,0.00024452595309547634,0.0002887669650591972,0.5454545454545454
4166,4166,스텝업/Noun,44,20,24,0.00024452595309547634,0.0002887669650591972,0.5454545454545454
4167,4167,긴박하다/Adjective,44,21,23,0.00025564076914527065,0.00027766054332615115,0.5227272727272727
4168,4168,임수정/Noun,44,23,21,0.00027787040124485944,0.0002554476998600591,0.5227272727272727
4169,4169,장군/Noun,44,21,23,0.00025564076914527065,0.00027766054332615115,0.5227272727272727
4170,4170,존중/Noun,44,22,22,0.000266755585195065,0.00026655412159310506,0.5
4171,4171,곱씹다/Verb,43,42,1,0.0004890519061909527,3.331926519913814e-05,0.9767441860465116
4172,4172,very/Alpha,43,42,1,0.0004890519061909527,3.331926519913814e-05,0.9767441860465116
4173,4173,실종/Noun,43,1,42,3.334444814938313e-05,0.0004886825562540262,0.9767441860465116
4174,4174,나발/Noun,43,2,41,4.445926419917751e-05,0.00047757613452098,0.9534883720930232
4175,4175,리즈시절/Noun,43,40,3,0.0004668222740913638,5.553210866523024e-05,0.9302325581395348
4176,4176,미묘하다/Adjective,43,39,4,0.00045570745804156943,6.663853039827628e-05,0.9069767441860463
4177,4177,허무맹랑/Noun,43,6,37,8.891852839835501e-05,0.0004331504475887958,0.8604651162790697
4178,4178,실소/Noun,43,7,36,0.0001000333444481494,0.0004220440258557498,0.8372093023255814
4179,4179,요약/Noun,43,8,35,0.00011114816049794375,0.0004109376041227037,0.813953488372093
4180,4180,8년/Number,43,35,8,0.0004112481938423919,0.00011106421733046048,0.813953488372093
4181,4181,비명/Noun,43,8,35,0.00011114816049794375,0.0004109376041227037,0.813953488372093
4182,4182,PD/Alpha,43,8,35,0.00011114816049794375,0.0004109376041227037,0.813953488372093
4183,4183,말기/Noun,43,9,34,0.00012226297654773814,0.00039983118238965764,0.7906976744186046
4184,4184,훈남/Noun,43,34,9,0.0004001333777925976,0.00012217063906350652,0.7906976744186046
4185,4185,콤비/Noun,43,33,10,0.00038901856174280313,0.00013327706079655256,0.7674418604651163
4186,4186,박해일/Noun,43,32,11,0.00037790374569300877,0.0001443834825295986,0.7441860465116279
4187,4187,정도/Foreign,43,11,32,0.0001444926086473269,0.0003776183389235656,0.7441860465116279
4188,4188,자랑스럽다/Adjective,43,32,11,0.00037790374569300877,0.0001443834825295986,0.7441860465116279
4189,4189,이념/Noun,43,31,12,0.00036678892964321435,0.00015548990426264466,0.7209302325581395
4190,4190,낯/Noun,43,12,31,0.00015560742469712126,0.00036651191719051963,0.7209302325581395
4191,4191,명도/Noun,43,12,31,0.00015560742469712126,0.00036651191719051963,0.7209302325581395
4192,4192,크리스토퍼/Noun,43,31,12,0.00036678892964321435,0.00015548990426264466,0.7209302325581395
4193,4193,일도/Noun,43,13,30,0.00016672224074691566,0.0003554054954574735,0.6976744186046512
4194,4194,거만/Noun,43,13,30,0.00016672224074691566,0.0003554054954574735,0.6976744186046512
4195,4195,에게서/Josa,43,30,13,0.00035567411359342004,0.0001665963259956907,0.6976744186046512
4196,4196,미국영화/Noun,43,13,30,0.00016672224074691566,0.0003554054954574735,0.6976744186046512
4197,4197,뮤직비디오/Noun,43,13,30,0.00016672224074691566,0.0003554054954574735,0.6976744186046512
4198,4198,모티브/Noun,43,13,30,0.00016672224074691566,0.0003554054954574735,0.6976744186046512
4199,4199,요구/Noun,43,13,30,0.00016672224074691566,0.0003554054954574735,0.6976744186046512
4200,4200,만/Foreign,43,14,29,0.00017783705679671002,0.00034429907372442745,0.6744186046511628
4201,4201,깨지다/Verb,43,14,29,0.00017783705679671002,0.00034429907372442745,0.6744186046511628
4202,4202,호강/Noun,43,29,14,0.0003445592975436257,0.00017770274772873674,0.6744186046511628
4203,4203,뉴욕/Noun,43,29,14,0.0003445592975436257,0.00017770274772873674,0.6744186046511628
4204,4204,끊임없다/Adjective,43,29,14,0.0003445592975436257,0.00017770274772873674,0.6744186046511628
4205,4205,남지/Noun,43,15,28,0.00018895187284650438,0.0003331926519913814,0.6511627906976745
4206,4206,옹/Noun,43,28,15,0.0003334444814938313,0.0001888091694617828,0.6511627906976745
4207,4207,교수/Noun,43,15,28,0.00018895187284650438,0.0003331926519913814,0.6511627906976745
4208,4208,학원/Noun,43,15,28,0.00018895187284650438,0.0003331926519913814,0.6511627906976745
4209,4209,2003년/Number,43,28,15,0.0003334444814938313,0.0001888091694617828,0.6511627906976745
4210,4210,혹평/Noun,43,28,15,0.0003334444814938313,0.0001888091694617828,0.6511627906976745
4211,4211,쫓다/Verb,43,15,28,0.00018895187284650438,0.0003331926519913814,0.6511627906976745
4212,4212,지니다/Verb,43,27,16,0.00032232966544403684,0.00019991559119482882,0.627906976744186
4213,4213,꺼리다/Verb,43,16,27,0.0002000666888962988,0.00032208623025833537,0.627906976744186
4214,4214,그/Modifier,43,16,27,0.0002000666888962988,0.00032208623025833537,0.627906976744186
4215,4215,라마/Noun,43,16,27,0.0002000666888962988,0.00032208623025833537,0.627906976744186
4216,4216,저번/Noun,43,17,26,0.00021118150494609317,0.00031097980852528933,0.6046511627906976
4217,4217,쓰러지다/Verb,43,17,26,0.00021118150494609317,0.00031097980852528933,0.6046511627906976
4218,4218,은퇴/Noun,43,17,26,0.00021118150494609317,0.00031097980852528933,0.6046511627906976
4219,4219,주목/Noun,43,26,17,0.00031121484939424253,0.0002110220129278749,0.6046511627906976
4220,4220,종류/Noun,43,26,17,0.00031121484939424253,0.0002110220129278749,0.6046511627906976
4221,4221,벽/Noun,43,26,17,0.00031121484939424253,0.0002110220129278749,0.6046511627906976
4222,4222,물의/Noun,43,25,18,0.00030010003334444816,0.00022212843466092096,0.5813953488372093
4223,4223,계획/Noun,43,25,18,0.00030010003334444816,0.00022212843466092096,0.5813953488372093
4224,4224,아역배우/Noun,43,25,18,0.00030010003334444816,0.00022212843466092096,0.5813953488372093
4225,4225,미술/Noun,43,25,18,0.00030010003334444816,0.00022212843466092096,0.5813953488372093
4226,4226,해적/Noun,43,25,18,0.00030010003334444816,0.00022212843466092096,0.5813953488372093
4227,4227,엽문/Noun,43,19,24,0.0002334111370456819,0.0002887669650591972,0.5581395348837209
4228,4228,밴드/Noun,43,24,19,0.0002889852172946538,0.000233234856393967,0.5581395348837209
4229,4229,몫/Noun,43,19,24,0.0002334111370456819,0.0002887669650591972,0.5581395348837209
4230,4230,노랗다/Adjective,43,20,23,0.00024452595309547634,0.00027766054332615115,0.5348837209302325
4231,4231,공중파/Noun,43,23,20,0.00027787040124485944,0.00024434127812701304,0.5348837209302325
4232,4232,기어/Noun,43,20,23,0.00024452595309547634,0.00027766054332615115,0.5348837209302325
4233,4233,가해자/Noun,43,20,23,0.00024452595309547634,0.00027766054332615115,0.5348837209302325
4234,4234,와이프/Noun,43,23,20,0.00027787040124485944,0.00024434127812701304,0.5348837209302325
4235,4235,명확하다/Adjective,43,23,20,0.00027787040124485944,0.00024434127812701304,0.5348837209302325
4236,4236,이민기/Noun,43,21,22,0.00025564076914527065,0.00026655412159310506,0.5116279069767442
4237,4237,ocn/Alpha,43,21,22,0.00025564076914527065,0.00026655412159310506,0.5116279069767442
4238,4238,실컷/Noun,43,22,21,0.000266755585195065,0.0002554476998600591,0.5116279069767442
4239,4239,장편/Noun,43,22,21,0.000266755585195065,0.0002554476998600591,0.5116279069767442
4240,4240,접근/Noun,43,22,21,0.000266755585195065,0.0002554476998600591,0.5116279069767442
4241,4241,욕구/Noun,43,22,21,0.000266755585195065,0.0002554476998600591,0.5116279069767442
4242,4242,도통/Noun,42,1,41,3.334444814938313e-05,0.00047757613452098,0.9761904761904762
4243,4243,남아돌다/Verb,42,1,41,3.334444814938313e-05,0.00047757613452098,0.9761904761904762
4244,4244,저급/Noun,42,2,40,4.445926419917751e-05,0.000466469712787934,0.9523809523809524
4245,4245,귀요미/Noun,42,38,4,0.000444592641991775,6.663853039827628e-05,0.9047619047619048
4246,4246,화만/Noun,42,4,38,6.668889629876625e-05,0.0004442568693218419,0.9047619047619048
4247,4247,에든/Josa,42,37,5,0.0004334778259419807,7.774495213132233e-05,0.8809523809523809
4248,4248,집어넣다/Verb,42,5,37,7.780371234856063e-05,0.0004331504475887958,0.8809523809523809
4249,4249,미안/Noun,42,6,36,8.891852839835501e-05,0.0004220440258557498,0.8571428571428571
4250,4250,이준기/Noun,42,35,7,0.0004112481938423919,9.995779559741441e-05,0.8333333333333334
4251,4251,망상/Noun,42,8,34,0.00011114816049794375,0.00039983118238965764,0.8095238095238095
4252,4252,눈뜨다/Verb,42,8,34,0.00011114816049794375,0.00039983118238965764,0.8095238095238095
4253,4253,찜찜하다/Adjective,42,8,34,0.00011114816049794375,0.00039983118238965764,0.8095238095238095
4254,4254,매혹/Noun,42,33,9,0.00038901856174280313,0.00012217063906350652,0.7857142857142857
4255,4255,경계/Noun,42,33,9,0.00038901856174280313,0.00012217063906350652,0.7857142857142857
4256,4256,상치/Noun,42,33,9,0.00038901856174280313,0.00012217063906350652,0.7857142857142857
4257,4257,진짜진짜/Noun,42,33,9,0.00038901856174280313,0.00012217063906350652,0.7857142857142857
4258,4258,자유롭다/Adjective,42,33,9,0.00038901856174280313,0.00012217063906350652,0.7857142857142857
4259,4259,사춘기/Noun,42,32,10,0.00037790374569300877,0.00013327706079655256,0.7619047619047619
4260,4260,앵글/Noun,42,10,32,0.0001333777925975325,0.0003776183389235656,0.7619047619047619
4261,4261,내기/Noun,42,11,31,0.0001444926086473269,0.00036651191719051963,0.7380952380952381
4262,4262,원인/Noun,42,11,31,0.0001444926086473269,0.00036651191719051963,0.7380952380952381
4263,4263,..??/Punctuation,42,11,31,0.0001444926086473269,0.00036651191719051963,0.7380952380952381
4264,4264,박신양/Noun,42,30,12,0.00035567411359342004,0.00015548990426264466,0.7142857142857143
4265,4265,덕후/Noun,42,12,30,0.00015560742469712126,0.0003554054954574735,0.7142857142857143
4266,4266,4년/Number,42,29,13,0.0003445592975436257,0.0001665963259956907,0.6904761904761905
4267,4267,주상욱/Noun,42,13,29,0.00016672224074691566,0.00034429907372442745,0.6904761904761905
4268,4268,강제/Noun,42,13,29,0.00016672224074691566,0.00034429907372442745,0.6904761904761905
4269,4269,유아인/Noun,42,28,14,0.0003334444814938313,0.00017770274772873674,0.6666666666666666
4270,4270,............/Punctuation,42,14,28,0.00017783705679671002,0.0003331926519913814,0.6666666666666666
4271,4271,원표/Noun,42,28,14,0.0003334444814938313,0.00017770274772873674,0.6666666666666666
4272,4272,가르다/Verb,42,28,14,0.0003334444814938313,0.00017770274772873674,0.6666666666666666
4273,4273,도하/Noun,42,27,15,0.00032232966544403684,0.0001888091694617828,0.6428571428571429
4274,4274,3년/Number,42,27,15,0.00032232966544403684,0.0001888091694617828,0.6428571428571429
4275,4275,그딴/Modifier,42,15,27,0.00018895187284650438,0.00032208623025833537,0.6428571428571429
4276,4276,권하다/Verb,42,15,27,0.00018895187284650438,0.00032208623025833537,0.6428571428571429
4277,4277,아프리카/Noun,42,26,16,0.00031121484939424253,0.00019991559119482882,0.6190476190476191
4278,4278,강지환/Noun,42,26,16,0.00031121484939424253,0.00019991559119482882,0.6190476190476191
4279,4279,포켓몬/Noun,42,17,25,0.00021118150494609317,0.0002998733867922433,0.5952380952380952
4280,4280,ㄱㄱ/KoreanParticle,42,17,25,0.00021118150494609317,0.0002998733867922433,0.5952380952380952
4281,4281,CGV/Alpha,42,17,25,0.00021118150494609317,0.0002998733867922433,0.5952380952380952
4282,4282,고로/Noun,42,18,24,0.0002222963209958875,0.0002887669650591972,0.5714285714285714
4283,4283,휴먼/Noun,42,24,18,0.0002889852172946538,0.00022212843466092096,0.5714285714285714
4284,4284,구르다/Verb,42,18,24,0.0002222963209958875,0.0002887669650591972,0.5714285714285714
4285,4285,여동생/Noun,42,18,24,0.0002222963209958875,0.0002887669650591972,0.5714285714285714
4286,4286,조금씩/Adverb,42,23,19,0.00027787040124485944,0.000233234856393967,0.5476190476190477
4287,4287,아가/Noun,42,23,19,0.00027787040124485944,0.000233234856393967,0.5476190476190477
4288,4288,3일/Number,42,23,19,0.00027787040124485944,0.000233234856393967,0.5476190476190477
4289,4289,고발/Noun,42,19,23,0.0002334111370456819,0.00027766054332615115,0.5476190476190477
4290,4290,랩/Noun,42,19,23,0.0002334111370456819,0.00027766054332615115,0.5476190476190477
4291,4291,닉/Noun,42,23,19,0.00027787040124485944,0.000233234856393967,0.5476190476190477
4292,4292,*/Punctuation,42,19,23,0.0002334111370456819,0.00027766054332615115,0.5476190476190477
4293,4293,땡기다/Verb,42,23,19,0.00027787040124485944,0.000233234856393967,0.5476190476190477
4294,4294,석/Modifier,42,20,22,0.00024452595309547634,0.00026655412159310506,0.5238095238095238
4295,4295,일드/Noun,42,20,22,0.00024452595309547634,0.00026655412159310506,0.5238095238095238
4296,4296,나나/Noun,42,20,22,0.00024452595309547634,0.00026655412159310506,0.5238095238095238
4297,4297,히스/Noun,42,22,20,0.000266755585195065,0.00024434127812701304,0.5238095238095238
4298,4298,이를/Josa,42,22,20,0.000266755585195065,0.00024434127812701304,0.5238095238095238
4299,4299,2005년/Number,42,20,22,0.00024452595309547634,0.00026655412159310506,0.5238095238095238
4300,4300,슈렉/Noun,42,22,20,0.000266755585195065,0.00024434127812701304,0.5238095238095238
4301,4301,게왜/Noun,42,22,20,0.000266755585195065,0.00024434127812701304,0.5238095238095238
4302,4302,오랜만/Adverb,42,22,20,0.000266755585195065,0.00024434127812701304,0.5238095238095238
4303,4303,김선아/Noun,42,22,20,0.000266755585195065,0.00024434127812701304,0.5238095238095238
4304,4304,르/Noun,42,22,20,0.000266755585195065,0.00024434127812701304,0.5238095238095238
4305,4305,갇히다/Verb,42,21,21,0.00025564076914527065,0.0002554476998600591,0.5
4306,4306,서프라이즈/Noun,41,2,39,4.445926419917751e-05,0.000455363291054888,0.951219512195122
4307,4307,존잼/Noun,41,39,2,0.00045570745804156943,4.4425686932184186e-05,0.951219512195122
4308,4308,가슴속/Noun,41,39,2,0.00045570745804156943,4.4425686932184186e-05,0.951219512195122
4309,4309,우리네/Noun,41,39,2,0.00045570745804156943,4.4425686932184186e-05,0.951219512195122
4310,4310,소박하다/Adjective,41,38,3,0.000444592641991775,5.553210866523024e-05,0.9268292682926829
4311,4311,짓거리/Noun,41,4,37,6.668889629876625e-05,0.0004331504475887958,0.902439024390244
4312,4312,희망이/Noun,41,36,5,0.00042236300989218633,7.774495213132233e-05,0.8780487804878049
4313,4313,예수님/Noun,41,35,6,0.0004112481938423919,8.885137386436837e-05,0.8536585365853658
4314,4314,충무로/Noun,41,8,33,0.00011114816049794375,0.00038872476065661166,0.8048780487804879
4315,4315,기쁨/Noun,41,33,8,0.00038901856174280313,0.00011106421733046048,0.8048780487804879
4316,4316,두근거리다/Adjective,41,33,8,0.00038901856174280313,0.00011106421733046048,0.8048780487804879
4317,4317,시보/Noun,41,33,8,0.00038901856174280313,0.00011106421733046048,0.8048780487804879
4318,4318,쏙/Noun,41,32,9,0.00037790374569300877,0.00012217063906350652,0.7804878048780488
4319,4319,쌈/Noun,41,9,32,0.00012226297654773814,0.0003776183389235656,0.7804878048780488
4320,4320,멘붕/Noun,41,9,32,0.00012226297654773814,0.0003776183389235656,0.7804878048780488
4321,4321,선하다/Adjective,41,32,9,0.00037790374569300877,0.00012217063906350652,0.7804878048780488
4322,4322,조조/Noun,41,10,31,0.0001333777925975325,0.00036651191719051963,0.7560975609756098
4323,4323,꼴리다/Verb,41,10,31,0.0001333777925975325,0.00036651191719051963,0.7560975609756098
4324,4324,행위/Noun,41,11,30,0.0001444926086473269,0.0003554054954574735,0.7317073170731707
4325,4325,유오성/Noun,41,12,29,0.00015560742469712126,0.00034429907372442745,0.7073170731707317
4326,4326,미흡하다/Adjective,41,12,29,0.00015560742469712126,0.00034429907372442745,0.7073170731707317
4327,4327,^^;/Punctuation,41,29,12,0.0003445592975436257,0.00015548990426264466,0.7073170731707317
4328,4328,오타쿠/Noun,41,12,29,0.00015560742469712126,0.00034429907372442745,0.7073170731707317
4329,4329,어우/Noun,41,12,29,0.00015560742469712126,0.00034429907372442745,0.7073170731707317
4330,4330,피터/Noun,41,29,12,0.0003445592975436257,0.00015548990426264466,0.7073170731707317
4331,4331,쓰기/Noun,41,12,29,0.00015560742469712126,0.00034429907372442745,0.7073170731707317
4332,4332,파고들다/Verb,41,29,12,0.0003445592975436257,0.00015548990426264466,0.7073170731707317
4333,4333,웹툰/Noun,41,12,29,0.00015560742469712126,0.00034429907372442745,0.7073170731707317
4334,4334,이러하다/Adjective,41,29,12,0.0003445592975436257,0.00015548990426264466,0.7073170731707317
4335,4335,->/Punctuation,41,13,28,0.00016672224074691566,0.0003331926519913814,0.6829268292682927
4336,4336,임신/Noun,41,13,28,0.00016672224074691566,0.0003331926519913814,0.6829268292682927
4337,4337,맷/Noun,41,28,13,0.0003334444814938313,0.0001665963259956907,0.6829268292682927
4338,4338,50년/Number,41,28,13,0.0003334444814938313,0.0001665963259956907,0.6829268292682927
4339,4339,디지다/Verb,41,13,28,0.00016672224074691566,0.0003331926519913814,0.6829268292682927
4340,4340,수십/Modifier,41,28,13,0.0003334444814938313,0.0001665963259956907,0.6829268292682927
4341,4341,차이다/Verb,41,13,28,0.00016672224074691566,0.0003331926519913814,0.6829268292682927
4342,4342,2012년/Number,41,14,27,0.00017783705679671002,0.00032208623025833537,0.6585365853658537
4343,4343,언급/Noun,41,14,27,0.00017783705679671002,0.00032208623025833537,0.6585365853658537
4344,4344,통수/Noun,41,14,27,0.00017783705679671002,0.00032208623025833537,0.6585365853658537
4345,4345,대로/Noun,41,14,27,0.00017783705679671002,0.00032208623025833537,0.6585365853658537
4346,4346,부턴/Josa,41,14,27,0.00017783705679671002,0.00032208623025833537,0.6585365853658537
4347,4347,it/Alpha,41,27,14,0.00032232966544403684,0.00017770274772873674,0.6585365853658537
4348,4348,황비홍/Noun,41,26,15,0.00031121484939424253,0.0001888091694617828,0.6341463414634146
4349,4349,해피/Noun,41,26,15,0.00031121484939424253,0.0001888091694617828,0.6341463414634146
4350,4350,지역/Noun,41,15,26,0.00018895187284650438,0.00031097980852528933,0.6341463414634146
4351,4351,궁/Noun,41,15,26,0.00018895187284650438,0.00031097980852528933,0.6341463414634146
4352,4352,날아가다/Verb,41,16,25,0.0002000666888962988,0.0002998733867922433,0.6097560975609756
4353,4353,@/Punctuation,41,16,25,0.0002000666888962988,0.0002998733867922433,0.6097560975609756
4354,4354,레드/Noun,41,25,16,0.00030010003334444816,0.00019991559119482882,0.6097560975609756
4355,4355,압박/Noun,41,16,25,0.0002000666888962988,0.0002998733867922433,0.6097560975609756
4356,4356,자매/Noun,41,17,24,0.00021118150494609317,0.0002887669650591972,0.5853658536585366
4357,4357,일베충/Noun,41,24,17,0.0002889852172946538,0.0002110220129278749,0.5853658536585366
4358,4358,독/Noun,41,17,24,0.00021118150494609317,0.0002887669650591972,0.5853658536585366
4359,4359,디자인/Noun,41,17,24,0.00021118150494609317,0.0002887669650591972,0.5853658536585366
4360,4360,재기/Noun,41,24,17,0.0002889852172946538,0.0002110220129278749,0.5853658536585366
4361,4361,작렬/Noun,41,17,24,0.00021118150494609317,0.0002887669650591972,0.5853658536585366
4362,4362,죽여주다/Verb,41,23,18,0.00027787040124485944,0.00022212843466092096,0.5609756097560976
4363,4363,어르다/Verb,41,18,23,0.0002222963209958875,0.00027766054332615115,0.5609756097560976
4364,4364,책임/Noun,41,18,23,0.0002222963209958875,0.00027766054332615115,0.5609756097560976
4365,4365,가능/Noun,41,23,18,0.00027787040124485944,0.00022212843466092096,0.5609756097560976
4366,4366,장나라/Noun,41,23,18,0.00027787040124485944,0.00022212843466092096,0.5609756097560976
4367,4367,휴가/Noun,41,23,18,0.00027787040124485944,0.00022212843466092096,0.5609756097560976
4368,4368,2013년/Number,41,18,23,0.0002222963209958875,0.00027766054332615115,0.5609756097560976
4369,4369,진작/Noun,41,23,18,0.00027787040124485944,0.00022212843466092096,0.5609756097560976
4370,4370,현/Noun,41,19,22,0.0002334111370456819,0.00026655412159310506,0.5365853658536586
4371,4371,빚/Noun,41,19,22,0.0002334111370456819,0.00026655412159310506,0.5365853658536586
4372,4372,식스센스/Noun,41,19,22,0.0002334111370456819,0.00026655412159310506,0.5365853658536586
4373,4373,윤아/Noun,41,21,20,0.00025564076914527065,0.00024434127812701304,0.5121951219512195
4374,4374,봣다/Noun,41,20,21,0.00024452595309547634,0.0002554476998600591,0.5121951219512195
4375,4375,컨저링/Noun,41,21,20,0.00025564076914527065,0.00024434127812701304,0.5121951219512195
4376,4376,위원/Noun,40,2,38,4.445926419917751e-05,0.0004442568693218419,0.95
4377,4377,찡/Adverb,40,37,3,0.0004334778259419807,5.553210866523024e-05,0.925
4378,4378,!^^/Punctuation,40,36,4,0.00042236300989218633,6.663853039827628e-05,0.9
4379,4379,상투/Noun,40,4,36,6.668889629876625e-05,0.0004220440258557498,0.9
4380,4380,마인드/Noun,40,5,35,7.780371234856063e-05,0.0004109376041227037,0.875
4381,4381,오인혜/Noun,40,5,35,7.780371234856063e-05,0.0004109376041227037,0.875
4382,4382,시리다/Adjective,40,35,5,0.0004112481938423919,7.774495213132233e-05,0.875
4383,4383,신파극/Noun,40,7,33,0.0001000333444481494,0.00038872476065661166,0.825
4384,4384,추락/Noun,40,7,33,0.0001000333444481494,0.00038872476065661166,0.825
4385,4385,이라곤/Josa,40,7,33,0.0001000333444481494,0.00038872476065661166,0.825
4386,4386,여정/Noun,40,32,8,0.00037790374569300877,0.00011106421733046048,0.8
4387,4387,귀가/Noun,40,32,8,0.00037790374569300877,0.00011106421733046048,0.8
4388,4388,증/Noun,40,8,32,0.00011114816049794375,0.0003776183389235656,0.8
4389,4389,어느새다/Adjective,40,32,8,0.00037790374569300877,0.00011106421733046048,0.8
4390,4390,이러니/Conjunction,40,8,32,0.00011114816049794375,0.0003776183389235656,0.8
4391,4391,강조/Noun,40,8,32,0.00011114816049794375,0.0003776183389235656,0.8
4392,4392,남자라면/Noun,40,32,8,0.00037790374569300877,0.00011106421733046048,0.8
4393,4393,ebs/Alpha,40,31,9,0.00036678892964321435,0.00012217063906350652,0.775
4394,4394,불법/Noun,40,9,31,0.00012226297654773814,0.00036651191719051963,0.775
4395,4395,저렴하다/Adjective,40,9,31,0.00012226297654773814,0.00036651191719051963,0.775
4396,4396,방이/Noun,40,30,10,0.00035567411359342004,0.00013327706079655256,0.75
4397,4397,곳곳/Noun,40,30,10,0.00035567411359342004,0.00013327706079655256,0.75
4398,4398,경이/Noun,40,30,10,0.00035567411359342004,0.00013327706079655256,0.75
4399,4399,옹박/Noun,40,10,30,0.0001333777925975325,0.0003554054954574735,0.75
4400,4400,자제/Noun,40,10,30,0.0001333777925975325,0.0003554054954574735,0.75
4401,4401,빼/Noun,40,11,29,0.0001444926086473269,0.00034429907372442745,0.725
4402,4402,우월/Noun,40,11,29,0.0001444926086473269,0.00034429907372442745,0.725
4403,4403,~~!/Punctuation,40,29,11,0.0003445592975436257,0.0001443834825295986,0.725
4404,4404,획/Noun,40,29,11,0.0003445592975436257,0.0001443834825295986,0.725
4405,4405,수업/Noun,40,29,11,0.0003445592975436257,0.0001443834825295986,0.725
4406,4406,호러물/Noun,40,11,29,0.0001444926086473269,0.00034429907372442745,0.725
4407,4407,유명/Noun,40,11,29,0.0001444926086473269,0.00034429907372442745,0.725
4408,4408,우디/Noun,40,28,12,0.0003334444814938313,0.00015548990426264466,0.7
4409,4409,승화/Noun,40,28,12,0.0003334444814938313,0.00015548990426264466,0.7
4410,4410,교감/Noun,40,28,12,0.0003334444814938313,0.00015548990426264466,0.7
4411,4411,외우다/Verb,40,28,12,0.0003334444814938313,0.00015548990426264466,0.7
4412,4412,퀴어/Noun,40,28,12,0.0003334444814938313,0.00015548990426264466,0.7
4413,4413,쫒다/Verb,40,13,27,0.00016672224074691566,0.00032208623025833537,0.675
4414,4414,수정/Noun,40,13,27,0.00016672224074691566,0.00032208623025833537,0.675
4415,4415,저녁/Noun,40,13,27,0.00016672224074691566,0.00032208623025833537,0.675
4416,4416,전의/Noun,40,26,14,0.00031121484939424253,0.00017770274772873674,0.65
4417,4417,상의/Noun,40,26,14,0.00031121484939424253,0.00017770274772873674,0.65
4418,4418,독창/Noun,40,14,26,0.00017783705679671002,0.00031097980852528933,0.65
4419,4419,매트릭스/Noun,40,26,14,0.00031121484939424253,0.00017770274772873674,0.65
4420,4420,버젼/Noun,40,15,25,0.00018895187284650438,0.0002998733867922433,0.625
4421,4421,김강우/Noun,40,24,16,0.0002889852172946538,0.00019991559119482882,0.6
4422,4422,런닝맨/Noun,40,16,24,0.0002000666888962988,0.0002887669650591972,0.6
4423,4423,리오/Noun,40,24,16,0.0002889852172946538,0.00019991559119482882,0.6
4424,4424,금방/Noun,40,24,16,0.0002889852172946538,0.00019991559119482882,0.6
4425,4425,정재영/Noun,40,24,16,0.0002889852172946538,0.00019991559119482882,0.6
4426,4426,건드리다/Verb,40,16,24,0.0002000666888962988,0.0002887669650591972,0.6
4427,4427,턱/Noun,40,17,23,0.00021118150494609317,0.00027766054332615115,0.575
4428,4428,감당/Noun,40,17,23,0.00021118150494609317,0.00027766054332615115,0.575
4429,4429,산드라/Noun,40,23,17,0.00027787040124485944,0.0002110220129278749,0.575
4430,4430,왓/Noun,40,23,17,0.00027787040124485944,0.0002110220129278749,0.575
4431,4431,애도/Noun,40,17,23,0.00021118150494609317,0.00027766054332615115,0.575
4432,4432,ㄹ/KoreanParticle,40,17,23,0.00021118150494609317,0.00027766054332615115,0.575
4433,4433,2004년/Number,40,23,17,0.00027787040124485944,0.0002110220129278749,0.575
4434,4434,한없이/Adverb,40,22,18,0.000266755585195065,0.00022212843466092096,0.55
4435,4435,높이/Noun,40,18,22,0.0002222963209958875,0.00026655412159310506,0.55
4436,4436,아자/Exclamation,40,22,18,0.000266755585195065,0.00022212843466092096,0.55
4437,4437,막스/Noun,40,22,18,0.000266755585195065,0.00022212843466092096,0.55
4438,4438,김민종/Noun,40,18,22,0.0002222963209958875,0.00026655412159310506,0.55
4439,4439,활/Noun,40,18,22,0.0002222963209958875,0.00026655412159310506,0.55
4440,4440,실존/Noun,40,21,19,0.00025564076914527065,0.000233234856393967,0.525
4441,4441,물씬/Noun,40,19,21,0.0002334111370456819,0.0002554476998600591,0.525
4442,4442,전사/Noun,40,19,21,0.0002334111370456819,0.0002554476998600591,0.525
4443,4443,로보캅/Noun,40,19,21,0.0002334111370456819,0.0002554476998600591,0.525
4444,4444,글구/Noun,40,20,20,0.00024452595309547634,0.00024434127812701304,0.5
4445,4445,격전/Noun,40,20,20,0.00024452595309547634,0.00024434127812701304,0.5
4446,4446,한예슬/Noun,40,20,20,0.00024452595309547634,0.00024434127812701304,0.5
4447,4447,진자/Noun,40,20,20,0.00024452595309547634,0.00024434127812701304,0.5
4448,4448,분석/Noun,40,20,20,0.00024452595309547634,0.00024434127812701304,0.5
4449,4449,투자자/Noun,39,0,39,2.2229632099588756e-05,0.000455363291054888,1.0
4450,4450,졸음/Noun,39,1,38,3.334444814938313e-05,0.0004442568693218419,0.9743589743589745
4451,4451,쓰레기통/Noun,39,1,38,3.334444814938313e-05,0.0004442568693218419,0.9743589743589745
4452,4452,문성우/Noun,39,2,37,4.445926419917751e-05,0.0004331504475887958,0.9487179487179488
4453,4453,환불/Noun,39,3,36,5.5574080248971876e-05,0.0004220440258557498,0.9230769230769232
4454,4454,황홀하다/Adjective,39,36,3,0.00042236300989218633,5.553210866523024e-05,0.9230769230769232
4455,4455,뭡/Noun,39,4,35,6.668889629876625e-05,0.0004109376041227037,0.8974358974358975
4456,4456,은은하다/Adjective,39,35,4,0.0004112481938423919,6.663853039827628e-05,0.8974358974358975
4457,4457,에서야/Josa,39,35,4,0.0004112481938423919,6.663853039827628e-05,0.8974358974358975
4458,4458,후지/Noun,39,4,35,6.668889629876625e-05,0.0004109376041227037,0.8974358974358975
4459,4459,우익/Noun,39,5,34,7.780371234856063e-05,0.00039983118238965764,0.8717948717948718
4460,4460,엉덩이/Noun,39,6,33,8.891852839835501e-05,0.00038872476065661166,0.8461538461538461
4461,4461,에릭/Noun,39,33,6,0.00038901856174280313,8.885137386436837e-05,0.8461538461538461
4462,4462,불면증/Noun,39,7,32,0.0001000333444481494,0.0003776183389235656,0.8205128205128205
4463,4463,찌푸리다/Verb,39,7,32,0.0001000333444481494,0.0003776183389235656,0.8205128205128205
4464,4464,구라/Noun,39,7,32,0.0001000333444481494,0.0003776183389235656,0.8205128205128205
4465,4465,젊음/Noun,39,31,8,0.00036678892964321435,0.00011106421733046048,0.7948717948717948
4466,4466,놀이/Suffix,39,8,31,0.00011114816049794375,0.00036651191719051963,0.7948717948717948
4467,4467,파이다/Verb,39,31,8,0.00036678892964321435,0.00011106421733046048,0.7948717948717948
4468,4468,울음/Noun,39,31,8,0.00036678892964321435,0.00011106421733046048,0.7948717948717948
4469,4469,헤어/Noun,39,30,9,0.00035567411359342004,0.00012217063906350652,0.7692307692307693
4470,4470,mbc/Alpha,39,9,30,0.00012226297654773814,0.0003554054954574735,0.7692307692307693
4471,4471,루이스/Noun,39,29,10,0.0003445592975436257,0.00013327706079655256,0.7435897435897436
4472,4472,에일리언/Noun,39,11,28,0.0001444926086473269,0.0003331926519913814,0.7179487179487181
4473,4473,전기/Noun,39,11,28,0.0001444926086473269,0.0003331926519913814,0.7179487179487181
4474,4474,극한/Noun,39,28,11,0.0003334444814938313,0.0001443834825295986,0.7179487179487181
4475,4475,우아하다/Adjective,39,28,11,0.0003334444814938313,0.0001443834825295986,0.7179487179487181
4476,4476,묘미/Noun,39,28,11,0.0003334444814938313,0.0001443834825295986,0.7179487179487181
4477,4477,관계자/Noun,39,11,28,0.0001444926086473269,0.0003331926519913814,0.7179487179487181
4478,4478,로그/Noun,39,11,28,0.0001444926086473269,0.0003331926519913814,0.7179487179487181
4479,4479,사나이/Noun,39,27,12,0.00032232966544403684,0.00015548990426264466,0.6923076923076923
4480,4480,오류/Noun,39,12,27,0.00015560742469712126,0.00032208623025833537,0.6923076923076923
4481,4481,이민정/Noun,39,27,12,0.00032232966544403684,0.00015548990426264466,0.6923076923076923
4482,4482,완/Noun,39,27,12,0.00032232966544403684,0.00015548990426264466,0.6923076923076923
4483,4483,한쪽/Noun,39,12,27,0.00015560742469712126,0.00032208623025833537,0.6923076923076923
4484,4484,활약/Noun,39,27,12,0.00032232966544403684,0.00015548990426264466,0.6923076923076923
4485,4485,필수/Noun,39,27,12,0.00032232966544403684,0.00015548990426264466,0.6923076923076923
4486,4486,제시/Noun,39,27,12,0.00032232966544403684,0.00015548990426264466,0.6923076923076923
4487,4487,찢다/Verb,39,13,26,0.00016672224074691566,0.00031097980852528933,0.6666666666666666
4488,4488,때메/Noun,39,13,26,0.00016672224074691566,0.00031097980852528933,0.6666666666666666
4489,4489,가사/Noun,39,26,13,0.00031121484939424253,0.0001665963259956907,0.6666666666666666
4490,4490,기간/Noun,39,26,13,0.00031121484939424253,0.0001665963259956907,0.6666666666666666
4491,4491,in/Alpha,39,26,13,0.00031121484939424253,0.0001665963259956907,0.6666666666666666
4492,4492,핸드폰/Noun,39,13,26,0.00016672224074691566,0.00031097980852528933,0.6666666666666666
4493,4493,멍청이/Noun,39,13,26,0.00016672224074691566,0.00031097980852528933,0.6666666666666666
4494,4494,사라/Noun,39,26,13,0.00031121484939424253,0.0001665963259956907,0.6666666666666666
4495,4495,쿠/Noun,39,26,13,0.00031121484939424253,0.0001665963259956907,0.6666666666666666
4496,4496,수다/Noun,39,14,25,0.00017783705679671002,0.0002998733867922433,0.6410256410256411
4497,4497,에의/Josa,39,25,14,0.00030010003334444816,0.00017770274772873674,0.6410256410256411
4498,4498,불러일으키다/Verb,39,25,14,0.00030010003334444816,0.00017770274772873674,0.6410256410256411
4499,4499,내겐/Noun,39,25,14,0.00030010003334444816,0.00017770274772873674,0.6410256410256411
4500,4500,크로우/Noun,39,25,14,0.00030010003334444816,0.00017770274772873674,0.6410256410256411
4501,4501,로렌스/Noun,39,25,14,0.00030010003334444816,0.00017770274772873674,0.6410256410256411
4502,4502,다음주/Noun,39,25,14,0.00030010003334444816,0.00017770274772873674,0.6410256410256411
4503,4503,불리다/Verb,39,24,15,0.0002889852172946538,0.0001888091694617828,0.6153846153846154
4504,4504,예매/Noun,39,15,24,0.00018895187284650438,0.0002887669650591972,0.6153846153846154
4505,4505,폭/Noun,39,24,15,0.0002889852172946538,0.0001888091694617828,0.6153846153846154
4506,4506,연장/Noun,39,15,24,0.00018895187284650438,0.0002887669650591972,0.6153846153846154
4507,4507,시르다/Adjective,39,15,24,0.00018895187284650438,0.0002887669650591972,0.6153846153846154
4508,4508,임용/Noun,39,16,23,0.0002000666888962988,0.00027766054332615115,0.5897435897435898
4509,4509,to/Alpha,39,23,16,0.00027787040124485944,0.00019991559119482882,0.5897435897435898
4510,4510,단편영화/Noun,39,16,23,0.0002000666888962988,0.00027766054332615115,0.5897435897435898
4511,4511,맥스/Noun,39,23,16,0.00027787040124485944,0.00019991559119482882,0.5897435897435898
4512,4512,전적/Noun,39,16,23,0.0002000666888962988,0.00027766054332615115,0.5897435897435898
4513,4513,그러면/Adverb,39,16,23,0.0002000666888962988,0.00027766054332615115,0.5897435897435898
4514,4514,창작/Noun,39,16,23,0.0002000666888962988,0.00027766054332615115,0.5897435897435898
4515,4515,볼땐/Noun,39,22,17,0.000266755585195065,0.0002110220129278749,0.5641025641025641
4516,4516,발생/Noun,39,22,17,0.000266755585195065,0.0002110220129278749,0.5641025641025641
4517,4517,사망/Noun,39,17,22,0.00021118150494609317,0.00026655412159310506,0.5641025641025641
4518,4518,다문화/Noun,39,17,22,0.00021118150494609317,0.00026655412159310506,0.5641025641025641
4519,4519,악평/Noun,39,22,17,0.000266755585195065,0.0002110220129278749,0.5641025641025641
4520,4520,호텔/Noun,39,21,18,0.00025564076914527065,0.00022212843466092096,0.5384615384615384
4521,4521,비난/Noun,39,21,18,0.00025564076914527065,0.00022212843466092096,0.5384615384615384
4522,4522,치명/Noun,39,21,18,0.00025564076914527065,0.00022212843466092096,0.5384615384615384
4523,4523,컬트/Noun,39,21,18,0.00025564076914527065,0.00022212843466092096,0.5384615384615384
4524,4524,샤를/Noun,39,21,18,0.00025564076914527065,0.00022212843466092096,0.5384615384615384
4525,4525,종일/Noun,39,18,21,0.0002222963209958875,0.0002554476998600591,0.5384615384615384
4526,4526,조직/Noun,39,21,18,0.00025564076914527065,0.00022212843466092096,0.5384615384615384
4527,4527,즉/Noun,39,20,19,0.00024452595309547634,0.000233234856393967,0.5128205128205128
4528,4528,노예/Noun,39,19,20,0.0002334111370456819,0.00024434127812701304,0.5128205128205128
4529,4529,이성재/Noun,39,20,19,0.00024452595309547634,0.000233234856393967,0.5128205128205128
4530,4530,충만/Noun,39,20,19,0.00024452595309547634,0.000233234856393967,0.5128205128205128
4531,4531,그러하다/Adjective,39,20,19,0.00024452595309547634,0.000233234856393967,0.5128205128205128
4532,4532,아마도/Adverb,39,19,20,0.0002334111370456819,0.00024434127812701304,0.5128205128205128
4533,4533,지상/Noun,39,20,19,0.00024452595309547634,0.000233234856393967,0.5128205128205128
4534,4534,안질리다/Verb,38,37,1,0.0004334778259419807,3.331926519913814e-05,0.9736842105263158
4535,4535,아리다/Adjective,38,36,2,0.00042236300989218633,4.4425686932184186e-05,0.9473684210526316
4536,4536,자빠지다/Verb,38,3,35,5.5574080248971876e-05,0.0004109376041227037,0.9210526315789472
4537,4537,무니/Noun,38,5,33,7.780371234856063e-05,0.00038872476065661166,0.8684210526315791
4538,4538,불친절하다/Adjective,38,5,33,7.780371234856063e-05,0.00038872476065661166,0.8684210526315791
4539,4539,은지/Noun,38,5,33,7.780371234856063e-05,0.00038872476065661166,0.8684210526315791
4540,4540,거창하다/Adjective,38,5,33,7.780371234856063e-05,0.00038872476065661166,0.8684210526315791
4541,4541,깝/Noun,38,6,32,8.891852839835501e-05,0.0003776183389235656,0.8421052631578947
4542,4542,0.5/Number,38,6,32,8.891852839835501e-05,0.0003776183389235656,0.8421052631578947
4543,4543,허탈하다/Adjective,38,7,31,0.0001000333444481494,0.00036651191719051963,0.8157894736842105
4544,4544,!!!!!!!/Punctuation,38,31,7,0.00036678892964321435,9.995779559741441e-05,0.8157894736842105
4545,4545,현대인/Noun,38,31,7,0.00036678892964321435,9.995779559741441e-05,0.8157894736842105
4546,4546,화평/Noun,38,9,29,0.00012226297654773814,0.00034429907372442745,0.7631578947368421
4547,4547,살아오다/Verb,38,29,9,0.0003445592975436257,0.00012217063906350652,0.7631578947368421
4548,4548,까먹다/Verb,38,9,29,0.00012226297654773814,0.00034429907372442745,0.7631578947368421
4549,4549,치열하다/Adjective,38,28,10,0.0003334444814938313,0.00013327706079655256,0.7368421052631579
4550,4550,제작사/Noun,38,10,28,0.0001333777925975325,0.0003331926519913814,0.7368421052631579
4551,4551,경쾌하다/Adjective,38,28,10,0.0003334444814938313,0.00013327706079655256,0.7368421052631579
4552,4552,연령/Noun,38,10,28,0.0001333777925975325,0.0003331926519913814,0.7368421052631579
4553,4553,F/Alpha,38,11,27,0.0001444926086473269,0.00032208623025833537,0.7105263157894737
4554,4554,간의/Noun,38,27,11,0.00032232966544403684,0.0001443834825295986,0.7105263157894737
4555,4555,생략/Noun,38,11,27,0.0001444926086473269,0.00032208623025833537,0.7105263157894737
4556,4556,14년/Number,38,27,11,0.00032232966544403684,0.0001443834825295986,0.7105263157894737
4557,4557,가버리다/Verb,38,12,26,0.00015560742469712126,0.00031097980852528933,0.6842105263157895
4558,4558,미만/Noun,38,12,26,0.00015560742469712126,0.00031097980852528933,0.6842105263157895
4559,4559,전세계/Noun,38,26,12,0.00031121484939424253,0.00015548990426264466,0.6842105263157895
4560,4560,질주/Noun,38,25,13,0.00030010003334444816,0.0001665963259956907,0.6578947368421053
4561,4561,아카데미/Noun,38,25,13,0.00030010003334444816,0.0001665963259956907,0.6578947368421053
4562,4562,부수/Noun,38,13,25,0.00016672224074691566,0.0002998733867922433,0.6578947368421053
4563,4563,동의/Noun,38,13,25,0.00016672224074691566,0.0002998733867922433,0.6578947368421053
4564,4564,청/Noun,38,13,25,0.00016672224074691566,0.0002998733867922433,0.6578947368421053
4565,4565,멍하다/Adjective,38,25,13,0.00030010003334444816,0.0001665963259956907,0.6578947368421053
4566,4566,물어보다/Verb,38,13,25,0.00016672224074691566,0.0002998733867922433,0.6578947368421053
4567,4567,빅뱅/Noun,38,24,14,0.0002889852172946538,0.00017770274772873674,0.631578947368421
4568,4568,레인/Noun,38,14,24,0.00017783705679671002,0.0002887669650591972,0.631578947368421
4569,4569,훈련/Noun,38,14,24,0.00017783705679671002,0.0002887669650591972,0.631578947368421
4570,4570,"..,/Punctuation",38,14,24,0.00017783705679671002,0.0002887669650591972,0.631578947368421
4571,4571,법칙/Noun,38,14,24,0.00017783705679671002,0.0002887669650591972,0.631578947368421
4572,4572,삼다/Verb,38,14,24,0.00017783705679671002,0.0002887669650591972,0.631578947368421
4573,4573,보장/Noun,38,24,14,0.0002889852172946538,0.00017770274772873674,0.631578947368421
4574,4574,마마/Noun,38,14,24,0.00017783705679671002,0.0002887669650591972,0.631578947368421
4575,4575,케이트/Noun,38,23,15,0.00027787040124485944,0.0001888091694617828,0.6052631578947368
4576,4576,얽히다/Verb,38,23,15,0.00027787040124485944,0.0001888091694617828,0.6052631578947368
4577,4577,직장/Noun,38,23,15,0.00027787040124485944,0.0001888091694617828,0.6052631578947368
4578,4578,로마/Noun,38,15,23,0.00018895187284650438,0.00027766054332615115,0.6052631578947368
4579,4579,트릭/Noun,38,23,15,0.00027787040124485944,0.0001888091694617828,0.6052631578947368
4580,4580,현빈/Noun,38,23,15,0.00027787040124485944,0.0001888091694617828,0.6052631578947368
4581,4581,허영/Noun,38,15,23,0.00018895187284650438,0.00027766054332615115,0.6052631578947368
4582,4582,에이리언/Noun,38,22,16,0.000266755585195065,0.00019991559119482882,0.5789473684210527
4583,4583,꾼/Suffix,38,16,22,0.0002000666888962988,0.00026655412159310506,0.5789473684210527
4584,4584,코스트/Noun,38,22,16,0.000266755585195065,0.00019991559119482882,0.5789473684210527
4585,4585,가운데/Noun,38,22,16,0.000266755585195065,0.00019991559119482882,0.5789473684210527
4586,4586,무려/Noun,38,22,16,0.000266755585195065,0.00019991559119482882,0.5789473684210527
4587,4587,동료/Noun,38,21,17,0.00025564076914527065,0.0002110220129278749,0.5526315789473685
4588,4588,높아지다/Verb,38,17,21,0.00021118150494609317,0.0002554476998600591,0.5526315789473685
4589,4589,외화/Noun,38,17,21,0.00021118150494609317,0.0002554476998600591,0.5526315789473685
4590,4590,가만히/Adverb,38,17,21,0.00021118150494609317,0.0002554476998600591,0.5526315789473685
4591,4591,자세/Noun,38,17,21,0.00021118150494609317,0.0002554476998600591,0.5526315789473685
4592,4592,나약하다/Adjective,38,21,17,0.00025564076914527065,0.0002110220129278749,0.5526315789473685
4593,4593,엄/Noun,38,18,20,0.0002222963209958875,0.00024434127812701304,0.5263157894736842
4594,4594,kbs/Alpha,38,20,18,0.00024452595309547634,0.00022212843466092096,0.5263157894736842
4595,4595,화해/Noun,38,20,18,0.00024452595309547634,0.00022212843466092096,0.5263157894736842
4596,4596,전국/Noun,38,20,18,0.00024452595309547634,0.00022212843466092096,0.5263157894736842
4597,4597,물리다/Verb,38,20,18,0.00024452595309547634,0.00022212843466092096,0.5263157894736842
4598,4598,머피/Noun,38,20,18,0.00024452595309547634,0.00022212843466092096,0.5263157894736842
4599,4599,평론/Noun,38,19,19,0.0002334111370456819,0.000233234856393967,0.5
4600,4600,데스/Noun,38,19,19,0.0002334111370456819,0.000233234856393967,0.5
4601,4601,관객수/Noun,38,19,19,0.0002334111370456819,0.000233234856393967,0.5
4602,4602,찬란/Noun,37,0,37,2.2229632099588756e-05,0.0004331504475887958,1.0
4603,4603,채플린/Noun,37,34,3,0.0004001333777925976,5.553210866523024e-05,0.9189189189189191
4604,4604,대책/Noun,37,3,34,5.5574080248971876e-05,0.00039983118238965764,0.9189189189189191
4605,4605,날로/Noun,37,3,34,5.5574080248971876e-05,0.00039983118238965764,0.9189189189189191
4606,4606,개잼/Noun,37,33,4,0.00038901856174280313,6.663853039827628e-05,0.8918918918918919
4607,4607,워싱턴/Noun,37,33,4,0.00038901856174280313,6.663853039827628e-05,0.8918918918918919
4608,4608,꾹/Noun,37,4,33,6.668889629876625e-05,0.00038872476065661166,0.8918918918918919
4609,4609,거뭐/Noun,37,5,32,7.780371234856063e-05,0.0003776183389235656,0.8648648648648649
4610,4610,설레임/Noun,37,32,5,0.00037790374569300877,7.774495213132233e-05,0.8648648648648649
4611,4611,습작/Noun,37,5,32,7.780371234856063e-05,0.0003776183389235656,0.8648648648648649
4612,4612,신들리다/Adjective,37,32,5,0.00037790374569300877,7.774495213132233e-05,0.8648648648648649
4613,4613,두근두근/Adverb,37,31,6,0.00036678892964321435,8.885137386436837e-05,0.8378378378378378
4614,4614,뇌리/Noun,37,31,6,0.00036678892964321435,8.885137386436837e-05,0.8378378378378378
4615,4615,패턴/Noun,37,6,31,8.891852839835501e-05,0.00036651191719051963,0.8378378378378378
4616,4616,공개/Noun,37,6,31,8.891852839835501e-05,0.00036651191719051963,0.8378378378378378
4617,4617,동아리/Noun,37,6,31,8.891852839835501e-05,0.00036651191719051963,0.8378378378378378
4618,4618,몰락/Noun,37,7,30,0.0001000333444481494,0.0003554054954574735,0.8108108108108109
4619,4619,옹호/Noun,37,7,30,0.0001000333444481494,0.0003554054954574735,0.8108108108108109
4620,4620,껄/Noun,37,7,30,0.0001000333444481494,0.0003554054954574735,0.8108108108108109
4621,4621,오로라/Noun,37,7,30,0.0001000333444481494,0.0003554054954574735,0.8108108108108109
4622,4622,신비롭다/Adjective,37,30,7,0.00035567411359342004,9.995779559741441e-05,0.8108108108108109
4623,4623,이라고는/Josa,37,8,29,0.00011114816049794375,0.00034429907372442745,0.7837837837837838
4624,4624,넋/Noun,37,29,8,0.0003445592975436257,0.00011106421733046048,0.7837837837837838
4625,4625,눈부시다/Adjective,37,29,8,0.0003445592975436257,0.00011106421733046048,0.7837837837837838
4626,4626,서우/Noun,37,8,29,0.00011114816049794375,0.00034429907372442745,0.7837837837837838
4627,4627,라곤/Josa,37,8,29,0.00011114816049794375,0.00034429907372442745,0.7837837837837838
4628,4628,닦다/Verb,37,8,29,0.00011114816049794375,0.00034429907372442745,0.7837837837837838
4629,4629,강호동/Noun,37,9,28,0.00012226297654773814,0.0003331926519913814,0.7567567567567568
4630,4630,탕웨이/Noun,37,28,9,0.0003334444814938313,0.00012217063906350652,0.7567567567567568
4631,4631,유도/Noun,37,9,28,0.00012226297654773814,0.0003331926519913814,0.7567567567567568
4632,4632,고질라/Noun,37,9,28,0.00012226297654773814,0.0003331926519913814,0.7567567567567568
4633,4633,엠마/Noun,37,28,9,0.0003334444814938313,0.00012217063906350652,0.7567567567567568
4634,4634,이남/Noun,37,28,9,0.0003334444814938313,0.00012217063906350652,0.7567567567567568
4635,4635,켄/Noun,37,28,9,0.0003334444814938313,0.00012217063906350652,0.7567567567567568
4636,4636,오랜/Adverb,37,27,10,0.00032232966544403684,0.00013327706079655256,0.7297297297297297
4637,4637,.!!/Punctuation,37,27,10,0.00032232966544403684,0.00013327706079655256,0.7297297297297297
4638,4638,근거/Noun,37,10,27,0.0001333777925975325,0.00032208623025833537,0.7297297297297297
4639,4639,브래드피트/Noun,37,27,10,0.00032232966544403684,0.00013327706079655256,0.7297297297297297
4640,4640,엑소시스트/Noun,37,10,27,0.0001333777925975325,0.00032208623025833537,0.7297297297297297
4641,4641,예의/Noun,37,11,26,0.0001444926086473269,0.00031097980852528933,0.7027027027027027
4642,4642,수술/Noun,37,11,26,0.0001444926086473269,0.00031097980852528933,0.7027027027027027
4643,4643,힙합/Noun,37,11,26,0.0001444926086473269,0.00031097980852528933,0.7027027027027027
4644,4644,............./Punctuation,37,11,26,0.0001444926086473269,0.00031097980852528933,0.7027027027027027
4645,4645,마초/Noun,37,11,26,0.0001444926086473269,0.00031097980852528933,0.7027027027027027
4646,4646,부담스럽다/Adjective,37,11,26,0.0001444926086473269,0.00031097980852528933,0.7027027027027027
4647,4647,소문/Noun,37,11,26,0.0001444926086473269,0.00031097980852528933,0.7027027027027027
4648,4648,사서/Noun,37,26,11,0.00031121484939424253,0.0001443834825295986,0.7027027027027027
4649,4649,변호사/Noun,37,26,11,0.00031121484939424253,0.0001443834825295986,0.7027027027027027
4650,4650,신선/Noun,37,25,12,0.00030010003334444816,0.00015548990426264466,0.6756756756756757
4651,4651,성향/Noun,37,12,25,0.00015560742469712126,0.0002998733867922433,0.6756756756756757
4652,4652,육체/Noun,37,13,24,0.00016672224074691566,0.0002887669650591972,0.6486486486486487
4653,4653,신현준/Noun,37,14,23,0.00017783705679671002,0.00027766054332615115,0.6216216216216216
4654,4654,진의/Noun,37,14,23,0.00017783705679671002,0.00027766054332615115,0.6216216216216216
4655,4655,유작/Noun,37,14,23,0.00017783705679671002,0.00027766054332615115,0.6216216216216216
4656,4656,간절하다/Adjective,37,23,14,0.00027787040124485944,0.00017770274772873674,0.6216216216216216
4657,4657,안경/Noun,37,14,23,0.00017783705679671002,0.00027766054332615115,0.6216216216216216
4658,4658,라지/Josa,37,14,23,0.00017783705679671002,0.00027766054332615115,0.6216216216216216
4659,4659,히트/Noun,37,23,14,0.00027787040124485944,0.00017770274772873674,0.6216216216216216
4660,4660,거울/Noun,37,23,14,0.00027787040124485944,0.00017770274772873674,0.6216216216216216
4661,4661,까지의/Josa,37,23,14,0.00027787040124485944,0.00017770274772873674,0.6216216216216216
4662,4662,용감하다/Adjective,37,22,15,0.000266755585195065,0.0001888091694617828,0.5945945945945946
4663,4663,나라/Suffix,37,15,22,0.00018895187284650438,0.00026655412159310506,0.5945945945945946
4664,4664,버금/Noun,37,22,15,0.000266755585195065,0.0001888091694617828,0.5945945945945946
4665,4665,믄/Modifier,37,15,22,0.00018895187284650438,0.00026655412159310506,0.5945945945945946
4666,4666,싹/Noun,37,15,22,0.00018895187284650438,0.00026655412159310506,0.5945945945945946
4667,4667,이순신/Noun,37,15,22,0.00018895187284650438,0.00026655412159310506,0.5945945945945946
4668,4668,주체/Noun,37,22,15,0.000266755585195065,0.0001888091694617828,0.5945945945945946
4669,4669,한장/Noun,37,22,15,0.000266755585195065,0.0001888091694617828,0.5945945945945946
4670,4670,나아지다/Verb,37,15,22,0.00018895187284650438,0.00026655412159310506,0.5945945945945946
4671,4671,마크/Noun,37,22,15,0.000266755585195065,0.0001888091694617828,0.5945945945945946
4672,4672,앞서다/Verb,37,21,16,0.00025564076914527065,0.00019991559119482882,0.5675675675675675
4673,4673,까메오/Noun,37,16,21,0.0002000666888962988,0.0002554476998600591,0.5675675675675675
4674,4674,홍진호/Noun,37,16,21,0.0002000666888962988,0.0002554476998600591,0.5675675675675675
4675,4675,300/Number,37,16,21,0.0002000666888962988,0.0002554476998600591,0.5675675675675675
4676,4676,제법/Noun,37,21,16,0.00025564076914527065,0.00019991559119482882,0.5675675675675675
4677,4677,더보/Noun,37,16,21,0.0002000666888962988,0.0002554476998600591,0.5675675675675675
4678,4678,페이/Noun,37,21,16,0.00025564076914527065,0.00019991559119482882,0.5675675675675675
4679,4679,이범수/Noun,37,21,16,0.00025564076914527065,0.00019991559119482882,0.5675675675675675
4680,4680,그러니까/Adverb,37,16,21,0.0002000666888962988,0.0002554476998600591,0.5675675675675675
4681,4681,금요일/Noun,37,21,16,0.00025564076914527065,0.00019991559119482882,0.5675675675675675
4682,4682,짐승/Noun,37,16,21,0.0002000666888962988,0.0002554476998600591,0.5675675675675675
4683,4683,부의/Noun,37,21,16,0.00025564076914527065,0.00019991559119482882,0.5675675675675675
4684,4684,지하철/Noun,37,16,21,0.0002000666888962988,0.0002554476998600591,0.5675675675675675
4685,4685,루크/Noun,37,21,16,0.00025564076914527065,0.00019991559119482882,0.5675675675675675
4686,4686,넓다/Adjective,37,17,20,0.00021118150494609317,0.00024434127812701304,0.5405405405405406
4687,4687,율/Noun,37,20,17,0.00024452595309547634,0.0002110220129278749,0.5405405405405406
4688,4688,황금/Noun,37,20,17,0.00024452595309547634,0.0002110220129278749,0.5405405405405406
4689,4689,부가/Noun,37,20,17,0.00024452595309547634,0.0002110220129278749,0.5405405405405406
4690,4690,스톤/Noun,37,17,20,0.00021118150494609317,0.00024434127812701304,0.5405405405405406
4691,4691,인디아나/Noun,37,19,18,0.0002334111370456819,0.00022212843466092096,0.5135135135135135
4692,4692,허전하다/Adjective,37,18,19,0.0002222963209958875,0.000233234856393967,0.5135135135135135
4693,4693,플/Exclamation,37,18,19,0.0002222963209958875,0.000233234856393967,0.5135135135135135
4694,4694,낚임/Noun,36,0,36,2.2229632099588756e-05,0.0004220440258557498,1.0
4695,4695,되돌아보다/Verb,36,35,1,0.0004112481938423919,3.331926519913814e-05,0.9722222222222222
4696,4696,보고/Foreign,36,3,33,5.5574080248971876e-05,0.00038872476065661166,0.9166666666666666
4697,4697,치기/Noun,36,3,33,5.5574080248971876e-05,0.00038872476065661166,0.9166666666666666
4698,4698,큐브/Noun,36,4,32,6.668889629876625e-05,0.0003776183389235656,0.8888888888888888
4699,4699,욤/Noun,36,31,5,0.00036678892964321435,7.774495213132233e-05,0.8611111111111112
4700,4700,허니/Noun,36,31,5,0.00036678892964321435,7.774495213132233e-05,0.8611111111111112
4701,4701,100분/Number,36,5,31,7.780371234856063e-05,0.00036651191719051963,0.8611111111111112
4702,4702,발암/Noun,36,5,31,7.780371234856063e-05,0.00036651191719051963,0.8611111111111112
4703,4703,엑스트라/Noun,36,6,30,8.891852839835501e-05,0.0003554054954574735,0.8333333333333334
4704,4704,서극/Noun,36,7,29,0.0001000333444481494,0.00034429907372442745,0.8055555555555556
4705,4705,멋대로/Noun,36,7,29,0.0001000333444481494,0.00034429907372442745,0.8055555555555556
4706,4706,평이하다/Adjective,36,7,29,0.0001000333444481494,0.00034429907372442745,0.8055555555555556
4707,4707,내러티브/Noun,36,8,28,0.00011114816049794375,0.0003331926519913814,0.7777777777777778
4708,4708,볼껄/Noun,36,8,28,0.00011114816049794375,0.0003331926519913814,0.7777777777777778
4709,4709,t/Alpha,36,28,8,0.0003334444814938313,0.00011106421733046048,0.7777777777777778
4710,4710,하차/Noun,36,8,28,0.00011114816049794375,0.0003331926519913814,0.7777777777777778
4711,4711,!!!!!!!!/Punctuation,36,28,8,0.0003334444814938313,0.00011106421733046048,0.7777777777777778
4712,4712,꽉/Noun,36,28,8,0.0003334444814938313,0.00011106421733046048,0.7777777777777778
4713,4713,역사왜곡/Noun,36,9,27,0.00012226297654773814,0.00032208623025833537,0.75
4714,4714,자신감/Noun,36,9,27,0.00012226297654773814,0.00032208623025833537,0.75
4715,4715,진화/Noun,36,26,10,0.00031121484939424253,0.00013327706079655256,0.7222222222222222
4716,4716,자본주의/Noun,36,26,10,0.00031121484939424253,0.00013327706079655256,0.7222222222222222
4717,4717,줄리엣/Noun,36,26,10,0.00031121484939424253,0.00013327706079655256,0.7222222222222222
4718,4718,다가가다/Verb,36,26,10,0.00031121484939424253,0.00013327706079655256,0.7222222222222222
4719,4719,지진희/Noun,36,10,26,0.0001333777925975325,0.00031097980852528933,0.7222222222222222
4720,4720,수애/Noun,36,25,11,0.00030010003334444816,0.0001443834825295986,0.6944444444444444
4721,4721,정신차리다/Adjective,36,11,25,0.0001444926086473269,0.0002998733867922433,0.6944444444444444
4722,4722,먹이다/Verb,36,12,24,0.00015560742469712126,0.0002887669650591972,0.6666666666666666
4723,4723,어찌나/Adverb,36,24,12,0.0002889852172946538,0.00015548990426264466,0.6666666666666666
4724,4724,문근영/Noun,36,24,12,0.0002889852172946538,0.00015548990426264466,0.6666666666666666
4725,4725,호평/Noun,36,12,24,0.00015560742469712126,0.0002887669650591972,0.6666666666666666
4726,4726,호소/Noun,36,13,23,0.00016672224074691566,0.00027766054332615115,0.6388888888888888
4727,4727,신은경/Noun,36,13,23,0.00016672224074691566,0.00027766054332615115,0.6388888888888888
4728,4728,일대기/Noun,36,23,13,0.00027787040124485944,0.0001665963259956907,0.6388888888888888
4729,4729,투표/Noun,36,13,23,0.00016672224074691566,0.00027766054332615115,0.6388888888888888
4730,4730,판치다/Verb,36,13,23,0.00016672224074691566,0.00027766054332615115,0.6388888888888888
4731,4731,휘/Noun,36,13,23,0.00016672224074691566,0.00027766054332615115,0.6388888888888888
4732,4732,놀람/Noun,36,22,14,0.000266755585195065,0.00017770274772873674,0.6111111111111112
4733,4733,런닝/Noun,36,14,22,0.00017783705679671002,0.00026655412159310506,0.6111111111111112
4734,4734,오리/Noun,36,14,22,0.00017783705679671002,0.00026655412159310506,0.6111111111111112
4735,4735,김하늘/Noun,36,22,14,0.000266755585195065,0.00017770274772873674,0.6111111111111112
4736,4736,"?""/Punctuation",36,14,22,0.00017783705679671002,0.00026655412159310506,0.6111111111111112
4737,4737,프레디/Noun,36,15,21,0.00018895187284650438,0.0002554476998600591,0.5833333333333334
4738,4738,사르다/Verb,36,21,15,0.00025564076914527065,0.0001888091694617828,0.5833333333333334
4739,4739,표본/Noun,36,15,21,0.00018895187284650438,0.0002554476998600591,0.5833333333333334
4740,4740,풍기다/Verb,36,15,21,0.00018895187284650438,0.0002554476998600591,0.5833333333333334
4741,4741,판타스틱/Noun,36,21,15,0.00025564076914527065,0.0001888091694617828,0.5833333333333334
4742,4742,미키/Noun,36,21,15,0.00025564076914527065,0.0001888091694617828,0.5833333333333334
4743,4743,퍼즐/Noun,36,15,21,0.00018895187284650438,0.0002554476998600591,0.5833333333333334
4744,4744,비정상/Noun,36,15,21,0.00018895187284650438,0.0002554476998600591,0.5833333333333334
4745,4745,바이러스/Noun,36,15,21,0.00018895187284650438,0.0002554476998600591,0.5833333333333334
4746,4746,받치다/Verb,36,16,20,0.0002000666888962988,0.00024434127812701304,0.5555555555555556
4747,4747,화답/Noun,36,16,20,0.0002000666888962988,0.00024434127812701304,0.5555555555555556
4748,4748,보삼/Noun,36,20,16,0.00024452595309547634,0.00019991559119482882,0.5555555555555556
4749,4749,호러영화/Noun,36,20,16,0.00024452595309547634,0.00019991559119482882,0.5555555555555556
4750,4750,2002년/Number,36,20,16,0.00024452595309547634,0.00019991559119482882,0.5555555555555556
4751,4751,며/Noun,36,20,16,0.00024452595309547634,0.00019991559119482882,0.5555555555555556
4752,4752,으로나/Josa,36,16,20,0.0002000666888962988,0.00024434127812701304,0.5555555555555556
4753,4753,발휘/Noun,36,17,19,0.00021118150494609317,0.000233234856393967,0.5277777777777778
4754,4754,테론/Noun,36,19,17,0.0002334111370456819,0.0002110220129278749,0.5277777777777778
4755,4755,가난하다/Adjective,36,19,17,0.0002334111370456819,0.0002110220129278749,0.5277777777777778
4756,4756,종이/Noun,36,19,17,0.0002334111370456819,0.0002110220129278749,0.5277777777777778
4757,4757,현장/Noun,36,19,17,0.0002334111370456819,0.0002110220129278749,0.5277777777777778
4758,4758,기묘하다/Adjective,36,19,17,0.0002334111370456819,0.0002110220129278749,0.5277777777777778
4759,4759,인종/Noun,36,19,17,0.0002334111370456819,0.0002110220129278749,0.5277777777777778
4760,4760,런닝타임/Noun,36,18,18,0.0002222963209958875,0.00022212843466092096,0.5
4761,4761,내공/Noun,36,18,18,0.0002222963209958875,0.00022212843466092096,0.5
4762,4762,벨/Noun,36,18,18,0.0002222963209958875,0.00022212843466092096,0.5
4763,4763,함정/Noun,36,18,18,0.0002222963209958875,0.00022212843466092096,0.5
4764,4764,비유/Noun,36,18,18,0.0002222963209958875,0.00022212843466092096,0.5
4765,4765,OCN/Alpha,36,18,18,0.0002222963209958875,0.00022212843466092096,0.5
4766,4766,♡♡/Foreign,35,35,0,0.0004112481938423919,2.2212843466092093e-05,1.0
4767,4767,최저/Noun,35,1,34,3.334444814938313e-05,0.00039983118238965764,0.9714285714285714
4768,4768,나열/Noun,35,2,33,4.445926419917751e-05,0.00038872476065661166,0.9428571428571428
4769,4769,알맹이/Noun,35,2,33,4.445926419917751e-05,0.00038872476065661166,0.9428571428571428
4770,4770,정신건강/Noun,35,3,32,5.5574080248971876e-05,0.0003776183389235656,0.9142857142857144
4771,4771,도아/Noun,35,3,32,5.5574080248971876e-05,0.0003776183389235656,0.9142857142857144
4772,4772,건강하다/Adjective,35,31,4,0.00036678892964321435,6.663853039827628e-05,0.8857142857142857
4773,4773,^_^/Punctuation,35,30,5,0.00035567411359342004,7.774495213132233e-05,0.8571428571428571
4774,4774,선전/Noun,35,5,30,7.780371234856063e-05,0.0003554054954574735,0.8571428571428571
4775,4775,구매/Noun,35,29,6,0.0003445592975436257,8.885137386436837e-05,0.8285714285714286
4776,4776,진솔하다/Adjective,35,29,6,0.0003445592975436257,8.885137386436837e-05,0.8285714285714286
4777,4777,이나마/Josa,35,29,6,0.0003445592975436257,8.885137386436837e-05,0.8285714285714286
4778,4778,어물/Noun,35,6,29,8.891852839835501e-05,0.00034429907372442745,0.8285714285714286
4779,4779,찰리/Noun,35,28,7,0.0003334444814938313,9.995779559741441e-05,0.8
4780,4780,합리화/Noun,35,7,28,0.0001000333444481494,0.0003331926519913814,0.8
4781,4781,작정/Noun,35,8,27,0.00011114816049794375,0.00032208623025833537,0.7714285714285715
4782,4782,데이먼/Noun,35,27,8,0.00032232966544403684,0.00011106421733046048,0.7714285714285715
4783,4783,잡지/Noun,35,8,27,0.00011114816049794375,0.00032208623025833537,0.7714285714285715
4784,4784,갑갑하다/Adjective,35,8,27,0.00011114816049794375,0.00032208623025833537,0.7714285714285715
4785,4785,인내/Noun,35,9,26,0.00012226297654773814,0.00031097980852528933,0.7428571428571429
4786,4786,미군/Noun,35,9,26,0.00012226297654773814,0.00031097980852528933,0.7428571428571429
4787,4787,발톱/Noun,35,9,26,0.00012226297654773814,0.00031097980852528933,0.7428571428571429
4788,4788,괴롭히다/Verb,35,9,26,0.00012226297654773814,0.00031097980852528933,0.7428571428571429
4789,4789,과도/Josa,35,26,9,0.00031121484939424253,0.00012217063906350652,0.7428571428571429
4790,4790,악몽/Noun,35,9,26,0.00012226297654773814,0.00031097980852528933,0.7428571428571429
4791,4791,ㄴㄴ/KoreanParticle,35,9,26,0.00012226297654773814,0.00031097980852528933,0.7428571428571429
4792,4792,보스/Noun,35,9,26,0.00012226297654773814,0.00031097980852528933,0.7428571428571429
4793,4793,띄우다/Verb,35,9,26,0.00012226297654773814,0.00031097980852528933,0.7428571428571429
4794,4794,치밀다/Verb,35,9,26,0.00012226297654773814,0.00031097980852528933,0.7428571428571429
4795,4795,광주/Noun,35,9,26,0.00012226297654773814,0.00031097980852528933,0.7428571428571429
4796,4796,혼나다/Verb,35,10,25,0.0001333777925975325,0.0002998733867922433,0.7142857142857143
4797,4797,태우다/Verb,35,10,25,0.0001333777925975325,0.0002998733867922433,0.7142857142857143
4798,4798,엘/Noun,35,25,10,0.00030010003334444816,0.00013327706079655256,0.7142857142857143
4799,4799,잣/Noun,35,10,25,0.0001333777925975325,0.0002998733867922433,0.7142857142857143
4800,4800,마구/Noun,35,10,25,0.0001333777925975325,0.0002998733867922433,0.7142857142857143
4801,4801,설치다/Adjective,35,10,25,0.0001333777925975325,0.0002998733867922433,0.7142857142857143
4802,4802,스포일러/Noun,35,24,11,0.0002889852172946538,0.0001443834825295986,0.6857142857142857
4803,4803,여자도/Noun,35,11,24,0.0001444926086473269,0.0002887669650591972,0.6857142857142857
4804,4804,쌓이다/Verb,35,11,24,0.0001444926086473269,0.0002887669650591972,0.6857142857142857
4805,4805,흘러나오다/Verb,35,23,12,0.00027787040124485944,0.00015548990426264466,0.6571428571428571
4806,4806,스티브/Noun,35,23,12,0.00027787040124485944,0.00015548990426264466,0.6571428571428571
4807,4807,이분/Noun,35,23,12,0.00027787040124485944,0.00015548990426264466,0.6571428571428571
4808,4808,한국말/Noun,35,12,23,0.00015560742469712126,0.00027766054332615115,0.6571428571428571
4809,4809,로우/Noun,35,23,12,0.00027787040124485944,0.00015548990426264466,0.6571428571428571
4810,4810,족/Noun,35,12,23,0.00015560742469712126,0.00027766054332615115,0.6571428571428571
4811,4811,듯이/Noun,35,12,23,0.00015560742469712126,0.00027766054332615115,0.6571428571428571
4812,4812,캐서린/Noun,35,12,23,0.00015560742469712126,0.00027766054332615115,0.6571428571428571
4813,4813,이완/Noun,35,22,13,0.000266755585195065,0.0001665963259956907,0.6285714285714286
4814,4814,주의자/Noun,35,13,22,0.00016672224074691566,0.00026655412159310506,0.6285714285714286
4815,4815,리들리/Noun,35,21,14,0.00025564076914527065,0.00017770274772873674,0.6
4816,4816,직전/Noun,35,14,21,0.00017783705679671002,0.0002554476998600591,0.6
4817,4817,엇음/Noun,35,14,21,0.00017783705679671002,0.0002554476998600591,0.6
4818,4818,낭/Noun,35,14,21,0.00017783705679671002,0.0002554476998600591,0.6
4819,4819,사이/Modifier,35,21,14,0.00025564076914527065,0.00017770274772873674,0.6
4820,4820,기독교인/Noun,35,14,21,0.00017783705679671002,0.0002554476998600591,0.6
4821,4821,프로젝트/Noun,35,14,21,0.00017783705679671002,0.0002554476998600591,0.6
4822,4822,~~~~~~/Punctuation,35,14,21,0.00017783705679671002,0.0002554476998600591,0.6
4823,4823,한지민/Noun,35,21,14,0.00025564076914527065,0.00017770274772873674,0.6
4824,4824,꾸준하다/Adjective,35,15,20,0.00018895187284650438,0.00024434127812701304,0.5714285714285714
4825,4825,cgv/Alpha,35,20,15,0.00024452595309547634,0.0001888091694617828,0.5714285714285714
4826,4826,위안/Noun,35,15,20,0.00018895187284650438,0.00024434127812701304,0.5714285714285714
4827,4827,안주/Noun,35,20,15,0.00024452595309547634,0.0001888091694617828,0.5714285714285714
4828,4828,음모/Noun,35,15,20,0.00018895187284650438,0.00024434127812701304,0.5714285714285714
4829,4829,의아/Noun,35,15,20,0.00018895187284650438,0.00024434127812701304,0.5714285714285714
4830,4830,사연/Noun,35,19,16,0.0002334111370456819,0.00019991559119482882,0.5428571428571428
4831,4831,샤론스톤/Noun,35,19,16,0.0002334111370456819,0.00019991559119482882,0.5428571428571428
4832,4832,2001년/Number,35,19,16,0.0002334111370456819,0.00019991559119482882,0.5428571428571428
4833,4833,확신/Noun,35,16,19,0.0002000666888962988,0.000233234856393967,0.5428571428571428
4834,4834,잘살다/Verb,35,16,19,0.0002000666888962988,0.000233234856393967,0.5428571428571428
4835,4835,우마/Noun,35,19,16,0.0002334111370456819,0.00019991559119482882,0.5428571428571428
4836,4836,의학/Noun,35,16,19,0.0002000666888962988,0.000233234856393967,0.5428571428571428
4837,4837,순진하다/Adjective,35,16,19,0.0002000666888962988,0.000233234856393967,0.5428571428571428
4838,4838,위치/Noun,35,16,19,0.0002000666888962988,0.000233234856393967,0.5428571428571428
4839,4839,옴니버스/Noun,35,17,18,0.00021118150494609317,0.00022212843466092096,0.5142857142857142
4840,4840,아시아/Noun,35,17,18,0.00021118150494609317,0.00022212843466092096,0.5142857142857142
4841,4841,정권/Noun,35,18,17,0.0002222963209958875,0.0002110220129278749,0.5142857142857142
4842,4842,몬스터/Noun,35,18,17,0.0002222963209958875,0.0002110220129278749,0.5142857142857142
4843,4843,따라서/Noun,35,17,18,0.00021118150494609317,0.00022212843466092096,0.5142857142857142
4844,4844,에리/Noun,35,18,17,0.0002222963209958875,0.0002110220129278749,0.5142857142857142
4845,4845,어려움/Noun,35,18,17,0.0002222963209958875,0.0002110220129278749,0.5142857142857142
4846,4846,독백/Noun,35,17,18,0.00021118150494609317,0.00022212843466092096,0.5142857142857142
4847,4847,퉤/Noun,34,2,32,4.445926419917751e-05,0.0003776183389235656,0.9411764705882352
4848,4848,만큼도/Josa,34,2,32,4.445926419917751e-05,0.0003776183389235656,0.9411764705882352
4849,4849,박신혜/Noun,34,31,3,0.00036678892964321435,5.553210866523024e-05,0.9117647058823528
4850,4850,자질/Noun,34,3,31,5.5574080248971876e-05,0.00036651191719051963,0.9117647058823528
4851,4851,...;;;/Punctuation,34,3,31,5.5574080248971876e-05,0.00036651191719051963,0.9117647058823528
4852,4852,공효진/Noun,34,30,4,0.00035567411359342004,6.663853039827628e-05,0.8823529411764706
4853,4853,톰크루즈/Noun,34,29,5,0.0003445592975436257,7.774495213132233e-05,0.8529411764705882
4854,4854,맑은/Noun,34,29,5,0.0003445592975436257,7.774495213132233e-05,0.8529411764705882
4855,4855,칠이/Noun,34,5,29,7.780371234856063e-05,0.00034429907372442745,0.8529411764705882
4856,4856,동호/Noun,34,5,29,7.780371234856063e-05,0.00034429907372442745,0.8529411764705882
4857,4857,이동욱/Noun,34,29,5,0.0003445592975436257,7.774495213132233e-05,0.8529411764705882
4858,4858,동기/Noun,34,6,28,8.891852839835501e-05,0.0003331926519913814,0.8235294117647058
4859,4859,~!!!!/Punctuation,34,27,7,0.00032232966544403684,9.995779559741441e-05,0.7941176470588235
4860,4860,가시/Noun,34,27,7,0.00032232966544403684,9.995779559741441e-05,0.7941176470588235
4861,4861,급전/Noun,34,7,27,0.0001000333444481494,0.00032208623025833537,0.7941176470588235
4862,4862,또한/Modifier,34,27,7,0.00032232966544403684,9.995779559741441e-05,0.7941176470588235
4863,4863,고려/Noun,34,7,27,0.0001000333444481494,0.00032208623025833537,0.7941176470588235
4864,4864,지다/Noun,34,27,7,0.00032232966544403684,9.995779559741441e-05,0.7941176470588235
4865,4865,카타르/Noun,34,27,7,0.00032232966544403684,9.995779559741441e-05,0.7941176470588235
4866,4866,숭고하다/Adjective,34,27,7,0.00032232966544403684,9.995779559741441e-05,0.7941176470588235
4867,4867,화이/Noun,34,27,7,0.00032232966544403684,9.995779559741441e-05,0.7941176470588235
4868,4868,뺨/Noun,34,8,26,0.00011114816049794375,0.00031097980852528933,0.7647058823529411
4869,4869,아웃/Noun,34,8,26,0.00011114816049794375,0.00031097980852528933,0.7647058823529411
4870,4870,출연료/Noun,34,8,26,0.00011114816049794375,0.00031097980852528933,0.7647058823529411
4871,4871,흥겹다/Adjective,34,26,8,0.00031121484939424253,0.00011106421733046048,0.7647058823529411
4872,4872,비급/Noun,34,8,26,0.00011114816049794375,0.00031097980852528933,0.7647058823529411
4873,4873,통한/Noun,34,26,8,0.00031121484939424253,0.00011106421733046048,0.7647058823529411
4874,4874,저예산영화/Noun,34,8,26,0.00011114816049794375,0.00031097980852528933,0.7647058823529411
4875,4875,멜깁슨/Noun,34,26,8,0.00031121484939424253,0.00011106421733046048,0.7647058823529411
4876,4876,어딨다/Verb,34,8,26,0.00011114816049794375,0.00031097980852528933,0.7647058823529411
4877,4877,행운/Noun,34,25,9,0.00030010003334444816,0.00012217063906350652,0.7352941176470589
4878,4878,도망/Noun,34,9,25,0.00012226297654773814,0.0002998733867922433,0.7352941176470589
4879,4879,린치/Noun,34,25,9,0.00030010003334444816,0.00012217063906350652,0.7352941176470589
4880,4880,잘쓰다/Verb,34,9,25,0.00012226297654773814,0.0002998733867922433,0.7352941176470589
4881,4881,또다시/Adverb,34,25,9,0.00030010003334444816,0.00012217063906350652,0.7352941176470589
4882,4882,처참하다/Adjective,34,9,25,0.00012226297654773814,0.0002998733867922433,0.7352941176470589
4883,4883,두/Modifier,34,9,25,0.00012226297654773814,0.0002998733867922433,0.7352941176470589
4884,4884,흐/Noun,34,25,9,0.00030010003334444816,0.00012217063906350652,0.7352941176470589
4885,4885,속도/Noun,34,10,24,0.0001333777925975325,0.0002887669650591972,0.7058823529411765
4886,4886,일본어/Noun,34,10,24,0.0001333777925975325,0.0002887669650591972,0.7058823529411765
4887,4887,털리다/Verb,34,10,24,0.0001333777925975325,0.0002887669650591972,0.7058823529411765
4888,4888,나아가다/Verb,34,24,10,0.0002889852172946538,0.00013327706079655256,0.7058823529411765
4889,4889,질투/Noun,34,24,10,0.0002889852172946538,0.00013327706079655256,0.7058823529411765
4890,4890,사이코패스/Noun,34,10,24,0.0001333777925975325,0.0002887669650591972,0.7058823529411765
4891,4891,2010년/Number,34,10,24,0.0001333777925975325,0.0002887669650591972,0.7058823529411765
4892,4892,김남길/Noun,34,24,10,0.0002889852172946538,0.00013327706079655256,0.7058823529411765
4893,4893,스치다/Verb,34,24,10,0.0002889852172946538,0.00013327706079655256,0.7058823529411765
4894,4894,파일/Noun,34,23,11,0.00027787040124485944,0.0001443834825295986,0.6764705882352942
4895,4895,S/Alpha,34,23,11,0.00027787040124485944,0.0001443834825295986,0.6764705882352942
4896,4896,떼/Noun,34,11,23,0.0001444926086473269,0.00027766054332615115,0.6764705882352942
4897,4897,토미/Noun,34,23,11,0.00027787040124485944,0.0001443834825295986,0.6764705882352942
4898,4898,?'/Punctuation,34,12,22,0.00015560742469712126,0.00026655412159310506,0.6470588235294118
4899,4899,페이지/Noun,34,22,12,0.000266755585195065,0.00015548990426264466,0.6470588235294118
4900,4900,중이/Noun,34,22,12,0.000266755585195065,0.00015548990426264466,0.6470588235294118
4901,4901,좌절/Noun,34,22,12,0.000266755585195065,0.00015548990426264466,0.6470588235294118
4902,4902,...!!/Punctuation,34,22,12,0.000266755585195065,0.00015548990426264466,0.6470588235294118
4903,4903,아르/Noun,34,22,12,0.000266755585195065,0.00015548990426264466,0.6470588235294118
4904,4904,프레데터/Noun,34,12,22,0.00015560742469712126,0.00026655412159310506,0.6470588235294118
4905,4905,고찰/Noun,34,22,12,0.000266755585195065,0.00015548990426264466,0.6470588235294118
4906,4906,고개/Noun,34,12,22,0.00015560742469712126,0.00026655412159310506,0.6470588235294118
4907,4907,고소영/Noun,34,12,22,0.00015560742469712126,0.00026655412159310506,0.6470588235294118
4908,4908,여우/Noun,34,22,12,0.000266755585195065,0.00015548990426264466,0.6470588235294118
4909,4909,안목/Noun,34,12,22,0.00015560742469712126,0.00026655412159310506,0.6470588235294118
4910,4910,이슈/Noun,34,13,21,0.00016672224074691566,0.0002554476998600591,0.6176470588235294
4911,4911,브리/Noun,34,21,13,0.00025564076914527065,0.0001665963259956907,0.6176470588235294
4912,4912,거대/Noun,34,13,21,0.00016672224074691566,0.0002554476998600591,0.6176470588235294
4913,4913,개독/Noun,34,13,21,0.00016672224074691566,0.0002554476998600591,0.6176470588235294
4914,4914,남자친구/Noun,34,21,13,0.00025564076914527065,0.0001665963259956907,0.6176470588235294
4915,4915,라며/Noun,34,13,21,0.00016672224074691566,0.0002554476998600591,0.6176470588235294
4916,4916,플레이/Noun,34,13,21,0.00016672224074691566,0.0002554476998600591,0.6176470588235294
4917,4917,몸부림/Noun,34,14,20,0.00017783705679671002,0.00024434127812701304,0.5882352941176471
4918,4918,이내/Noun,34,14,20,0.00017783705679671002,0.00024434127812701304,0.5882352941176471
4919,4919,하이킥/Noun,34,20,14,0.00024452595309547634,0.00017770274772873674,0.5882352941176471
4920,4920,스캔들/Noun,34,14,20,0.00017783705679671002,0.00024434127812701304,0.5882352941176471
4921,4921,블루/Noun,34,14,20,0.00017783705679671002,0.00024434127812701304,0.5882352941176471
4922,4922,성경/Noun,34,14,20,0.00017783705679671002,0.00024434127812701304,0.5882352941176471
4923,4923,제인/Noun,34,20,14,0.00024452595309547634,0.00017770274772873674,0.5882352941176471
4924,4924,차지/Noun,34,14,20,0.00017783705679671002,0.00024434127812701304,0.5882352941176471
4925,4925,하여금/Adverb,34,20,14,0.00024452595309547634,0.00017770274772873674,0.5882352941176471
4926,4926,대형/Noun,34,14,20,0.00017783705679671002,0.00024434127812701304,0.5882352941176471
4927,4927,조인성/Noun,34,20,14,0.00024452595309547634,0.00017770274772873674,0.5882352941176471
4928,4928,형성/Noun,34,20,14,0.00024452595309547634,0.00017770274772873674,0.5882352941176471
4929,4929,목표/Noun,34,20,14,0.00024452595309547634,0.00017770274772873674,0.5882352941176471
4930,4930,오토바이/Noun,34,14,20,0.00017783705679671002,0.00024434127812701304,0.5882352941176471
4931,4931,근본/Noun,34,14,20,0.00017783705679671002,0.00024434127812701304,0.5882352941176471
4932,4932,충분/Noun,34,20,14,0.00024452595309547634,0.00017770274772873674,0.5882352941176471
4933,4933,측면/Noun,34,14,20,0.00017783705679671002,0.00024434127812701304,0.5882352941176471
4934,4934,뿌리/Noun,34,19,15,0.0002334111370456819,0.0001888091694617828,0.5588235294117647
4935,4935,2008년/Number,34,19,15,0.0002334111370456819,0.0001888091694617828,0.5588235294117647
4936,4936,따윈/Noun,34,15,19,0.00018895187284650438,0.000233234856393967,0.5588235294117647
4937,4937,.?/Punctuation,34,19,15,0.0002334111370456819,0.0001888091694617828,0.5588235294117647
4938,4938,완결/Noun,34,19,15,0.0002334111370456819,0.0001888091694617828,0.5588235294117647
4939,4939,딱좋다/Adjective,34,19,15,0.0002334111370456819,0.0001888091694617828,0.5588235294117647
4940,4940,김수로/Noun,34,19,15,0.0002334111370456819,0.0001888091694617828,0.5588235294117647
4941,4941,2012/Number,34,15,19,0.00018895187284650438,0.000233234856393967,0.5588235294117647
4942,4942,마땅하다/Adjective,34,19,15,0.0002334111370456819,0.0001888091694617828,0.5588235294117647
4943,4943,뒤통수/Noun,34,15,19,0.00018895187284650438,0.000233234856393967,0.5588235294117647
4944,4944,태/Noun,34,18,16,0.0002222963209958875,0.00019991559119482882,0.5294117647058824
4945,4945,룩/Suffix,34,18,16,0.0002222963209958875,0.00019991559119482882,0.5294117647058824
4946,4946,서기/Noun,34,18,16,0.0002222963209958875,0.00019991559119482882,0.5294117647058824
4947,4947,특성/Noun,34,16,18,0.0002000666888962988,0.00022212843466092096,0.5294117647058824
4948,4948,끝장/Noun,34,18,16,0.0002222963209958875,0.00019991559119482882,0.5294117647058824
4949,4949,익다/Verb,34,16,18,0.0002000666888962988,0.00022212843466092096,0.5294117647058824
4950,4950,대리/Noun,34,18,16,0.0002222963209958875,0.00019991559119482882,0.5294117647058824
4951,4951,개미/Noun,34,17,17,0.00021118150494609317,0.0002110220129278749,0.5
4952,4952,강시/Noun,34,17,17,0.00021118150494609317,0.0002110220129278749,0.5
4953,4953,암살/Noun,34,17,17,0.00021118150494609317,0.0002110220129278749,0.5
4954,4954,다수/Noun,34,17,17,0.00021118150494609317,0.0002110220129278749,0.5
4955,4955,기계/Noun,34,17,17,0.00021118150494609317,0.0002110220129278749,0.5
4956,4956,!!^^/Punctuation,33,33,0,0.00038901856174280313,2.2212843466092093e-05,1.0
4957,4957,앓이/Noun,33,33,0,0.00038901856174280313,2.2212843466092093e-05,1.0
4958,4958,서세원/Noun,33,1,32,3.334444814938313e-05,0.0003776183389235656,0.9696969696969696
4959,4959,모처럼/Noun,33,32,1,0.00037790374569300877,3.331926519913814e-05,0.9696969696969696
4960,4960,알차다/Adjective,33,31,2,0.00036678892964321435,4.4425686932184186e-05,0.9393939393939394
4961,4961,조아/Adverb,33,31,2,0.00036678892964321435,4.4425686932184186e-05,0.9393939393939394
4962,4962,국뽕/Noun,33,3,30,5.5574080248971876e-05,0.0003554054954574735,0.9090909090909092
4963,4963,듣보잡/Noun,33,3,30,5.5574080248971876e-05,0.0003554054954574735,0.9090909090909092
4964,4964,best/Alpha,33,30,3,0.00035567411359342004,5.553210866523024e-05,0.9090909090909092
4965,4965,혹성탈출/Noun,33,6,27,8.891852839835501e-05,0.00032208623025833537,0.8181818181818182
4966,4966,어줍다/Adjective,33,6,27,8.891852839835501e-05,0.00032208623025833537,0.8181818181818182
4967,4967,매회/Adverb,33,27,6,0.00032232966544403684,8.885137386436837e-05,0.8181818181818182
4968,4968,놀이/Noun,33,7,26,0.0001000333444481494,0.00031097980852528933,0.7878787878787878
4969,4969,각인/Noun,33,26,7,0.00031121484939424253,9.995779559741441e-05,0.7878787878787878
4970,4970,공격/Noun,33,7,26,0.0001000333444481494,0.00031097980852528933,0.7878787878787878
4971,4971,사랑과전쟁/Noun,33,8,25,0.00011114816049794375,0.0002998733867922433,0.7575757575757576
4972,4972,마련/Noun,33,25,8,0.00030010003334444816,0.00011106421733046048,0.7575757575757576
4973,4973,발레/Noun,33,25,8,0.00030010003334444816,0.00011106421733046048,0.7575757575757576
4974,4974,해대/Noun,33,8,25,0.00011114816049794375,0.0002998733867922433,0.7575757575757576
4975,4975,전결/Noun,33,8,25,0.00011114816049794375,0.0002998733867922433,0.7575757575757576
4976,4976,진구/Noun,33,24,9,0.0002889852172946538,0.00012217063906350652,0.7272727272727273
4977,4977,서서히/Noun,33,24,9,0.0002889852172946538,0.00012217063906350652,0.7272727272727273
4978,4978,갑작스럽다/Adjective,33,9,24,0.00012226297654773814,0.0002887669650591972,0.7272727272727273
4979,4979,자아내다/Verb,33,24,9,0.0002889852172946538,0.00012217063906350652,0.7272727272727273
4980,4980,대의/Foreign,33,24,9,0.0002889852172946538,0.00012217063906350652,0.7272727272727273
4981,4981,대도/Noun,33,9,24,0.00012226297654773814,0.0002887669650591972,0.7272727272727273
4982,4982,나이트/Noun,33,10,23,0.0001333777925975325,0.00027766054332615115,0.696969696969697
4983,4983,얼른/Noun,33,23,10,0.00027787040124485944,0.00013327706079655256,0.696969696969697
4984,4984,재회/Noun,33,23,10,0.00027787040124485944,0.00013327706079655256,0.696969696969697
4985,4985,좌파/Noun,33,10,23,0.0001333777925975325,0.00027766054332615115,0.696969696969697
4986,4986,회장/Noun,33,10,23,0.0001333777925975325,0.00027766054332615115,0.696969696969697
4987,4987,돌아다니다/Verb,33,10,23,0.0001333777925975325,0.00027766054332615115,0.696969696969697
4988,4988,부러/Noun,33,23,10,0.00027787040124485944,0.00013327706079655256,0.696969696969697
4989,4989,승/Noun,33,11,22,0.0001444926086473269,0.00026655412159310506,0.6666666666666666
4990,4990,…/Punctuation,33,11,22,0.0001444926086473269,0.00026655412159310506,0.6666666666666666
4991,4991,후유증/Noun,33,22,11,0.000266755585195065,0.0001443834825295986,0.6666666666666666
4992,4992,안녕/Noun,33,22,11,0.000266755585195065,0.0001443834825295986,0.6666666666666666
4993,4993,에게나/Josa,33,22,11,0.000266755585195065,0.0001443834825295986,0.6666666666666666
4994,4994,효민/Noun,33,11,22,0.0001444926086473269,0.00026655412159310506,0.6666666666666666
4995,4995,피우다/Verb,33,11,22,0.0001444926086473269,0.00026655412159310506,0.6666666666666666
4996,4996,까지가/Josa,33,11,22,0.0001444926086473269,0.00026655412159310506,0.6666666666666666
4997,4997,케이스/Noun,33,11,22,0.0001444926086473269,0.00026655412159310506,0.6666666666666666
4998,4998,낯선/Noun,33,22,11,0.000266755585195065,0.0001443834825295986,0.6666666666666666
4999,4999,과제/Noun,33,12,21,0.00015560742469712126,0.0002554476998600591,0.6363636363636364
5000,5000,괴수/Noun,33,12,21,0.00015560742469712126,0.0002554476998600591,0.6363636363636364
5001,5001,장인/Noun,33,21,12,0.00025564076914527065,0.00015548990426264466,0.6363636363636364
5002,5002,미로/Noun,33,12,21,0.00015560742469712126,0.0002554476998600591,0.6363636363636364
5003,5003,시청율/Noun,33,12,21,0.00015560742469712126,0.0002554476998600591,0.6363636363636364
5004,5004,탕/Noun,33,12,21,0.00015560742469712126,0.0002554476998600591,0.6363636363636364
5005,5005,지성/Noun,33,21,12,0.00025564076914527065,0.00015548990426264466,0.6363636363636364
5006,5006,↓/Foreign,33,12,21,0.00015560742469712126,0.0002554476998600591,0.6363636363636364
5007,5007,만으로는/Josa,33,13,20,0.00016672224074691566,0.00024434127812701304,0.6060606060606061
5008,5008,대만/Noun,33,13,20,0.00016672224074691566,0.00024434127812701304,0.6060606060606061
5009,5009,신뢰/Noun,33,13,20,0.00016672224074691566,0.00024434127812701304,0.6060606060606061
5010,5010,人/Foreign,33,13,20,0.00016672224074691566,0.00024434127812701304,0.6060606060606061
5011,5011,고정/Noun,33,20,13,0.00024452595309547634,0.0001665963259956907,0.6060606060606061
5012,5012,서방/Noun,33,13,20,0.00016672224074691566,0.00024434127812701304,0.6060606060606061
5013,5013,2회/Number,33,20,13,0.00024452595309547634,0.0001665963259956907,0.6060606060606061
5014,5014,어둠/Noun,33,19,14,0.0002334111370456819,0.00017770274772873674,0.5757575757575758
5015,5015,결합/Noun,33,19,14,0.0002334111370456819,0.00017770274772873674,0.5757575757575758
5016,5016,뚜렷하다/Adjective,33,19,14,0.0002334111370456819,0.00017770274772873674,0.5757575757575758
5017,5017,뵈다/Verb,33,19,14,0.0002334111370456819,0.00017770274772873674,0.5757575757575758
5018,5018,이신/Josa,33,19,14,0.0002334111370456819,0.00017770274772873674,0.5757575757575758
5019,5019,소수/Noun,33,14,19,0.00017783705679671002,0.000233234856393967,0.5757575757575758
5020,5020,명량/Noun,33,19,14,0.0002334111370456819,0.00017770274772873674,0.5757575757575758
5021,5021,검/Noun,33,14,19,0.00017783705679671002,0.000233234856393967,0.5757575757575758
5022,5022,자하/Noun,33,14,19,0.00017783705679671002,0.000233234856393967,0.5757575757575758
5023,5023,도덕/Noun,33,15,18,0.00018895187284650438,0.00022212843466092096,0.5454545454545454
5024,5024,고통스럽다/Adjective,33,18,15,0.0002222963209958875,0.0001888091694617828,0.5454545454545454
5025,5025,패닝/Noun,33,18,15,0.0002222963209958875,0.0001888091694617828,0.5454545454545454
5026,5026,어보/Noun,33,18,15,0.0002222963209958875,0.0001888091694617828,0.5454545454545454
5027,5027,2009년/Number,33,18,15,0.0002222963209958875,0.0001888091694617828,0.5454545454545454
5028,5028,가치관/Noun,33,18,15,0.0002222963209958875,0.0001888091694617828,0.5454545454545454
5029,5029,조각/Noun,33,18,15,0.0002222963209958875,0.0001888091694617828,0.5454545454545454
5030,5030,핵심/Noun,33,15,18,0.00018895187284650438,0.00022212843466092096,0.5454545454545454
5031,5031,해리슨/Noun,33,15,18,0.00018895187284650438,0.00022212843466092096,0.5454545454545454
5032,5032,조심하다/Verb,33,15,18,0.00018895187284650438,0.00022212843466092096,0.5454545454545454
5033,5033,물질/Noun,33,18,15,0.0002222963209958875,0.0001888091694617828,0.5454545454545454
5034,5034,하여튼/Noun,33,15,18,0.00018895187284650438,0.00022212843466092096,0.5454545454545454
5035,5035,수단/Noun,33,18,15,0.0002222963209958875,0.0001888091694617828,0.5454545454545454
5036,5036,영화배우/Noun,33,18,15,0.0002222963209958875,0.0001888091694617828,0.5454545454545454
5037,5037,서민/Noun,33,18,15,0.0002222963209958875,0.0001888091694617828,0.5454545454545454
5038,5038,으아/Exclamation,33,18,15,0.0002222963209958875,0.0001888091694617828,0.5454545454545454
5039,5039,제공/Noun,33,18,15,0.0002222963209958875,0.0001888091694617828,0.5454545454545454
5040,5040,박자/Noun,33,17,16,0.00021118150494609317,0.00019991559119482882,0.5151515151515151
5041,5041,타입/Noun,33,16,17,0.0002000666888962988,0.0002110220129278749,0.5151515151515151
5042,5042,몰래/Noun,33,17,16,0.00021118150494609317,0.00019991559119482882,0.5151515151515151
5043,5043,스타뎀/Noun,33,17,16,0.00021118150494609317,0.00019991559119482882,0.5151515151515151
5044,5044,균형/Noun,33,17,16,0.00021118150494609317,0.00019991559119482882,0.5151515151515151
5045,5045,민주주의/Noun,33,17,16,0.00021118150494609317,0.00019991559119482882,0.5151515151515151
5046,5046,떄문/Noun,33,17,16,0.00021118150494609317,0.00019991559119482882,0.5151515151515151
5047,5047,테이크/Noun,33,17,16,0.00021118150494609317,0.00019991559119482882,0.5151515151515151
5048,5048,평정/Noun,33,16,17,0.0002000666888962988,0.0002110220129278749,0.5151515151515151
5049,5049,인터스텔라/Noun,33,17,16,0.00021118150494609317,0.00019991559119482882,0.5151515151515151
5050,5050,빅/Noun,33,17,16,0.00021118150494609317,0.00019991559119482882,0.5151515151515151
5051,5051,보석같다/Adjective,32,31,1,0.00036678892964321435,3.331926519913814e-05,0.96875
5052,5052,명곡/Noun,32,30,2,0.00035567411359342004,4.4425686932184186e-05,0.9375
5053,5053,유행어/Noun,32,2,30,4.445926419917751e-05,0.0003554054954574735,0.9375
5054,5054,AV/Alpha,32,2,30,4.445926419917751e-05,0.0003554054954574735,0.9375
5055,5055,얄팍하다/Adjective,32,2,30,4.445926419917751e-05,0.0003554054954574735,0.9375
5056,5056,></Punctuation,32,30,2,0.00035567411359342004,4.4425686932184186e-05,0.9375
5057,5057,썰렁하다/Adjective,32,3,29,5.5574080248971876e-05,0.00034429907372442745,0.90625
5058,5058,Very/Alpha,32,29,3,0.0003445592975436257,5.553210866523024e-05,0.90625
5059,5059,테스트/Noun,32,3,29,5.5574080248971876e-05,0.00034429907372442745,0.90625
5060,5060,love/Alpha,32,28,4,0.0003334444814938313,6.663853039827628e-05,0.875
5061,5061,괴작/Noun,32,4,28,6.668889629876625e-05,0.0003331926519913814,0.875
5062,5062,보석/Noun,32,28,4,0.0003334444814938313,6.663853039827628e-05,0.875
5063,5063,되새기다/Verb,32,28,4,0.0003334444814938313,6.663853039827628e-05,0.875
5064,5064,참혹하다/Adjective,32,27,5,0.00032232966544403684,7.774495213132233e-05,0.84375
5065,5065,어필/Noun,32,5,27,7.780371234856063e-05,0.00032208623025833537,0.84375
5066,5066,슈스케/Noun,32,5,27,7.780371234856063e-05,0.00032208623025833537,0.84375
5067,5067,마주/Noun,32,27,5,0.00032232966544403684,7.774495213132233e-05,0.84375
5068,5068,변명/Noun,32,6,26,8.891852839835501e-05,0.00031097980852528933,0.8125
5069,5069,감독판/Noun,32,26,6,0.00031121484939424253,8.885137386436837e-05,0.8125
5070,5070,아리/Noun,32,26,6,0.00031121484939424253,8.885137386436837e-05,0.8125
5071,5071,침몰/Noun,32,6,26,8.891852839835501e-05,0.00031097980852528933,0.8125
5072,5072,뽀로로/Noun,32,7,25,0.0001000333444481494,0.0002998733867922433,0.78125
5073,5073,맛깔나다/Adjective,32,25,7,0.00030010003334444816,9.995779559741441e-05,0.78125
5074,5074,토요명화/Noun,32,25,7,0.00030010003334444816,9.995779559741441e-05,0.78125
5075,5075,사소하다/Adjective,32,25,7,0.00030010003334444816,9.995779559741441e-05,0.78125
5076,5076,된장/Noun,32,8,24,0.00011114816049794375,0.0002887669650591972,0.75
5077,5077,쌍욕/Noun,32,8,24,0.00011114816049794375,0.0002887669650591972,0.75
5078,5078,어쨋/Noun,32,24,8,0.0002889852172946538,0.00011106421733046048,0.75
5079,5079,안달/Noun,32,8,24,0.00011114816049794375,0.0002887669650591972,0.75
5080,5080,취미/Noun,32,8,24,0.00011114816049794375,0.0002887669650591972,0.75
5081,5081,튀기다/Verb,32,8,24,0.00011114816049794375,0.0002887669650591972,0.75
5082,5082,my/Alpha,32,23,9,0.00027787040124485944,0.00012217063906350652,0.71875
5083,5083,콘서트/Noun,32,23,9,0.00027787040124485944,0.00012217063906350652,0.71875
5084,5084,토마스/Noun,32,23,9,0.00027787040124485944,0.00012217063906350652,0.71875
5085,5085,희극/Noun,32,22,10,0.000266755585195065,0.00013327706079655256,0.6875
5086,5086,싸/VerbPrefix,32,10,22,0.0001333777925975325,0.00026655412159310506,0.6875
5087,5087,압축/Noun,32,10,22,0.0001333777925975325,0.00026655412159310506,0.6875
5088,5088,아랫/Modifier,32,22,10,0.000266755585195065,0.00013327706079655256,0.6875
5089,5089,통일/Noun,32,22,10,0.000266755585195065,0.00013327706079655256,0.6875
5090,5090,me/Alpha,32,22,10,0.000266755585195065,0.00013327706079655256,0.6875
5091,5091,일베/Noun,32,10,22,0.0001333777925975325,0.00026655412159310506,0.6875
5092,5092,원빈/Noun,32,22,10,0.000266755585195065,0.00013327706079655256,0.6875
5093,5093,다한/Noun,32,10,22,0.0001333777925975325,0.00026655412159310506,0.6875
5094,5094,녹화/Noun,32,21,11,0.00025564076914527065,0.0001443834825295986,0.65625
5095,5095,기차/Noun,32,21,11,0.00025564076914527065,0.0001443834825295986,0.65625
5096,5096,주지훈/Noun,32,21,11,0.00025564076914527065,0.0001443834825295986,0.65625
5097,5097,공리/Noun,32,21,11,0.00025564076914527065,0.0001443834825295986,0.65625
5098,5098,정답/Noun,32,21,11,0.00025564076914527065,0.0001443834825295986,0.65625
5099,5099,최지우/Noun,32,21,11,0.00025564076914527065,0.0001443834825295986,0.65625
5100,5100,즘/Noun,32,11,21,0.0001444926086473269,0.0002554476998600591,0.65625
5101,5101,치르다/Verb,32,11,21,0.0001444926086473269,0.0002554476998600591,0.65625
5102,5102,벌이다/Verb,32,11,21,0.0001444926086473269,0.0002554476998600591,0.65625
5103,5103,치가/Noun,32,11,21,0.0001444926086473269,0.0002554476998600591,0.65625
5104,5104,무작정/Noun,32,11,21,0.0001444926086473269,0.0002554476998600591,0.65625
5105,5105,뱉다/Verb,32,11,21,0.0001444926086473269,0.0002554476998600591,0.65625
5106,5106,학/Noun,32,12,20,0.00015560742469712126,0.00024434127812701304,0.625
5107,5107,~~~~~~~/Punctuation,32,12,20,0.00015560742469712126,0.00024434127812701304,0.625
5108,5108,휴머니즘/Noun,32,20,12,0.00024452595309547634,0.00015548990426264466,0.625
5109,5109,트와일라잇/Noun,32,12,20,0.00015560742469712126,0.00024434127812701304,0.625
5110,5110,과감/Noun,32,12,20,0.00015560742469712126,0.00024434127812701304,0.625
5111,5111,크리/Noun,32,20,12,0.00024452595309547634,0.00015548990426264466,0.625
5112,5112,디스/Noun,32,12,20,0.00015560742469712126,0.00024434127812701304,0.625
5113,5113,동원/Noun,32,12,20,0.00015560742469712126,0.00024434127812701304,0.625
5114,5114,어벤져스/Noun,32,20,12,0.00024452595309547634,0.00015548990426264466,0.625
5115,5115,줄알/Noun,32,12,20,0.00015560742469712126,0.00024434127812701304,0.625
5116,5116,송중기/Noun,32,20,12,0.00024452595309547634,0.00015548990426264466,0.625
5117,5117,강혜정/Noun,32,13,19,0.00016672224074691566,0.000233234856393967,0.59375
5118,5118,므/Noun,32,19,13,0.0002334111370456819,0.0001665963259956907,0.59375
5119,5119,하우스/Noun,32,14,18,0.00017783705679671002,0.00022212843466092096,0.5625
5120,5120,여야/Noun,32,14,18,0.00017783705679671002,0.00022212843466092096,0.5625
5121,5121,주신/Noun,32,18,14,0.0002222963209958875,0.00017770274772873674,0.5625
5122,5122,쳐다보다/Verb,32,14,18,0.00017783705679671002,0.00022212843466092096,0.5625
5123,5123,2011년/Number,32,14,18,0.00017783705679671002,0.00022212843466092096,0.5625
5124,5124,가도/Noun,32,18,14,0.0002222963209958875,0.00017770274772873674,0.5625
5125,5125,쓰리다/Adjective,32,14,18,0.00017783705679671002,0.00022212843466092096,0.5625
5126,5126,자가/Noun,32,14,18,0.00017783705679671002,0.00022212843466092096,0.5625
5127,5127,적응/Noun,32,14,18,0.00017783705679671002,0.00022212843466092096,0.5625
5128,5128,에야/Josa,32,18,14,0.0002222963209958875,0.00017770274772873674,0.5625
5129,5129,작살/Noun,32,18,14,0.0002222963209958875,0.00017770274772873674,0.5625
5130,5130,뉴/Noun,32,15,17,0.00018895187284650438,0.0002110220129278749,0.53125
5131,5131,농구/Noun,32,17,15,0.00021118150494609317,0.0001888091694617828,0.53125
5132,5132,레이싱/Noun,32,17,15,0.00021118150494609317,0.0001888091694617828,0.53125
5133,5133,이선균/Noun,32,17,15,0.00021118150494609317,0.0001888091694617828,0.53125
5134,5134,갈수/Noun,32,15,17,0.00018895187284650438,0.0002110220129278749,0.53125
5135,5135,2일/Number,32,15,17,0.00018895187284650438,0.0002110220129278749,0.53125
5136,5136,피트/Noun,32,17,15,0.00021118150494609317,0.0001888091694617828,0.53125
5137,5137,여명/Noun,32,17,15,0.00021118150494609317,0.0001888091694617828,0.53125
5138,5138,어마어마하다/Adjective,32,16,16,0.0002000666888962988,0.00019991559119482882,0.5
5139,5139,친절하다/Adjective,32,16,16,0.0002000666888962988,0.00019991559119482882,0.5
5140,5140,잔혹/Noun,32,16,16,0.0002000666888962988,0.00019991559119482882,0.5
5141,5141,안듬/Noun,31,1,30,3.334444814938313e-05,0.0003554054954574735,0.967741935483871
5142,5142,참내/Noun,31,1,30,3.334444814938313e-05,0.0003554054954574735,0.967741935483871
5143,5143,이상형/Noun,31,28,3,0.0003334444814938313,5.553210866523024e-05,0.9032258064516128
5144,5144,못지않다/Adjective,31,28,3,0.0003334444814938313,5.553210866523024e-05,0.9032258064516128
5145,5145,그만두다/Verb,31,3,28,5.5574080248971876e-05,0.0003331926519913814,0.9032258064516128
5146,5146,잘맞다/Adjective,31,27,4,0.00032232966544403684,6.663853039827628e-05,0.8709677419354839
5147,5147,수습/Noun,31,4,27,6.668889629876625e-05,0.00032208623025833537,0.8709677419354839
5148,5148,발악/Noun,31,4,27,6.668889629876625e-05,0.00032208623025833537,0.8709677419354839
5149,5149,랍시고/Noun,31,4,27,6.668889629876625e-05,0.00032208623025833537,0.8709677419354839
5150,5150,자마자/Noun,31,5,26,7.780371234856063e-05,0.00031097980852528933,0.8387096774193549
5151,5151,공존/Noun,31,26,5,0.00031121484939424253,7.774495213132233e-05,0.8387096774193549
5152,5152,팬심/Noun,31,5,26,7.780371234856063e-05,0.00031097980852528933,0.8387096774193549
5153,5153,제이/Noun,31,26,5,0.00031121484939424253,7.774495213132233e-05,0.8387096774193549
5154,5154,봣던/Noun,31,25,6,0.00030010003334444816,8.885137386436837e-05,0.8064516129032258
5155,5155,통틀어/Noun,31,25,6,0.00030010003334444816,8.885137386436837e-05,0.8064516129032258
5156,5156,메리/Noun,31,25,6,0.00030010003334444816,8.885137386436837e-05,0.8064516129032258
5157,5157,쪽바리/Noun,31,6,25,8.891852839835501e-05,0.0002998733867922433,0.8064516129032258
5158,5158,결제/Noun,31,6,25,8.891852839835501e-05,0.0002998733867922433,0.8064516129032258
5159,5159,서인국/Noun,31,25,6,0.00030010003334444816,8.885137386436837e-05,0.8064516129032258
5160,5160,으로/Foreign,31,7,24,0.0001000333444481494,0.0002887669650591972,0.7741935483870968
5161,5161,히치콕/Noun,31,24,7,0.0002889852172946538,9.995779559741441e-05,0.7741935483870968
5162,5162,클린트/Noun,31,24,7,0.0002889852172946538,9.995779559741441e-05,0.7741935483870968
5163,5163,윌리엄스/Noun,31,24,7,0.0002889852172946538,9.995779559741441e-05,0.7741935483870968
5164,5164,혼/Noun,31,24,7,0.0002889852172946538,9.995779559741441e-05,0.7741935483870968
5165,5165,때론/Noun,31,24,7,0.0002889852172946538,9.995779559741441e-05,0.7741935483870968
5166,5166,기막히다/Adjective,31,23,8,0.00027787040124485944,0.00011106421733046048,0.7419354838709677
5167,5167,크리스틴/Noun,31,23,8,0.00027787040124485944,0.00011106421733046048,0.7419354838709677
5168,5168,부대/Noun,31,8,23,0.00011114816049794375,0.00027766054332615115,0.7419354838709677
5169,5169,이틀/Noun,31,23,8,0.00027787040124485944,0.00011106421733046048,0.7419354838709677
5170,5170,봣음/Noun,31,23,8,0.00027787040124485944,0.00011106421733046048,0.7419354838709677
5171,5171,욕설/Noun,31,8,23,0.00011114816049794375,0.00027766054332615115,0.7419354838709677
5172,5172,하필/Noun,31,9,22,0.00012226297654773814,0.00026655412159310506,0.7096774193548387
5173,5173,희한하다/Adjective,31,9,22,0.00012226297654773814,0.00026655412159310506,0.7096774193548387
5174,5174,윤계상/Noun,31,22,9,0.000266755585195065,0.00012217063906350652,0.7096774193548387
5175,5175,미니/Noun,31,22,9,0.000266755585195065,0.00012217063906350652,0.7096774193548387
5176,5176,대면/Noun,31,9,22,0.00012226297654773814,0.00026655412159310506,0.7096774193548387
5177,5177,약자/Noun,31,22,9,0.000266755585195065,0.00012217063906350652,0.7096774193548387
5178,5178,1억/Number,31,9,22,0.00012226297654773814,0.00026655412159310506,0.7096774193548387
5179,5179,사다코/Noun,31,9,22,0.00012226297654773814,0.00026655412159310506,0.7096774193548387
5180,5180,공상/Noun,31,9,22,0.00012226297654773814,0.00026655412159310506,0.7096774193548387
5181,5181,엑/Exclamation,31,9,22,0.00012226297654773814,0.00026655412159310506,0.7096774193548387
5182,5182,미개하다/Adjective,31,9,22,0.00012226297654773814,0.00026655412159310506,0.7096774193548387
5183,5183,....?/Punctuation,31,10,21,0.0001333777925975325,0.0002554476998600591,0.6774193548387096
5184,5184,츠/Noun,31,21,10,0.00025564076914527065,0.00013327706079655256,0.6774193548387096
5185,5185,인셉션/Noun,31,21,10,0.00025564076914527065,0.00013327706079655256,0.6774193548387096
5186,5186,스트립/Noun,31,21,10,0.00025564076914527065,0.00013327706079655256,0.6774193548387096
5187,5187,큰일/Noun,31,10,21,0.0001333777925975325,0.0002554476998600591,0.6774193548387096
5188,5188,오우/Noun,31,21,10,0.00025564076914527065,0.00013327706079655256,0.6774193548387096
5189,5189,무장/Noun,31,10,21,0.0001333777925975325,0.0002554476998600591,0.6774193548387096
5190,5190,끊어지다/Verb,31,10,21,0.0001333777925975325,0.0002554476998600591,0.6774193548387096
5191,5191,미남/Noun,31,21,10,0.00025564076914527065,0.00013327706079655256,0.6774193548387096
5192,5192,부류/Noun,31,10,21,0.0001333777925975325,0.0002554476998600591,0.6774193548387096
5193,5193,내주다/Verb,31,21,10,0.00025564076914527065,0.00013327706079655256,0.6774193548387096
5194,5194,마저/Noun,31,11,20,0.0001444926086473269,0.00024434127812701304,0.6451612903225806
5195,5195,라고는/Josa,31,11,20,0.0001444926086473269,0.00024434127812701304,0.6451612903225806
5196,5196,인증/Noun,31,11,20,0.0001444926086473269,0.00024434127812701304,0.6451612903225806
5197,5197,나인/Noun,31,20,11,0.00024452595309547634,0.0001443834825295986,0.6451612903225806
5198,5198,그런대로/Adverb,31,11,20,0.0001444926086473269,0.00024434127812701304,0.6451612903225806
5199,5199,",../Punctuation",31,11,20,0.0001444926086473269,0.00024434127812701304,0.6451612903225806
5200,5200,필립/Noun,31,20,11,0.00024452595309547634,0.0001443834825295986,0.6451612903225806
5201,5201,뎁/Noun,31,20,11,0.00024452595309547634,0.0001443834825295986,0.6451612903225806
5202,5202,써주다/Verb,31,11,20,0.0001444926086473269,0.00024434127812701304,0.6451612903225806
5203,5203,난이/Noun,31,20,11,0.00024452595309547634,0.0001443834825295986,0.6451612903225806
5204,5204,7~8/Number,31,20,11,0.00024452595309547634,0.0001443834825295986,0.6451612903225806
5205,5205,맞먹다/Verb,31,12,19,0.00015560742469712126,0.000233234856393967,0.6129032258064516
5206,5206,불꽃/Noun,31,19,12,0.0002334111370456819,0.00015548990426264466,0.6129032258064516
5207,5207,악의/Noun,31,19,12,0.0002334111370456819,0.00015548990426264466,0.6129032258064516
5208,5208,미스터/Noun,31,19,12,0.0002334111370456819,0.00015548990426264466,0.6129032258064516
5209,5209,진출/Noun,31,13,18,0.00016672224074691566,0.00022212843466092096,0.5806451612903226
5210,5210,기리/Noun,31,18,13,0.0002222963209958875,0.0001665963259956907,0.5806451612903226
5211,5211,주장/Noun,31,13,18,0.00016672224074691566,0.00022212843466092096,0.5806451612903226
5212,5212,불가능/Noun,31,18,13,0.0002222963209958875,0.0001665963259956907,0.5806451612903226
5213,5213,매튜/Noun,31,18,13,0.0002222963209958875,0.0001665963259956907,0.5806451612903226
5214,5214,보더/Noun,31,13,18,0.00016672224074691566,0.00022212843466092096,0.5806451612903226
5215,5215,리스트/Noun,31,18,13,0.0002222963209958875,0.0001665963259956907,0.5806451612903226
5216,5216,달려가다/Verb,31,18,13,0.0002222963209958875,0.0001665963259956907,0.5806451612903226
5217,5217,도박/Noun,31,18,13,0.0002222963209958875,0.0001665963259956907,0.5806451612903226
5218,5218,전투기/Noun,31,13,18,0.00016672224074691566,0.00022212843466092096,0.5806451612903226
5219,5219,창조/Noun,31,18,13,0.0002222963209958875,0.0001665963259956907,0.5806451612903226
5220,5220,정성/Noun,31,13,18,0.00016672224074691566,0.00022212843466092096,0.5806451612903226
5221,5221,미션/Noun,31,13,18,0.00016672224074691566,0.00022212843466092096,0.5806451612903226
5222,5222,큐/Noun,31,13,18,0.00016672224074691566,0.00022212843466092096,0.5806451612903226
5223,5223,좁다/Adjective,31,13,18,0.00016672224074691566,0.00022212843466092096,0.5806451612903226
5224,5224,앤딩/Noun,31,13,18,0.00016672224074691566,0.00022212843466092096,0.5806451612903226
5225,5225,장용/Noun,31,13,18,0.00016672224074691566,0.00022212843466092096,0.5806451612903226
5226,5226,사오다/Verb,31,18,13,0.0002222963209958875,0.0001665963259956907,0.5806451612903226
5227,5227,기반/Noun,31,13,18,0.00016672224074691566,0.00022212843466092096,0.5806451612903226
5228,5228,뜸/Noun,31,18,13,0.0002222963209958875,0.0001665963259956907,0.5806451612903226
5229,5229,궁금증/Noun,31,14,17,0.00017783705679671002,0.0002110220129278749,0.5483870967741935
5230,5230,문제점/Noun,31,14,17,0.00017783705679671002,0.0002110220129278749,0.5483870967741935
5231,5231,천녀유혼/Noun,31,14,17,0.00017783705679671002,0.0002110220129278749,0.5483870967741935
5232,5232,헤/Noun,31,14,17,0.00017783705679671002,0.0002110220129278749,0.5483870967741935
5233,5233,롯데/Noun,31,17,14,0.00021118150494609317,0.00017770274772873674,0.5483870967741935
5234,5234,미우다/Verb,31,17,14,0.00021118150494609317,0.00017770274772873674,0.5483870967741935
5235,5235,며칠/Noun,31,17,14,0.00021118150494609317,0.00017770274772873674,0.5483870967741935
5236,5236,발차기/Noun,31,14,17,0.00017783705679671002,0.0002110220129278749,0.5483870967741935
5237,5237,이겠다/Verb,31,17,14,0.00021118150494609317,0.00017770274772873674,0.5483870967741935
5238,5238,자녀/Noun,31,16,15,0.0002000666888962988,0.0001888091694617828,0.5161290322580645
5239,5239,마니아/Noun,31,16,15,0.0002000666888962988,0.0001888091694617828,0.5161290322580645
5240,5240,주시/Noun,31,16,15,0.0002000666888962988,0.0001888091694617828,0.5161290322580645
5241,5241,고현정/Noun,31,15,16,0.00018895187284650438,0.00019991559119482882,0.5161290322580645
5242,5242,K/Alpha,31,15,16,0.00018895187284650438,0.00019991559119482882,0.5161290322580645
5243,5243,을/Noun,31,15,16,0.00018895187284650438,0.00019991559119482882,0.5161290322580645
5244,5244,대학교/Noun,31,16,15,0.0002000666888962988,0.0001888091694617828,0.5161290322580645
5245,5245,천하/Noun,31,16,15,0.0002000666888962988,0.0001888091694617828,0.5161290322580645
5246,5246,O/Alpha,31,15,16,0.00018895187284650438,0.00019991559119482882,0.5161290322580645
5247,5247,난감하다/Adjective,30,1,29,3.334444814938313e-05,0.00034429907372442745,0.9666666666666668
5248,5248,흠뻑/Noun,30,29,1,0.0003445592975436257,3.331926519913814e-05,0.9666666666666668
5249,5249,난방/Noun,30,1,29,3.334444814938313e-05,0.00034429907372442745,0.9666666666666668
5250,5250,한물가다/Verb,30,2,28,4.445926419917751e-05,0.0003331926519913814,0.9333333333333332
5251,5251,중구/Noun,30,2,28,4.445926419917751e-05,0.0003331926519913814,0.9333333333333332
5252,5252,더러워지다/Verb,30,2,28,4.445926419917751e-05,0.0003331926519913814,0.9333333333333332
5253,5253,유승준/Noun,30,3,27,5.5574080248971876e-05,0.00032208623025833537,0.9
5254,5254,망신/Noun,30,3,27,5.5574080248971876e-05,0.00032208623025833537,0.9
5255,5255,인간미/Noun,30,26,4,0.00031121484939424253,6.663853039827628e-05,0.8666666666666667
5256,5256,무책임하다/Adjective,30,4,26,6.668889629876625e-05,0.00031097980852528933,0.8666666666666667
5257,5257,안남다/Adjective,30,4,26,6.668889629876625e-05,0.00031097980852528933,0.8666666666666667
5258,5258,진실되다/Adjective,30,26,4,0.00031121484939424253,6.663853039827628e-05,0.8666666666666667
5259,5259,괴/Noun,30,4,26,6.668889629876625e-05,0.00031097980852528933,0.8666666666666667
5260,5260,무표정/Noun,30,5,25,7.780371234856063e-05,0.0002998733867922433,0.8333333333333334
5261,5261,거도/Noun,30,6,24,8.891852839835501e-05,0.0002887669650591972,0.8
5262,5262,영화음악/Noun,30,24,6,0.0002889852172946538,8.885137386436837e-05,0.8
5263,5263,걸레/Noun,30,6,24,8.891852839835501e-05,0.0002887669650591972,0.8
5264,5264,ㅁㅊ/KoreanParticle,30,6,24,8.891852839835501e-05,0.0002887669650591972,0.8
5265,5265,쬐다/Verb,30,6,24,8.891852839835501e-05,0.0002887669650591972,0.8
5266,5266,잠수함/Noun,30,24,6,0.0002889852172946538,8.885137386436837e-05,0.8
5267,5267,관성/Noun,30,6,24,8.891852839835501e-05,0.0002887669650591972,0.8
5268,5268,으으/Exclamation,30,6,24,8.891852839835501e-05,0.0002887669650591972,0.8
5269,5269,패기/Noun,30,6,24,8.891852839835501e-05,0.0002887669650591972,0.8
5270,5270,진주/Noun,30,24,6,0.0002889852172946538,8.885137386436837e-05,0.8
5271,5271,은희/Noun,30,7,23,0.0001000333444481494,0.00027766054332615115,0.7666666666666667
5272,5272,미루다/Verb,30,23,7,0.00027787040124485944,9.995779559741441e-05,0.7666666666666667
5273,5273,피하/Noun,30,7,23,0.0001000333444481494,0.00027766054332615115,0.7666666666666667
5274,5274,여고괴담/Noun,30,7,23,0.0001000333444481494,0.00027766054332615115,0.7666666666666667
5275,5275,콧물/Noun,30,23,7,0.00027787040124485944,9.995779559741441e-05,0.7666666666666667
5276,5276,오점/Noun,30,8,22,0.00011114816049794375,0.00026655412159310506,0.7333333333333333
5277,5277,기념/Noun,30,8,22,0.00011114816049794375,0.00026655412159310506,0.7333333333333333
5278,5278,and/Alpha,30,22,8,0.000266755585195065,0.00011106421733046048,0.7333333333333333
5279,5279,토이스토리/Noun,30,22,8,0.000266755585195065,0.00011106421733046048,0.7333333333333333
5280,5280,교차/Noun,30,22,8,0.000266755585195065,0.00011106421733046048,0.7333333333333333
5281,5281,나마/Josa,30,22,8,0.000266755585195065,0.00011106421733046048,0.7333333333333333
5282,5282,평범/Noun,30,8,22,0.00011114816049794375,0.00026655412159310506,0.7333333333333333
5283,5283,무능하다/Adjective,30,9,21,0.00012226297654773814,0.0002554476998600591,0.7
5284,5284,아야/Noun,30,9,21,0.00012226297654773814,0.0002554476998600591,0.7
5285,5285,작업/Noun,30,9,21,0.00012226297654773814,0.0002554476998600591,0.7
5286,5286,처벌/Noun,30,9,21,0.00012226297654773814,0.0002554476998600591,0.7
5287,5287,구해/Noun,30,21,9,0.00025564076914527065,0.00012217063906350652,0.7
5288,5288,의존/Noun,30,9,21,0.00012226297654773814,0.0002554476998600591,0.7
5289,5289,에너지/Noun,30,20,10,0.00024452595309547634,0.00013327706079655256,0.6666666666666666
5290,5290,sbs/Alpha,30,10,20,0.0001333777925975325,0.00024434127812701304,0.6666666666666666
5291,5291,안정/Noun,30,20,10,0.00024452595309547634,0.00013327706079655256,0.6666666666666666
5292,5292,지능/Noun,30,10,20,0.0001333777925975325,0.00024434127812701304,0.6666666666666666
5293,5293,조재현/Noun,30,20,10,0.00024452595309547634,0.00013327706079655256,0.6666666666666666
5294,5294,축/Noun,30,10,20,0.0001333777925975325,0.00024434127812701304,0.6666666666666666
5295,5295,간접/Noun,30,20,10,0.00024452595309547634,0.00013327706079655256,0.6666666666666666
5296,5296,정적/Noun,30,20,10,0.00024452595309547634,0.00013327706079655256,0.6666666666666666
5297,5297,로드무비/Noun,30,20,10,0.00024452595309547634,0.00013327706079655256,0.6666666666666666
5298,5298,이종석/Noun,30,19,11,0.0002334111370456819,0.0001443834825295986,0.6333333333333333
5299,5299,갱/Noun,30,11,19,0.0001444926086473269,0.000233234856393967,0.6333333333333333
5300,5300,도감/Noun,30,19,11,0.0002334111370456819,0.0001443834825295986,0.6333333333333333
5301,5301,모델/Noun,30,11,19,0.0001444926086473269,0.000233234856393967,0.6333333333333333
5302,5302,웨슬리/Noun,30,11,19,0.0001444926086473269,0.000233234856393967,0.6333333333333333
5303,5303,모자/Noun,30,19,11,0.0002334111370456819,0.0001443834825295986,0.6333333333333333
5304,5304,쾌감/Noun,30,19,11,0.0002334111370456819,0.0001443834825295986,0.6333333333333333
5305,5305,안티/Noun,30,11,19,0.0001444926086473269,0.000233234856393967,0.6333333333333333
5306,5306,데이트/Noun,30,11,19,0.0001444926086473269,0.000233234856393967,0.6333333333333333
5307,5307,최진실/Noun,30,19,11,0.0002334111370456819,0.0001443834825295986,0.6333333333333333
5308,5308,속상하다/Adjective,30,19,11,0.0002334111370456819,0.0001443834825295986,0.6333333333333333
5309,5309,나비효과/Noun,30,12,18,0.00015560742469712126,0.00022212843466092096,0.6
5310,5310,무심하다/Adjective,30,12,18,0.00015560742469712126,0.00022212843466092096,0.6
5311,5311,두뇌/Noun,30,18,12,0.0002222963209958875,0.00015548990426264466,0.6
5312,5312,스토리텔링/Noun,30,12,18,0.00015560742469712126,0.00022212843466092096,0.6
5313,5313,평작/Noun,30,12,18,0.00015560742469712126,0.00022212843466092096,0.6
5314,5314,묶다/Verb,30,12,18,0.00015560742469712126,0.00022212843466092096,0.6
5315,5315,헛소리/Noun,30,12,18,0.00015560742469712126,0.00022212843466092096,0.6
5316,5316,일본애니/Noun,30,18,12,0.0002222963209958875,0.00015548990426264466,0.6
5317,5317,대니/Noun,30,18,12,0.0002222963209958875,0.00015548990426264466,0.6
5318,5318,출동/Noun,30,12,18,0.00015560742469712126,0.00022212843466092096,0.6
5319,5319,하여간/Adverb,30,12,18,0.00015560742469712126,0.00022212843466092096,0.6
5320,5320,시스템/Noun,30,18,12,0.0002222963209958875,0.00015548990426264466,0.6
5321,5321,유해진/Noun,30,18,12,0.0002222963209958875,0.00015548990426264466,0.6
5322,5322,가문/Noun,30,12,18,0.00015560742469712126,0.00022212843466092096,0.6
5323,5323,초능력/Noun,30,12,18,0.00015560742469712126,0.00022212843466092096,0.6
5324,5324,그룹/Noun,30,12,18,0.00015560742469712126,0.00022212843466092096,0.6
5325,5325,이승기/Noun,30,18,12,0.0002222963209958875,0.00015548990426264466,0.6
5326,5326,각성/Noun,30,13,17,0.00016672224074691566,0.0002110220129278749,0.5666666666666667
5327,5327,로사/Noun,30,17,13,0.00021118150494609317,0.0001665963259956907,0.5666666666666667
5328,5328,자존심/Noun,30,17,13,0.00021118150494609317,0.0001665963259956907,0.5666666666666667
5329,5329,번만/Noun,30,17,13,0.00021118150494609317,0.0001665963259956907,0.5666666666666667
5330,5330,고향/Noun,30,13,17,0.00016672224074691566,0.0002110220129278749,0.5666666666666667
5331,5331,뚫다/Verb,30,13,17,0.00016672224074691566,0.0002110220129278749,0.5666666666666667
5332,5332,해안/Noun,30,13,17,0.00016672224074691566,0.0002110220129278749,0.5666666666666667
5333,5333,퀄/Noun,30,17,13,0.00021118150494609317,0.0001665963259956907,0.5666666666666667
5334,5334,이입/Noun,30,13,17,0.00016672224074691566,0.0002110220129278749,0.5666666666666667
5335,5335,리언/Noun,30,17,13,0.00021118150494609317,0.0001665963259956907,0.5666666666666667
5336,5336,에서부터/Josa,30,13,17,0.00016672224074691566,0.0002110220129278749,0.5666666666666667
5337,5337,아트/Noun,30,17,13,0.00021118150494609317,0.0001665963259956907,0.5666666666666667
5338,5338,안고/Noun,30,17,13,0.00021118150494609317,0.0001665963259956907,0.5666666666666667
5339,5339,찍히다/Verb,30,14,16,0.00017783705679671002,0.00019991559119482882,0.5333333333333333
5340,5340,식당/Noun,30,14,16,0.00017783705679671002,0.00019991559119482882,0.5333333333333333
5341,5341,1%/Number,30,16,14,0.0002000666888962988,0.00017770274772873674,0.5333333333333333
5342,5342,헐크/Noun,30,16,14,0.0002000666888962988,0.00017770274772873674,0.5333333333333333
5343,5343,대판/Noun,30,16,14,0.0002000666888962988,0.00017770274772873674,0.5333333333333333
5344,5344,봉태규/Noun,30,14,16,0.00017783705679671002,0.00019991559119482882,0.5333333333333333
5345,5345,림/Noun,30,16,14,0.0002000666888962988,0.00017770274772873674,0.5333333333333333
5346,5346,경제/Noun,30,14,16,0.00017783705679671002,0.00019991559119482882,0.5333333333333333
5347,5347,악플/Noun,30,14,16,0.00017783705679671002,0.00019991559119482882,0.5333333333333333
5348,5348,장쯔이/Noun,30,16,14,0.0002000666888962988,0.00017770274772873674,0.5333333333333333
5349,5349,사의/Noun,30,16,14,0.0002000666888962988,0.00017770274772873674,0.5333333333333333
5350,5350,아날로그/Noun,30,16,14,0.0002000666888962988,0.00017770274772873674,0.5333333333333333
5351,5351,신동엽/Noun,30,15,15,0.00018895187284650438,0.0001888091694617828,0.5
5352,5352,모건/Noun,30,15,15,0.00018895187284650438,0.0001888091694617828,0.5
5353,5353,실체/Noun,30,15,15,0.00018895187284650438,0.0001888091694617828,0.5
5354,5354,지속/Noun,30,15,15,0.00018895187284650438,0.0001888091694617828,0.5
5355,5355,감싸다/Verb,30,15,15,0.00018895187284650438,0.0001888091694617828,0.5
5356,5356,200/Number,30,15,15,0.00018895187284650438,0.0001888091694617828,0.5
5357,5357,판타지영화/Noun,30,15,15,0.00018895187284650438,0.0001888091694617828,0.5
5358,5358,주고/Foreign,29,1,28,3.334444814938313e-05,0.0003331926519913814,0.9655172413793104
5359,5359,맑다/Adjective,29,28,1,0.0003334444814938313,3.331926519913814e-05,0.9655172413793104
5360,5360,남아도/Noun,29,2,27,4.445926419917751e-05,0.00032208623025833537,0.9310344827586208
5361,5361,간신히/Adverb,29,2,27,4.445926419917751e-05,0.00032208623025833537,0.9310344827586208
5362,5362,거중/Noun,29,2,27,4.445926419917751e-05,0.00032208623025833537,0.9310344827586208
5363,5363,성질/Noun,29,2,27,4.445926419917751e-05,0.00032208623025833537,0.9310344827586208
5364,5364,MC/Alpha,29,3,26,5.5574080248971876e-05,0.00031097980852528933,0.8965517241379308
5365,5365,입가/Noun,29,26,3,0.00031121484939424253,5.553210866523024e-05,0.8965517241379308
5366,5366,취지/Noun,29,3,26,5.5574080248971876e-05,0.00031097980852528933,0.8965517241379308
5367,5367,말장난/Noun,29,3,26,5.5574080248971876e-05,0.00031097980852528933,0.8965517241379308
5368,5368,나소/Noun,29,4,25,6.668889629876625e-05,0.0002998733867922433,0.8620689655172413
5369,5369,두서/Noun,29,4,25,6.668889629876625e-05,0.0002998733867922433,0.8620689655172413
5370,5370,"..,,/Punctuation",29,4,25,6.668889629876625e-05,0.0002998733867922433,0.8620689655172413
5371,5371,백미/Noun,29,25,4,0.00030010003334444816,6.663853039827628e-05,0.8620689655172413
5372,5372,미성년/Noun,29,4,25,6.668889629876625e-05,0.0002998733867922433,0.8620689655172413
5373,5373,잡아먹다/Verb,29,4,25,6.668889629876625e-05,0.0002998733867922433,0.8620689655172413
5374,5374,성냥/Noun,29,4,25,6.668889629876625e-05,0.0002998733867922433,0.8620689655172413
5375,5375,전파/Noun,29,4,25,6.668889629876625e-05,0.0002998733867922433,0.8620689655172413
5376,5376,틀어놓다/Verb,29,5,24,7.780371234856063e-05,0.0002887669650591972,0.8275862068965517
5377,5377,김규리/Noun,29,5,24,7.780371234856063e-05,0.0002887669650591972,0.8275862068965517
5378,5378,돌이키다/Verb,29,24,5,0.0002889852172946538,7.774495213132233e-05,0.8275862068965517
5379,5379,눈알/Noun,29,5,24,7.780371234856063e-05,0.0002887669650591972,0.8275862068965517
5380,5380,좆/Noun,29,5,24,7.780371234856063e-05,0.0002887669650591972,0.8275862068965517
5381,5381,으로의/Josa,29,24,5,0.0002889852172946538,7.774495213132233e-05,0.8275862068965517
5382,5382,똥폼/Noun,29,5,24,7.780371234856063e-05,0.0002887669650591972,0.8275862068965517
5383,5383,통쾌/Noun,29,23,6,0.00027787040124485944,8.885137386436837e-05,0.7931034482758621
5384,5384,퍼펙트/Noun,29,23,6,0.00027787040124485944,8.885137386436837e-05,0.7931034482758621
5385,5385,’/Punctuation,29,6,23,8.891852839835501e-05,0.00027766054332615115,0.7931034482758621
5386,5386,오늘날/Noun,29,23,6,0.00027787040124485944,8.885137386436837e-05,0.7931034482758621
5387,5387,깜찍하다/Adjective,29,23,6,0.00027787040124485944,8.885137386436837e-05,0.7931034482758621
5388,5388,사납다/Adjective,29,6,23,8.891852839835501e-05,0.00027766054332615115,0.7931034482758621
5389,5389,대치/Noun,29,7,22,0.0001000333444481494,0.00026655412159310506,0.7586206896551724
5390,5390,엇어/Noun,29,22,7,0.000266755585195065,9.995779559741441e-05,0.7586206896551724
5391,5391,별반/Noun,29,7,22,0.0001000333444481494,0.00026655412159310506,0.7586206896551724
5392,5392,단막극/Noun,29,7,22,0.0001000333444481494,0.00026655412159310506,0.7586206896551724
5393,5393,조롱/Noun,29,7,22,0.0001000333444481494,0.00026655412159310506,0.7586206896551724
5394,5394,",.../Punctuation",29,7,22,0.0001000333444481494,0.00026655412159310506,0.7586206896551724
5395,5395,운전/Noun,29,7,22,0.0001000333444481494,0.00026655412159310506,0.7586206896551724
5396,5396,가왜/Noun,29,7,22,0.0001000333444481494,0.00026655412159310506,0.7586206896551724
5397,5397,사전/Noun,29,22,7,0.000266755585195065,9.995779559741441e-05,0.7586206896551724
5398,5398,몬/Noun,29,7,22,0.0001000333444481494,0.00026655412159310506,0.7586206896551724
5399,5399,찌들다/Verb,29,22,7,0.000266755585195065,9.995779559741441e-05,0.7586206896551724
5400,5400,인공/Noun,29,8,21,0.00011114816049794375,0.0002554476998600591,0.7241379310344828
5401,5401,뮤직/Noun,29,21,8,0.00025564076914527065,0.00011106421733046048,0.7241379310344828
5402,5402,사례/Noun,29,8,21,0.00011114816049794375,0.0002554476998600591,0.7241379310344828
5403,5403,신기/Noun,29,8,21,0.00011114816049794375,0.0002554476998600591,0.7241379310344828
5404,5404,-.-/Punctuation,29,8,21,0.00011114816049794375,0.0002554476998600591,0.7241379310344828
5405,5405,영화니/Noun,29,8,21,0.00011114816049794375,0.0002554476998600591,0.7241379310344828
5406,5406,☆/Foreign,29,21,8,0.00025564076914527065,0.00011106421733046048,0.7241379310344828
5407,5407,당한/Noun,29,8,21,0.00011114816049794375,0.0002554476998600591,0.7241379310344828
5408,5408,사로자다/Verb,29,21,8,0.00025564076914527065,0.00011106421733046048,0.7241379310344828
5409,5409,길들이다/Verb,29,21,8,0.00025564076914527065,0.00011106421733046048,0.7241379310344828
5410,5410,연민/Noun,29,20,9,0.00024452595309547634,0.00012217063906350652,0.6896551724137931
5411,5411,금발/Noun,29,9,20,0.00012226297654773814,0.00024434127812701304,0.6896551724137931
5412,5412,치중/Noun,29,9,20,0.00012226297654773814,0.00024434127812701304,0.6896551724137931
5413,5413,가위/Noun,29,9,20,0.00012226297654773814,0.00024434127812701304,0.6896551724137931
5414,5414,짝사랑/Noun,29,20,9,0.00024452595309547634,0.00012217063906350652,0.6896551724137931
5415,5415,거들다/Verb,29,9,20,0.00012226297654773814,0.00024434127812701304,0.6896551724137931
5416,5416,보물/Noun,29,20,9,0.00024452595309547634,0.00012217063906350652,0.6896551724137931
5417,5417,17/Number,29,19,10,0.0002334111370456819,0.00013327706079655256,0.6551724137931034
5418,5418,여실히/Noun,29,10,19,0.0001333777925975325,0.000233234856393967,0.6551724137931034
5419,5419,타잔/Noun,29,10,19,0.0001333777925975325,0.000233234856393967,0.6551724137931034
5420,5420,토르/Noun,29,19,10,0.0002334111370456819,0.00013327706079655256,0.6551724137931034
5421,5421,무도/Noun,29,10,19,0.0001333777925975325,0.000233234856393967,0.6551724137931034
5422,5422,이성/Noun,29,19,10,0.0002334111370456819,0.00013327706079655256,0.6551724137931034
5423,5423,시원/Noun,29,19,10,0.0002334111370456819,0.00013327706079655256,0.6551724137931034
5424,5424,보호/Noun,29,19,10,0.0002334111370456819,0.00013327706079655256,0.6551724137931034
5425,5425,오기/Noun,29,10,19,0.0001333777925975325,0.000233234856393967,0.6551724137931034
5426,5426,시킴/Noun,29,10,19,0.0001333777925975325,0.000233234856393967,0.6551724137931034
5427,5427,해달라다/Verb,29,10,19,0.0001333777925975325,0.000233234856393967,0.6551724137931034
5428,5428,폭탄/Noun,29,10,19,0.0001333777925975325,0.000233234856393967,0.6551724137931034
5429,5429,파트너/Noun,29,11,18,0.0001444926086473269,0.00022212843466092096,0.6206896551724138
5430,5430,우울증/Noun,29,11,18,0.0001444926086473269,0.00022212843466092096,0.6206896551724138
5431,5431,어깨/Noun,29,18,11,0.0002222963209958875,0.0001443834825295986,0.6206896551724138
5432,5432,어울림/Noun,29,18,11,0.0002222963209958875,0.0001443834825295986,0.6206896551724138
5433,5433,힐/Noun,29,11,18,0.0001444926086473269,0.00022212843466092096,0.6206896551724138
5434,5434,홈/Noun,29,11,18,0.0001444926086473269,0.00022212843466092096,0.6206896551724138
5435,5435,병사/Noun,29,11,18,0.0001444926086473269,0.00022212843466092096,0.6206896551724138
5436,5436,라이브/Noun,29,18,11,0.0002222963209958875,0.0001443834825295986,0.6206896551724138
5437,5437,클루니/Noun,29,18,11,0.0002222963209958875,0.0001443834825295986,0.6206896551724138
5438,5438,어긋나다/Verb,29,11,18,0.0001444926086473269,0.00022212843466092096,0.6206896551724138
5439,5439,한몫/Noun,29,18,11,0.0002222963209958875,0.0001443834825295986,0.6206896551724138
5440,5440,영호/Noun,29,18,11,0.0002222963209958875,0.0001443834825295986,0.6206896551724138
5441,5441,이라기/Josa,29,11,18,0.0001444926086473269,0.00022212843466092096,0.6206896551724138
5442,5442,벨/Modifier,29,11,18,0.0001444926086473269,0.00022212843466092096,0.6206896551724138
5443,5443,수사/Noun,29,12,17,0.00015560742469712126,0.0002110220129278749,0.5862068965517241
5444,5444,경쟁/Noun,29,17,12,0.00021118150494609317,0.00015548990426264466,0.5862068965517241
5445,5445,백/Noun,29,12,17,0.00015560742469712126,0.0002110220129278749,0.5862068965517241
5446,5446,한때/Adverb,29,17,12,0.00021118150494609317,0.00015548990426264466,0.5862068965517241
5447,5447,‥/Foreign,29,17,12,0.00021118150494609317,0.00015548990426264466,0.5862068965517241
5448,5448,퍼/Noun,29,12,17,0.00015560742469712126,0.0002110220129278749,0.5862068965517241
5449,5449,원제/Noun,29,12,17,0.00015560742469712126,0.0002110220129278749,0.5862068965517241
5450,5450,초심/Noun,29,12,17,0.00015560742469712126,0.0002110220129278749,0.5862068965517241
5451,5451,삽입/Noun,29,12,17,0.00015560742469712126,0.0002110220129278749,0.5862068965517241
5452,5452,건물/Noun,29,12,17,0.00015560742469712126,0.0002110220129278749,0.5862068965517241
5453,5453,핫/Noun,29,17,12,0.00021118150494609317,0.00015548990426264466,0.5862068965517241
5454,5454,로라/Noun,29,12,17,0.00015560742469712126,0.0002110220129278749,0.5862068965517241
5455,5455,황/Noun,29,12,17,0.00015560742469712126,0.0002110220129278749,0.5862068965517241
5456,5456,아메리칸/Noun,29,16,13,0.0002000666888962988,0.0001665963259956907,0.5517241379310345
5457,5457,점임/Noun,29,13,16,0.00016672224074691566,0.00019991559119482882,0.5517241379310345
5458,5458,주민/Noun,29,13,16,0.00016672224074691566,0.00019991559119482882,0.5517241379310345
5459,5459,그림자/Noun,29,13,16,0.00016672224074691566,0.00019991559119482882,0.5517241379310345
5460,5460,피로/Noun,29,13,16,0.00016672224074691566,0.00019991559119482882,0.5517241379310345
5461,5461,선배/Noun,29,13,16,0.00016672224074691566,0.00019991559119482882,0.5517241379310345
5462,5462,헤헤/Noun,29,13,16,0.00016672224074691566,0.00019991559119482882,0.5517241379310345
5463,5463,세지/Noun,29,16,13,0.0002000666888962988,0.0001665963259956907,0.5517241379310345
5464,5464,헬기/Noun,29,13,16,0.00016672224074691566,0.00019991559119482882,0.5517241379310345
5465,5465,정글/Noun,29,14,15,0.00017783705679671002,0.0001888091694617828,0.5172413793103449
5466,5466,전통/Noun,29,15,14,0.00018895187284650438,0.00017770274772873674,0.5172413793103449
5467,5467,극도/Noun,29,14,15,0.00017783705679671002,0.0001888091694617828,0.5172413793103449
5468,5468,대처/Noun,29,15,14,0.00018895187284650438,0.00017770274772873674,0.5172413793103449
5469,5469,늘어나다/Verb,29,15,14,0.00018895187284650438,0.00017770274772873674,0.5172413793103449
5470,5470,세라/Noun,29,14,15,0.00017783705679671002,0.0001888091694617828,0.5172413793103449
5471,5471,디비디/Noun,29,15,14,0.00018895187284650438,0.00017770274772873674,0.5172413793103449
5472,5472,ㅆ/KoreanParticle,29,14,15,0.00017783705679671002,0.0001888091694617828,0.5172413793103449
5473,5473,이서/Noun,29,14,15,0.00017783705679671002,0.0001888091694617828,0.5172413793103449
5474,5474,.'/Punctuation,29,15,14,0.00018895187284650438,0.00017770274772873674,0.5172413793103449
5475,5475,대변/Noun,29,14,15,0.00017783705679671002,0.0001888091694617828,0.5172413793103449
5476,5476,악인/Noun,29,14,15,0.00017783705679671002,0.0001888091694617828,0.5172413793103449
5477,5477,블/Noun,29,14,15,0.00017783705679671002,0.0001888091694617828,0.5172413793103449
5478,5478,단계/Noun,29,15,14,0.00018895187284650438,0.00017770274772873674,0.5172413793103449
5479,5479,책임감/Noun,29,14,15,0.00017783705679671002,0.0001888091694617828,0.5172413793103449
5480,5480,구림/Noun,28,0,28,2.2229632099588756e-05,0.0003331926519913814,1.0
5481,5481,당췌/Noun,28,1,27,3.334444814938313e-05,0.00032208623025833537,0.9642857142857144
5482,5482,물결/Noun,28,26,2,0.00031121484939424253,4.4425686932184186e-05,0.9285714285714286
5483,5483,날림/Noun,28,3,25,5.5574080248971876e-05,0.0002998733867922433,0.8928571428571429
5484,5484,배슬기/Noun,28,3,25,5.5574080248971876e-05,0.0002998733867922433,0.8928571428571429
5485,5485,통찰/Noun,28,24,4,0.0002889852172946538,6.663853039827628e-05,0.8571428571428571
5486,5486,천박하다/Adjective,28,4,24,6.668889629876625e-05,0.0002887669650591972,0.8571428571428571
5487,5487,이면/Foreign,28,4,24,6.668889629876625e-05,0.0002887669650591972,0.8571428571428571
5488,5488,추잡하다/Adjective,28,4,24,6.668889629876625e-05,0.0002887669650591972,0.8571428571428571
5489,5489,결과물/Noun,28,4,24,6.668889629876625e-05,0.0002887669650591972,0.8571428571428571
5490,5490,로맨스영화/Noun,28,24,4,0.0002889852172946538,6.663853039827628e-05,0.8571428571428571
5491,5491,늘어놓다/Verb,28,4,24,6.668889629876625e-05,0.0002887669650591972,0.8571428571428571
5492,5492,봣습니/Noun,28,24,4,0.0002889852172946538,6.663853039827628e-05,0.8571428571428571
5493,5493,진부/Noun,28,5,23,7.780371234856063e-05,0.00027766054332615115,0.8214285714285714
5494,5494,심은하/Noun,28,23,5,0.00027787040124485944,7.774495213132233e-05,0.8214285714285714
5495,5495,농락/Noun,28,5,23,7.780371234856063e-05,0.00027766054332615115,0.8214285714285714
5496,5496,오열/Noun,28,23,5,0.00027787040124485944,7.774495213132233e-05,0.8214285714285714
5497,5497,주어지다/Verb,28,23,5,0.00027787040124485944,7.774495213132233e-05,0.8214285714285714
5498,5498,지못미/Noun,28,5,23,7.780371234856063e-05,0.00027766054332615115,0.8214285714285714
5499,5499,i/Alpha,28,22,6,0.000266755585195065,8.885137386436837e-05,0.7857142857142857
5500,5500,해설/Noun,28,6,22,8.891852839835501e-05,0.00026655412159310506,0.7857142857142857
5501,5501,좌좀/Noun,28,6,22,8.891852839835501e-05,0.00026655412159310506,0.7857142857142857
5502,5502,남겨지다/Verb,28,22,6,0.000266755585195065,8.885137386436837e-05,0.7857142857142857
5503,5503,‘/Foreign,28,6,22,8.891852839835501e-05,0.00026655412159310506,0.7857142857142857
5504,5504,아키라/Noun,28,21,7,0.00025564076914527065,9.995779559741441e-05,0.75
5505,5505,폭파/Noun,28,7,21,0.0001000333444481494,0.0002554476998600591,0.75
5506,5506,빠져나오다/Verb,28,21,7,0.00025564076914527065,9.995779559741441e-05,0.75
5507,5507,소유/Noun,28,21,7,0.00025564076914527065,9.995779559741441e-05,0.75
5508,5508,파멸/Noun,28,21,7,0.00025564076914527065,9.995779559741441e-05,0.75
5509,5509,보상/Noun,28,7,21,0.0001000333444481494,0.0002554476998600591,0.75
5510,5510,짐작/Noun,28,7,21,0.0001000333444481494,0.0002554476998600591,0.75
5511,5511,감우성/Noun,28,21,7,0.00025564076914527065,9.995779559741441e-05,0.75
5512,5512,후의/Noun,28,21,7,0.00025564076914527065,9.995779559741441e-05,0.75
5513,5513,거여/Noun,28,7,21,0.0001000333444481494,0.0002554476998600591,0.75
5514,5514,오묘하다/Adjective,28,21,7,0.00025564076914527065,9.995779559741441e-05,0.75
5515,5515,조커/Noun,28,21,7,0.00025564076914527065,9.995779559741441e-05,0.75
5516,5516,타이밍/Noun,28,7,21,0.0001000333444481494,0.0002554476998600591,0.75
5517,5517,스탤론/Noun,28,20,8,0.00024452595309547634,0.00011106421733046048,0.7142857142857143
5518,5518,느끼하다/Adjective,28,8,20,0.00011114816049794375,0.00024434127812701304,0.7142857142857143
5519,5519,시바/Noun,28,8,20,0.00011114816049794375,0.00024434127812701304,0.7142857142857143
5520,5520,고집/Noun,28,8,20,0.00011114816049794375,0.00024434127812701304,0.7142857142857143
5521,5521,이민호/Noun,28,20,8,0.00024452595309547634,0.00011106421733046048,0.7142857142857143
5522,5522,동참/Noun,28,8,20,0.00011114816049794375,0.00024434127812701304,0.7142857142857143
5523,5523,이모/Noun,28,20,8,0.00024452595309547634,0.00011106421733046048,0.7142857142857143
5524,5524,반면/Noun,28,8,20,0.00011114816049794375,0.00024434127812701304,0.7142857142857143
5525,5525,장만옥/Noun,28,20,8,0.00024452595309547634,0.00011106421733046048,0.7142857142857143
5526,5526,늑대인간/Noun,28,8,20,0.00011114816049794375,0.00024434127812701304,0.7142857142857143
5527,5527,이리저리/Adverb,28,8,20,0.00011114816049794375,0.00024434127812701304,0.7142857142857143
5528,5528,말리/Noun,28,8,20,0.00011114816049794375,0.00024434127812701304,0.7142857142857143
5529,5529,어메이징/Noun,28,19,9,0.0002334111370456819,0.00012217063906350652,0.6785714285714286
5530,5530,24/Number,28,19,9,0.0002334111370456819,0.00012217063906350652,0.6785714285714286
5531,5531,퀸/Noun,28,19,9,0.0002334111370456819,0.00012217063906350652,0.6785714285714286
5532,5532,예정/Noun,28,19,9,0.0002334111370456819,0.00012217063906350652,0.6785714285714286
5533,5533,노무/Noun,28,9,19,0.00012226297654773814,0.000233234856393967,0.6785714285714286
5534,5534,자료/Noun,28,19,9,0.0002334111370456819,0.00012217063906350652,0.6785714285714286
5535,5535,덤덤하다/Adjective,28,19,9,0.0002334111370456819,0.00012217063906350652,0.6785714285714286
5536,5536,권리/Noun,28,19,9,0.0002334111370456819,0.00012217063906350652,0.6785714285714286
5537,5537,스콜/Noun,28,19,9,0.0002334111370456819,0.00012217063906350652,0.6785714285714286
5538,5538,눈감다/Verb,28,9,19,0.00012226297654773814,0.000233234856393967,0.6785714285714286
5539,5539,o/Alpha,28,19,9,0.0002334111370456819,0.00012217063906350652,0.6785714285714286
5540,5540,화장/Noun,28,9,19,0.00012226297654773814,0.000233234856393967,0.6785714285714286
5541,5541,부리/Noun,28,10,18,0.0001333777925975325,0.00022212843466092096,0.6428571428571429
5542,5542,장담/Noun,28,18,10,0.0002222963209958875,0.00013327706079655256,0.6428571428571429
5543,5543,왕따/Noun,28,10,18,0.0001333777925975325,0.00022212843466092096,0.6428571428571429
5544,5544,이야말로/Josa,28,18,10,0.0002222963209958875,0.00013327706079655256,0.6428571428571429
5545,5545,서사시/Noun,28,18,10,0.0002222963209958875,0.00013327706079655256,0.6428571428571429
5546,5546,오디션/Noun,28,10,18,0.0001333777925975325,0.00022212843466092096,0.6428571428571429
5547,5547,아이리스/Noun,28,10,18,0.0001333777925975325,0.00022212843466092096,0.6428571428571429
5548,5548,군데/Noun,28,10,18,0.0001333777925975325,0.00022212843466092096,0.6428571428571429
5549,5549,지은/Noun,28,10,18,0.0001333777925975325,0.00022212843466092096,0.6428571428571429
5550,5550,타이타닉/Noun,28,18,10,0.0002222963209958875,0.00013327706079655256,0.6428571428571429
5551,5551,지난/Modifier,28,18,10,0.0002222963209958875,0.00013327706079655256,0.6428571428571429
5552,5552,우베/Noun,28,10,18,0.0001333777925975325,0.00022212843466092096,0.6428571428571429
5553,5553,인사/Noun,28,18,10,0.0002222963209958875,0.00013327706079655256,0.6428571428571429
5554,5554,붙잡다/Verb,28,17,11,0.00021118150494609317,0.0001443834825295986,0.6071428571428571
5555,5555,끓다/Verb,28,17,11,0.00021118150494609317,0.0001443834825295986,0.6071428571428571
5556,5556,고급/Noun,28,17,11,0.00021118150494609317,0.0001443834825295986,0.6071428571428571
5557,5557,털다/Verb,28,11,17,0.0001444926086473269,0.0002110220129278749,0.6071428571428571
5558,5558,물들다/Verb,28,17,11,0.00021118150494609317,0.0001443834825295986,0.6071428571428571
5559,5559,제레미/Noun,28,17,11,0.00021118150494609317,0.0001443834825295986,0.6071428571428571
5560,5560,수년/Noun,28,17,11,0.00021118150494609317,0.0001443834825295986,0.6071428571428571
5561,5561,엄태웅/Noun,28,11,17,0.0001444926086473269,0.0002110220129278749,0.6071428571428571
5562,5562,다나/Noun,28,11,17,0.0001444926086473269,0.0002110220129278749,0.6071428571428571
5563,5563,나오니/Noun,28,11,17,0.0001444926086473269,0.0002110220129278749,0.6071428571428571
5564,5564,모니카/Noun,28,11,17,0.0001444926086473269,0.0002110220129278749,0.6071428571428571
5565,5565,결투/Noun,28,17,11,0.00021118150494609317,0.0001443834825295986,0.6071428571428571
5566,5566,미련/Noun,28,11,17,0.0001444926086473269,0.0002110220129278749,0.6071428571428571
5567,5567,시네마/Noun,28,16,12,0.0002000666888962988,0.00015548990426264466,0.5714285714285714
5568,5568,묵다/Verb,28,12,16,0.00015560742469712126,0.00019991559119482882,0.5714285714285714
5569,5569,경기/Noun,28,16,12,0.0002000666888962988,0.00015548990426264466,0.5714285714285714
5570,5570,풀이/Noun,28,12,16,0.00015560742469712126,0.00019991559119482882,0.5714285714285714
5571,5571,이프/Noun,28,12,16,0.00015560742469712126,0.00019991559119482882,0.5714285714285714
5572,5572,빠다/Noun,28,12,16,0.00015560742469712126,0.00019991559119482882,0.5714285714285714
5573,5573,오름/Noun,28,16,12,0.0002000666888962988,0.00015548990426264466,0.5714285714285714
5574,5574,눈높이/Noun,28,12,16,0.00015560742469712126,0.00019991559119482882,0.5714285714285714
5575,5575,공기/Noun,28,16,12,0.0002000666888962988,0.00015548990426264466,0.5714285714285714
5576,5576,일인/Noun,28,16,12,0.0002000666888962988,0.00015548990426264466,0.5714285714285714
5577,5577,휴잭맨/Noun,28,12,16,0.00015560742469712126,0.00019991559119482882,0.5714285714285714
5578,5578,참신/Noun,28,16,12,0.0002000666888962988,0.00015548990426264466,0.5714285714285714
5579,5579,개방/Noun,28,12,16,0.00015560742469712126,0.00019991559119482882,0.5714285714285714
5580,5580,깨어나다/Verb,28,12,16,0.00015560742469712126,0.00019991559119482882,0.5714285714285714
5581,5581,안젤리나/Noun,28,13,15,0.00016672224074691566,0.0001888091694617828,0.5357142857142857
5582,5582,저만/Modifier,28,13,15,0.00016672224074691566,0.0001888091694617828,0.5357142857142857
5583,5583,문학/Noun,28,15,13,0.00018895187284650438,0.0001665963259956907,0.5357142857142857
5584,5584,?)/Punctuation,28,15,13,0.00018895187284650438,0.0001665963259956907,0.5357142857142857
5585,5585,비리/Noun,28,13,15,0.00016672224074691566,0.0001888091694617828,0.5357142857142857
5586,5586,찢어지다/Verb,28,13,15,0.00016672224074691566,0.0001888091694617828,0.5357142857142857
5587,5587,흡사하다/Adjective,28,15,13,0.00018895187284650438,0.0001665963259956907,0.5357142857142857
5588,5588,결혼식/Noun,28,13,15,0.00016672224074691566,0.0001888091694617828,0.5357142857142857
5589,5589,채민서/Noun,28,15,13,0.00018895187284650438,0.0001665963259956907,0.5357142857142857
5590,5590,상승/Noun,28,13,15,0.00016672224074691566,0.0001888091694617828,0.5357142857142857
5591,5591,2006년/Number,28,13,15,0.00016672224074691566,0.0001888091694617828,0.5357142857142857
5592,5592,약속/Noun,28,15,13,0.00018895187284650438,0.0001665963259956907,0.5357142857142857
5593,5593,톱/Noun,28,15,13,0.00018895187284650438,0.0001665963259956907,0.5357142857142857
5594,5594,롭/Noun,28,15,13,0.00018895187284650438,0.0001665963259956907,0.5357142857142857
5595,5595,세명/Noun,28,13,15,0.00016672224074691566,0.0001888091694617828,0.5357142857142857
5596,5596,무방/Noun,28,13,15,0.00016672224074691566,0.0001888091694617828,0.5357142857142857
5597,5597,다그/Noun,28,15,13,0.00018895187284650438,0.0001665963259956907,0.5357142857142857
5598,5598,윌스미스/Noun,28,15,13,0.00018895187284650438,0.0001665963259956907,0.5357142857142857
5599,5599,소원/Noun,28,13,15,0.00016672224074691566,0.0001888091694617828,0.5357142857142857
5600,5600,but/Alpha,28,13,15,0.00016672224074691566,0.0001888091694617828,0.5357142857142857
5601,5601,권선/Noun,28,13,15,0.00016672224074691566,0.0001888091694617828,0.5357142857142857
5602,5602,사형/Noun,28,13,15,0.00016672224074691566,0.0001888091694617828,0.5357142857142857
5603,5603,정신없이/Adverb,28,14,14,0.00017783705679671002,0.00017770274772873674,0.5
5604,5604,"),/Punctuation",28,14,14,0.00017783705679671002,0.00017770274772873674,0.5
5605,5605,자라/Noun,28,14,14,0.00017783705679671002,0.00017770274772873674,0.5
5606,5606,남한/Noun,28,14,14,0.00017783705679671002,0.00017770274772873674,0.5
5607,5607,공각기동대/Noun,28,14,14,0.00017783705679671002,0.00017770274772873674,0.5
5608,5608,닥터/Noun,28,14,14,0.00017783705679671002,0.00017770274772873674,0.5
5609,5609,미션임파서블/Noun,28,14,14,0.00017783705679671002,0.00017770274772873674,0.5
5610,5610,에혀/Noun,27,1,26,3.334444814938313e-05,0.00031097980852528933,0.9629629629629628
5611,5611,술함/Noun,27,3,24,5.5574080248971876e-05,0.0002887669650591972,0.8888888888888888
5612,5612,댓글알바/Noun,27,3,24,5.5574080248971876e-05,0.0002887669650591972,0.8888888888888888
5613,5613,초보/Noun,27,3,24,5.5574080248971876e-05,0.0002887669650591972,0.8888888888888888
5614,5614,쉣/Noun,27,3,24,5.5574080248971876e-05,0.0002887669650591972,0.8888888888888888
5615,5615,맡기다/Verb,27,3,24,5.5574080248971876e-05,0.0002887669650591972,0.8888888888888888
5616,5616,허망/Noun,27,4,23,6.668889629876625e-05,0.00027766054332615115,0.8518518518518519
5617,5617,오오/Exclamation,27,23,4,0.00027787040124485944,6.663853039827628e-05,0.8518518518518519
5618,5618,맥락/Noun,27,4,23,6.668889629876625e-05,0.00027766054332615115,0.8518518518518519
5619,5619,그리움/Noun,27,23,4,0.00027787040124485944,6.663853039827628e-05,0.8518518518518519
5620,5620,경지/Noun,27,23,4,0.00027787040124485944,6.663853039827628e-05,0.8518518518518519
5621,5621,제한/Noun,27,4,23,6.668889629876625e-05,0.00027766054332615115,0.8518518518518519
5622,5622,사하나/Noun,27,23,4,0.00027787040124485944,6.663853039827628e-05,0.8518518518518519
5623,5623,푸른/Noun,27,23,4,0.00027787040124485944,6.663853039827628e-05,0.8518518518518519
5624,5624,알아주다/Verb,27,22,5,0.000266755585195065,7.774495213132233e-05,0.8148148148148148
5625,5625,이정현/Noun,27,22,5,0.000266755585195065,7.774495213132233e-05,0.8148148148148148
5626,5626,전용/Noun,27,5,22,7.780371234856063e-05,0.00026655412159310506,0.8148148148148148
5627,5627,가상하다/Adjective,27,5,22,7.780371234856063e-05,0.00026655412159310506,0.8148148148148148
5628,5628,맙소사/Exclamation,27,5,22,7.780371234856063e-05,0.00026655412159310506,0.8148148148148148
5629,5629,훼손/Noun,27,5,22,7.780371234856063e-05,0.00026655412159310506,0.8148148148148148
5630,5630,av/Alpha,27,5,22,7.780371234856063e-05,0.00026655412159310506,0.8148148148148148
5631,5631,자칫/Noun,27,22,5,0.000266755585195065,7.774495213132233e-05,0.8148148148148148
5632,5632,궁금/Noun,27,5,22,7.780371234856063e-05,0.00026655412159310506,0.8148148148148148
5633,5633,--;/Punctuation,27,5,22,7.780371234856063e-05,0.00026655412159310506,0.8148148148148148
5634,5634,자비/Noun,27,21,6,0.00025564076914527065,8.885137386436837e-05,0.7777777777777778
5635,5635,본받다/Verb,27,21,6,0.00025564076914527065,8.885137386436837e-05,0.7777777777777778
5636,5636,웨스턴/Noun,27,21,6,0.00025564076914527065,8.885137386436837e-05,0.7777777777777778
5637,5637,피라냐/Noun,27,6,21,8.891852839835501e-05,0.0002554476998600591,0.7777777777777778
5638,5638,비노/Noun,27,21,6,0.00025564076914527065,8.885137386436837e-05,0.7777777777777778
5639,5639,헌신/Noun,27,21,6,0.00025564076914527065,8.885137386436837e-05,0.7777777777777778
5640,5640,탐욕/Noun,27,21,6,0.00025564076914527065,8.885137386436837e-05,0.7777777777777778
5641,5641,슬슬/Noun,27,6,21,8.891852839835501e-05,0.0002554476998600591,0.7777777777777778
5642,5642,평화롭다/Adjective,27,21,6,0.00025564076914527065,8.885137386436837e-05,0.7777777777777778
5643,5643,숨쉬다/Verb,27,21,6,0.00025564076914527065,8.885137386436837e-05,0.7777777777777778
5644,5644,박유천/Noun,27,21,6,0.00025564076914527065,8.885137386436837e-05,0.7777777777777778
5645,5645,삘/Noun,27,6,21,8.891852839835501e-05,0.0002554476998600591,0.7777777777777778
5646,5646,과언/Noun,27,21,6,0.00025564076914527065,8.885137386436837e-05,0.7777777777777778
5647,5647,지껄이다/Verb,27,7,20,0.0001000333444481494,0.00024434127812701304,0.7407407407407407
5648,5648,좌/Noun,27,20,7,0.00024452595309547634,9.995779559741441e-05,0.7407407407407407
5649,5649,용하다/Adjective,27,7,20,0.0001000333444481494,0.00024434127812701304,0.7407407407407407
5650,5650,컬/Noun,27,20,7,0.00024452595309547634,9.995779559741441e-05,0.7407407407407407
5651,5651,침대/Noun,27,7,20,0.0001000333444481494,0.00024434127812701304,0.7407407407407407
5652,5652,조선족/Noun,27,7,20,0.0001000333444481494,0.00024434127812701304,0.7407407407407407
5653,5653,성장기/Noun,27,20,7,0.00024452595309547634,9.995779559741441e-05,0.7407407407407407
5654,5654,브로디/Noun,27,7,20,0.0001000333444481494,0.00024434127812701304,0.7407407407407407
5655,5655,치부/Noun,27,20,7,0.00024452595309547634,9.995779559741441e-05,0.7407407407407407
5656,5656,치우다/Verb,27,7,20,0.0001000333444481494,0.00024434127812701304,0.7407407407407407
5657,5657,사이트/Noun,27,7,20,0.0001000333444481494,0.00024434127812701304,0.7407407407407407
5658,5658,구입/Noun,27,20,7,0.00024452595309547634,9.995779559741441e-05,0.7407407407407407
5659,5659,자리/Suffix,27,7,20,0.0001000333444481494,0.00024434127812701304,0.7407407407407407
5660,5660,평타/Noun,27,7,20,0.0001000333444481494,0.00024434127812701304,0.7407407407407407
5661,5661,모니터/Noun,27,7,20,0.0001000333444481494,0.00024434127812701304,0.7407407407407407
5662,5662,일방/Noun,27,7,20,0.0001000333444481494,0.00024434127812701304,0.7407407407407407
5663,5663,가나다/Noun,27,7,20,0.0001000333444481494,0.00024434127812701304,0.7407407407407407
5664,5664,허준/Noun,27,20,7,0.00024452595309547634,9.995779559741441e-05,0.7407407407407407
5665,5665,레저/Noun,27,19,8,0.0002334111370456819,0.00011106421733046048,0.7037037037037037
5666,5666,패스/Noun,27,8,19,0.00011114816049794375,0.000233234856393967,0.7037037037037037
5667,5667,오싹하다/Adjective,27,19,8,0.0002334111370456819,0.00011106421733046048,0.7037037037037037
5668,5668,석/Noun,27,8,19,0.00011114816049794375,0.000233234856393967,0.7037037037037037
5669,5669,종종/Noun,27,19,8,0.0002334111370456819,0.00011106421733046048,0.7037037037037037
5670,5670,쌓다/Verb,27,8,19,0.00011114816049794375,0.000233234856393967,0.7037037037037037
5671,5671,모자라/Noun,27,8,19,0.00011114816049794375,0.000233234856393967,0.7037037037037037
5672,5672,기절/Noun,27,8,19,0.00011114816049794375,0.000233234856393967,0.7037037037037037
5673,5673,깔깔/Noun,27,18,9,0.0002222963209958875,0.00012217063906350652,0.6666666666666666
5674,5674,질린다/Verb,27,9,18,0.00012226297654773814,0.00022212843466092096,0.6666666666666666
5675,5675,팬티/Noun,27,9,18,0.00012226297654773814,0.00022212843466092096,0.6666666666666666
5676,5676,솜씨/Noun,27,18,9,0.0002222963209958875,0.00012217063906350652,0.6666666666666666
5677,5677,치닫다/Verb,27,9,18,0.00012226297654773814,0.00022212843466092096,0.6666666666666666
5678,5678,이브/Noun,27,18,9,0.0002222963209958875,0.00012217063906350652,0.6666666666666666
5679,5679,최강희/Noun,27,18,9,0.0002222963209958875,0.00012217063906350652,0.6666666666666666
5680,5680,고릴라/Noun,27,9,18,0.00012226297654773814,0.00022212843466092096,0.6666666666666666
5681,5681,꺄/Noun,27,18,9,0.0002222963209958875,0.00012217063906350652,0.6666666666666666
5682,5682,리치/Noun,27,18,9,0.0002222963209958875,0.00012217063906350652,0.6666666666666666
5683,5683,괜찬/Noun,27,18,9,0.0002222963209958875,0.00012217063906350652,0.6666666666666666
5684,5684,난생/Noun,27,9,18,0.00012226297654773814,0.00022212843466092096,0.6666666666666666
5685,5685,삼촌/Noun,27,9,18,0.00012226297654773814,0.00022212843466092096,0.6666666666666666
5686,5686,투쟁/Noun,27,18,9,0.0002222963209958875,0.00012217063906350652,0.6666666666666666
5687,5687,피어/Noun,27,18,9,0.0002222963209958875,0.00012217063906350652,0.6666666666666666
5688,5688,모드/Noun,27,10,17,0.0001333777925975325,0.0002110220129278749,0.6296296296296297
5689,5689,사가/Noun,27,17,10,0.00021118150494609317,0.00013327706079655256,0.6296296296296297
5690,5690,............../Punctuation,27,10,17,0.0001333777925975325,0.0002110220129278749,0.6296296296296297
5691,5691,아일랜드/Noun,27,17,10,0.00021118150494609317,0.00013327706079655256,0.6296296296296297
5692,5692,피어스/Noun,27,17,10,0.00021118150494609317,0.00013327706079655256,0.6296296296296297
5693,5693,자시다/Verb,27,10,17,0.0001333777925975325,0.0002110220129278749,0.6296296296296297
5694,5694,어쩐지/Noun,27,10,17,0.0001333777925975325,0.0002110220129278749,0.6296296296296297
5695,5695,차인표/Noun,27,10,17,0.0001333777925975325,0.0002110220129278749,0.6296296296296297
5696,5696,근육/Noun,27,17,10,0.00021118150494609317,0.00013327706079655256,0.6296296296296297
5697,5697,명절/Noun,27,16,11,0.0002000666888962988,0.0001443834825295986,0.5925925925925926
5698,5698,하나경/Noun,27,11,16,0.0001444926086473269,0.00019991559119482882,0.5925925925925926
5699,5699,미인/Noun,27,16,11,0.0002000666888962988,0.0001443834825295986,0.5925925925925926
5700,5700,준수/Noun,27,16,11,0.0002000666888962988,0.0001443834825295986,0.5925925925925926
5701,5701,머물다/Verb,27,16,11,0.0002000666888962988,0.0001443834825295986,0.5925925925925926
5702,5702,정유미/Noun,27,16,11,0.0002000666888962988,0.0001443834825295986,0.5925925925925926
5703,5703,투입/Noun,27,11,16,0.0001444926086473269,0.00019991559119482882,0.5925925925925926
5704,5704,지리/Noun,27,11,16,0.0001444926086473269,0.00019991559119482882,0.5925925925925926
5705,5705,킴/Noun,27,16,11,0.0002000666888962988,0.0001443834825295986,0.5925925925925926
5706,5706,유진/Noun,27,16,11,0.0002000666888962988,0.0001443834825295986,0.5925925925925926
5707,5707,해드리다/Verb,27,16,11,0.0002000666888962988,0.0001443834825295986,0.5925925925925926
5708,5708,오줌/Noun,27,11,16,0.0001444926086473269,0.00019991559119482882,0.5925925925925926
5709,5709,만행/Noun,27,16,11,0.0002000666888962988,0.0001443834825295986,0.5925925925925926
5710,5710,멘스/Noun,27,11,16,0.0001444926086473269,0.00019991559119482882,0.5925925925925926
5711,5711,블록/Noun,27,16,11,0.0002000666888962988,0.0001443834825295986,0.5925925925925926
5712,5712,만인/Noun,27,16,11,0.0002000666888962988,0.0001443834825295986,0.5925925925925926
5713,5713,그날/Noun,27,16,11,0.0002000666888962988,0.0001443834825295986,0.5925925925925926
5714,5714,초적/Noun,27,16,11,0.0002000666888962988,0.0001443834825295986,0.5925925925925926
5715,5715,25/Number,27,16,11,0.0002000666888962988,0.0001443834825295986,0.5925925925925926
5716,5716,기운/Noun,27,11,16,0.0001444926086473269,0.00019991559119482882,0.5925925925925926
5717,5717,고기/Noun,27,16,11,0.0002000666888962988,0.0001443834825295986,0.5925925925925926
5718,5718,윤리/Noun,27,15,12,0.00018895187284650438,0.00015548990426264466,0.5555555555555556
5719,5719,보수/Noun,27,12,15,0.00015560742469712126,0.0001888091694617828,0.5555555555555556
5720,5720,클래스/Noun,27,15,12,0.00018895187284650438,0.00015548990426264466,0.5555555555555556
5721,5721,이제껏/Noun,27,12,15,0.00015560742469712126,0.0001888091694617828,0.5555555555555556
5722,5722,조기/Noun,27,12,15,0.00015560742469712126,0.0001888091694617828,0.5555555555555556
5723,5723,이중/Noun,27,12,15,0.00015560742469712126,0.0001888091694617828,0.5555555555555556
5724,5724,쓰나미/Noun,27,15,12,0.00018895187284650438,0.00015548990426264466,0.5555555555555556
5725,5725,여진구/Noun,27,15,12,0.00018895187284650438,0.00015548990426264466,0.5555555555555556
5726,5726,최대한/Noun,27,12,15,0.00015560742469712126,0.0001888091694617828,0.5555555555555556
5727,5727,도나/Noun,27,15,12,0.00018895187284650438,0.00015548990426264466,0.5555555555555556
5728,5728,유역비/Noun,27,12,15,0.00015560742469712126,0.0001888091694617828,0.5555555555555556
5729,5729,나비/Noun,27,12,15,0.00015560742469712126,0.0001888091694617828,0.5555555555555556
5730,5730,마피아/Noun,27,12,15,0.00015560742469712126,0.0001888091694617828,0.5555555555555556
5731,5731,알리/Noun,27,12,15,0.00015560742469712126,0.0001888091694617828,0.5555555555555556
5732,5732,딱딱하다/Adjective,27,12,15,0.00015560742469712126,0.0001888091694617828,0.5555555555555556
5733,5733,추석/Noun,27,15,12,0.00018895187284650438,0.00015548990426264466,0.5555555555555556
5734,5734,로나/Noun,27,12,15,0.00015560742469712126,0.0001888091694617828,0.5555555555555556
5735,5735,황제/Noun,27,13,14,0.00016672224074691566,0.00017770274772873674,0.5185185185185185
5736,5736,이치/Noun,27,14,13,0.00017783705679671002,0.0001665963259956907,0.5185185185185185
5737,5737,안소니/Noun,27,14,13,0.00017783705679671002,0.0001665963259956907,0.5185185185185185
5738,5738,죠스/Noun,27,14,13,0.00017783705679671002,0.0001665963259956907,0.5185185185185185
5739,5739,1000/Number,27,14,13,0.00017783705679671002,0.0001665963259956907,0.5185185185185185
5740,5740,^^;;/Punctuation,27,14,13,0.00017783705679671002,0.0001665963259956907,0.5185185185185185
5741,5741,대기업/Noun,27,13,14,0.00016672224074691566,0.00017770274772873674,0.5185185185185185
5742,5742,적도/Noun,27,13,14,0.00016672224074691566,0.00017770274772873674,0.5185185185185185
5743,5743,비행/Noun,27,14,13,0.00017783705679671002,0.0001665963259956907,0.5185185185185185
5744,5744,카드/Noun,27,14,13,0.00017783705679671002,0.0001665963259956907,0.5185185185185185
5745,5745,모름/Noun,27,14,13,0.00017783705679671002,0.0001665963259956907,0.5185185185185185
5746,5746,하리/Noun,27,13,14,0.00016672224074691566,0.00017770274772873674,0.5185185185185185
5747,5747,재판/Noun,27,14,13,0.00017783705679671002,0.0001665963259956907,0.5185185185185185
5748,5748,드래곤/Noun,27,13,14,0.00016672224074691566,0.00017770274772873674,0.5185185185185185
5749,5749,제도/Noun,27,13,14,0.00016672224074691566,0.00017770274772873674,0.5185185185185185
5750,5750,이스라엘/Noun,27,13,14,0.00016672224074691566,0.00017770274772873674,0.5185185185185185
5751,5751,14/Number,27,14,13,0.00017783705679671002,0.0001665963259956907,0.5185185185185185
5752,5752,세력/Noun,27,13,14,0.00016672224074691566,0.00017770274772873674,0.5185185185185185
5753,5753,안드로메다/Noun,26,0,26,2.2229632099588756e-05,0.00031097980852528933,1.0
5754,5754,돌림/Noun,26,1,25,3.334444814938313e-05,0.0002998733867922433,0.9615384615384616
5755,5755,불우/Noun,26,1,25,3.334444814938313e-05,0.0002998733867922433,0.9615384615384616
5756,5756,녹이다/Verb,26,25,1,0.00030010003334444816,3.331926519913814e-05,0.9615384615384616
5757,5757,한시/Noun,26,25,1,0.00030010003334444816,3.331926519913814e-05,0.9615384615384616
5758,5758,무리하다/Adjective,26,1,25,3.334444814938313e-05,0.0002998733867922433,0.9615384615384616
5759,5759,맘대로/Adverb,26,2,24,4.445926419917751e-05,0.0002887669650591972,0.9230769230769232
5760,5760,싸가지/Noun,26,2,24,4.445926419917751e-05,0.0002887669650591972,0.9230769230769232
5761,5761,니미/Noun,26,2,24,4.445926419917751e-05,0.0002887669650591972,0.9230769230769232
5762,5762,!!!!!!!!!/Punctuation,26,23,3,0.00027787040124485944,5.553210866523024e-05,0.8846153846153846
5763,5763,해학/Noun,26,23,3,0.00027787040124485944,5.553210866523024e-05,0.8846153846153846
5764,5764,정신병원/Noun,26,3,23,5.5574080248971876e-05,0.00027766054332615115,0.8846153846153846
5765,5765,괴상하다/Adjective,26,4,22,6.668889629876625e-05,0.00026655412159310506,0.8461538461538461
5766,5766,。/Foreign,26,22,4,0.000266755585195065,6.663853039827628e-05,0.8461538461538461
5767,5767,저건/Noun,26,4,22,6.668889629876625e-05,0.00026655412159310506,0.8461538461538461
5768,5768,사랑받다/Verb,26,22,4,0.000266755585195065,6.663853039827628e-05,0.8461538461538461
5769,5769,비용/Noun,26,4,22,6.668889629876625e-05,0.00026655412159310506,0.8461538461538461
5770,5770,침략/Noun,26,4,22,6.668889629876625e-05,0.00026655412159310506,0.8461538461538461
5771,5771,매년/Noun,26,22,4,0.000266755585195065,6.663853039827628e-05,0.8461538461538461
5772,5772,하루하루/Noun,26,22,4,0.000266755585195065,6.663853039827628e-05,0.8461538461538461
5773,5773,걸왜/Noun,26,4,22,6.668889629876625e-05,0.00026655412159310506,0.8461538461538461
5774,5774,절용/Noun,26,4,22,6.668889629876625e-05,0.00026655412159310506,0.8461538461538461
5775,5775,9년/Number,26,22,4,0.000266755585195065,6.663853039827628e-05,0.8461538461538461
5776,5776,장진영/Noun,26,21,5,0.00025564076914527065,7.774495213132233e-05,0.8076923076923077
5777,5777,드라마틱하다/Adjective,26,21,5,0.00025564076914527065,7.774495213132233e-05,0.8076923076923077
5778,5778,쯧/Adverb,26,5,21,7.780371234856063e-05,0.0002554476998600591,0.8076923076923077
5779,5779,류덕환/Noun,26,21,5,0.00025564076914527065,7.774495213132233e-05,0.8076923076923077
5780,5780,징징대다/Adjective,26,5,21,7.780371234856063e-05,0.0002554476998600591,0.8076923076923077
5781,5781,만원/Noun,26,5,21,7.780371234856063e-05,0.0002554476998600591,0.8076923076923077
5782,5782,나열하다/Adjective,26,5,21,7.780371234856063e-05,0.0002554476998600591,0.8076923076923077
5783,5783,피터팬/Noun,26,21,5,0.00025564076914527065,7.774495213132233e-05,0.8076923076923077
5784,5784,답습/Noun,26,5,21,7.780371234856063e-05,0.0002554476998600591,0.8076923076923077
5785,5785,싸이/Noun,26,6,20,8.891852839835501e-05,0.00024434127812701304,0.7692307692307693
5786,5786,코너/Noun,26,6,20,8.891852839835501e-05,0.00024434127812701304,0.7692307692307693
5787,5787,50분/Number,26,6,20,8.891852839835501e-05,0.00024434127812701304,0.7692307692307693
5788,5788,편지/Noun,26,20,6,0.00024452595309547634,8.885137386436837e-05,0.7692307692307693
5789,5789,봉준호/Noun,26,20,6,0.00024452595309547634,8.885137386436837e-05,0.7692307692307693
5790,5790,퇴보하다/Adjective,26,6,20,8.891852839835501e-05,0.00024434127812701304,0.7692307692307693
5791,5791,z/Alpha,26,6,20,8.891852839835501e-05,0.00024434127812701304,0.7692307692307693
5792,5792,한잔/Noun,26,20,6,0.00024452595309547634,8.885137386436837e-05,0.7692307692307693
5793,5793,쌤/Noun,26,20,6,0.00024452595309547634,8.885137386436837e-05,0.7692307692307693
5794,5794,살해/Noun,26,6,20,8.891852839835501e-05,0.00024434127812701304,0.7692307692307693
5795,5795,하든/Noun,26,6,20,8.891852839835501e-05,0.00024434127812701304,0.7692307692307693
5796,5796,주어/Noun,26,20,6,0.00024452595309547634,8.885137386436837e-05,0.7692307692307693
5797,5797,흐흐/Noun,26,19,7,0.0002334111370456819,9.995779559741441e-05,0.7307692307692307
5798,5798,진도/Noun,26,7,19,0.0001000333444481494,0.000233234856393967,0.7307692307692307
5799,5799,ㅈㄹ/KoreanParticle,26,7,19,0.0001000333444481494,0.000233234856393967,0.7307692307692307
5800,5800,메릴/Noun,26,19,7,0.0002334111370456819,9.995779559741441e-05,0.7307692307692307
5801,5801,주제곡/Noun,26,19,7,0.0002334111370456819,9.995779559741441e-05,0.7307692307692307
5802,5802,심심/Noun,26,7,19,0.0001000333444481494,0.000233234856393967,0.7307692307692307
5803,5803,선입견/Noun,26,19,7,0.0002334111370456819,9.995779559741441e-05,0.7307692307692307
5804,5804,형태/Noun,26,19,7,0.0002334111370456819,9.995779559741441e-05,0.7307692307692307
5805,5805,한수/Noun,26,19,7,0.0002334111370456819,9.995779559741441e-05,0.7307692307692307
5806,5806,재벌/Noun,26,7,19,0.0001000333444481494,0.000233234856393967,0.7307692307692307
5807,5807,부영/Noun,26,18,8,0.0002222963209958875,0.00011106421733046048,0.6923076923076923
5808,5808,.............../Punctuation,26,8,18,0.00011114816049794375,0.00022212843466092096,0.6923076923076923
5809,5809,닌자/Noun,26,8,18,0.00011114816049794375,0.00022212843466092096,0.6923076923076923
5810,5810,얕다/Adjective,26,8,18,0.00011114816049794375,0.00022212843466092096,0.6923076923076923
5811,5811,1.2/Number,26,18,8,0.0002222963209958875,0.00011106421733046048,0.6923076923076923
5812,5812,잘리다/Verb,26,8,18,0.00011114816049794375,0.00022212843466092096,0.6923076923076923
5813,5813,기네/Noun,26,8,18,0.00011114816049794375,0.00022212843466092096,0.6923076923076923
5814,5814,맞서다/Verb,26,18,8,0.0002222963209958875,0.00011106421733046048,0.6923076923076923
5815,5815,나뉘다/Verb,26,17,9,0.00021118150494609317,0.00012217063906350652,0.6538461538461539
5816,5816,키스신/Noun,26,17,9,0.00021118150494609317,0.00012217063906350652,0.6538461538461539
5817,5817,반지의제왕/Noun,26,17,9,0.00021118150494609317,0.00012217063906350652,0.6538461538461539
5818,5818,올인/Noun,26,17,9,0.00021118150494609317,0.00012217063906350652,0.6538461538461539
5819,5819,so/Alpha,26,17,9,0.00021118150494609317,0.00012217063906350652,0.6538461538461539
5820,5820,회의/Noun,26,9,17,0.00012226297654773814,0.0002110220129278749,0.6538461538461539
5821,5821,어요/Noun,26,17,9,0.00021118150494609317,0.00012217063906350652,0.6538461538461539
5822,5822,시간여행/Noun,26,17,9,0.00021118150494609317,0.00012217063906350652,0.6538461538461539
5823,5823,김래원/Noun,26,17,9,0.00021118150494609317,0.00012217063906350652,0.6538461538461539
5824,5824,원한/Noun,26,9,17,0.00012226297654773814,0.0002110220129278749,0.6538461538461539
5825,5825,해리/Noun,26,17,9,0.00021118150494609317,0.00012217063906350652,0.6538461538461539
5826,5826,수지/Noun,26,17,9,0.00021118150494609317,0.00012217063906350652,0.6538461538461539
5827,5827,여고생/Noun,26,10,16,0.0001333777925975325,0.00019991559119482882,0.6153846153846154
5828,5828,디아즈/Noun,26,10,16,0.0001333777925975325,0.00019991559119482882,0.6153846153846154
5829,5829,순정/Noun,26,16,10,0.0002000666888962988,0.00013327706079655256,0.6153846153846154
5830,5830,위선/Noun,26,10,16,0.0001333777925975325,0.00019991559119482882,0.6153846153846154
5831,5831,no/Alpha,26,10,16,0.0001333777925975325,0.00019991559119482882,0.6153846153846154
5832,5832,98년/Number,26,16,10,0.0002000666888962988,0.00013327706079655256,0.6153846153846154
5833,5833,맛보다/Verb,26,16,10,0.0002000666888962988,0.00013327706079655256,0.6153846153846154
5834,5834,유이/Noun,26,16,10,0.0002000666888962988,0.00013327706079655256,0.6153846153846154
5835,5835,앨리스/Noun,26,16,10,0.0002000666888962988,0.00013327706079655256,0.6153846153846154
5836,5836,씻다/Verb,26,10,16,0.0001333777925975325,0.00019991559119482882,0.6153846153846154
5837,5837,이뿌다/Adjective,26,16,10,0.0002000666888962988,0.00013327706079655256,0.6153846153846154
5838,5838,질감/Noun,26,10,16,0.0001333777925975325,0.00019991559119482882,0.6153846153846154
5839,5839,잉여/Noun,26,10,16,0.0001333777925975325,0.00019991559119482882,0.6153846153846154
5840,5840,돕다/Verb,26,10,16,0.0001333777925975325,0.00019991559119482882,0.6153846153846154
5841,5841,알고싶다/Noun,26,10,16,0.0001333777925975325,0.00019991559119482882,0.6153846153846154
5842,5842,추적/Noun,26,10,16,0.0001333777925975325,0.00019991559119482882,0.6153846153846154
5843,5843,블루레이/Noun,26,16,10,0.0002000666888962988,0.00013327706079655256,0.6153846153846154
5844,5844,부각/Noun,26,10,16,0.0001333777925975325,0.00019991559119482882,0.6153846153846154
5845,5845,이요원/Noun,26,10,16,0.0001333777925975325,0.00019991559119482882,0.6153846153846154
5846,5846,서사/Noun,26,11,15,0.0001444926086473269,0.0001888091694617828,0.5769230769230769
5847,5847,일일/Noun,26,11,15,0.0001444926086473269,0.0001888091694617828,0.5769230769230769
5848,5848,닥치다/Verb,26,11,15,0.0001444926086473269,0.0001888091694617828,0.5769230769230769
5849,5849,도도/Noun,26,11,15,0.0001444926086473269,0.0001888091694617828,0.5769230769230769
5850,5850,스칼렛/Noun,26,15,11,0.00018895187284650438,0.0001443834825295986,0.5769230769230769
5851,5851,변/Noun,26,15,11,0.00018895187284650438,0.0001443834825295986,0.5769230769230769
5852,5852,와이어/Noun,26,11,15,0.0001444926086473269,0.0001888091694617828,0.5769230769230769
5853,5853,2007년/Number,26,15,11,0.00018895187284650438,0.0001443834825295986,0.5769230769230769
5854,5854,왤다/Verb,26,11,15,0.0001444926086473269,0.0001888091694617828,0.5769230769230769
5855,5855,증오/Noun,26,15,11,0.00018895187284650438,0.0001443834825295986,0.5769230769230769
5856,5856,스틱/Noun,26,11,15,0.0001444926086473269,0.0001888091694617828,0.5769230769230769
5857,5857,신지/Noun,26,11,15,0.0001444926086473269,0.0001888091694617828,0.5769230769230769
5858,5858,미사일/Noun,26,11,15,0.0001444926086473269,0.0001888091694617828,0.5769230769230769
5859,5859,상업성/Noun,26,11,15,0.0001444926086473269,0.0001888091694617828,0.5769230769230769
5860,5860,암시/Noun,26,11,15,0.0001444926086473269,0.0001888091694617828,0.5769230769230769
5861,5861,웨이/Noun,26,15,11,0.00018895187284650438,0.0001443834825295986,0.5769230769230769
5862,5862,다듬다/Verb,26,11,15,0.0001444926086473269,0.0001888091694617828,0.5769230769230769
5863,5863,에디/Noun,26,11,15,0.0001444926086473269,0.0001888091694617828,0.5769230769230769
5864,5864,클럽/Noun,26,15,11,0.00018895187284650438,0.0001443834825295986,0.5769230769230769
5865,5865,기원/Noun,26,14,12,0.00017783705679671002,0.00015548990426264466,0.5384615384615384
5866,5866,2014/Number,26,14,12,0.00017783705679671002,0.00015548990426264466,0.5384615384615384
5867,5867,블레이드/Noun,26,12,14,0.00015560742469712126,0.00017770274772873674,0.5384615384615384
5868,5868,데스노트/Noun,26,12,14,0.00015560742469712126,0.00017770274772873674,0.5384615384615384
5869,5869,정돈/Noun,26,14,12,0.00017783705679671002,0.00015548990426264466,0.5384615384615384
5870,5870,대세/Noun,26,14,12,0.00017783705679671002,0.00015548990426264466,0.5384615384615384
5871,5871,개봉관/Noun,26,12,14,0.00015560742469712126,0.00017770274772873674,0.5384615384615384
5872,5872,안녕하다/Adjective,26,14,12,0.00017783705679671002,0.00015548990426264466,0.5384615384615384
5873,5873,인성/Noun,26,12,14,0.00015560742469712126,0.00017770274772873674,0.5384615384615384
5874,5874,터뜨리다/Verb,26,14,12,0.00017783705679671002,0.00015548990426264466,0.5384615384615384
5875,5875,고래/Noun,26,12,14,0.00015560742469712126,0.00017770274772873674,0.5384615384615384
5876,5876,비꼬다/Verb,26,14,12,0.00017783705679671002,0.00015548990426264466,0.5384615384615384
5877,5877,힘겹다/Adjective,26,12,14,0.00015560742469712126,0.00017770274772873674,0.5384615384615384
5878,5878,깃/Noun,26,14,12,0.00017783705679671002,0.00015548990426264466,0.5384615384615384
5879,5879,엥/Exclamation,26,12,14,0.00015560742469712126,0.00017770274772873674,0.5384615384615384
5880,5880,피부/Noun,26,13,13,0.00016672224074691566,0.0001665963259956907,0.5
5881,5881,생일/Noun,26,13,13,0.00016672224074691566,0.0001665963259956907,0.5
5882,5882,명예/Noun,26,13,13,0.00016672224074691566,0.0001665963259956907,0.5
5883,5883,사막/Noun,26,13,13,0.00016672224074691566,0.0001665963259956907,0.5
5884,5884,고고/Noun,26,13,13,0.00016672224074691566,0.0001665963259956907,0.5
5885,5885,굿바이/Noun,26,13,13,0.00016672224074691566,0.0001665963259956907,0.5
5886,5886,성동일/Noun,26,13,13,0.00016672224074691566,0.0001665963259956907,0.5
5887,5887,것임/Noun,26,13,13,0.00016672224074691566,0.0001665963259956907,0.5
5888,5888,죄책감/Noun,26,13,13,0.00016672224074691566,0.0001665963259956907,0.5
5889,5889,엮/Noun,26,13,13,0.00016672224074691566,0.0001665963259956907,0.5
5890,5890,Bad/Alpha,25,1,24,3.334444814938313e-05,0.0002887669650591972,0.96
5891,5891,꾸밈/Noun,25,24,1,0.0002889852172946538,3.331926519913814e-05,0.96
5892,5892,쏠쏠하다/Adjective,25,24,1,0.0002889852172946538,3.331926519913814e-05,0.96
5893,5893,기부/Noun,25,1,24,3.334444814938313e-05,0.0002887669650591972,0.96
5894,5894,ㅅㄱ/KoreanParticle,25,2,23,4.445926419917751e-05,0.00027766054332615115,0.92
5895,5895,인피니트/Noun,25,23,2,0.00027787040124485944,4.4425686932184186e-05,0.92
5896,5896,부실/Noun,25,2,23,4.445926419917751e-05,0.00027766054332615115,0.92
5897,5897,오래오래/Noun,25,23,2,0.00027787040124485944,4.4425686932184186e-05,0.92
5898,5898,탄탄/Noun,25,23,2,0.00027787040124485944,4.4425686932184186e-05,0.92
5899,5899,조잡/Noun,25,2,23,4.445926419917751e-05,0.00027766054332615115,0.92
5900,5900,지망/Noun,25,3,22,5.5574080248971876e-05,0.00026655412159310506,0.88
5901,5901,예상외/Noun,25,22,3,0.000266755585195065,5.553210866523024e-05,0.88
5902,5902,클릭/Noun,25,3,22,5.5574080248971876e-05,0.00026655412159310506,0.88
5903,5903,?./Punctuation,25,3,22,5.5574080248971876e-05,0.00026655412159310506,0.88
5904,5904,같잖다/Adjective,25,3,22,5.5574080248971876e-05,0.00026655412159310506,0.88
5905,5905,ㅡㅡㅋ/KoreanParticle,25,4,21,6.668889629876625e-05,0.0002554476998600591,0.84
5906,5906,윽/Noun,25,4,21,6.668889629876625e-05,0.0002554476998600591,0.84
5907,5907,훌륭/Noun,25,21,4,0.00025564076914527065,6.663853039827628e-05,0.84
5908,5908,엠씨/Noun,25,4,21,6.668889629876625e-05,0.0002554476998600591,0.84
5909,5909,쿠바/Noun,25,21,4,0.00025564076914527065,6.663853039827628e-05,0.84
5910,5910,축복/Noun,25,21,4,0.00025564076914527065,6.663853039827628e-05,0.84
5911,5911,온건/Noun,25,4,21,6.668889629876625e-05,0.0002554476998600591,0.84
5912,5912,4000원/Number,25,4,21,6.668889629876625e-05,0.0002554476998600591,0.84
5913,5913,붕/Noun,25,4,21,6.668889629876625e-05,0.0002554476998600591,0.84
5914,5914,...-_-/Punctuation,25,5,20,7.780371234856063e-05,0.00024434127812701304,0.8
5915,5915,양산/Noun,25,5,20,7.780371234856063e-05,0.00024434127812701304,0.8
5916,5916,슬로우/Noun,25,5,20,7.780371234856063e-05,0.00024434127812701304,0.8
5917,5917,바램/Noun,25,20,5,0.00024452595309547634,7.774495213132233e-05,0.8
5918,5918,쩔어요/Noun,25,20,5,0.00024452595309547634,7.774495213132233e-05,0.8
5919,5919,썅/Noun,25,5,20,7.780371234856063e-05,0.00024434127812701304,0.8
5920,5920,-_/Punctuation,25,5,20,7.780371234856063e-05,0.00024434127812701304,0.8
5921,5921,아이디/Noun,25,5,20,7.780371234856063e-05,0.00024434127812701304,0.8
5922,5922,따오다/Verb,25,5,20,7.780371234856063e-05,0.00024434127812701304,0.8
5923,5923,97년/Number,25,20,5,0.00024452595309547634,7.774495213132233e-05,0.8
5924,5924,소방관/Noun,25,20,5,0.00024452595309547634,7.774495213132233e-05,0.8
5925,5925,붕괴/Noun,25,5,20,7.780371234856063e-05,0.00024434127812701304,0.8
5926,5926,멸망/Noun,25,6,19,8.891852839835501e-05,0.000233234856393967,0.76
5927,5927,된장녀/Noun,25,6,19,8.891852839835501e-05,0.000233234856393967,0.76
5928,5928,진가/Noun,25,19,6,0.0002334111370456819,8.885137386436837e-05,0.76
5929,5929,고갈/Noun,25,6,19,8.891852839835501e-05,0.000233234856393967,0.76
5930,5930,브금/Noun,25,19,6,0.0002334111370456819,8.885137386436837e-05,0.76
5931,5931,서양인/Noun,25,6,19,8.891852839835501e-05,0.000233234856393967,0.76
5932,5932,요란하다/Adjective,25,6,19,8.891852839835501e-05,0.000233234856393967,0.76
5933,5933,억압/Noun,25,19,6,0.0002334111370456819,8.885137386436837e-05,0.76
5934,5934,김승우/Noun,25,6,19,8.891852839835501e-05,0.000233234856393967,0.76
5935,5935,1980년/Number,25,6,19,8.891852839835501e-05,0.000233234856393967,0.76
5936,5936,자전거/Noun,25,19,6,0.0002334111370456819,8.885137386436837e-05,0.76
5937,5937,껍데기/Noun,25,7,18,0.0001000333444481494,0.00022212843466092096,0.72
5938,5938,정상인/Noun,25,7,18,0.0001000333444481494,0.00022212843466092096,0.72
5939,5939,멘트/Noun,25,7,18,0.0001000333444481494,0.00022212843466092096,0.72
5940,5940,k/Alpha,25,7,18,0.0001000333444481494,0.00022212843466092096,0.72
5941,5941,분투/Noun,25,7,18,0.0001000333444481494,0.00022212843466092096,0.72
5942,5942,첩보물/Noun,25,18,7,0.0002222963209958875,9.995779559741441e-05,0.72
5943,5943,건달/Noun,25,7,18,0.0001000333444481494,0.00022212843466092096,0.72
5944,5944,윤발/Noun,25,7,18,0.0001000333444481494,0.00022212843466092096,0.72
5945,5945,제국주의/Noun,25,7,18,0.0001000333444481494,0.00022212843466092096,0.72
5946,5946,바사/Noun,25,7,18,0.0001000333444481494,0.00022212843466092096,0.72
5947,5947,애국/Noun,25,7,18,0.0001000333444481494,0.00022212843466092096,0.72
5948,5948,집합/Noun,25,8,17,0.00011114816049794375,0.0002110220129278749,0.68
5949,5949,삼국지/Noun,25,8,17,0.00011114816049794375,0.0002110220129278749,0.68
5950,5950,별개/Noun,25,8,17,0.00011114816049794375,0.0002110220129278749,0.68
5951,5951,분류/Noun,25,8,17,0.00011114816049794375,0.0002110220129278749,0.68
5952,5952,마셈/Noun,25,8,17,0.00011114816049794375,0.0002110220129278749,0.68
5953,5953,단말/Noun,25,8,17,0.00011114816049794375,0.0002110220129278749,0.68
5954,5954,러브레터/Noun,25,17,8,0.00021118150494609317,0.00011106421733046048,0.68
5955,5955,헌/Modifier,25,17,8,0.00021118150494609317,0.00011106421733046048,0.68
5956,5956,중견/Noun,25,8,17,0.00011114816049794375,0.0002110220129278749,0.68
5957,5957,박스/Noun,25,8,17,0.00011114816049794375,0.0002110220129278749,0.68
5958,5958,구지/Noun,25,8,17,0.00011114816049794375,0.0002110220129278749,0.68
5959,5959,No/Alpha,25,8,17,0.00011114816049794375,0.0002110220129278749,0.68
5960,5960,프리드/Noun,25,17,8,0.00021118150494609317,0.00011106421733046048,0.68
5961,5961,베를린/Noun,25,17,8,0.00021118150494609317,0.00011106421733046048,0.68
5962,5962,내지/Noun,25,8,17,0.00011114816049794375,0.0002110220129278749,0.68
5963,5963,제적/Noun,25,8,17,0.00011114816049794375,0.0002110220129278749,0.68
5964,5964,본드/Noun,25,17,8,0.00021118150494609317,0.00011106421733046048,0.68
5965,5965,알렉스/Noun,25,17,8,0.00021118150494609317,0.00011106421733046048,0.68
5966,5966,친일/Noun,25,8,17,0.00011114816049794375,0.0002110220129278749,0.68
5967,5967,귀하다/Adjective,25,17,8,0.00021118150494609317,0.00011106421733046048,0.68
5968,5968,고루/Noun,25,8,17,0.00011114816049794375,0.0002110220129278749,0.68
5969,5969,회복/Noun,25,17,8,0.00021118150494609317,0.00011106421733046048,0.68
5970,5970,좌빨/Noun,25,9,16,0.00012226297654773814,0.00019991559119482882,0.64
5971,5971,인위/Noun,25,9,16,0.00012226297654773814,0.00019991559119482882,0.64
5972,5972,스토/Noun,25,9,16,0.00012226297654773814,0.00019991559119482882,0.64
5973,5973,건조하다/Adjective,25,16,9,0.0002000666888962988,0.00012217063906350652,0.64
5974,5974,벌레/Noun,25,9,16,0.00012226297654773814,0.00019991559119482882,0.64
5975,5975,중요성/Noun,25,16,9,0.0002000666888962988,0.00012217063906350652,0.64
5976,5976,...!!!/Punctuation,25,16,9,0.0002000666888962988,0.00012217063906350652,0.64
5977,5977,에게만/Josa,25,9,16,0.00012226297654773814,0.00019991559119482882,0.64
5978,5978,당대/Noun,25,16,9,0.0002000666888962988,0.00012217063906350652,0.64
5979,5979,인칭/Noun,25,9,16,0.00012226297654773814,0.00019991559119482882,0.64
5980,5980,내버리다/Verb,25,9,16,0.00012226297654773814,0.00019991559119482882,0.64
5981,5981,폭소/Noun,25,9,16,0.00012226297654773814,0.00019991559119482882,0.64
5982,5982,대구/Noun,25,16,9,0.0002000666888962988,0.00012217063906350652,0.64
5983,5983,괴기/Noun,25,9,16,0.00012226297654773814,0.00019991559119482882,0.64
5984,5984,이어서/Adverb,25,16,9,0.0002000666888962988,0.00012217063906350652,0.64
5985,5985,사나/Noun,25,16,9,0.0002000666888962988,0.00012217063906350652,0.64
5986,5986,마력/Noun,25,16,9,0.0002000666888962988,0.00012217063906350652,0.64
5987,5987,인정받다/Verb,25,9,16,0.00012226297654773814,0.00019991559119482882,0.64
5988,5988,퍼지다/Verb,25,16,9,0.0002000666888962988,0.00012217063906350652,0.64
5989,5989,2%/Number,25,16,9,0.0002000666888962988,0.00012217063906350652,0.64
5990,5990,방사/Noun,25,9,16,0.00012226297654773814,0.00019991559119482882,0.64
5991,5991,세월호/Noun,25,16,9,0.0002000666888962988,0.00012217063906350652,0.64
5992,5992,타락하다/Adjective,25,15,10,0.00018895187284650438,0.00013327706079655256,0.6
5993,5993,토비/Noun,25,15,10,0.00018895187284650438,0.00013327706079655256,0.6
5994,5994,통속/Noun,25,10,15,0.0001333777925975325,0.0001888091694617828,0.6
5995,5995,펜/Noun,25,10,15,0.0001333777925975325,0.0001888091694617828,0.6
5996,5996,이정진/Noun,25,10,15,0.0001333777925975325,0.0001888091694617828,0.6
5997,5997,요원/Noun,25,15,10,0.00018895187284650438,0.00013327706079655256,0.6
5998,5998,장백지/Noun,25,10,15,0.0001333777925975325,0.0001888091694617828,0.6
5999,5999,스틸/Noun,25,10,15,0.0001333777925975325,0.0001888091694617828,0.6
6000,6000,덧/Noun,25,15,10,0.00018895187284650438,0.00013327706079655256,0.6
6001,6001,마동석/Noun,25,10,15,0.0001333777925975325,0.0001888091694617828,0.6
6002,6002,해주/Noun,25,15,10,0.00018895187284650438,0.00013327706079655256,0.6
6003,6003,조건/Noun,25,15,10,0.00018895187284650438,0.00013327706079655256,0.6
6004,6004,얹다/Verb,25,10,15,0.0001333777925975325,0.0001888091694617828,0.6
6005,6005,오가다/Verb,25,15,10,0.00018895187284650438,0.00013327706079655256,0.6
6006,6006,가가/Noun,25,15,10,0.00018895187284650438,0.00013327706079655256,0.6
6007,6007,이준/Noun,25,15,10,0.00018895187284650438,0.00013327706079655256,0.6
6008,6008,파이/Noun,25,11,14,0.0001444926086473269,0.00017770274772873674,0.56
6009,6009,찔리다/Verb,25,11,14,0.0001444926086473269,0.00017770274772873674,0.56
6010,6010,유튜브/Noun,25,11,14,0.0001444926086473269,0.00017770274772873674,0.56
6011,6011,여태껏/Noun,25,14,11,0.00017783705679671002,0.0001443834825295986,0.56
6012,6012,일기/Noun,25,11,14,0.0001444926086473269,0.00017770274772873674,0.56
6013,6013,탁/Noun,25,14,11,0.00017783705679671002,0.0001443834825295986,0.56
6014,6014,사정/Noun,25,11,14,0.0001444926086473269,0.00017770274772873674,0.56
6015,6015,띠/Noun,25,11,14,0.0001444926086473269,0.00017770274772873674,0.56
6016,6016,불교/Noun,25,14,11,0.00017783705679671002,0.0001443834825295986,0.56
6017,6017,타짜/Noun,25,14,11,0.00017783705679671002,0.0001443834825295986,0.56
6018,6018,위안부/Noun,25,11,14,0.0001444926086473269,0.00017770274772873674,0.56
6019,6019,종말/Noun,25,11,14,0.0001444926086473269,0.00017770274772873674,0.56
6020,6020,소가/Noun,25,11,14,0.0001444926086473269,0.00017770274772873674,0.56
6021,6021,톱스타/Noun,25,14,11,0.00017783705679671002,0.0001443834825295986,0.56
6022,6022,베트남/Noun,25,11,14,0.0001444926086473269,0.00017770274772873674,0.56
6023,6023,내/Modifier,25,11,14,0.0001444926086473269,0.00017770274772873674,0.56
6024,6024,놀/Noun,25,11,14,0.0001444926086473269,0.00017770274772873674,0.56
6025,6025,주변인/Noun,25,11,14,0.0001444926086473269,0.00017770274772873674,0.56
6026,6026,권총/Noun,25,11,14,0.0001444926086473269,0.00017770274772873674,0.56
6027,6027,에어/Noun,25,14,11,0.00017783705679671002,0.0001443834825295986,0.56
6028,6028,스무/Modifier,25,14,11,0.00017783705679671002,0.0001443834825295986,0.56
6029,6029,영화평론가/Noun,25,14,11,0.00017783705679671002,0.0001443834825295986,0.56
6030,6030,종북/Noun,25,11,14,0.0001444926086473269,0.00017770274772873674,0.56
6031,6031,브래드/Noun,25,14,11,0.00017783705679671002,0.0001443834825295986,0.56
6032,6032,동성애자/Noun,25,11,14,0.0001444926086473269,0.00017770274772873674,0.56
6033,6033,징악/Noun,25,11,14,0.0001444926086473269,0.00017770274772873674,0.56
6034,6034,신랑/Noun,25,12,13,0.00015560742469712126,0.0001665963259956907,0.52
6035,6035,까지나/Josa,25,12,13,0.00015560742469712126,0.0001665963259956907,0.52
6036,6036,진지/Noun,25,12,13,0.00015560742469712126,0.0001665963259956907,0.52
6037,6037,어리석다/Adjective,25,12,13,0.00015560742469712126,0.0001665963259956907,0.52
6038,6038,댐/Noun,25,12,13,0.00015560742469712126,0.0001665963259956907,0.52
6039,6039,컨데/Noun,25,12,13,0.00015560742469712126,0.0001665963259956907,0.52
6040,6040,1990년/Number,25,13,12,0.00016672224074691566,0.00015548990426264466,0.52
6041,6041,특급/Noun,25,13,12,0.00016672224074691566,0.00015548990426264466,0.52
6042,6042,마이크/Noun,25,12,13,0.00015560742469712126,0.0001665963259956907,0.52
6043,6043,슈/Noun,25,13,12,0.00016672224074691566,0.00015548990426264466,0.52
6044,6044,손잡다/Verb,25,13,12,0.00016672224074691566,0.00015548990426264466,0.52
6045,6045,제자/Noun,25,13,12,0.00016672224074691566,0.00015548990426264466,0.52
6046,6046,마술/Noun,25,12,13,0.00015560742469712126,0.0001665963259956907,0.52
6047,6047,일어나서/Noun,25,12,13,0.00015560742469712126,0.0001665963259956907,0.52
6048,6048,물고기/Noun,25,12,13,0.00015560742469712126,0.0001665963259956907,0.52
6049,6049,♡♡♡/Foreign,24,24,0,0.0002889852172946538,2.2212843466092093e-05,1.0
6050,6050,乃/Foreign,24,24,0,0.0002889852172946538,2.2212843466092093e-05,1.0
6051,6051,낚였어/Noun,24,0,24,2.2229632099588756e-05,0.0002887669650591972,1.0
6052,6052,관광/Noun,24,0,24,2.2229632099588756e-05,0.0002887669650591972,1.0
6053,6053,조치/Noun,24,1,23,3.334444814938313e-05,0.00027766054332615115,0.9583333333333334
6054,6054,맥빠지다/Adjective,24,1,23,3.334444814938313e-05,0.00027766054332615115,0.9583333333333334
6055,6055,빠르기/Noun,24,1,23,3.334444814938313e-05,0.00027766054332615115,0.9583333333333334
6056,6056,학예회/Noun,24,1,23,3.334444814938313e-05,0.00027766054332615115,0.9583333333333334
6057,6057,오그/Noun,24,1,23,3.334444814938313e-05,0.00027766054332615115,0.9583333333333334
6058,6058,반점/Noun,24,2,22,4.445926419917751e-05,0.00026655412159310506,0.9166666666666666
6059,6059,심금/Noun,24,22,2,0.000266755585195065,4.4425686932184186e-05,0.9166666666666666
6060,6060,닭살/Noun,24,2,22,4.445926419917751e-05,0.00026655412159310506,0.9166666666666666
6061,6061,전범/Noun,24,2,22,4.445926419917751e-05,0.00026655412159310506,0.9166666666666666
6062,6062,상쾌하다/Adjective,24,22,2,0.000266755585195065,4.4425686932184186e-05,0.9166666666666666
6063,6063,날카롭다/Adjective,24,22,2,0.000266755585195065,4.4425686932184186e-05,0.9166666666666666
6064,6064,소외/Noun,24,22,2,0.000266755585195065,4.4425686932184186e-05,0.9166666666666666
6065,6065,수면/Noun,24,2,22,4.445926419917751e-05,0.00026655412159310506,0.9166666666666666
6066,6066,방어율/Noun,24,2,22,4.445926419917751e-05,0.00026655412159310506,0.9166666666666666
6067,6067,구지성/Noun,24,2,22,4.445926419917751e-05,0.00026655412159310506,0.9166666666666666
6068,6068,뿐더러/Noun,24,3,21,5.5574080248971876e-05,0.0002554476998600591,0.875
6069,6069,거참/Noun,24,3,21,5.5574080248971876e-05,0.0002554476998600591,0.875
6070,6070,오래도록/Adverb,24,21,3,0.00025564076914527065,5.553210866523024e-05,0.875
6071,6071,캡틴/Noun,24,21,3,0.00025564076914527065,5.553210866523024e-05,0.875
6072,6072,어렷을때/Noun,24,21,3,0.00025564076914527065,5.553210866523024e-05,0.875
6073,6073,와나/Noun,24,4,20,6.668889629876625e-05,0.00024434127812701304,0.8333333333333334
6074,6074,대륙/Noun,24,4,20,6.668889629876625e-05,0.00024434127812701304,0.8333333333333334
6075,6075,브라질/Noun,24,20,4,0.00024452595309547634,6.663853039827628e-05,0.8333333333333334
6076,6076,실적/Noun,24,20,4,0.00024452595309547634,6.663853039827628e-05,0.8333333333333334
6077,6077,죽겠네/Noun,24,4,20,6.668889629876625e-05,0.00024434127812701304,0.8333333333333334
6078,6078,문명/Noun,24,20,4,0.00024452595309547634,6.663853039827628e-05,0.8333333333333334
6079,6079,장창/Noun,24,4,20,6.668889629876625e-05,0.00024434127812701304,0.8333333333333334
6080,6080,13년/Number,24,20,4,0.00024452595309547634,6.663853039827628e-05,0.8333333333333334
6081,6081,올려놓다/Verb,24,5,19,7.780371234856063e-05,0.000233234856393967,0.7916666666666666
6082,6082,흐리다/Verb,24,5,19,7.780371234856063e-05,0.000233234856393967,0.7916666666666666
6083,6083,렌트/Noun,24,5,19,7.780371234856063e-05,0.000233234856393967,0.7916666666666666
6084,6084,반의/Noun,24,5,19,7.780371234856063e-05,0.000233234856393967,0.7916666666666666
6085,6085,스무살/Noun,24,19,5,0.0002334111370456819,7.774495213132233e-05,0.7916666666666666
6086,6086,저능/Noun,24,5,19,7.780371234856063e-05,0.000233234856393967,0.7916666666666666
6087,6087,으악/Adverb,24,5,19,7.780371234856063e-05,0.000233234856393967,0.7916666666666666
6088,6088,박정희/Noun,24,5,19,7.780371234856063e-05,0.000233234856393967,0.7916666666666666
6089,6089,놔두다/Verb,24,5,19,7.780371234856063e-05,0.000233234856393967,0.7916666666666666
6090,6090,아따/Noun,24,5,19,7.780371234856063e-05,0.000233234856393967,0.7916666666666666
6091,6091,상속/Noun,24,19,5,0.0002334111370456819,7.774495213132233e-05,0.7916666666666666
6092,6092,진상/Noun,24,5,19,7.780371234856063e-05,0.000233234856393967,0.7916666666666666
6093,6093,적합하다/Adjective,24,5,19,7.780371234856063e-05,0.000233234856393967,0.7916666666666666
6094,6094,조디/Noun,24,19,5,0.0002334111370456819,7.774495213132233e-05,0.7916666666666666
6095,6095,액/Noun,24,5,19,7.780371234856063e-05,0.000233234856393967,0.7916666666666666
6096,6096,피고/Noun,24,6,18,8.891852839835501e-05,0.00022212843466092096,0.75
6097,6097,앵/Adverb,24,6,18,8.891852839835501e-05,0.00022212843466092096,0.75
6098,6098,가두다/Verb,24,6,18,8.891852839835501e-05,0.00022212843466092096,0.75
6099,6099,엠비씨/Noun,24,6,18,8.891852839835501e-05,0.00022212843466092096,0.75
6100,6100,하찮다/Adjective,24,6,18,8.891852839835501e-05,0.00022212843466092096,0.75
6101,6101,진국/Noun,24,18,6,0.0002222963209958875,8.885137386436837e-05,0.75
6102,6102,소비/Noun,24,6,18,8.891852839835501e-05,0.00022212843466092096,0.75
6103,6103,아주아주/Adverb,24,18,6,0.0002222963209958875,8.885137386436837e-05,0.75
6104,6104,ㅅㅅ/KoreanParticle,24,6,18,8.891852839835501e-05,0.00022212843466092096,0.75
6105,6105,축하/Noun,24,18,6,0.0002222963209958875,8.885137386436837e-05,0.75
6106,6106,게다/Noun,24,6,18,8.891852839835501e-05,0.00022212843466092096,0.75
6107,6107,이경영/Noun,24,6,18,8.891852839835501e-05,0.00022212843466092096,0.75
6108,6108,도배/Noun,24,7,17,0.0001000333444481494,0.0002110220129278749,0.7083333333333334
6109,6109,녹음/Noun,24,7,17,0.0001000333444481494,0.0002110220129278749,0.7083333333333334
6110,6110,존예/Noun,24,17,7,0.00021118150494609317,9.995779559741441e-05,0.7083333333333334
6111,6111,박살/Noun,24,7,17,0.0001000333444481494,0.0002110220129278749,0.7083333333333334
6112,6112,기기/Noun,24,7,17,0.0001000333444481494,0.0002110220129278749,0.7083333333333334
6113,6113,계단/Noun,24,17,7,0.00021118150494609317,9.995779559741441e-05,0.7083333333333334
6114,6114,명언/Noun,24,17,7,0.00021118150494609317,9.995779559741441e-05,0.7083333333333334
6115,6115,..!!!/Punctuation,24,17,7,0.00021118150494609317,9.995779559741441e-05,0.7083333333333334
6116,6116,브라이언/Noun,24,17,7,0.00021118150494609317,9.995779559741441e-05,0.7083333333333334
6117,6117,퀴/Noun,24,7,17,0.0001000333444481494,0.0002110220129278749,0.7083333333333334
6118,6118,90/Number,24,7,17,0.0001000333444481494,0.0002110220129278749,0.7083333333333334
6119,6119,완존/Noun,24,17,7,0.00021118150494609317,9.995779559741441e-05,0.7083333333333334
6120,6120,".,./Punctuation",24,7,17,0.0001000333444481494,0.0002110220129278749,0.7083333333333334
6121,6121,눈물샘/Noun,24,17,7,0.00021118150494609317,9.995779559741441e-05,0.7083333333333334
6122,6122,민호/Noun,24,17,7,0.00021118150494609317,9.995779559741441e-05,0.7083333333333334
6123,6123,장선우/Noun,24,7,17,0.0001000333444481494,0.0002110220129278749,0.7083333333333334
6124,6124,창문/Noun,24,7,17,0.0001000333444481494,0.0002110220129278749,0.7083333333333334
6125,6125,이빨/Noun,24,7,17,0.0001000333444481494,0.0002110220129278749,0.7083333333333334
6126,6126,파치노/Noun,24,17,7,0.00021118150494609317,9.995779559741441e-05,0.7083333333333334
6127,6127,낡다/Adjective,24,7,17,0.0001000333444481494,0.0002110220129278749,0.7083333333333334
6128,6128,초라하다/Adjective,24,7,17,0.0001000333444481494,0.0002110220129278749,0.7083333333333334
6129,6129,해소/Noun,24,17,7,0.00021118150494609317,9.995779559741441e-05,0.7083333333333334
6130,6130,이문식/Noun,24,7,17,0.0001000333444481494,0.0002110220129278749,0.7083333333333334
6131,6131,이뤄지다/Verb,24,17,7,0.00021118150494609317,9.995779559741441e-05,0.7083333333333334
6132,6132,스티븐시걸/Noun,24,8,16,0.00011114816049794375,0.00019991559119482882,0.6666666666666666
6133,6133,비우다/Verb,24,8,16,0.00011114816049794375,0.00019991559119482882,0.6666666666666666
6134,6134,부조리/Noun,24,16,8,0.0002000666888962988,0.00011106421733046048,0.6666666666666666
6135,6135,대립/Noun,24,16,8,0.0002000666888962988,0.00011106421733046048,0.6666666666666666
6136,6136,스님/Noun,24,16,8,0.0002000666888962988,0.00011106421733046048,0.6666666666666666
6137,6137,장영/Noun,24,16,8,0.0002000666888962988,0.00011106421733046048,0.6666666666666666
6138,6138,분노하다/Adjective,24,8,16,0.00011114816049794375,0.00019991559119482882,0.6666666666666666
6139,6139,월드컵/Noun,24,16,8,0.0002000666888962988,0.00011106421733046048,0.6666666666666666
6140,6140,?????/Punctuation,24,8,16,0.00011114816049794375,0.00019991559119482882,0.6666666666666666
6141,6141,쇼킹/Noun,24,16,8,0.0002000666888962988,0.00011106421733046048,0.6666666666666666
6142,6142,문구/Noun,24,8,16,0.00011114816049794375,0.00019991559119482882,0.6666666666666666
6143,6143,야쿠자/Noun,24,8,16,0.00011114816049794375,0.00019991559119482882,0.6666666666666666
6144,6144,택/Noun,24,8,16,0.00011114816049794375,0.00019991559119482882,0.6666666666666666
6145,6145,호랑이/Noun,24,16,8,0.0002000666888962988,0.00011106421733046048,0.6666666666666666
6146,6146,빈틈/Noun,24,16,8,0.0002000666888962988,0.00011106421733046048,0.6666666666666666
6147,6147,리차드/Noun,24,16,8,0.0002000666888962988,0.00011106421733046048,0.6666666666666666
6148,6148,움직임/Noun,24,16,8,0.0002000666888962988,0.00011106421733046048,0.6666666666666666
6149,6149,유준상/Noun,24,8,16,0.00011114816049794375,0.00019991559119482882,0.6666666666666666
6150,6150,류승룡/Noun,24,16,8,0.0002000666888962988,0.00011106421733046048,0.6666666666666666
6151,6151,캐다/Verb,24,9,15,0.00012226297654773814,0.0001888091694617828,0.625
6152,6152,안개/Noun,24,15,9,0.00018895187284650438,0.00012217063906350652,0.625
6153,6153,햇던/Noun,24,9,15,0.00012226297654773814,0.0001888091694617828,0.625
6154,6154,유승호/Noun,24,9,15,0.00012226297654773814,0.0001888091694617828,0.625
6155,6155,그리스/Noun,24,9,15,0.00012226297654773814,0.0001888091694617828,0.625
6156,6156,숀펜/Noun,24,15,9,0.00018895187284650438,0.00012217063906350652,0.625
6157,6157,지워지다/Verb,24,15,9,0.00018895187284650438,0.00012217063906350652,0.625
6158,6158,독도/Noun,24,15,9,0.00018895187284650438,0.00012217063906350652,0.625
6159,6159,외다/Verb,24,9,15,0.00012226297654773814,0.0001888091694617828,0.625
6160,6160,닳다/Verb,24,9,15,0.00012226297654773814,0.0001888091694617828,0.625
6161,6161,재일/Noun,24,15,9,0.00018895187284650438,0.00012217063906350652,0.625
6162,6162,김윤석/Noun,24,15,9,0.00018895187284650438,0.00012217063906350652,0.625
6163,6163,장미/Noun,24,15,9,0.00018895187284650438,0.00012217063906350652,0.625
6164,6164,교사/Noun,24,9,15,0.00012226297654773814,0.0001888091694617828,0.625
6165,6165,멕/Noun,24,10,14,0.0001333777925975325,0.00017770274772873674,0.5833333333333334
6166,6166,배두나/Noun,24,14,10,0.00017783705679671002,0.00013327706079655256,0.5833333333333334
6167,6167,취하/Noun,24,10,14,0.0001333777925975325,0.00017770274772873674,0.5833333333333334
6168,6168,김정은/Noun,24,10,14,0.0001333777925975325,0.00017770274772873674,0.5833333333333334
6169,6169,범죄영화/Noun,24,10,14,0.0001333777925975325,0.00017770274772873674,0.5833333333333334
6170,6170,영하/Noun,24,14,10,0.00017783705679671002,0.00013327706079655256,0.5833333333333334
6171,6171,날개/Noun,24,10,14,0.0001333777925975325,0.00017770274772873674,0.5833333333333334
6172,6172,연결고리/Noun,24,10,14,0.0001333777925975325,0.00017770274772873674,0.5833333333333334
6173,6173,굴/Noun,24,14,10,0.00017783705679671002,0.00013327706079655256,0.5833333333333334
6174,6174,디게/Adverb,24,14,10,0.00017783705679671002,0.00013327706079655256,0.5833333333333334
6175,6175,~?/Punctuation,24,10,14,0.0001333777925975325,0.00017770274772873674,0.5833333333333334
6176,6176,갱스터/Noun,24,14,10,0.00017783705679671002,0.00013327706079655256,0.5833333333333334
6177,6177,개척/Noun,24,14,10,0.00017783705679671002,0.00013327706079655256,0.5833333333333334
6178,6178,누리다/Verb,24,14,10,0.00017783705679671002,0.00013327706079655256,0.5833333333333334
6179,6179,제국/Noun,24,14,10,0.00017783705679671002,0.00013327706079655256,0.5833333333333334
6180,6180,초등/Noun,24,10,14,0.0001333777925975325,0.00017770274772873674,0.5833333333333334
6181,6181,우울/Noun,24,10,14,0.0001333777925975325,0.00017770274772873674,0.5833333333333334
6182,6182,ㅡㅜ/KoreanParticle,24,10,14,0.0001333777925975325,0.00017770274772873674,0.5833333333333334
6183,6183,스마트폰/Noun,24,10,14,0.0001333777925975325,0.00017770274772873674,0.5833333333333334
6184,6184,데려가다/Verb,24,11,13,0.0001444926086473269,0.0001665963259956907,0.5416666666666666
6185,6185,하/Noun,24,13,11,0.00016672224074691566,0.0001443834825295986,0.5416666666666666
6186,6186,조여정/Noun,24,13,11,0.00016672224074691566,0.0001443834825295986,0.5416666666666666
6187,6187,됫/Noun,24,13,11,0.00016672224074691566,0.0001443834825295986,0.5416666666666666
6188,6188,외치/Noun,24,11,13,0.0001444926086473269,0.0001665963259956907,0.5416666666666666
6189,6189,러/Noun,24,13,11,0.00016672224074691566,0.0001443834825295986,0.5416666666666666
6190,6190,비운/Noun,24,13,11,0.00016672224074691566,0.0001443834825295986,0.5416666666666666
6191,6191,나선/Noun,24,13,11,0.00016672224074691566,0.0001443834825295986,0.5416666666666666
6192,6192,손오공/Noun,24,11,13,0.0001444926086473269,0.0001665963259956907,0.5416666666666666
6193,6193,예지원/Noun,24,11,13,0.0001444926086473269,0.0001665963259956907,0.5416666666666666
6194,6194,이해력/Noun,24,11,13,0.0001444926086473269,0.0001665963259956907,0.5416666666666666
6195,6195,어유/Noun,24,13,11,0.00016672224074691566,0.0001443834825295986,0.5416666666666666
6196,6196,리부트/Noun,24,13,11,0.00016672224074691566,0.0001443834825295986,0.5416666666666666
6197,6197,닭/Noun,24,11,13,0.0001444926086473269,0.0001665963259956907,0.5416666666666666
6198,6198,노무현/Noun,24,11,13,0.0001444926086473269,0.0001665963259956907,0.5416666666666666
6199,6199,대지/Noun,24,11,13,0.0001444926086473269,0.0001665963259956907,0.5416666666666666
6200,6200,편성/Noun,24,11,13,0.0001444926086473269,0.0001665963259956907,0.5416666666666666
6201,6201,획기/Noun,24,13,11,0.00016672224074691566,0.0001443834825295986,0.5416666666666666
6202,6202,용의/Noun,24,13,11,0.00016672224074691566,0.0001443834825295986,0.5416666666666666
6203,6203,쌍둥이/Noun,24,11,13,0.0001444926086473269,0.0001665963259956907,0.5416666666666666
6204,6204,매치/Noun,24,11,13,0.0001444926086473269,0.0001665963259956907,0.5416666666666666
6205,6205,얼음/Noun,24,13,11,0.00016672224074691566,0.0001443834825295986,0.5416666666666666
6206,6206,바람둥이/Noun,24,11,13,0.0001444926086473269,0.0001665963259956907,0.5416666666666666
6207,6207,그토록/Adverb,24,11,13,0.0001444926086473269,0.0001665963259956907,0.5416666666666666
6208,6208,사자/Noun,24,11,13,0.0001444926086473269,0.0001665963259956907,0.5416666666666666
6209,6209,올드보이/Noun,24,11,13,0.0001444926086473269,0.0001665963259956907,0.5416666666666666
6210,6210,흑형/Noun,24,13,11,0.00016672224074691566,0.0001443834825295986,0.5416666666666666
6211,6211,빙의/Noun,24,13,11,0.00016672224074691566,0.0001443834825295986,0.5416666666666666
6212,6212,일텐데/Josa,24,13,11,0.00016672224074691566,0.0001443834825295986,0.5416666666666666
6213,6213,돌이/Noun,24,12,12,0.00015560742469712126,0.00015548990426264466,0.5
6214,6214,팔마/Noun,24,12,12,0.00015560742469712126,0.00015548990426264466,0.5
6215,6215,논란/Noun,24,12,12,0.00015560742469712126,0.00015548990426264466,0.5
6216,6216,환영/Noun,24,12,12,0.00015560742469712126,0.00015548990426264466,0.5
6217,6217,화제/Noun,24,12,12,0.00015560742469712126,0.00015548990426264466,0.5
6218,6218,환/Noun,24,12,12,0.00015560742469712126,0.00015548990426264466,0.5
6219,6219,라이즈/Noun,24,12,12,0.00015560742469712126,0.00015548990426264466,0.5
6220,6220,로안/Noun,24,12,12,0.00015560742469712126,0.00015548990426264466,0.5
6221,6221,한자/Noun,24,12,12,0.00015560742469712126,0.00015548990426264466,0.5
6222,6222,특색/Noun,24,12,12,0.00015560742469712126,0.00015548990426264466,0.5
6223,6223,가보/Noun,24,12,12,0.00015560742469712126,0.00015548990426264466,0.5
6224,6224,빼앗기다/Verb,24,12,12,0.00015560742469712126,0.00015548990426264466,0.5
6225,6225,포근하다/Adjective,23,23,0,0.00027787040124485944,2.2212843466092093e-05,1.0
6226,6226,물체/Noun,23,0,23,2.2229632099588756e-05,0.00027766054332615115,1.0
6227,6227,긴급/Noun,23,1,22,3.334444814938313e-05,0.00026655412159310506,0.9565217391304348
6228,6228,난감/Noun,23,1,22,3.334444814938313e-05,0.00026655412159310506,0.9565217391304348
6229,6229,추강/Noun,23,22,1,0.000266755585195065,3.331926519913814e-05,0.9565217391304348
6230,6230,잡탕/Noun,23,1,22,3.334444814938313e-05,0.00026655412159310506,0.9565217391304348
6231,6231,꼽는/Noun,23,22,1,0.000266755585195065,3.331926519913814e-05,0.9565217391304348
6232,6232,못만드/Noun,23,2,21,4.445926419917751e-05,0.0002554476998600591,0.9130434782608696
6233,6233,박영화/Noun,23,21,2,0.00025564076914527065,4.4425686932184186e-05,0.9130434782608696
6234,6234,바람나다/Verb,23,2,21,4.445926419917751e-05,0.0002554476998600591,0.9130434782608696
6235,6235,존잘/Noun,23,20,3,0.00024452595309547634,5.553210866523024e-05,0.8695652173913043
6236,6236,경력/Noun,23,3,20,5.5574080248971876e-05,0.00024434127812701304,0.8695652173913043
6237,6237,11년/Number,23,20,3,0.00024452595309547634,5.553210866523024e-05,0.8695652173913043
6238,6238,나대다/Verb,23,3,20,5.5574080248971876e-05,0.00024434127812701304,0.8695652173913043
6239,6239,-;/Punctuation,23,3,20,5.5574080248971876e-05,0.00024434127812701304,0.8695652173913043
6240,6240,^.^/Punctuation,23,20,3,0.00024452595309547634,5.553210866523024e-05,0.8695652173913043
6241,6241,노아/Noun,23,3,20,5.5574080248971876e-05,0.00024434127812701304,0.8695652173913043
6242,6242,욧/Noun,23,20,3,0.00024452595309547634,5.553210866523024e-05,0.8695652173913043
6243,6243,스며들다/Verb,23,20,3,0.00024452595309547634,5.553210866523024e-05,0.8695652173913043
6244,6244,호프/Noun,23,20,3,0.00024452595309547634,5.553210866523024e-05,0.8695652173913043
6245,6245,직장인/Noun,23,20,3,0.00024452595309547634,5.553210866523024e-05,0.8695652173913043
6246,6246,볼바/Noun,23,3,20,5.5574080248971876e-05,0.00024434127812701304,0.8695652173913043
6247,6247,반쪽/Noun,23,3,20,5.5574080248971876e-05,0.00024434127812701304,0.8695652173913043
6248,6248,꾸역꾸역/Adverb,23,3,20,5.5574080248971876e-05,0.00024434127812701304,0.8695652173913043
6249,6249,데드/Noun,23,4,19,6.668889629876625e-05,0.000233234856393967,0.8260869565217391
6250,6250,파탄/Noun,23,4,19,6.668889629876625e-05,0.000233234856393967,0.8260869565217391
6251,6251,사골/Noun,23,4,19,6.668889629876625e-05,0.000233234856393967,0.8260869565217391
6252,6252,동양인/Noun,23,4,19,6.668889629876625e-05,0.000233234856393967,0.8260869565217391
6253,6253,요가/Noun,23,4,19,6.668889629876625e-05,0.000233234856393967,0.8260869565217391
6254,6254,잼남/Noun,23,19,4,0.0002334111370456819,6.663853039827628e-05,0.8260869565217391
6255,6255,후진/Noun,23,4,19,6.668889629876625e-05,0.000233234856393967,0.8260869565217391
6256,6256,킹왕짱/Noun,23,19,4,0.0002334111370456819,6.663853039827628e-05,0.8260869565217391
6257,6257,갈망/Noun,23,19,4,0.0002334111370456819,6.663853039827628e-05,0.8260869565217391
6258,6258,구식/Noun,23,4,19,6.668889629876625e-05,0.000233234856393967,0.8260869565217391
6259,6259,세심/Noun,23,19,4,0.0002334111370456819,6.663853039827628e-05,0.8260869565217391
6260,6260,추상/Noun,23,4,19,6.668889629876625e-05,0.000233234856393967,0.8260869565217391
6261,6261,남우/Noun,23,19,4,0.0002334111370456819,6.663853039827628e-05,0.8260869565217391
6262,6262,밍밍/Noun,23,4,19,6.668889629876625e-05,0.000233234856393967,0.8260869565217391
6263,6263,?;;/Punctuation,23,4,19,6.668889629876625e-05,0.000233234856393967,0.8260869565217391
6264,6264,보너스/Noun,23,18,5,0.0002222963209958875,7.774495213132233e-05,0.7826086956521741
6265,6265,수호/Noun,23,18,5,0.0002222963209958875,7.774495213132233e-05,0.7826086956521741
6266,6266,토요일/Noun,23,18,5,0.0002222963209958875,7.774495213132233e-05,0.7826086956521741
6267,6267,람/Noun,23,5,18,7.780371234856063e-05,0.00022212843466092096,0.7826086956521741
6268,6268,화신/Noun,23,5,18,7.780371234856063e-05,0.00022212843466092096,0.7826086956521741
6269,6269,저학년/Noun,23,5,18,7.780371234856063e-05,0.00022212843466092096,0.7826086956521741
6270,6270,유부녀/Noun,23,5,18,7.780371234856063e-05,0.00022212843466092096,0.7826086956521741
6271,6271,기다림/Noun,23,18,5,0.0002222963209958875,7.774495213132233e-05,0.7826086956521741
6272,6272,왕국/Noun,23,5,18,7.780371234856063e-05,0.00022212843466092096,0.7826086956521741
6273,6273,불신/Noun,23,5,18,7.780371234856063e-05,0.00022212843466092096,0.7826086956521741
6274,6274,에반게리온/Noun,23,17,6,0.00021118150494609317,8.885137386436837e-05,0.7391304347826086
6275,6275,나탈리/Noun,23,17,6,0.00021118150494609317,8.885137386436837e-05,0.7391304347826086
6276,6276,온통/Noun,23,6,17,8.891852839835501e-05,0.0002110220129278749,0.7391304347826086
6277,6277,현상/Noun,23,6,17,8.891852839835501e-05,0.0002110220129278749,0.7391304347826086
6278,6278,25년/Number,23,17,6,0.00021118150494609317,8.885137386436837e-05,0.7391304347826086
6279,6279,뵙다/Verb,23,17,6,0.00021118150494609317,8.885137386436837e-05,0.7391304347826086
6280,6280,단조롭다/Adjective,23,6,17,8.891852839835501e-05,0.0002110220129278749,0.7391304347826086
6281,6281,나른하다/Adjective,23,17,6,0.00021118150494609317,8.885137386436837e-05,0.7391304347826086
6282,6282,후배/Noun,23,6,17,8.891852839835501e-05,0.0002110220129278749,0.7391304347826086
6283,6283,탱/Adverb,23,6,17,8.891852839835501e-05,0.0002110220129278749,0.7391304347826086
6284,6284,긁다/Verb,23,6,17,8.891852839835501e-05,0.0002110220129278749,0.7391304347826086
6285,6285,이기심/Noun,23,17,6,0.00021118150494609317,8.885137386436837e-05,0.7391304347826086
6286,6286,레고/Noun,23,17,6,0.00021118150494609317,8.885137386436837e-05,0.7391304347826086
6287,6287,?..../Punctuation,23,6,17,8.891852839835501e-05,0.0002110220129278749,0.7391304347826086
6288,6288,함축/Noun,23,17,6,0.00021118150494609317,8.885137386436837e-05,0.7391304347826086
6289,6289,쭈욱/Noun,23,17,6,0.00021118150494609317,8.885137386436837e-05,0.7391304347826086
6290,6290,먹고살다/Verb,23,7,16,0.0001000333444481494,0.00019991559119482882,0.6956521739130435
6291,6291,길거리/Noun,23,7,16,0.0001000333444481494,0.00019991559119482882,0.6956521739130435
6292,6292,오덕/Noun,23,7,16,0.0001000333444481494,0.00019991559119482882,0.6956521739130435
6293,6293,태권도/Noun,23,7,16,0.0001000333444481494,0.00019991559119482882,0.6956521739130435
6294,6294,lt/Alpha,23,16,7,0.0002000666888962988,9.995779559741441e-05,0.6956521739130435
6295,6295,송윤아/Noun,23,16,7,0.0002000666888962988,9.995779559741441e-05,0.6956521739130435
6296,6296,사신/Noun,23,7,16,0.0001000333444481494,0.00019991559119482882,0.6956521739130435
6297,6297,영화광/Noun,23,7,16,0.0001000333444481494,0.00019991559119482882,0.6956521739130435
6298,6298,고아라/Noun,23,16,7,0.0002000666888962988,9.995779559741441e-05,0.6956521739130435
6299,6299,건너/Noun,23,7,16,0.0001000333444481494,0.00019991559119482882,0.6956521739130435
6300,6300,반미/Noun,23,7,16,0.0001000333444481494,0.00019991559119482882,0.6956521739130435
6301,6301,인격/Noun,23,7,16,0.0001000333444481494,0.00019991559119482882,0.6956521739130435
6302,6302,에잇/Exclamation,23,7,16,0.0001000333444481494,0.00019991559119482882,0.6956521739130435
6303,6303,동정/Noun,23,7,16,0.0001000333444481494,0.00019991559119482882,0.6956521739130435
6304,6304,지하/Noun,23,7,16,0.0001000333444481494,0.00019991559119482882,0.6956521739130435
6305,6305,시위/Noun,23,7,16,0.0001000333444481494,0.00019991559119482882,0.6956521739130435
6306,6306,싱크로/Noun,23,15,8,0.00018895187284650438,0.00011106421733046048,0.6521739130434783
6307,6307,심판/Noun,23,8,15,0.00011114816049794375,0.0001888091694617828,0.6521739130434783
6308,6308,잘나오다/Verb,23,8,15,0.00011114816049794375,0.0001888091694617828,0.6521739130434783
6309,6309,리그/Noun,23,8,15,0.00011114816049794375,0.0001888091694617828,0.6521739130434783
6310,6310,꽃미남/Noun,23,15,8,0.00018895187284650438,0.00011106421733046048,0.6521739130434783
6311,6311,김수미/Noun,23,8,15,0.00011114816049794375,0.0001888091694617828,0.6521739130434783
6312,6312,치킨/Noun,23,8,15,0.00011114816049794375,0.0001888091694617828,0.6521739130434783
6313,6313,윤시윤/Noun,23,15,8,0.00018895187284650438,0.00011106421733046048,0.6521739130434783
6314,6314,gt/Alpha,23,15,8,0.00018895187284650438,0.00011106421733046048,0.6521739130434783
6315,6315,광해/Noun,23,15,8,0.00018895187284650438,0.00011106421733046048,0.6521739130434783
6316,6316,기선/Noun,23,8,15,0.00011114816049794375,0.0001888091694617828,0.6521739130434783
6317,6317,여서/Noun,23,15,8,0.00018895187284650438,0.00011106421733046048,0.6521739130434783
6318,6318,경/Noun,23,15,8,0.00018895187284650438,0.00011106421733046048,0.6521739130434783
6319,6319,에밀리/Noun,23,15,8,0.00018895187284650438,0.00011106421733046048,0.6521739130434783
6320,6320,페/Noun,23,15,8,0.00018895187284650438,0.00011106421733046048,0.6521739130434783
6321,6321,연락/Noun,23,15,8,0.00018895187284650438,0.00011106421733046048,0.6521739130434783
6322,6322,XX/Alpha,23,8,15,0.00011114816049794375,0.0001888091694617828,0.6521739130434783
6323,6323,밑바닥/Noun,23,8,15,0.00011114816049794375,0.0001888091694617828,0.6521739130434783
6324,6324,이자벨/Noun,23,15,8,0.00018895187284650438,0.00011106421733046048,0.6521739130434783
6325,6325,설리/Noun,23,15,8,0.00018895187284650438,0.00011106421733046048,0.6521739130434783
6326,6326,도망치다/Verb,23,8,15,0.00011114816049794375,0.0001888091694617828,0.6521739130434783
6327,6327,꼬집다/Verb,23,15,8,0.00018895187284650438,0.00011106421733046048,0.6521739130434783
6328,6328,라이더/Noun,23,15,8,0.00018895187284650438,0.00011106421733046048,0.6521739130434783
6329,6329,신앙/Noun,23,15,8,0.00018895187284650438,0.00011106421733046048,0.6521739130434783
6330,6330,들려주다/Verb,23,15,8,0.00018895187284650438,0.00011106421733046048,0.6521739130434783
6331,6331,6.5/Number,23,8,15,0.00011114816049794375,0.0001888091694617828,0.6521739130434783
6332,6332,뛰어다니다/Verb,23,8,15,0.00011114816049794375,0.0001888091694617828,0.6521739130434783
6333,6333,성폭행/Noun,23,8,15,0.00011114816049794375,0.0001888091694617828,0.6521739130434783
6334,6334,제주도/Noun,23,14,9,0.00017783705679671002,0.00012217063906350652,0.6086956521739131
6335,6335,둘리/Noun,23,14,9,0.00017783705679671002,0.00012217063906350652,0.6086956521739131
6336,6336,해운대/Noun,23,14,9,0.00017783705679671002,0.00012217063906350652,0.6086956521739131
6337,6337,그로테스크/Noun,23,14,9,0.00017783705679671002,0.00012217063906350652,0.6086956521739131
6338,6338,다케시/Noun,23,14,9,0.00017783705679671002,0.00012217063906350652,0.6086956521739131
6339,6339,상자/Noun,23,9,14,0.00012226297654773814,0.00017770274772873674,0.6086956521739131
6340,6340,내려오다/Verb,23,14,9,0.00017783705679671002,0.00012217063906350652,0.6086956521739131
6341,6341,햇음/Noun,23,9,14,0.00012226297654773814,0.00017770274772873674,0.6086956521739131
6342,6342,성기/Noun,23,9,14,0.00012226297654773814,0.00017770274772873674,0.6086956521739131
6343,6343,야수/Noun,23,14,9,0.00017783705679671002,0.00012217063906350652,0.6086956521739131
6344,6344,재생/Noun,23,9,14,0.00012226297654773814,0.00017770274772873674,0.6086956521739131
6345,6345,슬레/Noun,23,9,14,0.00012226297654773814,0.00017770274772873674,0.6086956521739131
6346,6346,테러리스트/Noun,23,9,14,0.00012226297654773814,0.00017770274772873674,0.6086956521739131
6347,6347,이불/Noun,23,14,9,0.00017783705679671002,0.00012217063906350652,0.6086956521739131
6348,6348,앗/Noun,23,14,9,0.00017783705679671002,0.00012217063906350652,0.6086956521739131
6349,6349,아유/Noun,23,9,14,0.00012226297654773814,0.00017770274772873674,0.6086956521739131
6350,6350,강소라/Noun,23,9,14,0.00012226297654773814,0.00017770274772873674,0.6086956521739131
6351,6351,하이라이트/Noun,23,13,10,0.00016672224074691566,0.00013327706079655256,0.5652173913043478
6352,6352,보드/Noun,23,10,13,0.0001333777925975325,0.0001665963259956907,0.5652173913043478
6353,6353,떤다/Verb,23,13,10,0.00016672224074691566,0.00013327706079655256,0.5652173913043478
6354,6354,바라지/Noun,23,10,13,0.0001333777925975325,0.0001665963259956907,0.5652173913043478
6355,6355,트라우마/Noun,23,13,10,0.00016672224074691566,0.00013327706079655256,0.5652173913043478
6356,6356,시한/Noun,23,13,10,0.00016672224074691566,0.00013327706079655256,0.5652173913043478
6357,6357,일만/Noun,23,10,13,0.0001333777925975325,0.0001665963259956907,0.5652173913043478
6358,6358,후편/Noun,23,13,10,0.00016672224074691566,0.00013327706079655256,0.5652173913043478
6359,6359,입히다/Verb,23,10,13,0.0001333777925975325,0.0001665963259956907,0.5652173913043478
6360,6360,끝없다/Adjective,23,13,10,0.00016672224074691566,0.00013327706079655256,0.5652173913043478
6361,6361,정책/Noun,23,10,13,0.0001333777925975325,0.0001665963259956907,0.5652173913043478
6362,6362,순이/Noun,23,10,13,0.0001333777925975325,0.0001665963259956907,0.5652173913043478
6363,6363,산업/Noun,23,13,10,0.00016672224074691566,0.00013327706079655256,0.5652173913043478
6364,6364,무죄/Noun,23,13,10,0.00016672224074691566,0.00013327706079655256,0.5652173913043478
6365,6365,화이트/Noun,23,10,13,0.0001333777925975325,0.0001665963259956907,0.5652173913043478
6366,6366,파헤치다/Verb,23,13,10,0.00016672224074691566,0.00013327706079655256,0.5652173913043478
6367,6367,잔인/Noun,23,13,10,0.00016672224074691566,0.00013327706079655256,0.5652173913043478
6368,6368,찰지다/Adjective,23,10,13,0.0001333777925975325,0.0001665963259956907,0.5652173913043478
6369,6369,아담샌들러/Noun,23,13,10,0.00016672224074691566,0.00013327706079655256,0.5652173913043478
6370,6370,"!""/Punctuation",23,10,13,0.0001333777925975325,0.0001665963259956907,0.5652173913043478
6371,6371,충족/Noun,23,13,10,0.00016672224074691566,0.00013327706079655256,0.5652173913043478
6372,6372,건담/Noun,23,13,10,0.00016672224074691566,0.00013327706079655256,0.5652173913043478
6373,6373,실속/Noun,23,10,13,0.0001333777925975325,0.0001665963259956907,0.5652173913043478
6374,6374,bgm/Alpha,23,13,10,0.00016672224074691566,0.00013327706079655256,0.5652173913043478
6375,6375,소련/Noun,23,10,13,0.0001333777925975325,0.0001665963259956907,0.5652173913043478
6376,6376,중세/Noun,23,11,12,0.0001444926086473269,0.00015548990426264466,0.5217391304347826
6377,6377,한일/Noun,23,11,12,0.0001444926086473269,0.00015548990426264466,0.5217391304347826
6378,6378,!'/Punctuation,23,12,11,0.00015560742469712126,0.0001443834825295986,0.5217391304347826
6379,6379,사악하다/Adjective,23,12,11,0.00015560742469712126,0.0001443834825295986,0.5217391304347826
6380,6380,꽂히다/Verb,23,12,11,0.00015560742469712126,0.0001443834825295986,0.5217391304347826
6381,6381,여자아이/Noun,23,11,12,0.0001444926086473269,0.00015548990426264466,0.5217391304347826
6382,6382,문자/Noun,23,11,12,0.0001444926086473269,0.00015548990426264466,0.5217391304347826
6383,6383,도가니/Noun,23,11,12,0.0001444926086473269,0.00015548990426264466,0.5217391304347826
6384,6384,L/Alpha,23,12,11,0.00015560742469712126,0.0001443834825295986,0.5217391304347826
6385,6385,킬/Noun,23,12,11,0.00015560742469712126,0.0001443834825295986,0.5217391304347826
6386,6386,교양/Noun,23,11,12,0.0001444926086473269,0.00015548990426264466,0.5217391304347826
6387,6387,라이트/Noun,23,12,11,0.00015560742469712126,0.0001443834825295986,0.5217391304347826
6388,6388,보편/Noun,23,11,12,0.0001444926086473269,0.00015548990426264466,0.5217391304347826
6389,6389,현란하다/Adjective,23,11,12,0.0001444926086473269,0.00015548990426264466,0.5217391304347826
6390,6390,감점/Noun,23,11,12,0.0001444926086473269,0.00015548990426264466,0.5217391304347826
6391,6391,피노키오/Noun,23,12,11,0.00015560742469712126,0.0001443834825295986,0.5217391304347826
6392,6392,대장/Noun,23,11,12,0.0001444926086473269,0.00015548990426264466,0.5217391304347826
6393,6393,폐해/Noun,23,11,12,0.0001444926086473269,0.00015548990426264466,0.5217391304347826
6394,6394,서태지/Noun,23,11,12,0.0001444926086473269,0.00015548990426264466,0.5217391304347826
6395,6395,규/Noun,23,12,11,0.00015560742469712126,0.0001443834825295986,0.5217391304347826
6396,6396,방울/Noun,23,12,11,0.00015560742469712126,0.0001443834825295986,0.5217391304347826
6397,6397,유사하다/Adjective,23,12,11,0.00015560742469712126,0.0001443834825295986,0.5217391304347826
6398,6398,대요/Noun,23,11,12,0.0001444926086473269,0.00015548990426264466,0.5217391304347826
6399,6399,다섯/Noun,23,12,11,0.00015560742469712126,0.0001443834825295986,0.5217391304347826
6400,6400,짖다/Verb,23,11,12,0.0001444926086473269,0.00015548990426264466,0.5217391304347826
6401,6401,휴지/Noun,23,11,12,0.0001444926086473269,0.00015548990426264466,0.5217391304347826
6402,6402,뭘말/Noun,22,0,22,2.2229632099588756e-05,0.00026655412159310506,1.0
6403,6403,어장/Noun,22,0,22,2.2229632099588756e-05,0.00026655412159310506,1.0
6404,6404,엇/Noun,22,21,1,0.00025564076914527065,3.331926519913814e-05,0.9545454545454546
6405,6405,멀미/Noun,22,1,21,3.334444814938313e-05,0.0002554476998600591,0.9545454545454546
6406,6406,비약/Noun,22,1,21,3.334444814938313e-05,0.0002554476998600591,0.9545454545454546
6407,6407,뭉클/Noun,22,21,1,0.00025564076914527065,3.331926519913814e-05,0.9545454545454546
6408,6408,그이/Noun,22,1,21,3.334444814938313e-05,0.0002554476998600591,0.9545454545454546
6409,6409,면상/Noun,22,2,20,4.445926419917751e-05,0.00024434127812701304,0.9090909090909092
6410,6410,시시/Noun,22,2,20,4.445926419917751e-05,0.00024434127812701304,0.9090909090909092
6411,6411,레즈비언/Noun,22,2,20,4.445926419917751e-05,0.00024434127812701304,0.9090909090909092
6412,6412,주님/Noun,22,20,2,0.00024452595309547634,4.4425686932184186e-05,0.9090909090909092
6413,6413,막무가내/Noun,22,2,20,4.445926419917751e-05,0.00024434127812701304,0.9090909090909092
6414,6414,연출자/Noun,22,2,20,4.445926419917751e-05,0.00024434127812701304,0.9090909090909092
6415,6415,장사/Noun,22,2,20,4.445926419917751e-05,0.00024434127812701304,0.9090909090909092
6416,6416,..;;;/Punctuation,22,2,20,4.445926419917751e-05,0.00024434127812701304,0.9090909090909092
6417,6417,에/Noun,22,3,19,5.5574080248971876e-05,0.000233234856393967,0.8636363636363636
6418,6418,쟤/Noun,22,3,19,5.5574080248971876e-05,0.000233234856393967,0.8636363636363636
6419,6419,공익/Noun,22,3,19,5.5574080248971876e-05,0.000233234856393967,0.8636363636363636
6420,6420,쯤/Foreign,22,3,19,5.5574080248971876e-05,0.000233234856393967,0.8636363636363636
6421,6421,저그/Noun,22,3,19,5.5574080248971876e-05,0.000233234856393967,0.8636363636363636
6422,6422,고사/Noun,22,3,19,5.5574080248971876e-05,0.000233234856393967,0.8636363636363636
6423,6423,바하/Noun,22,4,18,6.668889629876625e-05,0.00022212843466092096,0.8181818181818182
6424,6424,악행/Noun,22,4,18,6.668889629876625e-05,0.00022212843466092096,0.8181818181818182
6425,6425,쫙/Noun,22,18,4,0.0002222963209958875,6.663853039827628e-05,0.8181818181818182
6426,6426,윤진서/Noun,22,4,18,6.668889629876625e-05,0.00022212843466092096,0.8181818181818182
6427,6427,연설/Noun,22,18,4,0.0002222963209958875,6.663853039827628e-05,0.8181818181818182
6428,6428,가시다/Verb,22,18,4,0.0002222963209958875,6.663853039827628e-05,0.8181818181818182
6429,6429,",,,,,/Punctuation",22,4,18,6.668889629876625e-05,0.00022212843466092096,0.8181818181818182
6430,6430,꼴다/Verb,22,4,18,6.668889629876625e-05,0.00022212843466092096,0.8181818181818182
6431,6431,최수종/Noun,22,18,4,0.0002222963209958875,6.663853039827628e-05,0.8181818181818182
6432,6432,베드씬/Noun,22,4,18,6.668889629876625e-05,0.00022212843466092096,0.8181818181818182
6433,6433,대인/Noun,22,18,4,0.0002222963209958875,6.663853039827628e-05,0.8181818181818182
6434,6434,쿵푸팬더/Noun,22,4,18,6.668889629876625e-05,0.00022212843466092096,0.8181818181818182
6435,6435,민주화/Noun,22,4,18,6.668889629876625e-05,0.00022212843466092096,0.8181818181818182
6436,6436,미숙/Noun,22,4,18,6.668889629876625e-05,0.00022212843466092096,0.8181818181818182
6437,6437,소유진/Noun,22,4,18,6.668889629876625e-05,0.00022212843466092096,0.8181818181818182
6438,6438,일관/Noun,22,4,18,6.668889629876625e-05,0.00022212843466092096,0.8181818181818182
6439,6439,월화/Noun,22,17,5,0.00021118150494609317,7.774495213132233e-05,0.7727272727272727
6440,6440,위성/Noun,22,5,17,7.780371234856063e-05,0.0002110220129278749,0.7727272727272727
6441,6441,외로/Noun,22,17,5,0.00021118150494609317,7.774495213132233e-05,0.7727272727272727
6442,6442,초콜릿/Noun,22,17,5,0.00021118150494609317,7.774495213132233e-05,0.7727272727272727
6443,6443,김민희/Noun,22,17,5,0.00021118150494609317,7.774495213132233e-05,0.7727272727272727
6444,6444,나잇/Noun,22,5,17,7.780371234856063e-05,0.0002110220129278749,0.7727272727272727
6445,6445,낯설다/Adjective,22,17,5,0.00021118150494609317,7.774495213132233e-05,0.7727272727272727
6446,6446,라기보단/Josa,22,5,17,7.780371234856063e-05,0.0002110220129278749,0.7727272727272727
6447,6447,치우치다/Verb,22,5,17,7.780371234856063e-05,0.0002110220129278749,0.7727272727272727
6448,6448,냉소/Noun,22,17,5,0.00021118150494609317,7.774495213132233e-05,0.7727272727272727
6449,6449,하하/Exclamation,22,5,17,7.780371234856063e-05,0.0002110220129278749,0.7727272727272727
6450,6450,40년/Number,22,17,5,0.00021118150494609317,7.774495213132233e-05,0.7727272727272727
6451,6451,변질/Noun,22,5,17,7.780371234856063e-05,0.0002110220129278749,0.7727272727272727
6452,6452,마녀사냥/Noun,22,17,5,0.00021118150494609317,7.774495213132233e-05,0.7727272727272727
6453,6453,쨩/Suffix,22,17,5,0.00021118150494609317,7.774495213132233e-05,0.7727272727272727
6454,6454,연구/Noun,22,5,17,7.780371234856063e-05,0.0002110220129278749,0.7727272727272727
6455,6455,종교영화/Noun,22,6,16,8.891852839835501e-05,0.00019991559119482882,0.7272727272727273
6456,6456,조선시대/Noun,22,6,16,8.891852839835501e-05,0.00019991559119482882,0.7272727272727273
6457,6457,비틀즈/Noun,22,16,6,0.0002000666888962988,8.885137386436837e-05,0.7272727272727273
6458,6458,배달/Noun,22,6,16,8.891852839835501e-05,0.00019991559119482882,0.7272727272727273
6459,6459,입맛/Noun,22,6,16,8.891852839835501e-05,0.00019991559119482882,0.7272727272727273
6460,6460,사태/Noun,22,6,16,8.891852839835501e-05,0.00019991559119482882,0.7272727272727273
6461,6461,울버린/Noun,22,6,16,8.891852839835501e-05,0.00019991559119482882,0.7272727272727273
6462,6462,바이올린/Noun,22,16,6,0.0002000666888962988,8.885137386436837e-05,0.7272727272727273
6463,6463,ㅇㅅㅇ/KoreanParticle,22,16,6,0.0002000666888962988,8.885137386436837e-05,0.7272727272727273
6464,6464,마시다/Verb,22,6,16,8.891852839835501e-05,0.00019991559119482882,0.7272727272727273
6465,6465,간지나다/Verb,22,16,6,0.0002000666888962988,8.885137386436837e-05,0.7272727272727273
6466,6466,이지나/Noun,22,16,6,0.0002000666888962988,8.885137386436837e-05,0.7272727272727273
6467,6467,올바르다/Adjective,22,16,6,0.0002000666888962988,8.885137386436837e-05,0.7272727272727273
6468,6468,95년/Number,22,15,7,0.00018895187284650438,9.995779559741441e-05,0.6818181818181818
6469,6469,털/Noun,22,7,15,0.0001000333444481494,0.0001888091694617828,0.6818181818181818
6470,6470,서바이벌/Noun,22,7,15,0.0001000333444481494,0.0001888091694617828,0.6818181818181818
6471,6471,김윤진/Noun,22,7,15,0.0001000333444481494,0.0001888091694617828,0.6818181818181818
6472,6472,E/Alpha,22,7,15,0.0001000333444481494,0.0001888091694617828,0.6818181818181818
6473,6473,청춘영화/Noun,22,15,7,0.00018895187284650438,9.995779559741441e-05,0.6818181818181818
6474,6474,무덤/Noun,22,7,15,0.0001000333444481494,0.0001888091694617828,0.6818181818181818
6475,6475,심해/Noun,22,7,15,0.0001000333444481494,0.0001888091694617828,0.6818181818181818
6476,6476,덜다/Verb,22,7,15,0.0001000333444481494,0.0001888091694617828,0.6818181818181818
6477,6477,무고/Noun,22,7,15,0.0001000333444481494,0.0001888091694617828,0.6818181818181818
6478,6478,지라/Noun,22,15,7,0.00018895187284650438,9.995779559741441e-05,0.6818181818181818
6479,6479,보영/Noun,22,15,7,0.00018895187284650438,9.995779559741441e-05,0.6818181818181818
6480,6480,그따위/Noun,22,7,15,0.0001000333444481494,0.0001888091694617828,0.6818181818181818
6481,6481,헌터/Noun,22,7,15,0.0001000333444481494,0.0001888091694617828,0.6818181818181818
6482,6482,지상파/Noun,22,15,7,0.00018895187284650438,9.995779559741441e-05,0.6818181818181818
6483,6483,동화책/Noun,22,15,7,0.00018895187284650438,9.995779559741441e-05,0.6818181818181818
6484,6484,엑소/Noun,22,15,7,0.00018895187284650438,9.995779559741441e-05,0.6818181818181818
6485,6485,시어머니/Noun,22,7,15,0.0001000333444481494,0.0001888091694617828,0.6818181818181818
6486,6486,개월/Noun,22,15,7,0.00018895187284650438,9.995779559741441e-05,0.6818181818181818
6487,6487,조니/Noun,22,7,15,0.0001000333444481494,0.0001888091694617828,0.6818181818181818
6488,6488,싸지르다/Verb,22,7,15,0.0001000333444481494,0.0001888091694617828,0.6818181818181818
6489,6489,뱀/Noun,22,7,15,0.0001000333444481494,0.0001888091694617828,0.6818181818181818
6490,6490,저격/Noun,22,15,7,0.00018895187284650438,9.995779559741441e-05,0.6818181818181818
6491,6491,~~!!!/Punctuation,22,15,7,0.00018895187284650438,9.995779559741441e-05,0.6818181818181818
6492,6492,번방/Noun,22,15,7,0.00018895187284650438,9.995779559741441e-05,0.6818181818181818
6493,6493,박한별/Noun,22,8,14,0.00011114816049794375,0.00017770274772873674,0.6363636363636364
6494,6494,이진/Noun,22,8,14,0.00011114816049794375,0.00017770274772873674,0.6363636363636364
6495,6495,제시카알바/Noun,22,8,14,0.00011114816049794375,0.00017770274772873674,0.6363636363636364
6496,6496,환희/Noun,22,14,8,0.00017783705679671002,0.00011106421733046048,0.6363636363636364
6497,6497,인간성/Noun,22,14,8,0.00017783705679671002,0.00011106421733046048,0.6363636363636364
6498,6498,십대/Noun,22,8,14,0.00011114816049794375,0.00017770274772873674,0.6363636363636364
6499,6499,이슬람/Noun,22,14,8,0.00017783705679671002,0.00011106421733046048,0.6363636363636364
6500,6500,병자/Noun,22,8,14,0.00011114816049794375,0.00017770274772873674,0.6363636363636364
6501,6501,개쩌/Noun,22,14,8,0.00017783705679671002,0.00011106421733046048,0.6363636363636364
6502,6502,결/Noun,22,8,14,0.00011114816049794375,0.00017770274772873674,0.6363636363636364
6503,6503,마는/Noun,22,8,14,0.00011114816049794375,0.00017770274772873674,0.6363636363636364
6504,6504,산타/Noun,22,14,8,0.00017783705679671002,0.00011106421733046048,0.6363636363636364
6505,6505,달인/Noun,22,8,14,0.00011114816049794375,0.00017770274772873674,0.6363636363636364
6506,6506,금은/Noun,22,14,8,0.00017783705679671002,0.00011106421733046048,0.6363636363636364
6507,6507,조르다/Verb,22,8,14,0.00011114816049794375,0.00017770274772873674,0.6363636363636364
6508,6508,this/Alpha,22,14,8,0.00017783705679671002,0.00011106421733046048,0.6363636363636364
6509,6509,이상우/Noun,22,14,8,0.00017783705679671002,0.00011106421733046048,0.6363636363636364
6510,6510,숀/Noun,22,14,8,0.00017783705679671002,0.00011106421733046048,0.6363636363636364
6511,6511,무명/Noun,22,8,14,0.00011114816049794375,0.00017770274772873674,0.6363636363636364
6512,6512,불안/Noun,22,14,8,0.00017783705679671002,0.00011106421733046048,0.6363636363636364
6513,6513,유명배우/Noun,22,8,14,0.00011114816049794375,0.00017770274772873674,0.6363636363636364
6514,6514,모리/Noun,22,14,8,0.00017783705679671002,0.00011106421733046048,0.6363636363636364
6515,6515,배제/Noun,22,8,14,0.00011114816049794375,0.00017770274772873674,0.6363636363636364
6516,6516,어게인/Noun,22,14,8,0.00017783705679671002,0.00011106421733046048,0.6363636363636364
6517,6517,대답/Noun,22,14,8,0.00017783705679671002,0.00011106421733046048,0.6363636363636364
6518,6518,몸짓/Noun,22,14,8,0.00017783705679671002,0.00011106421733046048,0.6363636363636364
6519,6519,카페/Noun,22,14,8,0.00017783705679671002,0.00011106421733046048,0.6363636363636364
6520,6520,스미스/Noun,22,8,14,0.00011114816049794375,0.00017770274772873674,0.6363636363636364
6521,6521,물리/Noun,22,8,14,0.00011114816049794375,0.00017770274772873674,0.6363636363636364
6522,6522,타워/Noun,22,13,9,0.00016672224074691566,0.00012217063906350652,0.5909090909090909
6523,6523,김보성/Noun,22,9,13,0.00012226297654773814,0.0001665963259956907,0.5909090909090909
6524,6524,핀/Noun,22,9,13,0.00012226297654773814,0.0001665963259956907,0.5909090909090909
6525,6525,배고프다/Adjective,22,13,9,0.00016672224074691566,0.00012217063906350652,0.5909090909090909
6526,6526,세븐/Noun,22,9,13,0.00012226297654773814,0.0001665963259956907,0.5909090909090909
6527,6527,프리퀄/Noun,22,13,9,0.00016672224074691566,0.00012217063906350652,0.5909090909090909
6528,6528,맥그리거/Noun,22,13,9,0.00016672224074691566,0.00012217063906350652,0.5909090909090909
6529,6529,리더/Noun,22,13,9,0.00016672224074691566,0.00012217063906350652,0.5909090909090909
6530,6530,이롭다/Adjective,22,13,9,0.00016672224074691566,0.00012217063906350652,0.5909090909090909
6531,6531,지연/Noun,22,13,9,0.00016672224074691566,0.00012217063906350652,0.5909090909090909
6532,6532,성인영화/Noun,22,9,13,0.00012226297654773814,0.0001665963259956907,0.5909090909090909
6533,6533,먹이/Noun,22,9,13,0.00012226297654773814,0.0001665963259956907,0.5909090909090909
6534,6534,1~2/Number,22,9,13,0.00012226297654773814,0.0001665963259956907,0.5909090909090909
6535,6535,관념/Noun,22,9,13,0.00012226297654773814,0.0001665963259956907,0.5909090909090909
6536,6536,총격/Noun,22,13,9,0.00016672224074691566,0.00012217063906350652,0.5909090909090909
6537,6537,데미무어/Noun,22,9,13,0.00012226297654773814,0.0001665963259956907,0.5909090909090909
6538,6538,복귀/Noun,22,9,13,0.00012226297654773814,0.0001665963259956907,0.5909090909090909
6539,6539,재희/Noun,22,9,13,0.00012226297654773814,0.0001665963259956907,0.5909090909090909
6540,6540,윤은혜/Noun,22,9,13,0.00012226297654773814,0.0001665963259956907,0.5909090909090909
6541,6541,건강/Noun,22,13,9,0.00016672224074691566,0.00012217063906350652,0.5909090909090909
6542,6542,후/Foreign,22,9,13,0.00012226297654773814,0.0001665963259956907,0.5909090909090909
6543,6543,비웃다/Verb,22,9,13,0.00012226297654773814,0.0001665963259956907,0.5909090909090909
6544,6544,이즈/Noun,22,12,10,0.00015560742469712126,0.00013327706079655256,0.5454545454545454
6545,6545,애교/Noun,22,12,10,0.00015560742469712126,0.00013327706079655256,0.5454545454545454
6546,6546,비트/Noun,22,12,10,0.00015560742469712126,0.00013327706079655256,0.5454545454545454
6547,6547,껀/Noun,22,10,12,0.0001333777925975325,0.00015548990426264466,0.5454545454545454
6548,6548,박물관/Noun,22,12,10,0.00015560742469712126,0.00013327706079655256,0.5454545454545454
6549,6549,스포츠영화/Noun,22,12,10,0.00015560742469712126,0.00013327706079655256,0.5454545454545454
6550,6550,수녀/Noun,22,12,10,0.00015560742469712126,0.00013327706079655256,0.5454545454545454
6551,6551,개봉일/Noun,22,10,12,0.0001333777925975325,0.00015548990426264466,0.5454545454545454
6552,6552,취권/Noun,22,10,12,0.0001333777925975325,0.00015548990426264466,0.5454545454545454
6553,6553,~~~~~~~~/Punctuation,22,10,12,0.0001333777925975325,0.00015548990426264466,0.5454545454545454
6554,6554,만지다/Verb,22,12,10,0.00015560742469712126,0.00013327706079655256,0.5454545454545454
6555,6555,재탕하다/Adjective,22,12,10,0.00015560742469712126,0.00013327706079655256,0.5454545454545454
6556,6556,나치/Noun,22,10,12,0.0001333777925975325,0.00015548990426264466,0.5454545454545454
6557,6557,m/Alpha,22,10,12,0.0001333777925975325,0.00015548990426264466,0.5454545454545454
6558,6558,이익/Noun,22,12,10,0.00015560742469712126,0.00013327706079655256,0.5454545454545454
6559,6559,불어/Noun,22,12,10,0.00015560742469712126,0.00013327706079655256,0.5454545454545454
6560,6560,솔로/Noun,22,10,12,0.0001333777925975325,0.00015548990426264466,0.5454545454545454
6561,6561,취해/Noun,22,12,10,0.00015560742469712126,0.00013327706079655256,0.5454545454545454
6562,6562,스크림/Noun,22,12,10,0.00015560742469712126,0.00013327706079655256,0.5454545454545454
6563,6563,인디언/Noun,22,12,10,0.00015560742469712126,0.00013327706079655256,0.5454545454545454
6564,6564,책임지다/Verb,22,10,12,0.0001333777925975325,0.00015548990426264466,0.5454545454545454
6565,6565,직하다/Adjective,22,12,10,0.00015560742469712126,0.00013327706079655256,0.5454545454545454
6566,6566,이라는/Foreign,22,12,10,0.00015560742469712126,0.00013327706079655256,0.5454545454545454
6567,6567,훨낫다/Adjective,22,12,10,0.00015560742469712126,0.00013327706079655256,0.5454545454545454
6568,6568,서커스/Noun,22,10,12,0.0001333777925975325,0.00015548990426264466,0.5454545454545454
6569,6569,한적/Noun,22,10,12,0.0001333777925975325,0.00015548990426264466,0.5454545454545454
6570,6570,1초/Number,22,12,10,0.00015560742469712126,0.00013327706079655256,0.5454545454545454
6571,6571,습격/Noun,22,10,12,0.0001333777925975325,0.00015548990426264466,0.5454545454545454
6572,6572,주리/Noun,22,11,11,0.0001444926086473269,0.0001443834825295986,0.5
6573,6573,파티/Noun,22,11,11,0.0001444926086473269,0.0001443834825295986,0.5
6574,6574,살림/Noun,22,11,11,0.0001444926086473269,0.0001443834825295986,0.5
6575,6575,마스크/Noun,22,11,11,0.0001444926086473269,0.0001443834825295986,0.5
6576,6576,스토커/Noun,22,11,11,0.0001444926086473269,0.0001443834825295986,0.5
6577,6577,줄줄/Noun,22,11,11,0.0001444926086473269,0.0001443834825295986,0.5
6578,6578,유산/Noun,22,11,11,0.0001444926086473269,0.0001443834825295986,0.5
6579,6579,오마쥬/Noun,22,11,11,0.0001444926086473269,0.0001443834825295986,0.5
6580,6580,박현지/Noun,21,0,21,2.2229632099588756e-05,0.0002554476998600591,1.0
6581,6581,유머러스하다/Adjective,21,21,0,0.00025564076914527065,2.2212843466092093e-05,1.0
6582,6582,똥망/Noun,21,0,21,2.2229632099588756e-05,0.0002554476998600591,1.0
6583,6583,이수근/Noun,21,0,21,2.2229632099588756e-05,0.0002554476998600591,1.0
6584,6584,재즈/Noun,21,20,1,0.00024452595309547634,3.331926519913814e-05,0.9523809523809524
6585,6585,인내력/Noun,21,1,20,3.334444814938313e-05,0.00024434127812701304,0.9523809523809524
6586,6586,입력/Noun,21,1,20,3.334444814938313e-05,0.00024434127812701304,0.9523809523809524
6587,6587,조장/Noun,21,1,20,3.334444814938313e-05,0.00024434127812701304,0.9523809523809524
6588,6588,봣어/Noun,21,20,1,0.00024452595309547634,3.331926519913814e-05,0.9523809523809524
6589,6589,김현주/Noun,21,20,1,0.00024452595309547634,3.331926519913814e-05,0.9523809523809524
6590,6590,후레쉬맨/Noun,21,1,20,3.334444814938313e-05,0.00024434127812701304,0.9523809523809524
6591,6591,접영/Noun,21,1,20,3.334444814938313e-05,0.00024434127812701304,0.9523809523809524
6592,6592,멎다/Verb,21,20,1,0.00024452595309547634,3.331926519913814e-05,0.9523809523809524
6593,6593,개망작/Noun,21,1,20,3.334444814938313e-05,0.00024434127812701304,0.9523809523809524
6594,6594,긴지/Noun,21,1,20,3.334444814938313e-05,0.00024434127812701304,0.9523809523809524
6595,6595,퇴보/Noun,21,2,19,4.445926419917751e-05,0.000233234856393967,0.9047619047619048
6596,6596,우스꽝스럽다/Adjective,21,2,19,4.445926419917751e-05,0.000233234856393967,0.9047619047619048
6597,6597,귓가/Noun,21,19,2,0.0002334111370456819,4.4425686932184186e-05,0.9047619047619048
6598,6598,협박/Noun,21,2,19,4.445926419917751e-05,0.000233234856393967,0.9047619047619048
6599,6599,과분/Noun,21,2,19,4.445926419917751e-05,0.000233234856393967,0.9047619047619048
6600,6600,훌쩍/Noun,21,19,2,0.0002334111370456819,4.4425686932184186e-05,0.9047619047619048
6601,6601,탱고/Noun,21,19,2,0.0002334111370456819,4.4425686932184186e-05,0.9047619047619048
6602,6602,핑계/Noun,21,2,19,4.445926419917751e-05,0.000233234856393967,0.9047619047619048
6603,6603,개떡같다/Adjective,21,2,19,4.445926419917751e-05,0.000233234856393967,0.9047619047619048
6604,6604,이래도/Josa,21,2,19,4.445926419917751e-05,0.000233234856393967,0.9047619047619048
6605,6605,..-_-/Punctuation,21,3,18,5.5574080248971876e-05,0.00022212843466092096,0.8571428571428571
6606,6606,99년/Number,21,18,3,0.0002222963209958875,5.553210866523024e-05,0.8571428571428571
6607,6607,참패/Noun,21,3,18,5.5574080248971876e-05,0.00022212843466092096,0.8571428571428571
6608,6608,성지순례/Noun,21,3,18,5.5574080248971876e-05,0.00022212843466092096,0.8571428571428571
6609,6609,문채원/Noun,21,18,3,0.0002222963209958875,5.553210866523024e-05,0.8571428571428571
6610,6610,저따위/Noun,21,3,18,5.5574080248971876e-05,0.00022212843466092096,0.8571428571428571
6611,6611,매료/Noun,21,18,3,0.0002222963209958875,5.553210866523024e-05,0.8571428571428571
6612,6612,조국/Noun,21,18,3,0.0002222963209958875,5.553210866523024e-05,0.8571428571428571
6613,6613,장동민/Noun,21,18,3,0.0002222963209958875,5.553210866523024e-05,0.8571428571428571
6614,6614,하모니/Noun,21,18,3,0.0002222963209958875,5.553210866523024e-05,0.8571428571428571
6615,6615,장황하다/Adjective,21,3,18,5.5574080248971876e-05,0.00022212843466092096,0.8571428571428571
6616,6616,진실하다/Adjective,21,18,3,0.0002222963209958875,5.553210866523024e-05,0.8571428571428571
6617,6617,하트/Noun,21,18,3,0.0002222963209958875,5.553210866523024e-05,0.8571428571428571
6618,6618,둔갑/Noun,21,3,18,5.5574080248971876e-05,0.00022212843466092096,0.8571428571428571
6619,6619,꾀/Noun,21,18,3,0.0002222963209958875,5.553210866523024e-05,0.8571428571428571
6620,6620,끼들/Adverb,21,3,18,5.5574080248971876e-05,0.00022212843466092096,0.8571428571428571
6621,6621,으로부터/Josa,21,18,3,0.0002222963209958875,5.553210866523024e-05,0.8571428571428571
6622,6622,강원도/Noun,21,3,18,5.5574080248971876e-05,0.00022212843466092096,0.8571428571428571
6623,6623,한층/Noun,21,18,3,0.0002222963209958875,5.553210866523024e-05,0.8571428571428571
6624,6624,마스터피스/Noun,21,18,3,0.0002222963209958875,5.553210866523024e-05,0.8571428571428571
6625,6625,굵다/Adjective,21,17,4,0.00021118150494609317,6.663853039827628e-05,0.8095238095238095
6626,6626,하다못해/Adverb,21,4,17,6.668889629876625e-05,0.0002110220129278749,0.8095238095238095
6627,6627,방지/Noun,21,4,17,6.668889629876625e-05,0.0002110220129278749,0.8095238095238095
6628,6628,가다가/Noun,21,4,17,6.668889629876625e-05,0.0002110220129278749,0.8095238095238095
6629,6629,범작/Noun,21,4,17,6.668889629876625e-05,0.0002110220129278749,0.8095238095238095
6630,6630,시원시원하다/Adjective,21,17,4,0.00021118150494609317,6.663853039827628e-05,0.8095238095238095
6631,6631,어쩌구/Noun,21,4,17,6.668889629876625e-05,0.0002110220129278749,0.8095238095238095
6632,6632,오오오/Noun,21,17,4,0.00021118150494609317,6.663853039827628e-05,0.8095238095238095
6633,6633,눈살/Noun,21,4,17,6.668889629876625e-05,0.0002110220129278749,0.8095238095238095
6634,6634,미셸/Noun,21,17,4,0.00021118150494609317,6.663853039827628e-05,0.8095238095238095
6635,6635,줄라/Noun,21,4,17,6.668889629876625e-05,0.0002110220129278749,0.8095238095238095
6636,6636,편향/Noun,21,4,17,6.668889629876625e-05,0.0002110220129278749,0.8095238095238095
6637,6637,긴장도/Noun,21,4,17,6.668889629876625e-05,0.0002110220129278749,0.8095238095238095
6638,6638,동떨어지다/Adjective,21,4,17,6.668889629876625e-05,0.0002110220129278749,0.8095238095238095
6639,6639,뚝/Noun,21,5,16,7.780371234856063e-05,0.00019991559119482882,0.7619047619047619
6640,6640,트루/Noun,21,5,16,7.780371234856063e-05,0.00019991559119482882,0.7619047619047619
6641,6641,재림/Noun,21,5,16,7.780371234856063e-05,0.00019991559119482882,0.7619047619047619
6642,6642,레즈/Noun,21,5,16,7.780371234856063e-05,0.00019991559119482882,0.7619047619047619
6643,6643,오죽하다/Adjective,21,5,16,7.780371234856063e-05,0.00019991559119482882,0.7619047619047619
6644,6644,파도/Noun,21,16,5,0.0002000666888962988,7.774495213132233e-05,0.7619047619047619
6645,6645,젖/Noun,21,5,16,7.780371234856063e-05,0.00019991559119482882,0.7619047619047619
6646,6646,결여/Noun,21,5,16,7.780371234856063e-05,0.00019991559119482882,0.7619047619047619
6647,6647,절때/Noun,21,5,16,7.780371234856063e-05,0.00019991559119482882,0.7619047619047619
6648,6648,“/Foreign,21,5,16,7.780371234856063e-05,0.00019991559119482882,0.7619047619047619
6649,6649,콩가루/Noun,21,5,16,7.780371234856063e-05,0.00019991559119482882,0.7619047619047619
6650,6650,쌩뚱맞/Noun,21,5,16,7.780371234856063e-05,0.00019991559119482882,0.7619047619047619
6651,6651,댄서/Noun,21,5,16,7.780371234856063e-05,0.00019991559119482882,0.7619047619047619
6652,6652,느님/Noun,21,16,5,0.0002000666888962988,7.774495213132233e-05,0.7619047619047619
6653,6653,짚다/Verb,21,15,6,0.00018895187284650438,8.885137386436837e-05,0.7142857142857143
6654,6654,인용/Noun,21,6,15,8.891852839835501e-05,0.0001888091694617828,0.7142857142857143
6655,6655,음모론/Noun,21,6,15,8.891852839835501e-05,0.0001888091694617828,0.7142857142857143
6656,6656,!!!!!!!!!!!/Punctuation,21,15,6,0.00018895187284650438,8.885137386436837e-05,0.7142857142857143
6657,6657,재연/Noun,21,6,15,8.891852839835501e-05,0.0001888091694617828,0.7142857142857143
6658,6658,작고/Noun,21,6,15,8.891852839835501e-05,0.0001888091694617828,0.7142857142857143
6659,6659,대서/Noun,21,6,15,8.891852839835501e-05,0.0001888091694617828,0.7142857142857143
6660,6660,걸음/Noun,21,15,6,0.00018895187284650438,8.885137386436837e-05,0.7142857142857143
6661,6661,지향/Noun,21,6,15,8.891852839835501e-05,0.0001888091694617828,0.7142857142857143
6662,6662,보람/Noun,21,15,6,0.00018895187284650438,8.885137386436837e-05,0.7142857142857143
6663,6663,강우석/Noun,21,6,15,8.891852839835501e-05,0.0001888091694617828,0.7142857142857143
6664,6664,일진/Noun,21,6,15,8.891852839835501e-05,0.0001888091694617828,0.7142857142857143
6665,6665,금도/Noun,21,15,6,0.00018895187284650438,8.885137386436837e-05,0.7142857142857143
6666,6666,다짐/Noun,21,15,6,0.00018895187284650438,8.885137386436837e-05,0.7142857142857143
6667,6667,화재/Noun,21,6,15,8.891852839835501e-05,0.0001888091694617828,0.7142857142857143
6668,6668,ㅇㅋ/KoreanParticle,21,6,15,8.891852839835501e-05,0.0001888091694617828,0.7142857142857143
6669,6669,명분/Noun,21,6,15,8.891852839835501e-05,0.0001888091694617828,0.7142857142857143
6670,6670,영애/Noun,21,15,6,0.00018895187284650438,8.885137386436837e-05,0.7142857142857143
6671,6671,무었/Noun,21,15,6,0.00018895187284650438,8.885137386436837e-05,0.7142857142857143
6672,6672,에이미/Noun,21,14,7,0.00017783705679671002,9.995779559741441e-05,0.6666666666666666
6673,6673,악녀/Noun,21,7,14,0.0001000333444481494,0.00017770274772873674,0.6666666666666666
6674,6674,싱어/Noun,21,14,7,0.00017783705679671002,9.995779559741441e-05,0.6666666666666666
6675,6675,수능/Noun,21,14,7,0.00017783705679671002,9.995779559741441e-05,0.6666666666666666
6676,6676,시가/Noun,21,14,7,0.00017783705679671002,9.995779559741441e-05,0.6666666666666666
6677,6677,괴담/Noun,21,7,14,0.0001000333444481494,0.00017770274772873674,0.6666666666666666
6678,6678,일제/Noun,21,7,14,0.0001000333444481494,0.00017770274772873674,0.6666666666666666
6679,6679,****/Punctuation,21,14,7,0.00017783705679671002,9.995779559741441e-05,0.6666666666666666
6680,6680,푸하하하/Noun,21,7,14,0.0001000333444481494,0.00017770274772873674,0.6666666666666666
6681,6681,재수/Noun,21,7,14,0.0001000333444481494,0.00017770274772873674,0.6666666666666666
6682,6682,김민준/Noun,21,7,14,0.0001000333444481494,0.00017770274772873674,0.6666666666666666
6683,6683,둘이서/Noun,21,7,14,0.0001000333444481494,0.00017770274772873674,0.6666666666666666
6684,6684,핸드/Noun,21,7,14,0.0001000333444481494,0.00017770274772873674,0.6666666666666666
6685,6685,제격/Noun,21,14,7,0.00017783705679671002,9.995779559741441e-05,0.6666666666666666
6686,6686,정녕/Noun,21,7,14,0.0001000333444481494,0.00017770274772873674,0.6666666666666666
6687,6687,을해/Noun,21,7,14,0.0001000333444481494,0.00017770274772873674,0.6666666666666666
6688,6688,근대/Noun,21,14,7,0.00017783705679671002,9.995779559741441e-05,0.6666666666666666
6689,6689,쑤다/Verb,21,7,14,0.0001000333444481494,0.00017770274772873674,0.6666666666666666
6690,6690,동경/Noun,21,14,7,0.00017783705679671002,9.995779559741441e-05,0.6666666666666666
6691,6691,사업/Noun,21,7,14,0.0001000333444481494,0.00017770274772873674,0.6666666666666666
6692,6692,베토벤/Noun,21,14,7,0.00017783705679671002,9.995779559741441e-05,0.6666666666666666
6693,6693,런/Noun,21,14,7,0.00017783705679671002,9.995779559741441e-05,0.6666666666666666
6694,6694,넘버/Noun,21,14,7,0.00017783705679671002,9.995779559741441e-05,0.6666666666666666
6695,6695,댓글달다/Verb,21,7,14,0.0001000333444481494,0.00017770274772873674,0.6666666666666666
6696,6696,차기작/Noun,21,14,7,0.00017783705679671002,9.995779559741441e-05,0.6666666666666666
6697,6697,훅/Noun,21,7,14,0.0001000333444481494,0.00017770274772873674,0.6666666666666666
6698,6698,주요/Modifier,21,7,14,0.0001000333444481494,0.00017770274772873674,0.6666666666666666
6699,6699,나래/Noun,21,7,14,0.0001000333444481494,0.00017770274772873674,0.6666666666666666
6700,6700,한결같다/Adjective,21,7,14,0.0001000333444481494,0.00017770274772873674,0.6666666666666666
6701,6701,연평해전/Noun,21,7,14,0.0001000333444481494,0.00017770274772873674,0.6666666666666666
6702,6702,잊어버리다/Verb,21,14,7,0.00017783705679671002,9.995779559741441e-05,0.6666666666666666
6703,6703,어이없이/Adverb,21,7,14,0.0001000333444481494,0.00017770274772873674,0.6666666666666666
6704,6704,쿠엔틴/Noun,21,13,8,0.00016672224074691566,0.00011106421733046048,0.6190476190476191
6705,6705,염정아/Noun,21,13,8,0.00016672224074691566,0.00011106421733046048,0.6190476190476191
6706,6706,오드리/Noun,21,13,8,0.00016672224074691566,0.00011106421733046048,0.6190476190476191
6707,6707,빨르다/Adjective,21,8,13,0.00011114816049794375,0.0001665963259956907,0.6190476190476191
6708,6708,테마/Noun,21,8,13,0.00011114816049794375,0.0001665963259956907,0.6190476190476191
6709,6709,문소리/Noun,21,13,8,0.00016672224074691566,0.00011106421733046048,0.6190476190476191
6710,6710,소녀시대/Noun,21,8,13,0.00011114816049794375,0.0001665963259956907,0.6190476190476191
6711,6711,상도/Noun,21,13,8,0.00016672224074691566,0.00011106421733046048,0.6190476190476191
6712,6712,똥꼬/Noun,21,8,13,0.00011114816049794375,0.0001665963259956907,0.6190476190476191
6713,6713,백프로/Noun,21,8,13,0.00011114816049794375,0.0001665963259956907,0.6190476190476191
6714,6714,................./Punctuation,21,8,13,0.00011114816049794375,0.0001665963259956907,0.6190476190476191
6715,6715,not/Alpha,21,13,8,0.00016672224074691566,0.00011106421733046048,0.6190476190476191
6716,6716,리프/Noun,21,8,13,0.00011114816049794375,0.0001665963259956907,0.6190476190476191
6717,6717,식구/Noun,21,8,13,0.00011114816049794375,0.0001665963259956907,0.6190476190476191
6718,6718,대들다/Verb,21,8,13,0.00011114816049794375,0.0001665963259956907,0.6190476190476191
6719,6719,이제훈/Noun,21,13,8,0.00016672224074691566,0.00011106421733046048,0.6190476190476191
6720,6720,냥/Noun,21,8,13,0.00011114816049794375,0.0001665963259956907,0.6190476190476191
6721,6721,벨루치/Noun,21,8,13,0.00011114816049794375,0.0001665963259956907,0.6190476190476191
6722,6722,호주/Noun,21,8,13,0.00011114816049794375,0.0001665963259956907,0.6190476190476191
6723,6723,여군/Noun,21,8,13,0.00011114816049794375,0.0001665963259956907,0.6190476190476191
6724,6724,눈앞/Noun,21,13,8,0.00016672224074691566,0.00011106421733046048,0.6190476190476191
6725,6725,교도소/Noun,21,8,13,0.00011114816049794375,0.0001665963259956907,0.6190476190476191
6726,6726,힘없다/Adjective,21,12,9,0.00015560742469712126,0.00012217063906350652,0.5714285714285714
6727,6727,거구/Noun,21,12,9,0.00015560742469712126,0.00012217063906350652,0.5714285714285714
6728,6728,삼박자/Noun,21,12,9,0.00015560742469712126,0.00012217063906350652,0.5714285714285714
6729,6729,러시/Noun,21,12,9,0.00015560742469712126,0.00012217063906350652,0.5714285714285714
6730,6730,마모루/Noun,21,9,12,0.00012226297654773814,0.00015548990426264466,0.5714285714285714
6731,6731,박스오피스/Noun,21,9,12,0.00012226297654773814,0.00015548990426264466,0.5714285714285714
6732,6732,찍기/Noun,21,9,12,0.00012226297654773814,0.00015548990426264466,0.5714285714285714
6733,6733,마스터/Noun,21,12,9,0.00015560742469712126,0.00012217063906350652,0.5714285714285714
6734,6734,백/Suffix,21,12,9,0.00015560742469712126,0.00012217063906350652,0.5714285714285714
6735,6735,만이라도/Josa,21,12,9,0.00015560742469712126,0.00012217063906350652,0.5714285714285714
6736,6736,범벅/Noun,21,12,9,0.00015560742469712126,0.00012217063906350652,0.5714285714285714
6737,6737,룰/Noun,21,9,12,0.00012226297654773814,0.00015548990426264466,0.5714285714285714
6738,6738,발칙하다/Adjective,21,12,9,0.00015560742469712126,0.00012217063906350652,0.5714285714285714
6739,6739,억/Noun,21,9,12,0.00012226297654773814,0.00015548990426264466,0.5714285714285714
6740,6740,깜짝깜짝/Adverb,21,9,12,0.00012226297654773814,0.00015548990426264466,0.5714285714285714
6741,6741,카메오/Noun,21,9,12,0.00012226297654773814,0.00015548990426264466,0.5714285714285714
6742,6742,매체/Noun,21,12,9,0.00015560742469712126,0.00012217063906350652,0.5714285714285714
6743,6743,시퀀스/Noun,21,12,9,0.00015560742469712126,0.00012217063906350652,0.5714285714285714
6744,6744,스케/Noun,21,12,9,0.00015560742469712126,0.00012217063906350652,0.5714285714285714
6745,6745,쌍벽/Noun,21,9,12,0.00012226297654773814,0.00015548990426264466,0.5714285714285714
6746,6746,바비/Noun,21,12,9,0.00015560742469712126,0.00012217063906350652,0.5714285714285714
6747,6747,뭉치다/Verb,21,9,12,0.00012226297654773814,0.00015548990426264466,0.5714285714285714
6748,6748,오씨/Noun,21,9,12,0.00012226297654773814,0.00015548990426264466,0.5714285714285714
6749,6749,BGM/Alpha,21,12,9,0.00015560742469712126,0.00012217063906350652,0.5714285714285714
6750,6750,히틀러/Noun,21,12,9,0.00015560742469712126,0.00012217063906350652,0.5714285714285714
6751,6751,패배/Noun,21,12,9,0.00015560742469712126,0.00012217063906350652,0.5714285714285714
6752,6752,각심/Noun,21,12,9,0.00015560742469712126,0.00012217063906350652,0.5714285714285714
6753,6753,친척/Noun,21,9,12,0.00012226297654773814,0.00015548990426264466,0.5714285714285714
6754,6754,2분/Number,21,9,12,0.00012226297654773814,0.00015548990426264466,0.5714285714285714
6755,6755,유대인/Noun,21,12,9,0.00015560742469712126,0.00012217063906350652,0.5714285714285714
6756,6756,남상미/Noun,21,9,12,0.00012226297654773814,0.00015548990426264466,0.5714285714285714
6757,6757,모자이크/Noun,21,9,12,0.00012226297654773814,0.00015548990426264466,0.5714285714285714
6758,6758,메카/Noun,21,11,10,0.0001444926086473269,0.00013327706079655256,0.5238095238095238
6759,6759,조안/Noun,21,11,10,0.0001444926086473269,0.00013327706079655256,0.5238095238095238
6760,6760,정준호/Noun,21,10,11,0.0001333777925975325,0.0001443834825295986,0.5238095238095238
6761,6761,퍼센트/Noun,21,11,10,0.0001444926086473269,0.00013327706079655256,0.5238095238095238
6762,6762,워쇼스키/Noun,21,11,10,0.0001444926086473269,0.00013327706079655256,0.5238095238095238
6763,6763,전두환/Noun,21,10,11,0.0001333777925975325,0.0001443834825295986,0.5238095238095238
6764,6764,따라잡다/Verb,21,10,11,0.0001333777925975325,0.0001443834825295986,0.5238095238095238
6765,6765,타임머신/Noun,21,11,10,0.0001444926086473269,0.00013327706079655256,0.5238095238095238
6766,6766,그레이/Noun,21,11,10,0.0001444926086473269,0.00013327706079655256,0.5238095238095238
6767,6767,루시/Noun,21,10,11,0.0001333777925975325,0.0001443834825295986,0.5238095238095238
6768,6768,안내/Noun,21,10,11,0.0001333777925975325,0.0001443834825295986,0.5238095238095238
6769,6769,정치인/Noun,21,11,10,0.0001444926086473269,0.00013327706079655256,0.5238095238095238
6770,6770,욱/Noun,21,10,11,0.0001333777925975325,0.0001443834825295986,0.5238095238095238
6771,6771,중점/Noun,21,10,11,0.0001333777925975325,0.0001443834825295986,0.5238095238095238
6772,6772,그다음/Noun,21,11,10,0.0001444926086473269,0.00013327706079655256,0.5238095238095238
6773,6773,배틀/Noun,21,11,10,0.0001444926086473269,0.00013327706079655256,0.5238095238095238
6774,6774,팍/Noun,21,11,10,0.0001444926086473269,0.00013327706079655256,0.5238095238095238
6775,6775,...)/Punctuation,21,11,10,0.0001444926086473269,0.00013327706079655256,0.5238095238095238
6776,6776,연발/Noun,21,11,10,0.0001444926086473269,0.00013327706079655256,0.5238095238095238
6777,6777,기업/Noun,21,11,10,0.0001444926086473269,0.00013327706079655256,0.5238095238095238
6778,6778,으로서의/Josa,21,11,10,0.0001444926086473269,0.00013327706079655256,0.5238095238095238
6779,6779,극영화/Noun,21,10,11,0.0001333777925975325,0.0001443834825295986,0.5238095238095238
6780,6780,강남/Noun,21,10,11,0.0001333777925975325,0.0001443834825295986,0.5238095238095238
6781,6781,뮤지컬영화/Noun,21,11,10,0.0001444926086473269,0.00013327706079655256,0.5238095238095238
6782,6782,아파트/Noun,21,10,11,0.0001333777925975325,0.0001443834825295986,0.5238095238095238
6783,6783,..)/Punctuation,21,11,10,0.0001444926086473269,0.00013327706079655256,0.5238095238095238
6784,6784,로부터/Noun,21,10,11,0.0001333777925975325,0.0001443834825295986,0.5238095238095238
6785,6785,팩트/Noun,21,11,10,0.0001444926086473269,0.00013327706079655256,0.5238095238095238
6786,6786,우승/Noun,21,10,11,0.0001333777925975325,0.0001443834825295986,0.5238095238095238
6787,6787,낭패/Noun,20,0,20,2.2229632099588756e-05,0.00024434127812701304,1.0
6788,6788,낚시질/Noun,20,0,20,2.2229632099588756e-05,0.00024434127812701304,1.0
6789,6789,GOOD/Alpha,20,19,1,0.0002334111370456819,3.331926519913814e-05,0.95
6790,6790,맛없다/Adjective,20,1,19,3.334444814938313e-05,0.000233234856393967,0.95
6791,6791,자연스레/Adverb,20,19,1,0.0002334111370456819,3.331926519913814e-05,0.95
6792,6792,^^~/Punctuation,20,19,1,0.0002334111370456819,3.331926519913814e-05,0.95
6793,6793,우기다/Verb,20,1,19,3.334444814938313e-05,0.000233234856393967,0.95
6794,6794,어따/Exclamation,20,1,19,3.334444814938313e-05,0.000233234856393967,0.95
6795,6795,잔치/Noun,20,1,19,3.334444814938313e-05,0.000233234856393967,0.95
6796,6796,무미건조하다/Adjective,20,1,19,3.334444814938313e-05,0.000233234856393967,0.95
6797,6797,꽉차다/Verb,20,18,2,0.0002222963209958875,4.4425686932184186e-05,0.9
6798,6798,기한/Noun,20,2,18,4.445926419917751e-05,0.00022212843466092096,0.9
6799,6799,뷁/Noun,20,2,18,4.445926419917751e-05,0.00022212843466092096,0.9
6800,6800,보다/Foreign,20,2,18,4.445926419917751e-05,0.00022212843466092096,0.9
6801,6801,노소/Noun,20,18,2,0.0002222963209958875,4.4425686932184186e-05,0.9
6802,6802,한구석/Noun,20,18,2,0.0002222963209958875,4.4425686932184186e-05,0.9
6803,6803,유년/Noun,20,18,2,0.0002222963209958875,4.4425686932184186e-05,0.9
6804,6804,mc/Alpha,20,2,18,4.445926419917751e-05,0.00022212843466092096,0.9
6805,6805,양키/Noun,20,2,18,4.445926419917751e-05,0.00022212843466092096,0.9
6806,6806,미워하다/Adjective,20,17,3,0.00021118150494609317,5.553210866523024e-05,0.85
6807,6807,고추/Noun,20,3,17,5.5574080248971876e-05,0.0002110220129278749,0.85
6808,6808,박진영/Noun,20,3,17,5.5574080248971876e-05,0.0002110220129278749,0.85
6809,6809,>_</Punctuation,20,17,3,0.00021118150494609317,5.553210866523024e-05,0.85
6810,6810,자국/Noun,20,3,17,5.5574080248971876e-05,0.0002110220129278749,0.85
6811,6811,쫄깃/Noun,20,17,3,0.00021118150494609317,5.553210866523024e-05,0.85
6812,6812,테일러/Noun,20,17,3,0.00021118150494609317,5.553210866523024e-05,0.85
6813,6813,명백하다/Adjective,20,3,17,5.5574080248971876e-05,0.0002110220129278749,0.85
6814,6814,드릅/Noun,20,3,17,5.5574080248971876e-05,0.0002110220129278749,0.85
6815,6815,탈락/Noun,20,3,17,5.5574080248971876e-05,0.0002110220129278749,0.85
6816,6816,나위/Noun,20,17,3,0.00021118150494609317,5.553210866523024e-05,0.85
6817,6817,삼천포/Noun,20,3,17,5.5574080248971876e-05,0.0002110220129278749,0.85
6818,6818,섹/Noun,20,3,17,5.5574080248971876e-05,0.0002110220129278749,0.85
6819,6819,...;/Punctuation,20,3,17,5.5574080248971876e-05,0.0002110220129278749,0.85
6820,6820,떨구다/Verb,20,3,17,5.5574080248971876e-05,0.0002110220129278749,0.85
6821,6821,마더/Noun,20,17,3,0.00021118150494609317,5.553210866523024e-05,0.85
6822,6822,It/Alpha,20,17,3,0.00021118150494609317,5.553210866523024e-05,0.85
6823,6823,생동감/Noun,20,16,4,0.0002000666888962988,6.663853039827628e-05,0.8
6824,6824,CF/Alpha,20,4,16,6.668889629876625e-05,0.00019991559119482882,0.8
6825,6825,더러/Noun,20,4,16,6.668889629876625e-05,0.00019991559119482882,0.8
6826,6826,친일파/Noun,20,4,16,6.668889629876625e-05,0.00019991559119482882,0.8
6827,6827,쫓기다/Verb,20,4,16,6.668889629876625e-05,0.00019991559119482882,0.8
6828,6828,부진하다/Adjective,20,4,16,6.668889629876625e-05,0.00019991559119482882,0.8
6829,6829,교묘하다/Adjective,20,4,16,6.668889629876625e-05,0.00019991559119482882,0.8
6830,6830,우물/Noun,20,4,16,6.668889629876625e-05,0.00019991559119482882,0.8
6831,6831,읍니/Noun,20,16,4,0.0002000666888962988,6.663853039827628e-05,0.8
6832,6832,허비하다/Adjective,20,4,16,6.668889629876625e-05,0.00019991559119482882,0.8
6833,6833,수식어/Noun,20,16,4,0.0002000666888962988,6.663853039827628e-05,0.8
6834,6834,기름/Noun,20,4,16,6.668889629876625e-05,0.00019991559119482882,0.8
6835,6835,박용우/Noun,20,16,4,0.0002000666888962988,6.663853039827628e-05,0.8
6836,6836,나하/Noun,20,4,16,6.668889629876625e-05,0.00019991559119482882,0.8
6837,6837,람사/Noun,20,16,4,0.0002000666888962988,6.663853039827628e-05,0.8
6838,6838,앞두다/Verb,20,16,4,0.0002000666888962988,6.663853039827628e-05,0.8
6839,6839,서글프다/Adjective,20,16,4,0.0002000666888962988,6.663853039827628e-05,0.8
6840,6840,학적/Noun,20,4,16,6.668889629876625e-05,0.00019991559119482882,0.8
6841,6841,월요일/Noun,20,16,4,0.0002000666888962988,6.663853039827628e-05,0.8
6842,6842,프랭크/Noun,20,16,4,0.0002000666888962988,6.663853039827628e-05,0.8
6843,6843,총기/Noun,20,15,5,0.00018895187284650438,7.774495213132233e-05,0.75
6844,6844,시계/Noun,20,5,15,7.780371234856063e-05,0.0001888091694617828,0.75
6845,6845,소리내다/Verb,20,15,5,0.00018895187284650438,7.774495213132233e-05,0.75
6846,6846,머리카락/Noun,20,5,15,7.780371234856063e-05,0.0001888091694617828,0.75
6847,6847,가르침/Noun,20,15,5,0.00018895187284650438,7.774495213132233e-05,0.75
6848,6848,짜장면/Noun,20,5,15,7.780371234856063e-05,0.0001888091694617828,0.75
6849,6849,여사/Noun,20,15,5,0.00018895187284650438,7.774495213132233e-05,0.75
6850,6850,합작/Noun,20,5,15,7.780371234856063e-05,0.0001888091694617828,0.75
6851,6851,무심코/Noun,20,15,5,0.00018895187284650438,7.774495213132233e-05,0.75
6852,6852,전무후무/Noun,20,15,5,0.00018895187284650438,7.774495213132233e-05,0.75
6853,6853,시달리다/Verb,20,5,15,7.780371234856063e-05,0.0001888091694617828,0.75
6854,6854,관해/Noun,20,15,5,0.00018895187284650438,7.774495213132233e-05,0.75
6855,6855,ever/Alpha,20,15,5,0.00018895187284650438,7.774495213132233e-05,0.75
6856,6856,얄밉다/Adjective,20,15,5,0.00018895187284650438,7.774495213132233e-05,0.75
6857,6857,오만하다/Adjective,20,5,15,7.780371234856063e-05,0.0001888091694617828,0.75
6858,6858,노릇/Noun,20,5,15,7.780371234856063e-05,0.0001888091694617828,0.75
6859,6859,경상도/Noun,20,5,15,7.780371234856063e-05,0.0001888091694617828,0.75
6860,6860,학대/Noun,20,5,15,7.780371234856063e-05,0.0001888091694617828,0.75
6861,6861,.~/Punctuation,20,15,5,0.00018895187284650438,7.774495213132233e-05,0.75
6862,6862,연예/Noun,20,5,15,7.780371234856063e-05,0.0001888091694617828,0.75
6863,6863,세금/Noun,20,5,15,7.780371234856063e-05,0.0001888091694617828,0.75
6864,6864,순정만화/Noun,20,5,15,7.780371234856063e-05,0.0001888091694617828,0.75
6865,6865,이로/Noun,20,14,6,0.00017783705679671002,8.885137386436837e-05,0.7
6866,6866,몰려오다/Verb,20,6,14,8.891852839835501e-05,0.00017770274772873674,0.7
6867,6867,벨라/Noun,20,6,14,8.891852839835501e-05,0.00017770274772873674,0.7
6868,6868,번하다/Adjective,20,6,14,8.891852839835501e-05,0.00017770274772873674,0.7
6869,6869,폰부스/Noun,20,6,14,8.891852839835501e-05,0.00017770274772873674,0.7
6870,6870,유희/Noun,20,14,6,0.00017783705679671002,8.885137386436837e-05,0.7
6871,6871,잡스/Noun,20,6,14,8.891852839835501e-05,0.00017770274772873674,0.7
6872,6872,쿵푸/Noun,20,6,14,8.891852839835501e-05,0.00017770274772873674,0.7
6873,6873,사토시/Noun,20,14,6,0.00017783705679671002,8.885137386436837e-05,0.7
6874,6874,무성영화/Noun,20,14,6,0.00017783705679671002,8.885137386436837e-05,0.7
6875,6875,인데/Foreign,20,6,14,8.891852839835501e-05,0.00017770274772873674,0.7
6876,6876,안에/Foreign,20,6,14,8.891852839835501e-05,0.00017770274772873674,0.7
6877,6877,리플/Noun,20,6,14,8.891852839835501e-05,0.00017770274772873674,0.7
6878,6878,신비하다/Adjective,20,14,6,0.00017783705679671002,8.885137386436837e-05,0.7
6879,6879,켈리/Noun,20,14,6,0.00017783705679671002,8.885137386436837e-05,0.7
6880,6880,페미니즘/Noun,20,6,14,8.891852839835501e-05,0.00017770274772873674,0.7
6881,6881,몰아치다/Verb,20,14,6,0.00017783705679671002,8.885137386436837e-05,0.7
6882,6882,티라노/Noun,20,6,14,8.891852839835501e-05,0.00017770274772873674,0.7
6883,6883,다섯손가락/Noun,20,14,6,0.00017783705679671002,8.885137386436837e-05,0.7
6884,6884,SM/Alpha,20,6,14,8.891852839835501e-05,0.00017770274772873674,0.7
6885,6885,서툴다/Adjective,20,14,6,0.00017783705679671002,8.885137386436837e-05,0.7
6886,6886,불멸/Noun,20,14,6,0.00017783705679671002,8.885137386436837e-05,0.7
6887,6887,은애/Noun,20,6,14,8.891852839835501e-05,0.00017770274772873674,0.7
6888,6888,허각/Noun,20,14,6,0.00017783705679671002,8.885137386436837e-05,0.7
6889,6889,원망/Noun,20,6,14,8.891852839835501e-05,0.00017770274772873674,0.7
6890,6890,송새벽/Noun,20,6,14,8.891852839835501e-05,0.00017770274772873674,0.7
6891,6891,울부짖다/Verb,20,14,6,0.00017783705679671002,8.885137386436837e-05,0.7
6892,6892,꽁/Adverb,20,6,14,8.891852839835501e-05,0.00017770274772873674,0.7
6893,6893,한치/Noun,20,6,14,8.891852839835501e-05,0.00017770274772873674,0.7
6894,6894,즈음/Noun,20,14,6,0.00017783705679671002,8.885137386436837e-05,0.7
6895,6895,pd/Alpha,20,6,14,8.891852839835501e-05,0.00017770274772873674,0.7
6896,6896,마돈나/Noun,20,6,14,8.891852839835501e-05,0.00017770274772873674,0.7
6897,6897,스티/Noun,20,7,13,0.0001000333444481494,0.0001665963259956907,0.65
6898,6898,김주혁/Noun,20,13,7,0.00016672224074691566,9.995779559741441e-05,0.65
6899,6899,고함/Noun,20,7,13,0.0001000333444481494,0.0001665963259956907,0.65
6900,6900,밸런스/Noun,20,7,13,0.0001000333444481494,0.0001665963259956907,0.65
6901,6901,판도/Noun,20,13,7,0.00016672224074691566,9.995779559741441e-05,0.65
6902,6902,연대기/Noun,20,13,7,0.00016672224074691566,9.995779559741441e-05,0.65
6903,6903,신들/Noun,20,7,13,0.0001000333444481494,0.0001665963259956907,0.65
6904,6904,소라/Noun,20,7,13,0.0001000333444481494,0.0001665963259956907,0.65
6905,6905,어스/Noun,20,13,7,0.00016672224074691566,9.995779559741441e-05,0.65
6906,6906,모범/Noun,20,13,7,0.00016672224074691566,9.995779559741441e-05,0.65
6907,6907,부각시키다/Verb,20,7,13,0.0001000333444481494,0.0001665963259956907,0.65
6908,6908,다우니/Noun,20,13,7,0.00016672224074691566,9.995779559741441e-05,0.65
6909,6909,탐험/Noun,20,7,13,0.0001000333444481494,0.0001665963259956907,0.65
6910,6910,대다수/Noun,20,7,13,0.0001000333444481494,0.0001665963259956907,0.65
6911,6911,이크/Noun,20,7,13,0.0001000333444481494,0.0001665963259956907,0.65
6912,6912,대중성/Noun,20,7,13,0.0001000333444481494,0.0001665963259956907,0.65
6913,6913,부천/Noun,20,13,7,0.00016672224074691566,9.995779559741441e-05,0.65
6914,6914,13일/Number,20,7,13,0.0001000333444481494,0.0001665963259956907,0.65
6915,6915,김창완/Noun,20,7,13,0.0001000333444481494,0.0001665963259956907,0.65
6916,6916,미지/Noun,20,13,7,0.00016672224074691566,9.995779559741441e-05,0.65
6917,6917,탐정/Noun,20,7,13,0.0001000333444481494,0.0001665963259956907,0.65
6918,6918,아이템/Noun,20,7,13,0.0001000333444481494,0.0001665963259956907,0.65
6919,6919,존트라볼타/Noun,20,13,7,0.00016672224074691566,9.995779559741441e-05,0.65
6920,6920,류승완/Noun,20,8,12,0.00011114816049794375,0.00015548990426264466,0.6
6921,6921,甲/Foreign,20,12,8,0.00015560742469712126,0.00011106421733046048,0.6
6922,6922,사람인/Noun,20,8,12,0.00011114816049794375,0.00015548990426264466,0.6
6923,6923,헤매다/Verb,20,8,12,0.00011114816049794375,0.00015548990426264466,0.6
6924,6924,주문/Noun,20,8,12,0.00011114816049794375,0.00015548990426264466,0.6
6925,6925,스웨덴/Noun,20,12,8,0.00015560742469712126,0.00011106421733046048,0.6
6926,6926,겄/Noun,20,8,12,0.00011114816049794375,0.00015548990426264466,0.6
6927,6927,존쿠삭/Noun,20,12,8,0.00015560742469712126,0.00011106421733046048,0.6
6928,6928,top/Alpha,20,12,8,0.00015560742469712126,0.00011106421733046048,0.6
6929,6929,고난/Noun,20,12,8,0.00015560742469712126,0.00011106421733046048,0.6
6930,6930,숫자/Noun,20,12,8,0.00015560742469712126,0.00011106421733046048,0.6
6931,6931,원스/Noun,20,12,8,0.00015560742469712126,0.00011106421733046048,0.6
6932,6932,록/Noun,20,12,8,0.00015560742469712126,0.00011106421733046048,0.6
6933,6933,비둘기/Noun,20,8,12,0.00011114816049794375,0.00015548990426264466,0.6
6934,6934,김옥빈/Noun,20,12,8,0.00015560742469712126,0.00011106421733046048,0.6
6935,6935,리처드/Noun,20,12,8,0.00015560742469712126,0.00011106421733046048,0.6
6936,6936,천년/Noun,20,12,8,0.00015560742469712126,0.00011106421733046048,0.6
6937,6937,김청기/Noun,20,8,12,0.00011114816049794375,0.00015548990426264466,0.6
6938,6938,아씨/Noun,20,8,12,0.00011114816049794375,0.00015548990426264466,0.6
6939,6939,고본/Noun,20,8,12,0.00011114816049794375,0.00015548990426264466,0.6
6940,6940,강예원/Noun,20,8,12,0.00011114816049794375,0.00015548990426264466,0.6
6941,6941,개운하다/Adjective,20,8,12,0.00011114816049794375,0.00015548990426264466,0.6
6942,6942,구속/Noun,20,8,12,0.00011114816049794375,0.00015548990426264466,0.6
6943,6943,네요/Eomi,20,12,8,0.00015560742469712126,0.00011106421733046048,0.6
6944,6944,up/Alpha,20,12,8,0.00015560742469712126,0.00011106421733046048,0.6
6945,6945,위협/Noun,20,8,12,0.00011114816049794375,0.00015548990426264466,0.6
6946,6946,담당/Noun,20,8,12,0.00011114816049794375,0.00015548990426264466,0.6
6947,6947,전체관람가/Noun,20,8,12,0.00011114816049794375,0.00015548990426264466,0.6
6948,6948,익숙해지다/Verb,20,12,8,0.00015560742469712126,0.00011106421733046048,0.6
6949,6949,똘끼/Noun,20,9,11,0.00012226297654773814,0.0001443834825295986,0.55
6950,6950,고스트/Noun,20,9,11,0.00012226297654773814,0.0001443834825295986,0.55
6951,6951,살수/Noun,20,11,9,0.0001444926086473269,0.00012217063906350652,0.55
6952,6952,유코/Noun,20,11,9,0.0001444926086473269,0.00012217063906350652,0.55
6953,6953,낄낄/Noun,20,9,11,0.00012226297654773814,0.0001443834825295986,0.55
6954,6954,뮤비/Noun,20,9,11,0.00012226297654773814,0.0001443834825295986,0.55
6955,6955,장수/Noun,20,11,9,0.0001444926086473269,0.00012217063906350652,0.55
6956,6956,조진웅/Noun,20,11,9,0.0001444926086473269,0.00012217063906350652,0.55
6957,6957,1만/Number,20,11,9,0.0001444926086473269,0.00012217063906350652,0.55
6958,6958,라서/Noun,20,9,11,0.00012226297654773814,0.0001443834825295986,0.55
6959,6959,반항/Noun,20,9,11,0.00012226297654773814,0.0001443834825295986,0.55
6960,6960,강도/Noun,20,9,11,0.00012226297654773814,0.0001443834825295986,0.55
6961,6961,최종/Noun,20,9,11,0.00012226297654773814,0.0001443834825295986,0.55
6962,6962,낮아지다/Verb,20,11,9,0.0001444926086473269,0.00012217063906350652,0.55
6963,6963,생전/Noun,20,11,9,0.0001444926086473269,0.00012217063906350652,0.55
6964,6964,폴라/Noun,20,9,11,0.00012226297654773814,0.0001443834825295986,0.55
6965,6965,다양성/Noun,20,11,9,0.0001444926086473269,0.00012217063906350652,0.55
6966,6966,그중/Adverb,20,9,11,0.00012226297654773814,0.0001443834825295986,0.55
6967,6967,경고/Noun,20,11,9,0.0001444926086473269,0.00012217063906350652,0.55
6968,6968,믿어지다/Verb,20,11,9,0.0001444926086473269,0.00012217063906350652,0.55
6969,6969,오정세/Noun,20,11,9,0.0001444926086473269,0.00012217063906350652,0.55
6970,6970,다코타/Noun,20,11,9,0.0001444926086473269,0.00012217063906350652,0.55
6971,6971,비평/Noun,20,11,9,0.0001444926086473269,0.00012217063906350652,0.55
6972,6972,불행/Noun,20,11,9,0.0001444926086473269,0.00012217063906350652,0.55
6973,6973,플러스/Noun,20,9,11,0.00012226297654773814,0.0001443834825295986,0.55
6974,6974,은유/Noun,20,11,9,0.0001444926086473269,0.00012217063906350652,0.55
6975,6975,레벨/Noun,20,11,9,0.0001444926086473269,0.00012217063906350652,0.55
6976,6976,맥주/Noun,20,9,11,0.00012226297654773814,0.0001443834825295986,0.55
6977,6977,슌/Noun,20,11,9,0.0001444926086473269,0.00012217063906350652,0.55
6978,6978,괴수영화/Noun,20,11,9,0.0001444926086473269,0.00012217063906350652,0.55
6979,6979,수학/Noun,20,11,9,0.0001444926086473269,0.00012217063906350652,0.55
6980,6980,지방/Noun,20,11,9,0.0001444926086473269,0.00012217063906350652,0.55
6981,6981,느/Noun,20,11,9,0.0001444926086473269,0.00012217063906350652,0.55
6982,6982,비치다/Verb,20,9,11,0.00012226297654773814,0.0001443834825295986,0.55
6983,6983,일치/Noun,20,11,9,0.0001444926086473269,0.00012217063906350652,0.55
6984,6984,삼성/Noun,20,10,10,0.0001333777925975325,0.00013327706079655256,0.5
6985,6985,궁극/Noun,20,10,10,0.0001333777925975325,0.00013327706079655256,0.5
6986,6986,알맞다/Adjective,20,10,10,0.0001333777925975325,0.00013327706079655256,0.5
6987,6987,은행/Noun,20,10,10,0.0001333777925975325,0.00013327706079655256,0.5
6988,6988,양념/Noun,20,10,10,0.0001333777925975325,0.00013327706079655256,0.5
6989,6989,잠도/Noun,20,10,10,0.0001333777925975325,0.00013327706079655256,0.5
6990,6990,코넬/Noun,20,10,10,0.0001333777925975325,0.00013327706079655256,0.5
6991,6991,곽부성/Noun,20,10,10,0.0001333777925975325,0.00013327706079655256,0.5
6992,6992,동물농장/Noun,20,10,10,0.0001333777925975325,0.00013327706079655256,0.5
6993,6993,전후/Noun,20,10,10,0.0001333777925975325,0.00013327706079655256,0.5
6994,6994,퇴폐/Noun,20,10,10,0.0001333777925975325,0.00013327706079655256,0.5
6995,6995,백퍼/Noun,20,10,10,0.0001333777925975325,0.00013327706079655256,0.5
6996,6996,우승하다/Adjective,20,10,10,0.0001333777925975325,0.00013327706079655256,0.5
6997,6997,유재석/Noun,20,10,10,0.0001333777925975325,0.00013327706079655256,0.5
6998,6998,영점/Noun,19,0,19,2.2229632099588756e-05,0.000233234856393967,1.0
6999,6999,해롭다/Adjective,19,0,19,2.2229632099588756e-05,0.000233234856393967,1.0
7000,7000,맘에듬/Noun,19,19,0,0.0002334111370456819,2.2212843466092093e-05,1.0
7001,7001,쒸레기/Noun,19,0,19,2.2229632099588756e-05,0.000233234856393967,1.0
7002,7002,빼어나다/Adjective,19,18,1,0.0002222963209958875,3.331926519913814e-05,0.9473684210526316
7003,7003,발정/Noun,19,1,18,3.334444814938313e-05,0.00022212843466092096,0.9473684210526316
7004,7004,~~~^^/Punctuation,19,18,1,0.0002222963209958875,3.331926519913814e-05,0.9473684210526316
7005,7005,ㅆㄹㄱ/KoreanParticle,19,1,18,3.334444814938313e-05,0.00022212843466092096,0.9473684210526316
7006,7006,빈약/Noun,19,1,18,3.334444814938313e-05,0.00022212843466092096,0.9473684210526316
7007,7007,상쾌/Noun,19,18,1,0.0002222963209958875,3.331926519913814e-05,0.9473684210526316
7008,7008,짜증스럽다/Adjective,19,1,18,3.334444814938313e-05,0.00022212843466092096,0.9473684210526316
7009,7009,냉혹하다/Adjective,19,18,1,0.0002222963209958875,3.331926519913814e-05,0.9473684210526316
7010,7010,짜깁다/Verb,19,1,18,3.334444814938313e-05,0.00022212843466092096,0.9473684210526316
7011,7011,Ost/Alpha,19,18,1,0.0002222963209958875,3.331926519913814e-05,0.9473684210526316
7012,7012,재밌엇음/Noun,19,18,1,0.0002222963209958875,3.331926519913814e-05,0.9473684210526316
7013,7013,진전/Noun,19,1,18,3.334444814938313e-05,0.00022212843466092096,0.9473684210526316
7014,7014,발성/Noun,19,1,18,3.334444814938313e-05,0.00022212843466092096,0.9473684210526316
7015,7015,우웩/Noun,19,1,18,3.334444814938313e-05,0.00022212843466092096,0.9473684210526316
7016,7016,남다르다/Adjective,19,17,2,0.00021118150494609317,4.4425686932184186e-05,0.8947368421052632
7017,7017,최상/Noun,19,17,2,0.00021118150494609317,4.4425686932184186e-05,0.8947368421052632
7018,7018,80%/Number,19,2,17,4.445926419917751e-05,0.0002110220129278749,0.8947368421052632
7019,7019,9~10/Number,19,2,17,4.445926419917751e-05,0.0002110220129278749,0.8947368421052632
7020,7020,완소/Noun,19,17,2,0.00021118150494609317,4.4425686932184186e-05,0.8947368421052632
7021,7021,다인/Noun,19,2,17,4.445926419917751e-05,0.0002110220129278749,0.8947368421052632
7022,7022,생뚱맞/Noun,19,2,17,4.445926419917751e-05,0.0002110220129278749,0.8947368421052632
7023,7023,이글/Noun,19,2,17,4.445926419917751e-05,0.0002110220129278749,0.8947368421052632
7024,7024,툭툭/Noun,19,3,16,5.5574080248971876e-05,0.00019991559119482882,0.8421052631578947
7025,7025,실천/Noun,19,16,3,0.0002000666888962988,5.553210866523024e-05,0.8421052631578947
7026,7026,관우/Noun,19,3,16,5.5574080248971876e-05,0.00019991559119482882,0.8421052631578947
7027,7027,망정/Noun,19,3,16,5.5574080248971876e-05,0.00019991559119482882,0.8421052631578947
7028,7028,고질/Noun,19,3,16,5.5574080248971876e-05,0.00019991559119482882,0.8421052631578947
7029,7029,김혜선/Noun,19,3,16,5.5574080248971876e-05,0.00019991559119482882,0.8421052631578947
7030,7030,때로는/Noun,19,16,3,0.0002000666888962988,5.553210866523024e-05,0.8421052631578947
7031,7031,안중근/Noun,19,3,16,5.5574080248971876e-05,0.00019991559119482882,0.8421052631578947
7032,7032,호연/Noun,19,16,3,0.0002000666888962988,5.553210866523024e-05,0.8421052631578947
7033,7033,박시후/Noun,19,16,3,0.0002000666888962988,5.553210866523024e-05,0.8421052631578947
7034,7034,이쯤/Noun,19,3,16,5.5574080248971876e-05,0.00019991559119482882,0.8421052631578947
7035,7035,천천히/Adverb,19,16,3,0.0002000666888962988,5.553210866523024e-05,0.8421052631578947
7036,7036,애비/Noun,19,3,16,5.5574080248971876e-05,0.00019991559119482882,0.8421052631578947
7037,7037,알아듣다/Verb,19,3,16,5.5574080248971876e-05,0.00019991559119482882,0.8421052631578947
7038,7038,멜로디/Noun,19,15,4,0.00018895187284650438,6.663853039827628e-05,0.7894736842105263
7039,7039,지게/Noun,19,15,4,0.00018895187284650438,6.663853039827628e-05,0.7894736842105263
7040,7040,오래간만/Adverb,19,15,4,0.00018895187284650438,6.663853039827628e-05,0.7894736842105263
7041,7041,맴도/Noun,19,15,4,0.00018895187284650438,6.663853039827628e-05,0.7894736842105263
7042,7042,소스/Noun,19,4,15,6.668889629876625e-05,0.0001888091694617828,0.7894736842105263
7043,7043,................/Punctuation,19,4,15,6.668889629876625e-05,0.0001888091694617828,0.7894736842105263
7044,7044,수영/Noun,19,15,4,0.00018895187284650438,6.663853039827628e-05,0.7894736842105263
7045,7045,짝짝/Noun,19,15,4,0.00018895187284650438,6.663853039827628e-05,0.7894736842105263
7046,7046,”/Foreign,19,4,15,6.668889629876625e-05,0.0001888091694617828,0.7894736842105263
7047,7047,창의/Noun,19,15,4,0.00018895187284650438,6.663853039827628e-05,0.7894736842105263
7048,7048,액션연기/Noun,19,15,4,0.00018895187284650438,6.663853039827628e-05,0.7894736842105263
7049,7049,천/Noun,19,14,5,0.00017783705679671002,7.774495213132233e-05,0.7368421052631579
7050,7050,도의/Noun,19,14,5,0.00017783705679671002,7.774495213132233e-05,0.7368421052631579
7051,7051,추모/Noun,19,14,5,0.00017783705679671002,7.774495213132233e-05,0.7368421052631579
7052,7052,육/Modifier,19,5,14,7.780371234856063e-05,0.00017770274772873674,0.7368421052631579
7053,7053,제라드/Noun,19,14,5,0.00017783705679671002,7.774495213132233e-05,0.7368421052631579
7054,7054,자도/Noun,19,5,14,7.780371234856063e-05,0.00017770274772873674,0.7368421052631579
7055,7055,덩/Noun,19,5,14,7.780371234856063e-05,0.00017770274772873674,0.7368421052631579
7056,7056,슴가/Noun,19,5,14,7.780371234856063e-05,0.00017770274772873674,0.7368421052631579
7057,7057,90%/Number,19,5,14,7.780371234856063e-05,0.00017770274772873674,0.7368421052631579
7058,7058,샹/Noun,19,5,14,7.780371234856063e-05,0.00017770274772873674,0.7368421052631579
7059,7059,쾌락/Noun,19,14,5,0.00017783705679671002,7.774495213132233e-05,0.7368421052631579
7060,7060,김고은/Noun,19,5,14,7.780371234856063e-05,0.00017770274772873674,0.7368421052631579
7061,7061,흑백영화/Noun,19,14,5,0.00017783705679671002,7.774495213132233e-05,0.7368421052631579
7062,7062,퓨전/Noun,19,5,14,7.780371234856063e-05,0.00017770274772873674,0.7368421052631579
7063,7063,박진희/Noun,19,14,5,0.00017783705679671002,7.774495213132233e-05,0.7368421052631579
7064,7064,한판/Noun,19,5,14,7.780371234856063e-05,0.00017770274772873674,0.7368421052631579
7065,7065,새기다/Verb,19,14,5,0.00017783705679671002,7.774495213132233e-05,0.7368421052631579
7066,7066,난생처음/Noun,19,5,14,7.780371234856063e-05,0.00017770274772873674,0.7368421052631579
7067,7067,금성무/Noun,19,14,5,0.00017783705679671002,7.774495213132233e-05,0.7368421052631579
7068,7068,세련/Noun,19,14,5,0.00017783705679671002,7.774495213132233e-05,0.7368421052631579
7069,7069,재활용/Noun,19,5,14,7.780371234856063e-05,0.00017770274772873674,0.7368421052631579
7070,7070,진호/Noun,19,5,14,7.780371234856063e-05,0.00017770274772873674,0.7368421052631579
7071,7071,스승/Noun,19,14,5,0.00017783705679671002,7.774495213132233e-05,0.7368421052631579
7072,7072,~./Punctuation,19,14,5,0.00017783705679671002,7.774495213132233e-05,0.7368421052631579
7073,7073,인질/Noun,19,5,14,7.780371234856063e-05,0.00017770274772873674,0.7368421052631579
7074,7074,별것/Noun,19,5,14,7.780371234856063e-05,0.00017770274772873674,0.7368421052631579
7075,7075,휼륭하다/Adjective,19,14,5,0.00017783705679671002,7.774495213132233e-05,0.7368421052631579
7076,7076,민간인/Noun,19,5,14,7.780371234856063e-05,0.00017770274772873674,0.7368421052631579
7077,7077,샤말란/Noun,19,5,14,7.780371234856063e-05,0.00017770274772873674,0.7368421052631579
7078,7078,다분하다/Adjective,19,5,14,7.780371234856063e-05,0.00017770274772873674,0.7368421052631579
7079,7079,Z/Alpha,19,5,14,7.780371234856063e-05,0.00017770274772873674,0.7368421052631579
7080,7080,바가지/Noun,19,6,13,8.891852839835501e-05,0.0001665963259956907,0.6842105263157895
7081,7081,이처럼/Noun,19,13,6,0.00016672224074691566,8.885137386436837e-05,0.6842105263157895
7082,7082,가필드/Noun,19,13,6,0.00016672224074691566,8.885137386436837e-05,0.6842105263157895
7083,7083,for/Alpha,19,13,6,0.00016672224074691566,8.885137386436837e-05,0.6842105263157895
7084,7084,사고방식/Noun,19,6,13,8.891852839835501e-05,0.0001665963259956907,0.6842105263157895
7085,7085,허락/Noun,19,6,13,8.891852839835501e-05,0.0001665963259956907,0.6842105263157895
7086,7086,조한선/Noun,19,6,13,8.891852839835501e-05,0.0001665963259956907,0.6842105263157895
7087,7087,톡톡/Noun,19,13,6,0.00016672224074691566,8.885137386436837e-05,0.6842105263157895
7088,7088,넨/Noun,19,13,6,0.00016672224074691566,8.885137386436837e-05,0.6842105263157895
7089,7089,포스트/Noun,19,6,13,8.891852839835501e-05,0.0001665963259956907,0.6842105263157895
7090,7090,특정/Noun,19,6,13,8.891852839835501e-05,0.0001665963259956907,0.6842105263157895
7091,7091,후보/Noun,19,6,13,8.891852839835501e-05,0.0001665963259956907,0.6842105263157895
7092,7092,애환/Noun,19,13,6,0.00016672224074691566,8.885137386436837e-05,0.6842105263157895
7093,7093,순식간/Noun,19,6,13,8.891852839835501e-05,0.0001665963259956907,0.6842105263157895
7094,7094,싸인/Noun,19,13,6,0.00016672224074691566,8.885137386436837e-05,0.6842105263157895
7095,7095,영역/Noun,19,13,6,0.00016672224074691566,8.885137386436837e-05,0.6842105263157895
7096,7096,구로/Noun,19,13,6,0.00016672224074691566,8.885137386436837e-05,0.6842105263157895
7097,7097,생방송/Noun,19,6,13,8.891852839835501e-05,0.0001665963259956907,0.6842105263157895
7098,7098,며느리/Noun,19,6,13,8.891852839835501e-05,0.0001665963259956907,0.6842105263157895
7099,7099,업그레이드/Noun,19,13,6,0.00016672224074691566,8.885137386436837e-05,0.6842105263157895
7100,7100,곽지민/Noun,19,6,13,8.891852839835501e-05,0.0001665963259956907,0.6842105263157895
7101,7101,영리하다/Adjective,19,13,6,0.00016672224074691566,8.885137386436837e-05,0.6842105263157895
7102,7102,킹콩/Noun,19,6,13,8.891852839835501e-05,0.0001665963259956907,0.6842105263157895
7103,7103,해치다/Verb,19,6,13,8.891852839835501e-05,0.0001665963259956907,0.6842105263157895
7104,7104,별그대/Noun,19,13,6,0.00016672224074691566,8.885137386436837e-05,0.6842105263157895
7105,7105,스페셜/Noun,19,6,13,8.891852839835501e-05,0.0001665963259956907,0.6842105263157895
7106,7106,자꾸만/Noun,19,13,6,0.00016672224074691566,8.885137386436837e-05,0.6842105263157895
7107,7107,올리비아/Noun,19,12,7,0.00015560742469712126,9.995779559741441e-05,0.631578947368421
7108,7108,성욕/Noun,19,7,12,0.0001000333444481494,0.00015548990426264466,0.631578947368421
7109,7109,승자/Noun,19,12,7,0.00015560742469712126,9.995779559741441e-05,0.631578947368421
7110,7110,예나/Noun,19,12,7,0.00015560742469712126,9.995779559741441e-05,0.631578947368421
7111,7111,와이/Modifier,19,12,7,0.00015560742469712126,9.995779559741441e-05,0.631578947368421
7112,7112,100년/Number,19,12,7,0.00015560742469712126,9.995779559741441e-05,0.631578947368421
7113,7113,바디/Noun,19,7,12,0.0001000333444481494,0.00015548990426264466,0.631578947368421
7114,7114,대강/Noun,19,7,12,0.0001000333444481494,0.00015548990426264466,0.631578947368421
7115,7115,썸/Noun,19,7,12,0.0001000333444481494,0.00015548990426264466,0.631578947368421
7116,7116,여럿/Noun,19,7,12,0.0001000333444481494,0.00015548990426264466,0.631578947368421
7117,7117,만치/Josa,19,12,7,0.00015560742469712126,9.995779559741441e-05,0.631578947368421
7118,7118,주식/Noun,19,12,7,0.00015560742469712126,9.995779559741441e-05,0.631578947368421
7119,7119,뒤집어지다/Verb,19,12,7,0.00015560742469712126,9.995779559741441e-05,0.631578947368421
7120,7120,당기다/Verb,19,7,12,0.0001000333444481494,0.00015548990426264466,0.631578947368421
7121,7121,딸아이/Noun,19,12,7,0.00015560742469712126,9.995779559741441e-05,0.631578947368421
7122,7122,개구리/Noun,19,7,12,0.0001000333444481494,0.00015548990426264466,0.631578947368421
7123,7123,몰리다/Verb,19,7,12,0.0001000333444481494,0.00015548990426264466,0.631578947368421
7124,7124,스나입스/Noun,19,7,12,0.0001000333444481494,0.00015548990426264466,0.631578947368421
7125,7125,일류/Noun,19,7,12,0.0001000333444481494,0.00015548990426264466,0.631578947368421
7126,7126,이미숙/Noun,19,12,7,0.00015560742469712126,9.995779559741441e-05,0.631578947368421
7127,7127,거북/Noun,19,7,12,0.0001000333444481494,0.00015548990426264466,0.631578947368421
7128,7128,원본/Noun,19,12,7,0.00015560742469712126,9.995779559741441e-05,0.631578947368421
7129,7129,돌고래/Noun,19,12,7,0.00015560742469712126,9.995779559741441e-05,0.631578947368421
7130,7130,작성/Noun,19,7,12,0.0001000333444481494,0.00015548990426264466,0.631578947368421
7131,7131,케로로/Noun,19,12,7,0.00015560742469712126,9.995779559741441e-05,0.631578947368421
7132,7132,외계/Noun,19,7,12,0.0001000333444481494,0.00015548990426264466,0.631578947368421
7133,7133,우주선/Noun,19,7,12,0.0001000333444481494,0.00015548990426264466,0.631578947368421
7134,7134,달린다/Noun,19,7,12,0.0001000333444481494,0.00015548990426264466,0.631578947368421
7135,7135,상대로/Noun,19,7,12,0.0001000333444481494,0.00015548990426264466,0.631578947368421
7136,7136,꺾다/Verb,19,7,12,0.0001000333444481494,0.00015548990426264466,0.631578947368421
7137,7137,4회/Number,19,7,12,0.0001000333444481494,0.00015548990426264466,0.631578947368421
7138,7138,넘어지다/Verb,19,7,12,0.0001000333444481494,0.00015548990426264466,0.631578947368421
7139,7139,터널/Noun,19,12,7,0.00015560742469712126,9.995779559741441e-05,0.631578947368421
7140,7140,다물다/Verb,19,12,7,0.00015560742469712126,9.995779559741441e-05,0.631578947368421
7141,7141,28/Number,19,12,7,0.00015560742469712126,9.995779559741441e-05,0.631578947368421
7142,7142,건전하다/Adjective,19,11,8,0.0001444926086473269,0.00011106421733046048,0.5789473684210527
7143,7143,유기/Noun,19,8,11,0.00011114816049794375,0.0001443834825295986,0.5789473684210527
7144,7144,확실/Noun,19,8,11,0.00011114816049794375,0.0001443834825295986,0.5789473684210527
7145,7145,10%/Number,19,8,11,0.00011114816049794375,0.0001443834825295986,0.5789473684210527
7146,7146,////Punctuation,19,8,11,0.00011114816049794375,0.0001443834825295986,0.5789473684210527
7147,7147,와인/Noun,19,11,8,0.0001444926086473269,0.00011106421733046048,0.5789473684210527
7148,7148,갚다/Verb,19,8,11,0.00011114816049794375,0.0001443834825295986,0.5789473684210527
7149,7149,스카이/Noun,19,8,11,0.00011114816049794375,0.0001443834825295986,0.5789473684210527
7150,7150,파이터/Noun,19,8,11,0.00011114816049794375,0.0001443834825295986,0.5789473684210527
7151,7151,한창/Noun,19,8,11,0.00011114816049794375,0.0001443834825295986,0.5789473684210527
7152,7152,되돌리다/Verb,19,8,11,0.00011114816049794375,0.0001443834825295986,0.5789473684210527
7153,7153,박하선/Noun,19,11,8,0.0001444926086473269,0.00011106421733046048,0.5789473684210527
7154,7154,한반도/Noun,19,8,11,0.00011114816049794375,0.0001443834825295986,0.5789473684210527
7155,7155,관능/Noun,19,8,11,0.00011114816049794375,0.0001443834825295986,0.5789473684210527
7156,7156,운영/Noun,19,11,8,0.0001444926086473269,0.00011106421733046048,0.5789473684210527
7157,7157,장예모/Noun,19,11,8,0.0001444926086473269,0.00011106421733046048,0.5789473684210527
7158,7158,씬들/Noun,19,8,11,0.00011114816049794375,0.0001443834825295986,0.5789473684210527
7159,7159,취한/Noun,19,8,11,0.00011114816049794375,0.0001443834825295986,0.5789473684210527
7160,7160,이해해/Noun,19,8,11,0.00011114816049794375,0.0001443834825295986,0.5789473684210527
7161,7161,이대로/Adverb,19,11,8,0.0001444926086473269,0.00011106421733046048,0.5789473684210527
7162,7162,비비다/Verb,19,11,8,0.0001444926086473269,0.00011106421733046048,0.5789473684210527
7163,7163,먹방/Noun,19,8,11,0.00011114816049794375,0.0001443834825295986,0.5789473684210527
7164,7164,우수하다/Adjective,19,11,8,0.0001444926086473269,0.00011106421733046048,0.5789473684210527
7165,7165,사냥/Noun,19,8,11,0.00011114816049794375,0.0001443834825295986,0.5789473684210527
7166,7166,서서/Noun,19,11,8,0.0001444926086473269,0.00011106421733046048,0.5789473684210527
7167,7167,토토/Noun,19,11,8,0.0001444926086473269,0.00011106421733046048,0.5789473684210527
7168,7168,기념비/Noun,19,11,8,0.0001444926086473269,0.00011106421733046048,0.5789473684210527
7169,7169,단호/Noun,19,11,8,0.0001444926086473269,0.00011106421733046048,0.5789473684210527
7170,7170,윌/Noun,19,8,11,0.00011114816049794375,0.0001443834825295986,0.5789473684210527
7171,7171,판사/Noun,19,11,8,0.0001444926086473269,0.00011106421733046048,0.5789473684210527
7172,7172,투척/Noun,19,11,8,0.0001444926086473269,0.00011106421733046048,0.5789473684210527
7173,7173,이세/Noun,19,9,10,0.00012226297654773814,0.00013327706079655256,0.5263157894736842
7174,7174,불타다/Adjective,19,10,9,0.0001333777925975325,0.00012217063906350652,0.5263157894736842
7175,7175,방송국/Noun,19,9,10,0.00012226297654773814,0.00013327706079655256,0.5263157894736842
7176,7176,80/Number,19,10,9,0.0001333777925975325,0.00012217063906350652,0.5263157894736842
7177,7177,박력/Noun,19,9,10,0.00012226297654773814,0.00013327706079655256,0.5263157894736842
7178,7178,패밀리/Noun,19,9,10,0.00012226297654773814,0.00013327706079655256,0.5263157894736842
7179,7179,음산하다/Adjective,19,9,10,0.00012226297654773814,0.00013327706079655256,0.5263157894736842
7180,7180,장식/Noun,19,10,9,0.0001333777925975325,0.00012217063906350652,0.5263157894736842
7181,7181,야말로/Josa,19,10,9,0.0001333777925975325,0.00012217063906350652,0.5263157894736842
7182,7182,흥분하다/Adjective,19,10,9,0.0001333777925975325,0.00012217063906350652,0.5263157894736842
7183,7183,유료/Noun,19,10,9,0.0001333777925975325,0.00012217063906350652,0.5263157894736842
7184,7184,업적/Noun,19,9,10,0.00012226297654773814,0.00013327706079655256,0.5263157894736842
7185,7185,쇼크/Noun,19,9,10,0.00012226297654773814,0.00013327706079655256,0.5263157894736842
7186,7186,입양/Noun,19,10,9,0.0001333777925975325,0.00012217063906350652,0.5263157894736842
7187,7187,스팅/Noun,19,9,10,0.00012226297654773814,0.00013327706079655256,0.5263157894736842
7188,7188,연하다/Adjective,19,10,9,0.0001333777925975325,0.00012217063906350652,0.5263157894736842
7189,7189,동일하다/Adjective,19,10,9,0.0001333777925975325,0.00012217063906350652,0.5263157894736842
7190,7190,조심/Noun,19,10,9,0.0001333777925975325,0.00012217063906350652,0.5263157894736842
7191,7191,인즈/Noun,19,10,9,0.0001333777925975325,0.00012217063906350652,0.5263157894736842
7192,7192,V/Alpha,19,9,10,0.00012226297654773814,0.00013327706079655256,0.5263157894736842
7193,7193,법도/Noun,19,9,10,0.00012226297654773814,0.00013327706079655256,0.5263157894736842
7194,7194,불행하다/Adjective,19,10,9,0.0001333777925975325,0.00012217063906350652,0.5263157894736842
7195,7195,청자/Noun,19,9,10,0.00012226297654773814,0.00013327706079655256,0.5263157894736842
7196,7196,복싱/Noun,19,10,9,0.0001333777925975325,0.00012217063906350652,0.5263157894736842
7197,7197,노고/Noun,19,10,9,0.0001333777925975325,0.00012217063906350652,0.5263157894736842
7198,7198,세이/Noun,19,9,10,0.00012226297654773814,0.00013327706079655256,0.5263157894736842
7199,7199,한니발/Noun,19,10,9,0.0001333777925975325,0.00012217063906350652,0.5263157894736842
7200,7200,늦추다/Verb,18,18,0,0.0002222963209958875,2.2212843466092093e-05,1.0
7201,7201,다려지다/Verb,18,18,0,0.0002222963209958875,2.2212843466092093e-05,1.0
7202,7202,보고또보고/Noun,18,18,0,0.0002222963209958875,2.2212843466092093e-05,1.0
7203,7203,김준호/Noun,18,0,18,2.2229632099588756e-05,0.00022212843466092096,1.0
7204,7204,오광록/Noun,18,0,18,2.2229632099588756e-05,0.00022212843466092096,1.0
7205,7205,놨/Noun,18,0,18,2.2229632099588756e-05,0.00022212843466092096,1.0
7206,7206,굿잡/Noun,18,17,1,0.00021118150494609317,3.331926519913814e-05,0.9444444444444444
7207,7207,여비/Noun,18,1,17,3.334444814938313e-05,0.0002110220129278749,0.9444444444444444
7208,7208,여균동/Noun,18,1,17,3.334444814938313e-05,0.0002110220129278749,0.9444444444444444
7209,7209,혈압/Noun,18,1,17,3.334444814938313e-05,0.0002110220129278749,0.9444444444444444
7210,7210,평온하다/Adjective,18,17,1,0.00021118150494609317,3.331926519913814e-05,0.9444444444444444
7211,7211,불법체류자/Noun,18,1,17,3.334444814938313e-05,0.0002110220129278749,0.9444444444444444
7212,7212,출품/Noun,18,1,17,3.334444814938313e-05,0.0002110220129278749,0.9444444444444444
7213,7213,발가락/Noun,18,1,17,3.334444814938313e-05,0.0002110220129278749,0.9444444444444444
7214,7214,좀해/Noun,18,2,16,4.445926419917751e-05,0.00019991559119482882,0.8888888888888888
7215,7215,성해/Noun,18,2,16,4.445926419917751e-05,0.00019991559119482882,0.8888888888888888
7216,7216,충돌/Noun,18,16,2,0.0002000666888962988,4.4425686932184186e-05,0.8888888888888888
7217,7217,+_+/Punctuation,18,16,2,0.0002000666888962988,4.4425686932184186e-05,0.8888888888888888
7218,7218,신랄하다/Adjective,18,16,2,0.0002000666888962988,4.4425686932184186e-05,0.8888888888888888
7219,7219,졸귀/Noun,18,16,2,0.0002000666888962988,4.4425686932184186e-05,0.8888888888888888
7220,7220,만만하다/Adjective,18,2,16,4.445926419917751e-05,0.00019991559119482882,0.8888888888888888
7221,7221,엘렌/Noun,18,16,2,0.0002000666888962988,4.4425686932184186e-05,0.8888888888888888
7222,7222,테잎/Noun,18,16,2,0.0002000666888962988,4.4425686932184186e-05,0.8888888888888888
7223,7223,가차/Noun,18,2,16,4.445926419917751e-05,0.00019991559119482882,0.8888888888888888
7224,7224,테이프/Noun,18,16,2,0.0002000666888962988,4.4425686932184186e-05,0.8888888888888888
7225,7225,갈팡질팡/Noun,18,2,16,4.445926419917751e-05,0.00019991559119482882,0.8888888888888888
7226,7226,신발/Noun,18,2,16,4.445926419917751e-05,0.00019991559119482882,0.8888888888888888
7227,7227,용인/Noun,18,2,16,4.445926419917751e-05,0.00019991559119482882,0.8888888888888888
7228,7228,....;;/Punctuation,18,2,16,4.445926419917751e-05,0.00019991559119482882,0.8888888888888888
7229,7229,불과/Noun,18,2,16,4.445926419917751e-05,0.00019991559119482882,0.8888888888888888
7230,7230,전설의고향/Noun,18,2,16,4.445926419917751e-05,0.00019991559119482882,0.8888888888888888
7231,7231,혁신/Noun,18,16,2,0.0002000666888962988,4.4425686932184186e-05,0.8888888888888888
7232,7232,444/Number,18,2,16,4.445926419917751e-05,0.00019991559119482882,0.8888888888888888
7233,7233,비로소/Noun,18,16,2,0.0002000666888962988,4.4425686932184186e-05,0.8888888888888888
7234,7234,윗/Modifier,18,3,15,5.5574080248971876e-05,0.0001888091694617828,0.8333333333333334
7235,7235,장비/Noun,18,3,15,5.5574080248971876e-05,0.0001888091694617828,0.8333333333333334
7236,7236,니콜슨/Noun,18,15,3,0.00018895187284650438,5.553210866523024e-05,0.8333333333333334
7237,7237,부풀리다/Verb,18,3,15,5.5574080248971876e-05,0.0001888091694617828,0.8333333333333334
7238,7238,5~6/Number,18,3,15,5.5574080248971876e-05,0.0001888091694617828,0.8333333333333334
7239,7239,산뜻하다/Adjective,18,15,3,0.00018895187284650438,5.553210866523024e-05,0.8333333333333334
7240,7240,칙칙하다/Adjective,18,3,15,5.5574080248971876e-05,0.0001888091694617828,0.8333333333333334
7241,7241,더군다나/Noun,18,3,15,5.5574080248971876e-05,0.0001888091694617828,0.8333333333333334
7242,7242,교통사고/Noun,18,3,15,5.5574080248971876e-05,0.0001888091694617828,0.8333333333333334
7243,7243,레기/Noun,18,3,15,5.5574080248971876e-05,0.0001888091694617828,0.8333333333333334
7244,7244,통제/Noun,18,14,4,0.00017783705679671002,6.663853039827628e-05,0.7777777777777778
7245,7245,기능/Noun,18,4,14,6.668889629876625e-05,0.00017770274772873674,0.7777777777777778
7246,7246,주걸륜/Noun,18,4,14,6.668889629876625e-05,0.00017770274772873674,0.7777777777777778
7247,7247,천지/Noun,18,4,14,6.668889629876625e-05,0.00017770274772873674,0.7777777777777778
7248,7248,매기/Noun,18,4,14,6.668889629876625e-05,0.00017770274772873674,0.7777777777777778
7249,7249,폭동/Noun,18,4,14,6.668889629876625e-05,0.00017770274772873674,0.7777777777777778
7250,7250,엇갈리다/Verb,18,14,4,0.00017783705679671002,6.663853039827628e-05,0.7777777777777778
7251,7251,김소연/Noun,18,14,4,0.00017783705679671002,6.663853039827628e-05,0.7777777777777778
7252,7252,17년/Number,18,14,4,0.00017783705679671002,6.663853039827628e-05,0.7777777777777778
7253,7253,권장/Noun,18,4,14,6.668889629876625e-05,0.00017770274772873674,0.7777777777777778
7254,7254,나무라다/Verb,18,14,4,0.00017783705679671002,6.663853039827628e-05,0.7777777777777778
7255,7255,SBS/Alpha,18,4,14,6.668889629876625e-05,0.00017770274772873674,0.7777777777777778
7256,7256,전화하다/Adjective,18,4,14,6.668889629876625e-05,0.00017770274772873674,0.7777777777777778
7257,7257,김동욱/Noun,18,14,4,0.00017783705679671002,6.663853039827628e-05,0.7777777777777778
7258,7258,무관심/Noun,18,14,4,0.00017783705679671002,6.663853039827628e-05,0.7777777777777778
7259,7259,사운드트랙/Noun,18,14,4,0.00017783705679671002,6.663853039827628e-05,0.7777777777777778
7260,7260,황우슬혜/Noun,18,4,14,6.668889629876625e-05,0.00017770274772873674,0.7777777777777778
7261,7261,무한도전/Noun,18,4,14,6.668889629876625e-05,0.00017770274772873674,0.7777777777777778
7262,7262,리얼리즘/Noun,18,14,4,0.00017783705679671002,6.663853039827628e-05,0.7777777777777778
7263,7263,천정명/Noun,18,4,14,6.668889629876625e-05,0.00017770274772873674,0.7777777777777778
7264,7264,상한/Noun,18,5,13,7.780371234856063e-05,0.0001665963259956907,0.7222222222222222
7265,7265,식겁하다/Adjective,18,5,13,7.780371234856063e-05,0.0001665963259956907,0.7222222222222222
7266,7266,해품달/Noun,18,13,5,0.00016672224074691566,7.774495213132233e-05,0.7222222222222222
7267,7267,쥬/Noun,18,13,5,0.00016672224074691566,7.774495213132233e-05,0.7222222222222222
7268,7268,....!/Punctuation,18,13,5,0.00016672224074691566,7.774495213132233e-05,0.7222222222222222
7269,7269,능청/Noun,18,13,5,0.00016672224074691566,7.774495213132233e-05,0.7222222222222222
7270,7270,자화상/Noun,18,13,5,0.00016672224074691566,7.774495213132233e-05,0.7222222222222222
7271,7271,화살/Noun,18,5,13,7.780371234856063e-05,0.0001665963259956907,0.7222222222222222
7272,7272,강수연/Noun,18,5,13,7.780371234856063e-05,0.0001665963259956907,0.7222222222222222
7273,7273,국회의원/Noun,18,5,13,7.780371234856063e-05,0.0001665963259956907,0.7222222222222222
7274,7274,드라큐라/Noun,18,13,5,0.00016672224074691566,7.774495213132233e-05,0.7222222222222222
7275,7275,페넬로페/Noun,18,13,5,0.00016672224074691566,7.774495213132233e-05,0.7222222222222222
7276,7276,막말/Noun,18,5,13,7.780371234856063e-05,0.0001665963259956907,0.7222222222222222
7277,7277,누굴/Noun,18,5,13,7.780371234856063e-05,0.0001665963259956907,0.7222222222222222
7278,7278,훗날/Noun,18,13,5,0.00016672224074691566,7.774495213132233e-05,0.7222222222222222
7279,7279,풋/Noun,18,5,13,7.780371234856063e-05,0.0001665963259956907,0.7222222222222222
7280,7280,우주전쟁/Noun,18,5,13,7.780371234856063e-05,0.0001665963259956907,0.7222222222222222
7281,7281,키이라/Noun,18,13,5,0.00016672224074691566,7.774495213132233e-05,0.7222222222222222
7282,7282,곤란하다/Adjective,18,5,13,7.780371234856063e-05,0.0001665963259956907,0.7222222222222222
7283,7283,절규/Noun,18,13,5,0.00016672224074691566,7.774495213132233e-05,0.7222222222222222
7284,7284,정우/Noun,18,13,5,0.00016672224074691566,7.774495213132233e-05,0.7222222222222222
7285,7285,경향/Noun,18,5,13,7.780371234856063e-05,0.0001665963259956907,0.7222222222222222
7286,7286,가든/Noun,18,5,13,7.780371234856063e-05,0.0001665963259956907,0.7222222222222222
7287,7287,싸대기/Noun,18,5,13,7.780371234856063e-05,0.0001665963259956907,0.7222222222222222
7288,7288,복잡/Noun,18,13,5,0.00016672224074691566,7.774495213132233e-05,0.7222222222222222
7289,7289,이필/Noun,18,13,5,0.00016672224074691566,7.774495213132233e-05,0.7222222222222222
7290,7290,공자/Noun,18,13,5,0.00016672224074691566,7.774495213132233e-05,0.7222222222222222
7291,7291,치매/Noun,18,5,13,7.780371234856063e-05,0.0001665963259956907,0.7222222222222222
7292,7292,친근하다/Adjective,18,13,5,0.00016672224074691566,7.774495213132233e-05,0.7222222222222222
7293,7293,정교하다/Adjective,18,13,5,0.00016672224074691566,7.774495213132233e-05,0.7222222222222222
7294,7294,고서/Noun,18,5,13,7.780371234856063e-05,0.0001665963259956907,0.7222222222222222
7295,7295,주저/Noun,18,13,5,0.00016672224074691566,7.774495213132233e-05,0.7222222222222222
7296,7296,.;;/Punctuation,18,5,13,7.780371234856063e-05,0.0001665963259956907,0.7222222222222222
7297,7297,열차/Noun,18,5,13,7.780371234856063e-05,0.0001665963259956907,0.7222222222222222
7298,7298,이득/Noun,18,5,13,7.780371234856063e-05,0.0001665963259956907,0.7222222222222222
7299,7299,라네/Josa,18,6,12,8.891852839835501e-05,0.00015548990426264466,0.6666666666666666
7300,7300,내부/Noun,18,12,6,0.00015560742469712126,8.885137386436837e-05,0.6666666666666666
7301,7301,천원/Noun,18,6,12,8.891852839835501e-05,0.00015548990426264466,0.6666666666666666
7302,7302,악령/Noun,18,6,12,8.891852839835501e-05,0.00015548990426264466,0.6666666666666666
7303,7303,가오/Noun,18,6,12,8.891852839835501e-05,0.00015548990426264466,0.6666666666666666
7304,7304,투모로우/Noun,18,6,12,8.891852839835501e-05,0.00015548990426264466,0.6666666666666666
7305,7305,딱지/Noun,18,6,12,8.891852839835501e-05,0.00015548990426264466,0.6666666666666666
7306,7306,짤/Noun,18,6,12,8.891852839835501e-05,0.00015548990426264466,0.6666666666666666
7307,7307,강의/Noun,18,12,6,0.00015560742469712126,8.885137386436837e-05,0.6666666666666666
7308,7308,대우/Noun,18,12,6,0.00015560742469712126,8.885137386436837e-05,0.6666666666666666
7309,7309,고마/Noun,18,6,12,8.891852839835501e-05,0.00015548990426264466,0.6666666666666666
7310,7310,종편/Noun,18,12,6,0.00015560742469712126,8.885137386436837e-05,0.6666666666666666
7311,7311,미지근하다/Adjective,18,6,12,8.891852839835501e-05,0.00015548990426264466,0.6666666666666666
7312,7312,자부/Noun,18,12,6,0.00015560742469712126,8.885137386436837e-05,0.6666666666666666
7313,7313,세뇌/Noun,18,6,12,8.891852839835501e-05,0.00015548990426264466,0.6666666666666666
7314,7314,정사씬/Noun,18,6,12,8.891852839835501e-05,0.00015548990426264466,0.6666666666666666
7315,7315,오만/Noun,18,6,12,8.891852839835501e-05,0.00015548990426264466,0.6666666666666666
7316,7316,더더/Noun,18,12,6,0.00015560742469712126,8.885137386436837e-05,0.6666666666666666
7317,7317,김사랑/Noun,18,6,12,8.891852839835501e-05,0.00015548990426264466,0.6666666666666666
7318,7318,가져가다/Verb,18,6,12,8.891852839835501e-05,0.00015548990426264466,0.6666666666666666
7319,7319,140/Number,18,12,6,0.00015560742469712126,8.885137386436837e-05,0.6666666666666666
7320,7320,베니/Noun,18,12,6,0.00015560742469712126,8.885137386436837e-05,0.6666666666666666
7321,7321,"~""/Punctuation",18,12,6,0.00015560742469712126,8.885137386436837e-05,0.6666666666666666
7322,7322,추격자/Noun,18,6,12,8.891852839835501e-05,0.00015548990426264466,0.6666666666666666
7323,7323,건데/Noun,18,6,12,8.891852839835501e-05,0.00015548990426264466,0.6666666666666666
7324,7324,주니어/Noun,18,12,6,0.00015560742469712126,8.885137386436837e-05,0.6666666666666666
7325,7325,날수/Noun,18,12,6,0.00015560742469712126,8.885137386436837e-05,0.6666666666666666
7326,7326,핀처/Noun,18,12,6,0.00015560742469712126,8.885137386436837e-05,0.6666666666666666
7327,7327,김대중/Noun,18,6,12,8.891852839835501e-05,0.00015548990426264466,0.6666666666666666
7328,7328,삽질/Noun,18,6,12,8.891852839835501e-05,0.00015548990426264466,0.6666666666666666
7329,7329,위험/Noun,18,6,12,8.891852839835501e-05,0.00015548990426264466,0.6666666666666666
7330,7330,기해/Noun,18,6,12,8.891852839835501e-05,0.00015548990426264466,0.6666666666666666
7331,7331,정당하다/Adjective,18,6,12,8.891852839835501e-05,0.00015548990426264466,0.6666666666666666
7332,7332,정준/Noun,18,12,6,0.00015560742469712126,8.885137386436837e-05,0.6666666666666666
7333,7333,심각/Noun,18,12,6,0.00015560742469712126,8.885137386436837e-05,0.6666666666666666
7334,7334,2등/Number,18,7,11,0.0001000333444481494,0.0001443834825295986,0.6111111111111112
7335,7335,이나라/Noun,18,11,7,0.0001444926086473269,9.995779559741441e-05,0.6111111111111112
7336,7336,웬/Modifier,18,7,11,0.0001000333444481494,0.0001443834825295986,0.6111111111111112
7337,7337,80분/Number,18,7,11,0.0001000333444481494,0.0001443834825295986,0.6111111111111112
7338,7338,특선/Noun,18,11,7,0.0001444926086473269,9.995779559741441e-05,0.6111111111111112
7339,7339,비됴/Noun,18,7,11,0.0001000333444481494,0.0001443834825295986,0.6111111111111112
7340,7340,돌프/Noun,18,7,11,0.0001000333444481494,0.0001443834825295986,0.6111111111111112
7341,7341,노다메/Noun,18,11,7,0.0001444926086473269,9.995779559741441e-05,0.6111111111111112
7342,7342,장기/Noun,18,7,11,0.0001000333444481494,0.0001443834825295986,0.6111111111111112
7343,7343,오후/Noun,18,11,7,0.0001444926086473269,9.995779559741441e-05,0.6111111111111112
7344,7344,힐러리/Noun,18,11,7,0.0001444926086473269,9.995779559741441e-05,0.6111111111111112
7345,7345,선교/Noun,18,7,11,0.0001000333444481494,0.0001443834825295986,0.6111111111111112
7346,7346,바지/Noun,18,11,7,0.0001444926086473269,9.995779559741441e-05,0.6111111111111112
7347,7347,나오미/Noun,18,11,7,0.0001444926086473269,9.995779559741441e-05,0.6111111111111112
7348,7348,6~7/Number,18,11,7,0.0001444926086473269,9.995779559741441e-05,0.6111111111111112
7349,7349,바이블/Noun,18,11,7,0.0001444926086473269,9.995779559741441e-05,0.6111111111111112
7350,7350,비긴/Noun,18,11,7,0.0001444926086473269,9.995779559741441e-05,0.6111111111111112
7351,7351,익/Noun,18,7,11,0.0001000333444481494,0.0001443834825295986,0.6111111111111112
7352,7352,할리/Noun,18,11,7,0.0001444926086473269,9.995779559741441e-05,0.6111111111111112
7353,7353,여백/Noun,18,11,7,0.0001444926086473269,9.995779559741441e-05,0.6111111111111112
7354,7354,매드/Noun,18,11,7,0.0001444926086473269,9.995779559741441e-05,0.6111111111111112
7355,7355,쟁쟁/Noun,18,7,11,0.0001000333444481494,0.0001443834825295986,0.6111111111111112
7356,7356,왜캐/Noun,18,7,11,0.0001000333444481494,0.0001443834825295986,0.6111111111111112
7357,7357,제리/Noun,18,11,7,0.0001444926086473269,9.995779559741441e-05,0.6111111111111112
7358,7358,샷/Noun,18,7,11,0.0001000333444481494,0.0001443834825295986,0.6111111111111112
7359,7359,홍경인/Noun,18,7,11,0.0001000333444481494,0.0001443834825295986,0.6111111111111112
7360,7360,라기보다는/Josa,18,7,11,0.0001000333444481494,0.0001443834825295986,0.6111111111111112
7361,7361,현우/Noun,18,11,7,0.0001444926086473269,9.995779559741441e-05,0.6111111111111112
7362,7362,왈/Noun,18,7,11,0.0001000333444481494,0.0001443834825295986,0.6111111111111112
7363,7363,죄악/Noun,18,7,11,0.0001000333444481494,0.0001443834825295986,0.6111111111111112
7364,7364,곱/Noun,18,7,11,0.0001000333444481494,0.0001443834825295986,0.6111111111111112
7365,7365,닮음/Noun,18,11,7,0.0001444926086473269,9.995779559741441e-05,0.6111111111111112
7366,7366,오컬트/Noun,18,7,11,0.0001000333444481494,0.0001443834825295986,0.6111111111111112
7367,7367,상사/Noun,18,7,11,0.0001000333444481494,0.0001443834825295986,0.6111111111111112
7368,7368,날아다니다/Verb,18,7,11,0.0001000333444481494,0.0001443834825295986,0.6111111111111112
7369,7369,달래다/Verb,18,11,7,0.0001444926086473269,9.995779559741441e-05,0.6111111111111112
7370,7370,갈아타다/Verb,18,7,11,0.0001000333444481494,0.0001443834825295986,0.6111111111111112
7371,7371,유감/Noun,18,7,11,0.0001000333444481494,0.0001443834825295986,0.6111111111111112
7372,7372,남여/Noun,18,11,7,0.0001444926086473269,9.995779559741441e-05,0.6111111111111112
7373,7373,초대/Noun,18,11,7,0.0001444926086473269,9.995779559741441e-05,0.6111111111111112
7374,7374,달러/Noun,18,7,11,0.0001000333444481494,0.0001443834825295986,0.6111111111111112
7375,7375,날때/Noun,18,11,7,0.0001444926086473269,9.995779559741441e-05,0.6111111111111112
7376,7376,차카/Noun,18,7,11,0.0001000333444481494,0.0001443834825295986,0.6111111111111112
7377,7377,불가하다/Adjective,18,7,11,0.0001000333444481494,0.0001443834825295986,0.6111111111111112
7378,7378,무모하다/Adjective,18,11,7,0.0001444926086473269,9.995779559741441e-05,0.6111111111111112
7379,7379,씩/Adverb,18,7,11,0.0001000333444481494,0.0001443834825295986,0.6111111111111112
7380,7380,기초/Noun,18,8,10,0.00011114816049794375,0.00013327706079655256,0.5555555555555556
7381,7381,예외/Noun,18,8,10,0.00011114816049794375,0.00013327706079655256,0.5555555555555556
7382,7382,소식/Noun,18,10,8,0.0001333777925975325,0.00011106421733046048,0.5555555555555556
7383,7383,홉킨스/Noun,18,10,8,0.0001333777925975325,0.00011106421733046048,0.5555555555555556
7384,7384,에나/Noun,18,10,8,0.0001333777925975325,0.00011106421733046048,0.5555555555555556
7385,7385,그랬는데/Conjunction,18,8,10,0.00011114816049794375,0.00013327706079655256,0.5555555555555556
7386,7386,메이저/Noun,18,8,10,0.00011114816049794375,0.00013327706079655256,0.5555555555555556
7387,7387,주진모/Noun,18,10,8,0.0001333777925975325,0.00011106421733046048,0.5555555555555556
7388,7388,애쉬/Noun,18,10,8,0.0001333777925975325,0.00011106421733046048,0.5555555555555556
7389,7389,단단하다/Adjective,18,8,10,0.00011114816049794375,0.00013327706079655256,0.5555555555555556
7390,7390,서유기/Noun,18,10,8,0.0001333777925975325,0.00011106421733046048,0.5555555555555556
7391,7391,그릇/Noun,18,8,10,0.00011114816049794375,0.00013327706079655256,0.5555555555555556
7392,7392,..'/Punctuation,18,8,10,0.00011114816049794375,0.00013327706079655256,0.5555555555555556
7393,7393,어간/Noun,18,10,8,0.0001333777925975325,0.00011106421733046048,0.5555555555555556
7394,7394,망각/Noun,18,8,10,0.00011114816049794375,0.00013327706079655256,0.5555555555555556
7395,7395,스페이스/Noun,18,8,10,0.00011114816049794375,0.00013327706079655256,0.5555555555555556
7396,7396,이소연/Noun,18,8,10,0.00011114816049794375,0.00013327706079655256,0.5555555555555556
7397,7397,여부/Noun,18,8,10,0.00011114816049794375,0.00013327706079655256,0.5555555555555556
7398,7398,핳/Exclamation,18,8,10,0.00011114816049794375,0.00013327706079655256,0.5555555555555556
7399,7399,모세/Noun,18,10,8,0.0001333777925975325,0.00011106421733046048,0.5555555555555556
7400,7400,지기/Noun,18,8,10,0.00011114816049794375,0.00013327706079655256,0.5555555555555556
7401,7401,겸/Noun,18,10,8,0.0001333777925975325,0.00011106421733046048,0.5555555555555556
7402,7402,크기/Noun,18,8,10,0.00011114816049794375,0.00013327706079655256,0.5555555555555556
7403,7403,입체/Noun,18,8,10,0.00011114816049794375,0.00013327706079655256,0.5555555555555556
7404,7404,레이스/Noun,18,10,8,0.0001333777925975325,0.00011106421733046048,0.5555555555555556
7405,7405,이아/Noun,18,8,10,0.00011114816049794375,0.00013327706079655256,0.5555555555555556
7406,7406,유투브/Noun,18,10,8,0.0001333777925975325,0.00011106421733046048,0.5555555555555556
7407,7407,구현/Noun,18,10,8,0.0001333777925975325,0.00011106421733046048,0.5555555555555556
7408,7408,주로/Noun,18,8,10,0.00011114816049794375,0.00013327706079655256,0.5555555555555556
7409,7409,부시/Noun,18,8,10,0.00011114816049794375,0.00013327706079655256,0.5555555555555556
7410,7410,유선/Noun,18,10,8,0.0001333777925975325,0.00011106421733046048,0.5555555555555556
7411,7411,듬뿍/Noun,18,8,10,0.00011114816049794375,0.00013327706079655256,0.5555555555555556
7412,7412,드릴/Noun,18,8,10,0.00011114816049794375,0.00013327706079655256,0.5555555555555556
7413,7413,탱크/Noun,18,10,8,0.0001333777925975325,0.00011106421733046048,0.5555555555555556
7414,7414,정식/Noun,18,8,10,0.00011114816049794375,0.00013327706079655256,0.5555555555555556
7415,7415,중국어/Noun,18,8,10,0.00011114816049794375,0.00013327706079655256,0.5555555555555556
7416,7416,독재/Noun,18,8,10,0.00011114816049794375,0.00013327706079655256,0.5555555555555556
7417,7417,가스/Noun,18,8,10,0.00011114816049794375,0.00013327706079655256,0.5555555555555556
7418,7418,페이스/Noun,18,8,10,0.00011114816049794375,0.00013327706079655256,0.5555555555555556
7419,7419,요정/Noun,18,8,10,0.00011114816049794375,0.00013327706079655256,0.5555555555555556
7420,7420,포커스/Noun,18,8,10,0.00011114816049794375,0.00013327706079655256,0.5555555555555556
7421,7421,이미연/Noun,18,10,8,0.0001333777925975325,0.00011106421733046048,0.5555555555555556
7422,7422,알포인트/Noun,18,10,8,0.0001333777925975325,0.00011106421733046048,0.5555555555555556
7423,7423,크크/Exclamation,18,10,8,0.0001333777925975325,0.00011106421733046048,0.5555555555555556
7424,7424,지현우/Noun,18,8,10,0.00011114816049794375,0.00013327706079655256,0.5555555555555556
7425,7425,처지/Noun,18,10,8,0.0001333777925975325,0.00011106421733046048,0.5555555555555556
7426,7426,두루/Noun,18,9,9,0.00012226297654773814,0.00012217063906350652,0.5
7427,7427,무시무시하다/Adjective,18,9,9,0.00012226297654773814,0.00012217063906350652,0.5
7428,7428,갑툭튀/Noun,18,9,9,0.00012226297654773814,0.00012217063906350652,0.5
7429,7429,놀리다/Verb,18,9,9,0.00012226297654773814,0.00012217063906350652,0.5
7430,7430,..(/Punctuation,18,9,9,0.00012226297654773814,0.00012217063906350652,0.5
7431,7431,파이널/Noun,18,9,9,0.00012226297654773814,0.00012217063906350652,0.5
7432,7432,재임/Noun,18,9,9,0.00012226297654773814,0.00012217063906350652,0.5
7433,7433,이서진/Noun,18,9,9,0.00012226297654773814,0.00012217063906350652,0.5
7434,7434,돌아서다/Verb,18,9,9,0.00012226297654773814,0.00012217063906350652,0.5
7435,7435,식다/Verb,18,9,9,0.00012226297654773814,0.00012217063906350652,0.5
7436,7436,합격/Noun,18,9,9,0.00012226297654773814,0.00012217063906350652,0.5
7437,7437,이란/Foreign,18,9,9,0.00012226297654773814,0.00012217063906350652,0.5
7438,7438,윌리엄/Noun,18,9,9,0.00012226297654773814,0.00012217063906350652,0.5
7439,7439,스물/Noun,18,9,9,0.00012226297654773814,0.00012217063906350652,0.5
7440,7440,사도/Noun,18,9,9,0.00012226297654773814,0.00012217063906350652,0.5
7441,7441,료코/Noun,18,9,9,0.00012226297654773814,0.00012217063906350652,0.5
7442,7442,인시디어스/Noun,18,9,9,0.00012226297654773814,0.00012217063906350652,0.5
7443,7443,유방/Noun,18,9,9,0.00012226297654773814,0.00012217063906350652,0.5
7444,7444,질적/Noun,18,9,9,0.00012226297654773814,0.00012217063906350652,0.5
7445,7445,중요/Noun,18,9,9,0.00012226297654773814,0.00012217063906350652,0.5
7446,7446,나기/Noun,18,9,9,0.00012226297654773814,0.00012217063906350652,0.5
7447,7447,아싸/Exclamation,18,9,9,0.00012226297654773814,0.00012217063906350652,0.5
7448,7448,횽/Noun,18,9,9,0.00012226297654773814,0.00012217063906350652,0.5
7449,7449,독하다/Adjective,18,9,9,0.00012226297654773814,0.00012217063906350652,0.5
7450,7450,최신/Noun,18,9,9,0.00012226297654773814,0.00012217063906350652,0.5
7451,7451,요청/Noun,18,9,9,0.00012226297654773814,0.00012217063906350652,0.5
7452,7452,패륜/Noun,17,0,17,2.2229632099588756e-05,0.0002110220129278749,1.0
7453,7453,김대희/Noun,17,0,17,2.2229632099588756e-05,0.0002110220129278749,1.0
7454,7454,이러니까/Conjunction,17,0,17,2.2229632099588756e-05,0.0002110220129278749,1.0
7455,7455,*^^*/Punctuation,17,17,0,0.00021118150494609317,2.2212843466092093e-05,1.0
7456,7456,숙면/Noun,17,0,17,2.2229632099588756e-05,0.0002110220129278749,1.0
7457,7457,클레이/Noun,17,17,0,0.00021118150494609317,2.2212843466092093e-05,1.0
7458,7458,조음/Noun,17,17,0,0.00021118150494609317,2.2212843466092093e-05,1.0
7459,7459,8~10/Number,17,0,17,2.2229632099588756e-05,0.0002110220129278749,1.0
7460,7460,0.1/Number,17,1,16,3.334444814938313e-05,0.00019991559119482882,0.9411764705882352
7461,7461,하락/Noun,17,1,16,3.334444814938313e-05,0.00019991559119482882,0.9411764705882352
7462,7462,죄송/Noun,17,1,16,3.334444814938313e-05,0.00019991559119482882,0.9411764705882352
7463,7463,ㅡㅡㅡ/KoreanParticle,17,1,16,3.334444814938313e-05,0.00019991559119482882,0.9411764705882352
7464,7464,임성한/Noun,17,1,16,3.334444814938313e-05,0.00019991559119482882,0.9411764705882352
7465,7465,데려오다/Verb,17,1,16,3.334444814938313e-05,0.00019991559119482882,0.9411764705882352
7466,7466,눈시울/Noun,17,16,1,0.0002000666888962988,3.331926519913814e-05,0.9411764705882352
7467,7467,끓이다/Verb,17,1,16,3.334444814938313e-05,0.00019991559119482882,0.9411764705882352
7468,7468,원주고/Noun,17,1,16,3.334444814938313e-05,0.00019991559119482882,0.9411764705882352
7469,7469,고리타분하다/Adjective,17,2,15,4.445926419917751e-05,0.0001888091694617828,0.8823529411764706
7470,7470,훈녀/Noun,17,15,2,0.00018895187284650438,4.4425686932184186e-05,0.8823529411764706
7471,7471,궁합/Noun,17,15,2,0.00018895187284650438,4.4425686932184186e-05,0.8823529411764706
7472,7472,작자/Noun,17,2,15,4.445926419917751e-05,0.0001888091694617828,0.8823529411764706
7473,7473,암만/Noun,17,2,15,4.445926419917751e-05,0.0001888091694617828,0.8823529411764706
7474,7474,폐/Noun,17,2,15,4.445926419917751e-05,0.0001888091694617828,0.8823529411764706
7475,7475,신음/Noun,17,2,15,4.445926419917751e-05,0.0001888091694617828,0.8823529411764706
7476,7476,랄프/Noun,17,15,2,0.00018895187284650438,4.4425686932184186e-05,0.8823529411764706
7477,7477,쨋/Noun,17,15,2,0.00018895187284650438,4.4425686932184186e-05,0.8823529411764706
7478,7478,로더/Noun,17,2,15,4.445926419917751e-05,0.0001888091694617828,0.8823529411764706
7479,7479,bbb/Alpha,17,15,2,0.00018895187284650438,4.4425686932184186e-05,0.8823529411764706
7480,7480,야망/Noun,17,15,2,0.00018895187284650438,4.4425686932184186e-05,0.8823529411764706
7481,7481,파란만장하다/Adjective,17,15,2,0.00018895187284650438,4.4425686932184186e-05,0.8823529411764706
7482,7482,or/Alpha,17,2,15,4.445926419917751e-05,0.0001888091694617828,0.8823529411764706
7483,7483,서른/Noun,17,15,2,0.00018895187284650438,4.4425686932184186e-05,0.8823529411764706
7484,7484,앞세우다/Verb,17,2,15,4.445926419917751e-05,0.0001888091694617828,0.8823529411764706
7485,7485,심플/Noun,17,14,3,0.00017783705679671002,5.553210866523024e-05,0.8235294117647058
7486,7486,단면/Noun,17,14,3,0.00017783705679671002,5.553210866523024e-05,0.8235294117647058
7487,7487,사지/Noun,17,3,14,5.5574080248971876e-05,0.00017770274772873674,0.8235294117647058
7488,7488,딘/Noun,17,14,3,0.00017783705679671002,5.553210866523024e-05,0.8235294117647058
7489,7489,심보/Noun,17,3,14,5.5574080248971876e-05,0.00017770274772873674,0.8235294117647058
7490,7490,악어/Noun,17,3,14,5.5574080248971876e-05,0.00017770274772873674,0.8235294117647058
7491,7491,거저/Noun,17,3,14,5.5574080248971876e-05,0.00017770274772873674,0.8235294117647058
7492,7492,상위/Noun,17,14,3,0.00017783705679671002,5.553210866523024e-05,0.8235294117647058
7493,7493,생생/Noun,17,14,3,0.00017783705679671002,5.553210866523024e-05,0.8235294117647058
7494,7494,앤드류/Noun,17,14,3,0.00017783705679671002,5.553210866523024e-05,0.8235294117647058
7495,7495,폐인/Noun,17,14,3,0.00017783705679671002,5.553210866523024e-05,0.8235294117647058
7496,7496,ok/Alpha,17,3,14,5.5574080248971876e-05,0.00017770274772873674,0.8235294117647058
7497,7497,시리/Noun,17,14,3,0.00017783705679671002,5.553210866523024e-05,0.8235294117647058
7498,7498,제멋대로/Noun,17,3,14,5.5574080248971876e-05,0.00017770274772873674,0.8235294117647058
7499,7499,서비스/Noun,17,3,14,5.5574080248971876e-05,0.00017770274772873674,0.8235294117647058
7500,7500,쏠리다/Verb,17,3,14,5.5574080248971876e-05,0.00017770274772873674,0.8235294117647058
7501,7501,꽥꽥/Adverb,17,3,14,5.5574080248971876e-05,0.00017770274772873674,0.8235294117647058
7502,7502,빙빙/Noun,17,3,14,5.5574080248971876e-05,0.00017770274772873674,0.8235294117647058
7503,7503,뮤/Noun,17,14,3,0.00017783705679671002,5.553210866523024e-05,0.8235294117647058
7504,7504,쑤시다/Verb,17,3,14,5.5574080248971876e-05,0.00017770274772873674,0.8235294117647058
7505,7505,저희/Modifier,17,14,3,0.00017783705679671002,5.553210866523024e-05,0.8235294117647058
7506,7506,일색/Noun,17,3,14,5.5574080248971876e-05,0.00017770274772873674,0.8235294117647058
7507,7507,진진/Noun,17,14,3,0.00017783705679671002,5.553210866523024e-05,0.8235294117647058
7508,7508,배급/Noun,17,3,14,5.5574080248971876e-05,0.00017770274772873674,0.8235294117647058
7509,7509,운지/Noun,17,3,14,5.5574080248971876e-05,0.00017770274772873674,0.8235294117647058
7510,7510,토크/Noun,17,4,13,6.668889629876625e-05,0.0001665963259956907,0.7647058823529411
7511,7511,교/Noun,17,4,13,6.668889629876625e-05,0.0001665963259956907,0.7647058823529411
7512,7512,커트/Noun,17,13,4,0.00016672224074691566,6.663853039827628e-05,0.7647058823529411
7513,7513,우상/Noun,17,13,4,0.00016672224074691566,6.663853039827628e-05,0.7647058823529411
7514,7514,웠/Noun,17,13,4,0.00016672224074691566,6.663853039827628e-05,0.7647058823529411
7515,7515,미생/Noun,17,13,4,0.00016672224074691566,6.663853039827628e-05,0.7647058823529411
7516,7516,1998년/Number,17,13,4,0.00016672224074691566,6.663853039827628e-05,0.7647058823529411
7517,7517,내사/Noun,17,13,4,0.00016672224074691566,6.663853039827628e-05,0.7647058823529411
7518,7518,토시/Noun,17,4,13,6.668889629876625e-05,0.0001665963259956907,0.7647058823529411
7519,7519,아비/Noun,17,4,13,6.668889629876625e-05,0.0001665963259956907,0.7647058823529411
7520,7520,웨스/Noun,17,13,4,0.00016672224074691566,6.663853039827628e-05,0.7647058823529411
7521,7521,붙이/Noun,17,4,13,6.668889629876625e-05,0.0001665963259956907,0.7647058823529411
7522,7522,넘사벽/Noun,17,13,4,0.00016672224074691566,6.663853039827628e-05,0.7647058823529411
7523,7523,--;;/Punctuation,17,4,13,6.668889629876625e-05,0.0001665963259956907,0.7647058823529411
7524,7524,맘마미아/Noun,17,4,13,6.668889629876625e-05,0.0001665963259956907,0.7647058823529411
7525,7525,처지다/Verb,17,4,13,6.668889629876625e-05,0.0001665963259956907,0.7647058823529411
7526,7526,쉰/Noun,17,13,4,0.00016672224074691566,6.663853039827628e-05,0.7647058823529411
7527,7527,뽑히다/Verb,17,4,13,6.668889629876625e-05,0.0001665963259956907,0.7647058823529411
7528,7528,거려/Noun,17,4,13,6.668889629876625e-05,0.0001665963259956907,0.7647058823529411
7529,7529,..~/Punctuation,17,13,4,0.00016672224074691566,6.663853039827628e-05,0.7647058823529411
7530,7530,기립박수/Noun,17,13,4,0.00016672224074691566,6.663853039827628e-05,0.7647058823529411
7531,7531,래서/Noun,17,4,13,6.668889629876625e-05,0.0001665963259956907,0.7647058823529411
7532,7532,만능/Noun,17,13,4,0.00016672224074691566,6.663853039827628e-05,0.7647058823529411
7533,7533,마당/Noun,17,4,13,6.668889629876625e-05,0.0001665963259956907,0.7647058823529411
7534,7534,시궁창/Noun,17,4,13,6.668889629876625e-05,0.0001665963259956907,0.7647058823529411
7535,7535,발랄/Noun,17,13,4,0.00016672224074691566,6.663853039827628e-05,0.7647058823529411
7536,7536,항/Noun,17,4,13,6.668889629876625e-05,0.0001665963259956907,0.7647058823529411
7537,7537,시원찮다/Adjective,17,4,13,6.668889629876625e-05,0.0001665963259956907,0.7647058823529411
7538,7538,릴/Noun,17,5,12,7.780371234856063e-05,0.00015548990426264466,0.7058823529411765
7539,7539,연쇄/Noun,17,5,12,7.780371234856063e-05,0.00015548990426264466,0.7058823529411765
7540,7540,회수/Noun,17,5,12,7.780371234856063e-05,0.00015548990426264466,0.7058823529411765
7541,7541,소금/Noun,17,5,12,7.780371234856063e-05,0.00015548990426264466,0.7058823529411765
7542,7542,아가씨/Noun,17,5,12,7.780371234856063e-05,0.00015548990426264466,0.7058823529411765
7543,7543,머임/Noun,17,5,12,7.780371234856063e-05,0.00015548990426264466,0.7058823529411765
7544,7544,위엄/Noun,17,5,12,7.780371234856063e-05,0.00015548990426264466,0.7058823529411765
7545,7545,스탭/Noun,17,12,5,0.00015560742469712126,7.774495213132233e-05,0.7058823529411765
7546,7546,다행하다/Adjective,17,12,5,0.00015560742469712126,7.774495213132233e-05,0.7058823529411765
7547,7547,비위/Noun,17,5,12,7.780371234856063e-05,0.00015548990426264466,0.7058823529411765
7548,7548,특수부대/Noun,17,5,12,7.780371234856063e-05,0.00015548990426264466,0.7058823529411765
7549,7549,신영화/Noun,17,5,12,7.780371234856063e-05,0.00015548990426264466,0.7058823529411765
7550,7550,더럽히다/Verb,17,5,12,7.780371234856063e-05,0.00015548990426264466,0.7058823529411765
7551,7551,은밀/Noun,17,5,12,7.780371234856063e-05,0.00015548990426264466,0.7058823529411765
7552,7552,요한/Noun,17,12,5,0.00015560742469712126,7.774495213132233e-05,0.7058823529411765
7553,7553,p/Alpha,17,5,12,7.780371234856063e-05,0.00015548990426264466,0.7058823529411765
7554,7554,어쩌다가/Noun,17,5,12,7.780371234856063e-05,0.00015548990426264466,0.7058823529411765
7555,7555,아버/Noun,17,5,12,7.780371234856063e-05,0.00015548990426264466,0.7058823529411765
7556,7556,뒷모습/Noun,17,12,5,0.00015560742469712126,7.774495213132233e-05,0.7058823529411765
7557,7557,우습다/Adjective,17,5,12,7.780371234856063e-05,0.00015548990426264466,0.7058823529411765
7558,7558,................../Punctuation,17,5,12,7.780371234856063e-05,0.00015548990426264466,0.7058823529411765
7559,7559,당첨/Noun,17,5,12,7.780371234856063e-05,0.00015548990426264466,0.7058823529411765
7560,7560,물어/Noun,17,5,12,7.780371234856063e-05,0.00015548990426264466,0.7058823529411765
7561,7561,9.5/Number,17,12,5,0.00015560742469712126,7.774495213132233e-05,0.7058823529411765
7562,7562,종결/Noun,17,5,12,7.780371234856063e-05,0.00015548990426264466,0.7058823529411765
7563,7563,드럼/Noun,17,12,5,0.00015560742469712126,7.774495213132233e-05,0.7058823529411765
7564,7564,영화제작/Noun,17,5,12,7.780371234856063e-05,0.00015548990426264466,0.7058823529411765
7565,7565,입술/Noun,17,5,12,7.780371234856063e-05,0.00015548990426264466,0.7058823529411765
7566,7566,졋/Noun,17,5,12,7.780371234856063e-05,0.00015548990426264466,0.7058823529411765
7567,7567,맴/Noun,17,12,5,0.00015560742469712126,7.774495213132233e-05,0.7058823529411765
7568,7568,아부/Noun,17,5,12,7.780371234856063e-05,0.00015548990426264466,0.7058823529411765
7569,7569,전기영/Noun,17,12,5,0.00015560742469712126,7.774495213132233e-05,0.7058823529411765
7570,7570,윤제문/Noun,17,12,5,0.00015560742469712126,7.774495213132233e-05,0.7058823529411765
7571,7571,라가/Noun,17,5,12,7.780371234856063e-05,0.00015548990426264466,0.7058823529411765
7572,7572,해바라기/Noun,17,5,12,7.780371234856063e-05,0.00015548990426264466,0.7058823529411765
7573,7573,이보영/Noun,17,12,5,0.00015560742469712126,7.774495213132233e-05,0.7058823529411765
7574,7574,클로즈업/Noun,17,5,12,7.780371234856063e-05,0.00015548990426264466,0.7058823529411765
7575,7575,!!!!!!!!!!!!!!/Punctuation,17,11,6,0.0001444926086473269,8.885137386436837e-05,0.6470588235294118
7576,7576,92년/Number,17,11,6,0.0001444926086473269,8.885137386436837e-05,0.6470588235294118
7577,7577,판빙빙/Noun,17,6,11,8.891852839835501e-05,0.0001443834825295986,0.6470588235294118
7578,7578,끝없이/Adverb,17,11,6,0.0001444926086473269,8.885137386436837e-05,0.6470588235294118
7579,7579,영향력/Noun,17,11,6,0.0001444926086473269,8.885137386436837e-05,0.6470588235294118
7580,7580,한류/Noun,17,6,11,8.891852839835501e-05,0.0001443834825295986,0.6470588235294118
7581,7581,몇몇/Modifier,17,6,11,8.891852839835501e-05,0.0001443834825295986,0.6470588235294118
7582,7582,내심/Noun,17,6,11,8.891852839835501e-05,0.0001443834825295986,0.6470588235294118
7583,7583,도발/Noun,17,6,11,8.891852839835501e-05,0.0001443834825295986,0.6470588235294118
7584,7584,어나/Modifier,17,6,11,8.891852839835501e-05,0.0001443834825295986,0.6470588235294118
7585,7585,서영희/Noun,17,11,6,0.0001444926086473269,8.885137386436837e-05,0.6470588235294118
7586,7586,세계대전/Noun,17,6,11,8.891852839835501e-05,0.0001443834825295986,0.6470588235294118
7587,7587,투신/Noun,17,11,6,0.0001444926086473269,8.885137386436837e-05,0.6470588235294118
7588,7588,VOD/Alpha,17,6,11,8.891852839835501e-05,0.0001443834825295986,0.6470588235294118
7589,7589,민감하다/Adjective,17,6,11,8.891852839835501e-05,0.0001443834825295986,0.6470588235294118
7590,7590,정경호/Noun,17,11,6,0.0001444926086473269,8.885137386436837e-05,0.6470588235294118
7591,7591,You/Alpha,17,11,6,0.0001444926086473269,8.885137386436837e-05,0.6470588235294118
7592,7592,휴대폰/Noun,17,6,11,8.891852839835501e-05,0.0001443834825295986,0.6470588235294118
7593,7593,인디영화/Noun,17,6,11,8.891852839835501e-05,0.0001443834825295986,0.6470588235294118
7594,7594,94년/Number,17,11,6,0.0001444926086473269,8.885137386436837e-05,0.6470588235294118
7595,7595,가격/Noun,17,6,11,8.891852839835501e-05,0.0001443834825295986,0.6470588235294118
7596,7596,사투/Noun,17,11,6,0.0001444926086473269,8.885137386436837e-05,0.6470588235294118
7597,7597,초한지/Noun,17,11,6,0.0001444926086473269,8.885137386436837e-05,0.6470588235294118
7598,7598,십/Noun,17,6,11,8.891852839835501e-05,0.0001443834825295986,0.6470588235294118
7599,7599,훨신/Noun,17,6,11,8.891852839835501e-05,0.0001443834825295986,0.6470588235294118
7600,7600,장안/Noun,17,6,11,8.891852839835501e-05,0.0001443834825295986,0.6470588235294118
7601,7601,자동/Noun,17,6,11,8.891852839835501e-05,0.0001443834825295986,0.6470588235294118
7602,7602,대명사/Noun,17,11,6,0.0001444926086473269,8.885137386436837e-05,0.6470588235294118
7603,7603,이명박/Noun,17,6,11,8.891852839835501e-05,0.0001443834825295986,0.6470588235294118
7604,7604,은영/Noun,17,6,11,8.891852839835501e-05,0.0001443834825295986,0.6470588235294118
7605,7605,사색/Noun,17,11,6,0.0001444926086473269,8.885137386436837e-05,0.6470588235294118
7606,7606,요괴/Noun,17,11,6,0.0001444926086473269,8.885137386436837e-05,0.6470588235294118
7607,7607,발킬머/Noun,17,11,6,0.0001444926086473269,8.885137386436837e-05,0.6470588235294118
7608,7608,하녀/Noun,17,6,11,8.891852839835501e-05,0.0001443834825295986,0.6470588235294118
7609,7609,디지털/Noun,17,6,11,8.891852839835501e-05,0.0001443834825295986,0.6470588235294118
7610,7610,옆집/Noun,17,6,11,8.891852839835501e-05,0.0001443834825295986,0.6470588235294118
7611,7611,후후/Exclamation,17,11,6,0.0001444926086473269,8.885137386436837e-05,0.6470588235294118
7612,7612,차이나다/Verb,17,6,11,8.891852839835501e-05,0.0001443834825295986,0.6470588235294118
7613,7613,뒷이야기/Noun,17,11,6,0.0001444926086473269,8.885137386436837e-05,0.6470588235294118
7614,7614,김지수/Noun,17,11,6,0.0001444926086473269,8.885137386436837e-05,0.6470588235294118
7615,7615,올드/Noun,17,6,11,8.891852839835501e-05,0.0001443834825295986,0.6470588235294118
7616,7616,툭/Noun,17,6,11,8.891852839835501e-05,0.0001443834825295986,0.6470588235294118
7617,7617,일로/Noun,17,6,11,8.891852839835501e-05,0.0001443834825295986,0.6470588235294118
7618,7618,사이먼/Noun,17,11,6,0.0001444926086473269,8.885137386436837e-05,0.6470588235294118
7619,7619,카이/Noun,17,11,6,0.0001444926086473269,8.885137386436837e-05,0.6470588235294118
7620,7620,유일/Noun,17,10,7,0.0001333777925975325,9.995779559741441e-05,0.5882352941176471
7621,7621,올리버/Noun,17,7,10,0.0001000333444481494,0.00013327706079655256,0.5882352941176471
7622,7622,60/Number,17,7,10,0.0001000333444481494,0.00013327706079655256,0.5882352941176471
7623,7623,공중/Noun,17,10,7,0.0001333777925975325,9.995779559741441e-05,0.5882352941176471
7624,7624,)./Punctuation,17,7,10,0.0001000333444481494,0.00013327706079655256,0.5882352941176471
7625,7625,박시연/Noun,17,10,7,0.0001333777925975325,9.995779559741441e-05,0.5882352941176471
7626,7626,실버/Noun,17,10,7,0.0001333777925975325,9.995779559741441e-05,0.5882352941176471
7627,7627,봣으/Noun,17,10,7,0.0001333777925975325,9.995779559741441e-05,0.5882352941176471
7628,7628,후려/Noun,17,7,10,0.0001000333444481494,0.00013327706079655256,0.5882352941176471
7629,7629,70/Number,17,10,7,0.0001333777925975325,9.995779559741441e-05,0.5882352941176471
7630,7630,보리/Noun,17,10,7,0.0001333777925975325,9.995779559741441e-05,0.5882352941176471
7631,7631,한가인/Noun,17,7,10,0.0001000333444481494,0.00013327706079655256,0.5882352941176471
7632,7632,인의/Noun,17,7,10,0.0001000333444481494,0.00013327706079655256,0.5882352941176471
7633,7633,볼타/Noun,17,10,7,0.0001333777925975325,9.995779559741441e-05,0.5882352941176471
7634,7634,금물/Noun,17,7,10,0.0001000333444481494,0.00013327706079655256,0.5882352941176471
7635,7635,1970년/Number,17,7,10,0.0001000333444481494,0.00013327706079655256,0.5882352941176471
7636,7636,배우진/Noun,17,7,10,0.0001000333444481494,0.00013327706079655256,0.5882352941176471
7637,7637,헨리/Noun,17,10,7,0.0001333777925975325,9.995779559741441e-05,0.5882352941176471
7638,7638,의의/Noun,17,10,7,0.0001333777925975325,9.995779559741441e-05,0.5882352941176471
7639,7639,마사/Noun,17,10,7,0.0001333777925975325,9.995779559741441e-05,0.5882352941176471
7640,7640,킬빌/Noun,17,7,10,0.0001000333444481494,0.00013327706079655256,0.5882352941176471
7641,7641,유태인/Noun,17,10,7,0.0001333777925975325,9.995779559741441e-05,0.5882352941176471
7642,7642,이런저런/Modifier,17,7,10,0.0001000333444481494,0.00013327706079655256,0.5882352941176471
7643,7643,는가/Noun,17,10,7,0.0001333777925975325,9.995779559741441e-05,0.5882352941176471
7644,7644,동방불패/Noun,17,10,7,0.0001333777925975325,9.995779559741441e-05,0.5882352941176471
7645,7645,NO/Alpha,17,7,10,0.0001000333444481494,0.00013327706079655256,0.5882352941176471
7646,7646,마루/Noun,17,10,7,0.0001333777925975325,9.995779559741441e-05,0.5882352941176471
7647,7647,브로스/Noun,17,10,7,0.0001333777925975325,9.995779559741441e-05,0.5882352941176471
7648,7648,베테/Noun,17,10,7,0.0001333777925975325,9.995779559741441e-05,0.5882352941176471
7649,7649,싱크/Noun,17,7,10,0.0001000333444481494,0.00013327706079655256,0.5882352941176471
7650,7650,일병/Noun,17,10,7,0.0001333777925975325,9.995779559741441e-05,0.5882352941176471
7651,7651,존슨/Noun,17,7,10,0.0001000333444481494,0.00013327706079655256,0.5882352941176471
7652,7652,배경음/Noun,17,10,7,0.0001333777925975325,9.995779559741441e-05,0.5882352941176471
7653,7653,10000/Number,17,10,7,0.0001333777925975325,9.995779559741441e-05,0.5882352941176471
7654,7654,백년/Noun,17,10,7,0.0001333777925975325,9.995779559741441e-05,0.5882352941176471
7655,7655,이이/Noun,17,10,7,0.0001333777925975325,9.995779559741441e-05,0.5882352941176471
7656,7656,잡기/Noun,17,7,10,0.0001000333444481494,0.00013327706079655256,0.5882352941176471
7657,7657,라라/Noun,17,8,9,0.00011114816049794375,0.00012217063906350652,0.5294117647058824
7658,7658,도록/Noun,17,9,8,0.00012226297654773814,0.00011106421733046048,0.5294117647058824
7659,7659,라나/Noun,17,9,8,0.00012226297654773814,0.00011106421733046048,0.5294117647058824
7660,7660,본분/Noun,17,9,8,0.00012226297654773814,0.00011106421733046048,0.5294117647058824
7661,7661,예감/Noun,17,9,8,0.00012226297654773814,0.00011106421733046048,0.5294117647058824
7662,7662,제대/Noun,17,9,8,0.00012226297654773814,0.00011106421733046048,0.5294117647058824
7663,7663,안도/Noun,17,8,9,0.00011114816049794375,0.00012217063906350652,0.5294117647058824
7664,7664,더글라스/Noun,17,8,9,0.00011114816049794375,0.00012217063906350652,0.5294117647058824
7665,7665,인천/Noun,17,9,8,0.00012226297654773814,0.00011106421733046048,0.5294117647058824
7666,7666,무릎/Noun,17,9,8,0.00012226297654773814,0.00011106421733046048,0.5294117647058824
7667,7667,홀딱/Noun,17,8,9,0.00011114816049794375,0.00012217063906350652,0.5294117647058824
7668,7668,?(/Punctuation,17,8,9,0.00011114816049794375,0.00012217063906350652,0.5294117647058824
7669,7669,다람쥐/Noun,17,9,8,0.00012226297654773814,0.00011106421733046048,0.5294117647058824
7670,7670,햄버거/Noun,17,9,8,0.00012226297654773814,0.00011106421733046048,0.5294117647058824
7671,7671,움직/Noun,17,9,8,0.00012226297654773814,0.00011106421733046048,0.5294117647058824
7672,7672,퍼포먼스/Noun,17,9,8,0.00012226297654773814,0.00011106421733046048,0.5294117647058824
7673,7673,다잡다/Verb,17,8,9,0.00011114816049794375,0.00012217063906350652,0.5294117647058824
7674,7674,굿닥터/Noun,17,8,9,0.00011114816049794375,0.00012217063906350652,0.5294117647058824
7675,7675,지니어스/Noun,17,9,8,0.00012226297654773814,0.00011106421733046048,0.5294117647058824
7676,7676,티스/Noun,17,9,8,0.00012226297654773814,0.00011106421733046048,0.5294117647058824
7677,7677,디자이너/Noun,17,9,8,0.00012226297654773814,0.00011106421733046048,0.5294117647058824
7678,7678,주자/Noun,17,9,8,0.00012226297654773814,0.00011106421733046048,0.5294117647058824
7679,7679,G/Alpha,17,8,9,0.00011114816049794375,0.00012217063906350652,0.5294117647058824
7680,7680,어드벤쳐/Noun,17,9,8,0.00012226297654773814,0.00011106421733046048,0.5294117647058824
7681,7681,어어/Noun,17,8,9,0.00011114816049794375,0.00012217063906350652,0.5294117647058824
7682,7682,더블/Noun,17,8,9,0.00011114816049794375,0.00012217063906350652,0.5294117647058824
7683,7683,디다/Noun,17,8,9,0.00011114816049794375,0.00012217063906350652,0.5294117647058824
7684,7684,치아/Noun,17,9,8,0.00012226297654773814,0.00011106421733046048,0.5294117647058824
7685,7685,드류/Noun,17,9,8,0.00012226297654773814,0.00011106421733046048,0.5294117647058824
7686,7686,공산당/Noun,17,9,8,0.00012226297654773814,0.00011106421733046048,0.5294117647058824
7687,7687,주년/Noun,17,8,9,0.00011114816049794375,0.00012217063906350652,0.5294117647058824
7688,7688,쿨/Noun,17,9,8,0.00012226297654773814,0.00011106421733046048,0.5294117647058824
7689,7689,옜날/Noun,17,9,8,0.00012226297654773814,0.00011106421733046048,0.5294117647058824
7690,7690,내미다/Verb,17,9,8,0.00012226297654773814,0.00011106421733046048,0.5294117647058824
7691,7691,니슨/Noun,17,8,9,0.00011114816049794375,0.00012217063906350652,0.5294117647058824
7692,7692,100만/Number,17,9,8,0.00012226297654773814,0.00011106421733046048,0.5294117647058824
7693,7693,참담하다/Adjective,17,8,9,0.00011114816049794375,0.00012217063906350652,0.5294117647058824
7694,7694,조화롭다/Adjective,17,9,8,0.00012226297654773814,0.00011106421733046048,0.5294117647058824
7695,7695,위인/Noun,17,8,9,0.00011114816049794375,0.00012217063906350652,0.5294117647058824
7696,7696,이동진/Noun,17,9,8,0.00012226297654773814,0.00011106421733046048,0.5294117647058824
7697,7697,정준영/Noun,17,9,8,0.00012226297654773814,0.00011106421733046048,0.5294117647058824
7698,7698,빼먹다/Verb,17,9,8,0.00012226297654773814,0.00011106421733046048,0.5294117647058824
7699,7699,타파/Noun,17,9,8,0.00012226297654773814,0.00011106421733046048,0.5294117647058824
7700,7700,ㅁㅈㅎ/KoreanParticle,16,0,16,2.2229632099588756e-05,0.00019991559119482882,1.0
7701,7701,이뭐병/Noun,16,0,16,2.2229632099588756e-05,0.00019991559119482882,1.0
7702,7702,코끝/Noun,16,16,0,0.0002000666888962988,2.2212843466092093e-05,1.0
7703,7703,루고/Noun,16,0,16,2.2229632099588756e-05,0.00019991559119482882,1.0
7704,7704,감격/Noun,16,16,0,0.0002000666888962988,2.2212843466092093e-05,1.0
7705,7705,bbbb/Alpha,16,16,0,0.0002000666888962988,2.2212843466092093e-05,1.0
7706,7706,박하/Noun,16,16,0,0.0002000666888962988,2.2212843466092093e-05,1.0
7707,7707,좆망/Noun,16,1,15,3.334444814938313e-05,0.0001888091694617828,0.9375
7708,7708,찰스/Noun,16,15,1,0.00018895187284650438,3.331926519913814e-05,0.9375
7709,7709,상술/Noun,16,1,15,3.334444814938313e-05,0.0001888091694617828,0.9375
7710,7710,넘침/Noun,16,15,1,0.00018895187284650438,3.331926519913814e-05,0.9375
7711,7711,공군/Noun,16,1,15,3.334444814938313e-05,0.0001888091694617828,0.9375
7712,7712,모도/Noun,16,15,1,0.00018895187284650438,3.331926519913814e-05,0.9375
7713,7713,짱깨/Noun,16,1,15,3.334444814938313e-05,0.0001888091694617828,0.9375
7714,7714,씌우다/Verb,16,1,15,3.334444814938313e-05,0.0001888091694617828,0.9375
7715,7715,am/Alpha,16,15,1,0.00018895187284650438,3.331926519913814e-05,0.9375
7716,7716,빙자/Noun,16,1,15,3.334444814938313e-05,0.0001888091694617828,0.9375
7717,7717,윤재/Noun,16,1,15,3.334444814938313e-05,0.0001888091694617828,0.9375
7718,7718,얼렁뚱땅/Noun,16,1,15,3.334444814938313e-05,0.0001888091694617828,0.9375
7719,7719,하비에르/Noun,16,15,1,0.00018895187284650438,3.331926519913814e-05,0.9375
7720,7720,표지/Noun,16,2,14,4.445926419917751e-05,0.00017770274772873674,0.875
7721,7721,부추기다/Verb,16,2,14,4.445926419917751e-05,0.00017770274772873674,0.875
7722,7722,전과/Noun,16,14,2,0.00017783705679671002,4.4425686932184186e-05,0.875
7723,7723,우수/Noun,16,14,2,0.00017783705679671002,4.4425686932184186e-05,0.875
7724,7724,샤크/Noun,16,2,14,4.445926419917751e-05,0.00017770274772873674,0.875
7725,7725,과소/Noun,16,14,2,0.00017783705679671002,4.4425686932184186e-05,0.875
7726,7726,신중하다/Adjective,16,2,14,4.445926419917751e-05,0.00017770274772873674,0.875
7727,7727,유부/Noun,16,2,14,4.445926419917751e-05,0.00017770274772873674,0.875
7728,7728,돌아이/Noun,16,2,14,4.445926419917751e-05,0.00017770274772873674,0.875
7729,7729,!!!!!!!!!!/Punctuation,16,14,2,0.00017783705679671002,4.4425686932184186e-05,0.875
7730,7730,프렌즈/Noun,16,14,2,0.00017783705679671002,4.4425686932184186e-05,0.875
7731,7731,사죄/Noun,16,2,14,4.445926419917751e-05,0.00017770274772873674,0.875
7732,7732,어렴풋이/Adverb,16,14,2,0.00017783705679671002,4.4425686932184186e-05,0.875
7733,7733,막연하다/Adjective,16,14,2,0.00017783705679671002,4.4425686932184186e-05,0.875
7734,7734,값지다/Adjective,16,14,2,0.00017783705679671002,4.4425686932184186e-05,0.875
7735,7735,수박/Noun,16,2,14,4.445926419917751e-05,0.00017770274772873674,0.875
7736,7736,찌꺼기/Noun,16,2,14,4.445926419917751e-05,0.00017770274772873674,0.875
7737,7737,사먹다/Verb,16,2,14,4.445926419917751e-05,0.00017770274772873674,0.875
7738,7738,벗/Noun,16,2,14,4.445926419917751e-05,0.00017770274772873674,0.875
7739,7739,타겟/Noun,16,2,14,4.445926419917751e-05,0.00017770274772873674,0.875
7740,7740,직설/Noun,16,14,2,0.00017783705679671002,4.4425686932184186e-05,0.875
7741,7741,볼품/Noun,16,2,14,4.445926419917751e-05,0.00017770274772873674,0.875
7742,7742,sm/Alpha,16,2,14,4.445926419917751e-05,0.00017770274772873674,0.875
7743,7743,쓰시/Noun,16,3,13,5.5574080248971876e-05,0.0001665963259956907,0.8125
7744,7744,야마카시/Noun,16,3,13,5.5574080248971876e-05,0.0001665963259956907,0.8125
7745,7745,훈훈/Noun,16,13,3,0.00016672224074691566,5.553210866523024e-05,0.8125
7746,7746,지리하다/Adjective,16,3,13,5.5574080248971876e-05,0.0001665963259956907,0.8125
7747,7747,김아중/Noun,16,13,3,0.00016672224074691566,5.553210866523024e-05,0.8125
7748,7748,연성/Noun,16,3,13,5.5574080248971876e-05,0.0001665963259956907,0.8125
7749,7749,여학생/Noun,16,3,13,5.5574080248971876e-05,0.0001665963259956907,0.8125
7750,7750,찔끔/Adverb,16,13,3,0.00016672224074691566,5.553210866523024e-05,0.8125
7751,7751,개무시/Noun,16,3,13,5.5574080248971876e-05,0.0001665963259956907,0.8125
7752,7752,하트넷/Noun,16,13,3,0.00016672224074691566,5.553210866523024e-05,0.8125
7753,7753,;;;;;;/Punctuation,16,3,13,5.5574080248971876e-05,0.0001665963259956907,0.8125
7754,7754,입사/Noun,16,3,13,5.5574080248971876e-05,0.0001665963259956907,0.8125
7755,7755,지혜/Noun,16,13,3,0.00016672224074691566,5.553210866523024e-05,0.8125
7756,7756,살의/Noun,16,13,3,0.00016672224074691566,5.553210866523024e-05,0.8125
7757,7757,리나/Noun,16,3,13,5.5574080248971876e-05,0.0001665963259956907,0.8125
7758,7758,황정음/Noun,16,13,3,0.00016672224074691566,5.553210866523024e-05,0.8125
7759,7759,강정/Noun,16,3,13,5.5574080248971876e-05,0.0001665963259956907,0.8125
7760,7760,방화/Noun,16,3,13,5.5574080248971876e-05,0.0001665963259956907,0.8125
7761,7761,색기/Noun,16,3,13,5.5574080248971876e-05,0.0001665963259956907,0.8125
7762,7762,현기증/Noun,16,13,3,0.00016672224074691566,5.553210866523024e-05,0.8125
7763,7763,갈피/Noun,16,3,13,5.5574080248971876e-05,0.0001665963259956907,0.8125
7764,7764,차려/Noun,16,3,13,5.5574080248971876e-05,0.0001665963259956907,0.8125
7765,7765,이시영/Noun,16,13,3,0.00016672224074691566,5.553210866523024e-05,0.8125
7766,7766,퇴/Noun,16,3,13,5.5574080248971876e-05,0.0001665963259956907,0.8125
7767,7767,불허/Noun,16,13,3,0.00016672224074691566,5.553210866523024e-05,0.8125
7768,7768,배틀로얄/Noun,16,3,13,5.5574080248971876e-05,0.0001665963259956907,0.8125
7769,7769,국민학교/Noun,16,13,3,0.00016672224074691566,5.553210866523024e-05,0.8125
7770,7770,무당/Noun,16,3,13,5.5574080248971876e-05,0.0001665963259956907,0.8125
7771,7771,유동근/Noun,16,13,3,0.00016672224074691566,5.553210866523024e-05,0.8125
7772,7772,매염방/Noun,16,12,4,0.00015560742469712126,6.663853039827628e-05,0.75
7773,7773,꼬박꼬박/Noun,16,12,4,0.00015560742469712126,6.663853039827628e-05,0.75
7774,7774,넘버원/Noun,16,12,4,0.00015560742469712126,6.663853039827628e-05,0.75
7775,7775,쥑/Noun,16,12,4,0.00015560742469712126,6.663853039827628e-05,0.75
7776,7776,사무엘/Noun,16,12,4,0.00015560742469712126,6.663853039827628e-05,0.75
7777,7777,be/Alpha,16,12,4,0.00015560742469712126,6.663853039827628e-05,0.75
7778,7778,자폐/Noun,16,4,12,6.668889629876625e-05,0.00015548990426264466,0.75
7779,7779,빠돌이/Noun,16,4,12,6.668889629876625e-05,0.00015548990426264466,0.75
7780,7780,세기말/Noun,16,12,4,0.00015560742469712126,6.663853039827628e-05,0.75
7781,7781,김지운/Noun,16,12,4,0.00015560742469712126,6.663853039827628e-05,0.75
7782,7782,럼/Noun,16,4,12,6.668889629876625e-05,0.00015548990426264466,0.75
7783,7783,_-/Punctuation,16,4,12,6.668889629876625e-05,0.00015548990426264466,0.75
7784,7784,화구/Noun,16,4,12,6.668889629876625e-05,0.00015548990426264466,0.75
7785,7785,가물가물/Adverb,16,12,4,0.00015560742469712126,6.663853039827628e-05,0.75
7786,7786,1995년/Number,16,12,4,0.00015560742469712126,6.663853039827628e-05,0.75
7787,7787,-_-;;;/Punctuation,16,4,12,6.668889629876625e-05,0.00015548990426264466,0.75
7788,7788,한채영/Noun,16,4,12,6.668889629876625e-05,0.00015548990426264466,0.75
7789,7789,연속극/Noun,16,4,12,6.668889629876625e-05,0.00015548990426264466,0.75
7790,7790,뜻밖/Noun,16,12,4,0.00015560742469712126,6.663853039827628e-05,0.75
7791,7791,손녀/Noun,16,4,12,6.668889629876625e-05,0.00015548990426264466,0.75
7792,7792,상품/Noun,16,4,12,6.668889629876625e-05,0.00015548990426264466,0.75
7793,7793,장엄하다/Adjective,16,12,4,0.00015560742469712126,6.663853039827628e-05,0.75
7794,7794,꼽으라/Noun,16,12,4,0.00015560742469712126,6.663853039827628e-05,0.75
7795,7795,앙상블/Noun,16,12,4,0.00015560742469712126,6.663853039827628e-05,0.75
7796,7796,피닉스/Noun,16,12,4,0.00015560742469712126,6.663853039827628e-05,0.75
7797,7797,건축/Noun,16,12,4,0.00015560742469712126,6.663853039827628e-05,0.75
7798,7798,알콩달콩/Noun,16,12,4,0.00015560742469712126,6.663853039827628e-05,0.75
7799,7799,개쩜/Noun,16,12,4,0.00015560742469712126,6.663853039827628e-05,0.75
7800,7800,두기/Noun,16,12,4,0.00015560742469712126,6.663853039827628e-05,0.75
7801,7801,...??/Punctuation,16,4,12,6.668889629876625e-05,0.00015548990426264466,0.75
7802,7802,시내/Noun,16,4,12,6.668889629876625e-05,0.00015548990426264466,0.75
7803,7803,김상경/Noun,16,12,4,0.00015560742469712126,6.663853039827628e-05,0.75
7804,7804,우기/Noun,16,4,12,6.668889629876625e-05,0.00015548990426264466,0.75
7805,7805,숙제/Noun,16,12,4,0.00015560742469712126,6.663853039827628e-05,0.75
7806,7806,"...""/Punctuation",16,4,12,6.668889629876625e-05,0.00015548990426264466,0.75
7807,7807,설계/Noun,16,4,12,6.668889629876625e-05,0.00015548990426264466,0.75
7808,7808,베댓/Noun,16,4,12,6.668889629876625e-05,0.00015548990426264466,0.75
7809,7809,불편/Noun,16,4,12,6.668889629876625e-05,0.00015548990426264466,0.75
7810,7810,코메/Noun,16,4,12,6.668889629876625e-05,0.00015548990426264466,0.75
7811,7811,바리/Noun,16,4,12,6.668889629876625e-05,0.00015548990426264466,0.75
7812,7812,파커/Noun,16,12,4,0.00015560742469712126,6.663853039827628e-05,0.75
7813,7813,십분/Noun,16,4,12,6.668889629876625e-05,0.00015548990426264466,0.75
7814,7814,바둑/Noun,16,4,12,6.668889629876625e-05,0.00015548990426264466,0.75
7815,7815,제압/Noun,16,4,12,6.668889629876625e-05,0.00015548990426264466,0.75
7816,7816,집어치우다/Verb,16,4,12,6.668889629876625e-05,0.00015548990426264466,0.75
7817,7817,치의/Noun,16,12,4,0.00015560742469712126,6.663853039827628e-05,0.75
7818,7818,간혹/Noun,16,5,11,7.780371234856063e-05,0.0001443834825295986,0.6875
7819,7819,힘차다/Adjective,16,5,11,7.780371234856063e-05,0.0001443834825295986,0.6875
7820,7820,맥과이어/Noun,16,11,5,0.0001444926086473269,7.774495213132233e-05,0.6875
7821,7821,쉐프/Noun,16,5,11,7.780371234856063e-05,0.0001443834825295986,0.6875
7822,7822,민영화/Noun,16,11,5,0.0001444926086473269,7.774495213132233e-05,0.6875
7823,7823,외설/Noun,16,5,11,7.780371234856063e-05,0.0001443834825295986,0.6875
7824,7824,도서관/Noun,16,11,5,0.0001444926086473269,7.774495213132233e-05,0.6875
7825,7825,나마/Noun,16,11,5,0.0001444926086473269,7.774495213132233e-05,0.6875
7826,7826,후딱/Adverb,16,11,5,0.0001444926086473269,7.774495213132233e-05,0.6875
7827,7827,도둑질/Noun,16,5,11,7.780371234856063e-05,0.0001443834825295986,0.6875
7828,7828,일과/Noun,16,11,5,0.0001444926086473269,7.774495213132233e-05,0.6875
7829,7829,다다/Noun,16,5,11,7.780371234856063e-05,0.0001443834825295986,0.6875
7830,7830,혼합/Noun,16,5,11,7.780371234856063e-05,0.0001443834825295986,0.6875
7831,7831,끈끈/Noun,16,11,5,0.0001444926086473269,7.774495213132233e-05,0.6875
7832,7832,사위/Noun,16,5,11,7.780371234856063e-05,0.0001443834825295986,0.6875
7833,7833,타고나다/Verb,16,11,5,0.0001444926086473269,7.774495213132233e-05,0.6875
7834,7834,TOP/Alpha,16,11,5,0.0001444926086473269,7.774495213132233e-05,0.6875
7835,7835,괴리감/Noun,16,5,11,7.780371234856063e-05,0.0001443834825295986,0.6875
7836,7836,지로/Noun,16,5,11,7.780371234856063e-05,0.0001443834825295986,0.6875
7837,7837,확장/Noun,16,11,5,0.0001444926086473269,7.774495213132233e-05,0.6875
7838,7838,김민정/Noun,16,11,5,0.0001444926086473269,7.774495213132233e-05,0.6875
7839,7839,세포/Noun,16,11,5,0.0001444926086473269,7.774495213132233e-05,0.6875
7840,7840,시티/Noun,16,11,5,0.0001444926086473269,7.774495213132233e-05,0.6875
7841,7841,이영애/Noun,16,11,5,0.0001444926086473269,7.774495213132233e-05,0.6875
7842,7842,줄어들다/Verb,16,11,5,0.0001444926086473269,7.774495213132233e-05,0.6875
7843,7843,대회/Noun,16,5,11,7.780371234856063e-05,0.0001443834825295986,0.6875
7844,7844,똥파리/Noun,16,5,11,7.780371234856063e-05,0.0001443834825295986,0.6875
7845,7845,극우/Noun,16,5,11,7.780371234856063e-05,0.0001443834825295986,0.6875
7846,7846,곽경택/Noun,16,5,11,7.780371234856063e-05,0.0001443834825295986,0.6875
7847,7847,세로/Noun,16,5,11,7.780371234856063e-05,0.0001443834825295986,0.6875
7848,7848,수출/Noun,16,5,11,7.780371234856063e-05,0.0001443834825295986,0.6875
7849,7849,쌀/Noun,16,11,5,0.0001444926086473269,7.774495213132233e-05,0.6875
7850,7850,겜/Noun,16,11,5,0.0001444926086473269,7.774495213132233e-05,0.6875
7851,7851,고정관념/Noun,16,11,5,0.0001444926086473269,7.774495213132233e-05,0.6875
7852,7852,치도/Noun,16,11,5,0.0001444926086473269,7.774495213132233e-05,0.6875
7853,7853,민중/Noun,16,11,5,0.0001444926086473269,7.774495213132233e-05,0.6875
7854,7854,고하/Noun,16,5,11,7.780371234856063e-05,0.0001443834825295986,0.6875
7855,7855,23/Number,16,11,5,0.0001444926086473269,7.774495213132233e-05,0.6875
7856,7856,으아아/Exclamation,16,5,11,7.780371234856063e-05,0.0001443834825295986,0.6875
7857,7857,오마이갓/Noun,16,5,11,7.780371234856063e-05,0.0001443834825295986,0.6875
7858,7858,효과음/Noun,16,5,11,7.780371234856063e-05,0.0001443834825295986,0.6875
7859,7859,모조리/Noun,16,5,11,7.780371234856063e-05,0.0001443834825295986,0.6875
7860,7860,쇼생크탈출/Noun,16,11,5,0.0001444926086473269,7.774495213132233e-05,0.6875
7861,7861,닐/Noun,16,10,6,0.0001333777925975325,8.885137386436837e-05,0.625
7862,7862,여느/Noun,16,10,6,0.0001333777925975325,8.885137386436837e-05,0.625
7863,7863,깨우치다/Verb,16,10,6,0.0001333777925975325,8.885137386436837e-05,0.625
7864,7864,밭/Noun,16,10,6,0.0001333777925975325,8.885137386436837e-05,0.625
7865,7865,안전/Noun,16,6,10,8.891852839835501e-05,0.00013327706079655256,0.625
7866,7866,라디오스타/Noun,16,6,10,8.891852839835501e-05,0.00013327706079655256,0.625
7867,7867,억/Suffix,16,10,6,0.0001333777925975325,8.885137386436837e-05,0.625
7868,7868,정무문/Noun,16,10,6,0.0001333777925975325,8.885137386436837e-05,0.625
7869,7869,오시/Noun,16,6,10,8.891852839835501e-05,0.00013327706079655256,0.625
7870,7870,였음/Eomi,16,6,10,8.891852839835501e-05,0.00013327706079655256,0.625
7871,7871,차용/Noun,16,6,10,8.891852839835501e-05,0.00013327706079655256,0.625
7872,7872,라디오/Noun,16,10,6,0.0001333777925975325,8.885137386436837e-05,0.625
7873,7873,내포/Noun,16,10,6,0.0001333777925975325,8.885137386436837e-05,0.625
7874,7874,병들다/Verb,16,6,10,8.891852839835501e-05,0.00013327706079655256,0.625
7875,7875,마법사/Noun,16,10,6,0.0001333777925975325,8.885137386436837e-05,0.625
7876,7876,소지/Noun,16,6,10,8.891852839835501e-05,0.00013327706079655256,0.625
7877,7877,포켓몬스터/Noun,16,10,6,0.0001333777925975325,8.885137386436837e-05,0.625
7878,7878,어르신/Noun,16,10,6,0.0001333777925975325,8.885137386436837e-05,0.625
7879,7879,가방/Noun,16,6,10,8.891852839835501e-05,0.00013327706079655256,0.625
7880,7880,미사/Noun,16,10,6,0.0001333777925975325,8.885137386436837e-05,0.625
7881,7881,샤론/Noun,16,6,10,8.891852839835501e-05,0.00013327706079655256,0.625
7882,7882,메이킹/Noun,16,6,10,8.891852839835501e-05,0.00013327706079655256,0.625
7883,7883,복습/Noun,16,10,6,0.0001333777925975325,8.885137386436837e-05,0.625
7884,7884,죄인/Noun,16,6,10,8.891852839835501e-05,0.00013327706079655256,0.625
7885,7885,점줄/Noun,16,6,10,8.891852839835501e-05,0.00013327706079655256,0.625
7886,7886,소심하다/Adjective,16,6,10,8.891852839835501e-05,0.00013327706079655256,0.625
7887,7887,v/Alpha,16,6,10,8.891852839835501e-05,0.00013327706079655256,0.625
7888,7888,뮬란/Noun,16,10,6,0.0001333777925975325,8.885137386436837e-05,0.625
7889,7889,찍어내다/Verb,16,6,10,8.891852839835501e-05,0.00013327706079655256,0.625
7890,7890,저스틴/Noun,16,6,10,8.891852839835501e-05,0.00013327706079655256,0.625
7891,7891,요시/Noun,16,6,10,8.891852839835501e-05,0.00013327706079655256,0.625
7892,7892,도리/Noun,16,10,6,0.0001333777925975325,8.885137386436837e-05,0.625
7893,7893,각종/Noun,16,10,6,0.0001333777925975325,8.885137386436837e-05,0.625
7894,7894,도달/Noun,16,6,10,8.891852839835501e-05,0.00013327706079655256,0.625
7895,7895,거꾸로/Noun,16,6,10,8.891852839835501e-05,0.00013327706079655256,0.625
7896,7896,슬/Noun,16,10,6,0.0001333777925975325,8.885137386436837e-05,0.625
7897,7897,알라/Noun,16,10,6,0.0001333777925975325,8.885137386436837e-05,0.625
7898,7898,라던가/Josa,16,6,10,8.891852839835501e-05,0.00013327706079655256,0.625
7899,7899,폭스/Noun,16,10,6,0.0001333777925975325,8.885137386436837e-05,0.625
7900,7900,사탄/Noun,16,6,10,8.891852839835501e-05,0.00013327706079655256,0.625
7901,7901,약해지다/Verb,16,6,10,8.891852839835501e-05,0.00013327706079655256,0.625
7902,7902,저걸/Noun,16,6,10,8.891852839835501e-05,0.00013327706079655256,0.625
7903,7903,엘/Josa,16,10,6,0.0001333777925975325,8.885137386436837e-05,0.625
7904,7904,자임/Noun,16,6,10,8.891852839835501e-05,0.00013327706079655256,0.625
7905,7905,앨런/Noun,16,10,6,0.0001333777925975325,8.885137386436837e-05,0.625
7906,7906,랫/Noun,16,6,10,8.891852839835501e-05,0.00013327706079655256,0.625
7907,7907,딸도/Noun,16,6,10,8.891852839835501e-05,0.00013327706079655256,0.625
7908,7908,외도/Noun,16,6,10,8.891852839835501e-05,0.00013327706079655256,0.625
7909,7909,후련하다/Adjective,16,10,6,0.0001333777925975325,8.885137386436837e-05,0.625
7910,7910,출생/Noun,16,6,10,8.891852839835501e-05,0.00013327706079655256,0.625
7911,7911,차고/Noun,16,6,10,8.891852839835501e-05,0.00013327706079655256,0.625
7912,7912,ㅛ/KoreanParticle,16,9,7,0.00012226297654773814,9.995779559741441e-05,0.5625
7913,7913,김우빈/Noun,16,9,7,0.00012226297654773814,9.995779559741441e-05,0.5625
7914,7914,꼬리/Noun,16,9,7,0.00012226297654773814,9.995779559741441e-05,0.5625
7915,7915,송일국/Noun,16,9,7,0.00012226297654773814,9.995779559741441e-05,0.5625
7916,7916,샤/Noun,16,7,9,0.0001000333444481494,0.00012217063906350652,0.5625
7917,7917,취/Noun,16,7,9,0.0001000333444481494,0.00012217063906350652,0.5625
7918,7918,증언/Noun,16,7,9,0.0001000333444481494,0.00012217063906350652,0.5625
7919,7919,안구/Noun,16,9,7,0.00012226297654773814,9.995779559741441e-05,0.5625
7920,7920,엘리베이터/Noun,16,9,7,0.00012226297654773814,9.995779559741441e-05,0.5625
7921,7921,설날/Noun,16,9,7,0.00012226297654773814,9.995779559741441e-05,0.5625
7922,7922,부치다/Verb,16,7,9,0.0001000333444481494,0.00012217063906350652,0.5625
7923,7923,하느님/Noun,16,9,7,0.00012226297654773814,9.995779559741441e-05,0.5625
7924,7924,청순하다/Adjective,16,9,7,0.00012226297654773814,9.995779559741441e-05,0.5625
7925,7925,소위/Noun,16,9,7,0.00012226297654773814,9.995779559741441e-05,0.5625
7926,7926,트렌드/Noun,16,7,9,0.0001000333444481494,0.00012217063906350652,0.5625
7927,7927,실질/Noun,16,9,7,0.00012226297654773814,9.995779559741441e-05,0.5625
7928,7928,기교/Noun,16,7,9,0.0001000333444481494,0.00012217063906350652,0.5625
7929,7929,결심/Noun,16,7,9,0.0001000333444481494,0.00012217063906350652,0.5625
7930,7930,무언/Noun,16,7,9,0.0001000333444481494,0.00012217063906350652,0.5625
7931,7931,96년/Number,16,7,9,0.0001000333444481494,0.00012217063906350652,0.5625
7932,7932,모래/Noun,16,7,9,0.0001000333444481494,0.00012217063906350652,0.5625
7933,7933,초창/Noun,16,9,7,0.00012226297654773814,9.995779559741441e-05,0.5625
7934,7934,용면/Noun,16,7,9,0.0001000333444481494,0.00012217063906350652,0.5625
7935,7935,들어맞다/Verb,16,7,9,0.0001000333444481494,0.00012217063906350652,0.5625
7936,7936,태희/Noun,16,9,7,0.00012226297654773814,9.995779559741441e-05,0.5625
7937,7937,P/Alpha,16,9,7,0.00012226297654773814,9.995779559741441e-05,0.5625
7938,7938,강철/Noun,16,9,7,0.00012226297654773814,9.995779559741441e-05,0.5625
7939,7939,생물/Noun,16,7,9,0.0001000333444481494,0.00012217063906350652,0.5625
7940,7940,후손/Noun,16,7,9,0.0001000333444481494,0.00012217063906350652,0.5625
7941,7941,마키/Noun,16,7,9,0.0001000333444481494,0.00012217063906350652,0.5625
7942,7942,닌/Noun,16,7,9,0.0001000333444481494,0.00012217063906350652,0.5625
7943,7943,2만/Number,16,9,7,0.00012226297654773814,9.995779559741441e-05,0.5625
7944,7944,은하/Noun,16,9,7,0.00012226297654773814,9.995779559741441e-05,0.5625
7945,7945,선보이다/Verb,16,7,9,0.0001000333444481494,0.00012217063906350652,0.5625
7946,7946,악한/Noun,16,9,7,0.00012226297654773814,9.995779559741441e-05,0.5625
7947,7947,갠차다/Adjective,16,7,9,0.0001000333444481494,0.00012217063906350652,0.5625
7948,7948,강용석/Noun,16,7,9,0.0001000333444481494,0.00012217063906350652,0.5625
7949,7949,아메리카/Noun,16,7,9,0.0001000333444481494,0.00012217063906350652,0.5625
7950,7950,생산/Noun,16,7,9,0.0001000333444481494,0.00012217063906350652,0.5625
7951,7951,절친/Noun,16,7,9,0.0001000333444481494,0.00012217063906350652,0.5625
7952,7952,다투다/Verb,16,9,7,0.00012226297654773814,9.995779559741441e-05,0.5625
7953,7953,어쩌나/Adverb,16,9,7,0.00012226297654773814,9.995779559741441e-05,0.5625
7954,7954,태극기/Noun,16,7,9,0.0001000333444481494,0.00012217063906350652,0.5625
7955,7955,니모/Noun,16,7,9,0.0001000333444481494,0.00012217063906350652,0.5625
7956,7956,정복/Noun,16,9,7,0.00012226297654773814,9.995779559741441e-05,0.5625
7957,7957,써니/Noun,16,7,9,0.0001000333444481494,0.00012217063906350652,0.5625
7958,7958,앤더슨/Noun,16,9,7,0.00012226297654773814,9.995779559741441e-05,0.5625
7959,7959,태민/Noun,16,7,9,0.0001000333444481494,0.00012217063906350652,0.5625
7960,7960,공정하다/Adjective,16,7,9,0.0001000333444481494,0.00012217063906350652,0.5625
7961,7961,ㅔ/KoreanParticle,16,9,7,0.00012226297654773814,9.995779559741441e-05,0.5625
7962,7962,오픈/Noun,16,8,8,0.00011114816049794375,0.00011106421733046048,0.5
7963,7963,문성근/Noun,16,8,8,0.00011114816049794375,0.00011106421733046048,0.5
7964,7964,5월/Number,16,8,8,0.00011114816049794375,0.00011106421733046048,0.5
7965,7965,노트북/Noun,16,8,8,0.00011114816049794375,0.00011106421733046048,0.5
7966,7966,1999년/Number,16,8,8,0.00011114816049794375,0.00011106421733046048,0.5
7967,7967,산이/Noun,16,8,8,0.00011114816049794375,0.00011106421733046048,0.5
7968,7968,수사물/Noun,16,8,8,0.00011114816049794375,0.00011106421733046048,0.5
7969,7969,신자/Noun,16,8,8,0.00011114816049794375,0.00011106421733046048,0.5
7970,7970,백설공주/Noun,16,8,8,0.00011114816049794375,0.00011106421733046048,0.5
7971,7971,첫날/Noun,16,8,8,0.00011114816049794375,0.00011106421733046048,0.5
7972,7972,.)/Punctuation,16,8,8,0.00011114816049794375,0.00011106421733046048,0.5
7973,7973,들/Noun,16,8,8,0.00011114816049794375,0.00011106421733046048,0.5
7974,7974,번의/Noun,16,8,8,0.00011114816049794375,0.00011106421733046048,0.5
7975,7975,6.25/Number,16,8,8,0.00011114816049794375,0.00011106421733046048,0.5
7976,7976,쪼금/Noun,16,8,8,0.00011114816049794375,0.00011106421733046048,0.5
7977,7977,오오/Noun,16,8,8,0.00011114816049794375,0.00011106421733046048,0.5
7978,7978,검색어/Noun,16,8,8,0.00011114816049794375,0.00011106421733046048,0.5
7979,7979,출시/Noun,16,8,8,0.00011114816049794375,0.00011106421733046048,0.5
7980,7980,성시경/Noun,16,8,8,0.00011114816049794375,0.00011106421733046048,0.5
7981,7981,그간/Noun,16,8,8,0.00011114816049794375,0.00011106421733046048,0.5
7982,7982,공장/Noun,16,8,8,0.00011114816049794375,0.00011106421733046048,0.5
7983,7983,제이콥/Noun,16,8,8,0.00011114816049794375,0.00011106421733046048,0.5
7984,7984,바위/Noun,16,8,8,0.00011114816049794375,0.00011106421733046048,0.5
7985,7985,다임/Noun,15,0,15,2.2229632099588756e-05,0.0001888091694617828,1.0
7986,7986,감회/Noun,15,15,0,0.00018895187284650438,2.2212843466092093e-05,1.0
7987,7987,리좀/Noun,15,0,15,2.2229632099588756e-05,0.0001888091694617828,1.0
7988,7988,이상자/Noun,15,0,15,2.2229632099588756e-05,0.0001888091694617828,1.0
7989,7989,이수정/Noun,15,0,15,2.2229632099588756e-05,0.0001888091694617828,1.0
7990,7990,어루만지다/Verb,15,15,0,0.00018895187284650438,2.2212843466092093e-05,1.0
7991,7991,보다가/Foreign,15,0,15,2.2229632099588756e-05,0.0001888091694617828,1.0
7992,7992,왕정/Noun,15,0,15,2.2229632099588756e-05,0.0001888091694617828,1.0
7993,7993,폭풍눈물/Noun,15,15,0,0.00018895187284650438,2.2212843466092093e-05,1.0
7994,7994,착오/Noun,15,0,15,2.2229632099588756e-05,0.0001888091694617828,1.0
7995,7995,밋/Noun,15,15,0,0.00018895187284650438,2.2212843466092093e-05,1.0
7996,7996,대자연/Noun,15,15,0,0.00018895187284650438,2.2212843466092093e-05,1.0
7997,7997,중국산/Noun,15,0,15,2.2229632099588756e-05,0.0001888091694617828,1.0
7998,7998,잼슴/Noun,15,14,1,0.00017783705679671002,3.331926519913814e-05,0.9333333333333332
7999,7999,설마설마/Adverb,15,1,14,3.334444814938313e-05,0.00017770274772873674,0.9333333333333332
8000,8000,핫세/Noun,15,14,1,0.00017783705679671002,3.331926519913814e-05,0.9333333333333332
8001,8001,넣기/Noun,15,1,14,3.334444814938313e-05,0.00017770274772873674,0.9333333333333332
8002,8002,음미/Noun,15,14,1,0.00017783705679671002,3.331926519913814e-05,0.9333333333333332
8003,8003,boring/Alpha,15,1,14,3.334444814938313e-05,0.00017770274772873674,0.9333333333333332
8004,8004,아포칼립토/Noun,15,1,14,3.334444814938313e-05,0.00017770274772873674,0.9333333333333332
8005,8005,잘봣어/Noun,15,14,1,0.00017783705679671002,3.331926519913814e-05,0.9333333333333332
8006,8006,신소율/Noun,15,1,14,3.334444814938313e-05,0.00017770274772873674,0.9333333333333332
8007,8007,더티/Noun,15,1,14,3.334444814938313e-05,0.00017770274772873674,0.9333333333333332
8008,8008,무능력하다/Adjective,15,1,14,3.334444814938313e-05,0.00017770274772873674,0.9333333333333332
8009,8009,대소/Noun,15,14,1,0.00017783705679671002,3.331926519913814e-05,0.9333333333333332
8010,8010,성관계/Noun,15,1,14,3.334444814938313e-05,0.00017770274772873674,0.9333333333333332
8011,8011,핥다/Verb,15,1,14,3.334444814938313e-05,0.00017770274772873674,0.9333333333333332
8012,8012,보듬다/Verb,15,14,1,0.00017783705679671002,3.331926519913814e-05,0.9333333333333332
8013,8013,Best/Alpha,15,14,1,0.00017783705679671002,3.331926519913814e-05,0.9333333333333332
8014,8014,반했어/Noun,15,14,1,0.00017783705679671002,3.331926519913814e-05,0.9333333333333332
8015,8015,호모/Noun,15,1,14,3.334444814938313e-05,0.00017770274772873674,0.9333333333333332
8016,8016,로치/Noun,15,14,1,0.00017783705679671002,3.331926519913814e-05,0.9333333333333332
8017,8017,아른거리다/Verb,15,14,1,0.00017783705679671002,3.331926519913814e-05,0.9333333333333332
8018,8018,리슨/Noun,15,13,2,0.00016672224074691566,4.4425686932184186e-05,0.8666666666666667
8019,8019,참되다/Adjective,15,13,2,0.00016672224074691566,4.4425686932184186e-05,0.8666666666666667
8020,8020,아청법/Noun,15,2,13,4.445926419917751e-05,0.0001665963259956907,0.8666666666666667
8021,8021,편승/Noun,15,2,13,4.445926419917751e-05,0.0001665963259956907,0.8666666666666667
8022,8022,도현/Noun,15,2,13,4.445926419917751e-05,0.0001665963259956907,0.8666666666666667
8023,8023,버겁다/Adjective,15,2,13,4.445926419917751e-05,0.0001665963259956907,0.8666666666666667
8024,8024,잡다하다/Adjective,15,2,13,4.445926419917751e-05,0.0001665963259956907,0.8666666666666667
8025,8025,귀여니/Noun,15,2,13,4.445926419917751e-05,0.0001665963259956907,0.8666666666666667
8026,8026,오지랖/Noun,15,2,13,4.445926419917751e-05,0.0001665963259956907,0.8666666666666667
8027,8027,노년/Noun,15,13,2,0.00016672224074691566,4.4425686932184186e-05,0.8666666666666667
8028,8028,헬/Noun,15,2,13,4.445926419917751e-05,0.0001665963259956907,0.8666666666666667
8029,8029,조사/Noun,15,2,13,4.445926419917751e-05,0.0001665963259956907,0.8666666666666667
8030,8030,나니아/Noun,15,13,2,0.00016672224074691566,4.4425686932184186e-05,0.8666666666666667
8031,8031,위력/Noun,15,13,2,0.00016672224074691566,4.4425686932184186e-05,0.8666666666666667
8032,8032,우어/Noun,15,13,2,0.00016672224074691566,4.4425686932184186e-05,0.8666666666666667
8033,8033,쒯/Noun,15,2,13,4.445926419917751e-05,0.0001665963259956907,0.8666666666666667
8034,8034,투영/Noun,15,13,2,0.00016672224074691566,4.4425686932184186e-05,0.8666666666666667
8035,8035,임상수/Noun,15,2,13,4.445926419917751e-05,0.0001665963259956907,0.8666666666666667
8036,8036,워스트/Noun,15,2,13,4.445926419917751e-05,0.0001665963259956907,0.8666666666666667
8037,8037,히로/Noun,15,13,2,0.00016672224074691566,4.4425686932184186e-05,0.8666666666666667
8038,8038,박아/Noun,15,2,13,4.445926419917751e-05,0.0001665963259956907,0.8666666666666667
8039,8039,도신/Noun,15,2,13,4.445926419917751e-05,0.0001665963259956907,0.8666666666666667
8040,8040,사족/Noun,15,2,13,4.445926419917751e-05,0.0001665963259956907,0.8666666666666667
8041,8041,챔피언/Noun,15,13,2,0.00016672224074691566,4.4425686932184186e-05,0.8666666666666667
8042,8042,무차별/Noun,15,2,13,4.445926419917751e-05,0.0001665963259956907,0.8666666666666667
8043,8043,;;;;;/Punctuation,15,2,13,4.445926419917751e-05,0.0001665963259956907,0.8666666666666667
8044,8044,발매/Noun,15,13,2,0.00016672224074691566,4.4425686932184186e-05,0.8666666666666667
8045,8045,독수리/Noun,15,2,13,4.445926419917751e-05,0.0001665963259956907,0.8666666666666667
8046,8046,무관/Noun,15,2,13,4.445926419917751e-05,0.0001665963259956907,0.8666666666666667
8047,8047,연예계/Noun,15,2,13,4.445926419917751e-05,0.0001665963259956907,0.8666666666666667
8048,8048,소망/Noun,15,13,2,0.00016672224074691566,4.4425686932184186e-05,0.8666666666666667
8049,8049,차예련/Noun,15,2,13,4.445926419917751e-05,0.0001665963259956907,0.8666666666666667
8050,8050,안무/Noun,15,2,13,4.445926419917751e-05,0.0001665963259956907,0.8666666666666667
8051,8051,장학우/Noun,15,12,3,0.00015560742469712126,5.553210866523024e-05,0.8
8052,8052,분만/Noun,15,3,12,5.5574080248971876e-05,0.00015548990426264466,0.8
8053,8053,누드/Noun,15,3,12,5.5574080248971876e-05,0.00015548990426264466,0.8
8054,8054,다지/Noun,15,3,12,5.5574080248971876e-05,0.00015548990426264466,0.8
8055,8055,자칭/Noun,15,3,12,5.5574080248971876e-05,0.00015548990426264466,0.8
8056,8056,R/Alpha,15,12,3,0.00015560742469712126,5.553210866523024e-05,0.8
8057,8057,능력자/Noun,15,3,12,5.5574080248971876e-05,0.00015548990426264466,0.8
8058,8058,꿀잼임/Noun,15,12,3,0.00015560742469712126,5.553210866523024e-05,0.8
8059,8059,잠기다/Verb,15,12,3,0.00015560742469712126,5.553210866523024e-05,0.8
8060,8060,인양/Noun,15,3,12,5.5574080248971876e-05,0.00015548990426264466,0.8
8061,8061,지수/Noun,15,3,12,5.5574080248971876e-05,0.00015548990426264466,0.8
8062,8062,눈가/Noun,15,12,3,0.00015560742469712126,5.553210866523024e-05,0.8
8063,8063,카펜터/Noun,15,3,12,5.5574080248971876e-05,0.00015548990426264466,0.8
8064,8064,오버액션/Noun,15,3,12,5.5574080248971876e-05,0.00015548990426264466,0.8
8065,8065,가려진/Noun,15,12,3,0.00015560742469712126,5.553210866523024e-05,0.8
8066,8066,that/Alpha,15,12,3,0.00015560742469712126,5.553210866523024e-05,0.8
8067,8067,맴돈다/Verb,15,12,3,0.00015560742469712126,5.553210866523024e-05,0.8
8068,8068,노부/Noun,15,12,3,0.00015560742469712126,5.553210866523024e-05,0.8
8069,8069,정준하/Noun,15,3,12,5.5574080248971876e-05,0.00015548990426264466,0.8
8070,8070,사치/Noun,15,3,12,5.5574080248971876e-05,0.00015548990426264466,0.8
8071,8071,갈구다/Verb,15,12,3,0.00015560742469712126,5.553210866523024e-05,0.8
8072,8072,폭행/Noun,15,3,12,5.5574080248971876e-05,0.00015548990426264466,0.8
8073,8073,선명하다/Adjective,15,12,3,0.00015560742469712126,5.553210866523024e-05,0.8
8074,8074,황진이/Noun,15,12,3,0.00015560742469712126,5.553210866523024e-05,0.8
8075,8075,장하다/Adjective,15,3,12,5.5574080248971876e-05,0.00015548990426264466,0.8
8076,8076,티켓/Noun,15,3,12,5.5574080248971876e-05,0.00015548990426264466,0.8
8077,8077,장님/Noun,15,12,3,0.00015560742469712126,5.553210866523024e-05,0.8
8078,8078,세밀/Noun,15,12,3,0.00015560742469712126,5.553210866523024e-05,0.8
8079,8079,각본가/Noun,15,3,12,5.5574080248971876e-05,0.00015548990426264466,0.8
8080,8080,뿅/Adverb,15,12,3,0.00015560742469712126,5.553210866523024e-05,0.8
8081,8081,깊숙하다/Adjective,15,12,3,0.00015560742469712126,5.553210866523024e-05,0.8
8082,8082,버릇/Noun,15,4,11,6.668889629876625e-05,0.0001443834825295986,0.7333333333333333
8083,8083,혼신/Noun,15,11,4,0.0001444926086473269,6.663853039827628e-05,0.7333333333333333
8084,8084,토리/Noun,15,4,11,6.668889629876625e-05,0.0001443834825295986,0.7333333333333333
8085,8085,웅/Noun,15,11,4,0.0001444926086473269,6.663853039827628e-05,0.7333333333333333
8086,8086,로멘틱/Noun,15,11,4,0.0001444926086473269,6.663853039827628e-05,0.7333333333333333
8087,8087,격정/Noun,15,11,4,0.0001444926086473269,6.663853039827628e-05,0.7333333333333333
8088,8088,커다랗다/Adjective,15,11,4,0.0001444926086473269,6.663853039827628e-05,0.7333333333333333
8089,8089,불문/Noun,15,4,11,6.668889629876625e-05,0.0001443834825295986,0.7333333333333333
8090,8090,료/Noun,15,4,11,6.668889629876625e-05,0.0001443834825295986,0.7333333333333333
8091,8091,가발/Noun,15,4,11,6.668889629876625e-05,0.0001443834825295986,0.7333333333333333
8092,8092,걸어가다/Verb,15,11,4,0.0001444926086473269,6.663853039827628e-05,0.7333333333333333
8093,8093,고조/Noun,15,11,4,0.0001444926086473269,6.663853039827628e-05,0.7333333333333333
8094,8094,단언컨대/Noun,15,11,4,0.0001444926086473269,6.663853039827628e-05,0.7333333333333333
8095,8095,바람직하다/Adjective,15,11,4,0.0001444926086473269,6.663853039827628e-05,0.7333333333333333
8096,8096,꿈속/Noun,15,11,4,0.0001444926086473269,6.663853039827628e-05,0.7333333333333333
8097,8097,매달리다/Verb,15,4,11,6.668889629876625e-05,0.0001443834825295986,0.7333333333333333
8098,8098,모음/Noun,15,4,11,6.668889629876625e-05,0.0001443834825295986,0.7333333333333333
8099,8099,88년/Number,15,11,4,0.0001444926086473269,6.663853039827628e-05,0.7333333333333333
8100,8100,발끝/Noun,15,4,11,6.668889629876625e-05,0.0001443834825295986,0.7333333333333333
8101,8101,데스티네이션/Noun,15,4,11,6.668889629876625e-05,0.0001443834825295986,0.7333333333333333
8102,8102,편협/Noun,15,4,11,6.668889629876625e-05,0.0001443834825295986,0.7333333333333333
8103,8103,이하나/Noun,15,11,4,0.0001444926086473269,6.663853039827628e-05,0.7333333333333333
8104,8104,우애/Noun,15,11,4,0.0001444926086473269,6.663853039827628e-05,0.7333333333333333
8105,8105,썰전/Noun,15,4,11,6.668889629876625e-05,0.0001443834825295986,0.7333333333333333
8106,8106,비스트/Noun,15,11,4,0.0001444926086473269,6.663853039827628e-05,0.7333333333333333
8107,8107,are/Alpha,15,11,4,0.0001444926086473269,6.663853039827628e-05,0.7333333333333333
8108,8108,멘타리/Noun,15,4,11,6.668889629876625e-05,0.0001443834825295986,0.7333333333333333
8109,8109,깨달/Noun,15,11,4,0.0001444926086473269,6.663853039827628e-05,0.7333333333333333
8110,8110,쓸모없다/Adjective,15,4,11,6.668889629876625e-05,0.0001443834825295986,0.7333333333333333
8111,8111,루나/Noun,15,4,11,6.668889629876625e-05,0.0001443834825295986,0.7333333333333333
8112,8112,체감/Noun,15,11,4,0.0001444926086473269,6.663853039827628e-05,0.7333333333333333
8113,8113,생명력/Noun,15,11,4,0.0001444926086473269,6.663853039827628e-05,0.7333333333333333
8114,8114,|/Punctuation,15,4,11,6.668889629876625e-05,0.0001443834825295986,0.7333333333333333
8115,8115,켜/Noun,15,4,11,6.668889629876625e-05,0.0001443834825295986,0.7333333333333333
8116,8116,갈아/Adverb,15,4,11,6.668889629876625e-05,0.0001443834825295986,0.7333333333333333
8117,8117,뇨/Noun,15,4,11,6.668889629876625e-05,0.0001443834825295986,0.7333333333333333
8118,8118,샤이니/Noun,15,11,4,0.0001444926086473269,6.663853039827628e-05,0.7333333333333333
8119,8119,....;;;/Punctuation,15,4,11,6.668889629876625e-05,0.0001443834825295986,0.7333333333333333
8120,8120,부처/Noun,15,4,11,6.668889629876625e-05,0.0001443834825295986,0.7333333333333333
8121,8121,유전자/Noun,15,4,11,6.668889629876625e-05,0.0001443834825295986,0.7333333333333333
8122,8122,이기주의/Noun,15,4,11,6.668889629876625e-05,0.0001443834825295986,0.7333333333333333
8123,8123,를/Foreign,15,11,4,0.0001444926086473269,6.663853039827628e-05,0.7333333333333333
8124,8124,포맷/Noun,15,4,11,6.668889629876625e-05,0.0001443834825295986,0.7333333333333333
8125,8125,3시/Number,15,11,4,0.0001444926086473269,6.663853039827628e-05,0.7333333333333333
8126,8126,간결하다/Adjective,15,11,4,0.0001444926086473269,6.663853039827628e-05,0.7333333333333333
8127,8127,해체/Noun,15,4,11,6.668889629876625e-05,0.0001443834825295986,0.7333333333333333
8128,8128,모녀/Noun,15,5,10,7.780371234856063e-05,0.00013327706079655256,0.6666666666666666
8129,8129,책보/Noun,15,10,5,0.0001333777925975325,7.774495213132233e-05,0.6666666666666666
8130,8130,소림사/Noun,15,5,10,7.780371234856063e-05,0.00013327706079655256,0.6666666666666666
8131,8131,미스터빈/Noun,15,10,5,0.0001333777925975325,7.774495213132233e-05,0.6666666666666666
8132,8132,팝/Noun,15,5,10,7.780371234856063e-05,0.00013327706079655256,0.6666666666666666
8133,8133,출근/Noun,15,10,5,0.0001333777925975325,7.774495213132233e-05,0.6666666666666666
8134,8134,독특/Noun,15,10,5,0.0001333777925975325,7.774495213132233e-05,0.6666666666666666
8135,8135,스턴트맨/Noun,15,5,10,7.780371234856063e-05,0.00013327706079655256,0.6666666666666666
8136,8136,갈기/Noun,15,5,10,7.780371234856063e-05,0.00013327706079655256,0.6666666666666666
8137,8137,분야/Noun,15,5,10,7.780371234856063e-05,0.00013327706079655256,0.6666666666666666
8138,8138,아야세/Noun,15,10,5,0.0001333777925975325,7.774495213132233e-05,0.6666666666666666
8139,8139,프로도/Noun,15,5,10,7.780371234856063e-05,0.00013327706079655256,0.6666666666666666
8140,8140,타임슬립/Noun,15,5,10,7.780371234856063e-05,0.00013327706079655256,0.6666666666666666
8141,8141,은주/Noun,15,10,5,0.0001333777925975325,7.774495213132233e-05,0.6666666666666666
8142,8142,세운/Noun,15,5,10,7.780371234856063e-05,0.00013327706079655256,0.6666666666666666
8143,8143,일상생활/Noun,15,10,5,0.0001333777925975325,7.774495213132233e-05,0.6666666666666666
8144,8144,29/Number,15,5,10,7.780371234856063e-05,0.00013327706079655256,0.6666666666666666
8145,8145,박상민/Noun,15,5,10,7.780371234856063e-05,0.00013327706079655256,0.6666666666666666
8146,8146,무참/Noun,15,5,10,7.780371234856063e-05,0.00013327706079655256,0.6666666666666666
8147,8147,상류층/Noun,15,5,10,7.780371234856063e-05,0.00013327706079655256,0.6666666666666666
8148,8148,투니버스/Noun,15,5,10,7.780371234856063e-05,0.00013327706079655256,0.6666666666666666
8149,8149,심은경/Noun,15,10,5,0.0001333777925975325,7.774495213132233e-05,0.6666666666666666
8150,8150,천하다/Adjective,15,5,10,7.780371234856063e-05,0.00013327706079655256,0.6666666666666666
8151,8151,시오/Noun,15,10,5,0.0001333777925975325,7.774495213132233e-05,0.6666666666666666
8152,8152,동일/Noun,15,5,10,7.780371234856063e-05,0.00013327706079655256,0.6666666666666666
8153,8153,슬랩/Noun,15,5,10,7.780371234856063e-05,0.00013327706079655256,0.6666666666666666
8154,8154,손님/Noun,15,5,10,7.780371234856063e-05,0.00013327706079655256,0.6666666666666666
8155,8155,니야/Noun,15,5,10,7.780371234856063e-05,0.00013327706079655256,0.6666666666666666
8156,8156,설치/Noun,15,5,10,7.780371234856063e-05,0.00013327706079655256,0.6666666666666666
8157,8157,고든/Noun,15,10,5,0.0001333777925975325,7.774495213132233e-05,0.6666666666666666
8158,8158,뚫리다/Verb,15,5,10,7.780371234856063e-05,0.00013327706079655256,0.6666666666666666
8159,8159,철철/Noun,15,10,5,0.0001333777925975325,7.774495213132233e-05,0.6666666666666666
8160,8160,고리/Noun,15,10,5,0.0001333777925975325,7.774495213132233e-05,0.6666666666666666
8161,8161,93년/Number,15,10,5,0.0001333777925975325,7.774495213132233e-05,0.6666666666666666
8162,8162,잘해야/Noun,15,10,5,0.0001333777925975325,7.774495213132233e-05,0.6666666666666666
8163,8163,ㅕ/KoreanParticle,15,5,10,7.780371234856063e-05,0.00013327706079655256,0.6666666666666666
8164,8164,로랑/Noun,15,10,5,0.0001333777925975325,7.774495213132233e-05,0.6666666666666666
8165,8165,캐리비안/Noun,15,10,5,0.0001333777925975325,7.774495213132233e-05,0.6666666666666666
8166,8166,모토/Noun,15,10,5,0.0001333777925975325,7.774495213132233e-05,0.6666666666666666
8167,8167,돌파/Noun,15,10,5,0.0001333777925975325,7.774495213132233e-05,0.6666666666666666
8168,8168,거미/Noun,15,5,10,7.780371234856063e-05,0.00013327706079655256,0.6666666666666666
8169,8169,명치/Noun,15,5,10,7.780371234856063e-05,0.00013327706079655256,0.6666666666666666
8170,8170,진중하다/Adjective,15,10,5,0.0001333777925975325,7.774495213132233e-05,0.6666666666666666
8171,8171,89년/Number,15,10,5,0.0001333777925975325,7.774495213132233e-05,0.6666666666666666
8172,8172,매국노/Noun,15,5,10,7.780371234856063e-05,0.00013327706079655256,0.6666666666666666
8173,8173,컨텐츠/Noun,15,5,10,7.780371234856063e-05,0.00013327706079655256,0.6666666666666666
8174,8174,시나/Noun,15,5,10,7.780371234856063e-05,0.00013327706079655256,0.6666666666666666
8175,8175,비열하다/Adjective,15,10,5,0.0001333777925975325,7.774495213132233e-05,0.6666666666666666
8176,8176,what/Alpha,15,5,10,7.780371234856063e-05,0.00013327706079655256,0.6666666666666666
8177,8177,거두다/Verb,15,10,5,0.0001333777925975325,7.774495213132233e-05,0.6666666666666666
8178,8178,노리/Noun,15,5,10,7.780371234856063e-05,0.00013327706079655256,0.6666666666666666
8179,8179,지아/Noun,15,6,9,8.891852839835501e-05,0.00012217063906350652,0.6
8180,8180,멍하니/Noun,15,6,9,8.891852839835501e-05,0.00012217063906350652,0.6
8181,8181,말론/Noun,15,9,6,0.00012226297654773814,8.885137386436837e-05,0.6
8182,8182,베이비/Noun,15,6,9,8.891852839835501e-05,0.00012217063906350652,0.6
8183,8183,군요/Eomi,15,9,6,0.00012226297654773814,8.885137386436837e-05,0.6
8184,8184,...'/Punctuation,15,6,9,8.891852839835501e-05,0.00012217063906350652,0.6
8185,8185,놈놈놈/Noun,15,6,9,8.891852839835501e-05,0.00012217063906350652,0.6
8186,8186,쓸리다/Verb,15,6,9,8.891852839835501e-05,0.00012217063906350652,0.6
8187,8187,서리/Noun,15,9,6,0.00012226297654773814,8.885137386436837e-05,0.6
8188,8188,어드벤처/Noun,15,9,6,0.00012226297654773814,8.885137386436837e-05,0.6
8189,8189,충성/Noun,15,9,6,0.00012226297654773814,8.885137386436837e-05,0.6
8190,8190,맹목/Noun,15,9,6,0.00012226297654773814,8.885137386436837e-05,0.6
8191,8191,루카스/Noun,15,6,9,8.891852839835501e-05,0.00012217063906350652,0.6
8192,8192,어도/Noun,15,9,6,0.00012226297654773814,8.885137386436837e-05,0.6
8193,8193,기울이다/Verb,15,9,6,0.00012226297654773814,8.885137386436837e-05,0.6
8194,8194,코끼리/Noun,15,6,9,8.891852839835501e-05,0.00012217063906350652,0.6
8195,8195,여성부/Noun,15,6,9,8.891852839835501e-05,0.00012217063906350652,0.6
8196,8196,제보/Noun,15,9,6,0.00012226297654773814,8.885137386436837e-05,0.6
8197,8197,포로/Noun,15,6,9,8.891852839835501e-05,0.00012217063906350652,0.6
8198,8198,믹스/Noun,15,9,6,0.00012226297654773814,8.885137386436837e-05,0.6
8199,8199,복고/Noun,15,6,9,8.891852839835501e-05,0.00012217063906350652,0.6
8200,8200,우에노/Noun,15,6,9,8.891852839835501e-05,0.00012217063906350652,0.6
8201,8201,우울함/Noun,15,6,9,8.891852839835501e-05,0.00012217063906350652,0.6
8202,8202,맴돌다/Verb,15,9,6,0.00012226297654773814,8.885137386436837e-05,0.6
8203,8203,화법/Noun,15,6,9,8.891852839835501e-05,0.00012217063906350652,0.6
8204,8204,국가대표/Noun,15,6,9,8.891852839835501e-05,0.00012217063906350652,0.6
8205,8205,ㅑ/KoreanParticle,15,9,6,0.00012226297654773814,8.885137386436837e-05,0.6
8206,8206,권위/Noun,15,9,6,0.00012226297654773814,8.885137386436837e-05,0.6
8207,8207,트럭/Noun,15,6,9,8.891852839835501e-05,0.00012217063906350652,0.6
8208,8208,♬/Foreign,15,9,6,0.00012226297654773814,8.885137386436837e-05,0.6
8209,8209,로티/Noun,15,9,6,0.00012226297654773814,8.885137386436837e-05,0.6
8210,8210,빌어먹을/Noun,15,6,9,8.891852839835501e-05,0.00012217063906350652,0.6
8211,8211,소림축구/Noun,15,6,9,8.891852839835501e-05,0.00012217063906350652,0.6
8212,8212,무사/Noun,15,9,6,0.00012226297654773814,8.885137386436837e-05,0.6
8213,8213,보도/Noun,15,9,6,0.00012226297654773814,8.885137386436837e-05,0.6
8214,8214,자만/Noun,15,6,9,8.891852839835501e-05,0.00012217063906350652,0.6
8215,8215,키키/Noun,15,9,6,0.00012226297654773814,8.885137386436837e-05,0.6
8216,8216,20%/Number,15,6,9,8.891852839835501e-05,0.00012217063906350652,0.6
8217,8217,무용/Noun,15,9,6,0.00012226297654773814,8.885137386436837e-05,0.6
8218,8218,모임/Noun,15,6,9,8.891852839835501e-05,0.00012217063906350652,0.6
8219,8219,멜라/Noun,15,9,6,0.00012226297654773814,8.885137386436837e-05,0.6
8220,8220,몹시/Noun,15,9,6,0.00012226297654773814,8.885137386436837e-05,0.6
8221,8221,똑/Noun,15,9,6,0.00012226297654773814,8.885137386436837e-05,0.6
8222,8222,몰이/Noun,15,6,9,8.891852839835501e-05,0.00012217063906350652,0.6
8223,8223,일본만화/Noun,15,9,6,0.00012226297654773814,8.885137386436837e-05,0.6
8224,8224,레미제라블/Noun,15,9,6,0.00012226297654773814,8.885137386436837e-05,0.6
8225,8225,백만/Noun,15,6,9,8.891852839835501e-05,0.00012217063906350652,0.6
8226,8226,라울/Noun,15,6,9,8.891852839835501e-05,0.00012217063906350652,0.6
8227,8227,삼키다/Verb,15,9,6,0.00012226297654773814,8.885137386436837e-05,0.6
8228,8228,이유리/Noun,15,9,6,0.00012226297654773814,8.885137386436837e-05,0.6
8229,8229,라운드/Noun,15,6,9,8.891852839835501e-05,0.00012217063906350652,0.6
8230,8230,로드리게즈/Noun,15,9,6,0.00012226297654773814,8.885137386436837e-05,0.6
8231,8231,랜드/Noun,15,6,9,8.891852839835501e-05,0.00012217063906350652,0.6
8232,8232,금시/Noun,15,7,8,0.0001000333444481494,0.00011106421733046048,0.5333333333333333
8233,8233,2시/Number,15,7,8,0.0001000333444481494,0.00011106421733046048,0.5333333333333333
8234,8234,채시라/Noun,15,8,7,0.00011114816049794375,9.995779559741441e-05,0.5333333333333333
8235,8235,"..""/Punctuation",15,8,7,0.00011114816049794375,9.995779559741441e-05,0.5333333333333333
8236,8236,정신과/Noun,15,7,8,0.0001000333444481494,0.00011106421733046048,0.5333333333333333
8237,8237,이루/Noun,15,7,8,0.0001000333444481494,0.00011106421733046048,0.5333333333333333
8238,8238,껀데/Noun,15,7,8,0.0001000333444481494,0.00011106421733046048,0.5333333333333333
8239,8239,time/Alpha,15,8,7,0.00011114816049794375,9.995779559741441e-05,0.5333333333333333
8240,8240,겐/Noun,15,7,8,0.0001000333444481494,0.00011106421733046048,0.5333333333333333
8241,8241,화성/Noun,15,8,7,0.00011114816049794375,9.995779559741441e-05,0.5333333333333333
8242,8242,대여/Noun,15,8,7,0.00011114816049794375,9.995779559741441e-05,0.5333333333333333
8243,8243,H/Alpha,15,8,7,0.00011114816049794375,9.995779559741441e-05,0.5333333333333333
8244,8244,앨범/Noun,15,8,7,0.00011114816049794375,9.995779559741441e-05,0.5333333333333333
8245,8245,부딪히다/Verb,15,7,8,0.0001000333444481494,0.00011106421733046048,0.5333333333333333
8246,8246,g/Alpha,15,7,8,0.0001000333444481494,0.00011106421733046048,0.5333333333333333
8247,8247,꼬꼬/Noun,15,7,8,0.0001000333444481494,0.00011106421733046048,0.5333333333333333
8248,8248,현명하다/Adjective,15,8,7,0.00011114816049794375,9.995779559741441e-05,0.5333333333333333
8249,8249,짜임/Noun,15,8,7,0.00011114816049794375,9.995779559741441e-05,0.5333333333333333
8250,8250,팔리다/Verb,15,7,8,0.0001000333444481494,0.00011106421733046048,0.5333333333333333
8251,8251,로리/Noun,15,7,8,0.0001000333444481494,0.00011106421733046048,0.5333333333333333
8252,8252,시놉시스/Noun,15,7,8,0.0001000333444481494,0.00011106421733046048,0.5333333333333333
8253,8253,설다/Verb,15,8,7,0.00011114816049794375,9.995779559741441e-05,0.5333333333333333
8254,8254,동성/Noun,15,7,8,0.0001000333444481494,0.00011106421733046048,0.5333333333333333
8255,8255,미덕/Noun,15,8,7,0.00011114816049794375,9.995779559741441e-05,0.5333333333333333
8256,8256,백윤식/Noun,15,7,8,0.0001000333444481494,0.00011106421733046048,0.5333333333333333
8257,8257,파트/Noun,15,7,8,0.0001000333444481494,0.00011106421733046048,0.5333333333333333
8258,8258,마징/Noun,15,8,7,0.00011114816049794375,9.995779559741441e-05,0.5333333333333333
8259,8259,기보/Noun,15,7,8,0.0001000333444481494,0.00011106421733046048,0.5333333333333333
8260,8260,삼총사/Noun,15,8,7,0.00011114816049794375,9.995779559741441e-05,0.5333333333333333
8261,8261,분하다/Adjective,15,7,8,0.0001000333444481494,0.00011106421733046048,0.5333333333333333
8262,8262,속물/Noun,15,8,7,0.00011114816049794375,9.995779559741441e-05,0.5333333333333333
8263,8263,8월/Number,15,8,7,0.00011114816049794375,9.995779559741441e-05,0.5333333333333333
8264,8264,아빠어디가/Noun,15,7,8,0.0001000333444481494,0.00011106421733046048,0.5333333333333333
8265,8265,사하다/Verb,15,7,8,0.0001000333444481494,0.00011106421733046048,0.5333333333333333
8266,8266,장교/Noun,15,7,8,0.0001000333444481494,0.00011106421733046048,0.5333333333333333
8267,8267,퀴즈/Noun,15,8,7,0.00011114816049794375,9.995779559741441e-05,0.5333333333333333
8268,8268,But/Alpha,15,7,8,0.0001000333444481494,0.00011106421733046048,0.5333333333333333
8269,8269,덩달아/Noun,15,7,8,0.0001000333444481494,0.00011106421733046048,0.5333333333333333
8270,8270,권투/Noun,15,8,7,0.00011114816049794375,9.995779559741441e-05,0.5333333333333333
8271,8271,요한슨/Noun,15,7,8,0.0001000333444481494,0.00011106421733046048,0.5333333333333333
8272,8272,널리/Noun,15,7,8,0.0001000333444481494,0.00011106421733046048,0.5333333333333333
8273,8273,다카/Noun,15,7,8,0.0001000333444481494,0.00011106421733046048,0.5333333333333333
8274,8274,클레/Noun,15,8,7,0.00011114816049794375,9.995779559741441e-05,0.5333333333333333
8275,8275,김정화/Noun,15,8,7,0.00011114816049794375,9.995779559741441e-05,0.5333333333333333
8276,8276,한낱/Adverb,15,7,8,0.0001000333444481494,0.00011106421733046048,0.5333333333333333
8277,8277,모어/Noun,15,8,7,0.00011114816049794375,9.995779559741441e-05,0.5333333333333333
8278,8278,남동생/Noun,15,7,8,0.0001000333444481494,0.00011106421733046048,0.5333333333333333
8279,8279,컬러/Noun,15,7,8,0.0001000333444481494,0.00011106421733046048,0.5333333333333333
8280,8280,가난/Noun,15,8,7,0.00011114816049794375,9.995779559741441e-05,0.5333333333333333
8281,8281,달성/Noun,15,8,7,0.00011114816049794375,9.995779559741441e-05,0.5333333333333333
8282,8282,슈퍼스타/Noun,15,7,8,0.0001000333444481494,0.00011106421733046048,0.5333333333333333
8283,8283,진과/Noun,15,8,7,0.00011114816049794375,9.995779559741441e-05,0.5333333333333333
8284,8284,그레이스/Noun,15,8,7,0.00011114816049794375,9.995779559741441e-05,0.5333333333333333
8285,8285,측은하다/Adjective,15,7,8,0.0001000333444481494,0.00011106421733046048,0.5333333333333333
8286,8286,신성일/Noun,15,7,8,0.0001000333444481494,0.00011106421733046048,0.5333333333333333
8287,8287,경치/Noun,15,7,8,0.0001000333444481494,0.00011106421733046048,0.5333333333333333
8288,8288,레이미/Noun,15,8,7,0.00011114816049794375,9.995779559741441e-05,0.5333333333333333
8289,8289,방안/Noun,15,7,8,0.0001000333444481494,0.00011106421733046048,0.5333333333333333
8290,8290,만족감/Noun,15,7,8,0.0001000333444481494,0.00011106421733046048,0.5333333333333333
8291,8291,공백/Noun,15,7,8,0.0001000333444481494,0.00011106421733046048,0.5333333333333333
8292,8292,과자/Noun,15,8,7,0.00011114816049794375,9.995779559741441e-05,0.5333333333333333
8293,8293,렌/Noun,15,8,7,0.00011114816049794375,9.995779559741441e-05,0.5333333333333333
8294,8294,87년/Number,15,7,8,0.0001000333444481494,0.00011106421733046048,0.5333333333333333
8295,8295,동이/Noun,15,7,8,0.0001000333444481494,0.00011106421733046048,0.5333333333333333
8296,8296,조이다/Verb,14,14,0,0.00017783705679671002,2.2212843466092093e-05,1.0
8297,8297,밥맛/Noun,14,0,14,2.2229632099588756e-05,0.00017770274772873674,1.0
8298,8298,분신사바/Noun,14,0,14,2.2229632099588756e-05,0.00017770274772873674,1.0
8299,8299,혐/Noun,14,0,14,2.2229632099588756e-05,0.00017770274772873674,1.0
8300,8300,짱개/Noun,14,0,14,2.2229632099588756e-05,0.00017770274772873674,1.0
8301,8301,잘봣습니/Noun,14,14,0,0.00017783705679671002,2.2212843466092093e-05,1.0
8302,8302,햇살/Noun,14,14,0,0.00017783705679671002,2.2212843466092093e-05,1.0
8303,8303,영아/Noun,14,0,14,2.2229632099588756e-05,0.00017770274772873674,1.0
8304,8304,..-/Punctuation,14,0,14,2.2229632099588756e-05,0.00017770274772873674,1.0
8305,8305,졸림/Noun,14,0,14,2.2229632099588756e-05,0.00017770274772873674,1.0
8306,8306,..-_-;;/Punctuation,14,0,14,2.2229632099588756e-05,0.00017770274772873674,1.0
8307,8307,심슨/Noun,14,14,0,0.00017783705679671002,2.2212843466092093e-05,1.0
8308,8308,빠져듬/Noun,14,14,0,0.00017783705679671002,2.2212843466092093e-05,1.0
8309,8309,최선정/Noun,14,0,14,2.2229632099588756e-05,0.00017770274772873674,1.0
8310,8310,홍석천/Noun,14,0,14,2.2229632099588756e-05,0.00017770274772873674,1.0
8311,8311,어쩌자/Noun,14,0,14,2.2229632099588756e-05,0.00017770274772873674,1.0
8312,8312,성준/Noun,14,13,1,0.00016672224074691566,3.331926519913814e-05,0.9285714285714286
8313,8313,으뜸/Noun,14,13,1,0.00016672224074691566,3.331926519913814e-05,0.9285714285714286
8314,8314,독보/Noun,14,13,1,0.00016672224074691566,3.331926519913814e-05,0.9285714285714286
8315,8315,옷벗다/Verb,14,1,13,3.334444814938313e-05,0.0001665963259956907,0.9285714285714286
8316,8316,소송/Noun,14,1,13,3.334444814938313e-05,0.0001665963259956907,0.9285714285714286
8317,8317,인간관계/Noun,14,13,1,0.00016672224074691566,3.331926519913814e-05,0.9285714285714286
8318,8318,탁재훈/Noun,14,1,13,3.334444814938313e-05,0.0001665963259956907,0.9285714285714286
8319,8319,케이온/Noun,14,13,1,0.00016672224074691566,3.331926519913814e-05,0.9285714285714286
8320,8320,인간극장/Noun,14,1,13,3.334444814938313e-05,0.0001665963259956907,0.9285714285714286
8321,8321,무조/Noun,14,13,1,0.00016672224074691566,3.331926519913814e-05,0.9285714285714286
8322,8322,박예진/Noun,14,1,13,3.334444814938313e-05,0.0001665963259956907,0.9285714285714286
8323,8323,강츄/Noun,14,13,1,0.00016672224074691566,3.331926519913814e-05,0.9285714285714286
8324,8324,표방/Noun,14,1,13,3.334444814938313e-05,0.0001665963259956907,0.9285714285714286
8325,8325,더스틴/Noun,14,13,1,0.00016672224074691566,3.331926519913814e-05,0.9285714285714286
8326,8326,현저/Noun,14,1,13,3.334444814938313e-05,0.0001665963259956907,0.9285714285714286
8327,8327,주몽/Noun,14,13,1,0.00016672224074691566,3.331926519913814e-05,0.9285714285714286
8328,8328,강인하다/Adjective,14,13,1,0.00016672224074691566,3.331926519913814e-05,0.9285714285714286
8329,8329,호프만/Noun,14,13,1,0.00016672224074691566,3.331926519913814e-05,0.9285714285714286
8330,8330,불명/Noun,14,1,13,3.334444814938313e-05,0.0001665963259956907,0.9285714285714286
8331,8331,16년/Number,14,13,1,0.00016672224074691566,3.331926519913814e-05,0.9285714285714286
8332,8332,민주/Noun,14,1,13,3.334444814938313e-05,0.0001665963259956907,0.9285714285714286
8333,8333,산만/Noun,14,1,13,3.334444814938313e-05,0.0001665963259956907,0.9285714285714286
8334,8334,모시다/Verb,14,1,13,3.334444814938313e-05,0.0001665963259956907,0.9285714285714286
8335,8335,노민우/Noun,14,13,1,0.00016672224074691566,3.331926519913814e-05,0.9285714285714286
8336,8336,삽입곡/Noun,14,13,1,0.00016672224074691566,3.331926519913814e-05,0.9285714285714286
8337,8337,외전/Noun,14,1,13,3.334444814938313e-05,0.0001665963259956907,0.9285714285714286
8338,8338,반말/Noun,14,1,13,3.334444814938313e-05,0.0001665963259956907,0.9285714285714286
8339,8339,유사라/Noun,14,1,13,3.334444814938313e-05,0.0001665963259956907,0.9285714285714286
8340,8340,능욕/Noun,14,1,13,3.334444814938313e-05,0.0001665963259956907,0.9285714285714286
8341,8341,마담/Noun,14,2,12,4.445926419917751e-05,0.00015548990426264466,0.8571428571428571
8342,8342,주입/Noun,14,2,12,4.445926419917751e-05,0.00015548990426264466,0.8571428571428571
8343,8343,탄도/Noun,14,12,2,0.00015560742469712126,4.4425686932184186e-05,0.8571428571428571
8344,8344,오로라공주/Noun,14,2,12,4.445926419917751e-05,0.00015548990426264466,0.8571428571428571
8345,8345,소란/Noun,14,2,12,4.445926419917751e-05,0.00015548990426264466,0.8571428571428571
8346,8346,무렵/Noun,14,12,2,0.00015560742469712126,4.4425686932184186e-05,0.8571428571428571
8347,8347,연말/Noun,14,12,2,0.00015560742469712126,4.4425686932184186e-05,0.8571428571428571
8348,8348,주룩주룩/Noun,14,12,2,0.00015560742469712126,4.4425686932184186e-05,0.8571428571428571
8349,8349,폴리스스토리/Noun,14,12,2,0.00015560742469712126,4.4425686932184186e-05,0.8571428571428571
8350,8350,8천원/Number,14,2,12,4.445926419917751e-05,0.00015548990426264466,0.8571428571428571
8351,8351,스탭들/Noun,14,2,12,4.445926419917751e-05,0.00015548990426264466,0.8571428571428571
8352,8352,로다주/Noun,14,12,2,0.00015560742469712126,4.4425686932184186e-05,0.8571428571428571
8353,8353,힛걸/Noun,14,12,2,0.00015560742469712126,4.4425686932184186e-05,0.8571428571428571
8354,8354,늙은이/Noun,14,2,12,4.445926419917751e-05,0.00015548990426264466,0.8571428571428571
8355,8355,작작하다/Adjective,14,2,12,4.445926419917751e-05,0.00015548990426264466,0.8571428571428571
8356,8356,끼어들다/Verb,14,2,12,4.445926419917751e-05,0.00015548990426264466,0.8571428571428571
8357,8357,화이자/Noun,14,12,2,0.00015560742469712126,4.4425686932184186e-05,0.8571428571428571
8358,8358,로군/Josa,14,2,12,4.445926419917751e-05,0.00015548990426264466,0.8571428571428571
8359,8359,포트/Noun,14,12,2,0.00015560742469712126,4.4425686932184186e-05,0.8571428571428571
8360,8360,엑소시즘/Noun,14,2,12,4.445926419917751e-05,0.00015548990426264466,0.8571428571428571
8361,8361,감탄사/Noun,14,12,2,0.00015560742469712126,4.4425686932184186e-05,0.8571428571428571
8362,8362,노출하다/Adjective,14,2,12,4.445926419917751e-05,0.00015548990426264466,0.8571428571428571
8363,8363,왜봄/Noun,14,2,12,4.445926419917751e-05,0.00015548990426264466,0.8571428571428571
8364,8364,ㅗㅗ/KoreanParticle,14,2,12,4.445926419917751e-05,0.00015548990426264466,0.8571428571428571
8365,8365,겨냥/Noun,14,2,12,4.445926419917751e-05,0.00015548990426264466,0.8571428571428571
8366,8366,내리막/Noun,14,2,12,4.445926419917751e-05,0.00015548990426264466,0.8571428571428571
8367,8367,따먹다/Verb,14,2,12,4.445926419917751e-05,0.00015548990426264466,0.8571428571428571
8368,8368,뻘/Noun,14,2,12,4.445926419917751e-05,0.00015548990426264466,0.8571428571428571
8369,8369,메우다/Verb,14,2,12,4.445926419917751e-05,0.00015548990426264466,0.8571428571428571
8370,8370,부제/Noun,14,2,12,4.445926419917751e-05,0.00015548990426264466,0.8571428571428571
8371,8371,휘두르다/Verb,14,2,12,4.445926419917751e-05,0.00015548990426264466,0.8571428571428571
8372,8372,일어서다/Verb,14,12,2,0.00015560742469712126,4.4425686932184186e-05,0.8571428571428571
8373,8373,핵꿀잼/Noun,14,12,2,0.00015560742469712126,4.4425686932184186e-05,0.8571428571428571
8374,8374,회한/Noun,14,12,2,0.00015560742469712126,4.4425686932184186e-05,0.8571428571428571
8375,8375,벌이/Noun,14,2,12,4.445926419917751e-05,0.00015548990426264466,0.8571428571428571
8376,8376,치장/Noun,14,2,12,4.445926419917751e-05,0.00015548990426264466,0.8571428571428571
8377,8377,야호/Noun,14,12,2,0.00015560742469712126,4.4425686932184186e-05,0.8571428571428571
8378,8378,우왕좌왕/Noun,14,2,12,4.445926419917751e-05,0.00015548990426264466,0.8571428571428571
8379,8379,교체/Noun,14,2,12,4.445926419917751e-05,0.00015548990426264466,0.8571428571428571
8380,8380,지도자/Noun,14,12,2,0.00015560742469712126,4.4425686932184186e-05,0.8571428571428571
8381,8381,서늘하다/Adjective,14,12,2,0.00015560742469712126,4.4425686932184186e-05,0.8571428571428571
8382,8382,막심/Noun,14,3,11,5.5574080248971876e-05,0.0001443834825295986,0.7857142857142857
8383,8383,붐/Noun,14,3,11,5.5574080248971876e-05,0.0001443834825295986,0.7857142857142857
8384,8384,오늘이/Noun,14,11,3,0.0001444926086473269,5.553210866523024e-05,0.7857142857142857
8385,8385,복장/Noun,14,3,11,5.5574080248971876e-05,0.0001443834825295986,0.7857142857142857
8386,8386,>.</Punctuation,14,11,3,0.0001444926086473269,5.553210866523024e-05,0.7857142857142857
8387,8387,상기/Noun,14,11,3,0.0001444926086473269,5.553210866523024e-05,0.7857142857142857
8388,8388,조형기/Noun,14,3,11,5.5574080248971876e-05,0.0001443834825295986,0.7857142857142857
8389,8389,불량/Noun,14,3,11,5.5574080248971876e-05,0.0001443834825295986,0.7857142857142857
8390,8390,가만있다/Verb,14,3,11,5.5574080248971876e-05,0.0001443834825295986,0.7857142857142857
8391,8391,수목/Noun,14,11,3,0.0001444926086473269,5.553210866523024e-05,0.7857142857142857
8392,8392,번개/Noun,14,11,3,0.0001444926086473269,5.553210866523024e-05,0.7857142857142857
8393,8393,미술관/Noun,14,11,3,0.0001444926086473269,5.553210866523024e-05,0.7857142857142857
8394,8394,정려원/Noun,14,11,3,0.0001444926086473269,5.553210866523024e-05,0.7857142857142857
8395,8395,오마주/Noun,14,3,11,5.5574080248971876e-05,0.0001443834825295986,0.7857142857142857
8396,8396,뽀뽀/Noun,14,3,11,5.5574080248971876e-05,0.0001443834825295986,0.7857142857142857
8397,8397,닷/Modifier,14,11,3,0.0001444926086473269,5.553210866523024e-05,0.7857142857142857
8398,8398,느릿느릿/Noun,14,3,11,5.5574080248971876e-05,0.0001443834825295986,0.7857142857142857
8399,8399,오즈/Noun,14,11,3,0.0001444926086473269,5.553210866523024e-05,0.7857142857142857
8400,8400,푼/Noun,14,3,11,5.5574080248971876e-05,0.0001443834825295986,0.7857142857142857
8401,8401,지니/Noun,14,11,3,0.0001444926086473269,5.553210866523024e-05,0.7857142857142857
8402,8402,개밥/Noun,14,3,11,5.5574080248971876e-05,0.0001443834825295986,0.7857142857142857
8403,8403,이색/Noun,14,11,3,0.0001444926086473269,5.553210866523024e-05,0.7857142857142857
8404,8404,오리엔탈리즘/Noun,14,3,11,5.5574080248971876e-05,0.0001443834825295986,0.7857142857142857
8405,8405,젬/Noun,14,11,3,0.0001444926086473269,5.553210866523024e-05,0.7857142857142857
8406,8406,브라보/Noun,14,11,3,0.0001444926086473269,5.553210866523024e-05,0.7857142857142857
8407,8407,작작/Noun,14,3,11,5.5574080248971876e-05,0.0001443834825295986,0.7857142857142857
8408,8408,이듬/Noun,14,3,11,5.5574080248971876e-05,0.0001443834825295986,0.7857142857142857
8409,8409,지긋지긋하다/Adjective,14,3,11,5.5574080248971876e-05,0.0001443834825295986,0.7857142857142857
8410,8410,시초/Noun,14,11,3,0.0001444926086473269,5.553210866523024e-05,0.7857142857142857
8411,8411,청순/Noun,14,11,3,0.0001444926086473269,5.553210866523024e-05,0.7857142857142857
8412,8412,.................../Punctuation,14,3,11,5.5574080248971876e-05,0.0001443834825295986,0.7857142857142857
8413,8413,맹/Noun,14,3,11,5.5574080248971876e-05,0.0001443834825295986,0.7857142857142857
8414,8414,비상/Noun,14,3,11,5.5574080248971876e-05,0.0001443834825295986,0.7857142857142857
8415,8415,리버/Noun,14,11,3,0.0001444926086473269,5.553210866523024e-05,0.7857142857142857
8416,8416,불평/Noun,14,11,3,0.0001444926086473269,5.553210866523024e-05,0.7857142857142857
8417,8417,머레이/Noun,14,11,3,0.0001444926086473269,5.553210866523024e-05,0.7857142857142857
8418,8418,주름/Noun,14,3,11,5.5574080248971876e-05,0.0001443834825295986,0.7857142857142857
8419,8419,대머리/Noun,14,3,11,5.5574080248971876e-05,0.0001443834825295986,0.7857142857142857
8420,8420,저조하다/Adjective,14,11,3,0.0001444926086473269,5.553210866523024e-05,0.7857142857142857
8421,8421,노숙자/Noun,14,3,11,5.5574080248971876e-05,0.0001443834825295986,0.7857142857142857
8422,8422,점차/Noun,14,11,3,0.0001444926086473269,5.553210866523024e-05,0.7857142857142857
8423,8423,적용/Noun,14,3,11,5.5574080248971876e-05,0.0001443834825295986,0.7857142857142857
8424,8424,몽골/Noun,14,3,11,5.5574080248971876e-05,0.0001443834825295986,0.7857142857142857
8425,8425,난장판/Noun,14,3,11,5.5574080248971876e-05,0.0001443834825295986,0.7857142857142857
8426,8426,시인/Noun,14,11,3,0.0001444926086473269,5.553210866523024e-05,0.7857142857142857
8427,8427,몰락하다/Adjective,14,3,11,5.5574080248971876e-05,0.0001443834825295986,0.7857142857142857
8428,8428,할인/Noun,14,3,11,5.5574080248971876e-05,0.0001443834825295986,0.7857142857142857
8429,8429,결승전/Noun,14,3,11,5.5574080248971876e-05,0.0001443834825295986,0.7857142857142857
8430,8430,헬렌/Noun,14,11,3,0.0001444926086473269,5.553210866523024e-05,0.7857142857142857
8431,8431,밨/Noun,14,11,3,0.0001444926086473269,5.553210866523024e-05,0.7857142857142857
8432,8432,무례하다/Adjective,14,3,11,5.5574080248971876e-05,0.0001443834825295986,0.7857142857142857
8433,8433,호호/Noun,14,11,3,0.0001444926086473269,5.553210866523024e-05,0.7857142857142857
8434,8434,연쇄살인/Noun,14,3,11,5.5574080248971876e-05,0.0001443834825295986,0.7857142857142857
8435,8435,찌라시/Noun,14,3,11,5.5574080248971876e-05,0.0001443834825295986,0.7857142857142857
8436,8436,~~!!!!/Punctuation,14,11,3,0.0001444926086473269,5.553210866523024e-05,0.7857142857142857
8437,8437,갈증/Noun,14,10,4,0.0001333777925975325,6.663853039827628e-05,0.7142857142857143
8438,8438,무식/Noun,14,4,10,6.668889629876625e-05,0.00013327706079655256,0.7142857142857143
8439,8439,역경/Noun,14,10,4,0.0001333777925975325,6.663853039827628e-05,0.7142857142857143
8440,8440,태권브이/Noun,14,4,10,6.668889629876625e-05,0.00013327706079655256,0.7142857142857143
8441,8441,발달/Noun,14,10,4,0.0001333777925975325,6.663853039827628e-05,0.7142857142857143
8442,8442,센세이션/Noun,14,10,4,0.0001333777925975325,6.663853039827628e-05,0.7142857142857143
8443,8443,개입/Noun,14,4,10,6.668889629876625e-05,0.00013327706079655256,0.7142857142857143
8444,8444,의무/Noun,14,10,4,0.0001333777925975325,6.663853039827628e-05,0.7142857142857143
8445,8445,퍽/Noun,14,4,10,6.668889629876625e-05,0.00013327706079655256,0.7142857142857143
8446,8446,줄기/Noun,14,10,4,0.0001333777925975325,6.663853039827628e-05,0.7142857142857143
8447,8447,다섯/Modifier,14,10,4,0.0001333777925975325,6.663853039827628e-05,0.7142857142857143
8448,8448,애니스톤/Noun,14,4,10,6.668889629876625e-05,0.00013327706079655256,0.7142857142857143
8449,8449,?!!/Punctuation,14,4,10,6.668889629876625e-05,0.00013327706079655256,0.7142857142857143
8450,8450,김재원/Noun,14,10,4,0.0001333777925975325,6.663853039827628e-05,0.7142857142857143
8451,8451,조미료/Noun,14,4,10,6.668889629876625e-05,0.00013327706079655256,0.7142857142857143
8452,8452,수상한/Noun,14,10,4,0.0001333777925975325,6.663853039827628e-05,0.7142857142857143
8453,8453,흠/Exclamation,14,4,10,6.668889629876625e-05,0.00013327706079655256,0.7142857142857143
8454,8454,타의/Noun,14,10,4,0.0001333777925975325,6.663853039827628e-05,0.7142857142857143
8455,8455,이만/Modifier,14,10,4,0.0001333777925975325,6.663853039827628e-05,0.7142857142857143
8456,8456,리듬/Noun,14,10,4,0.0001333777925975325,6.663853039827628e-05,0.7142857142857143
8457,8457,르노/Noun,14,4,10,6.668889629876625e-05,0.00013327706079655256,0.7142857142857143
8458,8458,정규/Noun,14,10,4,0.0001333777925975325,6.663853039827628e-05,0.7142857142857143
8459,8459,레디/Noun,14,4,10,6.668889629876625e-05,0.00013327706079655256,0.7142857142857143
8460,8460,덕화/Noun,14,10,4,0.0001333777925975325,6.663853039827628e-05,0.7142857142857143
8461,8461,혼돈/Noun,14,10,4,0.0001333777925975325,6.663853039827628e-05,0.7142857142857143
8462,8462,박철수/Noun,14,4,10,6.668889629876625e-05,0.00013327706079655256,0.7142857142857143
8463,8463,드라큘라/Noun,14,4,10,6.668889629876625e-05,0.00013327706079655256,0.7142857142857143
8464,8464,흡혈귀/Noun,14,4,10,6.668889629876625e-05,0.00013327706079655256,0.7142857142857143
8465,8465,가중/Noun,14,4,10,6.668889629876625e-05,0.00013327706079655256,0.7142857142857143
8466,8466,메가박스/Noun,14,10,4,0.0001333777925975325,6.663853039827628e-05,0.7142857142857143
8467,8467,학원물/Noun,14,4,10,6.668889629876625e-05,0.00013327706079655256,0.7142857142857143
8468,8468,앗다/Verb,14,4,10,6.668889629876625e-05,0.00013327706079655256,0.7142857142857143
8469,8469,상실하다/Adjective,14,4,10,6.668889629876625e-05,0.00013327706079655256,0.7142857142857143
8470,8470,치자/Noun,14,4,10,6.668889629876625e-05,0.00013327706079655256,0.7142857142857143
8471,8471,셜록홈즈/Noun,14,10,4,0.0001333777925975325,6.663853039827628e-05,0.7142857142857143
8472,8472,에고/Noun,14,4,10,6.668889629876625e-05,0.00013327706079655256,0.7142857142857143
8473,8473,이벤트/Noun,14,4,10,6.668889629876625e-05,0.00013327706079655256,0.7142857142857143
8474,8474,굴욕/Noun,14,4,10,6.668889629876625e-05,0.00013327706079655256,0.7142857142857143
8475,8475,사이비/Noun,14,4,10,6.668889629876625e-05,0.00013327706079655256,0.7142857142857143
8476,8476,시련/Noun,14,10,4,0.0001333777925975325,6.663853039827628e-05,0.7142857142857143
8477,8477,면모/Noun,14,10,4,0.0001333777925975325,6.663853039827628e-05,0.7142857142857143
8478,8478,대적/Noun,14,4,10,6.668889629876625e-05,0.00013327706079655256,0.7142857142857143
8479,8479,아우르다/Verb,14,10,4,0.0001333777925975325,6.663853039827628e-05,0.7142857142857143
8480,8480,우디앨런/Noun,14,10,4,0.0001333777925975325,6.663853039827628e-05,0.7142857142857143
8481,8481,미쉘/Noun,14,10,4,0.0001333777925975325,6.663853039827628e-05,0.7142857142857143
8482,8482,이수경/Noun,14,10,4,0.0001333777925975325,6.663853039827628e-05,0.7142857142857143
8483,8483,랬/Noun,14,4,10,6.668889629876625e-05,0.00013327706079655256,0.7142857142857143
8484,8484,1시/Number,14,4,10,6.668889629876625e-05,0.00013327706079655256,0.7142857142857143
8485,8485,사채/Noun,14,4,10,6.668889629876625e-05,0.00013327706079655256,0.7142857142857143
8486,8486,유학/Noun,14,9,5,0.00012226297654773814,7.774495213132233e-05,0.6428571428571429
8487,8487,허탈/Noun,14,5,9,7.780371234856063e-05,0.00012217063906350652,0.6428571428571429
8488,8488,리턴즈/Noun,14,9,5,0.00012226297654773814,7.774495213132233e-05,0.6428571428571429
8489,8489,간수/Noun,14,5,9,7.780371234856063e-05,0.00012217063906350652,0.6428571428571429
8490,8490,사만/Noun,14,9,5,0.00012226297654773814,7.774495213132233e-05,0.6428571428571429
8491,8491,아앙/Noun,14,5,9,7.780371234856063e-05,0.00012217063906350652,0.6428571428571429
8492,8492,엑스/Noun,14,5,9,7.780371234856063e-05,0.00012217063906350652,0.6428571428571429
8493,8493,부들/Noun,14,5,9,7.780371234856063e-05,0.00012217063906350652,0.6428571428571429
8494,8494,.;/Punctuation,14,5,9,7.780371234856063e-05,0.00012217063906350652,0.6428571428571429
8495,8495,락스/Noun,14,9,5,0.00012226297654773814,7.774495213132233e-05,0.6428571428571429
8496,8496,돈좀/Noun,14,5,9,7.780371234856063e-05,0.00012217063906350652,0.6428571428571429
8497,8497,할리웃/Noun,14,5,9,7.780371234856063e-05,0.00012217063906350652,0.6428571428571429
8498,8498,매장/Noun,14,5,9,7.780371234856063e-05,0.00012217063906350652,0.6428571428571429
8499,8499,극히/Noun,14,5,9,7.780371234856063e-05,0.00012217063906350652,0.6428571428571429
8500,8500,이참/Noun,14,5,9,7.780371234856063e-05,0.00012217063906350652,0.6428571428571429
8501,8501,시대극/Noun,14,5,9,7.780371234856063e-05,0.00012217063906350652,0.6428571428571429
8502,8502,실로/Noun,14,9,5,0.00012226297654773814,7.774495213132233e-05,0.6428571428571429
8503,8503,본영/Noun,14,9,5,0.00012226297654773814,7.774495213132233e-05,0.6428571428571429
8504,8504,뺴/Noun,14,5,9,7.780371234856063e-05,0.00012217063906350652,0.6428571428571429
8505,8505,소동/Noun,14,5,9,7.780371234856063e-05,0.00012217063906350652,0.6428571428571429
8506,8506,구심/Noun,14,5,9,7.780371234856063e-05,0.00012217063906350652,0.6428571428571429
8507,8507,기지/Noun,14,9,5,0.00012226297654773814,7.774495213132233e-05,0.6428571428571429
8508,8508,요리사/Noun,14,5,9,7.780371234856063e-05,0.00012217063906350652,0.6428571428571429
8509,8509,아이언/Noun,14,9,5,0.00012226297654773814,7.774495213132233e-05,0.6428571428571429
8510,8510,배부르다/Adjective,14,9,5,0.00012226297654773814,7.774495213132233e-05,0.6428571428571429
8511,8511,!!!!!!!!!!!!/Punctuation,14,9,5,0.00012226297654773814,7.774495213132233e-05,0.6428571428571429
8512,8512,감초/Noun,14,9,5,0.00012226297654773814,7.774495213132233e-05,0.6428571428571429
8513,8513,품격/Noun,14,9,5,0.00012226297654773814,7.774495213132233e-05,0.6428571428571429
8514,8514,하치/Noun,14,9,5,0.00012226297654773814,7.774495213132233e-05,0.6428571428571429
8515,8515,몽/Noun,14,5,9,7.780371234856063e-05,0.00012217063906350652,0.6428571428571429
8516,8516,안이/Noun,14,9,5,0.00012226297654773814,7.774495213132233e-05,0.6428571428571429
8517,8517,볼맛/Noun,14,5,9,7.780371234856063e-05,0.00012217063906350652,0.6428571428571429
8518,8518,련/Noun,14,9,5,0.00012226297654773814,7.774495213132233e-05,0.6428571428571429
8519,8519,북괴/Noun,14,5,9,7.780371234856063e-05,0.00012217063906350652,0.6428571428571429
8520,8520,안타/Noun,14,5,9,7.780371234856063e-05,0.00012217063906350652,0.6428571428571429
8521,8521,오감/Noun,14,9,5,0.00012226297654773814,7.774495213132233e-05,0.6428571428571429
8522,8522,임산부/Noun,14,5,9,7.780371234856063e-05,0.00012217063906350652,0.6428571428571429
8523,8523,..................../Punctuation,14,5,9,7.780371234856063e-05,0.00012217063906350652,0.6428571428571429
8524,8524,달이/Noun,14,9,5,0.00012226297654773814,7.774495213132233e-05,0.6428571428571429
8525,8525,댓/Noun,14,5,9,7.780371234856063e-05,0.00012217063906350652,0.6428571428571429
8526,8526,친하다/Adjective,14,5,9,7.780371234856063e-05,0.00012217063906350652,0.6428571428571429
8527,8527,부유하다/Adjective,14,9,5,0.00012226297654773814,7.774495213132233e-05,0.6428571428571429
8528,8528,비서/Noun,14,5,9,7.780371234856063e-05,0.00012217063906350652,0.6428571428571429
8529,8529,거물/Noun,14,9,5,0.00012226297654773814,7.774495213132233e-05,0.6428571428571429
8530,8530,편의점/Noun,14,5,9,7.780371234856063e-05,0.00012217063906350652,0.6428571428571429
8531,8531,셀/Noun,14,9,5,0.00012226297654773814,7.774495213132233e-05,0.6428571428571429
8532,8532,CSI/Alpha,14,9,5,0.00012226297654773814,7.774495213132233e-05,0.6428571428571429
8533,8533,아베/Noun,14,5,9,7.780371234856063e-05,0.00012217063906350652,0.6428571428571429
8534,8534,절도/Noun,14,5,9,7.780371234856063e-05,0.00012217063906350652,0.6428571428571429
8535,8535,파고/Noun,14,5,9,7.780371234856063e-05,0.00012217063906350652,0.6428571428571429
8536,8536,후진국/Noun,14,5,9,7.780371234856063e-05,0.00012217063906350652,0.6428571428571429
8537,8537,도구/Noun,14,5,9,7.780371234856063e-05,0.00012217063906350652,0.6428571428571429
8538,8538,낙태/Noun,14,5,9,7.780371234856063e-05,0.00012217063906350652,0.6428571428571429
8539,8539,유키/Noun,14,9,5,0.00012226297654773814,7.774495213132233e-05,0.6428571428571429
8540,8540,에피/Noun,14,9,5,0.00012226297654773814,7.774495213132233e-05,0.6428571428571429
8541,8541,보성/Noun,14,9,5,0.00012226297654773814,7.774495213132233e-05,0.6428571428571429
8542,8542,수두/Noun,14,5,9,7.780371234856063e-05,0.00012217063906350652,0.6428571428571429
8543,8543,친숙하다/Adjective,14,9,5,0.00012226297654773814,7.774495213132233e-05,0.6428571428571429
8544,8544,애국가/Noun,14,5,9,7.780371234856063e-05,0.00012217063906350652,0.6428571428571429
8545,8545,테러범/Noun,14,5,9,7.780371234856063e-05,0.00012217063906350652,0.6428571428571429
8546,8546,무진장/Noun,14,5,9,7.780371234856063e-05,0.00012217063906350652,0.6428571428571429
8547,8547,난리치다/Verb,14,5,9,7.780371234856063e-05,0.00012217063906350652,0.6428571428571429
8548,8548,송/Noun,14,9,5,0.00012226297654773814,7.774495213132233e-05,0.6428571428571429
8549,8549,잘해주다/Verb,14,9,5,0.00012226297654773814,7.774495213132233e-05,0.6428571428571429
8550,8550,본연/Noun,14,9,5,0.00012226297654773814,7.774495213132233e-05,0.6428571428571429
8551,8551,탐구/Noun,14,9,5,0.00012226297654773814,7.774495213132233e-05,0.6428571428571429
8552,8552,일어나지/Noun,14,9,5,0.00012226297654773814,7.774495213132233e-05,0.6428571428571429
8553,8553,골든/Noun,14,9,5,0.00012226297654773814,7.774495213132233e-05,0.6428571428571429
8554,8554,로이/Noun,14,5,9,7.780371234856063e-05,0.00012217063906350652,0.6428571428571429
8555,8555,중복/Noun,14,8,6,0.00011114816049794375,8.885137386436837e-05,0.5714285714285714
8556,8556,은혜/Noun,14,8,6,0.00011114816049794375,8.885137386436837e-05,0.5714285714285714
8557,8557,밤새다/Verb,14,8,6,0.00011114816049794375,8.885137386436837e-05,0.5714285714285714
8558,8558,무인도/Noun,14,8,6,0.00011114816049794375,8.885137386436837e-05,0.5714285714285714
8559,8559,커리어/Noun,14,6,8,8.891852839835501e-05,0.00011106421733046048,0.5714285714285714
8560,8560,밀리/Noun,14,8,6,0.00011114816049794375,8.885137386436837e-05,0.5714285714285714
8561,8561,10월/Number,14,8,6,0.00011114816049794375,8.885137386436837e-05,0.5714285714285714
8562,8562,다름없다/Adjective,14,6,8,8.891852839835501e-05,0.00011106421733046048,0.5714285714285714
8563,8563,장례식/Noun,14,8,6,0.00011114816049794375,8.885137386436837e-05,0.5714285714285714
8564,8564,유괴/Noun,14,6,8,8.891852839835501e-05,0.00011106421733046048,0.5714285714285714
8565,8565,육아/Noun,14,8,6,0.00011114816049794375,8.885137386436837e-05,0.5714285714285714
8566,8566,고준희/Noun,14,6,8,8.891852839835501e-05,0.00011106421733046048,0.5714285714285714
8567,8567,배기/Noun,14,6,8,8.891852839835501e-05,0.00011106421733046048,0.5714285714285714
8568,8568,2월/Number,14,6,8,8.891852839835501e-05,0.00011106421733046048,0.5714285714285714
8569,8569,유죄/Noun,14,8,6,0.00011114816049794375,8.885137386436837e-05,0.5714285714285714
8570,8570,블러드/Noun,14,6,8,8.891852839835501e-05,0.00011106421733046048,0.5714285714285714
8571,8571,복제/Noun,14,6,8,8.891852839835501e-05,0.00011106421733046048,0.5714285714285714
8572,8572,사주다/Verb,14,6,8,8.891852839835501e-05,0.00011106421733046048,0.5714285714285714
8573,8573,심야/Noun,14,6,8,8.891852839835501e-05,0.00011106421733046048,0.5714285714285714
8574,8574,결방/Noun,14,6,8,8.891852839835501e-05,0.00011106421733046048,0.5714285714285714
8575,8575,녹/Noun,14,8,6,0.00011114816049794375,8.885137386436837e-05,0.5714285714285714
8576,8576,펀치/Noun,14,6,8,8.891852839835501e-05,0.00011106421733046048,0.5714285714285714
8577,8577,무자비하다/Adjective,14,8,6,0.00011114816049794375,8.885137386436837e-05,0.5714285714285714
8578,8578,판매/Noun,14,6,8,8.891852839835501e-05,0.00011106421733046048,0.5714285714285714
8579,8579,컴백/Noun,14,6,8,8.891852839835501e-05,0.00011106421733046048,0.5714285714285714
8580,8580,대입/Noun,14,8,6,0.00011114816049794375,8.885137386436837e-05,0.5714285714285714
8581,8581,서구/Noun,14,6,8,8.891852839835501e-05,0.00011106421733046048,0.5714285714285714
8582,8582,광대/Noun,14,8,6,0.00011114816049794375,8.885137386436837e-05,0.5714285714285714
8583,8583,과극/Noun,14,8,6,0.00011114816049794375,8.885137386436837e-05,0.5714285714285714
8584,8584,허황/Noun,14,6,8,8.891852839835501e-05,0.00011106421733046048,0.5714285714285714
8585,8585,도피/Noun,14,8,6,0.00011114816049794375,8.885137386436837e-05,0.5714285714285714
8586,8586,오션스/Noun,14,6,8,8.891852839835501e-05,0.00011106421733046048,0.5714285714285714
8587,8587,종족/Noun,14,6,8,8.891852839835501e-05,0.00011106421733046048,0.5714285714285714
8588,8588,f/Alpha,14,6,8,8.891852839835501e-05,0.00011106421733046048,0.5714285714285714
8589,8589,괴짜/Noun,14,8,6,0.00011114816049794375,8.885137386436837e-05,0.5714285714285714
8590,8590,가져다주다/Verb,14,8,6,0.00011114816049794375,8.885137386436837e-05,0.5714285714285714
8591,8591,비보이/Noun,14,6,8,8.891852839835501e-05,0.00011106421733046048,0.5714285714285714
8592,8592,내려놓다/Verb,14,8,6,0.00011114816049794375,8.885137386436837e-05,0.5714285714285714
8593,8593,스턴/Noun,14,8,6,0.00011114816049794375,8.885137386436837e-05,0.5714285714285714
8594,8594,!.../Punctuation,14,8,6,0.00011114816049794375,8.885137386436837e-05,0.5714285714285714
8595,8595,이현우/Noun,14,8,6,0.00011114816049794375,8.885137386436837e-05,0.5714285714285714
8596,8596,드하/Noun,14,6,8,8.891852839835501e-05,0.00011106421733046048,0.5714285714285714
8597,8597,아티스트/Noun,14,6,8,8.891852839835501e-05,0.00011106421733046048,0.5714285714285714
8598,8598,마다가스카/Noun,14,8,6,0.00011114816049794375,8.885137386436837e-05,0.5714285714285714
8599,8599,사생활/Noun,14,6,8,8.891852839835501e-05,0.00011106421733046048,0.5714285714285714
8600,8600,눈길/Noun,14,6,8,8.891852839835501e-05,0.00011106421733046048,0.5714285714285714
8601,8601,주류/Noun,14,6,8,8.891852839835501e-05,0.00011106421733046048,0.5714285714285714
8602,8602,의적/Noun,14,6,8,8.891852839835501e-05,0.00011106421733046048,0.5714285714285714
8603,8603,최고급/Noun,14,6,8,8.891852839835501e-05,0.00011106421733046048,0.5714285714285714
8604,8604,둥이/Noun,14,8,6,0.00011114816049794375,8.885137386436837e-05,0.5714285714285714
8605,8605,으로라도/Josa,14,6,8,8.891852839835501e-05,0.00011106421733046048,0.5714285714285714
8606,8606,구름/Noun,14,8,6,0.00011114816049794375,8.885137386436837e-05,0.5714285714285714
8607,8607,홀/Noun,14,8,6,0.00011114816049794375,8.885137386436837e-05,0.5714285714285714
8608,8608,아이덴티티/Noun,14,6,8,8.891852839835501e-05,0.00011106421733046048,0.5714285714285714
8609,8609,카스/Noun,14,6,8,8.891852839835501e-05,0.00011106421733046048,0.5714285714285714
8610,8610,데인/Noun,14,6,8,8.891852839835501e-05,0.00011106421733046048,0.5714285714285714
8611,8611,냉철하다/Adjective,14,8,6,0.00011114816049794375,8.885137386436837e-05,0.5714285714285714
8612,8612,검술/Noun,14,8,6,0.00011114816049794375,8.885137386436837e-05,0.5714285714285714
8613,8613,프레임/Noun,14,8,6,0.00011114816049794375,8.885137386436837e-05,0.5714285714285714
8614,8614,저항/Noun,14,6,8,8.891852839835501e-05,0.00011106421733046048,0.5714285714285714
8615,8615,분다/Noun,14,8,6,0.00011114816049794375,8.885137386436837e-05,0.5714285714285714
8616,8616,쟈/Noun,14,8,6,0.00011114816049794375,8.885137386436837e-05,0.5714285714285714
8617,8617,강풀/Noun,14,6,8,8.891852839835501e-05,0.00011106421733046048,0.5714285714285714
8618,8618,해변/Noun,14,6,8,8.891852839835501e-05,0.00011106421733046048,0.5714285714285714
8619,8619,암흑/Noun,14,6,8,8.891852839835501e-05,0.00011106421733046048,0.5714285714285714
8620,8620,911/Number,14,8,6,0.00011114816049794375,8.885137386436837e-05,0.5714285714285714
8621,8621,터키/Noun,14,8,6,0.00011114816049794375,8.885137386436837e-05,0.5714285714285714
8622,8622,이다/Foreign,14,8,6,0.00011114816049794375,8.885137386436837e-05,0.5714285714285714
8623,8623,는바/Noun,14,8,6,0.00011114816049794375,8.885137386436837e-05,0.5714285714285714
8624,8624,발표/Noun,14,6,8,8.891852839835501e-05,0.00011106421733046048,0.5714285714285714
8625,8625,이집트/Noun,14,8,6,0.00011114816049794375,8.885137386436837e-05,0.5714285714285714
8626,8626,링컨/Noun,14,6,8,8.891852839835501e-05,0.00011106421733046048,0.5714285714285714
8627,8627,차안/Noun,14,6,8,8.891852839835501e-05,0.00011106421733046048,0.5714285714285714
8628,8628,분노의질주/Noun,14,8,6,0.00011114816049794375,8.885137386436837e-05,0.5714285714285714
8629,8629,위버/Noun,14,8,6,0.00011114816049794375,8.885137386436837e-05,0.5714285714285714
8630,8630,프레/Noun,14,8,6,0.00011114816049794375,8.885137386436837e-05,0.5714285714285714
8631,8631,고의/Noun,14,6,8,8.891852839835501e-05,0.00011106421733046048,0.5714285714285714
8632,8632,재산/Noun,14,6,8,8.891852839835501e-05,0.00011106421733046048,0.5714285714285714
8633,8633,2013/Number,14,6,8,8.891852839835501e-05,0.00011106421733046048,0.5714285714285714
8634,8634,갈릴/Noun,14,8,6,0.00011114816049794375,8.885137386436837e-05,0.5714285714285714
8635,8635,이지아/Noun,14,6,8,8.891852839835501e-05,0.00011106421733046048,0.5714285714285714
8636,8636,응징/Noun,14,6,8,8.891852839835501e-05,0.00011106421733046048,0.5714285714285714
8637,8637,데니스/Noun,14,6,8,8.891852839835501e-05,0.00011106421733046048,0.5714285714285714
8638,8638,횡포/Noun,14,6,8,8.891852839835501e-05,0.00011106421733046048,0.5714285714285714
8639,8639,페인/Noun,14,6,8,8.891852839835501e-05,0.00011106421733046048,0.5714285714285714
8640,8640,독일군/Noun,14,8,6,0.00011114816049794375,8.885137386436837e-05,0.5714285714285714
8641,8641,뽀/Noun,14,6,8,8.891852839835501e-05,0.00011106421733046048,0.5714285714285714
8642,8642,빌어/Noun,14,8,6,0.00011114816049794375,8.885137386436837e-05,0.5714285714285714
8643,8643,최성국/Noun,14,6,8,8.891852839835501e-05,0.00011106421733046048,0.5714285714285714
8644,8644,헝거게임/Noun,14,8,6,0.00011114816049794375,8.885137386436837e-05,0.5714285714285714
8645,8645,리딕/Noun,14,8,6,0.00011114816049794375,8.885137386436837e-05,0.5714285714285714
8646,8646,형사물/Noun,14,6,8,8.891852839835501e-05,0.00011106421733046048,0.5714285714285714
8647,8647,두르다/Verb,14,7,7,0.0001000333444481494,9.995779559741441e-05,0.5
8648,8648,숲속/Noun,14,7,7,0.0001000333444481494,9.995779559741441e-05,0.5
8649,8649,랏/Noun,14,7,7,0.0001000333444481494,9.995779559741441e-05,0.5
8650,8650,화기/Noun,14,7,7,0.0001000333444481494,9.995779559741441e-05,0.5
8651,8651,김두한/Noun,14,7,7,0.0001000333444481494,9.995779559741441e-05,0.5
8652,8652,풍선/Noun,14,7,7,0.0001000333444481494,9.995779559741441e-05,0.5
8653,8653,의자/Noun,14,7,7,0.0001000333444481494,9.995779559741441e-05,0.5
8654,8654,토모/Noun,14,7,7,0.0001000333444481494,9.995779559741441e-05,0.5
8655,8655,수행/Noun,14,7,7,0.0001000333444481494,9.995779559741441e-05,0.5
8656,8656,서나/Noun,14,7,7,0.0001000333444481494,9.995779559741441e-05,0.5
8657,8657,텅/Noun,14,7,7,0.0001000333444481494,9.995779559741441e-05,0.5
8658,8658,선언/Noun,14,7,7,0.0001000333444481494,9.995779559741441e-05,0.5
8659,8659,탄압/Noun,14,7,7,0.0001000333444481494,9.995779559741441e-05,0.5
8660,8660,맞춤/Noun,14,7,7,0.0001000333444481494,9.995779559741441e-05,0.5
8661,8661,계시/Noun,14,7,7,0.0001000333444481494,9.995779559741441e-05,0.5
8662,8662,파렐/Noun,14,7,7,0.0001000333444481494,9.995779559741441e-05,0.5
8663,8663,일편/Noun,14,7,7,0.0001000333444481494,9.995779559741441e-05,0.5
8664,8664,수긍/Noun,14,7,7,0.0001000333444481494,9.995779559741441e-05,0.5
8665,8665,콜/Noun,14,7,7,0.0001000333444481494,9.995779559741441e-05,0.5
8666,8666,발사/Noun,14,7,7,0.0001000333444481494,9.995779559741441e-05,0.5
8667,8667,이청아/Noun,14,7,7,0.0001000333444481494,9.995779559741441e-05,0.5
8668,8668,방도/Noun,14,7,7,0.0001000333444481494,9.995779559741441e-05,0.5
8669,8669,체인지/Noun,14,7,7,0.0001000333444481494,9.995779559741441e-05,0.5
8670,8670,계급/Noun,14,7,7,0.0001000333444481494,9.995779559741441e-05,0.5
8671,8671,여하튼/Noun,14,7,7,0.0001000333444481494,9.995779559741441e-05,0.5
8672,8672,바랬는데/Noun,14,7,7,0.0001000333444481494,9.995779559741441e-05,0.5
8673,8673,브/Noun,14,7,7,0.0001000333444481494,9.995779559741441e-05,0.5
8674,8674,릴리/Noun,14,7,7,0.0001000333444481494,9.995779559741441e-05,0.5
8675,8675,이오/Noun,14,7,7,0.0001000333444481494,9.995779559741441e-05,0.5
8676,8676,말년/Noun,14,7,7,0.0001000333444481494,9.995779559741441e-05,0.5
8677,8677,서인/Noun,14,7,7,0.0001000333444481494,9.995779559741441e-05,0.5
8678,8678,홍길동/Noun,14,7,7,0.0001000333444481494,9.995779559741441e-05,0.5
8679,8679,현주소/Noun,14,7,7,0.0001000333444481494,9.995779559741441e-05,0.5
8680,8680,일어나고/Noun,14,7,7,0.0001000333444481494,9.995779559741441e-05,0.5
8681,8681,봉인/Noun,14,7,7,0.0001000333444481494,9.995779559741441e-05,0.5
8682,8682,해주시/Noun,14,7,7,0.0001000333444481494,9.995779559741441e-05,0.5
8683,8683,깔리다/Verb,14,7,7,0.0001000333444481494,9.995779559741441e-05,0.5
8684,8684,딜레마/Noun,14,7,7,0.0001000333444481494,9.995779559741441e-05,0.5
8685,8685,단독/Noun,14,7,7,0.0001000333444481494,9.995779559741441e-05,0.5
8686,8686,막막하다/Adjective,14,7,7,0.0001000333444481494,9.995779559741441e-05,0.5
8687,8687,남자에게/Noun,14,7,7,0.0001000333444481494,9.995779559741441e-05,0.5
8688,8688,은별/Noun,14,7,7,0.0001000333444481494,9.995779559741441e-05,0.5
8689,8689,금치/Noun,14,7,7,0.0001000333444481494,9.995779559741441e-05,0.5
8690,8690,휴지통/Noun,13,0,13,2.2229632099588756e-05,0.0001665963259956907,1.0
8691,8691,동남아/Noun,13,0,13,2.2229632099588756e-05,0.0001665963259956907,1.0
8692,8692,we/Alpha,13,13,0,0.00016672224074691566,2.2212843466092093e-05,1.0
8693,8693,저리다/Adjective,13,13,0,0.00016672224074691566,2.2212843466092093e-05,1.0
8694,8694,졷/Noun,13,0,13,2.2229632099588756e-05,0.0001665963259956907,1.0
8695,8695,이화영/Noun,13,0,13,2.2229632099588756e-05,0.0001665963259956907,1.0
8696,8696,라그/Noun,13,0,13,2.2229632099588756e-05,0.0001665963259956907,1.0
8697,8697,정윤희/Noun,13,13,0,0.00016672224074691566,2.2212843466092093e-05,1.0
8698,8698,정도껏해/Noun,13,0,13,2.2229632099588756e-05,0.0001665963259956907,1.0
8699,8699,나사/Noun,13,0,13,2.2229632099588756e-05,0.0001665963259956907,1.0
8700,8700,이상준/Noun,13,0,13,2.2229632099588756e-05,0.0001665963259956907,1.0
8701,8701,죽도/Noun,13,0,13,2.2229632099588756e-05,0.0001665963259956907,1.0
8702,8702,아려/Noun,13,13,0,0.00016672224074691566,2.2212843466092093e-05,1.0
8703,8703,댕기/Noun,13,0,13,2.2229632099588756e-05,0.0001665963259956907,1.0
8704,8704,지스토리/Noun,13,0,13,2.2229632099588756e-05,0.0001665963259956907,1.0
8705,8705,씩씩하다/Adjective,13,13,0,0.00016672224074691566,2.2212843466092093e-05,1.0
8706,8706,모욕감/Noun,13,0,13,2.2229632099588756e-05,0.0001665963259956907,1.0
8707,8707,질색/Noun,13,0,13,2.2229632099588756e-05,0.0001665963259956907,1.0
8708,8708,최우식/Noun,13,13,0,0.00016672224074691566,2.2212843466092093e-05,1.0
8709,8709,오호/Exclamation,13,12,1,0.00015560742469712126,3.331926519913814e-05,0.9230769230769232
8710,8710,무뇌/Noun,13,1,12,3.334444814938313e-05,0.00015548990426264466,0.9230769230769232
8711,8711,전날/Noun,13,12,1,0.00015560742469712126,3.331926519913814e-05,0.9230769230769232
8712,8712,잠듬/Noun,13,1,12,3.334444814938313e-05,0.00015548990426264466,0.9230769230769232
8713,8713,사뭇/Noun,13,12,1,0.00015560742469712126,3.331926519913814e-05,0.9230769230769232
8714,8714,ㅅㄲ/KoreanParticle,13,1,12,3.334444814938313e-05,0.00015548990426264466,0.9230769230769232
8715,8715,life/Alpha,13,12,1,0.00015560742469712126,3.331926519913814e-05,0.9230769230769232
8716,8716,상남자/Noun,13,12,1,0.00015560742469712126,3.331926519913814e-05,0.9230769230769232
8717,8717,툭하면/Noun,13,1,12,3.334444814938313e-05,0.00015548990426264466,0.9230769230769232
8718,8718,Cg/Alpha,13,1,12,3.334444814938313e-05,0.00015548990426264466,0.9230769230769232
8719,8719,이창동/Noun,13,12,1,0.00015560742469712126,3.331926519913814e-05,0.9230769230769232
8720,8720,노망/Noun,13,1,12,3.334444814938313e-05,0.00015548990426264466,0.9230769230769232
8721,8721,로빈윌리엄스/Noun,13,12,1,0.00015560742469712126,3.331926519913814e-05,0.9230769230769232
8722,8722,박기웅/Noun,13,12,1,0.00015560742469712126,3.331926519913814e-05,0.9230769230769232
8723,8723,한스/Noun,13,12,1,0.00015560742469712126,3.331926519913814e-05,0.9230769230769232
8724,8724,괜춘/Noun,13,12,1,0.00015560742469712126,3.331926519913814e-05,0.9230769230769232
8725,8725,아낌없이/Adverb,13,12,1,0.00015560742469712126,3.331926519913814e-05,0.9230769230769232
8726,8726,잘껄/Noun,13,1,12,3.334444814938313e-05,0.00015548990426264466,0.9230769230769232
8727,8727,미끼/Noun,13,1,12,3.334444814938313e-05,0.00015548990426264466,0.9230769230769232
8728,8728,밋밋/Noun,13,1,12,3.334444814938313e-05,0.00015548990426264466,0.9230769230769232
8729,8729,휴그랜트/Noun,13,12,1,0.00015560742469712126,3.331926519913814e-05,0.9230769230769232
8730,8730,분단/Noun,13,12,1,0.00015560742469712126,3.331926519913814e-05,0.9230769230769232
8731,8731,on/Alpha,13,12,1,0.00015560742469712126,3.331926519913814e-05,0.9230769230769232
8732,8732,타오르다/Verb,13,12,1,0.00015560742469712126,3.331926519913814e-05,0.9230769230769232
8733,8733,퉷/Noun,13,1,12,3.334444814938313e-05,0.00015548990426264466,0.9230769230769232
8734,8734,삭막하다/Adjective,13,12,1,0.00015560742469712126,3.331926519913814e-05,0.9230769230769232
8735,8735,쯔쯔/Noun,13,1,12,3.334444814938313e-05,0.00015548990426264466,0.9230769230769232
8736,8736,로건/Noun,13,12,1,0.00015560742469712126,3.331926519913814e-05,0.9230769230769232
8737,8737,따분함/Noun,13,1,12,3.334444814938313e-05,0.00015548990426264466,0.9230769230769232
8738,8738,바르뎀/Noun,13,12,1,0.00015560742469712126,3.331926519913814e-05,0.9230769230769232
8739,8739,쯧/Exclamation,13,2,11,4.445926419917751e-05,0.0001443834825295986,0.8461538461538461
8740,8740,쯧쯧/Exclamation,13,2,11,4.445926419917751e-05,0.0001443834825295986,0.8461538461538461
8741,8741,기껏/Noun,13,2,11,4.445926419917751e-05,0.0001443834825295986,0.8461538461538461
8742,8742,하기는/Adverb,13,2,11,4.445926419917751e-05,0.0001443834825295986,0.8461538461538461
8743,8743,.!!!/Punctuation,13,11,2,0.0001444926086473269,4.4425686932184186e-05,0.8461538461538461
8744,8744,별도/Noun,13,2,11,4.445926419917751e-05,0.0001443834825295986,0.8461538461538461
8745,8745,캠코더/Noun,13,2,11,4.445926419917751e-05,0.0001443834825295986,0.8461538461538461
8746,8746,방구/Noun,13,2,11,4.445926419917751e-05,0.0001443834825295986,0.8461538461538461
8747,8747,요런/Noun,13,11,2,0.0001444926086473269,4.4425686932184186e-05,0.8461538461538461
8748,8748,분전/Noun,13,2,11,4.445926419917751e-05,0.0001443834825295986,0.8461538461538461
8749,8749,부당하다/Adjective,13,11,2,0.0001444926086473269,4.4425686932184186e-05,0.8461538461538461
8750,8750,당근/Noun,13,11,2,0.0001444926086473269,4.4425686932184186e-05,0.8461538461538461
8751,8751,독립영화관/Noun,13,11,2,0.0001444926086473269,4.4425686932184186e-05,0.8461538461538461
8752,8752,농촌/Noun,13,11,2,0.0001444926086473269,4.4425686932184186e-05,0.8461538461538461
8753,8753,델피/Noun,13,11,2,0.0001444926086473269,4.4425686932184186e-05,0.8461538461538461
8754,8754,은정/Noun,13,2,11,4.445926419917751e-05,0.0001443834825295986,0.8461538461538461
8755,8755,지모/Noun,13,11,2,0.0001444926086473269,4.4425686932184186e-05,0.8461538461538461
8756,8756,캠/Noun,13,2,11,4.445926419917751e-05,0.0001443834825295986,0.8461538461538461
8757,8757,반한/Noun,13,11,2,0.0001444926086473269,4.4425686932184186e-05,0.8461538461538461
8758,8758,빽/Noun,13,2,11,4.445926419917751e-05,0.0001443834825295986,0.8461538461538461
8759,8759,래미/Noun,13,2,11,4.445926419917751e-05,0.0001443834825295986,0.8461538461538461
8760,8760,브랜든/Noun,13,11,2,0.0001444926086473269,4.4425686932184186e-05,0.8461538461538461
8761,8761,깍/Noun,13,2,11,4.445926419917751e-05,0.0001443834825295986,0.8461538461538461
8762,8762,애착/Noun,13,11,2,0.0001444926086473269,4.4425686932184186e-05,0.8461538461538461
8763,8763,재밌슴/Noun,13,11,2,0.0001444926086473269,4.4425686932184186e-05,0.8461538461538461
8764,8764,핑/Noun,13,11,2,0.0001444926086473269,4.4425686932184186e-05,0.8461538461538461
8765,8765,극악/Noun,13,2,11,4.445926419917751e-05,0.0001443834825295986,0.8461538461538461
8766,8766,해피앤딩/Noun,13,11,2,0.0001444926086473269,4.4425686932184186e-05,0.8461538461538461
8767,8767,기인/Noun,13,2,11,4.445926419917751e-05,0.0001443834825295986,0.8461538461538461
8768,8768,돈벌이/Noun,13,2,11,4.445926419917751e-05,0.0001443834825295986,0.8461538461538461
8769,8769,정감/Noun,13,11,2,0.0001444926086473269,4.4425686932184186e-05,0.8461538461538461
8770,8770,흡인/Noun,13,11,2,0.0001444926086473269,4.4425686932184186e-05,0.8461538461538461
8771,8771,삼각관계/Noun,13,2,11,4.445926419917751e-05,0.0001443834825295986,0.8461538461538461
8772,8772,특촬물/Noun,13,2,11,4.445926419917751e-05,0.0001443834825295986,0.8461538461538461
8773,8773,디도/Noun,13,2,11,4.445926419917751e-05,0.0001443834825295986,0.8461538461538461
8774,8774,야심/Noun,13,2,11,4.445926419917751e-05,0.0001443834825295986,0.8461538461538461
8775,8775,블레어/Noun,13,2,11,4.445926419917751e-05,0.0001443834825295986,0.8461538461538461
8776,8776,부리고/Noun,13,2,11,4.445926419917751e-05,0.0001443834825295986,0.8461538461538461
8777,8777,반대편/Noun,13,11,2,0.0001444926086473269,4.4425686932184186e-05,0.8461538461538461
8778,8778,습니/Noun,13,11,2,0.0001444926086473269,4.4425686932184186e-05,0.8461538461538461
8779,8779,무스/Noun,13,11,2,0.0001444926086473269,4.4425686932184186e-05,0.8461538461538461
8780,8780,REC/Alpha,13,2,11,4.445926419917751e-05,0.0001443834825295986,0.8461538461538461
8781,8781,꼽는다/Noun,13,11,2,0.0001444926086473269,4.4425686932184186e-05,0.8461538461538461
8782,8782,정은지/Noun,13,11,2,0.0001444926086473269,4.4425686932184186e-05,0.8461538461538461
8783,8783,분발/Noun,13,2,11,4.445926419917751e-05,0.0001443834825295986,0.8461538461538461
8784,8784,4~5/Number,13,2,11,4.445926419917751e-05,0.0001443834825295986,0.8461538461538461
8785,8785,애매모호하다/Adjective,13,2,11,4.445926419917751e-05,0.0001443834825295986,0.8461538461538461
8786,8786,업자/Noun,13,2,11,4.445926419917751e-05,0.0001443834825295986,0.8461538461538461
8787,8787,버프/Noun,13,2,11,4.445926419917751e-05,0.0001443834825295986,0.8461538461538461
8788,8788,코비/Noun,13,11,2,0.0001444926086473269,4.4425686932184186e-05,0.8461538461538461
8789,8789,썸띵/Noun,13,2,11,4.445926419917751e-05,0.0001443834825295986,0.8461538461538461
8790,8790,김정훈/Noun,13,3,10,5.5574080248971876e-05,0.00013327706079655256,0.7692307692307693
8791,8791,소감/Noun,13,3,10,5.5574080248971876e-05,0.00013327706079655256,0.7692307692307693
8792,8792,외로워/Noun,13,10,3,0.0001333777925975325,5.553210866523024e-05,0.7692307692307693
8793,8793,imdb/Alpha,13,3,10,5.5574080248971876e-05,0.00013327706079655256,0.7692307692307693
8794,8794,!!!!!!!!!!!!!/Punctuation,13,10,3,0.0001333777925975325,5.553210866523024e-05,0.7692307692307693
8795,8795,점령/Noun,13,3,10,5.5574080248971876e-05,0.00013327706079655256,0.7692307692307693
8796,8796,캠프/Noun,13,3,10,5.5574080248971876e-05,0.00013327706079655256,0.7692307692307693
8797,8797,숨소리/Noun,13,10,3,0.0001333777925975325,5.553210866523024e-05,0.7692307692307693
8798,8798,거림/Noun,13,10,3,0.0001333777925975325,5.553210866523024e-05,0.7692307692307693
8799,8799,도쿄/Noun,13,10,3,0.0001333777925975325,5.553210866523024e-05,0.7692307692307693
8800,8800,....^^/Punctuation,13,10,3,0.0001333777925975325,5.553210866523024e-05,0.7692307692307693
8801,8801,욥/Noun,13,10,3,0.0001333777925975325,5.553210866523024e-05,0.7692307692307693
8802,8802,인주/Noun,13,3,10,5.5574080248971876e-05,0.00013327706079655256,0.7692307692307693
8803,8803,평가절하/Noun,13,10,3,0.0001333777925975325,5.553210866523024e-05,0.7692307692307693
8804,8804,노홍철/Noun,13,10,3,0.0001333777925975325,5.553210866523024e-05,0.7692307692307693
8805,8805,굴곡/Noun,13,3,10,5.5574080248971876e-05,0.00013327706079655256,0.7692307692307693
8806,8806,소문나다/Verb,13,3,10,5.5574080248971876e-05,0.00013327706079655256,0.7692307692307693
8807,8807,십자/Noun,13,3,10,5.5574080248971876e-05,0.00013327706079655256,0.7692307692307693
8808,8808,쩔/Noun,13,10,3,0.0001333777925975325,5.553210866523024e-05,0.7692307692307693
8809,8809,맛깔/Noun,13,10,3,0.0001333777925975325,5.553210866523024e-05,0.7692307692307693
8810,8810,서유리/Noun,13,3,10,5.5574080248971876e-05,0.00013327706079655256,0.7692307692307693
8811,8811,햐/Noun,13,3,10,5.5574080248971876e-05,0.00013327706079655256,0.7692307692307693
8812,8812,끝임/Noun,13,3,10,5.5574080248971876e-05,0.00013327706079655256,0.7692307692307693
8813,8813,복사/Noun,13,3,10,5.5574080248971876e-05,0.00013327706079655256,0.7692307692307693
8814,8814,조미/Noun,13,10,3,0.0001333777925975325,5.553210866523024e-05,0.7692307692307693
8815,8815,수염/Noun,13,3,10,5.5574080248971876e-05,0.00013327706079655256,0.7692307692307693
8816,8816,빡/Noun,13,3,10,5.5574080248971876e-05,0.00013327706079655256,0.7692307692307693
8817,8817,카렐/Noun,13,10,3,0.0001333777925975325,5.553210866523024e-05,0.7692307692307693
8818,8818,간의/Foreign,13,10,3,0.0001333777925975325,5.553210866523024e-05,0.7692307692307693
8819,8819,이재은/Noun,13,3,10,5.5574080248971876e-05,0.00013327706079655256,0.7692307692307693
8820,8820,배출/Noun,13,10,3,0.0001333777925975325,5.553210866523024e-05,0.7692307692307693
8821,8821,누리/Noun,13,10,3,0.0001333777925975325,5.553210866523024e-05,0.7692307692307693
8822,8822,비겁하다/Adjective,13,3,10,5.5574080248971876e-05,0.00013327706079655256,0.7692307692307693
8823,8823,부들부들/Noun,13,3,10,5.5574080248971876e-05,0.00013327706079655256,0.7692307692307693
8824,8824,수트/Noun,13,10,3,0.0001333777925975325,5.553210866523024e-05,0.7692307692307693
8825,8825,뻑/Noun,13,3,10,5.5574080248971876e-05,0.00013327706079655256,0.7692307692307693
8826,8826,기수/Noun,13,3,10,5.5574080248971876e-05,0.00013327706079655256,0.7692307692307693
8827,8827,스럽지도/Josa,13,3,10,5.5574080248971876e-05,0.00013327706079655256,0.7692307692307693
8828,8828,예언/Noun,13,10,3,0.0001333777925975325,5.553210866523024e-05,0.7692307692307693
8829,8829,120/Number,13,3,10,5.5574080248971876e-05,0.00013327706079655256,0.7692307692307693
8830,8830,넘어오다/Verb,13,3,10,5.5574080248971876e-05,0.00013327706079655256,0.7692307692307693
8831,8831,히트치다/Verb,13,3,10,5.5574080248971876e-05,0.00013327706079655256,0.7692307692307693
8832,8832,고창석/Noun,13,3,10,5.5574080248971876e-05,0.00013327706079655256,0.7692307692307693
8833,8833,조로/Noun,13,3,10,5.5574080248971876e-05,0.00013327706079655256,0.7692307692307693
8834,8834,안대/Noun,13,3,10,5.5574080248971876e-05,0.00013327706079655256,0.7692307692307693
8835,8835,선장/Noun,13,10,3,0.0001333777925975325,5.553210866523024e-05,0.7692307692307693
8836,8836,시적/Noun,13,10,3,0.0001333777925975325,5.553210866523024e-05,0.7692307692307693
8837,8837,방송사/Noun,13,3,10,5.5574080248971876e-05,0.00013327706079655256,0.7692307692307693
8838,8838,국경/Noun,13,10,3,0.0001333777925975325,5.553210866523024e-05,0.7692307692307693
8839,8839,버디/Noun,13,10,3,0.0001333777925975325,5.553210866523024e-05,0.7692307692307693
8840,8840,신체/Noun,13,3,10,5.5574080248971876e-05,0.00013327706079655256,0.7692307692307693
8841,8841,마리옹/Noun,13,10,3,0.0001333777925975325,5.553210866523024e-05,0.7692307692307693
8842,8842,만끽/Noun,13,10,3,0.0001333777925975325,5.553210866523024e-05,0.7692307692307693
8843,8843,봉하/Noun,13,10,3,0.0001333777925975325,5.553210866523024e-05,0.7692307692307693
8844,8844,재개/Noun,13,10,3,0.0001333777925975325,5.553210866523024e-05,0.7692307692307693
8845,8845,살찌다/Adjective,13,3,10,5.5574080248971876e-05,0.00013327706079655256,0.7692307692307693
8846,8846,무의식/Noun,13,10,3,0.0001333777925975325,5.553210866523024e-05,0.7692307692307693
8847,8847,워킹/Noun,13,3,10,5.5574080248971876e-05,0.00013327706079655256,0.7692307692307693
8848,8848,우산/Noun,13,10,3,0.0001333777925975325,5.553210866523024e-05,0.7692307692307693
8849,8849,1960년/Number,13,3,10,5.5574080248971876e-05,0.00013327706079655256,0.7692307692307693
8850,8850,영원/Noun,13,10,3,0.0001333777925975325,5.553210866523024e-05,0.7692307692307693
8851,8851,마리아/Noun,13,10,3,0.0001333777925975325,5.553210866523024e-05,0.7692307692307693
8852,8852,계절/Noun,13,10,3,0.0001333777925975325,5.553210866523024e-05,0.7692307692307693
8853,8853,최루성/Noun,13,4,9,6.668889629876625e-05,0.00012217063906350652,0.6923076923076923
8854,8854,손길/Noun,13,9,4,0.00012226297654773814,6.663853039827628e-05,0.6923076923076923
8855,8855,한고은/Noun,13,4,9,6.668889629876625e-05,0.00012217063906350652,0.6923076923076923
8856,8856,문란하다/Adjective,13,4,9,6.668889629876625e-05,0.00012217063906350652,0.6923076923076923
8857,8857,꺅/Adverb,13,9,4,0.00012226297654773814,6.663853039827628e-05,0.6923076923076923
8858,8858,이영환/Noun,13,4,9,6.668889629876625e-05,0.00012217063906350652,0.6923076923076923
8859,8859,미취/Noun,13,4,9,6.668889629876625e-05,0.00012217063906350652,0.6923076923076923
8860,8860,갑옷/Noun,13,4,9,6.668889629876625e-05,0.00012217063906350652,0.6923076923076923
8861,8861,가르시아/Noun,13,9,4,0.00012226297654773814,6.663853039827628e-05,0.6923076923076923
8862,8862,이어도/Noun,13,9,4,0.00012226297654773814,6.663853039827628e-05,0.6923076923076923
8863,8863,천안함/Noun,13,4,9,6.668889629876625e-05,0.00012217063906350652,0.6923076923076923
8864,8864,하류/Noun,13,4,9,6.668889629876625e-05,0.00012217063906350652,0.6923076923076923
8865,8865,나미/Noun,13,4,9,6.668889629876625e-05,0.00012217063906350652,0.6923076923076923
8866,8866,엿/Noun,13,4,9,6.668889629876625e-05,0.00012217063906350652,0.6923076923076923
8867,8867,아찔하다/Adjective,13,9,4,0.00012226297654773814,6.663853039827628e-05,0.6923076923076923
8868,8868,소신/Noun,13,9,4,0.00012226297654773814,6.663853039827628e-05,0.6923076923076923
8869,8869,엘리/Noun,13,9,4,0.00012226297654773814,6.663853039827628e-05,0.6923076923076923
8870,8870,로미오/Noun,13,9,4,0.00012226297654773814,6.663853039827628e-05,0.6923076923076923
8871,8871,이씨/Noun,13,4,9,6.668889629876625e-05,0.00012217063906350652,0.6923076923076923
8872,8872,모모/Noun,13,4,9,6.668889629876625e-05,0.00012217063906350652,0.6923076923076923
8873,8873,비율/Noun,13,4,9,6.668889629876625e-05,0.00012217063906350652,0.6923076923076923
8874,8874,게이트/Noun,13,9,4,0.00012226297654773814,6.663853039827628e-05,0.6923076923076923
8875,8875,5.5/Number,13,4,9,6.668889629876625e-05,0.00012217063906350652,0.6923076923076923
8876,8876,고대/Noun,13,9,4,0.00012226297654773814,6.663853039827628e-05,0.6923076923076923
8877,8877,인가/Foreign,13,9,4,0.00012226297654773814,6.663853039827628e-05,0.6923076923076923
8878,8878,첩혈쌍웅/Noun,13,9,4,0.00012226297654773814,6.663853039827628e-05,0.6923076923076923
8879,8879,무쟈/Noun,13,4,9,6.668889629876625e-05,0.00012217063906350652,0.6923076923076923
8880,8880,왕가네/Noun,13,4,9,6.668889629876625e-05,0.00012217063906350652,0.6923076923076923
8881,8881,gg/Alpha,13,4,9,6.668889629876625e-05,0.00012217063906350652,0.6923076923076923
8882,8882,가출/Noun,13,4,9,6.668889629876625e-05,0.00012217063906350652,0.6923076923076923
8883,8883,캔디/Noun,13,9,4,0.00012226297654773814,6.663853039827628e-05,0.6923076923076923
8884,8884,취업/Noun,13,9,4,0.00012226297654773814,6.663853039827628e-05,0.6923076923076923
8885,8885,장통/Noun,13,9,4,0.00012226297654773814,6.663853039827628e-05,0.6923076923076923
8886,8886,조온나/Noun,13,4,9,6.668889629876625e-05,0.00012217063906350652,0.6923076923076923
8887,8887,설교/Noun,13,4,9,6.668889629876625e-05,0.00012217063906350652,0.6923076923076923
8888,8888,애증/Noun,13,9,4,0.00012226297654773814,6.663853039827628e-05,0.6923076923076923
8889,8889,빼앗다/Verb,13,4,9,6.668889629876625e-05,0.00012217063906350652,0.6923076923076923
8890,8890,강인/Noun,13,4,9,6.668889629876625e-05,0.00012217063906350652,0.6923076923076923
8891,8891,약점/Noun,13,4,9,6.668889629876625e-05,0.00012217063906350652,0.6923076923076923
8892,8892,올라서다/Verb,13,9,4,0.00012226297654773814,6.663853039827628e-05,0.6923076923076923
8893,8893,BEST/Alpha,13,9,4,0.00012226297654773814,6.663853039827628e-05,0.6923076923076923
8894,8894,왜냐하면/Adverb,13,9,4,0.00012226297654773814,6.663853039827628e-05,0.6923076923076923
8895,8895,훑다/Verb,13,4,9,6.668889629876625e-05,0.00012217063906350652,0.6923076923076923
8896,8896,동해/Noun,13,4,9,6.668889629876625e-05,0.00012217063906350652,0.6923076923076923
8897,8897,휴일/Noun,13,9,4,0.00012226297654773814,6.663853039827628e-05,0.6923076923076923
8898,8898,주된/Modifier,13,4,9,6.668889629876625e-05,0.00012217063906350652,0.6923076923076923
8899,8899,불사신/Noun,13,4,9,6.668889629876625e-05,0.00012217063906350652,0.6923076923076923
8900,8900,선악/Noun,13,9,4,0.00012226297654773814,6.663853039827628e-05,0.6923076923076923
8901,8901,공평하다/Adjective,13,9,4,0.00012226297654773814,6.663853039827628e-05,0.6923076923076923
8902,8902,신경안/Noun,13,4,9,6.668889629876625e-05,0.00012217063906350652,0.6923076923076923
8903,8903,성취/Noun,13,9,4,0.00012226297654773814,6.663853039827628e-05,0.6923076923076923
8904,8904,근원/Noun,13,9,4,0.00012226297654773814,6.663853039827628e-05,0.6923076923076923
8905,8905,민아/Noun,13,9,4,0.00012226297654773814,6.663853039827628e-05,0.6923076923076923
8906,8906,알렌/Noun,13,9,4,0.00012226297654773814,6.663853039827628e-05,0.6923076923076923
8907,8907,광수/Noun,13,4,9,6.668889629876625e-05,0.00012217063906350652,0.6923076923076923
8908,8908,시급하다/Adjective,13,4,9,6.668889629876625e-05,0.00012217063906350652,0.6923076923076923
8909,8909,남극/Noun,13,9,4,0.00012226297654773814,6.663853039827628e-05,0.6923076923076923
8910,8910,절벽/Noun,13,4,9,6.668889629876625e-05,0.00012217063906350652,0.6923076923076923
8911,8911,브레드/Noun,13,4,9,6.668889629876625e-05,0.00012217063906350652,0.6923076923076923
8912,8912,실현/Noun,13,9,4,0.00012226297654773814,6.663853039827628e-05,0.6923076923076923
8913,8913,아부지/Noun,13,9,4,0.00012226297654773814,6.663853039827628e-05,0.6923076923076923
8914,8914,27/Number,13,9,4,0.00012226297654773814,6.663853039827628e-05,0.6923076923076923
8915,8915,노출씬/Noun,13,4,9,6.668889629876625e-05,0.00012217063906350652,0.6923076923076923
8916,8916,달려들다/Verb,13,4,9,6.668889629876625e-05,0.00012217063906350652,0.6923076923076923
8917,8917,문어/Noun,13,4,9,6.668889629876625e-05,0.00012217063906350652,0.6923076923076923
8918,8918,동반/Noun,13,9,4,0.00012226297654773814,6.663853039827628e-05,0.6923076923076923
8919,8919,♪/Foreign,13,9,4,0.00012226297654773814,6.663853039827628e-05,0.6923076923076923
8920,8920,최다니엘/Noun,13,9,4,0.00012226297654773814,6.663853039827628e-05,0.6923076923076923
8921,8921,차량/Noun,13,4,9,6.668889629876625e-05,0.00012217063906350652,0.6923076923076923
8922,8922,주도/Noun,13,4,9,6.668889629876625e-05,0.00012217063906350652,0.6923076923076923
8923,8923,히든싱어/Noun,13,9,4,0.00012226297654773814,6.663853039827628e-05,0.6923076923076923
8924,8924,마자/Noun,13,4,9,6.668889629876625e-05,0.00012217063906350652,0.6923076923076923
8925,8925,시공간/Noun,13,9,4,0.00012226297654773814,6.663853039827628e-05,0.6923076923076923
8926,8926,신작/Noun,13,4,9,6.668889629876625e-05,0.00012217063906350652,0.6923076923076923
8927,8927,기여/Noun,13,9,4,0.00012226297654773814,6.663853039827628e-05,0.6923076923076923
8928,8928,른/Noun,13,9,4,0.00012226297654773814,6.663853039827628e-05,0.6923076923076923
8929,8929,수백/Modifier,13,4,9,6.668889629876625e-05,0.00012217063906350652,0.6923076923076923
8930,8930,무덥다/Adjective,13,9,4,0.00012226297654773814,6.663853039827628e-05,0.6923076923076923
8931,8931,김인권/Noun,13,4,9,6.668889629876625e-05,0.00012217063906350652,0.6923076923076923
8932,8932,성별/Noun,13,4,9,6.668889629876625e-05,0.00012217063906350652,0.6923076923076923
8933,8933,오징어/Noun,13,4,9,6.668889629876625e-05,0.00012217063906350652,0.6923076923076923
8934,8934,허드/Noun,13,4,9,6.668889629876625e-05,0.00012217063906350652,0.6923076923076923
8935,8935,치정/Noun,13,4,9,6.668889629876625e-05,0.00012217063906350652,0.6923076923076923
8936,8936,회도/Noun,13,9,4,0.00012226297654773814,6.663853039827628e-05,0.6923076923076923
8937,8937,구가/Noun,13,4,9,6.668889629876625e-05,0.00012217063906350652,0.6923076923076923
8938,8938,에어컨/Noun,13,5,8,7.780371234856063e-05,0.00011106421733046048,0.6153846153846154
8939,8939,최면/Noun,13,5,8,7.780371234856063e-05,0.00011106421733046048,0.6153846153846154
8940,8940,더락/Noun,13,8,5,0.00011114816049794375,7.774495213132233e-05,0.6153846153846154
8941,8941,찾아내다/Verb,13,8,5,0.00011114816049794375,7.774495213132233e-05,0.6153846153846154
8942,8942,자리다/Adjective,13,8,5,0.00011114816049794375,7.774495213132233e-05,0.6153846153846154
8943,8943,힝/Noun,13,8,5,0.00011114816049794375,7.774495213132233e-05,0.6153846153846154
8944,8944,으이/Adverb,13,5,8,7.780371234856063e-05,0.00011106421733046048,0.6153846153846154
8945,8945,스시/Noun,13,8,5,0.00011114816049794375,7.774495213132233e-05,0.6153846153846154
8946,8946,비도/Noun,13,8,5,0.00011114816049794375,7.774495213132233e-05,0.6153846153846154
8947,8947,특공대/Noun,13,5,8,7.780371234856063e-05,0.00011106421733046048,0.6153846153846154
8948,8948,고다르/Noun,13,8,5,0.00011114816049794375,7.774495213132233e-05,0.6153846153846154
8949,8949,아나운서/Noun,13,5,8,7.780371234856063e-05,0.00011106421733046048,0.6153846153846154
8950,8950,저주받다/Verb,13,5,8,7.780371234856063e-05,0.00011106421733046048,0.6153846153846154
8951,8951,정면/Noun,13,8,5,0.00011114816049794375,7.774495213132233e-05,0.6153846153846154
8952,8952,썸머/Noun,13,8,5,0.00011114816049794375,7.774495213132233e-05,0.6153846153846154
8953,8953,조성/Noun,13,5,8,7.780371234856063e-05,0.00011106421733046048,0.6153846153846154
8954,8954,모에/Noun,13,5,8,7.780371234856063e-05,0.00011106421733046048,0.6153846153846154
8955,8955,범죄물/Noun,13,5,8,7.780371234856063e-05,0.00011106421733046048,0.6153846153846154
8956,8956,엇을/Noun,13,5,8,7.780371234856063e-05,0.00011106421733046048,0.6153846153846154
8957,8957,해군/Noun,13,8,5,0.00011114816049794375,7.774495213132233e-05,0.6153846153846154
8958,8958,아우라/Noun,13,5,8,7.780371234856063e-05,0.00011106421733046048,0.6153846153846154
8959,8959,마나/Noun,13,5,8,7.780371234856063e-05,0.00011106421733046048,0.6153846153846154
8960,8960,구별/Noun,13,5,8,7.780371234856063e-05,0.00011106421733046048,0.6153846153846154
8961,8961,>./Punctuation,13,8,5,0.00011114816049794375,7.774495213132233e-05,0.6153846153846154
8962,8962,중립/Noun,13,5,8,7.780371234856063e-05,0.00011106421733046048,0.6153846153846154
8963,8963,멕시코/Noun,13,5,8,7.780371234856063e-05,0.00011106421733046048,0.6153846153846154
8964,8964,솔직/Noun,13,8,5,0.00011114816049794375,7.774495213132233e-05,0.6153846153846154
8965,8965,언덕/Noun,13,8,5,0.00011114816049794375,7.774495213132233e-05,0.6153846153846154
8966,8966,오케스트라/Noun,13,8,5,0.00011114816049794375,7.774495213132233e-05,0.6153846153846154
8967,8967,해병대/Noun,13,5,8,7.780371234856063e-05,0.00011106421733046048,0.6153846153846154
8968,8968,아악/Noun,13,5,8,7.780371234856063e-05,0.00011106421733046048,0.6153846153846154
8969,8969,필드/Noun,13,5,8,7.780371234856063e-05,0.00011106421733046048,0.6153846153846154
8970,8970,머랄/Noun,13,5,8,7.780371234856063e-05,0.00011106421733046048,0.6153846153846154
8971,8971,프로포즈/Noun,13,8,5,0.00011114816049794375,7.774495213132233e-05,0.6153846153846154
8972,8972,드레스/Noun,13,5,8,7.780371234856063e-05,0.00011106421733046048,0.6153846153846154
8973,8973,골고루/Adverb,13,8,5,0.00011114816049794375,7.774495213132233e-05,0.6153846153846154
8974,8974,건아/Noun,13,5,8,7.780371234856063e-05,0.00011106421733046048,0.6153846153846154
8975,8975,재목/Noun,13,5,8,7.780371234856063e-05,0.00011106421733046048,0.6153846153846154
8976,8976,난도질/Noun,13,5,8,7.780371234856063e-05,0.00011106421733046048,0.6153846153846154
8977,8977,km/Alpha,13,5,8,7.780371234856063e-05,0.00011106421733046048,0.6153846153846154
8978,8978,에이즈/Noun,13,5,8,7.780371234856063e-05,0.00011106421733046048,0.6153846153846154
8979,8979,소속/Noun,13,5,8,7.780371234856063e-05,0.00011106421733046048,0.6153846153846154
8980,8980,관찰/Noun,13,8,5,0.00011114816049794375,7.774495213132233e-05,0.6153846153846154
8981,8981,벨소리/Noun,13,5,8,7.780371234856063e-05,0.00011106421733046048,0.6153846153846154
8982,8982,전우치/Noun,13,8,5,0.00011114816049794375,7.774495213132233e-05,0.6153846153846154
8983,8983,FBI/Alpha,13,5,8,7.780371234856063e-05,0.00011106421733046048,0.6153846153846154
8984,8984,라이벌/Noun,13,8,5,0.00011114816049794375,7.774495213132233e-05,0.6153846153846154
8985,8985,방문/Noun,13,5,8,7.780371234856063e-05,0.00011106421733046048,0.6153846153846154
8986,8986,떳떳하다/Adjective,13,8,5,0.00011114816049794375,7.774495213132233e-05,0.6153846153846154
8987,8987,어느덧다/Adjective,13,8,5,0.00011114816049794375,7.774495213132233e-05,0.6153846153846154
8988,8988,브리트니/Noun,13,8,5,0.00011114816049794375,7.774495213132233e-05,0.6153846153846154
8989,8989,로망스/Noun,13,8,5,0.00011114816049794375,7.774495213132233e-05,0.6153846153846154
8990,8990,돌보다/Verb,13,8,5,0.00011114816049794375,7.774495213132233e-05,0.6153846153846154
8991,8991,아지/Noun,13,5,8,7.780371234856063e-05,0.00011106421733046048,0.6153846153846154
8992,8992,타카/Noun,13,8,5,0.00011114816049794375,7.774495213132233e-05,0.6153846153846154
8993,8993,바이/Noun,13,8,5,0.00011114816049794375,7.774495213132233e-05,0.6153846153846154
8994,8994,몇십/Modifier,13,5,8,7.780371234856063e-05,0.00011106421733046048,0.6153846153846154
8995,8995,사탕/Noun,13,5,8,7.780371234856063e-05,0.00011106421733046048,0.6153846153846154
8996,8996,무너/Noun,13,5,8,7.780371234856063e-05,0.00011106421733046048,0.6153846153846154
8997,8997,??????/Punctuation,13,5,8,7.780371234856063e-05,0.00011106421733046048,0.6153846153846154
8998,8998,참가자/Noun,13,5,8,7.780371234856063e-05,0.00011106421733046048,0.6153846153846154
8999,8999,창의력/Noun,13,5,8,7.780371234856063e-05,0.00011106421733046048,0.6153846153846154
9000,9000,산악/Noun,13,8,5,0.00011114816049794375,7.774495213132233e-05,0.6153846153846154
9001,9001,하진/Noun,13,8,5,0.00011114816049794375,7.774495213132233e-05,0.6153846153846154
9002,9002,밨는데/Noun,13,8,5,0.00011114816049794375,7.774495213132233e-05,0.6153846153846154
9003,9003,양자경/Noun,13,8,5,0.00011114816049794375,7.774495213132233e-05,0.6153846153846154
9004,9004,가만/Adverb,13,5,8,7.780371234856063e-05,0.00011106421733046048,0.6153846153846154
9005,9005,맨몸/Noun,13,8,5,0.00011114816049794375,7.774495213132233e-05,0.6153846153846154
9006,9006,오전/Noun,13,5,8,7.780371234856063e-05,0.00011106421733046048,0.6153846153846154
9007,9007,해당/Noun,13,5,8,7.780371234856063e-05,0.00011106421733046048,0.6153846153846154
9008,9008,수의/Noun,13,5,8,7.780371234856063e-05,0.00011106421733046048,0.6153846153846154
9009,9009,타이/Noun,13,8,5,0.00011114816049794375,7.774495213132233e-05,0.6153846153846154
9010,9010,박지성/Noun,13,8,5,0.00011114816049794375,7.774495213132233e-05,0.6153846153846154
9011,9011,대체로/Noun,13,5,8,7.780371234856063e-05,0.00011106421733046048,0.6153846153846154
9012,9012,ㅊ/KoreanParticle,13,8,5,0.00011114816049794375,7.774495213132233e-05,0.6153846153846154
9013,9013,차례/Noun,13,5,8,7.780371234856063e-05,0.00011106421733046048,0.6153846153846154
9014,9014,동굴/Noun,13,5,8,7.780371234856063e-05,0.00011106421733046048,0.6153846153846154
9015,9015,눈썹/Noun,13,5,8,7.780371234856063e-05,0.00011106421733046048,0.6153846153846154
9016,9016,코미/Noun,13,8,5,0.00011114816049794375,7.774495213132233e-05,0.6153846153846154
9017,9017,원주민/Noun,13,5,8,7.780371234856063e-05,0.00011106421733046048,0.6153846153846154
9018,9018,이론/Noun,13,6,7,8.891852839835501e-05,9.995779559741441e-05,0.5384615384615384
9019,9019,테니스/Noun,13,6,7,8.891852839835501e-05,9.995779559741441e-05,0.5384615384615384
9020,9020,123/Number,13,6,7,8.891852839835501e-05,9.995779559741441e-05,0.5384615384615384
9021,9021,전직/Noun,13,6,7,8.891852839835501e-05,9.995779559741441e-05,0.5384615384615384
9022,9022,박영규/Noun,13,7,6,0.0001000333444481494,8.885137386436837e-05,0.5384615384615384
9023,9023,생명체/Noun,13,6,7,8.891852839835501e-05,9.995779559741441e-05,0.5384615384615384
9024,9024,신드롬/Noun,13,6,7,8.891852839835501e-05,9.995779559741441e-05,0.5384615384615384
9025,9025,10만/Number,13,6,7,8.891852839835501e-05,9.995779559741441e-05,0.5384615384615384
9026,9026,달려오다/Verb,13,7,6,0.0001000333444481494,8.885137386436837e-05,0.5384615384615384
9027,9027,마주치다/Verb,13,6,7,8.891852839835501e-05,9.995779559741441e-05,0.5384615384615384
9028,9028,화로/Noun,13,7,6,0.0001000333444481494,8.885137386436837e-05,0.5384615384615384
9029,9029,백진희/Noun,13,7,6,0.0001000333444481494,8.885137386436837e-05,0.5384615384615384
9030,9030,단절/Noun,13,6,7,8.891852839835501e-05,9.995779559741441e-05,0.5384615384615384
9031,9031,둘러싸다/Verb,13,7,6,0.0001000333444481494,8.885137386436837e-05,0.5384615384615384
9032,9032,적히다/Verb,13,6,7,8.891852839835501e-05,9.995779559741441e-05,0.5384615384615384
9033,9033,에서/Foreign,13,6,7,8.891852839835501e-05,9.995779559741441e-05,0.5384615384615384
9034,9034,착/Noun,13,6,7,8.891852839835501e-05,9.995779559741441e-05,0.5384615384615384
9035,9035,6회/Number,13,6,7,8.891852839835501e-05,9.995779559741441e-05,0.5384615384615384
9036,9036,아하/Noun,13,7,6,0.0001000333444481494,8.885137386436837e-05,0.5384615384615384
9037,9037,복원/Noun,13,7,6,0.0001000333444481494,8.885137386436837e-05,0.5384615384615384
9038,9038,역설/Noun,13,6,7,8.891852839835501e-05,9.995779559741441e-05,0.5384615384615384
9039,9039,엑스파일/Noun,13,6,7,8.891852839835501e-05,9.995779559741441e-05,0.5384615384615384
9040,9040,어가/Noun,13,7,6,0.0001000333444481494,8.885137386436837e-05,0.5384615384615384
9041,9041,핏줄/Noun,13,6,7,8.891852839835501e-05,9.995779559741441e-05,0.5384615384615384
9042,9042,행오버/Noun,13,6,7,8.891852839835501e-05,9.995779559741441e-05,0.5384615384615384
9043,9043,쭉쭉/Noun,13,7,6,0.0001000333444481494,8.885137386436837e-05,0.5384615384615384
9044,9044,헤드/Noun,13,6,7,8.891852839835501e-05,9.995779559741441e-05,0.5384615384615384
9045,9045,섭/Noun,13,7,6,0.0001000333444481494,8.885137386436837e-05,0.5384615384615384
9046,9046,야마/Noun,13,7,6,0.0001000333444481494,8.885137386436837e-05,0.5384615384615384
9047,9047,사리/Noun,13,7,6,0.0001000333444481494,8.885137386436837e-05,0.5384615384615384
9048,9048,연결하다/Adjective,13,6,7,8.891852839835501e-05,9.995779559741441e-05,0.5384615384615384
9049,9049,답안/Noun,13,6,7,8.891852839835501e-05,9.995779559741441e-05,0.5384615384615384
9050,9050,기네스/Noun,13,6,7,8.891852839835501e-05,9.995779559741441e-05,0.5384615384615384
9051,9051,마이너/Noun,13,6,7,8.891852839835501e-05,9.995779559741441e-05,0.5384615384615384
9052,9052,쩌리/Noun,13,6,7,8.891852839835501e-05,9.995779559741441e-05,0.5384615384615384
9053,9053,이랑은/Josa,13,7,6,0.0001000333444481494,8.885137386436837e-05,0.5384615384615384
9054,9054,피나/Noun,13,7,6,0.0001000333444481494,8.885137386436837e-05,0.5384615384615384
9055,9055,미디어/Noun,13,7,6,0.0001000333444481494,8.885137386436837e-05,0.5384615384615384
9056,9056,김병만/Noun,13,7,6,0.0001000333444481494,8.885137386436837e-05,0.5384615384615384
9057,9057,우디알렌/Noun,13,7,6,0.0001000333444481494,8.885137386436837e-05,0.5384615384615384
9058,9058,잔잔/Noun,13,7,6,0.0001000333444481494,8.885137386436837e-05,0.5384615384615384
9059,9059,시기하다/Adjective,13,6,7,8.891852839835501e-05,9.995779559741441e-05,0.5384615384615384
9060,9060,스튜어트/Noun,13,7,6,0.0001000333444481494,8.885137386436837e-05,0.5384615384615384
9061,9061,도시락/Noun,13,7,6,0.0001000333444481494,8.885137386436837e-05,0.5384615384615384
9062,9062,자락/Noun,13,6,7,8.891852839835501e-05,9.995779559741441e-05,0.5384615384615384
9063,9063,방대하다/Adjective,13,7,6,0.0001000333444481494,8.885137386436837e-05,0.5384615384615384
9064,9064,의원/Noun,13,7,6,0.0001000333444481494,8.885137386436837e-05,0.5384615384615384
9065,9065,블럭버스터/Noun,13,6,7,8.891852839835501e-05,9.995779559741441e-05,0.5384615384615384
9066,9066,공무원/Noun,13,6,7,8.891852839835501e-05,9.995779559741441e-05,0.5384615384615384
9067,9067,한눈/Noun,13,6,7,8.891852839835501e-05,9.995779559741441e-05,0.5384615384615384
9068,9068,찬성/Noun,13,7,6,0.0001000333444481494,8.885137386436837e-05,0.5384615384615384
9069,9069,에라도/Josa,13,6,7,8.891852839835501e-05,9.995779559741441e-05,0.5384615384615384
9070,9070,실사판/Noun,13,6,7,8.891852839835501e-05,9.995779559741441e-05,0.5384615384615384
9071,9071,티브이/Noun,13,6,7,8.891852839835501e-05,9.995779559741441e-05,0.5384615384615384
9072,9072,김효진/Noun,13,6,7,8.891852839835501e-05,9.995779559741441e-05,0.5384615384615384
9073,9073,날뛰다/Verb,13,6,7,8.891852839835501e-05,9.995779559741441e-05,0.5384615384615384
9074,9074,·/Punctuation,13,7,6,0.0001000333444481494,8.885137386436837e-05,0.5384615384615384
9075,9075,수천/Modifier,13,7,6,0.0001000333444481494,8.885137386436837e-05,0.5384615384615384
9076,9076,프/Noun,13,6,7,8.891852839835501e-05,9.995779559741441e-05,0.5384615384615384
9077,9077,탄식/Noun,13,6,7,8.891852839835501e-05,9.995779559741441e-05,0.5384615384615384
9078,9078,미나/Noun,13,7,6,0.0001000333444481494,8.885137386436837e-05,0.5384615384615384
9079,9079,비애/Noun,13,7,6,0.0001000333444481494,8.885137386436837e-05,0.5384615384615384
9080,9080,철수/Noun,13,7,6,0.0001000333444481494,8.885137386436837e-05,0.5384615384615384
9081,9081,올림픽/Noun,13,6,7,8.891852839835501e-05,9.995779559741441e-05,0.5384615384615384
9082,9082,~~~!!/Punctuation,13,7,6,0.0001000333444481494,8.885137386436837e-05,0.5384615384615384
9083,9083,조문탁/Noun,13,7,6,0.0001000333444481494,8.885137386436837e-05,0.5384615384615384
9084,9084,노래방/Noun,13,6,7,8.891852839835501e-05,9.995779559741441e-05,0.5384615384615384
9085,9085,치이다/Verb,13,6,7,8.891852839835501e-05,9.995779559741441e-05,0.5384615384615384
9086,9086,두사부일체/Noun,13,7,6,0.0001000333444481494,8.885137386436837e-05,0.5384615384615384
9087,9087,천상/Noun,13,6,7,8.891852839835501e-05,9.995779559741441e-05,0.5384615384615384
9088,9088,엄연하다/Adjective,13,7,6,0.0001000333444481494,8.885137386436837e-05,0.5384615384615384
9089,9089,형아/Noun,13,6,7,8.891852839835501e-05,9.995779559741441e-05,0.5384615384615384
9090,9090,견/Noun,13,7,6,0.0001000333444481494,8.885137386436837e-05,0.5384615384615384
9091,9091,뤽/Noun,13,6,7,8.891852839835501e-05,9.995779559741441e-05,0.5384615384615384
9092,9092,슈나이더/Noun,13,6,7,8.891852839835501e-05,9.995779559741441e-05,0.5384615384615384
9093,9093,라이온킹/Noun,13,7,6,0.0001000333444481494,8.885137386436837e-05,0.5384615384615384
9094,9094,자극시키다/Verb,13,7,6,0.0001000333444481494,8.885137386436837e-05,0.5384615384615384
9095,9095,장보리/Noun,13,6,7,8.891852839835501e-05,9.995779559741441e-05,0.5384615384615384
9096,9096,중앙/Noun,13,7,6,0.0001000333444481494,8.885137386436837e-05,0.5384615384615384
9097,9097,담임/Noun,13,7,6,0.0001000333444481494,8.885137386436837e-05,0.5384615384615384
9098,9098,둥/Noun,13,6,7,8.891852839835501e-05,9.995779559741441e-05,0.5384615384615384
9099,9099,한나/Noun,13,7,6,0.0001000333444481494,8.885137386436837e-05,0.5384615384615384
9100,9100,동갑/Noun,13,6,7,8.891852839835501e-05,9.995779559741441e-05,0.5384615384615384
9101,9101,일등/Noun,13,7,6,0.0001000333444481494,8.885137386436837e-05,0.5384615384615384
9102,9102,이광수/Noun,13,7,6,0.0001000333444481494,8.885137386436837e-05,0.5384615384615384
9103,9103,강철중/Noun,13,7,6,0.0001000333444481494,8.885137386436837e-05,0.5384615384615384
9104,9104,이거슨/Noun,13,6,7,8.891852839835501e-05,9.995779559741441e-05,0.5384615384615384
9105,9105,보태/Noun,13,6,7,8.891852839835501e-05,9.995779559741441e-05,0.5384615384615384
9106,9106,에플렉/Noun,13,6,7,8.891852839835501e-05,9.995779559741441e-05,0.5384615384615384
9107,9107,음성/Noun,13,7,6,0.0001000333444481494,8.885137386436837e-05,0.5384615384615384
9108,9108,막내/Noun,13,7,6,0.0001000333444481494,8.885137386436837e-05,0.5384615384615384
9109,9109,심리전/Noun,13,6,7,8.891852839835501e-05,9.995779559741441e-05,0.5384615384615384
9110,9110,표면/Noun,13,6,7,8.891852839835501e-05,9.995779559741441e-05,0.5384615384615384
9111,9111,첨가/Noun,13,7,6,0.0001000333444481494,8.885137386436837e-05,0.5384615384615384
9112,9112,주유소/Noun,13,6,7,8.891852839835501e-05,9.995779559741441e-05,0.5384615384615384
9113,9113,체제/Noun,13,6,7,8.891852839835501e-05,9.995779559741441e-05,0.5384615384615384
9114,9114,달콤/Noun,12,12,0,0.00015560742469712126,2.2212843466092093e-05,1.0
9115,9115,아동학대/Noun,12,0,12,2.2229632099588756e-05,0.00015548990426264466,1.0
9116,9116,함량/Noun,12,0,12,2.2229632099588756e-05,0.00015548990426264466,1.0
9117,9117,언플/Noun,12,0,12,2.2229632099588756e-05,0.00015548990426264466,1.0
9118,9118,알몸/Noun,12,0,12,2.2229632099588756e-05,0.00015548990426264466,1.0
9119,9119,뭐/Exclamation,12,0,12,2.2229632099588756e-05,0.00015548990426264466,1.0
9120,9120,박시환/Noun,12,0,12,2.2229632099588756e-05,0.00015548990426264466,1.0
9121,9121,넘겨보다/Verb,12,0,12,2.2229632099588756e-05,0.00015548990426264466,1.0
9122,9122,예스/Noun,12,12,0,0.00015560742469712126,2.2212843466092093e-05,1.0
9123,9123,허접스럽다/Adjective,12,0,12,2.2229632099588756e-05,0.00015548990426264466,1.0
9124,9124,붙여넣기/Noun,12,0,12,2.2229632099588756e-05,0.00015548990426264466,1.0
9125,9125,횡설수설/Noun,12,0,12,2.2229632099588756e-05,0.00015548990426264466,1.0
9126,9126,故/Foreign,12,12,0,0.00015560742469712126,2.2212843466092093e-05,1.0
9127,9127,아이폰/Noun,12,0,12,2.2229632099588756e-05,0.00015548990426264466,1.0
9128,9128,게머/Noun,12,0,12,2.2229632099588756e-05,0.00015548990426264466,1.0
9129,9129,요점/Noun,12,0,12,2.2229632099588756e-05,0.00015548990426264466,1.0
9130,9130,쵝/Noun,12,12,0,0.00015560742469712126,2.2212843466092093e-05,1.0
9131,9131,정색/Noun,12,0,12,2.2229632099588756e-05,0.00015548990426264466,1.0
9132,9132,가지가지/Noun,12,0,12,2.2229632099588756e-05,0.00015548990426264466,1.0
9133,9133,화남/Noun,12,0,12,2.2229632099588756e-05,0.00015548990426264466,1.0
9134,9134,다망/Noun,12,0,12,2.2229632099588756e-05,0.00015548990426264466,1.0
9135,9135,서동요/Noun,12,11,1,0.0001444926086473269,3.331926519913814e-05,0.9166666666666666
9136,9136,에구/Exclamation,12,1,11,3.334444814938313e-05,0.0001443834825295986,0.9166666666666666
9137,9137,샬롯/Noun,12,11,1,0.0001444926086473269,3.331926519913814e-05,0.9166666666666666
9138,9138,화표/Noun,12,1,11,3.334444814938313e-05,0.0001443834825295986,0.9166666666666666
9139,9139,국물/Noun,12,1,11,3.334444814938313e-05,0.0001443834825295986,0.9166666666666666
9140,9140,겉도/Noun,12,1,11,3.334444814938313e-05,0.0001443834825295986,0.9166666666666666
9141,9141,온갖/Modifier,12,1,11,3.334444814938313e-05,0.0001443834825295986,0.9166666666666666
9142,9142,참상/Noun,12,11,1,0.0001444926086473269,3.331926519913814e-05,0.9166666666666666
9143,9143,챙/Noun,12,1,11,3.334444814938313e-05,0.0001443834825295986,0.9166666666666666
9144,9144,쉴드/Noun,12,1,11,3.334444814938313e-05,0.0001443834825295986,0.9166666666666666
9145,9145,비범하다/Adjective,12,11,1,0.0001444926086473269,3.331926519913814e-05,0.9166666666666666
9146,9146,갈비/Noun,12,1,11,3.334444814938313e-05,0.0001443834825295986,0.9166666666666666
9147,9147,~^/Punctuation,12,11,1,0.0001444926086473269,3.331926519913814e-05,0.9166666666666666
9148,9148,콩콩/Adverb,12,1,11,3.334444814938313e-05,0.0001443834825295986,0.9166666666666666
9149,9149,퇴마록/Noun,12,1,11,3.334444814938313e-05,0.0001443834825295986,0.9166666666666666
9150,9150,색안경/Noun,12,11,1,0.0001444926086473269,3.331926519913814e-05,0.9166666666666666
9151,9151,똥칠/Noun,12,1,11,3.334444814938313e-05,0.0001443834825295986,0.9166666666666666
9152,9152,장대/Noun,12,11,1,0.0001444926086473269,3.331926519913814e-05,0.9166666666666666
9153,9153,~*/Punctuation,12,11,1,0.0001444926086473269,3.331926519913814e-05,0.9166666666666666
9154,9154,My/Alpha,12,11,1,0.0001444926086473269,3.331926519913814e-05,0.9166666666666666
9155,9155,가까워지다/Verb,12,11,1,0.0001444926086473269,3.331926519913814e-05,0.9166666666666666
9156,9156,취재/Noun,12,1,11,3.334444814938313e-05,0.0001443834825295986,0.9166666666666666
9157,9157,시망/Noun,12,1,11,3.334444814938313e-05,0.0001443834825295986,0.9166666666666666
9158,9158,퉤퉤/Noun,12,1,11,3.334444814938313e-05,0.0001443834825295986,0.9166666666666666
9159,9159,유식/Noun,12,1,11,3.334444814938313e-05,0.0001443834825295986,0.9166666666666666
9160,9160,글썽/Noun,12,11,1,0.0001444926086473269,3.331926519913814e-05,0.9166666666666666
9161,9161,뻘짓/Noun,12,1,11,3.334444814938313e-05,0.0001443834825295986,0.9166666666666666
9162,9162,세도/Noun,12,1,11,3.334444814938313e-05,0.0001443834825295986,0.9166666666666666
9163,9163,초강추/Noun,12,11,1,0.0001444926086473269,3.331926519913814e-05,0.9166666666666666
9164,9164,친자/Noun,12,1,11,3.334444814938313e-05,0.0001443834825295986,0.9166666666666666
9165,9165,아이큐/Noun,12,1,11,3.334444814938313e-05,0.0001443834825295986,0.9166666666666666
9166,9166,마구잡이/Noun,12,1,11,3.334444814938313e-05,0.0001443834825295986,0.9166666666666666
9167,9167,위노나/Noun,12,11,1,0.0001444926086473269,3.331926519913814e-05,0.9166666666666666
9168,9168,개떡/Noun,12,1,11,3.334444814938313e-05,0.0001443834825295986,0.9166666666666666
9169,9169,당혹스럽다/Adjective,12,1,11,3.334444814938313e-05,0.0001443834825295986,0.9166666666666666
9170,9170,10억/Number,12,1,11,3.334444814938313e-05,0.0001443834825295986,0.9166666666666666
9171,9171,삼생이/Noun,12,1,11,3.334444814938313e-05,0.0001443834825295986,0.9166666666666666
9172,9172,뿌듯하다/Adjective,12,11,1,0.0001444926086473269,3.331926519913814e-05,0.9166666666666666
9173,9173,얼척/Noun,12,1,11,3.334444814938313e-05,0.0001443834825295986,0.9166666666666666
9174,9174,어정쩡/Adverb,12,1,11,3.334444814938313e-05,0.0001443834825295986,0.9166666666666666
9175,9175,미녀삼총사/Noun,12,1,11,3.334444814938313e-05,0.0001443834825295986,0.9166666666666666
9176,9176,봣네/Noun,12,11,1,0.0001444926086473269,3.331926519913814e-05,0.9166666666666666
9177,9177,11시/Number,12,11,1,0.0001444926086473269,3.331926519913814e-05,0.9166666666666666
9178,9178,눈꼽/Noun,12,1,11,3.334444814938313e-05,0.0001443834825295986,0.9166666666666666
9179,9179,화병/Noun,12,2,10,4.445926419917751e-05,0.00013327706079655256,0.8333333333333334
9180,9180,법적/Noun,12,2,10,4.445926419917751e-05,0.00013327706079655256,0.8333333333333334
9181,9181,캡/Noun,12,10,2,0.0001333777925975325,4.4425686932184186e-05,0.8333333333333334
9182,9182,",,,,,,/Punctuation",12,2,10,4.445926419917751e-05,0.00013327706079655256,0.8333333333333334
9183,9183,재일교포/Noun,12,10,2,0.0001333777925975325,4.4425686932184186e-05,0.8333333333333334
9184,9184,소속사/Noun,12,2,10,4.445926419917751e-05,0.00013327706079655256,0.8333333333333334
9185,9185,중단/Noun,12,2,10,4.445926419917751e-05,0.00013327706079655256,0.8333333333333334
9186,9186,손목/Noun,12,2,10,4.445926419917751e-05,0.00013327706079655256,0.8333333333333334
9187,9187,무인/Noun,12,10,2,0.0001333777925975325,4.4425686932184186e-05,0.8333333333333334
9188,9188,불사조/Noun,12,2,10,4.445926419917751e-05,0.00013327706079655256,0.8333333333333334
9189,9189,고소하다/Adjective,12,2,10,4.445926419917751e-05,0.00013327706079655256,0.8333333333333334
9190,9190,비긴즈/Noun,12,10,2,0.0001333777925975325,4.4425686932184186e-05,0.8333333333333334
9191,9191,직시/Noun,12,10,2,0.0001333777925975325,4.4425686932184186e-05,0.8333333333333334
9192,9192,84년/Number,12,10,2,0.0001333777925975325,4.4425686932184186e-05,0.8333333333333334
9193,9193,메르스/Noun,12,10,2,0.0001333777925975325,4.4425686932184186e-05,0.8333333333333334
9194,9194,르네젤위거/Noun,12,10,2,0.0001333777925975325,4.4425686932184186e-05,0.8333333333333334
9195,9195,후벼파다/Verb,12,10,2,0.0001333777925975325,4.4425686932184186e-05,0.8333333333333334
9196,9196,징기스칸/Noun,12,2,10,4.445926419917751e-05,0.00013327706079655256,0.8333333333333334
9197,9197,급작/Noun,12,2,10,4.445926419917751e-05,0.00013327706079655256,0.8333333333333334
9198,9198,김동완/Noun,12,10,2,0.0001333777925975325,4.4425686932184186e-05,0.8333333333333334
9199,9199,린지/Noun,12,2,10,4.445926419917751e-05,0.00013327706079655256,0.8333333333333334
9200,9200,애뜻/Noun,12,10,2,0.0001333777925975325,4.4425686932184186e-05,0.8333333333333334
9201,9201,라푼젤/Noun,12,10,2,0.0001333777925975325,4.4425686932184186e-05,0.8333333333333334
9202,9202,내적/Noun,12,10,2,0.0001333777925975325,4.4425686932184186e-05,0.8333333333333334
9203,9203,어후/Noun,12,2,10,4.445926419917751e-05,0.00013327706079655256,0.8333333333333334
9204,9204,아키/Noun,12,10,2,0.0001333777925975325,4.4425686932184186e-05,0.8333333333333334
9205,9205,마부/Noun,12,10,2,0.0001333777925975325,4.4425686932184186e-05,0.8333333333333334
9206,9206,스푼/Noun,12,2,10,4.445926419917751e-05,0.00013327706079655256,0.8333333333333334
9207,9207,정치가/Noun,12,10,2,0.0001333777925975325,4.4425686932184186e-05,0.8333333333333334
9208,9208,음슴다/Verb,12,2,10,4.445926419917751e-05,0.00013327706079655256,0.8333333333333334
9209,9209,훗/Noun,12,10,2,0.0001333777925975325,4.4425686932184186e-05,0.8333333333333334
9210,9210,더러/Josa,12,2,10,4.445926419917751e-05,0.00013327706079655256,0.8333333333333334
9211,9211,골빈/Noun,12,2,10,4.445926419917751e-05,0.00013327706079655256,0.8333333333333334
9212,9212,~~~!/Punctuation,12,10,2,0.0001333777925975325,4.4425686932184186e-05,0.8333333333333334
9213,9213,기질/Noun,12,2,10,4.445926419917751e-05,0.00013327706079655256,0.8333333333333334
9214,9214,들뜨다/Adjective,12,10,2,0.0001333777925975325,4.4425686932184186e-05,0.8333333333333334
9215,9215,최시원/Noun,12,2,10,4.445926419917751e-05,0.00013327706079655256,0.8333333333333334
9216,9216,부하/Noun,12,2,10,4.445926419917751e-05,0.00013327706079655256,0.8333333333333334
9217,9217,허리/Noun,12,2,10,4.445926419917751e-05,0.00013327706079655256,0.8333333333333334
9218,9218,인과/Noun,12,2,10,4.445926419917751e-05,0.00013327706079655256,0.8333333333333334
9219,9219,수채화/Noun,12,10,2,0.0001333777925975325,4.4425686932184186e-05,0.8333333333333334
9220,9220,팬더/Noun,12,2,10,4.445926419917751e-05,0.00013327706079655256,0.8333333333333334
9221,9221,본래/Noun,12,2,10,4.445926419917751e-05,0.00013327706079655256,0.8333333333333334
9222,9222,해답/Noun,12,10,2,0.0001333777925975325,4.4425686932184186e-05,0.8333333333333334
9223,9223,제자리/Noun,12,2,10,4.445926419917751e-05,0.00013327706079655256,0.8333333333333334
9224,9224,테드/Noun,12,10,2,0.0001333777925975325,4.4425686932184186e-05,0.8333333333333334
9225,9225,신물/Noun,12,2,10,4.445926419917751e-05,0.00013327706079655256,0.8333333333333334
9226,9226,볼빠/Noun,12,2,10,4.445926419917751e-05,0.00013327706079655256,0.8333333333333334
9227,9227,역행/Noun,12,2,10,4.445926419917751e-05,0.00013327706079655256,0.8333333333333334
9228,9228,당초/Noun,12,2,10,4.445926419917751e-05,0.00013327706079655256,0.8333333333333334
9229,9229,고요하다/Adjective,12,10,2,0.0001333777925975325,4.4425686932184186e-05,0.8333333333333334
9230,9230,킥/Noun,12,2,10,4.445926419917751e-05,0.00013327706079655256,0.8333333333333334
9231,9231,제이크/Noun,12,10,2,0.0001333777925975325,4.4425686932184186e-05,0.8333333333333334
9232,9232,연달/Noun,12,10,2,0.0001333777925975325,4.4425686932184186e-05,0.8333333333333334
9233,9233,강박증/Noun,12,9,3,0.00012226297654773814,5.553210866523024e-05,0.75
9234,9234,연재/Noun,12,9,3,0.00012226297654773814,5.553210866523024e-05,0.75
9235,9235,대로의/Josa,12,9,3,0.00012226297654773814,5.553210866523024e-05,0.75
9236,9236,암담하다/Adjective,12,3,9,5.5574080248971876e-05,0.00012217063906350652,0.75
9237,9237,왓으/Noun,12,9,3,0.00012226297654773814,5.553210866523024e-05,0.75
9238,9238,가상/Noun,12,9,3,0.00012226297654773814,5.553210866523024e-05,0.75
9239,9239,So/Alpha,12,9,3,0.00012226297654773814,5.553210866523024e-05,0.75
9240,9240,이래저래/Adverb,12,3,9,5.5574080248971876e-05,0.00012217063906350652,0.75
9241,9241,순전하다/Adjective,12,3,9,5.5574080248971876e-05,0.00012217063906350652,0.75
9242,9242,라이어/Noun,12,3,9,5.5574080248971876e-05,0.00012217063906350652,0.75
9243,9243,배치/Noun,12,9,3,0.00012226297654773814,5.553210866523024e-05,0.75
9244,9244,축소/Noun,12,9,3,0.00012226297654773814,5.553210866523024e-05,0.75
9245,9245,다듬어지다/Verb,12,9,3,0.00012226297654773814,5.553210866523024e-05,0.75
9246,9246,내년/Noun,12,9,3,0.00012226297654773814,5.553210866523024e-05,0.75
9247,9247,윌리암스/Noun,12,9,3,0.00012226297654773814,5.553210866523024e-05,0.75
9248,9248,해명/Noun,12,3,9,5.5574080248971876e-05,0.00012217063906350652,0.75
9249,9249,연연하다/Adjective,12,9,3,0.00012226297654773814,5.553210866523024e-05,0.75
9250,9250,정심/Noun,12,3,9,5.5574080248971876e-05,0.00012217063906350652,0.75
9251,9251,엘리자베스/Noun,12,9,3,0.00012226297654773814,5.553210866523024e-05,0.75
9252,9252,홍어/Noun,12,3,9,5.5574080248971876e-05,0.00012217063906350652,0.75
9253,9253,무법자/Noun,12,9,3,0.00012226297654773814,5.553210866523024e-05,0.75
9254,9254,여름방학/Noun,12,9,3,0.00012226297654773814,5.553210866523024e-05,0.75
9255,9255,사냥꾼/Noun,12,3,9,5.5574080248971876e-05,0.00012217063906350652,0.75
9256,9256,쇼핑/Noun,12,3,9,5.5574080248971876e-05,0.00012217063906350652,0.75
9257,9257,사무/Noun,12,3,9,5.5574080248971876e-05,0.00012217063906350652,0.75
9258,9258,깽/Noun,12,3,9,5.5574080248971876e-05,0.00012217063906350652,0.75
9259,9259,애물/Noun,12,3,9,5.5574080248971876e-05,0.00012217063906350652,0.75
9260,9260,헬드/Noun,12,3,9,5.5574080248971876e-05,0.00012217063906350652,0.75
9261,9261,쩌네/Noun,12,9,3,0.00012226297654773814,5.553210866523024e-05,0.75
9262,9262,고대로/Noun,12,3,9,5.5574080248971876e-05,0.00012217063906350652,0.75
9263,9263,덤앤더머/Noun,12,9,3,0.00012226297654773814,5.553210866523024e-05,0.75
9264,9264,호들갑/Noun,12,3,9,5.5574080248971876e-05,0.00012217063906350652,0.75
9265,9265,포토/Noun,12,3,9,5.5574080248971876e-05,0.00012217063906350652,0.75
9266,9266,격투기/Noun,12,3,9,5.5574080248971876e-05,0.00012217063906350652,0.75
9267,9267,서편제/Noun,12,9,3,0.00012226297654773814,5.553210866523024e-05,0.75
9268,9268,부질없다/Adjective,12,3,9,5.5574080248971876e-05,0.00012217063906350652,0.75
9269,9269,100회/Number,12,3,9,5.5574080248971876e-05,0.00012217063906350652,0.75
9270,9270,야경/Noun,12,3,9,5.5574080248971876e-05,0.00012217063906350652,0.75
9271,9271,고만/Modifier,12,3,9,5.5574080248971876e-05,0.00012217063906350652,0.75
9272,9272,",..../Punctuation",12,3,9,5.5574080248971876e-05,0.00012217063906350652,0.75
9273,9273,전역/Noun,12,9,3,0.00012226297654773814,5.553210866523024e-05,0.75
9274,9274,분도/Noun,12,9,3,0.00012226297654773814,5.553210866523024e-05,0.75
9275,9275,아대/Noun,12,3,9,5.5574080248971876e-05,0.00012217063906350652,0.75
9276,9276,즐감/Noun,12,9,3,0.00012226297654773814,5.553210866523024e-05,0.75
9277,9277,김소현/Noun,12,9,3,0.00012226297654773814,5.553210866523024e-05,0.75
9278,9278,아따맘마/Noun,12,9,3,0.00012226297654773814,5.553210866523024e-05,0.75
9279,9279,고장/Noun,12,3,9,5.5574080248971876e-05,0.00012217063906350652,0.75
9280,9280,차기/Noun,12,9,3,0.00012226297654773814,5.553210866523024e-05,0.75
9281,9281,김범/Noun,12,3,9,5.5574080248971876e-05,0.00012217063906350652,0.75
9282,9282,찰나/Noun,12,9,3,0.00012226297654773814,5.553210866523024e-05,0.75
9283,9283,부러지다/Verb,12,3,9,5.5574080248971876e-05,0.00012217063906350652,0.75
9284,9284,찰리채플린/Noun,12,9,3,0.00012226297654773814,5.553210866523024e-05,0.75
9285,9285,나락/Noun,12,3,9,5.5574080248971876e-05,0.00012217063906350652,0.75
9286,9286,로스/Noun,12,9,3,0.00012226297654773814,5.553210866523024e-05,0.75
9287,9287,풍운/Noun,12,3,9,5.5574080248971876e-05,0.00012217063906350652,0.75
9288,9288,일종/Noun,12,3,9,5.5574080248971876e-05,0.00012217063906350652,0.75
9289,9289,저딴/Modifier,12,3,9,5.5574080248971876e-05,0.00012217063906350652,0.75
9290,9290,생기지/Noun,12,3,9,5.5574080248971876e-05,0.00012217063906350652,0.75
9291,9291,~~~!!!/Punctuation,12,9,3,0.00012226297654773814,5.553210866523024e-05,0.75
9292,9292,크리스천/Noun,12,9,3,0.00012226297654773814,5.553210866523024e-05,0.75
9293,9293,10초/Number,12,3,9,5.5574080248971876e-05,0.00012217063906350652,0.75
9294,9294,스킬/Noun,12,3,9,5.5574080248971876e-05,0.00012217063906350652,0.75
9295,9295,노노/Noun,12,3,9,5.5574080248971876e-05,0.00012217063906350652,0.75
9296,9296,에프/Noun,12,9,3,0.00012226297654773814,5.553210866523024e-05,0.75
9297,9297,조보아/Noun,12,9,3,0.00012226297654773814,5.553210866523024e-05,0.75
9298,9298,교실/Noun,12,9,3,0.00012226297654773814,5.553210866523024e-05,0.75
9299,9299,만회/Noun,12,3,9,5.5574080248971876e-05,0.00012217063906350652,0.75
9300,9300,구먼/Noun,12,3,9,5.5574080248971876e-05,0.00012217063906350652,0.75
9301,9301,서막/Noun,12,9,3,0.00012226297654773814,5.553210866523024e-05,0.75
9302,9302,선진국/Noun,12,9,3,0.00012226297654773814,5.553210866523024e-05,0.75
9303,9303,전의/Foreign,12,9,3,0.00012226297654773814,5.553210866523024e-05,0.75
9304,9304,올린다/Noun,12,9,3,0.00012226297654773814,5.553210866523024e-05,0.75
9305,9305,천만다행/Noun,12,3,9,5.5574080248971876e-05,0.00012217063906350652,0.75
9306,9306,오연서/Noun,12,9,3,0.00012226297654773814,5.553210866523024e-05,0.75
9307,9307,입문/Noun,12,9,3,0.00012226297654773814,5.553210866523024e-05,0.75
9308,9308,가죽/Noun,12,3,9,5.5574080248971876e-05,0.00012217063906350652,0.75
9309,9309,인제/Noun,12,3,9,5.5574080248971876e-05,0.00012217063906350652,0.75
9310,9310,류현경/Noun,12,9,3,0.00012226297654773814,5.553210866523024e-05,0.75
9311,9311,4시간/Number,12,9,3,0.00012226297654773814,5.553210866523024e-05,0.75
9312,9312,논스톱/Noun,12,9,3,0.00012226297654773814,5.553210866523024e-05,0.75
9313,9313,작일/Noun,12,3,9,5.5574080248971876e-05,0.00012217063906350652,0.75
9314,9314,007시/Number,12,9,3,0.00012226297654773814,5.553210866523024e-05,0.75
9315,9315,전태일/Noun,12,9,3,0.00012226297654773814,5.553210866523024e-05,0.75
9316,9316,원수/Noun,12,3,9,5.5574080248971876e-05,0.00012217063906350652,0.75
9317,9317,눈동자/Noun,12,9,3,0.00012226297654773814,5.553210866523024e-05,0.75
9318,9318,심취/Noun,12,8,4,0.00011114816049794375,6.663853039827628e-05,0.6666666666666666
9319,9319,리플리/Noun,12,8,4,0.00011114816049794375,6.663853039827628e-05,0.6666666666666666
9320,9320,안내상/Noun,12,4,8,6.668889629876625e-05,0.00011106421733046048,0.6666666666666666
9321,9321,글로리아/Noun,12,8,4,0.00011114816049794375,6.663853039827628e-05,0.6666666666666666
9322,9322,만으론/Josa,12,4,8,6.668889629876625e-05,0.00011106421733046048,0.6666666666666666
9323,9323,사적/Noun,12,8,4,0.00011114816049794375,6.663853039827628e-05,0.6666666666666666
9324,9324,격인/Noun,12,4,8,6.668889629876625e-05,0.00011106421733046048,0.6666666666666666
9325,9325,입증/Noun,12,4,8,6.668889629876625e-05,0.00011106421733046048,0.6666666666666666
9326,9326,케인/Noun,12,8,4,0.00011114816049794375,6.663853039827628e-05,0.6666666666666666
9327,9327,시크릿/Noun,12,8,4,0.00011114816049794375,6.663853039827628e-05,0.6666666666666666
9328,9328,미라/Noun,12,4,8,6.668889629876625e-05,0.00011106421733046048,0.6666666666666666
9329,9329,퍼레이드/Noun,12,4,8,6.668889629876625e-05,0.00011106421733046048,0.6666666666666666
9330,9330,아이콘/Noun,12,4,8,6.668889629876625e-05,0.00011106421733046048,0.6666666666666666
9331,9331,처럼/Foreign,12,4,8,6.668889629876625e-05,0.00011106421733046048,0.6666666666666666
9332,9332,필자/Noun,12,4,8,6.668889629876625e-05,0.00011106421733046048,0.6666666666666666
9333,9333,우결/Noun,12,4,8,6.668889629876625e-05,0.00011106421733046048,0.6666666666666666
9334,9334,어떨/Modifier,12,8,4,0.00011114816049794375,6.663853039827628e-05,0.6666666666666666
9335,9335,아마존/Noun,12,8,4,0.00011114816049794375,6.663853039827628e-05,0.6666666666666666
9336,9336,다다르다/Verb,12,8,4,0.00011114816049794375,6.663853039827628e-05,0.6666666666666666
9337,9337,갖은/Noun,12,4,8,6.668889629876625e-05,0.00011106421733046048,0.6666666666666666
9338,9338,전생/Noun,12,8,4,0.00011114816049794375,6.663853039827628e-05,0.6666666666666666
9339,9339,모차르트/Noun,12,8,4,0.00011114816049794375,6.663853039827628e-05,0.6666666666666666
9340,9340,밀러/Noun,12,8,4,0.00011114816049794375,6.663853039827628e-05,0.6666666666666666
9341,9341,병헌/Noun,12,8,4,0.00011114816049794375,6.663853039827628e-05,0.6666666666666666
9342,9342,미란다/Noun,12,8,4,0.00011114816049794375,6.663853039827628e-05,0.6666666666666666
9343,9343,무지개/Noun,12,8,4,0.00011114816049794375,6.663853039827628e-05,0.6666666666666666
9344,9344,곤충/Noun,12,8,4,0.00011114816049794375,6.663853039827628e-05,0.6666666666666666
9345,9345,부패/Noun,12,8,4,0.00011114816049794375,6.663853039827628e-05,0.6666666666666666
9346,9346,대를/Foreign,12,8,4,0.00011114816049794375,6.663853039827628e-05,0.6666666666666666
9347,9347,진영/Noun,12,8,4,0.00011114816049794375,6.663853039827628e-05,0.6666666666666666
9348,9348,못난이/Noun,12,8,4,0.00011114816049794375,6.663853039827628e-05,0.6666666666666666
9349,9349,앤디/Noun,12,8,4,0.00011114816049794375,6.663853039827628e-05,0.6666666666666666
9350,9350,설원/Noun,12,8,4,0.00011114816049794375,6.663853039827628e-05,0.6666666666666666
9351,9351,뒷맛/Noun,12,4,8,6.668889629876625e-05,0.00011106421733046048,0.6666666666666666
9352,9352,맘껏/Noun,12,8,4,0.00011114816049794375,6.663853039827628e-05,0.6666666666666666
9353,9353,리틀/Noun,12,8,4,0.00011114816049794375,6.663853039827628e-05,0.6666666666666666
9354,9354,할로윈/Noun,12,4,8,6.668889629876625e-05,0.00011106421733046048,0.6666666666666666
9355,9355,여장/Noun,12,4,8,6.668889629876625e-05,0.00011106421733046048,0.6666666666666666
9356,9356,너머/Noun,12,8,4,0.00011114816049794375,6.663853039827628e-05,0.6666666666666666
9357,9357,되다/Adjective,12,4,8,6.668889629876625e-05,0.00011106421733046048,0.6666666666666666
9358,9358,우리엄마/Noun,12,8,4,0.00011114816049794375,6.663853039827628e-05,0.6666666666666666
9359,9359,임원희/Noun,12,4,8,6.668889629876625e-05,0.00011106421733046048,0.6666666666666666
9360,9360,흥얼거리다/Verb,12,8,4,0.00011114816049794375,6.663853039827628e-05,0.6666666666666666
9361,9361,자이언트/Noun,12,8,4,0.00011114816049794375,6.663853039827628e-05,0.6666666666666666
9362,9362,ㄱㄱㄱ/KoreanParticle,12,4,8,6.668889629876625e-05,0.00011106421733046048,0.6666666666666666
9363,9363,박근혜/Noun,12,8,4,0.00011114816049794375,6.663853039827628e-05,0.6666666666666666
9364,9364,버러지/Noun,12,4,8,6.668889629876625e-05,0.00011106421733046048,0.6666666666666666
9365,9365,특이/Noun,12,8,4,0.00011114816049794375,6.663853039827628e-05,0.6666666666666666
9366,9366,부서지다/Verb,12,4,8,6.668889629876625e-05,0.00011106421733046048,0.6666666666666666
9367,9367,우스/Noun,12,4,8,6.668889629876625e-05,0.00011106421733046048,0.6666666666666666
9368,9368,컬트영화/Noun,12,8,4,0.00011114816049794375,6.663853039827628e-05,0.6666666666666666
9369,9369,대견하다/Adjective,12,4,8,6.668889629876625e-05,0.00011106421733046048,0.6666666666666666
9370,9370,조의/Noun,12,8,4,0.00011114816049794375,6.663853039827628e-05,0.6666666666666666
9371,9371,파란/Noun,12,8,4,0.00011114816049794375,6.663853039827628e-05,0.6666666666666666
9372,9372,닐슨/Noun,12,8,4,0.00011114816049794375,6.663853039827628e-05,0.6666666666666666
9373,9373,인조/Noun,12,4,8,6.668889629876625e-05,0.00011106421733046048,0.6666666666666666
9374,9374,렌스/Noun,12,8,4,0.00011114816049794375,6.663853039827628e-05,0.6666666666666666
9375,9375,넬/Noun,12,8,4,0.00011114816049794375,6.663853039827628e-05,0.6666666666666666
9376,9376,모하/Noun,12,4,8,6.668889629876625e-05,0.00011106421733046048,0.6666666666666666
9377,9377,과장하다/Adjective,12,4,8,6.668889629876625e-05,0.00011106421733046048,0.6666666666666666
9378,9378,재결합/Noun,12,4,8,6.668889629876625e-05,0.00011106421733046048,0.6666666666666666
9379,9379,셜록/Noun,12,8,4,0.00011114816049794375,6.663853039827628e-05,0.6666666666666666
9380,9380,잡혀가다/Verb,12,4,8,6.668889629876625e-05,0.00011106421733046048,0.6666666666666666
9381,9381,각도/Noun,12,4,8,6.668889629876625e-05,0.00011106421733046048,0.6666666666666666
9382,9382,티아라/Noun,12,4,8,6.668889629876625e-05,0.00011106421733046048,0.6666666666666666
9383,9383,행성/Noun,12,4,8,6.668889629876625e-05,0.00011106421733046048,0.6666666666666666
9384,9384,런던/Noun,12,8,4,0.00011114816049794375,6.663853039827628e-05,0.6666666666666666
9385,9385,미노/Noun,12,4,8,6.668889629876625e-05,0.00011106421733046048,0.6666666666666666
9386,9386,미켈슨/Noun,12,8,4,0.00011114816049794375,6.663853039827628e-05,0.6666666666666666
9387,9387,사로잡히다/Verb,12,4,8,6.668889629876625e-05,0.00011106421733046048,0.6666666666666666
9388,9388,도자기/Noun,12,4,8,6.668889629876625e-05,0.00011106421733046048,0.6666666666666666
9389,9389,기와/Noun,12,8,4,0.00011114816049794375,6.663853039827628e-05,0.6666666666666666
9390,9390,홀리/Noun,12,4,8,6.668889629876625e-05,0.00011106421733046048,0.6666666666666666
9391,9391,솟다/Verb,12,8,4,0.00011114816049794375,6.663853039827628e-05,0.6666666666666666
9392,9392,일말/Noun,12,4,8,6.668889629876625e-05,0.00011106421733046048,0.6666666666666666
9393,9393,일부분/Noun,12,8,4,0.00011114816049794375,6.663853039827628e-05,0.6666666666666666
9394,9394,간호사/Noun,12,8,4,0.00011114816049794375,6.663853039827628e-05,0.6666666666666666
9395,9395,사촌동생/Noun,12,4,8,6.668889629876625e-05,0.00011106421733046048,0.6666666666666666
9396,9396,히히히/Noun,12,4,8,6.668889629876625e-05,0.00011106421733046048,0.6666666666666666
9397,9397,드뎌/Noun,12,8,4,0.00011114816049794375,6.663853039827628e-05,0.6666666666666666
9398,9398,문장/Noun,12,4,8,6.668889629876625e-05,0.00011106421733046048,0.6666666666666666
9399,9399,한껏/Adverb,12,8,4,0.00011114816049794375,6.663853039827628e-05,0.6666666666666666
9400,9400,33/Number,12,4,8,6.668889629876625e-05,0.00011106421733046048,0.6666666666666666
9401,9401,이주승/Noun,12,8,4,0.00011114816049794375,6.663853039827628e-05,0.6666666666666666
9402,9402,전병/Noun,12,4,8,6.668889629876625e-05,0.00011106421733046048,0.6666666666666666
9403,9403,스텔론/Noun,12,8,4,0.00011114816049794375,6.663853039827628e-05,0.6666666666666666
9404,9404,나리/Noun,12,4,8,6.668889629876625e-05,0.00011106421733046048,0.6666666666666666
9405,9405,종료/Noun,12,4,8,6.668889629876625e-05,0.00011106421733046048,0.6666666666666666
9406,9406,소나기/Noun,12,8,4,0.00011114816049794375,6.663853039827628e-05,0.6666666666666666
9407,9407,명과/Noun,12,8,4,0.00011114816049794375,6.663853039827628e-05,0.6666666666666666
9408,9408,기함/Noun,12,4,8,6.668889629876625e-05,0.00011106421733046048,0.6666666666666666
9409,9409,가세/Noun,12,4,8,6.668889629876625e-05,0.00011106421733046048,0.6666666666666666
9410,9410,다이아몬드/Noun,12,8,4,0.00011114816049794375,6.663853039827628e-05,0.6666666666666666
9411,9411,양쪽/Noun,12,4,8,6.668889629876625e-05,0.00011106421733046048,0.6666666666666666
9412,9412,히데/Noun,12,4,8,6.668889629876625e-05,0.00011106421733046048,0.6666666666666666
9413,9413,남궁민/Noun,12,8,4,0.00011114816049794375,6.663853039827628e-05,0.6666666666666666
9414,9414,김지영/Noun,12,4,8,6.668889629876625e-05,0.00011106421733046048,0.6666666666666666
9415,9415,주더/Noun,12,4,8,6.668889629876625e-05,0.00011106421733046048,0.6666666666666666
9416,9416,팔레스타인/Noun,12,8,4,0.00011114816049794375,6.663853039827628e-05,0.6666666666666666
9417,9417,필연/Noun,12,8,4,0.00011114816049794375,6.663853039827628e-05,0.6666666666666666
9418,9418,순풍/Noun,12,8,4,0.00011114816049794375,6.663853039827628e-05,0.6666666666666666
9419,9419,이중성/Noun,12,4,8,6.668889629876625e-05,0.00011106421733046048,0.6666666666666666
9420,9420,강박/Noun,12,4,8,6.668889629876625e-05,0.00011106421733046048,0.6666666666666666
9421,9421,트리오/Noun,12,8,4,0.00011114816049794375,6.663853039827628e-05,0.6666666666666666
9422,9422,엠버/Noun,12,4,8,6.668889629876625e-05,0.00011106421733046048,0.6666666666666666
9423,9423,유독/Noun,12,4,8,6.668889629876625e-05,0.00011106421733046048,0.6666666666666666
9424,9424,색즉시공/Noun,12,4,8,6.668889629876625e-05,0.00011106421733046048,0.6666666666666666
9425,9425,보트/Noun,12,7,5,0.0001000333444481494,7.774495213132233e-05,0.5833333333333334
9426,9426,하고만/Josa,12,7,5,0.0001000333444481494,7.774495213132233e-05,0.5833333333333334
9427,9427,즌/Noun,12,5,7,7.780371234856063e-05,9.995779559741441e-05,0.5833333333333334
9428,9428,출산/Noun,12,5,7,7.780371234856063e-05,9.995779559741441e-05,0.5833333333333334
9429,9429,영화상/Noun,12,5,7,7.780371234856063e-05,9.995779559741441e-05,0.5833333333333334
9430,9430,애슐리/Noun,12,5,7,7.780371234856063e-05,9.995779559741441e-05,0.5833333333333334
9431,9431,격투씬/Noun,12,5,7,7.780371234856063e-05,9.995779559741441e-05,0.5833333333333334
9432,9432,7시/Number,12,5,7,7.780371234856063e-05,9.995779559741441e-05,0.5833333333333334
9433,9433,미니시리즈/Noun,12,7,5,0.0001000333444481494,7.774495213132233e-05,0.5833333333333334
9434,9434,꽂다/Verb,12,5,7,7.780371234856063e-05,9.995779559741441e-05,0.5833333333333334
9435,9435,VS/Alpha,12,7,5,0.0001000333444481494,7.774495213132233e-05,0.5833333333333334
9436,9436,박지윤/Noun,12,5,7,7.780371234856063e-05,9.995779559741441e-05,0.5833333333333334
9437,9437,현지/Noun,12,5,7,7.780371234856063e-05,9.995779559741441e-05,0.5833333333333334
9438,9438,매너/Noun,12,7,5,0.0001000333444481494,7.774495213132233e-05,0.5833333333333334
9439,9439,do/Alpha,12,7,5,0.0001000333444481494,7.774495213132233e-05,0.5833333333333334
9440,9440,뷰티/Noun,12,7,5,0.0001000333444481494,7.774495213132233e-05,0.5833333333333334
9441,9441,토대/Noun,12,7,5,0.0001000333444481494,7.774495213132233e-05,0.5833333333333334
9442,9442,쇼생/Noun,12,7,5,0.0001000333444481494,7.774495213132233e-05,0.5833333333333334
9443,9443,어리숙하다/Adjective,12,5,7,7.780371234856063e-05,9.995779559741441e-05,0.5833333333333334
9444,9444,손자/Noun,12,7,5,0.0001000333444481494,7.774495213132233e-05,0.5833333333333334
9445,9445,이편/Noun,12,7,5,0.0001000333444481494,7.774495213132233e-05,0.5833333333333334
9446,9446,살벌하다/Adjective,12,7,5,0.0001000333444481494,7.774495213132233e-05,0.5833333333333334
9447,9447,박선영/Noun,12,7,5,0.0001000333444481494,7.774495213132233e-05,0.5833333333333334
9448,9448,몰두하다/Adjective,12,7,5,0.0001000333444481494,7.774495213132233e-05,0.5833333333333334
9449,9449,난왜/Noun,12,5,7,7.780371234856063e-05,9.995779559741441e-05,0.5833333333333334
9450,9450,잭블랙/Noun,12,7,5,0.0001000333444481494,7.774495213132233e-05,0.5833333333333334
9451,9451,목욕/Noun,12,5,7,7.780371234856063e-05,9.995779559741441e-05,0.5833333333333334
9452,9452,환호/Noun,12,7,5,0.0001000333444481494,7.774495213132233e-05,0.5833333333333334
9453,9453,타협/Noun,12,7,5,0.0001000333444481494,7.774495213132233e-05,0.5833333333333334
9454,9454,막바지/Noun,12,5,7,7.780371234856063e-05,9.995779559741441e-05,0.5833333333333334
9455,9455,지우/Noun,12,5,7,7.780371234856063e-05,9.995779559741441e-05,0.5833333333333334
9456,9456,넓히다/Verb,12,7,5,0.0001000333444481494,7.774495213132233e-05,0.5833333333333334
9457,9457,정자/Noun,12,5,7,7.780371234856063e-05,9.995779559741441e-05,0.5833333333333334
9458,9458,무상/Noun,12,7,5,0.0001000333444481494,7.774495213132233e-05,0.5833333333333334
9459,9459,이레/Noun,12,7,5,0.0001000333444481494,7.774495213132233e-05,0.5833333333333334
9460,9460,빠뜨리다/Verb,12,5,7,7.780371234856063e-05,9.995779559741441e-05,0.5833333333333334
9461,9461,삐뚤어지다/Verb,12,5,7,7.780371234856063e-05,9.995779559741441e-05,0.5833333333333334
9462,9462,술집/Noun,12,5,7,7.780371234856063e-05,9.995779559741441e-05,0.5833333333333334
9463,9463,한가득/Adverb,12,7,5,0.0001000333444481494,7.774495213132233e-05,0.5833333333333334
9464,9464,얌/Noun,12,5,7,7.780371234856063e-05,9.995779559741441e-05,0.5833333333333334
9465,9465,아이스/Noun,12,5,7,7.780371234856063e-05,9.995779559741441e-05,0.5833333333333334
9466,9466,개정/Noun,12,5,7,7.780371234856063e-05,9.995779559741441e-05,0.5833333333333334
9467,9467,기이하다/Adjective,12,5,7,7.780371234856063e-05,9.995779559741441e-05,0.5833333333333334
9468,9468,구출/Noun,12,7,5,0.0001000333444481494,7.774495213132233e-05,0.5833333333333334
9469,9469,구상/Noun,12,5,7,7.780371234856063e-05,9.995779559741441e-05,0.5833333333333334
9470,9470,돌연변이/Noun,12,5,7,7.780371234856063e-05,9.995779559741441e-05,0.5833333333333334
9471,9471,제프/Noun,12,7,5,0.0001000333444481494,7.774495213132233e-05,0.5833333333333334
9472,9472,소드/Noun,12,5,7,7.780371234856063e-05,9.995779559741441e-05,0.5833333333333334
9473,9473,일보/Noun,12,5,7,7.780371234856063e-05,9.995779559741441e-05,0.5833333333333334
9474,9474,휩쓸다/Adjective,12,7,5,0.0001000333444481494,7.774495213132233e-05,0.5833333333333334
9475,9475,공공/Modifier,12,7,5,0.0001000333444481494,7.774495213132233e-05,0.5833333333333334
9476,9476,어그/Noun,12,5,7,7.780371234856063e-05,9.995779559741441e-05,0.5833333333333334
9477,9477,왈츠/Noun,12,7,5,0.0001000333444481494,7.774495213132233e-05,0.5833333333333334
9478,9478,롤/Noun,12,5,7,7.780371234856063e-05,9.995779559741441e-05,0.5833333333333334
9479,9479,렷/Noun,12,5,7,7.780371234856063e-05,9.995779559741441e-05,0.5833333333333334
9480,9480,글래디에이터/Noun,12,5,7,7.780371234856063e-05,9.995779559741441e-05,0.5833333333333334
9481,9481,30%/Number,12,5,7,7.780371234856063e-05,9.995779559741441e-05,0.5833333333333334
9482,9482,→/Foreign,12,5,7,7.780371234856063e-05,9.995779559741441e-05,0.5833333333333334
9483,9483,딴사람/Noun,12,5,7,7.780371234856063e-05,9.995779559741441e-05,0.5833333333333334
9484,9484,날씨/Noun,12,7,5,0.0001000333444481494,7.774495213132233e-05,0.5833333333333334
9485,9485,생/Foreign,12,7,5,0.0001000333444481494,7.774495213132233e-05,0.5833333333333334
9486,9486,like/Alpha,12,7,5,0.0001000333444481494,7.774495213132233e-05,0.5833333333333334
9487,9487,치히로/Noun,12,7,5,0.0001000333444481494,7.774495213132233e-05,0.5833333333333334
9488,9488,경찰서/Noun,12,5,7,7.780371234856063e-05,9.995779559741441e-05,0.5833333333333334
9489,9489,정보석/Noun,12,7,5,0.0001000333444481494,7.774495213132233e-05,0.5833333333333334
9490,9490,인크레더블/Noun,12,7,5,0.0001000333444481494,7.774495213132233e-05,0.5833333333333334
9491,9491,수로/Noun,12,5,7,7.780371234856063e-05,9.995779559741441e-05,0.5833333333333334
9492,9492,텅빈/Noun,12,5,7,7.780371234856063e-05,9.995779559741441e-05,0.5833333333333334
9493,9493,그남자/Noun,12,7,5,0.0001000333444481494,7.774495213132233e-05,0.5833333333333334
9494,9494,서든/Noun,12,7,5,0.0001000333444481494,7.774495213132233e-05,0.5833333333333334
9495,9495,화려/Noun,12,7,5,0.0001000333444481494,7.774495213132233e-05,0.5833333333333334
9496,9496,좌충우돌/Noun,12,7,5,0.0001000333444481494,7.774495213132233e-05,0.5833333333333334
9497,9497,수십/Noun,12,7,5,0.0001000333444481494,7.774495213132233e-05,0.5833333333333334
9498,9498,3회/Number,12,5,7,7.780371234856063e-05,9.995779559741441e-05,0.5833333333333334
9499,9499,쿠퍼/Noun,12,7,5,0.0001000333444481494,7.774495213132233e-05,0.5833333333333334
9500,9500,그러므로/Conjunction,12,7,5,0.0001000333444481494,7.774495213132233e-05,0.5833333333333334
9501,9501,도구로/Noun,12,5,7,7.780371234856063e-05,9.995779559741441e-05,0.5833333333333334
9502,9502,바랬/Noun,12,5,7,7.780371234856063e-05,9.995779559741441e-05,0.5833333333333334
9503,9503,멸망하다/Adjective,12,5,7,7.780371234856063e-05,9.995779559741441e-05,0.5833333333333334
9504,9504,마왕/Noun,12,7,5,0.0001000333444481494,7.774495213132233e-05,0.5833333333333334
9505,9505,군국/Noun,12,5,7,7.780371234856063e-05,9.995779559741441e-05,0.5833333333333334
9506,9506,용의자/Noun,12,5,7,7.780371234856063e-05,9.995779559741441e-05,0.5833333333333334
9507,9507,고가/Noun,12,7,5,0.0001000333444481494,7.774495213132233e-05,0.5833333333333334
9508,9508,1~3/Number,12,7,5,0.0001000333444481494,7.774495213132233e-05,0.5833333333333334
9509,9509,엘리트/Noun,12,7,5,0.0001000333444481494,7.774495213132233e-05,0.5833333333333334
9510,9510,소시민/Noun,12,7,5,0.0001000333444481494,7.774495213132233e-05,0.5833333333333334
9511,9511,홍성/Noun,12,5,7,7.780371234856063e-05,9.995779559741441e-05,0.5833333333333334
9512,9512,맥클레인/Noun,12,7,5,0.0001000333444481494,7.774495213132233e-05,0.5833333333333334
9513,9513,고모/Noun,12,7,5,0.0001000333444481494,7.774495213132233e-05,0.5833333333333334
9514,9514,정직하다/Adjective,12,5,7,7.780371234856063e-05,9.995779559741441e-05,0.5833333333333334
9515,9515,김영철/Noun,12,7,5,0.0001000333444481494,7.774495213132233e-05,0.5833333333333334
9516,9516,이요/Noun,12,7,5,0.0001000333444481494,7.774495213132233e-05,0.5833333333333334
9517,9517,10시/Number,12,7,5,0.0001000333444481494,7.774495213132233e-05,0.5833333333333334
9518,9518,일정/Noun,12,7,5,0.0001000333444481494,7.774495213132233e-05,0.5833333333333334
9519,9519,나부랭이/Noun,12,5,7,7.780371234856063e-05,9.995779559741441e-05,0.5833333333333334
9520,9520,잘추다/Verb,12,7,5,0.0001000333444481494,7.774495213132233e-05,0.5833333333333334
9521,9521,대원/Noun,12,5,7,7.780371234856063e-05,9.995779559741441e-05,0.5833333333333334
9522,9522,스머프/Noun,12,7,5,0.0001000333444481494,7.774495213132233e-05,0.5833333333333334
9523,9523,니스/Noun,12,7,5,0.0001000333444481494,7.774495213132233e-05,0.5833333333333334
9524,9524,몸소/Noun,12,7,5,0.0001000333444481494,7.774495213132233e-05,0.5833333333333334
9525,9525,랴/Noun,12,5,7,7.780371234856063e-05,9.995779559741441e-05,0.5833333333333334
9526,9526,괴로움/Noun,12,7,5,0.0001000333444481494,7.774495213132233e-05,0.5833333333333334
9527,9527,유니크/Noun,12,7,5,0.0001000333444481494,7.774495213132233e-05,0.5833333333333334
9528,9528,오산/Noun,12,5,7,7.780371234856063e-05,9.995779559741441e-05,0.5833333333333334
9529,9529,거절/Noun,12,7,5,0.0001000333444481494,7.774495213132233e-05,0.5833333333333334
9530,9530,유연석/Noun,12,5,7,7.780371234856063e-05,9.995779559741441e-05,0.5833333333333334
9531,9531,미개/Noun,12,6,6,8.891852839835501e-05,8.885137386436837e-05,0.5
9532,9532,습관/Noun,12,6,6,8.891852839835501e-05,8.885137386436837e-05,0.5
9533,9533,태극권/Noun,12,6,6,8.891852839835501e-05,8.885137386436837e-05,0.5
9534,9534,귀환/Noun,12,6,6,8.891852839835501e-05,8.885137386436837e-05,0.5
9535,9535,한혜진/Noun,12,6,6,8.891852839835501e-05,8.885137386436837e-05,0.5
9536,9536,차로/Noun,12,6,6,8.891852839835501e-05,8.885137386436837e-05,0.5
9537,9537,22/Number,12,6,6,8.891852839835501e-05,8.885137386436837e-05,0.5
9538,9538,억양/Noun,12,6,6,8.891852839835501e-05,8.885137386436837e-05,0.5
9539,9539,베티/Noun,12,6,6,8.891852839835501e-05,8.885137386436837e-05,0.5
9540,9540,찜/Noun,12,6,6,8.891852839835501e-05,8.885137386436837e-05,0.5
9541,9541,널다/Verb,12,6,6,8.891852839835501e-05,8.885137386436837e-05,0.5
9542,9542,영화롭다/Adjective,12,6,6,8.891852839835501e-05,8.885137386436837e-05,0.5
9543,9543,템포/Noun,12,6,6,8.891852839835501e-05,8.885137386436837e-05,0.5
9544,9544,4.5/Number,12,6,6,8.891852839835501e-05,8.885137386436837e-05,0.5
9545,9545,상담/Noun,12,6,6,8.891852839835501e-05,8.885137386436837e-05,0.5
9546,9546,온주완/Noun,12,6,6,8.891852839835501e-05,8.885137386436837e-05,0.5
9547,9547,김재중/Noun,12,6,6,8.891852839835501e-05,8.885137386436837e-05,0.5
9548,9548,기황후/Noun,12,6,6,8.891852839835501e-05,8.885137386436837e-05,0.5
9549,9549,여전/Noun,12,6,6,8.891852839835501e-05,8.885137386436837e-05,0.5
9550,9550,소수자/Noun,12,6,6,8.891852839835501e-05,8.885137386436837e-05,0.5
9551,9551,해먹/Noun,12,6,6,8.891852839835501e-05,8.885137386436837e-05,0.5
9552,9552,네트/Noun,12,6,6,8.891852839835501e-05,8.885137386436837e-05,0.5
9553,9553,50%/Number,12,6,6,8.891852839835501e-05,8.885137386436837e-05,0.5
9554,9554,생소하다/Adjective,12,6,6,8.891852839835501e-05,8.885137386436837e-05,0.5
9555,9555,소주/Noun,12,6,6,8.891852839835501e-05,8.885137386436837e-05,0.5
9556,9556,엔딩씬/Noun,12,6,6,8.891852839835501e-05,8.885137386436837e-05,0.5
9557,9557,이거지/Adverb,12,6,6,8.891852839835501e-05,8.885137386436837e-05,0.5
9558,9558,예체능/Noun,12,6,6,8.891852839835501e-05,8.885137386436837e-05,0.5
9559,9559,고급스럽다/Adjective,12,6,6,8.891852839835501e-05,8.885137386436837e-05,0.5
9560,9560,왜색/Noun,12,6,6,8.891852839835501e-05,8.885137386436837e-05,0.5
9561,9561,스마트/Noun,12,6,6,8.891852839835501e-05,8.885137386436837e-05,0.5
9562,9562,편중/Noun,12,6,6,8.891852839835501e-05,8.885137386436837e-05,0.5
9563,9563,초능력자/Noun,12,6,6,8.891852839835501e-05,8.885137386436837e-05,0.5
9564,9564,흐미/Noun,12,6,6,8.891852839835501e-05,8.885137386436837e-05,0.5
9565,9565,안치/Noun,12,6,6,8.891852839835501e-05,8.885137386436837e-05,0.5
9566,9566,모션/Noun,12,6,6,8.891852839835501e-05,8.885137386436837e-05,0.5
9567,9567,배용준/Noun,12,6,6,8.891852839835501e-05,8.885137386436837e-05,0.5
9568,9568,째/Foreign,12,6,6,8.891852839835501e-05,8.885137386436837e-05,0.5
9569,9569,인대/Noun,12,6,6,8.891852839835501e-05,8.885137386436837e-05,0.5
9570,9570,샤워/Noun,12,6,6,8.891852839835501e-05,8.885137386436837e-05,0.5
9571,9571,액숀/Noun,12,6,6,8.891852839835501e-05,8.885137386436837e-05,0.5
9572,9572,리안/Noun,12,6,6,8.891852839835501e-05,8.885137386436837e-05,0.5
9573,9573,포심/Noun,12,6,6,8.891852839835501e-05,8.885137386436837e-05,0.5
9574,9574,도주/Noun,12,6,6,8.891852839835501e-05,8.885137386436837e-05,0.5
9575,9575,아론/Noun,12,6,6,8.891852839835501e-05,8.885137386436837e-05,0.5
9576,9576,점프/Noun,12,6,6,8.891852839835501e-05,8.885137386436837e-05,0.5
9577,9577,xx/Alpha,12,6,6,8.891852839835501e-05,8.885137386436837e-05,0.5
9578,9578,거란/Noun,12,6,6,8.891852839835501e-05,8.885137386436837e-05,0.5
9579,9579,살라/Noun,12,6,6,8.891852839835501e-05,8.885137386436837e-05,0.5
9580,9580,얻어맞다/Verb,12,6,6,8.891852839835501e-05,8.885137386436837e-05,0.5
9581,9581,뿜/Noun,12,6,6,8.891852839835501e-05,8.885137386436837e-05,0.5
9582,9582,두목/Noun,12,6,6,8.891852839835501e-05,8.885137386436837e-05,0.5
9583,9583,넷/Noun,12,6,6,8.891852839835501e-05,8.885137386436837e-05,0.5
9584,9584,컴/Noun,12,6,6,8.891852839835501e-05,8.885137386436837e-05,0.5
9585,9585,방치/Noun,12,6,6,8.891852839835501e-05,8.885137386436837e-05,0.5
9586,9586,간과/Noun,12,6,6,8.891852839835501e-05,8.885137386436837e-05,0.5
9587,9587,지미/Noun,12,6,6,8.891852839835501e-05,8.885137386436837e-05,0.5
9588,9588,베이커/Noun,12,6,6,8.891852839835501e-05,8.885137386436837e-05,0.5
9589,9589,다지다/Verb,12,6,6,8.891852839835501e-05,8.885137386436837e-05,0.5
9590,9590,진미/Noun,12,6,6,8.891852839835501e-05,8.885137386436837e-05,0.5
9591,9591,왜인/Noun,12,6,6,8.891852839835501e-05,8.885137386436837e-05,0.5
9592,9592,찾아다니다/Verb,12,6,6,8.891852839835501e-05,8.885137386436837e-05,0.5
9593,9593,심의/Noun,12,6,6,8.891852839835501e-05,8.885137386436837e-05,0.5
9594,9594,쨔응/Noun,11,11,0,0.0001444926086473269,2.2212843466092093e-05,1.0
9595,9595,깝깝/Noun,11,0,11,2.2229632099588756e-05,0.0001443834825295986,1.0
9596,9596,고은아/Noun,11,0,11,2.2229632099588756e-05,0.0001443834825295986,1.0
9597,9597,애하/Noun,11,0,11,2.2229632099588756e-05,0.0001443834825295986,1.0
9598,9598,폭도/Noun,11,0,11,2.2229632099588756e-05,0.0001443834825295986,1.0
9599,9599,티남/Noun,11,0,11,2.2229632099588756e-05,0.0001443834825295986,1.0
9600,9600,찍지마라/Noun,11,0,11,2.2229632099588756e-05,0.0001443834825295986,1.0
9601,9601,아하/Exclamation,11,0,11,2.2229632099588756e-05,0.0001443834825295986,1.0
9602,9602,500/Number,11,0,11,2.2229632099588756e-05,0.0001443834825295986,1.0
9603,9603,청소년기/Noun,11,11,0,0.0001444926086473269,2.2212843466092093e-05,1.0
9604,9604,손은서/Noun,11,0,11,2.2229632099588756e-05,0.0001443834825295986,1.0
9605,9605,유사/Noun,11,0,11,2.2229632099588756e-05,0.0001443834825295986,1.0
9606,9606,울화통/Noun,11,0,11,2.2229632099588756e-05,0.0001443834825295986,1.0
9607,9607,부릉부릉/Adverb,11,0,11,2.2229632099588756e-05,0.0001443834825295986,1.0
9608,9608,편파/Noun,11,0,11,2.2229632099588756e-05,0.0001443834825295986,1.0
9609,9609,과욕/Noun,11,0,11,2.2229632099588756e-05,0.0001443834825295986,1.0
9610,9610,싱그럽다/Adjective,11,11,0,0.0001444926086473269,2.2212843466092093e-05,1.0
9611,9611,탈세/Noun,11,0,11,2.2229632099588756e-05,0.0001443834825295986,1.0
9612,9612,까비/Noun,11,0,11,2.2229632099588756e-05,0.0001443834825295986,1.0
9613,9613,추기경/Noun,11,11,0,0.0001444926086473269,2.2212843466092093e-05,1.0
9614,9614,휴식/Noun,11,11,0,0.0001444926086473269,2.2212843466092093e-05,1.0
9615,9615,배종옥/Noun,11,11,0,0.0001444926086473269,2.2212843466092093e-05,1.0
9616,9616,노랑/Noun,11,0,11,2.2229632099588756e-05,0.0001443834825295986,1.0
9617,9617,말좀/Noun,11,0,11,2.2229632099588756e-05,0.0001443834825295986,1.0
9618,9618,후광/Noun,11,0,11,2.2229632099588756e-05,0.0001443834825295986,1.0
9619,9619,복수초/Noun,11,0,11,2.2229632099588756e-05,0.0001443834825295986,1.0
9620,9620,ㅠㅠㅜ/KoreanParticle,11,11,0,0.0001444926086473269,2.2212843466092093e-05,1.0
9621,9621,아나킨/Noun,11,11,0,0.0001444926086473269,2.2212843466092093e-05,1.0
9622,9622,윌슨/Noun,11,11,0,0.0001444926086473269,2.2212843466092093e-05,1.0
9623,9623,별루임/Noun,11,0,11,2.2229632099588756e-05,0.0001443834825295986,1.0
9624,9624,짱짱걸/Noun,11,10,1,0.0001333777925975325,3.331926519913814e-05,0.9090909090909092
9625,9625,벤허/Noun,11,10,1,0.0001333777925975325,3.331926519913814e-05,0.9090909090909092
9626,9626,애매/Noun,11,1,10,3.334444814938313e-05,0.00013327706079655256,0.9090909090909092
9627,9627,울트라/Noun,11,1,10,3.334444814938313e-05,0.00013327706079655256,0.9090909090909092
9628,9628,오바이트/Noun,11,1,10,3.334444814938313e-05,0.00013327706079655256,0.9090909090909092
9629,9629,구토/Noun,11,1,10,3.334444814938313e-05,0.00013327706079655256,0.9090909090909092
9630,9630,갓파더/Noun,11,1,10,3.334444814938313e-05,0.00013327706079655256,0.9090909090909092
9631,9631,덱스터/Noun,11,10,1,0.0001333777925975325,3.331926519913814e-05,0.9090909090909092
9632,9632,페미/Noun,11,1,10,3.334444814938313e-05,0.00013327706079655256,0.9090909090909092
9633,9633,4천원/Number,11,1,10,3.334444814938313e-05,0.00013327706079655256,0.9090909090909092
9634,9634,입담/Noun,11,10,1,0.0001333777925975325,3.331926519913814e-05,0.9090909090909092
9635,9635,알라딘/Noun,11,10,1,0.0001333777925975325,3.331926519913814e-05,0.9090909090909092
9636,9636,감금/Noun,11,1,10,3.334444814938313e-05,0.00013327706079655256,0.9090909090909092
9637,9637,수신료/Noun,11,1,10,3.334444814938313e-05,0.00013327706079655256,0.9090909090909092
9638,9638,소모/Noun,11,1,10,3.334444814938313e-05,0.00013327706079655256,0.9090909090909092
9639,9639,없슴/Noun,11,1,10,3.334444814938313e-05,0.00013327706079655256,0.9090909090909092
9640,9640,프로파간다/Noun,11,1,10,3.334444814938313e-05,0.00013327706079655256,0.9090909090909092
9641,9641,다이빙/Noun,11,1,10,3.334444814938313e-05,0.00013327706079655256,0.9090909090909092
9642,9642,유물/Noun,11,1,10,3.334444814938313e-05,0.00013327706079655256,0.9090909090909092
9643,9643,、/Foreign,11,10,1,0.0001333777925975325,3.331926519913814e-05,0.9090909090909092
9644,9644,먹듯/Noun,11,1,10,3.334444814938313e-05,0.00013327706079655256,0.9090909090909092
9645,9645,고역/Noun,11,1,10,3.334444814938313e-05,0.00013327706079655256,0.9090909090909092
9646,9646,개폼/Noun,11,1,10,3.334444814938313e-05,0.00013327706079655256,0.9090909090909092
9647,9647,골다/Verb,11,1,10,3.334444814938313e-05,0.00013327706079655256,0.9090909090909092
9648,9648,워터/Noun,11,1,10,3.334444814938313e-05,0.00013327706079655256,0.9090909090909092
9649,9649,world/Alpha,11,10,1,0.0001333777925975325,3.331926519913814e-05,0.9090909090909092
9650,9650,석양/Noun,11,10,1,0.0001333777925975325,3.331926519913814e-05,0.9090909090909092
9651,9651,이지현/Noun,11,1,10,3.334444814938313e-05,0.00013327706079655256,0.9090909090909092
9652,9652,징징거리다/Adjective,11,1,10,3.334444814938313e-05,0.00013327706079655256,0.9090909090909092
9653,9653,비키니/Noun,11,1,10,3.334444814938313e-05,0.00013327706079655256,0.9090909090909092
9654,9654,답시고/Noun,11,1,10,3.334444814938313e-05,0.00013327706079655256,0.9090909090909092
9655,9655,(-/Punctuation,11,1,10,3.334444814938313e-05,0.00013327706079655256,0.9090909090909092
9656,9656,압니/Noun,11,10,1,0.0001333777925975325,3.331926519913814e-05,0.9090909090909092
9657,9657,OTL/Alpha,11,1,10,3.334444814938313e-05,0.00013327706079655256,0.9090909090909092
9658,9658,퉁/Noun,11,1,10,3.334444814938313e-05,0.00013327706079655256,0.9090909090909092
9659,9659,오지호/Noun,11,1,10,3.334444814938313e-05,0.00013327706079655256,0.9090909090909092
9660,9660,KTX/Alpha,11,1,10,3.334444814938313e-05,0.00013327706079655256,0.9090909090909092
9661,9661,동행/Noun,11,10,1,0.0001333777925975325,3.331926519913814e-05,0.9090909090909092
9662,9662,8~9/Number,11,10,1,0.0001333777925975325,3.331926519913814e-05,0.9090909090909092
9663,9663,게이물/Noun,11,1,10,3.334444814938313e-05,0.00013327706079655256,0.9090909090909092
9664,9664,오분/Noun,11,1,10,3.334444814938313e-05,0.00013327706079655256,0.9090909090909092
9665,9665,개망/Noun,11,1,10,3.334444814938313e-05,0.00013327706079655256,0.9090909090909092
9666,9666,극화/Noun,11,1,10,3.334444814938313e-05,0.00013327706079655256,0.9090909090909092
9667,9667,킬러조/Noun,11,1,10,3.334444814938313e-05,0.00013327706079655256,0.9090909090909092
9668,9668,마음껏/Noun,11,10,1,0.0001333777925975325,3.331926519913814e-05,0.9090909090909092
9669,9669,팔고/Noun,11,1,10,3.334444814938313e-05,0.00013327706079655256,0.9090909090909092
9670,9670,OUT/Alpha,11,1,10,3.334444814938313e-05,0.00013327706079655256,0.9090909090909092
9671,9671,제안/Noun,11,1,10,3.334444814938313e-05,0.00013327706079655256,0.9090909090909092
9672,9672,착신아리/Noun,11,1,10,3.334444814938313e-05,0.00013327706079655256,0.9090909090909092
9673,9673,다스베이더/Noun,11,10,1,0.0001333777925975325,3.331926519913814e-05,0.9090909090909092
9674,9674,!!!^^/Punctuation,11,10,1,0.0001333777925975325,3.331926519913814e-05,0.9090909090909092
9675,9675,반함/Noun,11,10,1,0.0001333777925975325,3.331926519913814e-05,0.9090909090909092
9676,9676,엇습/Noun,11,10,1,0.0001333777925975325,3.331926519913814e-05,0.9090909090909092
9677,9677,궈/Noun,11,1,10,3.334444814938313e-05,0.00013327706079655256,0.9090909090909092
9678,9678,어릴떄/Noun,11,10,1,0.0001333777925975325,3.331926519913814e-05,0.9090909090909092
9679,9679,퀼리티/Noun,11,1,10,3.334444814938313e-05,0.00013327706079655256,0.9090909090909092
9680,9680,판정/Noun,11,2,9,4.445926419917751e-05,0.00012217063906350652,0.8181818181818182
9681,9681,구사/Noun,11,2,9,4.445926419917751e-05,0.00012217063906350652,0.8181818181818182
9682,9682,가려지다/Verb,11,9,2,0.00012226297654773814,4.4425686932184186e-05,0.8181818181818182
9683,9683,메리다/Noun,11,2,9,4.445926419917751e-05,0.00012217063906350652,0.8181818181818182
9684,9684,비디오테잎/Noun,11,9,2,0.00012226297654773814,4.4425686932184186e-05,0.8181818181818182
9685,9685,관통/Noun,11,9,2,0.00012226297654773814,4.4425686932184186e-05,0.8181818181818182
9686,9686,간지럽다/Adjective,11,2,9,4.445926419917751e-05,0.00012217063906350652,0.8181818181818182
9687,9687,광신도/Noun,11,2,9,4.445926419917751e-05,0.00012217063906350652,0.8181818181818182
9688,9688,34/Number,11,9,2,0.00012226297654773814,4.4425686932184186e-05,0.8181818181818182
9689,9689,윤/Noun,11,9,2,0.00012226297654773814,4.4425686932184186e-05,0.8181818181818182
9690,9690,깡통/Noun,11,2,9,4.445926419917751e-05,0.00012217063906350652,0.8181818181818182
9691,9691,70분/Number,11,2,9,4.445926419917751e-05,0.00012217063906350652,0.8181818181818182
9692,9692,계약/Noun,11,2,9,4.445926419917751e-05,0.00012217063906350652,0.8181818181818182
9693,9693,타락/Noun,11,2,9,4.445926419917751e-05,0.00012217063906350652,0.8181818181818182
9694,9694,분간/Noun,11,2,9,4.445926419917751e-05,0.00012217063906350652,0.8181818181818182
9695,9695,죤나/Noun,11,2,9,4.445926419917751e-05,0.00012217063906350652,0.8181818181818182
9696,9696,민망/Noun,11,2,9,4.445926419917751e-05,0.00012217063906350652,0.8181818181818182
9697,9697,축제/Noun,11,9,2,0.00012226297654773814,4.4425686932184186e-05,0.8181818181818182
9698,9698,방학/Noun,11,9,2,0.00012226297654773814,4.4425686932184186e-05,0.8181818181818182
9699,9699,되찾다/Verb,11,9,2,0.00012226297654773814,4.4425686932184186e-05,0.8181818181818182
9700,9700,음울하다/Adjective,11,9,2,0.00012226297654773814,4.4425686932184186e-05,0.8181818181818182
9701,9701,한주/Noun,11,9,2,0.00012226297654773814,4.4425686932184186e-05,0.8181818181818182
9702,9702,...................../Punctuation,11,2,9,4.445926419917751e-05,0.00012217063906350652,0.8181818181818182
9703,9703,들려오다/Verb,11,9,2,0.00012226297654773814,4.4425686932184186e-05,0.8181818181818182
9704,9704,취소/Noun,11,2,9,4.445926419917751e-05,0.00012217063906350652,0.8181818181818182
9705,9705,린즈링/Noun,11,2,9,4.445926419917751e-05,0.00012217063906350652,0.8181818181818182
9706,9706,동거/Noun,11,2,9,4.445926419917751e-05,0.00012217063906350652,0.8181818181818182
9707,9707,버틀러/Noun,11,9,2,0.00012226297654773814,4.4425686932184186e-05,0.8181818181818182
9708,9708,염병/Noun,11,2,9,4.445926419917751e-05,0.00012217063906350652,0.8181818181818182
9709,9709,80~90년/Number,11,2,9,4.445926419917751e-05,0.00012217063906350652,0.8181818181818182
9710,9710,센터/Noun,11,2,9,4.445926419917751e-05,0.00012217063906350652,0.8181818181818182
9711,9711,관계도/Noun,11,2,9,4.445926419917751e-05,0.00012217063906350652,0.8181818181818182
9712,9712,스탠리/Noun,11,9,2,0.00012226297654773814,4.4425686932184186e-05,0.8181818181818182
9713,9713,선교사/Noun,11,9,2,0.00012226297654773814,4.4425686932184186e-05,0.8181818181818182
9714,9714,양익준/Noun,11,9,2,0.00012226297654773814,4.4425686932184186e-05,0.8181818181818182
9715,9715,무민/Noun,11,9,2,0.00012226297654773814,4.4425686932184186e-05,0.8181818181818182
9716,9716,자지/Noun,11,2,9,4.445926419917751e-05,0.00012217063906350652,0.8181818181818182
9717,9717,go/Alpha,11,9,2,0.00012226297654773814,4.4425686932184186e-05,0.8181818181818182
9718,9718,랑께/Josa,11,2,9,4.445926419917751e-05,0.00012217063906350652,0.8181818181818182
9719,9719,서론/Noun,11,2,9,4.445926419917751e-05,0.00012217063906350652,0.8181818181818182
9720,9720,환각/Noun,11,2,9,4.445926419917751e-05,0.00012217063906350652,0.8181818181818182
9721,9721,미미하다/Adjective,11,2,9,4.445926419917751e-05,0.00012217063906350652,0.8181818181818182
9722,9722,고립/Noun,11,9,2,0.00012226297654773814,4.4425686932184186e-05,0.8181818181818182
9723,9723,저딴/Noun,11,2,9,4.445926419917751e-05,0.00012217063906350652,0.8181818181818182
9724,9724,사발/Noun,11,2,9,4.445926419917751e-05,0.00012217063906350652,0.8181818181818182
9725,9725,바스코/Noun,11,2,9,4.445926419917751e-05,0.00012217063906350652,0.8181818181818182
9726,9726,셰익스피어/Noun,11,9,2,0.00012226297654773814,4.4425686932184186e-05,0.8181818181818182
9727,9727,쿵후/Noun,11,2,9,4.445926419917751e-05,0.00012217063906350652,0.8181818181818182
9728,9728,난해/Noun,11,2,9,4.445926419917751e-05,0.00012217063906350652,0.8181818181818182
9729,9729,바퀴벌레/Noun,11,2,9,4.445926419917751e-05,0.00012217063906350652,0.8181818181818182
9730,9730,know/Alpha,11,9,2,0.00012226297654773814,4.4425686932184186e-05,0.8181818181818182
9731,9731,질렌할/Noun,11,9,2,0.00012226297654773814,4.4425686932184186e-05,0.8181818181818182
9732,9732,리다/Noun,11,2,9,4.445926419917751e-05,0.00012217063906350652,0.8181818181818182
9733,9733,연출가/Noun,11,2,9,4.445926419917751e-05,0.00012217063906350652,0.8181818181818182
9734,9734,호빗/Noun,11,9,2,0.00012226297654773814,4.4425686932184186e-05,0.8181818181818182
9735,9735,의욕/Noun,11,2,9,4.445926419917751e-05,0.00012217063906350652,0.8181818181818182
9736,9736,was/Alpha,11,9,2,0.00012226297654773814,4.4425686932184186e-05,0.8181818181818182
9737,9737,기무라/Noun,11,9,2,0.00012226297654773814,4.4425686932184186e-05,0.8181818181818182
9738,9738,안봣/Noun,11,9,2,0.00012226297654773814,4.4425686932184186e-05,0.8181818181818182
9739,9739,브랜드/Noun,11,9,2,0.00012226297654773814,4.4425686932184186e-05,0.8181818181818182
9740,9740,버킷리스트/Noun,11,9,2,0.00012226297654773814,4.4425686932184186e-05,0.8181818181818182
9741,9741,요인/Noun,11,2,9,4.445926419917751e-05,0.00012217063906350652,0.8181818181818182
9742,9742,"...,/Punctuation",11,2,9,4.445926419917751e-05,0.00012217063906350652,0.8181818181818182
9743,9743,무신론자/Noun,11,2,9,4.445926419917751e-05,0.00012217063906350652,0.8181818181818182
9744,9744,레슬링/Noun,11,2,9,4.445926419917751e-05,0.00012217063906350652,0.8181818181818182
9745,9745,노처녀/Noun,11,2,9,4.445926419917751e-05,0.00012217063906350652,0.8181818181818182
9746,9746,조엘/Noun,11,2,9,4.445926419917751e-05,0.00012217063906350652,0.8181818181818182
9747,9747,無/Foreign,11,2,9,4.445926419917751e-05,0.00012217063906350652,0.8181818181818182
9748,9748,쪽지/Noun,11,9,2,0.00012226297654773814,4.4425686932184186e-05,0.8181818181818182
9749,9749,형용/Noun,11,9,2,0.00012226297654773814,4.4425686932184186e-05,0.8181818181818182
9750,9750,zzz/Alpha,11,2,9,4.445926419917751e-05,0.00012217063906350652,0.8181818181818182
9751,9751,남북/Noun,11,9,2,0.00012226297654773814,4.4425686932184186e-05,0.8181818181818182
9752,9752,왕년/Noun,11,2,9,4.445926419917751e-05,0.00012217063906350652,0.8181818181818182
9753,9753,4월/Number,11,9,2,0.00012226297654773814,4.4425686932184186e-05,0.8181818181818182
9754,9754,댕/Noun,11,2,9,4.445926419917751e-05,0.00012217063906350652,0.8181818181818182
9755,9755,번지르르하다/Adjective,11,2,9,4.445926419917751e-05,0.00012217063906350652,0.8181818181818182
9756,9756,평보/Noun,11,2,9,4.445926419917751e-05,0.00012217063906350652,0.8181818181818182
9757,9757,김원효/Noun,11,2,9,4.445926419917751e-05,0.00012217063906350652,0.8181818181818182
9758,9758,사유/Noun,11,9,2,0.00012226297654773814,4.4425686932184186e-05,0.8181818181818182
9759,9759,행각/Noun,11,2,9,4.445926419917751e-05,0.00012217063906350652,0.8181818181818182
9760,9760,수치심/Noun,11,2,9,4.445926419917751e-05,0.00012217063906350652,0.8181818181818182
9761,9761,욜라/Noun,11,2,9,4.445926419917751e-05,0.00012217063906350652,0.8181818181818182
9762,9762,승희/Noun,11,2,9,4.445926419917751e-05,0.00012217063906350652,0.8181818181818182
9763,9763,오케이/Noun,11,2,9,4.445926419917751e-05,0.00012217063906350652,0.8181818181818182
9764,9764,팬텀/Noun,11,9,2,0.00012226297654773814,4.4425686932184186e-05,0.8181818181818182
9765,9765,하비/Noun,11,9,2,0.00012226297654773814,4.4425686932184186e-05,0.8181818181818182
9766,9766,김성수/Noun,11,2,9,4.445926419917751e-05,0.00012217063906350652,0.8181818181818182
9767,9767,달튼/Noun,11,9,2,0.00012226297654773814,4.4425686932184186e-05,0.8181818181818182
9768,9768,발라/Noun,11,2,9,4.445926419917751e-05,0.00012217063906350652,0.8181818181818182
9769,9769,박준형/Noun,11,2,9,4.445926419917751e-05,0.00012217063906350652,0.8181818181818182
9770,9770,불급/Noun,11,2,9,4.445926419917751e-05,0.00012217063906350652,0.8181818181818182
9771,9771,진지희/Noun,11,2,9,4.445926419917751e-05,0.00012217063906350652,0.8181818181818182
9772,9772,횟수/Noun,11,2,9,4.445926419917751e-05,0.00012217063906350652,0.8181818181818182
9773,9773,악플달다/Verb,11,9,2,0.00012226297654773814,4.4425686932184186e-05,0.8181818181818182
9774,9774,2.2/Number,11,2,9,4.445926419917751e-05,0.00012217063906350652,0.8181818181818182
9775,9775,레젼드/Noun,11,9,2,0.00012226297654773814,4.4425686932184186e-05,0.8181818181818182
9776,9776,김꽃비/Noun,11,2,9,4.445926419917751e-05,0.00012217063906350652,0.8181818181818182
9777,9777,무성의/Noun,11,2,9,4.445926419917751e-05,0.00012217063906350652,0.8181818181818182
9778,9778,일본사람/Noun,11,2,9,4.445926419917751e-05,0.00012217063906350652,0.8181818181818182
9779,9779,r/Alpha,11,3,8,5.5574080248971876e-05,0.00011106421733046048,0.7272727272727273
9780,9780,독고/Noun,11,8,3,0.00011114816049794375,5.553210866523024e-05,0.7272727272727273
9781,9781,나왓으/Noun,11,8,3,0.00011114816049794375,5.553210866523024e-05,0.7272727272727273
9782,9782,바티칸/Noun,11,3,8,5.5574080248971876e-05,0.00011106421733046048,0.7272727272727273
9783,9783,후퇴/Noun,11,3,8,5.5574080248971876e-05,0.00011106421733046048,0.7272727272727273
9784,9784,CD/Alpha,11,8,3,0.00011114816049794375,5.553210866523024e-05,0.7272727272727273
9785,9785,NG/Alpha,11,8,3,0.00011114816049794375,5.553210866523024e-05,0.7272727272727273
9786,9786,".,../Punctuation",11,3,8,5.5574080248971876e-05,0.00011106421733046048,0.7272727272727273
9787,9787,팝핀현준/Noun,11,3,8,5.5574080248971876e-05,0.00011106421733046048,0.7272727272727273
9788,9788,불협화음/Noun,11,3,8,5.5574080248971876e-05,0.00011106421733046048,0.7272727272727273
9789,9789,카터/Noun,11,8,3,0.00011114816049794375,5.553210866523024e-05,0.7272727272727273
9790,9790,뚜껑/Noun,11,3,8,5.5574080248971876e-05,0.00011106421733046048,0.7272727272727273
9791,9791,당사자/Noun,11,8,3,0.00011114816049794375,5.553210866523024e-05,0.7272727272727273
9792,9792,브란도/Noun,11,8,3,0.00011114816049794375,5.553210866523024e-05,0.7272727272727273
9793,9793,에르/Noun,11,8,3,0.00011114816049794375,5.553210866523024e-05,0.7272727272727273
9794,9794,참가/Noun,11,3,8,5.5574080248971876e-05,0.00011106421733046048,0.7272727272727273
9795,9795,승승장구/Noun,11,8,3,0.00011114816049794375,5.553210866523024e-05,0.7272727272727273
9796,9796,딥블루씨/Noun,11,3,8,5.5574080248971876e-05,0.00011106421733046048,0.7272727272727273
9797,9797,변경/Noun,11,3,8,5.5574080248971876e-05,0.00011106421733046048,0.7272727272727273
9798,9798,유효하다/Adjective,11,8,3,0.00011114816049794375,5.553210866523024e-05,0.7272727272727273
9799,9799,고달프다/Adjective,11,8,3,0.00011114816049794375,5.553210866523024e-05,0.7272727272727273
9800,9800,대조/Noun,11,8,3,0.00011114816049794375,5.553210866523024e-05,0.7272727272727273
9801,9801,근친상간/Noun,11,3,8,5.5574080248971876e-05,0.00011106421733046048,0.7272727272727273
9802,9802,충전/Noun,11,3,8,5.5574080248971876e-05,0.00011106421733046048,0.7272727272727273
9803,9803,추리물/Noun,11,3,8,5.5574080248971876e-05,0.00011106421733046048,0.7272727272727273
9804,9804,지오/Noun,11,8,3,0.00011114816049794375,5.553210866523024e-05,0.7272727272727273
9805,9805,들것/Noun,11,3,8,5.5574080248971876e-05,0.00011106421733046048,0.7272727272727273
9806,9806,근처/Noun,11,8,3,0.00011114816049794375,5.553210866523024e-05,0.7272727272727273
9807,9807,쉬리/Noun,11,3,8,5.5574080248971876e-05,0.00011106421733046048,0.7272727272727273
9808,9808,건너다/Verb,11,3,8,5.5574080248971876e-05,0.00011106421733046048,0.7272727272727273
9809,9809,로리타/Noun,11,3,8,5.5574080248971876e-05,0.00011106421733046048,0.7272727272727273
9810,9810,감방/Noun,11,3,8,5.5574080248971876e-05,0.00011106421733046048,0.7272727272727273
9811,9811,쑈/Noun,11,3,8,5.5574080248971876e-05,0.00011106421733046048,0.7272727272727273
9812,9812,피라미드/Noun,11,3,8,5.5574080248971876e-05,0.00011106421733046048,0.7272727272727273
9813,9813,마사미/Noun,11,8,3,0.00011114816049794375,5.553210866523024e-05,0.7272727272727273
9814,9814,개차반/Noun,11,3,8,5.5574080248971876e-05,0.00011106421733046048,0.7272727272727273
9815,9815,하드코어/Noun,11,3,8,5.5574080248971876e-05,0.00011106421733046048,0.7272727272727273
9816,9816,계몽/Noun,11,8,3,0.00011114816049794375,5.553210866523024e-05,0.7272727272727273
9817,9817,고구마/Noun,11,8,3,0.00011114816049794375,5.553210866523024e-05,0.7272727272727273
9818,9818,뭐길/Noun,11,3,8,5.5574080248971876e-05,0.00011106421733046048,0.7272727272727273
9819,9819,왓츠/Noun,11,8,3,0.00011114816049794375,5.553210866523024e-05,0.7272727272727273
9820,9820,꿀잠/Noun,11,3,8,5.5574080248971876e-05,0.00011106421733046048,0.7272727272727273
9821,9821,경기도/Noun,11,8,3,0.00011114816049794375,5.553210866523024e-05,0.7272727272727273
9822,9822,여분/Noun,11,3,8,5.5574080248971876e-05,0.00011106421733046048,0.7272727272727273
9823,9823,연작/Noun,11,8,3,0.00011114816049794375,5.553210866523024e-05,0.7272727272727273
9824,9824,전인/Noun,11,8,3,0.00011114816049794375,5.553210866523024e-05,0.7272727272727273
9825,9825,수첩/Noun,11,3,8,5.5574080248971876e-05,0.00011106421733046048,0.7272727272727273
9826,9826,려원/Noun,11,8,3,0.00011114816049794375,5.553210866523024e-05,0.7272727272727273
9827,9827,나이틀리/Noun,11,8,3,0.00011114816049794375,5.553210866523024e-05,0.7272727272727273
9828,9828,외침/Noun,11,8,3,0.00011114816049794375,5.553210866523024e-05,0.7272727272727273
9829,9829,시력/Noun,11,3,8,5.5574080248971876e-05,0.00011106421733046048,0.7272727272727273
9830,9830,밀고/Noun,11,3,8,5.5574080248971876e-05,0.00011106421733046048,0.7272727272727273
9831,9831,졸지/Noun,11,3,8,5.5574080248971876e-05,0.00011106421733046048,0.7272727272727273
9832,9832,패틴슨/Noun,11,3,8,5.5574080248971876e-05,0.00011106421733046048,0.7272727272727273
9833,9833,영국영화/Noun,11,8,3,0.00011114816049794375,5.553210866523024e-05,0.7272727272727273
9834,9834,이자스민/Noun,11,3,8,5.5574080248971876e-05,0.00011106421733046048,0.7272727272727273
9835,9835,합성/Noun,11,3,8,5.5574080248971876e-05,0.00011106421733046048,0.7272727272727273
9836,9836,대루/Noun,11,3,8,5.5574080248971876e-05,0.00011106421733046048,0.7272727272727273
9837,9837,뿜었다/Noun,11,3,8,5.5574080248971876e-05,0.00011106421733046048,0.7272727272727273
9838,9838,뻣뻣하다/Adjective,11,3,8,5.5574080248971876e-05,0.00011106421733046048,0.7272727272727273
9839,9839,각시탈/Noun,11,8,3,0.00011114816049794375,5.553210866523024e-05,0.7272727272727273
9840,9840,500원/Number,11,3,8,5.5574080248971876e-05,0.00011106421733046048,0.7272727272727273
9841,9841,하염없이/Adverb,11,8,3,0.00011114816049794375,5.553210866523024e-05,0.7272727272727273
9842,9842,이태임/Noun,11,3,8,5.5574080248971876e-05,0.00011106421733046048,0.7272727272727273
9843,9843,엽/Noun,11,8,3,0.00011114816049794375,5.553210866523024e-05,0.7272727272727273
9844,9844,박은혜/Noun,11,3,8,5.5574080248971876e-05,0.00011106421733046048,0.7272727272727273
9845,9845,상하/Noun,11,3,8,5.5574080248971876e-05,0.00011106421733046048,0.7272727272727273
9846,9846,This/Alpha,11,8,3,0.00011114816049794375,5.553210866523024e-05,0.7272727272727273
9847,9847,히로스에/Noun,11,3,8,5.5574080248971876e-05,0.00011106421733046048,0.7272727272727273
9848,9848,양은/Noun,11,3,8,5.5574080248971876e-05,0.00011106421733046048,0.7272727272727273
9849,9849,자서전/Noun,11,3,8,5.5574080248971876e-05,0.00011106421733046048,0.7272727272727273
9850,9850,고이/Noun,11,3,8,5.5574080248971876e-05,0.00011106421733046048,0.7272727272727273
9851,9851,콱/Noun,11,3,8,5.5574080248971876e-05,0.00011106421733046048,0.7272727272727273
9852,9852,이중인격/Noun,11,3,8,5.5574080248971876e-05,0.00011106421733046048,0.7272727272727273
9853,9853,허공/Noun,11,3,8,5.5574080248971876e-05,0.00011106421733046048,0.7272727272727273
9854,9854,임요환/Noun,11,3,8,5.5574080248971876e-05,0.00011106421733046048,0.7272727272727273
9855,9855,스리/Noun,11,8,3,0.00011114816049794375,5.553210866523024e-05,0.7272727272727273
9856,9856,가레스/Noun,11,3,8,5.5574080248971876e-05,0.00011106421733046048,0.7272727272727273
9857,9857,트렁크/Noun,11,3,8,5.5574080248971876e-05,0.00011106421733046048,0.7272727272727273
9858,9858,골든타임/Noun,11,3,8,5.5574080248971876e-05,0.00011106421733046048,0.7272727272727273
9859,9859,얼간이/Noun,11,3,8,5.5574080248971876e-05,0.00011106421733046048,0.7272727272727273
9860,9860,씩/Foreign,11,3,8,5.5574080248971876e-05,0.00011106421733046048,0.7272727272727273
9861,9861,섭섭하다/Adjective,11,8,3,0.00011114816049794375,5.553210866523024e-05,0.7272727272727273
9862,9862,여타/Noun,11,8,3,0.00011114816049794375,5.553210866523024e-05,0.7272727272727273
9863,9863,효율/Noun,11,3,8,5.5574080248971876e-05,0.00011106421733046048,0.7272727272727273
9864,9864,미처/Noun,11,8,3,0.00011114816049794375,5.553210866523024e-05,0.7272727272727273
9865,9865,하울/Noun,11,8,3,0.00011114816049794375,5.553210866523024e-05,0.7272727272727273
9866,9866,애처롭다/Adjective,11,8,3,0.00011114816049794375,5.553210866523024e-05,0.7272727272727273
9867,9867,꼬띠/Noun,11,8,3,0.00011114816049794375,5.553210866523024e-05,0.7272727272727273
9868,9868,숭배/Noun,11,3,8,5.5574080248971876e-05,0.00011106421733046048,0.7272727272727273
9869,9869,비키/Noun,11,3,8,5.5574080248971876e-05,0.00011106421733046048,0.7272727272727273
9870,9870,꾼/Noun,11,8,3,0.00011114816049794375,5.553210866523024e-05,0.7272727272727273
9871,9871,열망/Noun,11,8,3,0.00011114816049794375,5.553210866523024e-05,0.7272727272727273
9872,9872,추적자/Noun,11,8,3,0.00011114816049794375,5.553210866523024e-05,0.7272727272727273
9873,9873,또래/Noun,11,8,3,0.00011114816049794375,5.553210866523024e-05,0.7272727272727273
9874,9874,원장/Noun,11,3,8,5.5574080248971876e-05,0.00011106421733046048,0.7272727272727273
9875,9875,빙/Noun,11,3,8,5.5574080248971876e-05,0.00011106421733046048,0.7272727272727273
9876,9876,지식인/Noun,11,8,3,0.00011114816049794375,5.553210866523024e-05,0.7272727272727273
9877,9877,정수/Noun,11,8,3,0.00011114816049794375,5.553210866523024e-05,0.7272727272727273
9878,9878,미치광이/Noun,11,3,8,5.5574080248971876e-05,0.00011106421733046048,0.7272727272727273
9879,9879,쵸/VerbPrefix,11,8,3,0.00011114816049794375,5.553210866523024e-05,0.7272727272727273
9880,9880,화끈/Noun,11,8,3,0.00011114816049794375,5.553210866523024e-05,0.7272727272727273
9881,9881,증인/Noun,11,3,8,5.5574080248971876e-05,0.00011106421733046048,0.7272727272727273
9882,9882,악순환/Noun,11,8,3,0.00011114816049794375,5.553210866523024e-05,0.7272727272727273
9883,9883,최상급/Noun,11,8,3,0.00011114816049794375,5.553210866523024e-05,0.7272727272727273
9884,9884,유주/Noun,11,8,3,0.00011114816049794375,5.553210866523024e-05,0.7272727272727273
9885,9885,이제일/Noun,11,8,3,0.00011114816049794375,5.553210866523024e-05,0.7272727272727273
9886,9886,안심/Noun,11,8,3,0.00011114816049794375,5.553210866523024e-05,0.7272727272727273
9887,9887,쿵/Noun,11,8,3,0.00011114816049794375,5.553210866523024e-05,0.7272727272727273
9888,9888,고간/Noun,11,3,8,5.5574080248971876e-05,0.00011106421733046048,0.7272727272727273
9889,9889,김태우/Noun,11,8,3,0.00011114816049794375,5.553210866523024e-05,0.7272727272727273
9890,9890,이종혁/Noun,11,8,3,0.00011114816049794375,5.553210866523024e-05,0.7272727272727273
9891,9891,서른/Modifier,11,8,3,0.00011114816049794375,5.553210866523024e-05,0.7272727272727273
9892,9892,아이거/Noun,11,7,4,0.0001000333444481494,6.663853039827628e-05,0.6363636363636364
9893,9893,골드버그/Noun,11,7,4,0.0001000333444481494,6.663853039827628e-05,0.6363636363636364
9894,9894,명함/Noun,11,7,4,0.0001000333444481494,6.663853039827628e-05,0.6363636363636364
9895,9895,껌/Noun,11,7,4,0.0001000333444481494,6.663853039827628e-05,0.6363636363636364
9896,9896,쪼개다/Verb,11,4,7,6.668889629876625e-05,9.995779559741441e-05,0.6363636363636364
9897,9897,1997년/Number,11,7,4,0.0001000333444481494,6.663853039827628e-05,0.6363636363636364
9898,9898,차오르다/Verb,11,7,4,0.0001000333444481494,6.663853039827628e-05,0.6363636363636364
9899,9899,겟/Noun,11,4,7,6.668889629876625e-05,9.995779559741441e-05,0.6363636363636364
9900,9900,감수/Noun,11,4,7,6.668889629876625e-05,9.995779559741441e-05,0.6363636363636364
9901,9901,득/Noun,11,4,7,6.668889629876625e-05,9.995779559741441e-05,0.6363636363636364
9902,9902,이지훈/Noun,11,4,7,6.668889629876625e-05,9.995779559741441e-05,0.6363636363636364
9903,9903,었/Noun,11,7,4,0.0001000333444481494,6.663853039827628e-05,0.6363636363636364
9904,9904,출중하다/Adjective,11,7,4,0.0001000333444481494,6.663853039827628e-05,0.6363636363636364
9905,9905,견줄만/Noun,11,7,4,0.0001000333444481494,6.663853039827628e-05,0.6363636363636364
9906,9906,비감/Noun,11,4,7,6.668889629876625e-05,9.995779559741441e-05,0.6363636363636364
9907,9907,건네다/Verb,11,7,4,0.0001000333444481494,6.663853039827628e-05,0.6363636363636364
9908,9908,정지/Noun,11,7,4,0.0001000333444481494,6.663853039827628e-05,0.6363636363636364
9909,9909,임무/Noun,11,4,7,6.668889629876625e-05,9.995779559741441e-05,0.6363636363636364
9910,9910,산트/Noun,11,7,4,0.0001000333444481494,6.663853039827628e-05,0.6363636363636364
9911,9911,열등감/Noun,11,4,7,6.668889629876625e-05,9.995779559741441e-05,0.6363636363636364
9912,9912,헛점/Noun,11,4,7,6.668889629876625e-05,9.995779559741441e-05,0.6363636363636364
9913,9913,솔솔/Noun,11,4,7,6.668889629876625e-05,9.995779559741441e-05,0.6363636363636364
9914,9914,천장/Noun,11,7,4,0.0001000333444481494,6.663853039827628e-05,0.6363636363636364
9915,9915,우치/Noun,11,7,4,0.0001000333444481494,6.663853039827628e-05,0.6363636363636364
9916,9916,화비/Noun,11,4,7,6.668889629876625e-05,9.995779559741441e-05,0.6363636363636364
9917,9917,뚱뚱하다/Adjective,11,4,7,6.668889629876625e-05,9.995779559741441e-05,0.6363636363636364
9918,9918,본드걸/Noun,11,7,4,0.0001000333444481494,6.663853039827628e-05,0.6363636363636364
9919,9919,집시/Noun,11,7,4,0.0001000333444481494,6.663853039827628e-05,0.6363636363636364
9920,9920,퀄러티/Noun,11,7,4,0.0001000333444481494,6.663853039827628e-05,0.6363636363636364
9921,9921,분열/Noun,11,4,7,6.668889629876625e-05,9.995779559741441e-05,0.6363636363636364
9922,9922,후우/Exclamation,11,4,7,6.668889629876625e-05,9.995779559741441e-05,0.6363636363636364
9923,9923,배창호/Noun,11,7,4,0.0001000333444481494,6.663853039827628e-05,0.6363636363636364
9924,9924,팝송/Noun,11,4,7,6.668889629876625e-05,9.995779559741441e-05,0.6363636363636364
9925,9925,열악하다/Adjective,11,4,7,6.668889629876625e-05,9.995779559741441e-05,0.6363636363636364
9926,9926,악랄하다/Adjective,11,7,4,0.0001000333444481494,6.663853039827628e-05,0.6363636363636364
9927,9927,오멘/Noun,11,7,4,0.0001000333444481494,6.663853039827628e-05,0.6363636363636364
9928,9928,머시/Noun,11,7,4,0.0001000333444481494,6.663853039827628e-05,0.6363636363636364
9929,9929,열광/Noun,11,7,4,0.0001000333444481494,6.663853039827628e-05,0.6363636363636364
9930,9930,아보/Noun,11,4,7,6.668889629876625e-05,9.995779559741441e-05,0.6363636363636364
9931,9931,숨기/Noun,11,4,7,6.668889629876625e-05,9.995779559741441e-05,0.6363636363636364
9932,9932,퍼/PreEomi,11,4,7,6.668889629876625e-05,9.995779559741441e-05,0.6363636363636364
9933,9933,러쉬/Noun,11,7,4,0.0001000333444481494,6.663853039827628e-05,0.6363636363636364
9934,9934,반올림/Noun,11,4,7,6.668889629876625e-05,9.995779559741441e-05,0.6363636363636364
9935,9935,이하고/Josa,11,4,7,6.668889629876625e-05,9.995779559741441e-05,0.6363636363636364
9936,9936,종자/Noun,11,4,7,6.668889629876625e-05,9.995779559741441e-05,0.6363636363636364
9937,9937,더구나/Noun,11,4,7,6.668889629876625e-05,9.995779559741441e-05,0.6363636363636364
9938,9938,톰슨/Noun,11,7,4,0.0001000333444481494,6.663853039827628e-05,0.6363636363636364
9939,9939,사이드/Noun,11,7,4,0.0001000333444481494,6.663853039827628e-05,0.6363636363636364
9940,9940,가트/Noun,11,7,4,0.0001000333444481494,6.663853039827628e-05,0.6363636363636364
9941,9941,일제시대/Noun,11,7,4,0.0001000333444481494,6.663853039827628e-05,0.6363636363636364
9942,9942,씨부리다/Verb,11,4,7,6.668889629876625e-05,9.995779559741441e-05,0.6363636363636364
9943,9943,다리다/Verb,11,4,7,6.668889629876625e-05,9.995779559741441e-05,0.6363636363636364
9944,9944,총각/Noun,11,4,7,6.668889629876625e-05,9.995779559741441e-05,0.6363636363636364
9945,9945,자서/Noun,11,4,7,6.668889629876625e-05,9.995779559741441e-05,0.6363636363636364
9946,9946,쿄코/Noun,11,4,7,6.668889629876625e-05,9.995779559741441e-05,0.6363636363636364
9947,9947,롤러코스터/Noun,11,7,4,0.0001000333444481494,6.663853039827628e-05,0.6363636363636364
9948,9948,세영/Noun,11,4,7,6.668889629876625e-05,9.995779559741441e-05,0.6363636363636364
9949,9949,호수/Noun,11,7,4,0.0001000333444481494,6.663853039827628e-05,0.6363636363636364
9950,9950,장고/Noun,11,7,4,0.0001000333444481494,6.663853039827628e-05,0.6363636363636364
9951,9951,간장/Noun,11,4,7,6.668889629876625e-05,9.995779559741441e-05,0.6363636363636364
9952,9952,으로서는/Josa,11,4,7,6.668889629876625e-05,9.995779559741441e-05,0.6363636363636364
9953,9953,수상작/Noun,11,7,4,0.0001000333444481494,6.663853039827628e-05,0.6363636363636364
9954,9954,거북이/Noun,11,7,4,0.0001000333444481494,6.663853039827628e-05,0.6363636363636364
9955,9955,맨오브스틸/Noun,11,4,7,6.668889629876625e-05,9.995779559741441e-05,0.6363636363636364
9956,9956,매니저/Noun,11,4,7,6.668889629876625e-05,9.995779559741441e-05,0.6363636363636364
9957,9957,김일성/Noun,11,4,7,6.668889629876625e-05,9.995779559741441e-05,0.6363636363636364
9958,9958,ㄲ/KoreanParticle,11,4,7,6.668889629876625e-05,9.995779559741441e-05,0.6363636363636364
9959,9959,앓다/Verb,11,7,4,0.0001000333444481494,6.663853039827628e-05,0.6363636363636364
9960,9960,퍼시픽림/Noun,11,4,7,6.668889629876625e-05,9.995779559741441e-05,0.6363636363636364
9961,9961,전원/Noun,11,4,7,6.668889629876625e-05,9.995779559741441e-05,0.6363636363636364
9962,9962,샤넬/Noun,11,4,7,6.668889629876625e-05,9.995779559741441e-05,0.6363636363636364
9963,9963,60분/Number,11,4,7,6.668889629876625e-05,9.995779559741441e-05,0.6363636363636364
9964,9964,심혜진/Noun,11,4,7,6.668889629876625e-05,9.995779559741441e-05,0.6363636363636364
9965,9965,제기/Noun,11,4,7,6.668889629876625e-05,9.995779559741441e-05,0.6363636363636364
9966,9966,도우/Noun,11,7,4,0.0001000333444481494,6.663853039827628e-05,0.6363636363636364
9967,9967,에두/Noun,11,4,7,6.668889629876625e-05,9.995779559741441e-05,0.6363636363636364
9968,9968,스트/Noun,11,4,7,6.668889629876625e-05,9.995779559741441e-05,0.6363636363636364
9969,9969,창고/Noun,11,4,7,6.668889629876625e-05,9.995779559741441e-05,0.6363636363636364
9970,9970,도심/Noun,11,7,4,0.0001000333444481494,6.663853039827628e-05,0.6363636363636364
9971,9971,메가폰/Noun,11,4,7,6.668889629876625e-05,9.995779559741441e-05,0.6363636363636364
9972,9972,카밀라/Noun,11,4,7,6.668889629876625e-05,9.995779559741441e-05,0.6363636363636364
9973,9973,계승/Noun,11,7,4,0.0001000333444481494,6.663853039827628e-05,0.6363636363636364
9974,9974,김새론/Noun,11,7,4,0.0001000333444481494,6.663853039827628e-05,0.6363636363636364
9975,9975,한지혜/Noun,11,7,4,0.0001000333444481494,6.663853039827628e-05,0.6363636363636364
9976,9976,부도/Noun,11,7,4,0.0001000333444481494,6.663853039827628e-05,0.6363636363636364
9977,9977,아아/Exclamation,11,4,7,6.668889629876625e-05,9.995779559741441e-05,0.6363636363636364
9978,9978,민정/Noun,11,4,7,6.668889629876625e-05,9.995779559741441e-05,0.6363636363636364
9979,9979,만발/Noun,11,4,7,6.668889629876625e-05,9.995779559741441e-05,0.6363636363636364
9980,9980,82년/Number,11,7,4,0.0001000333444481494,6.663853039827628e-05,0.6363636363636364
9981,9981,모가지/Noun,11,4,7,6.668889629876625e-05,9.995779559741441e-05,0.6363636363636364
9982,9982,왼쪽/Noun,11,4,7,6.668889629876625e-05,9.995779559741441e-05,0.6363636363636364
9983,9983,트랩/Noun,11,4,7,6.668889629876625e-05,9.995779559741441e-05,0.6363636363636364
9984,9984,맹인/Noun,11,7,4,0.0001000333444481494,6.663853039827628e-05,0.6363636363636364
9985,9985,보완/Noun,11,4,7,6.668889629876625e-05,9.995779559741441e-05,0.6363636363636364
9986,9986,거인/Noun,11,4,7,6.668889629876625e-05,9.995779559741441e-05,0.6363636363636364
9987,9987,포세이돈/Noun,11,7,4,0.0001000333444481494,6.663853039827628e-05,0.6363636363636364
9988,9988,마감/Noun,11,4,7,6.668889629876625e-05,9.995779559741441e-05,0.6363636363636364
9989,9989,캐나다/Noun,11,4,7,6.668889629876625e-05,9.995779559741441e-05,0.6363636363636364
9990,9990,코멘트/Noun,11,7,4,0.0001000333444481494,6.663853039827628e-05,0.6363636363636364
9991,9991,오라/Noun,11,4,7,6.668889629876625e-05,9.995779559741441e-05,0.6363636363636364
9992,9992,현혹/Noun,11,4,7,6.668889629876625e-05,9.995779559741441e-05,0.6363636363636364
9993,9993,부시다/Verb,11,4,7,6.668889629876625e-05,9.995779559741441e-05,0.6363636363636364
9994,9994,고니/Noun,11,7,4,0.0001000333444481494,6.663853039827628e-05,0.6363636363636364
9995,9995,설사/Noun,11,4,7,6.668889629876625e-05,9.995779559741441e-05,0.6363636363636364
9996,9996,토로/Noun,11,7,4,0.0001000333444481494,6.663853039827628e-05,0.6363636363636364
9997,9997,****)/Punctuation,11,7,4,0.0001000333444481494,6.663853039827628e-05,0.6363636363636364
9998,9998,일그러지다/Verb,11,7,4,0.0001000333444481494,6.663853039827628e-05,0.6363636363636364
9999,9999,성실하다/Adjective,11,4,7,6.668889629876625e-05,9.995779559741441e-05,0.6363636363636364
10000,10000,튼튼하다/Adjective,11,7,4,0.0001000333444481494,6.663853039827628e-05,0.6363636363636364
10001,10001,룬드/Noun,11,7,4,0.0001000333444481494,6.663853039827628e-05,0.6363636363636364
10002,10002,저하/Noun,11,4,7,6.668889629876625e-05,9.995779559741441e-05,0.6363636363636364
10003,10003,주소/Noun,11,7,4,0.0001000333444481494,6.663853039827628e-05,0.6363636363636364
10004,10004,괴물영화/Noun,11,7,4,0.0001000333444481494,6.663853039827628e-05,0.6363636363636364
10005,10005,빈자리/Noun,11,7,4,0.0001000333444481494,6.663853039827628e-05,0.6363636363636364
10006,10006,오도/Noun,11,7,4,0.0001000333444481494,6.663853039827628e-05,0.6363636363636364
10007,10007,마린/Noun,11,4,7,6.668889629876625e-05,9.995779559741441e-05,0.6363636363636364
10008,10008,뉘/Noun,11,4,7,6.668889629876625e-05,9.995779559741441e-05,0.6363636363636364
10009,10009,cctv/Alpha,11,4,7,6.668889629876625e-05,9.995779559741441e-05,0.6363636363636364
10010,10010,딸내미/Noun,11,4,7,6.668889629876625e-05,9.995779559741441e-05,0.6363636363636364
10011,10011,비견/Noun,11,7,4,0.0001000333444481494,6.663853039827628e-05,0.6363636363636364
10012,10012,우유/Noun,11,6,5,8.891852839835501e-05,7.774495213132233e-05,0.5454545454545454
10013,10013,4일/Number,11,6,5,8.891852839835501e-05,7.774495213132233e-05,0.5454545454545454
10014,10014,청불/Noun,11,5,6,7.780371234856063e-05,8.885137386436837e-05,0.5454545454545454
10015,10015,중사/Noun,11,5,6,7.780371234856063e-05,8.885137386436837e-05,0.5454545454545454
10016,10016,힐러/Noun,11,5,6,7.780371234856063e-05,8.885137386436837e-05,0.5454545454545454
10017,10017,윈/Noun,11,6,5,8.891852839835501e-05,7.774495213132233e-05,0.5454545454545454
10018,10018,비아/Noun,11,5,6,7.780371234856063e-05,8.885137386436837e-05,0.5454545454545454
10019,10019,컴플렉스/Noun,11,6,5,8.891852839835501e-05,7.774495213132233e-05,0.5454545454545454
10020,10020,적지/Noun,11,6,5,8.891852839835501e-05,7.774495213132233e-05,0.5454545454545454
10021,10021,투캅스/Noun,11,5,6,7.780371234856063e-05,8.885137386436837e-05,0.5454545454545454
10022,10022,데이비스/Noun,11,6,5,8.891852839835501e-05,7.774495213132233e-05,0.5454545454545454
10023,10023,어짜피/Adverb,11,5,6,7.780371234856063e-05,8.885137386436837e-05,0.5454545454545454
10024,10024,동작/Noun,11,6,5,8.891852839835501e-05,7.774495213132233e-05,0.5454545454545454
10025,10025,이재용/Noun,11,5,6,7.780371234856063e-05,8.885137386436837e-05,0.5454545454545454
10026,10026,코피/Noun,11,6,5,8.891852839835501e-05,7.774495213132233e-05,0.5454545454545454
10027,10027,우릴/Noun,11,6,5,8.891852839835501e-05,7.774495213132233e-05,0.5454545454545454
10028,10028,면적/Noun,11,5,6,7.780371234856063e-05,8.885137386436837e-05,0.5454545454545454
10029,10029,세얼간이/Noun,11,5,6,7.780371234856063e-05,8.885137386436837e-05,0.5454545454545454
10030,10030,흙/Noun,11,6,5,8.891852839835501e-05,7.774495213132233e-05,0.5454545454545454
10031,10031,..???/Punctuation,11,5,6,7.780371234856063e-05,8.885137386436837e-05,0.5454545454545454
10032,10032,차서/Noun,11,5,6,7.780371234856063e-05,8.885137386436837e-05,0.5454545454545454
10033,10033,에스/Noun,11,5,6,7.780371234856063e-05,8.885137386436837e-05,0.5454545454545454
10034,10034,룸메이트/Noun,11,5,6,7.780371234856063e-05,8.885137386436837e-05,0.5454545454545454
10035,10035,점안/Noun,11,6,5,8.891852839835501e-05,7.774495213132233e-05,0.5454545454545454
10036,10036,이하늬/Noun,11,6,5,8.891852839835501e-05,7.774495213132233e-05,0.5454545454545454
10037,10037,\/Punctuation,11,6,5,8.891852839835501e-05,7.774495213132233e-05,0.5454545454545454
10038,10038,이랬는데/Conjunction,11,5,6,7.780371234856063e-05,8.885137386436837e-05,0.5454545454545454
10039,10039,라붐/Noun,11,6,5,8.891852839835501e-05,7.774495213132233e-05,0.5454545454545454
10040,10040,확률/Noun,11,6,5,8.891852839835501e-05,7.774495213132233e-05,0.5454545454545454
10041,10041,아멘/Noun,11,5,6,7.780371234856063e-05,8.885137386436837e-05,0.5454545454545454
10042,10042,cf/Alpha,11,5,6,7.780371234856063e-05,8.885137386436837e-05,0.5454545454545454
10043,10043,간디/Noun,11,6,5,8.891852839835501e-05,7.774495213132233e-05,0.5454545454545454
10044,10044,각오/Noun,11,6,5,8.891852839835501e-05,7.774495213132233e-05,0.5454545454545454
10045,10045,누적/Noun,11,5,6,7.780371234856063e-05,8.885137386436837e-05,0.5454545454545454
10046,10046,허드슨/Noun,11,5,6,7.780371234856063e-05,8.885137386436837e-05,0.5454545454545454
10047,10047,!../Punctuation,11,5,6,7.780371234856063e-05,8.885137386436837e-05,0.5454545454545454
10048,10048,승천/Noun,11,6,5,8.891852839835501e-05,7.774495213132233e-05,0.5454545454545454
10049,10049,세인/Noun,11,5,6,7.780371234856063e-05,8.885137386436837e-05,0.5454545454545454
10050,10050,여행가/Noun,11,6,5,8.891852839835501e-05,7.774495213132233e-05,0.5454545454545454
10051,10051,큐브릭/Noun,11,6,5,8.891852839835501e-05,7.774495213132233e-05,0.5454545454545454
10052,10052,계륜미/Noun,11,5,6,7.780371234856063e-05,8.885137386436837e-05,0.5454545454545454
10053,10053,구한/Noun,11,6,5,8.891852839835501e-05,7.774495213132233e-05,0.5454545454545454
10054,10054,음침하다/Adjective,11,6,5,8.891852839835501e-05,7.774495213132233e-05,0.5454545454545454
10055,10055,7월/Number,11,5,6,7.780371234856063e-05,8.885137386436837e-05,0.5454545454545454
10056,10056,화류/Noun,11,5,6,7.780371234856063e-05,8.885137386436837e-05,0.5454545454545454
10057,10057,늑대소년/Noun,11,5,6,7.780371234856063e-05,8.885137386436837e-05,0.5454545454545454
10058,10058,특별출연/Noun,11,6,5,8.891852839835501e-05,7.774495213132233e-05,0.5454545454545454
10059,10059,중경삼림/Noun,11,6,5,8.891852839835501e-05,7.774495213132233e-05,0.5454545454545454
10060,10060,처키/Noun,11,6,5,8.891852839835501e-05,7.774495213132233e-05,0.5454545454545454
10061,10061,솔까말/Noun,11,5,6,7.780371234856063e-05,8.885137386436837e-05,0.5454545454545454
10062,10062,빗나가다/Verb,11,5,6,7.780371234856063e-05,8.885137386436837e-05,0.5454545454545454
10063,10063,부잣집/Noun,11,5,6,7.780371234856063e-05,8.885137386436837e-05,0.5454545454545454
10064,10064,제트/Noun,11,5,6,7.780371234856063e-05,8.885137386436837e-05,0.5454545454545454
10065,10065,야마다/Noun,11,6,5,8.891852839835501e-05,7.774495213132233e-05,0.5454545454545454
10066,10066,셧/Noun,11,5,6,7.780371234856063e-05,8.885137386436837e-05,0.5454545454545454
10067,10067,사토미/Noun,11,6,5,8.891852839835501e-05,7.774495213132233e-05,0.5454545454545454
10068,10068,학도/Noun,11,6,5,8.891852839835501e-05,7.774495213132233e-05,0.5454545454545454
10069,10069,에볼루션/Noun,11,6,5,8.891852839835501e-05,7.774495213132233e-05,0.5454545454545454
10070,10070,.~~/Punctuation,11,5,6,7.780371234856063e-05,8.885137386436837e-05,0.5454545454545454
10071,10071,러너/Noun,11,5,6,7.780371234856063e-05,8.885137386436837e-05,0.5454545454545454
10072,10072,로맨틱영화/Noun,11,6,5,8.891852839835501e-05,7.774495213132233e-05,0.5454545454545454
10073,10073,난뒤/Noun,11,6,5,8.891852839835501e-05,7.774495213132233e-05,0.5454545454545454
10074,10074,스완/Noun,11,6,5,8.891852839835501e-05,7.774495213132233e-05,0.5454545454545454
10075,10075,가/Foreign,11,6,5,8.891852839835501e-05,7.774495213132233e-05,0.5454545454545454
10076,10076,브라/Noun,11,6,5,8.891852839835501e-05,7.774495213132233e-05,0.5454545454545454
10077,10077,클로이/Noun,11,6,5,8.891852839835501e-05,7.774495213132233e-05,0.5454545454545454
10078,10078,빌딩/Noun,11,5,6,7.780371234856063e-05,8.885137386436837e-05,0.5454545454545454
10079,10079,공산주의/Noun,11,5,6,7.780371234856063e-05,8.885137386436837e-05,0.5454545454545454
10080,10080,깁슨/Noun,11,6,5,8.891852839835501e-05,7.774495213132233e-05,0.5454545454545454
10081,10081,럭/Noun,11,6,5,8.891852839835501e-05,7.774495213132233e-05,0.5454545454545454
10082,10082,보복/Noun,11,5,6,7.780371234856063e-05,8.885137386436837e-05,0.5454545454545454
10083,10083,아랍/Noun,11,6,5,8.891852839835501e-05,7.774495213132233e-05,0.5454545454545454
10084,10084,반란/Noun,11,6,5,8.891852839835501e-05,7.774495213132233e-05,0.5454545454545454
10085,10085,발버둥치다/Verb,11,6,5,8.891852839835501e-05,7.774495213132233e-05,0.5454545454545454
10086,10086,연우진/Noun,11,6,5,8.891852839835501e-05,7.774495213132233e-05,0.5454545454545454
10087,10087,엄지/Noun,11,6,5,8.891852839835501e-05,7.774495213132233e-05,0.5454545454545454
10088,10088,접속/Noun,11,5,6,7.780371234856063e-05,8.885137386436837e-05,0.5454545454545454
10089,10089,상세/Noun,11,5,6,7.780371234856063e-05,8.885137386436837e-05,0.5454545454545454
10090,10090,선조/Noun,11,5,6,7.780371234856063e-05,8.885137386436837e-05,0.5454545454545454
10091,10091,".,,/Punctuation",11,6,5,8.891852839835501e-05,7.774495213132233e-05,0.5454545454545454
10092,10092,소의/Noun,11,6,5,8.891852839835501e-05,7.774495213132233e-05,0.5454545454545454
10093,10093,조윤희/Noun,11,5,6,7.780371234856063e-05,8.885137386436837e-05,0.5454545454545454
10094,10094,어진/Noun,11,6,5,8.891852839835501e-05,7.774495213132233e-05,0.5454545454545454
10095,10095,플래툰/Noun,11,6,5,8.891852839835501e-05,7.774495213132233e-05,0.5454545454545454
10096,10096,슬링/Noun,11,6,5,8.891852839835501e-05,7.774495213132233e-05,0.5454545454545454
10097,10097,역습/Noun,11,5,6,7.780371234856063e-05,8.885137386436837e-05,0.5454545454545454
10098,10098,윤하/Noun,11,5,6,7.780371234856063e-05,8.885137386436837e-05,0.5454545454545454
10099,10099,모레/Noun,11,6,5,8.891852839835501e-05,7.774495213132233e-05,0.5454545454545454
10100,10100,열쇠/Noun,11,6,5,8.891852839835501e-05,7.774495213132233e-05,0.5454545454545454
10101,10101,조정석/Noun,11,6,5,8.891852839835501e-05,7.774495213132233e-05,0.5454545454545454
10102,10102,틀림/Noun,11,5,6,7.780371234856063e-05,8.885137386436837e-05,0.5454545454545454
10103,10103,군상/Noun,11,5,6,7.780371234856063e-05,8.885137386436837e-05,0.5454545454545454
10104,10104,vod/Alpha,11,5,6,7.780371234856063e-05,8.885137386436837e-05,0.5454545454545454
10105,10105,제타/Noun,11,6,5,8.891852839835501e-05,7.774495213132233e-05,0.5454545454545454
10106,10106,김민선/Noun,11,5,6,7.780371234856063e-05,8.885137386436837e-05,0.5454545454545454
10107,10107,와일드/Noun,11,5,6,7.780371234856063e-05,8.885137386436837e-05,0.5454545454545454
10108,10108,소유자/Noun,11,5,6,7.780371234856063e-05,8.885137386436837e-05,0.5454545454545454
10109,10109,송은채/Noun,11,5,6,7.780371234856063e-05,8.885137386436837e-05,0.5454545454545454
10110,10110,역전/Noun,11,6,5,8.891852839835501e-05,7.774495213132233e-05,0.5454545454545454
10111,10111,코스/Noun,11,6,5,8.891852839835501e-05,7.774495213132233e-05,0.5454545454545454
10112,10112,결단/Noun,11,5,6,7.780371234856063e-05,8.885137386436837e-05,0.5454545454545454
10113,10113,오른/Noun,11,6,5,8.891852839835501e-05,7.774495213132233e-05,0.5454545454545454
10114,10114,배타/Noun,11,6,5,8.891852839835501e-05,7.774495213132233e-05,0.5454545454545454
10115,10115,통통/Noun,11,6,5,8.891852839835501e-05,7.774495213132233e-05,0.5454545454545454
10116,10116,베스타/Noun,11,6,5,8.891852839835501e-05,7.774495213132233e-05,0.5454545454545454
10117,10117,난건/Noun,11,6,5,8.891852839835501e-05,7.774495213132233e-05,0.5454545454545454
10118,10118,빗대다/Verb,11,6,5,8.891852839835501e-05,7.774495213132233e-05,0.5454545454545454
10119,10119,지점/Noun,11,6,5,8.891852839835501e-05,7.774495213132233e-05,0.5454545454545454
10120,10120,유심/Noun,11,5,6,7.780371234856063e-05,8.885137386436837e-05,0.5454545454545454
10121,10121,델/Noun,11,6,5,8.891852839835501e-05,7.774495213132233e-05,0.5454545454545454
10122,10122,브라운관/Noun,11,5,6,7.780371234856063e-05,8.885137386436837e-05,0.5454545454545454
10123,10123,로스트/Noun,11,5,6,7.780371234856063e-05,8.885137386436837e-05,0.5454545454545454
10124,10124,다이나믹/Noun,11,6,5,8.891852839835501e-05,7.774495213132233e-05,0.5454545454545454
10125,10125,화학/Noun,11,5,6,7.780371234856063e-05,8.885137386436837e-05,0.5454545454545454
10126,10126,목록/Noun,11,6,5,8.891852839835501e-05,7.774495213132233e-05,0.5454545454545454
10127,10127,카메론디아즈/Noun,11,5,6,7.780371234856063e-05,8.885137386436837e-05,0.5454545454545454
10128,10128,추격씬/Noun,11,5,6,7.780371234856063e-05,8.885137386436837e-05,0.5454545454545454
10129,10129,결핍/Noun,11,6,5,8.891852839835501e-05,7.774495213132233e-05,0.5454545454545454
10130,10130,폴리스/Noun,11,6,5,8.891852839835501e-05,7.774495213132233e-05,0.5454545454545454
10131,10131,야기/Noun,11,6,5,8.891852839835501e-05,7.774495213132233e-05,0.5454545454545454
10132,10132,해방/Noun,11,6,5,8.891852839835501e-05,7.774495213132233e-05,0.5454545454545454
10133,10133,테스/Noun,11,5,6,7.780371234856063e-05,8.885137386436837e-05,0.5454545454545454
10134,10134,엄지원/Noun,11,6,5,8.891852839835501e-05,7.774495213132233e-05,0.5454545454545454
10135,10135,목격/Noun,11,6,5,8.891852839835501e-05,7.774495213132233e-05,0.5454545454545454
10136,10136,맴버/Noun,11,6,5,8.891852839835501e-05,7.774495213132233e-05,0.5454545454545454
10137,10137,떨치다/Verb,11,5,6,7.780371234856063e-05,8.885137386436837e-05,0.5454545454545454
10138,10138,연제욱/Noun,11,6,5,8.891852839835501e-05,7.774495213132233e-05,0.5454545454545454
10139,10139,불치/Noun,11,6,5,8.891852839835501e-05,7.774495213132233e-05,0.5454545454545454
10140,10140,손현주/Noun,11,6,5,8.891852839835501e-05,7.774495213132233e-05,0.5454545454545454
10141,10141,따갑다/Adjective,11,5,6,7.780371234856063e-05,8.885137386436837e-05,0.5454545454545454
10142,10142,떠다니다/Verb,11,6,5,8.891852839835501e-05,7.774495213132233e-05,0.5454545454545454
10143,10143,령/Noun,11,5,6,7.780371234856063e-05,8.885137386436837e-05,0.5454545454545454
10144,10144,들키다/Verb,11,6,5,8.891852839835501e-05,7.774495213132233e-05,0.5454545454545454
10145,10145,규모/Noun,11,5,6,7.780371234856063e-05,8.885137386436837e-05,0.5454545454545454
10146,10146,의젖/Noun,10,0,10,2.2229632099588756e-05,0.00013327706079655256,1.0
10147,10147,본전/Noun,10,0,10,2.2229632099588756e-05,0.00013327706079655256,1.0
10148,10148,forever/Alpha,10,10,0,0.0001333777925975325,2.2212843466092093e-05,1.0
10149,10149,로고/Noun,10,0,10,2.2229632099588756e-05,0.00013327706079655256,1.0
10150,10150,정겨운/Noun,10,10,0,0.0001333777925975325,2.2212843466092093e-05,1.0
10151,10151,검증/Noun,10,0,10,2.2229632099588756e-05,0.00013327706079655256,1.0
10152,10152,마틸다/Noun,10,10,0,0.0001333777925975325,2.2212843466092093e-05,1.0
10153,10153,주르륵/Noun,10,10,0,0.0001333777925975325,2.2212843466092093e-05,1.0
10154,10154,쟈니/Noun,10,10,0,0.0001333777925975325,2.2212843466092093e-05,1.0
10155,10155,소나/Noun,10,0,10,2.2229632099588756e-05,0.00013327706079655256,1.0
10156,10156,에스티/Noun,10,10,0,0.0001333777925975325,2.2212843466092093e-05,1.0
10157,10157,trash/Alpha,10,0,10,2.2229632099588756e-05,0.00013327706079655256,1.0
10158,10158,벅차오르다/Adjective,10,10,0,0.0001333777925975325,2.2212843466092093e-05,1.0
10159,10159,증발/Noun,10,0,10,2.2229632099588756e-05,0.00013327706079655256,1.0
10160,10160,제데로/Adverb,10,0,10,2.2229632099588756e-05,0.00013327706079655256,1.0
10161,10161,비디오영화/Noun,10,0,10,2.2229632099588756e-05,0.00013327706079655256,1.0
10162,10162,욱일승천기/Noun,10,0,10,2.2229632099588756e-05,0.00013327706079655256,1.0
10163,10163,베르세르크/Noun,10,10,0,0.0001333777925975325,2.2212843466092093e-05,1.0
10164,10164,미자/Noun,10,10,0,0.0001333777925975325,2.2212843466092093e-05,1.0
10165,10165,숨죽/Noun,10,10,0,0.0001333777925975325,2.2212843466092093e-05,1.0
10166,10166,안재욱/Noun,10,10,0,0.0001333777925975325,2.2212843466092093e-05,1.0
10167,10167,8.0/Number,10,10,0,0.0001333777925975325,2.2212843466092093e-05,1.0
10168,10168,아낌없다/Adjective,10,10,0,0.0001333777925975325,2.2212843466092093e-05,1.0
10169,10169,떡칠/Noun,10,0,10,2.2229632099588756e-05,0.00013327706079655256,1.0
10170,10170,부조화/Noun,10,0,10,2.2229632099588756e-05,0.00013327706079655256,1.0
10171,10171,great/Alpha,10,10,0,0.0001333777925975325,2.2212843466092093e-05,1.0
10172,10172,베끼기/Noun,10,0,10,2.2229632099588756e-05,0.00013327706079655256,1.0
10173,10173,마음씨/Noun,10,10,0,0.0001333777925975325,2.2212843466092093e-05,1.0
10174,10174,송희진/Noun,10,0,10,2.2229632099588756e-05,0.00013327706079655256,1.0
10175,10175,정선희/Noun,10,0,10,2.2229632099588756e-05,0.00013327706079655256,1.0
10176,10176,:-)/Punctuation,10,10,0,0.0001333777925975325,2.2212843466092093e-05,1.0
10177,10177,불체/Noun,10,0,10,2.2229632099588756e-05,0.00013327706079655256,1.0
10178,10178,집기/Noun,10,0,10,2.2229632099588756e-05,0.00013327706079655256,1.0
10179,10179,존멋/Noun,10,10,0,0.0001333777925975325,2.2212843466092093e-05,1.0
10180,10180,♥♥♥♥♥/Foreign,10,10,0,0.0001333777925975325,2.2212843466092093e-05,1.0
10181,10181,~!^^/Punctuation,10,10,0,0.0001333777925975325,2.2212843466092093e-05,1.0
10182,10182,생쇼/Noun,10,0,10,2.2229632099588756e-05,0.00013327706079655256,1.0
10183,10183,이지마/Noun,10,0,10,2.2229632099588756e-05,0.00013327706079655256,1.0
10184,10184,영문/Noun,10,0,10,2.2229632099588756e-05,0.00013327706079655256,1.0
10185,10185,차만/Noun,10,0,10,2.2229632099588756e-05,0.00013327706079655256,1.0
10186,10186,벡터맨/Noun,10,0,10,2.2229632099588756e-05,0.00013327706079655256,1.0
10187,10187,ㅗㅗㅗ/KoreanParticle,10,0,10,2.2229632099588756e-05,0.00013327706079655256,1.0
10188,10188,ㅠㅜㅠ/KoreanParticle,10,10,0,0.0001333777925975325,2.2212843466092093e-05,1.0
10189,10189,윤제균/Noun,10,0,10,2.2229632099588756e-05,0.00013327706079655256,1.0
10190,10190,우연찮/Noun,10,10,0,0.0001333777925975325,2.2212843466092093e-05,1.0
10191,10191,루비/Noun,10,1,9,3.334444814938313e-05,0.00012217063906350652,0.9
10192,10192,안면/Noun,10,1,9,3.334444814938313e-05,0.00012217063906350652,0.9
10193,10193,공사/Noun,10,1,9,3.334444814938313e-05,0.00012217063906350652,0.9
10194,10194,이기만/Noun,10,1,9,3.334444814938313e-05,0.00012217063906350652,0.9
10195,10195,하희라/Noun,10,1,9,3.334444814938313e-05,0.00012217063906350652,0.9
10196,10196,사살/Noun,10,1,9,3.334444814938313e-05,0.00012217063906350652,0.9
10197,10197,차도/Noun,10,1,9,3.334444814938313e-05,0.00012217063906350652,0.9
10198,10198,맘속/Noun,10,9,1,0.00012226297654773814,3.331926519913814e-05,0.9
10199,10199,고삐/Noun,10,1,9,3.334444814938313e-05,0.00012217063906350652,0.9
10200,10200,도용/Noun,10,1,9,3.334444814938313e-05,0.00012217063906350652,0.9
10201,10201,쉴드치다/Verb,10,1,9,3.334444814938313e-05,0.00012217063906350652,0.9
10202,10202,몰살/Noun,10,1,9,3.334444814938313e-05,0.00012217063906350652,0.9
10203,10203,모시/Noun,10,9,1,0.00012226297654773814,3.331926519913814e-05,0.9
10204,10204,이데올로기/Noun,10,9,1,0.00012226297654773814,3.331926519913814e-05,0.9
10205,10205,왈칵/Noun,10,9,1,0.00012226297654773814,3.331926519913814e-05,0.9
10206,10206,박서준/Noun,10,9,1,0.00012226297654773814,3.331926519913814e-05,0.9
10207,10207,익살스럽다/Adjective,10,9,1,0.00012226297654773814,3.331926519913814e-05,0.9
10208,10208,지민/Noun,10,9,1,0.00012226297654773814,3.331926519913814e-05,0.9
10209,10209,기획사/Noun,10,1,9,3.334444814938313e-05,0.00012217063906350652,0.9
10210,10210,대게/Noun,10,9,1,0.00012226297654773814,3.331926519913814e-05,0.9
10211,10211,하향/Noun,10,1,9,3.334444814938313e-05,0.00012217063906350652,0.9
10212,10212,0%/Number,10,1,9,3.334444814938313e-05,0.00012217063906350652,0.9
10213,10213,ㅜㅠㅠ/KoreanParticle,10,9,1,0.00012226297654773814,3.331926519913814e-05,0.9
10214,10214,엠/Noun,10,1,9,3.334444814938313e-05,0.00012217063906350652,0.9
10215,10215,...-_-;/Punctuation,10,1,9,3.334444814938313e-05,0.00012217063906350652,0.9
10216,10216,발단/Noun,10,1,9,3.334444814938313e-05,0.00012217063906350652,0.9
10217,10217,줏대/Noun,10,1,9,3.334444814938313e-05,0.00012217063906350652,0.9
10218,10218,비밥/Noun,10,9,1,0.00012226297654773814,3.331926519913814e-05,0.9
10219,10219,처분/Noun,10,1,9,3.334444814938313e-05,0.00012217063906350652,0.9
10220,10220,통렬/Noun,10,9,1,0.00012226297654773814,3.331926519913814e-05,0.9
10221,10221,지리멸렬하다/Adjective,10,1,9,3.334444814938313e-05,0.00012217063906350652,0.9
10222,10222,^^!/Punctuation,10,9,1,0.00012226297654773814,3.331926519913814e-05,0.9
10223,10223,2~3/Number,10,1,9,3.334444814938313e-05,0.00012217063906350652,0.9
10224,10224,그루지/Noun,10,1,9,3.334444814938313e-05,0.00012217063906350652,0.9
10225,10225,타지/Noun,10,9,1,0.00012226297654773814,3.331926519913814e-05,0.9
10226,10226,추잡/Noun,10,1,9,3.334444814938313e-05,0.00012217063906350652,0.9
10227,10227,사회생활/Noun,10,9,1,0.00012226297654773814,3.331926519913814e-05,0.9
10228,10228,120분/Number,10,1,9,3.334444814938313e-05,0.00012217063906350652,0.9
10229,10229,단서/Noun,10,1,9,3.334444814938313e-05,0.00012217063906350652,0.9
10230,10230,전주/Noun,10,9,1,0.00012226297654773814,3.331926519913814e-05,0.9
10231,10231,캐스퍼/Noun,10,9,1,0.00012226297654773814,3.331926519913814e-05,0.9
10232,10232,구제/Noun,10,1,9,3.334444814938313e-05,0.00012217063906350652,0.9
10233,10233,70%/Number,10,1,9,3.334444814938313e-05,0.00012217063906350652,0.9
10234,10234,처녀/Noun,10,1,9,3.334444814938313e-05,0.00012217063906350652,0.9
10235,10235,조만간/Noun,10,9,1,0.00012226297654773814,3.331926519913814e-05,0.9
10236,10236,장구/Noun,10,1,9,3.334444814938313e-05,0.00012217063906350652,0.9
10237,10237,육성/Noun,10,1,9,3.334444814938313e-05,0.00012217063906350652,0.9
10238,10238,개꿀/Noun,10,9,1,0.00012226297654773814,3.331926519913814e-05,0.9
10239,10239,스톰/Noun,10,1,9,3.334444814938313e-05,0.00012217063906350652,0.9
10240,10240,봣더/Noun,10,1,9,3.334444814938313e-05,0.00012217063906350652,0.9
10241,10241,공략/Noun,10,1,9,3.334444814938313e-05,0.00012217063906350652,0.9
10242,10242,개간/Noun,10,9,1,0.00012226297654773814,3.331926519913814e-05,0.9
10243,10243,딸년/Noun,10,1,9,3.334444814938313e-05,0.00012217063906350652,0.9
10244,10244,러블리/Noun,10,9,1,0.00012226297654773814,3.331926519913814e-05,0.9
10245,10245,구숙정/Noun,10,9,1,0.00012226297654773814,3.331926519913814e-05,0.9
10246,10246,레나/Noun,10,9,1,0.00012226297654773814,3.331926519913814e-05,0.9
10247,10247,자금/Noun,10,1,9,3.334444814938313e-05,0.00012217063906350652,0.9
10248,10248,！/Foreign,10,9,1,0.00012226297654773814,3.331926519913814e-05,0.9
10249,10249,단조/Noun,10,1,9,3.334444814938313e-05,0.00012217063906350652,0.9
10250,10250,결재/Noun,10,1,9,3.334444814938313e-05,0.00012217063906350652,0.9
10251,10251,다작/Noun,10,1,9,3.334444814938313e-05,0.00012217063906350652,0.9
10252,10252,하위/Noun,10,1,9,3.334444814938313e-05,0.00012217063906350652,0.9
10253,10253,메이퀸/Noun,10,9,1,0.00012226297654773814,3.331926519913814e-05,0.9
10254,10254,꿈틀/Noun,10,9,1,0.00012226297654773814,3.331926519913814e-05,0.9
10255,10255,백조/Noun,10,9,1,0.00012226297654773814,3.331926519913814e-05,0.9
10256,10256,존엄/Noun,10,9,1,0.00012226297654773814,3.331926519913814e-05,0.9
10257,10257,은지원/Noun,10,2,8,4.445926419917751e-05,0.00011106421733046048,0.8
10258,10258,대응/Noun,10,2,8,4.445926419917751e-05,0.00011106421733046048,0.8
10259,10259,성숙/Noun,10,8,2,0.00011114816049794375,4.4425686932184186e-05,0.8
10260,10260,키도/Noun,10,2,8,4.445926419917751e-05,0.00011106421733046048,0.8
10261,10261,일지매/Noun,10,8,2,0.00011114816049794375,4.4425686932184186e-05,0.8
10262,10262,위반/Noun,10,2,8,4.445926419917751e-05,0.00011106421733046048,0.8
10263,10263,전투력/Noun,10,2,8,4.445926419917751e-05,0.00011106421733046048,0.8
10264,10264,정해/Noun,10,2,8,4.445926419917751e-05,0.00011106421733046048,0.8
10265,10265,위장/Noun,10,2,8,4.445926419917751e-05,0.00011106421733046048,0.8
10266,10266,다모/Noun,10,8,2,0.00011114816049794375,4.4425686932184186e-05,0.8
10267,10267,J/Alpha,10,2,8,4.445926419917751e-05,0.00011106421733046048,0.8
10268,10268,자시/Noun,10,2,8,4.445926419917751e-05,0.00011106421733046048,0.8
10269,10269,매춘부/Noun,10,2,8,4.445926419917751e-05,0.00011106421733046048,0.8
10270,10270,ㅠㅜㅜ/KoreanParticle,10,8,2,0.00011114816049794375,4.4425686932184186e-05,0.8
10271,10271,!!~~/Punctuation,10,8,2,0.00011114816049794375,4.4425686932184186e-05,0.8
10272,10272,죄값/Noun,10,2,8,4.445926419917751e-05,0.00011106421733046048,0.8
10273,10273,사형수/Noun,10,2,8,4.445926419917751e-05,0.00011106421733046048,0.8
10274,10274,줄평/Noun,10,2,8,4.445926419917751e-05,0.00011106421733046048,0.8
10275,10275,퇴색/Noun,10,2,8,4.445926419917751e-05,0.00011106421733046048,0.8
10276,10276,카톡/Noun,10,2,8,4.445926419917751e-05,0.00011106421733046048,0.8
10277,10277,신경질/Noun,10,2,8,4.445926419917751e-05,0.00011106421733046048,0.8
10278,10278,조던/Noun,10,8,2,0.00011114816049794375,4.4425686932184186e-05,0.8
10279,10279,객/Noun,10,2,8,4.445926419917751e-05,0.00011106421733046048,0.8
10280,10280,홍은희/Noun,10,2,8,4.445926419917751e-05,0.00011106421733046048,0.8
10281,10281,한다해/Noun,10,2,8,4.445926419917751e-05,0.00011106421733046048,0.8
10282,10282,개그콘서트/Noun,10,2,8,4.445926419917751e-05,0.00011106421733046048,0.8
10283,10283,구태의연하다/Adjective,10,2,8,4.445926419917751e-05,0.00011106421733046048,0.8
10284,10284,구두/Noun,10,8,2,0.00011114816049794375,4.4425686932184186e-05,0.8
10285,10285,박희순/Noun,10,8,2,0.00011114816049794375,4.4425686932184186e-05,0.8
10286,10286,무분별/Noun,10,2,8,4.445926419917751e-05,0.00011106421733046048,0.8
10287,10287,리즈중/Noun,10,8,2,0.00011114816049794375,4.4425686932184186e-05,0.8
10288,10288,유전/Noun,10,8,2,0.00011114816049794375,4.4425686932184186e-05,0.8
10289,10289,송재림/Noun,10,8,2,0.00011114816049794375,4.4425686932184186e-05,0.8
10290,10290,명탐정코난/Noun,10,8,2,0.00011114816049794375,4.4425686932184186e-05,0.8
10291,10291,집합소/Noun,10,2,8,4.445926419917751e-05,0.00011106421733046048,0.8
10292,10292,평면/Noun,10,2,8,4.445926419917751e-05,0.00011106421733046048,0.8
10293,10293,느닷없다/Adjective,10,2,8,4.445926419917751e-05,0.00011106421733046048,0.8
10294,10294,빠리/Noun,10,2,8,4.445926419917751e-05,0.00011106421733046048,0.8
10295,10295,과격하다/Adjective,10,2,8,4.445926419917751e-05,0.00011106421733046048,0.8
10296,10296,희생양/Noun,10,2,8,4.445926419917751e-05,0.00011106421733046048,0.8
10297,10297,짤/Suffix,10,2,8,4.445926419917751e-05,0.00011106421733046048,0.8
10298,10298,맞짱/Noun,10,2,8,4.445926419917751e-05,0.00011106421733046048,0.8
10299,10299,고시/Noun,10,2,8,4.445926419917751e-05,0.00011106421733046048,0.8
10300,10300,구시대/Noun,10,2,8,4.445926419917751e-05,0.00011106421733046048,0.8
10301,10301,코스모스/Noun,10,8,2,0.00011114816049794375,4.4425686932184186e-05,0.8
10302,10302,낌/Noun,10,8,2,0.00011114816049794375,4.4425686932184186e-05,0.8
10303,10303,가해/Noun,10,2,8,4.445926419917751e-05,0.00011106421733046048,0.8
10304,10304,찐빵/Noun,10,2,8,4.445926419917751e-05,0.00011106421733046048,0.8
10305,10305,뮤지션/Noun,10,8,2,0.00011114816049794375,4.4425686932184186e-05,0.8
10306,10306,이덕화/Noun,10,8,2,0.00011114816049794375,4.4425686932184186e-05,0.8
10307,10307,달기/Noun,10,2,8,4.445926419917751e-05,0.00011106421733046048,0.8
10308,10308,뚱땡이/Noun,10,2,8,4.445926419917751e-05,0.00011106421733046048,0.8
10309,10309,날짜/Noun,10,2,8,4.445926419917751e-05,0.00011106421733046048,0.8
10310,10310,with/Alpha,10,8,2,0.00011114816049794375,4.4425686932184186e-05,0.8
10311,10311,왜그러지/Noun,10,8,2,0.00011114816049794375,4.4425686932184186e-05,0.8
10312,10312,지휘/Noun,10,8,2,0.00011114816049794375,4.4425686932184186e-05,0.8
10313,10313,공이/Noun,10,2,8,4.445926419917751e-05,0.00011106421733046048,0.8
10314,10314,구만/Eomi,10,2,8,4.445926419917751e-05,0.00011106421733046048,0.8
10315,10315,계보/Noun,10,2,8,4.445926419917751e-05,0.00011106421733046048,0.8
10316,10316,퇴화/Noun,10,2,8,4.445926419917751e-05,0.00011106421733046048,0.8
10317,10317,김갑수/Noun,10,8,2,0.00011114816049794375,4.4425686932184186e-05,0.8
10318,10318,족하/Noun,10,2,8,4.445926419917751e-05,0.00011106421733046048,0.8
10319,10319,현수/Noun,10,2,8,4.445926419917751e-05,0.00011106421733046048,0.8
10320,10320,Top/Alpha,10,8,2,0.00011114816049794375,4.4425686932184186e-05,0.8
10321,10321,우파/Noun,10,8,2,0.00011114816049794375,4.4425686932184186e-05,0.8
10322,10322,ktx/Alpha,10,2,8,4.445926419917751e-05,0.00011106421733046048,0.8
10323,10323,거론/Noun,10,2,8,4.445926419917751e-05,0.00011106421733046048,0.8
10324,10324,IMDB/Alpha,10,2,8,4.445926419917751e-05,0.00011106421733046048,0.8
10325,10325,골로/Noun,10,2,8,4.445926419917751e-05,0.00011106421733046048,0.8
10326,10326,1000만/Number,10,2,8,4.445926419917751e-05,0.00011106421733046048,0.8
10327,10327,치욕/Noun,10,2,8,4.445926419917751e-05,0.00011106421733046048,0.8
10328,10328,개개인/Noun,10,8,2,0.00011114816049794375,4.4425686932184186e-05,0.8
10329,10329,에코/Noun,10,2,8,4.445926419917751e-05,0.00011106421733046048,0.8
10330,10330,재연배우/Noun,10,2,8,4.445926419917751e-05,0.00011106421733046048,0.8
10331,10331,8회/Number,10,8,2,0.00011114816049794375,4.4425686932184186e-05,0.8
10332,10332,개신교/Noun,10,2,8,4.445926419917751e-05,0.00011106421733046048,0.8
10333,10333,미아/Noun,10,8,2,0.00011114816049794375,4.4425686932184186e-05,0.8
10334,10334,낙하산/Noun,10,2,8,4.445926419917751e-05,0.00011106421733046048,0.8
10335,10335,중국사람/Noun,10,2,8,4.445926419917751e-05,0.00011106421733046048,0.8
10336,10336,로보트/Noun,10,2,8,4.445926419917751e-05,0.00011106421733046048,0.8
10337,10337,장관/Noun,10,8,2,0.00011114816049794375,4.4425686932184186e-05,0.8
10338,10338,썻/Noun,10,2,8,4.445926419917751e-05,0.00011106421733046048,0.8
10339,10339,대식/Foreign,10,2,8,4.445926419917751e-05,0.00011106421733046048,0.8
10340,10340,끈질기다/Adjective,10,8,2,0.00011114816049794375,4.4425686932184186e-05,0.8
10341,10341,방귀/Noun,10,2,8,4.445926419917751e-05,0.00011106421733046048,0.8
10342,10342,치즈/Noun,10,8,2,0.00011114816049794375,4.4425686932184186e-05,0.8
10343,10343,피에르/Noun,10,8,2,0.00011114816049794375,4.4425686932184186e-05,0.8
10344,10344,왕창/Noun,10,2,8,4.445926419917751e-05,0.00011106421733046048,0.8
10345,10345,클리/Noun,10,2,8,4.445926419917751e-05,0.00011106421733046048,0.8
10346,10346,개멋/Noun,10,8,2,0.00011114816049794375,4.4425686932184186e-05,0.8
10347,10347,쭈쭈/Noun,10,2,8,4.445926419917751e-05,0.00011106421733046048,0.8
10348,10348,26/Number,10,8,2,0.00011114816049794375,4.4425686932184186e-05,0.8
10349,10349,드라마스페셜/Noun,10,2,8,4.445926419917751e-05,0.00011106421733046048,0.8
10350,10350,추측/Noun,10,8,2,0.00011114816049794375,4.4425686932184186e-05,0.8
10351,10351,폭팔/Noun,10,8,2,0.00011114816049794375,4.4425686932184186e-05,0.8
10352,10352,쥐뿔/Noun,10,2,8,4.445926419917751e-05,0.00011106421733046048,0.8
10353,10353,데미/Noun,10,2,8,4.445926419917751e-05,0.00011106421733046048,0.8
10354,10354,테두리/Noun,10,2,8,4.445926419917751e-05,0.00011106421733046048,0.8
10355,10355,건방지다/Adjective,10,2,8,4.445926419917751e-05,0.00011106421733046048,0.8
10356,10356,♡♡♡♡/Foreign,10,8,2,0.00011114816049794375,4.4425686932184186e-05,0.8
10357,10357,부다/Noun,10,2,8,4.445926419917751e-05,0.00011106421733046048,0.8
10358,10358,질풍/Noun,10,8,2,0.00011114816049794375,4.4425686932184186e-05,0.8
10359,10359,동포/Noun,10,8,2,0.00011114816049794375,4.4425686932184186e-05,0.8
10360,10360,따라다니다/Verb,10,2,8,4.445926419917751e-05,0.00011106421733046048,0.8
10361,10361,전무하다/Adjective,10,2,8,4.445926419917751e-05,0.00011106421733046048,0.8
10362,10362,과유/Noun,10,2,8,4.445926419917751e-05,0.00011106421733046048,0.8
10363,10363,자의식/Noun,10,2,8,4.445926419917751e-05,0.00011106421733046048,0.8
10364,10364,합창/Noun,10,8,2,0.00011114816049794375,4.4425686932184186e-05,0.8
10365,10365,위태/Noun,10,8,2,0.00011114816049794375,4.4425686932184186e-05,0.8
10366,10366,이슬/Noun,10,8,2,0.00011114816049794375,4.4425686932184186e-05,0.8
10367,10367,튀어/Noun,10,2,8,4.445926419917751e-05,0.00011106421733046048,0.8
10368,10368,순박하다/Adjective,10,8,2,0.00011114816049794375,4.4425686932184186e-05,0.8
10369,10369,쩍/Noun,10,2,8,4.445926419917751e-05,0.00011106421733046048,0.8
10370,10370,슈트/Noun,10,3,7,5.5574080248971876e-05,9.995779559741441e-05,0.7
10371,10371,정선경/Noun,10,3,7,5.5574080248971876e-05,9.995779559741441e-05,0.7
10372,10372,통과/Noun,10,7,3,0.0001000333444481494,5.553210866523024e-05,0.7
10373,10373,웃음소리/Noun,10,3,7,5.5574080248971876e-05,9.995779559741441e-05,0.7
10374,10374,댜/Noun,10,7,3,0.0001000333444481494,5.553210866523024e-05,0.7
10375,10375,고귀하다/Adjective,10,7,3,0.0001000333444481494,5.553210866523024e-05,0.7
10376,10376,촌티/Noun,10,3,7,5.5574080248971876e-05,9.995779559741441e-05,0.7
10377,10377,파이어/Noun,10,7,3,0.0001000333444481494,5.553210866523024e-05,0.7
10378,10378,김정태/Noun,10,7,3,0.0001000333444481494,5.553210866523024e-05,0.7
10379,10379,파업/Noun,10,3,7,5.5574080248971876e-05,9.995779559741441e-05,0.7
10380,10380,월터/Noun,10,7,3,0.0001000333444481494,5.553210866523024e-05,0.7
10381,10381,가드/Noun,10,3,7,5.5574080248971876e-05,9.995779559741441e-05,0.7
10382,10382,패션왕/Noun,10,3,7,5.5574080248971876e-05,9.995779559741441e-05,0.7
10383,10383,킨/Noun,10,7,3,0.0001000333444481494,5.553210866523024e-05,0.7
10384,10384,니드/Noun,10,7,3,0.0001000333444481494,5.553210866523024e-05,0.7
10385,10385,미신/Noun,10,3,7,5.5574080248971876e-05,9.995779559741441e-05,0.7
10386,10386,김석훈/Noun,10,3,7,5.5574080248971876e-05,9.995779559741441e-05,0.7
10387,10387,실재/Noun,10,7,3,0.0001000333444481494,5.553210866523024e-05,0.7
10388,10388,부작용/Noun,10,3,7,5.5574080248971876e-05,9.995779559741441e-05,0.7
10389,10389,베닝/Noun,10,7,3,0.0001000333444481494,5.553210866523024e-05,0.7
10390,10390,백수/Noun,10,3,7,5.5574080248971876e-05,9.995779559741441e-05,0.7
10391,10391,네러티브/Noun,10,3,7,5.5574080248971876e-05,9.995779559741441e-05,0.7
10392,10392,정신분열증/Noun,10,3,7,5.5574080248971876e-05,9.995779559741441e-05,0.7
10393,10393,신의한수/Noun,10,7,3,0.0001000333444481494,5.553210866523024e-05,0.7
10394,10394,옥상/Noun,10,7,3,0.0001000333444481494,5.553210866523024e-05,0.7
10395,10395,노조미/Noun,10,7,3,0.0001000333444481494,5.553210866523024e-05,0.7
10396,10396,day/Alpha,10,7,3,0.0001000333444481494,5.553210866523024e-05,0.7
10397,10397,헤치다/Verb,10,7,3,0.0001000333444481494,5.553210866523024e-05,0.7
10398,10398,모양새/Noun,10,3,7,5.5574080248971876e-05,9.995779559741441e-05,0.7
10399,10399,자평/Noun,10,3,7,5.5574080248971876e-05,9.995779559741441e-05,0.7
10400,10400,잦다/Verb,10,3,7,5.5574080248971876e-05,9.995779559741441e-05,0.7
10401,10401,딧/Noun,10,7,3,0.0001000333444481494,5.553210866523024e-05,0.7
10402,10402,??../Punctuation,10,3,7,5.5574080248971876e-05,9.995779559741441e-05,0.7
10403,10403,롯/Noun,10,7,3,0.0001000333444481494,5.553210866523024e-05,0.7
10404,10404,이성민/Noun,10,7,3,0.0001000333444481494,5.553210866523024e-05,0.7
10405,10405,1.5/Number,10,3,7,5.5574080248971876e-05,9.995779559741441e-05,0.7
10406,10406,마우스/Noun,10,3,7,5.5574080248971876e-05,9.995779559741441e-05,0.7
10407,10407,닥터후/Noun,10,7,3,0.0001000333444481494,5.553210866523024e-05,0.7
10408,10408,갈리/Noun,10,7,3,0.0001000333444481494,5.553210866523024e-05,0.7
10409,10409,시온/Noun,10,7,3,0.0001000333444481494,5.553210866523024e-05,0.7
10410,10410,점퍼/Noun,10,3,7,5.5574080248971876e-05,9.995779559741441e-05,0.7
10411,10411,연정훈/Noun,10,7,3,0.0001000333444481494,5.553210866523024e-05,0.7
10412,10412,명목/Noun,10,3,7,5.5574080248971876e-05,9.995779559741441e-05,0.7
10413,10413,하의/Noun,10,3,7,5.5574080248971876e-05,9.995779559741441e-05,0.7
10414,10414,듯해/Noun,10,7,3,0.0001000333444481494,5.553210866523024e-05,0.7
10415,10415,군단/Noun,10,3,7,5.5574080248971876e-05,9.995779559741441e-05,0.7
10416,10416,조성하/Noun,10,3,7,5.5574080248971876e-05,9.995779559741441e-05,0.7
10417,10417,과학자/Noun,10,3,7,5.5574080248971876e-05,9.995779559741441e-05,0.7
10418,10418,all/Alpha,10,7,3,0.0001000333444481494,5.553210866523024e-05,0.7
10419,10419,행세/Noun,10,3,7,5.5574080248971876e-05,9.995779559741441e-05,0.7
10420,10420,실어/Noun,10,7,3,0.0001000333444481494,5.553210866523024e-05,0.7
10421,10421,말세/Noun,10,3,7,5.5574080248971876e-05,9.995779559741441e-05,0.7
10422,10422,이산/Noun,10,3,7,5.5574080248971876e-05,9.995779559741441e-05,0.7
10423,10423,.-/Punctuation,10,3,7,5.5574080248971876e-05,9.995779559741441e-05,0.7
10424,10424,북극/Noun,10,7,3,0.0001000333444481494,5.553210866523024e-05,0.7
10425,10425,불상/Noun,10,3,7,5.5574080248971876e-05,9.995779559741441e-05,0.7
10426,10426,달랑/Noun,10,3,7,5.5574080248971876e-05,9.995779559741441e-05,0.7
10427,10427,은교/Noun,10,3,7,5.5574080248971876e-05,9.995779559741441e-05,0.7
10428,10428,헤어스타일/Noun,10,3,7,5.5574080248971876e-05,9.995779559741441e-05,0.7
10429,10429,램버트/Noun,10,7,3,0.0001000333444481494,5.553210866523024e-05,0.7
10430,10430,쌩/Noun,10,3,7,5.5574080248971876e-05,9.995779559741441e-05,0.7
10431,10431,투혼/Noun,10,3,7,5.5574080248971876e-05,9.995779559741441e-05,0.7
10432,10432,로고/Josa,10,3,7,5.5574080248971876e-05,9.995779559741441e-05,0.7
10433,10433,그래비티/Noun,10,7,3,0.0001000333444481494,5.553210866523024e-05,0.7
10434,10434,격추/Noun,10,3,7,5.5574080248971876e-05,9.995779559741441e-05,0.7
10435,10435,불쌍타/Noun,10,3,7,5.5574080248971876e-05,9.995779559741441e-05,0.7
10436,10436,률/Noun,10,3,7,5.5574080248971876e-05,9.995779559741441e-05,0.7
10437,10437,비장하다/Adjective,10,7,3,0.0001000333444481494,5.553210866523024e-05,0.7
10438,10438,임마/Noun,10,3,7,5.5574080248971876e-05,9.995779559741441e-05,0.7
10439,10439,12월/Number,10,7,3,0.0001000333444481494,5.553210866523024e-05,0.7
10440,10440,징징/Noun,10,3,7,5.5574080248971876e-05,9.995779559741441e-05,0.7
10441,10441,공권력/Noun,10,7,3,0.0001000333444481494,5.553210866523024e-05,0.7
10442,10442,쪼/Noun,10,7,3,0.0001000333444481494,5.553210866523024e-05,0.7
10443,10443,죵/Noun,10,3,7,5.5574080248971876e-05,9.995779559741441e-05,0.7
10444,10444,일수록/Josa,10,3,7,5.5574080248971876e-05,9.995779559741441e-05,0.7
10445,10445,모텔/Noun,10,3,7,5.5574080248971876e-05,9.995779559741441e-05,0.7
10446,10446,잠재우다/Verb,10,3,7,5.5574080248971876e-05,9.995779559741441e-05,0.7
10447,10447,분신/Noun,10,3,7,5.5574080248971876e-05,9.995779559741441e-05,0.7
10448,10448,기생/Noun,10,3,7,5.5574080248971876e-05,9.995779559741441e-05,0.7
10449,10449,인가가/Josa,10,7,3,0.0001000333444481494,5.553210866523024e-05,0.7
10450,10450,볼륨/Noun,10,3,7,5.5574080248971876e-05,9.995779559741441e-05,0.7
10451,10451,로구나/Josa,10,3,7,5.5574080248971876e-05,9.995779559741441e-05,0.7
10452,10452,해서웨이/Noun,10,7,3,0.0001000333444481494,5.553210866523024e-05,0.7
10453,10453,초원/Noun,10,7,3,0.0001000333444481494,5.553210866523024e-05,0.7
10454,10454,자괴/Noun,10,3,7,5.5574080248971876e-05,9.995779559741441e-05,0.7
10455,10455,매진/Noun,10,7,3,0.0001000333444481494,5.553210866523024e-05,0.7
10456,10456,상호/Noun,10,7,3,0.0001000333444481494,5.553210866523024e-05,0.7
10457,10457,스타크래프트/Noun,10,7,3,0.0001000333444481494,5.553210866523024e-05,0.7
10458,10458,시각장애인/Noun,10,7,3,0.0001000333444481494,5.553210866523024e-05,0.7
10459,10459,인원/Noun,10,3,7,5.5574080248971876e-05,9.995779559741441e-05,0.7
10460,10460,격렬하다/Adjective,10,7,3,0.0001000333444481494,5.553210866523024e-05,0.7
10461,10461,허수아비/Noun,10,3,7,5.5574080248971876e-05,9.995779559741441e-05,0.7
10462,10462,스칼렛요한슨/Noun,10,7,3,0.0001000333444481494,5.553210866523024e-05,0.7
10463,10463,연도/Noun,10,7,3,0.0001000333444481494,5.553210866523024e-05,0.7
10464,10464,급격하다/Adjective,10,3,7,5.5574080248971876e-05,9.995779559741441e-05,0.7
10465,10465,물든/Noun,10,7,3,0.0001000333444481494,5.553210866523024e-05,0.7
10466,10466,리모컨/Noun,10,3,7,5.5574080248971876e-05,9.995779559741441e-05,0.7
10467,10467,비고/Noun,10,7,3,0.0001000333444481494,5.553210866523024e-05,0.7
10468,10468,one/Alpha,10,7,3,0.0001000333444481494,5.553210866523024e-05,0.7
10469,10469,서너/Modifier,10,7,3,0.0001000333444481494,5.553210866523024e-05,0.7
10470,10470,레아/Noun,10,7,3,0.0001000333444481494,5.553210866523024e-05,0.7
10471,10471,필리핀/Noun,10,3,7,5.5574080248971876e-05,9.995779559741441e-05,0.7
10472,10472,ET/Alpha,10,7,3,0.0001000333444481494,5.553210866523024e-05,0.7
10473,10473,비포/Noun,10,7,3,0.0001000333444481494,5.553210866523024e-05,0.7
10474,10474,오맹달/Noun,10,7,3,0.0001000333444481494,5.553210866523024e-05,0.7
10475,10475,좌익/Noun,10,3,7,5.5574080248971876e-05,9.995779559741441e-05,0.7
10476,10476,리브스/Noun,10,7,3,0.0001000333444481494,5.553210866523024e-05,0.7
10477,10477,덧글/Noun,10,3,7,5.5574080248971876e-05,9.995779559741441e-05,0.7
10478,10478,150/Number,10,3,7,5.5574080248971876e-05,9.995779559741441e-05,0.7
10479,10479,선호/Noun,10,7,3,0.0001000333444481494,5.553210866523024e-05,0.7
10480,10480,맞이/Noun,10,7,3,0.0001000333444481494,5.553210866523024e-05,0.7
10481,10481,방한/Noun,10,3,7,5.5574080248971876e-05,9.995779559741441e-05,0.7
10482,10482,크레이븐/Noun,10,7,3,0.0001000333444481494,5.553210866523024e-05,0.7
10483,10483,이효리/Noun,10,3,7,5.5574080248971876e-05,9.995779559741441e-05,0.7
10484,10484,자잘하다/Adjective,10,7,3,0.0001000333444481494,5.553210866523024e-05,0.7
10485,10485,방향성/Noun,10,3,7,5.5574080248971876e-05,9.995779559741441e-05,0.7
10486,10486,피스/Noun,10,7,3,0.0001000333444481494,5.553210866523024e-05,0.7
10487,10487,돌대가리/Noun,10,3,7,5.5574080248971876e-05,9.995779559741441e-05,0.7
10488,10488,의료/Noun,10,7,3,0.0001000333444481494,5.553210866523024e-05,0.7
10489,10489,실비/Noun,10,7,3,0.0001000333444481494,5.553210866523024e-05,0.7
10490,10490,코트/Noun,10,7,3,0.0001000333444481494,5.553210866523024e-05,0.7
10491,10491,지평/Noun,10,7,3,0.0001000333444481494,5.553210866523024e-05,0.7
10492,10492,ㆍ/Foreign,10,7,3,0.0001000333444481494,5.553210866523024e-05,0.7
10493,10493,로지/Noun,10,3,7,5.5574080248971876e-05,9.995779559741441e-05,0.7
10494,10494,열매/Noun,10,7,3,0.0001000333444481494,5.553210866523024e-05,0.7
10495,10495,안재모/Noun,10,7,3,0.0001000333444481494,5.553210866523024e-05,0.7
10496,10496,마츠코/Noun,10,3,7,5.5574080248971876e-05,9.995779559741441e-05,0.7
10497,10497,로페즈/Noun,10,3,7,5.5574080248971876e-05,9.995779559741441e-05,0.7
10498,10498,일일이/Noun,10,3,7,5.5574080248971876e-05,9.995779559741441e-05,0.7
10499,10499,배신자/Noun,10,3,7,5.5574080248971876e-05,9.995779559741441e-05,0.7
10500,10500,이주/Noun,10,7,3,0.0001000333444481494,5.553210866523024e-05,0.7
10501,10501,간판/Noun,10,3,7,5.5574080248971876e-05,9.995779559741441e-05,0.7
10502,10502,연애시대/Noun,10,7,3,0.0001000333444481494,5.553210866523024e-05,0.7
10503,10503,러브액츄얼리/Noun,10,7,3,0.0001000333444481494,5.553210866523024e-05,0.7
10504,10504,로비/Noun,10,3,7,5.5574080248971876e-05,9.995779559741441e-05,0.7
10505,10505,주드로/Noun,10,7,3,0.0001000333444481494,5.553210866523024e-05,0.7
10506,10506,히로인/Noun,10,3,7,5.5574080248971876e-05,9.995779559741441e-05,0.7
10507,10507,What/Alpha,10,3,7,5.5574080248971876e-05,9.995779559741441e-05,0.7
10508,10508,LA/Alpha,10,7,3,0.0001000333444481494,5.553210866523024e-05,0.7
10509,10509,박재정/Noun,10,3,7,5.5574080248971876e-05,9.995779559741441e-05,0.7
10510,10510,눈망울/Noun,10,7,3,0.0001000333444481494,5.553210866523024e-05,0.7
10511,10511,중국무협/Noun,10,3,7,5.5574080248971876e-05,9.995779559741441e-05,0.7
10512,10512,이용철/Noun,10,7,3,0.0001000333444481494,5.553210866523024e-05,0.7
10513,10513,포레스트검프/Noun,10,7,3,0.0001000333444481494,5.553210866523024e-05,0.7
10514,10514,정당성/Noun,10,3,7,5.5574080248971876e-05,9.995779559741441e-05,0.7
10515,10515,김신/Noun,10,3,7,5.5574080248971876e-05,9.995779559741441e-05,0.7
10516,10516,걔/Noun,10,3,7,5.5574080248971876e-05,9.995779559741441e-05,0.7
10517,10517,똥개/Noun,10,3,7,5.5574080248971876e-05,9.995779559741441e-05,0.7
10518,10518,아름/Noun,10,7,3,0.0001000333444481494,5.553210866523024e-05,0.7
10519,10519,개지/Noun,10,3,7,5.5574080248971876e-05,9.995779559741441e-05,0.7
10520,10520,'./Punctuation,10,7,3,0.0001000333444481494,5.553210866523024e-05,0.7
10521,10521,거고/Eomi,10,3,7,5.5574080248971876e-05,9.995779559741441e-05,0.7
10522,10522,떠나가다/Verb,10,7,3,0.0001000333444481494,5.553210866523024e-05,0.7
10523,10523,라오스/Noun,10,7,3,0.0001000333444481494,5.553210866523024e-05,0.7
10524,10524,공항/Noun,10,7,3,0.0001000333444481494,5.553210866523024e-05,0.7
10525,10525,아이엠/Noun,10,7,3,0.0001000333444481494,5.553210866523024e-05,0.7
10526,10526,더듬다/Verb,10,7,3,0.0001000333444481494,5.553210866523024e-05,0.7
10527,10527,깜빡/Noun,10,4,6,6.668889629876625e-05,8.885137386436837e-05,0.6
10528,10528,풍/Noun,10,4,6,6.668889629876625e-05,8.885137386436837e-05,0.6
10529,10529,김씨/Noun,10,4,6,6.668889629876625e-05,8.885137386436837e-05,0.6
10530,10530,좌석/Noun,10,4,6,6.668889629876625e-05,8.885137386436837e-05,0.6
10531,10531,바다로/Noun,10,4,6,6.668889629876625e-05,8.885137386436837e-05,0.6
10532,10532,가의/Noun,10,6,4,8.891852839835501e-05,6.663853039827628e-05,0.6
10533,10533,익스트림/Noun,10,4,6,6.668889629876625e-05,8.885137386436837e-05,0.6
10534,10534,익숙/Noun,10,6,4,8.891852839835501e-05,6.663853039827628e-05,0.6
10535,10535,멀어지다/Verb,10,4,6,6.668889629876625e-05,8.885137386436837e-05,0.6
10536,10536,막걸리/Noun,10,6,4,8.891852839835501e-05,6.663853039827628e-05,0.6
10537,10537,두산/Noun,10,6,4,8.891852839835501e-05,6.663853039827628e-05,0.6
10538,10538,소시오패스/Noun,10,4,6,6.668889629876625e-05,8.885137386436837e-05,0.6
10539,10539,김현중/Noun,10,4,6,6.668889629876625e-05,8.885137386436837e-05,0.6
10540,10540,베스트셀러/Noun,10,4,6,6.668889629876625e-05,8.885137386436837e-05,0.6
10541,10541,헛된/Noun,10,4,6,6.668889629876625e-05,8.885137386436837e-05,0.6
10542,10542,서두/Noun,10,4,6,6.668889629876625e-05,8.885137386436837e-05,0.6
10543,10543,세미/Noun,10,6,4,8.891852839835501e-05,6.663853039827628e-05,0.6
10544,10544,개구/Noun,10,4,6,6.668889629876625e-05,8.885137386436837e-05,0.6
10545,10545,자단/Noun,10,6,4,8.891852839835501e-05,6.663853039827628e-05,0.6
10546,10546,수퍼맨/Noun,10,6,4,8.891852839835501e-05,6.663853039827628e-05,0.6
10547,10547,1:1/Number,10,4,6,6.668889629876625e-05,8.885137386436837e-05,0.6
10548,10548,묵묵하다/Adjective,10,6,4,8.891852839835501e-05,6.663853039827628e-05,0.6
10549,10549,붓다/Verb,10,6,4,8.891852839835501e-05,6.663853039827628e-05,0.6
10550,10550,로또/Noun,10,4,6,6.668889629876625e-05,8.885137386436837e-05,0.6
10551,10551,코치/Noun,10,4,6,6.668889629876625e-05,8.885137386436837e-05,0.6
10552,10552,보험/Noun,10,6,4,8.891852839835501e-05,6.663853039827628e-05,0.6
10553,10553,블런트/Noun,10,6,4,8.891852839835501e-05,6.663853039827628e-05,0.6
10554,10554,메멘토/Noun,10,6,4,8.891852839835501e-05,6.663853039827628e-05,0.6
10555,10555,ㅏㅇ/KoreanParticle,10,6,4,8.891852839835501e-05,6.663853039827628e-05,0.6
10556,10556,번영/Noun,10,6,4,8.891852839835501e-05,6.663853039827628e-05,0.6
10557,10557,헐리우드영화/Noun,10,6,4,8.891852839835501e-05,6.663853039827628e-05,0.6
10558,10558,천배/Noun,10,6,4,8.891852839835501e-05,6.663853039827628e-05,0.6
10559,10559,제품/Noun,10,4,6,6.668889629876625e-05,8.885137386436837e-05,0.6
10560,10560,김소은/Noun,10,6,4,8.891852839835501e-05,6.663853039827628e-05,0.6
10561,10561,총잡이/Noun,10,4,6,6.668889629876625e-05,8.885137386436837e-05,0.6
10562,10562,침착하다/Adjective,10,6,4,8.891852839835501e-05,6.663853039827628e-05,0.6
10563,10563,마트/Noun,10,4,6,6.668889629876625e-05,8.885137386436837e-05,0.6
10564,10564,snl/Alpha,10,4,6,6.668889629876625e-05,8.885137386436837e-05,0.6
10565,10565,공통점/Noun,10,4,6,6.668889629876625e-05,8.885137386436837e-05,0.6
10566,10566,육감/Noun,10,4,6,6.668889629876625e-05,8.885137386436837e-05,0.6
10567,10567,칸타빌레/Noun,10,6,4,8.891852839835501e-05,6.663853039827628e-05,0.6
10568,10568,터치/Noun,10,6,4,8.891852839835501e-05,6.663853039827628e-05,0.6
10569,10569,블랙홀/Noun,10,6,4,8.891852839835501e-05,6.663853039827628e-05,0.6
10570,10570,해골/Noun,10,4,6,6.668889629876625e-05,8.885137386436837e-05,0.6
10571,10571,복제인간/Noun,10,6,4,8.891852839835501e-05,6.663853039827628e-05,0.6
10572,10572,30초/Number,10,4,6,6.668889629876625e-05,8.885137386436837e-05,0.6
10573,10573,매직/Noun,10,4,6,6.668889629876625e-05,8.885137386436837e-05,0.6
10574,10574,상일/Noun,10,4,6,6.668889629876625e-05,8.885137386436837e-05,0.6
10575,10575,3.14/Number,10,4,6,6.668889629876625e-05,8.885137386436837e-05,0.6
10576,10576,**/Punctuation,10,6,4,8.891852839835501e-05,6.663853039827628e-05,0.6
10577,10577,백야/Noun,10,4,6,6.668889629876625e-05,8.885137386436837e-05,0.6
10578,10578,단비/Noun,10,6,4,8.891852839835501e-05,6.663853039827628e-05,0.6
10579,10579,배리/Noun,10,4,6,6.668889629876625e-05,8.885137386436837e-05,0.6
10580,10580,패널/Noun,10,4,6,6.668889629876625e-05,8.885137386436837e-05,0.6
10581,10581,올리버스톤/Noun,10,6,4,8.891852839835501e-05,6.663853039827628e-05,0.6
10582,10582,한경직/Noun,10,4,6,6.668889629876625e-05,8.885137386436837e-05,0.6
10583,10583,신사/Noun,10,4,6,6.668889629876625e-05,8.885137386436837e-05,0.6
10584,10584,부끄러움/Noun,10,4,6,6.668889629876625e-05,8.885137386436837e-05,0.6
10585,10585,격감/Noun,10,6,4,8.891852839835501e-05,6.663853039827628e-05,0.6
10586,10586,자장가/Noun,10,4,6,6.668889629876625e-05,8.885137386436837e-05,0.6
10587,10587,...???/Punctuation,10,6,4,8.891852839835501e-05,6.663853039827628e-05,0.6
10588,10588,핵폭탄/Noun,10,4,6,6.668889629876625e-05,8.885137386436837e-05,0.6
10589,10589,진입/Noun,10,4,6,6.668889629876625e-05,8.885137386436837e-05,0.6
10590,10590,투명인간/Noun,10,4,6,6.668889629876625e-05,8.885137386436837e-05,0.6
10591,10591,기만/Modifier,10,4,6,6.668889629876625e-05,8.885137386436837e-05,0.6
10592,10592,1월/Number,10,6,4,8.891852839835501e-05,6.663853039827628e-05,0.6
10593,10593,유희왕/Noun,10,4,6,6.668889629876625e-05,8.885137386436837e-05,0.6
10594,10594,예견/Noun,10,6,4,8.891852839835501e-05,6.663853039827628e-05,0.6
10595,10595,프라임/Noun,10,6,4,8.891852839835501e-05,6.663853039827628e-05,0.6
10596,10596,부숴/Noun,10,4,6,6.668889629876625e-05,8.885137386436837e-05,0.6
10597,10597,실시간/Noun,10,6,4,8.891852839835501e-05,6.663853039827628e-05,0.6
10598,10598,딴다/Adjective,10,6,4,8.891852839835501e-05,6.663853039827628e-05,0.6
10599,10599,트롤/Noun,10,6,4,8.891852839835501e-05,6.663853039827628e-05,0.6
10600,10600,참사/Noun,10,4,6,6.668889629876625e-05,8.885137386436837e-05,0.6
10601,10601,허상/Noun,10,4,6,6.668889629876625e-05,8.885137386436837e-05,0.6
10602,10602,이민자/Noun,10,6,4,8.891852839835501e-05,6.663853039827628e-05,0.6
10603,10603,프로필/Noun,10,4,6,6.668889629876625e-05,8.885137386436837e-05,0.6
10604,10604,도어/Noun,10,6,4,8.891852839835501e-05,6.663853039827628e-05,0.6
10605,10605,피자/Noun,10,4,6,6.668889629876625e-05,8.885137386436837e-05,0.6
10606,10606,이두/Noun,10,4,6,6.668889629876625e-05,8.885137386436837e-05,0.6
10607,10607,이자나/Josa,10,4,6,6.668889629876625e-05,8.885137386436837e-05,0.6
10608,10608,여리다/Adjective,10,4,6,6.668889629876625e-05,8.885137386436837e-05,0.6
10609,10609,??!!/Punctuation,10,4,6,6.668889629876625e-05,8.885137386436837e-05,0.6
10610,10610,언더월드/Noun,10,4,6,6.668889629876625e-05,8.885137386436837e-05,0.6
10611,10611,쿵푸허슬/Noun,10,6,4,8.891852839835501e-05,6.663853039827628e-05,0.6
10612,10612,비정하다/Adjective,10,6,4,8.891852839835501e-05,6.663853039827628e-05,0.6
10613,10613,순애보/Noun,10,6,4,8.891852839835501e-05,6.663853039827628e-05,0.6
10614,10614,관용/Noun,10,4,6,6.668889629876625e-05,8.885137386436837e-05,0.6
10615,10615,교복/Noun,10,6,4,8.891852839835501e-05,6.663853039827628e-05,0.6
10616,10616,텔/Noun,10,4,6,6.668889629876625e-05,8.885137386436837e-05,0.6
10617,10617,나단/Noun,10,6,4,8.891852839835501e-05,6.663853039827628e-05,0.6
10618,10618,전남편/Noun,10,4,6,6.668889629876625e-05,8.885137386436837e-05,0.6
10619,10619,김유정/Noun,10,4,6,6.668889629876625e-05,8.885137386436837e-05,0.6
10620,10620,ㅜㅡ/KoreanParticle,10,4,6,6.668889629876625e-05,8.885137386436837e-05,0.6
10621,10621,인구/Noun,10,4,6,6.668889629876625e-05,8.885137386436837e-05,0.6
10622,10622,날아오다/Verb,10,4,6,6.668889629876625e-05,8.885137386436837e-05,0.6
10623,10623,5위안/Number,10,6,4,8.891852839835501e-05,6.663853039827628e-05,0.6
10624,10624,척도/Noun,10,4,6,6.668889629876625e-05,8.885137386436837e-05,0.6
10625,10625,자수/Noun,10,6,4,8.891852839835501e-05,6.663853039827628e-05,0.6
10626,10626,임펙트/Noun,10,6,4,8.891852839835501e-05,6.663853039827628e-05,0.6
10627,10627,기점/Noun,10,6,4,8.891852839835501e-05,6.663853039827628e-05,0.6
10628,10628,수리/Noun,10,4,6,6.668889629876625e-05,8.885137386436837e-05,0.6
10629,10629,복지/Noun,10,6,4,8.891852839835501e-05,6.663853039827628e-05,0.6
10630,10630,장도/Noun,10,4,6,6.668889629876625e-05,8.885137386436837e-05,0.6
10631,10631,탈옥/Noun,10,6,4,8.891852839835501e-05,6.663853039827628e-05,0.6
10632,10632,장병/Noun,10,4,6,6.668889629876625e-05,8.885137386436837e-05,0.6
10633,10633,카사노바/Noun,10,6,4,8.891852839835501e-05,6.663853039827628e-05,0.6
10634,10634,홈즈/Noun,10,6,4,8.891852839835501e-05,6.663853039827628e-05,0.6
10635,10635,내뱉다/Verb,10,4,6,6.668889629876625e-05,8.885137386436837e-05,0.6
10636,10636,도그빌/Noun,10,6,4,8.891852839835501e-05,6.663853039827628e-05,0.6
10637,10637,제타존스/Noun,10,4,6,6.668889629876625e-05,8.885137386436837e-05,0.6
10638,10638,이다해/Noun,10,6,4,8.891852839835501e-05,6.663853039827628e-05,0.6
10639,10639,몽롱/Noun,10,6,4,8.891852839835501e-05,6.663853039827628e-05,0.6
10640,10640,끈기/Noun,10,4,6,6.668889629876625e-05,8.885137386436837e-05,0.6
10641,10641,느긋하다/Adjective,10,4,6,6.668889629876625e-05,8.885137386436837e-05,0.6
10642,10642,박해진/Noun,10,6,4,8.891852839835501e-05,6.663853039827628e-05,0.6
10643,10643,카톨릭/Noun,10,4,6,6.668889629876625e-05,8.885137386436837e-05,0.6
10644,10644,여섯/Determiner,10,6,4,8.891852839835501e-05,6.663853039827628e-05,0.6
10645,10645,꽃님/Noun,10,4,6,6.668889629876625e-05,8.885137386436837e-05,0.6
10646,10646,은색/Noun,10,6,4,8.891852839835501e-05,6.663853039827628e-05,0.6
10647,10647,숟가락/Noun,10,4,6,6.668889629876625e-05,8.885137386436837e-05,0.6
10648,10648,5일/Number,10,6,4,8.891852839835501e-05,6.663853039827628e-05,0.6
10649,10649,도보/Noun,10,6,4,8.891852839835501e-05,6.663853039827628e-05,0.6
10650,10650,피아니스트/Noun,10,4,6,6.668889629876625e-05,8.885137386436837e-05,0.6
10651,10651,아영/Noun,10,6,4,8.891852839835501e-05,6.663853039827628e-05,0.6
10652,10652,MB/Alpha,10,6,4,8.891852839835501e-05,6.663853039827628e-05,0.6
10653,10653,탈북자/Noun,10,4,6,6.668889629876625e-05,8.885137386436837e-05,0.6
10654,10654,다중인격/Noun,10,4,6,6.668889629876625e-05,8.885137386436837e-05,0.6
10655,10655,이방인/Noun,10,6,4,8.891852839835501e-05,6.663853039827628e-05,0.6
10656,10656,실리다/Verb,10,6,4,8.891852839835501e-05,6.663853039827628e-05,0.6
10657,10657,김영애/Noun,10,6,4,8.891852839835501e-05,6.663853039827628e-05,0.6
10658,10658,풀풀/Adverb,10,4,6,6.668889629876625e-05,8.885137386436837e-05,0.6
10659,10659,하늘나라/Noun,10,6,4,8.891852839835501e-05,6.663853039827628e-05,0.6
10660,10660,슈퍼주니어/Noun,10,6,4,8.891852839835501e-05,6.663853039827628e-05,0.6
10661,10661,유세윤/Noun,10,4,6,6.668889629876625e-05,8.885137386436837e-05,0.6
10662,10662,내레이션/Noun,10,4,6,6.668889629876625e-05,8.885137386436837e-05,0.6
10663,10663,드라이브/Noun,10,4,6,6.668889629876625e-05,8.885137386436837e-05,0.6
10664,10664,하므다/Verb,10,4,6,6.668889629876625e-05,8.885137386436837e-05,0.6
10665,10665,챔프/Noun,10,4,6,6.668889629876625e-05,8.885137386436837e-05,0.6
10666,10666,백성/Noun,10,4,6,6.668889629876625e-05,8.885137386436837e-05,0.6
10667,10667,어바웃타임/Noun,10,6,4,8.891852839835501e-05,6.663853039827628e-05,0.6
10668,10668,하워드/Noun,10,6,4,8.891852839835501e-05,6.663853039827628e-05,0.6
10669,10669,3~4/Number,10,6,4,8.891852839835501e-05,6.663853039827628e-05,0.6
10670,10670,일본군/Noun,10,4,6,6.668889629876625e-05,8.885137386436837e-05,0.6
10671,10671,감칠맛/Noun,10,6,4,8.891852839835501e-05,6.663853039827628e-05,0.6
10672,10672,종교인/Noun,10,6,4,8.891852839835501e-05,6.663853039827628e-05,0.6
10673,10673,뻗다/Verb,10,6,4,8.891852839835501e-05,6.663853039827628e-05,0.6
10674,10674,원판/Noun,10,6,4,8.891852839835501e-05,6.663853039827628e-05,0.6
10675,10675,일침/Noun,10,6,4,8.891852839835501e-05,6.663853039827628e-05,0.6
10676,10676,UFO/Alpha,10,4,6,6.668889629876625e-05,8.885137386436837e-05,0.6
10677,10677,악하다/Adjective,10,4,6,6.668889629876625e-05,8.885137386436837e-05,0.6
10678,10678,소용/Noun,10,4,6,6.668889629876625e-05,8.885137386436837e-05,0.6
10679,10679,추종/Noun,10,6,4,8.891852839835501e-05,6.663853039827628e-05,0.6
10680,10680,사가다/Verb,10,4,6,6.668889629876625e-05,8.885137386436837e-05,0.6
10681,10681,야만/Noun,10,4,6,6.668889629876625e-05,8.885137386436837e-05,0.6
10682,10682,코리아/Noun,10,4,6,6.668889629876625e-05,8.885137386436837e-05,0.6
10683,10683,십자가/Noun,10,4,6,6.668889629876625e-05,8.885137386436837e-05,0.6
10684,10684,네네/Noun,10,4,6,6.668889629876625e-05,8.885137386436837e-05,0.6
10685,10685,룸/Noun,10,6,4,8.891852839835501e-05,6.663853039827628e-05,0.6
10686,10686,작용/Noun,10,6,4,8.891852839835501e-05,6.663853039827628e-05,0.6
10687,10687,대담하다/Adjective,10,6,4,8.891852839835501e-05,6.663853039827628e-05,0.6
10688,10688,두껍다/Adjective,10,4,6,6.668889629876625e-05,8.885137386436837e-05,0.6
10689,10689,지하실/Noun,10,6,4,8.891852839835501e-05,6.663853039827628e-05,0.6
10690,10690,정해진/Noun,10,6,4,8.891852839835501e-05,6.663853039827628e-05,0.6
10691,10691,랍니/Noun,10,6,4,8.891852839835501e-05,6.663853039827628e-05,0.6
10692,10692,찰/Noun,10,4,6,6.668889629876625e-05,8.885137386436837e-05,0.6
10693,10693,아이맥스/Noun,10,6,4,8.891852839835501e-05,6.663853039827628e-05,0.6
10694,10694,립/Noun,10,6,4,8.891852839835501e-05,6.663853039827628e-05,0.6
10695,10695,정지훈/Noun,10,6,4,8.891852839835501e-05,6.663853039827628e-05,0.6
10696,10696,내내/Foreign,10,6,4,8.891852839835501e-05,6.663853039827628e-05,0.6
10697,10697,숨바꼭질/Noun,10,4,6,6.668889629876625e-05,8.885137386436837e-05,0.6
10698,10698,",,./Punctuation",10,4,6,6.668889629876625e-05,8.885137386436837e-05,0.6
10699,10699,파이트/Noun,10,4,6,6.668889629876625e-05,8.885137386436837e-05,0.6
10700,10700,멍멍/Adverb,10,4,6,6.668889629876625e-05,8.885137386436837e-05,0.6
10701,10701,거늘/Noun,10,4,6,6.668889629876625e-05,8.885137386436837e-05,0.6
10702,10702,서투르다/Adjective,10,6,4,8.891852839835501e-05,6.663853039827628e-05,0.6
10703,10703,버무린/Noun,10,4,6,6.668889629876625e-05,8.885137386436837e-05,0.6
10704,10704,원더풀/Noun,10,6,4,8.891852839835501e-05,6.663853039827628e-05,0.6
10705,10705,아사/Noun,10,6,4,8.891852839835501e-05,6.663853039827628e-05,0.6
10706,10706,제거/Noun,10,6,4,8.891852839835501e-05,6.663853039827628e-05,0.6
10707,10707,명탐정/Noun,10,4,6,6.668889629876625e-05,8.885137386436837e-05,0.6
10708,10708,장끌/Noun,10,4,6,6.668889629876625e-05,8.885137386436837e-05,0.6
10709,10709,장화홍련/Noun,10,6,4,8.891852839835501e-05,6.663853039827628e-05,0.6
10710,10710,9.11/Number,10,6,4,8.891852839835501e-05,6.663853039827628e-05,0.6
10711,10711,순서/Noun,10,4,6,6.668889629876625e-05,8.885137386436837e-05,0.6
10712,10712,밀폐/Noun,10,6,4,8.891852839835501e-05,6.663853039827628e-05,0.6
10713,10713,일본드라마/Noun,10,6,4,8.891852839835501e-05,6.663853039827628e-05,0.6
10714,10714,엠마왓슨/Noun,10,4,6,6.668889629876625e-05,8.885137386436837e-05,0.6
10715,10715,관상/Noun,10,5,5,7.780371234856063e-05,7.774495213132233e-05,0.5
10716,10716,화두/Noun,10,5,5,7.780371234856063e-05,7.774495213132233e-05,0.5
10717,10717,김정일/Noun,10,5,5,7.780371234856063e-05,7.774495213132233e-05,0.5
10718,10718,슈퍼히어로/Noun,10,5,5,7.780371234856063e-05,7.774495213132233e-05,0.5
10719,10719,로/Foreign,10,5,5,7.780371234856063e-05,7.774495213132233e-05,0.5
10720,10720,김해숙/Noun,10,5,5,7.780371234856063e-05,7.774495213132233e-05,0.5
10721,10721,cm/Alpha,10,5,5,7.780371234856063e-05,7.774495213132233e-05,0.5
10722,10722,국영/Noun,10,5,5,7.780371234856063e-05,7.774495213132233e-05,0.5
10723,10723,35/Number,10,5,5,7.780371234856063e-05,7.774495213132233e-05,0.5
10724,10724,장서희/Noun,10,5,5,7.780371234856063e-05,7.774495213132233e-05,0.5
10725,10725,관도/Noun,10,5,5,7.780371234856063e-05,7.774495213132233e-05,0.5
10726,10726,울고불고/Adverb,10,5,5,7.780371234856063e-05,7.774495213132233e-05,0.5
10727,10727,브로/Noun,10,5,5,7.780371234856063e-05,7.774495213132233e-05,0.5
10728,10728,명중/Noun,10,5,5,7.780371234856063e-05,7.774495213132233e-05,0.5
10729,10729,사무실/Noun,10,5,5,7.780371234856063e-05,7.774495213132233e-05,0.5
10730,10730,범위/Noun,10,5,5,7.780371234856063e-05,7.774495213132233e-05,0.5
10731,10731,엔진/Noun,10,5,5,7.780371234856063e-05,7.774495213132233e-05,0.5
10732,10732,물량/Noun,10,5,5,7.780371234856063e-05,7.774495213132233e-05,0.5
10733,10733,혈/Noun,10,5,5,7.780371234856063e-05,7.774495213132233e-05,0.5
10734,10734,실전/Noun,10,5,5,7.780371234856063e-05,7.774495213132233e-05,0.5
10735,10735,첨단/Noun,10,5,5,7.780371234856063e-05,7.774495213132233e-05,0.5
10736,10736,음향효과/Noun,10,5,5,7.780371234856063e-05,7.774495213132233e-05,0.5
10737,10737,리하/Noun,10,5,5,7.780371234856063e-05,7.774495213132233e-05,0.5
10738,10738,!./Punctuation,10,5,5,7.780371234856063e-05,7.774495213132233e-05,0.5
10739,10739,오달수/Noun,10,5,5,7.780371234856063e-05,7.774495213132233e-05,0.5
10740,10740,읽히다/Verb,10,5,5,7.780371234856063e-05,7.774495213132233e-05,0.5
10741,10741,크루/Noun,10,5,5,7.780371234856063e-05,7.774495213132233e-05,0.5
10742,10742,진찌/Noun,10,5,5,7.780371234856063e-05,7.774495213132233e-05,0.5
10743,10743,옥택연/Noun,10,5,5,7.780371234856063e-05,7.774495213132233e-05,0.5
10744,10744,안톤/Noun,10,5,5,7.780371234856063e-05,7.774495213132233e-05,0.5
10745,10745,워낭소리/Noun,10,5,5,7.780371234856063e-05,7.774495213132233e-05,0.5
10746,10746,박민영/Noun,10,5,5,7.780371234856063e-05,7.774495213132233e-05,0.5
10747,10747,라이프/Noun,10,5,5,7.780371234856063e-05,7.774495213132233e-05,0.5
10748,10748,멀더/Noun,10,5,5,7.780371234856063e-05,7.774495213132233e-05,0.5
10749,10749,평행이론/Noun,10,5,5,7.780371234856063e-05,7.774495213132233e-05,0.5
10750,10750,대성/Noun,10,5,5,7.780371234856063e-05,7.774495213132233e-05,0.5
10751,10751,프라/Noun,10,5,5,7.780371234856063e-05,7.774495213132233e-05,0.5
10752,10752,백발/Noun,10,5,5,7.780371234856063e-05,7.774495213132233e-05,0.5
10753,10753,만큼만/Josa,10,5,5,7.780371234856063e-05,7.774495213132233e-05,0.5
10754,10754,합법/Noun,10,5,5,7.780371234856063e-05,7.774495213132233e-05,0.5
10755,10755,닝/Noun,10,5,5,7.780371234856063e-05,7.774495213132233e-05,0.5
10756,10756,상임/Noun,10,5,5,7.780371234856063e-05,7.774495213132233e-05,0.5
10757,10757,비비/Noun,10,5,5,7.780371234856063e-05,7.774495213132233e-05,0.5
10758,10758,조센징/Noun,10,5,5,7.780371234856063e-05,7.774495213132233e-05,0.5
10759,10759,전도/Noun,10,5,5,7.780371234856063e-05,7.774495213132233e-05,0.5
10760,10760,훼/Noun,10,5,5,7.780371234856063e-05,7.774495213132233e-05,0.5
10761,10761,4분/Number,10,5,5,7.780371234856063e-05,7.774495213132233e-05,0.5
10762,10762,자취/Noun,10,5,5,7.780371234856063e-05,7.774495213132233e-05,0.5
10763,10763,라이토/Noun,10,5,5,7.780371234856063e-05,7.774495213132233e-05,0.5
10764,10764,무전/Noun,10,5,5,7.780371234856063e-05,7.774495213132233e-05,0.5
10765,10765,주부/Noun,10,5,5,7.780371234856063e-05,7.774495213132233e-05,0.5
10766,10766,경비/Noun,10,5,5,7.780371234856063e-05,7.774495213132233e-05,0.5
10767,10767,지스/Noun,10,5,5,7.780371234856063e-05,7.774495213132233e-05,0.5
10768,10768,1996년/Number,10,5,5,7.780371234856063e-05,7.774495213132233e-05,0.5
10769,10769,대항/Noun,10,5,5,7.780371234856063e-05,7.774495213132233e-05,0.5
10770,10770,우연이/Noun,10,5,5,7.780371234856063e-05,7.774495213132233e-05,0.5
10771,10771,느그/Modifier,10,5,5,7.780371234856063e-05,7.774495213132233e-05,0.5
10772,10772,좔좔/Noun,10,5,5,7.780371234856063e-05,7.774495213132233e-05,0.5
10773,10773,합당/Noun,10,5,5,7.780371234856063e-05,7.774495213132233e-05,0.5
10774,10774,권유/Noun,10,5,5,7.780371234856063e-05,7.774495213132233e-05,0.5
10775,10775,확대/Noun,10,5,5,7.780371234856063e-05,7.774495213132233e-05,0.5
10776,10776,백성현/Noun,10,5,5,7.780371234856063e-05,7.774495213132233e-05,0.5
10777,10777,칼부림/Noun,10,5,5,7.780371234856063e-05,7.774495213132233e-05,0.5
10778,10778,부녀/Noun,10,5,5,7.780371234856063e-05,7.774495213132233e-05,0.5
10779,10779,마귀/Noun,10,5,5,7.780371234856063e-05,7.774495213132233e-05,0.5
10780,10780,습하다/Adjective,10,5,5,7.780371234856063e-05,7.774495213132233e-05,0.5
10781,10781,실물/Noun,10,5,5,7.780371234856063e-05,7.774495213132233e-05,0.5
10782,10782,~'/Punctuation,10,5,5,7.780371234856063e-05,7.774495213132233e-05,0.5
10783,10783,겁내/Noun,10,5,5,7.780371234856063e-05,7.774495213132233e-05,0.5
10784,10784,당분간/Noun,10,5,5,7.780371234856063e-05,7.774495213132233e-05,0.5
10785,10785,제때/Noun,10,5,5,7.780371234856063e-05,7.774495213132233e-05,0.5
10786,10786,정전/Noun,10,5,5,7.780371234856063e-05,7.774495213132233e-05,0.5
10787,10787,ㅠㅡㅠ/KoreanParticle,10,5,5,7.780371234856063e-05,7.774495213132233e-05,0.5
10788,10788,사시/Noun,10,5,5,7.780371234856063e-05,7.774495213132233e-05,0.5
10789,10789,썩을/Modifier,10,5,5,7.780371234856063e-05,7.774495213132233e-05,0.5
10790,10790,브레이크/Noun,10,5,5,7.780371234856063e-05,7.774495213132233e-05,0.5
10791,10791,소이현/Noun,10,5,5,7.780371234856063e-05,7.774495213132233e-05,0.5
10792,10792,3만/Number,10,5,5,7.780371234856063e-05,7.774495213132233e-05,0.5
10793,10793,독자/Noun,10,5,5,7.780371234856063e-05,7.774495213132233e-05,0.5
10794,10794,덧붙이다/Verb,10,5,5,7.780371234856063e-05,7.774495213132233e-05,0.5
10795,10795,상감/Noun,10,5,5,7.780371234856063e-05,7.774495213132233e-05,0.5
10796,10796,정일우/Noun,10,5,5,7.780371234856063e-05,7.774495213132233e-05,0.5
10797,10797,도성/Noun,10,5,5,7.780371234856063e-05,7.774495213132233e-05,0.5
10798,10798,후세/Noun,10,5,5,7.780371234856063e-05,7.774495213132233e-05,0.5
10799,10799,방가/Noun,10,5,5,7.780371234856063e-05,7.774495213132233e-05,0.5
10800,10800,집도/Noun,10,5,5,7.780371234856063e-05,7.774495213132233e-05,0.5
10801,10801,약물/Noun,10,5,5,7.780371234856063e-05,7.774495213132233e-05,0.5
10802,10802,연기면/Noun,10,5,5,7.780371234856063e-05,7.774495213132233e-05,0.5
10803,10803,정신차려라/Noun,9,0,9,2.2229632099588756e-05,0.00012217063906350652,1.0
10804,10804,망인/Noun,9,0,9,2.2229632099588756e-05,0.00012217063906350652,1.0
10805,10805,천조국/Noun,9,9,0,0.00012226297654773814,2.2212843466092093e-05,1.0
10806,10806,바니/Noun,9,9,0,0.00012226297654773814,2.2212843466092093e-05,1.0
10807,10807,거볼/Noun,9,0,9,2.2229632099588756e-05,0.00012217063906350652,1.0
10808,10808,장난없다/Adjective,9,9,0,0.00012226297654773814,2.2212843466092093e-05,1.0
10809,10809,땔/Noun,9,9,0,0.00012226297654773814,2.2212843466092093e-05,1.0
10810,10810,민경/Noun,9,0,9,2.2229632099588756e-05,0.00012217063906350652,1.0
10811,10811,분리수거/Noun,9,0,9,2.2229632099588756e-05,0.00012217063906350652,1.0
10812,10812,겸비/Noun,9,9,0,0.00012226297654773814,2.2212843466092093e-05,1.0
10813,10813,낙제/Noun,9,0,9,2.2229632099588756e-05,0.00012217063906350652,1.0
10814,10814,겸손하다/Adjective,9,9,0,0.00012226297654773814,2.2212843466092093e-05,1.0
10815,10815,직면/Noun,9,9,0,0.00012226297654773814,2.2212843466092093e-05,1.0
10816,10816,THE/Alpha,9,9,0,0.00012226297654773814,2.2212843466092093e-05,1.0
10817,10817,최진혁/Noun,9,9,0,0.00012226297654773814,2.2212843466092093e-05,1.0
10818,10818,용납/Noun,9,0,9,2.2229632099588756e-05,0.00012217063906350652,1.0
10819,10819,윤찬/Noun,9,0,9,2.2229632099588756e-05,0.00012217063906350652,1.0
10820,10820,할껄/Noun,9,0,9,2.2229632099588756e-05,0.00012217063906350652,1.0
10821,10821,잡담/Noun,9,0,9,2.2229632099588756e-05,0.00012217063906350652,1.0
10822,10822,강윤/Noun,9,0,9,2.2229632099588756e-05,0.00012217063906350652,1.0
10823,10823,벙어리/Noun,9,0,9,2.2229632099588756e-05,0.00012217063906350652,1.0
10824,10824,웹하드/Noun,9,0,9,2.2229632099588756e-05,0.00012217063906350652,1.0
10825,10825,낚였음/Noun,9,0,9,2.2229632099588756e-05,0.00012217063906350652,1.0
10826,10826,폐기/Noun,9,0,9,2.2229632099588756e-05,0.00012217063906350652,1.0
10827,10827,전라/Noun,9,0,9,2.2229632099588756e-05,0.00012217063906350652,1.0
10828,10828,오락가락/Noun,9,0,9,2.2229632099588756e-05,0.00012217063906350652,1.0
10829,10829,승질/Noun,9,0,9,2.2229632099588756e-05,0.00012217063906350652,1.0
10830,10830,맹물/Noun,9,0,9,2.2229632099588756e-05,0.00012217063906350652,1.0
10831,10831,배짱/Noun,9,0,9,2.2229632099588756e-05,0.00012217063906350652,1.0
10832,10832,괘씸하다/Adjective,9,0,9,2.2229632099588756e-05,0.00012217063906350652,1.0
10833,10833,귀염/Noun,9,9,0,0.00012226297654773814,2.2212843466092093e-05,1.0
10834,10834,멘마/Noun,9,9,0,0.00012226297654773814,2.2212843466092093e-05,1.0
10835,10835,썰렁/Noun,9,0,9,2.2229632099588756e-05,0.00012217063906350652,1.0
10836,10836,3500원/Number,9,0,9,2.2229632099588756e-05,0.00012217063906350652,1.0
10837,10837,하물며/Noun,9,0,9,2.2229632099588756e-05,0.00012217063906350652,1.0
10838,10838,좃/Noun,9,0,9,2.2229632099588756e-05,0.00012217063906350652,1.0
10839,10839,스크린쿼터제/Noun,9,0,9,2.2229632099588756e-05,0.00012217063906350652,1.0
10840,10840,시티헌터/Noun,9,9,0,0.00012226297654773814,2.2212843466092093e-05,1.0
10841,10841,잼잼/Noun,9,9,0,0.00012226297654773814,2.2212843466092093e-05,1.0
10842,10842,보다만/Josa,9,0,9,2.2229632099588756e-05,0.00012217063906350652,1.0
10843,10843,안이하다/Adjective,9,0,9,2.2229632099588756e-05,0.00012217063906350652,1.0
10844,10844,우좀/Noun,9,0,9,2.2229632099588756e-05,0.00012217063906350652,1.0
10845,10845,악/Exclamation,9,0,9,2.2229632099588756e-05,0.00012217063906350652,1.0
10846,10846,지창욱/Noun,9,9,0,0.00012226297654773814,2.2212843466092093e-05,1.0
10847,10847,Love/Alpha,9,9,0,0.00012226297654773814,2.2212843466092093e-05,1.0
10848,10848,ㄲㅈ/KoreanParticle,9,0,9,2.2229632099588756e-05,0.00012217063906350652,1.0
10849,10849,수화/Noun,9,9,0,0.00012226297654773814,2.2212843466092093e-05,1.0
10850,10850,남일/Noun,9,9,0,0.00012226297654773814,2.2212843466092093e-05,1.0
10851,10851,고흐/Noun,9,9,0,0.00012226297654773814,2.2212843466092093e-05,1.0
10852,10852,민비/Noun,9,0,9,2.2229632099588756e-05,0.00012217063906350652,1.0
10853,10853,핵폐기물/Noun,9,0,9,2.2229632099588756e-05,0.00012217063906350652,1.0
10854,10854,버젓이/Adverb,9,0,9,2.2229632099588756e-05,0.00012217063906350652,1.0
10855,10855,낚이/Noun,9,0,9,2.2229632099588756e-05,0.00012217063906350652,1.0
10856,10856,탁하다/Adjective,9,1,8,3.334444814938313e-05,0.00011106421733046048,0.8888888888888888
10857,10857,".,.,/Punctuation",9,1,8,3.334444814938313e-05,0.00011106421733046048,0.8888888888888888
10858,10858,다정하다/Adjective,9,8,1,0.00011114816049794375,3.331926519913814e-05,0.8888888888888888
10859,10859,인과관계/Noun,9,1,8,3.334444814938313e-05,0.00011106421733046048,0.8888888888888888
10860,10860,끌어내리다/Verb,9,1,8,3.334444814938313e-05,0.00011106421733046048,0.8888888888888888
10861,10861,씩/Noun,9,1,8,3.334444814938313e-05,0.00011106421733046048,0.8888888888888888
10862,10862,비장/Noun,9,8,1,0.00011114816049794375,3.331926519913814e-05,0.8888888888888888
10863,10863,시세/Noun,9,8,1,0.00011114816049794375,3.331926519913814e-05,0.8888888888888888
10864,10864,95분/Number,9,1,8,3.334444814938313e-05,0.00011106421733046048,0.8888888888888888
10865,10865,고소/Noun,9,1,8,3.334444814938313e-05,0.00011106421733046048,0.8888888888888888
10866,10866,청초하다/Adjective,9,8,1,0.00011114816049794375,3.331926519913814e-05,0.8888888888888888
10867,10867,드림하이/Noun,9,1,8,3.334444814938313e-05,0.00011106421733046048,0.8888888888888888
10868,10868,윤두준/Noun,9,8,1,0.00011114816049794375,3.331926519913814e-05,0.8888888888888888
10869,10869,브로드웨이/Noun,9,8,1,0.00011114816049794375,3.331926519913814e-05,0.8888888888888888
10870,10870,약탈/Noun,9,1,8,3.334444814938313e-05,0.00011106421733046048,0.8888888888888888
10871,10871,캐롤/Noun,9,8,1,0.00011114816049794375,3.331926519913814e-05,0.8888888888888888
10872,10872,너리/Noun,9,1,8,3.334444814938313e-05,0.00011106421733046048,0.8888888888888888
10873,10873,봉작/Noun,9,1,8,3.334444814938313e-05,0.00011106421733046048,0.8888888888888888
10874,10874,bomb/Alpha,9,1,8,3.334444814938313e-05,0.00011106421733046048,0.8888888888888888
10875,10875,위조/Noun,9,1,8,3.334444814938313e-05,0.00011106421733046048,0.8888888888888888
10876,10876,강연/Noun,9,8,1,0.00011114816049794375,3.331926519913814e-05,0.8888888888888888
10877,10877,사이보그/Noun,9,1,8,3.334444814938313e-05,0.00011106421733046048,0.8888888888888888
10878,10878,소오강호/Noun,9,8,1,0.00011114816049794375,3.331926519913814e-05,0.8888888888888888
10879,10879,나요/Eomi,9,8,1,0.00011114816049794375,3.331926519913814e-05,0.8888888888888888
10880,10880,선셋/Noun,9,8,1,0.00011114816049794375,3.331926519913814e-05,0.8888888888888888
10881,10881,딴판/Noun,9,1,8,3.334444814938313e-05,0.00011106421733046048,0.8888888888888888
10882,10882,읎/Noun,9,1,8,3.334444814938313e-05,0.00011106421733046048,0.8888888888888888
10883,10883,블로그/Noun,9,1,8,3.334444814938313e-05,0.00011106421733046048,0.8888888888888888
10884,10884,가원/Noun,9,8,1,0.00011114816049794375,3.331926519913814e-05,0.8888888888888888
10885,10885,본보기/Noun,9,1,8,3.334444814938313e-05,0.00011106421733046048,0.8888888888888888
10886,10886,비웃음/Noun,9,1,8,3.334444814938313e-05,0.00011106421733046048,0.8888888888888888
10887,10887,모기/Noun,9,1,8,3.334444814938313e-05,0.00011106421733046048,0.8888888888888888
10888,10888,앵앵거리다/Verb,9,1,8,3.334444814938313e-05,0.00011106421733046048,0.8888888888888888
10889,10889,파국/Noun,9,8,1,0.00011114816049794375,3.331926519913814e-05,0.8888888888888888
10890,10890,이수혁/Noun,9,8,1,0.00011114816049794375,3.331926519913814e-05,0.8888888888888888
10891,10891,쪼가리/Noun,9,1,8,3.334444814938313e-05,0.00011106421733046048,0.8888888888888888
10892,10892,돕기/Noun,9,1,8,3.334444814938313e-05,0.00011106421733046048,0.8888888888888888
10893,10893,ucc/Alpha,9,1,8,3.334444814938313e-05,0.00011106421733046048,0.8888888888888888
10894,10894,수백향/Noun,9,8,1,0.00011114816049794375,3.331926519913814e-05,0.8888888888888888
10895,10895,성범죄/Noun,9,1,8,3.334444814938313e-05,0.00011106421733046048,0.8888888888888888
10896,10896,불안감/Noun,9,8,1,0.00011114816049794375,3.331926519913814e-05,0.8888888888888888
10897,10897,난잡/Noun,9,1,8,3.334444814938313e-05,0.00011106421733046048,0.8888888888888888
10898,10898,폐가/Noun,9,1,8,3.334444814938313e-05,0.00011106421733046048,0.8888888888888888
10899,10899,설국열차/Noun,9,8,1,0.00011114816049794375,3.331926519913814e-05,0.8888888888888888
10900,10900,수선/Noun,9,1,8,3.334444814938313e-05,0.00011106421733046048,0.8888888888888888
10901,10901,우피/Noun,9,8,1,0.00011114816049794375,3.331926519913814e-05,0.8888888888888888
10902,10902,....................../Punctuation,9,1,8,3.334444814938313e-05,0.00011106421733046048,0.8888888888888888
10903,10903,그늘/Noun,9,8,1,0.00011114816049794375,3.331926519913814e-05,0.8888888888888888
10904,10904,퇴물/Noun,9,1,8,3.334444814938313e-05,0.00011106421733046048,0.8888888888888888
10905,10905,들통/Noun,9,1,8,3.334444814938313e-05,0.00011106421733046048,0.8888888888888888
10906,10906,해전/Noun,9,8,1,0.00011114816049794375,3.331926519913814e-05,0.8888888888888888
10907,10907,어미/Noun,9,8,1,0.00011114816049794375,3.331926519913814e-05,0.8888888888888888
10908,10908,뒈지다/Verb,9,1,8,3.334444814938313e-05,0.00011106421733046048,0.8888888888888888
10909,10909,유통/Noun,9,1,8,3.334444814938313e-05,0.00011106421733046048,0.8888888888888888
10910,10910,복합/Noun,9,8,1,0.00011114816049794375,3.331926519913814e-05,0.8888888888888888
10911,10911,진행형/Noun,9,8,1,0.00011114816049794375,3.331926519913814e-05,0.8888888888888888
10912,10912,만도/Noun,9,1,8,3.334444814938313e-05,0.00011106421733046048,0.8888888888888888
10913,10913,스폰서/Noun,9,1,8,3.334444814938313e-05,0.00011106421733046048,0.8888888888888888
10914,10914,머싯/Noun,9,8,1,0.00011114816049794375,3.331926519913814e-05,0.8888888888888888
10915,10915,불쾌감/Noun,9,1,8,3.334444814938313e-05,0.00011106421733046048,0.8888888888888888
10916,10916,조상/Noun,9,8,1,0.00011114816049794375,3.331926519913814e-05,0.8888888888888888
10917,10917,쪽박/Noun,9,1,8,3.334444814938313e-05,0.00011106421733046048,0.8888888888888888
10918,10918,중화사상/Noun,9,1,8,3.334444814938313e-05,0.00011106421733046048,0.8888888888888888
10919,10919,뺑소니/Noun,9,1,8,3.334444814938313e-05,0.00011106421733046048,0.8888888888888888
10920,10920,덴/Noun,9,1,8,3.334444814938313e-05,0.00011106421733046048,0.8888888888888888
10921,10921,전략/Noun,9,1,8,3.334444814938313e-05,0.00011106421733046048,0.8888888888888888
10922,10922,아이즈/Noun,9,8,1,0.00011114816049794375,3.331926519913814e-05,0.8888888888888888
10923,10923,4.4/Number,9,1,8,3.334444814938313e-05,0.00011106421733046048,0.8888888888888888
10924,10924,후려치다/Verb,9,1,8,3.334444814938313e-05,0.00011106421733046048,0.8888888888888888
10925,10925,꽃뱀/Noun,9,1,8,3.334444814938313e-05,0.00011106421733046048,0.8888888888888888
10926,10926,로프/Noun,9,8,1,0.00011114816049794375,3.331926519913814e-05,0.8888888888888888
10927,10927,매즈/Noun,9,8,1,0.00011114816049794375,3.331926519913814e-05,0.8888888888888888
10928,10928,가증/Noun,9,1,8,3.334444814938313e-05,0.00011106421733046048,0.8888888888888888
10929,10929,마음대로/Noun,9,1,8,3.334444814938313e-05,0.00011106421733046048,0.8888888888888888
10930,10930,들러리/Noun,9,1,8,3.334444814938313e-05,0.00011106421733046048,0.8888888888888888
10931,10931,인심/Noun,9,1,8,3.334444814938313e-05,0.00011106421733046048,0.8888888888888888
10932,10932,졸이다/Verb,9,8,1,0.00011114816049794375,3.331926519913814e-05,0.8888888888888888
10933,10933,생방/Noun,9,1,8,3.334444814938313e-05,0.00011106421733046048,0.8888888888888888
10934,10934,원조교제/Noun,9,1,8,3.334444814938313e-05,0.00011106421733046048,0.8888888888888888
10935,10935,꼭꼭/Noun,9,8,1,0.00011114816049794375,3.331926519913814e-05,0.8888888888888888
10936,10936,더없이/Noun,9,8,1,0.00011114816049794375,3.331926519913814e-05,0.8888888888888888
10937,10937,라스베가스/Noun,9,8,1,0.00011114816049794375,3.331926519913814e-05,0.8888888888888888
10938,10938,민세/Noun,9,1,8,3.334444814938313e-05,0.00011106421733046048,0.8888888888888888
10939,10939,감미롭다/Adjective,9,8,1,0.00011114816049794375,3.331926519913814e-05,0.8888888888888888
10940,10940,이명세/Noun,9,8,1,0.00011114816049794375,3.331926519913814e-05,0.8888888888888888
10941,10941,정열/Noun,9,8,1,0.00011114816049794375,3.331926519913814e-05,0.8888888888888888
10942,10942,시로/Noun,9,8,1,0.00011114816049794375,3.331926519913814e-05,0.8888888888888888
10943,10943,수수하다/Adjective,9,8,1,0.00011114816049794375,3.331926519913814e-05,0.8888888888888888
10944,10944,질의/Noun,9,1,8,3.334444814938313e-05,0.00011106421733046048,0.8888888888888888
10945,10945,리더십/Noun,9,8,1,0.00011114816049794375,3.331926519913814e-05,0.8888888888888888
10946,10946,8000원/Number,9,1,8,3.334444814938313e-05,0.00011106421733046048,0.8888888888888888
10947,10947,캬악/Noun,9,1,8,3.334444814938313e-05,0.00011106421733046048,0.8888888888888888
10948,10948,알렉산더/Noun,9,8,1,0.00011114816049794375,3.331926519913814e-05,0.8888888888888888
10949,10949,도희/Noun,9,1,8,3.334444814938313e-05,0.00011106421733046048,0.8888888888888888
10950,10950,삶속/Noun,9,8,1,0.00011114816049794375,3.331926519913814e-05,0.8888888888888888
10951,10951,구체/Noun,9,8,1,0.00011114816049794375,3.331926519913814e-05,0.8888888888888888
10952,10952,이상/Foreign,9,1,8,3.334444814938313e-05,0.00011106421733046048,0.8888888888888888
10953,10953,돌변/Noun,9,1,8,3.334444814938313e-05,0.00011106421733046048,0.8888888888888888
10954,10954,게으르다/Adjective,9,1,8,3.334444814938313e-05,0.00011106421733046048,0.8888888888888888
10955,10955,목요일/Noun,9,8,1,0.00011114816049794375,3.331926519913814e-05,0.8888888888888888
10956,10956,크림슨/Noun,9,1,8,3.334444814938313e-05,0.00011106421733046048,0.8888888888888888
10957,10957,우유부단하다/Adjective,9,2,7,4.445926419917751e-05,9.995779559741441e-05,0.7777777777777778
10958,10958,필히/Noun,9,7,2,0.0001000333444481494,4.4425686932184186e-05,0.7777777777777778
10959,10959,선도/Noun,9,2,7,4.445926419917751e-05,9.995779559741441e-05,0.7777777777777778
10960,10960,그루/Noun,9,7,2,0.0001000333444481494,4.4425686932184186e-05,0.7777777777777778
10961,10961,살펴보다/Verb,9,2,7,4.445926419917751e-05,9.995779559741441e-05,0.7777777777777778
10962,10962,리자/Noun,9,2,7,4.445926419917751e-05,9.995779559741441e-05,0.7777777777777778
10963,10963,꿇다/Verb,9,7,2,0.0001000333444481494,4.4425686932184186e-05,0.7777777777777778
10964,10964,사토/Noun,9,7,2,0.0001000333444481494,4.4425686932184186e-05,0.7777777777777778
10965,10965,존박/Noun,9,7,2,0.0001000333444481494,4.4425686932184186e-05,0.7777777777777778
10966,10966,물속/Noun,9,2,7,4.445926419917751e-05,9.995779559741441e-05,0.7777777777777778
10967,10967,수나/Noun,9,2,7,4.445926419917751e-05,9.995779559741441e-05,0.7777777777777778
10968,10968,볼트/Noun,9,7,2,0.0001000333444481494,4.4425686932184186e-05,0.7777777777777778
10969,10969,해프닝/Noun,9,2,7,4.445926419917751e-05,9.995779559741441e-05,0.7777777777777778
10970,10970,지체/Noun,9,2,7,4.445926419917751e-05,9.995779559741441e-05,0.7777777777777778
10971,10971,토막/Noun,9,2,7,4.445926419917751e-05,9.995779559741441e-05,0.7777777777777778
10972,10972,잠입/Noun,9,2,7,4.445926419917751e-05,9.995779559741441e-05,0.7777777777777778
10973,10973,스폰/Noun,9,2,7,4.445926419917751e-05,9.995779559741441e-05,0.7777777777777778
10974,10974,롤모델/Noun,9,7,2,0.0001000333444481494,4.4425686932184186e-05,0.7777777777777778
10975,10975,배드씬/Noun,9,2,7,4.445926419917751e-05,9.995779559741441e-05,0.7777777777777778
10976,10976,울프/Noun,9,7,2,0.0001000333444481494,4.4425686932184186e-05,0.7777777777777778
10977,10977,만듭시/Noun,9,2,7,4.445926419917751e-05,9.995779559741441e-05,0.7777777777777778
10978,10978,하룻밤/Noun,9,2,7,4.445926419917751e-05,9.995779559741441e-05,0.7777777777777778
10979,10979,잠재/Noun,9,7,2,0.0001000333444481494,4.4425686932184186e-05,0.7777777777777778
10980,10980,띄엄띄엄/Noun,9,2,7,4.445926419917751e-05,9.995779559741441e-05,0.7777777777777778
10981,10981,게시판/Noun,9,2,7,4.445926419917751e-05,9.995779559741441e-05,0.7777777777777778
10982,10982,가늠/Noun,9,7,2,0.0001000333444481494,4.4425686932184186e-05,0.7777777777777778
10983,10983,선라이즈/Noun,9,7,2,0.0001000333444481494,4.4425686932184186e-05,0.7777777777777778
10984,10984,무수/Noun,9,7,2,0.0001000333444481494,4.4425686932184186e-05,0.7777777777777778
10985,10985,중세시대/Noun,9,7,2,0.0001000333444481494,4.4425686932184186e-05,0.7777777777777778
10986,10986,데모/Noun,9,2,7,4.445926419917751e-05,9.995779559741441e-05,0.7777777777777778
10987,10987,창정/Noun,9,7,2,0.0001000333444481494,4.4425686932184186e-05,0.7777777777777778
10988,10988,그랜트/Noun,9,7,2,0.0001000333444481494,4.4425686932184186e-05,0.7777777777777778
10989,10989,빠져나가다/Verb,9,7,2,0.0001000333444481494,4.4425686932184186e-05,0.7777777777777778
10990,10990,맨발/Noun,9,7,2,0.0001000333444481494,4.4425686932184186e-05,0.7777777777777778
10991,10991,미약/Noun,9,2,7,4.445926419917751e-05,9.995779559741441e-05,0.7777777777777778
10992,10992,79년/Number,9,7,2,0.0001000333444481494,4.4425686932184186e-05,0.7777777777777778
10993,10993,광장/Noun,9,7,2,0.0001000333444481494,4.4425686932184186e-05,0.7777777777777778
10994,10994,찬가/Noun,9,7,2,0.0001000333444481494,4.4425686932184186e-05,0.7777777777777778
10995,10995,always/Alpha,9,7,2,0.0001000333444481494,4.4425686932184186e-05,0.7777777777777778
10996,10996,무신/Noun,9,2,7,4.445926419917751e-05,9.995779559741441e-05,0.7777777777777778
10997,10997,비단/Noun,9,7,2,0.0001000333444481494,4.4425686932184186e-05,0.7777777777777778
10998,10998,뻥튀기/Noun,9,2,7,4.445926419917751e-05,9.995779559741441e-05,0.7777777777777778
10999,10999,발언/Noun,9,2,7,4.445926419917751e-05,9.995779559741441e-05,0.7777777777777778
11000,11000,가감/Noun,9,7,2,0.0001000333444481494,4.4425686932184186e-05,0.7777777777777778
11001,11001,씽/Adverb,9,2,7,4.445926419917751e-05,9.995779559741441e-05,0.7777777777777778
11002,11002,라든가/Josa,9,2,7,4.445926419917751e-05,9.995779559741441e-05,0.7777777777777778
11003,11003,스파이크/Noun,9,2,7,4.445926419917751e-05,9.995779559741441e-05,0.7777777777777778
11004,11004,페킨파/Noun,9,7,2,0.0001000333444481494,4.4425686932184186e-05,0.7777777777777778
11005,11005,잠자리/Noun,9,2,7,4.445926419917751e-05,9.995779559741441e-05,0.7777777777777778
11006,11006,어눌하다/Adjective,9,2,7,4.445926419917751e-05,9.995779559741441e-05,0.7777777777777778
11007,11007,윤여정/Noun,9,7,2,0.0001000333444481494,4.4425686932184186e-05,0.7777777777777778
11008,11008,가루/Noun,9,2,7,4.445926419917751e-05,9.995779559741441e-05,0.7777777777777778
11009,11009,후자/Noun,9,2,7,4.445926419917751e-05,9.995779559741441e-05,0.7777777777777778
11010,11010,장물/Noun,9,2,7,4.445926419917751e-05,9.995779559741441e-05,0.7777777777777778
11011,11011,식민지/Noun,9,2,7,4.445926419917751e-05,9.995779559741441e-05,0.7777777777777778
11012,11012,에미/Noun,9,7,2,0.0001000333444481494,4.4425686932184186e-05,0.7777777777777778
11013,11013,격하/Noun,9,7,2,0.0001000333444481494,4.4425686932184186e-05,0.7777777777777778
11014,11014,재우다/Verb,9,2,7,4.445926419917751e-05,9.995779559741441e-05,0.7777777777777778
11015,11015,존엄성/Noun,9,7,2,0.0001000333444481494,4.4425686932184186e-05,0.7777777777777778
11016,11016,반짝/Noun,9,2,7,4.445926419917751e-05,9.995779559741441e-05,0.7777777777777778
11017,11017,가엾다/Adjective,9,2,7,4.445926419917751e-05,9.995779559741441e-05,0.7777777777777778
11018,11018,껄렁하다/Adjective,9,2,7,4.445926419917751e-05,9.995779559741441e-05,0.7777777777777778
11019,11019,뒷북/Noun,9,7,2,0.0001000333444481494,4.4425686932184186e-05,0.7777777777777778
11020,11020,위더/Noun,9,2,7,4.445926419917751e-05,9.995779559741441e-05,0.7777777777777778
11021,11021,우아/Exclamation,9,7,2,0.0001000333444481494,4.4425686932184186e-05,0.7777777777777778
11022,11022,급박하다/Adjective,9,2,7,4.445926419917751e-05,9.995779559741441e-05,0.7777777777777778
11023,11023,발리다/Verb,9,2,7,4.445926419917751e-05,9.995779559741441e-05,0.7777777777777778
11024,11024,레이저/Noun,9,2,7,4.445926419917751e-05,9.995779559741441e-05,0.7777777777777778
11025,11025,전복/Noun,9,2,7,4.445926419917751e-05,9.995779559741441e-05,0.7777777777777778
11026,11026,적벽대전/Noun,9,2,7,4.445926419917751e-05,9.995779559741441e-05,0.7777777777777778
11027,11027,깨물다/Verb,9,7,2,0.0001000333444481494,4.4425686932184186e-05,0.7777777777777778
11028,11028,포효/Noun,9,7,2,0.0001000333444481494,4.4425686932184186e-05,0.7777777777777778
11029,11029,타쿠야/Noun,9,7,2,0.0001000333444481494,4.4425686932184186e-05,0.7777777777777778
11030,11030,마술사/Noun,9,7,2,0.0001000333444481494,4.4425686932184186e-05,0.7777777777777778
11031,11031,치졸하다/Adjective,9,2,7,4.445926419917751e-05,9.995779559741441e-05,0.7777777777777778
11032,11032,년놈/Noun,9,2,7,4.445926419917751e-05,9.995779559741441e-05,0.7777777777777778
11033,11033,가인/Noun,9,7,2,0.0001000333444481494,4.4425686932184186e-05,0.7777777777777778
11034,11034,몽정기/Noun,9,2,7,4.445926419917751e-05,9.995779559741441e-05,0.7777777777777778
11035,11035,유모/Noun,9,7,2,0.0001000333444481494,4.4425686932184186e-05,0.7777777777777778
11036,11036,엘프/Noun,9,7,2,0.0001000333444481494,4.4425686932184186e-05,0.7777777777777778
11037,11037,흐믓/Noun,9,7,2,0.0001000333444481494,4.4425686932184186e-05,0.7777777777777778
11038,11038,자라나다/Verb,9,7,2,0.0001000333444481494,4.4425686932184186e-05,0.7777777777777778
11039,11039,일어/Noun,9,2,7,4.445926419917751e-05,9.995779559741441e-05,0.7777777777777778
11040,11040,단순화/Noun,9,2,7,4.445926419917751e-05,9.995779559741441e-05,0.7777777777777778
11041,11041,학과/Noun,9,2,7,4.445926419917751e-05,9.995779559741441e-05,0.7777777777777778
11042,11042,기타등등/Noun,9,2,7,4.445926419917751e-05,9.995779559741441e-05,0.7777777777777778
11043,11043,말초신경/Noun,9,2,7,4.445926419917751e-05,9.995779559741441e-05,0.7777777777777778
11044,11044,미카/Noun,9,7,2,0.0001000333444481494,4.4425686932184186e-05,0.7777777777777778
11045,11045,유기견/Noun,9,7,2,0.0001000333444481494,4.4425686932184186e-05,0.7777777777777778
11046,11046,IPTV/Alpha,9,2,7,4.445926419917751e-05,9.995779559741441e-05,0.7777777777777778
11047,11047,깡/Noun,9,2,7,4.445926419917751e-05,9.995779559741441e-05,0.7777777777777778
11048,11048,폭망/Noun,9,2,7,4.445926419917751e-05,9.995779559741441e-05,0.7777777777777778
11049,11049,소고기/Noun,9,2,7,4.445926419917751e-05,9.995779559741441e-05,0.7777777777777778
11050,11050,마미/Noun,9,7,2,0.0001000333444481494,4.4425686932184186e-05,0.7777777777777778
11051,11051,고유/Noun,9,7,2,0.0001000333444481494,4.4425686932184186e-05,0.7777777777777778
11052,11052,빅맨/Noun,9,7,2,0.0001000333444481494,4.4425686932184186e-05,0.7777777777777778
11053,11053,성나다/Verb,9,2,7,4.445926419917751e-05,9.995779559741441e-05,0.7777777777777778
11054,11054,발란스/Noun,9,2,7,4.445926419917751e-05,9.995779559741441e-05,0.7777777777777778
11055,11055,스모/Noun,9,2,7,4.445926419917751e-05,9.995779559741441e-05,0.7777777777777778
11056,11056,황폐/Noun,9,7,2,0.0001000333444481494,4.4425686932184186e-05,0.7777777777777778
11057,11057,바란/Noun,9,2,7,4.445926419917751e-05,9.995779559741441e-05,0.7777777777777778
11058,11058,빈센트/Noun,9,7,2,0.0001000333444481494,4.4425686932184186e-05,0.7777777777777778
11059,11059,원츄/Noun,9,7,2,0.0001000333444481494,4.4425686932184186e-05,0.7777777777777778
11060,11060,예기/Noun,9,2,7,4.445926419917751e-05,9.995779559741441e-05,0.7777777777777778
11061,11061,자폭/Noun,9,2,7,4.445926419917751e-05,9.995779559741441e-05,0.7777777777777778
11062,11062,주일/Noun,9,7,2,0.0001000333444481494,4.4425686932184186e-05,0.7777777777777778
11063,11063,지갑/Noun,9,2,7,4.445926419917751e-05,9.995779559741441e-05,0.7777777777777778
11064,11064,.!!!!/Punctuation,9,7,2,0.0001000333444481494,4.4425686932184186e-05,0.7777777777777778
11065,11065,따귀/Noun,9,2,7,4.445926419917751e-05,9.995779559741441e-05,0.7777777777777778
11066,11066,존시나/Noun,9,2,7,4.445926419917751e-05,9.995779559741441e-05,0.7777777777777778
11067,11067,헤라클레스/Noun,9,2,7,4.445926419917751e-05,9.995779559741441e-05,0.7777777777777778
11068,11068,최정윤/Noun,9,2,7,4.445926419917751e-05,9.995779559741441e-05,0.7777777777777778
11069,11069,정신연령/Noun,9,2,7,4.445926419917751e-05,9.995779559741441e-05,0.7777777777777778
11070,11070,선덕여왕/Noun,9,7,2,0.0001000333444481494,4.4425686932184186e-05,0.7777777777777778
11071,11071,실태/Noun,9,7,2,0.0001000333444481494,4.4425686932184186e-05,0.7777777777777778
11072,11072,낙원/Noun,9,7,2,0.0001000333444481494,4.4425686932184186e-05,0.7777777777777778
11073,11073,~^^*/Punctuation,9,7,2,0.0001000333444481494,4.4425686932184186e-05,0.7777777777777778
11074,11074,ㅎㄷㄷㄷ/KoreanParticle,9,7,2,0.0001000333444481494,4.4425686932184186e-05,0.7777777777777778
11075,11075,간츠/Noun,9,2,7,4.445926419917751e-05,9.995779559741441e-05,0.7777777777777778
11076,11076,이송희일/Noun,9,2,7,4.445926419917751e-05,9.995779559741441e-05,0.7777777777777778
11077,11077,스카/Noun,9,7,2,0.0001000333444481494,4.4425686932184186e-05,0.7777777777777778
11078,11078,이따금/Adverb,9,7,2,0.0001000333444481494,4.4425686932184186e-05,0.7777777777777778
11079,11079,처제/Noun,9,2,7,4.445926419917751e-05,9.995779559741441e-05,0.7777777777777778
11080,11080,주무시다/Verb,9,2,7,4.445926419917751e-05,9.995779559741441e-05,0.7777777777777778
11081,11081,뤽베송/Noun,9,7,2,0.0001000333444481494,4.4425686932184186e-05,0.7777777777777778
11082,11082,이적/Noun,9,7,2,0.0001000333444481494,4.4425686932184186e-05,0.7777777777777778
11083,11083,레슬리/Noun,9,7,2,0.0001000333444481494,4.4425686932184186e-05,0.7777777777777778
11084,11084,무릎팍/Noun,9,3,6,5.5574080248971876e-05,8.885137386436837e-05,0.6666666666666666
11085,11085,조그만/Noun,9,6,3,8.891852839835501e-05,5.553210866523024e-05,0.6666666666666666
11086,11086,얼룩지다/Verb,9,6,3,8.891852839835501e-05,5.553210866523024e-05,0.6666666666666666
11087,11087,사단/Noun,9,6,3,8.891852839835501e-05,5.553210866523024e-05,0.6666666666666666
11088,11088,외부/Noun,9,6,3,8.891852839835501e-05,5.553210866523024e-05,0.6666666666666666
11089,11089,윤성호/Noun,9,6,3,8.891852839835501e-05,5.553210866523024e-05,0.6666666666666666
11090,11090,학교폭력/Noun,9,3,6,5.5574080248971876e-05,8.885137386436837e-05,0.6666666666666666
11091,11091,케리/Noun,9,6,3,8.891852839835501e-05,5.553210866523024e-05,0.6666666666666666
11092,11092,럭키/Noun,9,3,6,5.5574080248971876e-05,8.885137386436837e-05,0.6666666666666666
11093,11093,힘주다/Verb,9,3,6,5.5574080248971876e-05,8.885137386436837e-05,0.6666666666666666
11094,11094,디아/Noun,9,3,6,5.5574080248971876e-05,8.885137386436837e-05,0.6666666666666666
11095,11095,조종사/Noun,9,3,6,5.5574080248971876e-05,8.885137386436837e-05,0.6666666666666666
11096,11096,샤이닝/Noun,9,3,6,5.5574080248971876e-05,8.885137386436837e-05,0.6666666666666666
11097,11097,파장/Noun,9,6,3,8.891852839835501e-05,5.553210866523024e-05,0.6666666666666666
11098,11098,남장/Noun,9,6,3,8.891852839835501e-05,5.553210866523024e-05,0.6666666666666666
11099,11099,상대방/Noun,9,6,3,8.891852839835501e-05,5.553210866523024e-05,0.6666666666666666
11100,11100,",.,/Punctuation",9,3,6,5.5574080248971876e-05,8.885137386436837e-05,0.6666666666666666
11101,11101,안햇/Noun,9,3,6,5.5574080248971876e-05,8.885137386436837e-05,0.6666666666666666
11102,11102,장가휘/Noun,9,6,3,8.891852839835501e-05,5.553210866523024e-05,0.6666666666666666
11103,11103,꼼꼼하다/Adjective,9,6,3,8.891852839835501e-05,5.553210866523024e-05,0.6666666666666666
11104,11104,지난주/Noun,9,3,6,5.5574080248971876e-05,8.885137386436837e-05,0.6666666666666666
11105,11105,사정봉/Noun,9,3,6,5.5574080248971876e-05,8.885137386436837e-05,0.6666666666666666
11106,11106,럽/Noun,9,6,3,8.891852839835501e-05,5.553210866523024e-05,0.6666666666666666
11107,11107,마가렛/Noun,9,6,3,8.891852839835501e-05,5.553210866523024e-05,0.6666666666666666
11108,11108,관음증/Noun,9,6,3,8.891852839835501e-05,5.553210866523024e-05,0.6666666666666666
11109,11109,동상/Noun,9,3,6,5.5574080248971876e-05,8.885137386436837e-05,0.6666666666666666
11110,11110,대갈/Noun,9,3,6,5.5574080248971876e-05,8.885137386436837e-05,0.6666666666666666
11111,11111,예민하다/Adjective,9,6,3,8.891852839835501e-05,5.553210866523024e-05,0.6666666666666666
11112,11112,4.3/Number,9,3,6,5.5574080248971876e-05,8.885137386436837e-05,0.6666666666666666
11113,11113,비리다/Adjective,9,3,6,5.5574080248971876e-05,8.885137386436837e-05,0.6666666666666666
11114,11114,스크린쿼터/Noun,9,3,6,5.5574080248971876e-05,8.885137386436837e-05,0.6666666666666666
11115,11115,아버님/Noun,9,6,3,8.891852839835501e-05,5.553210866523024e-05,0.6666666666666666
11116,11116,대장금/Noun,9,6,3,8.891852839835501e-05,5.553210866523024e-05,0.6666666666666666
11117,11117,7.8/Number,9,6,3,8.891852839835501e-05,5.553210866523024e-05,0.6666666666666666
11118,11118,린데/Noun,9,3,6,5.5574080248971876e-05,8.885137386436837e-05,0.6666666666666666
11119,11119,뿜어내다/Verb,9,6,3,8.891852839835501e-05,5.553210866523024e-05,0.6666666666666666
11120,11120,사망유희/Noun,9,6,3,8.891852839835501e-05,5.553210866523024e-05,0.6666666666666666
11121,11121,조율/Noun,9,6,3,8.891852839835501e-05,5.553210866523024e-05,0.6666666666666666
11122,11122,온라인/Noun,9,6,3,8.891852839835501e-05,5.553210866523024e-05,0.6666666666666666
11123,11123,스멜/Noun,9,3,6,5.5574080248971876e-05,8.885137386436837e-05,0.6666666666666666
11124,11124,만빵/Noun,9,6,3,8.891852839835501e-05,5.553210866523024e-05,0.6666666666666666
11125,11125,재발/Noun,9,3,6,5.5574080248971876e-05,8.885137386436837e-05,0.6666666666666666
11126,11126,어떡하다/Adjective,9,6,3,8.891852839835501e-05,5.553210866523024e-05,0.6666666666666666
11127,11127,뭉/Noun,9,3,6,5.5574080248971876e-05,8.885137386436837e-05,0.6666666666666666
11128,11128,응사/Noun,9,3,6,5.5574080248971876e-05,8.885137386436837e-05,0.6666666666666666
11129,11129,찌그러지다/Verb,9,3,6,5.5574080248971876e-05,8.885137386436837e-05,0.6666666666666666
11130,11130,엘리샤/Noun,9,3,6,5.5574080248971876e-05,8.885137386436837e-05,0.6666666666666666
11131,11131,하야/Noun,9,3,6,5.5574080248971876e-05,8.885137386436837e-05,0.6666666666666666
11132,11132,넉/Modifier,9,3,6,5.5574080248971876e-05,8.885137386436837e-05,0.6666666666666666
11133,11133,봉사/Noun,9,6,3,8.891852839835501e-05,5.553210866523024e-05,0.6666666666666666
11134,11134,코빅/Noun,9,6,3,8.891852839835501e-05,5.553210866523024e-05,0.6666666666666666
11135,11135,can/Alpha,9,6,3,8.891852839835501e-05,5.553210866523024e-05,0.6666666666666666
11136,11136,게속/Noun,9,3,6,5.5574080248971876e-05,8.885137386436837e-05,0.6666666666666666
11137,11137,워리어/Noun,9,3,6,5.5574080248971876e-05,8.885137386436837e-05,0.6666666666666666
11138,11138,꾹꾹/Noun,9,3,6,5.5574080248971876e-05,8.885137386436837e-05,0.6666666666666666
11139,11139,여고/Noun,9,3,6,5.5574080248971876e-05,8.885137386436837e-05,0.6666666666666666
11140,11140,필모/Noun,9,3,6,5.5574080248971876e-05,8.885137386436837e-05,0.6666666666666666
11141,11141,싱/Noun,9,3,6,5.5574080248971876e-05,8.885137386436837e-05,0.6666666666666666
11142,11142,우우/Adverb,9,3,6,5.5574080248971876e-05,8.885137386436837e-05,0.6666666666666666
11143,11143,적응하다/Adjective,9,6,3,8.891852839835501e-05,5.553210866523024e-05,0.6666666666666666
11144,11144,희미하다/Adjective,9,3,6,5.5574080248971876e-05,8.885137386436837e-05,0.6666666666666666
11145,11145,숱/Noun,9,3,6,5.5574080248971876e-05,8.885137386436837e-05,0.6666666666666666
11146,11146,보이스/Noun,9,6,3,8.891852839835501e-05,5.553210866523024e-05,0.6666666666666666
11147,11147,표기/Noun,9,3,6,5.5574080248971876e-05,8.885137386436837e-05,0.6666666666666666
11148,11148,배움/Noun,9,6,3,8.891852839835501e-05,5.553210866523024e-05,0.6666666666666666
11149,11149,농/Noun,9,6,3,8.891852839835501e-05,5.553210866523024e-05,0.6666666666666666
11150,11150,전쟁씬/Noun,9,6,3,8.891852839835501e-05,5.553210866523024e-05,0.6666666666666666
11151,11151,유민/Noun,9,6,3,8.891852839835501e-05,5.553210866523024e-05,0.6666666666666666
11152,11152,계층/Noun,9,6,3,8.891852839835501e-05,5.553210866523024e-05,0.6666666666666666
11153,11153,소린/Noun,9,3,6,5.5574080248971876e-05,8.885137386436837e-05,0.6666666666666666
11154,11154,타르/Noun,9,6,3,8.891852839835501e-05,5.553210866523024e-05,0.6666666666666666
11155,11155,거가/Noun,9,6,3,8.891852839835501e-05,5.553210866523024e-05,0.6666666666666666
11156,11156,?;/Punctuation,9,3,6,5.5574080248971876e-05,8.885137386436837e-05,0.6666666666666666
11157,11157,비키다/Verb,9,3,6,5.5574080248971876e-05,8.885137386436837e-05,0.6666666666666666
11158,11158,타격/Noun,9,3,6,5.5574080248971876e-05,8.885137386436837e-05,0.6666666666666666
11159,11159,호크/Noun,9,3,6,5.5574080248971876e-05,8.885137386436837e-05,0.6666666666666666
11160,11160,나문희/Noun,9,3,6,5.5574080248971876e-05,8.885137386436837e-05,0.6666666666666666
11161,11161,쥬드/Noun,9,6,3,8.891852839835501e-05,5.553210866523024e-05,0.6666666666666666
11162,11162,얼빵/Noun,9,3,6,5.5574080248971876e-05,8.885137386436837e-05,0.6666666666666666
11163,11163,핀란드/Noun,9,6,3,8.891852839835501e-05,5.553210866523024e-05,0.6666666666666666
11164,11164,별명/Noun,9,6,3,8.891852839835501e-05,5.553210866523024e-05,0.6666666666666666
11165,11165,일본침몰/Noun,9,3,6,5.5574080248971876e-05,8.885137386436837e-05,0.6666666666666666
11166,11166,호응/Noun,9,3,6,5.5574080248971876e-05,8.885137386436837e-05,0.6666666666666666
11167,11167,값어치/Noun,9,3,6,5.5574080248971876e-05,8.885137386436837e-05,0.6666666666666666
11168,11168,영화장르/Noun,9,3,6,5.5574080248971876e-05,8.885137386436837e-05,0.6666666666666666
11169,11169,아메리칸파이/Noun,9,6,3,8.891852839835501e-05,5.553210866523024e-05,0.6666666666666666
11170,11170,조우/Noun,9,6,3,8.891852839835501e-05,5.553210866523024e-05,0.6666666666666666
11171,11171,거만하다/Adjective,9,3,6,5.5574080248971876e-05,8.885137386436837e-05,0.6666666666666666
11172,11172,영화포스터/Noun,9,3,6,5.5574080248971876e-05,8.885137386436837e-05,0.6666666666666666
11173,11173,진짜사나이/Noun,9,3,6,5.5574080248971876e-05,8.885137386436837e-05,0.6666666666666666
11174,11174,전미선/Noun,9,6,3,8.891852839835501e-05,5.553210866523024e-05,0.6666666666666666
11175,11175,이기우/Noun,9,6,3,8.891852839835501e-05,5.553210866523024e-05,0.6666666666666666
11176,11176,일체/Noun,9,6,3,8.891852839835501e-05,5.553210866523024e-05,0.6666666666666666
11177,11177,흠집/Noun,9,3,6,5.5574080248971876e-05,8.885137386436837e-05,0.6666666666666666
11178,11178,수영장/Noun,9,3,6,5.5574080248971876e-05,8.885137386436837e-05,0.6666666666666666
11179,11179,스노우/Noun,9,3,6,5.5574080248971876e-05,8.885137386436837e-05,0.6666666666666666
11180,11180,>_/Punctuation,9,6,3,8.891852839835501e-05,5.553210866523024e-05,0.6666666666666666
11181,11181,미저리/Noun,9,3,6,5.5574080248971876e-05,8.885137386436837e-05,0.6666666666666666
11182,11182,이태리/Noun,9,6,3,8.891852839835501e-05,5.553210866523024e-05,0.6666666666666666
11183,11183,얼핏/Noun,9,6,3,8.891852839835501e-05,5.553210866523024e-05,0.6666666666666666
11184,11184,몽땅/Noun,9,6,3,8.891852839835501e-05,5.553210866523024e-05,0.6666666666666666
11185,11185,글렌/Noun,9,6,3,8.891852839835501e-05,5.553210866523024e-05,0.6666666666666666
11186,11186,봉만대/Noun,9,3,6,5.5574080248971876e-05,8.885137386436837e-05,0.6666666666666666
11187,11187,실사영화/Noun,9,6,3,8.891852839835501e-05,5.553210866523024e-05,0.6666666666666666
11188,11188,전기톱/Noun,9,3,6,5.5574080248971876e-05,8.885137386436837e-05,0.6666666666666666
11189,11189,뻣/Noun,9,6,3,8.891852839835501e-05,5.553210866523024e-05,0.6666666666666666
11190,11190,생사/Noun,9,6,3,8.891852839835501e-05,5.553210866523024e-05,0.6666666666666666
11191,11191,오예/Noun,9,6,3,8.891852839835501e-05,5.553210866523024e-05,0.6666666666666666
11192,11192,영채/Noun,9,3,6,5.5574080248971876e-05,8.885137386436837e-05,0.6666666666666666
11193,11193,꼴통/Noun,9,3,6,5.5574080248971876e-05,8.885137386436837e-05,0.6666666666666666
11194,11194,Oh/Alpha,9,3,6,5.5574080248971876e-05,8.885137386436837e-05,0.6666666666666666
11195,11195,조선인/Noun,9,3,6,5.5574080248971876e-05,8.885137386436837e-05,0.6666666666666666
11196,11196,이애/Noun,9,6,3,8.891852839835501e-05,5.553210866523024e-05,0.6666666666666666
11197,11197,홍수현/Noun,9,3,6,5.5574080248971876e-05,8.885137386436837e-05,0.6666666666666666
11198,11198,악덕/Noun,9,6,3,8.891852839835501e-05,5.553210866523024e-05,0.6666666666666666
11199,11199,홍수/Noun,9,6,3,8.891852839835501e-05,5.553210866523024e-05,0.6666666666666666
11200,11200,루미/Noun,9,6,3,8.891852839835501e-05,5.553210866523024e-05,0.6666666666666666
11201,11201,동전/Noun,9,6,3,8.891852839835501e-05,5.553210866523024e-05,0.6666666666666666
11202,11202,그램/Noun,9,6,3,8.891852839835501e-05,5.553210866523024e-05,0.6666666666666666
11203,11203,by/Alpha,9,6,3,8.891852839835501e-05,5.553210866523024e-05,0.6666666666666666
11204,11204,펑크/Noun,9,6,3,8.891852839835501e-05,5.553210866523024e-05,0.6666666666666666
11205,11205,극명하다/Adjective,9,3,6,5.5574080248971876e-05,8.885137386436837e-05,0.6666666666666666
11206,11206,쏠때/Noun,9,3,6,5.5574080248971876e-05,8.885137386436837e-05,0.6666666666666666
11207,11207,하인/Noun,9,3,6,5.5574080248971876e-05,8.885137386436837e-05,0.6666666666666666
11208,11208,내다보다/Verb,9,6,3,8.891852839835501e-05,5.553210866523024e-05,0.6666666666666666
11209,11209,보정/Noun,9,3,6,5.5574080248971876e-05,8.885137386436837e-05,0.6666666666666666
11210,11210,알아내다/Verb,9,3,6,5.5574080248971876e-05,8.885137386436837e-05,0.6666666666666666
11211,11211,왕건/Noun,9,3,6,5.5574080248971876e-05,8.885137386436837e-05,0.6666666666666666
11212,11212,더록/Noun,9,3,6,5.5574080248971876e-05,8.885137386436837e-05,0.6666666666666666
11213,11213,턴/Noun,9,6,3,8.891852839835501e-05,5.553210866523024e-05,0.6666666666666666
11214,11214,장모님/Noun,9,6,3,8.891852839835501e-05,5.553210866523024e-05,0.6666666666666666
11215,11215,성추행/Noun,9,3,6,5.5574080248971876e-05,8.885137386436837e-05,0.6666666666666666
11216,11216,십계/Noun,9,6,3,8.891852839835501e-05,5.553210866523024e-05,0.6666666666666666
11217,11217,''/Punctuation,9,3,6,5.5574080248971876e-05,8.885137386436837e-05,0.6666666666666666
11218,11218,요하/Noun,9,3,6,5.5574080248971876e-05,8.885137386436837e-05,0.6666666666666666
11219,11219,콜린스/Noun,9,3,6,5.5574080248971876e-05,8.885137386436837e-05,0.6666666666666666
11220,11220,솟구치다/Verb,9,3,6,5.5574080248971876e-05,8.885137386436837e-05,0.6666666666666666
11221,11221,병기/Noun,9,6,3,8.891852839835501e-05,5.553210866523024e-05,0.6666666666666666
11222,11222,ㅂㄷㅂㄷ/KoreanParticle,9,3,6,5.5574080248971876e-05,8.885137386436837e-05,0.6666666666666666
11223,11223,패러다임/Noun,9,6,3,8.891852839835501e-05,5.553210866523024e-05,0.6666666666666666
11224,11224,들먹이다/Verb,9,3,6,5.5574080248971876e-05,8.885137386436837e-05,0.6666666666666666
11225,11225,과시/Noun,9,3,6,5.5574080248971876e-05,8.885137386436837e-05,0.6666666666666666
11226,11226,금고/Noun,9,6,3,8.891852839835501e-05,5.553210866523024e-05,0.6666666666666666
11227,11227,꼴랑/Adverb,9,3,6,5.5574080248971876e-05,8.885137386436837e-05,0.6666666666666666
11228,11228,여중생/Noun,9,3,6,5.5574080248971876e-05,8.885137386436837e-05,0.6666666666666666
11229,11229,9월/Number,9,3,6,5.5574080248971876e-05,8.885137386436837e-05,0.6666666666666666
11230,11230,태권/Noun,9,3,6,5.5574080248971876e-05,8.885137386436837e-05,0.6666666666666666
11231,11231,휘날리다/Verb,9,3,6,5.5574080248971876e-05,8.885137386436837e-05,0.6666666666666666
11232,11232,맥아더/Noun,9,3,6,5.5574080248971876e-05,8.885137386436837e-05,0.6666666666666666
11233,11233,확보/Noun,9,3,6,5.5574080248971876e-05,8.885137386436837e-05,0.6666666666666666
11234,11234,스킨/Noun,9,3,6,5.5574080248971876e-05,8.885137386436837e-05,0.6666666666666666
11235,11235,날뻔/Noun,9,6,3,8.891852839835501e-05,5.553210866523024e-05,0.6666666666666666
11236,11236,스파르타쿠스/Noun,9,3,6,5.5574080248971876e-05,8.885137386436837e-05,0.6666666666666666
11237,11237,보디가드/Noun,9,3,6,5.5574080248971876e-05,8.885137386436837e-05,0.6666666666666666
11238,11238,가누다/Verb,9,3,6,5.5574080248971876e-05,8.885137386436837e-05,0.6666666666666666
11239,11239,에까지/Josa,9,6,3,8.891852839835501e-05,5.553210866523024e-05,0.6666666666666666
11240,11240,이마/Noun,9,3,6,5.5574080248971876e-05,8.885137386436837e-05,0.6666666666666666
11241,11241,내전/Noun,9,6,3,8.891852839835501e-05,5.553210866523024e-05,0.6666666666666666
11242,11242,물르다/Verb,9,3,6,5.5574080248971876e-05,8.885137386436837e-05,0.6666666666666666
11243,11243,32년/Number,9,6,3,8.891852839835501e-05,5.553210866523024e-05,0.6666666666666666
11244,11244,임은경/Noun,9,3,6,5.5574080248971876e-05,8.885137386436837e-05,0.6666666666666666
11245,11245,난쟁이/Noun,9,3,6,5.5574080248971876e-05,8.885137386436837e-05,0.6666666666666666
11246,11246,밀도/Noun,9,3,6,5.5574080248971876e-05,8.885137386436837e-05,0.6666666666666666
11247,11247,임순례/Noun,9,3,6,5.5574080248971876e-05,8.885137386436837e-05,0.6666666666666666
11248,11248,마네킹/Noun,9,3,6,5.5574080248971876e-05,8.885137386436837e-05,0.6666666666666666
11249,11249,좀처럼/Noun,9,3,6,5.5574080248971876e-05,8.885137386436837e-05,0.6666666666666666
11250,11250,허지웅/Noun,9,3,6,5.5574080248971876e-05,8.885137386436837e-05,0.6666666666666666
11251,11251,마스/Noun,9,6,3,8.891852839835501e-05,5.553210866523024e-05,0.6666666666666666
11252,11252,쩌는데/Noun,9,3,6,5.5574080248971876e-05,8.885137386436837e-05,0.6666666666666666
11253,11253,슬쩍/Adverb,9,3,6,5.5574080248971876e-05,8.885137386436837e-05,0.6666666666666666
11254,11254,선비/Noun,9,3,6,5.5574080248971876e-05,8.885137386436837e-05,0.6666666666666666
11255,11255,굽다/Verb,9,3,6,5.5574080248971876e-05,8.885137386436837e-05,0.6666666666666666
11256,11256,음란/Noun,9,3,6,5.5574080248971876e-05,8.885137386436837e-05,0.6666666666666666
11257,11257,뷰/Noun,9,6,3,8.891852839835501e-05,5.553210866523024e-05,0.6666666666666666
11258,11258,산부인과/Noun,9,3,6,5.5574080248971876e-05,8.885137386436837e-05,0.6666666666666666
11259,11259,Tv/Alpha,9,6,3,8.891852839835501e-05,5.553210866523024e-05,0.6666666666666666
11260,11260,침공/Noun,9,3,6,5.5574080248971876e-05,8.885137386436837e-05,0.6666666666666666
11261,11261,쿠키/Noun,9,3,6,5.5574080248971876e-05,8.885137386436837e-05,0.6666666666666666
11262,11262,로드리게스/Noun,9,6,3,8.891852839835501e-05,5.553210866523024e-05,0.6666666666666666
11263,11263,후리다/Verb,9,3,6,5.5574080248971876e-05,8.885137386436837e-05,0.6666666666666666
11264,11264,성범죄자/Noun,9,3,6,5.5574080248971876e-05,8.885137386436837e-05,0.6666666666666666
11265,11265,인재/Noun,9,6,3,8.891852839835501e-05,5.553210866523024e-05,0.6666666666666666
11266,11266,쏟아내다/Verb,9,6,3,8.891852839835501e-05,5.553210866523024e-05,0.6666666666666666
11267,11267,범람/Noun,9,3,6,5.5574080248971876e-05,8.885137386436837e-05,0.6666666666666666
11268,11268,프랑/Noun,9,6,3,8.891852839835501e-05,5.553210866523024e-05,0.6666666666666666
11269,11269,칭송/Noun,9,3,6,5.5574080248971876e-05,8.885137386436837e-05,0.6666666666666666
11270,11270,2.5/Number,9,3,6,5.5574080248971876e-05,8.885137386436837e-05,0.6666666666666666
11271,11271,에이스/Noun,9,6,3,8.891852839835501e-05,5.553210866523024e-05,0.6666666666666666
11272,11272,루피/Noun,9,3,6,5.5574080248971876e-05,8.885137386436837e-05,0.6666666666666666
11273,11273,대런/Noun,9,6,3,8.891852839835501e-05,5.553210866523024e-05,0.6666666666666666
11274,11274,~~~~~~~~~/Punctuation,9,3,6,5.5574080248971876e-05,8.885137386436837e-05,0.6666666666666666
11275,11275,케네디/Noun,9,6,3,8.891852839835501e-05,5.553210866523024e-05,0.6666666666666666
11276,11276,잡음/Noun,9,3,6,5.5574080248971876e-05,8.885137386436837e-05,0.6666666666666666
11277,11277,리키/Noun,9,6,3,8.891852839835501e-05,5.553210866523024e-05,0.6666666666666666
11278,11278,나물/Noun,9,3,6,5.5574080248971876e-05,8.885137386436837e-05,0.6666666666666666
11279,11279,자네/Noun,9,3,6,5.5574080248971876e-05,8.885137386436837e-05,0.6666666666666666
11280,11280,팽이/Noun,9,3,6,5.5574080248971876e-05,8.885137386436837e-05,0.6666666666666666
11281,11281,포레스트/Noun,9,6,3,8.891852839835501e-05,5.553210866523024e-05,0.6666666666666666
11282,11282,티모시/Noun,9,6,3,8.891852839835501e-05,5.553210866523024e-05,0.6666666666666666
11283,11283,부조리하다/Adjective,9,6,3,8.891852839835501e-05,5.553210866523024e-05,0.6666666666666666
11284,11284,놀이터/Noun,9,3,6,5.5574080248971876e-05,8.885137386436837e-05,0.6666666666666666
11285,11285,승호/Noun,9,6,3,8.891852839835501e-05,5.553210866523024e-05,0.6666666666666666
11286,11286,개조/Noun,9,6,3,8.891852839835501e-05,5.553210866523024e-05,0.6666666666666666
11287,11287,건만/Noun,9,3,6,5.5574080248971876e-05,8.885137386436837e-05,0.6666666666666666
11288,11288,주심/Noun,9,6,3,8.891852839835501e-05,5.553210866523024e-05,0.6666666666666666
11289,11289,오스카/Noun,9,6,3,8.891852839835501e-05,5.553210866523024e-05,0.6666666666666666
11290,11290,자기만족/Noun,9,3,6,5.5574080248971876e-05,8.885137386436837e-05,0.6666666666666666
11291,11291,손톱/Noun,9,3,6,5.5574080248971876e-05,8.885137386436837e-05,0.6666666666666666
11292,11292,손바닥/Noun,9,3,6,5.5574080248971876e-05,8.885137386436837e-05,0.6666666666666666
11293,11293,판결/Noun,9,3,6,5.5574080248971876e-05,8.885137386436837e-05,0.6666666666666666
11294,11294,이병훈/Noun,9,4,5,6.668889629876625e-05,7.774495213132233e-05,0.5555555555555556
11295,11295,구축/Noun,9,5,4,7.780371234856063e-05,6.663853039827628e-05,0.5555555555555556
11296,11296,응답/Noun,9,5,4,7.780371234856063e-05,6.663853039827628e-05,0.5555555555555556
11297,11297,선고/Noun,9,5,4,7.780371234856063e-05,6.663853039827628e-05,0.5555555555555556
11298,11298,보컬/Noun,9,5,4,7.780371234856063e-05,6.663853039827628e-05,0.5555555555555556
11299,11299,죄수/Noun,9,4,5,6.668889629876625e-05,7.774495213132233e-05,0.5555555555555556
11300,11300,이분법/Noun,9,5,4,7.780371234856063e-05,6.663853039827628e-05,0.5555555555555556
11301,11301,거래/Noun,9,5,4,7.780371234856063e-05,6.663853039827628e-05,0.5555555555555556
11302,11302,애국자/Noun,9,5,4,7.780371234856063e-05,6.663853039827628e-05,0.5555555555555556
11303,11303,광희/Noun,9,4,5,6.668889629876625e-05,7.774495213132233e-05,0.5555555555555556
11304,11304,괴리/Noun,9,4,5,6.668889629876625e-05,7.774495213132233e-05,0.5555555555555556
11305,11305,골목/Noun,9,5,4,7.780371234856063e-05,6.663853039827628e-05,0.5555555555555556
11306,11306,울트라맨/Noun,9,4,5,6.668889629876625e-05,7.774495213132233e-05,0.5555555555555556
11307,11307,앵무새/Noun,9,4,5,6.668889629876625e-05,7.774495213132233e-05,0.5555555555555556
11308,11308,무공/Noun,9,4,5,6.668889629876625e-05,7.774495213132233e-05,0.5555555555555556
11309,11309,귀족/Noun,9,5,4,7.780371234856063e-05,6.663853039827628e-05,0.5555555555555556
11310,11310,댁/Noun,9,5,4,7.780371234856063e-05,6.663853039827628e-05,0.5555555555555556
11311,11311,뛰어들다/Verb,9,4,5,6.668889629876625e-05,7.774495213132233e-05,0.5555555555555556
11312,11312,둘러보다/Verb,9,5,4,7.780371234856063e-05,6.663853039827628e-05,0.5555555555555556
11313,11313,솜/Noun,9,5,4,7.780371234856063e-05,6.663853039827628e-05,0.5555555555555556
11314,11314,회피/Noun,9,4,5,6.668889629876625e-05,7.774495213132233e-05,0.5555555555555556
11315,11315,---/Punctuation,9,4,5,6.668889629876625e-05,7.774495213132233e-05,0.5555555555555556
11316,11316,상해/Noun,9,4,5,6.668889629876625e-05,7.774495213132233e-05,0.5555555555555556
11317,11317,읭/Noun,9,5,4,7.780371234856063e-05,6.663853039827628e-05,0.5555555555555556
11318,11318,개취/Noun,9,4,5,6.668889629876625e-05,7.774495213132233e-05,0.5555555555555556
11319,11319,이역/Noun,9,4,5,6.668889629876625e-05,7.774495213132233e-05,0.5555555555555556
11320,11320,28일/Number,9,4,5,6.668889629876625e-05,7.774495213132233e-05,0.5555555555555556
11321,11321,Not/Alpha,9,4,5,6.668889629876625e-05,7.774495213132233e-05,0.5555555555555556
11322,11322,마다/Foreign,9,4,5,6.668889629876625e-05,7.774495213132233e-05,0.5555555555555556
11323,11323,동방신기/Noun,9,4,5,6.668889629876625e-05,7.774495213132233e-05,0.5555555555555556
11324,11324,염두/Noun,9,5,4,7.780371234856063e-05,6.663853039827628e-05,0.5555555555555556
11325,11325,나이트메어/Noun,9,5,4,7.780371234856063e-05,6.663853039827628e-05,0.5555555555555556
11326,11326,유다/Noun,9,4,5,6.668889629876625e-05,7.774495213132233e-05,0.5555555555555556
11327,11327,이홍기/Noun,9,5,4,7.780371234856063e-05,6.663853039827628e-05,0.5555555555555556
11328,11328,일케/Noun,9,5,4,7.780371234856063e-05,6.663853039827628e-05,0.5555555555555556
11329,11329,크리스탈/Noun,9,5,4,7.780371234856063e-05,6.663853039827628e-05,0.5555555555555556
11330,11330,김희애/Noun,9,5,4,7.780371234856063e-05,6.663853039827628e-05,0.5555555555555556
11331,11331,절박/Noun,9,5,4,7.780371234856063e-05,6.663853039827628e-05,0.5555555555555556
11332,11332,브이/Noun,9,5,4,7.780371234856063e-05,6.663853039827628e-05,0.5555555555555556
11333,11333,미진/Noun,9,4,5,6.668889629876625e-05,7.774495213132233e-05,0.5555555555555556
11334,11334,무감각/Noun,9,5,4,7.780371234856063e-05,6.663853039827628e-05,0.5555555555555556
11335,11335,도망자/Noun,9,4,5,6.668889629876625e-05,7.774495213132233e-05,0.5555555555555556
11336,11336,답변/Noun,9,4,5,6.668889629876625e-05,7.774495213132233e-05,0.5555555555555556
11337,11337,보관/Noun,9,5,4,7.780371234856063e-05,6.663853039827628e-05,0.5555555555555556
11338,11338,것좀/Noun,9,4,5,6.668889629876625e-05,7.774495213132233e-05,0.5555555555555556
11339,11339,김예림/Noun,9,5,4,7.780371234856063e-05,6.663853039827628e-05,0.5555555555555556
11340,11340,프랑스인/Noun,9,4,5,6.668889629876625e-05,7.774495213132233e-05,0.5555555555555556
11341,11341,해양/Noun,9,5,4,7.780371234856063e-05,6.663853039827628e-05,0.5555555555555556
11342,11342,대접/Noun,9,4,5,6.668889629876625e-05,7.774495213132233e-05,0.5555555555555556
11343,11343,스펀지/Noun,9,5,4,7.780371234856063e-05,6.663853039827628e-05,0.5555555555555556
11344,11344,인육/Noun,9,5,4,7.780371234856063e-05,6.663853039827628e-05,0.5555555555555556
11345,11345,구세주/Noun,9,4,5,6.668889629876625e-05,7.774495213132233e-05,0.5555555555555556
11346,11346,화합/Noun,9,5,4,7.780371234856063e-05,6.663853039827628e-05,0.5555555555555556
11347,11347,산책/Noun,9,5,4,7.780371234856063e-05,6.663853039827628e-05,0.5555555555555556
11348,11348,시집/Noun,9,5,4,7.780371234856063e-05,6.663853039827628e-05,0.5555555555555556
11349,11349,푸른거탑/Noun,9,5,4,7.780371234856063e-05,6.663853039827628e-05,0.5555555555555556
11350,11350,가라앉다/Verb,9,4,5,6.668889629876625e-05,7.774495213132233e-05,0.5555555555555556
11351,11351,편임/Noun,9,5,4,7.780371234856063e-05,6.663853039827628e-05,0.5555555555555556
11352,11352,시구/Noun,9,4,5,6.668889629876625e-05,7.774495213132233e-05,0.5555555555555556
11353,11353,하등/Noun,9,5,4,7.780371234856063e-05,6.663853039827628e-05,0.5555555555555556
11354,11354,소리치다/Verb,9,4,5,6.668889629876625e-05,7.774495213132233e-05,0.5555555555555556
11355,11355,피비/Noun,9,4,5,6.668889629876625e-05,7.774495213132233e-05,0.5555555555555556
11356,11356,장땡/Noun,9,4,5,6.668889629876625e-05,7.774495213132233e-05,0.5555555555555556
11357,11357,쫄/Noun,9,5,4,7.780371234856063e-05,6.663853039827628e-05,0.5555555555555556
11358,11358,서린/Noun,9,4,5,6.668889629876625e-05,7.774495213132233e-05,0.5555555555555556
11359,11359,셔/Noun,9,4,5,6.668889629876625e-05,7.774495213132233e-05,0.5555555555555556
11360,11360,톰하디/Noun,9,5,4,7.780371234856063e-05,6.663853039827628e-05,0.5555555555555556
11361,11361,스트레이트/Noun,9,5,4,7.780371234856063e-05,6.663853039827628e-05,0.5555555555555556
11362,11362,조폭마누라/Noun,9,4,5,6.668889629876625e-05,7.774495213132233e-05,0.5555555555555556
11363,11363,지침/Noun,9,5,4,7.780371234856063e-05,6.663853039827628e-05,0.5555555555555556
11364,11364,오르가즘/Noun,9,4,5,6.668889629876625e-05,7.774495213132233e-05,0.5555555555555556
11365,11365,가정부/Noun,9,5,4,7.780371234856063e-05,6.663853039827628e-05,0.5555555555555556
11366,11366,북미/Noun,9,5,4,7.780371234856063e-05,6.663853039827628e-05,0.5555555555555556
11367,11367,포도/Noun,9,5,4,7.780371234856063e-05,6.663853039827628e-05,0.5555555555555556
11368,11368,26년/Number,9,4,5,6.668889629876625e-05,7.774495213132233e-05,0.5555555555555556
11369,11369,어마/Noun,9,4,5,6.668889629876625e-05,7.774495213132233e-05,0.5555555555555556
11370,11370,god/Alpha,9,4,5,6.668889629876625e-05,7.774495213132233e-05,0.5555555555555556
11371,11371,번쩍/Noun,9,5,4,7.780371234856063e-05,6.663853039827628e-05,0.5555555555555556
11372,11372,시종/Noun,9,4,5,6.668889629876625e-05,7.774495213132233e-05,0.5555555555555556
11373,11373,젠토/Noun,9,4,5,6.668889629876625e-05,7.774495213132233e-05,0.5555555555555556
11374,11374,부상/Noun,9,4,5,6.668889629876625e-05,7.774495213132233e-05,0.5555555555555556
11375,11375,더욱이/Noun,9,4,5,6.668889629876625e-05,7.774495213132233e-05,0.5555555555555556
11376,11376,....(/Punctuation,9,5,4,7.780371234856063e-05,6.663853039827628e-05,0.5555555555555556
11377,11377,시야/Noun,9,4,5,6.668889629876625e-05,7.774495213132233e-05,0.5555555555555556
11378,11378,강하/Noun,9,5,4,7.780371234856063e-05,6.663853039827628e-05,0.5555555555555556
11379,11379,태평양/Noun,9,4,5,6.668889629876625e-05,7.774495213132233e-05,0.5555555555555556
11380,11380,서지/Noun,9,5,4,7.780371234856063e-05,6.663853039827628e-05,0.5555555555555556
11381,11381,연희/Noun,9,5,4,7.780371234856063e-05,6.663853039827628e-05,0.5555555555555556
11382,11382,쾅/Noun,9,4,5,6.668889629876625e-05,7.774495213132233e-05,0.5555555555555556
11383,11383,셔터/Noun,9,4,5,6.668889629876625e-05,7.774495213132233e-05,0.5555555555555556
11384,11384,펠트/Noun,9,4,5,6.668889629876625e-05,7.774495213132233e-05,0.5555555555555556
11385,11385,!!!!!!!!!!!!!!!!!!!/Punctuation,9,5,4,7.780371234856063e-05,6.663853039827628e-05,0.5555555555555556
11386,11386,표시/Noun,9,4,5,6.668889629876625e-05,7.774495213132233e-05,0.5555555555555556
11387,11387,원망하다/Adjective,9,4,5,6.668889629876625e-05,7.774495213132233e-05,0.5555555555555556
11388,11388,블럭/Noun,9,5,4,7.780371234856063e-05,6.663853039827628e-05,0.5555555555555556
11389,11389,아드레날린/Noun,9,5,4,7.780371234856063e-05,6.663853039827628e-05,0.5555555555555556
11390,11390,여대생/Noun,9,4,5,6.668889629876625e-05,7.774495213132233e-05,0.5555555555555556
11391,11391,작곡/Noun,9,5,4,7.780371234856063e-05,6.663853039827628e-05,0.5555555555555556
11392,11392,특선영화/Noun,9,4,5,6.668889629876625e-05,7.774495213132233e-05,0.5555555555555556
11393,11393,히로시/Noun,9,4,5,6.668889629876625e-05,7.774495213132233e-05,0.5555555555555556
11394,11394,덕이/Noun,9,4,5,6.668889629876625e-05,7.774495213132233e-05,0.5555555555555556
11395,11395,비평가/Noun,9,4,5,6.668889629876625e-05,7.774495213132233e-05,0.5555555555555556
11396,11396,디센트/Noun,9,4,5,6.668889629876625e-05,7.774495213132233e-05,0.5555555555555556
11397,11397,도착/Noun,9,5,4,7.780371234856063e-05,6.663853039827628e-05,0.5555555555555556
11398,11398,여호와/Noun,9,4,5,6.668889629876625e-05,7.774495213132233e-05,0.5555555555555556
11399,11399,금전/Noun,9,5,4,7.780371234856063e-05,6.663853039827628e-05,0.5555555555555556
11400,11400,참전/Noun,9,5,4,7.780371234856063e-05,6.663853039827628e-05,0.5555555555555556
11401,11401,꾸리/Noun,9,5,4,7.780371234856063e-05,6.663853039827628e-05,0.5555555555555556
11402,11402,로멘/Noun,9,5,4,7.780371234856063e-05,6.663853039827628e-05,0.5555555555555556
11403,11403,무뇌충/Noun,9,5,4,7.780371234856063e-05,6.663853039827628e-05,0.5555555555555556
11404,11404,지역감정/Noun,9,5,4,7.780371234856063e-05,6.663853039827628e-05,0.5555555555555556
11405,11405,전제/Noun,9,4,5,6.668889629876625e-05,7.774495213132233e-05,0.5555555555555556
11406,11406,나야/Noun,9,4,5,6.668889629876625e-05,7.774495213132233e-05,0.5555555555555556
11407,11407,장악/Noun,9,5,4,7.780371234856063e-05,6.663853039827628e-05,0.5555555555555556
11408,11408,도장/Noun,9,5,4,7.780371234856063e-05,6.663853039827628e-05,0.5555555555555556
11409,11409,익히다/Verb,9,5,4,7.780371234856063e-05,6.663853039827628e-05,0.5555555555555556
11410,11410,퓨리/Noun,9,4,5,6.668889629876625e-05,7.774495213132233e-05,0.5555555555555556
11411,11411,구야/Noun,9,4,5,6.668889629876625e-05,7.774495213132233e-05,0.5555555555555556
11412,11412,난민/Noun,9,5,4,7.780371234856063e-05,6.663853039827628e-05,0.5555555555555556
11413,11413,버려지다/Verb,9,5,4,7.780371234856063e-05,6.663853039827628e-05,0.5555555555555556
11414,11414,분통/Noun,9,5,4,7.780371234856063e-05,6.663853039827628e-05,0.5555555555555556
11415,11415,조종/Noun,9,4,5,6.668889629876625e-05,7.774495213132233e-05,0.5555555555555556
11416,11416,정기/Noun,9,5,4,7.780371234856063e-05,6.663853039827628e-05,0.5555555555555556
11417,11417,창피해/Noun,9,4,5,6.668889629876625e-05,7.774495213132233e-05,0.5555555555555556
11418,11418,공범/Noun,9,4,5,6.668889629876625e-05,7.774495213132233e-05,0.5555555555555556
11419,11419,목걸이/Noun,9,4,5,6.668889629876625e-05,7.774495213132233e-05,0.5555555555555556
11420,11420,불호/Noun,9,4,5,6.668889629876625e-05,7.774495213132233e-05,0.5555555555555556
11421,11421,뒤틀리다/Verb,9,5,4,7.780371234856063e-05,6.663853039827628e-05,0.5555555555555556
11422,11422,줄줄이/Noun,9,4,5,6.668889629876625e-05,7.774495213132233e-05,0.5555555555555556
11423,11423,기꺼이/Adverb,9,4,5,6.668889629876625e-05,7.774495213132233e-05,0.5555555555555556
11424,11424,신청/Noun,9,5,4,7.780371234856063e-05,6.663853039827628e-05,0.5555555555555556
11425,11425,2000/Number,9,4,5,6.668889629876625e-05,7.774495213132233e-05,0.5555555555555556
11426,11426,문법/Noun,9,4,5,6.668889629876625e-05,7.774495213132233e-05,0.5555555555555556
11427,11427,협상/Noun,9,4,5,6.668889629876625e-05,7.774495213132233e-05,0.5555555555555556
11428,11428,엑기스/Noun,9,5,4,7.780371234856063e-05,6.663853039827628e-05,0.5555555555555556
11429,11429,이순재/Noun,9,5,4,7.780371234856063e-05,6.663853039827628e-05,0.5555555555555556
11430,11430,상가/Noun,9,4,5,6.668889629876625e-05,7.774495213132233e-05,0.5555555555555556
11431,11431,고풍/Noun,9,4,5,6.668889629876625e-05,7.774495213132233e-05,0.5555555555555556
11432,11432,에필로그/Noun,9,4,5,6.668889629876625e-05,7.774495213132233e-05,0.5555555555555556
11433,11433,자게/Noun,9,4,5,6.668889629876625e-05,7.774495213132233e-05,0.5555555555555556
11434,11434,이라크/Noun,9,4,5,6.668889629876625e-05,7.774495213132233e-05,0.5555555555555556
11435,11435,미적/Noun,9,5,4,7.780371234856063e-05,6.663853039827628e-05,0.5555555555555556
11436,11436,회개/Noun,9,4,5,6.668889629876625e-05,7.774495213132233e-05,0.5555555555555556
11437,11437,팜므파탈/Noun,9,4,5,6.668889629876625e-05,7.774495213132233e-05,0.5555555555555556
11438,11438,가닥/Noun,9,4,5,6.668889629876625e-05,7.774495213132233e-05,0.5555555555555556
11439,11439,낭자/Noun,9,4,5,6.668889629876625e-05,7.774495213132233e-05,0.5555555555555556
11440,11440,이장우/Noun,9,4,5,6.668889629876625e-05,7.774495213132233e-05,0.5555555555555556
11441,11441,줌마/Noun,9,4,5,6.668889629876625e-05,7.774495213132233e-05,0.5555555555555556
11442,11442,만찬/Noun,9,4,5,6.668889629876625e-05,7.774495213132233e-05,0.5555555555555556
11443,11443,얍/Noun,9,5,4,7.780371234856063e-05,6.663853039827628e-05,0.5555555555555556
11444,11444,쪼끔/Noun,9,4,5,6.668889629876625e-05,7.774495213132233e-05,0.5555555555555556
11445,11445,다라/Noun,9,4,5,6.668889629876625e-05,7.774495213132233e-05,0.5555555555555556
11446,11446,진흙/Noun,9,5,4,7.780371234856063e-05,6.663853039827628e-05,0.5555555555555556
11447,11447,이해관계/Noun,9,5,4,7.780371234856063e-05,6.663853039827628e-05,0.5555555555555556
11448,11448,배우자/Noun,9,5,4,7.780371234856063e-05,6.663853039827628e-05,0.5555555555555556
11449,11449,준놈/Noun,9,4,5,6.668889629876625e-05,7.774495213132233e-05,0.5555555555555556
11450,11450,부와/Noun,9,4,5,6.668889629876625e-05,7.774495213132233e-05,0.5555555555555556
11451,11451,군생활/Noun,9,4,5,6.668889629876625e-05,7.774495213132233e-05,0.5555555555555556
11452,11452,무림/Noun,9,5,4,7.780371234856063e-05,6.663853039827628e-05,0.5555555555555556
11453,11453,앙/Exclamation,9,5,4,7.780371234856063e-05,6.663853039827628e-05,0.5555555555555556
11454,11454,밀양/Noun,9,5,4,7.780371234856063e-05,6.663853039827628e-05,0.5555555555555556
11455,11455,지급/Noun,9,4,5,6.668889629876625e-05,7.774495213132233e-05,0.5555555555555556
11456,11456,처단/Noun,9,5,4,7.780371234856063e-05,6.663853039827628e-05,0.5555555555555556
11457,11457,기둥/Noun,9,4,5,6.668889629876625e-05,7.774495213132233e-05,0.5555555555555556
11458,11458,열폭/Noun,9,4,5,6.668889629876625e-05,7.774495213132233e-05,0.5555555555555556
11459,11459,올슨/Noun,9,4,5,6.668889629876625e-05,7.774495213132233e-05,0.5555555555555556
11460,11460,마샬/Noun,9,5,4,7.780371234856063e-05,6.663853039827628e-05,0.5555555555555556
11461,11461,그해/Adverb,9,5,4,7.780371234856063e-05,6.663853039827628e-05,0.5555555555555556
11462,11462,멋쟁이/Noun,9,5,4,7.780371234856063e-05,6.663853039827628e-05,0.5555555555555556
11463,11463,보심/Noun,9,4,5,6.668889629876625e-05,7.774495213132233e-05,0.5555555555555556
11464,11464,호퍼/Noun,9,4,5,6.668889629876625e-05,7.774495213132233e-05,0.5555555555555556
11465,11465,연신/Adverb,9,4,5,6.668889629876625e-05,7.774495213132233e-05,0.5555555555555556
11466,11466,한국사/Noun,9,5,4,7.780371234856063e-05,6.663853039827628e-05,0.5555555555555556
11467,11467,정해지다/Verb,9,5,4,7.780371234856063e-05,6.663853039827628e-05,0.5555555555555556
11468,11468,바랬다/Noun,9,5,4,7.780371234856063e-05,6.663853039827628e-05,0.5555555555555556
11469,11469,박철민/Noun,9,4,5,6.668889629876625e-05,7.774495213132233e-05,0.5555555555555556
11470,11470,탈피/Noun,9,4,5,6.668889629876625e-05,7.774495213132233e-05,0.5555555555555556
11471,11471,전광렬/Noun,9,4,5,6.668889629876625e-05,7.774495213132233e-05,0.5555555555555556
11472,11472,것은/Noun,9,4,5,6.668889629876625e-05,7.774495213132233e-05,0.5555555555555556
11473,11473,오현경/Noun,9,5,4,7.780371234856063e-05,6.663853039827628e-05,0.5555555555555556
11474,11474,베트남전/Noun,9,4,5,6.668889629876625e-05,7.774495213132233e-05,0.5555555555555556
11475,11475,클로즈/Noun,9,5,4,7.780371234856063e-05,6.663853039827628e-05,0.5555555555555556
11476,11476,광태/Noun,9,4,5,6.668889629876625e-05,7.774495213132233e-05,0.5555555555555556
11477,11477,고향이/Noun,9,5,4,7.780371234856063e-05,6.663853039827628e-05,0.5555555555555556
11478,11478,선의/Noun,9,4,5,6.668889629876625e-05,7.774495213132233e-05,0.5555555555555556
11479,11479,이영/Noun,9,4,5,6.668889629876625e-05,7.774495213132233e-05,0.5555555555555556
11480,11480,착취/Noun,9,5,4,7.780371234856063e-05,6.663853039827628e-05,0.5555555555555556
11481,11481,준애/Noun,9,4,5,6.668889629876625e-05,7.774495213132233e-05,0.5555555555555556
11482,11482,유유/Noun,9,4,5,6.668889629876625e-05,7.774495213132233e-05,0.5555555555555556
11483,11483,왜냐면/Noun,9,4,5,6.668889629876625e-05,7.774495213132233e-05,0.5555555555555556
11484,11484,자각/Noun,9,5,4,7.780371234856063e-05,6.663853039827628e-05,0.5555555555555556
11485,11485,못내/Noun,9,4,5,6.668889629876625e-05,7.774495213132233e-05,0.5555555555555556
11486,11486,3월/Number,9,5,4,7.780371234856063e-05,6.663853039827628e-05,0.5555555555555556
11487,11487,진득/Noun,9,4,5,6.668889629876625e-05,7.774495213132233e-05,0.5555555555555556
11488,11488,까발리다/Verb,9,4,5,6.668889629876625e-05,7.774495213132233e-05,0.5555555555555556
11489,11489,끗/Noun,9,4,5,6.668889629876625e-05,7.774495213132233e-05,0.5555555555555556
11490,11490,첩/Noun,9,4,5,6.668889629876625e-05,7.774495213132233e-05,0.5555555555555556
11491,11491,듯함/Noun,9,4,5,6.668889629876625e-05,7.774495213132233e-05,0.5555555555555556
11492,11492,개선/Noun,9,4,5,6.668889629876625e-05,7.774495213132233e-05,0.5555555555555556
11493,11493,가혹하다/Adjective,9,5,4,7.780371234856063e-05,6.663853039827628e-05,0.5555555555555556
11494,11494,병장/Noun,9,5,4,7.780371234856063e-05,6.663853039827628e-05,0.5555555555555556
11495,11495,체리/Noun,9,5,4,7.780371234856063e-05,6.663853039827628e-05,0.5555555555555556
11496,11496,뛰어가다/Verb,9,4,5,6.668889629876625e-05,7.774495213132233e-05,0.5555555555555556
11497,11497,충고/Noun,9,4,5,6.668889629876625e-05,7.774495213132233e-05,0.5555555555555556
11498,11498,버들/Noun,9,5,4,7.780371234856063e-05,6.663853039827628e-05,0.5555555555555556
11499,11499,었다/Noun,9,4,5,6.668889629876625e-05,7.774495213132233e-05,0.5555555555555556
11500,11500,불운/Noun,9,5,4,7.780371234856063e-05,6.663853039827628e-05,0.5555555555555556
11501,11501,영자/Noun,9,4,5,6.668889629876625e-05,7.774495213132233e-05,0.5555555555555556
11502,11502,빔/Noun,9,5,4,7.780371234856063e-05,6.663853039827628e-05,0.5555555555555556
11503,11503,댄싱/Noun,9,4,5,6.668889629876625e-05,7.774495213132233e-05,0.5555555555555556
11504,11504,훨배/Noun,9,4,5,6.668889629876625e-05,7.774495213132233e-05,0.5555555555555556
11505,11505,헤더/Noun,9,4,5,6.668889629876625e-05,7.774495213132233e-05,0.5555555555555556
11506,11506,쿠스/Noun,9,5,4,7.780371234856063e-05,6.663853039827628e-05,0.5555555555555556
11507,11507,용어/Noun,9,4,5,6.668889629876625e-05,7.774495213132233e-05,0.5555555555555556
11508,11508,트로트/Noun,9,5,4,7.780371234856063e-05,6.663853039827628e-05,0.5555555555555556
11509,11509,악수/Noun,9,5,4,7.780371234856063e-05,6.663853039827628e-05,0.5555555555555556
11510,11510,고교/Noun,9,4,5,6.668889629876625e-05,7.774495213132233e-05,0.5555555555555556
11511,11511,들여다보다/Verb,9,5,4,7.780371234856063e-05,6.663853039827628e-05,0.5555555555555556
11512,11512,회전/Noun,9,5,4,7.780371234856063e-05,6.663853039827628e-05,0.5555555555555556
11513,11513,호쾌/Noun,9,5,4,7.780371234856063e-05,6.663853039827628e-05,0.5555555555555556
11514,11514,그레고리/Noun,8,8,0,0.00011114816049794375,2.2212843466092093e-05,1.0
11515,11515,기광/Noun,8,8,0,0.00011114816049794375,2.2212843466092093e-05,1.0
11516,11516,이기광/Noun,8,8,0,0.00011114816049794375,2.2212843466092093e-05,1.0
11517,11517,슬펏다/Noun,8,8,0,0.00011114816049794375,2.2212843466092093e-05,1.0
11518,11518,사드/Noun,8,8,0,0.00011114816049794375,2.2212843466092093e-05,1.0
11519,11519,박정민/Noun,8,8,0,0.00011114816049794375,2.2212843466092093e-05,1.0
11520,11520,자뻑/Noun,8,0,8,2.2229632099588756e-05,0.00011106421733046048,1.0
11521,11521,UCC/Alpha,8,0,8,2.2229632099588756e-05,0.00011106421733046048,1.0
11522,11522,두근/Adverb,8,8,0,0.00011114816049794375,2.2212843466092093e-05,1.0
11523,11523,페티쉬/Noun,8,0,8,2.2229632099588756e-05,0.00011106421733046048,1.0
11524,11524,19년/Number,8,8,0,0.00011114816049794375,2.2212843466092093e-05,1.0
11525,11525,야설/Noun,8,0,8,2.2229632099588756e-05,0.00011106421733046048,1.0
11526,11526,제임스딘/Noun,8,8,0,0.00011114816049794375,2.2212843466092093e-05,1.0
11527,11527,동조/Noun,8,0,8,2.2229632099588756e-05,0.00011106421733046048,1.0
11528,11528,아델/Noun,8,8,0,0.00011114816049794375,2.2212843466092093e-05,1.0
11529,11529,카메라맨/Noun,8,0,8,2.2229632099588756e-05,0.00011106421733046048,1.0
11530,11530,임밸류/Noun,8,0,8,2.2229632099588756e-05,0.00011106421733046048,1.0
11531,11531,흐접/Noun,8,0,8,2.2229632099588756e-05,0.00011106421733046048,1.0
11532,11532,하반기/Noun,8,8,0,0.00011114816049794375,2.2212843466092093e-05,1.0
11533,11533,전효성/Noun,8,0,8,2.2229632099588756e-05,0.00011106421733046048,1.0
11534,11534,땡큐/Noun,8,8,0,0.00011114816049794375,2.2212843466092093e-05,1.0
11535,11535,넘김/Noun,8,0,8,2.2229632099588756e-05,0.00011106421733046048,1.0
11536,11536,성괴/Noun,8,0,8,2.2229632099588756e-05,0.00011106421733046048,1.0
11537,11537,지불/Noun,8,0,8,2.2229632099588756e-05,0.00011106421733046048,1.0
11538,11538,도마/Noun,8,0,8,2.2229632099588756e-05,0.00011106421733046048,1.0
11539,11539,에보니/Noun,8,8,0,0.00011114816049794375,2.2212843466092093e-05,1.0
11540,11540,계집/Noun,8,0,8,2.2229632099588756e-05,0.00011106421733046048,1.0
11541,11541,십여/Modifier,8,8,0,0.00011114816049794375,2.2212843466092093e-05,1.0
11542,11542,쓰라리다/Adjective,8,8,0,0.00011114816049794375,2.2212843466092093e-05,1.0
11543,11543,Mbc/Alpha,8,0,8,2.2229632099588756e-05,0.00011106421733046048,1.0
11544,11544,레빗/Noun,8,8,0,0.00011114816049794375,2.2212843466092093e-05,1.0
11545,11545,박용하/Noun,8,8,0,0.00011114816049794375,2.2212843466092093e-05,1.0
11546,11546,게뭐임/Noun,8,0,8,2.2229632099588756e-05,0.00011106421733046048,1.0
11547,11547,개극혐/Noun,8,0,8,2.2229632099588756e-05,0.00011106421733046048,1.0
11548,11548,냉무/Noun,8,0,8,2.2229632099588756e-05,0.00011106421733046048,1.0
11549,11549,샤룩/Noun,8,8,0,0.00011114816049794375,2.2212843466092093e-05,1.0
11550,11550,빠들/Noun,8,0,8,2.2229632099588756e-05,0.00011106421733046048,1.0
11551,11551,배설/Noun,8,0,8,2.2229632099588756e-05,0.00011106421733046048,1.0
11552,11552,토크쇼/Noun,8,0,8,2.2229632099588756e-05,0.00011106421733046048,1.0
11553,11553,할머님/Noun,8,8,0,0.00011114816049794375,2.2212843466092093e-05,1.0
11554,11554,월광보합/Noun,8,8,0,0.00011114816049794375,2.2212843466092093e-05,1.0
11555,11555,치사하다/Adjective,8,0,8,2.2229632099588756e-05,0.00011106421733046048,1.0
11556,11556,꾸르잼/Noun,8,8,0,0.00011114816049794375,2.2212843466092093e-05,1.0
11557,11557,부라/Noun,8,0,8,2.2229632099588756e-05,0.00011106421733046048,1.0
11558,11558,균신/Noun,8,8,0,0.00011114816049794375,2.2212843466092093e-05,1.0
11559,11559,GG/Alpha,8,0,8,2.2229632099588756e-05,0.00011106421733046048,1.0
11560,11560,머꼬/Noun,8,0,8,2.2229632099588756e-05,0.00011106421733046048,1.0
11561,11561,맥아담스/Noun,8,8,0,0.00011114816049794375,2.2212843466092093e-05,1.0
11562,11562,박재범/Noun,8,0,8,2.2229632099588756e-05,0.00011106421733046048,1.0
11563,11563,속옷/Noun,8,0,8,2.2229632099588756e-05,0.00011106421733046048,1.0
11564,11564,칼질/Noun,8,0,8,2.2229632099588756e-05,0.00011106421733046048,1.0
11565,11565,희롱/Noun,8,0,8,2.2229632099588756e-05,0.00011106421733046048,1.0
11566,11566,멋진날/Noun,8,8,0,0.00011114816049794375,2.2212843466092093e-05,1.0
11567,11567,사인/Noun,8,0,8,2.2229632099588756e-05,0.00011106421733046048,1.0
11568,11568,심쿵/Noun,8,8,0,0.00011114816049794375,2.2212843466092093e-05,1.0
11569,11569,유년기/Noun,8,8,0,0.00011114816049794375,2.2212843466092093e-05,1.0
11570,11570,번봄/Noun,8,8,0,0.00011114816049794375,2.2212843466092093e-05,1.0
11571,11571,잡아내다/Verb,8,8,0,0.00011114816049794375,2.2212843466092093e-05,1.0
11572,11572,박차다/Verb,8,0,8,2.2229632099588756e-05,0.00011106421733046048,1.0
11573,11573,강성재/Noun,8,0,8,2.2229632099588756e-05,0.00011106421733046048,1.0
11574,11574,손수건/Noun,8,8,0,0.00011114816049794375,2.2212843466092093e-05,1.0
11575,11575,은커녕/Josa,8,0,8,2.2229632099588756e-05,0.00011106421733046048,1.0
11576,11576,조마조마하다/Adjective,8,8,0,0.00011114816049794375,2.2212843466092093e-05,1.0
11577,11577,똘/Noun,8,0,8,2.2229632099588756e-05,0.00011106421733046048,1.0
11578,11578,환하다/Adjective,8,8,0,0.00011114816049794375,2.2212843466092093e-05,1.0
11579,11579,웩/Noun,8,0,8,2.2229632099588756e-05,0.00011106421733046048,1.0
11580,11580,오그리다/Verb,8,0,8,2.2229632099588756e-05,0.00011106421733046048,1.0
11581,11581,난데없다/Adjective,8,0,8,2.2229632099588756e-05,0.00011106421733046048,1.0
11582,11582,씨엔블루/Noun,8,8,0,0.00011114816049794375,2.2212843466092093e-05,1.0
11583,11583,종특/Noun,8,0,8,2.2229632099588756e-05,0.00011106421733046048,1.0
11584,11584,정소동/Noun,8,0,8,2.2229632099588756e-05,0.00011106421733046048,1.0
11585,11585,끙/Adverb,8,0,8,2.2229632099588756e-05,0.00011106421733046048,1.0
11586,11586,한여운/Noun,8,8,0,0.00011114816049794375,2.2212843466092093e-05,1.0
11587,11587,518/Number,8,0,8,2.2229632099588756e-05,0.00011106421733046048,1.0
11588,11588,로키/Noun,8,8,0,0.00011114816049794375,2.2212843466092093e-05,1.0
11589,11589,One/Alpha,8,8,0,0.00011114816049794375,2.2212843466092093e-05,1.0
11590,11590,방콕/Noun,8,0,8,2.2229632099588756e-05,0.00011106421733046048,1.0
11591,11591,느릿하다/Adjective,8,0,8,2.2229632099588756e-05,0.00011106421733046048,1.0
11592,11592,무미/Noun,8,0,8,2.2229632099588756e-05,0.00011106421733046048,1.0
11593,11593,thumbs/Alpha,8,8,0,0.00011114816049794375,2.2212843466092093e-05,1.0
11594,11594,청승/Noun,8,0,8,2.2229632099588756e-05,0.00011106421733046048,1.0
11595,11595,일자리/Noun,8,1,7,3.334444814938313e-05,9.995779559741441e-05,0.875
11596,11596,벼/Noun,8,1,7,3.334444814938313e-05,9.995779559741441e-05,0.875
11597,11597,염치/Noun,8,1,7,3.334444814938313e-05,9.995779559741441e-05,0.875
11598,11598,6월/Number,8,7,1,0.0001000333444481494,3.331926519913814e-05,0.875
11599,11599,wow/Alpha,8,7,1,0.0001000333444481494,3.331926519913814e-05,0.875
11600,11600,병풍/Noun,8,1,7,3.334444814938313e-05,9.995779559741441e-05,0.875
11601,11601,꿰뚫다/Verb,8,7,1,0.0001000333444481494,3.331926519913814e-05,0.875
11602,11602,안전하다/Adjective,8,7,1,0.0001000333444481494,3.331926519913814e-05,0.875
11603,11603,펙/Noun,8,7,1,0.0001000333444481494,3.331926519913814e-05,0.875
11604,11604,니키/Noun,8,7,1,0.0001000333444481494,3.331926519913814e-05,0.875
11605,11605,트랙/Noun,8,7,1,0.0001000333444481494,3.331926519913814e-05,0.875
11606,11606,김흥수/Noun,8,1,7,3.334444814938313e-05,9.995779559741441e-05,0.875
11607,11607,타임캡슐/Noun,8,1,7,3.334444814938313e-05,9.995779559741441e-05,0.875
11608,11608,!!(/Punctuation,8,7,1,0.0001000333444481494,3.331926519913814e-05,0.875
11609,11609,무협지/Noun,8,1,7,3.334444814938313e-05,9.995779559741441e-05,0.875
11610,11610,기상/Noun,8,7,1,0.0001000333444481494,3.331926519913814e-05,0.875
11611,11611,드리프트/Noun,8,1,7,3.334444814938313e-05,9.995779559741441e-05,0.875
11612,11612,로맨스코미디/Noun,8,7,1,0.0001000333444481494,3.331926519913814e-05,0.875
11613,11613,ps/Alpha,8,7,1,0.0001000333444481494,3.331926519913814e-05,0.875
11614,11614,1992년/Number,8,7,1,0.0001000333444481494,3.331926519913814e-05,0.875
11615,11615,찮아다/Verb,8,7,1,0.0001000333444481494,3.331926519913814e-05,0.875
11616,11616,까운/Noun,8,1,7,3.334444814938313e-05,9.995779559741441e-05,0.875
11617,11617,어쩌란/Noun,8,1,7,3.334444814938313e-05,9.995779559741441e-05,0.875
11618,11618,난동/Noun,8,1,7,3.334444814938313e-05,9.995779559741441e-05,0.875
11619,11619,스피디/Noun,8,7,1,0.0001000333444481494,3.331926519913814e-05,0.875
11620,11620,사이다/Noun,8,7,1,0.0001000333444481494,3.331926519913814e-05,0.875
11621,11621,국비/Noun,8,1,7,3.334444814938313e-05,9.995779559741441e-05,0.875
11622,11622,마일/Noun,8,7,1,0.0001000333444481494,3.331926519913814e-05,0.875
11623,11623,오른쪽/Noun,8,1,7,3.334444814938313e-05,9.995779559741441e-05,0.875
11624,11624,근접하다/Adjective,8,7,1,0.0001000333444481494,3.331926519913814e-05,0.875
11625,11625,스타킹/Noun,8,1,7,3.334444814938313e-05,9.995779559741441e-05,0.875
11626,11626,정도전/Noun,8,7,1,0.0001000333444481494,3.331926519913814e-05,0.875
11627,11627,ㅍ/KoreanParticle,8,7,1,0.0001000333444481494,3.331926519913814e-05,0.875
11628,11628,변종/Noun,8,1,7,3.334444814938313e-05,9.995779559741441e-05,0.875
11629,11629,시너지/Noun,8,7,1,0.0001000333444481494,3.331926519913814e-05,0.875
11630,11630,맥시/Noun,8,7,1,0.0001000333444481494,3.331926519913814e-05,0.875
11631,11631,짱꼴라/Noun,8,1,7,3.334444814938313e-05,9.995779559741441e-05,0.875
11632,11632,-_-../Punctuation,8,1,7,3.334444814938313e-05,9.995779559741441e-05,0.875
11633,11633,술해/Noun,8,1,7,3.334444814938313e-05,9.995779559741441e-05,0.875
11634,11634,코인/Noun,8,1,7,3.334444814938313e-05,9.995779559741441e-05,0.875
11635,11635,허풍/Noun,8,1,7,3.334444814938313e-05,9.995779559741441e-05,0.875
11636,11636,게말/Noun,8,1,7,3.334444814938313e-05,9.995779559741441e-05,0.875
11637,11637,shit/Alpha,8,1,7,3.334444814938313e-05,9.995779559741441e-05,0.875
11638,11638,오디오/Noun,8,1,7,3.334444814938313e-05,9.995779559741441e-05,0.875
11639,11639,퉁퉁/Noun,8,7,1,0.0001000333444481494,3.331926519913814e-05,0.875
11640,11640,효도/Noun,8,7,1,0.0001000333444481494,3.331926519913814e-05,0.875
11641,11641,예비군/Noun,8,1,7,3.334444814938313e-05,9.995779559741441e-05,0.875
11642,11642,티아/Noun,8,7,1,0.0001000333444481494,3.331926519913814e-05,0.875
11643,11643,처자/Noun,8,1,7,3.334444814938313e-05,9.995779559741441e-05,0.875
11644,11644,~!!!!!/Punctuation,8,7,1,0.0001000333444481494,3.331926519913814e-05,0.875
11645,11645,우뢰/Noun,8,1,7,3.334444814938313e-05,9.995779559741441e-05,0.875
11646,11646,빤스/Noun,8,1,7,3.334444814938313e-05,9.995779559741441e-05,0.875
11647,11647,숭숭/Noun,8,1,7,3.334444814938313e-05,9.995779559741441e-05,0.875
11648,11648,런스/Noun,8,1,7,3.334444814938313e-05,9.995779559741441e-05,0.875
11649,11649,콕/Noun,8,7,1,0.0001000333444481494,3.331926519913814e-05,0.875
11650,11650,부자연/Noun,8,1,7,3.334444814938313e-05,9.995779559741441e-05,0.875
11651,11651,풍요/Noun,8,7,1,0.0001000333444481494,3.331926519913814e-05,0.875
11652,11652,추리소설/Noun,8,7,1,0.0001000333444481494,3.331926519913814e-05,0.875
11653,11653,유딩/Noun,8,1,7,3.334444814938313e-05,9.995779559741441e-05,0.875
11654,11654,盧/Foreign,8,1,7,3.334444814938313e-05,9.995779559741441e-05,0.875
11655,11655,뜬구름/Noun,8,1,7,3.334444814938313e-05,9.995779559741441e-05,0.875
11656,11656,후짐/Noun,8,1,7,3.334444814938313e-05,9.995779559741441e-05,0.875
11657,11657,개이득/Noun,8,1,7,3.334444814938313e-05,9.995779559741441e-05,0.875
11658,11658,쫄딱/Noun,8,1,7,3.334444814938313e-05,9.995779559741441e-05,0.875
11659,11659,프랑켄슈타인/Noun,8,7,1,0.0001000333444481494,3.331926519913814e-05,0.875
11660,11660,수법/Noun,8,1,7,3.334444814938313e-05,9.995779559741441e-05,0.875
11661,11661,혼혈/Noun,8,1,7,3.334444814938313e-05,9.995779559741441e-05,0.875
11662,11662,화요일/Noun,8,7,1,0.0001000333444481494,3.331926519913814e-05,0.875
11663,11663,35분/Number,8,1,7,3.334444814938313e-05,9.995779559741441e-05,0.875
11664,11664,나이스/Noun,8,7,1,0.0001000333444481494,3.331926519913814e-05,0.875
11665,11665,로필/Noun,8,7,1,0.0001000333444481494,3.331926519913814e-05,0.875
11666,11666,천둥/Noun,8,7,1,0.0001000333444481494,3.331926519913814e-05,0.875
11667,11667,품질/Noun,8,1,7,3.334444814938313e-05,9.995779559741441e-05,0.875
11668,11668,젓/Noun,8,1,7,3.334444814938313e-05,9.995779559741441e-05,0.875
11669,11669,야자/Noun,8,7,1,0.0001000333444481494,3.331926519913814e-05,0.875
11670,11670,이신가/Josa,8,1,7,3.334444814938313e-05,9.995779559741441e-05,0.875
11671,11671,홍수아/Noun,8,1,7,3.334444814938313e-05,9.995779559741441e-05,0.875
11672,11672,사명/Noun,8,7,1,0.0001000333444481494,3.331926519913814e-05,0.875
11673,11673,몰상식하다/Adjective,8,1,7,3.334444814938313e-05,9.995779559741441e-05,0.875
11674,11674,슈마허/Noun,8,1,7,3.334444814938313e-05,9.995779559741441e-05,0.875
11675,11675,찬물/Noun,8,1,7,3.334444814938313e-05,9.995779559741441e-05,0.875
11676,11676,자초/Noun,8,1,7,3.334444814938313e-05,9.995779559741441e-05,0.875
11677,11677,스트리트/Noun,8,1,7,3.334444814938313e-05,9.995779559741441e-05,0.875
11678,11678,휘성/Noun,8,7,1,0.0001000333444481494,3.331926519913814e-05,0.875
11679,11679,놓이다/Verb,8,7,1,0.0001000333444481494,3.331926519913814e-05,0.875
11680,11680,beautiful/Alpha,8,7,1,0.0001000333444481494,3.331926519913814e-05,0.875
11681,11681,숙연/Noun,8,7,1,0.0001000333444481494,3.331926519913814e-05,0.875
11682,11682,쌩뚱/Noun,8,1,7,3.334444814938313e-05,9.995779559741441e-05,0.875
11683,11683,해몽/Noun,8,1,7,3.334444814938313e-05,9.995779559741441e-05,0.875
11684,11684,개비/Noun,8,1,7,3.334444814938313e-05,9.995779559741441e-05,0.875
11685,11685,헌법/Noun,8,7,1,0.0001000333444481494,3.331926519913814e-05,0.875
11686,11686,희노애락/Noun,8,7,1,0.0001000333444481494,3.331926519913814e-05,0.875
11687,11687,웰케/Noun,8,7,1,0.0001000333444481494,3.331926519913814e-05,0.875
11688,11688,가입/Noun,8,7,1,0.0001000333444481494,3.331926519913814e-05,0.875
11689,11689,티격태격/Noun,8,7,1,0.0001000333444481494,3.331926519913814e-05,0.875
11690,11690,100원/Number,8,1,7,3.334444814938313e-05,9.995779559741441e-05,0.875
11691,11691,쓰리데이즈/Noun,8,7,1,0.0001000333444481494,3.331926519913814e-05,0.875
11692,11692,꼭두각시/Noun,8,1,7,3.334444814938313e-05,9.995779559741441e-05,0.875
11693,11693,고지식하다/Adjective,8,1,7,3.334444814938313e-05,9.995779559741441e-05,0.875
11694,11694,포트만/Noun,8,7,1,0.0001000333444481494,3.331926519913814e-05,0.875
11695,11695,100억/Number,8,1,7,3.334444814938313e-05,9.995779559741441e-05,0.875
11696,11696,뭍/Noun,8,7,1,0.0001000333444481494,3.331926519913814e-05,0.875
11697,11697,조류/Noun,8,1,7,3.334444814938313e-05,9.995779559741441e-05,0.875
11698,11698,perfect/Alpha,8,7,1,0.0001000333444481494,3.331926519913814e-05,0.875
11699,11699,고용/Noun,8,1,7,3.334444814938313e-05,9.995779559741441e-05,0.875
11700,11700,1/3/Number,8,1,7,3.334444814938313e-05,9.995779559741441e-05,0.875
11701,11701,틴토/Noun,8,1,7,3.334444814938313e-05,9.995779559741441e-05,0.875
11702,11702,거왜/Noun,8,1,7,3.334444814938313e-05,9.995779559741441e-05,0.875
11703,11703,도식/Noun,8,1,7,3.334444814938313e-05,9.995779559741441e-05,0.875
11704,11704,슬하/Noun,8,7,1,0.0001000333444481494,3.331926519913814e-05,0.875
11705,11705,밀리터리/Noun,8,1,7,3.334444814938313e-05,9.995779559741441e-05,0.875
11706,11706,우직하다/Adjective,8,7,1,0.0001000333444481494,3.331926519913814e-05,0.875
11707,11707,카이지/Noun,8,1,7,3.334444814938313e-05,9.995779559741441e-05,0.875
11708,11708,만만/Noun,8,1,7,3.334444814938313e-05,9.995779559741441e-05,0.875
11709,11709,이경실/Noun,8,1,7,3.334444814938313e-05,9.995779559741441e-05,0.875
11710,11710,이사/Noun,8,1,7,3.334444814938313e-05,9.995779559741441e-05,0.875
11711,11711,개살구/Noun,8,1,7,3.334444814938313e-05,9.995779559741441e-05,0.875
11712,11712,가구/Noun,8,7,1,0.0001000333444481494,3.331926519913814e-05,0.875
11713,11713,휘파람/Noun,8,7,1,0.0001000333444481494,3.331926519913814e-05,0.875
11714,11714,뉘앙스/Noun,8,1,7,3.334444814938313e-05,9.995779559741441e-05,0.875
11715,11715,푸근하다/Adjective,8,7,1,0.0001000333444481494,3.331926519913814e-05,0.875
11716,11716,멱살/Noun,8,1,7,3.334444814938313e-05,9.995779559741441e-05,0.875
11717,11717,라이언킹/Noun,8,7,1,0.0001000333444481494,3.331926519913814e-05,0.875
11718,11718,공급/Noun,8,1,7,3.334444814938313e-05,9.995779559741441e-05,0.875
11719,11719,김태훈/Noun,8,7,1,0.0001000333444481494,3.331926519913814e-05,0.875
11720,11720,유치뽕/Noun,8,1,7,3.334444814938313e-05,9.995779559741441e-05,0.875
11721,11721,중이병/Noun,8,1,7,3.334444814938313e-05,9.995779559741441e-05,0.875
11722,11722,똥덩어리/Noun,8,1,7,3.334444814938313e-05,9.995779559741441e-05,0.875
11723,11723,바론/Noun,8,7,1,0.0001000333444481494,3.331926519913814e-05,0.875
11724,11724,초토화/Noun,8,1,7,3.334444814938313e-05,9.995779559741441e-05,0.875
11725,11725,담론/Noun,8,1,7,3.334444814938313e-05,9.995779559741441e-05,0.875
11726,11726,천황/Noun,8,1,7,3.334444814938313e-05,9.995779559741441e-05,0.875
11727,11727,1987년/Number,8,7,1,0.0001000333444481494,3.331926519913814e-05,0.875
11728,11728,고마움/Noun,8,7,1,0.0001000333444481494,3.331926519913814e-05,0.875
11729,11729,무턱/Noun,8,1,7,3.334444814938313e-05,9.995779559741441e-05,0.875
11730,11730,완득이/Noun,8,1,7,3.334444814938313e-05,9.995779559741441e-05,0.875
11731,11731,상수/Noun,8,1,7,3.334444814938313e-05,9.995779559741441e-05,0.875
11732,11732,라만/Noun,8,1,7,3.334444814938313e-05,9.995779559741441e-05,0.875
11733,11733,수려/Noun,8,7,1,0.0001000333444481494,3.331926519913814e-05,0.875
11734,11734,데넘/Noun,8,7,1,0.0001000333444481494,3.331926519913814e-05,0.875
11735,11735,멸종/Noun,8,1,7,3.334444814938313e-05,9.995779559741441e-05,0.875
11736,11736,하급/Noun,8,1,7,3.334444814938313e-05,9.995779559741441e-05,0.875
11737,11737,반정부/Noun,8,1,7,3.334444814938313e-05,9.995779559741441e-05,0.875
11738,11738,슨상님/Noun,8,1,7,3.334444814938313e-05,9.995779559741441e-05,0.875
11739,11739,굴레/Noun,8,7,1,0.0001000333444481494,3.331926519913814e-05,0.875
11740,11740,your/Alpha,8,7,1,0.0001000333444481494,3.331926519913814e-05,0.875
11741,11741,부진/Noun,8,1,7,3.334444814938313e-05,9.995779559741441e-05,0.875
11742,11742,난정/Noun,8,7,1,0.0001000333444481494,3.331926519913814e-05,0.875
11743,11743,.-_-/Punctuation,8,1,7,3.334444814938313e-05,9.995779559741441e-05,0.875
11744,11744,평등하다/Adjective,8,7,1,0.0001000333444481494,3.331926519913814e-05,0.875
11745,11745,진짜루/Noun,8,7,1,0.0001000333444481494,3.331926519913814e-05,0.875
11746,11746,충동/Noun,8,1,7,3.334444814938313e-05,9.995779559741441e-05,0.875
11747,11747,베네딕트/Noun,8,7,1,0.0001000333444481494,3.331926519913814e-05,0.875
11748,11748,굶다/Verb,8,1,7,3.334444814938313e-05,9.995779559741441e-05,0.875
11749,11749,고만/Eomi,8,1,7,3.334444814938313e-05,9.995779559741441e-05,0.875
11750,11750,문답/Noun,8,1,7,3.334444814938313e-05,9.995779559741441e-05,0.875
11751,11751,마이클잭슨/Noun,8,7,1,0.0001000333444481494,3.331926519913814e-05,0.875
11752,11752,일전/Noun,8,7,1,0.0001000333444481494,3.331926519913814e-05,0.875
11753,11753,늦/Noun,8,7,1,0.0001000333444481494,3.331926519913814e-05,0.875
11754,11754,귀여웡/Noun,8,7,1,0.0001000333444481494,3.331926519913814e-05,0.875
11755,11755,경종/Noun,8,7,1,0.0001000333444481494,3.331926519913814e-05,0.875
11756,11756,미흡/Noun,8,1,7,3.334444814938313e-05,9.995779559741441e-05,0.875
11757,11757,등골/Noun,8,7,1,0.0001000333444481494,3.331926519913814e-05,0.875
11758,11758,김지호/Noun,8,1,7,3.334444814938313e-05,9.995779559741441e-05,0.875
11759,11759,식탁/Noun,8,2,6,4.445926419917751e-05,8.885137386436837e-05,0.75
11760,11760,엎/Noun,8,2,6,4.445926419917751e-05,8.885137386436837e-05,0.75
11761,11761,바티스타/Noun,8,2,6,4.445926419917751e-05,8.885137386436837e-05,0.75
11762,11762,성당/Noun,8,6,2,8.891852839835501e-05,4.4425686932184186e-05,0.75
11763,11763,랍/Noun,8,2,6,4.445926419917751e-05,8.885137386436837e-05,0.75
11764,11764,클라이맥스/Noun,8,2,6,4.445926419917751e-05,8.885137386436837e-05,0.75
11765,11765,관중/Noun,8,2,6,4.445926419917751e-05,8.885137386436837e-05,0.75
11766,11766,전우/Noun,8,6,2,8.891852839835501e-05,4.4425686932184186e-05,0.75
11767,11767,퀼/Noun,8,6,2,8.891852839835501e-05,4.4425686932184186e-05,0.75
11768,11768,지훈/Noun,8,2,6,4.445926419917751e-05,8.885137386436837e-05,0.75
11769,11769,n/Alpha,8,6,2,8.891852839835501e-05,4.4425686932184186e-05,0.75
11770,11770,막론/Noun,8,6,2,8.891852839835501e-05,4.4425686932184186e-05,0.75
11771,11771,어부/Noun,8,2,6,4.445926419917751e-05,8.885137386436837e-05,0.75
11772,11772,(+/Punctuation,8,2,6,4.445926419917751e-05,8.885137386436837e-05,0.75
11773,11773,슬램덩크/Noun,8,2,6,4.445926419917751e-05,8.885137386436837e-05,0.75
11774,11774,태상/Noun,8,2,6,4.445926419917751e-05,8.885137386436837e-05,0.75
11775,11775,암세포/Noun,8,2,6,4.445926419917751e-05,8.885137386436837e-05,0.75
11776,11776,해부/Noun,8,2,6,4.445926419917751e-05,8.885137386436837e-05,0.75
11777,11777,토의/Noun,8,6,2,8.891852839835501e-05,4.4425686932184186e-05,0.75
11778,11778,76년/Number,8,2,6,4.445926419917751e-05,8.885137386436837e-05,0.75
11779,11779,나들이/Noun,8,6,2,8.891852839835501e-05,4.4425686932184186e-05,0.75
11780,11780,갈아입다/Verb,8,2,6,4.445926419917751e-05,8.885137386436837e-05,0.75
11781,11781,기복/Noun,8,2,6,4.445926419917751e-05,8.885137386436837e-05,0.75
11782,11782,오/Exclamation,8,6,2,8.891852839835501e-05,4.4425686932184186e-05,0.75
11783,11783,자지러지다/Verb,8,6,2,8.891852839835501e-05,4.4425686932184186e-05,0.75
11784,11784,연쇄살인범/Noun,8,2,6,4.445926419917751e-05,8.885137386436837e-05,0.75
11785,11785,아이스크림/Noun,8,6,2,8.891852839835501e-05,4.4425686932184186e-05,0.75
11786,11786,좌우/Noun,8,6,2,8.891852839835501e-05,4.4425686932184186e-05,0.75
11787,11787,개과천선/Noun,8,2,6,4.445926419917751e-05,8.885137386436837e-05,0.75
11788,11788,토론/Noun,8,6,2,8.891852839835501e-05,4.4425686932184186e-05,0.75
11789,11789,77년/Number,8,6,2,8.891852839835501e-05,4.4425686932184186e-05,0.75
11790,11790,헐겁다/Adjective,8,2,6,4.445926419917751e-05,8.885137386436837e-05,0.75
11791,11791,미세하다/Adjective,8,6,2,8.891852839835501e-05,4.4425686932184186e-05,0.75
11792,11792,-;;/Punctuation,8,2,6,4.445926419917751e-05,8.885137386436837e-05,0.75
11793,11793,이어폰/Noun,8,6,2,8.891852839835501e-05,4.4425686932184186e-05,0.75
11794,11794,모험영화/Noun,8,6,2,8.891852839835501e-05,4.4425686932184186e-05,0.75
11795,11795,케스팅/Noun,8,2,6,4.445926419917751e-05,8.885137386436837e-05,0.75
11796,11796,질서/Noun,8,2,6,4.445926419917751e-05,8.885137386436837e-05,0.75
11797,11797,차이점/Noun,8,2,6,4.445926419917751e-05,8.885137386436837e-05,0.75
11798,11798,틸/Noun,8,6,2,8.891852839835501e-05,4.4425686932184186e-05,0.75
11799,11799,장선/Noun,8,6,2,8.891852839835501e-05,4.4425686932184186e-05,0.75
11800,11800,사사키/Noun,8,6,2,8.891852839835501e-05,4.4425686932184186e-05,0.75
11801,11801,체계/Noun,8,6,2,8.891852839835501e-05,4.4425686932184186e-05,0.75
11802,11802,헬로/Noun,8,2,6,4.445926419917751e-05,8.885137386436837e-05,0.75
11803,11803,강간범/Noun,8,2,6,4.445926419917751e-05,8.885137386436837e-05,0.75
11804,11804,가장이/Noun,8,6,2,8.891852839835501e-05,4.4425686932184186e-05,0.75
11805,11805,빅토리아/Noun,8,6,2,8.891852839835501e-05,4.4425686932184186e-05,0.75
11806,11806,츤데레/Noun,8,6,2,8.891852839835501e-05,4.4425686932184186e-05,0.75
11807,11807,생가/Noun,8,2,6,4.445926419917751e-05,8.885137386436837e-05,0.75
11808,11808,무지막지/Noun,8,6,2,8.891852839835501e-05,4.4425686932184186e-05,0.75
11809,11809,머리스타일/Noun,8,2,6,4.445926419917751e-05,8.885137386436837e-05,0.75
11810,11810,앉히다/Verb,8,2,6,4.445926419917751e-05,8.885137386436837e-05,0.75
11811,11811,음주/Noun,8,2,6,4.445926419917751e-05,8.885137386436837e-05,0.75
11812,11812,종결자/Noun,8,6,2,8.891852839835501e-05,4.4425686932184186e-05,0.75
11813,11813,가톨릭/Noun,8,6,2,8.891852839835501e-05,4.4425686932184186e-05,0.75
11814,11814,이영아/Noun,8,2,6,4.445926419917751e-05,8.885137386436837e-05,0.75
11815,11815,다이빙벨/Noun,8,2,6,4.445926419917751e-05,8.885137386436837e-05,0.75
11816,11816,면목/Noun,8,6,2,8.891852839835501e-05,4.4425686932184186e-05,0.75
11817,11817,고스트라이더/Noun,8,2,6,4.445926419917751e-05,8.885137386436837e-05,0.75
11818,11818,구애/Noun,8,6,2,8.891852839835501e-05,4.4425686932184186e-05,0.75
11819,11819,....!!/Punctuation,8,2,6,4.445926419917751e-05,8.885137386436837e-05,0.75
11820,11820,와이어액션/Noun,8,2,6,4.445926419917751e-05,8.885137386436837e-05,0.75
11821,11821,화산/Noun,8,6,2,8.891852839835501e-05,4.4425686932184186e-05,0.75
11822,11822,피셔/Noun,8,6,2,8.891852839835501e-05,4.4425686932184186e-05,0.75
11823,11823,콜라보/Noun,8,6,2,8.891852839835501e-05,4.4425686932184186e-05,0.75
11824,11824,미적지근하다/Adjective,8,2,6,4.445926419917751e-05,8.885137386436837e-05,0.75
11825,11825,기득권/Noun,8,6,2,8.891852839835501e-05,4.4425686932184186e-05,0.75
11826,11826,안전벨트/Noun,8,2,6,4.445926419917751e-05,8.885137386436837e-05,0.75
11827,11827,한단/Noun,8,2,6,4.445926419917751e-05,8.885137386436837e-05,0.75
11828,11828,ㄱㅊ/KoreanParticle,8,6,2,8.891852839835501e-05,4.4425686932184186e-05,0.75
11829,11829,~(/Punctuation,8,2,6,4.445926419917751e-05,8.885137386436837e-05,0.75
11830,11830,타블로/Noun,8,2,6,4.445926419917751e-05,8.885137386436837e-05,0.75
11831,11831,베이컨/Noun,8,6,2,8.891852839835501e-05,4.4425686932184186e-05,0.75
11832,11832,질병/Noun,8,2,6,4.445926419917751e-05,8.885137386436837e-05,0.75
11833,11833,만년/Noun,8,6,2,8.891852839835501e-05,4.4425686932184186e-05,0.75
11834,11834,위함/Noun,8,2,6,4.445926419917751e-05,8.885137386436837e-05,0.75
11835,11835,투사/Noun,8,6,2,8.891852839835501e-05,4.4425686932184186e-05,0.75
11836,11836,파랑/Noun,8,2,6,4.445926419917751e-05,8.885137386436837e-05,0.75
11837,11837,에덴/Noun,8,6,2,8.891852839835501e-05,4.4425686932184186e-05,0.75
11838,11838,루비반지/Noun,8,2,6,4.445926419917751e-05,8.885137386436837e-05,0.75
11839,11839,자연재해/Noun,8,6,2,8.891852839835501e-05,4.4425686932184186e-05,0.75
11840,11840,종로/Noun,8,6,2,8.891852839835501e-05,4.4425686932184186e-05,0.75
11841,11841,황신혜/Noun,8,2,6,4.445926419917751e-05,8.885137386436837e-05,0.75
11842,11842,복판/Noun,8,2,6,4.445926419917751e-05,8.885137386436837e-05,0.75
11843,11843,것일/Noun,8,2,6,4.445926419917751e-05,8.885137386436837e-05,0.75
11844,11844,주드/Noun,8,6,2,8.891852839835501e-05,4.4425686932184186e-05,0.75
11845,11845,철도/Noun,8,6,2,8.891852839835501e-05,4.4425686932184186e-05,0.75
11846,11846,잭니콜슨/Noun,8,6,2,8.891852839835501e-05,4.4425686932184186e-05,0.75
11847,11847,반짝반짝/Adverb,8,6,2,8.891852839835501e-05,4.4425686932184186e-05,0.75
11848,11848,한예리/Noun,8,6,2,8.891852839835501e-05,4.4425686932184186e-05,0.75
11849,11849,글씨/Noun,8,2,6,4.445926419917751e-05,8.885137386436837e-05,0.75
11850,11850,더미/Noun,8,2,6,4.445926419917751e-05,8.885137386436837e-05,0.75
11851,11851,이상인/Noun,8,6,2,8.891852839835501e-05,4.4425686932184186e-05,0.75
11852,11852,번지/Noun,8,6,2,8.891852839835501e-05,4.4425686932184186e-05,0.75
11853,11853,``/Punctuation,8,6,2,8.891852839835501e-05,4.4425686932184186e-05,0.75
11854,11854,돈버/Noun,8,2,6,4.445926419917751e-05,8.885137386436837e-05,0.75
11855,11855,99%/Number,8,6,2,8.891852839835501e-05,4.4425686932184186e-05,0.75
11856,11856,임금/Noun,8,2,6,4.445926419917751e-05,8.885137386436837e-05,0.75
11857,11857,직행/Noun,8,2,6,4.445926419917751e-05,8.885137386436837e-05,0.75
11858,11858,스와핑/Noun,8,2,6,4.445926419917751e-05,8.885137386436837e-05,0.75
11859,11859,문도/Noun,8,2,6,4.445926419917751e-05,8.885137386436837e-05,0.75
11860,11860,칠레/Noun,8,6,2,8.891852839835501e-05,4.4425686932184186e-05,0.75
11861,11861,무력하다/Adjective,8,2,6,4.445926419917751e-05,8.885137386436837e-05,0.75
11862,11862,머나멀다/Adjective,8,6,2,8.891852839835501e-05,4.4425686932184186e-05,0.75
11863,11863,탁탁/Noun,8,2,6,4.445926419917751e-05,8.885137386436837e-05,0.75
11864,11864,학력/Noun,8,2,6,4.445926419917751e-05,8.885137386436837e-05,0.75
11865,11865,카우보이/Noun,8,6,2,8.891852839835501e-05,4.4425686932184186e-05,0.75
11866,11866,신애/Noun,8,2,6,4.445926419917751e-05,8.885137386436837e-05,0.75
11867,11867,번호/Noun,8,2,6,4.445926419917751e-05,8.885137386436837e-05,0.75
11868,11868,저음/Noun,8,6,2,8.891852839835501e-05,4.4425686932184186e-05,0.75
11869,11869,바바라/Noun,8,6,2,8.891852839835501e-05,4.4425686932184186e-05,0.75
11870,11870,서요/Noun,8,2,6,4.445926419917751e-05,8.885137386436837e-05,0.75
11871,11871,본업/Noun,8,2,6,4.445926419917751e-05,8.885137386436837e-05,0.75
11872,11872,오닐/Noun,8,6,2,8.891852839835501e-05,4.4425686932184186e-05,0.75
11873,11873,개드립/Noun,8,2,6,4.445926419917751e-05,8.885137386436837e-05,0.75
11874,11874,메기/Noun,8,2,6,4.445926419917751e-05,8.885137386436837e-05,0.75
11875,11875,양다리/Noun,8,2,6,4.445926419917751e-05,8.885137386436837e-05,0.75
11876,11876,굵직하다/Adjective,8,6,2,8.891852839835501e-05,4.4425686932184186e-05,0.75
11877,11877,입원/Noun,8,2,6,4.445926419917751e-05,8.885137386436837e-05,0.75
11878,11878,파이란/Noun,8,6,2,8.891852839835501e-05,4.4425686932184186e-05,0.75
11879,11879,애플렉/Noun,8,6,2,8.891852839835501e-05,4.4425686932184186e-05,0.75
11880,11880,성우진/Noun,8,6,2,8.891852839835501e-05,4.4425686932184186e-05,0.75
11881,11881,불의/Noun,8,6,2,8.891852839835501e-05,4.4425686932184186e-05,0.75
11882,11882,27년/Number,8,6,2,8.891852839835501e-05,4.4425686932184186e-05,0.75
11883,11883,감시/Noun,8,6,2,8.891852839835501e-05,4.4425686932184186e-05,0.75
11884,11884,실리/Noun,8,6,2,8.891852839835501e-05,4.4425686932184186e-05,0.75
11885,11885,나부/Noun,8,2,6,4.445926419917751e-05,8.885137386436837e-05,0.75
11886,11886,발리우드/Noun,8,6,2,8.891852839835501e-05,4.4425686932184186e-05,0.75
11887,11887,대성통곡/Noun,8,6,2,8.891852839835501e-05,4.4425686932184186e-05,0.75
11888,11888,로완/Noun,8,6,2,8.891852839835501e-05,4.4425686932184186e-05,0.75
11889,11889,농부/Noun,8,6,2,8.891852839835501e-05,4.4425686932184186e-05,0.75
11890,11890,out/Alpha,8,2,6,4.445926419917751e-05,8.885137386436837e-05,0.75
11891,11891,부다페스트/Noun,8,2,6,4.445926419917751e-05,8.885137386436837e-05,0.75
11892,11892,어쩐/Modifier,8,2,6,4.445926419917751e-05,8.885137386436837e-05,0.75
11893,11893,;;;;;;;/Punctuation,8,2,6,4.445926419917751e-05,8.885137386436837e-05,0.75
11894,11894,대목/Noun,8,2,6,4.445926419917751e-05,8.885137386436837e-05,0.75
11895,11895,수식/Noun,8,6,2,8.891852839835501e-05,4.4425686932184186e-05,0.75
11896,11896,닉쿤/Noun,8,2,6,4.445926419917751e-05,8.885137386436837e-05,0.75
11897,11897,과대망상/Noun,8,2,6,4.445926419917751e-05,8.885137386436837e-05,0.75
11898,11898,개독교/Noun,8,2,6,4.445926419917751e-05,8.885137386436837e-05,0.75
11899,11899,전향/Noun,8,2,6,4.445926419917751e-05,8.885137386436837e-05,0.75
11900,11900,리해/Noun,8,2,6,4.445926419917751e-05,8.885137386436837e-05,0.75
11901,11901,나쁜사람/Noun,8,2,6,4.445926419917751e-05,8.885137386436837e-05,0.75
11902,11902,지진/Noun,8,2,6,4.445926419917751e-05,8.885137386436837e-05,0.75
11903,11903,번뜩이다/Verb,8,6,2,8.891852839835501e-05,4.4425686932184186e-05,0.75
11904,11904,우승자/Noun,8,2,6,4.445926419917751e-05,8.885137386436837e-05,0.75
11905,11905,콘/Noun,8,6,2,8.891852839835501e-05,4.4425686932184186e-05,0.75
11906,11906,소음/Noun,8,2,6,4.445926419917751e-05,8.885137386436837e-05,0.75
11907,11907,페드로/Noun,8,6,2,8.891852839835501e-05,4.4425686932184186e-05,0.75
11908,11908,손대다/Verb,8,2,6,4.445926419917751e-05,8.885137386436837e-05,0.75
11909,11909,엔젤/Noun,8,6,2,8.891852839835501e-05,4.4425686932184186e-05,0.75
11910,11910,감자별/Noun,8,6,2,8.891852839835501e-05,4.4425686932184186e-05,0.75
11911,11911,ㅊㅊ/KoreanParticle,8,6,2,8.891852839835501e-05,4.4425686932184186e-05,0.75
11912,11912,신가/Noun,8,2,6,4.445926419917751e-05,8.885137386436837e-05,0.75
11913,11913,마크로스/Noun,8,2,6,4.445926419917751e-05,8.885137386436837e-05,0.75
11914,11914,고스톱/Noun,8,2,6,4.445926419917751e-05,8.885137386436837e-05,0.75
11915,11915,닌자거북이/Noun,8,2,6,4.445926419917751e-05,8.885137386436837e-05,0.75
11916,11916,그나/Noun,8,2,6,4.445926419917751e-05,8.885137386436837e-05,0.75
11917,11917,구미/Noun,8,6,2,8.891852839835501e-05,4.4425686932184186e-05,0.75
11918,11918,그니까/Conjunction,8,2,6,4.445926419917751e-05,8.885137386436837e-05,0.75
11919,11919,고어영화/Noun,8,2,6,4.445926419917751e-05,8.885137386436837e-05,0.75
11920,11920,균/Noun,8,6,2,8.891852839835501e-05,4.4425686932184186e-05,0.75
11921,11921,이간/Noun,8,2,6,4.445926419917751e-05,8.885137386436837e-05,0.75
11922,11922,해병/Noun,8,6,2,8.891852839835501e-05,4.4425686932184186e-05,0.75
11923,11923,초이스/Noun,8,6,2,8.891852839835501e-05,4.4425686932184186e-05,0.75
11924,11924,장미인애/Noun,8,2,6,4.445926419917751e-05,8.885137386436837e-05,0.75
11925,11925,열사/Noun,8,6,2,8.891852839835501e-05,4.4425686932184186e-05,0.75
11926,11926,활짝/Noun,8,6,2,8.891852839835501e-05,4.4425686932184186e-05,0.75
11927,11927,소울/Noun,8,6,2,8.891852839835501e-05,4.4425686932184186e-05,0.75
11928,11928,when/Alpha,8,6,2,8.891852839835501e-05,4.4425686932184186e-05,0.75
11929,11929,see/Alpha,8,6,2,8.891852839835501e-05,4.4425686932184186e-05,0.75
11930,11930,무크/Noun,8,2,6,4.445926419917751e-05,8.885137386436837e-05,0.75
11931,11931,호박/Noun,8,2,6,4.445926419917751e-05,8.885137386436837e-05,0.75
11932,11932,링크/Noun,8,2,6,4.445926419917751e-05,8.885137386436837e-05,0.75
11933,11933,비만/Noun,8,6,2,8.891852839835501e-05,4.4425686932184186e-05,0.75
11934,11934,택연/Noun,8,6,2,8.891852839835501e-05,4.4425686932184186e-05,0.75
11935,11935,관전/Noun,8,2,6,4.445926419917751e-05,8.885137386436837e-05,0.75
11936,11936,팝스타/Noun,8,2,6,4.445926419917751e-05,8.885137386436837e-05,0.75
11937,11937,이상아/Noun,8,2,6,4.445926419917751e-05,8.885137386436837e-05,0.75
11938,11938,젤위거/Noun,8,6,2,8.891852839835501e-05,4.4425686932184186e-05,0.75
11939,11939,시츄에이션/Noun,8,2,6,4.445926419917751e-05,8.885137386436837e-05,0.75
11940,11940,씨쥐/Noun,8,2,6,4.445926419917751e-05,8.885137386436837e-05,0.75
11941,11941,...-/Punctuation,8,2,6,4.445926419917751e-05,8.885137386436837e-05,0.75
11942,11942,중생/Noun,8,2,6,4.445926419917751e-05,8.885137386436837e-05,0.75
11943,11943,굴복/Noun,8,6,2,8.891852839835501e-05,4.4425686932184186e-05,0.75
11944,11944,부어/Noun,8,2,6,4.445926419917751e-05,8.885137386436837e-05,0.75
11945,11945,천명/Noun,8,6,2,8.891852839835501e-05,4.4425686932184186e-05,0.75
11946,11946,데일/Noun,8,2,6,4.445926419917751e-05,8.885137386436837e-05,0.75
11947,11947,윤도현/Noun,8,2,6,4.445926419917751e-05,8.885137386436837e-05,0.75
11948,11948,나아/Adverb,8,2,6,4.445926419917751e-05,8.885137386436837e-05,0.75
11949,11949,99/Number,8,6,2,8.891852839835501e-05,4.4425686932184186e-05,0.75
11950,11950,파쿠르/Noun,8,2,6,4.445926419917751e-05,8.885137386436837e-05,0.75
11951,11951,형상/Noun,8,6,2,8.891852839835501e-05,4.4425686932184186e-05,0.75
11952,11952,간간이/Noun,8,6,2,8.891852839835501e-05,4.4425686932184186e-05,0.75
11953,11953,애나벨/Noun,8,6,2,8.891852839835501e-05,4.4425686932184186e-05,0.75
11954,11954,만일/Noun,8,2,6,4.445926419917751e-05,8.885137386436837e-05,0.75
11955,11955,흐려지다/Verb,8,6,2,8.891852839835501e-05,4.4425686932184186e-05,0.75
11956,11956,!!../Punctuation,8,6,2,8.891852839835501e-05,4.4425686932184186e-05,0.75
11957,11957,트리스탄/Noun,8,6,2,8.891852839835501e-05,4.4425686932184186e-05,0.75
11958,11958,얘길/Noun,8,2,6,4.445926419917751e-05,8.885137386436837e-05,0.75
11959,11959,볼떄/Noun,8,6,2,8.891852839835501e-05,4.4425686932184186e-05,0.75
11960,11960,무지무지/Adverb,8,6,2,8.891852839835501e-05,4.4425686932184186e-05,0.75
11961,11961,셀프/Noun,8,2,6,4.445926419917751e-05,8.885137386436837e-05,0.75
11962,11962,저장/Noun,8,6,2,8.891852839835501e-05,4.4425686932184186e-05,0.75
11963,11963,비토/Noun,8,6,2,8.891852839835501e-05,4.4425686932184186e-05,0.75
11964,11964,기구/Noun,8,2,6,4.445926419917751e-05,8.885137386436837e-05,0.75
11965,11965,매너리즘/Noun,8,2,6,4.445926419917751e-05,8.885137386436837e-05,0.75
11966,11966,코네/Noun,8,6,2,8.891852839835501e-05,4.4425686932184186e-05,0.75
11967,11967,마이애미/Noun,8,6,2,8.891852839835501e-05,4.4425686932184186e-05,0.75
11968,11968,콧수염/Noun,8,2,6,4.445926419917751e-05,8.885137386436837e-05,0.75
11969,11969,전시/Noun,8,2,6,4.445926419917751e-05,8.885137386436837e-05,0.75
11970,11970,서남/Noun,8,2,6,4.445926419917751e-05,8.885137386436837e-05,0.75
11971,11971,스태프/Noun,8,2,6,4.445926419917751e-05,8.885137386436837e-05,0.75
11972,11972,콘택트/Noun,8,6,2,8.891852839835501e-05,4.4425686932184186e-05,0.75
11973,11973,아홉/Determiner,8,6,2,8.891852839835501e-05,4.4425686932184186e-05,0.75
11974,11974,탁구/Noun,8,6,2,8.891852839835501e-05,4.4425686932184186e-05,0.75
11975,11975,개싸움/Noun,8,2,6,4.445926419917751e-05,8.885137386436837e-05,0.75
11976,11976,전수/Noun,8,2,6,4.445926419917751e-05,8.885137386436837e-05,0.75
11977,11977,주책/Noun,8,2,6,4.445926419917751e-05,8.885137386436837e-05,0.75
11978,11978,혜택/Noun,8,2,6,4.445926419917751e-05,8.885137386436837e-05,0.75
11979,11979,간극/Noun,8,6,2,8.891852839835501e-05,4.4425686932184186e-05,0.75
11980,11980,응급남녀/Noun,8,6,2,8.891852839835501e-05,4.4425686932184186e-05,0.75
11981,11981,초인/Noun,8,2,6,4.445926419917751e-05,8.885137386436837e-05,0.75
11982,11982,관록/Noun,8,6,2,8.891852839835501e-05,4.4425686932184186e-05,0.75
11983,11983,오니/Noun,8,2,6,4.445926419917751e-05,8.885137386436837e-05,0.75
11984,11984,크레이지/Noun,8,2,6,4.445926419917751e-05,8.885137386436837e-05,0.75
11985,11985,군사/Noun,8,2,6,4.445926419917751e-05,8.885137386436837e-05,0.75
11986,11986,애드립/Noun,8,2,6,4.445926419917751e-05,8.885137386436837e-05,0.75
11987,11987,근성/Noun,8,5,3,7.780371234856063e-05,5.553210866523024e-05,0.625
11988,11988,열풍/Noun,8,5,3,7.780371234856063e-05,5.553210866523024e-05,0.625
11989,11989,생계/Noun,8,5,3,7.780371234856063e-05,5.553210866523024e-05,0.625
11990,11990,중하/Noun,8,3,5,5.5574080248971876e-05,7.774495213132233e-05,0.625
11991,11991,롹/Noun,8,3,5,5.5574080248971876e-05,7.774495213132233e-05,0.625
11992,11992,춥다/Adjective,8,3,5,5.5574080248971876e-05,7.774495213132233e-05,0.625
11993,11993,대보다/Verb,8,3,5,5.5574080248971876e-05,7.774495213132233e-05,0.625
11994,11994,5회/Number,8,5,3,7.780371234856063e-05,5.553210866523024e-05,0.625
11995,11995,과오/Noun,8,5,3,7.780371234856063e-05,5.553210866523024e-05,0.625
11996,11996,자문/Noun,8,5,3,7.780371234856063e-05,5.553210866523024e-05,0.625
11997,11997,불사/Noun,8,5,3,7.780371234856063e-05,5.553210866523024e-05,0.625
11998,11998,초상/Noun,8,3,5,5.5574080248971876e-05,7.774495213132233e-05,0.625
11999,11999,나볼/Noun,8,5,3,7.780371234856063e-05,5.553210866523024e-05,0.625
12000,12000,지뢰/Noun,8,3,5,5.5574080248971876e-05,7.774495213132233e-05,0.625
12001,12001,사스/Noun,8,3,5,5.5574080248971876e-05,7.774495213132233e-05,0.625
12002,12002,생선/Noun,8,3,5,5.5574080248971876e-05,7.774495213132233e-05,0.625
12003,12003,she/Alpha,8,5,3,7.780371234856063e-05,5.553210866523024e-05,0.625
12004,12004,예진/Noun,8,5,3,7.780371234856063e-05,5.553210866523024e-05,0.625
12005,12005,요요/Noun,8,5,3,7.780371234856063e-05,5.553210866523024e-05,0.625
12006,12006,??.../Punctuation,8,3,5,5.5574080248971876e-05,7.774495213132233e-05,0.625
12007,12007,문정희/Noun,8,3,5,5.5574080248971876e-05,7.774495213132233e-05,0.625
12008,12008,구석구석/Noun,8,5,3,7.780371234856063e-05,5.553210866523024e-05,0.625
12009,12009,브라더스/Noun,8,5,3,7.780371234856063e-05,5.553210866523024e-05,0.625
12010,12010,도끼/Noun,8,3,5,5.5574080248971876e-05,7.774495213132233e-05,0.625
12011,12011,수용/Noun,8,5,3,7.780371234856063e-05,5.553210866523024e-05,0.625
12012,12012,무라카미/Noun,8,3,5,5.5574080248971876e-05,7.774495213132233e-05,0.625
12013,12013,태풍/Noun,8,3,5,5.5574080248971876e-05,7.774495213132233e-05,0.625
12014,12014,콜라/Noun,8,5,3,7.780371234856063e-05,5.553210866523024e-05,0.625
12015,12015,마고/Noun,8,5,3,7.780371234856063e-05,5.553210866523024e-05,0.625
12016,12016,탑건/Noun,8,3,5,5.5574080248971876e-05,7.774495213132233e-05,0.625
12017,12017,오스틴/Noun,8,5,3,7.780371234856063e-05,5.553210866523024e-05,0.625
12018,12018,동심파괴/Noun,8,3,5,5.5574080248971876e-05,7.774495213132233e-05,0.625
12019,12019,친해지다/Verb,8,5,3,7.780371234856063e-05,5.553210866523024e-05,0.625
12020,12020,게이고/Noun,8,5,3,7.780371234856063e-05,5.553210866523024e-05,0.625
12021,12021,최신영/Noun,8,3,5,5.5574080248971876e-05,7.774495213132233e-05,0.625
12022,12022,케이크/Noun,8,5,3,7.780371234856063e-05,5.553210866523024e-05,0.625
12023,12023,도약/Noun,8,3,5,5.5574080248971876e-05,7.774495213132233e-05,0.625
12024,12024,딩/Noun,8,3,5,5.5574080248971876e-05,7.774495213132233e-05,0.625
12025,12025,하소/Noun,8,3,5,5.5574080248971876e-05,7.774495213132233e-05,0.625
12026,12026,허당/Noun,8,5,3,7.780371234856063e-05,5.553210866523024e-05,0.625
12027,12027,도일/Noun,8,3,5,5.5574080248971876e-05,7.774495213132233e-05,0.625
12028,12028,야인시대/Noun,8,3,5,5.5574080248971876e-05,7.774495213132233e-05,0.625
12029,12029,이대/Modifier,8,3,5,5.5574080248971876e-05,7.774495213132233e-05,0.625
12030,12030,............................/Punctuation,8,3,5,5.5574080248971876e-05,7.774495213132233e-05,0.625
12031,12031,냉정/Noun,8,5,3,7.780371234856063e-05,5.553210866523024e-05,0.625
12032,12032,청각/Noun,8,5,3,7.780371234856063e-05,5.553210866523024e-05,0.625
12033,12033,행보/Noun,8,5,3,7.780371234856063e-05,5.553210866523024e-05,0.625
12034,12034,고위/Noun,8,5,3,7.780371234856063e-05,5.553210866523024e-05,0.625
12035,12035,깜/Noun,8,5,3,7.780371234856063e-05,5.553210866523024e-05,0.625
12036,12036,소제/Noun,8,5,3,7.780371234856063e-05,5.553210866523024e-05,0.625
12037,12037,라임/Noun,8,5,3,7.780371234856063e-05,5.553210866523024e-05,0.625
12038,12038,구스/Noun,8,5,3,7.780371234856063e-05,5.553210866523024e-05,0.625
12039,12039,일라이/Noun,8,5,3,7.780371234856063e-05,5.553210866523024e-05,0.625
12040,12040,정웅인/Noun,8,3,5,5.5574080248971876e-05,7.774495213132233e-05,0.625
12041,12041,서영이/Noun,8,5,3,7.780371234856063e-05,5.553210866523024e-05,0.625
12042,12042,가선/Noun,8,5,3,7.780371234856063e-05,5.553210866523024e-05,0.625
12043,12043,자유분방하다/Adjective,8,5,3,7.780371234856063e-05,5.553210866523024e-05,0.625
12044,12044,식객/Noun,8,3,5,5.5574080248971876e-05,7.774495213132233e-05,0.625
12045,12045,XXX/Alpha,8,3,5,5.5574080248971876e-05,7.774495213132233e-05,0.625
12046,12046,컨트롤/Noun,8,5,3,7.780371234856063e-05,5.553210866523024e-05,0.625
12047,12047,이상윤/Noun,8,5,3,7.780371234856063e-05,5.553210866523024e-05,0.625
12048,12048,노장/Noun,8,5,3,7.780371234856063e-05,5.553210866523024e-05,0.625
12049,12049,벅스라이프/Noun,8,3,5,5.5574080248971876e-05,7.774495213132233e-05,0.625
12050,12050,필사/Noun,8,5,3,7.780371234856063e-05,5.553210866523024e-05,0.625
12051,12051,거룩하다/Adjective,8,3,5,5.5574080248971876e-05,7.774495213132233e-05,0.625
12052,12052,레포트/Noun,8,3,5,5.5574080248971876e-05,7.774495213132233e-05,0.625
12053,12053,브레이/Noun,8,3,5,5.5574080248971876e-05,7.774495213132233e-05,0.625
12054,12054,윤상현/Noun,8,5,3,7.780371234856063e-05,5.553210866523024e-05,0.625
12055,12055,월등하다/Adjective,8,3,5,5.5574080248971876e-05,7.774495213132233e-05,0.625
12056,12056,뜰/Noun,8,3,5,5.5574080248971876e-05,7.774495213132233e-05,0.625
12057,12057,깨부수다/Verb,8,3,5,5.5574080248971876e-05,7.774495213132233e-05,0.625
12058,12058,저수지/Noun,8,3,5,5.5574080248971876e-05,7.774495213132233e-05,0.625
12059,12059,개보/Noun,8,3,5,5.5574080248971876e-05,7.774495213132233e-05,0.625
12060,12060,레이져/Noun,8,5,3,7.780371234856063e-05,5.553210866523024e-05,0.625
12061,12061,토마토/Noun,8,3,5,5.5574080248971876e-05,7.774495213132233e-05,0.625
12062,12062,짐머/Noun,8,5,3,7.780371234856063e-05,5.553210866523024e-05,0.625
12063,12063,랭/Noun,8,5,3,7.780371234856063e-05,5.553210866523024e-05,0.625
12064,12064,착륙/Noun,8,5,3,7.780371234856063e-05,5.553210866523024e-05,0.625
12065,12065,리드/Noun,8,3,5,5.5574080248971876e-05,7.774495213132233e-05,0.625
12066,12066,섭렵/Noun,8,5,3,7.780371234856063e-05,5.553210866523024e-05,0.625
12067,12067,인신매매/Noun,8,3,5,5.5574080248971876e-05,7.774495213132233e-05,0.625
12068,12068,월급/Noun,8,3,5,5.5574080248971876e-05,7.774495213132233e-05,0.625
12069,12069,이준익/Noun,8,3,5,5.5574080248971876e-05,7.774495213132233e-05,0.625
12070,12070,숫/Noun,8,5,3,7.780371234856063e-05,5.553210866523024e-05,0.625
12071,12071,레이드/Noun,8,5,3,7.780371234856063e-05,5.553210866523024e-05,0.625
12072,12072,리즈/Foreign,8,5,3,7.780371234856063e-05,5.553210866523024e-05,0.625
12073,12073,이어진/Noun,8,5,3,7.780371234856063e-05,5.553210866523024e-05,0.625
12074,12074,블란쳇/Noun,8,5,3,7.780371234856063e-05,5.553210866523024e-05,0.625
12075,12075,달리기/Noun,8,3,5,5.5574080248971876e-05,7.774495213132233e-05,0.625
12076,12076,우매/Noun,8,3,5,5.5574080248971876e-05,7.774495213132233e-05,0.625
12077,12077,된/Foreign,8,5,3,7.780371234856063e-05,5.553210866523024e-05,0.625
12078,12078,쿠삭/Noun,8,3,5,5.5574080248971876e-05,7.774495213132233e-05,0.625
12079,12079,심문/Noun,8,3,5,5.5574080248971876e-05,7.774495213132233e-05,0.625
12080,12080,아귀/Noun,8,5,3,7.780371234856063e-05,5.553210866523024e-05,0.625
12081,12081,이천희/Noun,8,5,3,7.780371234856063e-05,5.553210866523024e-05,0.625
12082,12082,의대/Noun,8,5,3,7.780371234856063e-05,5.553210866523024e-05,0.625
12083,12083,수확/Noun,8,3,5,5.5574080248971876e-05,7.774495213132233e-05,0.625
12084,12084,헵번/Noun,8,5,3,7.780371234856063e-05,5.553210866523024e-05,0.625
12085,12085,!(/Punctuation,8,5,3,7.780371234856063e-05,5.553210866523024e-05,0.625
12086,12086,really/Alpha,8,3,5,5.5574080248971876e-05,7.774495213132233e-05,0.625
12087,12087,GTA/Alpha,8,3,5,5.5574080248971876e-05,7.774495213132233e-05,0.625
12088,12088,단발/Noun,8,3,5,5.5574080248971876e-05,7.774495213132233e-05,0.625
12089,12089,우리말/Noun,8,3,5,5.5574080248971876e-05,7.774495213132233e-05,0.625
12090,12090,근무/Noun,8,3,5,5.5574080248971876e-05,7.774495213132233e-05,0.625
12091,12091,영국인/Noun,8,5,3,7.780371234856063e-05,5.553210866523024e-05,0.625
12092,12092,약혼자/Noun,8,3,5,5.5574080248971876e-05,7.774495213132233e-05,0.625
12093,12093,안되겠니/Noun,8,3,5,5.5574080248971876e-05,7.774495213132233e-05,0.625
12094,12094,98분/Number,8,3,5,5.5574080248971876e-05,7.774495213132233e-05,0.625
12095,12095,철권/Noun,8,5,3,7.780371234856063e-05,5.553210866523024e-05,0.625
12096,12096,토탈리콜/Noun,8,3,5,5.5574080248971876e-05,7.774495213132233e-05,0.625
12097,12097,곁들이다/Verb,8,5,3,7.780371234856063e-05,5.553210866523024e-05,0.625
12098,12098,노르웨이/Noun,8,3,5,5.5574080248971876e-05,7.774495213132233e-05,0.625
12099,12099,박건형/Noun,8,3,5,5.5574080248971876e-05,7.774495213132233e-05,0.625
12100,12100,어벤저스/Noun,8,5,3,7.780371234856063e-05,5.553210866523024e-05,0.625
12101,12101,수목드라마/Noun,8,5,3,7.780371234856063e-05,5.553210866523024e-05,0.625
12102,12102,발광하다/Adjective,8,3,5,5.5574080248971876e-05,7.774495213132233e-05,0.625
12103,12103,이마/Modifier,8,5,3,7.780371234856063e-05,5.553210866523024e-05,0.625
12104,12104,일해/Noun,8,3,5,5.5574080248971876e-05,7.774495213132233e-05,0.625
12105,12105,진흙탕/Noun,8,5,3,7.780371234856063e-05,5.553210866523024e-05,0.625
12106,12106,』/Foreign,8,5,3,7.780371234856063e-05,5.553210866523024e-05,0.625
12107,12107,팔자/Noun,8,3,5,5.5574080248971876e-05,7.774495213132233e-05,0.625
12108,12108,밍/Noun,8,5,3,7.780371234856063e-05,5.553210866523024e-05,0.625
12109,12109,정두홍/Noun,8,3,5,5.5574080248971876e-05,7.774495213132233e-05,0.625
12110,12110,일제강점기/Noun,8,5,3,7.780371234856063e-05,5.553210866523024e-05,0.625
12111,12111,공동/Noun,8,3,5,5.5574080248971876e-05,7.774495213132233e-05,0.625
12112,12112,유린/Noun,8,5,3,7.780371234856063e-05,5.553210866523024e-05,0.625
12113,12113,강물/Noun,8,5,3,7.780371234856063e-05,5.553210866523024e-05,0.625
12114,12114,숙이다/Verb,8,5,3,7.780371234856063e-05,5.553210866523024e-05,0.625
12115,12115,그러다가/Conjunction,8,3,5,5.5574080248971876e-05,7.774495213132233e-05,0.625
12116,12116,용구성/Noun,8,3,5,5.5574080248971876e-05,7.774495213132233e-05,0.625
12117,12117,정반대/Noun,8,5,3,7.780371234856063e-05,5.553210866523024e-05,0.625
12118,12118,냉전시대/Noun,8,5,3,7.780371234856063e-05,5.553210866523024e-05,0.625
12119,12119,폭격/Noun,8,3,5,5.5574080248971876e-05,7.774495213132233e-05,0.625
12120,12120,군부/Noun,8,5,3,7.780371234856063e-05,5.553210866523024e-05,0.625
12121,12121,왓음/Noun,8,3,5,5.5574080248971876e-05,7.774495213132233e-05,0.625
12122,12122,펑점/Noun,8,3,5,5.5574080248971876e-05,7.774495213132233e-05,0.625
12123,12123,~~~~~~~~~~~/Punctuation,8,5,3,7.780371234856063e-05,5.553210866523024e-05,0.625
12124,12124,왕빛나/Noun,8,3,5,5.5574080248971876e-05,7.774495213132233e-05,0.625
12125,12125,씬나다/Adjective,8,3,5,5.5574080248971876e-05,7.774495213132233e-05,0.625
12126,12126,프로스트/Noun,8,3,5,5.5574080248971876e-05,7.774495213132233e-05,0.625
12127,12127,점때/Noun,8,3,5,5.5574080248971876e-05,7.774495213132233e-05,0.625
12128,12128,story/Alpha,8,5,3,7.780371234856063e-05,5.553210866523024e-05,0.625
12129,12129,라퓨타/Noun,8,5,3,7.780371234856063e-05,5.553210866523024e-05,0.625
12130,12130,리리/Noun,8,5,3,7.780371234856063e-05,5.553210866523024e-05,0.625
12131,12131,헤븐/Noun,8,5,3,7.780371234856063e-05,5.553210866523024e-05,0.625
12132,12132,식사/Noun,8,3,5,5.5574080248971876e-05,7.774495213132233e-05,0.625
12133,12133,뮤츠/Noun,8,5,3,7.780371234856063e-05,5.553210866523024e-05,0.625
12134,12134,ㅇㄴ/KoreanParticle,8,3,5,5.5574080248971876e-05,7.774495213132233e-05,0.625
12135,12135,쏜다/Noun,8,3,5,5.5574080248971876e-05,7.774495213132233e-05,0.625
12136,12136,일기장/Noun,8,3,5,5.5574080248971876e-05,7.774495213132233e-05,0.625
12137,12137,초속/Noun,8,3,5,5.5574080248971876e-05,7.774495213132233e-05,0.625
12138,12138,젝키/Noun,8,5,3,7.780371234856063e-05,5.553210866523024e-05,0.625
12139,12139,10일/Number,8,5,3,7.780371234856063e-05,5.553210866523024e-05,0.625
12140,12140,점준놈/Noun,8,3,5,5.5574080248971876e-05,7.774495213132233e-05,0.625
12141,12141,셀마/Noun,8,5,3,7.780371234856063e-05,5.553210866523024e-05,0.625
12142,12142,대개/Noun,8,3,5,5.5574080248971876e-05,7.774495213132233e-05,0.625
12143,12143,뛰어내리다/Verb,8,5,3,7.780371234856063e-05,5.553210866523024e-05,0.625
12144,12144,시드/Noun,8,5,3,7.780371234856063e-05,5.553210866523024e-05,0.625
12145,12145,베베/Noun,8,3,5,5.5574080248971876e-05,7.774495213132233e-05,0.625
12146,12146,야비하다/Adjective,8,3,5,5.5574080248971876e-05,7.774495213132233e-05,0.625
12147,12147,파이트클럽/Noun,8,5,3,7.780371234856063e-05,5.553210866523024e-05,0.625
12148,12148,고잉홈/Noun,8,5,3,7.780371234856063e-05,5.553210866523024e-05,0.625
12149,12149,소아/Noun,8,5,3,7.780371234856063e-05,5.553210866523024e-05,0.625
12150,12150,테츠/Noun,8,5,3,7.780371234856063e-05,5.553210866523024e-05,0.625
12151,12151,회복하다/Adjective,8,5,3,7.780371234856063e-05,5.553210866523024e-05,0.625
12152,12152,바닷가/Noun,8,3,5,5.5574080248971876e-05,7.774495213132233e-05,0.625
12153,12153,촬영장/Noun,8,5,3,7.780371234856063e-05,5.553210866523024e-05,0.625
12154,12154,웨딩/Noun,8,5,3,7.780371234856063e-05,5.553210866523024e-05,0.625
12155,12155,입김/Noun,8,3,5,5.5574080248971876e-05,7.774495213132233e-05,0.625
12156,12156,공허/Noun,8,5,3,7.780371234856063e-05,5.553210866523024e-05,0.625
12157,12157,9시/Number,8,5,3,7.780371234856063e-05,5.553210866523024e-05,0.625
12158,12158,탈모/Noun,8,5,3,7.780371234856063e-05,5.553210866523024e-05,0.625
12159,12159,원정/Noun,8,3,5,5.5574080248971876e-05,7.774495213132233e-05,0.625
12160,12160,"~,/Punctuation",8,5,3,7.780371234856063e-05,5.553210866523024e-05,0.625
12161,12161,3등/Number,8,5,3,7.780371234856063e-05,5.553210866523024e-05,0.625
12162,12162,진주만/Noun,8,3,5,5.5574080248971876e-05,7.774495213132233e-05,0.625
12163,12163,상반/Noun,8,5,3,7.780371234856063e-05,5.553210866523024e-05,0.625
12164,12164,맨인블랙/Noun,8,5,3,7.780371234856063e-05,5.553210866523024e-05,0.625
12165,12165,!!!!!!!!!!!!!!!!/Punctuation,8,5,3,7.780371234856063e-05,5.553210866523024e-05,0.625
12166,12166,예술인/Noun,8,5,3,7.780371234856063e-05,5.553210866523024e-05,0.625
12167,12167,하내/Noun,8,3,5,5.5574080248971876e-05,7.774495213132233e-05,0.625
12168,12168,h/Alpha,8,5,3,7.780371234856063e-05,5.553210866523024e-05,0.625
12169,12169,폭로/Noun,8,5,3,7.780371234856063e-05,5.553210866523024e-05,0.625
12170,12170,연합/Noun,8,3,5,5.5574080248971876e-05,7.774495213132233e-05,0.625
12171,12171,작도/Noun,8,3,5,5.5574080248971876e-05,7.774495213132233e-05,0.625
12172,12172,패닉/Noun,8,5,3,7.780371234856063e-05,5.553210866523024e-05,0.625
12173,12173,시놉/Noun,8,3,5,5.5574080248971876e-05,7.774495213132233e-05,0.625
12174,12174,엘르/Noun,8,5,3,7.780371234856063e-05,5.553210866523024e-05,0.625
12175,12175,검찰/Noun,8,5,3,7.780371234856063e-05,5.553210866523024e-05,0.625
12176,12176,시라노/Noun,8,5,3,7.780371234856063e-05,5.553210866523024e-05,0.625
12177,12177,소연/Noun,8,5,3,7.780371234856063e-05,5.553210866523024e-05,0.625
12178,12178,김연아/Noun,8,3,5,5.5574080248971876e-05,7.774495213132233e-05,0.625
12179,12179,60초/Number,8,3,5,5.5574080248971876e-05,7.774495213132233e-05,0.625
12180,12180,그겨울/Noun,8,3,5,5.5574080248971876e-05,7.774495213132233e-05,0.625
12181,12181,밑에님/Noun,8,5,3,7.780371234856063e-05,5.553210866523024e-05,0.625
12182,12182,하드보일드/Noun,8,5,3,7.780371234856063e-05,5.553210866523024e-05,0.625
12183,12183,도마뱀/Noun,8,3,5,5.5574080248971876e-05,7.774495213132233e-05,0.625
12184,12184,우월하다/Adjective,8,5,3,7.780371234856063e-05,5.553210866523024e-05,0.625
12185,12185,호의/Noun,8,3,5,5.5574080248971876e-05,7.774495213132233e-05,0.625
12186,12186,허물/Noun,8,3,5,5.5574080248971876e-05,7.774495213132233e-05,0.625
12187,12187,테레비/Noun,8,3,5,5.5574080248971876e-05,7.774495213132233e-05,0.625
12188,12188,탈주/Noun,8,5,3,7.780371234856063e-05,5.553210866523024e-05,0.625
12189,12189,지끈/Noun,8,3,5,5.5574080248971876e-05,7.774495213132233e-05,0.625
12190,12190,오웬/Noun,8,5,3,7.780371234856063e-05,5.553210866523024e-05,0.625
12191,12191,흐릿/Noun,8,5,3,7.780371234856063e-05,5.553210866523024e-05,0.625
12192,12192,5원/Number,8,5,3,7.780371234856063e-05,5.553210866523024e-05,0.625
12193,12193,업체/Noun,8,3,5,5.5574080248971876e-05,7.774495213132233e-05,0.625
12194,12194,레슬러/Noun,8,3,5,5.5574080248971876e-05,7.774495213132233e-05,0.625
12195,12195,중동/Noun,8,5,3,7.780371234856063e-05,5.553210866523024e-05,0.625
12196,12196,티어/Noun,8,3,5,5.5574080248971876e-05,7.774495213132233e-05,0.625
12197,12197,긔/Noun,8,5,3,7.780371234856063e-05,5.553210866523024e-05,0.625
12198,12198,카라/Noun,8,3,5,5.5574080248971876e-05,7.774495213132233e-05,0.625
12199,12199,섬기다/Verb,8,5,3,7.780371234856063e-05,5.553210866523024e-05,0.625
12200,12200,다르덴/Noun,8,5,3,7.780371234856063e-05,5.553210866523024e-05,0.625
12201,12201,채식/Noun,8,3,5,5.5574080248971876e-05,7.774495213132233e-05,0.625
12202,12202,톰과제리/Noun,8,5,3,7.780371234856063e-05,5.553210866523024e-05,0.625
12203,12203,느꼇다/Noun,8,5,3,7.780371234856063e-05,5.553210866523024e-05,0.625
12204,12204,단골/Noun,8,3,5,5.5574080248971876e-05,7.774495213132233e-05,0.625
12205,12205,램/Noun,8,3,5,5.5574080248971876e-05,7.774495213132233e-05,0.625
12206,12206,미소녀/Noun,8,5,3,7.780371234856063e-05,5.553210866523024e-05,0.625
12207,12207,란걸/Noun,8,3,5,5.5574080248971876e-05,7.774495213132233e-05,0.625
12208,12208,@@/Punctuation,8,5,3,7.780371234856063e-05,5.553210866523024e-05,0.625
12209,12209,스타덤/Noun,8,3,5,5.5574080248971876e-05,7.774495213132233e-05,0.625
12210,12210,부패하다/Adjective,8,3,5,5.5574080248971876e-05,7.774495213132233e-05,0.625
12211,12211,검열/Noun,8,3,5,5.5574080248971876e-05,7.774495213132233e-05,0.625
12212,12212,공중전/Noun,8,5,3,7.780371234856063e-05,5.553210866523024e-05,0.625
12213,12213,우즈/Noun,8,5,3,7.780371234856063e-05,5.553210866523024e-05,0.625
12214,12214,자로/Noun,8,3,5,5.5574080248971876e-05,7.774495213132233e-05,0.625
12215,12215,마비/Noun,8,5,3,7.780371234856063e-05,5.553210866523024e-05,0.625
12216,12216,우리땅/Noun,8,3,5,5.5574080248971876e-05,7.774495213132233e-05,0.625
12217,12217,손해/Noun,8,3,5,5.5574080248971876e-05,7.774495213132233e-05,0.625
12218,12218,연길/Noun,8,5,3,7.780371234856063e-05,5.553210866523024e-05,0.625
12219,12219,베송/Noun,8,3,5,5.5574080248971876e-05,7.774495213132233e-05,0.625
12220,12220,있슴/Noun,8,3,5,5.5574080248971876e-05,7.774495213132233e-05,0.625
12221,12221,특권/Noun,8,3,5,5.5574080248971876e-05,7.774495213132233e-05,0.625
12222,12222,대위/Noun,8,3,5,5.5574080248971876e-05,7.774495213132233e-05,0.625
12223,12223,미나토/Noun,8,5,3,7.780371234856063e-05,5.553210866523024e-05,0.625
12224,12224,발작/Noun,8,5,3,7.780371234856063e-05,5.553210866523024e-05,0.625
12225,12225,줄타기/Noun,8,3,5,5.5574080248971876e-05,7.774495213132233e-05,0.625
12226,12226,연화/Noun,8,3,5,5.5574080248971876e-05,7.774495213132233e-05,0.625
12227,12227,일어난다/Noun,8,5,3,7.780371234856063e-05,5.553210866523024e-05,0.625
12228,12228,김지훈/Noun,8,5,3,7.780371234856063e-05,5.553210866523024e-05,0.625
12229,12229,첨밀밀/Noun,8,3,5,5.5574080248971876e-05,7.774495213132233e-05,0.625
12230,12230,두드리다/Verb,8,3,5,5.5574080248971876e-05,7.774495213132233e-05,0.625
12231,12231,임달화/Noun,8,5,3,7.780371234856063e-05,5.553210866523024e-05,0.625
12232,12232,분말/Noun,8,3,5,5.5574080248971876e-05,7.774495213132233e-05,0.625
12233,12233,~~~~~~~~~~/Punctuation,8,3,5,5.5574080248971876e-05,7.774495213132233e-05,0.625
12234,12234,짱짱하다/Adjective,8,5,3,7.780371234856063e-05,5.553210866523024e-05,0.625
12235,12235,권력자/Noun,8,5,3,7.780371234856063e-05,5.553210866523024e-05,0.625
12236,12236,아웅/Exclamation,8,3,5,5.5574080248971876e-05,7.774495213132233e-05,0.625
12237,12237,욕정/Noun,8,3,5,5.5574080248971876e-05,7.774495213132233e-05,0.625
12238,12238,시나리오작가/Noun,8,3,5,5.5574080248971876e-05,7.774495213132233e-05,0.625
12239,12239,랭킹/Noun,8,5,3,7.780371234856063e-05,5.553210866523024e-05,0.625
12240,12240,베플/Noun,8,3,5,5.5574080248971876e-05,7.774495213132233e-05,0.625
12241,12241,먹여주다/Verb,8,3,5,5.5574080248971876e-05,7.774495213132233e-05,0.625
12242,12242,삼만리/Noun,8,3,5,5.5574080248971876e-05,7.774495213132233e-05,0.625
12243,12243,..-_-;/Punctuation,8,3,5,5.5574080248971876e-05,7.774495213132233e-05,0.625
12244,12244,말함/Noun,8,3,5,5.5574080248971876e-05,7.774495213132233e-05,0.625
12245,12245,미세/Noun,8,5,3,7.780371234856063e-05,5.553210866523024e-05,0.625
12246,12246,프랑스어/Noun,8,3,5,5.5574080248971876e-05,7.774495213132233e-05,0.625
12247,12247,마인/Noun,8,3,5,5.5574080248971876e-05,7.774495213132233e-05,0.625
12248,12248,::/Punctuation,8,3,5,5.5574080248971876e-05,7.774495213132233e-05,0.625
12249,12249,브룩/Noun,8,5,3,7.780371234856063e-05,5.553210866523024e-05,0.625
12250,12250,ㅜㅜㅠ/KoreanParticle,8,5,3,7.780371234856063e-05,5.553210866523024e-05,0.625
12251,12251,#/Punctuation,8,3,5,5.5574080248971876e-05,7.774495213132233e-05,0.625
12252,12252,일장춘몽/Noun,8,5,3,7.780371234856063e-05,5.553210866523024e-05,0.625
12253,12253,어감/Noun,8,5,3,7.780371234856063e-05,5.553210866523024e-05,0.625
12254,12254,삭/Noun,8,3,5,5.5574080248971876e-05,7.774495213132233e-05,0.625
12255,12255,해고/Noun,8,3,5,5.5574080248971876e-05,7.774495213132233e-05,0.625
12256,12256,빛과/Noun,8,4,4,6.668889629876625e-05,6.663853039827628e-05,0.5
12257,12257,청소/Noun,8,4,4,6.668889629876625e-05,6.663853039827628e-05,0.5
12258,12258,심경/Noun,8,4,4,6.668889629876625e-05,6.663853039827628e-05,0.5
12259,12259,폭풍우/Noun,8,4,4,6.668889629876625e-05,6.663853039827628e-05,0.5
12260,12260,조세호/Noun,8,4,4,6.668889629876625e-05,6.663853039827628e-05,0.5
12261,12261,금기/Noun,8,4,4,6.668889629876625e-05,6.663853039827628e-05,0.5
12262,12262,햇빛/Noun,8,4,4,6.668889629876625e-05,6.663853039827628e-05,0.5
12263,12263,맛집/Noun,8,4,4,6.668889629876625e-05,6.663853039827628e-05,0.5
12264,12264,웰컴/Noun,8,4,4,6.668889629876625e-05,6.663853039827628e-05,0.5
12265,12265,징글징글/Noun,8,4,4,6.668889629876625e-05,6.663853039827628e-05,0.5
12266,12266,초난강/Noun,8,4,4,6.668889629876625e-05,6.663853039827628e-05,0.5
12267,12267,앜/Noun,8,4,4,6.668889629876625e-05,6.663853039827628e-05,0.5
12268,12268,까지와/Josa,8,4,4,6.668889629876625e-05,6.663853039827628e-05,0.5
12269,12269,여울/Noun,8,4,4,6.668889629876625e-05,6.663853039827628e-05,0.5
12270,12270,네버/Noun,8,4,4,6.668889629876625e-05,6.663853039827628e-05,0.5
12271,12271,속성/Noun,8,4,4,6.668889629876625e-05,6.663853039827628e-05,0.5
12272,12272,저력/Noun,8,4,4,6.668889629876625e-05,6.663853039827628e-05,0.5
12273,12273,촛불/Noun,8,4,4,6.668889629876625e-05,6.663853039827628e-05,0.5
12274,12274,동서/Noun,8,4,4,6.668889629876625e-05,6.663853039827628e-05,0.5
12275,12275,어린이날/Noun,8,4,4,6.668889629876625e-05,6.663853039827628e-05,0.5
12276,12276,전신/Noun,8,4,4,6.668889629876625e-05,6.663853039827628e-05,0.5
12277,12277,런타임/Noun,8,4,4,6.668889629876625e-05,6.663853039827628e-05,0.5
12278,12278,뿌/Noun,8,4,4,6.668889629876625e-05,6.663853039827628e-05,0.5
12279,12279,세아/Noun,8,4,4,6.668889629876625e-05,6.663853039827628e-05,0.5
12280,12280,필요성/Noun,8,4,4,6.668889629876625e-05,6.663853039827628e-05,0.5
12281,12281,집앞/Noun,8,4,4,6.668889629876625e-05,6.663853039827628e-05,0.5
12282,12282,드라이버/Noun,8,4,4,6.668889629876625e-05,6.663853039827628e-05,0.5
12283,12283,처형/Noun,8,4,4,6.668889629876625e-05,6.663853039827628e-05,0.5
12284,12284,박성웅/Noun,8,4,4,6.668889629876625e-05,6.663853039827628e-05,0.5
12285,12285,배포/Noun,8,4,4,6.668889629876625e-05,6.663853039827628e-05,0.5
12286,12286,꼭지/Noun,8,4,4,6.668889629876625e-05,6.663853039827628e-05,0.5
12287,12287,해진/Noun,8,4,4,6.668889629876625e-05,6.663853039827628e-05,0.5
12288,12288,못만듬/Noun,8,4,4,6.668889629876625e-05,6.663853039827628e-05,0.5
12289,12289,숙명/Noun,8,4,4,6.668889629876625e-05,6.663853039827628e-05,0.5
12290,12290,전원일기/Noun,8,4,4,6.668889629876625e-05,6.663853039827628e-05,0.5
12291,12291,고상하다/Adjective,8,4,4,6.668889629876625e-05,6.663853039827628e-05,0.5
12292,12292,속마음/Noun,8,4,4,6.668889629876625e-05,6.663853039827628e-05,0.5
12293,12293,뒤에/Foreign,8,4,4,6.668889629876625e-05,6.663853039827628e-05,0.5
12294,12294,스미다/Verb,8,4,4,6.668889629876625e-05,6.663853039827628e-05,0.5
12295,12295,경관/Noun,8,4,4,6.668889629876625e-05,6.663853039827628e-05,0.5
12296,12296,험담/Noun,8,4,4,6.668889629876625e-05,6.663853039827628e-05,0.5
12297,12297,HD/Alpha,8,4,4,6.668889629876625e-05,6.663853039827628e-05,0.5
12298,12298,규어/Noun,8,4,4,6.668889629876625e-05,6.663853039827628e-05,0.5
12299,12299,1~4/Number,8,4,4,6.668889629876625e-05,6.663853039827628e-05,0.5
12300,12300,>>/Punctuation,8,4,4,6.668889629876625e-05,6.663853039827628e-05,0.5
12301,12301,계란/Noun,8,4,4,6.668889629876625e-05,6.663853039827628e-05,0.5
12302,12302,장벽/Noun,8,4,4,6.668889629876625e-05,6.663853039827628e-05,0.5
12303,12303,영화매니아/Noun,8,4,4,6.668889629876625e-05,6.663853039827628e-05,0.5
12304,12304,발산/Noun,8,4,4,6.668889629876625e-05,6.663853039827628e-05,0.5
12305,12305,결점/Noun,8,4,4,6.668889629876625e-05,6.663853039827628e-05,0.5
12306,12306,진격/Noun,8,4,4,6.668889629876625e-05,6.663853039827628e-05,0.5
12307,12307,변호인/Noun,8,4,4,6.668889629876625e-05,6.663853039827628e-05,0.5
12308,12308,어쩜이리/Noun,8,4,4,6.668889629876625e-05,6.663853039827628e-05,0.5
12309,12309,와/Exclamation,8,4,4,6.668889629876625e-05,6.663853039827628e-05,0.5
12310,12310,신문/Noun,8,4,4,6.668889629876625e-05,6.663853039827628e-05,0.5
12311,12311,right/Alpha,8,4,4,6.668889629876625e-05,6.663853039827628e-05,0.5
12312,12312,9회/Number,8,4,4,6.668889629876625e-05,6.663853039827628e-05,0.5
12313,12313,파서/Noun,8,4,4,6.668889629876625e-05,6.663853039827628e-05,0.5
12314,12314,마네/Noun,8,4,4,6.668889629876625e-05,6.663853039827628e-05,0.5
12315,12315,투철/Noun,8,4,4,6.668889629876625e-05,6.663853039827628e-05,0.5
12316,12316,이상하/Noun,8,4,4,6.668889629876625e-05,6.663853039827628e-05,0.5
12317,12317,발현/Noun,8,4,4,6.668889629876625e-05,6.663853039827628e-05,0.5
12318,12318,제약/Noun,8,4,4,6.668889629876625e-05,6.663853039827628e-05,0.5
12319,12319,길어지다/Verb,8,4,4,6.668889629876625e-05,6.663853039827628e-05,0.5
12320,12320,판권/Noun,8,4,4,6.668889629876625e-05,6.663853039827628e-05,0.5
12321,12321,하리수/Noun,8,4,4,6.668889629876625e-05,6.663853039827628e-05,0.5
12322,12322,칼라/Noun,8,4,4,6.668889629876625e-05,6.663853039827628e-05,0.5
12323,12323,러시안/Noun,8,4,4,6.668889629876625e-05,6.663853039827628e-05,0.5
12324,12324,겨누/Noun,8,4,4,6.668889629876625e-05,6.663853039827628e-05,0.5
12325,12325,기일/Noun,8,4,4,6.668889629876625e-05,6.663853039827628e-05,0.5
12326,12326,금영/Noun,8,4,4,6.668889629876625e-05,6.663853039827628e-05,0.5
12327,12327,프렌치/Noun,8,4,4,6.668889629876625e-05,6.663853039827628e-05,0.5
12328,12328,썰다/Verb,8,4,4,6.668889629876625e-05,6.663853039827628e-05,0.5
12329,12329,여겨지다/Verb,8,4,4,6.668889629876625e-05,6.663853039827628e-05,0.5
12330,12330,made/Alpha,8,4,4,6.668889629876625e-05,6.663853039827628e-05,0.5
12331,12331,레베카/Noun,8,4,4,6.668889629876625e-05,6.663853039827628e-05,0.5
12332,12332,벤스틸러/Noun,8,4,4,6.668889629876625e-05,6.663853039827628e-05,0.5
12333,12333,옵티머스/Noun,8,4,4,6.668889629876625e-05,6.663853039827628e-05,0.5
12334,12334,복도/Noun,8,4,4,6.668889629876625e-05,6.663853039827628e-05,0.5
12335,12335,요즈음/Noun,8,4,4,6.668889629876625e-05,6.663853039827628e-05,0.5
12336,12336,바치/Noun,8,4,4,6.668889629876625e-05,6.663853039827628e-05,0.5
12337,12337,천공/Noun,8,4,4,6.668889629876625e-05,6.663853039827628e-05,0.5
12338,12338,냉장고/Noun,8,4,4,6.668889629876625e-05,6.663853039827628e-05,0.5
12339,12339,클레어/Noun,8,4,4,6.668889629876625e-05,6.663853039827628e-05,0.5
12340,12340,비인간/Noun,8,4,4,6.668889629876625e-05,6.663853039827628e-05,0.5
12341,12341,슈퍼카/Noun,8,4,4,6.668889629876625e-05,6.663853039827628e-05,0.5
12342,12342,배경인/Noun,8,4,4,6.668889629876625e-05,6.663853039827628e-05,0.5
12343,12343,욜/Noun,8,4,4,6.668889629876625e-05,6.663853039827628e-05,0.5
12344,12344,아슬아슬하다/Adjective,8,4,4,6.668889629876625e-05,6.663853039827628e-05,0.5
12345,12345,전현무/Noun,8,4,4,6.668889629876625e-05,6.663853039827628e-05,0.5
12346,12346,감상문/Noun,8,4,4,6.668889629876625e-05,6.663853039827628e-05,0.5
12347,12347,추노/Noun,8,4,4,6.668889629876625e-05,6.663853039827628e-05,0.5
12348,12348,계산/Noun,8,4,4,6.668889629876625e-05,6.663853039827628e-05,0.5
12349,12349,part/Alpha,8,4,4,6.668889629876625e-05,6.663853039827628e-05,0.5
12350,12350,트리플/Noun,8,4,4,6.668889629876625e-05,6.663853039827628e-05,0.5
12351,12351,스파게티/Noun,8,4,4,6.668889629876625e-05,6.663853039827628e-05,0.5
12352,12352,패자/Noun,8,4,4,6.668889629876625e-05,6.663853039827628e-05,0.5
12353,12353,헛되/Noun,8,4,4,6.668889629876625e-05,6.663853039827628e-05,0.5
12354,12354,레지던트이블/Noun,8,4,4,6.668889629876625e-05,6.663853039827628e-05,0.5
12355,12355,무교/Noun,8,4,4,6.668889629876625e-05,6.663853039827628e-05,0.5
12356,12356,매도/Noun,8,4,4,6.668889629876625e-05,6.663853039827628e-05,0.5
12357,12357,유인나/Noun,8,4,4,6.668889629876625e-05,6.663853039827628e-05,0.5
12358,12358,거보/Noun,8,4,4,6.668889629876625e-05,6.663853039827628e-05,0.5
12359,12359,펠레/Noun,8,4,4,6.668889629876625e-05,6.663853039827628e-05,0.5
12360,12360,루저/Noun,8,4,4,6.668889629876625e-05,6.663853039827628e-05,0.5
12361,12361,백치/Noun,8,4,4,6.668889629876625e-05,6.663853039827628e-05,0.5
12362,12362,20회/Number,8,4,4,6.668889629876625e-05,6.663853039827628e-05,0.5
12363,12363,관계없이/Adverb,8,4,4,6.668889629876625e-05,6.663853039827628e-05,0.5
12364,12364,초래/Noun,8,4,4,6.668889629876625e-05,6.663853039827628e-05,0.5
12365,12365,시월애/Noun,8,4,4,6.668889629876625e-05,6.663853039827628e-05,0.5
12366,12366,술술/Noun,8,4,4,6.668889629876625e-05,6.663853039827628e-05,0.5
12367,12367,단언/Noun,8,4,4,6.668889629876625e-05,6.663853039827628e-05,0.5
12368,12368,먹어주다/Verb,8,4,4,6.668889629876625e-05,6.663853039827628e-05,0.5
12369,12369,iptv/Alpha,8,4,4,6.668889629876625e-05,6.663853039827628e-05,0.5
12370,12370,퇴마/Noun,8,4,4,6.668889629876625e-05,6.663853039827628e-05,0.5
12371,12371,구인/Noun,8,4,4,6.668889629876625e-05,6.663853039827628e-05,0.5
12372,12372,리조/Noun,8,4,4,6.668889629876625e-05,6.663853039827628e-05,0.5
12373,12373,전함/Noun,8,4,4,6.668889629876625e-05,6.663853039827628e-05,0.5
12374,12374,요것/Noun,8,4,4,6.668889629876625e-05,6.663853039827628e-05,0.5
12375,12375,로케이션/Noun,8,4,4,6.668889629876625e-05,6.663853039827628e-05,0.5
12376,12376,아마겟돈/Noun,8,4,4,6.668889629876625e-05,6.663853039827628e-05,0.5
12377,12377,레이크/Noun,8,4,4,6.668889629876625e-05,6.663853039827628e-05,0.5
12378,12378,어머님/Noun,8,4,4,6.668889629876625e-05,6.663853039827628e-05,0.5
12379,12379,최첨단/Noun,8,4,4,6.668889629876625e-05,6.663853039827628e-05,0.5
12380,12380,선지/Noun,8,4,4,6.668889629876625e-05,6.663853039827628e-05,0.5
12381,12381,트루먼/Noun,8,4,4,6.668889629876625e-05,6.663853039827628e-05,0.5
12382,12382,트릴로지/Noun,8,4,4,6.668889629876625e-05,6.663853039827628e-05,0.5
12383,12383,양화/Noun,8,4,4,6.668889629876625e-05,6.663853039827628e-05,0.5
12384,12384,뉘우치다/Verb,8,4,4,6.668889629876625e-05,6.663853039827628e-05,0.5
12385,12385,타국/Noun,8,4,4,6.668889629876625e-05,6.663853039827628e-05,0.5
12386,12386,썬더/Noun,8,4,4,6.668889629876625e-05,6.663853039827628e-05,0.5
12387,12387,실행/Noun,8,4,4,6.668889629876625e-05,6.663853039827628e-05,0.5
12388,12388,수동/Noun,8,4,4,6.668889629876625e-05,6.663853039827628e-05,0.5
12389,12389,ㅋㅋㄱ/KoreanParticle,8,4,4,6.668889629876625e-05,6.663853039827628e-05,0.5
12390,12390,코코/Noun,8,4,4,6.668889629876625e-05,6.663853039827628e-05,0.5
12391,12391,자부심/Noun,8,4,4,6.668889629876625e-05,6.663853039827628e-05,0.5
12392,12392,하와이/Noun,8,4,4,6.668889629876625e-05,6.663853039827628e-05,0.5
12393,12393,멘토/Noun,8,4,4,6.668889629876625e-05,6.663853039827628e-05,0.5
12394,12394,환타/Noun,8,4,4,6.668889629876625e-05,6.663853039827628e-05,0.5
12395,12395,왈가/Noun,8,4,4,6.668889629876625e-05,6.663853039827628e-05,0.5
12396,12396,알기/Noun,8,4,4,6.668889629876625e-05,6.663853039827628e-05,0.5
12397,12397,밥상/Noun,8,4,4,6.668889629876625e-05,6.663853039827628e-05,0.5
12398,12398,시저/Noun,8,4,4,6.668889629876625e-05,6.663853039827628e-05,0.5
12399,12399,데이즈/Noun,8,4,4,6.668889629876625e-05,6.663853039827628e-05,0.5
12400,12400,누명/Noun,8,4,4,6.668889629876625e-05,6.663853039827628e-05,0.5
12401,12401,태생/Noun,8,4,4,6.668889629876625e-05,6.663853039827628e-05,0.5
12402,12402,길예르모/Noun,8,4,4,6.668889629876625e-05,6.663853039827628e-05,0.5
12403,12403,테레사/Noun,8,4,4,6.668889629876625e-05,6.663853039827628e-05,0.5
12404,12404,글귀/Noun,8,4,4,6.668889629876625e-05,6.663853039827628e-05,0.5
12405,12405,라즈베리/Noun,7,0,7,2.2229632099588756e-05,9.995779559741441e-05,1.0
12406,12406,갑지/Noun,7,0,7,2.2229632099588756e-05,9.995779559741441e-05,1.0
12407,12407,설익다/Verb,7,0,7,2.2229632099588756e-05,9.995779559741441e-05,1.0
12408,12408,선리기연/Noun,7,7,0,0.0001000333444481494,2.2212843466092093e-05,1.0
12409,12409,1500원/Number,7,0,7,2.2229632099588756e-05,9.995779559741441e-05,1.0
12410,12410,연아/Noun,7,7,0,0.0001000333444481494,2.2212843466092093e-05,1.0
12411,12411,음주운전/Noun,7,0,7,2.2229632099588756e-05,9.995779559741441e-05,1.0
12412,12412,용쟁호투/Noun,7,7,0,0.0001000333444481494,2.2212843466092093e-05,1.0
12413,12413,애덜/Noun,7,0,7,2.2229632099588756e-05,9.995779559741441e-05,1.0
12414,12414,주접/Noun,7,0,7,2.2229632099588756e-05,9.995779559741441e-05,1.0
12415,12415,심영/Noun,7,7,0,0.0001000333444481494,2.2212843466092093e-05,1.0
12416,12416,고은정/Noun,7,0,7,2.2229632099588756e-05,9.995779559741441e-05,1.0
12417,12417,범수/Noun,7,7,0,0.0001000333444481494,2.2212843466092093e-05,1.0
12418,12418,패트레이버/Noun,7,0,7,2.2229632099588756e-05,9.995779559741441e-05,1.0
12419,12419,진실성/Noun,7,7,0,0.0001000333444481494,2.2212843466092093e-05,1.0
12420,12420,관객모독/Noun,7,0,7,2.2229632099588756e-05,9.995779559741441e-05,1.0
12421,12421,책임자/Noun,7,0,7,2.2229632099588756e-05,9.995779559741441e-05,1.0
12422,12422,인기투표/Noun,7,0,7,2.2229632099588756e-05,9.995779559741441e-05,1.0
12423,12423,격동/Noun,7,7,0,0.0001000333444481494,2.2212843466092093e-05,1.0
12424,12424,스킨스/Noun,7,7,0,0.0001000333444481494,2.2212843466092093e-05,1.0
12425,12425,무늬/Noun,7,0,7,2.2229632099588756e-05,9.995779559741441e-05,1.0
12426,12426,제야/Noun,7,7,0,0.0001000333444481494,2.2212843466092093e-05,1.0
12427,12427,낚였네/Noun,7,0,7,2.2229632099588756e-05,9.995779559741441e-05,1.0
12428,12428,난또/Noun,7,0,7,2.2229632099588756e-05,9.995779559741441e-05,1.0
12429,12429,쫄깃쫄깃/Noun,7,7,0,0.0001000333444481494,2.2212843466092093e-05,1.0
12430,12430,난데없이/Adverb,7,0,7,2.2229632099588756e-05,9.995779559741441e-05,1.0
12431,12431,진범/Noun,7,0,7,2.2229632099588756e-05,9.995779559741441e-05,1.0
12432,12432,해군기지/Noun,7,0,7,2.2229632099588756e-05,9.995779559741441e-05,1.0
12433,12433,국정원/Noun,7,0,7,2.2229632099588756e-05,9.995779559741441e-05,1.0
12434,12434,집요하다/Adjective,7,7,0,0.0001000333444481494,2.2212843466092093e-05,1.0
12435,12435,날라리/Noun,7,0,7,2.2229632099588756e-05,9.995779559741441e-05,1.0
12436,12436,맹탕/Noun,7,0,7,2.2229632099588756e-05,9.995779559741441e-05,1.0
12437,12437,개똥이/Noun,7,0,7,2.2229632099588756e-05,9.995779559741441e-05,1.0
12438,12438,갈이/Noun,7,0,7,2.2229632099588756e-05,9.995779559741441e-05,1.0
12439,12439,은수/Noun,7,7,0,0.0001000333444481494,2.2212843466092093e-05,1.0
12440,12440,울엇어/Noun,7,7,0,0.0001000333444481494,2.2212843466092093e-05,1.0
12441,12441,넌센스/Noun,7,0,7,2.2229632099588756e-05,9.995779559741441e-05,1.0
12442,12442,입덕/Noun,7,7,0,0.0001000333444481494,2.2212843466092093e-05,1.0
12443,12443,회색/Noun,7,7,0,0.0001000333444481494,2.2212843466092093e-05,1.0
12444,12444,농구공/Noun,7,0,7,2.2229632099588756e-05,9.995779559741441e-05,1.0
12445,12445,싸이다/Verb,7,0,7,2.2229632099588756e-05,9.995779559741441e-05,1.0
12446,12446,판명/Noun,7,0,7,2.2229632099588756e-05,9.995779559741441e-05,1.0
12447,12447,았음/Noun,7,0,7,2.2229632099588756e-05,9.995779559741441e-05,1.0
12448,12448,200%/Number,7,7,0,0.0001000333444481494,2.2212843466092093e-05,1.0
12449,12449,썩소/Noun,7,0,7,2.2229632099588756e-05,9.995779559741441e-05,1.0
12450,12450,고지라/Noun,7,0,7,2.2229632099588756e-05,9.995779559741441e-05,1.0
12451,12451,촉촉하다/Adjective,7,7,0,0.0001000333444481494,2.2212843466092093e-05,1.0
12452,12452,모던/Noun,7,7,0,0.0001000333444481494,2.2212843466092093e-05,1.0
12453,12453,콩콩콩/Noun,7,0,7,2.2229632099588756e-05,9.995779559741441e-05,1.0
12454,12454,뭣같/Noun,7,0,7,2.2229632099588756e-05,9.995779559741441e-05,1.0
12455,12455,반짝이다/Verb,7,7,0,0.0001000333444481494,2.2212843466092093e-05,1.0
12456,12456,당나라/Noun,7,0,7,2.2229632099588756e-05,9.995779559741441e-05,1.0
12457,12457,거세/Noun,7,0,7,2.2229632099588756e-05,9.995779559741441e-05,1.0
12458,12458,10000원/Number,7,0,7,2.2229632099588756e-05,9.995779559741441e-05,1.0
12459,12459,고객/Noun,7,0,7,2.2229632099588756e-05,9.995779559741441e-05,1.0
12460,12460,생존자/Noun,7,0,7,2.2229632099588756e-05,9.995779559741441e-05,1.0
12461,12461,하앍/Noun,7,7,0,0.0001000333444481494,2.2212843466092093e-05,1.0
12462,12462,감염/Noun,7,0,7,2.2229632099588756e-05,9.995779559741441e-05,1.0
12463,12463,광활하다/Adjective,7,7,0,0.0001000333444481494,2.2212843466092093e-05,1.0
12464,12464,will/Alpha,7,7,0,0.0001000333444481494,2.2212843466092093e-05,1.0
12465,12465,블랙리스트/Noun,7,0,7,2.2229632099588756e-05,9.995779559741441e-05,1.0
12466,12466,시름/Noun,7,0,7,2.2229632099588756e-05,9.995779559741441e-05,1.0
12467,12467,서교/Noun,7,7,0,0.0001000333444481494,2.2212843466092093e-05,1.0
12468,12468,차분해지다/Verb,7,7,0,0.0001000333444481494,2.2212843466092093e-05,1.0
12469,12469,*_*/Punctuation,7,7,0,0.0001000333444481494,2.2212843466092093e-05,1.0
12470,12470,독선/Noun,7,0,7,2.2229632099588756e-05,9.995779559741441e-05,1.0
12471,12471,정기용/Noun,7,7,0,0.0001000333444481494,2.2212843466092093e-05,1.0
12472,12472,엽기적인그녀/Noun,7,0,7,2.2229632099588756e-05,9.995779559741441e-05,1.0
12473,12473,심쿵하다/Adjective,7,7,0,0.0001000333444481494,2.2212843466092093e-05,1.0
12474,12474,김영호/Noun,7,0,7,2.2229632099588756e-05,9.995779559741441e-05,1.0
12475,12475,아까버/Noun,7,0,7,2.2229632099588756e-05,9.995779559741441e-05,1.0
12476,12476,까다롭다/Adjective,7,7,0,0.0001000333444481494,2.2212843466092093e-05,1.0
12477,12477,정조/Noun,7,7,0,0.0001000333444481494,2.2212843466092093e-05,1.0
12478,12478,문학작품/Noun,7,7,0,0.0001000333444481494,2.2212843466092093e-05,1.0
12479,12479,우웨볼/Noun,7,0,7,2.2229632099588756e-05,9.995779559741441e-05,1.0
12480,12480,맘에안듬/Noun,7,0,7,2.2229632099588756e-05,9.995779559741441e-05,1.0
12481,12481,폐기물/Noun,7,0,7,2.2229632099588756e-05,9.995779559741441e-05,1.0
12482,12482,돈벌/Noun,7,0,7,2.2229632099588756e-05,9.995779559741441e-05,1.0
12483,12483,SNS/Alpha,7,7,0,0.0001000333444481494,2.2212843466092093e-05,1.0
12484,12484,뇌구조/Noun,7,0,7,2.2229632099588756e-05,9.995779559741441e-05,1.0
12485,12485,캐빈/Noun,7,7,0,0.0001000333444481494,2.2212843466092093e-05,1.0
12486,12486,4-5/Number,7,0,7,2.2229632099588756e-05,9.995779559741441e-05,1.0
12487,12487,마삼/Noun,7,0,7,2.2229632099588756e-05,9.995779559741441e-05,1.0
12488,12488,실없다/Adjective,7,0,7,2.2229632099588756e-05,9.995779559741441e-05,1.0
12489,12489,증폭/Noun,7,0,7,2.2229632099588756e-05,9.995779559741441e-05,1.0
12490,12490,서브/Noun,7,0,7,2.2229632099588756e-05,9.995779559741441e-05,1.0
12491,12491,삥/Noun,7,0,7,2.2229632099588756e-05,9.995779559741441e-05,1.0
12492,12492,-_-..../Punctuation,7,0,7,2.2229632099588756e-05,9.995779559741441e-05,1.0
12493,12493,희귀/Noun,7,0,7,2.2229632099588756e-05,9.995779559741441e-05,1.0
12494,12494,신격화/Noun,7,0,7,2.2229632099588756e-05,9.995779559741441e-05,1.0
12495,12495,담그다/Verb,7,0,7,2.2229632099588756e-05,9.995779559741441e-05,1.0
12496,12496,껏음/Noun,7,0,7,2.2229632099588756e-05,9.995779559741441e-05,1.0
12497,12497,절차/Noun,7,0,7,2.2229632099588756e-05,9.995779559741441e-05,1.0
12498,12498,어우르다/Verb,7,7,0,0.0001000333444481494,2.2212843466092093e-05,1.0
12499,12499,재미나다/Noun,7,7,0,0.0001000333444481494,2.2212843466092093e-05,1.0
12500,12500,욕함/Noun,7,0,7,2.2229632099588756e-05,9.995779559741441e-05,1.0
12501,12501,세이모어/Noun,7,7,0,0.0001000333444481494,2.2212843466092093e-05,1.0
12502,12502,스프/Noun,7,0,7,2.2229632099588756e-05,9.995779559741441e-05,1.0
12503,12503,화난/Noun,7,0,7,2.2229632099588756e-05,9.995779559741441e-05,1.0
12504,12504,내고/Foreign,7,0,7,2.2229632099588756e-05,9.995779559741441e-05,1.0
12505,12505,한지훈/Noun,7,0,7,2.2229632099588756e-05,9.995779559741441e-05,1.0
12506,12506,2/3/Number,7,0,7,2.2229632099588756e-05,9.995779559741441e-05,1.0
12507,12507,나날이/Noun,7,7,0,0.0001000333444481494,2.2212843466092093e-05,1.0
12508,12508,Two/Alpha,7,7,0,0.0001000333444481494,2.2212843466092093e-05,1.0
12509,12509,만주/Noun,7,0,7,2.2229632099588756e-05,9.995779559741441e-05,1.0
12510,12510,!~~/Punctuation,7,7,0,0.0001000333444481494,2.2212843466092093e-05,1.0
12511,12511,으이구/Exclamation,7,0,7,2.2229632099588756e-05,9.995779559741441e-05,1.0
12512,12512,서운하다/Adjective,7,7,0,0.0001000333444481494,2.2212843466092093e-05,1.0
12513,12513,개별/Noun,7,0,7,2.2229632099588756e-05,9.995779559741441e-05,1.0
12514,12514,글쎼/Noun,7,1,6,3.334444814938313e-05,8.885137386436837e-05,0.8571428571428571
12515,12515,강심장/Noun,7,6,1,8.891852839835501e-05,3.331926519913814e-05,0.8571428571428571
12516,12516,지난날/Noun,7,6,1,8.891852839835501e-05,3.331926519913814e-05,0.8571428571428571
12517,12517,되돌아가다/Verb,7,6,1,8.891852839835501e-05,3.331926519913814e-05,0.8571428571428571
12518,12518,걸그룹/Noun,7,1,6,3.334444814938313e-05,8.885137386436837e-05,0.8571428571428571
12519,12519,흰색/Noun,7,6,1,8.891852839835501e-05,3.331926519913814e-05,0.8571428571428571
12520,12520,'!/Punctuation,7,6,1,8.891852839835501e-05,3.331926519913814e-05,0.8571428571428571
12521,12521,노리개/Noun,7,1,6,3.334444814938313e-05,8.885137386436837e-05,0.8571428571428571
12522,12522,참극/Noun,7,1,6,3.334444814938313e-05,8.885137386436837e-05,0.8571428571428571
12523,12523,대기/Noun,7,1,6,3.334444814938313e-05,8.885137386436837e-05,0.8571428571428571
12524,12524,just/Alpha,7,6,1,8.891852839835501e-05,3.331926519913814e-05,0.8571428571428571
12525,12525,리허설/Noun,7,1,6,3.334444814938313e-05,8.885137386436837e-05,0.8571428571428571
12526,12526,맵다/Adjective,7,1,6,3.334444814938313e-05,8.885137386436837e-05,0.8571428571428571
12527,12527,시네마천국/Noun,7,6,1,8.891852839835501e-05,3.331926519913814e-05,0.8571428571428571
12528,12528,영양가/Noun,7,1,6,3.334444814938313e-05,8.885137386436837e-05,0.8571428571428571
12529,12529,몰카/Noun,7,1,6,3.334444814938313e-05,8.885137386436837e-05,0.8571428571428571
12530,12530,까닭/Noun,7,1,6,3.334444814938313e-05,8.885137386436837e-05,0.8571428571428571
12531,12531,이응경/Noun,7,1,6,3.334444814938313e-05,8.885137386436837e-05,0.8571428571428571
12532,12532,조소/Noun,7,6,1,8.891852839835501e-05,3.331926519913814e-05,0.8571428571428571
12533,12533,우먼/Noun,7,6,1,8.891852839835501e-05,3.331926519913814e-05,0.8571428571428571
12534,12534,떔/Noun,7,6,1,8.891852839835501e-05,3.331926519913814e-05,0.8571428571428571
12535,12535,For/Alpha,7,6,1,8.891852839835501e-05,3.331926519913814e-05,0.8571428571428571
12536,12536,릿카/Noun,7,6,1,8.891852839835501e-05,3.331926519913814e-05,0.8571428571428571
12537,12537,신사참배/Noun,7,1,6,3.334444814938313e-05,8.885137386436837e-05,0.8571428571428571
12538,12538,낮잠/Noun,7,1,6,3.334444814938313e-05,8.885137386436837e-05,0.8571428571428571
12539,12539,재탄생/Noun,7,6,1,8.891852839835501e-05,3.331926519913814e-05,0.8571428571428571
12540,12540,건축학개론/Noun,7,6,1,8.891852839835501e-05,3.331926519913814e-05,0.8571428571428571
12541,12541,칼날/Noun,7,1,6,3.334444814938313e-05,8.885137386436837e-05,0.8571428571428571
12542,12542,애마부인/Noun,7,1,6,3.334444814938313e-05,8.885137386436837e-05,0.8571428571428571
12543,12543,테리/Noun,7,6,1,8.891852839835501e-05,3.331926519913814e-05,0.8571428571428571
12544,12544,이산가족/Noun,7,6,1,8.891852839835501e-05,3.331926519913814e-05,0.8571428571428571
12545,12545,진절머리/Noun,7,1,6,3.334444814938313e-05,8.885137386436837e-05,0.8571428571428571
12546,12546,족보/Noun,7,1,6,3.334444814938313e-05,8.885137386436837e-05,0.8571428571428571
12547,12547,와장창/Adverb,7,1,6,3.334444814938313e-05,8.885137386436837e-05,0.8571428571428571
12548,12548,승려/Noun,7,1,6,3.334444814938313e-05,8.885137386436837e-05,0.8571428571428571
12549,12549,이함/Noun,7,6,1,8.891852839835501e-05,3.331926519913814e-05,0.8571428571428571
12550,12550,힐튼/Noun,7,1,6,3.334444814938313e-05,8.885137386436837e-05,0.8571428571428571
12551,12551,알란/Noun,7,6,1,8.891852839835501e-05,3.331926519913814e-05,0.8571428571428571
12552,12552,구질구질하다/Adjective,7,1,6,3.334444814938313e-05,8.885137386436837e-05,0.8571428571428571
12553,12553,잠기/Noun,7,6,1,8.891852839835501e-05,3.331926519913814e-05,0.8571428571428571
12554,12554,화양연화/Noun,7,6,1,8.891852839835501e-05,3.331926519913814e-05,0.8571428571428571
12555,12555,현자/Noun,7,1,6,3.334444814938313e-05,8.885137386436837e-05,0.8571428571428571
12556,12556,몽상가/Noun,7,6,1,8.891852839835501e-05,3.331926519913814e-05,0.8571428571428571
12557,12557,시크릿가든/Noun,7,6,1,8.891852839835501e-05,3.331926519913814e-05,0.8571428571428571
12558,12558,샴/Noun,7,1,6,3.334444814938313e-05,8.885137386436837e-05,0.8571428571428571
12559,12559,도수코/Noun,7,1,6,3.334444814938313e-05,8.885137386436837e-05,0.8571428571428571
12560,12560,버지니아/Noun,7,6,1,8.891852839835501e-05,3.331926519913814e-05,0.8571428571428571
12561,12561,게더/Noun,7,6,1,8.891852839835501e-05,3.331926519913814e-05,0.8571428571428571
12562,12562,운남/Noun,7,6,1,8.891852839835501e-05,3.331926519913814e-05,0.8571428571428571
12563,12563,멘탈붕괴/Noun,7,1,6,3.334444814938313e-05,8.885137386436837e-05,0.8571428571428571
12564,12564,승기/Noun,7,6,1,8.891852839835501e-05,3.331926519913814e-05,0.8571428571428571
12565,12565,전염/Noun,7,1,6,3.334444814938313e-05,8.885137386436837e-05,0.8571428571428571
12566,12566,쩌는듯/Noun,7,6,1,8.891852839835501e-05,3.331926519913814e-05,0.8571428571428571
12567,12567,붓다/Noun,7,1,6,3.334444814938313e-05,8.885137386436837e-05,0.8571428571428571
12568,12568,이목/Noun,7,1,6,3.334444814938313e-05,8.885137386436837e-05,0.8571428571428571
12569,12569,호날두/Noun,7,1,6,3.334444814938313e-05,8.885137386436837e-05,0.8571428571428571
12570,12570,부릅뜨다/Verb,7,1,6,3.334444814938313e-05,8.885137386436837e-05,0.8571428571428571
12571,12571,?????????/Punctuation,7,1,6,3.334444814938313e-05,8.885137386436837e-05,0.8571428571428571
12572,12572,묵시/Noun,7,6,1,8.891852839835501e-05,3.331926519913814e-05,0.8571428571428571
12573,12573,알아차리다/Verb,7,1,6,3.334444814938313e-05,8.885137386436837e-05,0.8571428571428571
12574,12574,혐한/Noun,7,1,6,3.334444814938313e-05,8.885137386436837e-05,0.8571428571428571
12575,12575,신혜/Noun,7,6,1,8.891852839835501e-05,3.331926519913814e-05,0.8571428571428571
12576,12576,유라/Noun,7,1,6,3.334444814938313e-05,8.885137386436837e-05,0.8571428571428571
12577,12577,휩싸이다/Verb,7,6,1,8.891852839835501e-05,3.331926519913814e-05,0.8571428571428571
12578,12578,박근형/Noun,7,6,1,8.891852839835501e-05,3.331926519913814e-05,0.8571428571428571
12579,12579,김준/Noun,7,6,1,8.891852839835501e-05,3.331926519913814e-05,0.8571428571428571
12580,12580,25분/Number,7,1,6,3.334444814938313e-05,8.885137386436837e-05,0.8571428571428571
12581,12581,찬찬하다/Adjective,7,6,1,8.891852839835501e-05,3.331926519913814e-05,0.8571428571428571
12582,12582,핑크/Noun,7,6,1,8.891852839835501e-05,3.331926519913814e-05,0.8571428571428571
12583,12583,ㄱㅐ/KoreanParticle,7,1,6,3.334444814938313e-05,8.885137386436837e-05,0.8571428571428571
12584,12584,비글/Noun,7,6,1,8.891852839835501e-05,3.331926519913814e-05,0.8571428571428571
12585,12585,으/Noun,7,1,6,3.334444814938313e-05,8.885137386436837e-05,0.8571428571428571
12586,12586,공인/Noun,7,1,6,3.334444814938313e-05,8.885137386436837e-05,0.8571428571428571
12587,12587,인력/Noun,7,1,6,3.334444814938313e-05,8.885137386436837e-05,0.8571428571428571
12588,12588,시설/Noun,7,1,6,3.334444814938313e-05,8.885137386436837e-05,0.8571428571428571
12589,12589,맹세/Noun,7,1,6,3.334444814938313e-05,8.885137386436837e-05,0.8571428571428571
12590,12590,밤새/Noun,7,6,1,8.891852839835501e-05,3.331926519913814e-05,0.8571428571428571
12591,12591,가업/Noun,7,1,6,3.334444814938313e-05,8.885137386436837e-05,0.8571428571428571
12592,12592,정장/Noun,7,6,1,8.891852839835501e-05,3.331926519913814e-05,0.8571428571428571
12593,12593,강호/Noun,7,6,1,8.891852839835501e-05,3.331926519913814e-05,0.8571428571428571
12594,12594,NC/Alpha,7,1,6,3.334444814938313e-05,8.885137386436837e-05,0.8571428571428571
12595,12595,빗/Noun,7,6,1,8.891852839835501e-05,3.331926519913814e-05,0.8571428571428571
12596,12596,주무/Noun,7,1,6,3.334444814938313e-05,8.885137386436837e-05,0.8571428571428571
12597,12597,주도하다/Adjective,7,6,1,8.891852839835501e-05,3.331926519913814e-05,0.8571428571428571
12598,12598,츄/Noun,7,1,6,3.334444814938313e-05,8.885137386436837e-05,0.8571428571428571
12599,12599,안드/Noun,7,1,6,3.334444814938313e-05,8.885137386436837e-05,0.8571428571428571
12600,12600,변형/Noun,7,1,6,3.334444814938313e-05,8.885137386436837e-05,0.8571428571428571
12601,12601,지장/Noun,7,1,6,3.334444814938313e-05,8.885137386436837e-05,0.8571428571428571
12602,12602,인생관/Noun,7,6,1,8.891852839835501e-05,3.331926519913814e-05,0.8571428571428571
12603,12603,꺼이꺼이/Adverb,7,6,1,8.891852839835501e-05,3.331926519913814e-05,0.8571428571428571
12604,12604,메타포/Noun,7,6,1,8.891852839835501e-05,3.331926519913814e-05,0.8571428571428571
12605,12605,^^./Punctuation,7,6,1,8.891852839835501e-05,3.331926519913814e-05,0.8571428571428571
12606,12606,크리처/Noun,7,1,6,3.334444814938313e-05,8.885137386436837e-05,0.8571428571428571
12607,12607,헨젤/Noun,7,1,6,3.334444814938313e-05,8.885137386436837e-05,0.8571428571428571
12608,12608,지지다/Verb,7,1,6,3.334444814938313e-05,8.885137386436837e-05,0.8571428571428571
12609,12609,패션쇼/Noun,7,1,6,3.334444814938313e-05,8.885137386436837e-05,0.8571428571428571
12610,12610,클린/Noun,7,6,1,8.891852839835501e-05,3.331926519913814e-05,0.8571428571428571
12611,12611,기고/Noun,7,1,6,3.334444814938313e-05,8.885137386436837e-05,0.8571428571428571
12612,12612,근사하다/Adjective,7,6,1,8.891852839835501e-05,3.331926519913814e-05,0.8571428571428571
12613,12613,힘쓰다/Verb,7,6,1,8.891852839835501e-05,3.331926519913814e-05,0.8571428571428571
12614,12614,벨트/Noun,7,1,6,3.334444814938313e-05,8.885137386436837e-05,0.8571428571428571
12615,12615,따분/Noun,7,1,6,3.334444814938313e-05,8.885137386436837e-05,0.8571428571428571
12616,12616,순환/Noun,7,6,1,8.891852839835501e-05,3.331926519913814e-05,0.8571428571428571
12617,12617,소스코드/Noun,7,1,6,3.334444814938313e-05,8.885137386436837e-05,0.8571428571428571
12618,12618,탁월/Noun,7,6,1,8.891852839835501e-05,3.331926519913814e-05,0.8571428571428571
12619,12619,오드리햅번/Noun,7,6,1,8.891852839835501e-05,3.331926519913814e-05,0.8571428571428571
12620,12620,음악가/Noun,7,6,1,8.891852839835501e-05,3.331926519913814e-05,0.8571428571428571
12621,12621,현영/Noun,7,1,6,3.334444814938313e-05,8.885137386436837e-05,0.8571428571428571
12622,12622,야박하다/Adjective,7,6,1,8.891852839835501e-05,3.331926519913814e-05,0.8571428571428571
12623,12623,더볼/Noun,7,6,1,8.891852839835501e-05,3.331926519913814e-05,0.8571428571428571
12624,12624,가족사/Noun,7,6,1,8.891852839835501e-05,3.331926519913814e-05,0.8571428571428571
12625,12625,터닝/Noun,7,6,1,8.891852839835501e-05,3.331926519913814e-05,0.8571428571428571
12626,12626,소령/Noun,7,6,1,8.891852839835501e-05,3.331926519913814e-05,0.8571428571428571
12627,12627,God/Alpha,7,6,1,8.891852839835501e-05,3.331926519913814e-05,0.8571428571428571
12628,12628,감자/Noun,7,6,1,8.891852839835501e-05,3.331926519913814e-05,0.8571428571428571
12629,12629,조루/Noun,7,1,6,3.334444814938313e-05,8.885137386436837e-05,0.8571428571428571
12630,12630,송해성/Noun,7,1,6,3.334444814938313e-05,8.885137386436837e-05,0.8571428571428571
12631,12631,어는/Modifier,7,1,6,3.334444814938313e-05,8.885137386436837e-05,0.8571428571428571
12632,12632,퇴장/Noun,7,1,6,3.334444814938313e-05,8.885137386436837e-05,0.8571428571428571
12633,12633,브랜든리/Noun,7,1,6,3.334444814938313e-05,8.885137386436837e-05,0.8571428571428571
12634,12634,으음/Exclamation,7,1,6,3.334444814938313e-05,8.885137386436837e-05,0.8571428571428571
12635,12635,통치/Noun,7,6,1,8.891852839835501e-05,3.331926519913814e-05,0.8571428571428571
12636,12636,아라하/Noun,7,6,1,8.891852839835501e-05,3.331926519913814e-05,0.8571428571428571
12637,12637,어우동/Noun,7,1,6,3.334444814938313e-05,8.885137386436837e-05,0.8571428571428571
12638,12638,27분/Number,7,1,6,3.334444814938313e-05,8.885137386436837e-05,0.8571428571428571
12639,12639,꽤볼/Noun,7,6,1,8.891852839835501e-05,3.331926519913814e-05,0.8571428571428571
12640,12640,서핑/Noun,7,6,1,8.891852839835501e-05,3.331926519913814e-05,0.8571428571428571
12641,12641,불쾌/Noun,7,1,6,3.334444814938313e-05,8.885137386436837e-05,0.8571428571428571
12642,12642,인투더/Noun,7,1,6,3.334444814938313e-05,8.885137386436837e-05,0.8571428571428571
12643,12643,주먹질/Noun,7,1,6,3.334444814938313e-05,8.885137386436837e-05,0.8571428571428571
12644,12644,편안/Noun,7,6,1,8.891852839835501e-05,3.331926519913814e-05,0.8571428571428571
12645,12645,사보다/Verb,7,6,1,8.891852839835501e-05,3.331926519913814e-05,0.8571428571428571
12646,12646,립싱크/Noun,7,1,6,3.334444814938313e-05,8.885137386436837e-05,0.8571428571428571
12647,12647,수장/Noun,7,1,6,3.334444814938313e-05,8.885137386436837e-05,0.8571428571428571
12648,12648,~`/Punctuation,7,6,1,8.891852839835501e-05,3.331926519913814e-05,0.8571428571428571
12649,12649,너므/Noun,7,6,1,8.891852839835501e-05,3.331926519913814e-05,0.8571428571428571
12650,12650,비슷비슷/Noun,7,1,6,3.334444814938313e-05,8.885137386436837e-05,0.8571428571428571
12651,12651,마침표/Noun,7,6,1,8.891852839835501e-05,3.331926519913814e-05,0.8571428571428571
12652,12652,......................./Punctuation,7,1,6,3.334444814938313e-05,8.885137386436837e-05,0.8571428571428571
12653,12653,므흣/Noun,7,6,1,8.891852839835501e-05,3.331926519913814e-05,0.8571428571428571
12654,12654,뭐함/Noun,7,1,6,3.334444814938313e-05,8.885137386436837e-05,0.8571428571428571
12655,12655,배트/Noun,7,1,6,3.334444814938313e-05,8.885137386436837e-05,0.8571428571428571
12656,12656,분과/Noun,7,6,1,8.891852839835501e-05,3.331926519913814e-05,0.8571428571428571
12657,12657,진동/Noun,7,1,6,3.334444814938313e-05,8.885137386436837e-05,0.8571428571428571
12658,12658,내기억/Noun,7,6,1,8.891852839835501e-05,3.331926519913814e-05,0.8571428571428571
12659,12659,크로노스/Noun,7,1,6,3.334444814938313e-05,8.885137386436837e-05,0.8571428571428571
12660,12660,더디다/Verb,7,1,6,3.334444814938313e-05,8.885137386436837e-05,0.8571428571428571
12661,12661,주근깨/Noun,7,6,1,8.891852839835501e-05,3.331926519913814e-05,0.8571428571428571
12662,12662,쩡/Noun,7,6,1,8.891852839835501e-05,3.331926519913814e-05,0.8571428571428571
12663,12663,ㅡㅅㅡ/KoreanParticle,7,1,6,3.334444814938313e-05,8.885137386436837e-05,0.8571428571428571
12664,12664,뻗치다/Verb,7,1,6,3.334444814938313e-05,8.885137386436837e-05,0.8571428571428571
12665,12665,애자/Noun,7,1,6,3.334444814938313e-05,8.885137386436837e-05,0.8571428571428571
12666,12666,2015/Number,7,6,1,8.891852839835501e-05,3.331926519913814e-05,0.8571428571428571
12667,12667,소용돌이/Noun,7,6,1,8.891852839835501e-05,3.331926519913814e-05,0.8571428571428571
12668,12668,근대사/Noun,7,6,1,8.891852839835501e-05,3.331926519913814e-05,0.8571428571428571
12669,12669,교향곡/Noun,7,6,1,8.891852839835501e-05,3.331926519913814e-05,0.8571428571428571
12670,12670,화차/Noun,7,1,6,3.334444814938313e-05,8.885137386436837e-05,0.8571428571428571
12671,12671,니나/Noun,7,1,6,3.334444814938313e-05,8.885137386436837e-05,0.8571428571428571
12672,12672,15일/Number,7,6,1,8.891852839835501e-05,3.331926519913814e-05,0.8571428571428571
12673,12673,객관성/Noun,7,1,6,3.334444814938313e-05,8.885137386436837e-05,0.8571428571428571
12674,12674,re/Alpha,7,6,1,8.891852839835501e-05,3.331926519913814e-05,0.8571428571428571
12675,12675,화원/Noun,7,6,1,8.891852839835501e-05,3.331926519913814e-05,0.8571428571428571
12676,12676,시상식/Noun,7,1,6,3.334444814938313e-05,8.885137386436837e-05,0.8571428571428571
12677,12677,되풀이/Noun,7,6,1,8.891852839835501e-05,3.331926519913814e-05,0.8571428571428571
12678,12678,신세/Noun,7,1,6,3.334444814938313e-05,8.885137386436837e-05,0.8571428571428571
12679,12679,시전/Noun,7,1,6,3.334444814938313e-05,8.885137386436837e-05,0.8571428571428571
12680,12680,훈/Noun,7,6,1,8.891852839835501e-05,3.331926519913814e-05,0.8571428571428571
12681,12681,대재앙/Noun,7,1,6,3.334444814938313e-05,8.885137386436837e-05,0.8571428571428571
12682,12682,성매매/Noun,7,1,6,3.334444814938313e-05,8.885137386436837e-05,0.8571428571428571
12683,12683,-_-?/Punctuation,7,1,6,3.334444814938313e-05,8.885137386436837e-05,0.8571428571428571
12684,12684,엊그제/Noun,7,6,1,8.891852839835501e-05,3.331926519913814e-05,0.8571428571428571
12685,12685,타이거/Noun,7,6,1,8.891852839835501e-05,3.331926519913814e-05,0.8571428571428571
12686,12686,Who/Alpha,7,6,1,8.891852839835501e-05,3.331926519913814e-05,0.8571428571428571
12687,12687,통증/Noun,7,1,6,3.334444814938313e-05,8.885137386436837e-05,0.8571428571428571
12688,12688,눈쌀/Noun,7,1,6,3.334444814938313e-05,8.885137386436837e-05,0.8571428571428571
12689,12689,얹히다/Verb,7,1,6,3.334444814938313e-05,8.885137386436837e-05,0.8571428571428571
12690,12690,난이도/Noun,7,1,6,3.334444814938313e-05,8.885137386436837e-05,0.8571428571428571
12691,12691,메일/Noun,7,6,1,8.891852839835501e-05,3.331926519913814e-05,0.8571428571428571
12692,12692,유리창/Noun,7,6,1,8.891852839835501e-05,3.331926519913814e-05,0.8571428571428571
12693,12693,컴퓨터그래픽/Noun,7,1,6,3.334444814938313e-05,8.885137386436837e-05,0.8571428571428571
12694,12694,jyj/Alpha,7,6,1,8.891852839835501e-05,3.331926519913814e-05,0.8571428571428571
12695,12695,사무치다/Verb,7,6,1,8.891852839835501e-05,3.331926519913814e-05,0.8571428571428571
12696,12696,예찬/Noun,7,1,6,3.334444814938313e-05,8.885137386436837e-05,0.8571428571428571
12697,12697,전장/Noun,7,6,1,8.891852839835501e-05,3.331926519913814e-05,0.8571428571428571
12698,12698,읎드다/Verb,7,1,6,3.334444814938313e-05,8.885137386436837e-05,0.8571428571428571
12699,12699,요강/Noun,7,6,1,8.891852839835501e-05,3.331926519913814e-05,0.8571428571428571
12700,12700,채림/Noun,7,6,1,8.891852839835501e-05,3.331926519913814e-05,0.8571428571428571
12701,12701,데이비드/Noun,7,6,1,8.891852839835501e-05,3.331926519913814e-05,0.8571428571428571
12702,12702,이십/Modifier,7,6,1,8.891852839835501e-05,3.331926519913814e-05,0.8571428571428571
12703,12703,옛사랑/Noun,7,6,1,8.891852839835501e-05,3.331926519913814e-05,0.8571428571428571
12704,12704,안야/Noun,7,1,6,3.334444814938313e-05,8.885137386436837e-05,0.8571428571428571
12705,12705,데이지/Noun,7,6,1,8.891852839835501e-05,3.331926519913814e-05,0.8571428571428571
12706,12706,주차/Noun,7,1,6,3.334444814938313e-05,8.885137386436837e-05,0.8571428571428571
12707,12707,집밥/Noun,7,1,6,3.334444814938313e-05,8.885137386436837e-05,0.8571428571428571
12708,12708,각기/Noun,7,6,1,8.891852839835501e-05,3.331926519913814e-05,0.8571428571428571
12709,12709,감미/Noun,7,6,1,8.891852839835501e-05,3.331926519913814e-05,0.8571428571428571
12710,12710,중시/Noun,7,6,1,8.891852839835501e-05,3.331926519913814e-05,0.8571428571428571
12711,12711,꿋꿋하다/Adjective,7,6,1,8.891852839835501e-05,3.331926519913814e-05,0.8571428571428571
12712,12712,푸르다/Adjective,7,6,1,8.891852839835501e-05,3.331926519913814e-05,0.8571428571428571
12713,12713,호스트/Noun,7,1,6,3.334444814938313e-05,8.885137386436837e-05,0.8571428571428571
12714,12714,수꼴/Noun,7,1,6,3.334444814938313e-05,8.885137386436837e-05,0.8571428571428571
12715,12715,공신/Noun,7,1,6,3.334444814938313e-05,8.885137386436837e-05,0.8571428571428571
12716,12716,상콤/Noun,7,6,1,8.891852839835501e-05,3.331926519913814e-05,0.8571428571428571
12717,12717,깜깜/Noun,7,1,6,3.334444814938313e-05,8.885137386436837e-05,0.8571428571428571
12718,12718,사격/Noun,7,1,6,3.334444814938313e-05,8.885137386436837e-05,0.8571428571428571
12719,12719,스타트렉/Noun,7,6,1,8.891852839835501e-05,3.331926519913814e-05,0.8571428571428571
12720,12720,김유미/Noun,7,6,1,8.891852839835501e-05,3.331926519913814e-05,0.8571428571428571
12721,12721,마코/Noun,7,6,1,8.891852839835501e-05,3.331926519913814e-05,0.8571428571428571
12722,12722,서지석/Noun,7,1,6,3.334444814938313e-05,8.885137386436837e-05,0.8571428571428571
12723,12723,진행중/Noun,7,6,1,8.891852839835501e-05,3.331926519913814e-05,0.8571428571428571
12724,12724,LOVE/Alpha,7,6,1,8.891852839835501e-05,3.331926519913814e-05,0.8571428571428571
12725,12725,후에/Foreign,7,6,1,8.891852839835501e-05,3.331926519913814e-05,0.8571428571428571
12726,12726,무정도시/Noun,7,6,1,8.891852839835501e-05,3.331926519913814e-05,0.8571428571428571
12727,12727,이토준지/Noun,7,1,6,3.334444814938313e-05,8.885137386436837e-05,0.8571428571428571
12728,12728,조이/Noun,7,6,1,8.891852839835501e-05,3.331926519913814e-05,0.8571428571428571
12729,12729,동물원/Noun,7,6,1,8.891852839835501e-05,3.331926519913814e-05,0.8571428571428571
12730,12730,쏠쏠/Noun,7,6,1,8.891852839835501e-05,3.331926519913814e-05,0.8571428571428571
12731,12731,인/Foreign,7,6,1,8.891852839835501e-05,3.331926519913814e-05,0.8571428571428571
12732,12732,백만배/Noun,7,1,6,3.334444814938313e-05,8.885137386436837e-05,0.8571428571428571
12733,12733,협찬/Noun,7,1,6,3.334444814938313e-05,8.885137386436837e-05,0.8571428571428571
12734,12734,상책/Noun,7,1,6,3.334444814938313e-05,8.885137386436837e-05,0.8571428571428571
12735,12735,PPL/Alpha,7,1,6,3.334444814938313e-05,8.885137386436837e-05,0.8571428571428571
12736,12736,주랑/Noun,7,6,1,8.891852839835501e-05,3.331926519913814e-05,0.8571428571428571
12737,12737,유두/Noun,7,1,6,3.334444814938313e-05,8.885137386436837e-05,0.8571428571428571
12738,12738,캐머런/Noun,7,6,1,8.891852839835501e-05,3.331926519913814e-05,0.8571428571428571
12739,12739,똥물/Noun,7,1,6,3.334444814938313e-05,8.885137386436837e-05,0.8571428571428571
12740,12740,삼고/Noun,7,6,1,8.891852839835501e-05,3.331926519913814e-05,0.8571428571428571
12741,12741,노도/Noun,7,6,1,8.891852839835501e-05,3.331926519913814e-05,0.8571428571428571
12742,12742,크리스챤/Noun,7,6,1,8.891852839835501e-05,3.331926519913814e-05,0.8571428571428571
12743,12743,9.1/Number,7,6,1,8.891852839835501e-05,3.331926519913814e-05,0.8571428571428571
12744,12744,이진욱/Noun,7,6,1,8.891852839835501e-05,3.331926519913814e-05,0.8571428571428571
12745,12745,김지현/Noun,7,1,6,3.334444814938313e-05,8.885137386436837e-05,0.8571428571428571
12746,12746,공연장/Noun,7,6,1,8.891852839835501e-05,3.331926519913814e-05,0.8571428571428571
12747,12747,모짜르트/Noun,7,6,1,8.891852839835501e-05,3.331926519913814e-05,0.8571428571428571
12748,12748,천군/Noun,7,1,6,3.334444814938313e-05,8.885137386436837e-05,0.8571428571428571
12749,12749,타가/Noun,7,6,1,8.891852839835501e-05,3.331926519913814e-05,0.8571428571428571
12750,12750,원내/Noun,7,1,6,3.334444814938313e-05,8.885137386436837e-05,0.8571428571428571
12751,12751,쟁취/Noun,7,6,1,8.891852839835501e-05,3.331926519913814e-05,0.8571428571428571
12752,12752,아하하/Adverb,7,1,6,3.334444814938313e-05,8.885137386436837e-05,0.8571428571428571
12753,12753,똥통/Noun,7,1,6,3.334444814938313e-05,8.885137386436837e-05,0.8571428571428571
12754,12754,모이/Noun,7,6,1,8.891852839835501e-05,3.331926519913814e-05,0.8571428571428571
12755,12755,정찬/Noun,7,1,6,3.334444814938313e-05,8.885137386436837e-05,0.8571428571428571
12756,12756,염소/Noun,7,6,1,8.891852839835501e-05,3.331926519913814e-05,0.8571428571428571
12757,12757,적막하다/Adjective,7,6,1,8.891852839835501e-05,3.331926519913814e-05,0.8571428571428571
12758,12758,비뚤어지다/Verb,7,1,6,3.334444814938313e-05,8.885137386436837e-05,0.8571428571428571
12759,12759,밍숭맹숭/Noun,7,1,6,3.334444814938313e-05,8.885137386436837e-05,0.8571428571428571
12760,12760,바고/Noun,7,6,1,8.891852839835501e-05,3.331926519913814e-05,0.8571428571428571
12761,12761,전쯤/Foreign,7,6,1,8.891852839835501e-05,3.331926519913814e-05,0.8571428571428571
12762,12762,왜구/Noun,7,1,6,3.334444814938313e-05,8.885137386436837e-05,0.8571428571428571
12763,12763,자멸/Noun,7,1,6,3.334444814938313e-05,8.885137386436837e-05,0.8571428571428571
12764,12764,말레나/Noun,7,5,2,7.780371234856063e-05,4.4425686932184186e-05,0.7142857142857143
12765,12765,연약하다/Adjective,7,5,2,7.780371234856063e-05,4.4425686932184186e-05,0.7142857142857143
12766,12766,운석/Noun,7,2,5,4.445926419917751e-05,7.774495213132233e-05,0.7142857142857143
12767,12767,가제/Noun,7,5,2,7.780371234856063e-05,4.4425686932184186e-05,0.7142857142857143
12768,12768,민국이/Noun,7,2,5,4.445926419917751e-05,7.774495213132233e-05,0.7142857142857143
12769,12769,안드레이/Noun,7,5,2,7.780371234856063e-05,4.4425686932184186e-05,0.7142857142857143
12770,12770,실마리/Noun,7,2,5,4.445926419917751e-05,7.774495213132233e-05,0.7142857142857143
12771,12771,할렐루야/Noun,7,5,2,7.780371234856063e-05,4.4425686932184186e-05,0.7142857142857143
12772,12772,리모콘/Noun,7,2,5,4.445926419917751e-05,7.774495213132233e-05,0.7142857142857143
12773,12773,박형식/Noun,7,5,2,7.780371234856063e-05,4.4425686932184186e-05,0.7142857142857143
12774,12774,허용/Noun,7,2,5,4.445926419917751e-05,7.774495213132233e-05,0.7142857142857143
12775,12775,분출/Noun,7,5,2,7.780371234856063e-05,4.4425686932184186e-05,0.7142857142857143
12776,12776,쥬리/Noun,7,2,5,4.445926419917751e-05,7.774495213132233e-05,0.7142857142857143
12777,12777,뇌물/Noun,7,2,5,4.445926419917751e-05,7.774495213132233e-05,0.7142857142857143
12778,12778,김남주/Noun,7,2,5,4.445926419917751e-05,7.774495213132233e-05,0.7142857142857143
12779,12779,확확/Adverb,7,5,2,7.780371234856063e-05,4.4425686932184186e-05,0.7142857142857143
12780,12780,진용/Noun,7,2,5,4.445926419917751e-05,7.774495213132233e-05,0.7142857142857143
12781,12781,천식/Noun,7,2,5,4.445926419917751e-05,7.774495213132233e-05,0.7142857142857143
12782,12782,동선/Noun,7,2,5,4.445926419917751e-05,7.774495213132233e-05,0.7142857142857143
12783,12783,뒷골목/Noun,7,5,2,7.780371234856063e-05,4.4425686932184186e-05,0.7142857142857143
12784,12784,점철/Noun,7,2,5,4.445926419917751e-05,7.774495213132233e-05,0.7142857142857143
12785,12785,가젤/Noun,7,2,5,4.445926419917751e-05,7.774495213132233e-05,0.7142857142857143
12786,12786,몸서리/Noun,7,5,2,7.780371234856063e-05,4.4425686932184186e-05,0.7142857142857143
12787,12787,정도영/Noun,7,2,5,4.445926419917751e-05,7.774495213132233e-05,0.7142857142857143
12788,12788,기겁/Noun,7,2,5,4.445926419917751e-05,7.774495213132233e-05,0.7142857142857143
12789,12789,어어/Exclamation,7,5,2,7.780371234856063e-05,4.4425686932184186e-05,0.7142857142857143
12790,12790,지영/Noun,7,5,2,7.780371234856063e-05,4.4425686932184186e-05,0.7142857142857143
12791,12791,라우/Noun,7,5,2,7.780371234856063e-05,4.4425686932184186e-05,0.7142857142857143
12792,12792,오현민/Noun,7,5,2,7.780371234856063e-05,4.4425686932184186e-05,0.7142857142857143
12793,12793,언스/Noun,7,2,5,4.445926419917751e-05,7.774495213132233e-05,0.7142857142857143
12794,12794,말미/Noun,7,5,2,7.780371234856063e-05,4.4425686932184186e-05,0.7142857142857143
12795,12795,공작/Noun,7,2,5,4.445926419917751e-05,7.774495213132233e-05,0.7142857142857143
12796,12796,김슬기/Noun,7,5,2,7.780371234856063e-05,4.4425686932184186e-05,0.7142857142857143
12797,12797,일시/Noun,7,5,2,7.780371234856063e-05,4.4425686932184186e-05,0.7142857142857143
12798,12798,학부모/Noun,7,5,2,7.780371234856063e-05,4.4425686932184186e-05,0.7142857142857143
12799,12799,광복절/Noun,7,5,2,7.780371234856063e-05,4.4425686932184186e-05,0.7142857142857143
12800,12800,물음표/Noun,7,2,5,4.445926419917751e-05,7.774495213132233e-05,0.7142857142857143
12801,12801,치즈루/Noun,7,5,2,7.780371234856063e-05,4.4425686932184186e-05,0.7142857142857143
12802,12802,제비/Noun,7,2,5,4.445926419917751e-05,7.774495213132233e-05,0.7142857142857143
12803,12803,일본엔/Noun,7,2,5,4.445926419917751e-05,7.774495213132233e-05,0.7142857142857143
12804,12804,자전/Noun,7,5,2,7.780371234856063e-05,4.4425686932184186e-05,0.7142857142857143
12805,12805,28분/Number,7,2,5,4.445926419917751e-05,7.774495213132233e-05,0.7142857142857143
12806,12806,병구/Noun,7,5,2,7.780371234856063e-05,4.4425686932184186e-05,0.7142857142857143
12807,12807,탄성/Noun,7,5,2,7.780371234856063e-05,4.4425686932184186e-05,0.7142857142857143
12808,12808,낄낄대다/Verb,7,2,5,4.445926419917751e-05,7.774495213132233e-05,0.7142857142857143
12809,12809,근현대사/Noun,7,5,2,7.780371234856063e-05,4.4425686932184186e-05,0.7142857142857143
12810,12810,흡사/Noun,7,5,2,7.780371234856063e-05,4.4425686932184186e-05,0.7142857142857143
12811,12811,투하/Noun,7,2,5,4.445926419917751e-05,7.774495213132233e-05,0.7142857142857143
12812,12812,김선영/Noun,7,2,5,4.445926419917751e-05,7.774495213132233e-05,0.7142857142857143
12813,12813,러시아워/Noun,7,5,2,7.780371234856063e-05,4.4425686932184186e-05,0.7142857142857143
12814,12814,전격/Noun,7,5,2,7.780371234856063e-05,4.4425686932184186e-05,0.7142857142857143
12815,12815,내야/Noun,7,2,5,4.445926419917751e-05,7.774495213132233e-05,0.7142857142857143
12816,12816,조권/Noun,7,5,2,7.780371234856063e-05,4.4425686932184186e-05,0.7142857142857143
12817,12817,유다인/Noun,7,5,2,7.780371234856063e-05,4.4425686932184186e-05,0.7142857142857143
12818,12818,쿠나/Noun,7,5,2,7.780371234856063e-05,4.4425686932184186e-05,0.7142857142857143
12819,12819,의천도룡기/Noun,7,5,2,7.780371234856063e-05,4.4425686932184186e-05,0.7142857142857143
12820,12820,마코토/Noun,7,5,2,7.780371234856063e-05,4.4425686932184186e-05,0.7142857142857143
12821,12821,안일하다/Adjective,7,2,5,4.445926419917751e-05,7.774495213132233e-05,0.7142857142857143
12822,12822,줄곧/Noun,7,2,5,4.445926419917751e-05,7.774495213132233e-05,0.7142857142857143
12823,12823,키시/Noun,7,2,5,4.445926419917751e-05,7.774495213132233e-05,0.7142857142857143
12824,12824,마츠야/Noun,7,5,2,7.780371234856063e-05,4.4425686932184186e-05,0.7142857142857143
12825,12825,성용/Noun,7,2,5,4.445926419917751e-05,7.774495213132233e-05,0.7142857142857143
12826,12826,작붕/Noun,7,2,5,4.445926419917751e-05,7.774495213132233e-05,0.7142857142857143
12827,12827,파가니니/Noun,7,2,5,4.445926419917751e-05,7.774495213132233e-05,0.7142857142857143
12828,12828,렵니/Noun,7,5,2,7.780371234856063e-05,4.4425686932184186e-05,0.7142857142857143
12829,12829,오렌지/Noun,7,5,2,7.780371234856063e-05,4.4425686932184186e-05,0.7142857142857143
12830,12830,지시/Noun,7,2,5,4.445926419917751e-05,7.774495213132233e-05,0.7142857142857143
12831,12831,마이걸/Noun,7,5,2,7.780371234856063e-05,4.4425686932184186e-05,0.7142857142857143
12832,12832,특수분장/Noun,7,2,5,4.445926419917751e-05,7.774495213132233e-05,0.7142857142857143
12833,12833,무자식/Noun,7,2,5,4.445926419917751e-05,7.774495213132233e-05,0.7142857142857143
12834,12834,김성은/Noun,7,2,5,4.445926419917751e-05,7.774495213132233e-05,0.7142857142857143
12835,12835,수퍼액션/Noun,7,2,5,4.445926419917751e-05,7.774495213132233e-05,0.7142857142857143
12836,12836,빙하/Noun,7,2,5,4.445926419917751e-05,7.774495213132233e-05,0.7142857142857143
12837,12837,기진/Noun,7,2,5,4.445926419917751e-05,7.774495213132233e-05,0.7142857142857143
12838,12838,조가/Noun,7,2,5,4.445926419917751e-05,7.774495213132233e-05,0.7142857142857143
12839,12839,더위/Noun,7,5,2,7.780371234856063e-05,4.4425686932184186e-05,0.7142857142857143
12840,12840,영춘권/Noun,7,2,5,4.445926419917751e-05,7.774495213132233e-05,0.7142857142857143
12841,12841,심란하다/Adjective,7,2,5,4.445926419917751e-05,7.774495213132233e-05,0.7142857142857143
12842,12842,독재자/Noun,7,5,2,7.780371234856063e-05,4.4425686932184186e-05,0.7142857142857143
12843,12843,감고/Noun,7,5,2,7.780371234856063e-05,4.4425686932184186e-05,0.7142857142857143
12844,12844,사회주의/Noun,7,5,2,7.780371234856063e-05,4.4425686932184186e-05,0.7142857142857143
12845,12845,소명/Noun,7,5,2,7.780371234856063e-05,4.4425686932184186e-05,0.7142857142857143
12846,12846,데미안/Noun,7,2,5,4.445926419917751e-05,7.774495213132233e-05,0.7142857142857143
12847,12847,부적/Noun,7,5,2,7.780371234856063e-05,4.4425686932184186e-05,0.7142857142857143
12848,12848,워킹데드/Noun,7,2,5,4.445926419917751e-05,7.774495213132233e-05,0.7142857142857143
12849,12849,서지혜/Noun,7,5,2,7.780371234856063e-05,4.4425686932184186e-05,0.7142857142857143
12850,12850,못함/Noun,7,2,5,4.445926419917751e-05,7.774495213132233e-05,0.7142857142857143
12851,12851,청각장애/Noun,7,5,2,7.780371234856063e-05,4.4425686932184186e-05,0.7142857142857143
12852,12852,폴리/Noun,7,5,2,7.780371234856063e-05,4.4425686932184186e-05,0.7142857142857143
12853,12853,라는데/Eomi,7,2,5,4.445926419917751e-05,7.774495213132233e-05,0.7142857142857143
12854,12854,배합/Noun,7,5,2,7.780371234856063e-05,4.4425686932184186e-05,0.7142857142857143
12855,12855,앳킨슨/Noun,7,5,2,7.780371234856063e-05,4.4425686932184186e-05,0.7142857142857143
12856,12856,dd/Alpha,7,5,2,7.780371234856063e-05,4.4425686932184186e-05,0.7142857142857143
12857,12857,연가시/Noun,7,2,5,4.445926419917751e-05,7.774495213132233e-05,0.7142857142857143
12858,12858,욱겨/Noun,7,5,2,7.780371234856063e-05,4.4425686932184186e-05,0.7142857142857143
12859,12859,버마/Noun,7,5,2,7.780371234856063e-05,4.4425686932184186e-05,0.7142857142857143
12860,12860,어질다/Adjective,7,5,2,7.780371234856063e-05,4.4425686932184186e-05,0.7142857142857143
12861,12861,투어/Noun,7,5,2,7.780371234856063e-05,4.4425686932184186e-05,0.7142857142857143
12862,12862,레지던트/Noun,7,2,5,4.445926419917751e-05,7.774495213132233e-05,0.7142857142857143
12863,12863,배/Foreign,7,2,5,4.445926419917751e-05,7.774495213132233e-05,0.7142857142857143
12864,12864,영업/Noun,7,5,2,7.780371234856063e-05,4.4425686932184186e-05,0.7142857142857143
12865,12865,제기랄/Noun,7,2,5,4.445926419917751e-05,7.774495213132233e-05,0.7142857142857143
12866,12866,압구정/Noun,7,2,5,4.445926419917751e-05,7.774495213132233e-05,0.7142857142857143
12867,12867,예리하다/Adjective,7,5,2,7.780371234856063e-05,4.4425686932184186e-05,0.7142857142857143
12868,12868,전문성/Noun,7,2,5,4.445926419917751e-05,7.774495213132233e-05,0.7142857142857143
12869,12869,./Foreign,7,5,2,7.780371234856063e-05,4.4425686932184186e-05,0.7142857142857143
12870,12870,워드/Noun,7,5,2,7.780371234856063e-05,4.4425686932184186e-05,0.7142857142857143
12871,12871,원더우먼/Noun,7,2,5,4.445926419917751e-05,7.774495213132233e-05,0.7142857142857143
12872,12872,일행/Noun,7,2,5,4.445926419917751e-05,7.774495213132233e-05,0.7142857142857143
12873,12873,구마/Noun,7,2,5,4.445926419917751e-05,7.774495213132233e-05,0.7142857142857143
12874,12874,얼어붙다/Verb,7,5,2,7.780371234856063e-05,4.4425686932184186e-05,0.7142857142857143
12875,12875,애니메/Noun,7,5,2,7.780371234856063e-05,4.4425686932184186e-05,0.7142857142857143
12876,12876,마시기/Noun,7,2,5,4.445926419917751e-05,7.774495213132233e-05,0.7142857142857143
12877,12877,건축가/Noun,7,5,2,7.780371234856063e-05,4.4425686932184186e-05,0.7142857142857143
12878,12878,동키/Noun,7,5,2,7.780371234856063e-05,4.4425686932184186e-05,0.7142857142857143
12879,12879,도적/Noun,7,2,5,4.445926419917751e-05,7.774495213132233e-05,0.7142857142857143
12880,12880,교정/Noun,7,2,5,4.445926419917751e-05,7.774495213132233e-05,0.7142857142857143
12881,12881,할기다/Verb,7,5,2,7.780371234856063e-05,4.4425686932184186e-05,0.7142857142857143
12882,12882,코만도/Noun,7,2,5,4.445926419917751e-05,7.774495213132233e-05,0.7142857142857143
12883,12883,인스턴트/Noun,7,2,5,4.445926419917751e-05,7.774495213132233e-05,0.7142857142857143
12884,12884,주식회사/Noun,7,5,2,7.780371234856063e-05,4.4425686932184186e-05,0.7142857142857143
12885,12885,제아/Noun,7,5,2,7.780371234856063e-05,4.4425686932184186e-05,0.7142857142857143
12886,12886,디카/Noun,7,2,5,4.445926419917751e-05,7.774495213132233e-05,0.7142857142857143
12887,12887,벗겨지다/Verb,7,5,2,7.780371234856063e-05,4.4425686932184186e-05,0.7142857142857143
12888,12888,튀김/Noun,7,2,5,4.445926419917751e-05,7.774495213132233e-05,0.7142857142857143
12889,12889,드세다/Adjective,7,2,5,4.445926419917751e-05,7.774495213132233e-05,0.7142857142857143
12890,12890,잔소리/Noun,7,5,2,7.780371234856063e-05,4.4425686932184186e-05,0.7142857142857143
12891,12891,위상/Noun,7,5,2,7.780371234856063e-05,4.4425686932184186e-05,0.7142857142857143
12892,12892,황혼/Noun,7,5,2,7.780371234856063e-05,4.4425686932184186e-05,0.7142857142857143
12893,12893,퍼니셔/Noun,7,5,2,7.780371234856063e-05,4.4425686932184186e-05,0.7142857142857143
12894,12894,완주/Noun,7,5,2,7.780371234856063e-05,4.4425686932184186e-05,0.7142857142857143
12895,12895,관건/Noun,7,2,5,4.445926419917751e-05,7.774495213132233e-05,0.7142857142857143
12896,12896,개체/Noun,7,5,2,7.780371234856063e-05,4.4425686932184186e-05,0.7142857142857143
12897,12897,장철/Noun,7,5,2,7.780371234856063e-05,4.4425686932184186e-05,0.7142857142857143
12898,12898,노스/Noun,7,5,2,7.780371234856063e-05,4.4425686932184186e-05,0.7142857142857143
12899,12899,김혜자/Noun,7,5,2,7.780371234856063e-05,4.4425686932184186e-05,0.7142857142857143
12900,12900,빌런/Noun,7,2,5,4.445926419917751e-05,7.774495213132233e-05,0.7142857142857143
12901,12901,송이/Noun,7,5,2,7.780371234856063e-05,4.4425686932184186e-05,0.7142857142857143
12902,12902,콤/Noun,7,5,2,7.780371234856063e-05,4.4425686932184186e-05,0.7142857142857143
12903,12903,꿀꿀하다/Adjective,7,5,2,7.780371234856063e-05,4.4425686932184186e-05,0.7142857142857143
12904,12904,삼십분/Noun,7,2,5,4.445926419917751e-05,7.774495213132233e-05,0.7142857142857143
12905,12905,선희/Noun,7,5,2,7.780371234856063e-05,4.4425686932184186e-05,0.7142857142857143
12906,12906,급무/Noun,7,2,5,4.445926419917751e-05,7.774495213132233e-05,0.7142857142857143
12907,12907,평좀/Noun,7,2,5,4.445926419917751e-05,7.774495213132233e-05,0.7142857142857143
12908,12908,모성/Noun,7,5,2,7.780371234856063e-05,4.4425686932184186e-05,0.7142857142857143
12909,12909,경배/Noun,7,5,2,7.780371234856063e-05,4.4425686932184186e-05,0.7142857142857143
12910,12910,피의자/Noun,7,2,5,4.445926419917751e-05,7.774495213132233e-05,0.7142857142857143
12911,12911,연하/Noun,7,2,5,4.445926419917751e-05,7.774495213132233e-05,0.7142857142857143
12912,12912,보나마나/Noun,7,2,5,4.445926419917751e-05,7.774495213132233e-05,0.7142857142857143
12913,12913,라든지/Josa,7,5,2,7.780371234856063e-05,4.4425686932184186e-05,0.7142857142857143
12914,12914,시합/Noun,7,2,5,4.445926419917751e-05,7.774495213132233e-05,0.7142857142857143
12915,12915,오피스/Noun,7,2,5,4.445926419917751e-05,7.774495213132233e-05,0.7142857142857143
12916,12916,프로덕션/Noun,7,2,5,4.445926419917751e-05,7.774495213132233e-05,0.7142857142857143
12917,12917,겉모습/Noun,7,5,2,7.780371234856063e-05,4.4425686932184186e-05,0.7142857142857143
12918,12918,픔/Noun,7,5,2,7.780371234856063e-05,4.4425686932184186e-05,0.7142857142857143
12919,12919,85년/Number,7,5,2,7.780371234856063e-05,4.4425686932184186e-05,0.7142857142857143
12920,12920,『/Foreign,7,5,2,7.780371234856063e-05,4.4425686932184186e-05,0.7142857142857143
12921,12921,최동훈/Noun,7,5,2,7.780371234856063e-05,4.4425686932184186e-05,0.7142857142857143
12922,12922,생체실험/Noun,7,2,5,4.445926419917751e-05,7.774495213132233e-05,0.7142857142857143
12923,12923,어떻든/Adverb,7,2,5,4.445926419917751e-05,7.774495213132233e-05,0.7142857142857143
12924,12924,!!!!!!!!!!!!!!!!!/Punctuation,7,5,2,7.780371234856063e-05,4.4425686932184186e-05,0.7142857142857143
12925,12925,Sf/Alpha,7,5,2,7.780371234856063e-05,4.4425686932184186e-05,0.7142857142857143
12926,12926,오신/Noun,7,2,5,4.445926419917751e-05,7.774495213132233e-05,0.7142857142857143
12927,12927,겨털/Noun,7,2,5,4.445926419917751e-05,7.774495213132233e-05,0.7142857142857143
12928,12928,대별/Noun,7,5,2,7.780371234856063e-05,4.4425686932184186e-05,0.7142857142857143
12929,12929,도윤/Noun,7,2,5,4.445926419917751e-05,7.774495213132233e-05,0.7142857142857143
12930,12930,일당백/Noun,7,5,2,7.780371234856063e-05,4.4425686932184186e-05,0.7142857142857143
12931,12931,스파이키드/Noun,7,2,5,4.445926419917751e-05,7.774495213132233e-05,0.7142857142857143
12932,12932,포에버/Noun,7,5,2,7.780371234856063e-05,4.4425686932184186e-05,0.7142857142857143
12933,12933,친딸/Noun,7,2,5,4.445926419917751e-05,7.774495213132233e-05,0.7142857142857143
12934,12934,아톰/Noun,7,5,2,7.780371234856063e-05,4.4425686932184186e-05,0.7142857142857143
12935,12935,진세연/Noun,7,5,2,7.780371234856063e-05,4.4425686932184186e-05,0.7142857142857143
12936,12936,벤자민/Noun,7,5,2,7.780371234856063e-05,4.4425686932184186e-05,0.7142857142857143
12937,12937,열중/Noun,7,2,5,4.445926419917751e-05,7.774495213132233e-05,0.7142857142857143
12938,12938,수류탄/Noun,7,2,5,4.445926419917751e-05,7.774495213132233e-05,0.7142857142857143
12939,12939,정표/Noun,7,2,5,4.445926419917751e-05,7.774495213132233e-05,0.7142857142857143
12940,12940,나스/Noun,7,5,2,7.780371234856063e-05,4.4425686932184186e-05,0.7142857142857143
12941,12941,강림/Noun,7,5,2,7.780371234856063e-05,4.4425686932184186e-05,0.7142857142857143
12942,12942,안양/Noun,7,5,2,7.780371234856063e-05,4.4425686932184186e-05,0.7142857142857143
12943,12943,개강/Noun,7,5,2,7.780371234856063e-05,4.4425686932184186e-05,0.7142857142857143
12944,12944,여행기/Noun,7,2,5,4.445926419917751e-05,7.774495213132233e-05,0.7142857142857143
12945,12945,적군/Noun,7,5,2,7.780371234856063e-05,4.4425686932184186e-05,0.7142857142857143
12946,12946,통곡/Noun,7,2,5,4.445926419917751e-05,7.774495213132233e-05,0.7142857142857143
12947,12947,였슴/Noun,7,5,2,7.780371234856063e-05,4.4425686932184186e-05,0.7142857142857143
12948,12948,파일럿/Noun,7,5,2,7.780371234856063e-05,4.4425686932184186e-05,0.7142857142857143
12949,12949,히말라야/Noun,7,5,2,7.780371234856063e-05,4.4425686932184186e-05,0.7142857142857143
12950,12950,그러기에/Conjunction,7,5,2,7.780371234856063e-05,4.4425686932184186e-05,0.7142857142857143
12951,12951,슈타게/Noun,7,5,2,7.780371234856063e-05,4.4425686932184186e-05,0.7142857142857143
12952,12952,조립/Noun,7,5,2,7.780371234856063e-05,4.4425686932184186e-05,0.7142857142857143
12953,12953,미필/Noun,7,5,2,7.780371234856063e-05,4.4425686932184186e-05,0.7142857142857143
12954,12954,한나라/Noun,7,2,5,4.445926419917751e-05,7.774495213132233e-05,0.7142857142857143
12955,12955,불/Foreign,7,2,5,4.445926419917751e-05,7.774495213132233e-05,0.7142857142857143
12956,12956,리우/Noun,7,2,5,4.445926419917751e-05,7.774495213132233e-05,0.7142857142857143
12957,12957,간부/Noun,7,2,5,4.445926419917751e-05,7.774495213132233e-05,0.7142857142857143
12958,12958,넝쿨당/Noun,7,5,2,7.780371234856063e-05,4.4425686932184186e-05,0.7142857142857143
12959,12959,매수/Noun,7,2,5,4.445926419917751e-05,7.774495213132233e-05,0.7142857142857143
12960,12960,1234567890/Number,7,5,2,7.780371234856063e-05,4.4425686932184186e-05,0.7142857142857143
12961,12961,친북/Noun,7,2,5,4.445926419917751e-05,7.774495213132233e-05,0.7142857142857143
12962,12962,강변/Noun,7,5,2,7.780371234856063e-05,4.4425686932184186e-05,0.7142857142857143
12963,12963,히키코모리/Noun,7,2,5,4.445926419917751e-05,7.774495213132233e-05,0.7142857142857143
12964,12964,여섯/Noun,7,2,5,4.445926419917751e-05,7.774495213132233e-05,0.7142857142857143
12965,12965,평판/Noun,7,5,2,7.780371234856063e-05,4.4425686932184186e-05,0.7142857142857143
12966,12966,한그루/Noun,7,5,2,7.780371234856063e-05,4.4425686932184186e-05,0.7142857142857143
12967,12967,?;;;/Punctuation,7,2,5,4.445926419917751e-05,7.774495213132233e-05,0.7142857142857143
12968,12968,보안관/Noun,7,2,5,4.445926419917751e-05,7.774495213132233e-05,0.7142857142857143
12969,12969,어이구/Noun,7,2,5,4.445926419917751e-05,7.774495213132233e-05,0.7142857142857143
12970,12970,too/Alpha,7,2,5,4.445926419917751e-05,7.774495213132233e-05,0.7142857142857143
12971,12971,부딪치다/Verb,7,5,2,7.780371234856063e-05,4.4425686932184186e-05,0.7142857142857143
12972,12972,앞머리/Noun,7,2,5,4.445926419917751e-05,7.774495213132233e-05,0.7142857142857143
12973,12973,허울/Noun,7,2,5,4.445926419917751e-05,7.774495213132233e-05,0.7142857142857143
12974,12974,성스럽다/Adjective,7,2,5,4.445926419917751e-05,7.774495213132233e-05,0.7142857142857143
12975,12975,교장/Noun,7,5,2,7.780371234856063e-05,4.4425686932184186e-05,0.7142857142857143
12976,12976,5.18/Number,7,2,5,4.445926419917751e-05,7.774495213132233e-05,0.7142857142857143
12977,12977,기생충/Noun,7,2,5,4.445926419917751e-05,7.774495213132233e-05,0.7142857142857143
12978,12978,소비자/Noun,7,2,5,4.445926419917751e-05,7.774495213132233e-05,0.7142857142857143
12979,12979,?^^/Punctuation,7,5,2,7.780371234856063e-05,4.4425686932184186e-05,0.7142857142857143
12980,12980,팽팽/Noun,7,5,2,7.780371234856063e-05,4.4425686932184186e-05,0.7142857142857143
12981,12981,구걸/Noun,7,2,5,4.445926419917751e-05,7.774495213132233e-05,0.7142857142857143
12982,12982,숭/Noun,7,5,2,7.780371234856063e-05,4.4425686932184186e-05,0.7142857142857143
12983,12983,고약하다/Adjective,7,2,5,4.445926419917751e-05,7.774495213132233e-05,0.7142857142857143
12984,12984,조여/Noun,7,5,2,7.780371234856063e-05,4.4425686932184186e-05,0.7142857142857143
12985,12985,회원/Noun,7,5,2,7.780371234856063e-05,4.4425686932184186e-05,0.7142857142857143
12986,12986,흡수/Noun,7,2,5,4.445926419917751e-05,7.774495213132233e-05,0.7142857142857143
12987,12987,비디오테이프/Noun,7,5,2,7.780371234856063e-05,4.4425686932184186e-05,0.7142857142857143
12988,12988,지드/Noun,7,5,2,7.780371234856063e-05,4.4425686932184186e-05,0.7142857142857143
12989,12989,민들레/Noun,7,5,2,7.780371234856063e-05,4.4425686932184186e-05,0.7142857142857143
12990,12990,심해지다/Verb,7,2,5,4.445926419917751e-05,7.774495213132233e-05,0.7142857142857143
12991,12991,강대국/Noun,7,5,2,7.780371234856063e-05,4.4425686932184186e-05,0.7142857142857143
12992,12992,덴마크/Noun,7,5,2,7.780371234856063e-05,4.4425686932184186e-05,0.7142857142857143
12993,12993,춘향전/Noun,7,2,5,4.445926419917751e-05,7.774495213132233e-05,0.7142857142857143
12994,12994,복불복/Noun,7,2,5,4.445926419917751e-05,7.774495213132233e-05,0.7142857142857143
12995,12995,ㅋㄱㅋ/KoreanParticle,7,2,5,4.445926419917751e-05,7.774495213132233e-05,0.7142857142857143
12996,12996,견해/Noun,7,2,5,4.445926419917751e-05,7.774495213132233e-05,0.7142857142857143
12997,12997,식스/Noun,7,2,5,4.445926419917751e-05,7.774495213132233e-05,0.7142857142857143
12998,12998,위험성/Noun,7,2,5,4.445926419917751e-05,7.774495213132233e-05,0.7142857142857143
12999,12999,애원/Noun,7,2,5,4.445926419917751e-05,7.774495213132233e-05,0.7142857142857143
13000,13000,조언/Noun,7,5,2,7.780371234856063e-05,4.4425686932184186e-05,0.7142857142857143
13001,13001,나타/Noun,7,5,2,7.780371234856063e-05,4.4425686932184186e-05,0.7142857142857143
13002,13002,기관/Noun,7,2,5,4.445926419917751e-05,7.774495213132233e-05,0.7142857142857143
13003,13003,양면/Noun,7,5,2,7.780371234856063e-05,4.4425686932184186e-05,0.7142857142857143
13004,13004,난사/Noun,7,2,5,4.445926419917751e-05,7.774495213132233e-05,0.7142857142857143
13005,13005,반/Foreign,7,2,5,4.445926419917751e-05,7.774495213132233e-05,0.7142857142857143
13006,13006,",@/Punctuation",7,2,5,4.445926419917751e-05,7.774495213132233e-05,0.7142857142857143
13007,13007,꽃남/Noun,7,5,2,7.780371234856063e-05,4.4425686932184186e-05,0.7142857142857143
13008,13008,봄날/Noun,7,5,2,7.780371234856063e-05,4.4425686932184186e-05,0.7142857142857143
13009,13009,소멸/Noun,7,5,2,7.780371234856063e-05,4.4425686932184186e-05,0.7142857142857143
13010,13010,어땟을까/Noun,7,2,5,4.445926419917751e-05,7.774495213132233e-05,0.7142857142857143
13011,13011,완료/Noun,7,5,2,7.780371234856063e-05,4.4425686932184186e-05,0.7142857142857143
13012,13012,브렌/Noun,7,5,2,7.780371234856063e-05,4.4425686932184186e-05,0.7142857142857143
13013,13013,Do/Alpha,7,5,2,7.780371234856063e-05,4.4425686932184186e-05,0.7142857142857143
13014,13014,사도세자/Noun,7,5,2,7.780371234856063e-05,4.4425686932184186e-05,0.7142857142857143
13015,13015,거미줄/Noun,7,5,2,7.780371234856063e-05,4.4425686932184186e-05,0.7142857142857143
13016,13016,제우스/Noun,7,2,5,4.445926419917751e-05,7.774495213132233e-05,0.7142857142857143
13017,13017,래빗/Noun,7,5,2,7.780371234856063e-05,4.4425686932184186e-05,0.7142857142857143
13018,13018,이대근/Noun,7,5,2,7.780371234856063e-05,4.4425686932184186e-05,0.7142857142857143
13019,13019,루키/Noun,7,5,2,7.780371234856063e-05,4.4425686932184186e-05,0.7142857142857143
13020,13020,자원/Noun,7,2,5,4.445926419917751e-05,7.774495213132233e-05,0.7142857142857143
13021,13021,씬시티/Noun,7,2,5,4.445926419917751e-05,7.774495213132233e-05,0.7142857142857143
13022,13022,바임/Noun,7,2,5,4.445926419917751e-05,7.774495213132233e-05,0.7142857142857143
13023,13023,오만/Modifier,7,2,5,4.445926419917751e-05,7.774495213132233e-05,0.7142857142857143
13024,13024,조강지처/Noun,7,2,5,4.445926419917751e-05,7.774495213132233e-05,0.7142857142857143
13025,13025,분자/Noun,7,2,5,4.445926419917751e-05,7.774495213132233e-05,0.7142857142857143
13026,13026,백원/Noun,7,2,5,4.445926419917751e-05,7.774495213132233e-05,0.7142857142857143
13027,13027,황수정/Noun,7,5,2,7.780371234856063e-05,4.4425686932184186e-05,0.7142857142857143
13028,13028,알리시아/Noun,7,5,2,7.780371234856063e-05,4.4425686932184186e-05,0.7142857142857143
13029,13029,전력/Noun,7,2,5,4.445926419917751e-05,7.774495213132233e-05,0.7142857142857143
13030,13030,정말루/Noun,7,5,2,7.780371234856063e-05,4.4425686932184186e-05,0.7142857142857143
13031,13031,덩이/Noun,7,2,5,4.445926419917751e-05,7.774495213132233e-05,0.7142857142857143
13032,13032,대선/Noun,7,2,5,4.445926419917751e-05,7.774495213132233e-05,0.7142857142857143
13033,13033,have/Alpha,7,5,2,7.780371234856063e-05,4.4425686932184186e-05,0.7142857142857143
13034,13034,better/Alpha,7,2,5,4.445926419917751e-05,7.774495213132233e-05,0.7142857142857143
13035,13035,강제규/Noun,7,2,5,4.445926419917751e-05,7.774495213132233e-05,0.7142857142857143
13036,13036,왕실/Noun,7,5,2,7.780371234856063e-05,4.4425686932184186e-05,0.7142857142857143
13037,13037,리턴/Noun,7,5,2,7.780371234856063e-05,4.4425686932184186e-05,0.7142857142857143
13038,13038,미제/Noun,7,2,5,4.445926419917751e-05,7.774495213132233e-05,0.7142857142857143
13039,13039,그었다/Noun,7,5,2,7.780371234856063e-05,4.4425686932184186e-05,0.7142857142857143
13040,13040,중력/Noun,7,5,2,7.780371234856063e-05,4.4425686932184186e-05,0.7142857142857143
13041,13041,1982년/Number,7,5,2,7.780371234856063e-05,4.4425686932184186e-05,0.7142857142857143
13042,13042,이심/Noun,7,5,2,7.780371234856063e-05,4.4425686932184186e-05,0.7142857142857143
13043,13043,무녀/Noun,7,2,5,4.445926419917751e-05,7.774495213132233e-05,0.7142857142857143
13044,13044,갈대/Noun,7,2,5,4.445926419917751e-05,7.774495213132233e-05,0.7142857142857143
13045,13045,루스/Noun,7,2,5,4.445926419917751e-05,7.774495213132233e-05,0.7142857142857143
13046,13046,jtbc/Alpha,7,5,2,7.780371234856063e-05,4.4425686932184186e-05,0.7142857142857143
13047,13047,어림/Noun,7,2,5,4.445926419917751e-05,7.774495213132233e-05,0.7142857142857143
13048,13048,출세작/Noun,7,5,2,7.780371234856063e-05,4.4425686932184186e-05,0.7142857142857143
13049,13049,나카시마/Noun,7,5,2,7.780371234856063e-05,4.4425686932184186e-05,0.7142857142857143
13050,13050,협력/Noun,7,5,2,7.780371234856063e-05,4.4425686932184186e-05,0.7142857142857143
13051,13051,이수/Noun,7,5,2,7.780371234856063e-05,4.4425686932184186e-05,0.7142857142857143
13052,13052,대량/Noun,7,2,5,4.445926419917751e-05,7.774495213132233e-05,0.7142857142857143
13053,13053,감지덕지/Noun,7,2,5,4.445926419917751e-05,7.774495213132233e-05,0.7142857142857143
13054,13054,111/Number,7,5,2,7.780371234856063e-05,4.4425686932184186e-05,0.7142857142857143
13055,13055,측/Suffix,7,2,5,4.445926419917751e-05,7.774495213132233e-05,0.7142857142857143
13056,13056,중도/Noun,7,2,5,4.445926419917751e-05,7.774495213132233e-05,0.7142857142857143
13057,13057,왕족/Noun,7,2,5,4.445926419917751e-05,7.774495213132233e-05,0.7142857142857143
13058,13058,가루지기/Noun,7,2,5,4.445926419917751e-05,7.774495213132233e-05,0.7142857142857143
13059,13059,지자/Noun,7,2,5,4.445926419917751e-05,7.774495213132233e-05,0.7142857142857143
13060,13060,로얄/Noun,7,2,5,4.445926419917751e-05,7.774495213132233e-05,0.7142857142857143
13061,13061,타일러/Noun,7,2,5,4.445926419917751e-05,7.774495213132233e-05,0.7142857142857143
13062,13062,오늘밤/Noun,7,5,2,7.780371234856063e-05,4.4425686932184186e-05,0.7142857142857143
13063,13063,농사/Noun,7,2,5,4.445926419917751e-05,7.774495213132233e-05,0.7142857142857143
13064,13064,무거/Noun,7,5,2,7.780371234856063e-05,4.4425686932184186e-05,0.7142857142857143
13065,13065,컴터/Noun,7,2,5,4.445926419917751e-05,7.774495213132233e-05,0.7142857142857143
13066,13066,일당/Noun,7,5,2,7.780371234856063e-05,4.4425686932184186e-05,0.7142857142857143
13067,13067,/////Punctuation,7,2,5,4.445926419917751e-05,7.774495213132233e-05,0.7142857142857143
13068,13068,캐치/Noun,7,5,2,7.780371234856063e-05,4.4425686932184186e-05,0.7142857142857143
13069,13069,당선/Noun,7,2,5,4.445926419917751e-05,7.774495213132233e-05,0.7142857142857143
13070,13070,행진/Noun,7,2,5,4.445926419917751e-05,7.774495213132233e-05,0.7142857142857143
13071,13071,아수라/Noun,7,5,2,7.780371234856063e-05,4.4425686932184186e-05,0.7142857142857143
13072,13072,86년/Number,7,5,2,7.780371234856063e-05,4.4425686932184186e-05,0.7142857142857143
13073,13073,가물/Noun,7,5,2,7.780371234856063e-05,4.4425686932184186e-05,0.7142857142857143
13074,13074,김용/Noun,7,5,2,7.780371234856063e-05,4.4425686932184186e-05,0.7142857142857143
13075,13075,누굴까/Adverb,7,2,5,4.445926419917751e-05,7.774495213132233e-05,0.7142857142857143
13076,13076,전계/Noun,7,2,5,4.445926419917751e-05,7.774495213132233e-05,0.7142857142857143
13077,13077,지난번/Noun,7,5,2,7.780371234856063e-05,4.4425686932184186e-05,0.7142857142857143
13078,13078,궂/Noun,7,2,5,4.445926419917751e-05,7.774495213132233e-05,0.7142857142857143
13079,13079,악질/Noun,7,2,5,4.445926419917751e-05,7.774495213132233e-05,0.7142857142857143
13080,13080,지탱/Noun,7,5,2,7.780371234856063e-05,4.4425686932184186e-05,0.7142857142857143
13081,13081,경박하다/Adjective,7,2,5,4.445926419917751e-05,7.774495213132233e-05,0.7142857142857143
13082,13082,수컷/Noun,7,5,2,7.780371234856063e-05,4.4425686932184186e-05,0.7142857142857143
13083,13083,이개/Noun,7,2,5,4.445926419917751e-05,7.774495213132233e-05,0.7142857142857143
13084,13084,호세/Noun,7,5,2,7.780371234856063e-05,4.4425686932184186e-05,0.7142857142857143
13085,13085,의혹/Noun,7,2,5,4.445926419917751e-05,7.774495213132233e-05,0.7142857142857143
13086,13086,악동/Noun,7,5,2,7.780371234856063e-05,4.4425686932184186e-05,0.7142857142857143
13087,13087,풍기/Noun,7,2,5,4.445926419917751e-05,7.774495213132233e-05,0.7142857142857143
13088,13088,토니쟈/Noun,7,2,5,4.445926419917751e-05,7.774495213132233e-05,0.7142857142857143
13089,13089,번외편/Noun,7,5,2,7.780371234856063e-05,4.4425686932184186e-05,0.7142857142857143
13090,13090,일개/Noun,7,2,5,4.445926419917751e-05,7.774495213132233e-05,0.7142857142857143
13091,13091,ㅠㅡㅜ/KoreanParticle,7,5,2,7.780371234856063e-05,4.4425686932184186e-05,0.7142857142857143
13092,13092,테오/Noun,7,5,2,7.780371234856063e-05,4.4425686932184186e-05,0.7142857142857143
13093,13093,나불/Noun,7,5,2,7.780371234856063e-05,4.4425686932184186e-05,0.7142857142857143
13094,13094,몹/Noun,7,5,2,7.780371234856063e-05,4.4425686932184186e-05,0.7142857142857143
13095,13095,갸/Noun,7,5,2,7.780371234856063e-05,4.4425686932184186e-05,0.7142857142857143
13096,13096,엮어/Noun,7,2,5,4.445926419917751e-05,7.774495213132233e-05,0.7142857142857143
13097,13097,모라/Noun,7,2,5,4.445926419917751e-05,7.774495213132233e-05,0.7142857142857143
13098,13098,소굴/Noun,7,2,5,4.445926419917751e-05,7.774495213132233e-05,0.7142857142857143
13099,13099,did/Alpha,7,5,2,7.780371234856063e-05,4.4425686932184186e-05,0.7142857142857143
13100,13100,내셔널/Noun,7,2,5,4.445926419917751e-05,7.774495213132233e-05,0.7142857142857143
13101,13101,풍속/Noun,7,2,5,4.445926419917751e-05,7.774495213132233e-05,0.7142857142857143
13102,13102,스팩/Noun,7,2,5,4.445926419917751e-05,7.774495213132233e-05,0.7142857142857143
13103,13103,괜시리/Noun,7,5,2,7.780371234856063e-05,4.4425686932184186e-05,0.7142857142857143
13104,13104,뒷받침/Noun,7,2,5,4.445926419917751e-05,7.774495213132233e-05,0.7142857142857143
13105,13105,=_=/Punctuation,7,2,5,4.445926419917751e-05,7.774495213132233e-05,0.7142857142857143
13106,13106,당하/Noun,7,2,5,4.445926419917751e-05,7.774495213132233e-05,0.7142857142857143
13107,13107,문학관/Noun,7,2,5,4.445926419917751e-05,7.774495213132233e-05,0.7142857142857143
13108,13108,말씀드리다/Verb,7,5,2,7.780371234856063e-05,4.4425686932184186e-05,0.7142857142857143
13109,13109,나가요/Noun,7,2,5,4.445926419917751e-05,7.774495213132233e-05,0.7142857142857143
13110,13110,똘똘/Noun,7,2,5,4.445926419917751e-05,7.774495213132233e-05,0.7142857142857143
13111,13111,블룸/Noun,7,2,5,4.445926419917751e-05,7.774495213132233e-05,0.7142857142857143
13112,13112,잔다르크/Noun,7,5,2,7.780371234856063e-05,4.4425686932184186e-05,0.7142857142857143
13113,13113,남지현/Noun,7,4,3,6.668889629876625e-05,5.553210866523024e-05,0.5714285714285714
13114,13114,버스터/Noun,7,3,4,5.5574080248971876e-05,6.663853039827628e-05,0.5714285714285714
13115,13115,시베리아/Noun,7,4,3,6.668889629876625e-05,5.553210866523024e-05,0.5714285714285714
13116,13116,멜로드라마/Noun,7,4,3,6.668889629876625e-05,5.553210866523024e-05,0.5714285714285714
13117,13117,에반스/Noun,7,4,3,6.668889629876625e-05,5.553210866523024e-05,0.5714285714285714
13118,13118,캐스트/Noun,7,4,3,6.668889629876625e-05,5.553210866523024e-05,0.5714285714285714
13119,13119,옥수수/Noun,7,3,4,5.5574080248971876e-05,6.663853039827628e-05,0.5714285714285714
13120,13120,루프/Noun,7,3,4,5.5574080248971876e-05,6.663853039827628e-05,0.5714285714285714
13121,13121,국수/Noun,7,3,4,5.5574080248971876e-05,6.663853039827628e-05,0.5714285714285714
13122,13122,김원희/Noun,7,4,3,6.668889629876625e-05,5.553210866523024e-05,0.5714285714285714
13123,13123,호가/Noun,7,3,4,5.5574080248971876e-05,6.663853039827628e-05,0.5714285714285714
13124,13124,내장/Noun,7,3,4,5.5574080248971876e-05,6.663853039827628e-05,0.5714285714285714
13125,13125,부흥/Noun,7,4,3,6.668889629876625e-05,5.553210866523024e-05,0.5714285714285714
13126,13126,구가의서/Noun,7,4,3,6.668889629876625e-05,5.553210866523024e-05,0.5714285714285714
13127,13127,미혼모/Noun,7,3,4,5.5574080248971876e-05,6.663853039827628e-05,0.5714285714285714
13128,13128,암투/Noun,7,3,4,5.5574080248971876e-05,6.663853039827628e-05,0.5714285714285714
13129,13129,원동력/Noun,7,4,3,6.668889629876625e-05,5.553210866523024e-05,0.5714285714285714
13130,13130,생김새/Noun,7,3,4,5.5574080248971876e-05,6.663853039827628e-05,0.5714285714285714
13131,13131,억눌리다/Verb,7,4,3,6.668889629876625e-05,5.553210866523024e-05,0.5714285714285714
13132,13132,셰프/Noun,7,3,4,5.5574080248971876e-05,6.663853039827628e-05,0.5714285714285714
13133,13133,입안/Noun,7,3,4,5.5574080248971876e-05,6.663853039827628e-05,0.5714285714285714
13134,13134,평일/Noun,7,4,3,6.668889629876625e-05,5.553210866523024e-05,0.5714285714285714
13135,13135,자알/Noun,7,3,4,5.5574080248971876e-05,6.663853039827628e-05,0.5714285714285714
13136,13136,카메라워크/Noun,7,3,4,5.5574080248971876e-05,6.663853039827628e-05,0.5714285714285714
13137,13137,콧/Noun,7,4,3,6.668889629876625e-05,5.553210866523024e-05,0.5714285714285714
13138,13138,곰팡이/Noun,7,3,4,5.5574080248971876e-05,6.663853039827628e-05,0.5714285714285714
13139,13139,왕좌/Noun,7,4,3,6.668889629876625e-05,5.553210866523024e-05,0.5714285714285714
13140,13140,저격수/Noun,7,4,3,6.668889629876625e-05,5.553210866523024e-05,0.5714285714285714
13141,13141,부위/Noun,7,3,4,5.5574080248971876e-05,6.663853039827628e-05,0.5714285714285714
13142,13142,미셀/Noun,7,3,4,5.5574080248971876e-05,6.663853039827628e-05,0.5714285714285714
13143,13143,쌔/Noun,7,4,3,6.668889629876625e-05,5.553210866523024e-05,0.5714285714285714
13144,13144,안토니오/Noun,7,4,3,6.668889629876625e-05,5.553210866523024e-05,0.5714285714285714
13145,13145,팬임/Noun,7,3,4,5.5574080248971876e-05,6.663853039827628e-05,0.5714285714285714
13146,13146,혜리/Noun,7,3,4,5.5574080248971876e-05,6.663853039827628e-05,0.5714285714285714
13147,13147,바른/Modifier,7,4,3,6.668889629876625e-05,5.553210866523024e-05,0.5714285714285714
13148,13148,무의미/Noun,7,3,4,5.5574080248971876e-05,6.663853039827628e-05,0.5714285714285714
13149,13149,부시맨/Noun,7,4,3,6.668889629876625e-05,5.553210866523024e-05,0.5714285714285714
13150,13150,대물/Noun,7,3,4,5.5574080248971876e-05,6.663853039827628e-05,0.5714285714285714
13151,13151,뽑기/Noun,7,4,3,6.668889629876625e-05,5.553210866523024e-05,0.5714285714285714
13152,13152,태현/Noun,7,3,4,5.5574080248971876e-05,6.663853039827628e-05,0.5714285714285714
13153,13153,풋볼/Noun,7,3,4,5.5574080248971876e-05,6.663853039827628e-05,0.5714285714285714
13154,13154,델마/Noun,7,3,4,5.5574080248971876e-05,6.663853039827628e-05,0.5714285714285714
13155,13155,최양일/Noun,7,3,4,5.5574080248971876e-05,6.663853039827628e-05,0.5714285714285714
13156,13156,편리하다/Adjective,7,3,4,5.5574080248971876e-05,6.663853039827628e-05,0.5714285714285714
13157,13157,가로/Noun,7,4,3,6.668889629876625e-05,5.553210866523024e-05,0.5714285714285714
13158,13158,선댄스/Noun,7,3,4,5.5574080248971876e-05,6.663853039827628e-05,0.5714285714285714
13159,13159,황진/Noun,7,4,3,6.668889629876625e-05,5.553210866523024e-05,0.5714285714285714
13160,13160,동명/Noun,7,3,4,5.5574080248971876e-05,6.663853039827628e-05,0.5714285714285714
13161,13161,4시/Number,7,4,3,6.668889629876625e-05,5.553210866523024e-05,0.5714285714285714
13162,13162,인형극/Noun,7,4,3,6.668889629876625e-05,5.553210866523024e-05,0.5714285714285714
13163,13163,전경/Noun,7,3,4,5.5574080248971876e-05,6.663853039827628e-05,0.5714285714285714
13164,13164,화피/Noun,7,4,3,6.668889629876625e-05,5.553210866523024e-05,0.5714285714285714
13165,13165,정은/Noun,7,4,3,6.668889629876625e-05,5.553210866523024e-05,0.5714285714285714
13166,13166,웅담/Noun,7,3,4,5.5574080248971876e-05,6.663853039827628e-05,0.5714285714285714
13167,13167,고경표/Noun,7,3,4,5.5574080248971876e-05,6.663853039827628e-05,0.5714285714285714
13168,13168,마릴/Noun,7,3,4,5.5574080248971876e-05,6.663853039827628e-05,0.5714285714285714
13169,13169,기술자/Noun,7,3,4,5.5574080248971876e-05,6.663853039827628e-05,0.5714285714285714
13170,13170,고온/Noun,7,4,3,6.668889629876625e-05,5.553210866523024e-05,0.5714285714285714
13171,13171,순하다/Adjective,7,4,3,6.668889629876625e-05,5.553210866523024e-05,0.5714285714285714
13172,13172,실실/Noun,7,3,4,5.5574080248971876e-05,6.663853039827628e-05,0.5714285714285714
13173,13173,프렌드/Noun,7,4,3,6.668889629876625e-05,5.553210866523024e-05,0.5714285714285714
13174,13174,최재성/Noun,7,4,3,6.668889629876625e-05,5.553210866523024e-05,0.5714285714285714
13175,13175,뒤끝/Noun,7,4,3,6.668889629876625e-05,5.553210866523024e-05,0.5714285714285714
13176,13176,홀트/Noun,7,4,3,6.668889629876625e-05,5.553210866523024e-05,0.5714285714285714
13177,13177,미드나잇/Noun,7,4,3,6.668889629876625e-05,5.553210866523024e-05,0.5714285714285714
13178,13178,고종/Noun,7,4,3,6.668889629876625e-05,5.553210866523024e-05,0.5714285714285714
13179,13179,가량/Noun,7,4,3,6.668889629876625e-05,5.553210866523024e-05,0.5714285714285714
13180,13180,슈주/Noun,7,4,3,6.668889629876625e-05,5.553210866523024e-05,0.5714285714285714
13181,13181,마스터링/Noun,7,4,3,6.668889629876625e-05,5.553210866523024e-05,0.5714285714285714
13182,13182,신성록/Noun,7,3,4,5.5574080248971876e-05,6.663853039827628e-05,0.5714285714285714
13183,13183,봤슴/Noun,7,4,3,6.668889629876625e-05,5.553210866523024e-05,0.5714285714285714
13184,13184,평민/Noun,7,3,4,5.5574080248971876e-05,6.663853039827628e-05,0.5714285714285714
13185,13185,태클/Noun,7,4,3,6.668889629876625e-05,5.553210866523024e-05,0.5714285714285714
13186,13186,백이/Noun,7,3,4,5.5574080248971876e-05,6.663853039827628e-05,0.5714285714285714
13187,13187,말입/Noun,7,3,4,5.5574080248971876e-05,6.663853039827628e-05,0.5714285714285714
13188,13188,터너/Noun,7,3,4,5.5574080248971876e-05,6.663853039827628e-05,0.5714285714285714
13189,13189,뎌/Modifier,7,3,4,5.5574080248971876e-05,6.663853039827628e-05,0.5714285714285714
13190,13190,21년/Number,7,3,4,5.5574080248971876e-05,6.663853039827628e-05,0.5714285714285714
13191,13191,불만족/Noun,7,3,4,5.5574080248971876e-05,6.663853039827628e-05,0.5714285714285714
13192,13192,확고하다/Adjective,7,4,3,6.668889629876625e-05,5.553210866523024e-05,0.5714285714285714
13193,13193,청담동/Noun,7,3,4,5.5574080248971876e-05,6.663853039827628e-05,0.5714285714285714
13194,13194,가주/Noun,7,4,3,6.668889629876625e-05,5.553210866523024e-05,0.5714285714285714
13195,13195,평안/Noun,7,4,3,6.668889629876625e-05,5.553210866523024e-05,0.5714285714285714
13196,13196,이단/Noun,7,3,4,5.5574080248971876e-05,6.663853039827628e-05,0.5714285714285714
13197,13197,호기/Noun,7,3,4,5.5574080248971876e-05,6.663853039827628e-05,0.5714285714285714
13198,13198,용소/Noun,7,3,4,5.5574080248971876e-05,6.663853039827628e-05,0.5714285714285714
13199,13199,얼릉/Noun,7,4,3,6.668889629876625e-05,5.553210866523024e-05,0.5714285714285714
13200,13200,북유럽/Noun,7,4,3,6.668889629876625e-05,5.553210866523024e-05,0.5714285714285714
13201,13201,SNL/Alpha,7,3,4,5.5574080248971876e-05,6.663853039827628e-05,0.5714285714285714
13202,13202,테라/Noun,7,4,3,6.668889629876625e-05,5.553210866523024e-05,0.5714285714285714
13203,13203,악기/Noun,7,4,3,6.668889629876625e-05,5.553210866523024e-05,0.5714285714285714
13204,13204,권법/Noun,7,3,4,5.5574080248971876e-05,6.663853039827628e-05,0.5714285714285714
13205,13205,방관/Noun,7,3,4,5.5574080248971876e-05,6.663853039827628e-05,0.5714285714285714
13206,13206,멋찌/Noun,7,4,3,6.668889629876625e-05,5.553210866523024e-05,0.5714285714285714
13207,13207,알트/Noun,7,4,3,6.668889629876625e-05,5.553210866523024e-05,0.5714285714285714
13208,13208,내용물/Noun,7,3,4,5.5574080248971876e-05,6.663853039827628e-05,0.5714285714285714
13209,13209,대미/Noun,7,3,4,5.5574080248971876e-05,6.663853039827628e-05,0.5714285714285714
13210,13210,ㅋㅎ/KoreanParticle,7,3,4,5.5574080248971876e-05,6.663853039827628e-05,0.5714285714285714
13211,13211,오노/Noun,7,4,3,6.668889629876625e-05,5.553210866523024e-05,0.5714285714285714
13212,13212,되살리다/Verb,7,4,3,6.668889629876625e-05,5.553210866523024e-05,0.5714285714285714
13213,13213,물음/Noun,7,4,3,6.668889629876625e-05,5.553210866523024e-05,0.5714285714285714
13214,13214,오잉/Noun,7,3,4,5.5574080248971876e-05,6.663853039827628e-05,0.5714285714285714
13215,13215,이그/Noun,7,3,4,5.5574080248971876e-05,6.663853039827628e-05,0.5714285714285714
13216,13216,발동/Noun,7,4,3,6.668889629876625e-05,5.553210866523024e-05,0.5714285714285714
13217,13217,뭉치/Noun,7,3,4,5.5574080248971876e-05,6.663853039827628e-05,0.5714285714285714
13218,13218,떳/Noun,7,3,4,5.5574080248971876e-05,6.663853039827628e-05,0.5714285714285714
13219,13219,로세/Josa,7,4,3,6.668889629876625e-05,5.553210866523024e-05,0.5714285714285714
13220,13220,만배/Noun,7,3,4,5.5574080248971876e-05,6.663853039827628e-05,0.5714285714285714
13221,13221,고품격/Noun,7,4,3,6.668889629876625e-05,5.553210866523024e-05,0.5714285714285714
13222,13222,시비/Noun,7,3,4,5.5574080248971876e-05,6.663853039827628e-05,0.5714285714285714
13223,13223,걱정스럽다/Adjective,7,3,4,5.5574080248971876e-05,6.663853039827628e-05,0.5714285714285714
13224,13224,보통사람/Noun,7,3,4,5.5574080248971876e-05,6.663853039827628e-05,0.5714285714285714
13225,13225,불리/Noun,7,3,4,5.5574080248971876e-05,6.663853039827628e-05,0.5714285714285714
13226,13226,불공평하다/Adjective,7,4,3,6.668889629876625e-05,5.553210866523024e-05,0.5714285714285714
13227,13227,활발하다/Adjective,7,3,4,5.5574080248971876e-05,6.663853039827628e-05,0.5714285714285714
13228,13228,어택/Noun,7,3,4,5.5574080248971876e-05,6.663853039827628e-05,0.5714285714285714
13229,13229,선샤인/Noun,7,4,3,6.668889629876625e-05,5.553210866523024e-05,0.5714285714285714
13230,13230,수요/Noun,7,3,4,5.5574080248971876e-05,6.663853039827628e-05,0.5714285714285714
13231,13231,단발머리/Noun,7,4,3,6.668889629876625e-05,5.553210866523024e-05,0.5714285714285714
13232,13232,찮/Noun,7,4,3,6.668889629876625e-05,5.553210866523024e-05,0.5714285714285714
13233,13233,으앙/Adverb,7,3,4,5.5574080248971876e-05,6.663853039827628e-05,0.5714285714285714
13234,13234,부업/Noun,7,3,4,5.5574080248971876e-05,6.663853039827628e-05,0.5714285714285714
13235,13235,카지노/Noun,7,3,4,5.5574080248971876e-05,6.663853039827628e-05,0.5714285714285714
13236,13236,박쥐/Noun,7,3,4,5.5574080248971876e-05,6.663853039827628e-05,0.5714285714285714
13237,13237,젠더/Noun,7,3,4,5.5574080248971876e-05,6.663853039827628e-05,0.5714285714285714
13238,13238,마가/Noun,7,3,4,5.5574080248971876e-05,6.663853039827628e-05,0.5714285714285714
13239,13239,All/Alpha,7,4,3,6.668889629876625e-05,5.553210866523024e-05,0.5714285714285714
13240,13240,하듯/Eomi,7,4,3,6.668889629876625e-05,5.553210866523024e-05,0.5714285714285714
13241,13241,타샤/Noun,7,4,3,6.668889629876625e-05,5.553210866523024e-05,0.5714285714285714
13242,13242,사키/Noun,7,4,3,6.668889629876625e-05,5.553210866523024e-05,0.5714285714285714
13243,13243,오카다/Noun,7,3,4,5.5574080248971876e-05,6.663853039827628e-05,0.5714285714285714
13244,13244,뽐내다/Verb,7,3,4,5.5574080248971876e-05,6.663853039827628e-05,0.5714285714285714
13245,13245,이티/Noun,7,4,3,6.668889629876625e-05,5.553210866523024e-05,0.5714285714285714
13246,13246,엔터테인먼트/Noun,7,4,3,6.668889629876625e-05,5.553210866523024e-05,0.5714285714285714
13247,13247,이라고도/Josa,7,4,3,6.668889629876625e-05,5.553210866523024e-05,0.5714285714285714
13248,13248,피구/Noun,7,3,4,5.5574080248971876e-05,6.663853039827628e-05,0.5714285714285714
13249,13249,08년/Number,7,4,3,6.668889629876625e-05,5.553210866523024e-05,0.5714285714285714
13250,13250,쳇/Exclamation,7,3,4,5.5574080248971876e-05,6.663853039827628e-05,0.5714285714285714
13251,13251,전멸/Noun,7,4,3,6.668889629876625e-05,5.553210866523024e-05,0.5714285714285714
13252,13252,고화질/Noun,7,4,3,6.668889629876625e-05,5.553210866523024e-05,0.5714285714285714
13253,13253,미완성/Noun,7,3,4,5.5574080248971876e-05,6.663853039827628e-05,0.5714285714285714
13254,13254,제주/Noun,7,4,3,6.668889629876625e-05,5.553210866523024e-05,0.5714285714285714
13255,13255,불감증/Noun,7,3,4,5.5574080248971876e-05,6.663853039827628e-05,0.5714285714285714
13256,13256,한신/Noun,7,4,3,6.668889629876625e-05,5.553210866523024e-05,0.5714285714285714
13257,13257,간나/Noun,7,3,4,5.5574080248971876e-05,6.663853039827628e-05,0.5714285714285714
13258,13258,프레이저/Noun,7,4,3,6.668889629876625e-05,5.553210866523024e-05,0.5714285714285714
13259,13259,번더/Noun,7,3,4,5.5574080248971876e-05,6.663853039827628e-05,0.5714285714285714
13260,13260,수익/Noun,7,3,4,5.5574080248971876e-05,6.663853039827628e-05,0.5714285714285714
13261,13261,show/Alpha,7,3,4,5.5574080248971876e-05,6.663853039827628e-05,0.5714285714285714
13262,13262,IS/Alpha,7,4,3,6.668889629876625e-05,5.553210866523024e-05,0.5714285714285714
13263,13263,현역/Noun,7,3,4,5.5574080248971876e-05,6.663853039827628e-05,0.5714285714285714
13264,13264,첸/Noun,7,4,3,6.668889629876625e-05,5.553210866523024e-05,0.5714285714285714
13265,13265,판다/Noun,7,3,4,5.5574080248971876e-05,6.663853039827628e-05,0.5714285714285714
13266,13266,복수심/Noun,7,3,4,5.5574080248971876e-05,6.663853039827628e-05,0.5714285714285714
13267,13267,어마/Exclamation,7,4,3,6.668889629876625e-05,5.553210866523024e-05,0.5714285714285714
13268,13268,.//Punctuation,7,3,4,5.5574080248971876e-05,6.663853039827628e-05,0.5714285714285714
13269,13269,철부지/Noun,7,3,4,5.5574080248971876e-05,6.663853039827628e-05,0.5714285714285714
13270,13270,더씽/Noun,7,3,4,5.5574080248971876e-05,6.663853039827628e-05,0.5714285714285714
13271,13271,눅눅하다/Adjective,7,4,3,6.668889629876625e-05,5.553210866523024e-05,0.5714285714285714
13272,13272,당돌하다/Adjective,7,3,4,5.5574080248971876e-05,6.663853039827628e-05,0.5714285714285714
13273,13273,자칫하면/Noun,7,4,3,6.668889629876625e-05,5.553210866523024e-05,0.5714285714285714
13274,13274,으스스하다/Adjective,7,4,3,6.668889629876625e-05,5.553210866523024e-05,0.5714285714285714
13275,13275,동막골/Noun,7,4,3,6.668889629876625e-05,5.553210866523024e-05,0.5714285714285714
13276,13276,허진호/Noun,7,4,3,6.668889629876625e-05,5.553210866523024e-05,0.5714285714285714
13277,13277,전자/Noun,7,3,4,5.5574080248971876e-05,6.663853039827628e-05,0.5714285714285714
13278,13278,女/Foreign,7,3,4,5.5574080248971876e-05,6.663853039827628e-05,0.5714285714285714
13279,13279,하은/Noun,7,3,4,5.5574080248971876e-05,6.663853039827628e-05,0.5714285714285714
13280,13280,식인/Noun,7,3,4,5.5574080248971876e-05,6.663853039827628e-05,0.5714285714285714
13281,13281,팬서비스/Noun,7,4,3,6.668889629876625e-05,5.553210866523024e-05,0.5714285714285714
13282,13282,이두용/Noun,7,3,4,5.5574080248971876e-05,6.663853039827628e-05,0.5714285714285714
13283,13283,발버둥/Noun,7,3,4,5.5574080248971876e-05,6.663853039827628e-05,0.5714285714285714
13284,13284,카야/Noun,7,4,3,6.668889629876625e-05,5.553210866523024e-05,0.5714285714285714
13285,13285,이신/Noun,7,4,3,6.668889629876625e-05,5.553210866523024e-05,0.5714285714285714
13286,13286,미혼/Noun,7,3,4,5.5574080248971876e-05,6.663853039827628e-05,0.5714285714285714
13287,13287,규칙/Noun,7,4,3,6.668889629876625e-05,5.553210866523024e-05,0.5714285714285714
13288,13288,러/Eomi,7,3,4,5.5574080248971876e-05,6.663853039827628e-05,0.5714285714285714
13289,13289,얼씬/Noun,7,3,4,5.5574080248971876e-05,6.663853039827628e-05,0.5714285714285714
13290,13290,훠/Noun,7,3,4,5.5574080248971876e-05,6.663853039827628e-05,0.5714285714285714
13291,13291,헝/Noun,7,4,3,6.668889629876625e-05,5.553210866523024e-05,0.5714285714285714
13292,13292,?~/Punctuation,7,3,4,5.5574080248971876e-05,6.663853039827628e-05,0.5714285714285714
13293,13293,밀당/Noun,7,3,4,5.5574080248971876e-05,6.663853039827628e-05,0.5714285714285714
13294,13294,노련하다/Adjective,7,4,3,6.668889629876625e-05,5.553210866523024e-05,0.5714285714285714
13295,13295,더프/Noun,7,4,3,6.668889629876625e-05,5.553210866523024e-05,0.5714285714285714
13296,13296,수백/Noun,7,3,4,5.5574080248971876e-05,6.663853039827628e-05,0.5714285714285714
13297,13297,oh/Alpha,7,4,3,6.668889629876625e-05,5.553210866523024e-05,0.5714285714285714
13298,13298,수련/Noun,7,3,4,5.5574080248971876e-05,6.663853039827628e-05,0.5714285714285714
13299,13299,봣는대/Noun,7,4,3,6.668889629876625e-05,5.553210866523024e-05,0.5714285714285714
13300,13300,돌려차기/Noun,7,3,4,5.5574080248971876e-05,6.663853039827628e-05,0.5714285714285714
13301,13301,반환/Noun,7,3,4,5.5574080248971876e-05,6.663853039827628e-05,0.5714285714285714
13302,13302,부문/Noun,7,4,3,6.668889629876625e-05,5.553210866523024e-05,0.5714285714285714
13303,13303,모스/Noun,7,4,3,6.668889629876625e-05,5.553210866523024e-05,0.5714285714285714
13304,13304,소도/Noun,7,3,4,5.5574080248971876e-05,6.663853039827628e-05,0.5714285714285714
13305,13305,개탄/Noun,7,4,3,6.668889629876625e-05,5.553210866523024e-05,0.5714285714285714
13306,13306,순도/Noun,7,4,3,6.668889629876625e-05,5.553210866523024e-05,0.5714285714285714
13307,13307,허위/Noun,7,3,4,5.5574080248971876e-05,6.663853039827628e-05,0.5714285714285714
13308,13308,방망이/Noun,7,3,4,5.5574080248971876e-05,6.663853039827628e-05,0.5714285714285714
13309,13309,비례/Noun,7,3,4,5.5574080248971876e-05,6.663853039827628e-05,0.5714285714285714
13310,13310,상우/Noun,7,4,3,6.668889629876625e-05,5.553210866523024e-05,0.5714285714285714
13311,13311,젠틀맨/Noun,7,4,3,6.668889629876625e-05,5.553210866523024e-05,0.5714285714285714
13312,13312,22년/Number,7,4,3,6.668889629876625e-05,5.553210866523024e-05,0.5714285714285714
13313,13313,생도/Noun,7,4,3,6.668889629876625e-05,5.553210866523024e-05,0.5714285714285714
13314,13314,티벳/Noun,7,4,3,6.668889629876625e-05,5.553210866523024e-05,0.5714285714285714
13315,13315,철학자/Noun,7,3,4,5.5574080248971876e-05,6.663853039827628e-05,0.5714285714285714
13316,13316,무거워/Noun,7,4,3,6.668889629876625e-05,5.553210866523024e-05,0.5714285714285714
13317,13317,사료/Noun,7,3,4,5.5574080248971876e-05,6.663853039827628e-05,0.5714285714285714
13318,13318,기량/Noun,7,4,3,6.668889629876625e-05,5.553210866523024e-05,0.5714285714285714
13319,13319,야야/Noun,7,4,3,6.668889629876625e-05,5.553210866523024e-05,0.5714285714285714
13320,13320,마침/Noun,7,3,4,5.5574080248971876e-05,6.663853039827628e-05,0.5714285714285714
13321,13321,마흔/Noun,7,4,3,6.668889629876625e-05,5.553210866523024e-05,0.5714285714285714
13322,13322,레시피/Noun,7,4,3,6.668889629876625e-05,5.553210866523024e-05,0.5714285714285714
13323,13323,바닐라/Noun,7,3,4,5.5574080248971876e-05,6.663853039827628e-05,0.5714285714285714
13324,13324,<</Punctuation,7,4,3,6.668889629876625e-05,5.553210866523024e-05,0.5714285714285714
13325,13325,사리다/Verb,7,4,3,6.668889629876625e-05,5.553210866523024e-05,0.5714285714285714
13326,13326,심령/Noun,7,4,3,6.668889629876625e-05,5.553210866523024e-05,0.5714285714285714
13327,13327,얀/Noun,7,3,4,5.5574080248971876e-05,6.663853039827628e-05,0.5714285714285714
13328,13328,미스트/Noun,7,3,4,5.5574080248971876e-05,6.663853039827628e-05,0.5714285714285714
13329,13329,스컬리/Noun,7,4,3,6.668889629876625e-05,5.553210866523024e-05,0.5714285714285714
13330,13330,교본/Noun,7,4,3,6.668889629876625e-05,5.553210866523024e-05,0.5714285714285714
13331,13331,폴더/Noun,7,4,3,6.668889629876625e-05,5.553210866523024e-05,0.5714285714285714
13332,13332,들추다/Verb,7,4,3,6.668889629876625e-05,5.553210866523024e-05,0.5714285714285714
13333,13333,불안정하다/Adjective,7,3,4,5.5574080248971876e-05,6.663853039827628e-05,0.5714285714285714
13334,13334,나루/Noun,7,3,4,5.5574080248971876e-05,6.663853039827628e-05,0.5714285714285714
13335,13335,양지/Noun,7,3,4,5.5574080248971876e-05,6.663853039827628e-05,0.5714285714285714
13336,13336,의사소통/Noun,7,3,4,5.5574080248971876e-05,6.663853039827628e-05,0.5714285714285714
13337,13337,타츠야/Noun,7,4,3,6.668889629876625e-05,5.553210866523024e-05,0.5714285714285714
13338,13338,낙오/Noun,7,4,3,6.668889629876625e-05,5.553210866523024e-05,0.5714285714285714
13339,13339,기억상실증/Noun,7,4,3,6.668889629876625e-05,5.553210866523024e-05,0.5714285714285714
13340,13340,원투/Noun,7,3,4,5.5574080248971876e-05,6.663853039827628e-05,0.5714285714285714
13341,13341,~~`/Punctuation,7,4,3,6.668889629876625e-05,5.553210866523024e-05,0.5714285714285714
13342,13342,얼리다/Verb,7,3,4,5.5574080248971876e-05,6.663853039827628e-05,0.5714285714285714
13343,13343,당당/Adverb,7,4,3,6.668889629876625e-05,5.553210866523024e-05,0.5714285714285714
13344,13344,킥애스/Noun,7,4,3,6.668889629876625e-05,5.553210866523024e-05,0.5714285714285714
13345,13345,"!!""/Punctuation",7,3,4,5.5574080248971876e-05,6.663853039827628e-05,0.5714285714285714
13346,13346,태고/Noun,7,3,4,5.5574080248971876e-05,6.663853039827628e-05,0.5714285714285714
13347,13347,꺄악/Noun,7,4,3,6.668889629876625e-05,5.553210866523024e-05,0.5714285714285714
13348,13348,리즈위더스푼/Noun,7,4,3,6.668889629876625e-05,5.553210866523024e-05,0.5714285714285714
13349,13349,타로/Noun,7,4,3,6.668889629876625e-05,5.553210866523024e-05,0.5714285714285714
13350,13350,애드리언/Noun,7,4,3,6.668889629876625e-05,5.553210866523024e-05,0.5714285714285714
13351,13351,말코/Noun,7,4,3,6.668889629876625e-05,5.553210866523024e-05,0.5714285714285714
13352,13352,레이디/Noun,7,3,4,5.5574080248971876e-05,6.663853039827628e-05,0.5714285714285714
13353,13353,생겨나다/Verb,7,3,4,5.5574080248971876e-05,6.663853039827628e-05,0.5714285714285714
13354,13354,폰트/Noun,7,4,3,6.668889629876625e-05,5.553210866523024e-05,0.5714285714285714
13355,13355,추상미/Noun,7,4,3,6.668889629876625e-05,5.553210866523024e-05,0.5714285714285714
13356,13356,파오/Noun,7,3,4,5.5574080248971876e-05,6.663853039827628e-05,0.5714285714285714
13357,13357,대왕/Noun,7,4,3,6.668889629876625e-05,5.553210866523024e-05,0.5714285714285714
13358,13358,fuck/Alpha,7,3,4,5.5574080248971876e-05,6.663853039827628e-05,0.5714285714285714
13359,13359,후후후/Noun,7,3,4,5.5574080248971876e-05,6.663853039827628e-05,0.5714285714285714
13360,13360,'?/Punctuation,7,3,4,5.5574080248971876e-05,6.663853039827628e-05,0.5714285714285714
13361,13361,오토/Noun,7,3,4,5.5574080248971876e-05,6.663853039827628e-05,0.5714285714285714
13362,13362,체스/Noun,7,4,3,6.668889629876625e-05,5.553210866523024e-05,0.5714285714285714
13363,13363,무성/Noun,7,3,4,5.5574080248971876e-05,6.663853039827628e-05,0.5714285714285714
13364,13364,씌/Noun,7,4,3,6.668889629876625e-05,5.553210866523024e-05,0.5714285714285714
13365,13365,사물/Noun,7,4,3,6.668889629876625e-05,5.553210866523024e-05,0.5714285714285714
13366,13366,폴란스키/Noun,7,3,4,5.5574080248971876e-05,6.663853039827628e-05,0.5714285714285714
13367,13367,한자리/Noun,7,3,4,5.5574080248971876e-05,6.663853039827628e-05,0.5714285714285714
13368,13368,이기전/Noun,7,4,3,6.668889629876625e-05,5.553210866523024e-05,0.5714285714285714
13369,13369,디저트/Noun,7,4,3,6.668889629876625e-05,5.553210866523024e-05,0.5714285714285714
13370,13370,인과응보/Noun,7,3,4,5.5574080248971876e-05,6.663853039827628e-05,0.5714285714285714
13371,13371,;../Punctuation,7,3,4,5.5574080248971876e-05,6.663853039827628e-05,0.5714285714285714
13372,13372,본의/Noun,7,3,4,5.5574080248971876e-05,6.663853039827628e-05,0.5714285714285714
13373,13373,신앙심/Noun,7,4,3,6.668889629876625e-05,5.553210866523024e-05,0.5714285714285714
13374,13374,발굴/Noun,7,3,4,5.5574080248971876e-05,6.663853039827628e-05,0.5714285714285714
13375,13375,도제/Noun,7,3,4,5.5574080248971876e-05,6.663853039827628e-05,0.5714285714285714
13376,13376,유용하다/Adjective,7,3,4,5.5574080248971876e-05,6.663853039827628e-05,0.5714285714285714
13377,13377,패스트/Noun,7,4,3,6.668889629876625e-05,5.553210866523024e-05,0.5714285714285714
13378,13378,투더/Noun,7,4,3,6.668889629876625e-05,5.553210866523024e-05,0.5714285714285714
13379,13379,나가야/Noun,7,4,3,6.668889629876625e-05,5.553210866523024e-05,0.5714285714285714
13380,13380,대규모/Noun,7,4,3,6.668889629876625e-05,5.553210866523024e-05,0.5714285714285714
13381,13381,전진/Noun,7,4,3,6.668889629876625e-05,5.553210866523024e-05,0.5714285714285714
13382,13382,장단/Noun,7,4,3,6.668889629876625e-05,5.553210866523024e-05,0.5714285714285714
13383,13383,그랜드/Noun,7,3,4,5.5574080248971876e-05,6.663853039827628e-05,0.5714285714285714
13384,13384,회상씬/Noun,7,4,3,6.668889629876625e-05,5.553210866523024e-05,0.5714285714285714
13385,13385,코디/Noun,7,3,4,5.5574080248971876e-05,6.663853039827628e-05,0.5714285714285714
13386,13386,민율/Noun,7,3,4,5.5574080248971876e-05,6.663853039827628e-05,0.5714285714285714
13387,13387,스너프/Noun,7,3,4,5.5574080248971876e-05,6.663853039827628e-05,0.5714285714285714
13388,13388,채운/Noun,7,4,3,6.668889629876625e-05,5.553210866523024e-05,0.5714285714285714
13389,13389,성하/Noun,7,4,3,6.668889629876625e-05,5.553210866523024e-05,0.5714285714285714
13390,13390,마차/Noun,7,4,3,6.668889629876625e-05,5.553210866523024e-05,0.5714285714285714
13391,13391,박명수/Noun,7,3,4,5.5574080248971876e-05,6.663853039827628e-05,0.5714285714285714
13392,13392,고양/Noun,7,3,4,5.5574080248971876e-05,6.663853039827628e-05,0.5714285714285714
13393,13393,48/Number,7,4,3,6.668889629876625e-05,5.553210866523024e-05,0.5714285714285714
13394,13394,만담/Noun,7,3,4,5.5574080248971876e-05,6.663853039827628e-05,0.5714285714285714
13395,13395,9.0/Number,7,4,3,6.668889629876625e-05,5.553210866523024e-05,0.5714285714285714
13396,13396,놨다/Noun,7,4,3,6.668889629876625e-05,5.553210866523024e-05,0.5714285714285714
13397,13397,스폰지밥/Noun,7,4,3,6.668889629876625e-05,5.553210866523024e-05,0.5714285714285714
13398,13398,사촌/Noun,7,3,4,5.5574080248971876e-05,6.663853039827628e-05,0.5714285714285714
13399,13399,첫째/Noun,7,4,3,6.668889629876625e-05,5.553210866523024e-05,0.5714285714285714
13400,13400,ㅇㅏ/KoreanParticle,7,4,3,6.668889629876625e-05,5.553210866523024e-05,0.5714285714285714
13401,13401,총격씬/Noun,7,3,4,5.5574080248971876e-05,6.663853039827628e-05,0.5714285714285714
13402,13402,비엘/Noun,7,4,3,6.668889629876625e-05,5.553210866523024e-05,0.5714285714285714
13403,13403,심리학/Noun,7,4,3,6.668889629876625e-05,5.553210866523024e-05,0.5714285714285714
13404,13404,팬클럽/Noun,7,4,3,6.668889629876625e-05,5.553210866523024e-05,0.5714285714285714
13405,13405,밀레니엄/Noun,7,4,3,6.668889629876625e-05,5.553210866523024e-05,0.5714285714285714
13406,13406,남북전쟁/Noun,7,4,3,6.668889629876625e-05,5.553210866523024e-05,0.5714285714285714
13407,13407,그네/Noun,7,4,3,6.668889629876625e-05,5.553210866523024e-05,0.5714285714285714
13408,13408,명감/Noun,7,4,3,6.668889629876625e-05,5.553210866523024e-05,0.5714285714285714
13409,13409,6시/Number,7,4,3,6.668889629876625e-05,5.553210866523024e-05,0.5714285714285714
13410,13410,슥/Modifier,7,4,3,6.668889629876625e-05,5.553210866523024e-05,0.5714285714285714
13411,13411,쇼타/Noun,7,4,3,6.668889629876625e-05,5.553210866523024e-05,0.5714285714285714
13412,13412,전보/Noun,7,4,3,6.668889629876625e-05,5.553210866523024e-05,0.5714285714285714
13413,13413,노래실력/Noun,7,4,3,6.668889629876625e-05,5.553210866523024e-05,0.5714285714285714
13414,13414,파가/Noun,7,3,4,5.5574080248971876e-05,6.663853039827628e-05,0.5714285714285714
13415,13415,미카엘/Noun,7,3,4,5.5574080248971876e-05,6.663853039827628e-05,0.5714285714285714
13416,13416,부엉이/Noun,7,3,4,5.5574080248971876e-05,6.663853039827628e-05,0.5714285714285714
13417,13417,퓨티드/Noun,7,3,4,5.5574080248971876e-05,6.663853039827628e-05,0.5714285714285714
13418,13418,에게로/Josa,7,4,3,6.668889629876625e-05,5.553210866523024e-05,0.5714285714285714
13419,13419,버드/Noun,7,3,4,5.5574080248971876e-05,6.663853039827628e-05,0.5714285714285714
13420,13420,내딸/Noun,7,3,4,5.5574080248971876e-05,6.663853039827628e-05,0.5714285714285714
13421,13421,보조/Noun,7,4,3,6.668889629876625e-05,5.553210866523024e-05,0.5714285714285714
13422,13422,보로/Noun,7,4,3,6.668889629876625e-05,5.553210866523024e-05,0.5714285714285714
13423,13423,합류/Noun,7,3,4,5.5574080248971876e-05,6.663853039827628e-05,0.5714285714285714
13424,13424,뭐시기/Noun,7,3,4,5.5574080248971876e-05,6.663853039827628e-05,0.5714285714285714
13425,13425,갈래/Noun,7,3,4,5.5574080248971876e-05,6.663853039827628e-05,0.5714285714285714
13426,13426,don/Alpha,7,4,3,6.668889629876625e-05,5.553210866523024e-05,0.5714285714285714
13427,13427,머리털/Noun,7,3,4,5.5574080248971876e-05,6.663853039827628e-05,0.5714285714285714
13428,13428,책상/Noun,7,4,3,6.668889629876625e-05,5.553210866523024e-05,0.5714285714285714
13429,13429,리라/Noun,7,3,4,5.5574080248971876e-05,6.663853039827628e-05,0.5714285714285714
13430,13430,호화롭다/Adjective,7,3,4,5.5574080248971876e-05,6.663853039827628e-05,0.5714285714285714
13431,13431,퍼스트/Noun,7,4,3,6.668889629876625e-05,5.553210866523024e-05,0.5714285714285714
13432,13432,강국/Noun,7,3,4,5.5574080248971876e-05,6.663853039827628e-05,0.5714285714285714
13433,13433,안봣는데/Noun,7,3,4,5.5574080248971876e-05,6.663853039827628e-05,0.5714285714285714
13434,13434,CIA/Alpha,7,4,3,6.668889629876625e-05,5.553210866523024e-05,0.5714285714285714
13435,13435,바랬던/Noun,7,4,3,6.668889629876625e-05,5.553210866523024e-05,0.5714285714285714
13436,13436,구타/Noun,7,3,4,5.5574080248971876e-05,6.663853039827628e-05,0.5714285714285714
13437,13437,로간/Noun,7,4,3,6.668889629876625e-05,5.553210866523024e-05,0.5714285714285714
13438,13438,요기/Noun,7,3,4,5.5574080248971876e-05,6.663853039827628e-05,0.5714285714285714
13439,13439,톡/Noun,7,4,3,6.668889629876625e-05,5.553210866523024e-05,0.5714285714285714
13440,13440,가창력/Noun,7,4,3,6.668889629876625e-05,5.553210866523024e-05,0.5714285714285714
13441,13441,집행/Noun,7,4,3,6.668889629876625e-05,5.553210866523024e-05,0.5714285714285714
13442,13442,백제/Noun,7,4,3,6.668889629876625e-05,5.553210866523024e-05,0.5714285714285714
13443,13443,끄적/Adverb,7,4,3,6.668889629876625e-05,5.553210866523024e-05,0.5714285714285714
13444,13444,목욕탕/Noun,7,4,3,6.668889629876625e-05,5.553210866523024e-05,0.5714285714285714
13445,13445,91년/Number,7,4,3,6.668889629876625e-05,5.553210866523024e-05,0.5714285714285714
13446,13446,한결같이/Adverb,7,4,3,6.668889629876625e-05,5.553210866523024e-05,0.5714285714285714
13447,13447,더라도/Noun,7,3,4,5.5574080248971876e-05,6.663853039827628e-05,0.5714285714285714
13448,13448,피조/Noun,7,3,4,5.5574080248971876e-05,6.663853039827628e-05,0.5714285714285714
13449,13449,설령/Noun,7,3,4,5.5574080248971876e-05,6.663853039827628e-05,0.5714285714285714
13450,13450,교육영화/Noun,7,3,4,5.5574080248971876e-05,6.663853039827628e-05,0.5714285714285714
13451,13451,헌트/Noun,7,4,3,6.668889629876625e-05,5.553210866523024e-05,0.5714285714285714
13452,13452,대가/Foreign,7,3,4,5.5574080248971876e-05,6.663853039827628e-05,0.5714285714285714
13453,13453,예약/Noun,7,3,4,5.5574080248971876e-05,6.663853039827628e-05,0.5714285714285714
13454,13454,오스/Noun,7,4,3,6.668889629876625e-05,5.553210866523024e-05,0.5714285714285714
13455,13455,우리동네/Noun,7,4,3,6.668889629876625e-05,5.553210866523024e-05,0.5714285714285714
13456,13456,상당/Noun,7,4,3,6.668889629876625e-05,5.553210866523024e-05,0.5714285714285714
13457,13457,브래들리/Noun,7,3,4,5.5574080248971876e-05,6.663853039827628e-05,0.5714285714285714
13458,13458,옅다/Adjective,7,4,3,6.668889629876625e-05,5.553210866523024e-05,0.5714285714285714
13459,13459,매가/Noun,7,4,3,6.668889629876625e-05,5.553210866523024e-05,0.5714285714285714
13460,13460,집념/Noun,7,4,3,6.668889629876625e-05,5.553210866523024e-05,0.5714285714285714
13461,13461,글래머/Noun,7,4,3,6.668889629876625e-05,5.553210866523024e-05,0.5714285714285714
13462,13462,중위/Noun,7,3,4,5.5574080248971876e-05,6.663853039827628e-05,0.5714285714285714
13463,13463,아스/Noun,7,3,4,5.5574080248971876e-05,6.663853039827628e-05,0.5714285714285714
13464,13464,횡재/Noun,7,4,3,6.668889629876625e-05,5.553210866523024e-05,0.5714285714285714
13465,13465,김기영/Noun,7,4,3,6.668889629876625e-05,5.553210866523024e-05,0.5714285714285714
13466,13466,카우프만/Noun,7,4,3,6.668889629876625e-05,5.553210866523024e-05,0.5714285714285714
13467,13467,수만/Noun,7,3,4,5.5574080248971876e-05,6.663853039827628e-05,0.5714285714285714
13468,13468,무력/Noun,7,3,4,5.5574080248971876e-05,6.663853039827628e-05,0.5714285714285714
13469,13469,취약/Noun,7,4,3,6.668889629876625e-05,5.553210866523024e-05,0.5714285714285714
13470,13470,니키타/Noun,7,3,4,5.5574080248971876e-05,6.663853039827628e-05,0.5714285714285714
13471,13471,라르/Noun,7,4,3,6.668889629876625e-05,5.553210866523024e-05,0.5714285714285714
13472,13472,주마/Noun,7,4,3,6.668889629876625e-05,5.553210866523024e-05,0.5714285714285714
13473,13473,복구/Noun,7,3,4,5.5574080248971876e-05,6.663853039827628e-05,0.5714285714285714
13474,13474,원죄/Noun,7,3,4,5.5574080248971876e-05,6.663853039827628e-05,0.5714285714285714
13475,13475,바흐/Noun,7,4,3,6.668889629876625e-05,5.553210866523024e-05,0.5714285714285714
13476,13476,남자이야기/Noun,7,3,4,5.5574080248971876e-05,6.663853039827628e-05,0.5714285714285714
13477,13477,성급하다/Adjective,7,3,4,5.5574080248971876e-05,6.663853039827628e-05,0.5714285714285714
13478,13478,드팔마/Noun,7,3,4,5.5574080248971876e-05,6.663853039827628e-05,0.5714285714285714
13479,13479,순금/Noun,7,3,4,5.5574080248971876e-05,6.663853039827628e-05,0.5714285714285714
13480,13480,행사/Noun,7,3,4,5.5574080248971876e-05,6.663853039827628e-05,0.5714285714285714
13481,13481,나란하다/Adjective,7,4,3,6.668889629876625e-05,5.553210866523024e-05,0.5714285714285714
13482,13482,임파/Noun,7,3,4,5.5574080248971876e-05,6.663853039827628e-05,0.5714285714285714
13483,13483,다미/Noun,7,4,3,6.668889629876625e-05,5.553210866523024e-05,0.5714285714285714
13484,13484,식품/Noun,7,3,4,5.5574080248971876e-05,6.663853039827628e-05,0.5714285714285714
13485,13485,빨치산/Noun,7,4,3,6.668889629876625e-05,5.553210866523024e-05,0.5714285714285714
13486,13486,트집/Noun,7,4,3,6.668889629876625e-05,5.553210866523024e-05,0.5714285714285714
13487,13487,허리우드/Noun,7,4,3,6.668889629876625e-05,5.553210866523024e-05,0.5714285714285714
13488,13488,썰매/Noun,7,4,3,6.668889629876625e-05,5.553210866523024e-05,0.5714285714285714
13489,13489,선곡/Noun,7,4,3,6.668889629876625e-05,5.553210866523024e-05,0.5714285714285714
13490,13490,카지노로얄/Noun,7,4,3,6.668889629876625e-05,5.553210866523024e-05,0.5714285714285714
13491,13491,놀음/Noun,7,3,4,5.5574080248971876e-05,6.663853039827628e-05,0.5714285714285714
13492,13492,반찬/Noun,7,3,4,5.5574080248971876e-05,6.663853039827628e-05,0.5714285714285714
13493,13493,잔인성/Noun,7,3,4,5.5574080248971876e-05,6.663853039827628e-05,0.5714285714285714
13494,13494,브라운/Noun,7,4,3,6.668889629876625e-05,5.553210866523024e-05,0.5714285714285714
13495,13495,이언/Noun,7,3,4,5.5574080248971876e-05,6.663853039827628e-05,0.5714285714285714
13496,13496,영관/Noun,7,3,4,5.5574080248971876e-05,6.663853039827628e-05,0.5714285714285714
13497,13497,에밀/Noun,7,4,3,6.668889629876625e-05,5.553210866523024e-05,0.5714285714285714
13498,13498,둥둥/Noun,7,4,3,6.668889629876625e-05,5.553210866523024e-05,0.5714285714285714
13499,13499,행태/Noun,7,3,4,5.5574080248971876e-05,6.663853039827628e-05,0.5714285714285714
13500,13500,괞/Noun,7,4,3,6.668889629876625e-05,5.553210866523024e-05,0.5714285714285714
13501,13501,스티브잡스/Noun,7,4,3,6.668889629876625e-05,5.553210866523024e-05,0.5714285714285714
13502,13502,투자가/Noun,7,3,4,5.5574080248971876e-05,6.663853039827628e-05,0.5714285714285714
13503,13503,신기전/Noun,7,4,3,6.668889629876625e-05,5.553210866523024e-05,0.5714285714285714
13504,13504,모래시계/Noun,7,4,3,6.668889629876625e-05,5.553210866523024e-05,0.5714285714285714
13505,13505,버티고/Noun,7,3,4,5.5574080248971876e-05,6.663853039827628e-05,0.5714285714285714
13506,13506,장본인/Noun,7,3,4,5.5574080248971876e-05,6.663853039827628e-05,0.5714285714285714
13507,13507,붕가붕가/Noun,6,0,6,2.2229632099588756e-05,8.885137386436837e-05,1.0
13508,13508,모호/Noun,6,0,6,2.2229632099588756e-05,8.885137386436837e-05,1.0
13509,13509,5초/Number,6,0,6,2.2229632099588756e-05,8.885137386436837e-05,1.0
13510,13510,편애/Noun,6,0,6,2.2229632099588756e-05,8.885137386436837e-05,1.0
13511,13511,각목/Noun,6,0,6,2.2229632099588756e-05,8.885137386436837e-05,1.0
13512,13512,용량/Noun,6,0,6,2.2229632099588756e-05,8.885137386436837e-05,1.0
13513,13513,2000원/Number,6,0,6,2.2229632099588756e-05,8.885137386436837e-05,1.0
13514,13514,잘빠지다/Verb,6,6,0,8.891852839835501e-05,2.2212843466092093e-05,1.0
13515,13515,마라도나/Noun,6,0,6,2.2229632099588756e-05,8.885137386436837e-05,1.0
13516,13516,패킷/Noun,6,0,6,2.2229632099588756e-05,8.885137386436837e-05,1.0
13517,13517,잠옴/Noun,6,0,6,2.2229632099588756e-05,8.885137386436837e-05,1.0
13518,13518,기미가요/Noun,6,0,6,2.2229632099588756e-05,8.885137386436837e-05,1.0
13519,13519,44/Number,6,0,6,2.2229632099588756e-05,8.885137386436837e-05,1.0
13520,13520,대학가/Noun,6,0,6,2.2229632099588756e-05,8.885137386436837e-05,1.0
13521,13521,노이즈/Noun,6,0,6,2.2229632099588756e-05,8.885137386436837e-05,1.0
13522,13522,곽현화/Noun,6,0,6,2.2229632099588756e-05,8.885137386436837e-05,1.0
13523,13523,창피/Noun,6,0,6,2.2229632099588756e-05,8.885137386436837e-05,1.0
13524,13524,Ebs/Alpha,6,6,0,8.891852839835501e-05,2.2212843466092093e-05,1.0
13525,13525,보급/Noun,6,0,6,2.2229632099588756e-05,8.885137386436837e-05,1.0
13526,13526,촌철/Noun,6,6,0,8.891852839835501e-05,2.2212843466092093e-05,1.0
13527,13527,역사관/Noun,6,0,6,2.2229632099588756e-05,8.885137386436837e-05,1.0
13528,13528,세르게이/Noun,6,0,6,2.2229632099588756e-05,8.885137386436837e-05,1.0
13529,13529,장하나/Noun,6,0,6,2.2229632099588756e-05,8.885137386436837e-05,1.0
13530,13530,2.6/Number,6,0,6,2.2229632099588756e-05,8.885137386436837e-05,1.0
13531,13531,생기다/Adjective,6,0,6,2.2229632099588756e-05,8.885137386436837e-05,1.0
13532,13532,존레논/Noun,6,6,0,8.891852839835501e-05,2.2212843466092093e-05,1.0
13533,13533,아작/Noun,6,0,6,2.2229632099588756e-05,8.885137386436837e-05,1.0
13534,13534,남쪽/Noun,6,6,0,8.891852839835501e-05,2.2212843466092093e-05,1.0
13535,13535,신예/Noun,6,0,6,2.2229632099588756e-05,8.885137386436837e-05,1.0
13536,13536,그림판/Noun,6,0,6,2.2229632099588756e-05,8.885137386436837e-05,1.0
13537,13537,개핵/Noun,6,0,6,2.2229632099588756e-05,8.885137386436837e-05,1.0
13538,13538,기왕/Noun,6,0,6,2.2229632099588756e-05,8.885137386436837e-05,1.0
13539,13539,장려/Noun,6,0,6,2.2229632099588756e-05,8.885137386436837e-05,1.0
13540,13540,우현/Noun,6,6,0,8.891852839835501e-05,2.2212843466092093e-05,1.0
13541,13541,시디/Noun,6,6,0,8.891852839835501e-05,2.2212843466092093e-05,1.0
13542,13542,종범/Noun,6,0,6,2.2229632099588756e-05,8.885137386436837e-05,1.0
13543,13543,정치사/Noun,6,6,0,8.891852839835501e-05,2.2212843466092093e-05,1.0
13544,13544,엔드/Noun,6,0,6,2.2229632099588756e-05,8.885137386436837e-05,1.0
13545,13545,허약하다/Adjective,6,0,6,2.2229632099588756e-05,8.885137386436837e-05,1.0
13546,13546,연개소문/Noun,6,0,6,2.2229632099588756e-05,8.885137386436837e-05,1.0
13547,13547,곤욕/Noun,6,0,6,2.2229632099588756e-05,8.885137386436837e-05,1.0
13548,13548,방정/Noun,6,0,6,2.2229632099588756e-05,8.885137386436837e-05,1.0
13549,13549,위쇼/Noun,6,6,0,8.891852839835501e-05,2.2212843466092093e-05,1.0
13550,13550,자상하다/Adjective,6,6,0,8.891852839835501e-05,2.2212843466092093e-05,1.0
13551,13551,라이오넬/Noun,6,6,0,8.891852839835501e-05,2.2212843466092093e-05,1.0
13552,13552,^)//Punctuation,6,6,0,8.891852839835501e-05,2.2212843466092093e-05,1.0
13553,13553,이케/Noun,6,0,6,2.2229632099588756e-05,8.885137386436837e-05,1.0
13554,13554,전대물/Noun,6,0,6,2.2229632099588756e-05,8.885137386436837e-05,1.0
13555,13555,동물학대/Noun,6,0,6,2.2229632099588756e-05,8.885137386436837e-05,1.0
13556,13556,ll/Alpha,6,6,0,8.891852839835501e-05,2.2212843466092093e-05,1.0
13557,13557,축축/Adverb,6,0,6,2.2229632099588756e-05,8.885137386436837e-05,1.0
13558,13558,페니/Noun,6,6,0,8.891852839835501e-05,2.2212843466092093e-05,1.0
13559,13559,...;;;;/Punctuation,6,0,6,2.2229632099588756e-05,8.885137386436837e-05,1.0
13560,13560,이러다가/Adverb,6,0,6,2.2229632099588756e-05,8.885137386436837e-05,1.0
13561,13561,간반/Noun,6,0,6,2.2229632099588756e-05,8.885137386436837e-05,1.0
13562,13562,짬봉/Noun,6,0,6,2.2229632099588756e-05,8.885137386436837e-05,1.0
13563,13563,허벅지/Noun,6,0,6,2.2229632099588756e-05,8.885137386436837e-05,1.0
13564,13564,"..,,./Punctuation",6,0,6,2.2229632099588756e-05,8.885137386436837e-05,1.0
13565,13565,정승/Noun,6,0,6,2.2229632099588756e-05,8.885137386436837e-05,1.0
13566,13566,지지리/Noun,6,0,6,2.2229632099588756e-05,8.885137386436837e-05,1.0
13567,13567,국군/Noun,6,0,6,2.2229632099588756e-05,8.885137386436837e-05,1.0
13568,13568,쫘악/Noun,6,6,0,8.891852839835501e-05,2.2212843466092093e-05,1.0
13569,13569,난로/Noun,6,6,0,8.891852839835501e-05,2.2212843466092093e-05,1.0
13570,13570,사생아/Noun,6,0,6,2.2229632099588756e-05,8.885137386436837e-05,1.0
13571,13571,31/Number,6,6,0,8.891852839835501e-05,2.2212843466092093e-05,1.0
13572,13572,아낙/Noun,6,0,6,2.2229632099588756e-05,8.885137386436837e-05,1.0
13573,13573,3.5/Number,6,0,6,2.2229632099588756e-05,8.885137386436837e-05,1.0
13574,13574,진행자/Noun,6,0,6,2.2229632099588756e-05,8.885137386436837e-05,1.0
13575,13575,맞춤법/Noun,6,0,6,2.2229632099588756e-05,8.885137386436837e-05,1.0
13576,13576,경찰차/Noun,6,0,6,2.2229632099588756e-05,8.885137386436837e-05,1.0
13577,13577,WWE/Alpha,6,0,6,2.2229632099588756e-05,8.885137386436837e-05,1.0
13578,13578,맹꽁/Adverb,6,0,6,2.2229632099588756e-05,8.885137386436837e-05,1.0
13579,13579,경비원/Noun,6,0,6,2.2229632099588756e-05,8.885137386436837e-05,1.0
13580,13580,걔네/Noun,6,0,6,2.2229632099588756e-05,8.885137386436837e-05,1.0
13581,13581,콕콕/Adverb,6,6,0,8.891852839835501e-05,2.2212843466092093e-05,1.0
13582,13582,퇴갤/Noun,6,0,6,2.2229632099588756e-05,8.885137386436837e-05,1.0
13583,13583,캠페인/Noun,6,0,6,2.2229632099588756e-05,8.885137386436837e-05,1.0
13584,13584,플라스틱/Noun,6,0,6,2.2229632099588756e-05,8.885137386436837e-05,1.0
13585,13585,다케/Noun,6,6,0,8.891852839835501e-05,2.2212843466092093e-05,1.0
13586,13586,원폭/Noun,6,0,6,2.2229632099588756e-05,8.885137386436837e-05,1.0
13587,13587,박영진/Noun,6,0,6,2.2229632099588756e-05,8.885137386436837e-05,1.0
13588,13588,맨홀/Noun,6,0,6,2.2229632099588756e-05,8.885137386436837e-05,1.0
13589,13589,쫄깃하/Noun,6,6,0,8.891852839835501e-05,2.2212843466092093e-05,1.0
13590,13590,셋트/Noun,6,0,6,2.2229632099588756e-05,8.885137386436837e-05,1.0
13591,13591,요란/Noun,6,0,6,2.2229632099588756e-05,8.885137386436837e-05,1.0
13592,13592,최여진/Noun,6,0,6,2.2229632099588756e-05,8.885137386436837e-05,1.0
13593,13593,본색/Noun,6,0,6,2.2229632099588756e-05,8.885137386436837e-05,1.0
13594,13594,여건/Noun,6,0,6,2.2229632099588756e-05,8.885137386436837e-05,1.0
13595,13595,낚인건/Noun,6,0,6,2.2229632099588756e-05,8.885137386436837e-05,1.0
13596,13596,주루룩/Adverb,6,6,0,8.891852839835501e-05,2.2212843466092093e-05,1.0
13597,13597,가스펠/Noun,6,6,0,8.891852839835501e-05,2.2212843466092093e-05,1.0
13598,13598,바로잡다/Verb,6,6,0,8.891852839835501e-05,2.2212843466092093e-05,1.0
13599,13599,혈액형/Noun,6,0,6,2.2229632099588756e-05,8.885137386436837e-05,1.0
13600,13600,풍족하다/Adjective,6,6,0,8.891852839835501e-05,2.2212843466092093e-05,1.0
13601,13601,킹스/Noun,6,6,0,8.891852839835501e-05,2.2212843466092093e-05,1.0
13602,13602,신보라/Noun,6,0,6,2.2229632099588756e-05,8.885137386436837e-05,1.0
13603,13603,돈크라이마미/Noun,6,0,6,2.2229632099588756e-05,8.885137386436837e-05,1.0
13604,13604,명예훼손/Noun,6,0,6,2.2229632099588756e-05,8.885137386436837e-05,1.0
13605,13605,나우/Noun,6,6,0,8.891852839835501e-05,2.2212843466092093e-05,1.0
13606,13606,요술/Noun,6,0,6,2.2229632099588756e-05,8.885137386436837e-05,1.0
13607,13607,김수환/Noun,6,6,0,8.891852839835501e-05,2.2212843466092093e-05,1.0
13608,13608,징글/Noun,6,0,6,2.2229632099588756e-05,8.885137386436837e-05,1.0
13609,13609,끝물/Noun,6,0,6,2.2229632099588756e-05,8.885137386436837e-05,1.0
13610,13610,틸다/Noun,6,6,0,8.891852839835501e-05,2.2212843466092093e-05,1.0
13611,13611,질도/Noun,6,0,6,2.2229632099588756e-05,8.885137386436837e-05,1.0
13612,13612,(?).../Punctuation,6,0,6,2.2229632099588756e-05,8.885137386436837e-05,1.0
13613,13613,빈곤하다/Adjective,6,0,6,2.2229632099588756e-05,8.885137386436837e-05,1.0
13614,13614,순간이동/Noun,6,0,6,2.2229632099588756e-05,8.885137386436837e-05,1.0
13615,13615,배틀쉽/Noun,6,0,6,2.2229632099588756e-05,8.885137386436837e-05,1.0
13616,13616,완치/Noun,6,6,0,8.891852839835501e-05,2.2212843466092093e-05,1.0
13617,13617,웨/Noun,6,0,6,2.2229632099588756e-05,8.885137386436837e-05,1.0
13618,13618,대충대충/Adverb,6,0,6,2.2229632099588756e-05,8.885137386436837e-05,1.0
13619,13619,올밴/Noun,6,0,6,2.2229632099588756e-05,8.885137386436837e-05,1.0
13620,13620,땅크/Noun,6,0,6,2.2229632099588756e-05,8.885137386436837e-05,1.0
13621,13621,손병호/Noun,6,0,6,2.2229632099588756e-05,8.885137386436837e-05,1.0
13622,13622,노을/Noun,6,6,0,8.891852839835501e-05,2.2212843466092093e-05,1.0
13623,13623,보살피다/Verb,6,6,0,8.891852839835501e-05,2.2212843466092093e-05,1.0
13624,13624,시후/Noun,6,6,0,8.891852839835501e-05,2.2212843466092093e-05,1.0
13625,13625,이지난/Foreign,6,6,0,8.891852839835501e-05,2.2212843466092093e-05,1.0
13626,13626,패딩턴/Noun,6,6,0,8.891852839835501e-05,2.2212843466092093e-05,1.0
13627,13627,재롱/Noun,6,0,6,2.2229632099588756e-05,8.885137386436837e-05,1.0
13628,13628,버거운/Noun,6,0,6,2.2229632099588756e-05,8.885137386436837e-05,1.0
13629,13629,일왕/Noun,6,0,6,2.2229632099588756e-05,8.885137386436837e-05,1.0
13630,13630,재밌넹/Noun,6,6,0,8.891852839835501e-05,2.2212843466092093e-05,1.0
13631,13631,^*^/Punctuation,6,6,0,8.891852839835501e-05,2.2212843466092093e-05,1.0
13632,13632,소꿉놀이/Noun,6,0,6,2.2229632099588756e-05,8.885137386436837e-05,1.0
13633,13633,레오네/Noun,6,6,0,8.891852839835501e-05,2.2212843466092093e-05,1.0
13634,13634,부터의/Josa,6,6,0,8.891852839835501e-05,2.2212843466092093e-05,1.0
13635,13635,희화/Noun,6,0,6,2.2229632099588756e-05,8.885137386436837e-05,1.0
13636,13636,성지/Noun,6,0,6,2.2229632099588756e-05,8.885137386436837e-05,1.0
13637,13637,사양/Noun,6,0,6,2.2229632099588756e-05,8.885137386436837e-05,1.0
13638,13638,과일/Noun,6,0,6,2.2229632099588756e-05,8.885137386436837e-05,1.0
13639,13639,승전/Noun,6,0,6,2.2229632099588756e-05,8.885137386436837e-05,1.0
13640,13640,노희경/Noun,6,6,0,8.891852839835501e-05,2.2212843466092093e-05,1.0
13641,13641,붕뜬/Noun,6,0,6,2.2229632099588756e-05,8.885137386436837e-05,1.0
13642,13642,음식물/Noun,6,0,6,2.2229632099588756e-05,8.885137386436837e-05,1.0
13643,13643,!!~/Punctuation,6,6,0,8.891852839835501e-05,2.2212843466092093e-05,1.0
13644,13644,관습/Noun,6,6,0,8.891852839835501e-05,2.2212843466092093e-05,1.0
13645,13645,적정/Noun,6,0,6,2.2229632099588756e-05,8.885137386436837e-05,1.0
13646,13646,섬터/Noun,6,6,0,8.891852839835501e-05,2.2212843466092093e-05,1.0
13647,13647,존경심/Noun,6,6,0,8.891852839835501e-05,2.2212843466092093e-05,1.0
13648,13648,슈타인/Noun,6,6,0,8.891852839835501e-05,2.2212843466092093e-05,1.0
13649,13649,역효과/Noun,6,0,6,2.2229632099588756e-05,8.885137386436837e-05,1.0
13650,13650,루니/Noun,6,6,0,8.891852839835501e-05,2.2212843466092093e-05,1.0
13651,13651,울먹이다/Verb,6,6,0,8.891852839835501e-05,2.2212843466092093e-05,1.0
13652,13652,범주/Noun,6,0,6,2.2229632099588756e-05,8.885137386436837e-05,1.0
13653,13653,쇼미더머니/Noun,6,0,6,2.2229632099588756e-05,8.885137386436837e-05,1.0
13654,13654,불능/Noun,6,0,6,2.2229632099588756e-05,8.885137386436837e-05,1.0
13655,13655,정정/Noun,6,0,6,2.2229632099588756e-05,8.885137386436837e-05,1.0
13656,13656,겟썸/Noun,6,0,6,2.2229632099588756e-05,8.885137386436837e-05,1.0
13657,13657,다욕/Noun,6,0,6,2.2229632099588756e-05,8.885137386436837e-05,1.0
13658,13658,포옹/Noun,6,6,0,8.891852839835501e-05,2.2212843466092093e-05,1.0
13659,13659,안중/Noun,6,0,6,2.2229632099588756e-05,8.885137386436837e-05,1.0
13660,13660,몽상/Noun,6,0,6,2.2229632099588756e-05,8.885137386436837e-05,1.0
13661,13661,아무런/Modifier,6,0,6,2.2229632099588756e-05,8.885137386436837e-05,1.0
13662,13662,인스피릿/Noun,6,6,0,8.891852839835501e-05,2.2212843466092093e-05,1.0
13663,13663,스탈린그라드/Noun,6,6,0,8.891852839835501e-05,2.2212843466092093e-05,1.0
13664,13664,방청객/Noun,6,0,6,2.2229632099588756e-05,8.885137386436837e-05,1.0
13665,13665,기관총/Noun,6,0,6,2.2229632099588756e-05,8.885137386436837e-05,1.0
13666,13666,자아도취/Noun,6,0,6,2.2229632099588756e-05,8.885137386436837e-05,1.0
13667,13667,험버트/Noun,6,6,0,8.891852839835501e-05,2.2212843466092093e-05,1.0
13668,13668,러시아어/Noun,6,0,6,2.2229632099588756e-05,8.885137386436837e-05,1.0
13669,13669,바닥나다/Verb,6,0,6,2.2229632099588756e-05,8.885137386436837e-05,1.0
13670,13670,굿임/Noun,6,6,0,8.891852839835501e-05,2.2212843466092093e-05,1.0
13671,13671,빠져듭니/Noun,6,6,0,8.891852839835501e-05,2.2212843466092093e-05,1.0
13672,13672,뇬/Noun,6,0,6,2.2229632099588756e-05,8.885137386436837e-05,1.0
13673,13673,곱등이/Noun,6,0,6,2.2229632099588756e-05,8.885137386436837e-05,1.0
13674,13674,메이크업/Noun,6,6,0,8.891852839835501e-05,2.2212843466092093e-05,1.0
13675,13675,버디무비/Noun,6,6,0,8.891852839835501e-05,2.2212843466092093e-05,1.0
13676,13676,후아유/Noun,6,6,0,8.891852839835501e-05,2.2212843466092093e-05,1.0
13677,13677,어사일럼/Noun,6,0,6,2.2229632099588756e-05,8.885137386436837e-05,1.0
13678,13678,반죽/Noun,6,0,6,2.2229632099588756e-05,8.885137386436837e-05,1.0
13679,13679,김은숙/Noun,6,6,0,8.891852839835501e-05,2.2212843466092093e-05,1.0
13680,13680,더파이팅/Noun,6,6,0,8.891852839835501e-05,2.2212843466092093e-05,1.0
13681,13681,중고생/Noun,6,0,6,2.2229632099588756e-05,8.885137386436837e-05,1.0
13682,13682,그레이드/Noun,6,0,6,2.2229632099588756e-05,8.885137386436837e-05,1.0
13683,13683,-_-.../Punctuation,6,0,6,2.2229632099588756e-05,8.885137386436837e-05,1.0
13684,13684,문외한/Noun,6,6,0,8.891852839835501e-05,2.2212843466092093e-05,1.0
13685,13685,어리둥절/Noun,6,0,6,2.2229632099588756e-05,8.885137386436837e-05,1.0
13686,13686,윌리/Noun,6,6,0,8.891852839835501e-05,2.2212843466092093e-05,1.0
13687,13687,글로버/Noun,6,6,0,8.891852839835501e-05,2.2212843466092093e-05,1.0
13688,13688,고요한/Noun,6,6,0,8.891852839835501e-05,2.2212843466092093e-05,1.0
13689,13689,60~70년/Number,6,0,6,2.2229632099588756e-05,8.885137386436837e-05,1.0
13690,13690,단숨/Noun,6,6,0,8.891852839835501e-05,2.2212843466092093e-05,1.0
13691,13691,백혈병/Noun,6,0,6,2.2229632099588756e-05,8.885137386436837e-05,1.0
13692,13692,달팽이/Noun,6,6,0,8.891852839835501e-05,2.2212843466092093e-05,1.0
13693,13693,도요타/Noun,6,0,6,2.2229632099588756e-05,8.885137386436837e-05,1.0
13694,13694,강마/Noun,6,6,0,8.891852839835501e-05,2.2212843466092093e-05,1.0
13695,13695,괜찬네/Noun,6,6,0,8.891852839835501e-05,2.2212843466092093e-05,1.0
13696,13696,어쩌라구/Noun,6,0,6,2.2229632099588756e-05,8.885137386436837e-05,1.0
13697,13697,도덕성/Noun,6,0,6,2.2229632099588756e-05,8.885137386436837e-05,1.0
13698,13698,사절/Noun,6,0,6,2.2229632099588756e-05,8.885137386436837e-05,1.0
13699,13699,달림/Noun,6,0,6,2.2229632099588756e-05,8.885137386436837e-05,1.0
13700,13700,북받치다/Verb,6,6,0,8.891852839835501e-05,2.2212843466092093e-05,1.0
13701,13701,지심/Noun,6,6,0,8.891852839835501e-05,2.2212843466092093e-05,1.0
13702,13702,한술/Noun,6,0,6,2.2229632099588756e-05,8.885137386436837e-05,1.0
13703,13703,빨강/Noun,6,6,0,8.891852839835501e-05,2.2212843466092093e-05,1.0
13704,13704,리엘/Noun,6,6,0,8.891852839835501e-05,2.2212843466092093e-05,1.0
13705,13705,치네다/Verb,6,0,6,2.2229632099588756e-05,8.885137386436837e-05,1.0
13706,13706,애정결핍/Noun,6,0,6,2.2229632099588756e-05,8.885137386436837e-05,1.0
13707,13707,흩어지다/Verb,6,0,6,2.2229632099588756e-05,8.885137386436837e-05,1.0
13708,13708,마니마니/Adverb,6,6,0,8.891852839835501e-05,2.2212843466092093e-05,1.0
13709,13709,덕지덕지/Noun,6,0,6,2.2229632099588756e-05,8.885137386436837e-05,1.0
13710,13710,"?,/Punctuation",6,5,1,7.780371234856063e-05,3.331926519913814e-05,0.8333333333333334
13711,13711,큰소리/Noun,6,1,5,3.334444814938313e-05,7.774495213132233e-05,0.8333333333333334
13712,13712,하곤/Eomi,6,1,5,3.334444814938313e-05,7.774495213132233e-05,0.8333333333333334
13713,13713,의무감/Noun,6,1,5,3.334444814938313e-05,7.774495213132233e-05,0.8333333333333334
13714,13714,cd/Alpha,6,1,5,3.334444814938313e-05,7.774495213132233e-05,0.8333333333333334
13715,13715,섬뜩/Adverb,6,5,1,7.780371234856063e-05,3.331926519913814e-05,0.8333333333333334
13716,13716,정지영/Noun,6,1,5,3.334444814938313e-05,7.774495213132233e-05,0.8333333333333334
13717,13717,포화/Noun,6,5,1,7.780371234856063e-05,3.331926519913814e-05,0.8333333333333334
13718,13718,창민/Noun,6,5,1,7.780371234856063e-05,3.331926519913814e-05,0.8333333333333334
13719,13719,개개/Noun,6,1,5,3.334444814938313e-05,7.774495213132233e-05,0.8333333333333334
13720,13720,팡/Adverb,6,5,1,7.780371234856063e-05,3.331926519913814e-05,0.8333333333333334
13721,13721,GV/Alpha,6,5,1,7.780371234856063e-05,3.331926519913814e-05,0.8333333333333334
13722,13722,강시선생/Noun,6,5,1,7.780371234856063e-05,3.331926519913814e-05,0.8333333333333334
13723,13723,지사/Noun,6,5,1,7.780371234856063e-05,3.331926519913814e-05,0.8333333333333334
13724,13724,매춘/Noun,6,1,5,3.334444814938313e-05,7.774495213132233e-05,0.8333333333333334
13725,13725,저작권/Noun,6,1,5,3.334444814938313e-05,7.774495213132233e-05,0.8333333333333334
13726,13726,선남선녀/Noun,6,5,1,7.780371234856063e-05,3.331926519913814e-05,0.8333333333333334
13727,13727,벌겋다/Adjective,6,1,5,3.334444814938313e-05,7.774495213132233e-05,0.8333333333333334
13728,13728,종반/Noun,6,1,5,3.334444814938313e-05,7.774495213132233e-05,0.8333333333333334
13729,13729,오자룡/Noun,6,1,5,3.334444814938313e-05,7.774495213132233e-05,0.8333333333333334
13730,13730,집사/Noun,6,5,1,7.780371234856063e-05,3.331926519913814e-05,0.8333333333333334
13731,13731,9천원/Number,6,1,5,3.334444814938313e-05,7.774495213132233e-05,0.8333333333333334
13732,13732,페이소스/Noun,6,5,1,7.780371234856063e-05,3.331926519913814e-05,0.8333333333333334
13733,13733,난봉/Noun,6,1,5,3.334444814938313e-05,7.774495213132233e-05,0.8333333333333334
13734,13734,활력소/Noun,6,5,1,7.780371234856063e-05,3.331926519913814e-05,0.8333333333333334
13735,13735,과외/Noun,6,1,5,3.334444814938313e-05,7.774495213132233e-05,0.8333333333333334
13736,13736,참말/Noun,6,1,5,3.334444814938313e-05,7.774495213132233e-05,0.8333333333333334
13737,13737,만화인/Noun,6,1,5,3.334444814938313e-05,7.774495213132233e-05,0.8333333333333334
13738,13738,그라드/Noun,6,1,5,3.334444814938313e-05,7.774495213132233e-05,0.8333333333333334
13739,13739,니시/Noun,6,5,1,7.780371234856063e-05,3.331926519913814e-05,0.8333333333333334
13740,13740,과함/Noun,6,1,5,3.334444814938313e-05,7.774495213132233e-05,0.8333333333333334
13741,13741,1991년/Number,6,5,1,7.780371234856063e-05,3.331926519913814e-05,0.8333333333333334
13742,13742,붕붕/Noun,6,1,5,3.334444814938313e-05,7.774495213132233e-05,0.8333333333333334
13743,13743,다니엘헤니/Noun,6,5,1,7.780371234856063e-05,3.331926519913814e-05,0.8333333333333334
13744,13744,조울증/Noun,6,1,5,3.334444814938313e-05,7.774495213132233e-05,0.8333333333333334
13745,13745,척척/Noun,6,1,5,3.334444814938313e-05,7.774495213132233e-05,0.8333333333333334
13746,13746,케시/Noun,6,5,1,7.780371234856063e-05,3.331926519913814e-05,0.8333333333333334
13747,13747,sns/Alpha,6,5,1,7.780371234856063e-05,3.331926519913814e-05,0.8333333333333334
13748,13748,발기/Noun,6,1,5,3.334444814938313e-05,7.774495213132233e-05,0.8333333333333334
13749,13749,오차/Noun,6,1,5,3.334444814938313e-05,7.774495213132233e-05,0.8333333333333334
13750,13750,중화/Noun,6,5,1,7.780371234856063e-05,3.331926519913814e-05,0.8333333333333334
13751,13751,베트남전쟁/Noun,6,5,1,7.780371234856063e-05,3.331926519913814e-05,0.8333333333333334
13752,13752,박시은/Noun,6,1,5,3.334444814938313e-05,7.774495213132233e-05,0.8333333333333334
13753,13753,니노/Noun,6,5,1,7.780371234856063e-05,3.331926519913814e-05,0.8333333333333334
13754,13754,오슬로/Noun,6,5,1,7.780371234856063e-05,3.331926519913814e-05,0.8333333333333334
13755,13755,패리스/Noun,6,1,5,3.334444814938313e-05,7.774495213132233e-05,0.8333333333333334
13756,13756,렉터/Noun,6,5,1,7.780371234856063e-05,3.331926519913814e-05,0.8333333333333334
13757,13757,좀바/Noun,6,1,5,3.334444814938313e-05,7.774495213132233e-05,0.8333333333333334
13758,13758,고두심/Noun,6,5,1,7.780371234856063e-05,3.331926519913814e-05,0.8333333333333334
13759,13759,길가/Noun,6,1,5,3.334444814938313e-05,7.774495213132233e-05,0.8333333333333334
13760,13760,토투/Noun,6,5,1,7.780371234856063e-05,3.331926519913814e-05,0.8333333333333334
13761,13761,헤엄/Noun,6,5,1,7.780371234856063e-05,3.331926519913814e-05,0.8333333333333334
13762,13762,여름밤/Noun,6,5,1,7.780371234856063e-05,3.331926519913814e-05,0.8333333333333334
13763,13763,순서대로/Noun,6,5,1,7.780371234856063e-05,3.331926519913814e-05,0.8333333333333334
13764,13764,구슬/Noun,6,1,5,3.334444814938313e-05,7.774495213132233e-05,0.8333333333333334
13765,13765,오타/Noun,6,5,1,7.780371234856063e-05,3.331926519913814e-05,0.8333333333333334
13766,13766,돌란/Noun,6,5,1,7.780371234856063e-05,3.331926519913814e-05,0.8333333333333334
13767,13767,타자/Noun,6,5,1,7.780371234856063e-05,3.331926519913814e-05,0.8333333333333334
13768,13768,도서/Noun,6,5,1,7.780371234856063e-05,3.331926519913814e-05,0.8333333333333334
13769,13769,워메/Noun,6,1,5,3.334444814938313e-05,7.774495213132233e-05,0.8333333333333334
13770,13770,버호벤/Noun,6,5,1,7.780371234856063e-05,3.331926519913814e-05,0.8333333333333334
13771,13771,박민우/Noun,6,1,5,3.334444814938313e-05,7.774495213132233e-05,0.8333333333333334
13772,13772,유연하다/Adjective,6,5,1,7.780371234856063e-05,3.331926519913814e-05,0.8333333333333334
13773,13773,냉/Noun,6,1,5,3.334444814938313e-05,7.774495213132233e-05,0.8333333333333334
13774,13774,그릇되다/Adjective,6,1,5,3.334444814938313e-05,7.774495213132233e-05,0.8333333333333334
13775,13775,작이라니/Foreign,6,5,1,7.780371234856063e-05,3.331926519913814e-05,0.8333333333333334
13776,13776,유명인/Noun,6,1,5,3.334444814938313e-05,7.774495213132233e-05,0.8333333333333334
13777,13777,실험영화/Noun,6,1,5,3.334444814938313e-05,7.774495213132233e-05,0.8333333333333334
13778,13778,이가흔/Noun,6,5,1,7.780371234856063e-05,3.331926519913814e-05,0.8333333333333334
13779,13779,고연/Modifier,6,5,1,7.780371234856063e-05,3.331926519913814e-05,0.8333333333333334
13780,13780,미스코리아/Noun,6,1,5,3.334444814938313e-05,7.774495213132233e-05,0.8333333333333334
13781,13781,레먼/Noun,6,5,1,7.780371234856063e-05,3.331926519913814e-05,0.8333333333333334
13782,13782,리더쉽/Noun,6,5,1,7.780371234856063e-05,3.331926519913814e-05,0.8333333333333334
13783,13783,춘희/Noun,6,5,1,7.780371234856063e-05,3.331926519913814e-05,0.8333333333333334
13784,13784,뻐기다/Verb,6,1,5,3.334444814938313e-05,7.774495213132233e-05,0.8333333333333334
13785,13785,할갑다/Adjective,6,1,5,3.334444814938313e-05,7.774495213132233e-05,0.8333333333333334
13786,13786,고천락/Noun,6,5,1,7.780371234856063e-05,3.331926519913814e-05,0.8333333333333334
13787,13787,칼리토/Noun,6,5,1,7.780371234856063e-05,3.331926519913814e-05,0.8333333333333334
13788,13788,프란체스카/Noun,6,1,5,3.334444814938313e-05,7.774495213132233e-05,0.8333333333333334
13789,13789,꽥/Adverb,6,1,5,3.334444814938313e-05,7.774495213132233e-05,0.8333333333333334
13790,13790,짤린/Noun,6,1,5,3.334444814938313e-05,7.774495213132233e-05,0.8333333333333334
13791,13791,치마/Noun,6,5,1,7.780371234856063e-05,3.331926519913814e-05,0.8333333333333334
13792,13792,저속하다/Adjective,6,1,5,3.334444814938313e-05,7.774495213132233e-05,0.8333333333333334
13793,13793,억수/Noun,6,5,1,7.780371234856063e-05,3.331926519913814e-05,0.8333333333333334
13794,13794,장남/Noun,6,5,1,7.780371234856063e-05,3.331926519913814e-05,0.8333333333333334
13795,13795,구글/Noun,6,1,5,3.334444814938313e-05,7.774495213132233e-05,0.8333333333333334
13796,13796,디스코/Noun,6,1,5,3.334444814938313e-05,7.774495213132233e-05,0.8333333333333334
13797,13797,의왕/Noun,6,1,5,3.334444814938313e-05,7.774495213132233e-05,0.8333333333333334
13798,13798,무재/Noun,6,5,1,7.780371234856063e-05,3.331926519913814e-05,0.8333333333333334
13799,13799,조현재/Noun,6,5,1,7.780371234856063e-05,3.331926519913814e-05,0.8333333333333334
13800,13800,곰탕/Noun,6,1,5,3.334444814938313e-05,7.774495213132233e-05,0.8333333333333334
13801,13801,욕실/Noun,6,5,1,7.780371234856063e-05,3.331926519913814e-05,0.8333333333333334
13802,13802,주륵주륵/Adverb,6,5,1,7.780371234856063e-05,3.331926519913814e-05,0.8333333333333334
13803,13803,반성은/Noun,6,1,5,3.334444814938313e-05,7.774495213132233e-05,0.8333333333333334
13804,13804,걸돈/Noun,6,1,5,3.334444814938313e-05,7.774495213132233e-05,0.8333333333333334
13805,13805,무관심하다/Adjective,6,5,1,7.780371234856063e-05,3.331926519913814e-05,0.8333333333333334
13806,13806,트로이/Noun,6,5,1,7.780371234856063e-05,3.331926519913814e-05,0.8333333333333334
13807,13807,인어공주/Noun,6,5,1,7.780371234856063e-05,3.331926519913814e-05,0.8333333333333334
13808,13808,병동/Noun,6,5,1,7.780371234856063e-05,3.331926519913814e-05,0.8333333333333334
13809,13809,케이티/Noun,6,1,5,3.334444814938313e-05,7.774495213132233e-05,0.8333333333333334
13810,13810,나체/Noun,6,1,5,3.334444814938313e-05,7.774495213132233e-05,0.8333333333333334
13811,13811,마리모/Noun,6,5,1,7.780371234856063e-05,3.331926519913814e-05,0.8333333333333334
13812,13812,아가리/Noun,6,1,5,3.334444814938313e-05,7.774495213132233e-05,0.8333333333333334
13813,13813,^~/Punctuation,6,5,1,7.780371234856063e-05,3.331926519913814e-05,0.8333333333333334
13814,13814,다이애나/Noun,6,1,5,3.334444814938313e-05,7.774495213132233e-05,0.8333333333333334
13815,13815,치켜세우다/Verb,6,1,5,3.334444814938313e-05,7.774495213132233e-05,0.8333333333333334
13816,13816,중계/Noun,6,1,5,3.334444814938313e-05,7.774495213132233e-05,0.8333333333333334
13817,13817,충실/Noun,6,1,5,3.334444814938313e-05,7.774495213132233e-05,0.8333333333333334
13818,13818,베풀다/Verb,6,5,1,7.780371234856063e-05,3.331926519913814e-05,0.8333333333333334
13819,13819,구미호/Noun,6,1,5,3.334444814938313e-05,7.774495213132233e-05,0.8333333333333334
13820,13820,디오/Noun,6,5,1,7.780371234856063e-05,3.331926519913814e-05,0.8333333333333334
13821,13821,채정안/Noun,6,5,1,7.780371234856063e-05,3.331926519913814e-05,0.8333333333333334
13822,13822,팁/Noun,6,5,1,7.780371234856063e-05,3.331926519913814e-05,0.8333333333333334
13823,13823,1979년/Number,6,5,1,7.780371234856063e-05,3.331926519913814e-05,0.8333333333333334
13824,13824,고쿠센/Noun,6,5,1,7.780371234856063e-05,3.331926519913814e-05,0.8333333333333334
13825,13825,부르짖다/Verb,6,1,5,3.334444814938313e-05,7.774495213132233e-05,0.8333333333333334
13826,13826,추장/Noun,6,1,5,3.334444814938313e-05,7.774495213132233e-05,0.8333333333333334
13827,13827,낳을/Noun,6,1,5,3.334444814938313e-05,7.774495213132233e-05,0.8333333333333334
13828,13828,노자/Noun,6,1,5,3.334444814938313e-05,7.774495213132233e-05,0.8333333333333334
13829,13829,바이오맨/Noun,6,1,5,3.334444814938313e-05,7.774495213132233e-05,0.8333333333333334
13830,13830,초콜렛/Noun,6,5,1,7.780371234856063e-05,3.331926519913814e-05,0.8333333333333334
13831,13831,레너드/Noun,6,5,1,7.780371234856063e-05,3.331926519913814e-05,0.8333333333333334
13832,13832,하노/Noun,6,1,5,3.334444814938313e-05,7.774495213132233e-05,0.8333333333333334
13833,13833,건설/Noun,6,1,5,3.334444814938313e-05,7.774495213132233e-05,0.8333333333333334
13834,13834,계속계속/Adverb,6,5,1,7.780371234856063e-05,3.331926519913814e-05,0.8333333333333334
13835,13835,군데군데/Noun,6,1,5,3.334444814938313e-05,7.774495213132233e-05,0.8333333333333334
13836,13836,위화/Noun,6,1,5,3.334444814938313e-05,7.774495213132233e-05,0.8333333333333334
13837,13837,두리/Noun,6,1,5,3.334444814938313e-05,7.774495213132233e-05,0.8333333333333334
13838,13838,로즈/Noun,6,5,1,7.780371234856063e-05,3.331926519913814e-05,0.8333333333333334
13839,13839,리포트/Noun,6,1,5,3.334444814938313e-05,7.774495213132233e-05,0.8333333333333334
13840,13840,발리/Noun,6,1,5,3.334444814938313e-05,7.774495213132233e-05,0.8333333333333334
13841,13841,어기다/Verb,6,1,5,3.334444814938313e-05,7.774495213132233e-05,0.8333333333333334
13842,13842,늠/Noun,6,5,1,7.780371234856063e-05,3.331926519913814e-05,0.8333333333333334
13843,13843,1994년/Number,6,5,1,7.780371234856063e-05,3.331926519913814e-05,0.8333333333333334
13844,13844,~~~~!!!/Punctuation,6,5,1,7.780371234856063e-05,3.331926519913814e-05,0.8333333333333334
13845,13845,보실/Noun,6,1,5,3.334444814938313e-05,7.774495213132233e-05,0.8333333333333334
13846,13846,영적/Noun,6,5,1,7.780371234856063e-05,3.331926519913814e-05,0.8333333333333334
13847,13847,채원/Noun,6,5,1,7.780371234856063e-05,3.331926519913814e-05,0.8333333333333334
13848,13848,커튼/Noun,6,5,1,7.780371234856063e-05,3.331926519913814e-05,0.8333333333333334
13849,13849,영창/Noun,6,1,5,3.334444814938313e-05,7.774495213132233e-05,0.8333333333333334
13850,13850,분한/Noun,6,5,1,7.780371234856063e-05,3.331926519913814e-05,0.8333333333333334
13851,13851,우정은/Noun,6,5,1,7.780371234856063e-05,3.331926519913814e-05,0.8333333333333334
13852,13852,soso/Alpha,6,1,5,3.334444814938313e-05,7.774495213132233e-05,0.8333333333333334
13853,13853,사담/Noun,6,1,5,3.334444814938313e-05,7.774495213132233e-05,0.8333333333333334
13854,13854,수시로/Adverb,6,1,5,3.334444814938313e-05,7.774495213132233e-05,0.8333333333333334
13855,13855,파시즘/Noun,6,1,5,3.334444814938313e-05,7.774495213132233e-05,0.8333333333333334
13856,13856,^^^/Punctuation,6,5,1,7.780371234856063e-05,3.331926519913814e-05,0.8333333333333334
13857,13857,살살/Noun,6,5,1,7.780371234856063e-05,3.331926519913814e-05,0.8333333333333334
13858,13858,바르게/Noun,6,5,1,7.780371234856063e-05,3.331926519913814e-05,0.8333333333333334
13859,13859,커스버트/Noun,6,1,5,3.334444814938313e-05,7.774495213132233e-05,0.8333333333333334
13860,13860,주군/Noun,6,5,1,7.780371234856063e-05,3.331926519913814e-05,0.8333333333333334
13861,13861,왜안/Noun,6,5,1,7.780371234856063e-05,3.331926519913814e-05,0.8333333333333334
13862,13862,울적하다/Adjective,6,5,1,7.780371234856063e-05,3.331926519913814e-05,0.8333333333333334
13863,13863,라티/Noun,6,1,5,3.334444814938313e-05,7.774495213132233e-05,0.8333333333333334
13864,13864,xxx/Alpha,6,1,5,3.334444814938313e-05,7.774495213132233e-05,0.8333333333333334
13865,13865,단정/Noun,6,5,1,7.780371234856063e-05,3.331926519913814e-05,0.8333333333333334
13866,13866,한공주/Noun,6,1,5,3.334444814938313e-05,7.774495213132233e-05,0.8333333333333334
13867,13867,페어리테일/Noun,6,5,1,7.780371234856063e-05,3.331926519913814e-05,0.8333333333333334
13868,13868,대망/Noun,6,1,5,3.334444814938313e-05,7.774495213132233e-05,0.8333333333333334
13869,13869,구수하다/Adjective,6,5,1,7.780371234856063e-05,3.331926519913814e-05,0.8333333333333334
13870,13870,개츠비/Noun,6,5,1,7.780371234856063e-05,3.331926519913814e-05,0.8333333333333334
13871,13871,덤벼/Noun,6,1,5,3.334444814938313e-05,7.774495213132233e-05,0.8333333333333334
13872,13872,비어/Noun,6,1,5,3.334444814938313e-05,7.774495213132233e-05,0.8333333333333334
13873,13873,친분/Noun,6,1,5,3.334444814938313e-05,7.774495213132233e-05,0.8333333333333334
13874,13874,려면/Noun,6,1,5,3.334444814938313e-05,7.774495213132233e-05,0.8333333333333334
13875,13875,다이스/Noun,6,5,1,7.780371234856063e-05,3.331926519913814e-05,0.8333333333333334
13876,13876,구조도/Noun,6,1,5,3.334444814938313e-05,7.774495213132233e-05,0.8333333333333334
13877,13877,박정아/Noun,6,1,5,3.334444814938313e-05,7.774495213132233e-05,0.8333333333333334
13878,13878,휙휙/Noun,6,1,5,3.334444814938313e-05,7.774495213132233e-05,0.8333333333333334
13879,13879,내의/Noun,6,5,1,7.780371234856063e-05,3.331926519913814e-05,0.8333333333333334
13880,13880,클로버필드/Noun,6,1,5,3.334444814938313e-05,7.774495213132233e-05,0.8333333333333334
13881,13881,은진/Noun,6,1,5,3.334444814938313e-05,7.774495213132233e-05,0.8333333333333334
13882,13882,원혼/Noun,6,1,5,3.334444814938313e-05,7.774495213132233e-05,0.8333333333333334
13883,13883,동안미녀/Noun,6,5,1,7.780371234856063e-05,3.331926519913814e-05,0.8333333333333334
13884,13884,잡수다/Verb,6,1,5,3.334444814938313e-05,7.774495213132233e-05,0.8333333333333334
13885,13885,홀려/Noun,6,1,5,3.334444814938313e-05,7.774495213132233e-05,0.8333333333333334
13886,13886,조은지/Noun,6,1,5,3.334444814938313e-05,7.774495213132233e-05,0.8333333333333334
13887,13887,CCTV/Alpha,6,1,5,3.334444814938313e-05,7.774495213132233e-05,0.8333333333333334
13888,13888,때깔/Noun,6,1,5,3.334444814938313e-05,7.774495213132233e-05,0.8333333333333334
13889,13889,숨결/Noun,6,5,1,7.780371234856063e-05,3.331926519913814e-05,0.8333333333333334
13890,13890,협회/Noun,6,1,5,3.334444814938313e-05,7.774495213132233e-05,0.8333333333333334
13891,13891,6분/Number,6,1,5,3.334444814938313e-05,7.774495213132233e-05,0.8333333333333334
13892,13892,이식/Noun,6,1,5,3.334444814938313e-05,7.774495213132233e-05,0.8333333333333334
13893,13893,오온/Noun,6,1,5,3.334444814938313e-05,7.774495213132233e-05,0.8333333333333334
13894,13894,감소/Noun,6,1,5,3.334444814938313e-05,7.774495213132233e-05,0.8333333333333334
13895,13895,girl/Alpha,6,5,1,7.780371234856063e-05,3.331926519913814e-05,0.8333333333333334
13896,13896,왓슨/Noun,6,5,1,7.780371234856063e-05,3.331926519913814e-05,0.8333333333333334
13897,13897,세르/Noun,6,5,1,7.780371234856063e-05,3.331926519913814e-05,0.8333333333333334
13898,13898,귀감/Noun,6,5,1,7.780371234856063e-05,3.331926519913814e-05,0.8333333333333334
13899,13899,용산/Noun,6,1,5,3.334444814938313e-05,7.774495213132233e-05,0.8333333333333334
13900,13900,성행위/Noun,6,1,5,3.334444814938313e-05,7.774495213132233e-05,0.8333333333333334
13901,13901,그레텔/Noun,6,1,5,3.334444814938313e-05,7.774495213132233e-05,0.8333333333333334
13902,13902,용형/Noun,6,5,1,7.780371234856063e-05,3.331926519913814e-05,0.8333333333333334
13903,13903,이징/Noun,6,1,5,3.334444814938313e-05,7.774495213132233e-05,0.8333333333333334
13904,13904,포즈/Noun,6,1,5,3.334444814938313e-05,7.774495213132233e-05,0.8333333333333334
13905,13905,감격시대/Noun,6,5,1,7.780371234856063e-05,3.331926519913814e-05,0.8333333333333334
13906,13906,양성/Noun,6,1,5,3.334444814938313e-05,7.774495213132233e-05,0.8333333333333334
13907,13907,피해망상/Noun,6,1,5,3.334444814938313e-05,7.774495213132233e-05,0.8333333333333334
13908,13908,호갱/Noun,6,1,5,3.334444814938313e-05,7.774495213132233e-05,0.8333333333333334
13909,13909,후루룩/Noun,6,1,5,3.334444814938313e-05,7.774495213132233e-05,0.8333333333333334
13910,13910,유출/Noun,6,1,5,3.334444814938313e-05,7.774495213132233e-05,0.8333333333333334
13911,13911,미스김/Noun,6,5,1,7.780371234856063e-05,3.331926519913814e-05,0.8333333333333334
13912,13912,이승철/Noun,6,1,5,3.334444814938313e-05,7.774495213132233e-05,0.8333333333333334
13913,13913,는데/Noun,6,5,1,7.780371234856063e-05,3.331926519913814e-05,0.8333333333333334
13914,13914,룰렛/Noun,6,5,1,7.780371234856063e-05,3.331926519913814e-05,0.8333333333333334
13915,13915,",,,,,,,,/Punctuation",6,1,5,3.334444814938313e-05,7.774495213132233e-05,0.8333333333333334
13916,13916,은행강도/Noun,6,1,5,3.334444814938313e-05,7.774495213132233e-05,0.8333333333333334
13917,13917,ㅋㄷㅋㄷ/KoreanParticle,6,5,1,7.780371234856063e-05,3.331926519913814e-05,0.8333333333333334
13918,13918,느므/Noun,6,5,1,7.780371234856063e-05,3.331926519913814e-05,0.8333333333333334
13919,13919,전면/Noun,6,1,5,3.334444814938313e-05,7.774495213132233e-05,0.8333333333333334
13920,13920,넬슨/Noun,6,5,1,7.780371234856063e-05,3.331926519913814e-05,0.8333333333333334
13921,13921,길동/Noun,6,5,1,7.780371234856063e-05,3.331926519913814e-05,0.8333333333333334
13922,13922,뉴하트/Noun,6,5,1,7.780371234856063e-05,3.331926519913814e-05,0.8333333333333334
13923,13923,도기/Noun,6,5,1,7.780371234856063e-05,3.331926519913814e-05,0.8333333333333334
13924,13924,월켄/Noun,6,5,1,7.780371234856063e-05,3.331926519913814e-05,0.8333333333333334
13925,13925,김서형/Noun,6,1,5,3.334444814938313e-05,7.774495213132233e-05,0.8333333333333334
13926,13926,이준영/Noun,6,5,1,7.780371234856063e-05,3.331926519913814e-05,0.8333333333333334
13927,13927,해치/Noun,6,1,5,3.334444814938313e-05,7.774495213132233e-05,0.8333333333333334
13928,13928,???????/Punctuation,6,1,5,3.334444814938313e-05,7.774495213132233e-05,0.8333333333333334
13929,13929,IQ/Alpha,6,1,5,3.334444814938313e-05,7.774495213132233e-05,0.8333333333333334
13930,13930,music/Alpha,6,5,1,7.780371234856063e-05,3.331926519913814e-05,0.8333333333333334
13931,13931,외계생명체/Noun,6,1,5,3.334444814938313e-05,7.774495213132233e-05,0.8333333333333334
13932,13932,전영록/Noun,6,1,5,3.334444814938313e-05,7.774495213132233e-05,0.8333333333333334
13933,13933,닼/Noun,6,5,1,7.780371234856063e-05,3.331926519913814e-05,0.8333333333333334
13934,13934,리포터/Noun,6,1,5,3.334444814938313e-05,7.774495213132233e-05,0.8333333333333334
13935,13935,싱싱하다/Adjective,6,1,5,3.334444814938313e-05,7.774495213132233e-05,0.8333333333333334
13936,13936,졸렬하다/Adjective,6,1,5,3.334444814938313e-05,7.774495213132233e-05,0.8333333333333334
13937,13937,him/Alpha,6,5,1,7.780371234856063e-05,3.331926519913814e-05,0.8333333333333334
13938,13938,소서/Noun,6,5,1,7.780371234856063e-05,3.331926519913814e-05,0.8333333333333334
13939,13939,노후/Noun,6,1,5,3.334444814938313e-05,7.774495213132233e-05,0.8333333333333334
13940,13940,의성/Noun,6,5,1,7.780371234856063e-05,3.331926519913814e-05,0.8333333333333334
13941,13941,고딕/Noun,6,5,1,7.780371234856063e-05,3.331926519913814e-05,0.8333333333333334
13942,13942,저해/Noun,6,1,5,3.334444814938313e-05,7.774495213132233e-05,0.8333333333333334
13943,13943,립스틱/Noun,6,5,1,7.780371234856063e-05,3.331926519913814e-05,0.8333333333333334
13944,13944,하버드/Noun,6,1,5,3.334444814938313e-05,7.774495213132233e-05,0.8333333333333334
13945,13945,젤로/Noun,6,5,1,7.780371234856063e-05,3.331926519913814e-05,0.8333333333333334
13946,13946,방언/Noun,6,1,5,3.334444814938313e-05,7.774495213132233e-05,0.8333333333333334
13947,13947,녹슬다/Verb,6,5,1,7.780371234856063e-05,3.331926519913814e-05,0.8333333333333334
13948,13948,제겐/Noun,6,5,1,7.780371234856063e-05,3.331926519913814e-05,0.8333333333333334
13949,13949,개코/Noun,6,1,5,3.334444814938313e-05,7.774495213132233e-05,0.8333333333333334
13950,13950,헿/Exclamation,6,5,1,7.780371234856063e-05,3.331926519913814e-05,0.8333333333333334
13951,13951,니코/Noun,6,5,1,7.780371234856063e-05,3.331926519913814e-05,0.8333333333333334
13952,13952,4.45/Number,6,1,5,3.334444814938313e-05,7.774495213132233e-05,0.8333333333333334
13953,13953,협주곡/Noun,6,5,1,7.780371234856063e-05,3.331926519913814e-05,0.8333333333333334
13954,13954,도합/Modifier,6,5,1,7.780371234856063e-05,3.331926519913814e-05,0.8333333333333334
13955,13955,인공호흡/Noun,6,1,5,3.334444814938313e-05,7.774495213132233e-05,0.8333333333333334
13956,13956,에서조차/Josa,6,1,5,3.334444814938313e-05,7.774495213132233e-05,0.8333333333333334
13957,13957,메모리/Noun,6,1,5,3.334444814938313e-05,7.774495213132233e-05,0.8333333333333334
13958,13958,공동체/Noun,6,5,1,7.780371234856063e-05,3.331926519913814e-05,0.8333333333333334
13959,13959,사이렌/Noun,6,5,1,7.780371234856063e-05,3.331926519913814e-05,0.8333333333333334
13960,13960,성애자/Noun,6,1,5,3.334444814938313e-05,7.774495213132233e-05,0.8333333333333334
13961,13961,고사하고/Noun,6,1,5,3.334444814938313e-05,7.774495213132233e-05,0.8333333333333334
13962,13962,찰떡/Noun,6,5,1,7.780371234856063e-05,3.331926519913814e-05,0.8333333333333334
13963,13963,바오/Noun,6,1,5,3.334444814938313e-05,7.774495213132233e-05,0.8333333333333334
13964,13964,웅얼웅얼/Noun,6,1,5,3.334444814938313e-05,7.774495213132233e-05,0.8333333333333334
13965,13965,32/Number,6,5,1,7.780371234856063e-05,3.331926519913814e-05,0.8333333333333334
13966,13966,다이아나/Noun,6,5,1,7.780371234856063e-05,3.331926519913814e-05,0.8333333333333334
13967,13967,기특하다/Adjective,6,5,1,7.780371234856063e-05,3.331926519913814e-05,0.8333333333333334
13968,13968,장민/Noun,6,5,1,7.780371234856063e-05,3.331926519913814e-05,0.8333333333333334
13969,13969,얼짱/Noun,6,5,1,7.780371234856063e-05,3.331926519913814e-05,0.8333333333333334
13970,13970,무쉬/Noun,6,5,1,7.780371234856063e-05,3.331926519913814e-05,0.8333333333333334
13971,13971,ㅋㄷ/KoreanParticle,6,5,1,7.780371234856063e-05,3.331926519913814e-05,0.8333333333333334
13972,13972,악취/Noun,6,1,5,3.334444814938313e-05,7.774495213132233e-05,0.8333333333333334
13973,13973,쌩뚱맞다/Noun,6,1,5,3.334444814938313e-05,7.774495213132233e-05,0.8333333333333334
13974,13974,규정/Noun,6,5,1,7.780371234856063e-05,3.331926519913814e-05,0.8333333333333334
13975,13975,둠스데이/Noun,6,1,5,3.334444814938313e-05,7.774495213132233e-05,0.8333333333333334
13976,13976,유노윤호/Noun,6,1,5,3.334444814938313e-05,7.774495213132233e-05,0.8333333333333334
13977,13977,본토/Noun,6,1,5,3.334444814938313e-05,7.774495213132233e-05,0.8333333333333334
13978,13978,울렁거리다/Verb,6,1,5,3.334444814938313e-05,7.774495213132233e-05,0.8333333333333334
13979,13979,성교육/Noun,6,1,5,3.334444814938313e-05,7.774495213132233e-05,0.8333333333333334
13980,13980,증지위/Noun,6,5,1,7.780371234856063e-05,3.331926519913814e-05,0.8333333333333334
13981,13981,엎드리다/Verb,6,1,5,3.334444814938313e-05,7.774495213132233e-05,0.8333333333333334
13982,13982,행여/Noun,6,1,5,3.334444814938313e-05,7.774495213132233e-05,0.8333333333333334
13983,13983,서럽다/Adjective,6,5,1,7.780371234856063e-05,3.331926519913814e-05,0.8333333333333334
13984,13984,레오나르도/Noun,6,5,1,7.780371234856063e-05,3.331926519913814e-05,0.8333333333333334
13985,13985,한평생/Noun,6,1,5,3.334444814938313e-05,7.774495213132233e-05,0.8333333333333334
13986,13986,자주자주/Adverb,6,5,1,7.780371234856063e-05,3.331926519913814e-05,0.8333333333333334
13987,13987,꺽/Noun,6,1,5,3.334444814938313e-05,7.774495213132233e-05,0.8333333333333334
13988,13988,That/Alpha,6,5,1,7.780371234856063e-05,3.331926519913814e-05,0.8333333333333334
13989,13989,서준영/Noun,6,5,1,7.780371234856063e-05,3.331926519913814e-05,0.8333333333333334
13990,13990,갈갈/Adverb,6,1,5,3.334444814938313e-05,7.774495213132233e-05,0.8333333333333334
13991,13991,^^!!/Punctuation,6,5,1,7.780371234856063e-05,3.331926519913814e-05,0.8333333333333334
13992,13992,호아킨/Noun,6,5,1,7.780371234856063e-05,3.331926519913814e-05,0.8333333333333334
13993,13993,쩝쩝/Adverb,6,1,5,3.334444814938313e-05,7.774495213132233e-05,0.8333333333333334
13994,13994,쫓아오다/Verb,6,1,5,3.334444814938313e-05,7.774495213132233e-05,0.8333333333333334
13995,13995,ㅈㅅ/KoreanParticle,6,1,5,3.334444814938313e-05,7.774495213132233e-05,0.8333333333333334
13996,13996,노파/Noun,6,1,5,3.334444814938313e-05,7.774495213132233e-05,0.8333333333333334
13997,13997,보안/Noun,6,1,5,3.334444814938313e-05,7.774495213132233e-05,0.8333333333333334
13998,13998,7.2/Number,6,1,5,3.334444814938313e-05,7.774495213132233e-05,0.8333333333333334
13999,13999,U/Alpha,6,5,1,7.780371234856063e-05,3.331926519913814e-05,0.8333333333333334
14000,14000,2천원/Number,6,1,5,3.334444814938313e-05,7.774495213132233e-05,0.8333333333333334
14001,14001,떄리다/Verb,6,1,5,3.334444814938313e-05,7.774495213132233e-05,0.8333333333333334
14002,14002,할껀/Noun,6,1,5,3.334444814938313e-05,7.774495213132233e-05,0.8333333333333334
14003,14003,학교괴담/Noun,6,1,5,3.334444814938313e-05,7.774495213132233e-05,0.8333333333333334
14004,14004,정의감/Noun,6,1,5,3.334444814938313e-05,7.774495213132233e-05,0.8333333333333334
14005,14005,자재/Noun,6,1,5,3.334444814938313e-05,7.774495213132233e-05,0.8333333333333334
14006,14006,대열/Noun,6,1,5,3.334444814938313e-05,7.774495213132233e-05,0.8333333333333334
14007,14007,행방불명/Noun,6,5,1,7.780371234856063e-05,3.331926519913814e-05,0.8333333333333334
14008,14008,편안함/Noun,6,5,1,7.780371234856063e-05,3.331926519913814e-05,0.8333333333333334
14009,14009,앤해서웨이/Noun,6,5,1,7.780371234856063e-05,3.331926519913814e-05,0.8333333333333334
14010,14010,심기/Noun,6,1,5,3.334444814938313e-05,7.774495213132233e-05,0.8333333333333334
14011,14011,변강쇠/Noun,6,1,5,3.334444814938313e-05,7.774495213132233e-05,0.8333333333333334
14012,14012,쓰다/Adjective,6,1,5,3.334444814938313e-05,7.774495213132233e-05,0.8333333333333334
14013,14013,권태/Noun,6,5,1,7.780371234856063e-05,3.331926519913814e-05,0.8333333333333334
14014,14014,포텐/Noun,6,5,1,7.780371234856063e-05,3.331926519913814e-05,0.8333333333333334
14015,14015,소릴/Noun,6,1,5,3.334444814938313e-05,7.774495213132233e-05,0.8333333333333334
14016,14016,적중/Noun,6,1,5,3.334444814938313e-05,7.774495213132233e-05,0.8333333333333334
14017,14017,장해/Noun,6,5,1,7.780371234856063e-05,3.331926519913814e-05,0.8333333333333334
14018,14018,...-_-;;/Punctuation,6,1,5,3.334444814938313e-05,7.774495213132233e-05,0.8333333333333334
14019,14019,미란/Noun,6,5,1,7.780371234856063e-05,3.331926519913814e-05,0.8333333333333334
14020,14020,~~~~!!!!/Punctuation,6,5,1,7.780371234856063e-05,3.331926519913814e-05,0.8333333333333334
14021,14021,시카고/Noun,6,1,5,3.334444814938313e-05,7.774495213132233e-05,0.8333333333333334
14022,14022,구더기/Noun,6,1,5,3.334444814938313e-05,7.774495213132233e-05,0.8333333333333334
14023,14023,도가니탕/Noun,6,5,1,7.780371234856063e-05,3.331926519913814e-05,0.8333333333333334
14024,14024,훨훨/Noun,6,5,1,7.780371234856063e-05,3.331926519913814e-05,0.8333333333333334
14025,14025,떡볶이/Noun,6,1,5,3.334444814938313e-05,7.774495213132233e-05,0.8333333333333334
14026,14026,작인데/Foreign,6,5,1,7.780371234856063e-05,3.331926519913814e-05,0.8333333333333334
14027,14027,베틀/Noun,6,1,5,3.334444814938313e-05,7.774495213132233e-05,0.8333333333333334
14028,14028,진희/Noun,6,5,1,7.780371234856063e-05,3.331926519913814e-05,0.8333333333333334
14029,14029,떵/Noun,6,1,5,3.334444814938313e-05,7.774495213132233e-05,0.8333333333333334
14030,14030,시가전/Noun,6,5,1,7.780371234856063e-05,3.331926519913814e-05,0.8333333333333334
14031,14031,공지/Noun,6,1,5,3.334444814938313e-05,7.774495213132233e-05,0.8333333333333334
14032,14032,구관/Noun,6,5,1,7.780371234856063e-05,3.331926519913814e-05,0.8333333333333334
14033,14033,집애/Noun,6,1,5,3.334444814938313e-05,7.774495213132233e-05,0.8333333333333334
14034,14034,9.3/Number,6,5,1,7.780371234856063e-05,3.331926519913814e-05,0.8333333333333334
14035,14035,빡빡이/Noun,6,1,5,3.334444814938313e-05,7.774495213132233e-05,0.8333333333333334
14036,14036,힌트/Noun,6,5,1,7.780371234856063e-05,3.331926519913814e-05,0.8333333333333334
14037,14037,여덟/Noun,6,5,1,7.780371234856063e-05,3.331926519913814e-05,0.8333333333333334
14038,14038,반토막/Noun,6,1,5,3.334444814938313e-05,7.774495213132233e-05,0.8333333333333334
14039,14039,스케이트보드/Noun,6,1,5,3.334444814938313e-05,7.774495213132233e-05,0.8333333333333334
14040,14040,항우/Noun,6,5,1,7.780371234856063e-05,3.331926519913814e-05,0.8333333333333334
14041,14041,기면/Noun,6,1,5,3.334444814938313e-05,7.774495213132233e-05,0.8333333333333334
14042,14042,현명/Noun,6,5,1,7.780371234856063e-05,3.331926519913814e-05,0.8333333333333334
14043,14043,임채무/Noun,6,1,5,3.334444814938313e-05,7.774495213132233e-05,0.8333333333333334
14044,14044,Kbs/Alpha,6,1,5,3.334444814938313e-05,7.774495213132233e-05,0.8333333333333334
14045,14045,소환/Noun,6,1,5,3.334444814938313e-05,7.774495213132233e-05,0.8333333333333334
14046,14046,벌벌/Noun,6,5,1,7.780371234856063e-05,3.331926519913814e-05,0.8333333333333334
14047,14047,지문/Noun,6,5,1,7.780371234856063e-05,3.331926519913814e-05,0.8333333333333334
14048,14048,페인트/Noun,6,1,5,3.334444814938313e-05,7.774495213132233e-05,0.8333333333333334
14049,14049,끄덕이다/Verb,6,5,1,7.780371234856063e-05,3.331926519913814e-05,0.8333333333333334
14050,14050,28년/Number,6,5,1,7.780371234856063e-05,3.331926519913814e-05,0.8333333333333334
14051,14051,가/Noun,6,5,1,7.780371234856063e-05,3.331926519913814e-05,0.8333333333333334
14052,14052,유느님/Noun,6,5,1,7.780371234856063e-05,3.331926519913814e-05,0.8333333333333334
14053,14053,지휘자/Noun,6,5,1,7.780371234856063e-05,3.331926519913814e-05,0.8333333333333334
14054,14054,텐/Noun,6,5,1,7.780371234856063e-05,3.331926519913814e-05,0.8333333333333334
14055,14055,불확실하다/Adjective,6,5,1,7.780371234856063e-05,3.331926519913814e-05,0.8333333333333334
14056,14056,백투더퓨처/Noun,6,5,1,7.780371234856063e-05,3.331926519913814e-05,0.8333333333333334
14057,14057,스카이폴/Noun,6,5,1,7.780371234856063e-05,3.331926519913814e-05,0.8333333333333334
14058,14058,추방/Noun,6,1,5,3.334444814938313e-05,7.774495213132233e-05,0.8333333333333334
14059,14059,삼겹살/Noun,6,1,5,3.334444814938313e-05,7.774495213132233e-05,0.8333333333333334
14060,14060,원영/Noun,6,5,1,7.780371234856063e-05,3.331926519913814e-05,0.8333333333333334
14061,14061,시신/Noun,6,5,1,7.780371234856063e-05,3.331926519913814e-05,0.8333333333333334
14062,14062,슬펏/Noun,6,5,1,7.780371234856063e-05,3.331926519913814e-05,0.8333333333333334
14063,14063,허준호/Noun,6,5,1,7.780371234856063e-05,3.331926519913814e-05,0.8333333333333334
14064,14064,관조/Noun,6,5,1,7.780371234856063e-05,3.331926519913814e-05,0.8333333333333334
14065,14065,프리미엄/Noun,6,1,5,3.334444814938313e-05,7.774495213132233e-05,0.8333333333333334
14066,14066,프리즌브레이크/Noun,6,5,1,7.780371234856063e-05,3.331926519913814e-05,0.8333333333333334
14067,14067,상과/Noun,6,5,1,7.780371234856063e-05,3.331926519913814e-05,0.8333333333333334
14068,14068,귀척/Noun,6,1,5,3.334444814938313e-05,7.774495213132233e-05,0.8333333333333334
14069,14069,공블리/Noun,6,5,1,7.780371234856063e-05,3.331926519913814e-05,0.8333333333333334
14070,14070,육식/Noun,6,5,1,7.780371234856063e-05,3.331926519913814e-05,0.8333333333333334
14071,14071,손쉽다/Adjective,6,1,5,3.334444814938313e-05,7.774495213132233e-05,0.8333333333333334
14072,14072,다시없다/Adjective,6,4,2,6.668889629876625e-05,4.4425686932184186e-05,0.6666666666666666
14073,14073,팅/Noun,6,2,4,4.445926419917751e-05,6.663853039827628e-05,0.6666666666666666
14074,14074,키다/Noun,6,2,4,4.445926419917751e-05,6.663853039827628e-05,0.6666666666666666
14075,14075,앨/Noun,6,2,4,4.445926419917751e-05,6.663853039827628e-05,0.6666666666666666
14076,14076,메스/Noun,6,4,2,6.668889629876625e-05,4.4425686932184186e-05,0.6666666666666666
14077,14077,팽배/Noun,6,4,2,6.668889629876625e-05,4.4425686932184186e-05,0.6666666666666666
14078,14078,에로스/Noun,6,2,4,4.445926419917751e-05,6.663853039827628e-05,0.6666666666666666
14079,14079,뷰티풀/Noun,6,2,4,4.445926419917751e-05,6.663853039827628e-05,0.6666666666666666
14080,14080,다발/Noun,6,2,4,4.445926419917751e-05,6.663853039827628e-05,0.6666666666666666
14081,14081,혓바닥/Noun,6,4,2,6.668889629876625e-05,4.4425686932184186e-05,0.6666666666666666
14082,14082,노익/Noun,6,4,2,6.668889629876625e-05,4.4425686932184186e-05,0.6666666666666666
14083,14083,컨디션/Noun,6,2,4,4.445926419917751e-05,6.663853039827628e-05,0.6666666666666666
14084,14084,IT/Alpha,6,4,2,6.668889629876625e-05,4.4425686932184186e-05,0.6666666666666666
14085,14085,혼동/Noun,6,2,4,4.445926419917751e-05,6.663853039827628e-05,0.6666666666666666
14086,14086,진시황/Noun,6,4,2,6.668889629876625e-05,4.4425686932184186e-05,0.6666666666666666
14087,14087,하수/Noun,6,2,4,4.445926419917751e-05,6.663853039827628e-05,0.6666666666666666
14088,14088,꿋꿋/Noun,6,4,2,6.668889629876625e-05,4.4425686932184186e-05,0.6666666666666666
14089,14089,바우어/Noun,6,4,2,6.668889629876625e-05,4.4425686932184186e-05,0.6666666666666666
14090,14090,12시/Number,6,4,2,6.668889629876625e-05,4.4425686932184186e-05,0.6666666666666666
14091,14091,....;/Punctuation,6,2,4,4.445926419917751e-05,6.663853039827628e-05,0.6666666666666666
14092,14092,차수연/Noun,6,4,2,6.668889629876625e-05,4.4425686932184186e-05,0.6666666666666666
14093,14093,눌/Noun,6,2,4,4.445926419917751e-05,6.663853039827628e-05,0.6666666666666666
14094,14094,애완견/Noun,6,4,2,6.668889629876625e-05,4.4425686932184186e-05,0.6666666666666666
14095,14095,아나콘다/Noun,6,2,4,4.445926419917751e-05,6.663853039827628e-05,0.6666666666666666
14096,14096,아기자기/Noun,6,4,2,6.668889629876625e-05,4.4425686932184186e-05,0.6666666666666666
14097,14097,수상/Noun,6,2,4,4.445926419917751e-05,6.663853039827628e-05,0.6666666666666666
14098,14098,갱스부르/Noun,6,4,2,6.668889629876625e-05,4.4425686932184186e-05,0.6666666666666666
14099,14099,중인/Noun,6,4,2,6.668889629876625e-05,4.4425686932184186e-05,0.6666666666666666
14100,14100,조단/Noun,6,2,4,4.445926419917751e-05,6.663853039827628e-05,0.6666666666666666
14101,14101,로빈훗/Noun,6,2,4,4.445926419917751e-05,6.663853039827628e-05,0.6666666666666666
14102,14102,이라기보단/Josa,6,2,4,4.445926419917751e-05,6.663853039827628e-05,0.6666666666666666
14103,14103,마치다/Verb,6,4,2,6.668889629876625e-05,4.4425686932184186e-05,0.6666666666666666
14104,14104,금세/Noun,6,4,2,6.668889629876625e-05,4.4425686932184186e-05,0.6666666666666666
14105,14105,드루/Noun,6,2,4,4.445926419917751e-05,6.663853039827628e-05,0.6666666666666666
14106,14106,표준/Noun,6,4,2,6.668889629876625e-05,4.4425686932184186e-05,0.6666666666666666
14107,14107,인자/Noun,6,4,2,6.668889629876625e-05,4.4425686932184186e-05,0.6666666666666666
14108,14108,틈틈이/Noun,6,4,2,6.668889629876625e-05,4.4425686932184186e-05,0.6666666666666666
14109,14109,ㅇㅂ/KoreanParticle,6,4,2,6.668889629876625e-05,4.4425686932184186e-05,0.6666666666666666
14110,14110,상적/Noun,6,2,4,4.445926419917751e-05,6.663853039827628e-05,0.6666666666666666
14111,14111,교황/Noun,6,4,2,6.668889629876625e-05,4.4425686932184186e-05,0.6666666666666666
14112,14112,색도/Noun,6,4,2,6.668889629876625e-05,4.4425686932184186e-05,0.6666666666666666
14113,14113,소세지/Noun,6,2,4,4.445926419917751e-05,6.663853039827628e-05,0.6666666666666666
14114,14114,영동/Noun,6,4,2,6.668889629876625e-05,4.4425686932184186e-05,0.6666666666666666
14115,14115,표류/Noun,6,2,4,4.445926419917751e-05,6.663853039827628e-05,0.6666666666666666
14116,14116,순순하다/Adjective,6,4,2,6.668889629876625e-05,4.4425686932184186e-05,0.6666666666666666
14117,14117,캔/Noun,6,4,2,6.668889629876625e-05,4.4425686932184186e-05,0.6666666666666666
14118,14118,혼내다/Verb,6,2,4,4.445926419917751e-05,6.663853039827628e-05,0.6666666666666666
14119,14119,단추/Noun,6,2,4,4.445926419917751e-05,6.663853039827628e-05,0.6666666666666666
14120,14120,독일인/Noun,6,2,4,4.445926419917751e-05,6.663853039827628e-05,0.6666666666666666
14121,14121,준호/Noun,6,4,2,6.668889629876625e-05,4.4425686932184186e-05,0.6666666666666666
14122,14122,이다지/Noun,6,4,2,6.668889629876625e-05,4.4425686932184186e-05,0.6666666666666666
14123,14123,음원/Noun,6,4,2,6.668889629876625e-05,4.4425686932184186e-05,0.6666666666666666
14124,14124,Of/Alpha,6,4,2,6.668889629876625e-05,4.4425686932184186e-05,0.6666666666666666
14125,14125,)(/Punctuation,6,4,2,6.668889629876625e-05,4.4425686932184186e-05,0.6666666666666666
14126,14126,넉/Noun,6,2,4,4.445926419917751e-05,6.663853039827628e-05,0.6666666666666666
14127,14127,서여/Noun,6,2,4,4.445926419917751e-05,6.663853039827628e-05,0.6666666666666666
14128,14128,제크로무/Noun,6,4,2,6.668889629876625e-05,4.4425686932184186e-05,0.6666666666666666
14129,14129,1988년/Number,6,4,2,6.668889629876625e-05,4.4425686932184186e-05,0.6666666666666666
14130,14130,리사/Noun,6,2,4,4.445926419917751e-05,6.663853039827628e-05,0.6666666666666666
14131,14131,장강/Noun,6,4,2,6.668889629876625e-05,4.4425686932184186e-05,0.6666666666666666
14132,14132,그떄/Noun,6,4,2,6.668889629876625e-05,4.4425686932184186e-05,0.6666666666666666
14133,14133,운동화/Noun,6,4,2,6.668889629876625e-05,4.4425686932184186e-05,0.6666666666666666
14134,14134,~_~/Punctuation,6,2,4,4.445926419917751e-05,6.663853039827628e-05,0.6666666666666666
14135,14135,분해/Noun,6,2,4,4.445926419917751e-05,6.663853039827628e-05,0.6666666666666666
14136,14136,시댁/Noun,6,2,4,4.445926419917751e-05,6.663853039827628e-05,0.6666666666666666
14137,14137,영드/Noun,6,4,2,6.668889629876625e-05,4.4425686932184186e-05,0.6666666666666666
14138,14138,트라이앵글/Noun,6,2,4,4.445926419917751e-05,6.663853039827628e-05,0.6666666666666666
14139,14139,박정철/Noun,6,2,4,4.445926419917751e-05,6.663853039827628e-05,0.6666666666666666
14140,14140,풀기/Noun,6,2,4,4.445926419917751e-05,6.663853039827628e-05,0.6666666666666666
14141,14141,쇼트/Noun,6,4,2,6.668889629876625e-05,4.4425686932184186e-05,0.6666666666666666
14142,14142,메이커/Noun,6,4,2,6.668889629876625e-05,4.4425686932184186e-05,0.6666666666666666
14143,14143,실하다/Adjective,6,2,4,4.445926419917751e-05,6.663853039827628e-05,0.6666666666666666
14144,14144,첫걸음/Noun,6,4,2,6.668889629876625e-05,4.4425686932184186e-05,0.6666666666666666
14145,14145,38/Number,6,2,4,4.445926419917751e-05,6.663853039827628e-05,0.6666666666666666
14146,14146,스피릿/Noun,6,4,2,6.668889629876625e-05,4.4425686932184186e-05,0.6666666666666666
14147,14147,스웨/Noun,6,4,2,6.668889629876625e-05,4.4425686932184186e-05,0.6666666666666666
14148,14148,닥터진/Noun,6,2,4,4.445926419917751e-05,6.663853039827628e-05,0.6666666666666666
14149,14149,먼로/Noun,6,4,2,6.668889629876625e-05,4.4425686932184186e-05,0.6666666666666666
14150,14150,죠/Noun,6,2,4,4.445926419917751e-05,6.663853039827628e-05,0.6666666666666666
14151,14151,8시/Number,6,2,4,4.445926419917751e-05,6.663853039827628e-05,0.6666666666666666
14152,14152,웃겻다/Noun,6,4,2,6.668889629876625e-05,4.4425686932184186e-05,0.6666666666666666
14153,14153,고구려/Noun,6,2,4,4.445926419917751e-05,6.663853039827628e-05,0.6666666666666666
14154,14154,단번/Noun,6,4,2,6.668889629876625e-05,4.4425686932184186e-05,0.6666666666666666
14155,14155,지름길/Noun,6,2,4,4.445926419917751e-05,6.663853039827628e-05,0.6666666666666666
14156,14156,흐음/Exclamation,6,4,2,6.668889629876625e-05,4.4425686932184186e-05,0.6666666666666666
14157,14157,아리랑/Noun,6,4,2,6.668889629876625e-05,4.4425686932184186e-05,0.6666666666666666
14158,14158,신참/Noun,6,2,4,4.445926419917751e-05,6.663853039827628e-05,0.6666666666666666
14159,14159,까불다/Verb,6,2,4,4.445926419917751e-05,6.663853039827628e-05,0.6666666666666666
14160,14160,번가/Noun,6,4,2,6.668889629876625e-05,4.4425686932184186e-05,0.6666666666666666
14161,14161,싹트다/Verb,6,4,2,6.668889629876625e-05,4.4425686932184186e-05,0.6666666666666666
14162,14162,테크닉/Noun,6,2,4,4.445926419917751e-05,6.663853039827628e-05,0.6666666666666666
14163,14163,예뻣다/Noun,6,4,2,6.668889629876625e-05,4.4425686932184186e-05,0.6666666666666666
14164,14164,복수혈전/Noun,6,2,4,4.445926419917751e-05,6.663853039827628e-05,0.6666666666666666
14165,14165,가두/Noun,6,4,2,6.668889629876625e-05,4.4425686932184186e-05,0.6666666666666666
14166,14166,촛점/Noun,6,4,2,6.668889629876625e-05,4.4425686932184186e-05,0.6666666666666666
14167,14167,83년/Number,6,2,4,4.445926419917751e-05,6.663853039827628e-05,0.6666666666666666
14168,14168,오경/Noun,6,2,4,4.445926419917751e-05,6.663853039827628e-05,0.6666666666666666
14169,14169,지노/Noun,6,2,4,4.445926419917751e-05,6.663853039827628e-05,0.6666666666666666
14170,14170,도사/Noun,6,4,2,6.668889629876625e-05,4.4425686932184186e-05,0.6666666666666666
14171,14171,엣지/Noun,6,4,2,6.668889629876625e-05,4.4425686932184186e-05,0.6666666666666666
14172,14172,인방/Noun,6,2,4,4.445926419917751e-05,6.663853039827628e-05,0.6666666666666666
14173,14173,은총/Noun,6,4,2,6.668889629876625e-05,4.4425686932184186e-05,0.6666666666666666
14174,14174,중/Foreign,6,2,4,4.445926419917751e-05,6.663853039827628e-05,0.6666666666666666
14175,14175,베니스/Noun,6,2,4,4.445926419917751e-05,6.663853039827628e-05,0.6666666666666666
14176,14176,텍스트/Noun,6,2,4,4.445926419917751e-05,6.663853039827628e-05,0.6666666666666666
14177,14177,스튜디오/Noun,6,2,4,4.445926419917751e-05,6.663853039827628e-05,0.6666666666666666
14178,14178,소나타/Noun,6,4,2,6.668889629876625e-05,4.4425686932184186e-05,0.6666666666666666
14179,14179,말살/Noun,6,4,2,6.668889629876625e-05,4.4425686932184186e-05,0.6666666666666666
14180,14180,1999/Number,6,2,4,4.445926419917751e-05,6.663853039827628e-05,0.6666666666666666
14181,14181,불완전하다/Adjective,6,4,2,6.668889629876625e-05,4.4425686932184186e-05,0.6666666666666666
14182,14182,신밧드/Noun,6,2,4,4.445926419917751e-05,6.663853039827628e-05,0.6666666666666666
14183,14183,심장마비/Noun,6,2,4,4.445926419917751e-05,6.663853039827628e-05,0.6666666666666666
14184,14184,교인/Noun,6,4,2,6.668889629876625e-05,4.4425686932184186e-05,0.6666666666666666
14185,14185,짜릿/Noun,6,4,2,6.668889629876625e-05,4.4425686932184186e-05,0.6666666666666666
14186,14186,알바인/Noun,6,2,4,4.445926419917751e-05,6.663853039827628e-05,0.6666666666666666
14187,14187,심지호/Noun,6,4,2,6.668889629876625e-05,4.4425686932184186e-05,0.6666666666666666
14188,14188,솔져/Noun,6,2,4,4.445926419917751e-05,6.663853039827628e-05,0.6666666666666666
14189,14189,외적/Noun,6,2,4,4.445926419917751e-05,6.663853039827628e-05,0.6666666666666666
14190,14190,김상중/Noun,6,4,2,6.668889629876625e-05,4.4425686932184186e-05,0.6666666666666666
14191,14191,영화에서처럼/Noun,6,2,4,4.445926419917751e-05,6.663853039827628e-05,0.6666666666666666
14192,14192,절단/Noun,6,4,2,6.668889629876625e-05,4.4425686932184186e-05,0.6666666666666666
14193,14193,전지전능하다/Adjective,6,2,4,4.445926419917751e-05,6.663853039827628e-05,0.6666666666666666
14194,14194,헤아리다/Verb,6,4,2,6.668889629876625e-05,4.4425686932184186e-05,0.6666666666666666
14195,14195,사후세계/Noun,6,4,2,6.668889629876625e-05,4.4425686932184186e-05,0.6666666666666666
14196,14196,한바탕/Noun,6,4,2,6.668889629876625e-05,4.4425686932184186e-05,0.6666666666666666
14197,14197,머신/Noun,6,2,4,4.445926419917751e-05,6.663853039827628e-05,0.6666666666666666
14198,14198,이다희/Noun,6,4,2,6.668889629876625e-05,4.4425686932184186e-05,0.6666666666666666
14199,14199,문의/Noun,6,2,4,4.445926419917751e-05,6.663853039827628e-05,0.6666666666666666
14200,14200,마여/Noun,6,2,4,4.445926419917751e-05,6.663853039827628e-05,0.6666666666666666
14201,14201,흡/Exclamation,6,4,2,6.668889629876625e-05,4.4425686932184186e-05,0.6666666666666666
14202,14202,야간/Noun,6,4,2,6.668889629876625e-05,4.4425686932184186e-05,0.6666666666666666
14203,14203,자폐증/Noun,6,4,2,6.668889629876625e-05,4.4425686932184186e-05,0.6666666666666666
14204,14204,신년/Noun,6,2,4,4.445926419917751e-05,6.663853039827628e-05,0.6666666666666666
14205,14205,시공/Noun,6,2,4,4.445926419917751e-05,6.663853039827628e-05,0.6666666666666666
14206,14206,서술/Noun,6,2,4,4.445926419917751e-05,6.663853039827628e-05,0.6666666666666666
14207,14207,막대/Noun,6,2,4,4.445926419917751e-05,6.663853039827628e-05,0.6666666666666666
14208,14208,??;;/Punctuation,6,2,4,4.445926419917751e-05,6.663853039827628e-05,0.6666666666666666
14209,14209,틀어지다/Verb,6,2,4,4.445926419917751e-05,6.663853039827628e-05,0.6666666666666666
14210,14210,익스펜더블/Noun,6,4,2,6.668889629876625e-05,4.4425686932184186e-05,0.6666666666666666
14211,14211,외출/Noun,6,4,2,6.668889629876625e-05,4.4425686932184186e-05,0.6666666666666666
14212,14212,분쇄기/Noun,6,2,4,4.445926419917751e-05,6.663853039827628e-05,0.6666666666666666
14213,14213,저가/Noun,6,2,4,4.445926419917751e-05,6.663853039827628e-05,0.6666666666666666
14214,14214,토가시/Noun,6,2,4,4.445926419917751e-05,6.663853039827628e-05,0.6666666666666666
14215,14215,라니까/Josa,6,2,4,4.445926419917751e-05,6.663853039827628e-05,0.6666666666666666
14216,14216,"....,/Punctuation",6,2,4,4.445926419917751e-05,6.663853039827628e-05,0.6666666666666666
14217,14217,한결/Noun,6,4,2,6.668889629876625e-05,4.4425686932184186e-05,0.6666666666666666
14218,14218,야만인/Noun,6,4,2,6.668889629876625e-05,4.4425686932184186e-05,0.6666666666666666
14219,14219,이블/Noun,6,2,4,4.445926419917751e-05,6.663853039827628e-05,0.6666666666666666
14220,14220,ANG/Alpha,6,4,2,6.668889629876625e-05,4.4425686932184186e-05,0.6666666666666666
14221,14221,티브/Noun,6,2,4,4.445926419917751e-05,6.663853039827628e-05,0.6666666666666666
14222,14222,가모/Noun,6,4,2,6.668889629876625e-05,4.4425686932184186e-05,0.6666666666666666
14223,14223,재정/Noun,6,2,4,4.445926419917751e-05,6.663853039827628e-05,0.6666666666666666
14224,14224,웃찾사/Noun,6,2,4,4.445926419917751e-05,6.663853039827628e-05,0.6666666666666666
14225,14225,변기/Noun,6,2,4,4.445926419917751e-05,6.663853039827628e-05,0.6666666666666666
14226,14226,간략하다/Adjective,6,2,4,4.445926419917751e-05,6.663853039827628e-05,0.6666666666666666
14227,14227,스티치/Noun,6,4,2,6.668889629876625e-05,4.4425686932184186e-05,0.6666666666666666
14228,14228,직후/Noun,6,4,2,6.668889629876625e-05,4.4425686932184186e-05,0.6666666666666666
14229,14229,우의/Noun,6,4,2,6.668889629876625e-05,4.4425686932184186e-05,0.6666666666666666
14230,14230,버터/Noun,6,4,2,6.668889629876625e-05,4.4425686932184186e-05,0.6666666666666666
14231,14231,영화개봉/Noun,6,4,2,6.668889629876625e-05,4.4425686932184186e-05,0.6666666666666666
14232,14232,패쓰/Noun,6,2,4,4.445926419917751e-05,6.663853039827628e-05,0.6666666666666666
14233,14233,)+/Punctuation,6,4,2,6.668889629876625e-05,4.4425686932184186e-05,0.6666666666666666
14234,14234,...!!!!/Punctuation,6,4,2,6.668889629876625e-05,4.4425686932184186e-05,0.6666666666666666
14235,14235,험하다/Adjective,6,4,2,6.668889629876625e-05,4.4425686932184186e-05,0.6666666666666666
14236,14236,130/Number,6,2,4,4.445926419917751e-05,6.663853039827628e-05,0.6666666666666666
14237,14237,알아채다/Verb,6,2,4,4.445926419917751e-05,6.663853039827628e-05,0.6666666666666666
14238,14238,영영/Noun,6,2,4,4.445926419917751e-05,6.663853039827628e-05,0.6666666666666666
14239,14239,캐시/Noun,6,4,2,6.668889629876625e-05,4.4425686932184186e-05,0.6666666666666666
14240,14240,힌/Noun,6,4,2,6.668889629876625e-05,4.4425686932184186e-05,0.6666666666666666
14241,14241,csi/Alpha,6,4,2,6.668889629876625e-05,4.4425686932184186e-05,0.6666666666666666
14242,14242,이블데드/Noun,6,4,2,6.668889629876625e-05,4.4425686932184186e-05,0.6666666666666666
14243,14243,잡것/Noun,6,2,4,4.445926419917751e-05,6.663853039827628e-05,0.6666666666666666
14244,14244,이스/Noun,6,4,2,6.668889629876625e-05,4.4425686932184186e-05,0.6666666666666666
14245,14245,여우주연상/Noun,6,4,2,6.668889629876625e-05,4.4425686932184186e-05,0.6666666666666666
14246,14246,양대/Modifier,6,4,2,6.668889629876625e-05,4.4425686932184186e-05,0.6666666666666666
14247,14247,란말/Noun,6,2,4,4.445926419917751e-05,6.663853039827628e-05,0.6666666666666666
14248,14248,역도/Noun,6,4,2,6.668889629876625e-05,4.4425686932184186e-05,0.6666666666666666
14249,14249,수임/Noun,6,2,4,4.445926419917751e-05,6.663853039827628e-05,0.6666666666666666
14250,14250,피크닉/Noun,6,4,2,6.668889629876625e-05,4.4425686932184186e-05,0.6666666666666666
14251,14251,텅텅/Noun,6,2,4,4.445926419917751e-05,6.663853039827628e-05,0.6666666666666666
14252,14252,셧으/Noun,6,4,2,6.668889629876625e-05,4.4425686932184186e-05,0.6666666666666666
14253,14253,핡/Noun,6,4,2,6.668889629876625e-05,4.4425686932184186e-05,0.6666666666666666
14254,14254,도미/Noun,6,2,4,4.445926419917751e-05,6.663853039827628e-05,0.6666666666666666
14255,14255,자크/Noun,6,4,2,6.668889629876625e-05,4.4425686932184186e-05,0.6666666666666666
14256,14256,'../Punctuation,6,4,2,6.668889629876625e-05,4.4425686932184186e-05,0.6666666666666666
14257,14257,칭/Noun,6,4,2,6.668889629876625e-05,4.4425686932184186e-05,0.6666666666666666
14258,14258,자꾸자꾸/Adverb,6,4,2,6.668889629876625e-05,4.4425686932184186e-05,0.6666666666666666
14259,14259,들썩이다/Verb,6,4,2,6.668889629876625e-05,4.4425686932184186e-05,0.6666666666666666
14260,14260,유토피아/Noun,6,4,2,6.668889629876625e-05,4.4425686932184186e-05,0.6666666666666666
14261,14261,후끈/Noun,6,4,2,6.668889629876625e-05,4.4425686932184186e-05,0.6666666666666666
14262,14262,동호회/Noun,6,2,4,4.445926419917751e-05,6.663853039827628e-05,0.6666666666666666
14263,14263,뻐꾸기/Noun,6,2,4,4.445926419917751e-05,6.663853039827628e-05,0.6666666666666666
14264,14264,복사기/Noun,6,4,2,6.668889629876625e-05,4.4425686932184186e-05,0.6666666666666666
14265,14265,거슬러/Noun,6,2,4,4.445926419917751e-05,6.663853039827628e-05,0.6666666666666666
14266,14266,바네사/Noun,6,4,2,6.668889629876625e-05,4.4425686932184186e-05,0.6666666666666666
14267,14267,박멸/Noun,6,2,4,4.445926419917751e-05,6.663853039827628e-05,0.6666666666666666
14268,14268,시들다/Verb,6,4,2,6.668889629876625e-05,4.4425686932184186e-05,0.6666666666666666
14269,14269,요건/Noun,6,2,4,4.445926419917751e-05,6.663853039827628e-05,0.6666666666666666
14270,14270,덤블도어/Noun,6,4,2,6.668889629876625e-05,4.4425686932184186e-05,0.6666666666666666
14271,14271,코믹스/Noun,6,2,4,4.445926419917751e-05,6.663853039827628e-05,0.6666666666666666
14272,14272,남탓/Noun,6,2,4,4.445926419917751e-05,6.663853039827628e-05,0.6666666666666666
14273,14273,글치/Noun,6,4,2,6.668889629876625e-05,4.4425686932184186e-05,0.6666666666666666
14274,14274,그레이엄/Noun,6,2,4,4.445926419917751e-05,6.663853039827628e-05,0.6666666666666666
14275,14275,67년/Number,6,4,2,6.668889629876625e-05,4.4425686932184186e-05,0.6666666666666666
14276,14276,브레인/Noun,6,4,2,6.668889629876625e-05,4.4425686932184186e-05,0.6666666666666666
14277,14277,ㅣㅇ/KoreanParticle,6,4,2,6.668889629876625e-05,4.4425686932184186e-05,0.6666666666666666
14278,14278,병아리/Noun,6,4,2,6.668889629876625e-05,4.4425686932184186e-05,0.6666666666666666
14279,14279,스테이/Noun,6,2,4,4.445926419917751e-05,6.663853039827628e-05,0.6666666666666666
14280,14280,템/Noun,6,2,4,4.445926419917751e-05,6.663853039827628e-05,0.6666666666666666
14281,14281,열렬하다/Adjective,6,4,2,6.668889629876625e-05,4.4425686932184186e-05,0.6666666666666666
14282,14282,킬머/Noun,6,4,2,6.668889629876625e-05,4.4425686932184186e-05,0.6666666666666666
14283,14283,볼순/Noun,6,4,2,6.668889629876625e-05,4.4425686932184186e-05,0.6666666666666666
14284,14284,동질감/Noun,6,4,2,6.668889629876625e-05,4.4425686932184186e-05,0.6666666666666666
14285,14285,유로트립/Noun,6,2,4,4.445926419917751e-05,6.663853039827628e-05,0.6666666666666666
14286,14286,노모/Noun,6,2,4,4.445926419917751e-05,6.663853039827628e-05,0.6666666666666666
14287,14287,주고받다/Verb,6,2,4,4.445926419917751e-05,6.663853039827628e-05,0.6666666666666666
14288,14288,대종상/Noun,6,4,2,6.668889629876625e-05,4.4425686932184186e-05,0.6666666666666666
14289,14289,후다닥/Noun,6,2,4,4.445926419917751e-05,6.663853039827628e-05,0.6666666666666666
14290,14290,관장/Noun,6,4,2,6.668889629876625e-05,4.4425686932184186e-05,0.6666666666666666
14291,14291,파쇼/Noun,6,2,4,4.445926419917751e-05,6.663853039827628e-05,0.6666666666666666
14292,14292,中/Foreign,6,4,2,6.668889629876625e-05,4.4425686932184186e-05,0.6666666666666666
14293,14293,김광석/Noun,6,4,2,6.668889629876625e-05,4.4425686932184186e-05,0.6666666666666666
14294,14294,촘촘/Noun,6,4,2,6.668889629876625e-05,4.4425686932184186e-05,0.6666666666666666
14295,14295,웁니/Noun,6,4,2,6.668889629876625e-05,4.4425686932184186e-05,0.6666666666666666
14296,14296,코미디언/Noun,6,4,2,6.668889629876625e-05,4.4425686932184186e-05,0.6666666666666666
14297,14297,난장/Noun,6,2,4,4.445926419917751e-05,6.663853039827628e-05,0.6666666666666666
14298,14298,얼얼하다/Adjective,6,4,2,6.668889629876625e-05,4.4425686932184186e-05,0.6666666666666666
14299,14299,여성성/Noun,6,2,4,4.445926419917751e-05,6.663853039827628e-05,0.6666666666666666
14300,14300,85분/Number,6,2,4,4.445926419917751e-05,6.663853039827628e-05,0.6666666666666666
14301,14301,가타/Noun,6,4,2,6.668889629876625e-05,4.4425686932184186e-05,0.6666666666666666
14302,14302,시실리/Noun,6,2,4,4.445926419917751e-05,6.663853039827628e-05,0.6666666666666666
14303,14303,비루하다/Adjective,6,2,4,4.445926419917751e-05,6.663853039827628e-05,0.6666666666666666
14304,14304,명인/Noun,6,2,4,4.445926419917751e-05,6.663853039827628e-05,0.6666666666666666
14305,14305,사이버/Noun,6,4,2,6.668889629876625e-05,4.4425686932184186e-05,0.6666666666666666
14306,14306,태원/Noun,6,2,4,4.445926419917751e-05,6.663853039827628e-05,0.6666666666666666
14307,14307,관세음보살/Noun,6,2,4,4.445926419917751e-05,6.663853039827628e-05,0.6666666666666666
14308,14308,애란/Noun,6,2,4,4.445926419917751e-05,6.663853039827628e-05,0.6666666666666666
14309,14309,프로메테우스/Noun,6,4,2,6.668889629876625e-05,4.4425686932184186e-05,0.6666666666666666
14310,14310,음란하다/Adjective,6,2,4,4.445926419917751e-05,6.663853039827628e-05,0.6666666666666666
14311,14311,뿜었음/Noun,6,2,4,4.445926419917751e-05,6.663853039827628e-05,0.6666666666666666
14312,14312,저팔계/Noun,6,2,4,4.445926419917751e-05,6.663853039827628e-05,0.6666666666666666
14313,14313,그리드/Noun,6,4,2,6.668889629876625e-05,4.4425686932184186e-05,0.6666666666666666
14314,14314,작품하나/Noun,6,4,2,6.668889629876625e-05,4.4425686932184186e-05,0.6666666666666666
14315,14315,남기남/Noun,6,2,4,4.445926419917751e-05,6.663853039827628e-05,0.6666666666666666
14316,14316,파라다이스/Noun,6,4,2,6.668889629876625e-05,4.4425686932184186e-05,0.6666666666666666
14317,14317,뱃속/Noun,6,2,4,4.445926419917751e-05,6.663853039827628e-05,0.6666666666666666
14318,14318,전염병/Noun,6,4,2,6.668889629876625e-05,4.4425686932184186e-05,0.6666666666666666
14319,14319,68년/Number,6,4,2,6.668889629876625e-05,4.4425686932184186e-05,0.6666666666666666
14320,14320,타래/Noun,6,4,2,6.668889629876625e-05,4.4425686932184186e-05,0.6666666666666666
14321,14321,단합/Noun,6,4,2,6.668889629876625e-05,4.4425686932184186e-05,0.6666666666666666
14322,14322,정독/Noun,6,2,4,4.445926419917751e-05,6.663853039827628e-05,0.6666666666666666
14323,14323,엠마뉴엘/Noun,6,4,2,6.668889629876625e-05,4.4425686932184186e-05,0.6666666666666666
14324,14324,컬킨/Noun,6,4,2,6.668889629876625e-05,4.4425686932184186e-05,0.6666666666666666
14325,14325,컬리/Noun,6,2,4,4.445926419917751e-05,6.663853039827628e-05,0.6666666666666666
14326,14326,고단/Noun,6,4,2,6.668889629876625e-05,4.4425686932184186e-05,0.6666666666666666
14327,14327,이이이/Noun,6,2,4,4.445926419917751e-05,6.663853039827628e-05,0.6666666666666666
14328,14328,식욕/Noun,6,4,2,6.668889629876625e-05,4.4425686932184186e-05,0.6666666666666666
14329,14329,도도하다/Adjective,6,4,2,6.668889629876625e-05,4.4425686932184186e-05,0.6666666666666666
14330,14330,계백/Noun,6,2,4,4.445926419917751e-05,6.663853039827628e-05,0.6666666666666666
14331,14331,올여름/Noun,6,4,2,6.668889629876625e-05,4.4425686932184186e-05,0.6666666666666666
14332,14332,수난/Noun,6,2,4,4.445926419917751e-05,6.663853039827628e-05,0.6666666666666666
14333,14333,2009/Number,6,4,2,6.668889629876625e-05,4.4425686932184186e-05,0.6666666666666666
14334,14334,스탠바이/Noun,6,4,2,6.668889629876625e-05,4.4425686932184186e-05,0.6666666666666666
14335,14335,차돌/Noun,6,4,2,6.668889629876625e-05,4.4425686932184186e-05,0.6666666666666666
14336,14336,박세영/Noun,6,4,2,6.668889629876625e-05,4.4425686932184186e-05,0.6666666666666666
14337,14337,재팬/Noun,6,2,4,4.445926419917751e-05,6.663853039827628e-05,0.6666666666666666
14338,14338,만두/Noun,6,2,4,4.445926419917751e-05,6.663853039827628e-05,0.6666666666666666
14339,14339,특기/Noun,6,2,4,4.445926419917751e-05,6.663853039827628e-05,0.6666666666666666
14340,14340,먀/Noun,6,2,4,4.445926419917751e-05,6.663853039827628e-05,0.6666666666666666
14341,14341,냠냠/Adverb,6,2,4,4.445926419917751e-05,6.663853039827628e-05,0.6666666666666666
14342,14342,활기차다/Adjective,6,4,2,6.668889629876625e-05,4.4425686932184186e-05,0.6666666666666666
14343,14343,tvn/Alpha,6,4,2,6.668889629876625e-05,4.4425686932184186e-05,0.6666666666666666
14344,14344,입대/Noun,6,4,2,6.668889629876625e-05,4.4425686932184186e-05,0.6666666666666666
14345,14345,백만불/Noun,6,2,4,4.445926419917751e-05,6.663853039827628e-05,0.6666666666666666
14346,14346,망은/Noun,6,4,2,6.668889629876625e-05,4.4425686932184186e-05,0.6666666666666666
14347,14347,사면/Noun,6,4,2,6.668889629876625e-05,4.4425686932184186e-05,0.6666666666666666
14348,14348,78년/Number,6,4,2,6.668889629876625e-05,4.4425686932184186e-05,0.6666666666666666
14349,14349,임주환/Noun,6,4,2,6.668889629876625e-05,4.4425686932184186e-05,0.6666666666666666
14350,14350,알콜/Noun,6,4,2,6.668889629876625e-05,4.4425686932184186e-05,0.6666666666666666
14351,14351,백화점/Noun,6,4,2,6.668889629876625e-05,4.4425686932184186e-05,0.6666666666666666
14352,14352,시집가다/Verb,6,2,4,4.445926419917751e-05,6.663853039827628e-05,0.6666666666666666
14353,14353,펑/Noun,6,4,2,6.668889629876625e-05,4.4425686932184186e-05,0.6666666666666666
14354,14354,국방부/Noun,6,2,4,4.445926419917751e-05,6.663853039827628e-05,0.6666666666666666
14355,14355,!!!!!!!!!!!!!!!/Punctuation,6,4,2,6.668889629876625e-05,4.4425686932184186e-05,0.6666666666666666
14356,14356,종려시/Noun,6,2,4,4.445926419917751e-05,6.663853039827628e-05,0.6666666666666666
14357,14357,할애/Noun,6,2,4,4.445926419917751e-05,6.663853039827628e-05,0.6666666666666666
14358,14358,패러디영화/Noun,6,2,4,4.445926419917751e-05,6.663853039827628e-05,0.6666666666666666
14359,14359,아성/Noun,6,4,2,6.668889629876625e-05,4.4425686932184186e-05,0.6666666666666666
14360,14360,장률/Noun,6,4,2,6.668889629876625e-05,4.4425686932184186e-05,0.6666666666666666
14361,14361,산전수전/Noun,6,2,4,4.445926419917751e-05,6.663853039827628e-05,0.6666666666666666
14362,14362,분리/Noun,6,4,2,6.668889629876625e-05,4.4425686932184186e-05,0.6666666666666666
14363,14363,Movie/Alpha,6,4,2,6.668889629876625e-05,4.4425686932184186e-05,0.6666666666666666
14364,14364,사이사이/Noun,6,4,2,6.668889629876625e-05,4.4425686932184186e-05,0.6666666666666666
14365,14365,",,,,,,,/Punctuation",6,2,4,4.445926419917751e-05,6.663853039827628e-05,0.6666666666666666
14366,14366,스타일리시/Noun,6,4,2,6.668889629876625e-05,4.4425686932184186e-05,0.6666666666666666
14367,14367,차림/Noun,6,2,4,4.445926419917751e-05,6.663853039827628e-05,0.6666666666666666
14368,14368,달고나/Noun,6,2,4,4.445926419917751e-05,6.663853039827628e-05,0.6666666666666666
14369,14369,부인과/Noun,6,2,4,4.445926419917751e-05,6.663853039827628e-05,0.6666666666666666
14370,14370,하드캐리/Noun,6,4,2,6.668889629876625e-05,4.4425686932184186e-05,0.6666666666666666
14371,14371,7회/Number,6,2,4,4.445926419917751e-05,6.663853039827628e-05,0.6666666666666666
14372,14372,간통/Noun,6,2,4,4.445926419917751e-05,6.663853039827628e-05,0.6666666666666666
14373,14373,야외/Noun,6,4,2,6.668889629876625e-05,4.4425686932184186e-05,0.6666666666666666
14374,14374,식히다/Verb,6,4,2,6.668889629876625e-05,4.4425686932184186e-05,0.6666666666666666
14375,14375,장장/Modifier,6,4,2,6.668889629876625e-05,4.4425686932184186e-05,0.6666666666666666
14376,14376,서퍼/Noun,6,2,4,4.445926419917751e-05,6.663853039827628e-05,0.6666666666666666
14377,14377,젤리/Noun,6,4,2,6.668889629876625e-05,4.4425686932184186e-05,0.6666666666666666
14378,14378,궁굼하/Noun,6,2,4,4.445926419917751e-05,6.663853039827628e-05,0.6666666666666666
14379,14379,녹색/Noun,6,4,2,6.668889629876625e-05,4.4425686932184186e-05,0.6666666666666666
14380,14380,콘돔/Noun,6,2,4,4.445926419917751e-05,6.663853039827628e-05,0.6666666666666666
14381,14381,도엔/Foreign,6,2,4,4.445926419917751e-05,6.663853039827628e-05,0.6666666666666666
14382,14382,스토킹/Noun,6,2,4,4.445926419917751e-05,6.663853039827628e-05,0.6666666666666666
14383,14383,녜/Noun,6,2,4,4.445926419917751e-05,6.663853039827628e-05,0.6666666666666666
14384,14384,섹쉬/Noun,6,2,4,4.445926419917751e-05,6.663853039827628e-05,0.6666666666666666
14385,14385,종방/Noun,6,4,2,6.668889629876625e-05,4.4425686932184186e-05,0.6666666666666666
14386,14386,사항/Noun,6,4,2,6.668889629876625e-05,4.4425686932184186e-05,0.6666666666666666
14387,14387,이임/Noun,6,4,2,6.668889629876625e-05,4.4425686932184186e-05,0.6666666666666666
14388,14388,끌어당기다/Verb,6,2,4,4.445926419917751e-05,6.663853039827628e-05,0.6666666666666666
14389,14389,훈련소/Noun,6,2,4,4.445926419917751e-05,6.663853039827628e-05,0.6666666666666666
14390,14390,소희/Noun,6,4,2,6.668889629876625e-05,4.4425686932184186e-05,0.6666666666666666
14391,14391,꽉꽉/Adverb,6,4,2,6.668889629876625e-05,4.4425686932184186e-05,0.6666666666666666
14392,14392,미이케/Noun,6,2,4,4.445926419917751e-05,6.663853039827628e-05,0.6666666666666666
14393,14393,연산군/Noun,6,2,4,4.445926419917751e-05,6.663853039827628e-05,0.6666666666666666
14394,14394,마침내/Noun,6,4,2,6.668889629876625e-05,4.4425686932184186e-05,0.6666666666666666
14395,14395,사부/Noun,6,2,4,4.445926419917751e-05,6.663853039827628e-05,0.6666666666666666
14396,14396,유무/Noun,6,4,2,6.668889629876625e-05,4.4425686932184186e-05,0.6666666666666666
14397,14397,국보/Noun,6,2,4,4.445926419917751e-05,6.663853039827628e-05,0.6666666666666666
14398,14398,태연/Noun,6,2,4,4.445926419917751e-05,6.663853039827628e-05,0.6666666666666666
14399,14399,스탠/Noun,6,4,2,6.668889629876625e-05,4.4425686932184186e-05,0.6666666666666666
14400,14400,가련하다/Adjective,6,2,4,4.445926419917751e-05,6.663853039827628e-05,0.6666666666666666
14401,14401,살다보면/Noun,6,4,2,6.668889629876625e-05,4.4425686932184186e-05,0.6666666666666666
14402,14402,고저/Noun,6,2,4,4.445926419917751e-05,6.663853039827628e-05,0.6666666666666666
14403,14403,계몽영화/Noun,6,2,4,4.445926419917751e-05,6.663853039827628e-05,0.6666666666666666
14404,14404,리코/Noun,6,4,2,6.668889629876625e-05,4.4425686932184186e-05,0.6666666666666666
14405,14405,라리/Noun,6,2,4,4.445926419917751e-05,6.663853039827628e-05,0.6666666666666666
14406,14406,5억/Number,6,2,4,4.445926419917751e-05,6.663853039827628e-05,0.6666666666666666
14407,14407,물감/Noun,6,4,2,6.668889629876625e-05,4.4425686932184186e-05,0.6666666666666666
14408,14408,니요/Noun,6,4,2,6.668889629876625e-05,4.4425686932184186e-05,0.6666666666666666
14409,14409,유신/Noun,6,4,2,6.668889629876625e-05,4.4425686932184186e-05,0.6666666666666666
14410,14410,웨버/Noun,6,4,2,6.668889629876625e-05,4.4425686932184186e-05,0.6666666666666666
14411,14411,입좀/Noun,6,2,4,4.445926419917751e-05,6.663853039827628e-05,0.6666666666666666
14412,14412,이네/Foreign,6,4,2,6.668889629876625e-05,4.4425686932184186e-05,0.6666666666666666
14413,14413,엄따/Noun,6,2,4,4.445926419917751e-05,6.663853039827628e-05,0.6666666666666666
14414,14414,소피아/Noun,6,4,2,6.668889629876625e-05,4.4425686932184186e-05,0.6666666666666666
14415,14415,판소리/Noun,6,4,2,6.668889629876625e-05,4.4425686932184186e-05,0.6666666666666666
14416,14416,스웽크/Noun,6,4,2,6.668889629876625e-05,4.4425686932184186e-05,0.6666666666666666
14417,14417,창의성/Noun,6,2,4,4.445926419917751e-05,6.663853039827628e-05,0.6666666666666666
14418,14418,이나고/Noun,6,2,4,4.445926419917751e-05,6.663853039827628e-05,0.6666666666666666
14419,14419,버니/Noun,6,4,2,6.668889629876625e-05,4.4425686932184186e-05,0.6666666666666666
14420,14420,미녀와야수/Noun,6,4,2,6.668889629876625e-05,4.4425686932184186e-05,0.6666666666666666
14421,14421,고무줄/Noun,6,2,4,4.445926419917751e-05,6.663853039827628e-05,0.6666666666666666
14422,14422,에서까지/Josa,6,2,4,4.445926419917751e-05,6.663853039827628e-05,0.6666666666666666
14423,14423,살육/Noun,6,2,4,4.445926419917751e-05,6.663853039827628e-05,0.6666666666666666
14424,14424,화전/Noun,6,2,4,4.445926419917751e-05,6.663853039827628e-05,0.6666666666666666
14425,14425,쉰들러리스트/Noun,6,4,2,6.668889629876625e-05,4.4425686932184186e-05,0.6666666666666666
14426,14426,익살/Noun,6,4,2,6.668889629876625e-05,4.4425686932184186e-05,0.6666666666666666
14427,14427,색체/Noun,6,4,2,6.668889629876625e-05,4.4425686932184186e-05,0.6666666666666666
14428,14428,쥬만지/Noun,6,2,4,4.445926419917751e-05,6.663853039827628e-05,0.6666666666666666
14429,14429,아카데미상/Noun,6,2,4,4.445926419917751e-05,6.663853039827628e-05,0.6666666666666666
14430,14430,들개/Noun,6,4,2,6.668889629876625e-05,4.4425686932184186e-05,0.6666666666666666
14431,14431,정인/Noun,6,2,4,4.445926419917751e-05,6.663853039827628e-05,0.6666666666666666
14432,14432,성지루/Noun,6,2,4,4.445926419917751e-05,6.663853039827628e-05,0.6666666666666666
14433,14433,포카혼타스/Noun,6,4,2,6.668889629876625e-05,4.4425686932184186e-05,0.6666666666666666
14434,14434,녹차/Noun,6,4,2,6.668889629876625e-05,4.4425686932184186e-05,0.6666666666666666
14435,14435,코앞/Noun,6,2,4,4.445926419917751e-05,6.663853039827628e-05,0.6666666666666666
14436,14436,이수현/Noun,6,4,2,6.668889629876625e-05,4.4425686932184186e-05,0.6666666666666666
14437,14437,다이어리/Noun,6,4,2,6.668889629876625e-05,4.4425686932184186e-05,0.6666666666666666
14438,14438,정용화/Noun,6,4,2,6.668889629876625e-05,4.4425686932184186e-05,0.6666666666666666
14439,14439,엑소더스/Noun,6,4,2,6.668889629876625e-05,4.4425686932184186e-05,0.6666666666666666
14440,14440,성현아/Noun,6,2,4,4.445926419917751e-05,6.663853039827628e-05,0.6666666666666666
14441,14441,유가/Noun,6,2,4,4.445926419917751e-05,6.663853039827628e-05,0.6666666666666666
14442,14442,랜턴/Noun,6,2,4,4.445926419917751e-05,6.663853039827628e-05,0.6666666666666666
14443,14443,명료하다/Adjective,6,4,2,6.668889629876625e-05,4.4425686932184186e-05,0.6666666666666666
14444,14444,괄호/Noun,6,2,4,4.445926419917751e-05,6.663853039827628e-05,0.6666666666666666
14445,14445,현시/Noun,6,4,2,6.668889629876625e-05,4.4425686932184186e-05,0.6666666666666666
14446,14446,이본/Noun,6,2,4,4.445926419917751e-05,6.663853039827628e-05,0.6666666666666666
14447,14447,개반/Noun,6,2,4,4.445926419917751e-05,6.663853039827628e-05,0.6666666666666666
14448,14448,의인/Noun,6,2,4,4.445926419917751e-05,6.663853039827628e-05,0.6666666666666666
14449,14449,키르/Noun,6,2,4,4.445926419917751e-05,6.663853039827628e-05,0.6666666666666666
14450,14450,접합/Noun,6,2,4,4.445926419917751e-05,6.663853039827628e-05,0.6666666666666666
14451,14451,광개토대왕/Noun,6,2,4,4.445926419917751e-05,6.663853039827628e-05,0.6666666666666666
14452,14452,조심스럽다/Adjective,6,4,2,6.668889629876625e-05,4.4425686932184186e-05,0.6666666666666666
14453,14453,땡땡/Noun,6,4,2,6.668889629876625e-05,4.4425686932184186e-05,0.6666666666666666
14454,14454,읊는/Noun,6,4,2,6.668889629876625e-05,4.4425686932184186e-05,0.6666666666666666
14455,14455,가정폭력/Noun,6,2,4,4.445926419917751e-05,6.663853039827628e-05,0.6666666666666666
14456,14456,월레스/Noun,6,4,2,6.668889629876625e-05,4.4425686932184186e-05,0.6666666666666666
14457,14457,깜작/Adverb,6,4,2,6.668889629876625e-05,4.4425686932184186e-05,0.6666666666666666
14458,14458,테이/Noun,6,2,4,4.445926419917751e-05,6.663853039827628e-05,0.6666666666666666
14459,14459,채팅/Noun,6,2,4,4.445926419917751e-05,6.663853039827628e-05,0.6666666666666666
14460,14460,폴란드/Noun,6,4,2,6.668889629876625e-05,4.4425686932184186e-05,0.6666666666666666
14461,14461,곡성/Noun,6,4,2,6.668889629876625e-05,4.4425686932184186e-05,0.6666666666666666
14462,14462,에아/Noun,6,4,2,6.668889629876625e-05,4.4425686932184186e-05,0.6666666666666666
14463,14463,보충/Noun,6,4,2,6.668889629876625e-05,4.4425686932184186e-05,0.6666666666666666
14464,14464,1993년/Number,6,2,4,4.445926419917751e-05,6.663853039827628e-05,0.6666666666666666
14465,14465,정직/Noun,6,4,2,6.668889629876625e-05,4.4425686932184186e-05,0.6666666666666666
14466,14466,나쁜남자/Noun,6,2,4,4.445926419917751e-05,6.663853039827628e-05,0.6666666666666666
14467,14467,광화문/Noun,6,4,2,6.668889629876625e-05,4.4425686932184186e-05,0.6666666666666666
14468,14468,야무지다/Adjective,6,2,4,4.445926419917751e-05,6.663853039827628e-05,0.6666666666666666
14469,14469,윤종신/Noun,6,2,4,4.445926419917751e-05,6.663853039827628e-05,0.6666666666666666
14470,14470,천벌/Noun,6,4,2,6.668889629876625e-05,4.4425686932184186e-05,0.6666666666666666
14471,14471,풀다/Noun,6,4,2,6.668889629876625e-05,4.4425686932184186e-05,0.6666666666666666
14472,14472,김삼순/Noun,6,4,2,6.668889629876625e-05,4.4425686932184186e-05,0.6666666666666666
14473,14473,처치/Noun,6,2,4,4.445926419917751e-05,6.663853039827628e-05,0.6666666666666666
14474,14474,뒹굴/Adverb,6,2,4,4.445926419917751e-05,6.663853039827628e-05,0.6666666666666666
14475,14475,여선생/Noun,6,2,4,4.445926419917751e-05,6.663853039827628e-05,0.6666666666666666
14476,14476,^^../Punctuation,6,4,2,6.668889629876625e-05,4.4425686932184186e-05,0.6666666666666666
14477,14477,크리스티나/Noun,6,4,2,6.668889629876625e-05,4.4425686932184186e-05,0.6666666666666666
14478,14478,노동/Noun,6,4,2,6.668889629876625e-05,4.4425686932184186e-05,0.6666666666666666
14479,14479,멍청/Noun,6,2,4,4.445926419917751e-05,6.663853039827628e-05,0.6666666666666666
14480,14480,맞대다/Verb,6,4,2,6.668889629876625e-05,4.4425686932184186e-05,0.6666666666666666
14481,14481,플래쉬/Noun,6,4,2,6.668889629876625e-05,4.4425686932184186e-05,0.6666666666666666
14482,14482,어로/Noun,6,2,4,4.445926419917751e-05,6.663853039827628e-05,0.6666666666666666
14483,14483,1200원/Number,6,2,4,4.445926419917751e-05,6.663853039827628e-05,0.6666666666666666
14484,14484,연륜/Noun,6,4,2,6.668889629876625e-05,4.4425686932184186e-05,0.6666666666666666
14485,14485,ㄹㄹ/KoreanParticle,6,4,2,6.668889629876625e-05,4.4425686932184186e-05,0.6666666666666666
14486,14486,폭죽/Noun,6,4,2,6.668889629876625e-05,4.4425686932184186e-05,0.6666666666666666
14487,14487,baby/Alpha,6,2,4,4.445926419917751e-05,6.663853039827628e-05,0.6666666666666666
14488,14488,깜박/Noun,6,2,4,4.445926419917751e-05,6.663853039827628e-05,0.6666666666666666
14489,14489,죠낸/Noun,6,2,4,4.445926419917751e-05,6.663853039827628e-05,0.6666666666666666
14490,14490,테무진/Noun,6,2,4,4.445926419917751e-05,6.663853039827628e-05,0.6666666666666666
14491,14491,칩/Noun,6,4,2,6.668889629876625e-05,4.4425686932184186e-05,0.6666666666666666
14492,14492,쿵쿵/Adverb,6,4,2,6.668889629876625e-05,4.4425686932184186e-05,0.6666666666666666
14493,14493,호빵맨/Noun,6,2,4,4.445926419917751e-05,6.663853039827628e-05,0.6666666666666666
14494,14494,"..,,../Punctuation",6,4,2,6.668889629876625e-05,4.4425686932184186e-05,0.6666666666666666
14495,14495,잔재미/Noun,6,4,2,6.668889629876625e-05,4.4425686932184186e-05,0.6666666666666666
14496,14496,4.0/Number,6,2,4,4.445926419917751e-05,6.663853039827628e-05,0.6666666666666666
14497,14497,여론/Noun,6,4,2,6.668889629876625e-05,4.4425686932184186e-05,0.6666666666666666
14498,14498,정다빈/Noun,6,4,2,6.668889629876625e-05,4.4425686932184186e-05,0.6666666666666666
14499,14499,류헤이/Noun,6,2,4,4.445926419917751e-05,6.663853039827628e-05,0.6666666666666666
14500,14500,교관/Noun,6,4,2,6.668889629876625e-05,4.4425686932184186e-05,0.6666666666666666
14501,14501,55/Number,6,2,4,4.445926419917751e-05,6.663853039827628e-05,0.6666666666666666
14502,14502,체크/Noun,6,2,4,4.445926419917751e-05,6.663853039827628e-05,0.6666666666666666
14503,14503,입학/Noun,6,4,2,6.668889629876625e-05,4.4425686932184186e-05,0.6666666666666666
14504,14504,장일/Noun,6,4,2,6.668889629876625e-05,4.4425686932184186e-05,0.6666666666666666
14505,14505,산물/Noun,6,2,4,4.445926419917751e-05,6.663853039827628e-05,0.6666666666666666
14506,14506,해감/Noun,6,2,4,4.445926419917751e-05,6.663853039827628e-05,0.6666666666666666
14507,14507,지조/Noun,6,2,4,4.445926419917751e-05,6.663853039827628e-05,0.6666666666666666
14508,14508,왈부/Noun,6,2,4,4.445926419917751e-05,6.663853039827628e-05,0.6666666666666666
14509,14509,여직원/Noun,6,4,2,6.668889629876625e-05,4.4425686932184186e-05,0.6666666666666666
14510,14510,수학여행/Noun,6,2,4,4.445926419917751e-05,6.663853039827628e-05,0.6666666666666666
14511,14511,발자국/Noun,6,2,4,4.445926419917751e-05,6.663853039827628e-05,0.6666666666666666
14512,14512,넘게/Foreign,6,2,4,4.445926419917751e-05,6.663853039827628e-05,0.6666666666666666
14513,14513,으로서도/Josa,6,2,4,4.445926419917751e-05,6.663853039827628e-05,0.6666666666666666
14514,14514,크나크다/Adjective,6,2,4,4.445926419917751e-05,6.663853039827628e-05,0.6666666666666666
14515,14515,끄덕/Noun,6,4,2,6.668889629876625e-05,4.4425686932184186e-05,0.6666666666666666
14516,14516,옥토/Noun,6,4,2,6.668889629876625e-05,4.4425686932184186e-05,0.6666666666666666
14517,14517,"""""/Punctuation",6,2,4,4.445926419917751e-05,6.663853039827628e-05,0.6666666666666666
14518,14518,박상원/Noun,6,2,4,4.445926419917751e-05,6.663853039827628e-05,0.6666666666666666
14519,14519,펄/Noun,6,2,4,4.445926419917751e-05,6.663853039827628e-05,0.6666666666666666
14520,14520,빈번/Noun,6,4,2,6.668889629876625e-05,4.4425686932184186e-05,0.6666666666666666
14521,14521,시큰둥하다/Adjective,6,4,2,6.668889629876625e-05,4.4425686932184186e-05,0.6666666666666666
14522,14522,오복성/Noun,6,4,2,6.668889629876625e-05,4.4425686932184186e-05,0.6666666666666666
14523,14523,피리/Noun,6,4,2,6.668889629876625e-05,4.4425686932184186e-05,0.6666666666666666
14524,14524,네로/Noun,6,4,2,6.668889629876625e-05,4.4425686932184186e-05,0.6666666666666666
14525,14525,설탕/Noun,6,2,4,4.445926419917751e-05,6.663853039827628e-05,0.6666666666666666
14526,14526,영희/Noun,6,4,2,6.668889629876625e-05,4.4425686932184186e-05,0.6666666666666666
14527,14527,헌/Noun,6,2,4,4.445926419917751e-05,6.663853039827628e-05,0.6666666666666666
14528,14528,보증/Noun,6,4,2,6.668889629876625e-05,4.4425686932184186e-05,0.6666666666666666
14529,14529,헤메/Noun,6,2,4,4.445926419917751e-05,6.663853039827628e-05,0.6666666666666666
14530,14530,연우/Noun,6,2,4,4.445926419917751e-05,6.663853039827628e-05,0.6666666666666666
14531,14531,손호준/Noun,6,4,2,6.668889629876625e-05,4.4425686932184186e-05,0.6666666666666666
14532,14532,변덕/Noun,6,2,4,4.445926419917751e-05,6.663853039827628e-05,0.6666666666666666
14533,14533,원시인/Noun,6,4,2,6.668889629876625e-05,4.4425686932184186e-05,0.6666666666666666
14534,14534,고독감/Noun,6,4,2,6.668889629876625e-05,4.4425686932184186e-05,0.6666666666666666
14535,14535,동족/Noun,6,2,4,4.445926419917751e-05,6.663853039827628e-05,0.6666666666666666
14536,14536,초대형/Noun,6,3,3,5.5574080248971876e-05,5.553210866523024e-05,0.5
14537,14537,식코/Noun,6,3,3,5.5574080248971876e-05,5.553210866523024e-05,0.5
14538,14538,상반기/Noun,6,3,3,5.5574080248971876e-05,5.553210866523024e-05,0.5
14539,14539,두더지/Noun,6,3,3,5.5574080248971876e-05,5.553210866523024e-05,0.5
14540,14540,에너미/Noun,6,3,3,5.5574080248971876e-05,5.553210866523024e-05,0.5
14541,14541,소매치기/Noun,6,3,3,5.5574080248971876e-05,5.553210866523024e-05,0.5
14542,14542,원치않다/Adjective,6,3,3,5.5574080248971876e-05,5.553210866523024e-05,0.5
14543,14543,메시/Noun,6,3,3,5.5574080248971876e-05,5.553210866523024e-05,0.5
14544,14544,오인/Noun,6,3,3,5.5574080248971876e-05,5.553210866523024e-05,0.5
14545,14545,통화/Noun,6,3,3,5.5574080248971876e-05,5.553210866523024e-05,0.5
14546,14546,스틸컷/Noun,6,3,3,5.5574080248971876e-05,5.553210866523024e-05,0.5
14547,14547,분별/Noun,6,3,3,5.5574080248971876e-05,5.553210866523024e-05,0.5
14548,14548,결실/Noun,6,3,3,5.5574080248971876e-05,5.553210866523024e-05,0.5
14549,14549,출구/Noun,6,3,3,5.5574080248971876e-05,5.553210866523024e-05,0.5
14550,14550,보다야/Josa,6,3,3,5.5574080248971876e-05,5.553210866523024e-05,0.5
14551,14551,대대/Noun,6,3,3,5.5574080248971876e-05,5.553210866523024e-05,0.5
14552,14552,요호/Noun,6,3,3,5.5574080248971876e-05,5.553210866523024e-05,0.5
14553,14553,맹승지/Noun,6,3,3,5.5574080248971876e-05,5.553210866523024e-05,0.5
14554,14554,진중권/Noun,6,3,3,5.5574080248971876e-05,5.553210866523024e-05,0.5
14555,14555,은줄/Noun,6,3,3,5.5574080248971876e-05,5.553210866523024e-05,0.5
14556,14556,한겨울/Noun,6,3,3,5.5574080248971876e-05,5.553210866523024e-05,0.5
14557,14557,속보/Noun,6,3,3,5.5574080248971876e-05,5.553210866523024e-05,0.5
14558,14558,서두르다/Verb,6,3,3,5.5574080248971876e-05,5.553210866523024e-05,0.5
14559,14559,오프/Noun,6,3,3,5.5574080248971876e-05,5.553210866523024e-05,0.5
14560,14560,재고/Noun,6,3,3,5.5574080248971876e-05,5.553210866523024e-05,0.5
14561,14561,")""/Punctuation",6,3,3,5.5574080248971876e-05,5.553210866523024e-05,0.5
14562,14562,땅콩/Noun,6,3,3,5.5574080248971876e-05,5.553210866523024e-05,0.5
14563,14563,홍자매/Noun,6,3,3,5.5574080248971876e-05,5.553210866523024e-05,0.5
14564,14564,유추/Noun,6,3,3,5.5574080248971876e-05,5.553210866523024e-05,0.5
14565,14565,재량/Noun,6,3,3,5.5574080248971876e-05,5.553210866523024e-05,0.5
14566,14566,ㄳ/KoreanParticle,6,3,3,5.5574080248971876e-05,5.553210866523024e-05,0.5
14567,14567,ㅇㅣ/KoreanParticle,6,3,3,5.5574080248971876e-05,5.553210866523024e-05,0.5
14568,14568,페이스북/Noun,6,3,3,5.5574080248971876e-05,5.553210866523024e-05,0.5
14569,14569,장미희/Noun,6,3,3,5.5574080248971876e-05,5.553210866523024e-05,0.5
14570,14570,매니악/Noun,6,3,3,5.5574080248971876e-05,5.553210866523024e-05,0.5
14571,14571,두세/Modifier,6,3,3,5.5574080248971876e-05,5.553210866523024e-05,0.5
14572,14572,이점/Noun,6,3,3,5.5574080248971876e-05,5.553210866523024e-05,0.5
14573,14573,텐데/Noun,6,3,3,5.5574080248971876e-05,5.553210866523024e-05,0.5
14574,14574,가희/Noun,6,3,3,5.5574080248971876e-05,5.553210866523024e-05,0.5
14575,14575,유비/Noun,6,3,3,5.5574080248971876e-05,5.553210866523024e-05,0.5
14576,14576,연휴/Noun,6,3,3,5.5574080248971876e-05,5.553210866523024e-05,0.5
14577,14577,승리자/Noun,6,3,3,5.5574080248971876e-05,5.553210866523024e-05,0.5
14578,14578,언뜻/Noun,6,3,3,5.5574080248971876e-05,5.553210866523024e-05,0.5
14579,14579,슬로우모션/Noun,6,3,3,5.5574080248971876e-05,5.553210866523024e-05,0.5
14580,14580,가을동화/Noun,6,3,3,5.5574080248971876e-05,5.553210866523024e-05,0.5
14581,14581,캣우먼/Noun,6,3,3,5.5574080248971876e-05,5.553210866523024e-05,0.5
14582,14582,관음/Noun,6,3,3,5.5574080248971876e-05,5.553210866523024e-05,0.5
14583,14583,협녀/Noun,6,3,3,5.5574080248971876e-05,5.553210866523024e-05,0.5
14584,14584,국화/Noun,6,3,3,5.5574080248971876e-05,5.553210866523024e-05,0.5
14585,14585,할망구/Noun,6,3,3,5.5574080248971876e-05,5.553210866523024e-05,0.5
14586,14586,치밀/Noun,6,3,3,5.5574080248971876e-05,5.553210866523024e-05,0.5
14587,14587,는/Foreign,6,3,3,5.5574080248971876e-05,5.553210866523024e-05,0.5
14588,14588,여옥/Noun,6,3,3,5.5574080248971876e-05,5.553210866523024e-05,0.5
14589,14589,으로써는/Josa,6,3,3,5.5574080248971876e-05,5.553210866523024e-05,0.5
14590,14590,로켓/Noun,6,3,3,5.5574080248971876e-05,5.553210866523024e-05,0.5
14591,14591,과/Foreign,6,3,3,5.5574080248971876e-05,5.553210866523024e-05,0.5
14592,14592,황량/Noun,6,3,3,5.5574080248971876e-05,5.553210866523024e-05,0.5
14593,14593,부부싸움/Noun,6,3,3,5.5574080248971876e-05,5.553210866523024e-05,0.5
14594,14594,선행/Noun,6,3,3,5.5574080248971876e-05,5.553210866523024e-05,0.5
14595,14595,폭격기/Noun,6,3,3,5.5574080248971876e-05,5.553210866523024e-05,0.5
14596,14596,아이스에이지/Noun,6,3,3,5.5574080248971876e-05,5.553210866523024e-05,0.5
14597,14597,옵니다/Eomi,6,3,3,5.5574080248971876e-05,5.553210866523024e-05,0.5
14598,14598,던지기/Noun,6,3,3,5.5574080248971876e-05,5.553210866523024e-05,0.5
14599,14599,친모/Noun,6,3,3,5.5574080248971876e-05,5.553210866523024e-05,0.5
14600,14600,멈/Noun,6,3,3,5.5574080248971876e-05,5.553210866523024e-05,0.5
14601,14601,루한/Noun,6,3,3,5.5574080248971876e-05,5.553210866523024e-05,0.5
14602,14602,도참/Noun,6,3,3,5.5574080248971876e-05,5.553210866523024e-05,0.5
14603,14603,데쓰/Noun,6,3,3,5.5574080248971876e-05,5.553210866523024e-05,0.5
14604,14604,권태기/Noun,6,3,3,5.5574080248971876e-05,5.553210866523024e-05,0.5
14605,14605,시프/Noun,6,3,3,5.5574080248971876e-05,5.553210866523024e-05,0.5
14606,14606,5%/Number,6,3,3,5.5574080248971876e-05,5.553210866523024e-05,0.5
14607,14607,두통/Noun,6,3,3,5.5574080248971876e-05,5.553210866523024e-05,0.5
14608,14608,발목/Noun,6,3,3,5.5574080248971876e-05,5.553210866523024e-05,0.5
14609,14609,골드/Noun,6,3,3,5.5574080248971876e-05,5.553210866523024e-05,0.5
14610,14610,병실/Noun,6,3,3,5.5574080248971876e-05,5.553210866523024e-05,0.5
14611,14611,갈라지다/Verb,6,3,3,5.5574080248971876e-05,5.553210866523024e-05,0.5
14612,14612,말타/Noun,6,3,3,5.5574080248971876e-05,5.553210866523024e-05,0.5
14613,14613,죨/Noun,6,3,3,5.5574080248971876e-05,5.553210866523024e-05,0.5
14614,14614,박준규/Noun,6,3,3,5.5574080248971876e-05,5.553210866523024e-05,0.5
14615,14615,zz/Alpha,6,3,3,5.5574080248971876e-05,5.553210866523024e-05,0.5
14616,14616,여과/Noun,6,3,3,5.5574080248971876e-05,5.553210866523024e-05,0.5
14617,14617,임의/Noun,6,3,3,5.5574080248971876e-05,5.553210866523024e-05,0.5
14618,14618,지롱/Josa,6,3,3,5.5574080248971876e-05,5.553210866523024e-05,0.5
14619,14619,더잼/Noun,6,3,3,5.5574080248971876e-05,5.553210866523024e-05,0.5
14620,14620,장인정신/Noun,6,3,3,5.5574080248971876e-05,5.553210866523024e-05,0.5
14621,14621,마리오/Noun,6,3,3,5.5574080248971876e-05,5.553210866523024e-05,0.5
14622,14622,변주/Noun,6,3,3,5.5574080248971876e-05,5.553210866523024e-05,0.5
14623,14623,우화/Noun,6,3,3,5.5574080248971876e-05,5.553210866523024e-05,0.5
14624,14624,장화/Noun,6,3,3,5.5574080248971876e-05,5.553210866523024e-05,0.5
14625,14625,엘지/Noun,6,3,3,5.5574080248971876e-05,5.553210866523024e-05,0.5
14626,14626,포선/Noun,6,3,3,5.5574080248971876e-05,5.553210866523024e-05,0.5
14627,14627,떠돌다/Verb,6,3,3,5.5574080248971876e-05,5.553210866523024e-05,0.5
14628,14628,오락실/Noun,6,3,3,5.5574080248971876e-05,5.553210866523024e-05,0.5
14629,14629,한선/Noun,6,3,3,5.5574080248971876e-05,5.553210866523024e-05,0.5
14630,14630,회식/Noun,6,3,3,5.5574080248971876e-05,5.553210866523024e-05,0.5
14631,14631,유능하다/Adjective,6,3,3,5.5574080248971876e-05,5.553210866523024e-05,0.5
14632,14632,뜰때/Noun,6,3,3,5.5574080248971876e-05,5.553210866523024e-05,0.5
14633,14633,삼위일체/Noun,6,3,3,5.5574080248971876e-05,5.553210866523024e-05,0.5
14634,14634,이병/Noun,6,3,3,5.5574080248971876e-05,5.553210866523024e-05,0.5
14635,14635,라빈/Noun,6,3,3,5.5574080248971876e-05,5.553210866523024e-05,0.5
14636,14636,건의/Noun,6,3,3,5.5574080248971876e-05,5.553210866523024e-05,0.5
14637,14637,비주류/Noun,6,3,3,5.5574080248971876e-05,5.553210866523024e-05,0.5
14638,14638,빅풋/Noun,6,3,3,5.5574080248971876e-05,5.553210866523024e-05,0.5
14639,14639,트이다/Verb,6,3,3,5.5574080248971876e-05,5.553210866523024e-05,0.5
14640,14640,사슴/Noun,6,3,3,5.5574080248971876e-05,5.553210866523024e-05,0.5
14641,14641,귀중하다/Adjective,6,3,3,5.5574080248971876e-05,5.553210866523024e-05,0.5
14642,14642,처량하다/Adjective,6,3,3,5.5574080248971876e-05,5.553210866523024e-05,0.5
14643,14643,팬덤/Noun,6,3,3,5.5574080248971876e-05,5.553210866523024e-05,0.5
14644,14644,돗/Noun,6,3,3,5.5574080248971876e-05,5.553210866523024e-05,0.5
14645,14645,선량하다/Adjective,6,3,3,5.5574080248971876e-05,5.553210866523024e-05,0.5
14646,14646,라오/Josa,6,3,3,5.5574080248971876e-05,5.553210866523024e-05,0.5
14647,14647,노조/Noun,6,3,3,5.5574080248971876e-05,5.553210866523024e-05,0.5
14648,14648,개중/Noun,6,3,3,5.5574080248971876e-05,5.553210866523024e-05,0.5
14649,14649,연수/Noun,6,3,3,5.5574080248971876e-05,5.553210866523024e-05,0.5
14650,14650,가공/Noun,6,3,3,5.5574080248971876e-05,5.553210866523024e-05,0.5
14651,14651,업무/Noun,6,3,3,5.5574080248971876e-05,5.553210866523024e-05,0.5
14652,14652,하단/Noun,6,3,3,5.5574080248971876e-05,5.553210866523024e-05,0.5
14653,14653,차/Foreign,6,3,3,5.5574080248971876e-05,5.553210866523024e-05,0.5
14654,14654,재해/Noun,6,3,3,5.5574080248971876e-05,5.553210866523024e-05,0.5
14655,14655,접목/Noun,6,3,3,5.5574080248971876e-05,5.553210866523024e-05,0.5
14656,14656,붕대/Noun,6,3,3,5.5574080248971876e-05,5.553210866523024e-05,0.5
14657,14657,시라/Noun,6,3,3,5.5574080248971876e-05,5.553210866523024e-05,0.5
14658,14658,앨빈/Noun,6,3,3,5.5574080248971876e-05,5.553210866523024e-05,0.5
14659,14659,택하/Noun,6,3,3,5.5574080248971876e-05,5.553210866523024e-05,0.5
14660,14660,광해군/Noun,6,3,3,5.5574080248971876e-05,5.553210866523024e-05,0.5
14661,14661,클론/Noun,6,3,3,5.5574080248971876e-05,5.553210866523024e-05,0.5
14662,14662,점더/Noun,6,3,3,5.5574080248971876e-05,5.553210866523024e-05,0.5
14663,14663,가뭄/Noun,6,3,3,5.5574080248971876e-05,5.553210866523024e-05,0.5
14664,14664,퀘/Noun,6,3,3,5.5574080248971876e-05,5.553210866523024e-05,0.5
14665,14665,변환/Noun,6,3,3,5.5574080248971876e-05,5.553210866523024e-05,0.5
14666,14666,워터월드/Noun,6,3,3,5.5574080248971876e-05,5.553210866523024e-05,0.5
14667,14667,갱신/Noun,6,3,3,5.5574080248971876e-05,5.553210866523024e-05,0.5
14668,14668,먼치킨/Noun,6,3,3,5.5574080248971876e-05,5.553210866523024e-05,0.5
14669,14669,찢기다/Verb,6,3,3,5.5574080248971876e-05,5.553210866523024e-05,0.5
14670,14670,매그놀리아/Noun,6,3,3,5.5574080248971876e-05,5.553210866523024e-05,0.5
14671,14671,게살/Noun,6,3,3,5.5574080248971876e-05,5.553210866523024e-05,0.5
14672,14672,조마조마/Noun,6,3,3,5.5574080248971876e-05,5.553210866523024e-05,0.5
14673,14673,순결하다/Adjective,6,3,3,5.5574080248971876e-05,5.553210866523024e-05,0.5
14674,14674,거실/Noun,6,3,3,5.5574080248971876e-05,5.553210866523024e-05,0.5
14675,14675,종말론/Noun,6,3,3,5.5574080248971876e-05,5.553210866523024e-05,0.5
14676,14676,괴팍하다/Adjective,6,3,3,5.5574080248971876e-05,5.553210866523024e-05,0.5
14677,14677,살길/Noun,6,3,3,5.5574080248971876e-05,5.553210866523024e-05,0.5
14678,14678,조선왕조/Noun,6,3,3,5.5574080248971876e-05,5.553210866523024e-05,0.5
14679,14679,엇네/Noun,6,3,3,5.5574080248971876e-05,5.553210866523024e-05,0.5
14680,14680,첼로/Noun,6,3,3,5.5574080248971876e-05,5.553210866523024e-05,0.5
14681,14681,발판/Noun,6,3,3,5.5574080248971876e-05,5.553210866523024e-05,0.5
14682,14682,에를/Josa,6,3,3,5.5574080248971876e-05,5.553210866523024e-05,0.5
14683,14683,고치/Noun,6,3,3,5.5574080248971876e-05,5.553210866523024e-05,0.5
14684,14684,각선미/Noun,6,3,3,5.5574080248971876e-05,5.553210866523024e-05,0.5
14685,14685,옵/Noun,6,3,3,5.5574080248971876e-05,5.553210866523024e-05,0.5
14686,14686,소설가/Noun,6,3,3,5.5574080248971876e-05,5.553210866523024e-05,0.5
14687,14687,다다다/Noun,6,3,3,5.5574080248971876e-05,5.553210866523024e-05,0.5
14688,14688,막방/Noun,6,3,3,5.5574080248971876e-05,5.553210866523024e-05,0.5
14689,14689,최배달/Noun,6,3,3,5.5574080248971876e-05,5.553210866523024e-05,0.5
14690,14690,뜻대로/Adverb,6,3,3,5.5574080248971876e-05,5.553210866523024e-05,0.5
14691,14691,지존파/Noun,6,3,3,5.5574080248971876e-05,5.553210866523024e-05,0.5
14692,14692,김두영/Noun,6,3,3,5.5574080248971876e-05,5.553210866523024e-05,0.5
14693,14693,보존/Noun,6,3,3,5.5574080248971876e-05,5.553210866523024e-05,0.5
14694,14694,지드래곤/Noun,6,3,3,5.5574080248971876e-05,5.553210866523024e-05,0.5
14695,14695,무사하다/Adjective,6,3,3,5.5574080248971876e-05,5.553210866523024e-05,0.5
14696,14696,slow/Alpha,6,3,3,5.5574080248971876e-05,5.553210866523024e-05,0.5
14697,14697,에헤/Exclamation,6,3,3,5.5574080248971876e-05,5.553210866523024e-05,0.5
14698,14698,권해효/Noun,6,3,3,5.5574080248971876e-05,5.553210866523024e-05,0.5
14699,14699,1000원/Number,6,3,3,5.5574080248971876e-05,5.553210866523024e-05,0.5
14700,14700,좌지우지/Noun,6,3,3,5.5574080248971876e-05,5.553210866523024e-05,0.5
14701,14701,계곡/Noun,6,3,3,5.5574080248971876e-05,5.553210866523024e-05,0.5
14702,14702,상급/Noun,6,3,3,5.5574080248971876e-05,5.553210866523024e-05,0.5
14703,14703,태평/Noun,6,3,3,5.5574080248971876e-05,5.553210866523024e-05,0.5
14704,14704,만사/Noun,6,3,3,5.5574080248971876e-05,5.553210866523024e-05,0.5
14705,14705,쇼파/Noun,6,3,3,5.5574080248971876e-05,5.553210866523024e-05,0.5
14706,14706,10회/Number,6,3,3,5.5574080248971876e-05,5.553210866523024e-05,0.5
14707,14707,조제/Noun,6,3,3,5.5574080248971876e-05,5.553210866523024e-05,0.5
14708,14708,공통/Noun,6,3,3,5.5574080248971876e-05,5.553210866523024e-05,0.5
14709,14709,서현진/Noun,6,3,3,5.5574080248971876e-05,5.553210866523024e-05,0.5
14710,14710,하이바라/Noun,6,3,3,5.5574080248971876e-05,5.553210866523024e-05,0.5
14711,14711,월스트리트/Noun,6,3,3,5.5574080248971876e-05,5.553210866523024e-05,0.5
14712,14712,내려지다/Verb,6,3,3,5.5574080248971876e-05,5.553210866523024e-05,0.5
14713,14713,니지/Noun,6,3,3,5.5574080248971876e-05,5.553210866523024e-05,0.5
14714,14714,에도/Foreign,6,3,3,5.5574080248971876e-05,5.553210866523024e-05,0.5
14715,14715,나영석/Noun,6,3,3,5.5574080248971876e-05,5.553210866523024e-05,0.5
14716,14716,대풍수/Noun,6,3,3,5.5574080248971876e-05,5.553210866523024e-05,0.5
14717,14717,베인/Noun,6,3,3,5.5574080248971876e-05,5.553210866523024e-05,0.5
14718,14718,환가/Noun,6,3,3,5.5574080248971876e-05,5.553210866523024e-05,0.5
14719,14719,피쉬/Noun,6,3,3,5.5574080248971876e-05,5.553210866523024e-05,0.5
14720,14720,남규리/Noun,6,3,3,5.5574080248971876e-05,5.553210866523024e-05,0.5
14721,14721,조은숙/Noun,6,3,3,5.5574080248971876e-05,5.553210866523024e-05,0.5
14722,14722,마라톤/Noun,6,3,3,5.5574080248971876e-05,5.553210866523024e-05,0.5
14723,14723,복음/Noun,6,3,3,5.5574080248971876e-05,5.553210866523024e-05,0.5
14724,14724,미움/Noun,6,3,3,5.5574080248971876e-05,5.553210866523024e-05,0.5
14725,14725,지위/Noun,6,3,3,5.5574080248971876e-05,5.553210866523024e-05,0.5
14726,14726,지붕/Noun,6,3,3,5.5574080248971876e-05,5.553210866523024e-05,0.5
14727,14727,주다해/Noun,6,3,3,5.5574080248971876e-05,5.553210866523024e-05,0.5
14728,14728,덕의/Noun,6,3,3,5.5574080248971876e-05,5.553210866523024e-05,0.5
14729,14729,토지/Noun,6,3,3,5.5574080248971876e-05,5.553210866523024e-05,0.5
14730,14730,주방/Noun,6,3,3,5.5574080248971876e-05,5.553210866523024e-05,0.5
14731,14731,스나이퍼/Noun,6,3,3,5.5574080248971876e-05,5.553210866523024e-05,0.5
14732,14732,달래/Noun,6,3,3,5.5574080248971876e-05,5.553210866523024e-05,0.5
14733,14733,허비/Noun,6,3,3,5.5574080248971876e-05,5.553210866523024e-05,0.5
14734,14734,스레/Noun,6,3,3,5.5574080248971876e-05,5.553210866523024e-05,0.5
14735,14735,신라/Noun,6,3,3,5.5574080248971876e-05,5.553210866523024e-05,0.5
14736,14736,이세영/Noun,6,3,3,5.5574080248971876e-05,5.553210866523024e-05,0.5
14737,14737,수명/Noun,6,3,3,5.5574080248971876e-05,5.553210866523024e-05,0.5
14738,14738,알음/Noun,6,3,3,5.5574080248971876e-05,5.553210866523024e-05,0.5
14739,14739,계열/Noun,6,3,3,5.5574080248971876e-05,5.553210866523024e-05,0.5
14740,14740,팔뚝/Noun,6,3,3,5.5574080248971876e-05,5.553210866523024e-05,0.5
14741,14741,왜놈/Noun,6,3,3,5.5574080248971876e-05,5.553210866523024e-05,0.5
14742,14742,정신분열/Noun,6,3,3,5.5574080248971876e-05,5.553210866523024e-05,0.5
14743,14743,전부터/Foreign,6,3,3,5.5574080248971876e-05,5.553210866523024e-05,0.5
14744,14744,조난/Noun,6,3,3,5.5574080248971876e-05,5.553210866523024e-05,0.5
14745,14745,탈의/Noun,6,3,3,5.5574080248971876e-05,5.553210866523024e-05,0.5
14746,14746,리터/Noun,6,3,3,5.5574080248971876e-05,5.553210866523024e-05,0.5
14747,14747,비행선/Noun,6,3,3,5.5574080248971876e-05,5.553210866523024e-05,0.5
14748,14748,????????/Punctuation,6,3,3,5.5574080248971876e-05,5.553210866523024e-05,0.5
14749,14749,후임/Noun,6,3,3,5.5574080248971876e-05,5.553210866523024e-05,0.5
14750,14750,Me/Alpha,6,3,3,5.5574080248971876e-05,5.553210866523024e-05,0.5
14751,14751,결전/Noun,6,3,3,5.5574080248971876e-05,5.553210866523024e-05,0.5
14752,14752,웬걸/Noun,6,3,3,5.5574080248971876e-05,5.553210866523024e-05,0.5
14753,14753,텍사스/Noun,6,3,3,5.5574080248971876e-05,5.553210866523024e-05,0.5
14754,14754,멜리사/Noun,6,3,3,5.5574080248971876e-05,5.553210866523024e-05,0.5
14755,14755,최고점/Noun,6,3,3,5.5574080248971876e-05,5.553210866523024e-05,0.5
14756,14756,화소/Noun,6,3,3,5.5574080248971876e-05,5.553210866523024e-05,0.5
14757,14757,합리/Noun,6,3,3,5.5574080248971876e-05,5.553210866523024e-05,0.5
14758,14758,어번/Noun,6,3,3,5.5574080248971876e-05,5.553210866523024e-05,0.5
14759,14759,만듭니/Noun,6,3,3,5.5574080248971876e-05,5.553210866523024e-05,0.5
14760,14760,기태/Noun,6,3,3,5.5574080248971876e-05,5.553210866523024e-05,0.5
14761,14761,쫙쫙/Noun,6,3,3,5.5574080248971876e-05,5.553210866523024e-05,0.5
14762,14762,경규/Noun,6,3,3,5.5574080248971876e-05,5.553210866523024e-05,0.5
14763,14763,장발장/Noun,6,3,3,5.5574080248971876e-05,5.553210866523024e-05,0.5
14764,14764,ㅉㅏ/KoreanParticle,6,3,3,5.5574080248971876e-05,5.553210866523024e-05,0.5
14765,14765,전임/Noun,6,3,3,5.5574080248971876e-05,5.553210866523024e-05,0.5
14766,14766,전지/Noun,6,3,3,5.5574080248971876e-05,5.553210866523024e-05,0.5
14767,14767,회귀/Noun,6,3,3,5.5574080248971876e-05,5.553210866523024e-05,0.5
14768,14768,ㅋㄱ/KoreanParticle,6,3,3,5.5574080248971876e-05,5.553210866523024e-05,0.5
14769,14769,사들이다/Verb,6,3,3,5.5574080248971876e-05,5.553210866523024e-05,0.5
14770,14770,축구선수/Noun,6,3,3,5.5574080248971876e-05,5.553210866523024e-05,0.5
14771,14771,네오/Noun,6,3,3,5.5574080248971876e-05,5.553210866523024e-05,0.5
14772,14772,진경/Noun,6,3,3,5.5574080248971876e-05,5.553210866523024e-05,0.5
14773,14773,가연/Noun,6,3,3,5.5574080248971876e-05,5.553210866523024e-05,0.5
14774,14774,실황/Noun,6,3,3,5.5574080248971876e-05,5.553210866523024e-05,0.5
14775,14775,유하/Noun,6,3,3,5.5574080248971876e-05,5.553210866523024e-05,0.5
14776,14776,다큐맨/Noun,6,3,3,5.5574080248971876e-05,5.553210866523024e-05,0.5
14777,14777,논픽션/Noun,6,3,3,5.5574080248971876e-05,5.553210866523024e-05,0.5
14778,14778,즌/Foreign,6,3,3,5.5574080248971876e-05,5.553210866523024e-05,0.5
14779,14779,재민/Noun,6,3,3,5.5574080248971876e-05,5.553210866523024e-05,0.5
14780,14780,익스/Noun,6,3,3,5.5574080248971876e-05,5.553210866523024e-05,0.5
14781,14781,베트맨/Noun,6,3,3,5.5574080248971876e-05,5.553210866523024e-05,0.5
14782,14782,이듭/Noun,6,3,3,5.5574080248971876e-05,5.553210866523024e-05,0.5
14783,14783,39/Number,6,3,3,5.5574080248971876e-05,5.553210866523024e-05,0.5
14784,14784,톡톡하다/Adjective,6,3,3,5.5574080248971876e-05,5.553210866523024e-05,0.5
14785,14785,타케시/Noun,6,3,3,5.5574080248971876e-05,5.553210866523024e-05,0.5
14786,14786,송선미/Noun,6,3,3,5.5574080248971876e-05,5.553210866523024e-05,0.5
14787,14787,족족/Noun,6,3,3,5.5574080248971876e-05,5.553210866523024e-05,0.5
14788,14788,자처/Noun,6,3,3,5.5574080248971876e-05,5.553210866523024e-05,0.5
14789,14789,컵/Noun,6,3,3,5.5574080248971876e-05,5.553210866523024e-05,0.5
14790,14790,카호/Noun,6,3,3,5.5574080248971876e-05,5.553210866523024e-05,0.5
14791,14791,로렌/Noun,5,5,0,7.780371234856063e-05,2.2212843466092093e-05,1.0
14792,14792,온돌/Noun,5,0,5,2.2229632099588756e-05,7.774495213132233e-05,1.0
14793,14793,에헴/Exclamation,5,0,5,2.2229632099588756e-05,7.774495213132233e-05,1.0
14794,14794,옥보단/Noun,5,0,5,2.2229632099588756e-05,7.774495213132233e-05,1.0
14795,14795,케서방/Noun,5,0,5,2.2229632099588756e-05,7.774495213132233e-05,1.0
14796,14796,헤픈/Noun,5,0,5,2.2229632099588756e-05,7.774495213132233e-05,1.0
14797,14797,제리케이/Noun,5,5,0,7.780371234856063e-05,2.2212843466092093e-05,1.0
14798,14798,플레이보이/Noun,5,0,5,2.2229632099588756e-05,7.774495213132233e-05,1.0
14799,14799,카비/Noun,5,5,0,7.780371234856063e-05,2.2212843466092093e-05,1.0
14800,14800,임재범/Noun,5,5,0,7.780371234856063e-05,2.2212843466092093e-05,1.0
14801,14801,몸뚱이/Noun,5,0,5,2.2229632099588756e-05,7.774495213132233e-05,1.0
14802,14802,애니메이션영화/Noun,5,5,0,7.780371234856063e-05,2.2212843466092093e-05,1.0
14803,14803,아릅답/Noun,5,5,0,7.780371234856063e-05,2.2212843466092093e-05,1.0
14804,14804,쇠/Noun,5,0,5,2.2229632099588756e-05,7.774495213132233e-05,1.0
14805,14805,주구/Noun,5,0,5,2.2229632099588756e-05,7.774495213132233e-05,1.0
14806,14806,모니터링/Noun,5,0,5,2.2229632099588756e-05,7.774495213132233e-05,1.0
14807,14807,지그/Noun,5,0,5,2.2229632099588756e-05,7.774495213132233e-05,1.0
14808,14808,그리스도인/Noun,5,5,0,7.780371234856063e-05,2.2212843466092093e-05,1.0
14809,14809,정신승리/Noun,5,0,5,2.2229632099588756e-05,7.774495213132233e-05,1.0
14810,14810,아나스타샤/Noun,5,5,0,7.780371234856063e-05,2.2212843466092093e-05,1.0
14811,14811,건들/Adverb,5,0,5,2.2229632099588756e-05,7.774495213132233e-05,1.0
14812,14812,싱싱/Noun,5,5,0,7.780371234856063e-05,2.2212843466092093e-05,1.0
14813,14813,생인데/Foreign,5,5,0,7.780371234856063e-05,2.2212843466092093e-05,1.0
14814,14814,흙속/Noun,5,5,0,7.780371234856063e-05,2.2212843466092093e-05,1.0
14815,14815,양수빈/Noun,5,0,5,2.2229632099588756e-05,7.774495213132233e-05,1.0
14816,14816,생겻/Noun,5,0,5,2.2229632099588756e-05,7.774495213132233e-05,1.0
14817,14817,상팔자/Noun,5,0,5,2.2229632099588756e-05,7.774495213132233e-05,1.0
14818,14818,용임/Noun,5,0,5,2.2229632099588756e-05,7.774495213132233e-05,1.0
14819,14819,이승희/Noun,5,0,5,2.2229632099588756e-05,7.774495213132233e-05,1.0
14820,14820,싸나이/Noun,5,5,0,7.780371234856063e-05,2.2212843466092093e-05,1.0
14821,14821,웬수/Noun,5,0,5,2.2229632099588756e-05,7.774495213132233e-05,1.0
14822,14822,창업/Noun,5,5,0,7.780371234856063e-05,2.2212843466092093e-05,1.0
14823,14823,협동/Noun,5,5,0,7.780371234856063e-05,2.2212843466092093e-05,1.0
14824,14824,캅/Noun,5,5,0,7.780371234856063e-05,2.2212843466092093e-05,1.0
14825,14825,뒤치닥/Noun,5,0,5,2.2229632099588756e-05,7.774495213132233e-05,1.0
14826,14826,말걸/Noun,5,0,5,2.2229632099588756e-05,7.774495213132233e-05,1.0
14827,14827,~??/Punctuation,5,0,5,2.2229632099588756e-05,7.774495213132233e-05,1.0
14828,14828,밌/Noun,5,5,0,7.780371234856063e-05,2.2212843466092093e-05,1.0
14829,14829,사기죄/Noun,5,0,5,2.2229632099588756e-05,7.774495213132233e-05,1.0
14830,14830,상당수/Noun,5,0,5,2.2229632099588756e-05,7.774495213132233e-05,1.0
14831,14831,황마/Noun,5,0,5,2.2229632099588756e-05,7.774495213132233e-05,1.0
14832,14832,없넹/Noun,5,0,5,2.2229632099588756e-05,7.774495213132233e-05,1.0
14833,14833,107분/Number,5,0,5,2.2229632099588756e-05,7.774495213132233e-05,1.0
14834,14834,남미/Noun,5,5,0,7.780371234856063e-05,2.2212843466092093e-05,1.0
14835,14835,임자/Noun,5,5,0,7.780371234856063e-05,2.2212843466092093e-05,1.0
14836,14836,육성재/Noun,5,5,0,7.780371234856063e-05,2.2212843466092093e-05,1.0
14837,14837,꼴값/Noun,5,0,5,2.2229632099588756e-05,7.774495213132233e-05,1.0
14838,14838,심심함/Noun,5,0,5,2.2229632099588756e-05,7.774495213132233e-05,1.0
14839,14839,편모/Noun,5,5,0,7.780371234856063e-05,2.2212843466092093e-05,1.0
14840,14840,아늑하다/Adjective,5,5,0,7.780371234856063e-05,2.2212843466092093e-05,1.0
14841,14841,냉전/Noun,5,5,0,7.780371234856063e-05,2.2212843466092093e-05,1.0
14842,14842,1/2/Number,5,0,5,2.2229632099588756e-05,7.774495213132233e-05,1.0
14843,14843,1234567/Number,5,5,0,7.780371234856063e-05,2.2212843466092093e-05,1.0
14844,14844,접해/Noun,5,0,5,2.2229632099588756e-05,7.774495213132233e-05,1.0
14845,14845,불꽃놀이/Noun,5,5,0,7.780371234856063e-05,2.2212843466092093e-05,1.0
14846,14846,코웃음/Noun,5,0,5,2.2229632099588756e-05,7.774495213132233e-05,1.0
14847,14847,전엔/Foreign,5,5,0,7.780371234856063e-05,2.2212843466092093e-05,1.0
14848,14848,5000원/Number,5,0,5,2.2229632099588756e-05,7.774495213132233e-05,1.0
14849,14849,름/Noun,5,5,0,7.780371234856063e-05,2.2212843466092093e-05,1.0
14850,14850,노친/Noun,5,0,5,2.2229632099588756e-05,7.774495213132233e-05,1.0
14851,14851,준거/Noun,5,0,5,2.2229632099588756e-05,7.774495213132233e-05,1.0
14852,14852,맹맹하다/Adjective,5,0,5,2.2229632099588756e-05,7.774495213132233e-05,1.0
14853,14853,배설물/Noun,5,0,5,2.2229632099588756e-05,7.774495213132233e-05,1.0
14854,14854,쪽쪽/Noun,5,0,5,2.2229632099588756e-05,7.774495213132233e-05,1.0
14855,14855,힘빠지다/Verb,5,0,5,2.2229632099588756e-05,7.774495213132233e-05,1.0
14856,14856,주둥이/Noun,5,0,5,2.2229632099588756e-05,7.774495213132233e-05,1.0
14857,14857,............................./Punctuation,5,0,5,2.2229632099588756e-05,7.774495213132233e-05,1.0
14858,14858,능글/Noun,5,5,0,7.780371234856063e-05,2.2212843466092093e-05,1.0
14859,14859,성생활/Noun,5,0,5,2.2229632099588756e-05,7.774495213132233e-05,1.0
14860,14860,최영/Noun,5,5,0,7.780371234856063e-05,2.2212843466092093e-05,1.0
14861,14861,헬리콥터/Noun,5,5,0,7.780371234856063e-05,2.2212843466092093e-05,1.0
14862,14862,게모/Noun,5,0,5,2.2229632099588756e-05,7.774495213132233e-05,1.0
14863,14863,^&^/Punctuation,5,5,0,7.780371234856063e-05,2.2212843466092093e-05,1.0
14864,14864,이동/Noun,5,0,5,2.2229632099588756e-05,7.774495213132233e-05,1.0
14865,14865,그름/Noun,5,5,0,7.780371234856063e-05,2.2212843466092093e-05,1.0
14866,14866,맥퀸/Noun,5,5,0,7.780371234856063e-05,2.2212843466092093e-05,1.0
14867,14867,다이쥬/Noun,5,0,5,2.2229632099588756e-05,7.774495213132233e-05,1.0
14868,14868,셀린느/Noun,5,5,0,7.780371234856063e-05,2.2212843466092093e-05,1.0
14869,14869,물귀신/Noun,5,0,5,2.2229632099588756e-05,7.774495213132233e-05,1.0
14870,14870,멍충/Noun,5,0,5,2.2229632099588756e-05,7.774495213132233e-05,1.0
14871,14871,팔천원/Noun,5,0,5,2.2229632099588756e-05,7.774495213132233e-05,1.0
14872,14872,feel/Alpha,5,5,0,7.780371234856063e-05,2.2212843466092093e-05,1.0
14873,14873,닭털/Noun,5,0,5,2.2229632099588756e-05,7.774495213132233e-05,1.0
14874,14874,유정/Noun,5,5,0,7.780371234856063e-05,2.2212843466092093e-05,1.0
14875,14875,에이프릴/Noun,5,5,0,7.780371234856063e-05,2.2212843466092093e-05,1.0
14876,14876,탑기어/Noun,5,0,5,2.2229632099588756e-05,7.774495213132233e-05,1.0
14877,14877,손태영/Noun,5,0,5,2.2229632099588756e-05,7.774495213132233e-05,1.0
14878,14878,Great/Alpha,5,5,0,7.780371234856063e-05,2.2212843466092093e-05,1.0
14879,14879,짤려/Noun,5,0,5,2.2229632099588756e-05,7.774495213132233e-05,1.0
14880,14880,박하사탕/Noun,5,5,0,7.780371234856063e-05,2.2212843466092093e-05,1.0
14881,14881,독설/Noun,5,5,0,7.780371234856063e-05,2.2212843466092093e-05,1.0
14882,14882,성소수자/Noun,5,0,5,2.2229632099588756e-05,7.774495213132233e-05,1.0
14883,14883,언행/Noun,5,0,5,2.2229632099588756e-05,7.774495213132233e-05,1.0
14884,14884,자구/Noun,5,0,5,2.2229632099588756e-05,7.774495213132233e-05,1.0
14885,14885,김진표/Noun,5,0,5,2.2229632099588756e-05,7.774495213132233e-05,1.0
14886,14886,more/Alpha,5,5,0,7.780371234856063e-05,2.2212843466092093e-05,1.0
14887,14887,정겹다/Adjective,5,5,0,7.780371234856063e-05,2.2212843466092093e-05,1.0
14888,14888,일가견/Noun,5,0,5,2.2229632099588756e-05,7.774495213132233e-05,1.0
14889,14889,1만원/Number,5,0,5,2.2229632099588756e-05,7.774495213132233e-05,1.0
14890,14890,에서가/Josa,5,5,0,7.780371234856063e-05,2.2212843466092093e-05,1.0
14891,14891,동등/Noun,5,5,0,7.780371234856063e-05,2.2212843466092093e-05,1.0
14892,14892,냔/Noun,5,0,5,2.2229632099588756e-05,7.774495213132233e-05,1.0
14893,14893,220억/Number,5,0,5,2.2229632099588756e-05,7.774495213132233e-05,1.0
14894,14894,융/Noun,5,5,0,7.780371234856063e-05,2.2212843466092093e-05,1.0
14895,14895,황보라/Noun,5,0,5,2.2229632099588756e-05,7.774495213132233e-05,1.0
14896,14896,참을성/Noun,5,0,5,2.2229632099588756e-05,7.774495213132233e-05,1.0
14897,14897,탈출기/Noun,5,5,0,7.780371234856063e-05,2.2212843466092093e-05,1.0
14898,14898,아름다워지다/Verb,5,5,0,7.780371234856063e-05,2.2212843466092093e-05,1.0
14899,14899,네스/Noun,5,5,0,7.780371234856063e-05,2.2212843466092093e-05,1.0
14900,14900,상납/Noun,5,0,5,2.2229632099588756e-05,7.774495213132233e-05,1.0
14901,14901,연대/Noun,5,5,0,7.780371234856063e-05,2.2212843466092093e-05,1.0
14902,14902,뭍혀/Noun,5,5,0,7.780371234856063e-05,2.2212843466092093e-05,1.0
14903,14903,럴/Noun,5,0,5,2.2229632099588756e-05,7.774495213132233e-05,1.0
14904,14904,홍보물/Noun,5,0,5,2.2229632099588756e-05,7.774495213132233e-05,1.0
14905,14905,조자룡/Noun,5,0,5,2.2229632099588756e-05,7.774495213132233e-05,1.0
14906,14906,육탄/Noun,5,0,5,2.2229632099588756e-05,7.774495213132233e-05,1.0
14907,14907,세태/Noun,5,5,0,7.780371234856063e-05,2.2212843466092093e-05,1.0
14908,14908,라면서/Eomi,5,0,5,2.2229632099588756e-05,7.774495213132233e-05,1.0
14909,14909,여파/Noun,5,5,0,7.780371234856063e-05,2.2212843466092093e-05,1.0
14910,14910,초집/Noun,5,5,0,7.780371234856063e-05,2.2212843466092093e-05,1.0
14911,14911,200억/Number,5,0,5,2.2229632099588756e-05,7.774495213132233e-05,1.0
14912,14912,(^/Punctuation,5,5,0,7.780371234856063e-05,2.2212843466092093e-05,1.0
14913,14913,웬디/Noun,5,5,0,7.780371234856063e-05,2.2212843466092093e-05,1.0
14914,14914,교리/Noun,5,0,5,2.2229632099588756e-05,7.774495213132233e-05,1.0
14915,14915,웃프/Noun,5,5,0,7.780371234856063e-05,2.2212843466092093e-05,1.0
14916,14916,명색/Noun,5,0,5,2.2229632099588756e-05,7.774495213132233e-05,1.0
14917,14917,에어울프/Noun,5,5,0,7.780371234856063e-05,2.2212843466092093e-05,1.0
14918,14918,벚꽃/Noun,5,5,0,7.780371234856063e-05,2.2212843466092093e-05,1.0
14919,14919,방울방울/Noun,5,5,0,7.780371234856063e-05,2.2212843466092093e-05,1.0
14920,14920,께선/Josa,5,5,0,7.780371234856063e-05,2.2212843466092093e-05,1.0
14921,14921,정원/Noun,5,5,0,7.780371234856063e-05,2.2212843466092093e-05,1.0
14922,14922,장모/Noun,5,0,5,2.2229632099588756e-05,7.774495213132233e-05,1.0
14923,14923,수목장/Noun,5,0,5,2.2229632099588756e-05,7.774495213132233e-05,1.0
14924,14924,구색/Noun,5,0,5,2.2229632099588756e-05,7.774495213132233e-05,1.0
14925,14925,가용/Noun,5,0,5,2.2229632099588756e-05,7.774495213132233e-05,1.0
14926,14926,유건/Noun,5,5,0,7.780371234856063e-05,2.2212843466092093e-05,1.0
14927,14927,보샘/Noun,5,5,0,7.780371234856063e-05,2.2212843466092093e-05,1.0
14928,14928,주현/Noun,5,0,5,2.2229632099588756e-05,7.774495213132233e-05,1.0
14929,14929,카오스/Noun,5,0,5,2.2229632099588756e-05,7.774495213132233e-05,1.0
14930,14930,다방면/Noun,5,5,0,7.780371234856063e-05,2.2212843466092093e-05,1.0
14931,14931,무미건조/Noun,5,0,5,2.2229632099588756e-05,7.774495213132233e-05,1.0
14932,14932,쌉싸름하다/Adjective,5,5,0,7.780371234856063e-05,2.2212843466092093e-05,1.0
14933,14933,대령/Noun,5,5,0,7.780371234856063e-05,2.2212843466092093e-05,1.0
14934,14934,..................................../Punctuation,5,0,5,2.2229632099588756e-05,7.774495213132233e-05,1.0
14935,14935,가뜩이나/Noun,5,0,5,2.2229632099588756e-05,7.774495213132233e-05,1.0
14936,14936,분노조절/Noun,5,0,5,2.2229632099588756e-05,7.774495213132233e-05,1.0
14937,14937,그린랜턴/Noun,5,0,5,2.2229632099588756e-05,7.774495213132233e-05,1.0
14938,14938,오냐/Noun,5,0,5,2.2229632099588756e-05,7.774495213132233e-05,1.0
14939,14939,고만하다/Adjective,5,0,5,2.2229632099588756e-05,7.774495213132233e-05,1.0
14940,14940,반려견/Noun,5,5,0,7.780371234856063e-05,2.2212843466092093e-05,1.0
14941,14941,43분/Number,5,0,5,2.2229632099588756e-05,7.774495213132233e-05,1.0
14942,14942,민주당/Noun,5,0,5,2.2229632099588756e-05,7.774495213132233e-05,1.0
14943,14943,88분/Number,5,0,5,2.2229632099588756e-05,7.774495213132233e-05,1.0
14944,14944,미져리/Noun,5,5,0,7.780371234856063e-05,2.2212843466092093e-05,1.0
14945,14945,유망/Noun,5,0,5,2.2229632099588756e-05,7.774495213132233e-05,1.0
14946,14946,리액션/Noun,5,0,5,2.2229632099588756e-05,7.774495213132233e-05,1.0
14947,14947,수경/Noun,5,5,0,7.780371234856063e-05,2.2212843466092093e-05,1.0
14948,14948,^*/Punctuation,5,5,0,7.780371234856063e-05,2.2212843466092093e-05,1.0
14949,14949,주절주절/Adverb,5,0,5,2.2229632099588756e-05,7.774495213132233e-05,1.0
14950,14950,최송현/Noun,5,0,5,2.2229632099588756e-05,7.774495213132233e-05,1.0
14951,14951,적재적소/Noun,5,5,0,7.780371234856063e-05,2.2212843466092093e-05,1.0
14952,14952,이경/Noun,5,0,5,2.2229632099588756e-05,7.774495213132233e-05,1.0
14953,14953,쌩쇼/Noun,5,0,5,2.2229632099588756e-05,7.774495213132233e-05,1.0
14954,14954,추기/Noun,5,0,5,2.2229632099588756e-05,7.774495213132233e-05,1.0
14955,14955,무취/Noun,5,0,5,2.2229632099588756e-05,7.774495213132233e-05,1.0
14956,14956,황인식/Noun,5,5,0,7.780371234856063e-05,2.2212843466092093e-05,1.0
14957,14957,단가/Noun,5,0,5,2.2229632099588756e-05,7.774495213132233e-05,1.0
14958,14958,깐느/Noun,5,0,5,2.2229632099588756e-05,7.774495213132233e-05,1.0
14959,14959,정가/Noun,5,5,0,7.780371234856063e-05,2.2212843466092093e-05,1.0
14960,14960,짜르/Noun,5,0,5,2.2229632099588756e-05,7.774495213132233e-05,1.0
14961,14961,진짜꿀/Noun,5,5,0,7.780371234856063e-05,2.2212843466092093e-05,1.0
14962,14962,새옹지마/Noun,5,5,0,7.780371234856063e-05,2.2212843466092093e-05,1.0
14963,14963,고안/Noun,5,0,5,2.2229632099588756e-05,7.774495213132233e-05,1.0
14964,14964,단성사/Noun,5,5,0,7.780371234856063e-05,2.2212843466092093e-05,1.0
14965,14965,센빠이/Noun,5,5,0,7.780371234856063e-05,2.2212843466092093e-05,1.0
14966,14966,5천/Number,5,0,5,2.2229632099588756e-05,7.774495213132233e-05,1.0
14967,14967,코타/Noun,5,5,0,7.780371234856063e-05,2.2212843466092093e-05,1.0
14968,14968,에미넴/Noun,5,5,0,7.780371234856063e-05,2.2212843466092093e-05,1.0
14969,14969,쥐똥/Noun,5,0,5,2.2229632099588756e-05,7.774495213132233e-05,1.0
14970,14970,스윈튼/Noun,5,5,0,7.780371234856063e-05,2.2212843466092093e-05,1.0
14971,14971,갈기갈기/Noun,5,0,5,2.2229632099588756e-05,7.774495213132233e-05,1.0
14972,14972,두텁다/Adjective,5,5,0,7.780371234856063e-05,2.2212843466092093e-05,1.0
14973,14973,꼼수/Noun,5,0,5,2.2229632099588756e-05,7.774495213132233e-05,1.0
14974,14974,첩보원/Noun,5,0,5,2.2229632099588756e-05,7.774495213132233e-05,1.0
14975,14975,gonna/Alpha,5,5,0,7.780371234856063e-05,2.2212843466092093e-05,1.0
14976,14976,유딩들/Noun,5,0,5,2.2229632099588756e-05,7.774495213132233e-05,1.0
14977,14977,장신영/Noun,5,0,5,2.2229632099588756e-05,7.774495213132233e-05,1.0
14978,14978,이종수/Noun,5,0,5,2.2229632099588756e-05,7.774495213132233e-05,1.0
14979,14979,싸랑/Noun,5,5,0,7.780371234856063e-05,2.2212843466092093e-05,1.0
14980,14980,황금기/Noun,5,5,0,7.780371234856063e-05,2.2212843466092093e-05,1.0
14981,14981,강추임/Noun,5,5,0,7.780371234856063e-05,2.2212843466092093e-05,1.0
14982,14982,알바로/Noun,5,0,5,2.2229632099588756e-05,7.774495213132233e-05,1.0
14983,14983,장수원/Noun,5,0,5,2.2229632099588756e-05,7.774495213132233e-05,1.0
14984,14984,끌기/Noun,5,0,5,2.2229632099588756e-05,7.774495213132233e-05,1.0
14985,14985,칼빵/Noun,5,0,5,2.2229632099588756e-05,7.774495213132233e-05,1.0
14986,14986,루임/Noun,5,0,5,2.2229632099588756e-05,7.774495213132233e-05,1.0
14987,14987,똥임/Noun,5,0,5,2.2229632099588756e-05,7.774495213132233e-05,1.0
14988,14988,땔수/Noun,5,5,0,7.780371234856063e-05,2.2212843466092093e-05,1.0
14989,14989,감상주의/Noun,5,0,5,2.2229632099588756e-05,7.774495213132233e-05,1.0
14990,14990,핵잼/Noun,5,5,0,7.780371234856063e-05,2.2212843466092093e-05,1.0
14991,14991,노선/Noun,5,0,5,2.2229632099588756e-05,7.774495213132233e-05,1.0
14992,14992,만델라/Noun,5,5,0,7.780371234856063e-05,2.2212843466092093e-05,1.0
14993,14993,강유/Noun,5,0,5,2.2229632099588756e-05,7.774495213132233e-05,1.0
14994,14994,~~~~^^/Punctuation,5,5,0,7.780371234856063e-05,2.2212843466092093e-05,1.0
14995,14995,신용카드/Noun,5,0,5,2.2229632099588756e-05,7.774495213132233e-05,1.0
14996,14996,은대구/Noun,5,5,0,7.780371234856063e-05,2.2212843466092093e-05,1.0
14997,14997,팥/Noun,5,0,5,2.2229632099588756e-05,7.774495213132233e-05,1.0
14998,14998,블라인드/Noun,5,0,5,2.2229632099588756e-05,7.774495213132233e-05,1.0
14999,14999,핵무기/Noun,5,0,5,2.2229632099588756e-05,7.774495213132233e-05,1.0
15000,15000,조도/Noun,5,5,0,7.780371234856063e-05,2.2212843466092093e-05,1.0
15001,15001,와사비/Noun,5,0,5,2.2229632099588756e-05,7.774495213132233e-05,1.0
15002,15002,해마다/Adverb,5,5,0,7.780371234856063e-05,2.2212843466092093e-05,1.0
15003,15003,단편소설/Noun,5,5,0,7.780371234856063e-05,2.2212843466092093e-05,1.0
15004,15004,일간/Noun,5,5,0,7.780371234856063e-05,2.2212843466092093e-05,1.0
15005,15005,캡쳐/Noun,5,0,5,2.2229632099588756e-05,7.774495213132233e-05,1.0
15006,15006,고요함/Noun,5,5,0,7.780371234856063e-05,2.2212843466092093e-05,1.0
15007,15007,급임/Noun,5,0,5,2.2229632099588756e-05,7.774495213132233e-05,1.0
15008,15008,중주/Noun,5,5,0,7.780371234856063e-05,2.2212843466092093e-05,1.0
15009,15009,야릇하다/Adjective,5,5,0,7.780371234856063e-05,2.2212843466092093e-05,1.0
15010,15010,재상/Noun,5,5,0,7.780371234856063e-05,2.2212843466092093e-05,1.0
15011,15011,이무영/Noun,5,0,5,2.2229632099588756e-05,7.774495213132233e-05,1.0
15012,15012,140원/Number,5,0,5,2.2229632099588756e-05,7.774495213132233e-05,1.0
15013,15013,다드/Noun,5,0,5,2.2229632099588756e-05,7.774495213132233e-05,1.0
15014,15014,성찬/Noun,5,0,5,2.2229632099588756e-05,7.774495213132233e-05,1.0
15015,15015,★★★★★/Foreign,5,5,0,7.780371234856063e-05,2.2212843466092093e-05,1.0
15016,15016,갱스/Noun,5,5,0,7.780371234856063e-05,2.2212843466092093e-05,1.0
15017,15017,자유로/Noun,5,5,0,7.780371234856063e-05,2.2212843466092093e-05,1.0
15018,15018,왜만듬/Noun,5,0,5,2.2229632099588756e-05,7.774495213132233e-05,1.0
15019,15019,야곱/Noun,5,5,0,7.780371234856063e-05,2.2212843466092093e-05,1.0
15020,15020,어쨌다/Noun,5,0,5,2.2229632099588756e-05,7.774495213132233e-05,1.0
15021,15021,이상주/Noun,5,0,5,2.2229632099588756e-05,7.774495213132233e-05,1.0
15022,15022,르네상스/Noun,5,5,0,7.780371234856063e-05,2.2212843466092093e-05,1.0
15023,15023,여담/Noun,5,5,0,7.780371234856063e-05,2.2212843466092093e-05,1.0
15024,15024,악물다/Verb,5,0,5,2.2229632099588756e-05,7.774495213132233e-05,1.0
15025,15025,최효종/Noun,5,0,5,2.2229632099588756e-05,7.774495213132233e-05,1.0
15026,15026,마마마/Noun,5,5,0,7.780371234856063e-05,2.2212843466092093e-05,1.0
15027,15027,통편집/Noun,5,0,5,2.2229632099588756e-05,7.774495213132233e-05,1.0
15028,15028,베가/Noun,5,5,0,7.780371234856063e-05,2.2212843466092093e-05,1.0
15029,15029,짜리로/Foreign,5,0,5,2.2229632099588756e-05,7.774495213132233e-05,1.0
15030,15030,룻거/Noun,5,5,0,7.780371234856063e-05,2.2212843466092093e-05,1.0
15031,15031,망조/Noun,5,0,5,2.2229632099588756e-05,7.774495213132233e-05,1.0
15032,15032,태산/Noun,5,0,5,2.2229632099588756e-05,7.774495213132233e-05,1.0
15033,15033,돌기/Noun,5,0,5,2.2229632099588756e-05,7.774495213132233e-05,1.0
15034,15034,꼬아/Noun,5,0,5,2.2229632099588756e-05,7.774495213132233e-05,1.0
15035,15035,정성일/Noun,5,0,5,2.2229632099588756e-05,7.774495213132233e-05,1.0
15036,15036,1976년/Number,5,5,0,7.780371234856063e-05,2.2212843466092093e-05,1.0
15037,15037,업보/Noun,5,5,0,7.780371234856063e-05,2.2212843466092093e-05,1.0
15038,15038,몽키/Noun,5,0,5,2.2229632099588756e-05,7.774495213132233e-05,1.0
15039,15039,난의/Noun,5,0,5,2.2229632099588756e-05,7.774495213132233e-05,1.0
15040,15040,형언/Noun,5,5,0,7.780371234856063e-05,2.2212843466092093e-05,1.0
15041,15041,카이저/Noun,5,5,0,7.780371234856063e-05,2.2212843466092093e-05,1.0
15042,15042,순결/Noun,5,0,5,2.2229632099588756e-05,7.774495213132233e-05,1.0
15043,15043,하네케/Noun,5,5,0,7.780371234856063e-05,2.2212843466092093e-05,1.0
15044,15044,득템/Noun,5,5,0,7.780371234856063e-05,2.2212843466092093e-05,1.0
15045,15045,쌩뚱맞고/Noun,5,0,5,2.2229632099588756e-05,7.774495213132233e-05,1.0
15046,15046,체널/Noun,5,0,5,2.2229632099588756e-05,7.774495213132233e-05,1.0
15047,15047,찜찜/Noun,5,0,5,2.2229632099588756e-05,7.774495213132233e-05,1.0
15048,15048,망처/Noun,5,0,5,2.2229632099588756e-05,7.774495213132233e-05,1.0
15049,15049,개수/Noun,5,0,5,2.2229632099588756e-05,7.774495213132233e-05,1.0
15050,15050,더글러스/Noun,5,0,5,2.2229632099588756e-05,7.774495213132233e-05,1.0
15051,15051,씨앗/Noun,5,5,0,7.780371234856063e-05,2.2212843466092093e-05,1.0
15052,15052,묶이다/Verb,5,0,5,2.2229632099588756e-05,7.774495213132233e-05,1.0
15053,15053,속삭이다/Verb,5,5,0,7.780371234856063e-05,2.2212843466092093e-05,1.0
15054,15054,개꿈/Noun,5,0,5,2.2229632099588756e-05,7.774495213132233e-05,1.0
15055,15055,욯/Noun,5,5,0,7.780371234856063e-05,2.2212843466092093e-05,1.0
15056,15056,다짜고짜/Noun,5,0,5,2.2229632099588756e-05,7.774495213132233e-05,1.0
15057,15057,오죽/Noun,5,0,5,2.2229632099588756e-05,7.774495213132233e-05,1.0
15058,15058,허우적대다/Verb,5,0,5,2.2229632099588756e-05,7.774495213132233e-05,1.0
15059,15059,신저/Noun,5,5,0,7.780371234856063e-05,2.2212843466092093e-05,1.0
15060,15060,경첨/Noun,5,0,5,2.2229632099588756e-05,7.774495213132233e-05,1.0
15061,15061,쉽사리/Noun,5,5,0,7.780371234856063e-05,2.2212843466092093e-05,1.0
15062,15062,널린/Noun,5,0,5,2.2229632099588756e-05,7.774495213132233e-05,1.0
15063,15063,...^^*/Punctuation,5,5,0,7.780371234856063e-05,2.2212843466092093e-05,1.0
15064,15064,테디/Noun,5,5,0,7.780371234856063e-05,2.2212843466092093e-05,1.0
15065,15065,박희본/Noun,5,5,0,7.780371234856063e-05,2.2212843466092093e-05,1.0
15066,15066,날조/Noun,5,0,5,2.2229632099588756e-05,7.774495213132233e-05,1.0
15067,15067,왜함/Noun,5,0,5,2.2229632099588756e-05,7.774495213132233e-05,1.0
15068,15068,이게뭡/Noun,5,0,5,2.2229632099588756e-05,7.774495213132233e-05,1.0
15069,15069,러브신/Noun,5,0,5,2.2229632099588756e-05,7.774495213132233e-05,1.0
15070,15070,깨뜨리다/Verb,5,0,5,2.2229632099588756e-05,7.774495213132233e-05,1.0
15071,15071,하데스/Noun,5,0,5,2.2229632099588756e-05,7.774495213132233e-05,1.0
15072,15072,먹잇감/Noun,5,0,5,2.2229632099588756e-05,7.774495213132233e-05,1.0
15073,15073,면죄부/Noun,5,0,5,2.2229632099588756e-05,7.774495213132233e-05,1.0
15074,15074,세스/Noun,5,5,0,7.780371234856063e-05,2.2212843466092093e-05,1.0
15075,15075,잘봣음/Noun,5,5,0,7.780371234856063e-05,2.2212843466092093e-05,1.0
15076,15076,마쇼/Noun,5,0,5,2.2229632099588756e-05,7.774495213132233e-05,1.0
15077,15077,훈계/Noun,5,0,5,2.2229632099588756e-05,7.774495213132233e-05,1.0
15078,15078,2222/Number,5,0,5,2.2229632099588756e-05,7.774495213132233e-05,1.0
15079,15079,>>>>/Punctuation,5,0,5,2.2229632099588756e-05,7.774495213132233e-05,1.0
15080,15080,이태란/Noun,5,0,5,2.2229632099588756e-05,7.774495213132233e-05,1.0
15081,15081,문화유산/Noun,5,5,0,7.780371234856063e-05,2.2212843466092093e-05,1.0
15082,15082,호비다/Verb,5,5,0,7.780371234856063e-05,2.2212843466092093e-05,1.0
15083,15083,어버버/Adverb,5,0,5,2.2229632099588756e-05,7.774495213132233e-05,1.0
15084,15084,개불/Noun,5,0,5,2.2229632099588756e-05,7.774495213132233e-05,1.0
15085,15085,자작/Noun,5,0,5,2.2229632099588756e-05,7.774495213132233e-05,1.0
15086,15086,합채/Noun,5,0,5,2.2229632099588756e-05,7.774495213132233e-05,1.0
15087,15087,지각/Noun,5,5,0,7.780371234856063e-05,2.2212843466092093e-05,1.0
15088,15088,Don/Alpha,5,5,0,7.780371234856063e-05,2.2212843466092093e-05,1.0
15089,15089,꼬셔/Noun,5,0,5,2.2229632099588756e-05,7.774495213132233e-05,1.0
15090,15090,빗속/Noun,5,5,0,7.780371234856063e-05,2.2212843466092093e-05,1.0
15091,15091,면허/Noun,5,0,5,2.2229632099588756e-05,7.774495213132233e-05,1.0
15092,15092,명화극장/Noun,5,5,0,7.780371234856063e-05,2.2212843466092093e-05,1.0
15093,15093,1984년/Number,5,5,0,7.780371234856063e-05,2.2212843466092093e-05,1.0
15094,15094,;;;;;;;;;/Punctuation,5,0,5,2.2229632099588756e-05,7.774495213132233e-05,1.0
15095,15095,한마음/Noun,5,5,0,7.780371234856063e-05,2.2212843466092093e-05,1.0
15096,15096,해괴망측/Noun,5,0,5,2.2229632099588756e-05,7.774495213132233e-05,1.0
15097,15097,송종국/Noun,5,0,5,2.2229632099588756e-05,7.774495213132233e-05,1.0
15098,15098,꿀잼꿀잼/Noun,5,5,0,7.780371234856063e-05,2.2212843466092093e-05,1.0
15099,15099,뒤론/Noun,5,0,5,2.2229632099588756e-05,7.774495213132233e-05,1.0
15100,15100,명동/Noun,5,0,5,2.2229632099588756e-05,7.774495213132233e-05,1.0
15101,15101,고래고래/Noun,5,0,5,2.2229632099588756e-05,7.774495213132233e-05,1.0
15102,15102,우둔하다/Adjective,5,0,5,2.2229632099588756e-05,7.774495213132233e-05,1.0
15103,15103,분잡/Noun,5,0,5,2.2229632099588756e-05,7.774495213132233e-05,1.0
15104,15104,골수/Noun,5,0,5,2.2229632099588756e-05,7.774495213132233e-05,1.0
15105,15105,표값/Noun,5,0,5,2.2229632099588756e-05,7.774495213132233e-05,1.0
15106,15106,벌목/Noun,5,0,5,2.2229632099588756e-05,7.774495213132233e-05,1.0
15107,15107,킁/Noun,5,0,5,2.2229632099588756e-05,7.774495213132233e-05,1.0
15108,15108,낚시꾼/Noun,5,0,5,2.2229632099588756e-05,7.774495213132233e-05,1.0
15109,15109,재혼/Noun,5,0,5,2.2229632099588756e-05,7.774495213132233e-05,1.0
15110,15110,어언/Adverb,5,5,0,7.780371234856063e-05,2.2212843466092093e-05,1.0
15111,15111,!~^^/Punctuation,5,5,0,7.780371234856063e-05,2.2212843466092093e-05,1.0
15112,15112,fail/Alpha,5,0,5,2.2229632099588756e-05,7.774495213132233e-05,1.0
15113,15113,추접/Noun,5,0,5,2.2229632099588756e-05,7.774495213132233e-05,1.0
15114,15114,대학로/Noun,5,5,0,7.780371234856063e-05,2.2212843466092093e-05,1.0
15115,15115,데니/Noun,5,5,0,7.780371234856063e-05,2.2212843466092093e-05,1.0
15116,15116,텔러/Noun,5,5,0,7.780371234856063e-05,2.2212843466092093e-05,1.0
15117,15117,로이킴/Noun,5,0,5,2.2229632099588756e-05,7.774495213132233e-05,1.0
15118,15118,!..../Punctuation,5,0,5,2.2229632099588756e-05,7.774495213132233e-05,1.0
15119,15119,기단/Noun,5,0,5,2.2229632099588756e-05,7.774495213132233e-05,1.0
15120,15120,깽깽/Adverb,5,0,5,2.2229632099588756e-05,7.774495213132233e-05,1.0
15121,15121,zero/Alpha,5,0,5,2.2229632099588756e-05,7.774495213132233e-05,1.0
15122,15122,저릿저릿하다/Adjective,5,5,0,7.780371234856063e-05,2.2212843466092093e-05,1.0
15123,15123,목격자/Noun,5,0,5,2.2229632099588756e-05,7.774495213132233e-05,1.0
15124,15124,엣헴/Noun,5,0,5,2.2229632099588756e-05,7.774495213132233e-05,1.0
15125,15125,유나/Noun,5,5,0,7.780371234856063e-05,2.2212843466092093e-05,1.0
15126,15126,애나/Noun,5,0,5,2.2229632099588756e-05,7.774495213132233e-05,1.0
15127,15127,특출나다/Adjective,5,0,5,2.2229632099588756e-05,7.774495213132233e-05,1.0
15128,15128,혈팬/Noun,5,5,0,7.780371234856063e-05,2.2212843466092093e-05,1.0
15129,15129,^~^/Punctuation,5,5,0,7.780371234856063e-05,2.2212843466092093e-05,1.0
15130,15130,이이해/Noun,5,0,5,2.2229632099588756e-05,7.774495213132233e-05,1.0
15131,15131,개시/Noun,5,0,5,2.2229632099588756e-05,7.774495213132233e-05,1.0
15132,15132,불결하다/Adjective,5,0,5,2.2229632099588756e-05,7.774495213132233e-05,1.0
15133,15133,가급적/Adverb,5,0,5,2.2229632099588756e-05,7.774495213132233e-05,1.0
15134,15134,마소/Noun,5,0,5,2.2229632099588756e-05,7.774495213132233e-05,1.0
15135,15135,학습/Noun,5,5,0,7.780371234856063e-05,2.2212843466092093e-05,1.0
15136,15136,포뇨/Noun,5,5,0,7.780371234856063e-05,2.2212843466092093e-05,1.0
15137,15137,조은영/Noun,5,5,0,7.780371234856063e-05,2.2212843466092093e-05,1.0
15138,15138,판/Foreign,5,1,4,3.334444814938313e-05,6.663853039827628e-05,0.8
15139,15139,몬스타/Noun,5,4,1,6.668889629876625e-05,3.331926519913814e-05,0.8
15140,15140,잭스/Noun,5,4,1,6.668889629876625e-05,3.331926519913814e-05,0.8
15141,15141,톨스토이/Noun,5,4,1,6.668889629876625e-05,3.331926519913814e-05,0.8
15142,15142,180/Number,5,1,4,3.334444814938313e-05,6.663853039827628e-05,0.8
15143,15143,!!!!!!!!!!!!!!!!!!!!!!!/Punctuation,5,4,1,6.668889629876625e-05,3.331926519913814e-05,0.8
15144,15144,진실로/Adverb,5,4,1,6.668889629876625e-05,3.331926519913814e-05,0.8
15145,15145,연기대상/Noun,5,4,1,6.668889629876625e-05,3.331926519913814e-05,0.8
15146,15146,부사/Noun,5,1,4,3.334444814938313e-05,6.663853039827628e-05,0.8
15147,15147,에이트/Noun,5,1,4,3.334444814938313e-05,6.663853039827628e-05,0.8
15148,15148,분단국가/Noun,5,4,1,6.668889629876625e-05,3.331926519913814e-05,0.8
15149,15149,메리트/Noun,5,4,1,6.668889629876625e-05,3.331926519913814e-05,0.8
15150,15150,프로즌/Noun,5,4,1,6.668889629876625e-05,3.331926519913814e-05,0.8
15151,15151,스크립트/Noun,5,1,4,3.334444814938313e-05,6.663853039827628e-05,0.8
15152,15152,왕팬/Noun,5,4,1,6.668889629876625e-05,3.331926519913814e-05,0.8
15153,15153,년대/Noun,5,1,4,3.334444814938313e-05,6.663853039827628e-05,0.8
15154,15154,마나피/Noun,5,1,4,3.334444814938313e-05,6.663853039827628e-05,0.8
15155,15155,젓다/Verb,5,4,1,6.668889629876625e-05,3.331926519913814e-05,0.8
15156,15156,딛다/Verb,5,4,1,6.668889629876625e-05,3.331926519913814e-05,0.8
15157,15157,페로/Noun,5,4,1,6.668889629876625e-05,3.331926519913814e-05,0.8
15158,15158,강남스타일/Noun,5,1,4,3.334444814938313e-05,6.663853039827628e-05,0.8
15159,15159,세분/Noun,5,4,1,6.668889629876625e-05,3.331926519913814e-05,0.8
15160,15160,死/Foreign,5,1,4,3.334444814938313e-05,6.663853039827628e-05,0.8
15161,15161,표상/Noun,5,1,4,3.334444814938313e-05,6.663853039827628e-05,0.8
15162,15162,에다가/Noun,5,1,4,3.334444814938313e-05,6.663853039827628e-05,0.8
15163,15163,간이/Noun,5,1,4,3.334444814938313e-05,6.663853039827628e-05,0.8
15164,15164,!!'/Punctuation,5,1,4,3.334444814938313e-05,6.663853039827628e-05,0.8
15165,15165,역사드라마/Noun,5,4,1,6.668889629876625e-05,3.331926519913814e-05,0.8
15166,15166,거때매/Noun,5,1,4,3.334444814938313e-05,6.663853039827628e-05,0.8
15167,15167,?;;;;/Punctuation,5,1,4,3.334444814938313e-05,6.663853039827628e-05,0.8
15168,15168,콤플렉스/Noun,5,1,4,3.334444814938313e-05,6.663853039827628e-05,0.8
15169,15169,박현/Noun,5,1,4,3.334444814938313e-05,6.663853039827628e-05,0.8
15170,15170,전차/Noun,5,1,4,3.334444814938313e-05,6.663853039827628e-05,0.8
15171,15171,굉장/Noun,5,4,1,6.668889629876625e-05,3.331926519913814e-05,0.8
15172,15172,메이트/Noun,5,4,1,6.668889629876625e-05,3.331926519913814e-05,0.8
15173,15173,배터리/Noun,5,4,1,6.668889629876625e-05,3.331926519913814e-05,0.8
15174,15174,고지전/Noun,5,1,4,3.334444814938313e-05,6.663853039827628e-05,0.8
15175,15175,농장/Noun,5,1,4,3.334444814938313e-05,6.663853039827628e-05,0.8
15176,15176,담장/Noun,5,4,1,6.668889629876625e-05,3.331926519913814e-05,0.8
15177,15177,착란/Noun,5,1,4,3.334444814938313e-05,6.663853039827628e-05,0.8
15178,15178,정치드라마/Noun,5,4,1,6.668889629876625e-05,3.331926519913814e-05,0.8
15179,15179,번천/Noun,5,1,4,3.334444814938313e-05,6.663853039827628e-05,0.8
15180,15180,안통/Noun,5,1,4,3.334444814938313e-05,6.663853039827628e-05,0.8
15181,15181,흰둥이/Noun,5,4,1,6.668889629876625e-05,3.331926519913814e-05,0.8
15182,15182,탭댄스/Noun,5,4,1,6.668889629876625e-05,3.331926519913814e-05,0.8
15183,15183,향상/Noun,5,4,1,6.668889629876625e-05,3.331926519913814e-05,0.8
15184,15184,쌍칼/Noun,5,1,4,3.334444814938313e-05,6.663853039827628e-05,0.8
15185,15185,캠퍼스/Noun,5,4,1,6.668889629876625e-05,3.331926519913814e-05,0.8
15186,15186,서준이/Noun,5,4,1,6.668889629876625e-05,3.331926519913814e-05,0.8
15187,15187,한승연/Noun,5,1,4,3.334444814938313e-05,6.663853039827628e-05,0.8
15188,15188,액스맨/Noun,5,1,4,3.334444814938313e-05,6.663853039827628e-05,0.8
15189,15189,다툼/Noun,5,4,1,6.668889629876625e-05,3.331926519913814e-05,0.8
15190,15190,이인상/Noun,5,4,1,6.668889629876625e-05,3.331926519913814e-05,0.8
15191,15191,월남전/Noun,5,4,1,6.668889629876625e-05,3.331926519913814e-05,0.8
15192,15192,구성원/Noun,5,4,1,6.668889629876625e-05,3.331926519913814e-05,0.8
15193,15193,마음먹다/Verb,5,1,4,3.334444814938313e-05,6.663853039827628e-05,0.8
15194,15194,저승/Noun,5,1,4,3.334444814938313e-05,6.663853039827628e-05,0.8
15195,15195,봣을때/Noun,5,4,1,6.668889629876625e-05,3.331926519913814e-05,0.8
15196,15196,딴말/Noun,5,4,1,6.668889629876625e-05,3.331926519913814e-05,0.8
15197,15197,무책임/Noun,5,1,4,3.334444814938313e-05,6.663853039827628e-05,0.8
15198,15198,자장면/Noun,5,4,1,6.668889629876625e-05,3.331926519913814e-05,0.8
15199,15199,인걸/Noun,5,1,4,3.334444814938313e-05,6.663853039827628e-05,0.8
15200,15200,영웅재중/Noun,5,1,4,3.334444814938313e-05,6.663853039827628e-05,0.8
15201,15201,풍만하다/Adjective,5,4,1,6.668889629876625e-05,3.331926519913814e-05,0.8
15202,15202,강타/Noun,5,4,1,6.668889629876625e-05,3.331926519913814e-05,0.8
15203,15203,금액/Noun,5,1,4,3.334444814938313e-05,6.663853039827628e-05,0.8
15204,15204,순종/Noun,5,4,1,6.668889629876625e-05,3.331926519913814e-05,0.8
15205,15205,약혼/Noun,5,1,4,3.334444814938313e-05,6.663853039827628e-05,0.8
15206,15206,개늑시/Noun,5,4,1,6.668889629876625e-05,3.331926519913814e-05,0.8
15207,15207,한겨레/Noun,5,4,1,6.668889629876625e-05,3.331926519913814e-05,0.8
15208,15208,백지/Noun,5,4,1,6.668889629876625e-05,3.331926519913814e-05,0.8
15209,15209,궁상맞다/Adjective,5,1,4,3.334444814938313e-05,6.663853039827628e-05,0.8
15210,15210,로베르토/Noun,5,4,1,6.668889629876625e-05,3.331926519913814e-05,0.8
15211,15211,신입/Noun,5,1,4,3.334444814938313e-05,6.663853039827628e-05,0.8
15212,15212,강산/Noun,5,4,1,6.668889629876625e-05,3.331926519913814e-05,0.8
15213,15213,딸바보/Noun,5,4,1,6.668889629876625e-05,3.331926519913814e-05,0.8
15214,15214,연줄/Noun,5,1,4,3.334444814938313e-05,6.663853039827628e-05,0.8
15215,15215,관여/Noun,5,1,4,3.334444814938313e-05,6.663853039827628e-05,0.8
15216,15216,라이터/Noun,5,1,4,3.334444814938313e-05,6.663853039827628e-05,0.8
15217,15217,초록/Noun,5,4,1,6.668889629876625e-05,3.331926519913814e-05,0.8
15218,15218,골룸/Noun,5,1,4,3.334444814938313e-05,6.663853039827628e-05,0.8
15219,15219,샵/Suffix,5,4,1,6.668889629876625e-05,3.331926519913814e-05,0.8
15220,15220,들판/Noun,5,4,1,6.668889629876625e-05,3.331926519913814e-05,0.8
15221,15221,뫼비우스/Noun,5,4,1,6.668889629876625e-05,3.331926519913814e-05,0.8
15222,15222,2500원/Number,5,1,4,3.334444814938313e-05,6.663853039827628e-05,0.8
15223,15223,드림걸즈/Noun,5,1,4,3.334444814938313e-05,6.663853039827628e-05,0.8
15224,15224,비아이/Noun,5,1,4,3.334444814938313e-05,6.663853039827628e-05,0.8
15225,15225,3천/Number,5,1,4,3.334444814938313e-05,6.663853039827628e-05,0.8
15226,15226,35년/Number,5,4,1,6.668889629876625e-05,3.331926519913814e-05,0.8
15227,15227,서영/Noun,5,1,4,3.334444814938313e-05,6.663853039827628e-05,0.8
15228,15228,일터/Noun,5,1,4,3.334444814938313e-05,6.663853039827628e-05,0.8
15229,15229,삼십/Noun,5,4,1,6.668889629876625e-05,3.331926519913814e-05,0.8
15230,15230,노가다/Noun,5,1,4,3.334444814938313e-05,6.663853039827628e-05,0.8
15231,15231,신구/Noun,5,4,1,6.668889629876625e-05,3.331926519913814e-05,0.8
15232,15232,출생의비밀/Noun,5,1,4,3.334444814938313e-05,6.663853039827628e-05,0.8
15233,15233,시아버지/Noun,5,1,4,3.334444814938313e-05,6.663853039827628e-05,0.8
15234,15234,홍경민/Noun,5,1,4,3.334444814938313e-05,6.663853039827628e-05,0.8
15235,15235,달라짐/Noun,5,1,4,3.334444814938313e-05,6.663853039827628e-05,0.8
15236,15236,실미도/Noun,5,1,4,3.334444814938313e-05,6.663853039827628e-05,0.8
15237,15237,네/Exclamation,5,4,1,6.668889629876625e-05,3.331926519913814e-05,0.8
15238,15238,법대/Noun,5,4,1,6.668889629876625e-05,3.331926519913814e-05,0.8
15239,15239,마등/Noun,5,4,1,6.668889629876625e-05,3.331926519913814e-05,0.8
15240,15240,1.4/Number,5,1,4,3.334444814938313e-05,6.663853039827628e-05,0.8
15241,15241,back/Alpha,5,4,1,6.668889629876625e-05,3.331926519913814e-05,0.8
15242,15242,궤/Noun,5,4,1,6.668889629876625e-05,3.331926519913814e-05,0.8
15243,15243,경로/Noun,5,1,4,3.334444814938313e-05,6.663853039827628e-05,0.8
15244,15244,애프터/Noun,5,4,1,6.668889629876625e-05,3.331926519913814e-05,0.8
15245,15245,199/Number,5,1,4,3.334444814938313e-05,6.663853039827628e-05,0.8
15246,15246,☞/Foreign,5,1,4,3.334444814938313e-05,6.663853039827628e-05,0.8
15247,15247,한해/Noun,5,4,1,6.668889629876625e-05,3.331926519913814e-05,0.8
15248,15248,성재/Noun,5,1,4,3.334444814938313e-05,6.663853039827628e-05,0.8
15249,15249,묵/Noun,5,1,4,3.334444814938313e-05,6.663853039827628e-05,0.8
15250,15250,적인걸/Noun,5,1,4,3.334444814938313e-05,6.663853039827628e-05,0.8
15251,15251,대일/Noun,5,4,1,6.668889629876625e-05,3.331926519913814e-05,0.8
15252,15252,이왕/Adverb,5,1,4,3.334444814938313e-05,6.663853039827628e-05,0.8
15253,15253,하강/Noun,5,1,4,3.334444814938313e-05,6.663853039827628e-05,0.8
15254,15254,네일/Noun,5,4,1,6.668889629876625e-05,3.331926519913814e-05,0.8
15255,15255,들이밀다/Verb,5,1,4,3.334444814938313e-05,6.663853039827628e-05,0.8
15256,15256,안부/Noun,5,1,4,3.334444814938313e-05,6.663853039827628e-05,0.8
15257,15257,훈장/Noun,5,1,4,3.334444814938313e-05,6.663853039827628e-05,0.8
15258,15258,레시라무/Noun,5,4,1,6.668889629876625e-05,3.331926519913814e-05,0.8
15259,15259,장판/Noun,5,1,4,3.334444814938313e-05,6.663853039827628e-05,0.8
15260,15260,한드/Noun,5,4,1,6.668889629876625e-05,3.331926519913814e-05,0.8
15261,15261,전무/Noun,5,1,4,3.334444814938313e-05,6.663853039827628e-05,0.8
15262,15262,베끼/Noun,5,1,4,3.334444814938313e-05,6.663853039827628e-05,0.8
15263,15263,에지/Noun,5,4,1,6.668889629876625e-05,3.331926519913814e-05,0.8
15264,15264,청리/Noun,5,1,4,3.334444814938313e-05,6.663853039827628e-05,0.8
15265,15265,콩트/Noun,5,1,4,3.334444814938313e-05,6.663853039827628e-05,0.8
15266,15266,사설/Noun,5,1,4,3.334444814938313e-05,6.663853039827628e-05,0.8
15267,15267,난대/Noun,5,1,4,3.334444814938313e-05,6.663853039827628e-05,0.8
15268,15268,네드/Noun,5,4,1,6.668889629876625e-05,3.331926519913814e-05,0.8
15269,15269,무산/Noun,5,4,1,6.668889629876625e-05,3.331926519913814e-05,0.8
15270,15270,성자/Noun,5,4,1,6.668889629876625e-05,3.331926519913814e-05,0.8
15271,15271,유스케/Noun,5,1,4,3.334444814938313e-05,6.663853039827628e-05,0.8
15272,15272,명쾌하다/Adjective,5,4,1,6.668889629876625e-05,3.331926519913814e-05,0.8
15273,15273,조수/Noun,5,1,4,3.334444814938313e-05,6.663853039827628e-05,0.8
15274,15274,원샷/Noun,5,1,4,3.334444814938313e-05,6.663853039827628e-05,0.8
15275,15275,연금술사/Noun,5,4,1,6.668889629876625e-05,3.331926519913814e-05,0.8
15276,15276,친구여/Noun,5,4,1,6.668889629876625e-05,3.331926519913814e-05,0.8
15277,15277,추앙/Noun,5,1,4,3.334444814938313e-05,6.663853039827628e-05,0.8
15278,15278,백터/Noun,5,1,4,3.334444814938313e-05,6.663853039827628e-05,0.8
15279,15279,스내치/Noun,5,4,1,6.668889629876625e-05,3.331926519913814e-05,0.8
15280,15280,원점/Noun,5,1,4,3.334444814938313e-05,6.663853039827628e-05,0.8
15281,15281,지면/Noun,5,4,1,6.668889629876625e-05,3.331926519913814e-05,0.8
15282,15282,병폐/Noun,5,1,4,3.334444814938313e-05,6.663853039827628e-05,0.8
15283,15283,ㄹㄹㄹ/KoreanParticle,5,4,1,6.668889629876625e-05,3.331926519913814e-05,0.8
15284,15284,",!/Punctuation",5,4,1,6.668889629876625e-05,3.331926519913814e-05,0.8
15285,15285,에픽/Noun,5,1,4,3.334444814938313e-05,6.663853039827628e-05,0.8
15286,15286,대군/Noun,5,1,4,3.334444814938313e-05,6.663853039827628e-05,0.8
15287,15287,대포/Noun,5,1,4,3.334444814938313e-05,6.663853039827628e-05,0.8
15288,15288,한민족/Noun,5,4,1,6.668889629876625e-05,3.331926519913814e-05,0.8
15289,15289,주사위/Noun,5,1,4,3.334444814938313e-05,6.663853039827628e-05,0.8
15290,15290,탑블레이드/Noun,5,1,4,3.334444814938313e-05,6.663853039827628e-05,0.8
15291,15291,일박이일/Noun,5,1,4,3.334444814938313e-05,6.663853039827628e-05,0.8
15292,15292,한강/Noun,5,4,1,6.668889629876625e-05,3.331926519913814e-05,0.8
15293,15293,반박/Noun,5,1,4,3.334444814938313e-05,6.663853039827628e-05,0.8
15294,15294,뙇/Noun,5,4,1,6.668889629876625e-05,3.331926519913814e-05,0.8
15295,15295,개사/Noun,5,1,4,3.334444814938313e-05,6.663853039827628e-05,0.8
15296,15296,찬열/Noun,5,4,1,6.668889629876625e-05,3.331926519913814e-05,0.8
15297,15297,오어/Noun,5,4,1,6.668889629876625e-05,3.331926519913814e-05,0.8
15298,15298,디시/Noun,5,4,1,6.668889629876625e-05,3.331926519913814e-05,0.8
15299,15299,말콤/Noun,5,4,1,6.668889629876625e-05,3.331926519913814e-05,0.8
15300,15300,수현/Noun,5,4,1,6.668889629876625e-05,3.331926519913814e-05,0.8
15301,15301,주적/Noun,5,1,4,3.334444814938313e-05,6.663853039827628e-05,0.8
15302,15302,1981년/Number,5,4,1,6.668889629876625e-05,3.331926519913814e-05,0.8
15303,15303,따라쟁/Noun,5,1,4,3.334444814938313e-05,6.663853039827628e-05,0.8
15304,15304,일빠/Noun,5,1,4,3.334444814938313e-05,6.663853039827628e-05,0.8
15305,15305,살딸/Noun,5,4,1,6.668889629876625e-05,3.331926519913814e-05,0.8
15306,15306,속세/Noun,5,1,4,3.334444814938313e-05,6.663853039827628e-05,0.8
15307,15307,유천/Noun,5,4,1,6.668889629876625e-05,3.331926519913814e-05,0.8
15308,15308,가타카/Noun,5,1,4,3.334444814938313e-05,6.663853039827628e-05,0.8
15309,15309,년후/Noun,5,4,1,6.668889629876625e-05,3.331926519913814e-05,0.8
15310,15310,쩖/Noun,5,4,1,6.668889629876625e-05,3.331926519913814e-05,0.8
15311,15311,쌈빡하다/Adjective,5,1,4,3.334444814938313e-05,6.663853039827628e-05,0.8
15312,15312,희수/Noun,5,1,4,3.334444814938313e-05,6.663853039827628e-05,0.8
15313,15313,타당/Noun,5,1,4,3.334444814938313e-05,6.663853039827628e-05,0.8
15314,15314,적절/Noun,5,1,4,3.334444814938313e-05,6.663853039827628e-05,0.8
15315,15315,노병/Noun,5,4,1,6.668889629876625e-05,3.331926519913814e-05,0.8
15316,15316,신공/Noun,5,1,4,3.334444814938313e-05,6.663853039827628e-05,0.8
15317,15317,민하/Noun,5,4,1,6.668889629876625e-05,3.331926519913814e-05,0.8
15318,15318,농민/Noun,5,4,1,6.668889629876625e-05,3.331926519913814e-05,0.8
15319,15319,로마시대/Noun,5,4,1,6.668889629876625e-05,3.331926519913814e-05,0.8
15320,15320,럭비/Noun,5,4,1,6.668889629876625e-05,3.331926519913814e-05,0.8
15321,15321,섹파/Noun,5,1,4,3.334444814938313e-05,6.663853039827628e-05,0.8
15322,15322,한여름/Noun,5,4,1,6.668889629876625e-05,3.331926519913814e-05,0.8
15323,15323,연봉/Noun,5,1,4,3.334444814938313e-05,6.663853039827628e-05,0.8
15324,15324,두기봉/Noun,5,4,1,6.668889629876625e-05,3.331926519913814e-05,0.8
15325,15325,불분명/Noun,5,1,4,3.334444814938313e-05,6.663853039827628e-05,0.8
15326,15326,후뢰시맨/Noun,5,1,4,3.334444814938313e-05,6.663853039827628e-05,0.8
15327,15327,그리스도/Noun,5,4,1,6.668889629876625e-05,3.331926519913814e-05,0.8
15328,15328,남용/Noun,5,1,4,3.334444814938313e-05,6.663853039827628e-05,0.8
15329,15329,행복감/Noun,5,4,1,6.668889629876625e-05,3.331926519913814e-05,0.8
15330,15330,섹스씬/Noun,5,1,4,3.334444814938313e-05,6.663853039827628e-05,0.8
15331,15331,ㅜㅡㅜ/KoreanParticle,5,4,1,6.668889629876625e-05,3.331926519913814e-05,0.8
15332,15332,우후죽순/Noun,5,1,4,3.334444814938313e-05,6.663853039827628e-05,0.8
15333,15333,끼리끼리/Noun,5,1,4,3.334444814938313e-05,6.663853039827628e-05,0.8
15334,15334,-->/Punctuation,5,1,4,3.334444814938313e-05,6.663853039827628e-05,0.8
15335,15335,7일/Number,5,1,4,3.334444814938313e-05,6.663853039827628e-05,0.8
15336,15336,잡아끌다/Verb,5,4,1,6.668889629876625e-05,3.331926519913814e-05,0.8
15337,15337,자건/Noun,5,4,1,6.668889629876625e-05,3.331926519913814e-05,0.8
15338,15338,기담/Noun,5,4,1,6.668889629876625e-05,3.331926519913814e-05,0.8
15339,15339,또렷하다/Adjective,5,4,1,6.668889629876625e-05,3.331926519913814e-05,0.8
15340,15340,바꿔치다/Verb,5,1,4,3.334444814938313e-05,6.663853039827628e-05,0.8
15341,15341,엣날/Noun,5,4,1,6.668889629876625e-05,3.331926519913814e-05,0.8
15342,15342,앨리/Noun,5,4,1,6.668889629876625e-05,3.331926519913814e-05,0.8
15343,15343,",,../Punctuation",5,1,4,3.334444814938313e-05,6.663853039827628e-05,0.8
15344,15344,민국/Noun,5,1,4,3.334444814938313e-05,6.663853039827628e-05,0.8
15345,15345,eyes/Alpha,5,4,1,6.668889629876625e-05,3.331926519913814e-05,0.8
15346,15346,관심사/Noun,5,1,4,3.334444814938313e-05,6.663853039827628e-05,0.8
15347,15347,DC/Alpha,5,1,4,3.334444814938313e-05,6.663853039827628e-05,0.8
15348,15348,오뉴월/Noun,5,4,1,6.668889629876625e-05,3.331926519913814e-05,0.8
15349,15349,무능력/Noun,5,1,4,3.334444814938313e-05,6.663853039827628e-05,0.8
15350,15350,무소유/Noun,5,4,1,6.668889629876625e-05,3.331926519913814e-05,0.8
15351,15351,김혜리/Noun,5,4,1,6.668889629876625e-05,3.331926519913814e-05,0.8
15352,15352,후지산/Noun,5,1,4,3.334444814938313e-05,6.663853039827628e-05,0.8
15353,15353,대란/Noun,5,4,1,6.668889629876625e-05,3.331926519913814e-05,0.8
15354,15354,산자/Noun,5,4,1,6.668889629876625e-05,3.331926519913814e-05,0.8
15355,15355,성경책/Noun,5,1,4,3.334444814938313e-05,6.663853039827628e-05,0.8
15356,15356,e/Alpha,5,4,1,6.668889629876625e-05,3.331926519913814e-05,0.8
15357,15357,촌빨/Noun,5,1,4,3.334444814938313e-05,6.663853039827628e-05,0.8
15358,15358,And/Alpha,5,4,1,6.668889629876625e-05,3.331926519913814e-05,0.8
15359,15359,브라스/Noun,5,1,4,3.334444814938313e-05,6.663853039827628e-05,0.8
15360,15360,대에는/Foreign,5,1,4,3.334444814938313e-05,6.663853039827628e-05,0.8
15361,15361,새아빠/Noun,5,4,1,6.668889629876625e-05,3.331926519913814e-05,0.8
15362,15362,가벼워지다/Verb,5,4,1,6.668889629876625e-05,3.331926519913814e-05,0.8
15363,15363,윤수/Noun,5,4,1,6.668889629876625e-05,3.331926519913814e-05,0.8
15364,15364,마티/Noun,5,4,1,6.668889629876625e-05,3.331926519913814e-05,0.8
15365,15365,반격/Noun,5,4,1,6.668889629876625e-05,3.331926519913814e-05,0.8
15366,15366,낚일순/Noun,5,4,1,6.668889629876625e-05,3.331926519913814e-05,0.8
15367,15367,기마/Noun,5,1,4,3.334444814938313e-05,6.663853039827628e-05,0.8
15368,15368,뒤/Foreign,5,4,1,6.668889629876625e-05,3.331926519913814e-05,0.8
15369,15369,박일/Noun,5,4,1,6.668889629876625e-05,3.331926519913814e-05,0.8
15370,15370,<-/Punctuation,5,1,4,3.334444814938313e-05,6.663853039827628e-05,0.8
15371,15371,보건/Noun,5,1,4,3.334444814938313e-05,6.663853039827628e-05,0.8
15372,15372,스트레칭/Noun,5,1,4,3.334444814938313e-05,6.663853039827628e-05,0.8
15373,15373,무신/Modifier,5,1,4,3.334444814938313e-05,6.663853039827628e-05,0.8
15374,15374,전선/Noun,5,1,4,3.334444814938313e-05,6.663853039827628e-05,0.8
15375,15375,우루루/Adverb,5,1,4,3.334444814938313e-05,6.663853039827628e-05,0.8
15376,15376,아킬레스/Noun,5,4,1,6.668889629876625e-05,3.331926519913814e-05,0.8
15377,15377,벅/Noun,5,1,4,3.334444814938313e-05,6.663853039827628e-05,0.8
15378,15378,천진난만하다/Adjective,5,4,1,6.668889629876625e-05,3.331926519913814e-05,0.8
15379,15379,다스/Noun,5,1,4,3.334444814938313e-05,6.663853039827628e-05,0.8
15380,15380,컨/Noun,5,4,1,6.668889629876625e-05,3.331926519913814e-05,0.8
15381,15381,히/Noun,5,1,4,3.334444814938313e-05,6.663853039827628e-05,0.8
15382,15382,1/10/Number,5,1,4,3.334444814938313e-05,6.663853039827628e-05,0.8
15383,15383,보오/Noun,5,1,4,3.334444814938313e-05,6.663853039827628e-05,0.8
15384,15384,눈의여왕/Noun,5,1,4,3.334444814938313e-05,6.663853039827628e-05,0.8
15385,15385,추녀/Noun,5,1,4,3.334444814938313e-05,6.663853039827628e-05,0.8
15386,15386,ㅈㅐ/KoreanParticle,5,4,1,6.668889629876625e-05,3.331926519913814e-05,0.8
15387,15387,대하드라마/Noun,5,4,1,6.668889629876625e-05,3.331926519913814e-05,0.8
15388,15388,길냥이/Noun,5,4,1,6.668889629876625e-05,3.331926519913814e-05,0.8
15389,15389,파크/Noun,5,1,4,3.334444814938313e-05,6.663853039827628e-05,0.8
15390,15390,경멸/Noun,5,1,4,3.334444814938313e-05,6.663853039827628e-05,0.8
15391,15391,닦이다/Verb,5,1,4,3.334444814938313e-05,6.663853039827628e-05,0.8
15392,15392,파랑새/Noun,5,4,1,6.668889629876625e-05,3.331926519913814e-05,0.8
15393,15393,에볼라/Noun,5,4,1,6.668889629876625e-05,3.331926519913814e-05,0.8
15394,15394,!!!~/Punctuation,5,4,1,6.668889629876625e-05,3.331926519913814e-05,0.8
15395,15395,저쩌/Noun,5,1,4,3.334444814938313e-05,6.663853039827628e-05,0.8
15396,15396,!)/Punctuation,5,1,4,3.334444814938313e-05,6.663853039827628e-05,0.8
15397,15397,마파도/Noun,5,1,4,3.334444814938313e-05,6.663853039827628e-05,0.8
15398,15398,광대하다/Adjective,5,4,1,6.668889629876625e-05,3.331926519913814e-05,0.8
15399,15399,이뽀/Noun,5,4,1,6.668889629876625e-05,3.331926519913814e-05,0.8
15400,15400,상인/Noun,5,1,4,3.334444814938313e-05,6.663853039827628e-05,0.8
15401,15401,빌붙다/Verb,5,1,4,3.334444814938313e-05,6.663853039827628e-05,0.8
15402,15402,",,?/Punctuation",5,1,4,3.334444814938313e-05,6.663853039827628e-05,0.8
15403,15403,유가령/Noun,5,4,1,6.668889629876625e-05,3.331926519913814e-05,0.8
15404,15404,험난하다/Adjective,5,4,1,6.668889629876625e-05,3.331926519913814e-05,0.8
15405,15405,끌어안다/Verb,5,4,1,6.668889629876625e-05,3.331926519913814e-05,0.8
15406,15406,기력/Noun,5,4,1,6.668889629876625e-05,3.331926519913814e-05,0.8
15407,15407,인조인간/Noun,5,1,4,3.334444814938313e-05,6.663853039827628e-05,0.8
15408,15408,가일/Noun,5,1,4,3.334444814938313e-05,6.663853039827628e-05,0.8
15409,15409,오백원/Noun,5,4,1,6.668889629876625e-05,3.331926519913814e-05,0.8
15410,15410,한프로/Noun,5,1,4,3.334444814938313e-05,6.663853039827628e-05,0.8
15411,15411,종현/Noun,5,4,1,6.668889629876625e-05,3.331926519913814e-05,0.8
15412,15412,쉿/Noun,5,1,4,3.334444814938313e-05,6.663853039827628e-05,0.8
15413,15413,윤소이/Noun,5,1,4,3.334444814938313e-05,6.663853039827628e-05,0.8
15414,15414,황야/Noun,5,4,1,6.668889629876625e-05,3.331926519913814e-05,0.8
15415,15415,보살/Noun,5,1,4,3.334444814938313e-05,6.663853039827628e-05,0.8
15416,15416,닌지/Noun,5,1,4,3.334444814938313e-05,6.663853039827628e-05,0.8
15417,15417,Q/Alpha,5,4,1,6.668889629876625e-05,3.331926519913814e-05,0.8
15418,15418,2~3년/Number,5,4,1,6.668889629876625e-05,3.331926519913814e-05,0.8
15419,15419,일본도/Noun,5,1,4,3.334444814938313e-05,6.663853039827628e-05,0.8
15420,15420,발광/Noun,5,1,4,3.334444814938313e-05,6.663853039827628e-05,0.8
15421,15421,밀회/Noun,5,4,1,6.668889629876625e-05,3.331926519913814e-05,0.8
15422,15422,JYP/Alpha,5,1,4,3.334444814938313e-05,6.663853039827628e-05,0.8
15423,15423,거금/Noun,5,1,4,3.334444814938313e-05,6.663853039827628e-05,0.8
15424,15424,차이나/Noun,5,1,4,3.334444814938313e-05,6.663853039827628e-05,0.8
15425,15425,어지러움/Noun,5,1,4,3.334444814938313e-05,6.663853039827628e-05,0.8
15426,15426,칸나/Noun,5,1,4,3.334444814938313e-05,6.663853039827628e-05,0.8
15427,15427,볼법/Noun,5,1,4,3.334444814938313e-05,6.663853039827628e-05,0.8
15428,15428,추성훈/Noun,5,1,4,3.334444814938313e-05,6.663853039827628e-05,0.8
15429,15429,잘만드/Noun,5,4,1,6.668889629876625e-05,3.331926519913814e-05,0.8
15430,15430,음반/Noun,5,4,1,6.668889629876625e-05,3.331926519913814e-05,0.8
15431,15431,꼭대기/Noun,5,4,1,6.668889629876625e-05,3.331926519913814e-05,0.8
15432,15432,ㅁㅇ/KoreanParticle,5,4,1,6.668889629876625e-05,3.331926519913814e-05,0.8
15433,15433,패자부활전/Noun,5,1,4,3.334444814938313e-05,6.663853039827628e-05,0.8
15434,15434,두준/Noun,5,4,1,6.668889629876625e-05,3.331926519913814e-05,0.8
15435,15435,볼랬는데/Noun,5,1,4,3.334444814938313e-05,6.663853039827628e-05,0.8
15436,15436,아스테릭스/Noun,5,1,4,3.334444814938313e-05,6.663853039827628e-05,0.8
15437,15437,려니/Noun,5,1,4,3.334444814938313e-05,6.663853039827628e-05,0.8
15438,15438,열기/Noun,5,4,1,6.668889629876625e-05,3.331926519913814e-05,0.8
15439,15439,----/Punctuation,5,1,4,3.334444814938313e-05,6.663853039827628e-05,0.8
15440,15440,한밤중/Noun,5,4,1,6.668889629876625e-05,3.331926519913814e-05,0.8
15441,15441,Com/Alpha,5,4,1,6.668889629876625e-05,3.331926519913814e-05,0.8
15442,15442,황새/Noun,5,1,4,3.334444814938313e-05,6.663853039827628e-05,0.8
15443,15443,자손/Noun,5,1,4,3.334444814938313e-05,6.663853039827628e-05,0.8
15444,15444,난자/Noun,5,4,1,6.668889629876625e-05,3.331926519913814e-05,0.8
15445,15445,조혜련/Noun,5,1,4,3.334444814938313e-05,6.663853039827628e-05,0.8
15446,15446,방송인/Noun,5,1,4,3.334444814938313e-05,6.663853039827628e-05,0.8
15447,15447,너저분하다/Adjective,5,1,4,3.334444814938313e-05,6.663853039827628e-05,0.8
15448,15448,병력/Noun,5,1,4,3.334444814938313e-05,6.663853039827628e-05,0.8
15449,15449,ㅋㅋㅋㄱ/KoreanParticle,5,4,1,6.668889629876625e-05,3.331926519913814e-05,0.8
15450,15450,협소/Noun,5,1,4,3.334444814938313e-05,6.663853039827628e-05,0.8
15451,15451,@/Foreign,5,4,1,6.668889629876625e-05,3.331926519913814e-05,0.8
15452,15452,예쁜남자/Noun,5,4,1,6.668889629876625e-05,3.331926519913814e-05,0.8
15453,15453,혁명가/Noun,5,4,1,6.668889629876625e-05,3.331926519913814e-05,0.8
15454,15454,최강창민/Noun,5,4,1,6.668889629876625e-05,3.331926519913814e-05,0.8
15455,15455,도화선/Noun,5,1,4,3.334444814938313e-05,6.663853039827628e-05,0.8
15456,15456,이기선/Noun,5,4,1,6.668889629876625e-05,3.331926519913814e-05,0.8
15457,15457,깨끗해지다/Verb,5,4,1,6.668889629876625e-05,3.331926519913814e-05,0.8
15458,15458,멉/Noun,5,1,4,3.334444814938313e-05,6.663853039827628e-05,0.8
15459,15459,데자뷰/Noun,5,1,4,3.334444814938313e-05,6.663853039827628e-05,0.8
15460,15460,기역/Noun,5,4,1,6.668889629876625e-05,3.331926519913814e-05,0.8
15461,15461,자해/Noun,5,1,4,3.334444814938313e-05,6.663853039827628e-05,0.8
15462,15462,강사/Noun,5,1,4,3.334444814938313e-05,6.663853039827628e-05,0.8
15463,15463,빅터/Noun,5,4,1,6.668889629876625e-05,3.331926519913814e-05,0.8
15464,15464,육질/Noun,5,4,1,6.668889629876625e-05,3.331926519913814e-05,0.8
15465,15465,소총/Noun,5,1,4,3.334444814938313e-05,6.663853039827628e-05,0.8
15466,15466,발걸음/Noun,5,4,1,6.668889629876625e-05,3.331926519913814e-05,0.8
15467,15467,큭/Noun,5,1,4,3.334444814938313e-05,6.663853039827628e-05,0.8
15468,15468,까지는/Foreign,5,1,4,3.334444814938313e-05,6.663853039827628e-05,0.8
15469,15469,반납/Noun,5,1,4,3.334444814938313e-05,6.663853039827628e-05,0.8
15470,15470,레쉬/Noun,5,1,4,3.334444814938313e-05,6.663853039827628e-05,0.8
15471,15471,film/Alpha,5,4,1,6.668889629876625e-05,3.331926519913814e-05,0.8
15472,15472,부임/Noun,5,1,4,3.334444814938313e-05,6.663853039827628e-05,0.8
15473,15473,비비안/Noun,5,4,1,6.668889629876625e-05,3.331926519913814e-05,0.8
15474,15474,ㄸ/KoreanParticle,5,1,4,3.334444814938313e-05,6.663853039827628e-05,0.8
15475,15475,~~~~~~~~~~~~~/Punctuation,5,4,1,6.668889629876625e-05,3.331926519913814e-05,0.8
15476,15476,재등장/Noun,5,1,4,3.334444814938313e-05,6.663853039827628e-05,0.8
15477,15477,watch/Alpha,5,4,1,6.668889629876625e-05,3.331926519913814e-05,0.8
15478,15478,마츠다/Noun,5,4,1,6.668889629876625e-05,3.331926519913814e-05,0.8
15479,15479,먹거리/Noun,5,1,4,3.334444814938313e-05,6.663853039827628e-05,0.8
15480,15480,성희롱/Noun,5,1,4,3.334444814938313e-05,6.663853039827628e-05,0.8
15481,15481,선거/Noun,5,4,1,6.668889629876625e-05,3.331926519913814e-05,0.8
15482,15482,전봇대/Noun,5,1,4,3.334444814938313e-05,6.663853039827628e-05,0.8
15483,15483,보우/Noun,5,1,4,3.334444814938313e-05,6.663853039827628e-05,0.8
15484,15484,못난이주의보/Noun,5,4,1,6.668889629876625e-05,3.331926519913814e-05,0.8
15485,15485,쾌/Noun,5,4,1,6.668889629876625e-05,3.331926519913814e-05,0.8
15486,15486,훌룡/Noun,5,4,1,6.668889629876625e-05,3.331926519913814e-05,0.8
15487,15487,구니스/Noun,5,4,1,6.668889629876625e-05,3.331926519913814e-05,0.8
15488,15488,차례대로/Noun,5,1,4,3.334444814938313e-05,6.663853039827628e-05,0.8
15489,15489,목회자/Noun,5,4,1,6.668889629876625e-05,3.331926519913814e-05,0.8
15490,15490,내보이다/Verb,5,1,4,3.334444814938313e-05,6.663853039827628e-05,0.8
15491,15491,적반하장/Noun,5,1,4,3.334444814938313e-05,6.663853039827628e-05,0.8
15492,15492,궤변/Noun,5,1,4,3.334444814938313e-05,6.663853039827628e-05,0.8
15493,15493,파급/Noun,5,1,4,3.334444814938313e-05,6.663853039827628e-05,0.8
15494,15494,아바/Noun,5,4,1,6.668889629876625e-05,3.331926519913814e-05,0.8
15495,15495,강해진/Noun,5,1,4,3.334444814938313e-05,6.663853039827628e-05,0.8
15496,15496,제한상영가/Noun,5,1,4,3.334444814938313e-05,6.663853039827628e-05,0.8
15497,15497,에슐리/Noun,5,4,1,6.668889629876625e-05,3.331926519913814e-05,0.8
15498,15498,찌개/Noun,5,1,4,3.334444814938313e-05,6.663853039827628e-05,0.8
15499,15499,짊/Noun,5,4,1,6.668889629876625e-05,3.331926519913814e-05,0.8
15500,15500,real/Alpha,5,4,1,6.668889629876625e-05,3.331926519913814e-05,0.8
15501,15501,초초초/Noun,5,1,4,3.334444814938313e-05,6.663853039827628e-05,0.8
15502,15502,호제/Noun,5,4,1,6.668889629876625e-05,3.331926519913814e-05,0.8
15503,15503,푸욱/Noun,5,4,1,6.668889629876625e-05,3.331926519913814e-05,0.8
15504,15504,상하이/Noun,5,4,1,6.668889629876625e-05,3.331926519913814e-05,0.8
15505,15505,시크/Noun,5,4,1,6.668889629876625e-05,3.331926519913814e-05,0.8
15506,15506,슛/Noun,5,4,1,6.668889629876625e-05,3.331926519913814e-05,0.8
15507,15507,부자간/Noun,5,4,1,6.668889629876625e-05,3.331926519913814e-05,0.8
15508,15508,자기애/Noun,5,1,4,3.334444814938313e-05,6.663853039827628e-05,0.8
15509,15509,왜못/Noun,5,4,1,6.668889629876625e-05,3.331926519913814e-05,0.8
15510,15510,.....?/Punctuation,5,1,4,3.334444814938313e-05,6.663853039827628e-05,0.8
15511,15511,"',/Punctuation",5,4,1,6.668889629876625e-05,3.331926519913814e-05,0.8
15512,15512,판박이/Noun,5,1,4,3.334444814938313e-05,6.663853039827628e-05,0.8
15513,15513,ㄱㅅ/KoreanParticle,5,4,1,6.668889629876625e-05,3.331926519913814e-05,0.8
15514,15514,으잉/Noun,5,1,4,3.334444814938313e-05,6.663853039827628e-05,0.8
15515,15515,건대/Noun,5,4,1,6.668889629876625e-05,3.331926519913814e-05,0.8
15516,15516,허큘리스/Noun,5,4,1,6.668889629876625e-05,3.331926519913814e-05,0.8
15517,15517,로케/Noun,5,1,4,3.334444814938313e-05,6.663853039827628e-05,0.8
15518,15518,어여/Adverb,5,1,4,3.334444814938313e-05,6.663853039827628e-05,0.8
15519,15519,성적소수자/Noun,5,4,1,6.668889629876625e-05,3.331926519913814e-05,0.8
15520,15520,뼈대/Noun,5,1,4,3.334444814938313e-05,6.663853039827628e-05,0.8
15521,15521,양양/Noun,5,4,1,6.668889629876625e-05,3.331926519913814e-05,0.8
15522,15522,함장/Noun,5,4,1,6.668889629876625e-05,3.331926519913814e-05,0.8
15523,15523,커스틴/Noun,5,4,1,6.668889629876625e-05,3.331926519913814e-05,0.8
15524,15524,신상옥/Noun,5,1,4,3.334444814938313e-05,6.663853039827628e-05,0.8
15525,15525,참치/Noun,5,1,4,3.334444814938313e-05,6.663853039827628e-05,0.8
15526,15526,본기/Noun,5,1,4,3.334444814938313e-05,6.663853039827628e-05,0.8
15527,15527,오싱/Noun,5,4,1,6.668889629876625e-05,3.331926519913814e-05,0.8
15528,15528,김한민/Noun,5,1,4,3.334444814938313e-05,6.663853039827628e-05,0.8
15529,15529,어린왕자/Noun,5,4,1,6.668889629876625e-05,3.331926519913814e-05,0.8
15530,15530,캣/Noun,5,1,4,3.334444814938313e-05,6.663853039827628e-05,0.8
15531,15531,각국/Noun,5,4,1,6.668889629876625e-05,3.331926519913814e-05,0.8
15532,15532,절권도/Noun,5,4,1,6.668889629876625e-05,3.331926519913814e-05,0.8
15533,15533,징역/Noun,5,1,4,3.334444814938313e-05,6.663853039827628e-05,0.8
15534,15534,저서/Noun,5,1,4,3.334444814938313e-05,6.663853039827628e-05,0.8
15535,15535,드롱/Noun,5,4,1,6.668889629876625e-05,3.331926519913814e-05,0.8
15536,15536,이종인/Noun,5,1,4,3.334444814938313e-05,6.663853039827628e-05,0.8
15537,15537,발의/Noun,5,1,4,3.334444814938313e-05,6.663853039827628e-05,0.8
15538,15538,코같다/Adjective,5,1,4,3.334444814938313e-05,6.663853039827628e-05,0.8
15539,15539,상향/Noun,5,4,1,6.668889629876625e-05,3.331926519913814e-05,0.8
15540,15540,벤더스/Noun,5,4,1,6.668889629876625e-05,3.331926519913814e-05,0.8
15541,15541,외톨이/Noun,5,1,4,3.334444814938313e-05,6.663853039827628e-05,0.8
15542,15542,야생/Noun,5,4,1,6.668889629876625e-05,3.331926519913814e-05,0.8
15543,15543,사다리/Noun,5,4,1,6.668889629876625e-05,3.331926519913814e-05,0.8
15544,15544,플랜맨/Noun,5,4,1,6.668889629876625e-05,3.331926519913814e-05,0.8
15545,15545,역류/Noun,5,1,4,3.334444814938313e-05,6.663853039827628e-05,0.8
15546,15546,개병/Noun,5,1,4,3.334444814938313e-05,6.663853039827628e-05,0.8
15547,15547,에서라도/Josa,5,4,1,6.668889629876625e-05,3.331926519913814e-05,0.8
15548,15548,타이어/Noun,5,1,4,3.334444814938313e-05,6.663853039827628e-05,0.8
15549,15549,까지를/Josa,5,4,1,6.668889629876625e-05,3.331926519913814e-05,0.8
15550,15550,세자/Noun,5,4,1,6.668889629876625e-05,3.331926519913814e-05,0.8
15551,15551,와르르/Noun,5,1,4,3.334444814938313e-05,6.663853039827628e-05,0.8
15552,15552,격려/Noun,5,4,1,6.668889629876625e-05,3.331926519913814e-05,0.8
15553,15553,양파/Noun,5,1,4,3.334444814938313e-05,6.663853039827628e-05,0.8
15554,15554,오염/Noun,5,4,1,6.668889629876625e-05,3.331926519913814e-05,0.8
15555,15555,보라색/Noun,5,4,1,6.668889629876625e-05,3.331926519913814e-05,0.8
15556,15556,/../Punctuation,5,1,4,3.334444814938313e-05,6.663853039827628e-05,0.8
15557,15557,메르/Noun,5,1,4,3.334444814938313e-05,6.663853039827628e-05,0.8
15558,15558,촬영감독/Noun,5,1,4,3.334444814938313e-05,6.663853039827628e-05,0.8
15559,15559,아랍인/Noun,5,4,1,6.668889629876625e-05,3.331926519913814e-05,0.8
15560,15560,스카이라인/Noun,5,1,4,3.334444814938313e-05,6.663853039827628e-05,0.8
15561,15561,도모/Noun,5,4,1,6.668889629876625e-05,3.331926519913814e-05,0.8
15562,15562,여민정/Noun,5,1,4,3.334444814938313e-05,6.663853039827628e-05,0.8
15563,15563,잔득/Noun,5,1,4,3.334444814938313e-05,6.663853039827628e-05,0.8
15564,15564,적진/Noun,5,1,4,3.334444814938313e-05,6.663853039827628e-05,0.8
15565,15565,퇴치/Noun,5,1,4,3.334444814938313e-05,6.663853039827628e-05,0.8
15566,15566,명연/Noun,5,4,1,6.668889629876625e-05,3.331926519913814e-05,0.8
15567,15567,미용실/Noun,5,4,1,6.668889629876625e-05,3.331926519913814e-05,0.8
15568,15568,뒷목잡다/Verb,5,1,4,3.334444814938313e-05,6.663853039827628e-05,0.8
15569,15569,후작/Noun,5,4,1,6.668889629876625e-05,3.331926519913814e-05,0.8
15570,15570,스펙트럼/Noun,5,4,1,6.668889629876625e-05,3.331926519913814e-05,0.8
15571,15571,파운드/Noun,5,1,4,3.334444814938313e-05,6.663853039827628e-05,0.8
15572,15572,ㄴㄴㄴ/KoreanParticle,5,1,4,3.334444814938313e-05,6.663853039827628e-05,0.8
15573,15573,댓/Modifier,5,1,4,3.334444814938313e-05,6.663853039827628e-05,0.8
15574,15574,금성/Noun,5,4,1,6.668889629876625e-05,3.331926519913814e-05,0.8
15575,15575,레퀴엠/Noun,5,4,1,6.668889629876625e-05,3.331926519913814e-05,0.8
15576,15576,고충/Noun,5,4,1,6.668889629876625e-05,3.331926519913814e-05,0.8
15577,15577,루카/Noun,5,4,1,6.668889629876625e-05,3.331926519913814e-05,0.8
15578,15578,백년의유산/Noun,5,4,1,6.668889629876625e-05,3.331926519913814e-05,0.8
15579,15579,성비/Noun,5,1,4,3.334444814938313e-05,6.663853039827628e-05,0.8
15580,15580,포이/Noun,5,4,1,6.668889629876625e-05,3.331926519913814e-05,0.8
15581,15581,하나라/Noun,5,4,1,6.668889629876625e-05,3.331926519913814e-05,0.8
15582,15582,분배/Noun,5,1,4,3.334444814938313e-05,6.663853039827628e-05,0.8
15583,15583,뱁새/Noun,5,1,4,3.334444814938313e-05,6.663853039827628e-05,0.8
15584,15584,족치다/Verb,5,1,4,3.334444814938313e-05,6.663853039827628e-05,0.8
15585,15585,변치않다/Verb,5,4,1,6.668889629876625e-05,3.331926519913814e-05,0.8
15586,15586,건줄/Noun,5,1,4,3.334444814938313e-05,6.663853039827628e-05,0.8
15587,15587,찌찌/Noun,5,1,4,3.334444814938313e-05,6.663853039827628e-05,0.8
15588,15588,98%/Number,5,1,4,3.334444814938313e-05,6.663853039827628e-05,0.8
15589,15589,침투/Noun,5,1,4,3.334444814938313e-05,6.663853039827628e-05,0.8
15590,15590,아미/Noun,5,1,4,3.334444814938313e-05,6.663853039827628e-05,0.8
15591,15591,후카/Noun,5,1,4,3.334444814938313e-05,6.663853039827628e-05,0.8
15592,15592,무쌍/Noun,5,1,4,3.334444814938313e-05,6.663853039827628e-05,0.8
15593,15593,번봣/Noun,5,4,1,6.668889629876625e-05,3.331926519913814e-05,0.8
15594,15594,자베르/Noun,5,1,4,3.334444814938313e-05,6.663853039827628e-05,0.8
15595,15595,항문/Noun,5,1,4,3.334444814938313e-05,6.663853039827628e-05,0.8
15596,15596,반공/Noun,5,1,4,3.334444814938313e-05,6.663853039827628e-05,0.8
15597,15597,......................../Punctuation,5,1,4,3.334444814938313e-05,6.663853039827628e-05,0.8
15598,15598,붕어빵/Noun,5,1,4,3.334444814938313e-05,6.663853039827628e-05,0.8
15599,15599,비정상회담/Noun,5,4,1,6.668889629876625e-05,3.331926519913814e-05,0.8
15600,15600,무뚝뚝하다/Adjective,5,4,1,6.668889629876625e-05,3.331926519913814e-05,0.8
15601,15601,정예/Noun,5,1,4,3.334444814938313e-05,6.663853039827628e-05,0.8
15602,15602,떨기/Noun,5,1,4,3.334444814938313e-05,6.663853039827628e-05,0.8
15603,15603,놧/Noun,5,1,4,3.334444814938313e-05,6.663853039827628e-05,0.8
15604,15604,알다/Noun,5,4,1,6.668889629876625e-05,3.331926519913814e-05,0.8
15605,15605,메탈리카/Noun,5,4,1,6.668889629876625e-05,3.331926519913814e-05,0.8
15606,15606,골수팬/Noun,5,1,4,3.334444814938313e-05,6.663853039827628e-05,0.8
15607,15607,낚는/Noun,5,1,4,3.334444814938313e-05,6.663853039827628e-05,0.8
15608,15608,커밍/Noun,5,4,1,6.668889629876625e-05,3.331926519913814e-05,0.8
15609,15609,에잉/Noun,5,1,4,3.334444814938313e-05,6.663853039827628e-05,0.8
15610,15610,됫음/Noun,5,4,1,6.668889629876625e-05,3.331926519913814e-05,0.8
15611,15611,이승연/Noun,5,1,4,3.334444814938313e-05,6.663853039827628e-05,0.8
15612,15612,제각각/Noun,5,1,4,3.334444814938313e-05,6.663853039827628e-05,0.8
15613,15613,친한친구/Noun,5,4,1,6.668889629876625e-05,3.331926519913814e-05,0.8
15614,15614,단상/Noun,5,1,4,3.334444814938313e-05,6.663853039827628e-05,0.8
15615,15615,퓨/Noun,5,1,4,3.334444814938313e-05,6.663853039827628e-05,0.8
15616,15616,통합/Noun,5,1,4,3.334444814938313e-05,6.663853039827628e-05,0.8
15617,15617,푹푹/Adverb,5,1,4,3.334444814938313e-05,6.663853039827628e-05,0.8
15618,15618,쥰/Noun,5,1,4,3.334444814938313e-05,6.663853039827628e-05,0.8
15619,15619,제정/Noun,5,1,4,3.334444814938313e-05,6.663853039827628e-05,0.8
15620,15620,이대/Noun,5,1,4,3.334444814938313e-05,6.663853039827628e-05,0.8
15621,15621,민족주의/Noun,5,1,4,3.334444814938313e-05,6.663853039827628e-05,0.8
15622,15622,침울하다/Adjective,5,1,4,3.334444814938313e-05,6.663853039827628e-05,0.8
15623,15623,피날레/Noun,5,4,1,6.668889629876625e-05,3.331926519913814e-05,0.8
15624,15624,비화/Noun,5,1,4,3.334444814938313e-05,6.663853039827628e-05,0.8
15625,15625,대국민/Noun,5,1,4,3.334444814938313e-05,6.663853039827628e-05,0.8
15626,15626,이력/Noun,5,1,4,3.334444814938313e-05,6.663853039827628e-05,0.8
15627,15627,미사여구/Noun,5,1,4,3.334444814938313e-05,6.663853039827628e-05,0.8
15628,15628,카레/Noun,5,1,4,3.334444814938313e-05,6.663853039827628e-05,0.8
15629,15629,순응/Noun,5,4,1,6.668889629876625e-05,3.331926519913814e-05,0.8
15630,15630,한예린/Noun,5,1,4,3.334444814938313e-05,6.663853039827628e-05,0.8
15631,15631,녘/Noun,5,4,1,6.668889629876625e-05,3.331926519913814e-05,0.8
15632,15632,거니/Eomi,5,1,4,3.334444814938313e-05,6.663853039827628e-05,0.8
15633,15633,박지빈/Noun,5,4,1,6.668889629876625e-05,3.331926519913814e-05,0.8
15634,15634,어투/Noun,5,1,4,3.334444814938313e-05,6.663853039827628e-05,0.8
15635,15635,라다/Noun,5,1,4,3.334444814938313e-05,6.663853039827628e-05,0.8
15636,15636,달아나다/Verb,5,4,1,6.668889629876625e-05,3.331926519913814e-05,0.8
15637,15637,결승/Noun,5,1,4,3.334444814938313e-05,6.663853039827628e-05,0.8
15638,15638,한탄/Noun,5,1,4,3.334444814938313e-05,6.663853039827628e-05,0.8
15639,15639,네이션/Noun,5,4,1,6.668889629876625e-05,3.331926519913814e-05,0.8
15640,15640,후시/Noun,5,1,4,3.334444814938313e-05,6.663853039827628e-05,0.8
15641,15641,통장/Noun,5,1,4,3.334444814938313e-05,6.663853039827628e-05,0.8
15642,15642,윤한/Noun,5,1,4,3.334444814938313e-05,6.663853039827628e-05,0.8
15643,15643,모태/Noun,5,4,1,6.668889629876625e-05,3.331926519913814e-05,0.8
15644,15644,가망/Noun,5,1,4,3.334444814938313e-05,6.663853039827628e-05,0.8
15645,15645,다이아/Noun,5,1,4,3.334444814938313e-05,6.663853039827628e-05,0.8
15646,15646,24년/Number,5,4,1,6.668889629876625e-05,3.331926519913814e-05,0.8
15647,15647,뒤엎/Noun,5,4,1,6.668889629876625e-05,3.331926519913814e-05,0.8
15648,15648,아랑사또전/Noun,5,4,1,6.668889629876625e-05,3.331926519913814e-05,0.8
15649,15649,코딱지/Noun,5,1,4,3.334444814938313e-05,6.663853039827628e-05,0.8
15650,15650,파내다/Verb,5,1,4,3.334444814938313e-05,6.663853039827628e-05,0.8
15651,15651,패인/Noun,5,1,4,3.334444814938313e-05,6.663853039827628e-05,0.8
15652,15652,서럽다/Verb,5,4,1,6.668889629876625e-05,3.331926519913814e-05,0.8
15653,15653,플레이어/Noun,5,4,1,6.668889629876625e-05,3.331926519913814e-05,0.8
15654,15654,200원/Number,5,1,4,3.334444814938313e-05,6.663853039827628e-05,0.8
15655,15655,대조영/Noun,5,1,4,3.334444814938313e-05,6.663853039827628e-05,0.8
15656,15656,나주/Noun,5,1,4,3.334444814938313e-05,6.663853039827628e-05,0.8
15657,15657,명관/Noun,5,4,1,6.668889629876625e-05,3.331926519913814e-05,0.8
15658,15658,패가/Noun,5,4,1,6.668889629876625e-05,3.331926519913814e-05,0.8
15659,15659,엄슴/Noun,5,1,4,3.334444814938313e-05,6.663853039827628e-05,0.8
15660,15660,6-7/Number,5,1,4,3.334444814938313e-05,6.663853039827628e-05,0.8
15661,15661,언터처블/Noun,5,4,1,6.668889629876625e-05,3.331926519913814e-05,0.8
15662,15662,마르지/Noun,5,4,1,6.668889629876625e-05,3.331926519913814e-05,0.8
15663,15663,우위/Noun,5,1,4,3.334444814938313e-05,6.663853039827628e-05,0.8
15664,15664,축축하다/Adjective,5,4,1,6.668889629876625e-05,3.331926519913814e-05,0.8
15665,15665,전에는/Foreign,5,1,4,3.334444814938313e-05,6.663853039827628e-05,0.8
15666,15666,정혜/Noun,5,4,1,6.668889629876625e-05,3.331926519913814e-05,0.8
15667,15667,81년/Number,5,4,1,6.668889629876625e-05,3.331926519913814e-05,0.8
15668,15668,참석/Noun,5,1,4,3.334444814938313e-05,6.663853039827628e-05,0.8
15669,15669,작부/Noun,5,1,4,3.334444814938313e-05,6.663853039827628e-05,0.8
15670,15670,언론플레이/Noun,5,1,4,3.334444814938313e-05,6.663853039827628e-05,0.8
15671,15671,아우디/Noun,5,4,1,6.668889629876625e-05,3.331926519913814e-05,0.8
15672,15672,제휴/Noun,5,1,4,3.334444814938313e-05,6.663853039827628e-05,0.8
15673,15673,은비/Noun,5,4,1,6.668889629876625e-05,3.331926519913814e-05,0.8
15674,15674,천주교/Noun,5,1,4,3.334444814938313e-05,6.663853039827628e-05,0.8
15675,15675,그랴/Noun,5,1,4,3.334444814938313e-05,6.663853039827628e-05,0.8
15676,15676,워킹맘/Noun,5,4,1,6.668889629876625e-05,3.331926519913814e-05,0.8
15677,15677,영홥니/Noun,5,4,1,6.668889629876625e-05,3.331926519913814e-05,0.8
15678,15678,갈겨/Adverb,5,1,4,3.334444814938313e-05,6.663853039827628e-05,0.8
15679,15679,꺠/Noun,5,1,4,3.334444814938313e-05,6.663853039827628e-05,0.8
15680,15680,닥쳐오다/Verb,5,4,1,6.668889629876625e-05,3.331926519913814e-05,0.8
15681,15681,하악/Exclamation,5,4,1,6.668889629876625e-05,3.331926519913814e-05,0.8
15682,15682,소/Foreign,5,4,1,6.668889629876625e-05,3.331926519913814e-05,0.8
15683,15683,브레이커/Noun,5,1,4,3.334444814938313e-05,6.663853039827628e-05,0.8
15684,15684,7.4/Number,5,4,1,6.668889629876625e-05,3.331926519913814e-05,0.8
15685,15685,음양사/Noun,5,4,1,6.668889629876625e-05,3.331926519913814e-05,0.8
15686,15686,양가휘/Noun,5,4,1,6.668889629876625e-05,3.331926519913814e-05,0.8
15687,15687,이웃집/Noun,5,1,4,3.334444814938313e-05,6.663853039827628e-05,0.8
15688,15688,리카/Noun,5,4,1,6.668889629876625e-05,3.331926519913814e-05,0.8
15689,15689,탈때/Noun,5,4,1,6.668889629876625e-05,3.331926519913814e-05,0.8
15690,15690,인어/Noun,5,4,1,6.668889629876625e-05,3.331926519913814e-05,0.8
15691,15691,12일/Number,5,1,4,3.334444814938313e-05,6.663853039827628e-05,0.8
15692,15692,눈사태/Noun,5,4,1,6.668889629876625e-05,3.331926519913814e-05,0.8
15693,15693,냉혈/Noun,5,4,1,6.668889629876625e-05,3.331926519913814e-05,0.8
15694,15694,골탕/Noun,5,1,4,3.334444814938313e-05,6.663853039827628e-05,0.8
15695,15695,게일/Noun,5,4,1,6.668889629876625e-05,3.331926519913814e-05,0.8
15696,15696,어렷을적/Noun,5,4,1,6.668889629876625e-05,3.331926519913814e-05,0.8
15697,15697,15초/Number,5,1,4,3.334444814938313e-05,6.663853039827628e-05,0.8
15698,15698,무오/Noun,5,1,4,3.334444814938313e-05,6.663853039827628e-05,0.8
15699,15699,사마/Noun,5,4,1,6.668889629876625e-05,3.331926519913814e-05,0.8
15700,15700,충남/Noun,5,1,4,3.334444814938313e-05,6.663853039827628e-05,0.8
15701,15701,11월/Number,5,4,1,6.668889629876625e-05,3.331926519913814e-05,0.8
15702,15702,초록물고기/Noun,5,4,1,6.668889629876625e-05,3.331926519913814e-05,0.8
15703,15703,반동안/Foreign,5,1,4,3.334444814938313e-05,6.663853039827628e-05,0.8
15704,15704,하래/Noun,5,1,4,3.334444814938313e-05,6.663853039827628e-05,0.8
15705,15705,빙글빙글/Adverb,5,1,4,3.334444814938313e-05,6.663853039827628e-05,0.8
15706,15706,무사백동수/Noun,5,4,1,6.668889629876625e-05,3.331926519913814e-05,0.8
15707,15707,김해/Noun,5,1,4,3.334444814938313e-05,6.663853039827628e-05,0.8
15708,15708,어허/Exclamation,5,1,4,3.334444814938313e-05,6.663853039827628e-05,0.8
15709,15709,와일드카드/Noun,5,1,4,3.334444814938313e-05,6.663853039827628e-05,0.8
15710,15710,가브리엘/Noun,5,4,1,6.668889629876625e-05,3.331926519913814e-05,0.8
15711,15711,메뚜기/Noun,5,1,4,3.334444814938313e-05,6.663853039827628e-05,0.8
15712,15712,유인원/Noun,5,4,1,6.668889629876625e-05,3.331926519913814e-05,0.8
15713,15713,창백하다/Adjective,5,4,1,6.668889629876625e-05,3.331926519913814e-05,0.8
15714,15714,때/Foreign,5,4,1,6.668889629876625e-05,3.331926519913814e-05,0.8
15715,15715,영민/Noun,5,4,1,6.668889629876625e-05,3.331926519913814e-05,0.8
15716,15716,알리샤/Noun,5,4,1,6.668889629876625e-05,3.331926519913814e-05,0.8
15717,15717,설키/Noun,5,1,4,3.334444814938313e-05,6.663853039827628e-05,0.8
15718,15718,이영훈/Noun,5,4,1,6.668889629876625e-05,3.331926519913814e-05,0.8
15719,15719,주저리주저리/Adverb,5,1,4,3.334444814938313e-05,6.663853039827628e-05,0.8
15720,15720,연주가/Noun,5,4,1,6.668889629876625e-05,3.331926519913814e-05,0.8
15721,15721,장희빈/Noun,5,1,4,3.334444814938313e-05,6.663853039827628e-05,0.8
15722,15722,다크니스/Noun,5,4,1,6.668889629876625e-05,3.331926519913814e-05,0.8
15723,15723,드라이/Noun,5,4,1,6.668889629876625e-05,3.331926519913814e-05,0.8
15724,15724,-!/Punctuation,5,4,1,6.668889629876625e-05,3.331926519913814e-05,0.8
15725,15725,심신/Noun,5,1,4,3.334444814938313e-05,6.663853039827628e-05,0.8
15726,15726,얌전하다/Adjective,5,1,4,3.334444814938313e-05,6.663853039827628e-05,0.8
15727,15727,양육/Noun,5,1,4,3.334444814938313e-05,6.663853039827628e-05,0.8
15728,15728,공중부양/Noun,5,1,4,3.334444814938313e-05,6.663853039827628e-05,0.8
15729,15729,제네시스/Noun,5,1,4,3.334444814938313e-05,6.663853039827628e-05,0.8
15730,15730,넴/Noun,5,4,1,6.668889629876625e-05,3.331926519913814e-05,0.8
15731,15731,ㅎㅎㅋㅋ/KoreanParticle,5,4,1,6.668889629876625e-05,3.331926519913814e-05,0.8
15732,15732,seen/Alpha,5,4,1,6.668889629876625e-05,3.331926519913814e-05,0.8
15733,15733,ve/Alpha,5,4,1,6.668889629876625e-05,3.331926519913814e-05,0.8
15734,15734,다크라이/Noun,5,1,4,3.334444814938313e-05,6.663853039827628e-05,0.8
15735,15735,스나이더/Noun,5,4,1,6.668889629876625e-05,3.331926519913814e-05,0.8
15736,15736,미명/Noun,5,1,4,3.334444814938313e-05,6.663853039827628e-05,0.8
15737,15737,종잡/Noun,5,1,4,3.334444814938313e-05,6.663853039827628e-05,0.8
15738,15738,핏빛/Noun,5,4,1,6.668889629876625e-05,3.331926519913814e-05,0.8
15739,15739,리스크/Noun,5,1,4,3.334444814938313e-05,6.663853039827628e-05,0.8
15740,15740,오크/Noun,5,1,4,3.334444814938313e-05,6.663853039827628e-05,0.8
15741,15741,텔레비전/Noun,5,4,1,6.668889629876625e-05,3.331926519913814e-05,0.8
15742,15742,거원/Noun,5,1,4,3.334444814938313e-05,6.663853039827628e-05,0.8
15743,15743,레닌/Noun,5,1,4,3.334444814938313e-05,6.663853039827628e-05,0.8
15744,15744,이와이슌지/Noun,5,4,1,6.668889629876625e-05,3.331926519913814e-05,0.8
15745,15745,바늘/Noun,5,1,4,3.334444814938313e-05,6.663853039827628e-05,0.8
15746,15746,진우/Noun,5,1,4,3.334444814938313e-05,6.663853039827628e-05,0.8
15747,15747,섭리/Noun,5,4,1,6.668889629876625e-05,3.331926519913814e-05,0.8
15748,15748,주요/Noun,5,1,4,3.334444814938313e-05,6.663853039827628e-05,0.8
15749,15749,팔씨름/Noun,5,4,1,6.668889629876625e-05,3.331926519913814e-05,0.8
15750,15750,껍/Noun,5,1,4,3.334444814938313e-05,6.663853039827628e-05,0.8
15751,15751,라거/Noun,5,1,4,3.334444814938313e-05,6.663853039827628e-05,0.8
15752,15752,반정/Noun,5,4,1,6.668889629876625e-05,3.331926519913814e-05,0.8
15753,15753,오언조/Noun,5,4,1,6.668889629876625e-05,3.331926519913814e-05,0.8
15754,15754,Ocn/Alpha,5,1,4,3.334444814938313e-05,6.663853039827628e-05,0.8
15755,15755,코엑스/Noun,5,1,4,3.334444814938313e-05,6.663853039827628e-05,0.8
15756,15756,슈퍼노바/Noun,5,4,1,6.668889629876625e-05,3.331926519913814e-05,0.8
15757,15757,웨인/Noun,5,4,1,6.668889629876625e-05,3.331926519913814e-05,0.8
15758,15758,배렸다/Noun,5,1,4,3.334444814938313e-05,6.663853039827628e-05,0.8
15759,15759,슈발/Noun,5,4,1,6.668889629876625e-05,3.331926519913814e-05,0.8
15760,15760,특촬/Noun,5,1,4,3.334444814938313e-05,6.663853039827628e-05,0.8
15761,15761,항변/Noun,5,1,4,3.334444814938313e-05,6.663853039827628e-05,0.8
15762,15762,나르시즘/Noun,5,1,4,3.334444814938313e-05,6.663853039827628e-05,0.8
15763,15763,살색/Noun,5,1,4,3.334444814938313e-05,6.663853039827628e-05,0.8
15764,15764,푸핫/Exclamation,5,1,4,3.334444814938313e-05,6.663853039827628e-05,0.8
15765,15765,곽/Noun,5,4,1,6.668889629876625e-05,3.331926519913814e-05,0.8
15766,15766,82분/Number,5,1,4,3.334444814938313e-05,6.663853039827628e-05,0.8
15767,15767,^)/Punctuation,5,4,1,6.668889629876625e-05,3.331926519913814e-05,0.8
15768,15768,형부/Noun,5,1,4,3.334444814938313e-05,6.663853039827628e-05,0.8
15769,15769,파르/Noun,5,4,1,6.668889629876625e-05,3.331926519913814e-05,0.8
15770,15770,해커/Noun,5,1,4,3.334444814938313e-05,6.663853039827628e-05,0.8
15771,15771,성형수술/Noun,5,1,4,3.334444814938313e-05,6.663853039827628e-05,0.8
15772,15772,소프트/Noun,5,1,4,3.334444814938313e-05,6.663853039827628e-05,0.8
15773,15773,롤링/Noun,5,4,1,6.668889629876625e-05,3.331926519913814e-05,0.8
15774,15774,외딴/Noun,5,1,4,3.334444814938313e-05,6.663853039827628e-05,0.8
15775,15775,국방/Noun,5,1,4,3.334444814938313e-05,6.663853039827628e-05,0.8
15776,15776,everything/Alpha,5,4,1,6.668889629876625e-05,3.331926519913814e-05,0.8
15777,15777,캡틴아메리카/Noun,5,4,1,6.668889629876625e-05,3.331926519913814e-05,0.8
15778,15778,황산벌/Noun,5,1,4,3.334444814938313e-05,6.663853039827628e-05,0.8
15779,15779,유구무언/Noun,5,1,4,3.334444814938313e-05,6.663853039827628e-05,0.8
15780,15780,특별/Noun,5,1,4,3.334444814938313e-05,6.663853039827628e-05,0.8
15781,15781,생태계/Noun,5,4,1,6.668889629876625e-05,3.331926519913814e-05,0.8
15782,15782,약육강식/Noun,5,4,1,6.668889629876625e-05,3.331926519913814e-05,0.8
15783,15783,GP/Alpha,5,1,4,3.334444814938313e-05,6.663853039827628e-05,0.8
15784,15784,논리성/Noun,5,1,4,3.334444814938313e-05,6.663853039827628e-05,0.8
15785,15785,수만/Modifier,5,3,2,5.5574080248971876e-05,4.4425686932184186e-05,0.6
15786,15786,공산/Noun,5,3,2,5.5574080248971876e-05,4.4425686932184186e-05,0.6
15787,15787,소니/Noun,5,2,3,4.445926419917751e-05,5.553210866523024e-05,0.6
15788,15788,향해/Noun,5,3,2,5.5574080248971876e-05,4.4425686932184186e-05,0.6
15789,15789,상보/Noun,5,3,2,5.5574080248971876e-05,4.4425686932184186e-05,0.6
15790,15790,멀티/Noun,5,2,3,4.445926419917751e-05,5.553210866523024e-05,0.6
15791,15791,여유롭다/Verb,5,2,3,4.445926419917751e-05,5.553210866523024e-05,0.6
15792,15792,내막/Noun,5,2,3,4.445926419917751e-05,5.553210866523024e-05,0.6
15793,15793,윈슬렛/Noun,5,2,3,4.445926419917751e-05,5.553210866523024e-05,0.6
15794,15794,미미/Noun,5,3,2,5.5574080248971876e-05,4.4425686932184186e-05,0.6
15795,15795,펄롱/Noun,5,3,2,5.5574080248971876e-05,4.4425686932184186e-05,0.6
15796,15796,~~~!!!!/Punctuation,5,2,3,4.445926419917751e-05,5.553210866523024e-05,0.6
15797,15797,뒤태/Noun,5,2,3,4.445926419917751e-05,5.553210866523024e-05,0.6
15798,15798,전전/Noun,5,3,2,5.5574080248971876e-05,4.4425686932184186e-05,0.6
15799,15799,프라다/Noun,5,3,2,5.5574080248971876e-05,4.4425686932184186e-05,0.6
15800,15800,다말/Noun,5,2,3,4.445926419917751e-05,5.553210866523024e-05,0.6
15801,15801,뚫어지다/Verb,5,3,2,5.5574080248971876e-05,4.4425686932184186e-05,0.6
15802,15802,조총련/Noun,5,2,3,4.445926419917751e-05,5.553210866523024e-05,0.6
15803,15803,엇슴/Noun,5,2,3,4.445926419917751e-05,5.553210866523024e-05,0.6
15804,15804,일조/Noun,5,2,3,4.445926419917751e-05,5.553210866523024e-05,0.6
15805,15805,필터/Noun,5,2,3,4.445926419917751e-05,5.553210866523024e-05,0.6
15806,15806,대나무/Noun,5,2,3,4.445926419917751e-05,5.553210866523024e-05,0.6
15807,15807,영주/Noun,5,3,2,5.5574080248971876e-05,4.4425686932184186e-05,0.6
15808,15808,멧돼지/Noun,5,2,3,4.445926419917751e-05,5.553210866523024e-05,0.6
15809,15809,스르/Noun,5,2,3,4.445926419917751e-05,5.553210866523024e-05,0.6
15810,15810,매몰/Noun,5,3,2,5.5574080248971876e-05,4.4425686932184186e-05,0.6
15811,15811,디에고/Noun,5,3,2,5.5574080248971876e-05,4.4425686932184186e-05,0.6
15812,15812,로저/Noun,5,3,2,5.5574080248971876e-05,4.4425686932184186e-05,0.6
15813,15813,저금/Noun,5,2,3,4.445926419917751e-05,5.553210866523024e-05,0.6
15814,15814,그물/Noun,5,3,2,5.5574080248971876e-05,4.4425686932184186e-05,0.6
15815,15815,프로야구/Noun,5,2,3,4.445926419917751e-05,5.553210866523024e-05,0.6
15816,15816,벙커/Noun,5,2,3,4.445926419917751e-05,5.553210866523024e-05,0.6
15817,15817,사촌형/Noun,5,3,2,5.5574080248971876e-05,4.4425686932184186e-05,0.6
15818,15818,처사/Noun,5,2,3,4.445926419917751e-05,5.553210866523024e-05,0.6
15819,15819,죤/Noun,5,2,3,4.445926419917751e-05,5.553210866523024e-05,0.6
15820,15820,마눌/Noun,5,3,2,5.5574080248971876e-05,4.4425686932184186e-05,0.6
15821,15821,쓸모/Noun,5,3,2,5.5574080248971876e-05,4.4425686932184186e-05,0.6
15822,15822,명랑/Noun,5,2,3,4.445926419917751e-05,5.553210866523024e-05,0.6
15823,15823,진저/Noun,5,3,2,5.5574080248971876e-05,4.4425686932184186e-05,0.6
15824,15824,매개/Noun,5,2,3,4.445926419917751e-05,5.553210866523024e-05,0.6
15825,15825,..^^;;/Punctuation,5,2,3,4.445926419917751e-05,5.553210866523024e-05,0.6
15826,15826,뉴문/Noun,5,3,2,5.5574080248971876e-05,4.4425686932184186e-05,0.6
15827,15827,안락사/Noun,5,2,3,4.445926419917751e-05,5.553210866523024e-05,0.6
15828,15828,자객/Noun,5,2,3,4.445926419917751e-05,5.553210866523024e-05,0.6
15829,15829,재밌드/Noun,5,3,2,5.5574080248971876e-05,4.4425686932184186e-05,0.6
15830,15830,고다/Noun,5,3,2,5.5574080248971876e-05,4.4425686932184186e-05,0.6
15831,15831,여자라서/Noun,5,2,3,4.445926419917751e-05,5.553210866523024e-05,0.6
15832,15832,붙들다/Verb,5,3,2,5.5574080248971876e-05,4.4425686932184186e-05,0.6
15833,15833,ㄲㄲㄲ/KoreanParticle,5,2,3,4.445926419917751e-05,5.553210866523024e-05,0.6
15834,15834,화산고/Noun,5,3,2,5.5574080248971876e-05,4.4425686932184186e-05,0.6
15835,15835,콧대/Noun,5,2,3,4.445926419917751e-05,5.553210866523024e-05,0.6
15836,15836,욬/Noun,5,2,3,4.445926419917751e-05,5.553210866523024e-05,0.6
15837,15837,ㅡㅡㅋㅋ/KoreanParticle,5,2,3,4.445926419917751e-05,5.553210866523024e-05,0.6
15838,15838,방어/Noun,5,2,3,4.445926419917751e-05,5.553210866523024e-05,0.6
15839,15839,우회/Noun,5,3,2,5.5574080248971876e-05,4.4425686932184186e-05,0.6
15840,15840,신카이/Noun,5,3,2,5.5574080248971876e-05,4.4425686932184186e-05,0.6
15841,15841,브레이브/Noun,5,3,2,5.5574080248971876e-05,4.4425686932184186e-05,0.6
15842,15842,달마/Noun,5,3,2,5.5574080248971876e-05,4.4425686932184186e-05,0.6
15843,15843,브람스/Noun,5,2,3,4.445926419917751e-05,5.553210866523024e-05,0.6
15844,15844,음악감독/Noun,5,3,2,5.5574080248971876e-05,4.4425686932184186e-05,0.6
15845,15845,관망/Noun,5,3,2,5.5574080248971876e-05,4.4425686932184186e-05,0.6
15846,15846,꼬박/Noun,5,3,2,5.5574080248971876e-05,4.4425686932184186e-05,0.6
15847,15847,가상현실/Noun,5,3,2,5.5574080248971876e-05,4.4425686932184186e-05,0.6
15848,15848,버블/Noun,5,2,3,4.445926419917751e-05,5.553210866523024e-05,0.6
15849,15849,텐션/Noun,5,2,3,4.445926419917751e-05,5.553210866523024e-05,0.6
15850,15850,표적/Noun,5,3,2,5.5574080248971876e-05,4.4425686932184186e-05,0.6
15851,15851,자태/Noun,5,2,3,4.445926419917751e-05,5.553210866523024e-05,0.6
15852,15852,베타/Noun,5,3,2,5.5574080248971876e-05,4.4425686932184186e-05,0.6
15853,15853,리아/Noun,5,3,2,5.5574080248971876e-05,4.4425686932184186e-05,0.6
15854,15854,이솜/Noun,5,3,2,5.5574080248971876e-05,4.4425686932184186e-05,0.6
15855,15855,확연/Noun,5,2,3,4.445926419917751e-05,5.553210866523024e-05,0.6
15856,15856,의향/Noun,5,3,2,5.5574080248971876e-05,4.4425686932184186e-05,0.6
15857,15857,파스텔/Noun,5,3,2,5.5574080248971876e-05,4.4425686932184186e-05,0.6
15858,15858,재키/Noun,5,3,2,5.5574080248971876e-05,4.4425686932184186e-05,0.6
15859,15859,16회/Number,5,3,2,5.5574080248971876e-05,4.4425686932184186e-05,0.6
15860,15860,직무/Noun,5,3,2,5.5574080248971876e-05,4.4425686932184186e-05,0.6
15861,15861,쫓아가다/Verb,5,2,3,4.445926419917751e-05,5.553210866523024e-05,0.6
15862,15862,400/Number,5,3,2,5.5574080248971876e-05,4.4425686932184186e-05,0.6
15863,15863,세익스피어/Noun,5,3,2,5.5574080248971876e-05,4.4425686932184186e-05,0.6
15864,15864,스몰빌/Noun,5,2,3,4.445926419917751e-05,5.553210866523024e-05,0.6
15865,15865,라피/Noun,5,2,3,4.445926419917751e-05,5.553210866523024e-05,0.6
15866,15866,생으로/Noun,5,2,3,4.445926419917751e-05,5.553210866523024e-05,0.6
15867,15867,실신/Noun,5,2,3,4.445926419917751e-05,5.553210866523024e-05,0.6
15868,15868,족속/Noun,5,3,2,5.5574080248971876e-05,4.4425686932184186e-05,0.6
15869,15869,떡실신/Noun,5,2,3,4.445926419917751e-05,5.553210866523024e-05,0.6
15870,15870,듣보다/Verb,5,3,2,5.5574080248971876e-05,4.4425686932184186e-05,0.6
15871,15871,라미/Noun,5,3,2,5.5574080248971876e-05,4.4425686932184186e-05,0.6
15872,15872,허구성/Noun,5,2,3,4.445926419917751e-05,5.553210866523024e-05,0.6
15873,15873,성열/Noun,5,2,3,4.445926419917751e-05,5.553210866523024e-05,0.6
15874,15874,사심/Noun,5,3,2,5.5574080248971876e-05,4.4425686932184186e-05,0.6
15875,15875,고심/Noun,5,3,2,5.5574080248971876e-05,4.4425686932184186e-05,0.6
15876,15876,이웃사람/Noun,5,3,2,5.5574080248971876e-05,4.4425686932184186e-05,0.6
15877,15877,퀵/Noun,5,2,3,4.445926419917751e-05,5.553210866523024e-05,0.6
15878,15878,자행/Noun,5,2,3,4.445926419917751e-05,5.553210866523024e-05,0.6
15879,15879,닌텐도/Noun,5,3,2,5.5574080248971876e-05,4.4425686932184186e-05,0.6
15880,15880,유위/Noun,5,3,2,5.5574080248971876e-05,4.4425686932184186e-05,0.6
15881,15881,국회/Noun,5,3,2,5.5574080248971876e-05,4.4425686932184186e-05,0.6
15882,15882,마무/Noun,5,2,3,4.445926419917751e-05,5.553210866523024e-05,0.6
15883,15883,번쨰/Noun,5,2,3,4.445926419917751e-05,5.553210866523024e-05,0.6
15884,15884,애시/Noun,5,2,3,4.445926419917751e-05,5.553210866523024e-05,0.6
15885,15885,태연하다/Adjective,5,3,2,5.5574080248971876e-05,4.4425686932184186e-05,0.6
15886,15886,112/Number,5,2,3,4.445926419917751e-05,5.553210866523024e-05,0.6
15887,15887,개재/Noun,5,2,3,4.445926419917751e-05,5.553210866523024e-05,0.6
15888,15888,총사/Noun,5,2,3,4.445926419917751e-05,5.553210866523024e-05,0.6
15889,15889,성미/Noun,5,3,2,5.5574080248971876e-05,4.4425686932184186e-05,0.6
15890,15890,비버/Noun,5,2,3,4.445926419917751e-05,5.553210866523024e-05,0.6
15891,15891,JSA/Alpha,5,2,3,4.445926419917751e-05,5.553210866523024e-05,0.6
15892,15892,아즈미/Noun,5,2,3,4.445926419917751e-05,5.553210866523024e-05,0.6
15893,15893,포의/Noun,5,3,2,5.5574080248971876e-05,4.4425686932184186e-05,0.6
15894,15894,크아/Noun,5,3,2,5.5574080248971876e-05,4.4425686932184186e-05,0.6
15895,15895,몽둥이/Noun,5,3,2,5.5574080248971876e-05,4.4425686932184186e-05,0.6
15896,15896,올가미/Noun,5,3,2,5.5574080248971876e-05,4.4425686932184186e-05,0.6
15897,15897,대거/Noun,5,2,3,4.445926419917751e-05,5.553210866523024e-05,0.6
15898,15898,입도/Noun,5,2,3,4.445926419917751e-05,5.553210866523024e-05,0.6
15899,15899,침해/Noun,5,2,3,4.445926419917751e-05,5.553210866523024e-05,0.6
15900,15900,교전/Noun,5,3,2,5.5574080248971876e-05,4.4425686932184186e-05,0.6
15901,15901,애송이/Noun,5,2,3,4.445926419917751e-05,5.553210866523024e-05,0.6
15902,15902,빌리버/Noun,5,3,2,5.5574080248971876e-05,4.4425686932184186e-05,0.6
15903,15903,디스토피아/Noun,5,3,2,5.5574080248971876e-05,4.4425686932184186e-05,0.6
15904,15904,말고도/Josa,5,3,2,5.5574080248971876e-05,4.4425686932184186e-05,0.6
15905,15905,흉하다/Adjective,5,2,3,4.445926419917751e-05,5.553210866523024e-05,0.6
15906,15906,12회/Number,5,3,2,5.5574080248971876e-05,4.4425686932184186e-05,0.6
15907,15907,껄끄럽/Noun,5,2,3,4.445926419917751e-05,5.553210866523024e-05,0.6
15908,15908,음음/Noun,5,3,2,5.5574080248971876e-05,4.4425686932184186e-05,0.6
15909,15909,아서/Eomi,5,3,2,5.5574080248971876e-05,4.4425686932184186e-05,0.6
15910,15910,브릿/Noun,5,3,2,5.5574080248971876e-05,4.4425686932184186e-05,0.6
15911,15911,아웃사이더/Noun,5,3,2,5.5574080248971876e-05,4.4425686932184186e-05,0.6
15912,15912,",.,,/Punctuation",5,3,2,5.5574080248971876e-05,4.4425686932184186e-05,0.6
15913,15913,막막/Noun,5,2,3,4.445926419917751e-05,5.553210866523024e-05,0.6
15914,15914,풀어지다/Verb,5,3,2,5.5574080248971876e-05,4.4425686932184186e-05,0.6
15915,15915,탈영/Noun,5,3,2,5.5574080248971876e-05,4.4425686932184186e-05,0.6
15916,15916,발발/Noun,5,2,3,4.445926419917751e-05,5.553210866523024e-05,0.6
15917,15917,스페인어/Noun,5,3,2,5.5574080248971876e-05,4.4425686932184186e-05,0.6
15918,15918,300만/Number,5,2,3,4.445926419917751e-05,5.553210866523024e-05,0.6
15919,15919,브로큰/Noun,5,3,2,5.5574080248971876e-05,4.4425686932184186e-05,0.6
15920,15920,기아/Noun,5,2,3,4.445926419917751e-05,5.553210866523024e-05,0.6
15921,15921,소파/Noun,5,3,2,5.5574080248971876e-05,4.4425686932184186e-05,0.6
15922,15922,볼케이노/Noun,5,2,3,4.445926419917751e-05,5.553210866523024e-05,0.6
15923,15923,나다니다/Verb,5,3,2,5.5574080248971876e-05,4.4425686932184186e-05,0.6
15924,15924,패티/Noun,5,2,3,4.445926419917751e-05,5.553210866523024e-05,0.6
15925,15925,패왕별희/Noun,5,2,3,4.445926419917751e-05,5.553210866523024e-05,0.6
15926,15926,장의사/Noun,5,3,2,5.5574080248971876e-05,4.4425686932184186e-05,0.6
15927,15927,홍대/Noun,5,2,3,4.445926419917751e-05,5.553210866523024e-05,0.6
15928,15928,수상하다/Adjective,5,2,3,4.445926419917751e-05,5.553210866523024e-05,0.6
15929,15929,중화권/Noun,5,3,2,5.5574080248971876e-05,4.4425686932184186e-05,0.6
15930,15930,성립/Noun,5,2,3,4.445926419917751e-05,5.553210866523024e-05,0.6
15931,15931,더로드/Noun,5,3,2,5.5574080248971876e-05,4.4425686932184186e-05,0.6
15932,15932,살포시/Noun,5,3,2,5.5574080248971876e-05,4.4425686932184186e-05,0.6
15933,15933,동태/Noun,5,2,3,4.445926419917751e-05,5.553210866523024e-05,0.6
15934,15934,명랑하다/Adjective,5,3,2,5.5574080248971876e-05,4.4425686932184186e-05,0.6
15935,15935,에게까지/Josa,5,2,3,4.445926419917751e-05,5.553210866523024e-05,0.6
15936,15936,시속/Noun,5,2,3,4.445926419917751e-05,5.553210866523024e-05,0.6
15937,15937,윤주/Noun,5,2,3,4.445926419917751e-05,5.553210866523024e-05,0.6
15938,15938,리메이크판/Noun,5,3,2,5.5574080248971876e-05,4.4425686932184186e-05,0.6
15939,15939,진혜림/Noun,5,3,2,5.5574080248971876e-05,4.4425686932184186e-05,0.6
15940,15940,가운/Noun,5,2,3,4.445926419917751e-05,5.553210866523024e-05,0.6
15941,15941,퍼트/Noun,5,2,3,4.445926419917751e-05,5.553210866523024e-05,0.6
15942,15942,키득거리다/Verb,5,3,2,5.5574080248971876e-05,4.4425686932184186e-05,0.6
15943,15943,공모자/Noun,5,2,3,4.445926419917751e-05,5.553210866523024e-05,0.6
15944,15944,오지명/Noun,5,3,2,5.5574080248971876e-05,4.4425686932184186e-05,0.6
15945,15945,29일/Number,5,2,3,4.445926419917751e-05,5.553210866523024e-05,0.6
15946,15946,소탕/Noun,5,3,2,5.5574080248971876e-05,4.4425686932184186e-05,0.6
15947,15947,윤회/Noun,5,3,2,5.5574080248971876e-05,4.4425686932184186e-05,0.6
15948,15948,AM/Alpha,5,3,2,5.5574080248971876e-05,4.4425686932184186e-05,0.6
15949,15949,어떠케/Noun,5,2,3,4.445926419917751e-05,5.553210866523024e-05,0.6
15950,15950,순화/Noun,5,3,2,5.5574080248971876e-05,4.4425686932184186e-05,0.6
15951,15951,징계/Noun,5,2,3,4.445926419917751e-05,5.553210866523024e-05,0.6
15952,15952,((/Punctuation,5,3,2,5.5574080248971876e-05,4.4425686932184186e-05,0.6
15953,15953,항복/Noun,5,3,2,5.5574080248971876e-05,4.4425686932184186e-05,0.6
15954,15954,바이크/Noun,5,2,3,4.445926419917751e-05,5.553210866523024e-05,0.6
15955,15955,명계남/Noun,5,2,3,4.445926419917751e-05,5.553210866523024e-05,0.6
15956,15956,필살기/Noun,5,3,2,5.5574080248971876e-05,4.4425686932184186e-05,0.6
15957,15957,나혼자산다/Noun,5,3,2,5.5574080248971876e-05,4.4425686932184186e-05,0.6
15958,15958,내쉬다/Verb,5,3,2,5.5574080248971876e-05,4.4425686932184186e-05,0.6
15959,15959,워렌/Noun,5,2,3,4.445926419917751e-05,5.553210866523024e-05,0.6
15960,15960,볶다/Verb,5,2,3,4.445926419917751e-05,5.553210866523024e-05,0.6
15961,15961,이종격투기/Noun,5,2,3,4.445926419917751e-05,5.553210866523024e-05,0.6
15962,15962,친엄마/Noun,5,2,3,4.445926419917751e-05,5.553210866523024e-05,0.6
15963,15963,부터라도/Josa,5,3,2,5.5574080248971876e-05,4.4425686932184186e-05,0.6
15964,15964,김풍/Noun,5,2,3,4.445926419917751e-05,5.553210866523024e-05,0.6
15965,15965,기시감/Noun,5,2,3,4.445926419917751e-05,5.553210866523024e-05,0.6
15966,15966,나본/Noun,5,3,2,5.5574080248971876e-05,4.4425686932184186e-05,0.6
15967,15967,일맥상통/Noun,5,3,2,5.5574080248971876e-05,4.4425686932184186e-05,0.6
15968,15968,06년/Number,5,3,2,5.5574080248971876e-05,4.4425686932184186e-05,0.6
15969,15969,괸/Noun,5,3,2,5.5574080248971876e-05,4.4425686932184186e-05,0.6
15970,15970,홍련/Noun,5,3,2,5.5574080248971876e-05,4.4425686932184186e-05,0.6
15971,15971,사후/Noun,5,2,3,4.445926419917751e-05,5.553210866523024e-05,0.6
15972,15972,어쩃/Noun,5,2,3,4.445926419917751e-05,5.553210866523024e-05,0.6
15973,15973,글쓰기/Noun,5,2,3,4.445926419917751e-05,5.553210866523024e-05,0.6
15974,15974,몸짱/Noun,5,3,2,5.5574080248971876e-05,4.4425686932184186e-05,0.6
15975,15975,은기/Noun,5,3,2,5.5574080248971876e-05,4.4425686932184186e-05,0.6
15976,15976,곡괭이/Noun,5,2,3,4.445926419917751e-05,5.553210866523024e-05,0.6
15977,15977,트랜스포터/Noun,5,3,2,5.5574080248971876e-05,4.4425686932184186e-05,0.6
15978,15978,반신반의/Noun,5,3,2,5.5574080248971876e-05,4.4425686932184186e-05,0.6
15979,15979,기레기/Noun,5,2,3,4.445926419917751e-05,5.553210866523024e-05,0.6
15980,15980,people/Alpha,5,3,2,5.5574080248971876e-05,4.4425686932184186e-05,0.6
15981,15981,곽도원/Noun,5,2,3,4.445926419917751e-05,5.553210866523024e-05,0.6
15982,15982,팩토리/Noun,5,2,3,4.445926419917751e-05,5.553210866523024e-05,0.6
15983,15983,바질/Noun,5,2,3,4.445926419917751e-05,5.553210866523024e-05,0.6
15984,15984,앞날/Noun,5,3,2,5.5574080248971876e-05,4.4425686932184186e-05,0.6
15985,15985,차이나타운/Noun,5,2,3,4.445926419917751e-05,5.553210866523024e-05,0.6
15986,15986,as/Alpha,5,3,2,5.5574080248971876e-05,4.4425686932184186e-05,0.6
15987,15987,람다/Noun,5,2,3,4.445926419917751e-05,5.553210866523024e-05,0.6
15988,15988,합체/Noun,5,2,3,4.445926419917751e-05,5.553210866523024e-05,0.6
15989,15989,귀로/Noun,5,3,2,5.5574080248971876e-05,4.4425686932184186e-05,0.6
15990,15990,베로니카/Noun,5,3,2,5.5574080248971876e-05,4.4425686932184186e-05,0.6
15991,15991,간질간질/Adverb,5,3,2,5.5574080248971876e-05,4.4425686932184186e-05,0.6
15992,15992,서현/Noun,5,2,3,4.445926419917751e-05,5.553210866523024e-05,0.6
15993,15993,샤워씬/Noun,5,2,3,4.445926419917751e-05,5.553210866523024e-05,0.6
15994,15994,지우개/Noun,5,3,2,5.5574080248971876e-05,4.4425686932184186e-05,0.6
15995,15995,뚜/Noun,5,3,2,5.5574080248971876e-05,4.4425686932184186e-05,0.6
15996,15996,걸어오다/Verb,5,3,2,5.5574080248971876e-05,4.4425686932184186e-05,0.6
15997,15997,해리스/Noun,5,3,2,5.5574080248971876e-05,4.4425686932184186e-05,0.6
15998,15998,쿼터/Noun,5,2,3,4.445926419917751e-05,5.553210866523024e-05,0.6
15999,15999,사내/Noun,5,2,3,4.445926419917751e-05,5.553210866523024e-05,0.6
16000,16000,속임수/Noun,5,2,3,4.445926419917751e-05,5.553210866523024e-05,0.6
16001,16001,애플/Noun,5,3,2,5.5574080248971876e-05,4.4425686932184186e-05,0.6
16002,16002,율동/Noun,5,2,3,4.445926419917751e-05,5.553210866523024e-05,0.6
16003,16003,로군요/Josa,5,3,2,5.5574080248971876e-05,4.4425686932184186e-05,0.6
16004,16004,다이버전트/Noun,5,2,3,4.445926419917751e-05,5.553210866523024e-05,0.6
16005,16005,리신/Noun,5,2,3,4.445926419917751e-05,5.553210866523024e-05,0.6
16006,16006,하류인생/Noun,5,2,3,4.445926419917751e-05,5.553210866523024e-05,0.6
16007,16007,병적/Noun,5,2,3,4.445926419917751e-05,5.553210866523024e-05,0.6
16008,16008,석유/Noun,5,3,2,5.5574080248971876e-05,4.4425686932184186e-05,0.6
16009,16009,벤츠/Noun,5,2,3,4.445926419917751e-05,5.553210866523024e-05,0.6
16010,16010,ㄷㅏ/KoreanParticle,5,2,3,4.445926419917751e-05,5.553210866523024e-05,0.6
16011,16011,분동/Noun,5,2,3,4.445926419917751e-05,5.553210866523024e-05,0.6
16012,16012,밀크/Noun,5,3,2,5.5574080248971876e-05,4.4425686932184186e-05,0.6
16013,16013,김밥/Noun,5,2,3,4.445926419917751e-05,5.553210866523024e-05,0.6
16014,16014,또보/Noun,5,3,2,5.5574080248971876e-05,4.4425686932184186e-05,0.6
16015,16015,휘트니/Noun,5,3,2,5.5574080248971876e-05,4.4425686932184186e-05,0.6
16016,16016,살찐/Noun,5,2,3,4.445926419917751e-05,5.553210866523024e-05,0.6
16017,16017,진희경/Noun,5,2,3,4.445926419917751e-05,5.553210866523024e-05,0.6
16018,16018,저지/Noun,5,3,2,5.5574080248971876e-05,4.4425686932184186e-05,0.6
16019,16019,베컴/Noun,5,2,3,4.445926419917751e-05,5.553210866523024e-05,0.6
16020,16020,터리/Noun,5,2,3,4.445926419917751e-05,5.553210866523024e-05,0.6
16021,16021,셀러/Noun,5,2,3,4.445926419917751e-05,5.553210866523024e-05,0.6
16022,16022,대출/Noun,5,2,3,4.445926419917751e-05,5.553210866523024e-05,0.6
16023,16023,렉스/Noun,5,2,3,4.445926419917751e-05,5.553210866523024e-05,0.6
16024,16024,중고/Noun,5,3,2,5.5574080248971876e-05,4.4425686932184186e-05,0.6
16025,16025,호범/Noun,5,2,3,4.445926419917751e-05,5.553210866523024e-05,0.6
16026,16026,송두리째/Noun,5,3,2,5.5574080248971876e-05,4.4425686932184186e-05,0.6
16027,16027,스마일리/Noun,5,3,2,5.5574080248971876e-05,4.4425686932184186e-05,0.6
16028,16028,OMG/Alpha,5,2,3,4.445926419917751e-05,5.553210866523024e-05,0.6
16029,16029,햇으/Noun,5,2,3,4.445926419917751e-05,5.553210866523024e-05,0.6
16030,16030,만큼이라도/Josa,5,3,2,5.5574080248971876e-05,4.4425686932184186e-05,0.6
16031,16031,혈투/Noun,5,2,3,4.445926419917751e-05,5.553210866523024e-05,0.6
16032,16032,곤란/Noun,5,2,3,4.445926419917751e-05,5.553210866523024e-05,0.6
16033,16033,호야/Noun,5,3,2,5.5574080248971876e-05,4.4425686932184186e-05,0.6
16034,16034,로튼토마토/Noun,5,3,2,5.5574080248971876e-05,4.4425686932184186e-05,0.6
16035,16035,관료/Noun,5,3,2,5.5574080248971876e-05,4.4425686932184186e-05,0.6
16036,16036,스위스/Noun,5,3,2,5.5574080248971876e-05,4.4425686932184186e-05,0.6
16037,16037,업계/Noun,5,2,3,4.445926419917751e-05,5.553210866523024e-05,0.6
16038,16038,요일/Noun,5,2,3,4.445926419917751e-05,5.553210866523024e-05,0.6
16039,16039,기미/Noun,5,3,2,5.5574080248971876e-05,4.4425686932184186e-05,0.6
16040,16040,새엄마/Noun,5,3,2,5.5574080248971876e-05,4.4425686932184186e-05,0.6
16041,16041,깃발/Noun,5,3,2,5.5574080248971876e-05,4.4425686932184186e-05,0.6
16042,16042,기숙사/Noun,5,3,2,5.5574080248971876e-05,4.4425686932184186e-05,0.6
16043,16043,닥치/Noun,5,3,2,5.5574080248971876e-05,4.4425686932184186e-05,0.6
16044,16044,루머/Noun,5,3,2,5.5574080248971876e-05,4.4425686932184186e-05,0.6
16045,16045,골격/Noun,5,2,3,4.445926419917751e-05,5.553210866523024e-05,0.6
16046,16046,주의보/Noun,5,3,2,5.5574080248971876e-05,4.4425686932184186e-05,0.6
16047,16047,거제도/Noun,5,2,3,4.445926419917751e-05,5.553210866523024e-05,0.6
16048,16048,1977년/Number,5,3,2,5.5574080248971876e-05,4.4425686932184186e-05,0.6
16049,16049,유실/Noun,5,2,3,4.445926419917751e-05,5.553210866523024e-05,0.6
16050,16050,어빠/Noun,5,3,2,5.5574080248971876e-05,4.4425686932184186e-05,0.6
16051,16051,지안/Noun,5,3,2,5.5574080248971876e-05,4.4425686932184186e-05,0.6
16052,16052,갑부/Noun,5,2,3,4.445926419917751e-05,5.553210866523024e-05,0.6
16053,16053,쉐/Noun,5,3,2,5.5574080248971876e-05,4.4425686932184186e-05,0.6
16054,16054,유란/Noun,5,2,3,4.445926419917751e-05,5.553210866523024e-05,0.6
16055,16055,우도/Noun,5,3,2,5.5574080248971876e-05,4.4425686932184186e-05,0.6
16056,16056,트론/Noun,5,2,3,4.445926419917751e-05,5.553210866523024e-05,0.6
16057,16057,질퍽/Noun,5,3,2,5.5574080248971876e-05,4.4425686932184186e-05,0.6
16058,16058,2011/Number,5,2,3,4.445926419917751e-05,5.553210866523024e-05,0.6
16059,16059,함몰/Noun,5,2,3,4.445926419917751e-05,5.553210866523024e-05,0.6
16060,16060,플래시/Noun,5,3,2,5.5574080248971876e-05,4.4425686932184186e-05,0.6
16061,16061,8.88/Number,5,3,2,5.5574080248971876e-05,4.4425686932184186e-05,0.6
16062,16062,윤설희/Noun,5,3,2,5.5574080248971876e-05,4.4425686932184186e-05,0.6
16063,16063,비수/Noun,5,2,3,4.445926419917751e-05,5.553210866523024e-05,0.6
16064,16064,사형제/Noun,5,3,2,5.5574080248971876e-05,4.4425686932184186e-05,0.6
16065,16065,태조/Noun,5,3,2,5.5574080248971876e-05,4.4425686932184186e-05,0.6
16066,16066,투명하다/Adjective,5,3,2,5.5574080248971876e-05,4.4425686932184186e-05,0.6
16067,16067,캐치온/Noun,5,2,3,4.445926419917751e-05,5.553210866523024e-05,0.6
16068,16068,청소부/Noun,5,2,3,4.445926419917751e-05,5.553210866523024e-05,0.6
16069,16069,성병/Noun,5,2,3,4.445926419917751e-05,5.553210866523024e-05,0.6
16070,16070,주안/Noun,5,3,2,5.5574080248971876e-05,4.4425686932184186e-05,0.6
16071,16071,순영/Noun,5,3,2,5.5574080248971876e-05,4.4425686932184186e-05,0.6
16072,16072,바라냐/Noun,5,3,2,5.5574080248971876e-05,4.4425686932184186e-05,0.6
16073,16073,그리기/Noun,5,3,2,5.5574080248971876e-05,4.4425686932184186e-05,0.6
16074,16074,공해/Noun,5,2,3,4.445926419917751e-05,5.553210866523024e-05,0.6
16075,16075,2.3/Number,5,2,3,4.445926419917751e-05,5.553210866523024e-05,0.6
16076,16076,심정은/Noun,5,2,3,4.445926419917751e-05,5.553210866523024e-05,0.6
16077,16077,프로보/Noun,5,2,3,4.445926419917751e-05,5.553210866523024e-05,0.6
16078,16078,철인/Noun,5,2,3,4.445926419917751e-05,5.553210866523024e-05,0.6
16079,16079,연가/Noun,5,3,2,5.5574080248971876e-05,4.4425686932184186e-05,0.6
16080,16080,요절/Noun,5,3,2,5.5574080248971876e-05,4.4425686932184186e-05,0.6
16081,16081,간질/Noun,5,2,3,4.445926419917751e-05,5.553210866523024e-05,0.6
16082,16082,bbc/Alpha,5,2,3,4.445926419917751e-05,5.553210866523024e-05,0.6
16083,16083,회차/Noun,5,3,2,5.5574080248971876e-05,4.4425686932184186e-05,0.6
16084,16084,머무르다/Verb,5,3,2,5.5574080248971876e-05,4.4425686932184186e-05,0.6
16085,16085,자존감/Noun,5,3,2,5.5574080248971876e-05,4.4425686932184186e-05,0.6
16086,16086,짬/Noun,5,3,2,5.5574080248971876e-05,4.4425686932184186e-05,0.6
16087,16087,저승사자/Noun,5,3,2,5.5574080248971876e-05,4.4425686932184186e-05,0.6
16088,16088,최정원/Noun,5,3,2,5.5574080248971876e-05,4.4425686932184186e-05,0.6
16089,16089,신건/Noun,5,2,3,4.445926419917751e-05,5.553210866523024e-05,0.6
16090,16090,피에타/Noun,5,3,2,5.5574080248971876e-05,4.4425686932184186e-05,0.6
16091,16091,빠따/Noun,5,2,3,4.445926419917751e-05,5.553210866523024e-05,0.6
16092,16092,다고/Eomi,5,2,3,4.445926419917751e-05,5.553210866523024e-05,0.6
16093,16093,작곡가/Noun,5,2,3,4.445926419917751e-05,5.553210866523024e-05,0.6
16094,16094,체력/Noun,5,2,3,4.445926419917751e-05,5.553210866523024e-05,0.6
16095,16095,괜춘함/Noun,5,3,2,5.5574080248971876e-05,4.4425686932184186e-05,0.6
16096,16096,유형/Noun,5,2,3,4.445926419917751e-05,5.553210866523024e-05,0.6
16097,16097,후세인/Noun,5,3,2,5.5574080248971876e-05,4.4425686932184186e-05,0.6
16098,16098,흉터/Noun,5,3,2,5.5574080248971876e-05,4.4425686932184186e-05,0.6
16099,16099,셨/Noun,5,2,3,4.445926419917751e-05,5.553210866523024e-05,0.6
16100,16100,스포츠카/Noun,5,2,3,4.445926419917751e-05,5.553210866523024e-05,0.6
16101,16101,보이즈/Noun,5,3,2,5.5574080248971876e-05,4.4425686932184186e-05,0.6
16102,16102,유니버셜/Noun,5,2,3,4.445926419917751e-05,5.553210866523024e-05,0.6
16103,16103,류담/Noun,5,3,2,5.5574080248971876e-05,4.4425686932184186e-05,0.6
16104,16104,악의축/Noun,5,3,2,5.5574080248971876e-05,4.4425686932184186e-05,0.6
16105,16105,커밍아웃/Noun,5,2,3,4.445926419917751e-05,5.553210866523024e-05,0.6
16106,16106,매듭/Noun,5,2,3,4.445926419917751e-05,5.553210866523024e-05,0.6
16107,16107,2억/Number,5,2,3,4.445926419917751e-05,5.553210866523024e-05,0.6
16108,16108,언터쳐블/Noun,5,3,2,5.5574080248971876e-05,4.4425686932184186e-05,0.6
16109,16109,라인업/Noun,5,2,3,4.445926419917751e-05,5.553210866523024e-05,0.6
16110,16110,능글맞다/Adjective,5,2,3,4.445926419917751e-05,5.553210866523024e-05,0.6
16111,16111,평등/Noun,5,3,2,5.5574080248971876e-05,4.4425686932184186e-05,0.6
16112,16112,알량하다/Adjective,5,2,3,4.445926419917751e-05,5.553210866523024e-05,0.6
16113,16113,원랜/Noun,5,3,2,5.5574080248971876e-05,4.4425686932184186e-05,0.6
16114,16114,헤이글/Noun,5,2,3,4.445926419917751e-05,5.553210866523024e-05,0.6
16115,16115,~)/Punctuation,5,3,2,5.5574080248971876e-05,4.4425686932184186e-05,0.6
16116,16116,쭈/Noun,5,3,2,5.5574080248971876e-05,4.4425686932184186e-05,0.6
16117,16117,집주인/Noun,5,3,2,5.5574080248971876e-05,4.4425686932184186e-05,0.6
16118,16118,....!!!/Punctuation,5,3,2,5.5574080248971876e-05,4.4425686932184186e-05,0.6
16119,16119,떡하니/Adverb,5,2,3,4.445926419917751e-05,5.553210866523024e-05,0.6
16120,16120,주니/Noun,5,3,2,5.5574080248971876e-05,4.4425686932184186e-05,0.6
16121,16121,너구리/Noun,5,3,2,5.5574080248971876e-05,4.4425686932184186e-05,0.6
16122,16122,마운틴/Noun,5,3,2,5.5574080248971876e-05,4.4425686932184186e-05,0.6
16123,16123,온도/Noun,5,2,3,4.445926419917751e-05,5.553210866523024e-05,0.6
16124,16124,강압/Noun,5,3,2,5.5574080248971876e-05,4.4425686932184186e-05,0.6
16125,16125,피칠갑/Noun,5,3,2,5.5574080248971876e-05,4.4425686932184186e-05,0.6
16126,16126,환생하다/Adjective,5,3,2,5.5574080248971876e-05,4.4425686932184186e-05,0.6
16127,16127,환생/Noun,5,3,2,5.5574080248971876e-05,4.4425686932184186e-05,0.6
16128,16128,자음/Noun,5,2,3,4.445926419917751e-05,5.553210866523024e-05,0.6
16129,16129,소행/Noun,5,2,3,4.445926419917751e-05,5.553210866523024e-05,0.6
16130,16130,정아/Noun,5,2,3,4.445926419917751e-05,5.553210866523024e-05,0.6
16131,16131,네덜란드/Noun,5,2,3,4.445926419917751e-05,5.553210866523024e-05,0.6
16132,16132,놀림/Noun,5,3,2,5.5574080248971876e-05,4.4425686932184186e-05,0.6
16133,16133,자루/Noun,5,2,3,4.445926419917751e-05,5.553210866523024e-05,0.6
16134,16134,밑바탕/Noun,5,2,3,4.445926419917751e-05,5.553210866523024e-05,0.6
16135,16135,복종/Noun,5,3,2,5.5574080248971876e-05,4.4425686932184186e-05,0.6
16136,16136,후잡/Noun,5,3,2,5.5574080248971876e-05,4.4425686932184186e-05,0.6
16137,16137,친절/Noun,5,2,3,4.445926419917751e-05,5.553210866523024e-05,0.6
16138,16138,천/Suffix,5,2,3,4.445926419917751e-05,5.553210866523024e-05,0.6
16139,16139,낮술/Noun,5,2,3,4.445926419917751e-05,5.553210866523024e-05,0.6
16140,16140,백도빈/Noun,5,2,3,4.445926419917751e-05,5.553210866523024e-05,0.6
16141,16141,고아원/Noun,5,3,2,5.5574080248971876e-05,4.4425686932184186e-05,0.6
16142,16142,파파/Noun,5,2,3,4.445926419917751e-05,5.553210866523024e-05,0.6
16143,16143,언능/Adverb,5,2,3,4.445926419917751e-05,5.553210866523024e-05,0.6
16144,16144,조리/Noun,5,3,2,5.5574080248971876e-05,4.4425686932184186e-05,0.6
16145,16145,코마/Noun,5,3,2,5.5574080248971876e-05,4.4425686932184186e-05,0.6
16146,16146,건전/Noun,5,3,2,5.5574080248971876e-05,4.4425686932184186e-05,0.6
16147,16147,산맥/Noun,5,2,3,4.445926419917751e-05,5.553210866523024e-05,0.6
16148,16148,케르디오/Noun,5,2,3,4.445926419917751e-05,5.553210866523024e-05,0.6
16149,16149,이희준/Noun,5,3,2,5.5574080248971876e-05,4.4425686932184186e-05,0.6
16150,16150,장갑/Noun,5,2,3,4.445926419917751e-05,5.553210866523024e-05,0.6
16151,16151,햄/Noun,5,3,2,5.5574080248971876e-05,4.4425686932184186e-05,0.6
16152,16152,작아지다/Verb,5,2,3,4.445926419917751e-05,5.553210866523024e-05,0.6
16153,16153,심청전/Noun,5,2,3,4.445926419917751e-05,5.553210866523024e-05,0.6
16154,16154,막장인생/Noun,5,2,3,4.445926419917751e-05,5.553210866523024e-05,0.6
16155,16155,가위바위보/Noun,5,2,3,4.445926419917751e-05,5.553210866523024e-05,0.6
16156,16156,"!,/Punctuation",5,3,2,5.5574080248971876e-05,4.4425686932184186e-05,0.6
16157,16157,주머니/Noun,5,2,3,4.445926419917751e-05,5.553210866523024e-05,0.6
16158,16158,어캐/Noun,5,2,3,4.445926419917751e-05,5.553210866523024e-05,0.6
16159,16159,~.../Punctuation,5,2,3,4.445926419917751e-05,5.553210866523024e-05,0.6
16160,16160,봉지/Noun,5,3,2,5.5574080248971876e-05,4.4425686932184186e-05,0.6
16161,16161,막부/Noun,5,3,2,5.5574080248971876e-05,4.4425686932184186e-05,0.6
16162,16162,불효자/Noun,5,2,3,4.445926419917751e-05,5.553210866523024e-05,0.6
16163,16163,양복/Noun,5,2,3,4.445926419917751e-05,5.553210866523024e-05,0.6
16164,16164,그랫/Noun,5,3,2,5.5574080248971876e-05,4.4425686932184186e-05,0.6
16165,16165,농간/Noun,5,2,3,4.445926419917751e-05,5.553210866523024e-05,0.6
16166,16166,다봣는데/Noun,5,3,2,5.5574080248971876e-05,4.4425686932184186e-05,0.6
16167,16167,레디에이터/Noun,5,2,3,4.445926419917751e-05,5.553210866523024e-05,0.6
16168,16168,미호/Noun,5,3,2,5.5574080248971876e-05,4.4425686932184186e-05,0.6
16169,16169,대수/Noun,5,3,2,5.5574080248971876e-05,4.4425686932184186e-05,0.6
16170,16170,자유의지/Noun,5,3,2,5.5574080248971876e-05,4.4425686932184186e-05,0.6
16171,16171,케이츠/Noun,5,3,2,5.5574080248971876e-05,4.4425686932184186e-05,0.6
16172,16172,한재석/Noun,5,3,2,5.5574080248971876e-05,4.4425686932184186e-05,0.6
16173,16173,선방/Noun,5,3,2,5.5574080248971876e-05,4.4425686932184186e-05,0.6
16174,16174,제의/Noun,5,3,2,5.5574080248971876e-05,4.4425686932184186e-05,0.6
16175,16175,항의/Noun,5,2,3,4.445926419917751e-05,5.553210866523024e-05,0.6
16176,16176,)//Punctuation,5,2,3,4.445926419917751e-05,5.553210866523024e-05,0.6
16177,16177,면암/Noun,5,2,3,4.445926419917751e-05,5.553210866523024e-05,0.6
16178,16178,데어데블/Noun,5,2,3,4.445926419917751e-05,5.553210866523024e-05,0.6
16179,16179,........................./Punctuation,5,2,3,4.445926419917751e-05,5.553210866523024e-05,0.6
16180,16180,살피다/Verb,5,2,3,4.445926419917751e-05,5.553210866523024e-05,0.6
16181,16181,이주일/Noun,5,3,2,5.5574080248971876e-05,4.4425686932184186e-05,0.6
16182,16182,미터/Noun,5,2,3,4.445926419917751e-05,5.553210866523024e-05,0.6
16183,16183,정복자/Noun,5,2,3,4.445926419917751e-05,5.553210866523024e-05,0.6
16184,16184,백악관/Noun,5,2,3,4.445926419917751e-05,5.553210866523024e-05,0.6
16185,16185,속사정/Noun,5,2,3,4.445926419917751e-05,5.553210866523024e-05,0.6
16186,16186,와아/Exclamation,5,3,2,5.5574080248971876e-05,4.4425686932184186e-05,0.6
16187,16187,걷기/Noun,5,3,2,5.5574080248971876e-05,4.4425686932184186e-05,0.6
16188,16188,보강/Noun,5,3,2,5.5574080248971876e-05,4.4425686932184186e-05,0.6
16189,16189,순대/Noun,5,3,2,5.5574080248971876e-05,4.4425686932184186e-05,0.6
16190,16190,아주머니/Noun,5,2,3,4.445926419917751e-05,5.553210866523024e-05,0.6
16191,16191,한화/Noun,5,3,2,5.5574080248971876e-05,4.4425686932184186e-05,0.6
16192,16192,지아이조/Noun,5,2,3,4.445926419917751e-05,5.553210866523024e-05,0.6
16193,16193,닌자어쌔신/Noun,5,2,3,4.445926419917751e-05,5.553210866523024e-05,0.6
16194,16194,리썰웨폰/Noun,5,2,3,4.445926419917751e-05,5.553210866523024e-05,0.6
16195,16195,유학생/Noun,5,3,2,5.5574080248971876e-05,4.4425686932184186e-05,0.6
16196,16196,여요/Noun,5,2,3,4.445926419917751e-05,5.553210866523024e-05,0.6
16197,16197,비상구/Noun,5,3,2,5.5574080248971876e-05,4.4425686932184186e-05,0.6
16198,16198,호타루/Noun,5,2,3,4.445926419917751e-05,5.553210866523024e-05,0.6
16199,16199,데포/Noun,5,2,3,4.445926419917751e-05,5.553210866523024e-05,0.6
16200,16200,정크푸드/Noun,5,3,2,5.5574080248971876e-05,4.4425686932184186e-05,0.6
16201,16201,PC/Alpha,5,2,3,4.445926419917751e-05,5.553210866523024e-05,0.6
16202,16202,알반/Noun,5,3,2,5.5574080248971876e-05,4.4425686932184186e-05,0.6
16203,16203,열심/Noun,5,2,3,4.445926419917751e-05,5.553210866523024e-05,0.6
16204,16204,아구/Noun,5,3,2,5.5574080248971876e-05,4.4425686932184186e-05,0.6
16205,16205,다방/Noun,5,2,3,4.445926419917751e-05,5.553210866523024e-05,0.6
16206,16206,보가/Noun,5,3,2,5.5574080248971876e-05,4.4425686932184186e-05,0.6
16207,16207,주보/Noun,5,3,2,5.5574080248971876e-05,4.4425686932184186e-05,0.6
16208,16208,학벌/Noun,5,2,3,4.445926419917751e-05,5.553210866523024e-05,0.6
16209,16209,해갈/Noun,5,3,2,5.5574080248971876e-05,4.4425686932184186e-05,0.6
16210,16210,드림팀/Noun,5,2,3,4.445926419917751e-05,5.553210866523024e-05,0.6
16211,16211,갖/Noun,5,2,3,4.445926419917751e-05,5.553210866523024e-05,0.6
16212,16212,~../Punctuation,5,2,3,4.445926419917751e-05,5.553210866523024e-05,0.6
16213,16213,구실/Noun,5,3,2,5.5574080248971876e-05,4.4425686932184186e-05,0.6
16214,16214,폭포/Noun,5,2,3,4.445926419917751e-05,5.553210866523024e-05,0.6
16215,16215,리베라/Noun,5,3,2,5.5574080248971876e-05,4.4425686932184186e-05,0.6
16216,16216,sorry/Alpha,5,2,3,4.445926419917751e-05,5.553210866523024e-05,0.6
16217,16217,박탈/Noun,5,3,2,5.5574080248971876e-05,4.4425686932184186e-05,0.6
16218,16218,랜덤/Noun,5,3,2,5.5574080248971876e-05,4.4425686932184186e-05,0.6
16219,16219,".,.../Punctuation",5,2,3,4.445926419917751e-05,5.553210866523024e-05,0.6
16220,16220,스풀/Noun,5,3,2,5.5574080248971876e-05,4.4425686932184186e-05,0.6
16221,16221,다사/Noun,5,2,3,4.445926419917751e-05,5.553210866523024e-05,0.6
16222,16222,다마/Noun,5,3,2,5.5574080248971876e-05,4.4425686932184186e-05,0.6
16223,16223,에이브/Noun,5,2,3,4.445926419917751e-05,5.553210866523024e-05,0.6
16224,16224,새드/Noun,5,2,3,4.445926419917751e-05,5.553210866523024e-05,0.6
16225,16225,이지은/Noun,5,3,2,5.5574080248971876e-05,4.4425686932184186e-05,0.6
16226,16226,1994/Number,5,3,2,5.5574080248971876e-05,4.4425686932184186e-05,0.6
16227,16227,어젯밤/Noun,5,2,3,4.445926419917751e-05,5.553210866523024e-05,0.6
16228,16228,줄때/Noun,5,3,2,5.5574080248971876e-05,4.4425686932184186e-05,0.6
16229,16229,시행/Noun,5,3,2,5.5574080248971876e-05,4.4425686932184186e-05,0.6
16230,16230,우하하하/Noun,5,2,3,4.445926419917751e-05,5.553210866523024e-05,0.6
16231,16231,실생활/Noun,5,3,2,5.5574080248971876e-05,4.4425686932184186e-05,0.6
16232,16232,검도/Noun,5,2,3,4.445926419917751e-05,5.553210866523024e-05,0.6
16233,16233,딸기/Noun,5,3,2,5.5574080248971876e-05,4.4425686932184186e-05,0.6
16234,16234,딥/Noun,5,3,2,5.5574080248971876e-05,4.4425686932184186e-05,0.6
16235,16235,페리/Noun,5,2,3,4.445926419917751e-05,5.553210866523024e-05,0.6
16236,16236,덩치/Noun,5,3,2,5.5574080248971876e-05,4.4425686932184186e-05,0.6
16237,16237,부귀/Noun,5,3,2,5.5574080248971876e-05,4.4425686932184186e-05,0.6
16238,16238,블랙스완/Noun,5,2,3,4.445926419917751e-05,5.553210866523024e-05,0.6
16239,16239,ㅇㅅ/KoreanParticle,5,2,3,4.445926419917751e-05,5.553210866523024e-05,0.6
16240,16240,인베이젼/Noun,5,2,3,4.445926419917751e-05,5.553210866523024e-05,0.6
16241,16241,비보잉/Noun,5,2,3,4.445926419917751e-05,5.553210866523024e-05,0.6
16242,16242,유쾌하/Noun,5,3,2,5.5574080248971876e-05,4.4425686932184186e-05,0.6
16243,16243,1234/Number,5,2,3,4.445926419917751e-05,5.553210866523024e-05,0.6
16244,16244,라니깐/Josa,5,3,2,5.5574080248971876e-05,4.4425686932184186e-05,0.6
16245,16245,살로/Noun,5,2,3,4.445926419917751e-05,5.553210866523024e-05,0.6
16246,16246,누비/Noun,5,3,2,5.5574080248971876e-05,4.4425686932184186e-05,0.6
16247,16247,굴리/Noun,5,2,3,4.445926419917751e-05,5.553210866523024e-05,0.6
16248,16248,ㅤ/Foreign,5,2,3,4.445926419917751e-05,5.553210866523024e-05,0.6
16249,16249,사파리/Noun,5,2,3,4.445926419917751e-05,5.553210866523024e-05,0.6
16250,16250,36/Number,5,3,2,5.5574080248971876e-05,4.4425686932184186e-05,0.6
16251,16251,한복/Noun,5,2,3,4.445926419917751e-05,5.553210866523024e-05,0.6
16252,16252,콤보/Noun,5,2,3,4.445926419917751e-05,5.553210866523024e-05,0.6
16253,16253,에라곤/Noun,5,3,2,5.5574080248971876e-05,4.4425686932184186e-05,0.6
16254,16254,리노/Noun,5,3,2,5.5574080248971876e-05,4.4425686932184186e-05,0.6
16255,16255,코프/Noun,5,3,2,5.5574080248971876e-05,4.4425686932184186e-05,0.6
16256,16256,mother/Alpha,5,3,2,5.5574080248971876e-05,4.4425686932184186e-05,0.6
16257,16257,눈꺼풀/Noun,5,2,3,4.445926419917751e-05,5.553210866523024e-05,0.6
16258,16258,젤위/Noun,5,3,2,5.5574080248971876e-05,4.4425686932184186e-05,0.6
16259,16259,돔/Noun,5,3,2,5.5574080248971876e-05,4.4425686932184186e-05,0.6
16260,16260,연습생/Noun,5,2,3,4.445926419917751e-05,5.553210866523024e-05,0.6
16261,16261,킬림/Noun,5,3,2,5.5574080248971876e-05,4.4425686932184186e-05,0.6
16262,16262,고아성/Noun,5,2,3,4.445926419917751e-05,5.553210866523024e-05,0.6
16263,16263,Mr/Alpha,5,2,3,4.445926419917751e-05,5.553210866523024e-05,0.6
16264,16264,프라이/Noun,5,2,3,4.445926419917751e-05,5.553210866523024e-05,0.6
16265,16265,어쨌거/Noun,5,2,3,4.445926419917751e-05,5.553210866523024e-05,0.6
16266,16266,아폴로/Noun,5,3,2,5.5574080248971876e-05,4.4425686932184186e-05,0.6
16267,16267,닫히다/Verb,5,2,3,4.445926419917751e-05,5.553210866523024e-05,0.6
16268,16268,이북/Noun,5,3,2,5.5574080248971876e-05,4.4425686932184186e-05,0.6
16269,16269,변장/Noun,5,2,3,4.445926419917751e-05,5.553210866523024e-05,0.6
16270,16270,욘사마/Noun,5,2,3,4.445926419917751e-05,5.553210866523024e-05,0.6
16271,16271,서윤/Noun,5,2,3,4.445926419917751e-05,5.553210866523024e-05,0.6
16272,16272,까불지마/Noun,5,3,2,5.5574080248971876e-05,4.4425686932184186e-05,0.6
16273,16273,21일/Number,5,3,2,5.5574080248971876e-05,4.4425686932184186e-05,0.6
16274,16274,이노/Noun,5,2,3,4.445926419917751e-05,5.553210866523024e-05,0.6
16275,16275,발해/Noun,5,2,3,4.445926419917751e-05,5.553210866523024e-05,0.6
16276,16276,필립스/Noun,5,3,2,5.5574080248971876e-05,4.4425686932184186e-05,0.6
16277,16277,어비스/Noun,5,2,3,4.445926419917751e-05,5.553210866523024e-05,0.6
16278,16278,동사서독/Noun,5,3,2,5.5574080248971876e-05,4.4425686932184186e-05,0.6
16279,16279,usb/Alpha,5,2,3,4.445926419917751e-05,5.553210866523024e-05,0.6
16280,16280,아군/Noun,5,3,2,5.5574080248971876e-05,4.4425686932184186e-05,0.6
16281,16281,독립운동/Noun,5,3,2,5.5574080248971876e-05,4.4425686932184186e-05,0.6
16282,16282,꺅꺅/Adverb,5,2,3,4.445926419917751e-05,5.553210866523024e-05,0.6
16283,16283,무능/Noun,5,3,2,5.5574080248971876e-05,4.4425686932184186e-05,0.6
16284,16284,남짓/Noun,5,3,2,5.5574080248971876e-05,4.4425686932184186e-05,0.6
16285,16285,메탈/Noun,5,2,3,4.445926419917751e-05,5.553210866523024e-05,0.6
16286,16286,8.4/Number,5,2,3,4.445926419917751e-05,5.553210866523024e-05,0.6
16287,16287,대중화/Noun,5,3,2,5.5574080248971876e-05,4.4425686932184186e-05,0.6
16288,16288,굴러가다/Verb,5,3,2,5.5574080248971876e-05,4.4425686932184186e-05,0.6
16289,16289,상혁/Noun,5,2,3,4.445926419917751e-05,5.553210866523024e-05,0.6
16290,16290,둥지/Noun,5,2,3,4.445926419917751e-05,5.553210866523024e-05,0.6
16291,16291,폭주/Noun,5,2,3,4.445926419917751e-05,5.553210866523024e-05,0.6
16292,16292,타네/Noun,5,2,3,4.445926419917751e-05,5.553210866523024e-05,0.6
16293,16293,날줄/Noun,5,2,3,4.445926419917751e-05,5.553210866523024e-05,0.6
16294,16294,늬/Noun,5,3,2,5.5574080248971876e-05,4.4425686932184186e-05,0.6
16295,16295,껄껄/Noun,5,2,3,4.445926419917751e-05,5.553210866523024e-05,0.6
16296,16296,내재/Noun,5,3,2,5.5574080248971876e-05,4.4425686932184186e-05,0.6
16297,16297,문방구/Noun,5,3,2,5.5574080248971876e-05,4.4425686932184186e-05,0.6
16298,16298,편곡/Noun,5,3,2,5.5574080248971876e-05,4.4425686932184186e-05,0.6
16299,16299,더도/Noun,5,2,3,4.445926419917751e-05,5.553210866523024e-05,0.6
16300,16300,집대성/Noun,5,3,2,5.5574080248971876e-05,4.4425686932184186e-05,0.6
16301,16301,못봣/Noun,5,3,2,5.5574080248971876e-05,4.4425686932184186e-05,0.6
16302,16302,토이/Noun,5,2,3,4.445926419917751e-05,5.553210866523024e-05,0.6
16303,16303,살상/Noun,5,2,3,4.445926419917751e-05,5.553210866523024e-05,0.6
16304,16304,아우성/Noun,5,3,2,5.5574080248971876e-05,4.4425686932184186e-05,0.6
16305,16305,시커멓다/Adjective,5,2,3,4.445926419917751e-05,5.553210866523024e-05,0.6
16306,16306,뱅/Noun,5,3,2,5.5574080248971876e-05,4.4425686932184186e-05,0.6
16307,16307,순진/Noun,5,3,2,5.5574080248971876e-05,4.4425686932184186e-05,0.6
16308,16308,렛/Noun,5,3,2,5.5574080248971876e-05,4.4425686932184186e-05,0.6
16309,16309,소풍/Noun,5,2,3,4.445926419917751e-05,5.553210866523024e-05,0.6
16310,16310,해법/Noun,5,2,3,4.445926419917751e-05,5.553210866523024e-05,0.6
16311,16311,틱장애/Noun,5,3,2,5.5574080248971876e-05,4.4425686932184186e-05,0.6
16312,16312,생물학/Noun,5,2,3,4.445926419917751e-05,5.553210866523024e-05,0.6
16313,16313,""",/Punctuation",5,3,2,5.5574080248971876e-05,4.4425686932184186e-05,0.6
16314,16314,노킹/Noun,5,2,3,4.445926419917751e-05,5.553210866523024e-05,0.6
16315,16315,바로바로/Adverb,5,3,2,5.5574080248971876e-05,4.4425686932184186e-05,0.6
16316,16316,총리/Noun,5,2,3,4.445926419917751e-05,5.553210866523024e-05,0.6
16317,16317,이지혜/Noun,5,2,3,4.445926419917751e-05,5.553210866523024e-05,0.6
16318,16318,블랙호크다운/Noun,5,3,2,5.5574080248971876e-05,4.4425686932184186e-05,0.6
16319,16319,새미/Noun,5,2,3,4.445926419917751e-05,5.553210866523024e-05,0.6
16320,16320,나카마/Noun,5,3,2,5.5574080248971876e-05,4.4425686932184186e-05,0.6
16321,16321,자씨/Noun,5,3,2,5.5574080248971876e-05,4.4425686932184186e-05,0.6
16322,16322,태범/Noun,5,3,2,5.5574080248971876e-05,4.4425686932184186e-05,0.6
16323,16323,동방/Noun,5,3,2,5.5574080248971876e-05,4.4425686932184186e-05,0.6
16324,16324,연한/Noun,5,3,2,5.5574080248971876e-05,4.4425686932184186e-05,0.6
16325,16325,아르세우스/Noun,5,3,2,5.5574080248971876e-05,4.4425686932184186e-05,0.6
16326,16326,엌/Noun,5,3,2,5.5574080248971876e-05,4.4425686932184186e-05,0.6
16327,16327,니아/Noun,5,3,2,5.5574080248971876e-05,4.4425686932184186e-05,0.6
16328,16328,선인/Noun,5,3,2,5.5574080248971876e-05,4.4425686932184186e-05,0.6
16329,16329,사쿠라/Noun,5,2,3,4.445926419917751e-05,5.553210866523024e-05,0.6
16330,16330,히나타/Noun,5,3,2,5.5574080248971876e-05,4.4425686932184186e-05,0.6
16331,16331,ㅓㅇ/KoreanParticle,5,3,2,5.5574080248971876e-05,4.4425686932184186e-05,0.6
16332,16332,카트/Noun,5,3,2,5.5574080248971876e-05,4.4425686932184186e-05,0.6
16333,16333,경찰관/Noun,5,3,2,5.5574080248971876e-05,4.4425686932184186e-05,0.6
16334,16334,장래희망/Noun,5,3,2,5.5574080248971876e-05,4.4425686932184186e-05,0.6
16335,16335,군자/Noun,5,3,2,5.5574080248971876e-05,4.4425686932184186e-05,0.6
16336,16336,소룡/Noun,5,2,3,4.445926419917751e-05,5.553210866523024e-05,0.6
16337,16337,단것/Noun,5,3,2,5.5574080248971876e-05,4.4425686932184186e-05,0.6
16338,16338,아네트베닝/Noun,5,2,3,4.445926419917751e-05,5.553210866523024e-05,0.6
16339,16339,게으름/Noun,5,2,3,4.445926419917751e-05,5.553210866523024e-05,0.6
16340,16340,티파니/Noun,5,3,2,5.5574080248971876e-05,4.4425686932184186e-05,0.6
16341,16341,정형/Noun,5,2,3,4.445926419917751e-05,5.553210866523024e-05,0.6
16342,16342,주역/Noun,5,2,3,4.445926419917751e-05,5.553210866523024e-05,0.6
16343,16343,배후/Noun,5,2,3,4.445926419917751e-05,5.553210866523024e-05,0.6
16344,16344,금융/Noun,5,3,2,5.5574080248971876e-05,4.4425686932184186e-05,0.6
16345,16345,냅다/Adverb,5,2,3,4.445926419917751e-05,5.553210866523024e-05,0.6
16346,16346,수리검/Noun,5,3,2,5.5574080248971876e-05,4.4425686932184186e-05,0.6
16347,16347,법인/Noun,5,2,3,4.445926419917751e-05,5.553210866523024e-05,0.6
16348,16348,말종/Noun,5,2,3,4.445926419917751e-05,5.553210866523024e-05,0.6
16349,16349,이연결/Noun,5,3,2,5.5574080248971876e-05,4.4425686932184186e-05,0.6
16350,16350,키기/Noun,5,3,2,5.5574080248971876e-05,4.4425686932184186e-05,0.6
16351,16351,껍질/Noun,5,3,2,5.5574080248971876e-05,4.4425686932184186e-05,0.6
16352,16352,호스텔/Noun,5,2,3,4.445926419917751e-05,5.553210866523024e-05,0.6
16353,16353,달라붙다/Verb,5,2,3,4.445926419917751e-05,5.553210866523024e-05,0.6
16354,16354,낚일/Noun,5,2,3,4.445926419917751e-05,5.553210866523024e-05,0.6
16355,16355,가렛/Noun,5,2,3,4.445926419917751e-05,5.553210866523024e-05,0.6
16356,16356,칠흑/Noun,5,3,2,5.5574080248971876e-05,4.4425686932184186e-05,0.6
16357,16357,-.-;;/Punctuation,5,2,3,4.445926419917751e-05,5.553210866523024e-05,0.6
16358,16358,일분/Noun,5,3,2,5.5574080248971876e-05,4.4425686932184186e-05,0.6
16359,16359,이순신장군/Noun,5,2,3,4.445926419917751e-05,5.553210866523024e-05,0.6
16360,16360,휠씬/Noun,5,3,2,5.5574080248971876e-05,4.4425686932184186e-05,0.6
16361,16361,손가락질/Noun,5,3,2,5.5574080248971876e-05,4.4425686932184186e-05,0.6
16362,16362,에는/Foreign,5,2,3,4.445926419917751e-05,5.553210866523024e-05,0.6
16363,16363,진성/Noun,5,3,2,5.5574080248971876e-05,4.4425686932184186e-05,0.6
16364,16364,힘껏/Noun,5,3,2,5.5574080248971876e-05,4.4425686932184186e-05,0.6
16365,16365,페루/Noun,5,3,2,5.5574080248971876e-05,4.4425686932184186e-05,0.6
16366,16366,해나/Noun,5,2,3,4.445926419917751e-05,5.553210866523024e-05,0.6
16367,16367,탄광/Noun,5,3,2,5.5574080248971876e-05,4.4425686932184186e-05,0.6
16368,16368,쥐약/Noun,5,2,3,4.445926419917751e-05,5.553210866523024e-05,0.6
16369,16369,잠잠하다/Adjective,5,2,3,4.445926419917751e-05,5.553210866523024e-05,0.6
16370,16370,고막/Noun,5,2,3,4.445926419917751e-05,5.553210866523024e-05,0.6
16371,16371,시지/Noun,5,2,3,4.445926419917751e-05,5.553210866523024e-05,0.6
16372,16372,브레이브하트/Noun,5,3,2,5.5574080248971876e-05,4.4425686932184186e-05,0.6
16373,16373,헤집다/Verb,5,3,2,5.5574080248971876e-05,4.4425686932184186e-05,0.6
16374,16374,안길/Noun,5,3,2,5.5574080248971876e-05,4.4425686932184186e-05,0.6
16375,16375,김조광수/Noun,5,2,3,4.445926419917751e-05,5.553210866523024e-05,0.6
16376,16376,경주/Noun,5,2,3,4.445926419917751e-05,5.553210866523024e-05,0.6
16377,16377,작이라고/Foreign,5,2,3,4.445926419917751e-05,5.553210866523024e-05,0.6
16378,16378,리야/Noun,5,3,2,5.5574080248971876e-05,4.4425686932184186e-05,0.6
16379,16379,어머/Noun,5,3,2,5.5574080248971876e-05,4.4425686932184186e-05,0.6
16380,16380,어두움/Noun,5,2,3,4.445926419917751e-05,5.553210866523024e-05,0.6
16381,16381,네타/Noun,5,2,3,4.445926419917751e-05,5.553210866523024e-05,0.6
16382,16382,팔면/Noun,5,3,2,5.5574080248971876e-05,4.4425686932184186e-05,0.6
16383,16383,단시간/Noun,5,2,3,4.445926419917751e-05,5.553210866523024e-05,0.6
16384,16384,일삼/Noun,5,3,2,5.5574080248971876e-05,4.4425686932184186e-05,0.6
16385,16385,트랜드/Noun,5,2,3,4.445926419917751e-05,5.553210866523024e-05,0.6
16386,16386,퇴근/Noun,5,2,3,4.445926419917751e-05,5.553210866523024e-05,0.6
16387,16387,온전/Noun,5,3,2,5.5574080248971876e-05,4.4425686932184186e-05,0.6
16388,16388,야구장/Noun,5,2,3,4.445926419917751e-05,5.553210866523024e-05,0.6
16389,16389,산산조각/Noun,5,2,3,4.445926419917751e-05,5.553210866523024e-05,0.6
16390,16390,제임스본드/Noun,5,3,2,5.5574080248971876e-05,4.4425686932184186e-05,0.6
16391,16391,전술/Noun,5,2,3,4.445926419917751e-05,5.553210866523024e-05,0.6
16392,16392,23년/Number,5,2,3,4.445926419917751e-05,5.553210866523024e-05,0.6
16393,16393,김무열/Noun,5,3,2,5.5574080248971876e-05,4.4425686932184186e-05,0.6
16394,16394,베이스/Noun,5,3,2,5.5574080248971876e-05,4.4425686932184186e-05,0.6
16395,16395,1986년/Number,5,3,2,5.5574080248971876e-05,4.4425686932184186e-05,0.6
16396,16396,으어/Noun,5,2,3,4.445926419917751e-05,5.553210866523024e-05,0.6
16397,16397,노약/Noun,5,3,2,5.5574080248971876e-05,4.4425686932184186e-05,0.6
16398,16398,아집/Noun,5,2,3,4.445926419917751e-05,5.553210866523024e-05,0.6
16399,16399,벌떡/Noun,5,3,2,5.5574080248971876e-05,4.4425686932184186e-05,0.6
16400,16400,인색하다/Adjective,5,3,2,5.5574080248971876e-05,4.4425686932184186e-05,0.6
16401,16401,대사관/Noun,5,3,2,5.5574080248971876e-05,4.4425686932184186e-05,0.6
16402,16402,요코/Noun,5,2,3,4.445926419917751e-05,5.553210866523024e-05,0.6
16403,16403,십대/Modifier,5,3,2,5.5574080248971876e-05,4.4425686932184186e-05,0.6
16404,16404,더라면/Noun,5,3,2,5.5574080248971876e-05,4.4425686932184186e-05,0.6
16405,16405,환경오염/Noun,5,3,2,5.5574080248971876e-05,4.4425686932184186e-05,0.6
16406,16406,조그마하다/Adjective,5,2,3,4.445926419917751e-05,5.553210866523024e-05,0.6
16407,16407,오하/Noun,5,2,3,4.445926419917751e-05,5.553210866523024e-05,0.6
16408,16408,침입/Noun,5,3,2,5.5574080248971876e-05,4.4425686932184186e-05,0.6
16409,16409,무단/Noun,5,2,3,4.445926419917751e-05,5.553210866523024e-05,0.6
16410,16410,쪙/Noun,5,3,2,5.5574080248971876e-05,4.4425686932184186e-05,0.6
16411,16411,낙천/Noun,5,2,3,4.445926419917751e-05,5.553210866523024e-05,0.6
16412,16412,7.0/Number,5,3,2,5.5574080248971876e-05,4.4425686932184186e-05,0.6
16413,16413,속담/Noun,5,2,3,4.445926419917751e-05,5.553210866523024e-05,0.6
16414,16414,명/Foreign,5,3,2,5.5574080248971876e-05,4.4425686932184186e-05,0.6
16415,16415,노트/Noun,5,3,2,5.5574080248971876e-05,4.4425686932184186e-05,0.6
16416,16416,가산/Noun,5,2,3,4.445926419917751e-05,5.553210866523024e-05,0.6
16417,16417,사고뭉치/Noun,5,2,3,4.445926419917751e-05,5.553210866523024e-05,0.6
16418,16418,클락/Noun,5,3,2,5.5574080248971876e-05,4.4425686932184186e-05,0.6
16419,16419,명수/Noun,5,2,3,4.445926419917751e-05,5.553210866523024e-05,0.6
16420,16420,펙트/Noun,5,2,3,4.445926419917751e-05,5.553210866523024e-05,0.6
16421,16421,과도기/Noun,5,3,2,5.5574080248971876e-05,4.4425686932184186e-05,0.6
16422,16422,송해/Noun,5,3,2,5.5574080248971876e-05,4.4425686932184186e-05,0.6
16423,16423,인강/Noun,5,3,2,5.5574080248971876e-05,4.4425686932184186e-05,0.6
16424,16424,스핀오프/Noun,5,3,2,5.5574080248971876e-05,4.4425686932184186e-05,0.6
16425,16425,이특/Noun,5,3,2,5.5574080248971876e-05,4.4425686932184186e-05,0.6
16426,16426,숙청/Noun,5,2,3,4.445926419917751e-05,5.553210866523024e-05,0.6
16427,16427,꼬임/Noun,5,2,3,4.445926419917751e-05,5.553210866523024e-05,0.6
16428,16428,100일/Number,5,2,3,4.445926419917751e-05,5.553210866523024e-05,0.6
16429,16429,지라치/Noun,5,2,3,4.445926419917751e-05,5.553210866523024e-05,0.6
16430,16430,want/Alpha,5,3,2,5.5574080248971876e-05,4.4425686932184186e-05,0.6
16431,16431,치고받다/Verb,5,3,2,5.5574080248971876e-05,4.4425686932184186e-05,0.6
16432,16432,롤랜드/Noun,5,2,3,4.445926419917751e-05,5.553210866523024e-05,0.6
16433,16433,)../Punctuation,5,2,3,4.445926419917751e-05,5.553210866523024e-05,0.6
16434,16434,지팡이/Noun,5,2,3,4.445926419917751e-05,5.553210866523024e-05,0.6
16435,16435,개잡/Noun,5,2,3,4.445926419917751e-05,5.553210866523024e-05,0.6
16436,16436,곽재용/Noun,5,2,3,4.445926419917751e-05,5.553210866523024e-05,0.6
16437,16437,??!/Punctuation,5,2,3,4.445926419917751e-05,5.553210866523024e-05,0.6
16438,16438,클로드/Noun,5,3,2,5.5574080248971876e-05,4.4425686932184186e-05,0.6
16439,16439,레스/Noun,5,3,2,5.5574080248971876e-05,4.4425686932184186e-05,0.6
16440,16440,7분/Number,5,2,3,4.445926419917751e-05,5.553210866523024e-05,0.6
16441,16441,알리야/Noun,5,2,3,4.445926419917751e-05,5.553210866523024e-05,0.6
16442,16442,쇼타임/Noun,5,3,2,5.5574080248971876e-05,4.4425686932184186e-05,0.6
16443,16443,왜왜왜/Noun,5,3,2,5.5574080248971876e-05,4.4425686932184186e-05,0.6
16444,16444,이비/Noun,5,2,3,4.445926419917751e-05,5.553210866523024e-05,0.6
16445,16445,신기원/Noun,5,3,2,5.5574080248971876e-05,4.4425686932184186e-05,0.6
16446,16446,상공/Noun,5,2,3,4.445926419917751e-05,5.553210866523024e-05,0.6
16447,16447,난관/Noun,5,3,2,5.5574080248971876e-05,4.4425686932184186e-05,0.6
16448,16448,신임/Noun,5,3,2,5.5574080248971876e-05,4.4425686932184186e-05,0.6
16449,16449,도해/Noun,5,3,2,5.5574080248971876e-05,4.4425686932184186e-05,0.6
16450,16450,광개토태왕/Noun,5,2,3,4.445926419917751e-05,5.553210866523024e-05,0.6
16451,16451,1일/Number,5,3,2,5.5574080248971876e-05,4.4425686932184186e-05,0.6
16452,16452,클랜/Noun,5,3,2,5.5574080248971876e-05,4.4425686932184186e-05,0.6
16453,16453,다솜/Noun,5,3,2,5.5574080248971876e-05,4.4425686932184186e-05,0.6
16454,16454,팽/Noun,5,2,3,4.445926419917751e-05,5.553210866523024e-05,0.6
16455,16455,가신/Noun,5,3,2,5.5574080248971876e-05,4.4425686932184186e-05,0.6
16456,16456,걷어차다/Verb,5,2,3,4.445926419917751e-05,5.553210866523024e-05,0.6
16457,16457,텀/Noun,5,2,3,4.445926419917751e-05,5.553210866523024e-05,0.6
16458,16458,순회/Noun,5,2,3,4.445926419917751e-05,5.553210866523024e-05,0.6
16459,16459,필적/Noun,5,3,2,5.5574080248971876e-05,4.4425686932184186e-05,0.6
16460,16460,거땜/Noun,5,2,3,4.445926419917751e-05,5.553210866523024e-05,0.6
16461,16461,45년/Number,5,3,2,5.5574080248971876e-05,4.4425686932184186e-05,0.6
16462,16462,한글제목/Noun,5,2,3,4.445926419917751e-05,5.553210866523024e-05,0.6
16463,16463,으헝/Noun,5,3,2,5.5574080248971876e-05,4.4425686932184186e-05,0.6
16464,16464,최불암/Noun,5,3,2,5.5574080248971876e-05,4.4425686932184186e-05,0.6
16465,16465,토네이도/Noun,5,3,2,5.5574080248971876e-05,4.4425686932184186e-05,0.6
16466,16466,에단/Noun,5,2,3,4.445926419917751e-05,5.553210866523024e-05,0.6
16467,16467,유종/Noun,5,3,2,5.5574080248971876e-05,4.4425686932184186e-05,0.6
16468,16468,항해/Noun,5,3,2,5.5574080248971876e-05,4.4425686932184186e-05,0.6
16469,16469,개구쟁이/Noun,5,2,3,4.445926419917751e-05,5.553210866523024e-05,0.6
16470,16470,상병/Noun,5,2,3,4.445926419917751e-05,5.553210866523024e-05,0.6
16471,16471,의형제/Noun,5,2,3,4.445926419917751e-05,5.553210866523024e-05,0.6
16472,16472,여름날/Noun,5,3,2,5.5574080248971876e-05,4.4425686932184186e-05,0.6
16473,16473,이사장/Noun,5,2,3,4.445926419917751e-05,5.553210866523024e-05,0.6
16474,16474,부장/Noun,5,3,2,5.5574080248971876e-05,4.4425686932184186e-05,0.6
16475,16475,세친구/Noun,5,3,2,5.5574080248971876e-05,4.4425686932184186e-05,0.6
16476,16476,납/Noun,5,3,2,5.5574080248971876e-05,4.4425686932184186e-05,0.6
16477,16477,찜질방/Noun,5,3,2,5.5574080248971876e-05,4.4425686932184186e-05,0.6
16478,16478,쉴즈/Noun,5,3,2,5.5574080248971876e-05,4.4425686932184186e-05,0.6
16479,16479,카운트/Noun,5,3,2,5.5574080248971876e-05,4.4425686932184186e-05,0.6
16480,16480,꽃보다남자/Noun,5,3,2,5.5574080248971876e-05,4.4425686932184186e-05,0.6
16481,16481,택배/Noun,5,2,3,4.445926419917751e-05,5.553210866523024e-05,0.6
16482,16482,삼일/Noun,5,2,3,4.445926419917751e-05,5.553210866523024e-05,0.6
16483,16483,갖가지/Noun,5,2,3,4.445926419917751e-05,5.553210866523024e-05,0.6
16484,16484,이성애자/Noun,5,3,2,5.5574080248971876e-05,4.4425686932184186e-05,0.6
16485,16485,미우라/Noun,5,2,3,4.445926419917751e-05,5.553210866523024e-05,0.6
16486,16486,교류/Noun,5,2,3,4.445926419917751e-05,5.553210866523024e-05,0.6
16487,16487,파랗다/Adjective,5,3,2,5.5574080248971876e-05,4.4425686932184186e-05,0.6
16488,16488,단둘/Noun,5,2,3,4.445926419917751e-05,5.553210866523024e-05,0.6
16489,16489,가부장/Noun,5,2,3,4.445926419917751e-05,5.553210866523024e-05,0.6
16490,16490,점/Foreign,5,2,3,4.445926419917751e-05,5.553210866523024e-05,0.6
16491,16491,움찔/Noun,5,3,2,5.5574080248971876e-05,4.4425686932184186e-05,0.6
16492,16492,만물/Noun,5,3,2,5.5574080248971876e-05,4.4425686932184186e-05,0.6
16493,16493,그릴/Noun,5,3,2,5.5574080248971876e-05,4.4425686932184186e-05,0.6
16494,16494,빨래/Noun,5,3,2,5.5574080248971876e-05,4.4425686932184186e-05,0.6
16495,16495,아물다/Verb,5,2,3,4.445926419917751e-05,5.553210866523024e-05,0.6
16496,16496,패럴/Noun,5,3,2,5.5574080248971876e-05,4.4425686932184186e-05,0.6
16497,16497,닉슨/Noun,5,3,2,5.5574080248971876e-05,4.4425686932184186e-05,0.6
16498,16498,래퍼/Noun,5,2,3,4.445926419917751e-05,5.553210866523024e-05,0.6
16499,16499,아스팔트/Noun,5,3,2,5.5574080248971876e-05,4.4425686932184186e-05,0.6
16500,16500,벤틀리/Noun,5,3,2,5.5574080248971876e-05,4.4425686932184186e-05,0.6
16501,16501,틸리/Noun,5,3,2,5.5574080248971876e-05,4.4425686932184186e-05,0.6
16502,16502,용돈/Noun,5,2,3,4.445926419917751e-05,5.553210866523024e-05,0.6
16503,16503,화도/Noun,5,3,2,5.5574080248971876e-05,4.4425686932184186e-05,0.6
16504,16504,흥이/Noun,5,2,3,4.445926419917751e-05,5.553210866523024e-05,0.6
16505,16505,소득/Noun,5,2,3,4.445926419917751e-05,5.553210866523024e-05,0.6
16506,16506,실명/Noun,5,2,3,4.445926419917751e-05,5.553210866523024e-05,0.6
16507,16507,자식새끼/Noun,5,3,2,5.5574080248971876e-05,4.4425686932184186e-05,0.6
16508,16508,글리/Noun,5,2,3,4.445926419917751e-05,5.553210866523024e-05,0.6
16509,16509,비틀어지다/Verb,5,2,3,4.445926419917751e-05,5.553210866523024e-05,0.6
16510,16510,배정/Noun,5,3,2,5.5574080248971876e-05,4.4425686932184186e-05,0.6
16511,16511,11분/Number,5,2,3,4.445926419917751e-05,5.553210866523024e-05,0.6
16512,16512,격조/Noun,5,3,2,5.5574080248971876e-05,4.4425686932184186e-05,0.6
16513,16513,반칙/Noun,5,3,2,5.5574080248971876e-05,4.4425686932184186e-05,0.6
16514,16514,지젤/Noun,5,2,3,4.445926419917751e-05,5.553210866523024e-05,0.6
16515,16515,타이탄/Noun,5,2,3,4.445926419917751e-05,5.553210866523024e-05,0.6
16516,16516,랄라/Adverb,5,3,2,5.5574080248971876e-05,4.4425686932184186e-05,0.6
16517,16517,고아/Noun,5,3,2,5.5574080248971876e-05,4.4425686932184186e-05,0.6
16518,16518,여가/Noun,5,2,3,4.445926419917751e-05,5.553210866523024e-05,0.6
16519,16519,용암/Noun,5,3,2,5.5574080248971876e-05,4.4425686932184186e-05,0.6
16520,16520,긴머리/Noun,5,2,3,4.445926419917751e-05,5.553210866523024e-05,0.6
16521,16521,위드/Noun,5,2,3,4.445926419917751e-05,5.553210866523024e-05,0.6
16522,16522,반고흐/Noun,5,3,2,5.5574080248971876e-05,4.4425686932184186e-05,0.6
16523,16523,이장호/Noun,5,3,2,5.5574080248971876e-05,4.4425686932184186e-05,0.6
16524,16524,아이구/Exclamation,5,2,3,4.445926419917751e-05,5.553210866523024e-05,0.6
16525,16525,중요시/Noun,5,2,3,4.445926419917751e-05,5.553210866523024e-05,0.6
16526,16526,브룩쉴즈/Noun,5,2,3,4.445926419917751e-05,5.553210866523024e-05,0.6
16527,16527,점준애/Noun,5,2,3,4.445926419917751e-05,5.553210866523024e-05,0.6
16528,16528,이영은/Noun,5,2,3,4.445926419917751e-05,5.553210866523024e-05,0.6
16529,16529,…./Punctuation,5,2,3,4.445926419917751e-05,5.553210866523024e-05,0.6
16530,16530,종형/Noun,5,2,3,4.445926419917751e-05,5.553210866523024e-05,0.6
16531,16531,지적장애/Noun,5,2,3,4.445926419917751e-05,5.553210866523024e-05,0.6
16532,16532,뻐/Noun,5,3,2,5.5574080248971876e-05,4.4425686932184186e-05,0.6
16533,16533,경례/Noun,5,2,3,4.445926419917751e-05,5.553210866523024e-05,0.6
16534,16534,훤히/Noun,5,3,2,5.5574080248971876e-05,4.4425686932184186e-05,0.6
16535,16535,수호지/Noun,5,2,3,4.445926419917751e-05,5.553210866523024e-05,0.6
16536,16536,아담스/Noun,5,3,2,5.5574080248971876e-05,4.4425686932184186e-05,0.6
16537,16537,터보/Noun,5,3,2,5.5574080248971876e-05,4.4425686932184186e-05,0.6
16538,16538,비폭력/Noun,5,3,2,5.5574080248971876e-05,4.4425686932184186e-05,0.6
16539,16539,너그럽다/Adjective,5,3,2,5.5574080248971876e-05,4.4425686932184186e-05,0.6
16540,16540,산영/Noun,5,3,2,5.5574080248971876e-05,4.4425686932184186e-05,0.6
16541,16541,획득/Noun,5,2,3,4.445926419917751e-05,5.553210866523024e-05,0.6
16542,16542,라미란/Noun,5,3,2,5.5574080248971876e-05,4.4425686932184186e-05,0.6
16543,16543,류수영/Noun,5,3,2,5.5574080248971876e-05,4.4425686932184186e-05,0.6
16544,16544,투지/Noun,5,3,2,5.5574080248971876e-05,4.4425686932184186e-05,0.6
16545,16545,눈뎅/Noun,4,4,0,6.668889629876625e-05,2.2212843466092093e-05,1.0
16546,16546,태주/Noun,4,4,0,6.668889629876625e-05,2.2212843466092093e-05,1.0
16547,16547,쇼팽/Noun,4,4,0,6.668889629876625e-05,2.2212843466092093e-05,1.0
16548,16548,꾸러기/Noun,4,4,0,6.668889629876625e-05,2.2212843466092093e-05,1.0
16549,16549,방기/Noun,4,0,4,2.2229632099588756e-05,6.663853039827628e-05,1.0
16550,16550,개꿀잼임/Noun,4,4,0,6.668889629876625e-05,2.2212843466092093e-05,1.0
16551,16551,봣었/Noun,4,4,0,6.668889629876625e-05,2.2212843466092093e-05,1.0
16552,16552,나타남/Noun,4,0,4,2.2229632099588756e-05,6.663853039827628e-05,1.0
16553,16553,극혐임/Noun,4,0,4,2.2229632099588756e-05,6.663853039827628e-05,1.0
16554,16554,퍼킹/Noun,4,0,4,2.2229632099588756e-05,6.663853039827628e-05,1.0
16555,16555,ㅋㄲㅈㅁ/KoreanParticle,4,0,4,2.2229632099588756e-05,6.663853039827628e-05,1.0
16556,16556,49/Number,4,4,0,6.668889629876625e-05,2.2212843466092093e-05,1.0
16557,16557,버거/Noun,4,0,4,2.2229632099588756e-05,6.663853039827628e-05,1.0
16558,16558,청바지/Noun,4,4,0,6.668889629876625e-05,2.2212843466092093e-05,1.0
16559,16559,Man/Alpha,4,4,0,6.668889629876625e-05,2.2212843466092093e-05,1.0
16560,16560,'.../Punctuation,4,4,0,6.668889629876625e-05,2.2212843466092093e-05,1.0
16561,16561,거뭐임/Noun,4,0,4,2.2229632099588756e-05,6.663853039827628e-05,1.0
16562,16562,봣엇/Noun,4,4,0,6.668889629876625e-05,2.2212843466092093e-05,1.0
16563,16563,여봐라/Noun,4,0,4,2.2229632099588756e-05,6.663853039827628e-05,1.0
16564,16564,바보엄마/Noun,4,4,0,6.668889629876625e-05,2.2212843466092093e-05,1.0
16565,16565,낭만자객/Noun,4,0,4,2.2229632099588756e-05,6.663853039827628e-05,1.0
16566,16566,와이즈/Noun,4,4,0,6.668889629876625e-05,2.2212843466092093e-05,1.0
16567,16567,서안/Noun,4,0,4,2.2229632099588756e-05,6.663853039827628e-05,1.0
16568,16568,series/Alpha,4,4,0,6.668889629876625e-05,2.2212843466092093e-05,1.0
16569,16569,신입사원/Noun,4,0,4,2.2229632099588756e-05,6.663853039827628e-05,1.0
16570,16570,불혹/Noun,4,4,0,6.668889629876625e-05,2.2212843466092093e-05,1.0
16571,16571,장기매매/Noun,4,0,4,2.2229632099588756e-05,6.663853039827628e-05,1.0
16572,16572,어떡/Noun,4,0,4,2.2229632099588756e-05,6.663853039827628e-05,1.0
16573,16573,말임/Noun,4,4,0,6.668889629876625e-05,2.2212843466092093e-05,1.0
16574,16574,복희/Noun,4,0,4,2.2229632099588756e-05,6.663853039827628e-05,1.0
16575,16575,?>/Punctuation,4,0,4,2.2229632099588756e-05,6.663853039827628e-05,1.0
16576,16576,음조/Noun,4,4,0,6.668889629876625e-05,2.2212843466092093e-05,1.0
16577,16577,시청료/Noun,4,0,4,2.2229632099588756e-05,6.663853039827628e-05,1.0
16578,16578,김태연/Noun,4,0,4,2.2229632099588756e-05,6.663853039827628e-05,1.0
16579,16579,롱런/Noun,4,4,0,6.668889629876625e-05,2.2212843466092093e-05,1.0
16580,16580,이비에스/Noun,4,4,0,6.668889629876625e-05,2.2212843466092093e-05,1.0
16581,16581,파이프/Noun,4,0,4,2.2229632099588756e-05,6.663853039827628e-05,1.0
16582,16582,！！/Foreign,4,4,0,6.668889629876625e-05,2.2212843466092093e-05,1.0
16583,16583,레토/Noun,4,4,0,6.668889629876625e-05,2.2212843466092093e-05,1.0
16584,16584,왜리/Noun,4,4,0,6.668889629876625e-05,2.2212843466092093e-05,1.0
16585,16585,get/Alpha,4,4,0,6.668889629876625e-05,2.2212843466092093e-05,1.0
16586,16586,.;;;;/Punctuation,4,0,4,2.2229632099588756e-05,6.663853039827628e-05,1.0
16587,16587,임/Foreign,4,0,4,2.2229632099588756e-05,6.663853039827628e-05,1.0
16588,16588,현직/Noun,4,4,0,6.668889629876625e-05,2.2212843466092093e-05,1.0
16589,16589,제나/Noun,4,4,0,6.668889629876625e-05,2.2212843466092093e-05,1.0
16590,16590,셰퍼드/Noun,4,4,0,6.668889629876625e-05,2.2212843466092093e-05,1.0
16591,16591,떼거지/Noun,4,0,4,2.2229632099588756e-05,6.663853039827628e-05,1.0
16592,16592,잡수시다/Verb,4,0,4,2.2229632099588756e-05,6.663853039827628e-05,1.0
16593,16593,변태성욕/Noun,4,0,4,2.2229632099588756e-05,6.663853039827628e-05,1.0
16594,16594,까미유/Noun,4,4,0,6.668889629876625e-05,2.2212843466092093e-05,1.0
16595,16595,가속/Noun,4,4,0,6.668889629876625e-05,2.2212843466092093e-05,1.0
16596,16596,이스터섬/Noun,4,4,0,6.668889629876625e-05,2.2212843466092093e-05,1.0
16597,16597,109분/Number,4,0,4,2.2229632099588756e-05,6.663853039827628e-05,1.0
16598,16598,...................................../Punctuation,4,0,4,2.2229632099588756e-05,6.663853039827628e-05,1.0
16599,16599,어이쿠/Noun,4,0,4,2.2229632099588756e-05,6.663853039827628e-05,1.0
16600,16600,노노노/Noun,4,0,4,2.2229632099588756e-05,6.663853039827628e-05,1.0
16601,16601,김성균/Noun,4,4,0,6.668889629876625e-05,2.2212843466092093e-05,1.0
16602,16602,후대/Noun,4,4,0,6.668889629876625e-05,2.2212843466092093e-05,1.0
16603,16603,ㅈㅈ/KoreanParticle,4,0,4,2.2229632099588756e-05,6.663853039827628e-05,1.0
16604,16604,레파/Noun,4,0,4,2.2229632099588756e-05,6.663853039827628e-05,1.0
16605,16605,가비/Noun,4,4,0,6.668889629876625e-05,2.2212843466092093e-05,1.0
16606,16606,이로써/Adverb,4,0,4,2.2229632099588756e-05,6.663853039827628e-05,1.0
16607,16607,혹독하다/Adjective,4,4,0,6.668889629876625e-05,2.2212843466092093e-05,1.0
16608,16608,;.../Punctuation,4,0,4,2.2229632099588756e-05,6.663853039827628e-05,1.0
16609,16609,뭐꼬/Noun,4,0,4,2.2229632099588756e-05,6.663853039827628e-05,1.0
16610,16610,공세/Noun,4,0,4,2.2229632099588756e-05,6.663853039827628e-05,1.0
16611,16611,불현듯/Noun,4,4,0,6.668889629876625e-05,2.2212843466092093e-05,1.0
16612,16612,원칙/Noun,4,0,4,2.2229632099588756e-05,6.663853039827628e-05,1.0
16613,16613,박미선/Noun,4,0,4,2.2229632099588756e-05,6.663853039827628e-05,1.0
16614,16614,골디/Noun,4,4,0,6.668889629876625e-05,2.2212843466092093e-05,1.0
16615,16615,가소롭다/Adjective,4,0,4,2.2229632099588756e-05,6.663853039827628e-05,1.0
16616,16616,챙피/Noun,4,0,4,2.2229632099588756e-05,6.663853039827628e-05,1.0
16617,16617,3.1/Number,4,0,4,2.2229632099588756e-05,6.663853039827628e-05,1.0
16618,16618,첫등장/Noun,4,0,4,2.2229632099588756e-05,6.663853039827628e-05,1.0
16619,16619,지아장커/Noun,4,4,0,6.668889629876625e-05,2.2212843466092093e-05,1.0
16620,16620,안드로이드/Noun,4,4,0,6.668889629876625e-05,2.2212843466092093e-05,1.0
16621,16621,ㅂㅂ/KoreanParticle,4,0,4,2.2229632099588756e-05,6.663853039827628e-05,1.0
16622,16622,인간지네/Noun,4,0,4,2.2229632099588756e-05,6.663853039827628e-05,1.0
16623,16623,순리/Noun,4,4,0,6.668889629876625e-05,2.2212843466092093e-05,1.0
16624,16624,뮈/Noun,4,0,4,2.2229632099588756e-05,6.663853039827628e-05,1.0
16625,16625,다물어지다/Verb,4,4,0,6.668889629876625e-05,2.2212843466092093e-05,1.0
16626,16626,하루히/Noun,4,4,0,6.668889629876625e-05,2.2212843466092093e-05,1.0
16627,16627,여심/Noun,4,4,0,6.668889629876625e-05,2.2212843466092093e-05,1.0
16628,16628,저열/Noun,4,0,4,2.2229632099588756e-05,6.663853039827628e-05,1.0
16629,16629,엘라/Noun,4,4,0,6.668889629876625e-05,2.2212843466092093e-05,1.0
16630,16630,보빨/Noun,4,0,4,2.2229632099588756e-05,6.663853039827628e-05,1.0
16631,16631,집의/Noun,4,0,4,2.2229632099588756e-05,6.663853039827628e-05,1.0
16632,16632,파멸하다/Adjective,4,4,0,6.668889629876625e-05,2.2212843466092093e-05,1.0
16633,16633,트래쉬/Noun,4,0,4,2.2229632099588756e-05,6.663853039827628e-05,1.0
16634,16634,간닷/Noun,4,0,4,2.2229632099588756e-05,6.663853039827628e-05,1.0
16635,16635,시럽/Noun,4,0,4,2.2229632099588756e-05,6.663853039827628e-05,1.0
16636,16636,♥♥♥♥♥♥♥/Foreign,4,4,0,6.668889629876625e-05,2.2212843466092093e-05,1.0
16637,16637,……./Punctuation,4,0,4,2.2229632099588756e-05,6.663853039827628e-05,1.0
16638,16638,아웅산수치/Noun,4,4,0,6.668889629876625e-05,2.2212843466092093e-05,1.0
16639,16639,꿀꿀/Noun,4,4,0,6.668889629876625e-05,2.2212843466092093e-05,1.0
16640,16640,금옥/Noun,4,0,4,2.2229632099588756e-05,6.663853039827628e-05,1.0
16641,16641,again/Alpha,4,4,0,6.668889629876625e-05,2.2212843466092093e-05,1.0
16642,16642,뭇/Modifier,4,4,0,6.668889629876625e-05,2.2212843466092093e-05,1.0
16643,16643,잼잼잼/Noun,4,4,0,6.668889629876625e-05,2.2212843466092093e-05,1.0
16644,16644,유분수/Noun,4,0,4,2.2229632099588756e-05,6.663853039827628e-05,1.0
16645,16645,기생수/Noun,4,4,0,6.668889629876625e-05,2.2212843466092093e-05,1.0
16646,16646,건성건성/Noun,4,0,4,2.2229632099588756e-05,6.663853039827628e-05,1.0
16647,16647,!!!!!!!!!!!!!!!!!!!!!!!!!!!/Punctuation,4,4,0,6.668889629876625e-05,2.2212843466092093e-05,1.0
16648,16648,크라운제이/Noun,4,0,4,2.2229632099588756e-05,6.663853039827628e-05,1.0
16649,16649,똥례/Noun,4,0,4,2.2229632099588756e-05,6.663853039827628e-05,1.0
16650,16650,정소민/Noun,4,4,0,6.668889629876625e-05,2.2212843466092093e-05,1.0
16651,16651,똥망작/Noun,4,0,4,2.2229632099588756e-05,6.663853039827628e-05,1.0
16652,16652,피카/Noun,4,4,0,6.668889629876625e-05,2.2212843466092093e-05,1.0
16653,16653,We/Alpha,4,4,0,6.668889629876625e-05,2.2212843466092093e-05,1.0
16654,16654,울적/Noun,4,0,4,2.2229632099588756e-05,6.663853039827628e-05,1.0
16655,16655,쓰르라미/Noun,4,0,4,2.2229632099588756e-05,6.663853039827628e-05,1.0
16656,16656,부린다/Noun,4,0,4,2.2229632099588756e-05,6.663853039827628e-05,1.0
16657,16657,착잡하다/Adjective,4,4,0,6.668889629876625e-05,2.2212843466092093e-05,1.0
16658,16658,스반/Noun,4,4,0,6.668889629876625e-05,2.2212843466092093e-05,1.0
16659,16659,벙/Noun,4,0,4,2.2229632099588756e-05,6.663853039827628e-05,1.0
16660,16660,1010101010/Number,4,4,0,6.668889629876625e-05,2.2212843466092093e-05,1.0
16661,16661,1998/Number,4,4,0,6.668889629876625e-05,2.2212843466092093e-05,1.0
16662,16662,게이샤/Noun,4,0,4,2.2229632099588756e-05,6.663853039827628e-05,1.0
16663,16663,뱅뱅/Noun,4,0,4,2.2229632099588756e-05,6.663853039827628e-05,1.0
16664,16664,꼴깝/Noun,4,0,4,2.2229632099588756e-05,6.663853039827628e-05,1.0
16665,16665,뭘더바/Noun,4,4,0,6.668889629876625e-05,2.2212843466092093e-05,1.0
16666,16666,1~6/Number,4,4,0,6.668889629876625e-05,2.2212843466092093e-05,1.0
16667,16667,망고/Noun,4,0,4,2.2229632099588756e-05,6.663853039827628e-05,1.0
16668,16668,수레/Noun,4,0,4,2.2229632099588756e-05,6.663853039827628e-05,1.0
16669,16669,무안/Noun,4,0,4,2.2229632099588756e-05,6.663853039827628e-05,1.0
16670,16670,월령/Noun,4,4,0,6.668889629876625e-05,2.2212843466092093e-05,1.0
16671,16671,픈/Noun,4,4,0,6.668889629876625e-05,2.2212843466092093e-05,1.0
16672,16672,민속/Noun,4,4,0,6.668889629876625e-05,2.2212843466092093e-05,1.0
16673,16673,콜린파렐/Noun,4,4,0,6.668889629876625e-05,2.2212843466092093e-05,1.0
16674,16674,알레고리/Noun,4,0,4,2.2229632099588756e-05,6.663853039827628e-05,1.0
16675,16675,섯다/Noun,4,4,0,6.668889629876625e-05,2.2212843466092093e-05,1.0
16676,16676,8일/Number,4,4,0,6.668889629876625e-05,2.2212843466092093e-05,1.0
16677,16677,볼프강/Noun,4,4,0,6.668889629876625e-05,2.2212843466092093e-05,1.0
16678,16678,두부/Noun,4,0,4,2.2229632099588756e-05,6.663853039827628e-05,1.0
16679,16679,국군포로/Noun,4,0,4,2.2229632099588756e-05,6.663853039827628e-05,1.0
16680,16680,7.3/Number,4,0,4,2.2229632099588756e-05,6.663853039827628e-05,1.0
16681,16681,야왕/Noun,4,0,4,2.2229632099588756e-05,6.663853039827628e-05,1.0
16682,16682,깅코/Noun,4,0,4,2.2229632099588756e-05,6.663853039827628e-05,1.0
16683,16683,심장이뛴다/Noun,4,4,0,6.668889629876625e-05,2.2212843466092093e-05,1.0
16684,16684,".,.,./Punctuation",4,0,4,2.2229632099588756e-05,6.663853039827628e-05,1.0
16685,16685,요따위/Modifier,4,0,4,2.2229632099588756e-05,6.663853039827628e-05,1.0
16686,16686,메타/Noun,4,4,0,6.668889629876625e-05,2.2212843466092093e-05,1.0
16687,16687,랑드/Noun,4,4,0,6.668889629876625e-05,2.2212843466092093e-05,1.0
16688,16688,세탁/Noun,4,0,4,2.2229632099588756e-05,6.663853039827628e-05,1.0
16689,16689,맥가이버/Noun,4,4,0,6.668889629876625e-05,2.2212843466092093e-05,1.0
16690,16690,종군기자/Noun,4,4,0,6.668889629876625e-05,2.2212843466092093e-05,1.0
16691,16691,~!~!/Punctuation,4,4,0,6.668889629876625e-05,2.2212843466092093e-05,1.0
16692,16692,중지/Noun,4,0,4,2.2229632099588756e-05,6.663853039827628e-05,1.0
16693,16693,지구과학/Noun,4,4,0,6.668889629876625e-05,2.2212843466092093e-05,1.0
16694,16694,소개팅/Noun,4,0,4,2.2229632099588756e-05,6.663853039827628e-05,1.0
16695,16695,단보/Noun,4,4,0,6.668889629876625e-05,2.2212843466092093e-05,1.0
16696,16696,꿰어/Noun,4,0,4,2.2229632099588756e-05,6.663853039827628e-05,1.0
16697,16697,퓨처라마/Noun,4,4,0,6.668889629876625e-05,2.2212843466092093e-05,1.0
16698,16698,천외/Noun,4,4,0,6.668889629876625e-05,2.2212843466092093e-05,1.0
16699,16699,지표/Noun,4,4,0,6.668889629876625e-05,2.2212843466092093e-05,1.0
16700,16700,찡찡거리다/Verb,4,0,4,2.2229632099588756e-05,6.663853039827628e-05,1.0
16701,16701,흉/Noun,4,4,0,6.668889629876625e-05,2.2212843466092093e-05,1.0
16702,16702,이돈/Noun,4,0,4,2.2229632099588756e-05,6.663853039827628e-05,1.0
16703,16703,이발사/Noun,4,0,4,2.2229632099588756e-05,6.663853039827628e-05,1.0
16704,16704,넋두리/Noun,4,0,4,2.2229632099588756e-05,6.663853039827628e-05,1.0
16705,16705,구면/Noun,4,0,4,2.2229632099588756e-05,6.663853039827628e-05,1.0
16706,16706,김공/Noun,4,0,4,2.2229632099588756e-05,6.663853039827628e-05,1.0
16707,16707,이경규/Noun,4,0,4,2.2229632099588756e-05,6.663853039827628e-05,1.0
16708,16708,카자흐스탄/Noun,4,0,4,2.2229632099588756e-05,6.663853039827628e-05,1.0
16709,16709,정하은/Noun,4,0,4,2.2229632099588756e-05,6.663853039827628e-05,1.0
16710,16710,환대/Noun,4,4,0,6.668889629876625e-05,2.2212843466092093e-05,1.0
16711,16711,학도병/Noun,4,4,0,6.668889629876625e-05,2.2212843466092093e-05,1.0
16712,16712,창가/Noun,4,4,0,6.668889629876625e-05,2.2212843466092093e-05,1.0
16713,16713,류현진/Noun,4,0,4,2.2229632099588756e-05,6.663853039827628e-05,1.0
16714,16714,엮어낸/Noun,4,4,0,6.668889629876625e-05,2.2212843466092093e-05,1.0
16715,16715,푸념/Noun,4,0,4,2.2229632099588756e-05,6.663853039827628e-05,1.0
16716,16716,작이/Foreign,4,0,4,2.2229632099588756e-05,6.663853039827628e-05,1.0
16717,16717,창작물/Noun,4,0,4,2.2229632099588756e-05,6.663853039827628e-05,1.0
16718,16718,only/Alpha,4,4,0,6.668889629876625e-05,2.2212843466092093e-05,1.0
16719,16719,앳된/Noun,4,4,0,6.668889629876625e-05,2.2212843466092093e-05,1.0
16720,16720,담표/Noun,4,0,4,2.2229632099588756e-05,6.663853039827628e-05,1.0
16721,16721,소대장/Noun,4,0,4,2.2229632099588756e-05,6.663853039827628e-05,1.0
16722,16722,송하윤/Noun,4,4,0,6.668889629876625e-05,2.2212843466092093e-05,1.0
16723,16723,부지/Noun,4,0,4,2.2229632099588756e-05,6.663853039827628e-05,1.0
16724,16724,아득하다/Adjective,4,4,0,6.668889629876625e-05,2.2212843466092093e-05,1.0
16725,16725,드와이트/Noun,4,4,0,6.668889629876625e-05,2.2212843466092093e-05,1.0
16726,16726,신선도/Noun,4,0,4,2.2229632099588756e-05,6.663853039827628e-05,1.0
16727,16727,로미/Noun,4,4,0,6.668889629876625e-05,2.2212843466092093e-05,1.0
16728,16728,심혈/Noun,4,4,0,6.668889629876625e-05,2.2212843466092093e-05,1.0
16729,16729,맘에듭니/Noun,4,4,0,6.668889629876625e-05,2.2212843466092093e-05,1.0
16730,16730,두만강/Noun,4,4,0,6.668889629876625e-05,2.2212843466092093e-05,1.0
16731,16731,소녀시절/Noun,4,4,0,6.668889629876625e-05,2.2212843466092093e-05,1.0
16732,16732,공영/Noun,4,0,4,2.2229632099588756e-05,6.663853039827628e-05,1.0
16733,16733,아르헨티나/Noun,4,4,0,6.668889629876625e-05,2.2212843466092093e-05,1.0
16734,16734,일곱/Noun,4,0,4,2.2229632099588756e-05,6.663853039827628e-05,1.0
16735,16735,유한/Noun,4,4,0,6.668889629876625e-05,2.2212843466092093e-05,1.0
16736,16736,다이노/Noun,4,0,4,2.2229632099588756e-05,6.663853039827628e-05,1.0
16737,16737,수니/Noun,4,4,0,6.668889629876625e-05,2.2212843466092093e-05,1.0
16738,16738,루이/Noun,4,4,0,6.668889629876625e-05,2.2212843466092093e-05,1.0
16739,16739,ㅆㅅㅌㅊ/KoreanParticle,4,4,0,6.668889629876625e-05,2.2212843466092093e-05,1.0
16740,16740,옥소리/Noun,4,4,0,6.668889629876625e-05,2.2212843466092093e-05,1.0
16741,16741,뺴곤/Noun,4,0,4,2.2229632099588756e-05,6.663853039827628e-05,1.0
16742,16742,엿같/Noun,4,0,4,2.2229632099588756e-05,6.663853039827628e-05,1.0
16743,16743,디어/Noun,4,4,0,6.668889629876625e-05,2.2212843466092093e-05,1.0
16744,16744,소간/Noun,4,4,0,6.668889629876625e-05,2.2212843466092093e-05,1.0
16745,16745,아호/Noun,4,0,4,2.2229632099588756e-05,6.663853039827628e-05,1.0
16746,16746,스타트랙/Noun,4,4,0,6.668889629876625e-05,2.2212843466092093e-05,1.0
16747,16747,금욜/Noun,4,4,0,6.668889629876625e-05,2.2212843466092093e-05,1.0
16748,16748,노팅힐/Noun,4,4,0,6.668889629876625e-05,2.2212843466092093e-05,1.0
16749,16749,품위/Noun,4,4,0,6.668889629876625e-05,2.2212843466092093e-05,1.0
16750,16750,).../Punctuation,4,0,4,2.2229632099588756e-05,6.663853039827628e-05,1.0
16751,16751,노코멘트/Noun,4,0,4,2.2229632099588756e-05,6.663853039827628e-05,1.0
16752,16752,척노리스/Noun,4,4,0,6.668889629876625e-05,2.2212843466092093e-05,1.0
16753,16753,임진강/Noun,4,4,0,6.668889629876625e-05,2.2212843466092093e-05,1.0
16754,16754,혼잡하다/Adjective,4,0,4,2.2229632099588756e-05,6.663853039827628e-05,1.0
16755,16755,복녀/Noun,4,4,0,6.668889629876625e-05,2.2212843466092093e-05,1.0
16756,16756,성대현/Noun,4,0,4,2.2229632099588756e-05,6.663853039827628e-05,1.0
16757,16757,정설/Noun,4,0,4,2.2229632099588756e-05,6.663853039827628e-05,1.0
16758,16758,어흑/Noun,4,4,0,6.668889629876625e-05,2.2212843466092093e-05,1.0
16759,16759,60%/Number,4,0,4,2.2229632099588756e-05,6.663853039827628e-05,1.0
16760,16760,....!!!!/Punctuation,4,4,0,6.668889629876625e-05,2.2212843466092093e-05,1.0
16761,16761,주홍글씨/Noun,4,0,4,2.2229632099588756e-05,6.663853039827628e-05,1.0
16762,16762,흘러내리다/Verb,4,4,0,6.668889629876625e-05,2.2212843466092093e-05,1.0
16763,16763,일견/Noun,4,4,0,6.668889629876625e-05,2.2212843466092093e-05,1.0
16764,16764,몇대/Modifier,4,0,4,2.2229632099588756e-05,6.663853039827628e-05,1.0
16765,16765,덫/Noun,4,0,4,2.2229632099588756e-05,6.663853039827628e-05,1.0
16766,16766,북극곰/Noun,4,4,0,6.668889629876625e-05,2.2212843466092093e-05,1.0
16767,16767,죽대/Noun,4,0,4,2.2229632099588756e-05,6.663853039827628e-05,1.0
16768,16768,치하/Noun,4,4,0,6.668889629876625e-05,2.2212843466092093e-05,1.0
16769,16769,가족사진/Noun,4,4,0,6.668889629876625e-05,2.2212843466092093e-05,1.0
16770,16770,탈선/Noun,4,0,4,2.2229632099588756e-05,6.663853039827628e-05,1.0
16771,16771,반타작/Noun,4,0,4,2.2229632099588756e-05,6.663853039827628e-05,1.0
16772,16772,에네스/Noun,4,0,4,2.2229632099588756e-05,6.663853039827628e-05,1.0
16773,16773,탈락자/Noun,4,0,4,2.2229632099588756e-05,6.663853039827628e-05,1.0
16774,16774,아마데우스/Noun,4,4,0,6.668889629876625e-05,2.2212843466092093e-05,1.0
16775,16775,조웅/Noun,4,0,4,2.2229632099588756e-05,6.663853039827628e-05,1.0
16776,16776,경호원/Noun,4,0,4,2.2229632099588756e-05,6.663853039827628e-05,1.0
16777,16777,아이젠/Noun,4,4,0,6.668889629876625e-05,2.2212843466092093e-05,1.0
16778,16778,라시오/Noun,4,4,0,6.668889629876625e-05,2.2212843466092093e-05,1.0
16779,16779,렌즈/Noun,4,0,4,2.2229632099588756e-05,6.663853039827628e-05,1.0
16780,16780,차라/Noun,4,0,4,2.2229632099588756e-05,6.663853039827628e-05,1.0
16781,16781,새누리당/Noun,4,0,4,2.2229632099588756e-05,6.663853039827628e-05,1.0
16782,16782,중도하차/Noun,4,0,4,2.2229632099588756e-05,6.663853039827628e-05,1.0
16783,16783,홀리랜드/Noun,4,0,4,2.2229632099588756e-05,6.663853039827628e-05,1.0
16784,16784,법석/Noun,4,0,4,2.2229632099588756e-05,6.663853039827628e-05,1.0
16785,16785,마르코/Noun,4,4,0,6.668889629876625e-05,2.2212843466092093e-05,1.0
16786,16786,꼬아놓/Noun,4,0,4,2.2229632099588756e-05,6.663853039827628e-05,1.0
16787,16787,양쿠미/Noun,4,4,0,6.668889629876625e-05,2.2212843466092093e-05,1.0
16788,16788,외제차/Noun,4,0,4,2.2229632099588756e-05,6.663853039827628e-05,1.0
16789,16789,테넌트/Noun,4,4,0,6.668889629876625e-05,2.2212843466092093e-05,1.0
16790,16790,여진/Noun,4,4,0,6.668889629876625e-05,2.2212843466092093e-05,1.0
16791,16791,구경만/Noun,4,0,4,2.2229632099588756e-05,6.663853039827628e-05,1.0
16792,16792,화팅/Noun,4,4,0,6.668889629876625e-05,2.2212843466092093e-05,1.0
16793,16793,사공/Noun,4,0,4,2.2229632099588756e-05,6.663853039827628e-05,1.0
16794,16794,눈꼽만치/Noun,4,0,4,2.2229632099588756e-05,6.663853039827628e-05,1.0
16795,16795,...*_*/Punctuation,4,4,0,6.668889629876625e-05,2.2212843466092093e-05,1.0
16796,16796,초장/Noun,4,0,4,2.2229632099588756e-05,6.663853039827628e-05,1.0
16797,16797,얼토당토않다/Adjective,4,0,4,2.2229632099588756e-05,6.663853039827628e-05,1.0
16798,16798,음란물/Noun,4,0,4,2.2229632099588756e-05,6.663853039827628e-05,1.0
16799,16799,나토/Noun,4,4,0,6.668889629876625e-05,2.2212843466092093e-05,1.0
16800,16800,섬짓/Noun,4,4,0,6.668889629876625e-05,2.2212843466092093e-05,1.0
16801,16801,청산가리/Noun,4,0,4,2.2229632099588756e-05,6.663853039827628e-05,1.0
16802,16802,햅번/Noun,4,4,0,6.668889629876625e-05,2.2212843466092093e-05,1.0
16803,16803,수건/Noun,4,0,4,2.2229632099588756e-05,6.663853039827628e-05,1.0
16804,16804,액트/Noun,4,0,4,2.2229632099588756e-05,6.663853039827628e-05,1.0
16805,16805,반절/Noun,4,0,4,2.2229632099588756e-05,6.663853039827628e-05,1.0
16806,16806,LG/Alpha,4,0,4,2.2229632099588756e-05,6.663853039827628e-05,1.0
16807,16807,이퀄리브리엄/Noun,4,0,4,2.2229632099588756e-05,6.663853039827628e-05,1.0
16808,16808,비디오게임/Noun,4,4,0,6.668889629876625e-05,2.2212843466092093e-05,1.0
16809,16809,쿵쾅거리다/Verb,4,4,0,6.668889629876625e-05,2.2212843466092093e-05,1.0
16810,16810,16분/Number,4,0,4,2.2229632099588756e-05,6.663853039827628e-05,1.0
16811,16811,첫째/Modifier,4,4,0,6.668889629876625e-05,2.2212843466092093e-05,1.0
16812,16812,if/Alpha,4,4,0,6.668889629876625e-05,2.2212843466092093e-05,1.0
16813,16813,시진핑/Noun,4,0,4,2.2229632099588756e-05,6.663853039827628e-05,1.0
16814,16814,뚝딱/Noun,4,0,4,2.2229632099588756e-05,6.663853039827628e-05,1.0
16815,16815,하휘동/Noun,4,0,4,2.2229632099588756e-05,6.663853039827628e-05,1.0
16816,16816,랄것/Noun,4,0,4,2.2229632099588756e-05,6.663853039827628e-05,1.0
16817,16817,할로우/Noun,4,0,4,2.2229632099588756e-05,6.663853039827628e-05,1.0
16818,16818,노크/Noun,4,0,4,2.2229632099588756e-05,6.663853039827628e-05,1.0
16819,16819,착착/Noun,4,4,0,6.668889629876625e-05,2.2212843466092093e-05,1.0
16820,16820,태국인/Noun,4,0,4,2.2229632099588756e-05,6.663853039827628e-05,1.0
16821,16821,호준/Noun,4,4,0,6.668889629876625e-05,2.2212843466092093e-05,1.0
16822,16822,연석/Noun,4,4,0,6.668889629876625e-05,2.2212843466092093e-05,1.0
16823,16823,창시자/Noun,4,0,4,2.2229632099588756e-05,6.663853039827628e-05,1.0
16824,16824,가라데/Noun,4,0,4,2.2229632099588756e-05,6.663853039827628e-05,1.0
16825,16825,이지스함/Noun,4,0,4,2.2229632099588756e-05,6.663853039827628e-05,1.0
16826,16826,픽업/Noun,4,0,4,2.2229632099588756e-05,6.663853039827628e-05,1.0
16827,16827,분풀이/Noun,4,0,4,2.2229632099588756e-05,6.663853039827628e-05,1.0
16828,16828,욘/Noun,4,4,0,6.668889629876625e-05,2.2212843466092093e-05,1.0
16829,16829,에린/Noun,4,4,0,6.668889629876625e-05,2.2212843466092093e-05,1.0
16830,16830,kt/Alpha,4,0,4,2.2229632099588756e-05,6.663853039827628e-05,1.0
16831,16831,가면라이더/Noun,4,0,4,2.2229632099588756e-05,6.663853039827628e-05,1.0
16832,16832,명드/Noun,4,4,0,6.668889629876625e-05,2.2212843466092093e-05,1.0
16833,16833,달라이라마/Noun,4,4,0,6.668889629876625e-05,2.2212843466092093e-05,1.0
16834,16834,오비완/Noun,4,4,0,6.668889629876625e-05,2.2212843466092093e-05,1.0
16835,16835,이든지/Josa,4,0,4,2.2229632099588756e-05,6.663853039827628e-05,1.0
16836,16836,몬드/Noun,4,4,0,6.668889629876625e-05,2.2212843466092093e-05,1.0
16837,16837,돌풍/Noun,4,4,0,6.668889629876625e-05,2.2212843466092093e-05,1.0
16838,16838,홀린/Noun,4,4,0,6.668889629876625e-05,2.2212843466092093e-05,1.0
16839,16839,오취/Noun,4,0,4,2.2229632099588756e-05,6.663853039827628e-05,1.0
16840,16840,카다/Noun,4,0,4,2.2229632099588756e-05,6.663853039827628e-05,1.0
16841,16841,엔돌핀/Noun,4,4,0,6.668889629876625e-05,2.2212843466092093e-05,1.0
16842,16842,이소재/Noun,4,0,4,2.2229632099588756e-05,6.663853039827628e-05,1.0
16843,16843,잠수/Noun,4,0,4,2.2229632099588756e-05,6.663853039827628e-05,1.0
16844,16844,잡아가다/Verb,4,0,4,2.2229632099588756e-05,6.663853039827628e-05,1.0
16845,16845,-_-^/Punctuation,4,0,4,2.2229632099588756e-05,6.663853039827628e-05,1.0
16846,16846,열두/Modifier,4,0,4,2.2229632099588756e-05,6.663853039827628e-05,1.0
16847,16847,슬펏음/Noun,4,4,0,6.668889629876625e-05,2.2212843466092093e-05,1.0
16848,16848,pm/Alpha,4,4,0,6.668889629876625e-05,2.2212843466092093e-05,1.0
16849,16849,맹룡과강/Noun,4,4,0,6.668889629876625e-05,2.2212843466092093e-05,1.0
16850,16850,설설/Noun,4,0,4,2.2229632099588756e-05,6.663853039827628e-05,1.0
16851,16851,궁지/Noun,4,4,0,6.668889629876625e-05,2.2212843466092093e-05,1.0
16852,16852,코로/Noun,4,0,4,2.2229632099588756e-05,6.663853039827628e-05,1.0
16853,16853,마르셀/Noun,4,4,0,6.668889629876625e-05,2.2212843466092093e-05,1.0
16854,16854,순진무구/Noun,4,4,0,6.668889629876625e-05,2.2212843466092093e-05,1.0
16855,16855,유카/Noun,4,4,0,6.668889629876625e-05,2.2212843466092093e-05,1.0
16856,16856,손익/Noun,4,0,4,2.2229632099588756e-05,6.663853039827628e-05,1.0
16857,16857,핍박하다/Adjective,4,0,4,2.2229632099588756e-05,6.663853039827628e-05,1.0
16858,16858,아모레/Noun,4,4,0,6.668889629876625e-05,2.2212843466092093e-05,1.0
16859,16859,round/Alpha,4,0,4,2.2229632099588756e-05,6.663853039827628e-05,1.0
16860,16860,갈매기/Noun,4,4,0,6.668889629876625e-05,2.2212843466092093e-05,1.0
16861,16861,남구/Noun,4,4,0,6.668889629876625e-05,2.2212843466092093e-05,1.0
16862,16862,버닝/Noun,4,4,0,6.668889629876625e-05,2.2212843466092093e-05,1.0
16863,16863,삼은/Noun,4,0,4,2.2229632099588756e-05,6.663853039827628e-05,1.0
16864,16864,1997/Number,4,4,0,6.668889629876625e-05,2.2212843466092093e-05,1.0
16865,16865,정경/Noun,4,4,0,6.668889629876625e-05,2.2212843466092093e-05,1.0
16866,16866,덤비다/Verb,4,0,4,2.2229632099588756e-05,6.663853039827628e-05,1.0
16867,16867,출세/Noun,4,0,4,2.2229632099588756e-05,6.663853039827628e-05,1.0
16868,16868,뻔뻔스럽다/Adjective,4,0,4,2.2229632099588756e-05,6.663853039827628e-05,1.0
16869,16869,명성황후/Noun,4,0,4,2.2229632099588756e-05,6.663853039827628e-05,1.0
16870,16870,최원영/Noun,4,4,0,6.668889629876625e-05,2.2212843466092093e-05,1.0
16871,16871,^^;;;/Punctuation,4,0,4,2.2229632099588756e-05,6.663853039827628e-05,1.0
16872,16872,정운택/Noun,4,0,4,2.2229632099588756e-05,6.663853039827628e-05,1.0
16873,16873,부스러기/Noun,4,0,4,2.2229632099588756e-05,6.663853039827628e-05,1.0
16874,16874,해죽/Noun,4,0,4,2.2229632099588756e-05,6.663853039827628e-05,1.0
16875,16875,20일/Number,4,4,0,6.668889629876625e-05,2.2212843466092093e-05,1.0
16876,16876,떫/Noun,4,0,4,2.2229632099588756e-05,6.663853039827628e-05,1.0
16877,16877,증상/Noun,4,0,4,2.2229632099588756e-05,6.663853039827628e-05,1.0
16878,16878,혜수/Noun,4,4,0,6.668889629876625e-05,2.2212843466092093e-05,1.0
16879,16879,대도/Foreign,4,0,4,2.2229632099588756e-05,6.663853039827628e-05,1.0
16880,16880,57/Number,4,0,4,2.2229632099588756e-05,6.663853039827628e-05,1.0
16881,16881,성대모사/Noun,4,0,4,2.2229632099588756e-05,6.663853039827628e-05,1.0
16882,16882,설렁설렁/Adverb,4,0,4,2.2229632099588756e-05,6.663853039827628e-05,1.0
16883,16883,황금시간대/Noun,4,0,4,2.2229632099588756e-05,6.663853039827628e-05,1.0
16884,16884,썽/Noun,4,4,0,6.668889629876625e-05,2.2212843466092093e-05,1.0
16885,16885,충무공/Noun,4,0,4,2.2229632099588756e-05,6.663853039827628e-05,1.0
16886,16886,디디/Noun,4,4,0,6.668889629876625e-05,2.2212843466092093e-05,1.0
16887,16887,이라든지/Josa,4,0,4,2.2229632099588756e-05,6.663853039827628e-05,1.0
16888,16888,two/Alpha,4,4,0,6.668889629876625e-05,2.2212843466092093e-05,1.0
16889,16889,나이라/Noun,4,4,0,6.668889629876625e-05,2.2212843466092093e-05,1.0
16890,16890,집약/Noun,4,4,0,6.668889629876625e-05,2.2212843466092093e-05,1.0
16891,16891,콩가/Noun,4,0,4,2.2229632099588756e-05,6.663853039827628e-05,1.0
16892,16892,말빨/Noun,4,4,0,6.668889629876625e-05,2.2212843466092093e-05,1.0
16893,16893,;;?/Punctuation,4,0,4,2.2229632099588756e-05,6.663853039827628e-05,1.0
16894,16894,고이즈미/Noun,4,0,4,2.2229632099588756e-05,6.663853039827628e-05,1.0
16895,16895,르네/Noun,4,4,0,6.668889629876625e-05,2.2212843466092093e-05,1.0
16896,16896,랜디/Noun,4,4,0,6.668889629876625e-05,2.2212843466092093e-05,1.0
16897,16897,로튼/Noun,4,0,4,2.2229632099588756e-05,6.663853039827628e-05,1.0
16898,16898,뒤로/Noun,4,4,0,6.668889629876625e-05,2.2212843466092093e-05,1.0
16899,16899,사계절/Noun,4,4,0,6.668889629876625e-05,2.2212843466092093e-05,1.0
16900,16900,없드/Noun,4,0,4,2.2229632099588756e-05,6.663853039827628e-05,1.0
16901,16901,팻/Noun,4,4,0,6.668889629876625e-05,2.2212843466092093e-05,1.0
16902,16902,악도/Noun,4,4,0,6.668889629876625e-05,2.2212843466092093e-05,1.0
16903,16903,이집/Noun,4,0,4,2.2229632099588756e-05,6.663853039827628e-05,1.0
16904,16904,최공/Noun,4,4,0,6.668889629876625e-05,2.2212843466092093e-05,1.0
16905,16905,샷건/Noun,4,0,4,2.2229632099588756e-05,6.663853039827628e-05,1.0
16906,16906,촌극/Noun,4,0,4,2.2229632099588756e-05,6.663853039827628e-05,1.0
16907,16907,억측/Noun,4,0,4,2.2229632099588756e-05,6.663853039827628e-05,1.0
16908,16908,팬픽/Noun,4,0,4,2.2229632099588756e-05,6.663853039827628e-05,1.0
16909,16909,0.3/Number,4,0,4,2.2229632099588756e-05,6.663853039827628e-05,1.0
16910,16910,신나요/Noun,4,4,0,6.668889629876625e-05,2.2212843466092093e-05,1.0
16911,16911,깝치/Noun,4,0,4,2.2229632099588756e-05,6.663853039827628e-05,1.0
16912,16912,레골라스/Noun,4,4,0,6.668889629876625e-05,2.2212843466092093e-05,1.0
16913,16913,이글아이/Noun,4,0,4,2.2229632099588756e-05,6.663853039827628e-05,1.0
16914,16914,걸표/Noun,4,0,4,2.2229632099588756e-05,6.663853039827628e-05,1.0
16915,16915,가축/Noun,4,4,0,6.668889629876625e-05,2.2212843466092093e-05,1.0
16916,16916,패착/Noun,4,0,4,2.2229632099588756e-05,6.663853039827628e-05,1.0
16917,16917,목말/Noun,4,4,0,6.668889629876625e-05,2.2212843466092093e-05,1.0
16918,16918,스티브유/Noun,4,0,4,2.2229632099588756e-05,6.663853039827628e-05,1.0
16919,16919,유야/Noun,4,4,0,6.668889629876625e-05,2.2212843466092093e-05,1.0
16920,16920,쫄아/Noun,4,0,4,2.2229632099588756e-05,6.663853039827628e-05,1.0
16921,16921,국한/Noun,4,4,0,6.668889629876625e-05,2.2212843466092093e-05,1.0
16922,16922,반동/Noun,4,0,4,2.2229632099588756e-05,6.663853039827628e-05,1.0
16923,16923,껄렁/Adverb,4,0,4,2.2229632099588756e-05,6.663853039827628e-05,1.0
16924,16924,알프/Noun,4,4,0,6.668889629876625e-05,2.2212843466092093e-05,1.0
16925,16925,카프/Noun,4,4,0,6.668889629876625e-05,2.2212843466092093e-05,1.0
16926,16926,~~~~~~~~~~~~/Punctuation,4,4,0,6.668889629876625e-05,2.2212843466092093e-05,1.0
16927,16927,톱니바퀴/Noun,4,4,0,6.668889629876625e-05,2.2212843466092093e-05,1.0
16928,16928,테닥/Noun,4,4,0,6.668889629876625e-05,2.2212843466092093e-05,1.0
16929,16929,33년/Number,4,0,4,2.2229632099588756e-05,6.663853039827628e-05,1.0
16930,16930,착상/Noun,4,0,4,2.2229632099588756e-05,6.663853039827628e-05,1.0
16931,16931,풍비박산/Noun,4,0,4,2.2229632099588756e-05,6.663853039827628e-05,1.0
16932,16932,강서연/Noun,4,0,4,2.2229632099588756e-05,6.663853039827628e-05,1.0
16933,16933,곰곰하다/Adjective,4,4,0,6.668889629876625e-05,2.2212843466092093e-05,1.0
16934,16934,박해/Noun,4,4,0,6.668889629876625e-05,2.2212843466092093e-05,1.0
16935,16935,옥한흠/Noun,4,4,0,6.668889629876625e-05,2.2212843466092093e-05,1.0
16936,16936,대에나/Foreign,4,0,4,2.2229632099588756e-05,6.663853039827628e-05,1.0
16937,16937,만들엇을까/Noun,4,0,4,2.2229632099588756e-05,6.663853039827628e-05,1.0
16938,16938,ㅠㅅㅠ/KoreanParticle,4,4,0,6.668889629876625e-05,2.2212843466092093e-05,1.0
16939,16939,..--;/Punctuation,4,0,4,2.2229632099588756e-05,6.663853039827628e-05,1.0
16940,16940,똥꾸/Noun,4,0,4,2.2229632099588756e-05,6.663853039827628e-05,1.0
16941,16941,불도/Noun,4,0,4,2.2229632099588756e-05,6.663853039827628e-05,1.0
16942,16942,엘리펀트/Noun,4,4,0,6.668889629876625e-05,2.2212843466092093e-05,1.0
16943,16943,욀케/Noun,4,4,0,6.668889629876625e-05,2.2212843466092093e-05,1.0
16944,16944,바나/Noun,4,4,0,6.668889629876625e-05,2.2212843466092093e-05,1.0
16945,16945,노땅/Noun,4,0,4,2.2229632099588756e-05,6.663853039827628e-05,1.0
16946,16946,마루타/Noun,4,0,4,2.2229632099588756e-05,6.663853039827628e-05,1.0
16947,16947,대쉬/Noun,4,0,4,2.2229632099588756e-05,6.663853039827628e-05,1.0
16948,16948,빅엿/Noun,4,0,4,2.2229632099588756e-05,6.663853039827628e-05,1.0
16949,16949,강재/Noun,4,4,0,6.668889629876625e-05,2.2212843466092093e-05,1.0
16950,16950,해투/Noun,4,0,4,2.2229632099588756e-05,6.663853039827628e-05,1.0
16951,16951,겁쟁이/Noun,4,4,0,6.668889629876625e-05,2.2212843466092093e-05,1.0
16952,16952,액자/Noun,4,4,0,6.668889629876625e-05,2.2212843466092093e-05,1.0
16953,16953,우희/Noun,4,4,0,6.668889629876625e-05,2.2212843466092093e-05,1.0
16954,16954,got/Alpha,4,4,0,6.668889629876625e-05,2.2212843466092093e-05,1.0
16955,16955,무속인/Noun,4,0,4,2.2229632099588756e-05,6.663853039827628e-05,1.0
16956,16956,".,.,.,/Punctuation",4,0,4,2.2229632099588756e-05,6.663853039827628e-05,1.0
16957,16957,china/Alpha,4,0,4,2.2229632099588756e-05,6.663853039827628e-05,1.0
16958,16958,꼽자/Noun,4,4,0,6.668889629876625e-05,2.2212843466092093e-05,1.0
16959,16959,",?/Punctuation",4,0,4,2.2229632099588756e-05,6.663853039827628e-05,1.0
16960,16960,게이바/Noun,4,0,4,2.2229632099588756e-05,6.663853039827628e-05,1.0
16961,16961,만호/Noun,4,4,0,6.668889629876625e-05,2.2212843466092093e-05,1.0
16962,16962,강동/Noun,4,4,0,6.668889629876625e-05,2.2212843466092093e-05,1.0
16963,16963,겸손/Noun,4,4,0,6.668889629876625e-05,2.2212843466092093e-05,1.0
16964,16964,정철/Noun,4,4,0,6.668889629876625e-05,2.2212843466092093e-05,1.0
16965,16965,어인/Modifier,4,0,4,2.2229632099588756e-05,6.663853039827628e-05,1.0
16966,16966,으루/Noun,4,0,4,2.2229632099588756e-05,6.663853039827628e-05,1.0
16967,16967,완전체/Noun,4,4,0,6.668889629876625e-05,2.2212843466092093e-05,1.0
16968,16968,검심/Noun,4,4,0,6.668889629876625e-05,2.2212843466092093e-05,1.0
16969,16969,까지야/Josa,4,0,4,2.2229632099588756e-05,6.663853039827628e-05,1.0
16970,16970,하연수/Noun,4,4,0,6.668889629876625e-05,2.2212843466092093e-05,1.0
16971,16971,생리/Noun,4,4,0,6.668889629876625e-05,2.2212843466092093e-05,1.0
16972,16972,좋았슴/Noun,4,4,0,6.668889629876625e-05,2.2212843466092093e-05,1.0
16973,16973,오뚜기/Noun,4,0,4,2.2229632099588756e-05,6.663853039827628e-05,1.0
16974,16974,Bravo/Alpha,4,4,0,6.668889629876625e-05,2.2212843466092093e-05,1.0
16975,16975,성도착/Noun,4,0,4,2.2229632099588756e-05,6.663853039827628e-05,1.0
16976,16976,한동/Noun,4,4,0,6.668889629876625e-05,2.2212843466092093e-05,1.0
16977,16977,소규모/Noun,4,0,4,2.2229632099588756e-05,6.663853039827628e-05,1.0
16978,16978,명나라/Noun,4,0,4,2.2229632099588756e-05,6.663853039827628e-05,1.0
16979,16979,~!!^^/Punctuation,4,4,0,6.668889629876625e-05,2.2212843466092093e-05,1.0
16980,16980,테루/Noun,4,4,0,6.668889629876625e-05,2.2212843466092093e-05,1.0
16981,16981,씨댕/Noun,4,0,4,2.2229632099588756e-05,6.663853039827628e-05,1.0
16982,16982,김지미/Noun,4,4,0,6.668889629876625e-05,2.2212843466092093e-05,1.0
16983,16983,드웨/Noun,4,0,4,2.2229632099588756e-05,6.663853039827628e-05,1.0
16984,16984,엠넷/Noun,4,0,4,2.2229632099588756e-05,6.663853039827628e-05,1.0
16985,16985,심사평/Noun,4,0,4,2.2229632099588756e-05,6.663853039827628e-05,1.0
16986,16986,기성세대/Noun,4,4,0,6.668889629876625e-05,2.2212843466092093e-05,1.0
16987,16987,goood/Alpha,4,4,0,6.668889629876625e-05,2.2212843466092093e-05,1.0
16988,16988,셀룰러/Noun,4,0,4,2.2229632099588756e-05,6.663853039827628e-05,1.0
16989,16989,울컥울컥/Adverb,4,4,0,6.668889629876625e-05,2.2212843466092093e-05,1.0
16990,16990,고나은/Noun,4,0,4,2.2229632099588756e-05,6.663853039827628e-05,1.0
16991,16991,어슬프/Noun,4,0,4,2.2229632099588756e-05,6.663853039827628e-05,1.0
16992,16992,날/Foreign,4,0,4,2.2229632099588756e-05,6.663853039827628e-05,1.0
16993,16993,회보/Noun,4,4,0,6.668889629876625e-05,2.2212843466092093e-05,1.0
16994,16994,슈퍼배드/Noun,4,4,0,6.668889629876625e-05,2.2212843466092093e-05,1.0
16995,16995,삭발/Noun,4,0,4,2.2229632099588756e-05,6.663853039827628e-05,1.0
16996,16996,완다/Noun,4,4,0,6.668889629876625e-05,2.2212843466092093e-05,1.0
16997,16997,야합/Noun,4,0,4,2.2229632099588756e-05,6.663853039827628e-05,1.0
16998,16998,아릿하다/Adjective,4,4,0,6.668889629876625e-05,2.2212843466092093e-05,1.0
16999,16999,이승환/Noun,4,4,0,6.668889629876625e-05,2.2212843466092093e-05,1.0
17000,17000,치루/Noun,4,4,0,6.668889629876625e-05,2.2212843466092093e-05,1.0
17001,17001,야훼/Noun,4,0,4,2.2229632099588756e-05,6.663853039827628e-05,1.0
17002,17002,▽/Foreign,4,4,0,6.668889629876625e-05,2.2212843466092093e-05,1.0
17003,17003,히피/Noun,4,4,0,6.668889629876625e-05,2.2212843466092093e-05,1.0
17004,17004,독실하다/Adjective,4,0,4,2.2229632099588756e-05,6.663853039827628e-05,1.0
17005,17005,파렴치하다/Adjective,4,0,4,2.2229632099588756e-05,6.663853039827628e-05,1.0
17006,17006,사기영화/Noun,4,0,4,2.2229632099588756e-05,6.663853039827628e-05,1.0
17007,17007,효효효/Noun,4,0,4,2.2229632099588756e-05,6.663853039827628e-05,1.0
17008,17008,전혜진/Noun,4,0,4,2.2229632099588756e-05,6.663853039827628e-05,1.0
17009,17009,펜대/Noun,4,0,4,2.2229632099588756e-05,6.663853039827628e-05,1.0
17010,17010,모히칸/Noun,4,4,0,6.668889629876625e-05,2.2212843466092093e-05,1.0
17011,17011,글러/Noun,4,0,4,2.2229632099588756e-05,6.663853039827628e-05,1.0
17012,17012,정민/Noun,4,4,0,6.668889629876625e-05,2.2212843466092093e-05,1.0
17013,17013,영홥/Noun,4,0,4,2.2229632099588756e-05,6.663853039827628e-05,1.0
17014,17014,돌직구/Noun,4,4,0,6.668889629876625e-05,2.2212843466092093e-05,1.0
17015,17015,♥♥♥♥♥♥/Foreign,4,4,0,6.668889629876625e-05,2.2212843466092093e-05,1.0
17016,17016,씨알/Noun,4,0,4,2.2229632099588756e-05,6.663853039827628e-05,1.0
17017,17017,여성향/Noun,4,0,4,2.2229632099588756e-05,6.663853039827628e-05,1.0
17018,17018,우상화/Noun,4,0,4,2.2229632099588756e-05,6.663853039827628e-05,1.0
17019,17019,천박/Noun,4,0,4,2.2229632099588756e-05,6.663853039827628e-05,1.0
17020,17020,썻는/Noun,4,0,4,2.2229632099588756e-05,6.663853039827628e-05,1.0
17021,17021,글쌔/Noun,4,0,4,2.2229632099588756e-05,6.663853039827628e-05,1.0
17022,17022,꺽꺽/Noun,4,4,0,6.668889629876625e-05,2.2212843466092093e-05,1.0
17023,17023,La/Alpha,4,4,0,6.668889629876625e-05,2.2212843466092093e-05,1.0
17024,17024,부동/Noun,4,0,4,2.2229632099588756e-05,6.663853039827628e-05,1.0
17025,17025,독신/Noun,4,0,4,2.2229632099588756e-05,6.663853039827628e-05,1.0
17026,17026,승하/Noun,4,4,0,6.668889629876625e-05,2.2212843466092093e-05,1.0
17027,17027,뮤직뱅크/Noun,4,0,4,2.2229632099588756e-05,6.663853039827628e-05,1.0
17028,17028,몸둘/Noun,4,0,4,2.2229632099588756e-05,6.663853039827628e-05,1.0
17029,17029,도취/Noun,4,0,4,2.2229632099588756e-05,6.663853039827628e-05,1.0
17030,17030,...^^;/Punctuation,4,4,0,6.668889629876625e-05,2.2212843466092093e-05,1.0
17031,17031,최약/Noun,4,0,4,2.2229632099588756e-05,6.663853039827628e-05,1.0
17032,17032,수요일/Noun,4,4,0,6.668889629876625e-05,2.2212843466092093e-05,1.0
17033,17033,초등생/Noun,4,0,4,2.2229632099588756e-05,6.663853039827628e-05,1.0
17034,17034,웃낌/Noun,4,4,0,6.668889629876625e-05,2.2212843466092093e-05,1.0
17035,17035,빨아들이다/Verb,4,4,0,6.668889629876625e-05,2.2212843466092093e-05,1.0
17036,17036,파리스/Noun,4,4,0,6.668889629876625e-05,2.2212843466092093e-05,1.0
17037,17037,김춘추/Noun,4,0,4,2.2229632099588756e-05,6.663853039827628e-05,1.0
17038,17038,유랑/Noun,4,0,4,2.2229632099588756e-05,6.663853039827628e-05,1.0
17039,17039,Wow/Alpha,4,4,0,6.668889629876625e-05,2.2212843466092093e-05,1.0
17040,17040,실베스터/Noun,4,4,0,6.668889629876625e-05,2.2212843466092093e-05,1.0
17041,17041,봣습/Noun,4,4,0,6.668889629876625e-05,2.2212843466092093e-05,1.0
17042,17042,재및/Noun,4,4,0,6.668889629876625e-05,2.2212843466092093e-05,1.0
17043,17043,dead/Alpha,4,0,4,2.2229632099588756e-05,6.663853039827628e-05,1.0
17044,17044,배분/Noun,4,0,4,2.2229632099588756e-05,6.663853039827628e-05,1.0
17045,17045,학구/Noun,4,4,0,6.668889629876625e-05,2.2212843466092093e-05,1.0
17046,17046,험프리/Noun,4,4,0,6.668889629876625e-05,2.2212843466092093e-05,1.0
17047,17047,박순희/Noun,4,0,4,2.2229632099588756e-05,6.663853039827628e-05,1.0
17048,17048,머겅다/Verb,4,0,4,2.2229632099588756e-05,6.663853039827628e-05,1.0
17049,17049,생수/Noun,4,0,4,2.2229632099588756e-05,6.663853039827628e-05,1.0
17050,17050,완성형/Noun,4,4,0,6.668889629876625e-05,2.2212843466092093e-05,1.0
17051,17051,일본말/Noun,4,0,4,2.2229632099588756e-05,6.663853039827628e-05,1.0
17052,17052,가랑이/Noun,4,0,4,2.2229632099588756e-05,6.663853039827628e-05,1.0
17053,17053,불행중/Noun,4,0,4,2.2229632099588756e-05,6.663853039827628e-05,1.0
17054,17054,찌릿/Noun,4,4,0,6.668889629876625e-05,2.2212843466092093e-05,1.0
17055,17055,메롱/Noun,4,0,4,2.2229632099588756e-05,6.663853039827628e-05,1.0
17056,17056,대용/Noun,4,0,4,2.2229632099588756e-05,6.663853039827628e-05,1.0
17057,17057,케나/Noun,4,0,4,2.2229632099588756e-05,6.663853039827628e-05,1.0
17058,17058,....-_-/Punctuation,4,0,4,2.2229632099588756e-05,6.663853039827628e-05,1.0
17059,17059,Blockbuster/Alpha,4,4,0,6.668889629876625e-05,2.2212843466092093e-05,1.0
17060,17060,해피해피/Noun,4,0,4,2.2229632099588756e-05,6.663853039827628e-05,1.0
17061,17061,퇴행/Noun,4,0,4,2.2229632099588756e-05,6.663853039827628e-05,1.0
17062,17062,광속/Noun,4,0,4,2.2229632099588756e-05,6.663853039827628e-05,1.0
17063,17063,2.0/Number,4,0,4,2.2229632099588756e-05,6.663853039827628e-05,1.0
17064,17064,밧슈/Noun,4,4,0,6.668889629876625e-05,2.2212843466092093e-05,1.0
17065,17065,Life/Alpha,4,4,0,6.668889629876625e-05,2.2212843466092093e-05,1.0
17066,17066,깜둥이/Noun,4,0,4,2.2229632099588756e-05,6.663853039827628e-05,1.0
17067,17067,체코/Noun,4,4,0,6.668889629876625e-05,2.2212843466092093e-05,1.0
17068,17068,배낌/Noun,4,0,4,2.2229632099588756e-05,6.663853039827628e-05,1.0
17069,17069,수색대/Noun,4,0,4,2.2229632099588756e-05,6.663853039827628e-05,1.0
17070,17070,잘라먹다/Verb,4,0,4,2.2229632099588756e-05,6.663853039827628e-05,1.0
17071,17071,이하일/Noun,4,0,4,2.2229632099588756e-05,6.663853039827628e-05,1.0
17072,17072,강문/Noun,4,4,0,6.668889629876625e-05,2.2212843466092093e-05,1.0
17073,17073,보답/Noun,4,4,0,6.668889629876625e-05,2.2212843466092093e-05,1.0
17074,17074,푸드/Noun,4,4,0,6.668889629876625e-05,2.2212843466092093e-05,1.0
17075,17075,DDR/Alpha,4,0,4,2.2229632099588756e-05,6.663853039827628e-05,1.0
17076,17076,관영/Noun,4,0,4,2.2229632099588756e-05,6.663853039827628e-05,1.0
17077,17077,아스트랄/Noun,4,0,4,2.2229632099588756e-05,6.663853039827628e-05,1.0
17078,17078,권오중/Noun,4,0,4,2.2229632099588756e-05,6.663853039827628e-05,1.0
17079,17079,윤숙/Noun,4,4,0,6.668889629876625e-05,2.2212843466092093e-05,1.0
17080,17080,조두순/Noun,4,4,0,6.668889629876625e-05,2.2212843466092093e-05,1.0
17081,17081,도의/Foreign,4,4,0,6.668889629876625e-05,2.2212843466092093e-05,1.0
17082,17082,풍도/Noun,4,0,4,2.2229632099588756e-05,6.663853039827628e-05,1.0
17083,17083,오딘/Noun,4,0,4,2.2229632099588756e-05,6.663853039827628e-05,1.0
17084,17084,담하다/Adjective,4,0,4,2.2229632099588756e-05,6.663853039827628e-05,1.0
17085,17085,평해/Noun,4,0,4,2.2229632099588756e-05,6.663853039827628e-05,1.0
17086,17086,이외수/Noun,4,0,4,2.2229632099588756e-05,6.663853039827628e-05,1.0
17087,17087,캄캄하다/Adjective,4,0,4,2.2229632099588756e-05,6.663853039827628e-05,1.0
17088,17088,스즈미/Noun,4,4,0,6.668889629876625e-05,2.2212843466092093e-05,1.0
17089,17089,에이전트/Noun,4,0,4,2.2229632099588756e-05,6.663853039827628e-05,1.0
17090,17090,조페시/Noun,4,4,0,6.668889629876625e-05,2.2212843466092093e-05,1.0
17091,17091,꺼림칙하다/Adjective,4,0,4,2.2229632099588756e-05,6.663853039827628e-05,1.0
17092,17092,무뇌아/Noun,4,0,4,2.2229632099588756e-05,6.663853039827628e-05,1.0
17093,17093,부감/Noun,4,4,0,6.668889629876625e-05,2.2212843466092093e-05,1.0
17094,17094,로류/Noun,4,0,4,2.2229632099588756e-05,6.663853039827628e-05,1.0
17095,17095,강은비/Noun,4,0,4,2.2229632099588756e-05,6.663853039827628e-05,1.0
17096,17096,김보라/Noun,4,4,0,6.668889629876625e-05,2.2212843466092093e-05,1.0
17097,17097,변죽/Noun,4,0,4,2.2229632099588756e-05,6.663853039827628e-05,1.0
17098,17098,보루/Noun,4,4,0,6.668889629876625e-05,2.2212843466092093e-05,1.0
17099,17099,아가페/Noun,4,4,0,6.668889629876625e-05,2.2212843466092093e-05,1.0
17100,17100,페지/Noun,4,0,4,2.2229632099588756e-05,6.663853039827628e-05,1.0
17101,17101,행해/Noun,4,4,0,6.668889629876625e-05,2.2212843466092093e-05,1.0
17102,17102,정주/Noun,4,4,0,6.668889629876625e-05,2.2212843466092093e-05,1.0
17103,17103,유호/Noun,4,0,4,2.2229632099588756e-05,6.663853039827628e-05,1.0
17104,17104,째즈/Noun,4,4,0,6.668889629876625e-05,2.2212843466092093e-05,1.0
17105,17105,검프/Noun,4,4,0,6.668889629876625e-05,2.2212843466092093e-05,1.0
17106,17106,제니/Noun,4,4,0,6.668889629876625e-05,2.2212843466092093e-05,1.0
17107,17107,너비/Noun,4,4,0,6.668889629876625e-05,2.2212843466092093e-05,1.0
17108,17108,수배/Noun,4,0,4,2.2229632099588756e-05,6.663853039827628e-05,1.0
17109,17109,프란시스/Noun,4,0,4,2.2229632099588756e-05,6.663853039827628e-05,1.0
17110,17110,으웩/Noun,4,0,4,2.2229632099588756e-05,6.663853039827628e-05,1.0
17111,17111,메리포핀스/Noun,4,4,0,6.668889629876625e-05,2.2212843466092093e-05,1.0
17112,17112,창자/Noun,4,0,4,2.2229632099588756e-05,6.663853039827628e-05,1.0
17113,17113,멌/Noun,4,4,0,6.668889629876625e-05,2.2212843466092093e-05,1.0
17114,17114,콜롬비아나/Noun,4,0,4,2.2229632099588756e-05,6.663853039827628e-05,1.0
17115,17115,자업자득/Noun,4,0,4,2.2229632099588756e-05,6.663853039827628e-05,1.0
17116,17116,윤승아/Noun,4,0,4,2.2229632099588756e-05,6.663853039827628e-05,1.0
17117,17117,카일/Noun,4,4,0,6.668889629876625e-05,2.2212843466092093e-05,1.0
17118,17118,카와이/Noun,4,4,0,6.668889629876625e-05,2.2212843466092093e-05,1.0
17119,17119,개낚였/Noun,4,0,4,2.2229632099588756e-05,6.663853039827628e-05,1.0
17120,17120,지해/Noun,4,0,4,2.2229632099588756e-05,6.663853039827628e-05,1.0
17121,17121,팅팅/Noun,4,4,0,6.668889629876625e-05,2.2212843466092093e-05,1.0
17122,17122,때봣/Noun,4,4,0,6.668889629876625e-05,2.2212843466092093e-05,1.0
17123,17123,이지나도/Foreign,4,4,0,6.668889629876625e-05,2.2212843466092093e-05,1.0
17124,17124,서버/Noun,4,4,0,6.668889629876625e-05,2.2212843466092093e-05,1.0
17125,17125,불순/Noun,4,0,4,2.2229632099588756e-05,6.663853039827628e-05,1.0
17126,17126,스티플러/Noun,4,4,0,6.668889629876625e-05,2.2212843466092093e-05,1.0
17127,17127,주력/Noun,4,0,4,2.2229632099588756e-05,6.663853039827628e-05,1.0
17128,17128,트림/Noun,4,0,4,2.2229632099588756e-05,6.663853039827628e-05,1.0
17129,17129,임금님/Noun,4,0,4,2.2229632099588756e-05,6.663853039827628e-05,1.0
17130,17130,흐트러/Noun,4,0,4,2.2229632099588756e-05,6.663853039827628e-05,1.0
17131,17131,추정/Noun,4,4,0,6.668889629876625e-05,2.2212843466092093e-05,1.0
17132,17132,교만하다/Adjective,4,0,4,2.2229632099588756e-05,6.663853039827628e-05,1.0
17133,17133,억울/Noun,4,0,4,2.2229632099588756e-05,6.663853039827628e-05,1.0
17134,17134,인민군/Noun,4,0,4,2.2229632099588756e-05,6.663853039827628e-05,1.0
17135,17135,판도라/Noun,4,0,4,2.2229632099588756e-05,6.663853039827628e-05,1.0
17136,17136,설산/Noun,4,4,0,6.668889629876625e-05,2.2212843466092093e-05,1.0
17137,17137,무에타이/Noun,4,0,4,2.2229632099588756e-05,6.663853039827628e-05,1.0
17138,17138,훌룡하/Noun,4,4,0,6.668889629876625e-05,2.2212843466092093e-05,1.0
17139,17139,!!!!!!!!!!!!!!!!!!/Punctuation,4,4,0,6.668889629876625e-05,2.2212843466092093e-05,1.0
17140,17140,엇다/Noun,4,0,4,2.2229632099588756e-05,6.663853039827628e-05,1.0
17141,17141,뻔뻔/Noun,4,0,4,2.2229632099588756e-05,6.663853039827628e-05,1.0
17142,17142,근간/Noun,4,4,0,6.668889629876625e-05,2.2212843466092093e-05,1.0
17143,17143,인치/Noun,4,4,0,6.668889629876625e-05,2.2212843466092093e-05,1.0
17144,17144,sad/Alpha,4,4,0,6.668889629876625e-05,2.2212843466092093e-05,1.0
17145,17145,용팔이/Noun,4,4,0,6.668889629876625e-05,2.2212843466092093e-05,1.0
17146,17146,송창의/Noun,4,4,0,6.668889629876625e-05,2.2212843466092093e-05,1.0
17147,17147,요동치다/Verb,4,4,0,6.668889629876625e-05,2.2212843466092093e-05,1.0
17148,17148,초식/Noun,4,4,0,6.668889629876625e-05,2.2212843466092093e-05,1.0
17149,17149,슷/Noun,4,0,4,2.2229632099588756e-05,6.663853039827628e-05,1.0
17150,17150,쫄깃해/Noun,4,4,0,6.668889629876625e-05,2.2212843466092093e-05,1.0
17151,17151,철면피/Noun,4,0,4,2.2229632099588756e-05,6.663853039827628e-05,1.0
17152,17152,텔링/Noun,4,0,4,2.2229632099588756e-05,6.663853039827628e-05,1.0
17153,17153,체육관/Noun,4,0,4,2.2229632099588756e-05,6.663853039827628e-05,1.0
17154,17154,채피/Noun,4,4,0,6.668889629876625e-05,2.2212843466092093e-05,1.0
17155,17155,시스터/Noun,4,0,4,2.2229632099588756e-05,6.663853039827628e-05,1.0
17156,17156,이민/Noun,4,4,0,6.668889629876625e-05,2.2212843466092093e-05,1.0
17157,17157,모씨/Noun,4,0,4,2.2229632099588756e-05,6.663853039827628e-05,1.0
17158,17158,섹슈얼/Noun,4,0,4,2.2229632099588756e-05,6.663853039827628e-05,1.0
17159,17159,30일/Number,4,0,4,2.2229632099588756e-05,6.663853039827628e-05,1.0
17160,17160,돈맛/Noun,4,0,4,2.2229632099588756e-05,6.663853039827628e-05,1.0
17161,17161,천사몽/Noun,4,0,4,2.2229632099588756e-05,6.663853039827628e-05,1.0
17162,17162,잼썻음/Noun,4,4,0,6.668889629876625e-05,2.2212843466092093e-05,1.0
17163,17163,무마/Noun,4,0,4,2.2229632099588756e-05,6.663853039827628e-05,1.0
17164,17164,기물/Noun,4,0,4,2.2229632099588756e-05,6.663853039827628e-05,1.0
17165,17165,유딩때/Noun,4,4,0,6.668889629876625e-05,2.2212843466092093e-05,1.0
17166,17166,얼버무리다/Verb,4,0,4,2.2229632099588756e-05,6.663853039827628e-05,1.0
17167,17167,염원/Noun,4,4,0,6.668889629876625e-05,2.2212843466092093e-05,1.0
17168,17168,형수/Noun,4,0,4,2.2229632099588756e-05,6.663853039827628e-05,1.0
17169,17169,정갈하다/Adjective,4,4,0,6.668889629876625e-05,2.2212843466092093e-05,1.0
17170,17170,네임드/Noun,4,0,4,2.2229632099588756e-05,6.663853039827628e-05,1.0
17171,17171,객기/Noun,4,0,4,2.2229632099588756e-05,6.663853039827628e-05,1.0
17172,17172,WTF/Alpha,4,0,4,2.2229632099588756e-05,6.663853039827628e-05,1.0
17173,17173,갤럭투스/Noun,4,0,4,2.2229632099588756e-05,6.663853039827628e-05,1.0
17174,17174,우진/Noun,4,4,0,6.668889629876625e-05,2.2212843466092093e-05,1.0
17175,17175,하우/Adverb,4,0,4,2.2229632099588756e-05,6.663853039827628e-05,1.0
17176,17176,내나라/Noun,4,0,4,2.2229632099588756e-05,6.663853039827628e-05,1.0
17177,17177,밨습니/Noun,4,4,0,6.668889629876625e-05,2.2212843466092093e-05,1.0
17178,17178,프롯/Noun,4,4,0,6.668889629876625e-05,2.2212843466092093e-05,1.0
17179,17179,달빛/Noun,4,4,0,6.668889629876625e-05,2.2212843466092093e-05,1.0
17180,17180,짤리/Noun,4,0,4,2.2229632099588756e-05,6.663853039827628e-05,1.0
17181,17181,수줍다/Adjective,4,4,0,6.668889629876625e-05,2.2212843466092093e-05,1.0
17182,17182,더지니어스/Noun,4,4,0,6.668889629876625e-05,2.2212843466092093e-05,1.0
17183,17183,개봉시/Noun,4,4,0,6.668889629876625e-05,2.2212843466092093e-05,1.0
17184,17184,전래/Noun,4,0,4,2.2229632099588756e-05,6.663853039827628e-05,1.0
17185,17185,!^/Punctuation,4,4,0,6.668889629876625e-05,2.2212843466092093e-05,1.0
17186,17186,인턴/Noun,4,4,0,6.668889629876625e-05,2.2212843466092093e-05,1.0
17187,17187,임시완/Noun,4,4,0,6.668889629876625e-05,2.2212843466092093e-05,1.0
17188,17188,유서/Noun,4,4,0,6.668889629876625e-05,2.2212843466092093e-05,1.0
17189,17189,젓가락/Noun,4,0,4,2.2229632099588756e-05,6.663853039827628e-05,1.0
17190,17190,포착/Noun,4,4,0,6.668889629876625e-05,2.2212843466092093e-05,1.0
17191,17191,개인정보/Noun,4,0,4,2.2229632099588756e-05,6.663853039827628e-05,1.0
17192,17192,홈페이지/Noun,4,0,4,2.2229632099588756e-05,6.663853039827628e-05,1.0
17193,17193,데브/Noun,4,4,0,6.668889629876625e-05,2.2212843466092093e-05,1.0
17194,17194,히드라/Noun,4,0,4,2.2229632099588756e-05,6.663853039827628e-05,1.0
17195,17195,혐의/Noun,4,0,4,2.2229632099588756e-05,6.663853039827628e-05,1.0
17196,17196,0.1%/Number,4,0,4,2.2229632099588756e-05,6.663853039827628e-05,1.0
17197,17197,.^^*/Punctuation,4,4,0,6.668889629876625e-05,2.2212843466092093e-05,1.0
17198,17198,온스타일/Noun,4,4,0,6.668889629876625e-05,2.2212843466092093e-05,1.0
17199,17199,허걱/Noun,4,0,4,2.2229632099588756e-05,6.663853039827628e-05,1.0
17200,17200,타무라/Noun,4,0,4,2.2229632099588756e-05,6.663853039827628e-05,1.0
17201,17201,이거볼빠/Noun,4,0,4,2.2229632099588756e-05,6.663853039827628e-05,1.0
17202,17202,1978년/Number,4,4,0,6.668889629876625e-05,2.2212843466092093e-05,1.0
17203,17203,땐데/Noun,4,0,4,2.2229632099588756e-05,6.663853039827628e-05,1.0
17204,17204,종은/Noun,4,4,0,6.668889629876625e-05,2.2212843466092093e-05,1.0
17205,17205,죠지/Noun,4,0,4,2.2229632099588756e-05,6.663853039827628e-05,1.0
17206,17206,졸예/Noun,4,4,0,6.668889629876625e-05,2.2212843466092093e-05,1.0
17207,17207,주정/Noun,4,0,4,2.2229632099588756e-05,6.663853039827628e-05,1.0
17208,17208,개욕/Noun,4,0,4,2.2229632099588756e-05,6.663853039827628e-05,1.0
17209,17209,즌이/Foreign,4,4,0,6.668889629876625e-05,2.2212843466092093e-05,1.0
17210,17210,울랄라/Noun,4,0,4,2.2229632099588756e-05,6.663853039827628e-05,1.0
17211,17211,허파/Noun,4,0,4,2.2229632099588756e-05,6.663853039827628e-05,1.0
17212,17212,애뜻함/Noun,4,4,0,6.668889629876625e-05,2.2212843466092093e-05,1.0
17213,17213,.~^^/Punctuation,4,4,0,6.668889629876625e-05,2.2212843466092093e-05,1.0
17214,17214,삐삐/Noun,4,4,0,6.668889629876625e-05,2.2212843466092093e-05,1.0
17215,17215,에궁/Noun,4,0,4,2.2229632099588756e-05,6.663853039827628e-05,1.0
17216,17216,기증/Noun,4,0,4,2.2229632099588756e-05,6.663853039827628e-05,1.0
17217,17217,쪽발이/Noun,4,0,4,2.2229632099588756e-05,6.663853039827628e-05,1.0
17218,17218,갓뎀/Noun,4,0,4,2.2229632099588756e-05,6.663853039827628e-05,1.0
17219,17219,이태석/Noun,4,4,0,6.668889629876625e-05,2.2212843466092093e-05,1.0
17220,17220,박규리/Noun,4,4,0,6.668889629876625e-05,2.2212843466092093e-05,1.0
17221,17221,궁색하다/Adjective,4,0,4,2.2229632099588756e-05,6.663853039827628e-05,1.0
17222,17222,크래딧/Noun,4,4,0,6.668889629876625e-05,2.2212843466092093e-05,1.0
17223,17223,격돌/Noun,4,4,0,6.668889629876625e-05,2.2212843466092093e-05,1.0
17224,17224,기합/Noun,4,0,4,2.2229632099588756e-05,6.663853039827628e-05,1.0
17225,17225,생화학/Noun,4,0,4,2.2229632099588756e-05,6.663853039827628e-05,1.0
17226,17226,괴한/Noun,4,0,4,2.2229632099588756e-05,6.663853039827628e-05,1.0
17227,17227,TT/Alpha,4,4,0,6.668889629876625e-05,2.2212843466092093e-05,1.0
17228,17228,울엇습니/Noun,4,4,0,6.668889629876625e-05,2.2212843466092093e-05,1.0
17229,17229,카산드라/Noun,4,4,0,6.668889629876625e-05,2.2212843466092093e-05,1.0
17230,17230,색휘/Noun,4,0,4,2.2229632099588756e-05,6.663853039827628e-05,1.0
17231,17231,지지자/Noun,4,0,4,2.2229632099588756e-05,6.663853039827628e-05,1.0
17232,17232,굿샷/Noun,4,4,0,6.668889629876625e-05,2.2212843466092093e-05,1.0
17233,17233,온대/Noun,4,0,4,2.2229632099588756e-05,6.663853039827628e-05,1.0
17234,17234,506/Number,4,0,4,2.2229632099588756e-05,6.663853039827628e-05,1.0
17235,17235,황금의제국/Noun,4,4,0,6.668889629876625e-05,2.2212843466092093e-05,1.0
17236,17236,빨간색/Noun,4,4,0,6.668889629876625e-05,2.2212843466092093e-05,1.0
17237,17237,블리/Noun,4,4,0,6.668889629876625e-05,2.2212843466092093e-05,1.0
17238,17238,불량하다/Adjective,4,0,4,2.2229632099588756e-05,6.663853039827628e-05,1.0
17239,17239,극대/Noun,4,4,0,6.668889629876625e-05,2.2212843466092093e-05,1.0
17240,17240,강치/Noun,4,4,0,6.668889629876625e-05,2.2212843466092093e-05,1.0
17241,17241,트위스트/Noun,4,4,0,6.668889629876625e-05,2.2212843466092093e-05,1.0
17242,17242,글세/Noun,4,1,3,3.334444814938313e-05,5.553210866523024e-05,0.75
17243,17243,퍼붓다/Verb,4,1,3,3.334444814938313e-05,5.553210866523024e-05,0.75
17244,17244,나진/Noun,4,1,3,3.334444814938313e-05,5.553210866523024e-05,0.75
17245,17245,박치기/Noun,4,3,1,5.5574080248971876e-05,3.331926519913814e-05,0.75
17246,17246,베충/Noun,4,3,1,5.5574080248971876e-05,3.331926519913814e-05,0.75
17247,17247,개혁/Noun,4,3,1,5.5574080248971876e-05,3.331926519913814e-05,0.75
17248,17248,....'/Punctuation,4,1,3,3.334444814938313e-05,5.553210866523024e-05,0.75
17249,17249,안젤라/Noun,4,1,3,3.334444814938313e-05,5.553210866523024e-05,0.75
17250,17250,집권/Noun,4,1,3,3.334444814938313e-05,5.553210866523024e-05,0.75
17251,17251,지혜롭/Noun,4,3,1,5.5574080248971876e-05,3.331926519913814e-05,0.75
17252,17252,만화방/Noun,4,1,3,3.334444814938313e-05,5.553210866523024e-05,0.75
17253,17253,번갈아/Noun,4,3,1,5.5574080248971876e-05,3.331926519913814e-05,0.75
17254,17254,쓰다듬다/Verb,4,3,1,5.5574080248971876e-05,3.331926519913814e-05,0.75
17255,17255,근로자/Noun,4,3,1,5.5574080248971876e-05,3.331926519913814e-05,0.75
17256,17256,스캇/Noun,4,3,1,5.5574080248971876e-05,3.331926519913814e-05,0.75
17257,17257,非/Foreign,4,3,1,5.5574080248971876e-05,3.331926519913814e-05,0.75
17258,17258,괜챦/Noun,4,3,1,5.5574080248971876e-05,3.331926519913814e-05,0.75
17259,17259,엘런/Noun,4,1,3,3.334444814938313e-05,5.553210866523024e-05,0.75
17260,17260,돠/Noun,4,3,1,5.5574080248971876e-05,3.331926519913814e-05,0.75
17261,17261,실장/Noun,4,3,1,5.5574080248971876e-05,3.331926519913814e-05,0.75
17262,17262,러블/Noun,4,3,1,5.5574080248971876e-05,3.331926519913814e-05,0.75
17263,17263,잉글리쉬/Noun,4,1,3,3.334444814938313e-05,5.553210866523024e-05,0.75
17264,17264,꽃보다할배/Noun,4,1,3,3.334444814938313e-05,5.553210866523024e-05,0.75
17265,17265,이태원/Noun,4,1,3,3.334444814938313e-05,5.553210866523024e-05,0.75
17266,17266,1963년/Number,4,3,1,5.5574080248971876e-05,3.331926519913814e-05,0.75
17267,17267,신이치/Noun,4,3,1,5.5574080248971876e-05,3.331926519913814e-05,0.75
17268,17268,록산느/Noun,4,1,3,3.334444814938313e-05,5.553210866523024e-05,0.75
17269,17269,리즘/Noun,4,1,3,3.334444814938313e-05,5.553210866523024e-05,0.75
17270,17270,드라마영화/Noun,4,3,1,5.5574080248971876e-05,3.331926519913814e-05,0.75
17271,17271,짝패/Noun,4,1,3,3.334444814938313e-05,5.553210866523024e-05,0.75
17272,17272,9.9/Number,4,3,1,5.5574080248971876e-05,3.331926519913814e-05,0.75
17273,17273,얼티메이텀/Noun,4,1,3,3.334444814938313e-05,5.553210866523024e-05,0.75
17274,17274,늬들/Noun,4,1,3,3.334444814938313e-05,5.553210866523024e-05,0.75
17275,17275,태아/Noun,4,1,3,3.334444814938313e-05,5.553210866523024e-05,0.75
17276,17276,거볼때/Noun,4,3,1,5.5574080248971876e-05,3.331926519913814e-05,0.75
17277,17277,봤드/Noun,4,1,3,3.334444814938313e-05,5.553210866523024e-05,0.75
17278,17278,폐쇄된/Noun,4,3,1,5.5574080248971876e-05,3.331926519913814e-05,0.75
17279,17279,일본해/Noun,4,1,3,3.334444814938313e-05,5.553210866523024e-05,0.75
17280,17280,내/Foreign,4,1,3,3.334444814938313e-05,5.553210866523024e-05,0.75
17281,17281,!!!!~/Punctuation,4,3,1,5.5574080248971876e-05,3.331926519913814e-05,0.75
17282,17282,홍반장/Noun,4,3,1,5.5574080248971876e-05,3.331926519913814e-05,0.75
17283,17283,동지/Noun,4,1,3,3.334444814938313e-05,5.553210866523024e-05,0.75
17284,17284,김영광/Noun,4,3,1,5.5574080248971876e-05,3.331926519913814e-05,0.75
17285,17285,황인영/Noun,4,1,3,3.334444814938313e-05,5.553210866523024e-05,0.75
17286,17286,노수람/Noun,4,1,3,3.334444814938313e-05,5.553210866523024e-05,0.75
17287,17287,들썩들썩/Adverb,4,3,1,5.5574080248971876e-05,3.331926519913814e-05,0.75
17288,17288,끝맛/Noun,4,3,1,5.5574080248971876e-05,3.331926519913814e-05,0.75
17289,17289,채영/Noun,4,3,1,5.5574080248971876e-05,3.331926519913814e-05,0.75
17290,17290,쌈질/Noun,4,1,3,3.334444814938313e-05,5.553210866523024e-05,0.75
17291,17291,난하다/Adjective,4,1,3,3.334444814938313e-05,5.553210866523024e-05,0.75
17292,17292,스트라이커/Noun,4,1,3,3.334444814938313e-05,5.553210866523024e-05,0.75
17293,17293,꼽으/Noun,4,3,1,5.5574080248971876e-05,3.331926519913814e-05,0.75
17294,17294,0.2/Number,4,1,3,3.334444814938313e-05,5.553210866523024e-05,0.75
17295,17295,물가/Noun,4,1,3,3.334444814938313e-05,5.553210866523024e-05,0.75
17296,17296,나카타/Noun,4,1,3,3.334444814938313e-05,5.553210866523024e-05,0.75
17297,17297,지린다/Verb,4,1,3,3.334444814938313e-05,5.553210866523024e-05,0.75
17298,17298,우중충하다/Adjective,4,1,3,3.334444814938313e-05,5.553210866523024e-05,0.75
17299,17299,영미/Noun,4,3,1,5.5574080248971876e-05,3.331926519913814e-05,0.75
17300,17300,샛별/Noun,4,1,3,3.334444814938313e-05,5.553210866523024e-05,0.75
17301,17301,고지/Noun,4,3,1,5.5574080248971876e-05,3.331926519913814e-05,0.75
17302,17302,모리스/Noun,4,1,3,3.334444814938313e-05,5.553210866523024e-05,0.75
17303,17303,비틀/Noun,4,1,3,3.334444814938313e-05,5.553210866523024e-05,0.75
17304,17304,동기부여/Noun,4,1,3,3.334444814938313e-05,5.553210866523024e-05,0.75
17305,17305,전공/Noun,4,3,1,5.5574080248971876e-05,3.331926519913814e-05,0.75
17306,17306,생판/Noun,4,1,3,3.334444814938313e-05,5.553210866523024e-05,0.75
17307,17307,전위/Noun,4,3,1,5.5574080248971876e-05,3.331926519913814e-05,0.75
17308,17308,승무원/Noun,4,3,1,5.5574080248971876e-05,3.331926519913814e-05,0.75
17309,17309,으윽/Adverb,4,1,3,3.334444814938313e-05,5.553210866523024e-05,0.75
17310,17310,몽고/Noun,4,1,3,3.334444814938313e-05,5.553210866523024e-05,0.75
17311,17311,메이져/Noun,4,3,1,5.5574080248971876e-05,3.331926519913814e-05,0.75
17312,17312,월트/Noun,4,1,3,3.334444814938313e-05,5.553210866523024e-05,0.75
17313,17313,미실/Noun,4,3,1,5.5574080248971876e-05,3.331926519913814e-05,0.75
17314,17314,어리광/Noun,4,1,3,3.334444814938313e-05,5.553210866523024e-05,0.75
17315,17315,이방원/Noun,4,3,1,5.5574080248971876e-05,3.331926519913814e-05,0.75
17316,17316,(!)/Punctuation,4,1,3,3.334444814938313e-05,5.553210866523024e-05,0.75
17317,17317,어두침침하다/Adjective,4,1,3,3.334444814938313e-05,5.553210866523024e-05,0.75
17318,17318,보증수표/Noun,4,1,3,3.334444814938313e-05,5.553210866523024e-05,0.75
17319,17319,10101010/Number,4,1,3,3.334444814938313e-05,5.553210866523024e-05,0.75
17320,17320,대나/Foreign,4,1,3,3.334444814938313e-05,5.553210866523024e-05,0.75
17321,17321,훔/Noun,4,1,3,3.334444814938313e-05,5.553210866523024e-05,0.75
17322,17322,다코다/Noun,4,1,3,3.334444814938313e-05,5.553210866523024e-05,0.75
17323,17323,수호천사/Noun,4,3,1,5.5574080248971876e-05,3.331926519913814e-05,0.75
17324,17324,개속/Noun,4,1,3,3.334444814938313e-05,5.553210866523024e-05,0.75
17325,17325,가늘다/Adjective,4,1,3,3.334444814938313e-05,5.553210866523024e-05,0.75
17326,17326,노예제/Noun,4,3,1,5.5574080248971876e-05,3.331926519913814e-05,0.75
17327,17327,어른스럽다/Adjective,4,3,1,5.5574080248971876e-05,3.331926519913814e-05,0.75
17328,17328,성현/Noun,4,3,1,5.5574080248971876e-05,3.331926519913814e-05,0.75
17329,17329,스팀/Noun,4,1,3,3.334444814938313e-05,5.553210866523024e-05,0.75
17330,17330,예성/Noun,4,3,1,5.5574080248971876e-05,3.331926519913814e-05,0.75
17331,17331,판단력/Noun,4,1,3,3.334444814938313e-05,5.553210866523024e-05,0.75
17332,17332,상환/Noun,4,1,3,3.334444814938313e-05,5.553210866523024e-05,0.75
17333,17333,↑/Foreign,4,3,1,5.5574080248971876e-05,3.331926519913814e-05,0.75
17334,17334,복기/Noun,4,3,1,5.5574080248971876e-05,3.331926519913814e-05,0.75
17335,17335,구제역/Noun,4,1,3,3.334444814938313e-05,5.553210866523024e-05,0.75
17336,17336,겨울방학/Noun,4,3,1,5.5574080248971876e-05,3.331926519913814e-05,0.75
17337,17337,다자/Noun,4,1,3,3.334444814938313e-05,5.553210866523024e-05,0.75
17338,17338,어처구니없이/Adverb,4,1,3,3.334444814938313e-05,5.553210866523024e-05,0.75
17339,17339,포항/Noun,4,1,3,3.334444814938313e-05,5.553210866523024e-05,0.75
17340,17340,이채영/Noun,4,1,3,3.334444814938313e-05,5.553210866523024e-05,0.75
17341,17341,애꿎/Noun,4,1,3,3.334444814938313e-05,5.553210866523024e-05,0.75
17342,17342,엠씨몽/Noun,4,1,3,3.334444814938313e-05,5.553210866523024e-05,0.75
17343,17343,양성애자/Noun,4,1,3,3.334444814938313e-05,5.553210866523024e-05,0.75
17344,17344,찬송/Noun,4,3,1,5.5574080248971876e-05,3.331926519913814e-05,0.75
17345,17345,이계인/Noun,4,1,3,3.334444814938313e-05,5.553210866523024e-05,0.75
17346,17346,유실물/Noun,4,1,3,3.334444814938313e-05,5.553210866523024e-05,0.75
17347,17347,일률/Noun,4,1,3,3.334444814938313e-05,5.553210866523024e-05,0.75
17348,17348,직결/Noun,4,1,3,3.334444814938313e-05,5.553210866523024e-05,0.75
17349,17349,타계/Noun,4,3,1,5.5574080248971876e-05,3.331926519913814e-05,0.75
17350,17350,dp/Alpha,4,1,3,3.334444814938313e-05,5.553210866523024e-05,0.75
17351,17351,몰지각하다/Adjective,4,1,3,3.334444814938313e-05,5.553210866523024e-05,0.75
17352,17352,ㅋㅌ/KoreanParticle,4,1,3,3.334444814938313e-05,5.553210866523024e-05,0.75
17353,17353,황후/Noun,4,3,1,5.5574080248971876e-05,3.331926519913814e-05,0.75
17354,17354,20시간/Number,4,1,3,3.334444814938313e-05,5.553210866523024e-05,0.75
17355,17355,활보/Noun,4,1,3,3.334444814938313e-05,5.553210866523024e-05,0.75
17356,17356,killing/Alpha,4,1,3,3.334444814938313e-05,5.553210866523024e-05,0.75
17357,17357,명제/Noun,4,1,3,3.334444814938313e-05,5.553210866523024e-05,0.75
17358,17358,NOT/Alpha,4,1,3,3.334444814938313e-05,5.553210866523024e-05,0.75
17359,17359,박지수/Noun,4,3,1,5.5574080248971876e-05,3.331926519913814e-05,0.75
17360,17360,켄신/Noun,4,3,1,5.5574080248971876e-05,3.331926519913814e-05,0.75
17361,17361,칭호/Noun,4,1,3,3.334444814938313e-05,5.553210866523024e-05,0.75
17362,17362,임정은/Noun,4,1,3,3.334444814938313e-05,5.553210866523024e-05,0.75
17363,17363,허프/Noun,4,3,1,5.5574080248971876e-05,3.331926519913814e-05,0.75
17364,17364,94/Number,4,3,1,5.5574080248971876e-05,3.331926519913814e-05,0.75
17365,17365,02년/Number,4,3,1,5.5574080248971876e-05,3.331926519913814e-05,0.75
17366,17366,!!@/Punctuation,4,3,1,5.5574080248971876e-05,3.331926519913814e-05,0.75
17367,17367,반장/Noun,4,1,3,3.334444814938313e-05,5.553210866523024e-05,0.75
17368,17368,수란/Noun,4,1,3,3.334444814938313e-05,5.553210866523024e-05,0.75
17369,17369,담날/Noun,4,3,1,5.5574080248971876e-05,3.331926519913814e-05,0.75
17370,17370,것땜/Noun,4,3,1,5.5574080248971876e-05,3.331926519913814e-05,0.75
17371,17371,파스타/Noun,4,3,1,5.5574080248971876e-05,3.331926519913814e-05,0.75
17372,17372,".,.,.,./Punctuation",4,1,3,3.334444814938313e-05,5.553210866523024e-05,0.75
17373,17373,촤/Noun,4,3,1,5.5574080248971876e-05,3.331926519913814e-05,0.75
17374,17374,대에도/Foreign,4,1,3,3.334444814938313e-05,5.553210866523024e-05,0.75
17375,17375,발렌타인/Noun,4,3,1,5.5574080248971876e-05,3.331926519913814e-05,0.75
17376,17376,물랑루즈/Noun,4,1,3,3.334444814938313e-05,5.553210866523024e-05,0.75
17377,17377,개요/Noun,4,3,1,5.5574080248971876e-05,3.331926519913814e-05,0.75
17378,17378,아더왕/Noun,4,1,3,3.334444814938313e-05,5.553210866523024e-05,0.75
17379,17379,돌격/Noun,4,3,1,5.5574080248971876e-05,3.331926519913814e-05,0.75
17380,17380,오만석/Noun,4,3,1,5.5574080248971876e-05,3.331926519913814e-05,0.75
17381,17381,옜다/Noun,4,1,3,3.334444814938313e-05,5.553210866523024e-05,0.75
17382,17382,연필/Noun,4,3,1,5.5574080248971876e-05,3.331926519913814e-05,0.75
17383,17383,70~80년/Number,4,1,3,3.334444814938313e-05,5.553210866523024e-05,0.75
17384,17384,기하/Noun,4,1,3,3.334444814938313e-05,5.553210866523024e-05,0.75
17385,17385,아리아/Noun,4,1,3,3.334444814938313e-05,5.553210866523024e-05,0.75
17386,17386,돋보다/Verb,4,3,1,5.5574080248971876e-05,3.331926519913814e-05,0.75
17387,17387,BMW/Alpha,4,1,3,3.334444814938313e-05,5.553210866523024e-05,0.75
17388,17388,GT/Alpha,4,3,1,5.5574080248971876e-05,3.331926519913814e-05,0.75
17389,17389,파라노말액티비티/Noun,4,1,3,3.334444814938313e-05,5.553210866523024e-05,0.75
17390,17390,불어오다/Verb,4,3,1,5.5574080248971876e-05,3.331926519913814e-05,0.75
17391,17391,JJ/Alpha,4,1,3,3.334444814938313e-05,5.553210866523024e-05,0.75
17392,17392,이끼/Noun,4,1,3,3.334444814938313e-05,5.553210866523024e-05,0.75
17393,17393,바알/Noun,4,1,3,3.334444814938313e-05,5.553210866523024e-05,0.75
17394,17394,메구미/Noun,4,3,1,5.5574080248971876e-05,3.331926519913814e-05,0.75
17395,17395,Let/Alpha,4,3,1,5.5574080248971876e-05,3.331926519913814e-05,0.75
17396,17396,2003/Number,4,3,1,5.5574080248971876e-05,3.331926519913814e-05,0.75
17397,17397,5시/Number,4,3,1,5.5574080248971876e-05,3.331926519913814e-05,0.75
17398,17398,아테나/Noun,4,1,3,3.334444814938313e-05,5.553210866523024e-05,0.75
17399,17399,회고/Noun,4,3,1,5.5574080248971876e-05,3.331926519913814e-05,0.75
17400,17400,겉잡/Noun,4,3,1,5.5574080248971876e-05,3.331926519913814e-05,0.75
17401,17401,김혜성/Noun,4,1,3,3.334444814938313e-05,5.553210866523024e-05,0.75
17402,17402,작을/Foreign,4,1,3,3.334444814938313e-05,5.553210866523024e-05,0.75
17403,17403,딕/Noun,4,1,3,3.334444814938313e-05,5.553210866523024e-05,0.75
17404,17404,데스페라도/Noun,4,1,3,3.334444814938313e-05,5.553210866523024e-05,0.75
17405,17405,부지런하다/Adjective,4,3,1,5.5574080248971876e-05,3.331926519913814e-05,0.75
17406,17406,쿠로사와/Noun,4,1,3,3.334444814938313e-05,5.553210866523024e-05,0.75
17407,17407,허덕이다/Verb,4,3,1,5.5574080248971876e-05,3.331926519913814e-05,0.75
17408,17408,달아오르다/Verb,4,3,1,5.5574080248971876e-05,3.331926519913814e-05,0.75
17409,17409,의뢰인/Noun,4,1,3,3.334444814938313e-05,5.553210866523024e-05,0.75
17410,17410,마에다/Noun,4,3,1,5.5574080248971876e-05,3.331926519913814e-05,0.75
17411,17411,잏/Noun,4,3,1,5.5574080248971876e-05,3.331926519913814e-05,0.75
17412,17412,희망고문/Noun,4,3,1,5.5574080248971876e-05,3.331926519913814e-05,0.75
17413,17413,보디/Noun,4,1,3,3.334444814938313e-05,5.553210866523024e-05,0.75
17414,17414,스파르타/Noun,4,3,1,5.5574080248971876e-05,3.331926519913814e-05,0.75
17415,17415,프롤로그/Noun,4,1,3,3.334444814938313e-05,5.553210866523024e-05,0.75
17416,17416,초롱/Noun,4,3,1,5.5574080248971876e-05,3.331926519913814e-05,0.75
17417,17417,데헷/Noun,4,3,1,5.5574080248971876e-05,3.331926519913814e-05,0.75
17418,17418,지목/Noun,4,1,3,3.334444814938313e-05,5.553210866523024e-05,0.75
17419,17419,손짓/Noun,4,3,1,5.5574080248971876e-05,3.331926519913814e-05,0.75
17420,17420,BBC/Alpha,4,1,3,3.334444814938313e-05,5.553210866523024e-05,0.75
17421,17421,컴퍼니/Noun,4,3,1,5.5574080248971876e-05,3.331926519913814e-05,0.75
17422,17422,미영/Noun,4,3,1,5.5574080248971876e-05,3.331926519913814e-05,0.75
17423,17423,실리콘/Noun,4,1,3,3.334444814938313e-05,5.553210866523024e-05,0.75
17424,17424,봄여름가을겨울/Noun,4,3,1,5.5574080248971876e-05,3.331926519913814e-05,0.75
17425,17425,벌주다/Verb,4,1,3,3.334444814938313e-05,5.553210866523024e-05,0.75
17426,17426,헤드셋/Noun,4,3,1,5.5574080248971876e-05,3.331926519913814e-05,0.75
17427,17427,500만/Number,4,3,1,5.5574080248971876e-05,3.331926519913814e-05,0.75
17428,17428,인애/Noun,4,1,3,3.334444814938313e-05,5.553210866523024e-05,0.75
17429,17429,매달다/Verb,4,3,1,5.5574080248971876e-05,3.331926519913814e-05,0.75
17430,17430,24시간/Number,4,3,1,5.5574080248971876e-05,3.331926519913814e-05,0.75
17431,17431,애처/Noun,4,3,1,5.5574080248971876e-05,3.331926519913814e-05,0.75
17432,17432,에전/Noun,4,1,3,3.334444814938313e-05,5.553210866523024e-05,0.75
17433,17433,는야/Josa,4,3,1,5.5574080248971876e-05,3.331926519913814e-05,0.75
17434,17434,염력/Noun,4,1,3,3.334444814938313e-05,5.553210866523024e-05,0.75
17435,17435,발린/Noun,4,1,3,3.334444814938313e-05,5.553210866523024e-05,0.75
17436,17436,섬나라/Noun,4,1,3,3.334444814938313e-05,5.553210866523024e-05,0.75
17437,17437,이수아/Noun,4,1,3,3.334444814938313e-05,5.553210866523024e-05,0.75
17438,17438,99.9%/Number,4,1,3,3.334444814938313e-05,5.553210866523024e-05,0.75
17439,17439,반려동물/Noun,4,3,1,5.5574080248971876e-05,3.331926519913814e-05,0.75
17440,17440,청정/Noun,4,3,1,5.5574080248971876e-05,3.331926519913814e-05,0.75
17441,17441,화술/Noun,4,1,3,3.334444814938313e-05,5.553210866523024e-05,0.75
17442,17442,직진/Noun,4,3,1,5.5574080248971876e-05,3.331926519913814e-05,0.75
17443,17443,이승/Noun,4,3,1,5.5574080248971876e-05,3.331926519913814e-05,0.75
17444,17444,신조/Noun,4,1,3,3.334444814938313e-05,5.553210866523024e-05,0.75
17445,17445,뒤엎는/Noun,4,3,1,5.5574080248971876e-05,3.331926519913814e-05,0.75
17446,17446,구일/Noun,4,1,3,3.334444814938313e-05,5.553210866523024e-05,0.75
17447,17447,코카콜라/Noun,4,3,1,5.5574080248971876e-05,3.331926519913814e-05,0.75
17448,17448,쌍코피/Noun,4,3,1,5.5574080248971876e-05,3.331926519913814e-05,0.75
17449,17449,손담비/Noun,4,1,3,3.334444814938313e-05,5.553210866523024e-05,0.75
17450,17450,타라/Noun,4,1,3,3.334444814938313e-05,5.553210866523024e-05,0.75
17451,17451,이장면/Noun,4,1,3,3.334444814938313e-05,5.553210866523024e-05,0.75
17452,17452,카인/Noun,4,1,3,3.334444814938313e-05,5.553210866523024e-05,0.75
17453,17453,화염/Noun,4,1,3,3.334444814938313e-05,5.553210866523024e-05,0.75
17454,17454,안마/Noun,4,1,3,3.334444814938313e-05,5.553210866523024e-05,0.75
17455,17455,송가연/Noun,4,1,3,3.334444814938313e-05,5.553210866523024e-05,0.75
17456,17456,종대/Noun,4,1,3,3.334444814938313e-05,5.553210866523024e-05,0.75
17457,17457,유효/Noun,4,3,1,5.5574080248971876e-05,3.331926519913814e-05,0.75
17458,17458,동무/Noun,4,1,3,3.334444814938313e-05,5.553210866523024e-05,0.75
17459,17459,시들하다/Adjective,4,3,1,5.5574080248971876e-05,3.331926519913814e-05,0.75
17460,17460,원흉/Noun,4,1,3,3.334444814938313e-05,5.553210866523024e-05,0.75
17461,17461,대주/Noun,4,1,3,3.334444814938313e-05,5.553210866523024e-05,0.75
17462,17462,보좌/Noun,4,1,3,3.334444814938313e-05,5.553210866523024e-05,0.75
17463,17463,랭크/Noun,4,3,1,5.5574080248971876e-05,3.331926519913814e-05,0.75
17464,17464,도어즈/Noun,4,3,1,5.5574080248971876e-05,3.331926519913814e-05,0.75
17465,17465,다스리다/Verb,4,3,1,5.5574080248971876e-05,3.331926519913814e-05,0.75
17466,17466,백업/Noun,4,3,1,5.5574080248971876e-05,3.331926519913814e-05,0.75
17467,17467,이용만/Noun,4,1,3,3.334444814938313e-05,5.553210866523024e-05,0.75
17468,17468,헤리/Noun,4,3,1,5.5574080248971876e-05,3.331926519913814e-05,0.75
17469,17469,YOU/Alpha,4,3,1,5.5574080248971876e-05,3.331926519913814e-05,0.75
17470,17470,단다/Eomi,4,3,1,5.5574080248971876e-05,3.331926519913814e-05,0.75
17471,17471,이펙트/Noun,4,3,1,5.5574080248971876e-05,3.331926519913814e-05,0.75
17472,17472,Rock/Alpha,4,3,1,5.5574080248971876e-05,3.331926519913814e-05,0.75
17473,17473,서해/Noun,4,1,3,3.334444814938313e-05,5.553210866523024e-05,0.75
17474,17474,헝가리/Noun,4,3,1,5.5574080248971876e-05,3.331926519913814e-05,0.75
17475,17475,수중/Noun,4,3,1,5.5574080248971876e-05,3.331926519913814e-05,0.75
17476,17476,최우수/Noun,4,3,1,5.5574080248971876e-05,3.331926519913814e-05,0.75
17477,17477,확정/Noun,4,3,1,5.5574080248971876e-05,3.331926519913814e-05,0.75
17478,17478,7.9/Number,4,1,3,3.334444814938313e-05,5.553210866523024e-05,0.75
17479,17479,참전용사/Noun,4,3,1,5.5574080248971876e-05,3.331926519913814e-05,0.75
17480,17480,각하/Noun,4,1,3,3.334444814938313e-05,5.553210866523024e-05,0.75
17481,17481,거르/Noun,4,1,3,3.334444814938313e-05,5.553210866523024e-05,0.75
17482,17482,글로리/Noun,4,3,1,5.5574080248971876e-05,3.331926519913814e-05,0.75
17483,17483,봉황/Noun,4,3,1,5.5574080248971876e-05,3.331926519913814e-05,0.75
17484,17484,거진/Adverb,4,1,3,3.334444814938313e-05,5.553210866523024e-05,0.75
17485,17485,광경/Noun,4,1,3,3.334444814938313e-05,5.553210866523024e-05,0.75
17486,17486,나영/Noun,4,1,3,3.334444814938313e-05,5.553210866523024e-05,0.75
17487,17487,이반/Noun,4,3,1,5.5574080248971876e-05,3.331926519913814e-05,0.75
17488,17488,이라/Foreign,4,1,3,3.334444814938313e-05,5.553210866523024e-05,0.75
17489,17489,왕초/Noun,4,3,1,5.5574080248971876e-05,3.331926519913814e-05,0.75
17490,17490,김건모/Noun,4,3,1,5.5574080248971876e-05,3.331926519913814e-05,0.75
17491,17491,웅대림/Noun,4,1,3,3.334444814938313e-05,5.553210866523024e-05,0.75
17492,17492,발바닥/Noun,4,1,3,3.334444814938313e-05,5.553210866523024e-05,0.75
17493,17493,구조대/Noun,4,3,1,5.5574080248971876e-05,3.331926519913814e-05,0.75
17494,17494,남아공/Noun,4,3,1,5.5574080248971876e-05,3.331926519913814e-05,0.75
17495,17495,아디/Noun,4,1,3,3.334444814938313e-05,5.553210866523024e-05,0.75
17496,17496,신전/Noun,4,1,3,3.334444814938313e-05,5.553210866523024e-05,0.75
17497,17497,홀릭/Noun,4,3,1,5.5574080248971876e-05,3.331926519913814e-05,0.75
17498,17498,할러/Noun,4,3,1,5.5574080248971876e-05,3.331926519913814e-05,0.75
17499,17499,온화하다/Adjective,4,3,1,5.5574080248971876e-05,3.331926519913814e-05,0.75
17500,17500,사령관/Noun,4,3,1,5.5574080248971876e-05,3.331926519913814e-05,0.75
17501,17501,YB/Alpha,4,3,1,5.5574080248971876e-05,3.331926519913814e-05,0.75
17502,17502,다오/Noun,4,1,3,3.334444814938313e-05,5.553210866523024e-05,0.75
17503,17503,사주/Noun,4,1,3,3.334444814938313e-05,5.553210866523024e-05,0.75
17504,17504,점박이/Noun,4,1,3,3.334444814938313e-05,5.553210866523024e-05,0.75
17505,17505,점더줌/Noun,4,1,3,3.334444814938313e-05,5.553210866523024e-05,0.75
17506,17506,곳도/Noun,4,1,3,3.334444814938313e-05,5.553210866523024e-05,0.75
17507,17507,청아/Noun,4,3,1,5.5574080248971876e-05,3.331926519913814e-05,0.75
17508,17508,허섭/Noun,4,1,3,3.334444814938313e-05,5.553210866523024e-05,0.75
17509,17509,왼발/Noun,4,1,3,3.334444814938313e-05,5.553210866523024e-05,0.75
17510,17510,취학/Noun,4,1,3,3.334444814938313e-05,5.553210866523024e-05,0.75
17511,17511,뛰어오다/Verb,4,3,1,5.5574080248971876e-05,3.331926519913814e-05,0.75
17512,17512,당나귀/Noun,4,1,3,3.334444814938313e-05,5.553210866523024e-05,0.75
17513,17513,명칭/Noun,4,3,1,5.5574080248971876e-05,3.331926519913814e-05,0.75
17514,17514,이율/Noun,4,1,3,3.334444814938313e-05,5.553210866523024e-05,0.75
17515,17515,초자연적/Noun,4,1,3,3.334444814938313e-05,5.553210866523024e-05,0.75
17516,17516,전말/Noun,4,1,3,3.334444814938313e-05,5.553210866523024e-05,0.75
17517,17517,산타바바라/Noun,4,3,1,5.5574080248971876e-05,3.331926519913814e-05,0.75
17518,17518,8.6/Number,4,3,1,5.5574080248971876e-05,3.331926519913814e-05,0.75
17519,17519,의수/Noun,4,3,1,5.5574080248971876e-05,3.331926519913814e-05,0.75
17520,17520,마로/Noun,4,1,3,3.334444814938313e-05,5.553210866523024e-05,0.75
17521,17521,요나/Noun,4,3,1,5.5574080248971876e-05,3.331926519913814e-05,0.75
17522,17522,바서/Noun,4,3,1,5.5574080248971876e-05,3.331926519913814e-05,0.75
17523,17523,고우영/Noun,4,3,1,5.5574080248971876e-05,3.331926519913814e-05,0.75
17524,17524,보신탕/Noun,4,1,3,3.334444814938313e-05,5.553210866523024e-05,0.75
17525,17525,터프/Noun,4,3,1,5.5574080248971876e-05,3.331926519913814e-05,0.75
17526,17526,다시키/Noun,4,1,3,3.334444814938313e-05,5.553210866523024e-05,0.75
17527,17527,충의/Noun,4,3,1,5.5574080248971876e-05,3.331926519913814e-05,0.75
17528,17528,낸시/Noun,4,1,3,3.334444814938313e-05,5.553210866523024e-05,0.75
17529,17529,보배/Noun,4,1,3,3.334444814938313e-05,5.553210866523024e-05,0.75
17530,17530,48시간/Number,4,1,3,3.334444814938313e-05,5.553210866523024e-05,0.75
17531,17531,!!.../Punctuation,4,3,1,5.5574080248971876e-05,3.331926519913814e-05,0.75
17532,17532,damn/Alpha,4,1,3,3.334444814938313e-05,5.553210866523024e-05,0.75
17533,17533,찬송가/Noun,4,1,3,3.334444814938313e-05,5.553210866523024e-05,0.75
17534,17534,쟁/Noun,4,1,3,3.334444814938313e-05,5.553210866523024e-05,0.75
17535,17535,전이나/Foreign,4,3,1,5.5574080248971876e-05,3.331926519913814e-05,0.75
17536,17536,리트/Noun,4,1,3,3.334444814938313e-05,5.553210866523024e-05,0.75
17537,17537,목수/Noun,4,3,1,5.5574080248971876e-05,3.331926519913814e-05,0.75
17538,17538,확산/Noun,4,1,3,3.334444814938313e-05,5.553210866523024e-05,0.75
17539,17539,똘똘이/Noun,4,3,1,5.5574080248971876e-05,3.331926519913814e-05,0.75
17540,17540,진품/Noun,4,3,1,5.5574080248971876e-05,3.331926519913814e-05,0.75
17541,17541,트랜스/Noun,4,3,1,5.5574080248971876e-05,3.331926519913814e-05,0.75
17542,17542,지남/Noun,4,1,3,3.334444814938313e-05,5.553210866523024e-05,0.75
17543,17543,비밀스럽다/Adjective,4,1,3,3.334444814938313e-05,5.553210866523024e-05,0.75
17544,17544,듀얼/Noun,4,1,3,3.334444814938313e-05,5.553210866523024e-05,0.75
17545,17545,찿/Noun,4,1,3,3.334444814938313e-05,5.553210866523024e-05,0.75
17546,17546,귀타귀/Noun,4,1,3,3.334444814938313e-05,5.553210866523024e-05,0.75
17547,17547,낼때/Noun,4,1,3,3.334444814938313e-05,5.553210866523024e-05,0.75
17548,17548,의인화/Noun,4,3,1,5.5574080248971876e-05,3.331926519913814e-05,0.75
17549,17549,니노미야/Noun,4,3,1,5.5574080248971876e-05,3.331926519913814e-05,0.75
17550,17550,함보/Noun,4,3,1,5.5574080248971876e-05,3.331926519913814e-05,0.75
17551,17551,정호/Noun,4,1,3,3.334444814938313e-05,5.553210866523024e-05,0.75
17552,17552,에로씬/Noun,4,1,3,3.334444814938313e-05,5.553210866523024e-05,0.75
17553,17553,funny/Alpha,4,3,1,5.5574080248971876e-05,3.331926519913814e-05,0.75
17554,17554,her/Alpha,4,3,1,5.5574080248971876e-05,3.331926519913814e-05,0.75
17555,17555,벽돌/Noun,4,3,1,5.5574080248971876e-05,3.331926519913814e-05,0.75
17556,17556,지렁이/Noun,4,3,1,5.5574080248971876e-05,3.331926519913814e-05,0.75
17557,17557,감치/Noun,4,1,3,3.334444814938313e-05,5.553210866523024e-05,0.75
17558,17558,범행/Noun,4,1,3,3.334444814938313e-05,5.553210866523024e-05,0.75
17559,17559,기형/Noun,4,1,3,3.334444814938313e-05,5.553210866523024e-05,0.75
17560,17560,똘이장군/Noun,4,3,1,5.5574080248971876e-05,3.331926519913814e-05,0.75
17561,17561,박해미/Noun,4,1,3,3.334444814938313e-05,5.553210866523024e-05,0.75
17562,17562,부연/Noun,4,3,1,5.5574080248971876e-05,3.331926519913814e-05,0.75
17563,17563,.??/Punctuation,4,1,3,3.334444814938313e-05,5.553210866523024e-05,0.75
17564,17564,휘발/Noun,4,1,3,3.334444814938313e-05,5.553210866523024e-05,0.75
17565,17565,52/Number,4,3,1,5.5574080248971876e-05,3.331926519913814e-05,0.75
17566,17566,담보/Noun,4,3,1,5.5574080248971876e-05,3.331926519913814e-05,0.75
17567,17567,^^.../Punctuation,4,1,3,3.334444814938313e-05,5.553210866523024e-05,0.75
17568,17568,소이/Noun,4,3,1,5.5574080248971876e-05,3.331926519913814e-05,0.75
17569,17569,물러나다/Verb,4,1,3,3.334444814938313e-05,5.553210866523024e-05,0.75
17570,17570,데비/Noun,4,1,3,3.334444814938313e-05,5.553210866523024e-05,0.75
17571,17571,후련/Noun,4,3,1,5.5574080248971876e-05,3.331926519913814e-05,0.75
17572,17572,브레/Noun,4,3,1,5.5574080248971876e-05,3.331926519913814e-05,0.75
17573,17573,맛보기/Noun,4,3,1,5.5574080248971876e-05,3.331926519913814e-05,0.75
17574,17574,통탄/Noun,4,1,3,3.334444814938313e-05,5.553210866523024e-05,0.75
17575,17575,송어/Noun,4,3,1,5.5574080248971876e-05,3.331926519913814e-05,0.75
17576,17576,번인/Noun,4,3,1,5.5574080248971876e-05,3.331926519913814e-05,0.75
17577,17577,41분/Number,4,1,3,3.334444814938313e-05,5.553210866523024e-05,0.75
17578,17578,악플러/Noun,4,3,1,5.5574080248971876e-05,3.331926519913814e-05,0.75
17579,17579,헐/Exclamation,4,3,1,5.5574080248971876e-05,3.331926519913814e-05,0.75
17580,17580,호주영화/Noun,4,1,3,3.334444814938313e-05,5.553210866523024e-05,0.75
17581,17581,반일/Noun,4,3,1,5.5574080248971876e-05,3.331926519913814e-05,0.75
17582,17582,김산호/Noun,4,1,3,3.334444814938313e-05,5.553210866523024e-05,0.75
17583,17583,일동/Noun,4,1,3,3.334444814938313e-05,5.553210866523024e-05,0.75
17584,17584,신설/Noun,4,1,3,3.334444814938313e-05,5.553210866523024e-05,0.75
17585,17585,베스/Noun,4,3,1,5.5574080248971876e-05,3.331926519913814e-05,0.75
17586,17586,선상/Noun,4,3,1,5.5574080248971876e-05,3.331926519913814e-05,0.75
17587,17587,만추/Noun,4,1,3,3.334444814938313e-05,5.553210866523024e-05,0.75
17588,17588,쯔쯔쯔/Noun,4,1,3,3.334444814938313e-05,5.553210866523024e-05,0.75
17589,17589,숙희/Noun,4,3,1,5.5574080248971876e-05,3.331926519913814e-05,0.75
17590,17590,편집증/Noun,4,3,1,5.5574080248971876e-05,3.331926519913814e-05,0.75
17591,17591,파생/Noun,4,3,1,5.5574080248971876e-05,3.331926519913814e-05,0.75
17592,17592,1948년/Number,4,1,3,3.334444814938313e-05,5.553210866523024e-05,0.75
17593,17593,전북/Noun,4,1,3,3.334444814938313e-05,5.553210866523024e-05,0.75
17594,17594,바인/Noun,4,1,3,3.334444814938313e-05,5.553210866523024e-05,0.75
17595,17595,OBS/Alpha,4,3,1,5.5574080248971876e-05,3.331926519913814e-05,0.75
17596,17596,켯/Noun,4,3,1,5.5574080248971876e-05,3.331926519913814e-05,0.75
17597,17597,들여놓다/Verb,4,1,3,3.334444814938313e-05,5.553210866523024e-05,0.75
17598,17598,와타나베/Noun,4,3,1,5.5574080248971876e-05,3.331926519913814e-05,0.75
17599,17599,교환/Noun,4,1,3,3.334444814938313e-05,5.553210866523024e-05,0.75
17600,17600,무안하다/Adjective,4,1,3,3.334444814938313e-05,5.553210866523024e-05,0.75
17601,17601,동명이인/Noun,4,1,3,3.334444814938313e-05,5.553210866523024e-05,0.75
17602,17602,십/Suffix,4,3,1,5.5574080248971876e-05,3.331926519913814e-05,0.75
17603,17603,교주/Noun,4,3,1,5.5574080248971876e-05,3.331926519913814e-05,0.75
17604,17604,구암허준/Noun,4,3,1,5.5574080248971876e-05,3.331926519913814e-05,0.75
17605,17605,외할머니/Noun,4,3,1,5.5574080248971876e-05,3.331926519913814e-05,0.75
17606,17606,왁스/Noun,4,3,1,5.5574080248971876e-05,3.331926519913814e-05,0.75
17607,17607,인맥/Noun,4,1,3,3.334444814938313e-05,5.553210866523024e-05,0.75
17608,17608,부심/Noun,4,1,3,3.334444814938313e-05,5.553210866523024e-05,0.75
17609,17609,정밀/Noun,4,3,1,5.5574080248971876e-05,3.331926519913814e-05,0.75
17610,17610,이유나/Noun,4,1,3,3.334444814938313e-05,5.553210866523024e-05,0.75
17611,17611,루지/Noun,4,3,1,5.5574080248971876e-05,3.331926519913814e-05,0.75
17612,17612,이종원/Noun,4,3,1,5.5574080248971876e-05,3.331926519913814e-05,0.75
17613,17613,50원/Number,4,1,3,3.334444814938313e-05,5.553210866523024e-05,0.75
17614,17614,노하우/Noun,4,1,3,3.334444814938313e-05,5.553210866523024e-05,0.75
17615,17615,조반/Noun,4,1,3,3.334444814938313e-05,5.553210866523024e-05,0.75
17616,17616,뉴튼/Noun,4,1,3,3.334444814938313e-05,5.553210866523024e-05,0.75
17617,17617,대로는/Josa,4,1,3,3.334444814938313e-05,5.553210866523024e-05,0.75
17618,17618,듸/Noun,4,3,1,5.5574080248971876e-05,3.331926519913814e-05,0.75
17619,17619,잎/Noun,4,1,3,3.334444814938313e-05,5.553210866523024e-05,0.75
17620,17620,존재도/Noun,4,1,3,3.334444814938313e-05,5.553210866523024e-05,0.75
17621,17621,아랫사람/Noun,4,1,3,3.334444814938313e-05,5.553210866523024e-05,0.75
17622,17622,외곡/Noun,4,1,3,3.334444814938313e-05,5.553210866523024e-05,0.75
17623,17623,스완슨/Noun,4,3,1,5.5574080248971876e-05,3.331926519913814e-05,0.75
17624,17624,검거/Noun,4,3,1,5.5574080248971876e-05,3.331926519913814e-05,0.75
17625,17625,배끼/Noun,4,1,3,3.334444814938313e-05,5.553210866523024e-05,0.75
17626,17626,81분/Number,4,1,3,3.334444814938313e-05,5.553210866523024e-05,0.75
17627,17627,시방/Noun,4,3,1,5.5574080248971876e-05,3.331926519913814e-05,0.75
17628,17628,밥그릇/Noun,4,1,3,3.334444814938313e-05,5.553210866523024e-05,0.75
17629,17629,낚지마/Noun,4,1,3,3.334444814938313e-05,5.553210866523024e-05,0.75
17630,17630,about/Alpha,4,3,1,5.5574080248971876e-05,3.331926519913814e-05,0.75
17631,17631,뺑뺑/Noun,4,1,3,3.334444814938313e-05,5.553210866523024e-05,0.75
17632,17632,밖에/Foreign,4,3,1,5.5574080248971876e-05,3.331926519913814e-05,0.75
17633,17633,..;;;;/Punctuation,4,1,3,3.334444814938313e-05,5.553210866523024e-05,0.75
17634,17634,지애/Noun,4,3,1,5.5574080248971876e-05,3.331926519913814e-05,0.75
17635,17635,황소/Noun,4,1,3,3.334444814938313e-05,5.553210866523024e-05,0.75
17636,17636,파도치다/Verb,4,3,1,5.5574080248971876e-05,3.331926519913814e-05,0.75
17637,17637,속삭임/Noun,4,3,1,5.5574080248971876e-05,3.331926519913814e-05,0.75
17638,17638,구호/Noun,4,1,3,3.334444814938313e-05,5.553210866523024e-05,0.75
17639,17639,준걸/Noun,4,1,3,3.334444814938313e-05,5.553210866523024e-05,0.75
17640,17640,치민/Noun,4,1,3,3.334444814938313e-05,5.553210866523024e-05,0.75
17641,17641,누더기/Noun,4,1,3,3.334444814938313e-05,5.553210866523024e-05,0.75
17642,17642,광역/Noun,4,1,3,3.334444814938313e-05,5.553210866523024e-05,0.75
17643,17643,배송/Noun,4,3,1,5.5574080248971876e-05,3.331926519913814e-05,0.75
17644,17644,야스/Noun,4,3,1,5.5574080248971876e-05,3.331926519913814e-05,0.75
17645,17645,미켈란젤로/Noun,4,3,1,5.5574080248971876e-05,3.331926519913814e-05,0.75
17646,17646,윤지/Noun,4,3,1,5.5574080248971876e-05,3.331926519913814e-05,0.75
17647,17647,육상/Noun,4,1,3,3.334444814938313e-05,5.553210866523024e-05,0.75
17648,17648,캐쉬/Noun,4,3,1,5.5574080248971876e-05,3.331926519913814e-05,0.75
17649,17649,압력/Noun,4,3,1,5.5574080248971876e-05,3.331926519913814e-05,0.75
17650,17650,능동/Noun,4,3,1,5.5574080248971876e-05,3.331926519913814e-05,0.75
17651,17651,한은정/Noun,4,1,3,3.334444814938313e-05,5.553210866523024e-05,0.75
17652,17652,쟁탈전/Noun,4,1,3,3.334444814938313e-05,5.553210866523024e-05,0.75
17653,17653,구기다/Verb,4,1,3,3.334444814938313e-05,5.553210866523024e-05,0.75
17654,17654,차차/Noun,4,1,3,3.334444814938313e-05,5.553210866523024e-05,0.75
17655,17655,알싸하다/Adjective,4,3,1,5.5574080248971876e-05,3.331926519913814e-05,0.75
17656,17656,차츰/Adverb,4,3,1,5.5574080248971876e-05,3.331926519913814e-05,0.75
17657,17657,8분/Number,4,3,1,5.5574080248971876e-05,3.331926519913814e-05,0.75
17658,17658,fun/Alpha,4,3,1,5.5574080248971876e-05,3.331926519913814e-05,0.75
17659,17659,국제사회/Noun,4,3,1,5.5574080248971876e-05,3.331926519913814e-05,0.75
17660,17660,them/Alpha,4,3,1,5.5574080248971876e-05,3.331926519913814e-05,0.75
17661,17661,별표/Noun,4,1,3,3.334444814938313e-05,5.553210866523024e-05,0.75
17662,17662,づ/Foreign,4,3,1,5.5574080248971876e-05,3.331926519913814e-05,0.75
17663,17663,연식/Noun,4,3,1,5.5574080248971876e-05,3.331926519913814e-05,0.75
17664,17664,브로커/Noun,4,1,3,3.334444814938313e-05,5.553210866523024e-05,0.75
17665,17665,끈적끈적하다/Adjective,4,3,1,5.5574080248971876e-05,3.331926519913814e-05,0.75
17666,17666,갑작스레/Noun,4,3,1,5.5574080248971876e-05,3.331926519913814e-05,0.75
17667,17667,아화/Noun,4,3,1,5.5574080248971876e-05,3.331926519913814e-05,0.75
17668,17668,ㅅㅌㅊ/KoreanParticle,4,3,1,5.5574080248971876e-05,3.331926519913814e-05,0.75
17669,17669,레몬/Noun,4,3,1,5.5574080248971876e-05,3.331926519913814e-05,0.75
17670,17670,갤럭시/Noun,4,1,3,3.334444814938313e-05,5.553210866523024e-05,0.75
17671,17671,‥‥/Foreign,4,1,3,3.334444814938313e-05,5.553210866523024e-05,0.75
17672,17672,최종병기/Noun,4,1,3,3.334444814938313e-05,5.553210866523024e-05,0.75
17673,17673,블랙유머/Noun,4,3,1,5.5574080248971876e-05,3.331926519913814e-05,0.75
17674,17674,most/Alpha,4,1,3,3.334444814938313e-05,5.553210866523024e-05,0.75
17675,17675,개피/Noun,4,1,3,3.334444814938313e-05,5.553210866523024e-05,0.75
17676,17676,번지점프/Noun,4,1,3,3.334444814938313e-05,5.553210866523024e-05,0.75
17677,17677,연애소설/Noun,4,3,1,5.5574080248971876e-05,3.331926519913814e-05,0.75
17678,17678,너넨/Noun,4,1,3,3.334444814938313e-05,5.553210866523024e-05,0.75
17679,17679,깃털/Noun,4,3,1,5.5574080248971876e-05,3.331926519913814e-05,0.75
17680,17680,취침/Noun,4,3,1,5.5574080248971876e-05,3.331926519913814e-05,0.75
17681,17681,킬미힐미/Noun,4,3,1,5.5574080248971876e-05,3.331926519913814e-05,0.75
17682,17682,~.~/Punctuation,4,1,3,3.334444814938313e-05,5.553210866523024e-05,0.75
17683,17683,리얼스틸/Noun,4,3,1,5.5574080248971876e-05,3.331926519913814e-05,0.75
17684,17684,감개/Noun,4,3,1,5.5574080248971876e-05,3.331926519913814e-05,0.75
17685,17685,직도/Noun,4,3,1,5.5574080248971876e-05,3.331926519913814e-05,0.75
17686,17686,유시/Noun,4,3,1,5.5574080248971876e-05,3.331926519913814e-05,0.75
17687,17687,항적/Noun,4,3,1,5.5574080248971876e-05,3.331926519913814e-05,0.75
17688,17688,엘리엇/Noun,4,3,1,5.5574080248971876e-05,3.331926519913814e-05,0.75
17689,17689,크리스토프/Noun,4,3,1,5.5574080248971876e-05,3.331926519913814e-05,0.75
17690,17690,산속/Noun,4,1,3,3.334444814938313e-05,5.553210866523024e-05,0.75
17691,17691,아노하나/Noun,4,3,1,5.5574080248971876e-05,3.331926519913814e-05,0.75
17692,17692,오디/Noun,4,1,3,3.334444814938313e-05,5.553210866523024e-05,0.75
17693,17693,전광판/Noun,4,1,3,3.334444814938313e-05,5.553210866523024e-05,0.75
17694,17694,To/Alpha,4,3,1,5.5574080248971876e-05,3.331926519913814e-05,0.75
17695,17695,..^&^/Punctuation,4,1,3,3.334444814938313e-05,5.553210866523024e-05,0.75
17696,17696,선동렬/Noun,4,1,3,3.334444814938313e-05,5.553210866523024e-05,0.75
17697,17697,ㅅㅋ/KoreanParticle,4,1,3,3.334444814938313e-05,5.553210866523024e-05,0.75
17698,17698,실루엣/Noun,4,3,1,5.5574080248971876e-05,3.331926519913814e-05,0.75
17699,17699,적기/Noun,4,3,1,5.5574080248971876e-05,3.331926519913814e-05,0.75
17700,17700,차우/Noun,4,1,3,3.334444814938313e-05,5.553210866523024e-05,0.75
17701,17701,객석/Noun,4,1,3,3.334444814938313e-05,5.553210866523024e-05,0.75
17702,17702,군도/Noun,4,3,1,5.5574080248971876e-05,3.331926519913814e-05,0.75
17703,17703,후크/Noun,4,3,1,5.5574080248971876e-05,3.331926519913814e-05,0.75
17704,17704,밤바/Noun,4,3,1,5.5574080248971876e-05,3.331926519913814e-05,0.75
17705,17705,goes/Alpha,4,3,1,5.5574080248971876e-05,3.331926519913814e-05,0.75
17706,17706,얼라이브/Noun,4,1,3,3.334444814938313e-05,5.553210866523024e-05,0.75
17707,17707,출진/Noun,4,1,3,3.334444814938313e-05,5.553210866523024e-05,0.75
17708,17708,글거/Noun,4,1,3,3.334444814938313e-05,5.553210866523024e-05,0.75
17709,17709,덮이다/Verb,4,3,1,5.5574080248971876e-05,3.331926519913814e-05,0.75
17710,17710,유미/Noun,4,3,1,5.5574080248971876e-05,3.331926519913814e-05,0.75
17711,17711,트윈스/Noun,4,1,3,3.334444814938313e-05,5.553210866523024e-05,0.75
17712,17712,부안/Noun,4,1,3,3.334444814938313e-05,5.553210866523024e-05,0.75
17713,17713,비종/Noun,4,3,1,5.5574080248971876e-05,3.331926519913814e-05,0.75
17714,17714,솜사탕/Noun,4,3,1,5.5574080248971876e-05,3.331926519913814e-05,0.75
17715,17715,우시/Noun,4,1,3,3.334444814938313e-05,5.553210866523024e-05,0.75
17716,17716,세바퀴/Noun,4,1,3,3.334444814938313e-05,5.553210866523024e-05,0.75
17717,17717,5-6/Number,4,1,3,3.334444814938313e-05,5.553210866523024e-05,0.75
17718,17718,오진우/Noun,4,3,1,5.5574080248971876e-05,3.331926519913814e-05,0.75
17719,17719,루팡/Noun,4,3,1,5.5574080248971876e-05,3.331926519913814e-05,0.75
17720,17720,비굴하다/Adjective,4,1,3,3.334444814938313e-05,5.553210866523024e-05,0.75
17721,17721,싸늘하다/Adjective,4,3,1,5.5574080248971876e-05,3.331926519913814e-05,0.75
17722,17722,채경/Noun,4,1,3,3.334444814938313e-05,5.553210866523024e-05,0.75
17723,17723,공책/Noun,4,3,1,5.5574080248971876e-05,3.331926519913814e-05,0.75
17724,17724,3.4/Number,4,3,1,5.5574080248971876e-05,3.331926519913814e-05,0.75
17725,17725,신성하다/Adjective,4,3,1,5.5574080248971876e-05,3.331926519913814e-05,0.75
17726,17726,페러다임/Noun,4,3,1,5.5574080248971876e-05,3.331926519913814e-05,0.75
17727,17727,변수/Noun,4,3,1,5.5574080248971876e-05,3.331926519913814e-05,0.75
17728,17728,바그다드/Noun,4,3,1,5.5574080248971876e-05,3.331926519913814e-05,0.75
17729,17729,뿌잉/Noun,4,1,3,3.334444814938313e-05,5.553210866523024e-05,0.75
17730,17730,바퀴/Noun,4,1,3,3.334444814938313e-05,5.553210866523024e-05,0.75
17731,17731,도인/Noun,4,1,3,3.334444814938313e-05,5.553210866523024e-05,0.75
17732,17732,효주/Noun,4,1,3,3.334444814938313e-05,5.553210866523024e-05,0.75
17733,17733,00년/Number,4,1,3,3.334444814938313e-05,5.553210866523024e-05,0.75
17734,17734,다망하다/Adjective,4,3,1,5.5574080248971876e-05,3.331926519913814e-05,0.75
17735,17735,세현/Noun,4,3,1,5.5574080248971876e-05,3.331926519913814e-05,0.75
17736,17736,코브/Noun,4,3,1,5.5574080248971876e-05,3.331926519913814e-05,0.75
17737,17737,엄두/Noun,4,1,3,3.334444814938313e-05,5.553210866523024e-05,0.75
17738,17738,롭다/Noun,4,3,1,5.5574080248971876e-05,3.331926519913814e-05,0.75
17739,17739,애꾸/Noun,4,1,3,3.334444814938313e-05,5.553210866523024e-05,0.75
17740,17740,중재/Noun,4,1,3,3.334444814938313e-05,5.553210866523024e-05,0.75
17741,17741,은혁/Noun,4,1,3,3.334444814938313e-05,5.553210866523024e-05,0.75
17742,17742,그래프/Noun,4,1,3,3.334444814938313e-05,5.553210866523024e-05,0.75
17743,17743,개쩔/Noun,4,3,1,5.5574080248971876e-05,3.331926519913814e-05,0.75
17744,17744,추위/Noun,4,1,3,3.334444814938313e-05,5.553210866523024e-05,0.75
17745,17745,귤/Noun,4,1,3,3.334444814938313e-05,5.553210866523024e-05,0.75
17746,17746,린코/Noun,4,3,1,5.5574080248971876e-05,3.331926519913814e-05,0.75
17747,17747,재일동포/Noun,4,3,1,5.5574080248971876e-05,3.331926519913814e-05,0.75
17748,17748,나왓/Noun,4,1,3,3.334444814938313e-05,5.553210866523024e-05,0.75
17749,17749,부정부패/Noun,4,1,3,3.334444814938313e-05,5.553210866523024e-05,0.75
17750,17750,고살/Noun,4,3,1,5.5574080248971876e-05,3.331926519913814e-05,0.75
17751,17751,오른손/Noun,4,1,3,3.334444814938313e-05,5.553210866523024e-05,0.75
17752,17752,태자/Noun,4,3,1,5.5574080248971876e-05,3.331926519913814e-05,0.75
17753,17753,골프/Noun,4,3,1,5.5574080248971876e-05,3.331926519913814e-05,0.75
17754,17754,년뒤/Noun,4,3,1,5.5574080248971876e-05,3.331926519913814e-05,0.75
17755,17755,바토/Noun,4,3,1,5.5574080248971876e-05,3.331926519913814e-05,0.75
17756,17756,일루/Noun,4,1,3,3.334444814938313e-05,5.553210866523024e-05,0.75
17757,17757,킬링필드/Noun,4,1,3,3.334444814938313e-05,5.553210866523024e-05,0.75
17758,17758,좌표/Noun,4,1,3,3.334444814938313e-05,5.553210866523024e-05,0.75
17759,17759,양민/Noun,4,1,3,3.334444814938313e-05,5.553210866523024e-05,0.75
17760,17760,실검/Noun,4,1,3,3.334444814938313e-05,5.553210866523024e-05,0.75
17761,17761,............................../Punctuation,4,1,3,3.334444814938313e-05,5.553210866523024e-05,0.75
17762,17762,ㅎㄷ/KoreanParticle,4,3,1,5.5574080248971876e-05,3.331926519913814e-05,0.75
17763,17763,새싹/Noun,4,3,1,5.5574080248971876e-05,3.331926519913814e-05,0.75
17764,17764,액츄얼리/Noun,4,3,1,5.5574080248971876e-05,3.331926519913814e-05,0.75
17765,17765,텝/Noun,4,1,3,3.334444814938313e-05,5.553210866523024e-05,0.75
17766,17766,낙서/Noun,4,1,3,3.334444814938313e-05,5.553210866523024e-05,0.75
17767,17767,효연/Noun,4,1,3,3.334444814938313e-05,5.553210866523024e-05,0.75
17768,17768,그깟/Modifier,4,1,3,3.334444814938313e-05,5.553210866523024e-05,0.75
17769,17769,한가운데/Noun,4,1,3,3.334444814938313e-05,5.553210866523024e-05,0.75
17770,17770,오옷/Noun,4,3,1,5.5574080248971876e-05,3.331926519913814e-05,0.75
17771,17771,생떼/Noun,4,1,3,3.334444814938313e-05,5.553210866523024e-05,0.75
17772,17772,500일/Number,4,3,1,5.5574080248971876e-05,3.331926519913814e-05,0.75
17773,17773,겨루다/Verb,4,1,3,3.334444814938313e-05,5.553210866523024e-05,0.75
17774,17774,간달프/Noun,4,1,3,3.334444814938313e-05,5.553210866523024e-05,0.75
17775,17775,마다의/Josa,4,3,1,5.5574080248971876e-05,3.331926519913814e-05,0.75
17776,17776,짜리를/Foreign,4,1,3,3.334444814938313e-05,5.553210866523024e-05,0.75
17777,17777,강진/Noun,4,3,1,5.5574080248971876e-05,3.331926519913814e-05,0.75
17778,17778,101010/Number,4,3,1,5.5574080248971876e-05,3.331926519913814e-05,0.75
17779,17779,페이스오프/Noun,4,3,1,5.5574080248971876e-05,3.331926519913814e-05,0.75
17780,17780,역도산/Noun,4,3,1,5.5574080248971876e-05,3.331926519913814e-05,0.75
17781,17781,코지/Noun,4,3,1,5.5574080248971876e-05,3.331926519913814e-05,0.75
17782,17782,족쇄/Noun,4,3,1,5.5574080248971876e-05,3.331926519913814e-05,0.75
17783,17783,잠식/Noun,4,3,1,5.5574080248971876e-05,3.331926519913814e-05,0.75
17784,17784,되돌아오다/Verb,4,1,3,3.334444814938313e-05,5.553210866523024e-05,0.75
17785,17785,가십/Noun,4,3,1,5.5574080248971876e-05,3.331926519913814e-05,0.75
17786,17786,털끝/Noun,4,1,3,3.334444814938313e-05,5.553210866523024e-05,0.75
17787,17787,양말/Noun,4,3,1,5.5574080248971876e-05,3.331926519913814e-05,0.75
17788,17788,어엉/Noun,4,3,1,5.5574080248971876e-05,3.331926519913814e-05,0.75
17789,17789,텔론/Noun,4,3,1,5.5574080248971876e-05,3.331926519913814e-05,0.75
17790,17790,베스타스/Noun,4,3,1,5.5574080248971876e-05,3.331926519913814e-05,0.75
17791,17791,유대/Noun,4,1,3,3.334444814938313e-05,5.553210866523024e-05,0.75
17792,17792,오싹/Noun,4,3,1,5.5574080248971876e-05,3.331926519913814e-05,0.75
17793,17793,음하하/Exclamation,4,1,3,3.334444814938313e-05,5.553210866523024e-05,0.75
17794,17794,고속버스/Noun,4,3,1,5.5574080248971876e-05,3.331926519913814e-05,0.75
17795,17795,레이놀즈/Noun,4,1,3,3.334444814938313e-05,5.553210866523024e-05,0.75
17796,17796,here/Alpha,4,3,1,5.5574080248971876e-05,3.331926519913814e-05,0.75
17797,17797,칸느/Noun,4,1,3,3.334444814938313e-05,5.553210866523024e-05,0.75
17798,17798,콜라보레이션/Noun,4,3,1,5.5574080248971876e-05,3.331926519913814e-05,0.75
17799,17799,광우병/Noun,4,1,3,3.334444814938313e-05,5.553210866523024e-05,0.75
17800,17800,필견/Noun,4,3,1,5.5574080248971876e-05,3.331926519913814e-05,0.75
17801,17801,광신/Noun,4,1,3,3.334444814938313e-05,5.553210866523024e-05,0.75
17802,17802,본부/Noun,4,1,3,3.334444814938313e-05,5.553210866523024e-05,0.75
17803,17803,4000/Number,4,1,3,3.334444814938313e-05,5.553210866523024e-05,0.75
17804,17804,캐논/Noun,4,3,1,5.5574080248971876e-05,3.331926519913814e-05,0.75
17805,17805,생뚱/Noun,4,1,3,3.334444814938313e-05,5.553210866523024e-05,0.75
17806,17806,콘크리트/Noun,4,3,1,5.5574080248971876e-05,3.331926519913814e-05,0.75
17807,17807,하하호호/Noun,4,3,1,5.5574080248971876e-05,3.331926519913814e-05,0.75
17808,17808,견주/Noun,4,3,1,5.5574080248971876e-05,3.331926519913814e-05,0.75
17809,17809,아더/Noun,4,3,1,5.5574080248971876e-05,3.331926519913814e-05,0.75
17810,17810,전전긍긍/Noun,4,1,3,3.334444814938313e-05,5.553210866523024e-05,0.75
17811,17811,away/Alpha,4,3,1,5.5574080248971876e-05,3.331926519913814e-05,0.75
17812,17812,물리학/Noun,4,1,3,3.334444814938313e-05,5.553210866523024e-05,0.75
17813,17813,ㅠㅠㅋ/KoreanParticle,4,3,1,5.5574080248971876e-05,3.331926519913814e-05,0.75
17814,17814,핡핡/Noun,4,3,1,5.5574080248971876e-05,3.331926519913814e-05,0.75
17815,17815,승현/Noun,4,3,1,5.5574080248971876e-05,3.331926519913814e-05,0.75
17816,17816,!!!!!!!!!!!!!!!!!!!!!!!!!/Punctuation,4,3,1,5.5574080248971876e-05,3.331926519913814e-05,0.75
17817,17817,흡족하다/Adjective,4,3,1,5.5574080248971876e-05,3.331926519913814e-05,0.75
17818,17818,휴스턴/Noun,4,1,3,3.334444814938313e-05,5.553210866523024e-05,0.75
17819,17819,군무/Noun,4,3,1,5.5574080248971876e-05,3.331926519913814e-05,0.75
17820,17820,예여/Josa,4,3,1,5.5574080248971876e-05,3.331926519913814e-05,0.75
17821,17821,쿠라/Noun,4,1,3,3.334444814938313e-05,5.553210866523024e-05,0.75
17822,17822,쭉빵/Noun,4,1,3,3.334444814938313e-05,5.553210866523024e-05,0.75
17823,17823,랭보/Noun,4,3,1,5.5574080248971876e-05,3.331926519913814e-05,0.75
17824,17824,김득구/Noun,4,3,1,5.5574080248971876e-05,3.331926519913814e-05,0.75
17825,17825,백동수/Noun,4,1,3,3.334444814938313e-05,5.553210866523024e-05,0.75
17826,17826,퀀/Noun,4,3,1,5.5574080248971876e-05,3.331926519913814e-05,0.75
17827,17827,아미르/Noun,4,3,1,5.5574080248971876e-05,3.331926519913814e-05,0.75
17828,17828,맹신/Noun,4,1,3,3.334444814938313e-05,5.553210866523024e-05,0.75
17829,17829,웨이즈/Noun,4,1,3,3.334444814938313e-05,5.553210866523024e-05,0.75
17830,17830,몽타주/Noun,4,3,1,5.5574080248971876e-05,3.331926519913814e-05,0.75
17831,17831,26일/Number,4,1,3,3.334444814938313e-05,5.553210866523024e-05,0.75
17832,17832,분할/Noun,4,1,3,3.334444814938313e-05,5.553210866523024e-05,0.75
17833,17833,허영만/Noun,4,1,3,3.334444814938313e-05,5.553210866523024e-05,0.75
17834,17834,부당거래/Noun,4,3,1,5.5574080248971876e-05,3.331926519913814e-05,0.75
17835,17835,싸이트/Noun,4,1,3,3.334444814938313e-05,5.553210866523024e-05,0.75
17836,17836,메리크리스마스/Noun,4,3,1,5.5574080248971876e-05,3.331926519913814e-05,0.75
17837,17837,아차/Noun,4,3,1,5.5574080248971876e-05,3.331926519913814e-05,0.75
17838,17838,머드/Noun,4,3,1,5.5574080248971876e-05,3.331926519913814e-05,0.75
17839,17839,밝아지다/Verb,4,3,1,5.5574080248971876e-05,3.331926519913814e-05,0.75
17840,17840,야성/Noun,4,3,1,5.5574080248971876e-05,3.331926519913814e-05,0.75
17841,17841,습보/Noun,4,1,3,3.334444814938313e-05,5.553210866523024e-05,0.75
17842,17842,붙잡히다/Verb,4,1,3,3.334444814938313e-05,5.553210866523024e-05,0.75
17843,17843,인디밴드/Noun,4,3,1,5.5574080248971876e-05,3.331926519913814e-05,0.75
17844,17844,감돈/Noun,4,3,1,5.5574080248971876e-05,3.331926519913814e-05,0.75
17845,17845,굳어지다/Verb,4,3,1,5.5574080248971876e-05,3.331926519913814e-05,0.75
17846,17846,와웅/Noun,4,3,1,5.5574080248971876e-05,3.331926519913814e-05,0.75
17847,17847,뚝심/Noun,4,3,1,5.5574080248971876e-05,3.331926519913814e-05,0.75
17848,17848,.>/Punctuation,4,3,1,5.5574080248971876e-05,3.331926519913814e-05,0.75
17849,17849,부랑/Noun,4,1,3,3.334444814938313e-05,5.553210866523024e-05,0.75
17850,17850,우성/Noun,4,3,1,5.5574080248971876e-05,3.331926519913814e-05,0.75
17851,17851,여경/Noun,4,1,3,3.334444814938313e-05,5.553210866523024e-05,0.75
17852,17852,관지림/Noun,4,3,1,5.5574080248971876e-05,3.331926519913814e-05,0.75
17853,17853,이재희/Noun,4,1,3,3.334444814938313e-05,5.553210866523024e-05,0.75
17854,17854,진관희/Noun,4,3,1,5.5574080248971876e-05,3.331926519913814e-05,0.75
17855,17855,십덕/Noun,4,1,3,3.334444814938313e-05,5.553210866523024e-05,0.75
17856,17856,쿵짝/Noun,4,3,1,5.5574080248971876e-05,3.331926519913814e-05,0.75
17857,17857,으로선/Josa,4,3,1,5.5574080248971876e-05,3.331926519913814e-05,0.75
17858,17858,/./Punctuation,4,1,3,3.334444814938313e-05,5.553210866523024e-05,0.75
17859,17859,투덜대다/Verb,4,3,1,5.5574080248971876e-05,3.331926519913814e-05,0.75
17860,17860,현준/Noun,4,1,3,3.334444814938313e-05,5.553210866523024e-05,0.75
17861,17861,낚여/Noun,4,3,1,5.5574080248971876e-05,3.331926519913814e-05,0.75
17862,17862,소용없다/Adjective,4,1,3,3.334444814938313e-05,5.553210866523024e-05,0.75
17863,17863,디엠/Noun,4,3,1,5.5574080248971876e-05,3.331926519913814e-05,0.75
17864,17864,gta/Alpha,4,1,3,3.334444814938313e-05,5.553210866523024e-05,0.75
17865,17865,비기다/Verb,4,1,3,3.334444814938313e-05,5.553210866523024e-05,0.75
17866,17866,키리시/Noun,4,3,1,5.5574080248971876e-05,3.331926519913814e-05,0.75
17867,17867,이보희/Noun,4,3,1,5.5574080248971876e-05,3.331926519913814e-05,0.75
17868,17868,올란도/Noun,4,1,3,3.334444814938313e-05,5.553210866523024e-05,0.75
17869,17869,오바마/Noun,4,1,3,3.334444814938313e-05,5.553210866523024e-05,0.75
17870,17870,게이지/Noun,4,1,3,3.334444814938313e-05,5.553210866523024e-05,0.75
17871,17871,엔/Noun,4,1,3,3.334444814938313e-05,5.553210866523024e-05,0.75
17872,17872,대초반/Foreign,4,1,3,3.334444814938313e-05,5.553210866523024e-05,0.75
17873,17873,일급/Noun,4,1,3,3.334444814938313e-05,5.553210866523024e-05,0.75
17874,17874,마직막/Noun,4,1,3,3.334444814938313e-05,5.553210866523024e-05,0.75
17875,17875,후후훗/Exclamation,4,3,1,5.5574080248971876e-05,3.331926519913814e-05,0.75
17876,17876,파키스탄/Noun,4,1,3,3.334444814938313e-05,5.553210866523024e-05,0.75
17877,17877,프레드/Noun,4,3,1,5.5574080248971876e-05,3.331926519913814e-05,0.75
17878,17878,브루노/Noun,4,1,3,3.334444814938313e-05,5.553210866523024e-05,0.75
17879,17879,추세/Noun,4,1,3,3.334444814938313e-05,5.553210866523024e-05,0.75
17880,17880,일레인/Noun,4,3,1,5.5574080248971876e-05,3.331926519913814e-05,0.75
17881,17881,알바니/Noun,4,1,3,3.334444814938313e-05,5.553210866523024e-05,0.75
17882,17882,성품/Noun,4,1,3,3.334444814938313e-05,5.553210866523024e-05,0.75
17883,17883,버무러진/Noun,4,3,1,5.5574080248971876e-05,3.331926519913814e-05,0.75
17884,17884,비지스/Noun,4,3,1,5.5574080248971876e-05,3.331926519913814e-05,0.75
17885,17885,하이힐/Noun,4,1,3,3.334444814938313e-05,5.553210866523024e-05,0.75
17886,17886,totally/Alpha,4,1,3,3.334444814938313e-05,5.553210866523024e-05,0.75
17887,17887,정진영/Noun,4,1,3,3.334444814938313e-05,5.553210866523024e-05,0.75
17888,17888,멘타/Noun,4,1,3,3.334444814938313e-05,5.553210866523024e-05,0.75
17889,17889,히스레져/Noun,4,3,1,5.5574080248971876e-05,3.331926519913814e-05,0.75
17890,17890,낙엽/Noun,4,1,3,3.334444814938313e-05,5.553210866523024e-05,0.75
17891,17891,서신애/Noun,4,3,1,5.5574080248971876e-05,3.331926519913814e-05,0.75
17892,17892,가당/Noun,4,1,3,3.334444814938313e-05,5.553210866523024e-05,0.75
17893,17893,추종자/Noun,4,1,3,3.334444814938313e-05,5.553210866523024e-05,0.75
17894,17894,헤니/Noun,4,1,3,3.334444814938313e-05,5.553210866523024e-05,0.75
17895,17895,과속/Noun,4,3,1,5.5574080248971876e-05,3.331926519913814e-05,0.75
17896,17896,경감/Noun,4,1,3,3.334444814938313e-05,5.553210866523024e-05,0.75
17897,17897,꽁치/Noun,4,1,3,3.334444814938313e-05,5.553210866523024e-05,0.75
17898,17898,교가/Noun,4,3,1,5.5574080248971876e-05,3.331926519913814e-05,0.75
17899,17899,불가사의/Noun,4,1,3,3.334444814938313e-05,5.553210866523024e-05,0.75
17900,17900,소방/Noun,4,1,3,3.334444814938313e-05,5.553210866523024e-05,0.75
17901,17901,김기범/Noun,4,1,3,3.334444814938313e-05,5.553210866523024e-05,0.75
17902,17902,포지션/Noun,4,1,3,3.334444814938313e-05,5.553210866523024e-05,0.75
17903,17903,항거/Noun,4,1,3,3.334444814938313e-05,5.553210866523024e-05,0.75
17904,17904,왕조/Noun,4,1,3,3.334444814938313e-05,5.553210866523024e-05,0.75
17905,17905,장렬/Noun,4,3,1,5.5574080248971876e-05,3.331926519913814e-05,0.75
17906,17906,취직/Noun,4,1,3,3.334444814938313e-05,5.553210866523024e-05,0.75
17907,17907,.../Foreign,4,1,3,3.334444814938313e-05,5.553210866523024e-05,0.75
17908,17908,별수/Noun,4,1,3,3.334444814938313e-05,5.553210866523024e-05,0.75
17909,17909,세종대왕/Noun,4,1,3,3.334444814938313e-05,5.553210866523024e-05,0.75
17910,17910,외세/Noun,4,3,1,5.5574080248971876e-05,3.331926519913814e-05,0.75
17911,17911,강하늘/Noun,4,3,1,5.5574080248971876e-05,3.331926519913814e-05,0.75
17912,17912,수레기/Noun,4,1,3,3.334444814938313e-05,5.553210866523024e-05,0.75
17913,17913,카메룬/Noun,4,3,1,5.5574080248971876e-05,3.331926519913814e-05,0.75
17914,17914,마이티/Noun,4,3,1,5.5574080248971876e-05,3.331926519913814e-05,0.75
17915,17915,나드/Noun,4,1,3,3.334444814938313e-05,5.553210866523024e-05,0.75
17916,17916,봣던거/Noun,4,3,1,5.5574080248971876e-05,3.331926519913814e-05,0.75
17917,17917,뭐건/Noun,4,1,3,3.334444814938313e-05,5.553210866523024e-05,0.75
17918,17918,찡그리다/Verb,4,1,3,3.334444814938313e-05,5.553210866523024e-05,0.75
17919,17919,막상막하/Noun,4,1,3,3.334444814938313e-05,5.553210866523024e-05,0.75
17920,17920,명박/Noun,4,1,3,3.334444814938313e-05,5.553210866523024e-05,0.75
17921,17921,star/Alpha,4,3,1,5.5574080248971876e-05,3.331926519913814e-05,0.75
17922,17922,th/Alpha,4,3,1,5.5574080248971876e-05,3.331926519913814e-05,0.75
17923,17923,파묻히다/Verb,4,1,3,3.334444814938313e-05,5.553210866523024e-05,0.75
17924,17924,play/Alpha,4,3,1,5.5574080248971876e-05,3.331926519913814e-05,0.75
17925,17925,작이라고는/Foreign,4,1,3,3.334444814938313e-05,5.553210866523024e-05,0.75
17926,17926,소담/Noun,4,3,1,5.5574080248971876e-05,3.331926519913814e-05,0.75
17927,17927,실연/Noun,4,3,1,5.5574080248971876e-05,3.331926519913814e-05,0.75
17928,17928,외박/Noun,4,1,3,3.334444814938313e-05,5.553210866523024e-05,0.75
17929,17929,산화/Noun,4,1,3,3.334444814938313e-05,5.553210866523024e-05,0.75
17930,17930,이말년/Noun,4,1,3,3.334444814938313e-05,5.553210866523024e-05,0.75
17931,17931,맛탱/Noun,4,1,3,3.334444814938313e-05,5.553210866523024e-05,0.75
17932,17932,.;;;/Punctuation,4,1,3,3.334444814938313e-05,5.553210866523024e-05,0.75
17933,17933,꾸리다/Verb,4,1,3,3.334444814938313e-05,5.553210866523024e-05,0.75
17934,17934,축약/Noun,4,3,1,5.5574080248971876e-05,3.331926519913814e-05,0.75
17935,17935,미그/Noun,4,1,3,3.334444814938313e-05,5.553210866523024e-05,0.75
17936,17936,책정/Noun,4,1,3,3.334444814938313e-05,5.553210866523024e-05,0.75
17937,17937,청와대/Noun,4,1,3,3.334444814938313e-05,5.553210866523024e-05,0.75
17938,17938,설킨/Noun,4,3,1,5.5574080248971876e-05,3.331926519913814e-05,0.75
17939,17939,스탈린/Noun,4,3,1,5.5574080248971876e-05,3.331926519913814e-05,0.75
17940,17940,장재인/Noun,4,3,1,5.5574080248971876e-05,3.331926519913814e-05,0.75
17941,17941,윤다훈/Noun,4,1,3,3.334444814938313e-05,5.553210866523024e-05,0.75
17942,17942,_!/Punctuation,4,3,1,5.5574080248971876e-05,3.331926519913814e-05,0.75
17943,17943,장거리/Noun,4,3,1,5.5574080248971876e-05,3.331926519913814e-05,0.75
17944,17944,본새/Noun,4,1,3,3.334444814938313e-05,5.553210866523024e-05,0.75
17945,17945,굶주리다/Verb,4,3,1,5.5574080248971876e-05,3.331926519913814e-05,0.75
17946,17946,부적절하다/Adjective,4,1,3,3.334444814938313e-05,5.553210866523024e-05,0.75
17947,17947,동사/Noun,4,1,3,3.334444814938313e-05,5.553210866523024e-05,0.75
17948,17948,관좀/Noun,4,3,1,5.5574080248971876e-05,3.331926519913814e-05,0.75
17949,17949,곧이/Adverb,4,1,3,3.334444814938313e-05,5.553210866523024e-05,0.75
17950,17950,신기록/Noun,4,1,3,3.334444814938313e-05,5.553210866523024e-05,0.75
17951,17951,작가라/Noun,4,1,3,3.334444814938313e-05,5.553210866523024e-05,0.75
17952,17952,배수빈/Noun,4,3,1,5.5574080248971876e-05,3.331926519913814e-05,0.75
17953,17953,박노식/Noun,4,1,3,3.334444814938313e-05,5.553210866523024e-05,0.75
17954,17954,몽매/Noun,4,1,3,3.334444814938313e-05,5.553210866523024e-05,0.75
17955,17955,백마/Noun,4,1,3,3.334444814938313e-05,5.553210866523024e-05,0.75
17956,17956,헌터헌터/Noun,4,1,3,3.334444814938313e-05,5.553210866523024e-05,0.75
17957,17957,티셔츠/Noun,4,3,1,5.5574080248971876e-05,3.331926519913814e-05,0.75
17958,17958,어김없이/Adverb,4,1,3,3.334444814938313e-05,5.553210866523024e-05,0.75
17959,17959,도에도/Foreign,4,3,1,5.5574080248971876e-05,3.331926519913814e-05,0.75
17960,17960,가바/Noun,4,1,3,3.334444814938313e-05,5.553210866523024e-05,0.75
17961,17961,조디악/Noun,4,1,3,3.334444814938313e-05,5.553210866523024e-05,0.75
17962,17962,외할아버지/Noun,4,3,1,5.5574080248971876e-05,3.331926519913814e-05,0.75
17963,17963,간통죄/Noun,4,1,3,3.334444814938313e-05,5.553210866523024e-05,0.75
17964,17964,CJ/Alpha,4,1,3,3.334444814938313e-05,5.553210866523024e-05,0.75
17965,17965,엔젤아이즈/Noun,4,3,1,5.5574080248971876e-05,3.331926519913814e-05,0.75
17966,17966,유니세프/Noun,4,1,3,3.334444814938313e-05,5.553210866523024e-05,0.75
17967,17967,오라버니/Noun,4,3,1,5.5574080248971876e-05,3.331926519913814e-05,0.75
17968,17968,달동/Noun,4,3,1,5.5574080248971876e-05,3.331926519913814e-05,0.75
17969,17969,모범생/Noun,4,3,1,5.5574080248971876e-05,3.331926519913814e-05,0.75
17970,17970,숏컷/Noun,4,3,1,5.5574080248971876e-05,3.331926519913814e-05,0.75
17971,17971,무과/Noun,4,1,3,3.334444814938313e-05,5.553210866523024e-05,0.75
17972,17972,레비아탄/Noun,4,3,1,5.5574080248971876e-05,3.331926519913814e-05,0.75
17973,17973,사카모토/Noun,4,3,1,5.5574080248971876e-05,3.331926519913814e-05,0.75
17974,17974,종사/Noun,4,1,3,3.334444814938313e-05,5.553210866523024e-05,0.75
17975,17975,순례/Noun,4,3,1,5.5574080248971876e-05,3.331926519913814e-05,0.75
17976,17976,아이피/Noun,4,1,3,3.334444814938313e-05,5.553210866523024e-05,0.75
17977,17977,열대야/Noun,4,3,1,5.5574080248971876e-05,3.331926519913814e-05,0.75
17978,17978,without/Alpha,4,3,1,5.5574080248971876e-05,3.331926519913814e-05,0.75
17979,17979,경쟁력/Noun,4,1,3,3.334444814938313e-05,5.553210866523024e-05,0.75
17980,17980,라일/Noun,4,3,1,5.5574080248971876e-05,3.331926519913814e-05,0.75
17981,17981,왓습니/Noun,4,3,1,5.5574080248971876e-05,3.331926519913814e-05,0.75
17982,17982,왕비/Noun,4,3,1,5.5574080248971876e-05,3.331926519913814e-05,0.75
17983,17983,정일/Noun,4,1,3,3.334444814938313e-05,5.553210866523024e-05,0.75
17984,17984,롬/Noun,4,1,3,3.334444814938313e-05,5.553210866523024e-05,0.75
17985,17985,알렉산드라/Noun,4,1,3,3.334444814938313e-05,5.553210866523024e-05,0.75
17986,17986,슈왈제네거/Noun,4,3,1,5.5574080248971876e-05,3.331926519913814e-05,0.75
17987,17987,거사/Noun,4,1,3,3.334444814938313e-05,5.553210866523024e-05,0.75
17988,17988,지환/Noun,4,3,1,5.5574080248971876e-05,3.331926519913814e-05,0.75
17989,17989,심야식당/Noun,4,1,3,3.334444814938313e-05,5.553210866523024e-05,0.75
17990,17990,재인/Noun,4,3,1,5.5574080248971876e-05,3.331926519913814e-05,0.75
17991,17991,기로/Eomi,4,3,1,5.5574080248971876e-05,3.331926519913814e-05,0.75
17992,17992,크라이/Noun,4,3,1,5.5574080248971876e-05,3.331926519913814e-05,0.75
17993,17993,네마/Noun,4,1,3,3.334444814938313e-05,5.553210866523024e-05,0.75
17994,17994,진목승/Noun,4,1,3,3.334444814938313e-05,5.553210866523024e-05,0.75
17995,17995,감사히/Adverb,4,3,1,5.5574080248971876e-05,3.331926519913814e-05,0.75
17996,17996,한인/Noun,4,3,1,5.5574080248971876e-05,3.331926519913814e-05,0.75
17997,17997,측정/Noun,4,1,3,3.334444814938313e-05,5.553210866523024e-05,0.75
17998,17998,연개/Noun,4,1,3,3.334444814938313e-05,5.553210866523024e-05,0.75
17999,17999,지성인/Noun,4,3,1,5.5574080248971876e-05,3.331926519913814e-05,0.75
18000,18000,교시/Noun,4,1,3,3.334444814938313e-05,5.553210866523024e-05,0.75
18001,18001,왕도/Noun,4,3,1,5.5574080248971876e-05,3.331926519913814e-05,0.75
18002,18002,알콜중독/Noun,4,3,1,5.5574080248971876e-05,3.331926519913814e-05,0.75
18003,18003,나가시/Noun,4,1,3,3.334444814938313e-05,5.553210866523024e-05,0.75
18004,18004,섣불리/Noun,4,3,1,5.5574080248971876e-05,3.331926519913814e-05,0.75
18005,18005,망령/Noun,4,1,3,3.334444814938313e-05,5.553210866523024e-05,0.75
18006,18006,new/Alpha,4,3,1,5.5574080248971876e-05,3.331926519913814e-05,0.75
18007,18007,폐허/Noun,4,3,1,5.5574080248971876e-05,3.331926519913814e-05,0.75
18008,18008,이완용/Noun,4,1,3,3.334444814938313e-05,5.553210866523024e-05,0.75
18009,18009,요업/Noun,4,3,1,5.5574080248971876e-05,3.331926519913814e-05,0.75
18010,18010,태식/Noun,4,3,1,5.5574080248971876e-05,3.331926519913814e-05,0.75
18011,18011,단아/Noun,4,1,3,3.334444814938313e-05,5.553210866523024e-05,0.75
18012,18012,무제/Noun,4,3,1,5.5574080248971876e-05,3.331926519913814e-05,0.75
18013,18013,빰/Noun,4,1,3,3.334444814938313e-05,5.553210866523024e-05,0.75
18014,18014,가까이/Foreign,4,3,1,5.5574080248971876e-05,3.331926519913814e-05,0.75
18015,18015,용철/Noun,4,3,1,5.5574080248971876e-05,3.331926519913814e-05,0.75
18016,18016,태지/Noun,4,3,1,5.5574080248971876e-05,3.331926519913814e-05,0.75
18017,18017,친영/Noun,4,1,3,3.334444814938313e-05,5.553210866523024e-05,0.75
18018,18018,명단/Noun,4,1,3,3.334444814938313e-05,5.553210866523024e-05,0.75
18019,18019,망햇/Noun,4,1,3,3.334444814938313e-05,5.553210866523024e-05,0.75
18020,18020,장옥정/Noun,4,3,1,5.5574080248971876e-05,3.331926519913814e-05,0.75
18021,18021,!^^*/Punctuation,4,3,1,5.5574080248971876e-05,3.331926519913814e-05,0.75
18022,18022,인디음악/Noun,4,1,3,3.334444814938313e-05,5.553210866523024e-05,0.75
18023,18023,윤호/Noun,4,1,3,3.334444814938313e-05,5.553210866523024e-05,0.75
18024,18024,칵/Noun,4,1,3,3.334444814938313e-05,5.553210866523024e-05,0.75
18025,18025,백여/Modifier,4,3,1,5.5574080248971876e-05,3.331926519913814e-05,0.75
18026,18026,애견/Noun,4,1,3,3.334444814938313e-05,5.553210866523024e-05,0.75
18027,18027,기발/Noun,4,3,1,5.5574080248971876e-05,3.331926519913814e-05,0.75
18028,18028,판국/Noun,4,1,3,3.334444814938313e-05,5.553210866523024e-05,0.75
18029,18029,씨익/Noun,4,1,3,3.334444814938313e-05,5.553210866523024e-05,0.75
18030,18030,이엘/Noun,4,1,3,3.334444814938313e-05,5.553210866523024e-05,0.75
18031,18031,선우일란/Noun,4,1,3,3.334444814938313e-05,5.553210866523024e-05,0.75
18032,18032,휙/Noun,4,3,1,5.5574080248971876e-05,3.331926519913814e-05,0.75
18033,18033,배반/Noun,4,1,3,3.334444814938313e-05,5.553210866523024e-05,0.75
18034,18034,이상민/Noun,4,1,3,3.334444814938313e-05,5.553210866523024e-05,0.75
18035,18035,가위손/Noun,4,3,1,5.5574080248971876e-05,3.331926519913814e-05,0.75
18036,18036,감행/Noun,4,1,3,3.334444814938313e-05,5.553210866523024e-05,0.75
18037,18037,향기롭다/Adjective,4,3,1,5.5574080248971876e-05,3.331926519913814e-05,0.75
18038,18038,유족/Noun,4,1,3,3.334444814938313e-05,5.553210866523024e-05,0.75
18039,18039,천성/Noun,4,3,1,5.5574080248971876e-05,3.331926519913814e-05,0.75
18040,18040,비번/Noun,4,1,3,3.334444814938313e-05,5.553210866523024e-05,0.75
18041,18041,토리코/Noun,4,3,1,5.5574080248971876e-05,3.331926519913814e-05,0.75
18042,18042,털털/Noun,4,3,1,5.5574080248971876e-05,3.331926519913814e-05,0.75
18043,18043,..</Punctuation,4,3,1,5.5574080248971876e-05,3.331926519913814e-05,0.75
18044,18044,색정/Noun,4,1,3,3.334444814938313e-05,5.553210866523024e-05,0.75
18045,18045,참조/Noun,4,3,1,5.5574080248971876e-05,3.331926519913814e-05,0.75
18046,18046,통통하다/Adjective,4,3,1,5.5574080248971876e-05,3.331926519913814e-05,0.75
18047,18047,먹이사슬/Noun,4,3,1,5.5574080248971876e-05,3.331926519913814e-05,0.75
18048,18048,해어지다/Verb,4,3,1,5.5574080248971876e-05,3.331926519913814e-05,0.75
18049,18049,;;.../Punctuation,4,1,3,3.334444814938313e-05,5.553210866523024e-05,0.75
18050,18050,색계/Noun,4,3,1,5.5574080248971876e-05,3.331926519913814e-05,0.75
18051,18051,단물/Noun,4,1,3,3.334444814938313e-05,5.553210866523024e-05,0.75
18052,18052,증가/Noun,4,1,3,3.334444814938313e-05,5.553210866523024e-05,0.75
18053,18053,등용문/Noun,4,3,1,5.5574080248971876e-05,3.331926519913814e-05,0.75
18054,18054,발자취/Noun,4,3,1,5.5574080248971876e-05,3.331926519913814e-05,0.75
18055,18055,의논/Noun,4,1,3,3.334444814938313e-05,5.553210866523024e-05,0.75
18056,18056,티끌/Noun,4,3,1,5.5574080248971876e-05,3.331926519913814e-05,0.75
18057,18057,금욕/Noun,4,3,1,5.5574080248971876e-05,3.331926519913814e-05,0.75
18058,18058,뉴에이지/Noun,4,1,3,3.334444814938313e-05,5.553210866523024e-05,0.75
18059,18059,처럼만/Josa,4,1,3,3.334444814938313e-05,5.553210866523024e-05,0.75
18060,18060,고만고만하다/Adjective,4,1,3,3.334444814938313e-05,5.553210866523024e-05,0.75
18061,18061,어중/Noun,4,1,3,3.334444814938313e-05,5.553210866523024e-05,0.75
18062,18062,불평등/Noun,4,3,1,5.5574080248971876e-05,3.331926519913814e-05,0.75
18063,18063,소년원/Noun,4,1,3,3.334444814938313e-05,5.553210866523024e-05,0.75
18064,18064,육회/Noun,4,1,3,3.334444814938313e-05,5.553210866523024e-05,0.75
18065,18065,오스트리아/Noun,4,1,3,3.334444814938313e-05,5.553210866523024e-05,0.75
18066,18066,적성/Noun,4,1,3,3.334444814938313e-05,5.553210866523024e-05,0.75
18067,18067,얼떨결/Noun,4,3,1,5.5574080248971876e-05,3.331926519913814e-05,0.75
18068,18068,24시/Number,4,3,1,5.5574080248971876e-05,3.331926519913814e-05,0.75
18069,18069,이규형/Noun,4,3,1,5.5574080248971876e-05,3.331926519913814e-05,0.75
18070,18070,무극/Noun,4,1,3,3.334444814938313e-05,5.553210866523024e-05,0.75
18071,18071,규명/Noun,4,3,1,5.5574080248971876e-05,3.331926519913814e-05,0.75
18072,18072,반헬싱/Noun,4,1,3,3.334444814938313e-05,5.553210866523024e-05,0.75
18073,18073,여류/Noun,4,3,1,5.5574080248971876e-05,3.331926519913814e-05,0.75
18074,18074,어리석음/Noun,4,1,3,3.334444814938313e-05,5.553210866523024e-05,0.75
18075,18075,의드/Noun,4,3,1,5.5574080248971876e-05,3.331926519913814e-05,0.75
18076,18076,마하/Noun,4,1,3,3.334444814938313e-05,5.553210866523024e-05,0.75
18077,18077,빅뱅이론/Noun,4,1,3,3.334444814938313e-05,5.553210866523024e-05,0.75
18078,18078,수발/Noun,4,1,3,3.334444814938313e-05,5.553210866523024e-05,0.75
18079,18079,상사부일체/Noun,4,1,3,3.334444814938313e-05,5.553210866523024e-05,0.75
18080,18080,밨다/Noun,4,3,1,5.5574080248971876e-05,3.331926519913814e-05,0.75
18081,18081,풍경화/Noun,4,3,1,5.5574080248971876e-05,3.331926519913814e-05,0.75
18082,18082,캠벨/Noun,4,1,3,3.334444814938313e-05,5.553210866523024e-05,0.75
18083,18083,편입/Noun,4,3,1,5.5574080248971876e-05,3.331926519913814e-05,0.75
18084,18084,업슴/Noun,4,1,3,3.334444814938313e-05,5.553210866523024e-05,0.75
18085,18085,하란/Noun,4,1,3,3.334444814938313e-05,5.553210866523024e-05,0.75
18086,18086,다봣다/Noun,4,3,1,5.5574080248971876e-05,3.331926519913814e-05,0.75
18087,18087,중천/Noun,4,1,3,3.334444814938313e-05,5.553210866523024e-05,0.75
18088,18088,촉/Noun,4,1,3,3.334444814938313e-05,5.553210866523024e-05,0.75
18089,18089,이쁜이/Noun,4,3,1,5.5574080248971876e-05,3.331926519913814e-05,0.75
18090,18090,한우/Noun,4,1,3,3.334444814938313e-05,5.553210866523024e-05,0.75
18091,18091,한가하다/Adjective,4,1,3,3.334444814938313e-05,5.553210866523024e-05,0.75
18092,18092,......................................../Punctuation,4,1,3,3.334444814938313e-05,5.553210866523024e-05,0.75
18093,18093,토악질/Noun,4,1,3,3.334444814938313e-05,5.553210866523024e-05,0.75
18094,18094,수연/Noun,4,3,1,5.5574080248971876e-05,3.331926519913814e-05,0.75
18095,18095,70-80년/Number,4,1,3,3.334444814938313e-05,5.553210866523024e-05,0.75
18096,18096,지중해/Noun,4,3,1,5.5574080248971876e-05,3.331926519913814e-05,0.75
18097,18097,점심/Noun,4,3,1,5.5574080248971876e-05,3.331926519913814e-05,0.75
18098,18098,동맹/Noun,4,1,3,3.334444814938313e-05,5.553210866523024e-05,0.75
18099,18099,비탄/Noun,4,3,1,5.5574080248971876e-05,3.331926519913814e-05,0.75
18100,18100,느데/Noun,4,1,3,3.334444814938313e-05,5.553210866523024e-05,0.75
18101,18101,모텐슨/Noun,4,3,1,5.5574080248971876e-05,3.331926519913814e-05,0.75
18102,18102,종착역/Noun,4,3,1,5.5574080248971876e-05,3.331926519913814e-05,0.75
18103,18103,대장정/Noun,4,3,1,5.5574080248971876e-05,3.331926519913814e-05,0.75
18104,18104,자학/Noun,4,1,3,3.334444814938313e-05,5.553210866523024e-05,0.75
18105,18105,행진곡/Noun,4,3,1,5.5574080248971876e-05,3.331926519913814e-05,0.75
18106,18106,시조/Noun,4,3,1,5.5574080248971876e-05,3.331926519913814e-05,0.75
18107,18107,사육/Noun,4,1,3,3.334444814938313e-05,5.553210866523024e-05,0.75
18108,18108,아크로바틱/Noun,4,3,1,5.5574080248971876e-05,3.331926519913814e-05,0.75
18109,18109,변두리/Noun,4,3,1,5.5574080248971876e-05,3.331926519913814e-05,0.75
18110,18110,벼랑/Noun,4,3,1,5.5574080248971876e-05,3.331926519913814e-05,0.75
18111,18111,대피/Noun,4,1,3,3.334444814938313e-05,5.553210866523024e-05,0.75
18112,18112,아랑/Noun,4,3,1,5.5574080248971876e-05,3.331926519913814e-05,0.75
18113,18113,역린/Noun,4,3,1,5.5574080248971876e-05,3.331926519913814e-05,0.75
18114,18114,10위안/Number,4,3,1,5.5574080248971876e-05,3.331926519913814e-05,0.75
18115,18115,문관/Noun,4,1,3,3.334444814938313e-05,5.553210866523024e-05,0.75
18116,18116,주정뱅이/Noun,4,1,3,3.334444814938313e-05,5.553210866523024e-05,0.75
18117,18117,도살/Noun,4,1,3,3.334444814938313e-05,5.553210866523024e-05,0.75
18118,18118,장보고/Noun,4,3,1,5.5574080248971876e-05,3.331926519913814e-05,0.75
18119,18119,블랑쉐/Noun,4,3,1,5.5574080248971876e-05,3.331926519913814e-05,0.75
18120,18120,재중/Noun,4,3,1,5.5574080248971876e-05,3.331926519913814e-05,0.75
18121,18121,생중계/Noun,4,3,1,5.5574080248971876e-05,3.331926519913814e-05,0.75
18122,18122,바짝/Noun,4,3,1,5.5574080248971876e-05,3.331926519913814e-05,0.75
18123,18123,리까/Noun,4,3,1,5.5574080248971876e-05,3.331926519913814e-05,0.75
18124,18124,나태하다/Adjective,4,1,3,3.334444814938313e-05,5.553210866523024e-05,0.75
18125,18125,강탈/Noun,4,1,3,3.334444814938313e-05,5.553210866523024e-05,0.75
18126,18126,혜교/Noun,4,3,1,5.5574080248971876e-05,3.331926519913814e-05,0.75
18127,18127,저년/Noun,4,1,3,3.334444814938313e-05,5.553210866523024e-05,0.75
18128,18128,무용지물/Noun,4,1,3,3.334444814938313e-05,5.553210866523024e-05,0.75
18129,18129,플랜/Noun,4,1,3,3.334444814938313e-05,5.553210866523024e-05,0.75
18130,18130,쯔/Noun,4,3,1,5.5574080248971876e-05,3.331926519913814e-05,0.75
18131,18131,대딩/Noun,4,1,3,3.334444814938313e-05,5.553210866523024e-05,0.75
18132,18132,낚아/Noun,4,1,3,3.334444814938313e-05,5.553210866523024e-05,0.75
18133,18133,손수/Noun,4,1,3,3.334444814938313e-05,5.553210866523024e-05,0.75
18134,18134,김전일/Noun,4,1,3,3.334444814938313e-05,5.553210866523024e-05,0.75
18135,18135,즉흥/Noun,4,1,3,3.334444814938313e-05,5.553210866523024e-05,0.75
18136,18136,영도/Noun,4,1,3,3.334444814938313e-05,5.553210866523024e-05,0.75
18137,18137,대학시절/Noun,4,3,1,5.5574080248971876e-05,3.331926519913814e-05,0.75
18138,18138,됫는데/Noun,4,3,1,5.5574080248971876e-05,3.331926519913814e-05,0.75
18139,18139,노프/Noun,4,3,1,5.5574080248971876e-05,3.331926519913814e-05,0.75
18140,18140,방주/Noun,4,1,3,3.334444814938313e-05,5.553210866523024e-05,0.75
18141,18141,괜찬다/Noun,4,3,1,5.5574080248971876e-05,3.331926519913814e-05,0.75
18142,18142,끝낫/Noun,4,3,1,5.5574080248971876e-05,3.331926519913814e-05,0.75
18143,18143,!@/Punctuation,4,3,1,5.5574080248971876e-05,3.331926519913814e-05,0.75
18144,18144,브라우닝/Noun,4,3,1,5.5574080248971876e-05,3.331926519913814e-05,0.75
18145,18145,건배/Noun,4,1,3,3.334444814938313e-05,5.553210866523024e-05,0.75
18146,18146,way/Alpha,4,3,1,5.5574080248971876e-05,3.331926519913814e-05,0.75
18147,18147,명실/Noun,4,3,1,5.5574080248971876e-05,3.331926519913814e-05,0.75
18148,18148,고취/Noun,4,1,3,3.334444814938313e-05,5.553210866523024e-05,0.75
18149,18149,무적인/Noun,4,1,3,3.334444814938313e-05,5.553210866523024e-05,0.75
18150,18150,소치/Noun,4,1,3,3.334444814938313e-05,5.553210866523024e-05,0.75
18151,18151,시드니/Noun,4,3,1,5.5574080248971876e-05,3.331926519913814e-05,0.75
18152,18152,구점/Noun,4,3,1,5.5574080248971876e-05,3.331926519913814e-05,0.75
18153,18153,포핀스/Noun,4,3,1,5.5574080248971876e-05,3.331926519913814e-05,0.75
18154,18154,간신/Noun,4,3,1,5.5574080248971876e-05,3.331926519913814e-05,0.75
18155,18155,ㅡㅡㅗ/KoreanParticle,4,1,3,3.334444814938313e-05,5.553210866523024e-05,0.75
18156,18156,리수/Noun,4,1,3,3.334444814938313e-05,5.553210866523024e-05,0.75
18157,18157,비빔밥/Noun,4,1,3,3.334444814938313e-05,5.553210866523024e-05,0.75
18158,18158,5천원/Number,4,1,3,3.334444814938313e-05,5.553210866523024e-05,0.75
18159,18159,지란/Noun,4,1,3,3.334444814938313e-05,5.553210866523024e-05,0.75
18160,18160,10원/Number,4,1,3,3.334444814938313e-05,5.553210866523024e-05,0.75
18161,18161,센티/Noun,4,1,3,3.334444814938313e-05,5.553210866523024e-05,0.75
18162,18162,인트로/Noun,4,3,1,5.5574080248971876e-05,3.331926519913814e-05,0.75
18163,18163,체인/Noun,4,3,1,5.5574080248971876e-05,3.331926519913814e-05,0.75
18164,18164,규환/Noun,4,3,1,5.5574080248971876e-05,3.331926519913814e-05,0.75
18165,18165,소홀하다/Adjective,4,3,1,5.5574080248971876e-05,3.331926519913814e-05,0.75
18166,18166,조화로/Noun,4,3,1,5.5574080248971876e-05,3.331926519913814e-05,0.75
18167,18167,탑제/Noun,4,1,3,3.334444814938313e-05,5.553210866523024e-05,0.75
18168,18168,조련사/Noun,4,3,1,5.5574080248971876e-05,3.331926519913814e-05,0.75
18169,18169,학기/Noun,4,3,1,5.5574080248971876e-05,3.331926519913814e-05,0.75
18170,18170,부러워하다/Adjective,4,3,1,5.5574080248971876e-05,3.331926519913814e-05,0.75
18171,18171,고차원/Noun,4,1,3,3.334444814938313e-05,5.553210866523024e-05,0.75
18172,18172,녹정기/Noun,4,3,1,5.5574080248971876e-05,3.331926519913814e-05,0.75
18173,18173,충청도/Noun,4,1,3,3.334444814938313e-05,5.553210866523024e-05,0.75
18174,18174,물임/Noun,4,1,3,3.334444814938313e-05,5.553210866523024e-05,0.75
18175,18175,은폐/Noun,4,1,3,3.334444814938313e-05,5.553210866523024e-05,0.75
18176,18176,동엽신/Noun,4,3,1,5.5574080248971876e-05,3.331926519913814e-05,0.75
18177,18177,저우쉰/Noun,4,3,1,5.5574080248971876e-05,3.331926519913814e-05,0.75
18178,18178,위스키/Noun,4,1,3,3.334444814938313e-05,5.553210866523024e-05,0.75
18179,18179,가나다라/Noun,4,1,3,3.334444814938313e-05,5.553210866523024e-05,0.75
18180,18180,일임/Noun,4,3,1,5.5574080248971876e-05,3.331926519913814e-05,0.75
18181,18181,뮤턴트/Noun,4,1,3,3.334444814938313e-05,5.553210866523024e-05,0.75
18182,18182,3위안/Number,4,3,1,5.5574080248971876e-05,3.331926519913814e-05,0.75
18183,18183,베이컨시/Noun,4,1,3,3.334444814938313e-05,5.553210866523024e-05,0.75
18184,18184,설움/Noun,4,1,3,3.334444814938313e-05,5.553210866523024e-05,0.75
18185,18185,바나나/Noun,4,1,3,3.334444814938313e-05,5.553210866523024e-05,0.75
18186,18186,프랭코/Noun,4,3,1,5.5574080248971876e-05,3.331926519913814e-05,0.75
18187,18187,핑구/Noun,4,1,3,3.334444814938313e-05,5.553210866523024e-05,0.75
18188,18188,투명/Noun,4,1,3,3.334444814938313e-05,5.553210866523024e-05,0.75
18189,18189,김봉두/Noun,4,3,1,5.5574080248971876e-05,3.331926519913814e-05,0.75
18190,18190,고학년/Noun,4,1,3,3.334444814938313e-05,5.553210866523024e-05,0.75
18191,18191,천추/Noun,4,1,3,3.334444814938313e-05,5.553210866523024e-05,0.75
18192,18192,스톱모션/Noun,4,3,1,5.5574080248971876e-05,3.331926519913814e-05,0.75
18193,18193,쫑/Noun,4,3,1,5.5574080248971876e-05,3.331926519913814e-05,0.75
18194,18194,정씨/Noun,4,3,1,5.5574080248971876e-05,3.331926519913814e-05,0.75
18195,18195,우어어/Exclamation,4,1,3,3.334444814938313e-05,5.553210866523024e-05,0.75
18196,18196,버킷/Noun,4,3,1,5.5574080248971876e-05,3.331926519913814e-05,0.75
18197,18197,돌파구/Noun,4,3,1,5.5574080248971876e-05,3.331926519913814e-05,0.75
18198,18198,49회/Number,4,1,3,3.334444814938313e-05,5.553210866523024e-05,0.75
18199,18199,백투더퓨쳐/Noun,4,3,1,5.5574080248971876e-05,3.331926519913814e-05,0.75
18200,18200,윤진이/Noun,4,1,3,3.334444814938313e-05,5.553210866523024e-05,0.75
18201,18201,어렷/Noun,4,3,1,5.5574080248971876e-05,3.331926519913814e-05,0.75
18202,18202,본뜨다/Verb,4,1,3,3.334444814938313e-05,5.553210866523024e-05,0.75
18203,18203,잘되지/Noun,4,3,1,5.5574080248971876e-05,3.331926519913814e-05,0.75
18204,18204,비드/Noun,4,3,1,5.5574080248971876e-05,3.331926519913814e-05,0.75
18205,18205,산삼/Noun,4,1,3,3.334444814938313e-05,5.553210866523024e-05,0.75
18206,18206,ㅘ/KoreanParticle,4,3,1,5.5574080248971876e-05,3.331926519913814e-05,0.75
18207,18207,빛깔/Noun,4,3,1,5.5574080248971876e-05,3.331926519913814e-05,0.75
18208,18208,분홍/Noun,4,3,1,5.5574080248971876e-05,3.331926519913814e-05,0.75
18209,18209,배럴/Noun,4,1,3,3.334444814938313e-05,5.553210866523024e-05,0.75
18210,18210,스탁/Noun,4,1,3,3.334444814938313e-05,5.553210866523024e-05,0.75
18211,18211,슬럼프/Noun,4,1,3,3.334444814938313e-05,5.553210866523024e-05,0.75
18212,18212,조교/Noun,4,1,3,3.334444814938313e-05,5.553210866523024e-05,0.75
18213,18213,8.3/Number,4,3,1,5.5574080248971876e-05,3.331926519913814e-05,0.75
18214,18214,렁/Noun,4,3,1,5.5574080248971876e-05,3.331926519913814e-05,0.75
18215,18215,거린/Noun,4,1,3,3.334444814938313e-05,5.553210866523024e-05,0.75
18216,18216,안티크라이스트/Noun,4,3,1,5.5574080248971876e-05,3.331926519913814e-05,0.75
18217,18217,직선/Noun,4,3,1,5.5574080248971876e-05,3.331926519913814e-05,0.75
18218,18218,00/Number,4,3,1,5.5574080248971876e-05,3.331926519913814e-05,0.75
18219,18219,신야/Noun,4,3,1,5.5574080248971876e-05,3.331926519913814e-05,0.75
18220,18220,스타게이트/Noun,4,3,1,5.5574080248971876e-05,3.331926519913814e-05,0.75
18221,18221,똑살/Noun,4,3,1,5.5574080248971876e-05,3.331926519913814e-05,0.75
18222,18222,쿠로/Noun,4,3,1,5.5574080248971876e-05,3.331926519913814e-05,0.75
18223,18223,찍찍/Noun,4,1,3,3.334444814938313e-05,5.553210866523024e-05,0.75
18224,18224,흥신소/Noun,4,1,3,3.334444814938313e-05,5.553210866523024e-05,0.75
18225,18225,동하/Noun,4,3,1,5.5574080248971876e-05,3.331926519913814e-05,0.75
18226,18226,입시/Noun,4,3,1,5.5574080248971876e-05,3.331926519913814e-05,0.75
18227,18227,외심/Noun,4,3,1,5.5574080248971876e-05,3.331926519913814e-05,0.75
18228,18228,퀼트/Noun,4,3,1,5.5574080248971876e-05,3.331926519913814e-05,0.75
18229,18229,영구아트/Noun,4,1,3,3.334444814938313e-05,5.553210866523024e-05,0.75
18230,18230,털보/Noun,4,3,1,5.5574080248971876e-05,3.331926519913814e-05,0.75
18231,18231,개임/Noun,4,3,1,5.5574080248971876e-05,3.331926519913814e-05,0.75
18232,18232,액기스/Noun,4,3,1,5.5574080248971876e-05,3.331926519913814e-05,0.75
18233,18233,리만/Noun,4,1,3,3.334444814938313e-05,5.553210866523024e-05,0.75
18234,18234,채탁연/Noun,4,3,1,5.5574080248971876e-05,3.331926519913814e-05,0.75
18235,18235,티노/Noun,4,3,1,5.5574080248971876e-05,3.331926519913814e-05,0.75
18236,18236,다이너마이트/Noun,4,1,3,3.334444814938313e-05,5.553210866523024e-05,0.75
18237,18237,독점/Noun,4,3,1,5.5574080248971876e-05,3.331926519913814e-05,0.75
18238,18238,만수/Noun,4,3,1,5.5574080248971876e-05,3.331926519913814e-05,0.75
18239,18239,유플러스/Noun,4,1,3,3.334444814938313e-05,5.553210866523024e-05,0.75
18240,18240,배아/Noun,4,3,1,5.5574080248971876e-05,3.331926519913814e-05,0.75
18241,18241,헐떡거리다/Verb,4,1,3,3.334444814938313e-05,5.553210866523024e-05,0.75
18242,18242,죗값/Noun,4,1,3,3.334444814938313e-05,5.553210866523024e-05,0.75
18243,18243,불가사리/Noun,4,3,1,5.5574080248971876e-05,3.331926519913814e-05,0.75
18244,18244,하루빨리/Adverb,4,3,1,5.5574080248971876e-05,3.331926519913814e-05,0.75
18245,18245,빼기/Noun,4,1,3,3.334444814938313e-05,5.553210866523024e-05,0.75
18246,18246,네모/Noun,4,3,1,5.5574080248971876e-05,3.331926519913814e-05,0.75
18247,18247,ㅋㅎㅋㅎ/KoreanParticle,4,3,1,5.5574080248971876e-05,3.331926519913814e-05,0.75
18248,18248,윙거/Noun,4,3,1,5.5574080248971876e-05,3.331926519913814e-05,0.75
18249,18249,황순원/Noun,4,3,1,5.5574080248971876e-05,3.331926519913814e-05,0.75
18250,18250,카를로/Noun,4,3,1,5.5574080248971876e-05,3.331926519913814e-05,0.75
18251,18251,개쩌는데/Noun,4,1,3,3.334444814938313e-05,5.553210866523024e-05,0.75
18252,18252,마중/Noun,4,3,1,5.5574080248971876e-05,3.331926519913814e-05,0.75
18253,18253,기안/Noun,4,1,3,3.334444814938313e-05,5.553210866523024e-05,0.75
18254,18254,아카펠라/Noun,4,1,3,3.334444814938313e-05,5.553210866523024e-05,0.75
18255,18255,소꿉장난/Noun,4,1,3,3.334444814938313e-05,5.553210866523024e-05,0.75
18256,18256,ㅏㅏ/KoreanParticle,4,1,3,3.334444814938313e-05,5.553210866523024e-05,0.75
18257,18257,화물/Noun,4,1,3,3.334444814938313e-05,5.553210866523024e-05,0.75
18258,18258,테입/Noun,4,3,1,5.5574080248971876e-05,3.331926519913814e-05,0.75
18259,18259,함익병/Noun,4,1,3,3.334444814938313e-05,5.553210866523024e-05,0.75
18260,18260,수순/Noun,4,1,3,3.334444814938313e-05,5.553210866523024e-05,0.75
18261,18261,강력반/Noun,4,1,3,3.334444814938313e-05,5.553210866523024e-05,0.75
18262,18262,갯수/Noun,4,1,3,3.334444814938313e-05,5.553210866523024e-05,0.75
18263,18263,가꾸다/Verb,4,1,3,3.334444814938313e-05,5.553210866523024e-05,0.75
18264,18264,위층/Noun,4,1,3,3.334444814938313e-05,5.553210866523024e-05,0.75
18265,18265,경호/Noun,4,3,1,5.5574080248971876e-05,3.331926519913814e-05,0.75
18266,18266,주군의태양/Noun,4,3,1,5.5574080248971876e-05,3.331926519913814e-05,0.75
18267,18267,ddr/Alpha,4,1,3,3.334444814938313e-05,5.553210866523024e-05,0.75
18268,18268,결부/Noun,4,3,1,5.5574080248971876e-05,3.331926519913814e-05,0.75
18269,18269,장어/Noun,4,1,3,3.334444814938313e-05,5.553210866523024e-05,0.75
18270,18270,운전대/Noun,4,1,3,3.334444814938313e-05,5.553210866523024e-05,0.75
18271,18271,예비/Noun,4,3,1,5.5574080248971876e-05,3.331926519913814e-05,0.75
18272,18272,윈도우/Noun,4,3,1,5.5574080248971876e-05,3.331926519913814e-05,0.75
18273,18273,얼빠지다/Verb,4,1,3,3.334444814938313e-05,5.553210866523024e-05,0.75
18274,18274,메로/Noun,4,1,3,3.334444814938313e-05,5.553210866523024e-05,0.75
18275,18275,51/Number,4,1,3,3.334444814938313e-05,5.553210866523024e-05,0.75
18276,18276,유경/Noun,4,1,3,3.334444814938313e-05,5.553210866523024e-05,0.75
18277,18277,웍/Noun,4,3,1,5.5574080248971876e-05,3.331926519913814e-05,0.75
18278,18278,",,,,,,,,,,,/Punctuation",4,1,3,3.334444814938313e-05,5.553210866523024e-05,0.75
18279,18279,쌩뚱맞음/Noun,4,1,3,3.334444814938313e-05,5.553210866523024e-05,0.75
18280,18280,초사/Noun,4,1,3,3.334444814938313e-05,5.553210866523024e-05,0.75
18281,18281,헬멧/Noun,4,1,3,3.334444814938313e-05,5.553210866523024e-05,0.75
18282,18282,날렵하다/Adjective,4,3,1,5.5574080248971876e-05,3.331926519913814e-05,0.75
18283,18283,그야/Noun,4,1,3,3.334444814938313e-05,5.553210866523024e-05,0.75
18284,18284,강가/Noun,4,1,3,3.334444814938313e-05,5.553210866523024e-05,0.75
18285,18285,PS/Alpha,4,1,3,3.334444814938313e-05,5.553210866523024e-05,0.75
18286,18286,벌린/Noun,4,1,3,3.334444814938313e-05,5.553210866523024e-05,0.75
18287,18287,물정/Noun,4,3,1,5.5574080248971876e-05,3.331926519913814e-05,0.75
18288,18288,대영화/Foreign,4,1,3,3.334444814938313e-05,5.553210866523024e-05,0.75
18289,18289,박제/Noun,4,1,3,3.334444814938313e-05,5.553210866523024e-05,0.75
18290,18290,텐트/Noun,4,1,3,3.334444814938313e-05,5.553210866523024e-05,0.75
18291,18291,등산/Noun,4,1,3,3.334444814938313e-05,5.553210866523024e-05,0.75
18292,18292,지정/Noun,4,3,1,5.5574080248971876e-05,3.331926519913814e-05,0.75
18293,18293,이인/Noun,4,1,3,3.334444814938313e-05,5.553210866523024e-05,0.75
18294,18294,본가/Noun,4,1,3,3.334444814938313e-05,5.553210866523024e-05,0.75
18295,18295,차세대/Noun,4,3,1,5.5574080248971876e-05,3.331926519913814e-05,0.75
18296,18296,묵념/Noun,4,1,3,3.334444814938313e-05,5.553210866523024e-05,0.75
18297,18297,김태균/Noun,4,1,3,3.334444814938313e-05,5.553210866523024e-05,0.75
18298,18298,디안시/Noun,4,1,3,3.334444814938313e-05,5.553210866523024e-05,0.75
18299,18299,난치/Noun,4,1,3,3.334444814938313e-05,5.553210866523024e-05,0.75
18300,18300,울궈/Noun,4,1,3,3.334444814938313e-05,5.553210866523024e-05,0.75
18301,18301,웃픈/Noun,4,3,1,5.5574080248971876e-05,3.331926519913814e-05,0.75
18302,18302,어여쁘다/Adjective,4,3,1,5.5574080248971876e-05,3.331926519913814e-05,0.75
18303,18303,동산/Noun,4,3,1,5.5574080248971876e-05,3.331926519913814e-05,0.75
18304,18304,수갑/Noun,4,1,3,3.334444814938313e-05,5.553210866523024e-05,0.75
18305,18305,삐뚤다/Adjective,4,3,1,5.5574080248971876e-05,3.331926519913814e-05,0.75
18306,18306,황인/Noun,4,3,1,5.5574080248971876e-05,3.331926519913814e-05,0.75
18307,18307,아르헨/Noun,4,3,1,5.5574080248971876e-05,3.331926519913814e-05,0.75
18308,18308,man/Alpha,4,3,1,5.5574080248971876e-05,3.331926519913814e-05,0.75
18309,18309,티보/Noun,4,1,3,3.334444814938313e-05,5.553210866523024e-05,0.75
18310,18310,인디펜던스/Noun,4,1,3,3.334444814938313e-05,5.553210866523024e-05,0.75
18311,18311,약사/Noun,4,3,1,5.5574080248971876e-05,3.331926519913814e-05,0.75
18312,18312,엔/Foreign,4,2,2,4.445926419917751e-05,4.4425686932184186e-05,0.5
18313,18313,유채영/Noun,4,2,2,4.445926419917751e-05,4.4425686932184186e-05,0.5
18314,18314,국민성/Noun,4,2,2,4.445926419917751e-05,4.4425686932184186e-05,0.5
18315,18315,논문/Noun,4,2,2,4.445926419917751e-05,4.4425686932184186e-05,0.5
18316,18316,앞잡이/Noun,4,2,2,4.445926419917751e-05,4.4425686932184186e-05,0.5
18317,18317,over/Alpha,4,2,2,4.445926419917751e-05,4.4425686932184186e-05,0.5
18318,18318,OVA/Alpha,4,2,2,4.445926419917751e-05,4.4425686932184186e-05,0.5
18319,18319,미식축구/Noun,4,2,2,4.445926419917751e-05,4.4425686932184186e-05,0.5
18320,18320,500만원/Number,4,2,2,4.445926419917751e-05,4.4425686932184186e-05,0.5
18321,18321,때때로/Adverb,4,2,2,4.445926419917751e-05,4.4425686932184186e-05,0.5
18322,18322,저글링/Noun,4,2,2,4.445926419917751e-05,4.4425686932184186e-05,0.5
18323,18323,밀실/Noun,4,2,2,4.445926419917751e-05,4.4425686932184186e-05,0.5
18324,18324,말아톤/Noun,4,2,2,4.445926419917751e-05,4.4425686932184186e-05,0.5
18325,18325,w/Alpha,4,2,2,4.445926419917751e-05,4.4425686932184186e-05,0.5
18326,18326,루시퍼/Noun,4,2,2,4.445926419917751e-05,4.4425686932184186e-05,0.5
18327,18327,김지우/Noun,4,2,2,4.445926419917751e-05,4.4425686932184186e-05,0.5
18328,18328,장항준/Noun,4,2,2,4.445926419917751e-05,4.4425686932184186e-05,0.5
18329,18329,부제목/Noun,4,2,2,4.445926419917751e-05,4.4425686932184186e-05,0.5
18330,18330,랩퍼/Noun,4,2,2,4.445926419917751e-05,4.4425686932184186e-05,0.5
18331,18331,프린세스/Noun,4,2,2,4.445926419917751e-05,4.4425686932184186e-05,0.5
18332,18332,프린스/Noun,4,2,2,4.445926419917751e-05,4.4425686932184186e-05,0.5
18333,18333,매하/Noun,4,2,2,4.445926419917751e-05,4.4425686932184186e-05,0.5
18334,18334,말레이시아/Noun,4,2,2,4.445926419917751e-05,4.4425686932184186e-05,0.5
18335,18335,ㅎㅅㅎ/KoreanParticle,4,2,2,4.445926419917751e-05,4.4425686932184186e-05,0.5
18336,18336,zzzz/Alpha,4,2,2,4.445926419917751e-05,4.4425686932184186e-05,0.5
18337,18337,제복/Noun,4,2,2,4.445926419917751e-05,4.4425686932184186e-05,0.5
18338,18338,78/Number,4,2,2,4.445926419917751e-05,4.4425686932184186e-05,0.5
18339,18339,..?!/Punctuation,4,2,2,4.445926419917751e-05,4.4425686932184186e-05,0.5
18340,18340,득실/Noun,4,2,2,4.445926419917751e-05,4.4425686932184186e-05,0.5
18341,18341,쿠리다/Adjective,4,2,2,4.445926419917751e-05,4.4425686932184186e-05,0.5
18342,18342,품세/Noun,4,2,2,4.445926419917751e-05,4.4425686932184186e-05,0.5
18343,18343,스마우그/Noun,4,2,2,4.445926419917751e-05,4.4425686932184186e-05,0.5
18344,18344,유에프오/Noun,4,2,2,4.445926419917751e-05,4.4425686932184186e-05,0.5
18345,18345,무한대/Noun,4,2,2,4.445926419917751e-05,4.4425686932184186e-05,0.5
18346,18346,***/Punctuation,4,2,2,4.445926419917751e-05,4.4425686932184186e-05,0.5
18347,18347,밧줄/Noun,4,2,2,4.445926419917751e-05,4.4425686932184186e-05,0.5
18348,18348,오역/Noun,4,2,2,4.445926419917751e-05,4.4425686932184186e-05,0.5
18349,18349,수퍼/Noun,4,2,2,4.445926419917751e-05,4.4425686932184186e-05,0.5
18350,18350,간격/Noun,4,2,2,4.445926419917751e-05,4.4425686932184186e-05,0.5
18351,18351,태웅/Noun,4,2,2,4.445926419917751e-05,4.4425686932184186e-05,0.5
18352,18352,인도판/Noun,4,2,2,4.445926419917751e-05,4.4425686932184186e-05,0.5
18353,18353,듀오/Noun,4,2,2,4.445926419917751e-05,4.4425686932184186e-05,0.5
18354,18354,김탁구/Noun,4,2,2,4.445926419917751e-05,4.4425686932184186e-05,0.5
18355,18355,독재정/Noun,4,2,2,4.445926419917751e-05,4.4425686932184186e-05,0.5
18356,18356,기독교도/Noun,4,2,2,4.445926419917751e-05,4.4425686932184186e-05,0.5
18357,18357,조동혁/Noun,4,2,2,4.445926419917751e-05,4.4425686932184186e-05,0.5
18358,18358,파도처럼/Noun,4,2,2,4.445926419917751e-05,4.4425686932184186e-05,0.5
18359,18359,상봉/Noun,4,2,2,4.445926419917751e-05,4.4425686932184186e-05,0.5
18360,18360,세바스찬/Noun,4,2,2,4.445926419917751e-05,4.4425686932184186e-05,0.5
18361,18361,오사카/Noun,4,2,2,4.445926419917751e-05,4.4425686932184186e-05,0.5
18362,18362,두발/Noun,4,2,2,4.445926419917751e-05,4.4425686932184186e-05,0.5
18363,18363,동유럽/Noun,4,2,2,4.445926419917751e-05,4.4425686932184186e-05,0.5
18364,18364,코브라/Noun,4,2,2,4.445926419917751e-05,4.4425686932184186e-05,0.5
18365,18365,불리하다/Adjective,4,2,2,4.445926419917751e-05,4.4425686932184186e-05,0.5
18366,18366,트랄/Noun,4,2,2,4.445926419917751e-05,4.4425686932184186e-05,0.5
18367,18367,영등포/Noun,4,2,2,4.445926419917751e-05,4.4425686932184186e-05,0.5
18368,18368,외국어/Noun,4,2,2,4.445926419917751e-05,4.4425686932184186e-05,0.5
18369,18369,해탈/Noun,4,2,2,4.445926419917751e-05,4.4425686932184186e-05,0.5
18370,18370,랄라라/Noun,4,2,2,4.445926419917751e-05,4.4425686932184186e-05,0.5
18371,18371,모나리자/Noun,4,2,2,4.445926419917751e-05,4.4425686932184186e-05,0.5
18372,18372,개인주의/Noun,4,2,2,4.445926419917751e-05,4.4425686932184186e-05,0.5
18373,18373,시라소니/Noun,4,2,2,4.445926419917751e-05,4.4425686932184186e-05,0.5
18374,18374,왓다/Noun,4,2,2,4.445926419917751e-05,4.4425686932184186e-05,0.5
18375,18375,일영/Noun,4,2,2,4.445926419917751e-05,4.4425686932184186e-05,0.5
18376,18376,염려/Noun,4,2,2,4.445926419917751e-05,4.4425686932184186e-05,0.5
18377,18377,갱생/Noun,4,2,2,4.445926419917751e-05,4.4425686932184186e-05,0.5
18378,18378,갖힌/Noun,4,2,2,4.445926419917751e-05,4.4425686932184186e-05,0.5
18379,18379,수집/Noun,4,2,2,4.445926419917751e-05,4.4425686932184186e-05,0.5
18380,18380,지석/Noun,4,2,2,4.445926419917751e-05,4.4425686932184186e-05,0.5
18381,18381,와전/Noun,4,2,2,4.445926419917751e-05,4.4425686932184186e-05,0.5
18382,18382,새우다/Verb,4,2,2,4.445926419917751e-05,4.4425686932184186e-05,0.5
18383,18383,정품/Noun,4,2,2,4.445926419917751e-05,4.4425686932184186e-05,0.5
18384,18384,",(/Punctuation",4,2,2,4.445926419917751e-05,4.4425686932184186e-05,0.5
18385,18385,거너/Noun,4,2,2,4.445926419917751e-05,4.4425686932184186e-05,0.5
18386,18386,주저앉다/Verb,4,2,2,4.445926419917751e-05,4.4425686932184186e-05,0.5
18387,18387,오토봇/Noun,4,2,2,4.445926419917751e-05,4.4425686932184186e-05,0.5
18388,18388,버려진/Noun,4,2,2,4.445926419917751e-05,4.4425686932184186e-05,0.5
18389,18389,트릴/Noun,4,2,2,4.445926419917751e-05,4.4425686932184186e-05,0.5
18390,18390,회관/Noun,4,2,2,4.445926419917751e-05,4.4425686932184186e-05,0.5
18391,18391,원가/Noun,4,2,2,4.445926419917751e-05,4.4425686932184186e-05,0.5
18392,18392,시더/Noun,4,2,2,4.445926419917751e-05,4.4425686932184186e-05,0.5
18393,18393,never/Alpha,4,2,2,4.445926419917751e-05,4.4425686932184186e-05,0.5
18394,18394,의정/Noun,4,2,2,4.445926419917751e-05,4.4425686932184186e-05,0.5
18395,18395,데드캠프/Noun,4,2,2,4.445926419917751e-05,4.4425686932184186e-05,0.5
18396,18396,샤아/Noun,4,2,2,4.445926419917751e-05,4.4425686932184186e-05,0.5
18397,18397,도리어/Noun,4,2,2,4.445926419917751e-05,4.4425686932184186e-05,0.5
18398,18398,꼬투리/Noun,4,2,2,4.445926419917751e-05,4.4425686932184186e-05,0.5
18399,18399,선글라스/Noun,4,2,2,4.445926419917751e-05,4.4425686932184186e-05,0.5
18400,18400,헬보이/Noun,4,2,2,4.445926419917751e-05,4.4425686932184186e-05,0.5
18401,18401,^^:/Punctuation,4,2,2,4.445926419917751e-05,4.4425686932184186e-05,0.5
18402,18402,돼지고기/Noun,4,2,2,4.445926419917751e-05,4.4425686932184186e-05,0.5
18403,18403,프롬/Noun,4,2,2,4.445926419917751e-05,4.4425686932184186e-05,0.5
18404,18404,집사람/Noun,4,2,2,4.445926419917751e-05,4.4425686932184186e-05,0.5
18405,18405,작태/Noun,4,2,2,4.445926419917751e-05,4.4425686932184186e-05,0.5
18406,18406,사정없이/Adverb,4,2,2,4.445926419917751e-05,4.4425686932184186e-05,0.5
18407,18407,어선/Noun,4,2,2,4.445926419917751e-05,4.4425686932184186e-05,0.5
18408,18408,탈취/Noun,4,2,2,4.445926419917751e-05,4.4425686932184186e-05,0.5
18409,18409,선녀/Noun,4,2,2,4.445926419917751e-05,4.4425686932184186e-05,0.5
18410,18410,기침/Noun,4,2,2,4.445926419917751e-05,4.4425686932184186e-05,0.5
18411,18411,신병/Noun,4,2,2,4.445926419917751e-05,4.4425686932184186e-05,0.5
18412,18412,해하/Noun,4,2,2,4.445926419917751e-05,4.4425686932184186e-05,0.5
18413,18413,IN/Alpha,4,2,2,4.445926419917751e-05,4.4425686932184186e-05,0.5
18414,18414,세가족/Noun,4,2,2,4.445926419917751e-05,4.4425686932184186e-05,0.5
18415,18415,정애리/Noun,4,2,2,4.445926419917751e-05,4.4425686932184186e-05,0.5
18416,18416,서동/Noun,4,2,2,4.445926419917751e-05,4.4425686932184186e-05,0.5
18417,18417,이현/Noun,4,2,2,4.445926419917751e-05,4.4425686932184186e-05,0.5
18418,18418,모집/Noun,4,2,2,4.445926419917751e-05,4.4425686932184186e-05,0.5
18419,18419,알버트/Noun,4,2,2,4.445926419917751e-05,4.4425686932184186e-05,0.5
18420,18420,뀌/Noun,4,2,2,4.445926419917751e-05,4.4425686932184186e-05,0.5
18421,18421,배는/Foreign,4,2,2,4.445926419917751e-05,4.4425686932184186e-05,0.5
18422,18422,미라클/Noun,4,2,2,4.445926419917751e-05,4.4425686932184186e-05,0.5
18423,18423,복면/Noun,4,2,2,4.445926419917751e-05,4.4425686932184186e-05,0.5
18424,18424,괴뢰/Noun,4,2,2,4.445926419917751e-05,4.4425686932184186e-05,0.5
18425,18425,대일본제국/Noun,4,2,2,4.445926419917751e-05,4.4425686932184186e-05,0.5
18426,18426,임꺽정/Noun,4,2,2,4.445926419917751e-05,4.4425686932184186e-05,0.5
18427,18427,서고/Noun,4,2,2,4.445926419917751e-05,4.4425686932184186e-05,0.5
18428,18428,포르노그라피/Noun,4,2,2,4.445926419917751e-05,4.4425686932184186e-05,0.5
18429,18429,쥴리아/Noun,4,2,2,4.445926419917751e-05,4.4425686932184186e-05,0.5
18430,18430,피지/Noun,4,2,2,4.445926419917751e-05,4.4425686932184186e-05,0.5
18431,18431,다음생/Noun,4,2,2,4.445926419917751e-05,4.4425686932184186e-05,0.5
18432,18432,인트/Noun,4,2,2,4.445926419917751e-05,4.4425686932184186e-05,0.5
18433,18433,오명/Noun,4,2,2,4.445926419917751e-05,4.4425686932184186e-05,0.5
18434,18434,근엄하다/Adjective,4,2,2,4.445926419917751e-05,4.4425686932184186e-05,0.5
18435,18435,엇냐/Noun,4,2,2,4.445926419917751e-05,4.4425686932184186e-05,0.5
18436,18436,일면/Noun,4,2,2,4.445926419917751e-05,4.4425686932184186e-05,0.5
18437,18437,세인트/Noun,4,2,2,4.445926419917751e-05,4.4425686932184186e-05,0.5
18438,18438,일가/Noun,4,2,2,4.445926419917751e-05,4.4425686932184186e-05,0.5
18439,18439,당해/Modifier,4,2,2,4.445926419917751e-05,4.4425686932184186e-05,0.5
18440,18440,망토/Noun,4,2,2,4.445926419917751e-05,4.4425686932184186e-05,0.5
18441,18441,간정/Noun,4,2,2,4.445926419917751e-05,4.4425686932184186e-05,0.5
18442,18442,연애담/Noun,4,2,2,4.445926419917751e-05,4.4425686932184186e-05,0.5
18443,18443,살짝살짝/Adverb,4,2,2,4.445926419917751e-05,4.4425686932184186e-05,0.5
18444,18444,개웃/Adverb,4,2,2,4.445926419917751e-05,4.4425686932184186e-05,0.5
18445,18445,조선총잡이/Noun,4,2,2,4.445926419917751e-05,4.4425686932184186e-05,0.5
18446,18446,데뷰/Noun,4,2,2,4.445926419917751e-05,4.4425686932184186e-05,0.5
18447,18447,케이팝스타/Noun,4,2,2,4.445926419917751e-05,4.4425686932184186e-05,0.5
18448,18448,황시/Noun,4,2,2,4.445926419917751e-05,4.4425686932184186e-05,0.5
18449,18449,식인상어/Noun,4,2,2,4.445926419917751e-05,4.4425686932184186e-05,0.5
18450,18450,나왓음/Noun,4,2,2,4.445926419917751e-05,4.4425686932184186e-05,0.5
18451,18451,경도/Noun,4,2,2,4.445926419917751e-05,4.4425686932184186e-05,0.5
18452,18452,은평/Noun,4,2,2,4.445926419917751e-05,4.4425686932184186e-05,0.5
18453,18453,기정/Noun,4,2,2,4.445926419917751e-05,4.4425686932184186e-05,0.5
18454,18454,요망/Noun,4,2,2,4.445926419917751e-05,4.4425686932184186e-05,0.5
18455,18455,프로이트/Noun,4,2,2,4.445926419917751e-05,4.4425686932184186e-05,0.5
18456,18456,만사이/Noun,4,2,2,4.445926419917751e-05,4.4425686932184186e-05,0.5
18457,18457,굳히다/Verb,4,2,2,4.445926419917751e-05,4.4425686932184186e-05,0.5
18458,18458,세훈/Noun,4,2,2,4.445926419917751e-05,4.4425686932184186e-05,0.5
18459,18459,신호/Noun,4,2,2,4.445926419917751e-05,4.4425686932184186e-05,0.5
18460,18460,샘솟다/Verb,4,2,2,4.445926419917751e-05,4.4425686932184186e-05,0.5
18461,18461,40%/Number,4,2,2,4.445926419917751e-05,4.4425686932184186e-05,0.5
18462,18462,여유도/Noun,4,2,2,4.445926419917751e-05,4.4425686932184186e-05,0.5
18463,18463,..^^;/Punctuation,4,2,2,4.445926419917751e-05,4.4425686932184186e-05,0.5
18464,18464,샤시/Noun,4,2,2,4.445926419917751e-05,4.4425686932184186e-05,0.5
18465,18465,수구/Noun,4,2,2,4.445926419917751e-05,4.4425686932184186e-05,0.5
18466,18466,석도/Noun,4,2,2,4.445926419917751e-05,4.4425686932184186e-05,0.5
18467,18467,피안/Noun,4,2,2,4.445926419917751e-05,4.4425686932184186e-05,0.5
18468,18468,상냥하다/Adjective,4,2,2,4.445926419917751e-05,4.4425686932184186e-05,0.5
18469,18469,ㅁㅁ/KoreanParticle,4,2,2,4.445926419917751e-05,4.4425686932184186e-05,0.5
18470,18470,구하라/Noun,4,2,2,4.445926419917751e-05,4.4425686932184186e-05,0.5
18471,18471,감량/Noun,4,2,2,4.445926419917751e-05,4.4425686932184186e-05,0.5
18472,18472,응징자/Noun,4,2,2,4.445926419917751e-05,4.4425686932184186e-05,0.5
18473,18473,역주행/Noun,4,2,2,4.445926419917751e-05,4.4425686932184186e-05,0.5
18474,18474,9.2/Number,4,2,2,4.445926419917751e-05,4.4425686932184186e-05,0.5
18475,18475,어뢰/Noun,4,2,2,4.445926419917751e-05,4.4425686932184186e-05,0.5
18476,18476,조민수/Noun,4,2,2,4.445926419917751e-05,4.4425686932184186e-05,0.5
18477,18477,장래/Noun,4,2,2,4.445926419917751e-05,4.4425686932184186e-05,0.5
18478,18478,전반전/Noun,4,2,2,4.445926419917751e-05,4.4425686932184186e-05,0.5
18479,18479,양보/Noun,4,2,2,4.445926419917751e-05,4.4425686932184186e-05,0.5
18480,18480,소심/Noun,4,2,2,4.445926419917751e-05,4.4425686932184186e-05,0.5
18481,18481,메이슨/Noun,4,2,2,4.445926419917751e-05,4.4425686932184186e-05,0.5
18482,18482,전세/Noun,4,2,2,4.445926419917751e-05,4.4425686932184186e-05,0.5
18483,18483,의기/Noun,4,2,2,4.445926419917751e-05,4.4425686932184186e-05,0.5
18484,18484,주간아이돌/Noun,4,2,2,4.445926419917751e-05,4.4425686932184186e-05,0.5
18485,18485,터미널/Noun,4,2,2,4.445926419917751e-05,4.4425686932184186e-05,0.5
18486,18486,창희/Noun,4,2,2,4.445926419917751e-05,4.4425686932184186e-05,0.5
18487,18487,석궁/Noun,4,2,2,4.445926419917751e-05,4.4425686932184186e-05,0.5
18488,18488,기관사/Noun,4,2,2,4.445926419917751e-05,4.4425686932184186e-05,0.5
18489,18489,애니메이터/Noun,4,2,2,4.445926419917751e-05,4.4425686932184186e-05,0.5
18490,18490,꼬옥/Adverb,4,2,2,4.445926419917751e-05,4.4425686932184186e-05,0.5
18491,18491,찬미/Noun,4,2,2,4.445926419917751e-05,4.4425686932184186e-05,0.5
18492,18492,서울대/Noun,4,2,2,4.445926419917751e-05,4.4425686932184186e-05,0.5
18493,18493,흉악/Noun,4,2,2,4.445926419917751e-05,4.4425686932184186e-05,0.5
18494,18494,퇴마사/Noun,4,2,2,4.445926419917751e-05,4.4425686932184186e-05,0.5
18495,18495,리멤버/Noun,4,2,2,4.445926419917751e-05,4.4425686932184186e-05,0.5
18496,18496,신호탄/Noun,4,2,2,4.445926419917751e-05,4.4425686932184186e-05,0.5
18497,18497,전화기/Noun,4,2,2,4.445926419917751e-05,4.4425686932184186e-05,0.5
18498,18498,사관/Noun,4,2,2,4.445926419917751e-05,4.4425686932184186e-05,0.5
18499,18499,전해/Noun,4,2,2,4.445926419917751e-05,4.4425686932184186e-05,0.5
18500,18500,됫다/Noun,4,2,2,4.445926419917751e-05,4.4425686932184186e-05,0.5
18501,18501,십이/Noun,4,2,2,4.445926419917751e-05,4.4425686932184186e-05,0.5
18502,18502,떠밀다/Verb,4,2,2,4.445926419917751e-05,4.4425686932184186e-05,0.5
18503,18503,빈집/Noun,4,2,2,4.445926419917751e-05,4.4425686932184186e-05,0.5
18504,18504,6.0/Number,4,2,2,4.445926419917751e-05,4.4425686932184186e-05,0.5
18505,18505,기어이/Noun,4,2,2,4.445926419917751e-05,4.4425686932184186e-05,0.5
18506,18506,낚시바늘/Noun,4,2,2,4.445926419917751e-05,4.4425686932184186e-05,0.5
18507,18507,불시/Noun,4,2,2,4.445926419917751e-05,4.4425686932184186e-05,0.5
18508,18508,ㅇㅓ/KoreanParticle,4,2,2,4.445926419917751e-05,4.4425686932184186e-05,0.5
18509,18509,마야/Noun,4,2,2,4.445926419917751e-05,4.4425686932184186e-05,0.5
18510,18510,마도/Noun,4,2,2,4.445926419917751e-05,4.4425686932184186e-05,0.5
18511,18511,700/Number,4,2,2,4.445926419917751e-05,4.4425686932184186e-05,0.5
18512,18512,월트디즈니/Noun,4,2,2,4.445926419917751e-05,4.4425686932184186e-05,0.5
18513,18513,딸감/Noun,4,2,2,4.445926419917751e-05,4.4425686932184186e-05,0.5
18514,18514,팍팍하다/Adjective,4,2,2,4.445926419917751e-05,4.4425686932184186e-05,0.5
18515,18515,맥아/Noun,4,2,2,4.445926419917751e-05,4.4425686932184186e-05,0.5
18516,18516,노벨/Noun,4,2,2,4.445926419917751e-05,4.4425686932184186e-05,0.5
18517,18517,인하/Noun,4,2,2,4.445926419917751e-05,4.4425686932184186e-05,0.5
18518,18518,지호/Noun,4,2,2,4.445926419917751e-05,4.4425686932184186e-05,0.5
18519,18519,국장/Noun,4,2,2,4.445926419917751e-05,4.4425686932184186e-05,0.5
18520,18520,독사/Noun,4,2,2,4.445926419917751e-05,4.4425686932184186e-05,0.5
18521,18521,가정은/Noun,4,2,2,4.445926419917751e-05,4.4425686932184186e-05,0.5
18522,18522,겅/Noun,4,2,2,4.445926419917751e-05,4.4425686932184186e-05,0.5
18523,18523,2010/Number,4,2,2,4.445926419917751e-05,4.4425686932184186e-05,0.5
18524,18524,원리/Noun,4,2,2,4.445926419917751e-05,4.4425686932184186e-05,0.5
18525,18525,괜츈/Noun,4,2,2,4.445926419917751e-05,4.4425686932184186e-05,0.5
18526,18526,평안하다/Adjective,4,2,2,4.445926419917751e-05,4.4425686932184186e-05,0.5
18527,18527,해피투게더/Noun,4,2,2,4.445926419917751e-05,4.4425686932184186e-05,0.5
18528,18528,롤라/Noun,4,2,2,4.445926419917751e-05,4.4425686932184186e-05,0.5
18529,18529,체질/Noun,4,2,2,4.445926419917751e-05,4.4425686932184186e-05,0.5
18530,18530,입지/Noun,4,2,2,4.445926419917751e-05,4.4425686932184186e-05,0.5
18531,18531,서면/Noun,4,2,2,4.445926419917751e-05,4.4425686932184186e-05,0.5
18532,18532,위신/Noun,4,2,2,4.445926419917751e-05,4.4425686932184186e-05,0.5
18533,18533,유인영/Noun,4,2,2,4.445926419917751e-05,4.4425686932184186e-05,0.5
18534,18534,최적화/Noun,4,2,2,4.445926419917751e-05,4.4425686932184186e-05,0.5
18535,18535,UN/Alpha,4,2,2,4.445926419917751e-05,4.4425686932184186e-05,0.5
18536,18536,후원/Noun,4,2,2,4.445926419917751e-05,4.4425686932184186e-05,0.5
18537,18537,햇님/Noun,4,2,2,4.445926419917751e-05,4.4425686932184186e-05,0.5
18538,18538,열전/Noun,4,2,2,4.445926419917751e-05,4.4425686932184186e-05,0.5
18539,18539,원년/Noun,4,2,2,4.445926419917751e-05,4.4425686932184186e-05,0.5
18540,18540,입부/Noun,4,2,2,4.445926419917751e-05,4.4425686932184186e-05,0.5
18541,18541,발렌타인데이/Noun,4,2,2,4.445926419917751e-05,4.4425686932184186e-05,0.5
18542,18542,염세/Noun,4,2,2,4.445926419917751e-05,4.4425686932184186e-05,0.5
18543,18543,입금/Noun,4,2,2,4.445926419917751e-05,4.4425686932184186e-05,0.5
18544,18544,패거리/Noun,4,2,2,4.445926419917751e-05,4.4425686932184186e-05,0.5
18545,18545,치바/Noun,4,2,2,4.445926419917751e-05,4.4425686932184186e-05,0.5
18546,18546,파수/Noun,4,2,2,4.445926419917751e-05,4.4425686932184186e-05,0.5
18547,18547,본대/Noun,4,2,2,4.445926419917751e-05,4.4425686932184186e-05,0.5
18548,18548,장광/Noun,4,2,2,4.445926419917751e-05,4.4425686932184186e-05,0.5
18549,18549,제본/Noun,4,2,2,4.445926419917751e-05,4.4425686932184186e-05,0.5
18550,18550,문보령/Noun,4,2,2,4.445926419917751e-05,4.4425686932184186e-05,0.5
18551,18551,꿈나라/Noun,4,2,2,4.445926419917751e-05,4.4425686932184186e-05,0.5
18552,18552,펫/Noun,4,2,2,4.445926419917751e-05,4.4425686932184186e-05,0.5
18553,18553,화약/Noun,4,2,2,4.445926419917751e-05,4.4425686932184186e-05,0.5
18554,18554,행적/Noun,4,2,2,4.445926419917751e-05,4.4425686932184186e-05,0.5
18555,18555,ch/Alpha,4,2,2,4.445926419917751e-05,4.4425686932184186e-05,0.5
18556,18556,자만하다/Adjective,4,2,2,4.445926419917751e-05,4.4425686932184186e-05,0.5
18557,18557,게바라/Noun,4,2,2,4.445926419917751e-05,4.4425686932184186e-05,0.5
18558,18558,일요/Noun,4,2,2,4.445926419917751e-05,4.4425686932184186e-05,0.5
18559,18559,일후/Noun,4,2,2,4.445926419917751e-05,4.4425686932184186e-05,0.5
18560,18560,ㅡㅋ/KoreanParticle,4,2,2,4.445926419917751e-05,4.4425686932184186e-05,0.5
18561,18561,김보경/Noun,4,2,2,4.445926419917751e-05,4.4425686932184186e-05,0.5
18562,18562,심볼/Noun,4,2,2,4.445926419917751e-05,4.4425686932184186e-05,0.5
18563,18563,보그/Noun,4,2,2,4.445926419917751e-05,4.4425686932184186e-05,0.5
18564,18564,감임/Noun,4,2,2,4.445926419917751e-05,4.4425686932184186e-05,0.5
18565,18565,우월감/Noun,4,2,2,4.445926419917751e-05,4.4425686932184186e-05,0.5
18566,18566,술자리/Noun,4,2,2,4.445926419917751e-05,4.4425686932184186e-05,0.5
18567,18567,뛰어나가다/Verb,4,2,2,4.445926419917751e-05,4.4425686932184186e-05,0.5
18568,18568,염색/Noun,4,2,2,4.445926419917751e-05,4.4425686932184186e-05,0.5
18569,18569,신인시절/Noun,4,2,2,4.445926419917751e-05,4.4425686932184186e-05,0.5
18570,18570,카니/Noun,4,2,2,4.445926419917751e-05,4.4425686932184186e-05,0.5
18571,18571,버트/Noun,4,2,2,4.445926419917751e-05,4.4425686932184186e-05,0.5
18572,18572,출력/Noun,4,2,2,4.445926419917751e-05,4.4425686932184186e-05,0.5
18573,18573,장훈/Noun,4,2,2,4.445926419917751e-05,4.4425686932184186e-05,0.5
18574,18574,단죄/Noun,4,2,2,4.445926419917751e-05,4.4425686932184186e-05,0.5
18575,18575,주짓수/Noun,4,2,2,4.445926419917751e-05,4.4425686932184186e-05,0.5
18576,18576,성탄절/Noun,4,2,2,4.445926419917751e-05,4.4425686932184186e-05,0.5
18577,18577,대마/Noun,4,2,2,4.445926419917751e-05,4.4425686932184186e-05,0.5
18578,18578,해파리/Noun,4,2,2,4.445926419917751e-05,4.4425686932184186e-05,0.5
18579,18579,블루스/Noun,4,2,2,4.445926419917751e-05,4.4425686932184186e-05,0.5
18580,18580,테크노/Noun,4,2,2,4.445926419917751e-05,4.4425686932184186e-05,0.5
18581,18581,반역/Noun,4,2,2,4.445926419917751e-05,4.4425686932184186e-05,0.5
18582,18582,돈치/Noun,4,2,2,4.445926419917751e-05,4.4425686932184186e-05,0.5
18583,18583,안방/Noun,4,2,2,4.445926419917751e-05,4.4425686932184186e-05,0.5
18584,18584,퀄리/Noun,4,2,2,4.445926419917751e-05,4.4425686932184186e-05,0.5
18585,18585,코알라/Noun,4,2,2,4.445926419917751e-05,4.4425686932184186e-05,0.5
18586,18586,ㅝ/KoreanParticle,4,2,2,4.445926419917751e-05,4.4425686932184186e-05,0.5
18587,18587,베이커리/Noun,4,2,2,4.445926419917751e-05,4.4425686932184186e-05,0.5
18588,18588,체다/Noun,4,2,2,4.445926419917751e-05,4.4425686932184186e-05,0.5
18589,18589,괴이/Noun,4,2,2,4.445926419917751e-05,4.4425686932184186e-05,0.5
18590,18590,김용건/Noun,4,2,2,4.445926419917751e-05,4.4425686932184186e-05,0.5
18591,18591,2004/Number,4,2,2,4.445926419917751e-05,4.4425686932184186e-05,0.5
18592,18592,광산/Noun,4,2,2,4.445926419917751e-05,4.4425686932184186e-05,0.5
18593,18593,패배하다/Adjective,4,2,2,4.445926419917751e-05,4.4425686932184186e-05,0.5
18594,18594,이견/Noun,4,2,2,4.445926419917751e-05,4.4425686932184186e-05,0.5
18595,18595,-.../Punctuation,4,2,2,4.445926419917751e-05,4.4425686932184186e-05,0.5
18596,18596,고등/Noun,4,2,2,4.445926419917751e-05,4.4425686932184186e-05,0.5
18597,18597,이몽/Noun,4,2,2,4.445926419917751e-05,4.4425686932184186e-05,0.5
18598,18598,빈부격차/Noun,4,2,2,4.445926419917751e-05,4.4425686932184186e-05,0.5
18599,18599,초석/Noun,4,2,2,4.445926419917751e-05,4.4425686932184186e-05,0.5
18600,18600,무자/Noun,4,2,2,4.445926419917751e-05,4.4425686932184186e-05,0.5
18601,18601,최루탄/Noun,4,2,2,4.445926419917751e-05,4.4425686932184186e-05,0.5
18602,18602,모험물/Noun,4,2,2,4.445926419917751e-05,4.4425686932184186e-05,0.5
18603,18603,토드/Noun,4,2,2,4.445926419917751e-05,4.4425686932184186e-05,0.5
18604,18604,약국/Noun,4,2,2,4.445926419917751e-05,4.4425686932184186e-05,0.5
18605,18605,왼/Modifier,4,2,2,4.445926419917751e-05,4.4425686932184186e-05,0.5
18606,18606,브루/Noun,4,2,2,4.445926419917751e-05,4.4425686932184186e-05,0.5
18607,18607,수해/Noun,4,2,2,4.445926419917751e-05,4.4425686932184186e-05,0.5
18608,18608,본사/Noun,4,2,2,4.445926419917751e-05,4.4425686932184186e-05,0.5
18609,18609,일화/Noun,4,2,2,4.445926419917751e-05,4.4425686932184186e-05,0.5
18610,18610,센트/Noun,4,2,2,4.445926419917751e-05,4.4425686932184186e-05,0.5
18611,18611,온기/Noun,4,2,2,4.445926419917751e-05,4.4425686932184186e-05,0.5
18612,18612,군림/Noun,4,2,2,4.445926419917751e-05,4.4425686932184186e-05,0.5
18613,18613,압권임/Noun,4,2,2,4.445926419917751e-05,4.4425686932184186e-05,0.5
18614,18614,아이엠샘/Noun,4,2,2,4.445926419917751e-05,4.4425686932184186e-05,0.5
18615,18615,율도/Noun,4,2,2,4.445926419917751e-05,4.4425686932184186e-05,0.5
18616,18616,라카/Noun,4,2,2,4.445926419917751e-05,4.4425686932184186e-05,0.5
18617,18617,헤리포터/Noun,4,2,2,4.445926419917751e-05,4.4425686932184186e-05,0.5
18618,18618,트레/Noun,4,2,2,4.445926419917751e-05,4.4425686932184186e-05,0.5
18619,18619,트루라이즈/Noun,4,2,2,4.445926419917751e-05,4.4425686932184186e-05,0.5
18620,18620,군입대/Noun,4,2,2,4.445926419917751e-05,4.4425686932184186e-05,0.5
18621,18621,송일곤/Noun,4,2,2,4.445926419917751e-05,4.4425686932184186e-05,0.5
18622,18622,6.9/Number,4,2,2,4.445926419917751e-05,4.4425686932184186e-05,0.5
18623,18623,육중/Noun,4,2,2,4.445926419917751e-05,4.4425686932184186e-05,0.5
18624,18624,101/Number,4,2,2,4.445926419917751e-05,4.4425686932184186e-05,0.5
18625,18625,인현왕후/Noun,4,2,2,4.445926419917751e-05,4.4425686932184186e-05,0.5
18626,18626,이등병/Noun,4,2,2,4.445926419917751e-05,4.4425686932184186e-05,0.5
18627,18627,사교/Noun,4,2,2,4.445926419917751e-05,4.4425686932184186e-05,0.5
18628,18628,주사/Noun,4,2,2,4.445926419917751e-05,4.4425686932184186e-05,0.5
18629,18629,론서바이버/Noun,4,2,2,4.445926419917751e-05,4.4425686932184186e-05,0.5
18630,18630,사모님/Noun,4,2,2,4.445926419917751e-05,4.4425686932184186e-05,0.5
18631,18631,장마/Noun,4,2,2,4.445926419917751e-05,4.4425686932184186e-05,0.5
18632,18632,데이브/Noun,4,2,2,4.445926419917751e-05,4.4425686932184186e-05,0.5
18633,18633,직할/Noun,4,2,2,4.445926419917751e-05,4.4425686932184186e-05,0.5
18634,18634,헤피엔딩/Noun,4,2,2,4.445926419917751e-05,4.4425686932184186e-05,0.5
18635,18635,무채색/Noun,4,2,2,4.445926419917751e-05,4.4425686932184186e-05,0.5
18636,18636,마일리지/Noun,4,2,2,4.445926419917751e-05,4.4425686932184186e-05,0.5
18637,18637,구합/Noun,4,2,2,4.445926419917751e-05,4.4425686932184186e-05,0.5
18638,18638,해상/Noun,4,2,2,4.445926419917751e-05,4.4425686932184186e-05,0.5
18639,18639,구단/Noun,4,2,2,4.445926419917751e-05,4.4425686932184186e-05,0.5
18640,18640,모스맨/Noun,4,2,2,4.445926419917751e-05,4.4425686932184186e-05,0.5
18641,18641,해피엔드/Noun,4,2,2,4.445926419917751e-05,4.4425686932184186e-05,0.5
18642,18642,열애/Noun,4,2,2,4.445926419917751e-05,4.4425686932184186e-05,0.5
18643,18643,버질/Noun,4,2,2,4.445926419917751e-05,4.4425686932184186e-05,0.5
18644,18644,개솔/Noun,4,2,2,4.445926419917751e-05,4.4425686932184186e-05,0.5
18645,18645,애잔/Noun,4,2,2,4.445926419917751e-05,4.4425686932184186e-05,0.5
18646,18646,아프간/Noun,4,2,2,4.445926419917751e-05,4.4425686932184186e-05,0.5
18647,18647,개뿜/Noun,4,2,2,4.445926419917751e-05,4.4425686932184186e-05,0.5
18648,18648,홍주/Noun,4,2,2,4.445926419917751e-05,4.4425686932184186e-05,0.5
18649,18649,걔/Modifier,4,2,2,4.445926419917751e-05,4.4425686932184186e-05,0.5
18650,18650,원보/Noun,4,2,2,4.445926419917751e-05,4.4425686932184186e-05,0.5
18651,18651,자책/Noun,4,2,2,4.445926419917751e-05,4.4425686932184186e-05,0.5
18652,18652,가성/Noun,4,2,2,4.445926419917751e-05,4.4425686932184186e-05,0.5
18653,18653,이바/Noun,4,2,2,4.445926419917751e-05,4.4425686932184186e-05,0.5
18654,18654,유영/Noun,4,2,2,4.445926419917751e-05,4.4425686932184186e-05,0.5
18655,18655,쩌구/Noun,4,2,2,4.445926419917751e-05,4.4425686932184186e-05,0.5
18656,18656,!!!./Punctuation,4,2,2,4.445926419917751e-05,4.4425686932184186e-05,0.5
18657,18657,진술/Noun,4,2,2,4.445926419917751e-05,4.4425686932184186e-05,0.5
18658,18658,조신/Noun,4,2,2,4.445926419917751e-05,4.4425686932184186e-05,0.5
18659,18659,출하/Noun,4,2,2,4.445926419917751e-05,4.4425686932184186e-05,0.5
18660,18660,돌리지/Noun,4,2,2,4.445926419917751e-05,4.4425686932184186e-05,0.5
18661,18661,어메/Exclamation,4,2,2,4.445926419917751e-05,4.4425686932184186e-05,0.5
18662,18662,불합리/Noun,4,2,2,4.445926419917751e-05,4.4425686932184186e-05,0.5
18663,18663,승객/Noun,4,2,2,4.445926419917751e-05,4.4425686932184186e-05,0.5
18664,18664,첩첩산중/Noun,4,2,2,4.445926419917751e-05,4.4425686932184186e-05,0.5
18665,18665,이탈/Noun,4,2,2,4.445926419917751e-05,4.4425686932184186e-05,0.5
18666,18666,풀하우스/Noun,4,2,2,4.445926419917751e-05,4.4425686932184186e-05,0.5
18667,18667,스타크/Noun,4,2,2,4.445926419917751e-05,4.4425686932184186e-05,0.5
18668,18668,관절/Noun,4,2,2,4.445926419917751e-05,4.4425686932184186e-05,0.5
18669,18669,틀림없이/Adverb,4,2,2,4.445926419917751e-05,4.4425686932184186e-05,0.5
18670,18670,김성/Noun,4,2,2,4.445926419917751e-05,4.4425686932184186e-05,0.5
18671,18671,깜찍/Noun,4,2,2,4.445926419917751e-05,4.4425686932184186e-05,0.5
18672,18672,혜/Noun,4,2,2,4.445926419917751e-05,4.4425686932184186e-05,0.5
18673,18673,우하하/Noun,4,2,2,4.445926419917751e-05,4.4425686932184186e-05,0.5
18674,18674,추진/Noun,4,2,2,4.445926419917751e-05,4.4425686932184186e-05,0.5
18675,18675,쳇바퀴/Noun,4,2,2,4.445926419917751e-05,4.4425686932184186e-05,0.5
18676,18676,김준현/Noun,4,2,2,4.445926419917751e-05,4.4425686932184186e-05,0.5
18677,18677,채닝/Noun,4,2,2,4.445926419917751e-05,4.4425686932184186e-05,0.5
18678,18678,제갈량/Noun,4,2,2,4.445926419917751e-05,4.4425686932184186e-05,0.5
18679,18679,대여섯/Modifier,4,2,2,4.445926419917751e-05,4.4425686932184186e-05,0.5
18680,18680,모나/Noun,4,2,2,4.445926419917751e-05,4.4425686932184186e-05,0.5
18681,18681,숙성/Noun,4,2,2,4.445926419917751e-05,4.4425686932184186e-05,0.5
18682,18682,천옌시/Noun,4,2,2,4.445926419917751e-05,4.4425686932184186e-05,0.5
18683,18683,앤드류스/Noun,4,2,2,4.445926419917751e-05,4.4425686932184186e-05,0.5
18684,18684,민효린/Noun,4,2,2,4.445926419917751e-05,4.4425686932184186e-05,0.5
18685,18685,킨스키/Noun,4,2,2,4.445926419917751e-05,4.4425686932184186e-05,0.5
18686,18686,현태/Noun,4,2,2,4.445926419917751e-05,4.4425686932184186e-05,0.5
18687,18687,안바/Noun,4,2,2,4.445926419917751e-05,4.4425686932184186e-05,0.5
18688,18688,고속도로/Noun,4,2,2,4.445926419917751e-05,4.4425686932184186e-05,0.5
18689,18689,갑임/Noun,4,2,2,4.445926419917751e-05,4.4425686932184186e-05,0.5
18690,18690,헬레/Noun,4,2,2,4.445926419917751e-05,4.4425686932184186e-05,0.5
18691,18691,원안/Noun,4,2,2,4.445926419917751e-05,4.4425686932184186e-05,0.5
18692,18692,짐보/Noun,4,2,2,4.445926419917751e-05,4.4425686932184186e-05,0.5
18693,18693,태경/Noun,4,2,2,4.445926419917751e-05,4.4425686932184186e-05,0.5
18694,18694,1~5/Number,4,2,2,4.445926419917751e-05,4.4425686932184186e-05,0.5
18695,18695,팜플렛/Noun,4,2,2,4.445926419917751e-05,4.4425686932184186e-05,0.5
18696,18696,켄지/Noun,4,2,2,4.445926419917751e-05,4.4425686932184186e-05,0.5
18697,18697,변희봉/Noun,4,2,2,4.445926419917751e-05,4.4425686932184186e-05,0.5
18698,18698,통째/Noun,4,2,2,4.445926419917751e-05,4.4425686932184186e-05,0.5
18699,18699,뿔/Noun,4,2,2,4.445926419917751e-05,4.4425686932184186e-05,0.5
18700,18700,20초/Number,4,2,2,4.445926419917751e-05,4.4425686932184186e-05,0.5
18701,18701,요시노/Noun,4,2,2,4.445926419917751e-05,4.4425686932184186e-05,0.5
18702,18702,MOVIE/Alpha,4,2,2,4.445926419917751e-05,4.4425686932184186e-05,0.5
18703,18703,기요/Noun,4,2,2,4.445926419917751e-05,4.4425686932184186e-05,0.5
18704,18704,띵/Noun,4,2,2,4.445926419917751e-05,4.4425686932184186e-05,0.5
18705,18705,플라이/Noun,4,2,2,4.445926419917751e-05,4.4425686932184186e-05,0.5
18706,18706,하프/Noun,4,2,2,4.445926419917751e-05,4.4425686932184186e-05,0.5
18707,18707,음식점/Noun,4,2,2,4.445926419917751e-05,4.4425686932184186e-05,0.5
18708,18708,하사/Noun,4,2,2,4.445926419917751e-05,4.4425686932184186e-05,0.5
18709,18709,트루먼쇼/Noun,4,2,2,4.445926419917751e-05,4.4425686932184186e-05,0.5
18710,18710,If/Alpha,4,2,2,4.445926419917751e-05,4.4425686932184186e-05,0.5
18711,18711,))/Punctuation,4,2,2,4.445926419917751e-05,4.4425686932184186e-05,0.5
18712,18712,검은색/Noun,4,2,2,4.445926419917751e-05,4.4425686932184186e-05,0.5
18713,18713,뭣모르/Noun,4,2,2,4.445926419917751e-05,4.4425686932184186e-05,0.5
18714,18714,에놀/Noun,4,2,2,4.445926419917751e-05,4.4425686932184186e-05,0.5
18715,18715,음탕하다/Adjective,4,2,2,4.445926419917751e-05,4.4425686932184186e-05,0.5
18716,18716,지엠/Noun,4,2,2,4.445926419917751e-05,4.4425686932184186e-05,0.5
18717,18717,슬기/Noun,4,2,2,4.445926419917751e-05,4.4425686932184186e-05,0.5
18718,18718,오홋/Noun,4,2,2,4.445926419917751e-05,4.4425686932184186e-05,0.5
18719,18719,여의/Noun,4,2,2,4.445926419917751e-05,4.4425686932184186e-05,0.5
18720,18720,마찰/Noun,4,2,2,4.445926419917751e-05,4.4425686932184186e-05,0.5
18721,18721,카운터/Noun,4,2,2,4.445926419917751e-05,4.4425686932184186e-05,0.5
18722,18722,개티즌들/Noun,4,2,2,4.445926419917751e-05,4.4425686932184186e-05,0.5
18723,18723,장말/Noun,4,2,2,4.445926419917751e-05,4.4425686932184186e-05,0.5
18724,18724,home/Alpha,4,2,2,4.445926419917751e-05,4.4425686932184186e-05,0.5
18725,18725,푼돈/Noun,4,2,2,4.445926419917751e-05,4.4425686932184186e-05,0.5
18726,18726,much/Alpha,4,2,2,4.445926419917751e-05,4.4425686932184186e-05,0.5
18727,18727,웹/Noun,4,2,2,4.445926419917751e-05,4.4425686932184186e-05,0.5
18728,18728,쮸쮸/Noun,4,2,2,4.445926419917751e-05,4.4425686932184186e-05,0.5
18729,18729,헌팅/Noun,4,2,2,4.445926419917751e-05,4.4425686932184186e-05,0.5
18730,18730,압승/Noun,4,2,2,4.445926419917751e-05,4.4425686932184186e-05,0.5
18731,18731,제출/Noun,4,2,2,4.445926419917751e-05,4.4425686932184186e-05,0.5
18732,18732,스키장/Noun,4,2,2,4.445926419917751e-05,4.4425686932184186e-05,0.5
18733,18733,코러스/Noun,4,2,2,4.445926419917751e-05,4.4425686932184186e-05,0.5
18734,18734,이탈리안/Noun,4,2,2,4.445926419917751e-05,4.4425686932184186e-05,0.5
18735,18735,자본가/Noun,4,2,2,4.445926419917751e-05,4.4425686932184186e-05,0.5
18736,18736,맞선/Noun,4,2,2,4.445926419917751e-05,4.4425686932184186e-05,0.5
18737,18737,법치/Noun,4,2,2,4.445926419917751e-05,4.4425686932184186e-05,0.5
18738,18738,로메/Noun,4,2,2,4.445926419917751e-05,4.4425686932184186e-05,0.5
18739,18739,세차/Noun,4,2,2,4.445926419917751e-05,4.4425686932184186e-05,0.5
18740,18740,올려다보다/Verb,4,2,2,4.445926419917751e-05,4.4425686932184186e-05,0.5
18741,18741,만족도/Noun,4,2,2,4.445926419917751e-05,4.4425686932184186e-05,0.5
18742,18742,예이츠/Noun,4,2,2,4.445926419917751e-05,4.4425686932184186e-05,0.5
18743,18743,음료/Noun,4,2,2,4.445926419917751e-05,4.4425686932184186e-05,0.5
18744,18744,김성근/Noun,4,2,2,4.445926419917751e-05,4.4425686932184186e-05,0.5
18745,18745,뒷전/Noun,4,2,2,4.445926419917751e-05,4.4425686932184186e-05,0.5
18746,18746,"','/Punctuation",4,2,2,4.445926419917751e-05,4.4425686932184186e-05,0.5
18747,18747,차별성/Noun,4,2,2,4.445926419917751e-05,4.4425686932184186e-05,0.5
18748,18748,정령/Noun,4,2,2,4.445926419917751e-05,4.4425686932184186e-05,0.5
18749,18749,04년/Number,4,2,2,4.445926419917751e-05,4.4425686932184186e-05,0.5
18750,18750,사안/Noun,4,2,2,4.445926419917751e-05,4.4425686932184186e-05,0.5
18751,18751,37년/Number,4,2,2,4.445926419917751e-05,4.4425686932184186e-05,0.5
18752,18752,적나라/Noun,4,2,2,4.445926419917751e-05,4.4425686932184186e-05,0.5
18753,18753,만요/Noun,4,2,2,4.445926419917751e-05,4.4425686932184186e-05,0.5
18754,18754,일기토/Noun,4,2,2,4.445926419917751e-05,4.4425686932184186e-05,0.5
18755,18755,남상/Noun,4,2,2,4.445926419917751e-05,4.4425686932184186e-05,0.5
18756,18756,막강/Noun,4,2,2,4.445926419917751e-05,4.4425686932184186e-05,0.5
18757,18757,차근차근/Noun,4,2,2,4.445926419917751e-05,4.4425686932184186e-05,0.5
18758,18758,창공/Noun,4,2,2,4.445926419917751e-05,4.4425686932184186e-05,0.5
18759,18759,저울/Noun,4,2,2,4.445926419917751e-05,4.4425686932184186e-05,0.5
18760,18760,태극/Noun,4,2,2,4.445926419917751e-05,4.4425686932184186e-05,0.5
18761,18761,딸램/Noun,4,2,2,4.445926419917751e-05,4.4425686932184186e-05,0.5
18762,18762,고국/Noun,4,2,2,4.445926419917751e-05,4.4425686932184186e-05,0.5
18763,18763,3초/Number,4,2,2,4.445926419917751e-05,4.4425686932184186e-05,0.5
18764,18764,큰딸/Noun,4,2,2,4.445926419917751e-05,4.4425686932184186e-05,0.5
18765,18765,게로/Noun,4,2,2,4.445926419917751e-05,4.4425686932184186e-05,0.5
18766,18766,구질/Noun,4,2,2,4.445926419917751e-05,4.4425686932184186e-05,0.5
18767,18767,메간폭스/Noun,4,2,2,4.445926419917751e-05,4.4425686932184186e-05,0.5
18768,18768,성불/Noun,4,2,2,4.445926419917751e-05,4.4425686932184186e-05,0.5
18769,18769,로트/Noun,4,2,2,4.445926419917751e-05,4.4425686932184186e-05,0.5
18770,18770,적자/Noun,4,2,2,4.445926419917751e-05,4.4425686932184186e-05,0.5
18771,18771,에펠탑/Noun,4,2,2,4.445926419917751e-05,4.4425686932184186e-05,0.5
18772,18772,곽원갑/Noun,4,2,2,4.445926419917751e-05,4.4425686932184186e-05,0.5
18773,18773,Why/Alpha,4,2,2,4.445926419917751e-05,4.4425686932184186e-05,0.5
18774,18774,바르셀로나/Noun,4,2,2,4.445926419917751e-05,4.4425686932184186e-05,0.5
18775,18775,데도/Eomi,4,2,2,4.445926419917751e-05,4.4425686932184186e-05,0.5
18776,18776,큰코다치다/Verb,4,2,2,4.445926419917751e-05,4.4425686932184186e-05,0.5
18777,18777,블레이드러너/Noun,4,2,2,4.445926419917751e-05,4.4425686932184186e-05,0.5
18778,18778,45분/Number,4,2,2,4.445926419917751e-05,4.4425686932184186e-05,0.5
18779,18779,해결사/Noun,4,2,2,4.445926419917751e-05,4.4425686932184186e-05,0.5
18780,18780,종국/Noun,4,2,2,4.445926419917751e-05,4.4425686932184186e-05,0.5
18781,18781,띠리리/Noun,4,2,2,4.445926419917751e-05,4.4425686932184186e-05,0.5
18782,18782,안성맞춤/Noun,4,2,2,4.445926419917751e-05,4.4425686932184186e-05,0.5
18783,18783,파충류/Noun,4,2,2,4.445926419917751e-05,4.4425686932184186e-05,0.5
18784,18784,중공군/Noun,4,2,2,4.445926419917751e-05,4.4425686932184186e-05,0.5
18785,18785,패권/Noun,4,2,2,4.445926419917751e-05,4.4425686932184186e-05,0.5
18786,18786,얄/Noun,4,2,2,4.445926419917751e-05,4.4425686932184186e-05,0.5
18787,18787,위너/Noun,4,2,2,4.445926419917751e-05,4.4425686932184186e-05,0.5
18788,18788,당일/Noun,4,2,2,4.445926419917751e-05,4.4425686932184186e-05,0.5
18789,18789,저택/Noun,4,2,2,4.445926419917751e-05,4.4425686932184186e-05,0.5
18790,18790,무가/Noun,4,2,2,4.445926419917751e-05,4.4425686932184186e-05,0.5
18791,18791,길래/Eomi,4,2,2,4.445926419917751e-05,4.4425686932184186e-05,0.5
18792,18792,사려/Noun,4,2,2,4.445926419917751e-05,4.4425686932184186e-05,0.5
18793,18793,친부모/Noun,4,2,2,4.445926419917751e-05,4.4425686932184186e-05,0.5
18794,18794,전방/Noun,4,2,2,4.445926419917751e-05,4.4425686932184186e-05,0.5
18795,18795,도련님/Noun,4,2,2,4.445926419917751e-05,4.4425686932184186e-05,0.5
18796,18796,초/Foreign,4,2,2,4.445926419917751e-05,4.4425686932184186e-05,0.5
18797,18797,레트/Noun,4,2,2,4.445926419917751e-05,4.4425686932184186e-05,0.5
18798,18798,상통/Noun,4,2,2,4.445926419917751e-05,4.4425686932184186e-05,0.5
18799,18799,장인어른/Noun,4,2,2,4.445926419917751e-05,4.4425686932184186e-05,0.5
18800,18800,그리피스/Noun,4,2,2,4.445926419917751e-05,4.4425686932184186e-05,0.5
18801,18801,팀워크/Noun,4,2,2,4.445926419917751e-05,4.4425686932184186e-05,0.5
18802,18802,막둥이/Noun,4,2,2,4.445926419917751e-05,4.4425686932184186e-05,0.5
18803,18803,개뿜었다/Noun,4,2,2,4.445926419917751e-05,4.4425686932184186e-05,0.5
18804,18804,바바/Noun,4,2,2,4.445926419917751e-05,4.4425686932184186e-05,0.5
18805,18805,올랜도/Noun,4,2,2,4.445926419917751e-05,4.4425686932184186e-05,0.5
18806,18806,죄송스럽다/Adjective,4,2,2,4.445926419917751e-05,4.4425686932184186e-05,0.5
18807,18807,시마/Noun,4,2,2,4.445926419917751e-05,4.4425686932184186e-05,0.5
18808,18808,도태/Noun,4,2,2,4.445926419917751e-05,4.4425686932184186e-05,0.5
18809,18809,항쟁/Noun,4,2,2,4.445926419917751e-05,4.4425686932184186e-05,0.5
18810,18810,"""./Punctuation",4,2,2,4.445926419917751e-05,4.4425686932184186e-05,0.5
18811,18811,대낮/Noun,4,2,2,4.445926419917751e-05,4.4425686932184186e-05,0.5
18812,18812,베지터/Noun,4,2,2,4.445926419917751e-05,4.4425686932184186e-05,0.5
18813,18813,신성모독/Noun,4,2,2,4.445926419917751e-05,4.4425686932184186e-05,0.5
18814,18814,꼬락서니/Noun,4,2,2,4.445926419917751e-05,4.4425686932184186e-05,0.5
18815,18815,키포인트/Noun,4,2,2,4.445926419917751e-05,4.4425686932184186e-05,0.5
18816,18816,육덕/Noun,4,2,2,4.445926419917751e-05,4.4425686932184186e-05,0.5
18817,18817,호칭/Noun,4,2,2,4.445926419917751e-05,4.4425686932184186e-05,0.5
18818,18818,화때/Noun,4,2,2,4.445926419917751e-05,4.4425686932184186e-05,0.5
18819,18819,인문학/Noun,4,2,2,4.445926419917751e-05,4.4425686932184186e-05,0.5
18820,18820,차이코프스키/Noun,4,2,2,4.445926419917751e-05,4.4425686932184186e-05,0.5
18821,18821,만국/Noun,4,2,2,4.445926419917751e-05,4.4425686932184186e-05,0.5
18822,18822,디스커버리/Noun,4,2,2,4.445926419917751e-05,4.4425686932184186e-05,0.5
18823,18823,포식자/Noun,4,2,2,4.445926419917751e-05,4.4425686932184186e-05,0.5
18824,18824,이행/Noun,4,2,2,4.445926419917751e-05,4.4425686932184186e-05,0.5
18825,18825,빈스/Noun,4,2,2,4.445926419917751e-05,4.4425686932184186e-05,0.5
18826,18826,젝일/Noun,4,2,2,4.445926419917751e-05,4.4425686932184186e-05,0.5
18827,18827,삼각김밥/Noun,4,2,2,4.445926419917751e-05,4.4425686932184186e-05,0.5
18828,18828,×/Foreign,4,2,2,4.445926419917751e-05,4.4425686932184186e-05,0.5
18829,18829,광선/Noun,4,2,2,4.445926419917751e-05,4.4425686932184186e-05,0.5
18830,18830,1939년/Number,4,2,2,4.445926419917751e-05,4.4425686932184186e-05,0.5
18831,18831,헬조센/Noun,4,2,2,4.445926419917751e-05,4.4425686932184186e-05,0.5
18832,18832,픽픽/Noun,4,2,2,4.445926419917751e-05,4.4425686932184186e-05,0.5
18833,18833,어전/Noun,4,2,2,4.445926419917751e-05,4.4425686932184186e-05,0.5
18834,18834,폐쇄적/Noun,4,2,2,4.445926419917751e-05,4.4425686932184186e-05,0.5
18835,18835,편린/Noun,4,2,2,4.445926419917751e-05,4.4425686932184186e-05,0.5
18836,18836,느꼇/Noun,4,2,2,4.445926419917751e-05,4.4425686932184186e-05,0.5
18837,18837,오이/Noun,4,2,2,4.445926419917751e-05,4.4425686932184186e-05,0.5
18838,18838,헤프/Noun,4,2,2,4.445926419917751e-05,4.4425686932184186e-05,0.5
18839,18839,후지와라/Noun,4,2,2,4.445926419917751e-05,4.4425686932184186e-05,0.5
18840,18840,이상태/Noun,4,2,2,4.445926419917751e-05,4.4425686932184186e-05,0.5
18841,18841,빈부/Noun,4,2,2,4.445926419917751e-05,4.4425686932184186e-05,0.5
18842,18842,활개/Noun,4,2,2,4.445926419917751e-05,4.4425686932184186e-05,0.5
18843,18843,군부독재/Noun,4,2,2,4.445926419917751e-05,4.4425686932184186e-05,0.5
18844,18844,8.66/Number,4,2,2,4.445926419917751e-05,4.4425686932184186e-05,0.5
18845,18845,제독/Noun,4,2,2,4.445926419917751e-05,4.4425686932184186e-05,0.5
18846,18846,족구/Noun,4,2,2,4.445926419917751e-05,4.4425686932184186e-05,0.5
18847,18847,ng/Alpha,4,2,2,4.445926419917751e-05,4.4425686932184186e-05,0.5
18848,18848,편점/Noun,4,2,2,4.445926419917751e-05,4.4425686932184186e-05,0.5
18849,18849,익산/Noun,4,2,2,4.445926419917751e-05,4.4425686932184186e-05,0.5
18850,18850,스피커/Noun,4,2,2,4.445926419917751e-05,4.4425686932184186e-05,0.5
18851,18851,회화/Noun,4,2,2,4.445926419917751e-05,4.4425686932184186e-05,0.5
18852,18852,투사부일체/Noun,4,2,2,4.445926419917751e-05,4.4425686932184186e-05,0.5
18853,18853,신유/Noun,4,2,2,4.445926419917751e-05,4.4425686932184186e-05,0.5
18854,18854,뚱녀/Noun,4,2,2,4.445926419917751e-05,4.4425686932184186e-05,0.5
18855,18855,영화정보/Noun,4,2,2,4.445926419917751e-05,4.4425686932184186e-05,0.5
18856,18856,불면/Noun,4,2,2,4.445926419917751e-05,4.4425686932184186e-05,0.5
18857,18857,ㅏㄷ/KoreanParticle,4,2,2,4.445926419917751e-05,4.4425686932184186e-05,0.5
18858,18858,여보/Noun,4,2,2,4.445926419917751e-05,4.4425686932184186e-05,0.5
18859,18859,키스씬/Noun,4,2,2,4.445926419917751e-05,4.4425686932184186e-05,0.5
18860,18860,라틴/Noun,4,2,2,4.445926419917751e-05,4.4425686932184186e-05,0.5
18861,18861,2015.02/Number,4,2,2,4.445926419917751e-05,4.4425686932184186e-05,0.5
18862,18862,티모/Noun,4,2,2,4.445926419917751e-05,4.4425686932184186e-05,0.5
18863,18863,까마귀/Noun,4,2,2,4.445926419917751e-05,4.4425686932184186e-05,0.5
18864,18864,션트/Noun,4,2,2,4.445926419917751e-05,4.4425686932184186e-05,0.5
18865,18865,에서처럼/Josa,4,2,2,4.445926419917751e-05,4.4425686932184186e-05,0.5
18866,18866,건국/Noun,4,2,2,4.445926419917751e-05,4.4425686932184186e-05,0.5
18867,18867,익사/Noun,4,2,2,4.445926419917751e-05,4.4425686932184186e-05,0.5
18868,18868,체포/Noun,4,2,2,4.445926419917751e-05,4.4425686932184186e-05,0.5
18869,18869,105분/Number,4,2,2,4.445926419917751e-05,4.4425686932184186e-05,0.5
18870,18870,방아쇠/Noun,4,2,2,4.445926419917751e-05,4.4425686932184186e-05,0.5
18871,18871,쏠/Noun,4,2,2,4.445926419917751e-05,4.4425686932184186e-05,0.5
18872,18872,이선/Noun,4,2,2,4.445926419917751e-05,4.4425686932184186e-05,0.5
18873,18873,진저리/Noun,4,2,2,4.445926419917751e-05,4.4425686932184186e-05,0.5
18874,18874,다주/Noun,4,2,2,4.445926419917751e-05,4.4425686932184186e-05,0.5
18875,18875,캬캬캬/Noun,4,2,2,4.445926419917751e-05,4.4425686932184186e-05,0.5
18876,18876,피똥/Noun,4,2,2,4.445926419917751e-05,4.4425686932184186e-05,0.5
18877,18877,저편/Noun,4,2,2,4.445926419917751e-05,4.4425686932184186e-05,0.5
18878,18878,포악하다/Adjective,4,2,2,4.445926419917751e-05,4.4425686932184186e-05,0.5
18879,18879,자인/Noun,4,2,2,4.445926419917751e-05,4.4425686932184186e-05,0.5
18880,18880,몰리/Noun,4,2,2,4.445926419917751e-05,4.4425686932184186e-05,0.5
18881,18881,돈키호테/Noun,4,2,2,4.445926419917751e-05,4.4425686932184186e-05,0.5
18882,18882,진퉁/Noun,4,2,2,4.445926419917751e-05,4.4425686932184186e-05,0.5
18883,18883,풋내/Noun,4,2,2,4.445926419917751e-05,4.4425686932184186e-05,0.5
18884,18884,8.7/Number,4,2,2,4.445926419917751e-05,4.4425686932184186e-05,0.5
18885,18885,악연/Noun,4,2,2,4.445926419917751e-05,4.4425686932184186e-05,0.5
18886,18886,올킬/Noun,4,2,2,4.445926419917751e-05,4.4425686932184186e-05,0.5
18887,18887,360/Number,4,2,2,4.445926419917751e-05,4.4425686932184186e-05,0.5
18888,18888,처남/Noun,4,2,2,4.445926419917751e-05,4.4425686932184186e-05,0.5
18889,18889,편때/Noun,4,2,2,4.445926419917751e-05,4.4425686932184186e-05,0.5
18890,18890,견줄/Noun,4,2,2,4.445926419917751e-05,4.4425686932184186e-05,0.5
18891,18891,천은경/Noun,4,2,2,4.445926419917751e-05,4.4425686932184186e-05,0.5
18892,18892,",.,,,/Punctuation",4,2,2,4.445926419917751e-05,4.4425686932184186e-05,0.5
18893,18893,윌리암/Noun,4,2,2,4.445926419917751e-05,4.4425686932184186e-05,0.5
18894,18894,아이앰/Noun,4,2,2,4.445926419917751e-05,4.4425686932184186e-05,0.5
18895,18895,코렐/Noun,4,2,2,4.445926419917751e-05,4.4425686932184186e-05,0.5
18896,18896,선혈/Noun,4,2,2,4.445926419917751e-05,4.4425686932184186e-05,0.5
18897,18897,애완동물/Noun,4,2,2,4.445926419917751e-05,4.4425686932184186e-05,0.5
18898,18898,시원스럽다/Adjective,4,2,2,4.445926419917751e-05,4.4425686932184186e-05,0.5
18899,18899,동안의/Foreign,4,2,2,4.445926419917751e-05,4.4425686932184186e-05,0.5
18900,18900,핼드/Noun,4,2,2,4.445926419917751e-05,4.4425686932184186e-05,0.5
18901,18901,고고씽/Noun,4,2,2,4.445926419917751e-05,4.4425686932184186e-05,0.5
18902,18902,방면/Noun,4,2,2,4.445926419917751e-05,4.4425686932184186e-05,0.5
18903,18903,금메달/Noun,4,2,2,4.445926419917751e-05,4.4425686932184186e-05,0.5
18904,18904,력도/Noun,4,2,2,4.445926419917751e-05,4.4425686932184186e-05,0.5
18905,18905,장애물/Noun,4,2,2,4.445926419917751e-05,4.4425686932184186e-05,0.5
18906,18906,외상/Noun,4,2,2,4.445926419917751e-05,4.4425686932184186e-05,0.5
18907,18907,여름향기/Noun,4,2,2,4.445926419917751e-05,4.4425686932184186e-05,0.5
18908,18908,덕목/Noun,4,2,2,4.445926419917751e-05,4.4425686932184186e-05,0.5
18909,18909,비구니/Noun,4,2,2,4.445926419917751e-05,4.4425686932184186e-05,0.5
18910,18910,패전/Noun,4,2,2,4.445926419917751e-05,4.4425686932184186e-05,0.5
18911,18911,탄사/Noun,4,2,2,4.445926419917751e-05,4.4425686932184186e-05,0.5
18912,18912,똑똑/Noun,4,2,2,4.445926419917751e-05,4.4425686932184186e-05,0.5
18913,18913,항공/Noun,4,2,2,4.445926419917751e-05,4.4425686932184186e-05,0.5
18914,18914,드라/Noun,4,2,2,4.445926419917751e-05,4.4425686932184186e-05,0.5
18915,18915,깜빡이다/Verb,4,2,2,4.445926419917751e-05,4.4425686932184186e-05,0.5
18916,18916,비밀번호/Noun,4,2,2,4.445926419917751e-05,4.4425686932184186e-05,0.5
18917,18917,유혜리/Noun,4,2,2,4.445926419917751e-05,4.4425686932184186e-05,0.5
18918,18918,최명길/Noun,4,2,2,4.445926419917751e-05,4.4425686932184186e-05,0.5
18919,18919,죤내/Noun,4,2,2,4.445926419917751e-05,4.4425686932184186e-05,0.5
18920,18920,소년병/Noun,4,2,2,4.445926419917751e-05,4.4425686932184186e-05,0.5
18921,18921,!!!!!!!!!!!!!!!!!!!!/Punctuation,4,2,2,4.445926419917751e-05,4.4425686932184186e-05,0.5
18922,18922,판가름/Noun,4,2,2,4.445926419917751e-05,4.4425686932184186e-05,0.5
18923,18923,힛/Noun,4,2,2,4.445926419917751e-05,4.4425686932184186e-05,0.5
18924,18924,오작교/Noun,4,2,2,4.445926419917751e-05,4.4425686932184186e-05,0.5
18925,18925,칭하/Noun,4,2,2,4.445926419917751e-05,4.4425686932184186e-05,0.5
18926,18926,내려앉다/Verb,4,2,2,4.445926419917751e-05,4.4425686932184186e-05,0.5
18927,18927,만년필/Noun,4,2,2,4.445926419917751e-05,4.4425686932184186e-05,0.5
18928,18928,에서보다/Josa,4,2,2,4.445926419917751e-05,4.4425686932184186e-05,0.5
18929,18929,47/Number,4,2,2,4.445926419917751e-05,4.4425686932184186e-05,0.5
18930,18930,더시티/Noun,4,2,2,4.445926419917751e-05,4.4425686932184186e-05,0.5
18931,18931,워치/Noun,4,2,2,4.445926419917751e-05,4.4425686932184186e-05,0.5
18932,18932,일본제국/Noun,4,2,2,4.445926419917751e-05,4.4425686932184186e-05,0.5
18933,18933,그저께/Noun,4,2,2,4.445926419917751e-05,4.4425686932184186e-05,0.5
18934,18934,체중/Noun,4,2,2,4.445926419917751e-05,4.4425686932184186e-05,0.5
18935,18935,알제리/Noun,4,2,2,4.445926419917751e-05,4.4425686932184186e-05,0.5
18936,18936,yb/Alpha,4,2,2,4.445926419917751e-05,4.4425686932184186e-05,0.5
18937,18937,에버/Noun,4,2,2,4.445926419917751e-05,4.4425686932184186e-05,0.5
18938,18938,빈곤/Noun,4,2,2,4.445926419917751e-05,4.4425686932184186e-05,0.5
18939,18939,미쳣/Noun,4,2,2,4.445926419917751e-05,4.4425686932184186e-05,0.5
18940,18940,옹기종기/Noun,4,2,2,4.445926419917751e-05,4.4425686932184186e-05,0.5
18941,18941,독살/Noun,4,2,2,4.445926419917751e-05,4.4425686932184186e-05,0.5
18942,18942,박광수/Noun,4,2,2,4.445926419917751e-05,4.4425686932184186e-05,0.5
18943,18943,비결/Noun,4,2,2,4.445926419917751e-05,4.4425686932184186e-05,0.5
18944,18944,유타/Noun,4,2,2,4.445926419917751e-05,4.4425686932184186e-05,0.5
18945,18945,나일/Noun,4,2,2,4.445926419917751e-05,4.4425686932184186e-05,0.5
18946,18946,맨손/Noun,4,2,2,4.445926419917751e-05,4.4425686932184186e-05,0.5
18947,18947,러브씬/Noun,4,2,2,4.445926419917751e-05,4.4425686932184186e-05,0.5
18948,18948,룰루/Noun,4,2,2,4.445926419917751e-05,4.4425686932184186e-05,0.5
18949,18949,드라마정/Noun,4,2,2,4.445926419917751e-05,4.4425686932184186e-05,0.5
18950,18950,본심/Noun,4,2,2,4.445926419917751e-05,4.4425686932184186e-05,0.5
18951,18951,봣었는데/Noun,4,2,2,4.445926419917751e-05,4.4425686932184186e-05,0.5
18952,18952,오염시키다/Verb,4,2,2,4.445926419917751e-05,4.4425686932184186e-05,0.5
18953,18953,간단/Noun,4,2,2,4.445926419917751e-05,4.4425686932184186e-05,0.5
18954,18954,활활/Noun,4,2,2,4.445926419917751e-05,4.4425686932184186e-05,0.5
18955,18955,이라고/Foreign,4,2,2,4.445926419917751e-05,4.4425686932184186e-05,0.5
18956,18956,".,,,/Punctuation",4,2,2,4.445926419917751e-05,4.4425686932184186e-05,0.5
18957,18957,명이/Foreign,4,2,2,4.445926419917751e-05,4.4425686932184186e-05,0.5
18958,18958,다정/Noun,4,2,2,4.445926419917751e-05,4.4425686932184186e-05,0.5
18959,18959,모정/Noun,4,2,2,4.445926419917751e-05,4.4425686932184186e-05,0.5
18960,18960,수사극/Noun,4,2,2,4.445926419917751e-05,4.4425686932184186e-05,0.5
18961,18961,bj/Alpha,4,2,2,4.445926419917751e-05,4.4425686932184186e-05,0.5
18962,18962,김종국/Noun,4,2,2,4.445926419917751e-05,4.4425686932184186e-05,0.5
18963,18963,적의/Noun,4,2,2,4.445926419917751e-05,4.4425686932184186e-05,0.5
18964,18964,만의/Foreign,4,2,2,4.445926419917751e-05,4.4425686932184186e-05,0.5
18965,18965,탈바꿈/Noun,4,2,2,4.445926419917751e-05,4.4425686932184186e-05,0.5
18966,18966,선포/Noun,4,2,2,4.445926419917751e-05,4.4425686932184186e-05,0.5
18967,18967,관속/Noun,4,2,2,4.445926419917751e-05,4.4425686932184186e-05,0.5
18968,18968,우씨/Noun,4,2,2,4.445926419917751e-05,4.4425686932184186e-05,0.5
18969,18969,엄기준/Noun,4,2,2,4.445926419917751e-05,4.4425686932184186e-05,0.5
18970,18970,한겨례/Noun,4,2,2,4.445926419917751e-05,4.4425686932184186e-05,0.5
18971,18971,마노/Noun,4,2,2,4.445926419917751e-05,4.4425686932184186e-05,0.5
18972,18972,명보/Noun,4,2,2,4.445926419917751e-05,4.4425686932184186e-05,0.5
18973,18973,대마초/Noun,4,2,2,4.445926419917751e-05,4.4425686932184186e-05,0.5
18974,18974,불타/Noun,4,2,2,4.445926419917751e-05,4.4425686932184186e-05,0.5
18975,18975,척결/Noun,4,2,2,4.445926419917751e-05,4.4425686932184186e-05,0.5
18976,18976,혼미하다/Adjective,4,2,2,4.445926419917751e-05,4.4425686932184186e-05,0.5
18977,18977,럽라/Noun,4,2,2,4.445926419917751e-05,4.4425686932184186e-05,0.5
18978,18978,뱅크/Noun,4,2,2,4.445926419917751e-05,4.4425686932184186e-05,0.5
18979,18979,8.8/Number,4,2,2,4.445926419917751e-05,4.4425686932184186e-05,0.5
18980,18980,임명/Noun,4,2,2,4.445926419917751e-05,4.4425686932184186e-05,0.5
18981,18981,당혹/Noun,4,2,2,4.445926419917751e-05,4.4425686932184186e-05,0.5
18982,18982,"....,,,,/Punctuation",4,2,2,4.445926419917751e-05,4.4425686932184186e-05,0.5
18983,18983,입다/Noun,3,3,0,5.5574080248971876e-05,2.2212843466092093e-05,1.0
18984,18984,-__-/Punctuation,3,0,3,2.2229632099588756e-05,5.553210866523024e-05,1.0
18985,18985,전교조/Noun,3,0,3,2.2229632099588756e-05,5.553210866523024e-05,1.0
18986,18986,분업/Noun,3,3,0,5.5574080248971876e-05,2.2212843466092093e-05,1.0
18987,18987,우여곡절/Noun,3,3,0,5.5574080248971876e-05,2.2212843466092093e-05,1.0
18988,18988,영화목록/Noun,3,3,0,5.5574080248971876e-05,2.2212843466092093e-05,1.0
18989,18989,30억/Number,3,0,3,2.2229632099588756e-05,5.553210866523024e-05,1.0
18990,18990,숙주/Noun,3,3,0,5.5574080248971876e-05,2.2212843466092093e-05,1.0
18991,18991,삐지다/Adjective,3,0,3,2.2229632099588756e-05,5.553210866523024e-05,1.0
18992,18992,친목질/Noun,3,0,3,2.2229632099588756e-05,5.553210866523024e-05,1.0
18993,18993,서민호/Noun,3,3,0,5.5574080248971876e-05,2.2212843466092093e-05,1.0
18994,18994,양해/Noun,3,0,3,2.2229632099588756e-05,5.553210866523024e-05,1.0
18995,18995,습니다/Eomi,3,3,0,5.5574080248971876e-05,2.2212843466092093e-05,1.0
18996,18996,☞☜/Foreign,3,3,0,5.5574080248971876e-05,2.2212843466092093e-05,1.0
18997,18997,외인/Noun,3,3,0,5.5574080248971876e-05,2.2212843466092093e-05,1.0
18998,18998,따땃해/Noun,3,3,0,5.5574080248971876e-05,2.2212843466092093e-05,1.0
18999,18999,?//Punctuation,3,3,0,5.5574080248971876e-05,2.2212843466092093e-05,1.0
19000,19000,쉽죠잉/Noun,3,0,3,2.2229632099588756e-05,5.553210866523024e-05,1.0
19001,19001,아랐/Noun,3,0,3,2.2229632099588756e-05,5.553210866523024e-05,1.0
19002,19002,..~!/Punctuation,3,3,0,5.5574080248971876e-05,2.2212843466092093e-05,1.0
19003,19003,한의사/Noun,3,0,3,2.2229632099588756e-05,5.553210866523024e-05,1.0
19004,19004,유플릭스/Noun,3,0,3,2.2229632099588756e-05,5.553210866523024e-05,1.0
19005,19005,알았슴/Noun,3,0,3,2.2229632099588756e-05,5.553210866523024e-05,1.0
19006,19006,다혈질/Noun,3,0,3,2.2229632099588756e-05,5.553210866523024e-05,1.0
19007,19007,JYJ/Alpha,3,3,0,5.5574080248971876e-05,2.2212843466092093e-05,1.0
19008,19008,이떄/Noun,3,3,0,5.5574080248971876e-05,2.2212843466092093e-05,1.0
19009,19009,속죄/Noun,3,3,0,5.5574080248971876e-05,2.2212843466092093e-05,1.0
19010,19010,는커녕/Josa,3,0,3,2.2229632099588756e-05,5.553210866523024e-05,1.0
19011,19011,amour/Alpha,3,3,0,5.5574080248971876e-05,2.2212843466092093e-05,1.0
19012,19012,때밀이/Noun,3,0,3,2.2229632099588756e-05,5.553210866523024e-05,1.0
19013,19013,수험생/Noun,3,3,0,5.5574080248971876e-05,2.2212843466092093e-05,1.0
19014,19014,천사도/Noun,3,3,0,5.5574080248971876e-05,2.2212843466092093e-05,1.0
19015,19015,장기간/Noun,3,0,3,2.2229632099588756e-05,5.553210866523024e-05,1.0
19016,19016,묶음/Noun,3,0,3,2.2229632099588756e-05,5.553210866523024e-05,1.0
19017,19017,재무/Noun,3,0,3,2.2229632099588756e-05,5.553210866523024e-05,1.0
19018,19018,게머임/Noun,3,0,3,2.2229632099588756e-05,5.553210866523024e-05,1.0
19019,19019,영재/Noun,3,3,0,5.5574080248971876e-05,2.2212843466092093e-05,1.0
19020,19020,알록달록하다/Adjective,3,3,0,5.5574080248971876e-05,2.2212843466092093e-05,1.0
19021,19021,ㄵ/KoreanParticle,3,0,3,2.2229632099588756e-05,5.553210866523024e-05,1.0
19022,19022,동민/Noun,3,3,0,5.5574080248971876e-05,2.2212843466092093e-05,1.0
19023,19023,숨은그림찾기/Noun,3,3,0,5.5574080248971876e-05,2.2212843466092093e-05,1.0
19024,19024,카프리/Noun,3,3,0,5.5574080248971876e-05,2.2212843466092093e-05,1.0
19025,19025,바라나시/Noun,3,3,0,5.5574080248971876e-05,2.2212843466092093e-05,1.0
19026,19026,est/Alpha,3,3,0,5.5574080248971876e-05,2.2212843466092093e-05,1.0
19027,19027,발레리/Noun,3,3,0,5.5574080248971876e-05,2.2212843466092093e-05,1.0
19028,19028,이송/Noun,3,0,3,2.2229632099588756e-05,5.553210866523024e-05,1.0
19029,19029,..^.^/Punctuation,3,3,0,5.5574080248971876e-05,2.2212843466092093e-05,1.0
19030,19030,로큰롤/Noun,3,3,0,5.5574080248971876e-05,2.2212843466092093e-05,1.0
19031,19031,언어유희/Noun,3,3,0,5.5574080248971876e-05,2.2212843466092093e-05,1.0
19032,19032,미니어처/Noun,3,0,3,2.2229632099588756e-05,5.553210866523024e-05,1.0
19033,19033,BA/Alpha,3,3,0,5.5574080248971876e-05,2.2212843466092093e-05,1.0
19034,19034,해공/Noun,3,3,0,5.5574080248971876e-05,2.2212843466092093e-05,1.0
19035,19035,카츠/Noun,3,3,0,5.5574080248971876e-05,2.2212843466092093e-05,1.0
19036,19036,음정/Noun,3,0,3,2.2229632099588756e-05,5.553210866523024e-05,1.0
19037,19037,앤키/Noun,3,3,0,5.5574080248971876e-05,2.2212843466092093e-05,1.0
19038,19038,쥬로링/Noun,3,3,0,5.5574080248971876e-05,2.2212843466092093e-05,1.0
19039,19039,식/Foreign,3,0,3,2.2229632099588756e-05,5.553210866523024e-05,1.0
19040,19040,쓰지맙시/Noun,3,0,3,2.2229632099588756e-05,5.553210866523024e-05,1.0
19041,19041,bitch/Alpha,3,0,3,2.2229632099588756e-05,5.553210866523024e-05,1.0
19042,19042,동인/Noun,3,0,3,2.2229632099588756e-05,5.553210866523024e-05,1.0
19043,19043,롤로/Noun,3,3,0,5.5574080248971876e-05,2.2212843466092093e-05,1.0
19044,19044,좇/Noun,3,0,3,2.2229632099588756e-05,5.553210866523024e-05,1.0
19045,19045,열흘/Noun,3,3,0,5.5574080248971876e-05,2.2212843466092093e-05,1.0
19046,19046,통신/Noun,3,3,0,5.5574080248971876e-05,2.2212843466092093e-05,1.0
19047,19047,긴가민가하다/Adjective,3,3,0,5.5574080248971876e-05,2.2212843466092093e-05,1.0
19048,19048,이뻣/Noun,3,3,0,5.5574080248971876e-05,2.2212843466092093e-05,1.0
19049,19049,오사/Noun,3,0,3,2.2229632099588756e-05,5.553210866523024e-05,1.0
19050,19050,군함/Noun,3,3,0,5.5574080248971876e-05,2.2212843466092093e-05,1.0
19051,19051,짜릿짜릿하다/Adjective,3,3,0,5.5574080248971876e-05,2.2212843466092093e-05,1.0
19052,19052,조성모/Noun,3,0,3,2.2229632099588756e-05,5.553210866523024e-05,1.0
19053,19053,법안/Noun,3,3,0,5.5574080248971876e-05,2.2212843466092093e-05,1.0
19054,19054,009/Number,3,3,0,5.5574080248971876e-05,2.2212843466092093e-05,1.0
19055,19055,이응/Noun,3,3,0,5.5574080248971876e-05,2.2212843466092093e-05,1.0
19056,19056,울렁증/Noun,3,0,3,2.2229632099588756e-05,5.553210866523024e-05,1.0
19057,19057,또봇/Noun,3,0,3,2.2229632099588756e-05,5.553210866523024e-05,1.0
19058,19058,반딧불/Noun,3,0,3,2.2229632099588756e-05,5.553210866523024e-05,1.0
19059,19059,♡♥/Foreign,3,3,0,5.5574080248971876e-05,2.2212843466092093e-05,1.0
19060,19060,쓰레/Noun,3,0,3,2.2229632099588756e-05,5.553210866523024e-05,1.0
19061,19061,후반기/Noun,3,0,3,2.2229632099588756e-05,5.553210866523024e-05,1.0
19062,19062,랑께요/Josa,3,0,3,2.2229632099588756e-05,5.553210866523024e-05,1.0
19063,19063,폴포츠/Noun,3,3,0,5.5574080248971876e-05,2.2212843466092093e-05,1.0
19064,19064,Bean/Alpha,3,0,3,2.2229632099588756e-05,5.553210866523024e-05,1.0
19065,19065,잡종/Noun,3,0,3,2.2229632099588756e-05,5.553210866523024e-05,1.0
19066,19066,은제/Noun,3,3,0,5.5574080248971876e-05,2.2212843466092093e-05,1.0
19067,19067,선화공주/Noun,3,3,0,5.5574080248971876e-05,2.2212843466092093e-05,1.0
19068,19068,기동/Noun,3,3,0,5.5574080248971876e-05,2.2212843466092093e-05,1.0
19069,19069,철회/Noun,3,0,3,2.2229632099588756e-05,5.553210866523024e-05,1.0
19070,19070,렘/Noun,3,3,0,5.5574080248971876e-05,2.2212843466092093e-05,1.0
19071,19071,엿같아/Noun,3,0,3,2.2229632099588756e-05,5.553210866523024e-05,1.0
19072,19072,대보면/Noun,3,0,3,2.2229632099588756e-05,5.553210866523024e-05,1.0
19073,19073,녹아내리다/Verb,3,3,0,5.5574080248971876e-05,2.2212843466092093e-05,1.0
19074,19074,류구/Noun,3,0,3,2.2229632099588756e-05,5.553210866523024e-05,1.0
19075,19075,찌끄레기/Noun,3,0,3,2.2229632099588756e-05,5.553210866523024e-05,1.0
19076,19076,거꼭/Noun,3,3,0,5.5574080248971876e-05,2.2212843466092093e-05,1.0
19077,19077,꿀벌/Noun,3,3,0,5.5574080248971876e-05,2.2212843466092093e-05,1.0
19078,19078,알흠/Noun,3,3,0,5.5574080248971876e-05,2.2212843466092093e-05,1.0
19079,19079,쨩/Noun,3,3,0,5.5574080248971876e-05,2.2212843466092093e-05,1.0
19080,19080,쉐리/Noun,3,3,0,5.5574080248971876e-05,2.2212843466092093e-05,1.0
19081,19081,씨받이/Noun,3,0,3,2.2229632099588756e-05,5.553210866523024e-05,1.0
19082,19082,59년/Number,3,3,0,5.5574080248971876e-05,2.2212843466092093e-05,1.0
19083,19083,엘비스/Noun,3,3,0,5.5574080248971876e-05,2.2212843466092093e-05,1.0
19084,19084,가이거/Noun,3,3,0,5.5574080248971876e-05,2.2212843466092093e-05,1.0
19085,19085,서슴없이/Adverb,3,3,0,5.5574080248971876e-05,2.2212843466092093e-05,1.0
19086,19086,상디/Noun,3,3,0,5.5574080248971876e-05,2.2212843466092093e-05,1.0
19087,19087,귯/Noun,3,3,0,5.5574080248971876e-05,2.2212843466092093e-05,1.0
19088,19088,현충일/Noun,3,3,0,5.5574080248971876e-05,2.2212843466092093e-05,1.0
19089,19089,최영장군/Noun,3,3,0,5.5574080248971876e-05,2.2212843466092093e-05,1.0
19090,19090,이현세/Noun,3,0,3,2.2229632099588756e-05,5.553210866523024e-05,1.0
19091,19091,신상/Noun,3,0,3,2.2229632099588756e-05,5.553210866523024e-05,1.0
19092,19092,출가/Noun,3,0,3,2.2229632099588756e-05,5.553210866523024e-05,1.0
19093,19093,왼/Noun,3,0,3,2.2229632099588756e-05,5.553210866523024e-05,1.0
19094,19094,팔방미인/Noun,3,3,0,5.5574080248971876e-05,2.2212843466092093e-05,1.0
19095,19095,졸잼졸잼/Noun,3,3,0,5.5574080248971876e-05,2.2212843466092093e-05,1.0
19096,19096,강우/Noun,3,3,0,5.5574080248971876e-05,2.2212843466092093e-05,1.0
19097,19097,기장면/Noun,3,0,3,2.2229632099588756e-05,5.553210866523024e-05,1.0
19098,19098,36%/Number,3,0,3,2.2229632099588756e-05,5.553210866523024e-05,1.0
19099,19099,.^/Punctuation,3,3,0,5.5574080248971876e-05,2.2212843466092093e-05,1.0
19100,19100,흠칫/Noun,3,3,0,5.5574080248971876e-05,2.2212843466092093e-05,1.0
19101,19101,변방/Noun,3,0,3,2.2229632099588756e-05,5.553210866523024e-05,1.0
19102,19102,뻑하/Noun,3,0,3,2.2229632099588756e-05,5.553210866523024e-05,1.0
19103,19103,고원/Noun,3,3,0,5.5574080248971876e-05,2.2212843466092093e-05,1.0
19104,19104,동준/Noun,3,0,3,2.2229632099588756e-05,5.553210866523024e-05,1.0
19105,19105,touching/Alpha,3,3,0,5.5574080248971876e-05,2.2212843466092093e-05,1.0
19106,19106,ㅜㅡㅠ/KoreanParticle,3,3,0,5.5574080248971876e-05,2.2212843466092093e-05,1.0
19107,19107,역차별/Noun,3,0,3,2.2229632099588756e-05,5.553210866523024e-05,1.0
19108,19108,thing/Alpha,3,3,0,5.5574080248971876e-05,2.2212843466092093e-05,1.0
19109,19109,레시/Noun,3,0,3,2.2229632099588756e-05,5.553210866523024e-05,1.0
19110,19110,기욤/Noun,3,3,0,5.5574080248971876e-05,2.2212843466092093e-05,1.0
19111,19111,콩닥콩닥/Adverb,3,3,0,5.5574080248971876e-05,2.2212843466092093e-05,1.0
19112,19112,크리스토퍼놀란/Noun,3,3,0,5.5574080248971876e-05,2.2212843466092093e-05,1.0
19113,19113,독단/Noun,3,0,3,2.2229632099588756e-05,5.553210866523024e-05,1.0
19114,19114,성미산/Noun,3,3,0,5.5574080248971876e-05,2.2212843466092093e-05,1.0
19115,19115,이십분/Noun,3,0,3,2.2229632099588756e-05,5.553210866523024e-05,1.0
19116,19116,무휼/Noun,3,3,0,5.5574080248971876e-05,2.2212843466092093e-05,1.0
19117,19117,태왕사신기/Noun,3,0,3,2.2229632099588756e-05,5.553210866523024e-05,1.0
19118,19118,지구촌/Noun,3,3,0,5.5574080248971876e-05,2.2212843466092093e-05,1.0
19119,19119,췌/Noun,3,0,3,2.2229632099588756e-05,5.553210866523024e-05,1.0
19120,19120,당산대형/Noun,3,3,0,5.5574080248971876e-05,2.2212843466092093e-05,1.0
19121,19121,....-/Punctuation,3,0,3,2.2229632099588756e-05,5.553210866523024e-05,1.0
19122,19122,ㅆㄹ/KoreanParticle,3,0,3,2.2229632099588756e-05,5.553210866523024e-05,1.0
19123,19123,유해/Noun,3,0,3,2.2229632099588756e-05,5.553210866523024e-05,1.0
19124,19124,졸짝/Noun,3,0,3,2.2229632099588756e-05,5.553210866523024e-05,1.0
19125,19125,카가와/Noun,3,3,0,5.5574080248971876e-05,2.2212843466092093e-05,1.0
19126,19126,주노/Noun,3,3,0,5.5574080248971876e-05,2.2212843466092093e-05,1.0
19127,19127,미경/Noun,3,3,0,5.5574080248971876e-05,2.2212843466092093e-05,1.0
19128,19128,베버리힐즈/Noun,3,3,0,5.5574080248971876e-05,2.2212843466092093e-05,1.0
19129,19129,티저/Noun,3,0,3,2.2229632099588756e-05,5.553210866523024e-05,1.0
19130,19130,도넛/Noun,3,3,0,5.5574080248971876e-05,2.2212843466092093e-05,1.0
19131,19131,사지절단/Noun,3,0,3,2.2229632099588756e-05,5.553210866523024e-05,1.0
19132,19132,WHO/Alpha,3,3,0,5.5574080248971876e-05,2.2212843466092093e-05,1.0
19133,19133,파동/Noun,3,3,0,5.5574080248971876e-05,2.2212843466092093e-05,1.0
19134,19134,시애틀/Noun,3,3,0,5.5574080248971876e-05,2.2212843466092093e-05,1.0
19135,19135,벤치/Noun,3,3,0,5.5574080248971876e-05,2.2212843466092093e-05,1.0
19136,19136,문화인/Noun,3,0,3,2.2229632099588756e-05,5.553210866523024e-05,1.0
19137,19137,뽀잉/Noun,3,3,0,5.5574080248971876e-05,2.2212843466092093e-05,1.0
19138,19138,솟아오르다/Verb,3,3,0,5.5574080248971876e-05,2.2212843466092093e-05,1.0
19139,19139,치구/Noun,3,0,3,2.2229632099588756e-05,5.553210866523024e-05,1.0
19140,19140,외적인/Noun,3,0,3,2.2229632099588756e-05,5.553210866523024e-05,1.0
19141,19141,떠벌리다/Verb,3,0,3,2.2229632099588756e-05,5.553210866523024e-05,1.0
19142,19142,총리와나/Noun,3,3,0,5.5574080248971876e-05,2.2212843466092093e-05,1.0
19143,19143,밥줄/Noun,3,0,3,2.2229632099588756e-05,5.553210866523024e-05,1.0
19144,19144,만장일치/Noun,3,0,3,2.2229632099588756e-05,5.553210866523024e-05,1.0
19145,19145,더그/Noun,3,3,0,5.5574080248971876e-05,2.2212843466092093e-05,1.0
19146,19146,프랜차이즈/Noun,3,0,3,2.2229632099588756e-05,5.553210866523024e-05,1.0
19147,19147,스렉/Noun,3,0,3,2.2229632099588756e-05,5.553210866523024e-05,1.0
19148,19148,투구/Noun,3,0,3,2.2229632099588756e-05,5.553210866523024e-05,1.0
19149,19149,喜/Foreign,3,3,0,5.5574080248971876e-05,2.2212843466092093e-05,1.0
19150,19150,박효주/Noun,3,3,0,5.5574080248971876e-05,2.2212843466092093e-05,1.0
19151,19151,가구야/Noun,3,3,0,5.5574080248971876e-05,2.2212843466092093e-05,1.0
19152,19152,처가/Noun,3,3,0,5.5574080248971876e-05,2.2212843466092093e-05,1.0
19153,19153,고결하다/Adjective,3,3,0,5.5574080248971876e-05,2.2212843466092093e-05,1.0
19154,19154,프리메이슨/Noun,3,0,3,2.2229632099588756e-05,5.553210866523024e-05,1.0
19155,19155,침팬지/Noun,3,3,0,5.5574080248971876e-05,2.2212843466092093e-05,1.0
19156,19156,켓/Noun,3,3,0,5.5574080248971876e-05,2.2212843466092093e-05,1.0
19157,19157,"-,.-;;/Punctuation",3,0,3,2.2229632099588756e-05,5.553210866523024e-05,1.0
19158,19158,자레드/Noun,3,3,0,5.5574080248971876e-05,2.2212843466092093e-05,1.0
19159,19159,델리/Noun,3,3,0,5.5574080248971876e-05,2.2212843466092093e-05,1.0
19160,19160,문어체/Noun,3,0,3,2.2229632099588756e-05,5.553210866523024e-05,1.0
19161,19161,유호정/Noun,3,3,0,5.5574080248971876e-05,2.2212843466092093e-05,1.0
19162,19162,서진/Noun,3,3,0,5.5574080248971876e-05,2.2212843466092093e-05,1.0
19163,19163,대폭/Noun,3,0,3,2.2229632099588756e-05,5.553210866523024e-05,1.0
19164,19164,they/Alpha,3,3,0,5.5574080248971876e-05,2.2212843466092093e-05,1.0
19165,19165,boys/Alpha,3,3,0,5.5574080248971876e-05,2.2212843466092093e-05,1.0
19166,19166,네버랜드/Noun,3,3,0,5.5574080248971876e-05,2.2212843466092093e-05,1.0
19167,19167,채권/Noun,3,0,3,2.2229632099588756e-05,5.553210866523024e-05,1.0
19168,19168,베오울프/Noun,3,3,0,5.5574080248971876e-05,2.2212843466092093e-05,1.0
19169,19169,총지배인/Noun,3,0,3,2.2229632099588756e-05,5.553210866523024e-05,1.0
19170,19170,AIDS/Alpha,3,0,3,2.2229632099588756e-05,5.553210866523024e-05,1.0
19171,19171,놨음/Noun,3,0,3,2.2229632099588756e-05,5.553210866523024e-05,1.0
19172,19172,개잼꿀잼/Noun,3,3,0,5.5574080248971876e-05,2.2212843466092093e-05,1.0
19173,19173,가년/Noun,3,0,3,2.2229632099588756e-05,5.553210866523024e-05,1.0
19174,19174,AKB/Alpha,3,0,3,2.2229632099588756e-05,5.553210866523024e-05,1.0
19175,19175,비보/Noun,3,0,3,2.2229632099588756e-05,5.553210866523024e-05,1.0
19176,19176,정은채/Noun,3,0,3,2.2229632099588756e-05,5.553210866523024e-05,1.0
19177,19177,유하은/Noun,3,0,3,2.2229632099588756e-05,5.553210866523024e-05,1.0
19178,19178,amazing/Alpha,3,3,0,5.5574080248971876e-05,2.2212843466092093e-05,1.0
19179,19179,박진표/Noun,3,0,3,2.2229632099588756e-05,5.553210866523024e-05,1.0
19180,19180,부옇다/Adjective,3,0,3,2.2229632099588756e-05,5.553210866523024e-05,1.0
19181,19181,제밌다/Noun,3,3,0,5.5574080248971876e-05,2.2212843466092093e-05,1.0
19182,19182,..;;;;;/Punctuation,3,0,3,2.2229632099588756e-05,5.553210866523024e-05,1.0
19183,19183,조물/Noun,3,0,3,2.2229632099588756e-05,5.553210866523024e-05,1.0
19184,19184,봤넹/Noun,3,3,0,5.5574080248971876e-05,2.2212843466092093e-05,1.0
19185,19185,헤스/Noun,3,3,0,5.5574080248971876e-05,2.2212843466092093e-05,1.0
19186,19186,찰톤/Noun,3,3,0,5.5574080248971876e-05,2.2212843466092093e-05,1.0
19187,19187,웡/Noun,3,3,0,5.5574080248971876e-05,2.2212843466092093e-05,1.0
19188,19188,냉동/Noun,3,0,3,2.2229632099588756e-05,5.553210866523024e-05,1.0
19189,19189,스코필드/Noun,3,3,0,5.5574080248971876e-05,2.2212843466092093e-05,1.0
19190,19190,live/Alpha,3,3,0,5.5574080248971876e-05,2.2212843466092093e-05,1.0
19191,19191,등지/Noun,3,3,0,5.5574080248971876e-05,2.2212843466092093e-05,1.0
19192,19192,배격/Noun,3,3,0,5.5574080248971876e-05,2.2212843466092093e-05,1.0
19193,19193,기입/Noun,3,0,3,2.2229632099588756e-05,5.553210866523024e-05,1.0
19194,19194,킹덤/Noun,3,3,0,5.5574080248971876e-05,2.2212843466092093e-05,1.0
19195,19195,자기야/Noun,3,0,3,2.2229632099588756e-05,5.553210866523024e-05,1.0
19196,19196,불확실/Noun,3,0,3,2.2229632099588756e-05,5.553210866523024e-05,1.0
19197,19197,으레/Noun,3,0,3,2.2229632099588756e-05,5.553210866523024e-05,1.0
19198,19198,!!)/Punctuation,3,3,0,5.5574080248971876e-05,2.2212843466092093e-05,1.0
19199,19199,교도/Noun,3,0,3,2.2229632099588756e-05,5.553210866523024e-05,1.0
19200,19200,윈다졸/Noun,3,0,3,2.2229632099588756e-05,5.553210866523024e-05,1.0
19201,19201,나올껄/Noun,3,0,3,2.2229632099588756e-05,5.553210866523024e-05,1.0
19202,19202,펄펄/Adverb,3,3,0,5.5574080248971876e-05,2.2212843466092093e-05,1.0
19203,19203,;;;;;;;;/Punctuation,3,0,3,2.2229632099588756e-05,5.553210866523024e-05,1.0
19204,19204,발명/Noun,3,0,3,2.2229632099588756e-05,5.553210866523024e-05,1.0
19205,19205,유래/Noun,3,0,3,2.2229632099588756e-05,5.553210866523024e-05,1.0
19206,19206,북조선/Noun,3,0,3,2.2229632099588756e-05,5.553210866523024e-05,1.0
19207,19207,히어로즈/Noun,3,3,0,5.5574080248971876e-05,2.2212843466092093e-05,1.0
19208,19208,굿구/Noun,3,3,0,5.5574080248971876e-05,2.2212843466092093e-05,1.0
19209,19209,IMDb/Alpha,3,0,3,2.2229632099588756e-05,5.553210866523024e-05,1.0
19210,19210,송재호/Noun,3,3,0,5.5574080248971876e-05,2.2212843466092093e-05,1.0
19211,19211,y/Alpha,3,3,0,5.5574080248971876e-05,2.2212843466092093e-05,1.0
19212,19212,엽서/Noun,3,3,0,5.5574080248971876e-05,2.2212843466092093e-05,1.0
19213,19213,스모크/Noun,3,3,0,5.5574080248971876e-05,2.2212843466092093e-05,1.0
19214,19214,만들엇네/Noun,3,0,3,2.2229632099588756e-05,5.553210866523024e-05,1.0
19215,19215,섬뜻/Noun,3,3,0,5.5574080248971876e-05,2.2212843466092093e-05,1.0
19216,19216,촤고/Noun,3,3,0,5.5574080248971876e-05,2.2212843466092093e-05,1.0
19217,19217,망언/Noun,3,0,3,2.2229632099588756e-05,5.553210866523024e-05,1.0
19218,19218,킥킥대다/Verb,3,3,0,5.5574080248971876e-05,2.2212843466092093e-05,1.0
19219,19219,하이브리드/Noun,3,0,3,2.2229632099588756e-05,5.553210866523024e-05,1.0
19220,19220,잘잘못/Noun,3,0,3,2.2229632099588756e-05,5.553210866523024e-05,1.0
19221,19221,시에라/Noun,3,3,0,5.5574080248971876e-05,2.2212843466092093e-05,1.0
19222,19222,인굿/Noun,3,3,0,5.5574080248971876e-05,2.2212843466092093e-05,1.0
19223,19223,류진/Noun,3,0,3,2.2229632099588756e-05,5.553210866523024e-05,1.0
19224,19224,이질/Noun,3,0,3,2.2229632099588756e-05,5.553210866523024e-05,1.0
19225,19225,버럭버럭/Adverb,3,0,3,2.2229632099588756e-05,5.553210866523024e-05,1.0
19226,19226,외숙모/Noun,3,0,3,2.2229632099588756e-05,5.553210866523024e-05,1.0
19227,19227,선속/Noun,3,3,0,5.5574080248971876e-05,2.2212843466092093e-05,1.0
19228,19228,세면/Noun,3,0,3,2.2229632099588756e-05,5.553210866523024e-05,1.0
19229,19229,퀵실버/Noun,3,3,0,5.5574080248971876e-05,2.2212843466092093e-05,1.0
19230,19230,사퇴/Noun,3,0,3,2.2229632099588756e-05,5.553210866523024e-05,1.0
19231,19231,중학/Noun,3,3,0,5.5574080248971876e-05,2.2212843466092093e-05,1.0
19232,19232,有/Foreign,3,0,3,2.2229632099588756e-05,5.553210866523024e-05,1.0
19233,19233,잼있넹/Noun,3,3,0,5.5574080248971876e-05,2.2212843466092093e-05,1.0
19234,19234,rain/Alpha,3,3,0,5.5574080248971876e-05,2.2212843466092093e-05,1.0
19235,19235,기별/Noun,3,0,3,2.2229632099588756e-05,5.553210866523024e-05,1.0
19236,19236,틀때/Noun,3,0,3,2.2229632099588756e-05,5.553210866523024e-05,1.0
19237,19237,서하/Noun,3,0,3,2.2229632099588756e-05,5.553210866523024e-05,1.0
19238,19238,밤늦다/Adjective,3,3,0,5.5574080248971876e-05,2.2212843466092093e-05,1.0
19239,19239,남다름/Noun,3,3,0,5.5574080248971876e-05,2.2212843466092093e-05,1.0
19240,19240,해괴/Noun,3,0,3,2.2229632099588756e-05,5.553210866523024e-05,1.0
19241,19241,부림/Noun,3,0,3,2.2229632099588756e-05,5.553210866523024e-05,1.0
19242,19242,낚였군/Noun,3,0,3,2.2229632099588756e-05,5.553210866523024e-05,1.0
19243,19243,민페/Noun,3,0,3,2.2229632099588756e-05,5.553210866523024e-05,1.0
19244,19244,김희철/Noun,3,0,3,2.2229632099588756e-05,5.553210866523024e-05,1.0
19245,19245,정하나/Noun,3,0,3,2.2229632099588756e-05,5.553210866523024e-05,1.0
19246,19246,김문옥/Noun,3,0,3,2.2229632099588756e-05,5.553210866523024e-05,1.0
19247,19247,돈대/Noun,3,0,3,2.2229632099588756e-05,5.553210866523024e-05,1.0
19248,19248,사비/Noun,3,0,3,2.2229632099588756e-05,5.553210866523024e-05,1.0
19249,19249,??????????/Punctuation,3,0,3,2.2229632099588756e-05,5.553210866523024e-05,1.0
19250,19250,불성실하다/Adjective,3,0,3,2.2229632099588756e-05,5.553210866523024e-05,1.0
19251,19251,샤우팅/Noun,3,0,3,2.2229632099588756e-05,5.553210866523024e-05,1.0
19252,19252,면욕/Noun,3,0,3,2.2229632099588756e-05,5.553210866523024e-05,1.0
19253,19253,기차역/Noun,3,3,0,5.5574080248971876e-05,2.2212843466092093e-05,1.0
19254,19254,줏/Noun,3,3,0,5.5574080248971876e-05,2.2212843466092093e-05,1.0
19255,19255,쉬이/Noun,3,3,0,5.5574080248971876e-05,2.2212843466092093e-05,1.0
19256,19256,부탄/Noun,3,3,0,5.5574080248971876e-05,2.2212843466092093e-05,1.0
19257,19257,김성오/Noun,3,0,3,2.2229632099588756e-05,5.553210866523024e-05,1.0
19258,19258,류승수/Noun,3,3,0,5.5574080248971876e-05,2.2212843466092093e-05,1.0
19259,19259,머슴/Noun,3,0,3,2.2229632099588756e-05,5.553210866523024e-05,1.0
19260,19260,육지/Noun,3,3,0,5.5574080248971876e-05,2.2212843466092093e-05,1.0
19261,19261,점정/Noun,3,3,0,5.5574080248971876e-05,2.2212843466092093e-05,1.0
19262,19262,화룡/Noun,3,3,0,5.5574080248971876e-05,2.2212843466092093e-05,1.0
19263,19263,절름발이/Noun,3,3,0,5.5574080248971876e-05,2.2212843466092093e-05,1.0
19264,19264,주모/Noun,3,0,3,2.2229632099588756e-05,5.553210866523024e-05,1.0
19265,19265,인호/Noun,3,3,0,5.5574080248971876e-05,2.2212843466092093e-05,1.0
19266,19266,120억/Number,3,0,3,2.2229632099588756e-05,5.553210866523024e-05,1.0
19267,19267,영수/Noun,3,3,0,5.5574080248971876e-05,2.2212843466092093e-05,1.0
19268,19268,프란/Noun,3,3,0,5.5574080248971876e-05,2.2212843466092093e-05,1.0
19269,19269,짬밥/Noun,3,0,3,2.2229632099588756e-05,5.553210866523024e-05,1.0
19270,19270,백야행/Noun,3,3,0,5.5574080248971876e-05,2.2212843466092093e-05,1.0
19271,19271,.^^;/Punctuation,3,3,0,5.5574080248971876e-05,2.2212843466092093e-05,1.0
19272,19272,퀸스/Noun,3,3,0,5.5574080248971876e-05,2.2212843466092093e-05,1.0
19273,19273,이상현/Noun,3,0,3,2.2229632099588756e-05,5.553210866523024e-05,1.0
19274,19274,Can/Alpha,3,3,0,5.5574080248971876e-05,2.2212843466092093e-05,1.0
19275,19275,조급하다/Adjective,3,0,3,2.2229632099588756e-05,5.553210866523024e-05,1.0
19276,19276,하렘/Noun,3,0,3,2.2229632099588756e-05,5.553210866523024e-05,1.0
19277,19277,미묘/Noun,3,0,3,2.2229632099588756e-05,5.553210866523024e-05,1.0
19278,19278,오하나/Noun,3,3,0,5.5574080248971876e-05,2.2212843466092093e-05,1.0
19279,19279,즉시/Noun,3,3,0,5.5574080248971876e-05,2.2212843466092093e-05,1.0
19280,19280,천대/Noun,3,0,3,2.2229632099588756e-05,5.553210866523024e-05,1.0
19281,19281,사제/Noun,3,0,3,2.2229632099588756e-05,5.553210866523024e-05,1.0
19282,19282,특효약/Noun,3,0,3,2.2229632099588756e-05,5.553210866523024e-05,1.0
19283,19283,비닐봉지/Noun,3,0,3,2.2229632099588756e-05,5.553210866523024e-05,1.0
19284,19284,끝일/Noun,3,3,0,5.5574080248971876e-05,2.2212843466092093e-05,1.0
19285,19285,염증/Noun,3,3,0,5.5574080248971876e-05,2.2212843466092093e-05,1.0
19286,19286,세부/Noun,3,0,3,2.2229632099588756e-05,5.553210866523024e-05,1.0
19287,19287,실습/Noun,3,0,3,2.2229632099588756e-05,5.553210866523024e-05,1.0
19288,19288,이니셜/Noun,3,0,3,2.2229632099588756e-05,5.553210866523024e-05,1.0
19289,19289,!!@@/Punctuation,3,3,0,5.5574080248971876e-05,2.2212843466092093e-05,1.0
19290,19290,호노카/Noun,3,0,3,2.2229632099588756e-05,5.553210866523024e-05,1.0
19291,19291,칼리/Noun,3,3,0,5.5574080248971876e-05,2.2212843466092093e-05,1.0
19292,19292,당시/Foreign,3,3,0,5.5574080248971876e-05,2.2212843466092093e-05,1.0
19293,19293,제로센/Noun,3,0,3,2.2229632099588756e-05,5.553210866523024e-05,1.0
19294,19294,켜지다/Verb,3,0,3,2.2229632099588756e-05,5.553210866523024e-05,1.0
19295,19295,가슴성형/Noun,3,0,3,2.2229632099588756e-05,5.553210866523024e-05,1.0
19296,19296,용씨/Noun,3,3,0,5.5574080248971876e-05,2.2212843466092093e-05,1.0
19297,19297,사일런트/Noun,3,0,3,2.2229632099588756e-05,5.553210866523024e-05,1.0
19298,19298,뭐합/Noun,3,0,3,2.2229632099588756e-05,5.553210866523024e-05,1.0
19299,19299,돌려막기/Noun,3,0,3,2.2229632099588756e-05,5.553210866523024e-05,1.0
19300,19300,효리/Noun,3,0,3,2.2229632099588756e-05,5.553210866523024e-05,1.0
19301,19301,뱅크시/Noun,3,3,0,5.5574080248971876e-05,2.2212843466092093e-05,1.0
19302,19302,나도꽃/Noun,3,3,0,5.5574080248971876e-05,2.2212843466092093e-05,1.0
19303,19303,이정표/Noun,3,3,0,5.5574080248971876e-05,2.2212843466092093e-05,1.0
19304,19304,염불/Noun,3,0,3,2.2229632099588756e-05,5.553210866523024e-05,1.0
19305,19305,석가모니/Noun,3,0,3,2.2229632099588756e-05,5.553210866523024e-05,1.0
19306,19306,가야로/Noun,3,3,0,5.5574080248971876e-05,2.2212843466092093e-05,1.0
19307,19307,가대/Noun,3,0,3,2.2229632099588756e-05,5.553210866523024e-05,1.0
19308,19308,차가워지다/Verb,3,3,0,5.5574080248971876e-05,2.2212843466092093e-05,1.0
19309,19309,해양경찰/Noun,3,0,3,2.2229632099588756e-05,5.553210866523024e-05,1.0
19310,19310,자고로/Noun,3,0,3,2.2229632099588756e-05,5.553210866523024e-05,1.0
19311,19311,족적/Noun,3,3,0,5.5574080248971876e-05,2.2212843466092093e-05,1.0
19312,19312,메이지/Noun,3,3,0,5.5574080248971876e-05,2.2212843466092093e-05,1.0
19313,19313,샘물교회/Noun,3,0,3,2.2229632099588756e-05,5.553210866523024e-05,1.0
19314,19314,ㅅㄱㅇ/KoreanParticle,3,0,3,2.2229632099588756e-05,5.553210866523024e-05,1.0
19315,19315,이호/Noun,3,3,0,5.5574080248971876e-05,2.2212843466092093e-05,1.0
19316,19316,뮤즈/Noun,3,3,0,5.5574080248971876e-05,2.2212843466092093e-05,1.0
19317,19317,무용담/Noun,3,0,3,2.2229632099588756e-05,5.553210866523024e-05,1.0
19318,19318,프사이/Noun,3,3,0,5.5574080248971876e-05,2.2212843466092093e-05,1.0
19319,19319,크라임씬/Noun,3,3,0,5.5574080248971876e-05,2.2212843466092093e-05,1.0
19320,19320,희로애락/Noun,3,3,0,5.5574080248971876e-05,2.2212843466092093e-05,1.0
19321,19321,금상첨화/Noun,3,3,0,5.5574080248971876e-05,2.2212843466092093e-05,1.0
19322,19322,레슬리닐슨/Noun,3,3,0,5.5574080248971876e-05,2.2212843466092093e-05,1.0
19323,19323,밑천/Noun,3,0,3,2.2229632099588756e-05,5.553210866523024e-05,1.0
19324,19324,관광지/Noun,3,0,3,2.2229632099588756e-05,5.553210866523024e-05,1.0
19325,19325,생뚱맞는/Noun,3,0,3,2.2229632099588756e-05,5.553210866523024e-05,1.0
19326,19326,come/Alpha,3,3,0,5.5574080248971876e-05,2.2212843466092093e-05,1.0
19327,19327,벨아미/Noun,3,0,3,2.2229632099588756e-05,5.553210866523024e-05,1.0
19328,19328,ㅈㅈㅈ/KoreanParticle,3,0,3,2.2229632099588756e-05,5.553210866523024e-05,1.0
19329,19329,총상/Noun,3,0,3,2.2229632099588756e-05,5.553210866523024e-05,1.0
19330,19330,연적/Noun,3,0,3,2.2229632099588756e-05,5.553210866523024e-05,1.0
19331,19331,사표/Noun,3,0,3,2.2229632099588756e-05,5.553210866523024e-05,1.0
19332,19332,떡대/Noun,3,0,3,2.2229632099588756e-05,5.553210866523024e-05,1.0
19333,19333,섬찟하다/Adjective,3,3,0,5.5574080248971876e-05,2.2212843466092093e-05,1.0
19334,19334,르누아르/Noun,3,3,0,5.5574080248971876e-05,2.2212843466092093e-05,1.0
19335,19335,애마/Noun,3,0,3,2.2229632099588756e-05,5.553210866523024e-05,1.0
19336,19336,퍼갈게/Noun,3,3,0,5.5574080248971876e-05,2.2212843466092093e-05,1.0
19337,19337,두산베어스/Noun,3,0,3,2.2229632099588756e-05,5.553210866523024e-05,1.0
19338,19338,개망작임/Noun,3,0,3,2.2229632099588756e-05,5.553210866523024e-05,1.0
19339,19339,법정씬/Noun,3,0,3,2.2229632099588756e-05,5.553210866523024e-05,1.0
19340,19340,저쪽/Noun,3,0,3,2.2229632099588756e-05,5.553210866523024e-05,1.0
19341,19341,윤석화/Noun,3,0,3,2.2229632099588756e-05,5.553210866523024e-05,1.0
19342,19342,경탄/Noun,3,3,0,5.5574080248971876e-05,2.2212843466092093e-05,1.0
19343,19343,밥통/Noun,3,0,3,2.2229632099588756e-05,5.553210866523024e-05,1.0
19344,19344,겉돈/Noun,3,0,3,2.2229632099588756e-05,5.553210866523024e-05,1.0
19345,19345,상금/Noun,3,0,3,2.2229632099588756e-05,5.553210866523024e-05,1.0
19346,19346,",.,.,.,.,./Punctuation",3,0,3,2.2229632099588756e-05,5.553210866523024e-05,1.0
19347,19347,피땀/Noun,3,0,3,2.2229632099588756e-05,5.553210866523024e-05,1.0
19348,19348,fu/Alpha,3,0,3,2.2229632099588756e-05,5.553210866523024e-05,1.0
19349,19349,자발/Noun,3,0,3,2.2229632099588756e-05,5.553210866523024e-05,1.0
19350,19350,아슬아슬/Noun,3,3,0,5.5574080248971876e-05,2.2212843466092093e-05,1.0
19351,19351,견고하다/Adjective,3,3,0,5.5574080248971876e-05,2.2212843466092093e-05,1.0
19352,19352,에스엠/Noun,3,3,0,5.5574080248971876e-05,2.2212843466092093e-05,1.0
19353,19353,업로드/Noun,3,0,3,2.2229632099588756e-05,5.553210866523024e-05,1.0
19354,19354,빠삐용/Noun,3,3,0,5.5574080248971876e-05,2.2212843466092093e-05,1.0
19355,19355,TO/Alpha,3,3,0,5.5574080248971876e-05,2.2212843466092093e-05,1.0
19356,19356,담대하다/Adjective,3,3,0,5.5574080248971876e-05,2.2212843466092093e-05,1.0
19357,19357,한수아/Noun,3,0,3,2.2229632099588756e-05,5.553210866523024e-05,1.0
19358,19358,밧데리/Noun,3,0,3,2.2229632099588756e-05,5.553210866523024e-05,1.0
19359,19359,발다/Noun,3,0,3,2.2229632099588756e-05,5.553210866523024e-05,1.0
19360,19360,후끈하다/Adjective,3,0,3,2.2229632099588756e-05,5.553210866523024e-05,1.0
19361,19361,회안/Noun,3,0,3,2.2229632099588756e-05,5.553210866523024e-05,1.0
19362,19362,부전/Noun,3,0,3,2.2229632099588756e-05,5.553210866523024e-05,1.0
19363,19363,외한/Noun,3,3,0,5.5574080248971876e-05,2.2212843466092093e-05,1.0
19364,19364,닝겐/Noun,3,3,0,5.5574080248971876e-05,2.2212843466092093e-05,1.0
19365,19365,이륙/Noun,3,0,3,2.2229632099588756e-05,5.553210866523024e-05,1.0
19366,19366,박하나/Noun,3,3,0,5.5574080248971876e-05,2.2212843466092093e-05,1.0
19367,19367,외교/Noun,3,3,0,5.5574080248971876e-05,2.2212843466092093e-05,1.0
19368,19368,자연인/Noun,3,3,0,5.5574080248971876e-05,2.2212843466092093e-05,1.0
19369,19369,뜨끔하다/Adjective,3,3,0,5.5574080248971876e-05,2.2212843466092093e-05,1.0
19370,19370,맞장구/Noun,3,0,3,2.2229632099588756e-05,5.553210866523024e-05,1.0
19371,19371,발기다/Verb,3,3,0,5.5574080248971876e-05,2.2212843466092093e-05,1.0
19372,19372,독립군/Noun,3,0,3,2.2229632099588756e-05,5.553210866523024e-05,1.0
19373,19373,대문/Noun,3,0,3,2.2229632099588756e-05,5.553210866523024e-05,1.0
19374,19374,거창/Noun,3,0,3,2.2229632099588756e-05,5.553210866523024e-05,1.0
19375,19375,켄드릭/Noun,3,3,0,5.5574080248971876e-05,2.2212843466092093e-05,1.0
19376,19376,쪼이다/Verb,3,3,0,5.5574080248971876e-05,2.2212843466092093e-05,1.0
19377,19377,고라/Noun,3,0,3,2.2229632099588756e-05,5.553210866523024e-05,1.0
19378,19378,기름값/Noun,3,0,3,2.2229632099588756e-05,5.553210866523024e-05,1.0
19379,19379,힛힛/Noun,3,0,3,2.2229632099588756e-05,5.553210866523024e-05,1.0
19380,19380,황석/Noun,3,3,0,5.5574080248971876e-05,2.2212843466092093e-05,1.0
19381,19381,째보/Noun,3,3,0,5.5574080248971876e-05,2.2212843466092093e-05,1.0
19382,19382,단세포/Noun,3,0,3,2.2229632099588756e-05,5.553210866523024e-05,1.0
19383,19383,만분/Noun,3,0,3,2.2229632099588756e-05,5.553210866523024e-05,1.0
19384,19384,에릭클랩튼/Noun,3,3,0,5.5574080248971876e-05,2.2212843466092093e-05,1.0
19385,19385,~!!!!!!!!!!/Punctuation,3,3,0,5.5574080248971876e-05,2.2212843466092093e-05,1.0
19386,19386,".,.,.,.,.,./Punctuation",3,0,3,2.2229632099588756e-05,5.553210866523024e-05,1.0
19387,19387,같/Noun,3,0,3,2.2229632099588756e-05,5.553210866523024e-05,1.0
19388,19388,큼은/Foreign,3,3,0,5.5574080248971876e-05,2.2212843466092093e-05,1.0
19389,19389,커트코베인/Noun,3,3,0,5.5574080248971876e-05,2.2212843466092093e-05,1.0
19390,19390,맨붕/Noun,3,0,3,2.2229632099588756e-05,5.553210866523024e-05,1.0
19391,19391,홍종현/Noun,3,3,0,5.5574080248971876e-05,2.2212843466092093e-05,1.0
19392,19392,선우/Noun,3,3,0,5.5574080248971876e-05,2.2212843466092093e-05,1.0
19393,19393,조유영/Noun,3,0,3,2.2229632099588756e-05,5.553210866523024e-05,1.0
19394,19394,좌편향/Noun,3,0,3,2.2229632099588756e-05,5.553210866523024e-05,1.0
19395,19395,상현/Noun,3,3,0,5.5574080248971876e-05,2.2212843466092093e-05,1.0
19396,19396,손상/Noun,3,0,3,2.2229632099588756e-05,5.553210866523024e-05,1.0
19397,19397,처넌/Noun,3,0,3,2.2229632099588756e-05,5.553210866523024e-05,1.0
19398,19398,부쵸/Noun,3,3,0,5.5574080248971876e-05,2.2212843466092093e-05,1.0
19399,19399,변치/Noun,3,3,0,5.5574080248971876e-05,2.2212843466092093e-05,1.0
19400,19400,건내다/Verb,3,3,0,5.5574080248971876e-05,2.2212843466092093e-05,1.0
19401,19401,파트라/Noun,3,3,0,5.5574080248971876e-05,2.2212843466092093e-05,1.0
19402,19402,서도영/Noun,3,3,0,5.5574080248971876e-05,2.2212843466092093e-05,1.0
19403,19403,철판/Noun,3,0,3,2.2229632099588756e-05,5.553210866523024e-05,1.0
19404,19404,안드네/Noun,3,0,3,2.2229632099588756e-05,5.553210866523024e-05,1.0
19405,19405,스파/Noun,3,0,3,2.2229632099588756e-05,5.553210866523024e-05,1.0
19406,19406,던스트/Noun,3,3,0,5.5574080248971876e-05,2.2212843466092093e-05,1.0
19407,19407,알피/Noun,3,3,0,5.5574080248971876e-05,2.2212843466092093e-05,1.0
19408,19408,델토/Noun,3,3,0,5.5574080248971876e-05,2.2212843466092093e-05,1.0
19409,19409,첨부/Noun,3,3,0,5.5574080248971876e-05,2.2212843466092093e-05,1.0
19410,19410,스윙스/Noun,3,0,3,2.2229632099588756e-05,5.553210866523024e-05,1.0
19411,19411,고추가/Noun,3,3,0,5.5574080248971876e-05,2.2212843466092093e-05,1.0
19412,19412,급상승/Noun,3,0,3,2.2229632099588756e-05,5.553210866523024e-05,1.0
19413,19413,Captain/Alpha,3,3,0,5.5574080248971876e-05,2.2212843466092093e-05,1.0
19414,19414,가랑비/Noun,3,3,0,5.5574080248971876e-05,2.2212843466092093e-05,1.0
19415,19415,급사/Noun,3,0,3,2.2229632099588756e-05,5.553210866523024e-05,1.0
19416,19416,숫처녀/Noun,3,0,3,2.2229632099588756e-05,5.553210866523024e-05,1.0
19417,19417,꽁트/Noun,3,0,3,2.2229632099588756e-05,5.553210866523024e-05,1.0
19418,19418,샴발라/Noun,3,0,3,2.2229632099588756e-05,5.553210866523024e-05,1.0
19419,19419,눈웃음/Noun,3,3,0,5.5574080248971876e-05,2.2212843466092093e-05,1.0
19420,19420,'-'/Punctuation,3,3,0,5.5574080248971876e-05,2.2212843466092093e-05,1.0
19421,19421,80억/Number,3,0,3,2.2229632099588756e-05,5.553210866523024e-05,1.0
19422,19422,1.3/Number,3,0,3,2.2229632099588756e-05,5.553210866523024e-05,1.0
19423,19423,없엇어/Noun,3,3,0,5.5574080248971876e-05,2.2212843466092093e-05,1.0
19424,19424,대한민국만세/Noun,3,3,0,5.5574080248971876e-05,2.2212843466092093e-05,1.0
19425,19425,피상/Noun,3,0,3,2.2229632099588756e-05,5.553210866523024e-05,1.0
19426,19426,서류/Noun,3,0,3,2.2229632099588756e-05,5.553210866523024e-05,1.0
19427,19427,반추/Noun,3,3,0,5.5574080248971876e-05,2.2212843466092093e-05,1.0
19428,19428,구봉서/Noun,3,3,0,5.5574080248971876e-05,2.2212843466092093e-05,1.0
19429,19429,일장기/Noun,3,0,3,2.2229632099588756e-05,5.553210866523024e-05,1.0
19430,19430,너포위/Noun,3,3,0,5.5574080248971876e-05,2.2212843466092093e-05,1.0
19431,19431,기성용/Noun,3,3,0,5.5574080248971876e-05,2.2212843466092093e-05,1.0
19432,19432,카메라감독/Noun,3,0,3,2.2229632099588756e-05,5.553210866523024e-05,1.0
19433,19433,러신/Noun,3,3,0,5.5574080248971876e-05,2.2212843466092093e-05,1.0
19434,19434,써클/Noun,3,0,3,2.2229632099588756e-05,5.553210866523024e-05,1.0
19435,19435,글러브/Noun,3,0,3,2.2229632099588756e-05,5.553210866523024e-05,1.0
19436,19436,발가벗기다/Verb,3,3,0,5.5574080248971876e-05,2.2212843466092093e-05,1.0
19437,19437,타당성/Noun,3,0,3,2.2229632099588756e-05,5.553210866523024e-05,1.0
19438,19438,뿡뿡이/Noun,3,0,3,2.2229632099588756e-05,5.553210866523024e-05,1.0
19439,19439,다가서다/Verb,3,3,0,5.5574080248971876e-05,2.2212843466092093e-05,1.0
19440,19440,호킨스/Noun,3,3,0,5.5574080248971876e-05,2.2212843466092093e-05,1.0
19441,19441,손호영/Noun,3,0,3,2.2229632099588756e-05,5.553210866523024e-05,1.0
19442,19442,살며시/Adverb,3,3,0,5.5574080248971876e-05,2.2212843466092093e-05,1.0
19443,19443,방조/Noun,3,0,3,2.2229632099588756e-05,5.553210866523024e-05,1.0
19444,19444,공모/Noun,3,0,3,2.2229632099588756e-05,5.553210866523024e-05,1.0
19445,19445,엄니/Noun,3,0,3,2.2229632099588756e-05,5.553210866523024e-05,1.0
19446,19446,김생민/Noun,3,0,3,2.2229632099588756e-05,5.553210866523024e-05,1.0
19447,19447,싸움질/Noun,3,0,3,2.2229632099588756e-05,5.553210866523024e-05,1.0
19448,19448,7~10/Number,3,0,3,2.2229632099588756e-05,5.553210866523024e-05,1.0
19449,19449,미티/Noun,3,3,0,5.5574080248971876e-05,2.2212843466092093e-05,1.0
19450,19450,avi/Alpha,3,0,3,2.2229632099588756e-05,5.553210866523024e-05,1.0
19451,19451,강신일/Noun,3,0,3,2.2229632099588756e-05,5.553210866523024e-05,1.0
19452,19452,예원/Noun,3,3,0,5.5574080248971876e-05,2.2212843466092093e-05,1.0
19453,19453,안거/Noun,3,0,3,2.2229632099588756e-05,5.553210866523024e-05,1.0
19454,19454,퍼니플래닛/Noun,3,0,3,2.2229632099588756e-05,5.553210866523024e-05,1.0
19455,19455,험악하다/Adjective,3,0,3,2.2229632099588756e-05,5.553210866523024e-05,1.0
19456,19456,취조/Noun,3,0,3,2.2229632099588756e-05,5.553210866523024e-05,1.0
19457,19457,최대로/Noun,3,0,3,2.2229632099588756e-05,5.553210866523024e-05,1.0
19458,19458,합심/Noun,3,0,3,2.2229632099588756e-05,5.553210866523024e-05,1.0
19459,19459,--../Punctuation,3,0,3,2.2229632099588756e-05,5.553210866523024e-05,1.0
19460,19460,위장결혼/Noun,3,0,3,2.2229632099588756e-05,5.553210866523024e-05,1.0
19461,19461,슬로모션/Noun,3,3,0,5.5574080248971876e-05,2.2212843466092093e-05,1.0
19462,19462,보물섬/Noun,3,3,0,5.5574080248971876e-05,2.2212843466092093e-05,1.0
19463,19463,스탄/Noun,3,0,3,2.2229632099588756e-05,5.553210866523024e-05,1.0
19464,19464,오호호/Adverb,3,3,0,5.5574080248971876e-05,2.2212843466092093e-05,1.0
19465,19465,둘러대다/Verb,3,0,3,2.2229632099588756e-05,5.553210866523024e-05,1.0
19466,19466,횡대/Noun,3,0,3,2.2229632099588756e-05,5.553210866523024e-05,1.0
19467,19467,~~!!^^/Punctuation,3,3,0,5.5574080248971876e-05,2.2212843466092093e-05,1.0
19468,19468,매국/Noun,3,0,3,2.2229632099588756e-05,5.553210866523024e-05,1.0
19469,19469,유니버스/Noun,3,3,0,5.5574080248971876e-05,2.2212843466092093e-05,1.0
19470,19470,아틀란티스/Noun,3,3,0,5.5574080248971876e-05,2.2212843466092093e-05,1.0
19471,19471,진일/Noun,3,3,0,5.5574080248971876e-05,2.2212843466092093e-05,1.0
19472,19472,그른/Noun,3,3,0,5.5574080248971876e-05,2.2212843466092093e-05,1.0
19473,19473,묶인/Noun,3,3,0,5.5574080248971876e-05,2.2212843466092093e-05,1.0
19474,19474,시피/Noun,3,0,3,2.2229632099588756e-05,5.553210866523024e-05,1.0
19475,19475,왕리홍/Noun,3,0,3,2.2229632099588756e-05,5.553210866523024e-05,1.0
19476,19476,오천원/Noun,3,0,3,2.2229632099588756e-05,5.553210866523024e-05,1.0
19477,19477,앱등이/Noun,3,0,3,2.2229632099588756e-05,5.553210866523024e-05,1.0
19478,19478,길용우/Noun,3,0,3,2.2229632099588756e-05,5.553210866523024e-05,1.0
19479,19479,7.99/Number,3,3,0,5.5574080248971876e-05,2.2212843466092093e-05,1.0
19480,19480,울진/Noun,3,3,0,5.5574080248971876e-05,2.2212843466092093e-05,1.0
19481,19481,써로게이트/Noun,3,0,3,2.2229632099588756e-05,5.553210866523024e-05,1.0
19482,19482,혼선/Noun,3,0,3,2.2229632099588756e-05,5.553210866523024e-05,1.0
19483,19483,정완/Noun,3,3,0,5.5574080248971876e-05,2.2212843466092093e-05,1.0
19484,19484,선데이/Noun,3,3,0,5.5574080248971876e-05,2.2212843466092093e-05,1.0
19485,19485,이시하라/Noun,3,0,3,2.2229632099588756e-05,5.553210866523024e-05,1.0
19486,19486,이수성/Noun,3,0,3,2.2229632099588756e-05,5.553210866523024e-05,1.0
19487,19487,선데이서울/Noun,3,0,3,2.2229632099588756e-05,5.553210866523024e-05,1.0
19488,19488,선심/Noun,3,0,3,2.2229632099588756e-05,5.553210866523024e-05,1.0
19489,19489,하이스쿨/Noun,3,3,0,5.5574080248971876e-05,2.2212843466092093e-05,1.0
19490,19490,트립/Noun,3,0,3,2.2229632099588756e-05,5.553210866523024e-05,1.0
19491,19491,뱀검/Noun,3,3,0,5.5574080248971876e-05,2.2212843466092093e-05,1.0
19492,19492,데니안/Noun,3,0,3,2.2229632099588756e-05,5.553210866523024e-05,1.0
19493,19493,신안/Noun,3,0,3,2.2229632099588756e-05,5.553210866523024e-05,1.0
19494,19494,해물/Noun,3,0,3,2.2229632099588756e-05,5.553210866523024e-05,1.0
19495,19495,호로/Noun,3,0,3,2.2229632099588756e-05,5.553210866523024e-05,1.0
19496,19496,라커/Noun,3,0,3,2.2229632099588756e-05,5.553210866523024e-05,1.0
19497,19497,회전목마/Noun,3,3,0,5.5574080248971876e-05,2.2212843466092093e-05,1.0
19498,19498,휠/Noun,3,0,3,2.2229632099588756e-05,5.553210866523024e-05,1.0
19499,19499,넘겨주다/Verb,3,0,3,2.2229632099588756e-05,5.553210866523024e-05,1.0
19500,19500,팬층/Noun,3,0,3,2.2229632099588756e-05,5.553210866523024e-05,1.0
19501,19501,맺힌다/Noun,3,3,0,5.5574080248971876e-05,2.2212843466092093e-05,1.0
19502,19502,대척점/Noun,3,0,3,2.2229632099588756e-05,5.553210866523024e-05,1.0
19503,19503,디렉터스컷/Noun,3,3,0,5.5574080248971876e-05,2.2212843466092093e-05,1.0
19504,19504,ㅠㅠㅋㅋㅋ/KoreanParticle,3,3,0,5.5574080248971876e-05,2.2212843466092093e-05,1.0
19505,19505,디올/Noun,3,3,0,5.5574080248971876e-05,2.2212843466092093e-05,1.0
19506,19506,컴버/Noun,3,3,0,5.5574080248971876e-05,2.2212843466092093e-05,1.0
19507,19507,스벤/Noun,3,3,0,5.5574080248971876e-05,2.2212843466092093e-05,1.0
19508,19508,DMB/Alpha,3,3,0,5.5574080248971876e-05,2.2212843466092093e-05,1.0
19509,19509,심벌/Noun,3,0,3,2.2229632099588756e-05,5.553210866523024e-05,1.0
19510,19510,김지석/Noun,3,3,0,5.5574080248971876e-05,2.2212843466092093e-05,1.0
19511,19511,마르퀴스/Noun,3,3,0,5.5574080248971876e-05,2.2212843466092093e-05,1.0
19512,19512,봉합/Noun,3,0,3,2.2229632099588756e-05,5.553210866523024e-05,1.0
19513,19513,.....^^/Punctuation,3,3,0,5.5574080248971876e-05,2.2212843466092093e-05,1.0
19514,19514,문명인/Noun,3,3,0,5.5574080248971876e-05,2.2212843466092093e-05,1.0
19515,19515,순애/Noun,3,0,3,2.2229632099588756e-05,5.553210866523024e-05,1.0
19516,19516,불씨/Noun,3,3,0,5.5574080248971876e-05,2.2212843466092093e-05,1.0
19517,19517,윤개상/Noun,3,0,3,2.2229632099588756e-05,5.553210866523024e-05,1.0
19518,19518,플러/Noun,3,3,0,5.5574080248971876e-05,2.2212843466092093e-05,1.0
19519,19519,그랫음/Noun,3,0,3,2.2229632099588756e-05,5.553210866523024e-05,1.0
19520,19520,무후/Noun,3,0,3,2.2229632099588756e-05,5.553210866523024e-05,1.0
19521,19521,김운경/Noun,3,3,0,5.5574080248971876e-05,2.2212843466092093e-05,1.0
19522,19522,Beautiful/Alpha,3,3,0,5.5574080248971876e-05,2.2212843466092093e-05,1.0
19523,19523,단신/Noun,3,0,3,2.2229632099588756e-05,5.553210866523024e-05,1.0
19524,19524,윤혜영/Noun,3,0,3,2.2229632099588756e-05,5.553210866523024e-05,1.0
19525,19525,산산/Noun,3,0,3,2.2229632099588756e-05,5.553210866523024e-05,1.0
19526,19526,용이하다/Adjective,3,3,0,5.5574080248971876e-05,2.2212843466092093e-05,1.0
19527,19527,일산/Noun,3,0,3,2.2229632099588756e-05,5.553210866523024e-05,1.0
19528,19528,횟집/Noun,3,0,3,2.2229632099588756e-05,5.553210866523024e-05,1.0
19529,19529,나가이/Noun,3,0,3,2.2229632099588756e-05,5.553210866523024e-05,1.0
19530,19530,이소리/Noun,3,0,3,2.2229632099588756e-05,5.553210866523024e-05,1.0
19531,19531,못생겻/Noun,3,0,3,2.2229632099588756e-05,5.553210866523024e-05,1.0
19532,19532,베리드/Noun,3,0,3,2.2229632099588756e-05,5.553210866523024e-05,1.0
19533,19533,포청천/Noun,3,0,3,2.2229632099588756e-05,5.553210866523024e-05,1.0
19534,19534,쁘/Noun,3,3,0,5.5574080248971876e-05,2.2212843466092093e-05,1.0
19535,19535,FF/Alpha,3,0,3,2.2229632099588756e-05,5.553210866523024e-05,1.0
19536,19536,유후/Noun,3,3,0,5.5574080248971876e-05,2.2212843466092093e-05,1.0
19537,19537,신입생/Noun,3,0,3,2.2229632099588756e-05,5.553210866523024e-05,1.0
19538,19538,대폭발/Noun,3,0,3,2.2229632099588756e-05,5.553210866523024e-05,1.0
19539,19539,...~/Punctuation,3,0,3,2.2229632099588756e-05,5.553210866523024e-05,1.0
19540,19540,무혁/Noun,3,3,0,5.5574080248971876e-05,2.2212843466092093e-05,1.0
19541,19541,콘티/Noun,3,0,3,2.2229632099588756e-05,5.553210866523024e-05,1.0
19542,19542,-*/Punctuation,3,3,0,5.5574080248971876e-05,2.2212843466092093e-05,1.0
19543,19543,대동단결/Noun,3,0,3,2.2229632099588756e-05,5.553210866523024e-05,1.0
19544,19544,실타/Noun,3,0,3,2.2229632099588756e-05,5.553210866523024e-05,1.0
19545,19545,흐믓해/Noun,3,3,0,5.5574080248971876e-05,2.2212843466092093e-05,1.0
19546,19546,미칀/Noun,3,0,3,2.2229632099588756e-05,5.553210866523024e-05,1.0
19547,19547,화형식/Noun,3,3,0,5.5574080248971876e-05,2.2212843466092093e-05,1.0
19548,19548,레게/Noun,3,0,3,2.2229632099588756e-05,5.553210866523024e-05,1.0
19549,19549,논점/Noun,3,0,3,2.2229632099588756e-05,5.553210866523024e-05,1.0
19550,19550,세원/Noun,3,0,3,2.2229632099588756e-05,5.553210866523024e-05,1.0
19551,19551,꽁꽁/Noun,3,0,3,2.2229632099588756e-05,5.553210866523024e-05,1.0
19552,19552,열병/Noun,3,3,0,5.5574080248971876e-05,2.2212843466092093e-05,1.0
19553,19553,한길/Noun,3,3,0,5.5574080248971876e-05,2.2212843466092093e-05,1.0
19554,19554,wrong/Alpha,3,3,0,5.5574080248971876e-05,2.2212843466092093e-05,1.0
19555,19555,영화리뷰/Noun,3,0,3,2.2229632099588756e-05,5.553210866523024e-05,1.0
19556,19556,능글능글하다/Adjective,3,3,0,5.5574080248971876e-05,2.2212843466092093e-05,1.0
19557,19557,갈림길/Noun,3,3,0,5.5574080248971876e-05,2.2212843466092093e-05,1.0
19558,19558,독불장군/Noun,3,3,0,5.5574080248971876e-05,2.2212843466092093e-05,1.0
19559,19559,가압/Noun,3,3,0,5.5574080248971876e-05,2.2212843466092093e-05,1.0
19560,19560,본방송/Noun,3,0,3,2.2229632099588756e-05,5.553210866523024e-05,1.0
19561,19561,동구/Noun,3,3,0,5.5574080248971876e-05,2.2212843466092093e-05,1.0
19562,19562,동그랗다/Adjective,3,0,3,2.2229632099588756e-05,5.553210866523024e-05,1.0
19563,19563,강화/Noun,3,3,0,5.5574080248971876e-05,2.2212843466092093e-05,1.0
19564,19564,돈까스/Noun,3,0,3,2.2229632099588756e-05,5.553210866523024e-05,1.0
19565,19565,심난하다/Adjective,3,0,3,2.2229632099588756e-05,5.553210866523024e-05,1.0
19566,19566,앙증맞다/Adjective,3,3,0,5.5574080248971876e-05,2.2212843466092093e-05,1.0
19567,19567,쿠시/Noun,3,3,0,5.5574080248971876e-05,2.2212843466092093e-05,1.0
19568,19568,3.6/Number,3,0,3,2.2229632099588756e-05,5.553210866523024e-05,1.0
19569,19569,컨벤션/Noun,3,0,3,2.2229632099588756e-05,5.553210866523024e-05,1.0
19570,19570,카르페디엠/Noun,3,3,0,5.5574080248971876e-05,2.2212843466092093e-05,1.0
19571,19571,에타/Noun,3,3,0,5.5574080248971876e-05,2.2212843466092093e-05,1.0
19572,19572,길리엄/Noun,3,3,0,5.5574080248971876e-05,2.2212843466092093e-05,1.0
19573,19573,앵앵대다/Verb,3,0,3,2.2229632099588756e-05,5.553210866523024e-05,1.0
19574,19574,잠적/Noun,3,0,3,2.2229632099588756e-05,5.553210866523024e-05,1.0
19575,19575,빵구/Noun,3,0,3,2.2229632099588756e-05,5.553210866523024e-05,1.0
19576,19576,능멸/Noun,3,0,3,2.2229632099588756e-05,5.553210866523024e-05,1.0
19577,19577,평양/Noun,3,3,0,5.5574080248971876e-05,2.2212843466092093e-05,1.0
19578,19578,==/Punctuation,3,0,3,2.2229632099588756e-05,5.553210866523024e-05,1.0
19579,19579,오합지졸/Noun,3,0,3,2.2229632099588756e-05,5.553210866523024e-05,1.0
19580,19580,에스텔/Noun,3,0,3,2.2229632099588756e-05,5.553210866523024e-05,1.0
19581,19581,사돈/Noun,3,0,3,2.2229632099588756e-05,5.553210866523024e-05,1.0
19582,19582,플스/Noun,3,3,0,5.5574080248971876e-05,2.2212843466092093e-05,1.0
19583,19583,shall/Alpha,3,3,0,5.5574080248971876e-05,2.2212843466092093e-05,1.0
19584,19584,남남/Noun,3,0,3,2.2229632099588756e-05,5.553210866523024e-05,1.0
19585,19585,어두컴컴하다/Adjective,3,3,0,5.5574080248971876e-05,2.2212843466092093e-05,1.0
19586,19586,스산/Noun,3,3,0,5.5574080248971876e-05,2.2212843466092093e-05,1.0
19587,19587,헨/Noun,3,3,0,5.5574080248971876e-05,2.2212843466092093e-05,1.0
19588,19588,효녀/Noun,3,3,0,5.5574080248971876e-05,2.2212843466092093e-05,1.0
19589,19589,조병/Noun,3,3,0,5.5574080248971876e-05,2.2212843466092093e-05,1.0
19590,19590,*^/Punctuation,3,3,0,5.5574080248971876e-05,2.2212843466092093e-05,1.0
19591,19591,2008/Number,3,3,0,5.5574080248971876e-05,2.2212843466092093e-05,1.0
19592,19592,리얼리/Noun,3,3,0,5.5574080248971876e-05,2.2212843466092093e-05,1.0
19593,19593,머릿/Noun,3,3,0,5.5574080248971876e-05,2.2212843466092093e-05,1.0
19594,19594,짜개/Noun,3,3,0,5.5574080248971876e-05,2.2212843466092093e-05,1.0
19595,19595,핍박/Noun,3,3,0,5.5574080248971876e-05,2.2212843466092093e-05,1.0
19596,19596,세요/Eomi,3,0,3,2.2229632099588756e-05,5.553210866523024e-05,1.0
19597,19597,디아블로/Noun,3,0,3,2.2229632099588756e-05,5.553210866523024e-05,1.0
19598,19598,조센진/Noun,3,0,3,2.2229632099588756e-05,5.553210866523024e-05,1.0
19599,19599,채찍/Noun,3,0,3,2.2229632099588756e-05,5.553210866523024e-05,1.0
19600,19600,.*^^*/Punctuation,3,3,0,5.5574080248971876e-05,2.2212843466092093e-05,1.0
19601,19601,호주머니/Noun,3,0,3,2.2229632099588756e-05,5.553210866523024e-05,1.0
19602,19602,ㅎㅋ/KoreanParticle,3,3,0,5.5574080248971876e-05,2.2212843466092093e-05,1.0
19603,19603,얼치기/Noun,3,0,3,2.2229632099588756e-05,5.553210866523024e-05,1.0
19604,19604,박초롱/Noun,3,3,0,5.5574080248971876e-05,2.2212843466092093e-05,1.0
19605,19605,lovely/Alpha,3,3,0,5.5574080248971876e-05,2.2212843466092093e-05,1.0
19606,19606,0.01/Number,3,0,3,2.2229632099588756e-05,5.553210866523024e-05,1.0
19607,19607,객실/Noun,3,0,3,2.2229632099588756e-05,5.553210866523024e-05,1.0
19608,19608,무치/Noun,3,0,3,2.2229632099588756e-05,5.553210866523024e-05,1.0
19609,19609,요지/Noun,3,0,3,2.2229632099588756e-05,5.553210866523024e-05,1.0
19610,19610,원어민/Noun,3,3,0,5.5574080248971876e-05,2.2212843466092093e-05,1.0
19611,19611,븅/Noun,3,0,3,2.2229632099588756e-05,5.553210866523024e-05,1.0
19612,19612,:))/Punctuation,3,3,0,5.5574080248971876e-05,2.2212843466092093e-05,1.0
19613,19613,이라도/Foreign,3,0,3,2.2229632099588756e-05,5.553210866523024e-05,1.0
19614,19614,부처님/Noun,3,3,0,5.5574080248971876e-05,2.2212843466092093e-05,1.0
19615,19615,도화지/Noun,3,3,0,5.5574080248971876e-05,2.2212843466092093e-05,1.0
19616,19616,재생산/Noun,3,0,3,2.2229632099588756e-05,5.553210866523024e-05,1.0
19617,19617,~~./Punctuation,3,3,0,5.5574080248971876e-05,2.2212843466092093e-05,1.0
19618,19618,응축/Noun,3,3,0,5.5574080248971876e-05,2.2212843466092093e-05,1.0
19619,19619,Amazing/Alpha,3,3,0,5.5574080248971876e-05,2.2212843466092093e-05,1.0
19620,19620,뿌리치다/Verb,3,0,3,2.2229632099588756e-05,5.553210866523024e-05,1.0
19621,19621,뱀파/Noun,3,0,3,2.2229632099588756e-05,5.553210866523024e-05,1.0
19622,19622,내/VerbPrefix,3,3,0,5.5574080248971876e-05,2.2212843466092093e-05,1.0
19623,19623,허슬/Noun,3,0,3,2.2229632099588756e-05,5.553210866523024e-05,1.0
19624,19624,cry/Alpha,3,3,0,5.5574080248971876e-05,2.2212843466092093e-05,1.0
19625,19625,윤곽/Noun,3,0,3,2.2229632099588756e-05,5.553210866523024e-05,1.0
19626,19626,재밍/Noun,3,3,0,5.5574080248971876e-05,2.2212843466092093e-05,1.0
19627,19627,혜성/Noun,3,3,0,5.5574080248971876e-05,2.2212843466092093e-05,1.0
19628,19628,사사롭다/Adjective,3,3,0,5.5574080248971876e-05,2.2212843466092093e-05,1.0
19629,19629,남태현/Noun,3,0,3,2.2229632099588756e-05,5.553210866523024e-05,1.0
19630,19630,가리키다/Verb,3,3,0,5.5574080248971876e-05,2.2212843466092093e-05,1.0
19631,19631,나랏돈/Noun,3,0,3,2.2229632099588756e-05,5.553210866523024e-05,1.0
19632,19632,댄싱나인/Noun,3,0,3,2.2229632099588756e-05,5.553210866523024e-05,1.0
19633,19633,지갠뎃/Noun,3,0,3,2.2229632099588756e-05,5.553210866523024e-05,1.0
19634,19634,찬스/Noun,3,3,0,5.5574080248971876e-05,2.2212843466092093e-05,1.0
19635,19635,최은/Noun,3,0,3,2.2229632099588756e-05,5.553210866523024e-05,1.0
19636,19636,고명환/Noun,3,0,3,2.2229632099588756e-05,5.553210866523024e-05,1.0
19637,19637,연속성/Noun,3,0,3,2.2229632099588756e-05,5.553210866523024e-05,1.0
19638,19638,요부/Noun,3,0,3,2.2229632099588756e-05,5.553210866523024e-05,1.0
19639,19639,중에/Foreign,3,0,3,2.2229632099588756e-05,5.553210866523024e-05,1.0
19640,19640,시진/Noun,3,3,0,5.5574080248971876e-05,2.2212843466092093e-05,1.0
19641,19641,"-.,-/Punctuation",3,0,3,2.2229632099588756e-05,5.553210866523024e-05,1.0
19642,19642,태백산맥/Noun,3,0,3,2.2229632099588756e-05,5.553210866523024e-05,1.0
19643,19643,아라시/Noun,3,3,0,5.5574080248971876e-05,2.2212843466092093e-05,1.0
19644,19644,어쨌/Noun,3,0,3,2.2229632099588756e-05,5.553210866523024e-05,1.0
19645,19645,얼개/Noun,3,0,3,2.2229632099588756e-05,5.553210866523024e-05,1.0
19646,19646,쌩쑈/Noun,3,0,3,2.2229632099588756e-05,5.553210866523024e-05,1.0
19647,19647,총장/Noun,3,3,0,5.5574080248971876e-05,2.2212843466092093e-05,1.0
19648,19648,우웅/Exclamation,3,3,0,5.5574080248971876e-05,2.2212843466092093e-05,1.0
19649,19649,자격증/Noun,3,0,3,2.2229632099588756e-05,5.553210866523024e-05,1.0
19650,19650,동현/Noun,3,3,0,5.5574080248971876e-05,2.2212843466092093e-05,1.0
19651,19651,식자/Noun,3,0,3,2.2229632099588756e-05,5.553210866523024e-05,1.0
19652,19652,결혼식장/Noun,3,0,3,2.2229632099588756e-05,5.553210866523024e-05,1.0
19653,19653,일별/Noun,3,0,3,2.2229632099588756e-05,5.553210866523024e-05,1.0
19654,19654,66/Number,3,3,0,5.5574080248971876e-05,2.2212843466092093e-05,1.0
19655,19655,Say/Alpha,3,3,0,5.5574080248971876e-05,2.2212843466092093e-05,1.0
19656,19656,had/Alpha,3,3,0,5.5574080248971876e-05,2.2212843466092093e-05,1.0
19657,19657,완구/Noun,3,0,3,2.2229632099588756e-05,5.553210866523024e-05,1.0
19658,19658,마물/Noun,3,0,3,2.2229632099588756e-05,5.553210866523024e-05,1.0
19659,19659,￣∇￣/Foreign,3,3,0,5.5574080248971876e-05,2.2212843466092093e-05,1.0
19660,19660,튼실하다/Adjective,3,0,3,2.2229632099588756e-05,5.553210866523024e-05,1.0
19661,19661,이윤기/Noun,3,3,0,5.5574080248971876e-05,2.2212843466092093e-05,1.0
19662,19662,워프/Noun,3,0,3,2.2229632099588756e-05,5.553210866523024e-05,1.0
19663,19663,쓴웃음/Noun,3,0,3,2.2229632099588756e-05,5.553210866523024e-05,1.0
19664,19664,fighting/Alpha,3,3,0,5.5574080248971876e-05,2.2212843466092093e-05,1.0
19665,19665,음부/Noun,3,3,0,5.5574080248971876e-05,2.2212843466092093e-05,1.0
19666,19666,데이빗보위/Noun,3,3,0,5.5574080248971876e-05,2.2212843466092093e-05,1.0
19667,19667,칸영화제/Noun,3,3,0,5.5574080248971876e-05,2.2212843466092093e-05,1.0
19668,19668,옷차림/Noun,3,0,3,2.2229632099588756e-05,5.553210866523024e-05,1.0
19669,19669,결의/Noun,3,3,0,5.5574080248971876e-05,2.2212843466092093e-05,1.0
19670,19670,특별판/Noun,3,3,0,5.5574080248971876e-05,2.2212843466092093e-05,1.0
19671,19671,건쥐/Noun,3,0,3,2.2229632099588756e-05,5.553210866523024e-05,1.0
19672,19672,배심원/Noun,3,3,0,5.5574080248971876e-05,2.2212843466092093e-05,1.0
19673,19673,간문제/Noun,3,0,3,2.2229632099588756e-05,5.553210866523024e-05,1.0
19674,19674,군필/Noun,3,0,3,2.2229632099588756e-05,5.553210866523024e-05,1.0
19675,19675,아둔하다/Adjective,3,0,3,2.2229632099588756e-05,5.553210866523024e-05,1.0
19676,19676,행선/Noun,3,0,3,2.2229632099588756e-05,5.553210866523024e-05,1.0
19677,19677,면제/Noun,3,0,3,2.2229632099588756e-05,5.553210866523024e-05,1.0
19678,19678,목줄/Noun,3,0,3,2.2229632099588756e-05,5.553210866523024e-05,1.0
19679,19679,무량/Noun,3,3,0,5.5574080248971876e-05,2.2212843466092093e-05,1.0
19680,19680,성내다/Verb,3,0,3,2.2229632099588756e-05,5.553210866523024e-05,1.0
19681,19681,후에도/Foreign,3,3,0,5.5574080248971876e-05,2.2212843466092093e-05,1.0
19682,19682,환도/Noun,3,3,0,5.5574080248971876e-05,2.2212843466092093e-05,1.0
19683,19683,두리반/Noun,3,3,0,5.5574080248971876e-05,2.2212843466092093e-05,1.0
19684,19684,이만/Adverb,3,0,3,2.2229632099588756e-05,5.553210866523024e-05,1.0
19685,19685,뭐좀/Noun,3,0,3,2.2229632099588756e-05,5.553210866523024e-05,1.0
19686,19686,민수/Noun,3,0,3,2.2229632099588756e-05,5.553210866523024e-05,1.0
19687,19687,키노/Noun,3,3,0,5.5574080248971876e-05,2.2212843466092093e-05,1.0
19688,19688,gv/Alpha,3,3,0,5.5574080248971876e-05,2.2212843466092093e-05,1.0
19689,19689,꽈/Noun,3,0,3,2.2229632099588756e-05,5.553210866523024e-05,1.0
19690,19690,gp/Alpha,3,0,3,2.2229632099588756e-05,5.553210866523024e-05,1.0
19691,19691,떼쓰다/Verb,3,0,3,2.2229632099588756e-05,5.553210866523024e-05,1.0
19692,19692,93분/Number,3,0,3,2.2229632099588756e-05,5.553210866523024e-05,1.0
19693,19693,개런티/Noun,3,0,3,2.2229632099588756e-05,5.553210866523024e-05,1.0
19694,19694,말썽/Noun,3,3,0,5.5574080248971876e-05,2.2212843466092093e-05,1.0
19695,19695,넌더리/Noun,3,0,3,2.2229632099588756e-05,5.553210866523024e-05,1.0
19696,19696,웬일/Noun,3,0,3,2.2229632099588756e-05,5.553210866523024e-05,1.0
19697,19697,그랫다/Noun,3,0,3,2.2229632099588756e-05,5.553210866523024e-05,1.0
19698,19698,미르/Noun,3,3,0,5.5574080248971876e-05,2.2212843466092093e-05,1.0
19699,19699,정성껏/Noun,3,3,0,5.5574080248971876e-05,2.2212843466092093e-05,1.0
19700,19700,낚인듯/Noun,3,0,3,2.2229632099588756e-05,5.553210866523024e-05,1.0
19701,19701,시누이/Noun,3,0,3,2.2229632099588756e-05,5.553210866523024e-05,1.0
19702,19702,돈줄/Noun,3,0,3,2.2229632099588756e-05,5.553210866523024e-05,1.0
19703,19703,짊어지/Noun,3,3,0,5.5574080248971876e-05,2.2212843466092093e-05,1.0
19704,19704,이은우/Noun,3,3,0,5.5574080248971876e-05,2.2212843466092093e-05,1.0
19705,19705,봄비/Noun,3,3,0,5.5574080248971876e-05,2.2212843466092093e-05,1.0
19706,19706,인민재판/Noun,3,0,3,2.2229632099588756e-05,5.553210866523024e-05,1.0
19707,19707,북경/Noun,3,3,0,5.5574080248971876e-05,2.2212843466092093e-05,1.0
19708,19708,불만제로/Noun,3,0,3,2.2229632099588756e-05,5.553210866523024e-05,1.0
19709,19709,물탄/Noun,3,0,3,2.2229632099588756e-05,5.553210866523024e-05,1.0
19710,19710,....;;;;/Punctuation,3,0,3,2.2229632099588756e-05,5.553210866523024e-05,1.0
19711,19711,잿빛/Noun,3,3,0,5.5574080248971876e-05,2.2212843466092093e-05,1.0
19712,19712,김유신/Noun,3,0,3,2.2229632099588756e-05,5.553210866523024e-05,1.0
19713,19713,자그마하다/Adjective,3,3,0,5.5574080248971876e-05,2.2212843466092093e-05,1.0
19714,19714,텨/Noun,3,0,3,2.2229632099588756e-05,5.553210866523024e-05,1.0
19715,19715,로마군/Noun,3,0,3,2.2229632099588756e-05,5.553210866523024e-05,1.0
19716,19716,트레이드/Noun,3,0,3,2.2229632099588756e-05,5.553210866523024e-05,1.0
19717,19717,DJ/Alpha,3,0,3,2.2229632099588756e-05,5.553210866523024e-05,1.0
19718,19718,갸우뚱/Adverb,3,0,3,2.2229632099588756e-05,5.553210866523024e-05,1.0
19719,19719,장임/Noun,3,0,3,2.2229632099588756e-05,5.553210866523024e-05,1.0
19720,19720,평정하다/Adjective,3,3,0,5.5574080248971876e-05,2.2212843466092093e-05,1.0
19721,19721,어쩌란거/Noun,3,0,3,2.2229632099588756e-05,5.553210866523024e-05,1.0
19722,19722,요로/Noun,3,0,3,2.2229632099588756e-05,5.553210866523024e-05,1.0
19723,19723,랜스/Noun,3,3,0,5.5574080248971876e-05,2.2212843466092093e-05,1.0
19724,19724,특허/Noun,3,0,3,2.2229632099588756e-05,5.553210866523024e-05,1.0
19725,19725,game/Alpha,3,3,0,5.5574080248971876e-05,2.2212843466092093e-05,1.0
19726,19726,킹오브/Noun,3,0,3,2.2229632099588756e-05,5.553210866523024e-05,1.0
19727,19727,스페이시/Noun,3,3,0,5.5574080248971876e-05,2.2212843466092093e-05,1.0
19728,19728,글타/Noun,3,0,3,2.2229632099588756e-05,5.553210866523024e-05,1.0
19729,19729,90회/Number,3,0,3,2.2229632099588756e-05,5.553210866523024e-05,1.0
19730,19730,팩스/Noun,3,3,0,5.5574080248971876e-05,2.2212843466092093e-05,1.0
19731,19731,반반하다/Adjective,3,0,3,2.2229632099588756e-05,5.553210866523024e-05,1.0
19732,19732,최지연/Noun,3,0,3,2.2229632099588756e-05,5.553210866523024e-05,1.0
19733,19733,삼합회/Noun,3,0,3,2.2229632099588756e-05,5.553210866523024e-05,1.0
19734,19734,본론/Noun,3,0,3,2.2229632099588756e-05,5.553210866523024e-05,1.0
19735,19735,올리브/Noun,3,3,0,5.5574080248971876e-05,2.2212843466092093e-05,1.0
19736,19736,끌벅쩍/Noun,3,0,3,2.2229632099588756e-05,5.553210866523024e-05,1.0
19737,19737,승복/Noun,3,0,3,2.2229632099588756e-05,5.553210866523024e-05,1.0
19738,19738,깨금이/Noun,3,3,0,5.5574080248971876e-05,2.2212843466092093e-05,1.0
19739,19739,고분/Noun,3,0,3,2.2229632099588756e-05,5.553210866523024e-05,1.0
19740,19740,븜/Noun,3,0,3,2.2229632099588756e-05,5.553210866523024e-05,1.0
19741,19741,개황/Noun,3,0,3,2.2229632099588756e-05,5.553210866523024e-05,1.0
19742,19742,유별나다/Adjective,3,0,3,2.2229632099588756e-05,5.553210866523024e-05,1.0
19743,19743,똘똘하/Noun,3,3,0,5.5574080248971876e-05,2.2212843466092093e-05,1.0
19744,19744,OK/Alpha,3,0,3,2.2229632099588756e-05,5.553210866523024e-05,1.0
19745,19745,모되/Noun,3,0,3,2.2229632099588756e-05,5.553210866523024e-05,1.0
19746,19746,방탄/Noun,3,0,3,2.2229632099588756e-05,5.553210866523024e-05,1.0
19747,19747,만리/Noun,3,0,3,2.2229632099588756e-05,5.553210866523024e-05,1.0
19748,19748,클라크/Noun,3,3,0,5.5574080248971876e-05,2.2212843466092093e-05,1.0
19749,19749,7천원/Number,3,0,3,2.2229632099588756e-05,5.553210866523024e-05,1.0
19750,19750,반세기/Noun,3,3,0,5.5574080248971876e-05,2.2212843466092093e-05,1.0
19751,19751,사원/Noun,3,3,0,5.5574080248971876e-05,2.2212843466092093e-05,1.0
19752,19752,소울메이트/Noun,3,3,0,5.5574080248971876e-05,2.2212843466092093e-05,1.0
19753,19753,썸씽/Noun,3,0,3,2.2229632099588756e-05,5.553210866523024e-05,1.0
19754,19754,북쪽/Noun,3,3,0,5.5574080248971876e-05,2.2212843466092093e-05,1.0
19755,19755,조짐/Noun,3,0,3,2.2229632099588756e-05,5.553210866523024e-05,1.0
19756,19756,주스/Noun,3,0,3,2.2229632099588756e-05,5.553210866523024e-05,1.0
19757,19757,폴뉴먼/Noun,3,3,0,5.5574080248971876e-05,2.2212843466092093e-05,1.0
19758,19758,쿄애니/Noun,3,3,0,5.5574080248971876e-05,2.2212843466092093e-05,1.0
19759,19759,저녁식사/Noun,3,3,0,5.5574080248971876e-05,2.2212843466092093e-05,1.0
19760,19760,mm/Alpha,3,0,3,2.2229632099588756e-05,5.553210866523024e-05,1.0
19761,19761,굿잼/Noun,3,3,0,5.5574080248971876e-05,2.2212843466092093e-05,1.0
19762,19762,괜차늠/Noun,3,3,0,5.5574080248971876e-05,2.2212843466092093e-05,1.0
19763,19763,묵고/Noun,3,0,3,2.2229632099588756e-05,5.553210866523024e-05,1.0
19764,19764,지음/Noun,3,3,0,5.5574080248971876e-05,2.2212843466092093e-05,1.0
19765,19765,음료수/Noun,3,0,3,2.2229632099588756e-05,5.553210866523024e-05,1.0
19766,19766,절봉/Noun,3,3,0,5.5574080248971876e-05,2.2212843466092093e-05,1.0
19767,19767,유연/Noun,3,3,0,5.5574080248971876e-05,2.2212843466092093e-05,1.0
19768,19768,데체/Noun,3,0,3,2.2229632099588756e-05,5.553210866523024e-05,1.0
19769,19769,티슈/Noun,3,3,0,5.5574080248971876e-05,2.2212843466092093e-05,1.0
19770,19770,크보/Noun,3,3,0,5.5574080248971876e-05,2.2212843466092093e-05,1.0
19771,19771,spin/Alpha,3,0,3,2.2229632099588756e-05,5.553210866523024e-05,1.0
19772,19772,주먹밥/Noun,3,3,0,5.5574080248971876e-05,2.2212843466092093e-05,1.0
19773,19773,자자하다/Adjective,3,0,3,2.2229632099588756e-05,5.553210866523024e-05,1.0
19774,19774,1800원/Number,3,0,3,2.2229632099588756e-05,5.553210866523024e-05,1.0
19775,19775,Worst/Alpha,3,0,3,2.2229632099588756e-05,5.553210866523024e-05,1.0
19776,19776,방랑/Noun,3,3,0,5.5574080248971876e-05,2.2212843466092093e-05,1.0
19777,19777,닥본사/Noun,3,3,0,5.5574080248971876e-05,2.2212843466092093e-05,1.0
19778,19778,아메바/Noun,3,0,3,2.2229632099588756e-05,5.553210866523024e-05,1.0
19779,19779,애달프다/Adjective,3,3,0,5.5574080248971876e-05,2.2212843466092093e-05,1.0
19780,19780,드랍/Noun,3,0,3,2.2229632099588756e-05,5.553210866523024e-05,1.0
19781,19781,마사토/Noun,3,3,0,5.5574080248971876e-05,2.2212843466092093e-05,1.0
19782,19782,사카이/Noun,3,3,0,5.5574080248971876e-05,2.2212843466092093e-05,1.0
19783,19783,유착/Noun,3,3,0,5.5574080248971876e-05,2.2212843466092093e-05,1.0
19784,19784,흉측하다/Adjective,3,0,3,2.2229632099588756e-05,5.553210866523024e-05,1.0
19785,19785,ㅠㅋ/KoreanParticle,3,3,0,5.5574080248971876e-05,2.2212843466092093e-05,1.0
19786,19786,문메이슨/Noun,3,3,0,5.5574080248971876e-05,2.2212843466092093e-05,1.0
19787,19787,?-/Punctuation,3,0,3,2.2229632099588756e-05,5.553210866523024e-05,1.0
19788,19788,주절거리다/Verb,3,0,3,2.2229632099588756e-05,5.553210866523024e-05,1.0
19789,19789,전영화라니/Foreign,3,3,0,5.5574080248971876e-05,2.2212843466092093e-05,1.0
19790,19790,반비례/Noun,3,0,3,2.2229632099588756e-05,5.553210866523024e-05,1.0
19791,19791,쯩/Noun,3,0,3,2.2229632099588756e-05,5.553210866523024e-05,1.0
19792,19792,연구원/Noun,3,0,3,2.2229632099588756e-05,5.553210866523024e-05,1.0
19793,19793,나인뮤지스/Noun,3,3,0,5.5574080248971876e-05,2.2212843466092093e-05,1.0
19794,19794,질라/Noun,3,3,0,5.5574080248971876e-05,2.2212843466092093e-05,1.0
19795,19795,리타/Noun,3,3,0,5.5574080248971876e-05,2.2212843466092093e-05,1.0
19796,19796,임진/Noun,3,0,3,2.2229632099588756e-05,5.553210866523024e-05,1.0
19797,19797,사병/Noun,3,0,3,2.2229632099588756e-05,5.553210866523024e-05,1.0
19798,19798,위급하다/Adjective,3,0,3,2.2229632099588756e-05,5.553210866523024e-05,1.0
19799,19799,스무/Noun,3,3,0,5.5574080248971876e-05,2.2212843466092093e-05,1.0
19800,19800,부르주아/Noun,3,0,3,2.2229632099588756e-05,5.553210866523024e-05,1.0
19801,19801,최종회/Noun,3,3,0,5.5574080248971876e-05,2.2212843466092093e-05,1.0
19802,19802,가비지/Noun,3,0,3,2.2229632099588756e-05,5.553210866523024e-05,1.0
19803,19803,부터도/Josa,3,3,0,5.5574080248971876e-05,2.2212843466092093e-05,1.0
19804,19804,극악하다/Adjective,3,3,0,5.5574080248971876e-05,2.2212843466092093e-05,1.0
19805,19805,미스테리물/Noun,3,3,0,5.5574080248971876e-05,2.2212843466092093e-05,1.0
19806,19806,유인촌/Noun,3,0,3,2.2229632099588756e-05,5.553210866523024e-05,1.0
19807,19807,법조인/Noun,3,3,0,5.5574080248971876e-05,2.2212843466092093e-05,1.0
19808,19808,근절/Noun,3,0,3,2.2229632099588756e-05,5.553210866523024e-05,1.0
19809,19809,빠담빠담/Noun,3,3,0,5.5574080248971876e-05,2.2212843466092093e-05,1.0
19810,19810,오물/Noun,3,0,3,2.2229632099588756e-05,5.553210866523024e-05,1.0
19811,19811,끌뻔/Noun,3,0,3,2.2229632099588756e-05,5.553210866523024e-05,1.0
19812,19812,넼/Noun,3,0,3,2.2229632099588756e-05,5.553210866523024e-05,1.0
19813,19813,꼬우/Noun,3,0,3,2.2229632099588756e-05,5.553210866523024e-05,1.0
19814,19814,기호/Noun,3,3,0,5.5574080248971876e-05,2.2212843466092093e-05,1.0
19815,19815,완벽주의자/Noun,3,3,0,5.5574080248971876e-05,2.2212843466092093e-05,1.0
19816,19816,양현석/Noun,3,0,3,2.2229632099588756e-05,5.553210866523024e-05,1.0
19817,19817,날조하다/Adjective,3,0,3,2.2229632099588756e-05,5.553210866523024e-05,1.0
19818,19818,벡실/Noun,3,3,0,5.5574080248971876e-05,2.2212843466092093e-05,1.0
19819,19819,..................................................../Punctuation,3,0,3,2.2229632099588756e-05,5.553210866523024e-05,1.0
19820,19820,검둥이/Noun,3,0,3,2.2229632099588756e-05,5.553210866523024e-05,1.0
19821,19821,또볼/Noun,3,3,0,5.5574080248971876e-05,2.2212843466092093e-05,1.0
19822,19822,더원/Noun,3,3,0,5.5574080248971876e-05,2.2212843466092093e-05,1.0
19823,19823,퐝당/Noun,3,0,3,2.2229632099588756e-05,5.553210866523024e-05,1.0
19824,19824,자석/Noun,3,0,3,2.2229632099588756e-05,5.553210866523024e-05,1.0
19825,19825,극심하다/Adjective,3,0,3,2.2229632099588756e-05,5.553210866523024e-05,1.0
19826,19826,박지르다/Verb,3,0,3,2.2229632099588756e-05,5.553210866523024e-05,1.0
19827,19827,1700만/Number,3,0,3,2.2229632099588756e-05,5.553210866523024e-05,1.0
19828,19828,표절의혹/Noun,3,0,3,2.2229632099588756e-05,5.553210866523024e-05,1.0
19829,19829,알콜중독자/Noun,3,3,0,5.5574080248971876e-05,2.2212843466092093e-05,1.0
19830,19830,눈사람/Noun,3,3,0,5.5574080248971876e-05,2.2212843466092093e-05,1.0
19831,19831,덕심/Noun,3,3,0,5.5574080248971876e-05,2.2212843466092093e-05,1.0
19832,19832,꼽겠다/Noun,3,3,0,5.5574080248971876e-05,2.2212843466092093e-05,1.0
19833,19833,다면/Eomi,3,3,0,5.5574080248971876e-05,2.2212843466092093e-05,1.0
19834,19834,벼슬/Noun,3,0,3,2.2229632099588756e-05,5.553210866523024e-05,1.0
19835,19835,풍덩/Adverb,3,3,0,5.5574080248971876e-05,2.2212843466092093e-05,1.0
19836,19836,폐차/Noun,3,0,3,2.2229632099588756e-05,5.553210866523024e-05,1.0
19837,19837,전라디언/Noun,3,0,3,2.2229632099588756e-05,5.553210866523024e-05,1.0
19838,19838,사이좋다/Adjective,3,0,3,2.2229632099588756e-05,5.553210866523024e-05,1.0
19839,19839,PM/Alpha,3,3,0,5.5574080248971876e-05,2.2212843466092093e-05,1.0
19840,19840,허지만/Noun,3,0,3,2.2229632099588756e-05,5.553210866523024e-05,1.0
19841,19841,진가신/Noun,3,3,0,5.5574080248971876e-05,2.2212843466092093e-05,1.0
19842,19842,거유/Noun,3,0,3,2.2229632099588756e-05,5.553210866523024e-05,1.0
19843,19843,카악/Adverb,3,0,3,2.2229632099588756e-05,5.553210866523024e-05,1.0
19844,19844,우체통/Noun,3,0,3,2.2229632099588756e-05,5.553210866523024e-05,1.0
19845,19845,더줌/Noun,3,0,3,2.2229632099588756e-05,5.553210866523024e-05,1.0
19846,19846,광끼/Noun,3,3,0,5.5574080248971876e-05,2.2212843466092093e-05,1.0
19847,19847,천진/Noun,3,3,0,5.5574080248971876e-05,2.2212843466092093e-05,1.0
19848,19848,bored/Alpha,3,0,3,2.2229632099588756e-05,5.553210866523024e-05,1.0
19849,19849,후쿠야마/Noun,3,3,0,5.5574080248971876e-05,2.2212843466092093e-05,1.0
19850,19850,라흐마니노프/Noun,3,3,0,5.5574080248971876e-05,2.2212843466092093e-05,1.0
19851,19851,노숙/Noun,3,0,3,2.2229632099588756e-05,5.553210866523024e-05,1.0
19852,19852,브라자/Noun,3,0,3,2.2229632099588756e-05,5.553210866523024e-05,1.0
19853,19853,찔금/Adverb,3,3,0,5.5574080248971876e-05,2.2212843466092093e-05,1.0
19854,19854,라이스/Noun,3,0,3,2.2229632099588756e-05,5.553210866523024e-05,1.0
19855,19855,오카/Noun,3,0,3,2.2229632099588756e-05,5.553210866523024e-05,1.0
19856,19856,이하임/Noun,3,0,3,2.2229632099588756e-05,5.553210866523024e-05,1.0
19857,19857,개털/Noun,3,0,3,2.2229632099588756e-05,5.553210866523024e-05,1.0
19858,19858,아코디언/Noun,3,3,0,5.5574080248971876e-05,2.2212843466092093e-05,1.0
19859,19859,포장마차/Noun,3,0,3,2.2229632099588756e-05,5.553210866523024e-05,1.0
19860,19860,환자연기/Noun,3,3,0,5.5574080248971876e-05,2.2212843466092093e-05,1.0
19861,19861,자비롭다/Adjective,3,0,3,2.2229632099588756e-05,5.553210866523024e-05,1.0
19862,19862,강서현/Noun,3,0,3,2.2229632099588756e-05,5.553210866523024e-05,1.0
19863,19863,뤠/Noun,3,0,3,2.2229632099588756e-05,5.553210866523024e-05,1.0
19864,19864,매칭/Noun,3,0,3,2.2229632099588756e-05,5.553210866523024e-05,1.0
19865,19865,신주아/Noun,3,0,3,2.2229632099588756e-05,5.553210866523024e-05,1.0
19866,19866,..^^*/Punctuation,3,3,0,5.5574080248971876e-05,2.2212843466092093e-05,1.0
19867,19867,히든/Noun,3,0,3,2.2229632099588756e-05,5.553210866523024e-05,1.0
19868,19868,괭장히/Noun,3,3,0,5.5574080248971876e-05,2.2212843466092093e-05,1.0
19869,19869,쯧쯔/Noun,3,0,3,2.2229632099588756e-05,5.553210866523024e-05,1.0
19870,19870,기품/Noun,3,3,0,5.5574080248971876e-05,2.2212843466092093e-05,1.0
19871,19871,진드기/Noun,3,0,3,2.2229632099588756e-05,5.553210866523024e-05,1.0
19872,19872,옵션/Noun,3,0,3,2.2229632099588756e-05,5.553210866523024e-05,1.0
19873,19873,선영/Noun,3,3,0,5.5574080248971876e-05,2.2212843466092093e-05,1.0
19874,19874,룸싸롱/Noun,3,0,3,2.2229632099588756e-05,5.553210866523024e-05,1.0
19875,19875,WOW/Alpha,3,3,0,5.5574080248971876e-05,2.2212843466092093e-05,1.0
19876,19876,열거/Noun,3,0,3,2.2229632099588756e-05,5.553210866523024e-05,1.0
19877,19877,그랑블루/Noun,3,3,0,5.5574080248971876e-05,2.2212843466092093e-05,1.0
19878,19878,기사단/Noun,3,0,3,2.2229632099588756e-05,5.553210866523024e-05,1.0
19879,19879,우사/Noun,3,3,0,5.5574080248971876e-05,2.2212843466092093e-05,1.0
19880,19880,↗/Foreign,3,3,0,5.5574080248971876e-05,2.2212843466092093e-05,1.0
19881,19881,더냐/Noun,3,0,3,2.2229632099588756e-05,5.553210866523024e-05,1.0
19882,19882,반미영/Noun,3,0,3,2.2229632099588756e-05,5.553210866523024e-05,1.0
19883,19883,화근/Noun,3,0,3,2.2229632099588756e-05,5.553210866523024e-05,1.0
19884,19884,탄창/Noun,3,0,3,2.2229632099588756e-05,5.553210866523024e-05,1.0
19885,19885,후드/Noun,3,3,0,5.5574080248971876e-05,2.2212843466092093e-05,1.0
19886,19886,애덤스/Noun,3,3,0,5.5574080248971876e-05,2.2212843466092093e-05,1.0
19887,19887,뒷담화/Noun,3,0,3,2.2229632099588756e-05,5.553210866523024e-05,1.0
19888,19888,필승/Noun,3,3,0,5.5574080248971876e-05,2.2212843466092093e-05,1.0
19889,19889,모작/Noun,3,0,3,2.2229632099588756e-05,5.553210866523024e-05,1.0
19890,19890,!!!.../Punctuation,3,3,0,5.5574080248971876e-05,2.2212843466092093e-05,1.0
19891,19891,모함/Noun,3,0,3,2.2229632099588756e-05,5.553210866523024e-05,1.0
19892,19892,리볼버/Noun,3,0,3,2.2229632099588756e-05,5.553210866523024e-05,1.0
19893,19893,찬옥/Noun,3,3,0,5.5574080248971876e-05,2.2212843466092093e-05,1.0
19894,19894,뢰/Noun,3,3,0,5.5574080248971876e-05,2.2212843466092093e-05,1.0
19895,19895,"...,./Punctuation",3,0,3,2.2229632099588756e-05,5.553210866523024e-05,1.0
19896,19896,공갈/Noun,3,0,3,2.2229632099588756e-05,5.553210866523024e-05,1.0
19897,19897,공찬/Noun,3,3,0,5.5574080248971876e-05,2.2212843466092093e-05,1.0
19898,19898,송능/Noun,3,3,0,5.5574080248971876e-05,2.2212843466092093e-05,1.0
19899,19899,친정엄마/Noun,3,0,3,2.2229632099588756e-05,5.553210866523024e-05,1.0
19900,19900,공갈빵/Noun,3,0,3,2.2229632099588756e-05,5.553210866523024e-05,1.0
19901,19901,핵꿀/Noun,3,3,0,5.5574080248971876e-05,2.2212843466092093e-05,1.0
19902,19902,한진/Noun,3,0,3,2.2229632099588756e-05,5.553210866523024e-05,1.0
19903,19903,포가튼/Noun,3,0,3,2.2229632099588756e-05,5.553210866523024e-05,1.0
19904,19904,으로부터의/Josa,3,3,0,5.5574080248971876e-05,2.2212843466092093e-05,1.0
19905,19905,동창생/Noun,3,0,3,2.2229632099588756e-05,5.553210866523024e-05,1.0
19906,19906,시정/Noun,3,0,3,2.2229632099588756e-05,5.553210866523024e-05,1.0
19907,19907,의처증/Noun,3,0,3,2.2229632099588756e-05,5.553210866523024e-05,1.0
19908,19908,궁디/Noun,3,0,3,2.2229632099588756e-05,5.553210866523024e-05,1.0
19909,19909,단란/Noun,3,3,0,5.5574080248971876e-05,2.2212843466092093e-05,1.0
19910,19910,탈탈/Adverb,3,0,3,2.2229632099588756e-05,5.553210866523024e-05,1.0
19911,19911,또왜/Noun,3,0,3,2.2229632099588756e-05,5.553210866523024e-05,1.0
19912,19912,제어/Noun,3,3,0,5.5574080248971876e-05,2.2212843466092093e-05,1.0
19913,19913,。。/Foreign,3,3,0,5.5574080248971876e-05,2.2212843466092093e-05,1.0
19914,19914,병과/Noun,3,0,3,2.2229632099588756e-05,5.553210866523024e-05,1.0
19915,19915,몆번/Noun,3,3,0,5.5574080248971876e-05,2.2212843466092093e-05,1.0
19916,19916,니코니코니/Noun,3,3,0,5.5574080248971876e-05,2.2212843466092093e-05,1.0
19917,19917,Film/Alpha,3,0,3,2.2229632099588756e-05,5.553210866523024e-05,1.0
19918,19918,지엔/Noun,3,3,0,5.5574080248971876e-05,2.2212843466092093e-05,1.0
19919,19919,정소영/Noun,3,0,3,2.2229632099588756e-05,5.553210866523024e-05,1.0
19920,19920,증권/Noun,3,3,0,5.5574080248971876e-05,2.2212843466092093e-05,1.0
19921,19921,Park/Alpha,3,3,0,5.5574080248971876e-05,2.2212843466092093e-05,1.0
19922,19922,쿨럭/Adverb,3,3,0,5.5574080248971876e-05,2.2212843466092093e-05,1.0
19923,19923,1930년/Number,3,0,3,2.2229632099588756e-05,5.553210866523024e-05,1.0
19924,19924,nc/Alpha,3,0,3,2.2229632099588756e-05,5.553210866523024e-05,1.0
19925,19925,자스민/Noun,3,3,0,5.5574080248971876e-05,2.2212843466092093e-05,1.0
19926,19926,흐엉/Noun,3,3,0,5.5574080248971876e-05,2.2212843466092093e-05,1.0
19927,19927,혜정/Noun,3,0,3,2.2229632099588756e-05,5.553210866523024e-05,1.0
19928,19928,함대/Noun,3,0,3,2.2229632099588756e-05,5.553210866523024e-05,1.0
19929,19929,IP/Alpha,3,0,3,2.2229632099588756e-05,5.553210866523024e-05,1.0
19930,19930,만듭/Noun,3,0,3,2.2229632099588756e-05,5.553210866523024e-05,1.0
19931,19931,모네/Noun,3,3,0,5.5574080248971876e-05,2.2212843466092093e-05,1.0
19932,19932,벙하다/Adjective,3,0,3,2.2229632099588756e-05,5.553210866523024e-05,1.0
19933,19933,BOB/Alpha,3,3,0,5.5574080248971876e-05,2.2212843466092093e-05,1.0
19934,19934,바랬어/Noun,3,3,0,5.5574080248971876e-05,2.2212843466092093e-05,1.0
19935,19935,몬트리올/Noun,3,3,0,5.5574080248971876e-05,2.2212843466092093e-05,1.0
19936,19936,머큐리/Noun,3,3,0,5.5574080248971876e-05,2.2212843466092093e-05,1.0
19937,19937,나뮤/Noun,3,3,0,5.5574080248971876e-05,2.2212843466092093e-05,1.0
19938,19938,발등/Noun,3,0,3,2.2229632099588756e-05,5.553210866523024e-05,1.0
19939,19939,밤일/Noun,3,0,3,2.2229632099588756e-05,5.553210866523024e-05,1.0
19940,19940,건개/Noun,3,0,3,2.2229632099588756e-05,5.553210866523024e-05,1.0
19941,19941,~~../Punctuation,3,3,0,5.5574080248971876e-05,2.2212843466092093e-05,1.0
19942,19942,박상면/Noun,3,0,3,2.2229632099588756e-05,5.553210866523024e-05,1.0
19943,19943,천진하다/Adjective,3,3,0,5.5574080248971876e-05,2.2212843466092093e-05,1.0
19944,19944,걸핏하면/Noun,3,0,3,2.2229632099588756e-05,5.553210866523024e-05,1.0
19945,19945,우쭈쭈/Noun,3,0,3,2.2229632099588756e-05,5.553210866523024e-05,1.0
19946,19946,^^~*/Punctuation,3,3,0,5.5574080248971876e-05,2.2212843466092093e-05,1.0
19947,19947,^.~/Punctuation,3,3,0,5.5574080248971876e-05,2.2212843466092093e-05,1.0
19948,19948,103분/Number,3,0,3,2.2229632099588756e-05,5.553210866523024e-05,1.0
19949,19949,going/Alpha,3,3,0,5.5574080248971876e-05,2.2212843466092093e-05,1.0
19950,19950,아쿠아리움/Noun,3,3,0,5.5574080248971876e-05,2.2212843466092093e-05,1.0
19951,19951,와즈다/Noun,3,3,0,5.5574080248971876e-05,2.2212843466092093e-05,1.0
19952,19952,war/Alpha,3,0,3,2.2229632099588756e-05,5.553210866523024e-05,1.0
19953,19953,연루/Noun,3,0,3,2.2229632099588756e-05,5.553210866523024e-05,1.0
19954,19954,네오나치/Noun,3,3,0,5.5574080248971876e-05,2.2212843466092093e-05,1.0
19955,19955,불합격/Noun,3,0,3,2.2229632099588756e-05,5.553210866523024e-05,1.0
19956,19956,방글라데시/Noun,3,0,3,2.2229632099588756e-05,5.553210866523024e-05,1.0
19957,19957,~!~/Punctuation,3,3,0,5.5574080248971876e-05,2.2212843466092093e-05,1.0
19958,19958,윤정희/Noun,3,3,0,5.5574080248971876e-05,2.2212843466092093e-05,1.0
19959,19959,춘향뎐/Noun,3,0,3,2.2229632099588756e-05,5.553210866523024e-05,1.0
19960,19960,무현/Noun,3,0,3,2.2229632099588756e-05,5.553210866523024e-05,1.0
19961,19961,미비하다/Adjective,3,0,3,2.2229632099588756e-05,5.553210866523024e-05,1.0
19962,19962,극상/Noun,3,0,3,2.2229632099588756e-05,5.553210866523024e-05,1.0
19963,19963,이하이/Noun,3,0,3,2.2229632099588756e-05,5.553210866523024e-05,1.0
19964,19964,패리/Noun,3,0,3,2.2229632099588756e-05,5.553210866523024e-05,1.0
19965,19965,김은형/Noun,3,3,0,5.5574080248971876e-05,2.2212843466092093e-05,1.0
19966,19966,어쩌지/Adverb,3,0,3,2.2229632099588756e-05,5.553210866523024e-05,1.0
19967,19967,생활비/Noun,3,0,3,2.2229632099588756e-05,5.553210866523024e-05,1.0
19968,19968,에이타/Noun,3,3,0,5.5574080248971876e-05,2.2212843466092093e-05,1.0
19969,19969,퍼줘/Noun,3,0,3,2.2229632099588756e-05,5.553210866523024e-05,1.0
19970,19970,9876543210/Number,3,3,0,5.5574080248971876e-05,2.2212843466092093e-05,1.0
19971,19971,성조기/Noun,3,0,3,2.2229632099588756e-05,5.553210866523024e-05,1.0
19972,19972,은행나무/Noun,3,0,3,2.2229632099588756e-05,5.553210866523024e-05,1.0
19973,19973,춘추전국시대/Noun,3,3,0,5.5574080248971876e-05,2.2212843466092093e-05,1.0
19974,19974,68/Number,3,3,0,5.5574080248971876e-05,2.2212843466092093e-05,1.0
19975,19975,거외/Noun,3,0,3,2.2229632099588756e-05,5.553210866523024e-05,1.0
19976,19976,케케묵/Noun,3,0,3,2.2229632099588756e-05,5.553210866523024e-05,1.0
19977,19977,효시/Noun,3,3,0,5.5574080248971876e-05,2.2212843466092093e-05,1.0
19978,19978,썸녀/Noun,3,0,3,2.2229632099588756e-05,5.553210866523024e-05,1.0
19979,19979,오덕후/Noun,3,3,0,5.5574080248971876e-05,2.2212843466092093e-05,1.0
19980,19980,수행평가/Noun,3,0,3,2.2229632099588756e-05,5.553210866523024e-05,1.0
19981,19981,숙식/Noun,3,0,3,2.2229632099588756e-05,5.553210866523024e-05,1.0
19982,19982,worst/Alpha,3,0,3,2.2229632099588756e-05,5.553210866523024e-05,1.0
19983,19983,사랑과영혼/Noun,3,0,3,2.2229632099588756e-05,5.553210866523024e-05,1.0
19984,19984,될런/Noun,3,0,3,2.2229632099588756e-05,5.553210866523024e-05,1.0
19985,19985,하오/Eomi,3,3,0,5.5574080248971876e-05,2.2212843466092093e-05,1.0
19986,19986,의방/Noun,3,0,3,2.2229632099588756e-05,5.553210866523024e-05,1.0
19987,19987,전대/Noun,3,3,0,5.5574080248971876e-05,2.2212843466092093e-05,1.0
19988,19988,종신형/Noun,3,3,0,5.5574080248971876e-05,2.2212843466092093e-05,1.0
19989,19989,투리/Noun,3,0,3,2.2229632099588756e-05,5.553210866523024e-05,1.0
19990,19990,톤즈/Noun,3,3,0,5.5574080248971876e-05,2.2212843466092093e-05,1.0
19991,19991,타운/Noun,3,0,3,2.2229632099588756e-05,5.553210866523024e-05,1.0
19992,19992,유약/Noun,3,3,0,5.5574080248971876e-05,2.2212843466092093e-05,1.0
19993,19993,번지르르/Noun,3,0,3,2.2229632099588756e-05,5.553210866523024e-05,1.0
19994,19994,속수무책/Noun,3,0,3,2.2229632099588756e-05,5.553210866523024e-05,1.0
19995,19995,눈밑/Noun,3,0,3,2.2229632099588756e-05,5.553210866523024e-05,1.0
19996,19996,꼴사납다/Adjective,3,0,3,2.2229632099588756e-05,5.553210866523024e-05,1.0
19997,19997,영선/Noun,3,3,0,5.5574080248971876e-05,2.2212843466092093e-05,1.0
19998,19998,아멜리아/Noun,3,3,0,5.5574080248971876e-05,2.2212843466092093e-05,1.0
19999,19999,명정/Noun,3,0,3,2.2229632099588756e-05,5.553210866523024e-05,1.0
20000,20000,청설/Noun,3,3,0,5.5574080248971876e-05,2.2212843466092093e-05,1.0
20001,20001,조민아/Noun,3,0,3,2.2229632099588756e-05,5.553210866523024e-05,1.0
20002,20002,생크림/Noun,3,0,3,2.2229632099588756e-05,5.553210866523024e-05,1.0
20003,20003,제빵/Noun,3,0,3,2.2229632099588756e-05,5.553210866523024e-05,1.0
20004,20004,어무이/Noun,3,3,0,5.5574080248971876e-05,2.2212843466092093e-05,1.0
20005,20005,지부리/Noun,3,0,3,2.2229632099588756e-05,5.553210866523024e-05,1.0
20006,20006,ㅡㅠ/KoreanParticle,3,0,3,2.2229632099588756e-05,5.553210866523024e-05,1.0
20007,20007,카레이서/Noun,3,0,3,2.2229632099588756e-05,5.553210866523024e-05,1.0
20008,20008,이태백/Noun,3,3,0,5.5574080248971876e-05,2.2212843466092093e-05,1.0
20009,20009,1975년/Number,3,3,0,5.5574080248971876e-05,2.2212843466092093e-05,1.0
20010,20010,후훗/Noun,3,3,0,5.5574080248971876e-05,2.2212843466092093e-05,1.0
20011,20011,....................................................../Punctuation,3,0,3,2.2229632099588756e-05,5.553210866523024e-05,1.0
20012,20012,매스/Noun,3,3,0,5.5574080248971876e-05,2.2212843466092093e-05,1.0
20013,20013,프리허그/Noun,3,0,3,2.2229632099588756e-05,5.553210866523024e-05,1.0
20014,20014,아치로/Noun,3,0,3,2.2229632099588756e-05,5.553210866523024e-05,1.0
20015,20015,방위/Noun,3,0,3,2.2229632099588756e-05,5.553210866523024e-05,1.0
20016,20016,..^/Punctuation,3,3,0,5.5574080248971876e-05,2.2212843466092093e-05,1.0
20017,20017,즈/Noun,3,3,0,5.5574080248971876e-05,2.2212843466092093e-05,1.0
20018,20018,복권/Noun,3,0,3,2.2229632099588756e-05,5.553210866523024e-05,1.0
20019,20019,ㅂㄹ/KoreanParticle,3,0,3,2.2229632099588756e-05,5.553210866523024e-05,1.0
20020,20020,쒸레/Noun,3,0,3,2.2229632099588756e-05,5.553210866523024e-05,1.0
20021,20021,데미지/Noun,3,0,3,2.2229632099588756e-05,5.553210866523024e-05,1.0
20022,20022,신빙/Noun,3,0,3,2.2229632099588756e-05,5.553210866523024e-05,1.0
20023,20023,백도/Noun,3,0,3,2.2229632099588756e-05,5.553210866523024e-05,1.0
20024,20024,RIP/Alpha,3,3,0,5.5574080248971876e-05,2.2212843466092093e-05,1.0
20025,20025,강성민/Noun,3,3,0,5.5574080248971876e-05,2.2212843466092093e-05,1.0
20026,20026,잭맨/Noun,3,3,0,5.5574080248971876e-05,2.2212843466092093e-05,1.0
20027,20027,죽빵/Noun,3,0,3,2.2229632099588756e-05,5.553210866523024e-05,1.0
20028,20028,띵똥/Noun,3,3,0,5.5574080248971876e-05,2.2212843466092093e-05,1.0
20029,20029,안병기/Noun,3,0,3,2.2229632099588756e-05,5.553210866523024e-05,1.0
20030,20030,운빨/Noun,3,0,3,2.2229632099588756e-05,5.553210866523024e-05,1.0
20031,20031,발라드/Noun,3,3,0,5.5574080248971876e-05,2.2212843466092093e-05,1.0
20032,20032,생물체/Noun,3,0,3,2.2229632099588756e-05,5.553210866523024e-05,1.0
20033,20033,고등어/Noun,3,0,3,2.2229632099588756e-05,5.553210866523024e-05,1.0
20034,20034,굴려/Noun,3,0,3,2.2229632099588756e-05,5.553210866523024e-05,1.0
20035,20035,트래비스/Noun,3,3,0,5.5574080248971876e-05,2.2212843466092093e-05,1.0
20036,20036,병림픽/Noun,3,0,3,2.2229632099588756e-05,5.553210866523024e-05,1.0
20037,20037,초대장/Noun,3,0,3,2.2229632099588756e-05,5.553210866523024e-05,1.0
20038,20038,요딴/Modifier,3,0,3,2.2229632099588756e-05,5.553210866523024e-05,1.0
20039,20039,채택/Noun,3,0,3,2.2229632099588756e-05,5.553210866523024e-05,1.0
20040,20040,아이칼리/Noun,3,3,0,5.5574080248971876e-05,2.2212843466092093e-05,1.0
20041,20041,해태/Noun,3,3,0,5.5574080248971876e-05,2.2212843466092093e-05,1.0
20042,20042,비투스/Noun,3,3,0,5.5574080248971876e-05,2.2212843466092093e-05,1.0
20043,20043,방공/Noun,3,0,3,2.2229632099588756e-05,5.553210866523024e-05,1.0
20044,20044,안드레아/Noun,3,3,0,5.5574080248971876e-05,2.2212843466092093e-05,1.0
20045,20045,버즈/Noun,3,3,0,5.5574080248971876e-05,2.2212843466092093e-05,1.0
20046,20046,알츠하이머/Noun,3,3,0,5.5574080248971876e-05,2.2212843466092093e-05,1.0
20047,20047,호남/Noun,3,0,3,2.2229632099588756e-05,5.553210866523024e-05,1.0
20048,20048,밨던/Noun,3,3,0,5.5574080248971876e-05,2.2212843466092093e-05,1.0
20049,20049,학부/Noun,3,0,3,2.2229632099588756e-05,5.553210866523024e-05,1.0
20050,20050,걸리버/Noun,3,0,3,2.2229632099588756e-05,5.553210866523024e-05,1.0
20051,20051,태익/Noun,3,3,0,5.5574080248971876e-05,2.2212843466092093e-05,1.0
20052,20052,아우슈비츠/Noun,3,3,0,5.5574080248971876e-05,2.2212843466092093e-05,1.0
20053,20053,음흉하다/Adjective,3,0,3,2.2229632099588756e-05,5.553210866523024e-05,1.0
20054,20054,킁킁/Adverb,3,0,3,2.2229632099588756e-05,5.553210866523024e-05,1.0
20055,20055,다웠다/Noun,3,0,3,2.2229632099588756e-05,5.553210866523024e-05,1.0
20056,20056,뽀뽀뽀/Noun,3,0,3,2.2229632099588756e-05,5.553210866523024e-05,1.0
20057,20057,최오/Noun,3,3,0,5.5574080248971876e-05,2.2212843466092093e-05,1.0
20058,20058,연예가중계/Noun,3,0,3,2.2229632099588756e-05,5.553210866523024e-05,1.0
20059,20059,어쨌건/Adverb,3,0,3,2.2229632099588756e-05,5.553210866523024e-05,1.0
20060,20060,만쉐이/Noun,3,3,0,5.5574080248971876e-05,2.2212843466092093e-05,1.0
20061,20061,디스크/Noun,3,0,3,2.2229632099588756e-05,5.553210866523024e-05,1.0
20062,20062,why/Alpha,3,3,0,5.5574080248971876e-05,2.2212843466092093e-05,1.0
20063,20063,3.3/Number,3,0,3,2.2229632099588756e-05,5.553210866523024e-05,1.0
20064,20064,스르르/Noun,3,3,0,5.5574080248971876e-05,2.2212843466092093e-05,1.0
20065,20065,직감/Noun,3,0,3,2.2229632099588756e-05,5.553210866523024e-05,1.0
20066,20066,턱턱/Noun,3,3,0,5.5574080248971876e-05,2.2212843466092093e-05,1.0
20067,20067,성남/Noun,3,3,0,5.5574080248971876e-05,2.2212843466092093e-05,1.0
20068,20068,아련아련/Noun,3,3,0,5.5574080248971876e-05,2.2212843466092093e-05,1.0
20069,20069,>?/Punctuation,3,0,3,2.2229632099588756e-05,5.553210866523024e-05,1.0
20070,20070,62년/Number,3,3,0,5.5574080248971876e-05,2.2212843466092093e-05,1.0
20071,20071,몽크/Noun,3,3,0,5.5574080248971876e-05,2.2212843466092093e-05,1.0
20072,20072,세드/Noun,3,3,0,5.5574080248971876e-05,2.2212843466092093e-05,1.0
20073,20073,수도원/Noun,3,3,0,5.5574080248971876e-05,2.2212843466092093e-05,1.0
20074,20074,병역/Noun,3,0,3,2.2229632099588756e-05,5.553210866523024e-05,1.0
20075,20075,칙칙/Adverb,3,3,0,5.5574080248971876e-05,2.2212843466092093e-05,1.0
20076,20076,희망버스/Noun,3,0,3,2.2229632099588756e-05,5.553210866523024e-05,1.0
20077,20077,두드러지다/Adjective,3,0,3,2.2229632099588756e-05,5.553210866523024e-05,1.0
20078,20078,쩌내/Noun,3,3,0,5.5574080248971876e-05,2.2212843466092093e-05,1.0
20079,20079,방임/Noun,3,0,3,2.2229632099588756e-05,5.553210866523024e-05,1.0
20080,20080,카니발/Noun,3,3,0,5.5574080248971876e-05,2.2212843466092093e-05,1.0
20081,20081,급성/Noun,3,0,3,2.2229632099588756e-05,5.553210866523024e-05,1.0
20082,20082,건성/Noun,3,0,3,2.2229632099588756e-05,5.553210866523024e-05,1.0
20083,20083,whole/Alpha,3,3,0,5.5574080248971876e-05,2.2212843466092093e-05,1.0
20084,20084,6~70년/Number,3,0,3,2.2229632099588756e-05,5.553210866523024e-05,1.0
20085,20085,관문/Noun,3,3,0,5.5574080248971876e-05,2.2212843466092093e-05,1.0
20086,20086,민혁/Noun,3,3,0,5.5574080248971876e-05,2.2212843466092093e-05,1.0
20087,20087,김진명/Noun,3,0,3,2.2229632099588756e-05,5.553210866523024e-05,1.0
20088,20088,김태용/Noun,3,3,0,5.5574080248971876e-05,2.2212843466092093e-05,1.0
20089,20089,동수/Noun,3,3,0,5.5574080248971876e-05,2.2212843466092093e-05,1.0
20090,20090,땜빵/Noun,3,0,3,2.2229632099588756e-05,5.553210866523024e-05,1.0
20091,20091,폐륜/Noun,3,0,3,2.2229632099588756e-05,5.553210866523024e-05,1.0
20092,20092,격파/Noun,3,0,3,2.2229632099588756e-05,5.553210866523024e-05,1.0
20093,20093,천수/Noun,3,3,0,5.5574080248971876e-05,2.2212843466092093e-05,1.0
20094,20094,이태/Noun,3,3,0,5.5574080248971876e-05,2.2212843466092093e-05,1.0
20095,20095,에드가/Noun,3,3,0,5.5574080248971876e-05,2.2212843466092093e-05,1.0
20096,20096,맹수/Noun,3,3,0,5.5574080248971876e-05,2.2212843466092093e-05,1.0
20097,20097,퍼시픽/Noun,3,3,0,5.5574080248971876e-05,2.2212843466092093e-05,1.0
20098,20098,밑밑/Noun,3,0,3,2.2229632099588756e-05,5.553210866523024e-05,1.0
20099,20099,됴/Noun,3,3,0,5.5574080248971876e-05,2.2212843466092093e-05,1.0
20100,20100,전념/Noun,3,0,3,2.2229632099588756e-05,5.553210866523024e-05,1.0
20101,20101,양도/Noun,3,0,3,2.2229632099588756e-05,5.553210866523024e-05,1.0
20102,20102,꼬띠아르/Noun,3,3,0,5.5574080248971876e-05,2.2212843466092093e-05,1.0
20103,20103,성서/Noun,3,3,0,5.5574080248971876e-05,2.2212843466092093e-05,1.0
20104,20104,급보/Noun,3,0,3,2.2229632099588756e-05,5.553210866523024e-05,1.0
20105,20105,이즈미/Noun,3,0,3,2.2229632099588756e-05,5.553210866523024e-05,1.0
20106,20106,시래기/Noun,3,0,3,2.2229632099588756e-05,5.553210866523024e-05,1.0
20107,20107,쭝/Noun,3,0,3,2.2229632099588756e-05,5.553210866523024e-05,1.0
20108,20108,볼껀/Noun,3,0,3,2.2229632099588756e-05,5.553210866523024e-05,1.0
20109,20109,뿜음/Noun,3,0,3,2.2229632099588756e-05,5.553210866523024e-05,1.0
20110,20110,병태/Noun,3,3,0,5.5574080248971876e-05,2.2212843466092093e-05,1.0
20111,20111,엄석대/Noun,3,3,0,5.5574080248971876e-05,2.2212843466092093e-05,1.0
20112,20112,원시/Noun,3,3,0,5.5574080248971876e-05,2.2212843466092093e-05,1.0
20113,20113,꼬았으/Noun,3,0,3,2.2229632099588756e-05,5.553210866523024e-05,1.0
20114,20114,세탁기/Noun,3,3,0,5.5574080248971876e-05,2.2212843466092093e-05,1.0
20115,20115,이상보/Noun,3,0,3,2.2229632099588756e-05,5.553210866523024e-05,1.0
20116,20116,전인데/Foreign,3,3,0,5.5574080248971876e-05,2.2212843466092093e-05,1.0
20117,20117,어영부영/Adverb,3,0,3,2.2229632099588756e-05,5.553210866523024e-05,1.0
20118,20118,애청/Noun,3,3,0,5.5574080248971876e-05,2.2212843466092093e-05,1.0
20119,20119,빈스본/Noun,3,3,0,5.5574080248971876e-05,2.2212843466092093e-05,1.0
20120,20120,당체/Noun,3,0,3,2.2229632099588756e-05,5.553210866523024e-05,1.0
20121,20121,대수준/Foreign,3,0,3,2.2229632099588756e-05,5.553210866523024e-05,1.0
20122,20122,약주/Noun,3,0,3,2.2229632099588756e-05,5.553210866523024e-05,1.0
20123,20123,텅텅빈/Noun,3,0,3,2.2229632099588756e-05,5.553210866523024e-05,1.0
20124,20124,재개발/Noun,3,3,0,5.5574080248971876e-05,2.2212843466092093e-05,1.0
20125,20125,친구사이/Noun,3,3,0,5.5574080248971876e-05,2.2212843466092093e-05,1.0
20126,20126,gooood/Alpha,3,3,0,5.5574080248971876e-05,2.2212843466092093e-05,1.0
20127,20127,비원에이포/Noun,3,3,0,5.5574080248971876e-05,2.2212843466092093e-05,1.0
20128,20128,카이스트/Noun,3,3,0,5.5574080248971876e-05,2.2212843466092093e-05,1.0
20129,20129,뚝방/Noun,3,0,3,2.2229632099588756e-05,5.553210866523024e-05,1.0
20130,20130,개낚임/Noun,3,0,3,2.2229632099588756e-05,5.553210866523024e-05,1.0
20131,20131,김호진/Noun,3,0,3,2.2229632099588756e-05,5.553210866523024e-05,1.0
20132,20132,대디/Noun,3,0,3,2.2229632099588756e-05,5.553210866523024e-05,1.0
20133,20133,벌금/Noun,3,0,3,2.2229632099588756e-05,5.553210866523024e-05,1.0
20134,20134,육남매/Noun,3,3,0,5.5574080248971876e-05,2.2212843466092093e-05,1.0
20135,20135,여의사/Noun,3,0,3,2.2229632099588756e-05,5.553210866523024e-05,1.0
20136,20136,장현성/Noun,3,3,0,5.5574080248971876e-05,2.2212843466092093e-05,1.0
20137,20137,화목/Noun,3,3,0,5.5574080248971876e-05,2.2212843466092093e-05,1.0
20138,20138,낮짝/Noun,3,0,3,2.2229632099588756e-05,5.553210866523024e-05,1.0
20139,20139,김승호/Noun,3,3,0,5.5574080248971876e-05,2.2212843466092093e-05,1.0
20140,20140,메스꺼움/Noun,3,0,3,2.2229632099588756e-05,5.553210866523024e-05,1.0
20141,20141,일초/Noun,3,3,0,5.5574080248971876e-05,2.2212843466092093e-05,1.0
20142,20142,칼침/Noun,3,0,3,2.2229632099588756e-05,5.553210866523024e-05,1.0
20143,20143,중공/Noun,3,0,3,2.2229632099588756e-05,5.553210866523024e-05,1.0
20144,20144,ㅣㅆ/KoreanParticle,3,3,0,5.5574080248971876e-05,2.2212843466092093e-05,1.0
20145,20145,범죄소년/Noun,3,3,0,5.5574080248971876e-05,2.2212843466092093e-05,1.0
20146,20146,꼴불견/Noun,3,0,3,2.2229632099588756e-05,5.553210866523024e-05,1.0
20147,20147,날씬하다/Adjective,3,0,3,2.2229632099588756e-05,5.553210866523024e-05,1.0
20148,20148,귀향/Noun,3,0,3,2.2229632099588756e-05,5.553210866523024e-05,1.0
20149,20149,갈라/Noun,3,3,0,5.5574080248971876e-05,2.2212843466092093e-05,1.0
20150,20150,약혼녀/Noun,3,0,3,2.2229632099588756e-05,5.553210866523024e-05,1.0
20151,20151,화인/Noun,3,0,3,2.2229632099588756e-05,5.553210866523024e-05,1.0
20152,20152,재맛/Noun,3,3,0,5.5574080248971876e-05,2.2212843466092093e-05,1.0
20153,20153,니콜라스홀트/Noun,3,3,0,5.5574080248971876e-05,2.2212843466092093e-05,1.0
20154,20154,울상/Noun,3,0,3,2.2229632099588756e-05,5.553210866523024e-05,1.0
20155,20155,홧김/Noun,3,0,3,2.2229632099588756e-05,5.553210866523024e-05,1.0
20156,20156,쉬쉬/Adverb,3,0,3,2.2229632099588756e-05,5.553210866523024e-05,1.0
20157,20157,논쟁/Noun,3,0,3,2.2229632099588756e-05,5.553210866523024e-05,1.0
20158,20158,망햇음/Noun,3,0,3,2.2229632099588756e-05,5.553210866523024e-05,1.0
20159,20159,정초신/Noun,3,0,3,2.2229632099588756e-05,5.553210866523024e-05,1.0
20160,20160,븐/Noun,3,0,3,2.2229632099588756e-05,5.553210866523024e-05,1.0
20161,20161,느낌표/Noun,3,3,0,5.5574080248971876e-05,2.2212843466092093e-05,1.0
20162,20162,주해/Noun,3,0,3,2.2229632099588756e-05,5.553210866523024e-05,1.0
20163,20163,대로/Foreign,3,0,3,2.2229632099588756e-05,5.553210866523024e-05,1.0
20164,20164,악담/Noun,3,3,0,5.5574080248971876e-05,2.2212843466092093e-05,1.0
20165,20165,만가/Noun,3,0,3,2.2229632099588756e-05,5.553210866523024e-05,1.0
20166,20166,ㅆㅏ/KoreanParticle,3,0,3,2.2229632099588756e-05,5.553210866523024e-05,1.0
20167,20167,으잌/Noun,3,0,3,2.2229632099588756e-05,5.553210866523024e-05,1.0
20168,20168,흥국/Noun,3,3,0,5.5574080248971876e-05,2.2212843466092093e-05,1.0
20169,20169,악뮤/Noun,3,0,3,2.2229632099588756e-05,5.553210866523024e-05,1.0
20170,20170,신속하다/Adjective,3,0,3,2.2229632099588756e-05,5.553210866523024e-05,1.0
20171,20171,오십/Modifier,3,0,3,2.2229632099588756e-05,5.553210866523024e-05,1.0
20172,20172,..^-^/Punctuation,3,3,0,5.5574080248971876e-05,2.2212843466092093e-05,1.0
20173,20173,메뉴/Noun,3,0,3,2.2229632099588756e-05,5.553210866523024e-05,1.0
20174,20174,앤젤/Noun,3,3,0,5.5574080248971876e-05,2.2212843466092093e-05,1.0
20175,20175,유리가면/Noun,3,0,3,2.2229632099588756e-05,5.553210866523024e-05,1.0
20176,20176,화장품/Noun,3,3,0,5.5574080248971876e-05,2.2212843466092093e-05,1.0
20177,20177,누벨바그/Noun,3,3,0,5.5574080248971876e-05,2.2212843466092093e-05,1.0
20178,20178,영화평론/Noun,3,3,0,5.5574080248971876e-05,2.2212843466092093e-05,1.0
20179,20179,골초/Noun,3,0,3,2.2229632099588756e-05,5.553210866523024e-05,1.0
20180,20180,drama/Alpha,3,3,0,5.5574080248971876e-05,2.2212843466092093e-05,1.0
20181,20181,지근/Noun,3,0,3,2.2229632099588756e-05,5.553210866523024e-05,1.0
20182,20182,뉘우침/Noun,3,0,3,2.2229632099588756e-05,5.553210866523024e-05,1.0
20183,20183,350/Number,3,0,3,2.2229632099588756e-05,5.553210866523024e-05,1.0
20184,20184,외교부/Noun,3,3,0,5.5574080248971876e-05,2.2212843466092093e-05,1.0
20185,20185,여도/Eomi,3,0,3,2.2229632099588756e-05,5.553210866523024e-05,1.0
20186,20186,여당/Noun,3,3,0,5.5574080248971876e-05,2.2212843466092093e-05,1.0
20187,20187,솔트/Noun,3,0,3,2.2229632099588756e-05,5.553210866523024e-05,1.0
20188,20188,든든하다/Adjective,3,3,0,5.5574080248971876e-05,2.2212843466092093e-05,1.0
20189,20189,말론브란도/Noun,3,3,0,5.5574080248971876e-05,2.2212843466092093e-05,1.0
20190,20190,허둥대다/Verb,3,0,3,2.2229632099588756e-05,5.553210866523024e-05,1.0
20191,20191,에듬/Foreign,3,3,0,5.5574080248971876e-05,2.2212843466092093e-05,1.0
20192,20192,뿅뿅/Adverb,3,3,0,5.5574080248971876e-05,2.2212843466092093e-05,1.0
20193,20193,허가/Noun,3,0,3,2.2229632099588756e-05,5.553210866523024e-05,1.0
20194,20194,간담/Noun,3,0,3,2.2229632099588756e-05,5.553210866523024e-05,1.0
20195,20195,껏습니/Noun,3,0,3,2.2229632099588756e-05,5.553210866523024e-05,1.0
20196,20196,그니/Noun,3,3,0,5.5574080248971876e-05,2.2212843466092093e-05,1.0
20197,20197,인혜/Noun,3,0,3,2.2229632099588756e-05,5.553210866523024e-05,1.0
20198,20198,친정/Noun,3,0,3,2.2229632099588756e-05,5.553210866523024e-05,1.0
20199,20199,성전환/Noun,3,3,0,5.5574080248971876e-05,2.2212843466092093e-05,1.0
20200,20200,대자/Noun,3,3,0,5.5574080248971876e-05,2.2212843466092093e-05,1.0
20201,20201,벌거숭이/Noun,3,0,3,2.2229632099588756e-05,5.553210866523024e-05,1.0
20202,20202,엮어내/Noun,3,3,0,5.5574080248971876e-05,2.2212843466092093e-05,1.0
20203,20203,시동/Noun,3,0,3,2.2229632099588756e-05,5.553210866523024e-05,1.0
20204,20204,정세운/Noun,3,0,3,2.2229632099588756e-05,5.553210866523024e-05,1.0
20205,20205,백현/Noun,3,3,0,5.5574080248971876e-05,2.2212843466092093e-05,1.0
20206,20206,음절/Noun,3,3,0,5.5574080248971876e-05,2.2212843466092093e-05,1.0
20207,20207,건반/Noun,3,3,0,5.5574080248971876e-05,2.2212843466092093e-05,1.0
20208,20208,필로미나/Noun,3,3,0,5.5574080248971876e-05,2.2212843466092093e-05,1.0
20209,20209,교재/Noun,3,0,3,2.2229632099588756e-05,5.553210866523024e-05,1.0
20210,20210,호두/Noun,3,0,3,2.2229632099588756e-05,5.553210866523024e-05,1.0
20211,20211,!!!^/Punctuation,3,3,0,5.5574080248971876e-05,2.2212843466092093e-05,1.0
20212,20212,주무르다/Verb,3,0,3,2.2229632099588756e-05,5.553210866523024e-05,1.0
20213,20213,요런/Modifier,3,0,3,2.2229632099588756e-05,5.553210866523024e-05,1.0
20214,20214,컨트리/Noun,3,3,0,5.5574080248971876e-05,2.2212843466092093e-05,1.0
20215,20215,★★/Foreign,3,3,0,5.5574080248971876e-05,2.2212843466092093e-05,1.0
20216,20216,준지/Noun,3,0,3,2.2229632099588756e-05,5.553210866523024e-05,1.0
20217,20217,이토/Noun,3,0,3,2.2229632099588756e-05,5.553210866523024e-05,1.0
20218,20218,최근영/Noun,3,3,0,5.5574080248971876e-05,2.2212843466092093e-05,1.0
20219,20219,보고따/Noun,3,0,3,2.2229632099588756e-05,5.553210866523024e-05,1.0
20220,20220,프로포폴/Noun,3,3,0,5.5574080248971876e-05,2.2212843466092093e-05,1.0
20221,20221,도니/Noun,3,3,0,5.5574080248971876e-05,2.2212843466092093e-05,1.0
20222,20222,탈레반/Noun,3,0,3,2.2229632099588756e-05,5.553210866523024e-05,1.0
20223,20223,탐미/Noun,3,3,0,5.5574080248971876e-05,2.2212843466092093e-05,1.0
20224,20224,국력/Noun,3,0,3,2.2229632099588756e-05,5.553210866523024e-05,1.0
20225,20225,탤런트/Noun,3,0,3,2.2229632099588756e-05,5.553210866523024e-05,1.0
20226,20226,몸집/Noun,3,0,3,2.2229632099588756e-05,5.553210866523024e-05,1.0
20227,20227,하몽/Noun,3,0,3,2.2229632099588756e-05,5.553210866523024e-05,1.0
20228,20228,쏙쏙/Noun,3,3,0,5.5574080248971876e-05,2.2212843466092093e-05,1.0
20229,20229,사체/Noun,3,0,3,2.2229632099588756e-05,5.553210866523024e-05,1.0
20230,20230,"10,000원/Number",3,0,3,2.2229632099588756e-05,5.553210866523024e-05,1.0
20231,20231,모친/Noun,3,0,3,2.2229632099588756e-05,5.553210866523024e-05,1.0
20232,20232,혼잣말/Noun,3,0,3,2.2229632099588756e-05,5.553210866523024e-05,1.0
20233,20233,느무느무/Noun,3,3,0,5.5574080248971876e-05,2.2212843466092093e-05,1.0
20234,20234,칭샤/Noun,3,3,0,5.5574080248971876e-05,2.2212843466092093e-05,1.0
20235,20235,하드디스크/Noun,3,0,3,2.2229632099588756e-05,5.553210866523024e-05,1.0
20236,20236,오경이/Noun,3,0,3,2.2229632099588756e-05,5.553210866523024e-05,1.0
20237,20237,~~~~!/Punctuation,3,3,0,5.5574080248971876e-05,2.2212843466092093e-05,1.0
20238,20238,일회용/Noun,3,0,3,2.2229632099588756e-05,5.553210866523024e-05,1.0
20239,20239,파마머리/Noun,3,0,3,2.2229632099588756e-05,5.553210866523024e-05,1.0
20240,20240,안산/Noun,3,0,3,2.2229632099588756e-05,5.553210866523024e-05,1.0
20241,20241,보톡스/Noun,3,0,3,2.2229632099588756e-05,5.553210866523024e-05,1.0
20242,20242,쓰랙/Noun,3,0,3,2.2229632099588756e-05,5.553210866523024e-05,1.0
20243,20243,바바리안/Noun,3,0,3,2.2229632099588756e-05,5.553210866523024e-05,1.0
20244,20244,5등/Number,3,3,0,5.5574080248971876e-05,2.2212843466092093e-05,1.0
20245,20245,행동거지/Noun,3,0,3,2.2229632099588756e-05,5.553210866523024e-05,1.0
20246,20246,원레/Noun,3,3,0,5.5574080248971876e-05,2.2212843466092093e-05,1.0
20247,20247,파손/Noun,3,0,3,2.2229632099588756e-05,5.553210866523024e-05,1.0
20248,20248,훤하/Noun,3,0,3,2.2229632099588756e-05,5.553210866523024e-05,1.0
20249,20249,awesome/Alpha,3,3,0,5.5574080248971876e-05,2.2212843466092093e-05,1.0
20250,20250,화단/Noun,3,0,3,2.2229632099588756e-05,5.553210866523024e-05,1.0
20251,20251,즉사/Noun,3,0,3,2.2229632099588756e-05,5.553210866523024e-05,1.0
20252,20252,~>/Punctuation,3,3,0,5.5574080248971876e-05,2.2212843466092093e-05,1.0
20253,20253,+.+/Punctuation,3,3,0,5.5574080248971876e-05,2.2212843466092093e-05,1.0
20254,20254,3000/Number,3,0,3,2.2229632099588756e-05,5.553210866523024e-05,1.0
20255,20255,미어캣/Noun,3,3,0,5.5574080248971876e-05,2.2212843466092093e-05,1.0
20256,20256,1989년/Number,3,3,0,5.5574080248971876e-05,2.2212843466092093e-05,1.0
20257,20257,사류/Noun,3,0,3,2.2229632099588756e-05,5.553210866523024e-05,1.0
20258,20258,마흔/Modifier,3,3,0,5.5574080248971876e-05,2.2212843466092093e-05,1.0
20259,20259,쥰세이/Noun,3,3,0,5.5574080248971876e-05,2.2212843466092093e-05,1.0
20260,20260,까지보다가/Foreign,3,0,3,2.2229632099588756e-05,5.553210866523024e-05,1.0
20261,20261,에이브릴라빈/Noun,3,0,3,2.2229632099588756e-05,5.553210866523024e-05,1.0
20262,20262,반군/Noun,3,3,0,5.5574080248971876e-05,2.2212843466092093e-05,1.0
20263,20263,알러뷰/Noun,3,3,0,5.5574080248971876e-05,2.2212843466092093e-05,1.0
20264,20264,규현/Noun,3,0,3,2.2229632099588756e-05,5.553210866523024e-05,1.0
20265,20265,김국진/Noun,3,0,3,2.2229632099588756e-05,5.553210866523024e-05,1.0
20266,20266,파문/Noun,3,3,0,5.5574080248971876e-05,2.2212843466092093e-05,1.0
20267,20267,올드해/Noun,3,0,3,2.2229632099588756e-05,5.553210866523024e-05,1.0
20268,20268,원형/Noun,3,3,0,5.5574080248971876e-05,2.2212843466092093e-05,1.0
20269,20269,노오/Noun,3,0,3,2.2229632099588756e-05,5.553210866523024e-05,1.0
20270,20270,동대문/Noun,3,0,3,2.2229632099588756e-05,5.553210866523024e-05,1.0
20271,20271,도난/Noun,3,0,3,2.2229632099588756e-05,5.553210866523024e-05,1.0
20272,20272,천만원/Noun,3,0,3,2.2229632099588756e-05,5.553210866523024e-05,1.0
20273,20273,엄는/Noun,3,0,3,2.2229632099588756e-05,5.553210866523024e-05,1.0
20274,20274,꼬시/Noun,3,0,3,2.2229632099588756e-05,5.553210866523024e-05,1.0
20275,20275,것입/Noun,3,0,3,2.2229632099588756e-05,5.553210866523024e-05,1.0
20276,20276,~^_^/Punctuation,3,3,0,5.5574080248971876e-05,2.2212843466092093e-05,1.0
20277,20277,미래세/Noun,3,3,0,5.5574080248971876e-05,2.2212843466092093e-05,1.0
20278,20278,한하유/Noun,3,3,0,5.5574080248971876e-05,2.2212843466092093e-05,1.0
20279,20279,3~4년/Number,3,0,3,2.2229632099588756e-05,5.553210866523024e-05,1.0
20280,20280,엄숙하다/Adjective,3,3,0,5.5574080248971876e-05,2.2212843466092093e-05,1.0
20281,20281,한도/Noun,3,0,3,2.2229632099588756e-05,5.553210866523024e-05,1.0
20282,20282,에스프레소/Noun,3,3,0,5.5574080248971876e-05,2.2212843466092093e-05,1.0
20283,20283,호텔리어/Noun,3,0,3,2.2229632099588756e-05,5.553210866523024e-05,1.0
20284,20284,곰신/Noun,3,3,0,5.5574080248971876e-05,2.2212843466092093e-05,1.0
20285,20285,막시무스/Noun,3,3,0,5.5574080248971876e-05,2.2212843466092093e-05,1.0
20286,20286,4등/Number,3,0,3,2.2229632099588756e-05,5.553210866523024e-05,1.0
20287,20287,깨닭/Noun,3,0,3,2.2229632099588756e-05,5.553210866523024e-05,1.0
20288,20288,애틋/Noun,3,3,0,5.5574080248971876e-05,2.2212843466092093e-05,1.0
20289,20289,호환/Noun,3,0,3,2.2229632099588756e-05,5.553210866523024e-05,1.0
20290,20290,ufo/Alpha,3,0,3,2.2229632099588756e-05,5.553210866523024e-05,1.0
20291,20291,될껄/Noun,3,0,3,2.2229632099588756e-05,5.553210866523024e-05,1.0
20292,20292,HBO/Alpha,3,3,0,5.5574080248971876e-05,2.2212843466092093e-05,1.0
20293,20293,장량/Noun,3,0,3,2.2229632099588756e-05,5.553210866523024e-05,1.0
20294,20294,오디세이/Noun,3,3,0,5.5574080248971876e-05,2.2212843466092093e-05,1.0
20295,20295,단수/Noun,3,0,3,2.2229632099588756e-05,5.553210866523024e-05,1.0
20296,20296,궁리/Noun,3,0,3,2.2229632099588756e-05,5.553210866523024e-05,1.0
20297,20297,르망/Noun,3,0,3,2.2229632099588756e-05,5.553210866523024e-05,1.0
20298,20298,500억/Number,3,0,3,2.2229632099588756e-05,5.553210866523024e-05,1.0
20299,20299,미도리/Noun,3,0,3,2.2229632099588756e-05,5.553210866523024e-05,1.0
20300,20300,무가치/Noun,3,0,3,2.2229632099588756e-05,5.553210866523024e-05,1.0
20301,20301,유키오/Noun,3,3,0,5.5574080248971876e-05,2.2212843466092093e-05,1.0
20302,20302,묘기/Noun,3,0,3,2.2229632099588756e-05,5.553210866523024e-05,1.0
20303,20303,여캐/Noun,3,3,0,5.5574080248971876e-05,2.2212843466092093e-05,1.0
20304,20304,Le/Alpha,3,3,0,5.5574080248971876e-05,2.2212843466092093e-05,1.0
20305,20305,~@.@/Punctuation,3,0,3,2.2229632099588756e-05,5.553210866523024e-05,1.0
20306,20306,Up/Alpha,3,3,0,5.5574080248971876e-05,2.2212843466092093e-05,1.0
20307,20307,나찌/Noun,3,0,3,2.2229632099588756e-05,5.553210866523024e-05,1.0
20308,20308,애등/Noun,3,3,0,5.5574080248971876e-05,2.2212843466092093e-05,1.0
20309,20309,산업화/Noun,3,3,0,5.5574080248971876e-05,2.2212843466092093e-05,1.0
20310,20310,일련/Noun,3,0,3,2.2229632099588756e-05,5.553210866523024e-05,1.0
20311,20311,전으로/Foreign,3,0,3,2.2229632099588756e-05,5.553210866523024e-05,1.0
20312,20312,개리/Noun,3,3,0,5.5574080248971876e-05,2.2212843466092093e-05,1.0
20313,20313,years/Alpha,3,3,0,5.5574080248971876e-05,2.2212843466092093e-05,1.0
20314,20314,문서/Noun,3,0,3,2.2229632099588756e-05,5.553210866523024e-05,1.0
20315,20315,외주/Noun,3,0,3,2.2229632099588756e-05,5.553210866523024e-05,1.0
20316,20316,이호영/Noun,3,3,0,5.5574080248971876e-05,2.2212843466092093e-05,1.0
20317,20317,레이어/Noun,3,3,0,5.5574080248971876e-05,2.2212843466092093e-05,1.0
20318,20318,야오이/Noun,3,0,3,2.2229632099588756e-05,5.553210866523024e-05,1.0
20319,20319,싸리/Noun,3,0,3,2.2229632099588756e-05,5.553210866523024e-05,1.0
20320,20320,job/Alpha,3,3,0,5.5574080248971876e-05,2.2212843466092093e-05,1.0
20321,20321,득도/Noun,3,0,3,2.2229632099588756e-05,5.553210866523024e-05,1.0
20322,20322,페트/Noun,3,0,3,2.2229632099588756e-05,5.553210866523024e-05,1.0
20323,20323,동인녀/Noun,3,0,3,2.2229632099588756e-05,5.553210866523024e-05,1.0
20324,20324,지극/Noun,3,3,0,5.5574080248971876e-05,2.2212843466092093e-05,1.0
20325,20325,야매/Noun,3,0,3,2.2229632099588756e-05,5.553210866523024e-05,1.0
20326,20326,운전기사/Noun,3,0,3,2.2229632099588756e-05,5.553210866523024e-05,1.0
20327,20327,밤잠/Noun,3,3,0,5.5574080248971876e-05,2.2212843466092093e-05,1.0
20328,20328,줄창/Noun,3,0,3,2.2229632099588756e-05,5.553210866523024e-05,1.0
20329,20329,아잉/Exclamation,3,3,0,5.5574080248971876e-05,2.2212843466092093e-05,1.0
20330,20330,@@@/Punctuation,3,3,0,5.5574080248971876e-05,2.2212843466092093e-05,1.0
20331,20331,한낮/Noun,3,3,0,5.5574080248971876e-05,2.2212843466092093e-05,1.0
20332,20332,피시/Noun,3,0,3,2.2229632099588756e-05,5.553210866523024e-05,1.0
20333,20333,박인영/Noun,3,3,0,5.5574080248971876e-05,2.2212843466092093e-05,1.0
20334,20334,아웅산/Noun,3,3,0,5.5574080248971876e-05,2.2212843466092093e-05,1.0
20335,20335,평탄하다/Adjective,3,0,3,2.2229632099588756e-05,5.553210866523024e-05,1.0
20336,20336,공민왕/Noun,3,3,0,5.5574080248971876e-05,2.2212843466092093e-05,1.0
20337,20337,에이핑크/Noun,3,3,0,5.5574080248971876e-05,2.2212843466092093e-05,1.0
20338,20338,편집자/Noun,3,0,3,2.2229632099588756e-05,5.553210866523024e-05,1.0
20339,20339,3.2/Number,3,0,3,2.2229632099588756e-05,5.553210866523024e-05,1.0
20340,20340,입구/Noun,3,0,3,2.2229632099588756e-05,5.553210866523024e-05,1.0
20341,20341,융합/Noun,3,3,0,5.5574080248971876e-05,2.2212843466092093e-05,1.0
20342,20342,만들엇냐/Noun,3,0,3,2.2229632099588756e-05,5.553210866523024e-05,1.0
20343,20343,텐텐/Noun,3,3,0,5.5574080248971876e-05,2.2212843466092093e-05,1.0
20344,20344,8-90년/Number,3,3,0,5.5574080248971876e-05,2.2212843466092093e-05,1.0
20345,20345,흐규흐규/Noun,3,3,0,5.5574080248971876e-05,2.2212843466092093e-05,1.0
20346,20346,달후/Noun,3,0,3,2.2229632099588756e-05,5.553210866523024e-05,1.0
20347,20347,루트/Noun,3,0,3,2.2229632099588756e-05,5.553210866523024e-05,1.0
20348,20348,얼토/Noun,3,0,3,2.2229632099588756e-05,5.553210866523024e-05,1.0
20349,20349,아스라하다/Adjective,3,3,0,5.5574080248971876e-05,2.2212843466092093e-05,1.0
20350,20350,어수룩하다/Adjective,3,0,3,2.2229632099588756e-05,5.553210866523024e-05,1.0
20351,20351,황은정/Noun,3,0,3,2.2229632099588756e-05,5.553210866523024e-05,1.0
20352,20352,중국역사/Noun,3,0,3,2.2229632099588756e-05,5.553210866523024e-05,1.0
20353,20353,동북공정/Noun,3,0,3,2.2229632099588756e-05,5.553210866523024e-05,1.0
20354,20354,살리에리/Noun,3,3,0,5.5574080248971876e-05,2.2212843466092093e-05,1.0
20355,20355,구본승/Noun,3,0,3,2.2229632099588756e-05,5.553210866523024e-05,1.0
20356,20356,그리샴/Noun,3,0,3,2.2229632099588756e-05,5.553210866523024e-05,1.0
20357,20357,냄비/Noun,3,0,3,2.2229632099588756e-05,5.553210866523024e-05,1.0
20358,20358,짜장/Noun,3,0,3,2.2229632099588756e-05,5.553210866523024e-05,1.0
20359,20359,이그리/Noun,3,0,3,2.2229632099588756e-05,5.553210866523024e-05,1.0
20360,20360,윈프리/Noun,3,3,0,5.5574080248971876e-05,2.2212843466092093e-05,1.0
20361,20361,오프라/Noun,3,3,0,5.5574080248971876e-05,2.2212843466092093e-05,1.0
20362,20362,질소/Noun,3,0,3,2.2229632099588756e-05,5.553210866523024e-05,1.0
20363,20363,염복/Noun,3,3,0,5.5574080248971876e-05,2.2212843466092093e-05,1.0
20364,20364,수수께끼/Noun,3,0,3,2.2229632099588756e-05,5.553210866523024e-05,1.0
20365,20365,폭주족/Noun,3,0,3,2.2229632099588756e-05,5.553210866523024e-05,1.0
20366,20366,카게무샤/Noun,3,3,0,5.5574080248971876e-05,2.2212843466092093e-05,1.0
20367,20367,김경탁/Noun,3,3,0,5.5574080248971876e-05,2.2212843466092093e-05,1.0
20368,20368,구질구질/Noun,3,0,3,2.2229632099588756e-05,5.553210866523024e-05,1.0
20369,20369,대대손손/Noun,3,3,0,5.5574080248971876e-05,2.2212843466092093e-05,1.0
20370,20370,암탉/Noun,3,0,3,2.2229632099588756e-05,5.553210866523024e-05,1.0
20371,20371,개쒸레기/Noun,3,0,3,2.2229632099588756e-05,5.553210866523024e-05,1.0
20372,20372,류시원/Noun,3,0,3,2.2229632099588756e-05,5.553210866523024e-05,1.0
20373,20373,유가족/Noun,3,0,3,2.2229632099588756e-05,5.553210866523024e-05,1.0
20374,20374,이기용/Noun,3,0,3,2.2229632099588756e-05,5.553210866523024e-05,1.0
20375,20375,나주고/Noun,3,0,3,2.2229632099588756e-05,5.553210866523024e-05,1.0
20376,20376,인물관계도/Noun,3,0,3,2.2229632099588756e-05,5.553210866523024e-05,1.0
20377,20377,출판사/Noun,3,0,3,2.2229632099588756e-05,5.553210866523024e-05,1.0
20378,20378,출입/Noun,3,0,3,2.2229632099588756e-05,5.553210866523024e-05,1.0
20379,20379,서장/Noun,3,0,3,2.2229632099588756e-05,5.553210866523024e-05,1.0
20380,20380,hot/Alpha,3,0,3,2.2229632099588756e-05,5.553210866523024e-05,1.0
20381,20381,료마/Noun,3,3,0,5.5574080248971876e-05,2.2212843466092093e-05,1.0
20382,20382,강태공/Noun,3,0,3,2.2229632099588756e-05,5.553210866523024e-05,1.0
20383,20383,주술/Noun,3,0,3,2.2229632099588756e-05,5.553210866523024e-05,1.0
20384,20384,악쓰다/Verb,3,0,3,2.2229632099588756e-05,5.553210866523024e-05,1.0
20385,20385,퐁당/Noun,3,3,0,5.5574080248971876e-05,2.2212843466092093e-05,1.0
20386,20386,보미/Noun,3,3,0,5.5574080248971876e-05,2.2212843466092093e-05,1.0
20387,20387,지출/Noun,3,0,3,2.2229632099588756e-05,5.553210866523024e-05,1.0
20388,20388,은위/Noun,3,3,0,5.5574080248971876e-05,2.2212843466092093e-05,1.0
20389,20389,밑밥/Noun,3,0,3,2.2229632099588756e-05,5.553210866523024e-05,1.0
20390,20390,라이드/Noun,3,3,0,5.5574080248971876e-05,2.2212843466092093e-05,1.0
20391,20391,퀀시/Noun,3,0,3,2.2229632099588756e-05,5.553210866523024e-05,1.0
20392,20392,라핀/Noun,3,3,0,5.5574080248971876e-05,2.2212843466092093e-05,1.0
20393,20393,도정/Noun,3,2,1,4.445926419917751e-05,3.331926519913814e-05,0.6666666666666666
20394,20394,아비게일/Noun,3,2,1,4.445926419917751e-05,3.331926519913814e-05,0.6666666666666666
20395,20395,brilliant/Alpha,3,2,1,4.445926419917751e-05,3.331926519913814e-05,0.6666666666666666
20396,20396,운남고/Noun,3,2,1,4.445926419917751e-05,3.331926519913814e-05,0.6666666666666666
20397,20397,연옥/Noun,3,2,1,4.445926419917751e-05,3.331926519913814e-05,0.6666666666666666
20398,20398,에그/Exclamation,3,1,2,3.334444814938313e-05,4.4425686932184186e-05,0.6666666666666666
20399,20399,무적자/Noun,3,1,2,3.334444814938313e-05,4.4425686932184186e-05,0.6666666666666666
20400,20400,법원/Noun,3,1,2,3.334444814938313e-05,4.4425686932184186e-05,0.6666666666666666
20401,20401,1920년/Number,3,2,1,4.445926419917751e-05,3.331926519913814e-05,0.6666666666666666
20402,20402,ER/Alpha,3,2,1,4.445926419917751e-05,3.331926519913814e-05,0.6666666666666666
20403,20403,존레넌/Noun,3,2,1,4.445926419917751e-05,3.331926519913814e-05,0.6666666666666666
20404,20404,심연/Noun,3,2,1,4.445926419917751e-05,3.331926519913814e-05,0.6666666666666666
20405,20405,바이킹/Noun,3,2,1,4.445926419917751e-05,3.331926519913814e-05,0.6666666666666666
20406,20406,묵인/Noun,3,1,2,3.334444814938313e-05,4.4425686932184186e-05,0.6666666666666666
20407,20407,비크티니/Noun,3,2,1,4.445926419917751e-05,3.331926519913814e-05,0.6666666666666666
20408,20408,쏭/Noun,3,2,1,4.445926419917751e-05,3.331926519913814e-05,0.6666666666666666
20409,20409,이성진/Noun,3,2,1,4.445926419917751e-05,3.331926519913814e-05,0.6666666666666666
20410,20410,..//Punctuation,3,1,2,3.334444814938313e-05,4.4425686932184186e-05,0.6666666666666666
20411,20411,더기/Noun,3,2,1,4.445926419917751e-05,3.331926519913814e-05,0.6666666666666666
20412,20412,셩/Noun,3,2,1,4.445926419917751e-05,3.331926519913814e-05,0.6666666666666666
20413,20413,젝스키스/Noun,3,1,2,3.334444814938313e-05,4.4425686932184186e-05,0.6666666666666666
20414,20414,트포/Noun,3,2,1,4.445926419917751e-05,3.331926519913814e-05,0.6666666666666666
20415,20415,치/Exclamation,3,1,2,3.334444814938313e-05,4.4425686932184186e-05,0.6666666666666666
20416,20416,비욘세/Noun,3,2,1,4.445926419917751e-05,3.331926519913814e-05,0.6666666666666666
20417,20417,배추/Noun,3,1,2,3.334444814938313e-05,4.4425686932184186e-05,0.6666666666666666
20418,20418,연씨/Noun,3,2,1,4.445926419917751e-05,3.331926519913814e-05,0.6666666666666666
20419,20419,ㅋㅋㄲ/KoreanParticle,3,1,2,3.334444814938313e-05,4.4425686932184186e-05,0.6666666666666666
20420,20420,쪽국/Noun,3,1,2,3.334444814938313e-05,4.4425686932184186e-05,0.6666666666666666
20421,20421,파지/Noun,3,2,1,4.445926419917751e-05,3.331926519913814e-05,0.6666666666666666
20422,20422,미국드라마/Noun,3,1,2,3.334444814938313e-05,4.4425686932184186e-05,0.6666666666666666
20423,20423,하주희/Noun,3,1,2,3.334444814938313e-05,4.4425686932184186e-05,0.6666666666666666
20424,20424,퓨처/Noun,3,2,1,4.445926419917751e-05,3.331926519913814e-05,0.6666666666666666
20425,20425,범한/Noun,3,1,2,3.334444814938313e-05,4.4425686932184186e-05,0.6666666666666666
20426,20426,전원주/Noun,3,2,1,4.445926419917751e-05,3.331926519913814e-05,0.6666666666666666
20427,20427,샘물/Noun,3,2,1,4.445926419917751e-05,3.331926519913814e-05,0.6666666666666666
20428,20428,민영/Noun,3,2,1,4.445926419917751e-05,3.331926519913814e-05,0.6666666666666666
20429,20429,히스테리/Noun,3,2,1,4.445926419917751e-05,3.331926519913814e-05,0.6666666666666666
20430,20430,;;;;;;;;;;;;;;;;;/Punctuation,3,1,2,3.334444814938313e-05,4.4425686932184186e-05,0.6666666666666666
20431,20431,첫키스/Noun,3,2,1,4.445926419917751e-05,3.331926519913814e-05,0.6666666666666666
20432,20432,구차하다/Adjective,3,1,2,3.334444814938313e-05,4.4425686932184186e-05,0.6666666666666666
20433,20433,싱글맘/Noun,3,1,2,3.334444814938313e-05,4.4425686932184186e-05,0.6666666666666666
20434,20434,사견/Noun,3,1,2,3.334444814938313e-05,4.4425686932184186e-05,0.6666666666666666
20435,20435,공화국/Noun,3,2,1,4.445926419917751e-05,3.331926519913814e-05,0.6666666666666666
20436,20436,돌진/Noun,3,1,2,3.334444814938313e-05,4.4425686932184186e-05,0.6666666666666666
20437,20437,강민경/Noun,3,1,2,3.334444814938313e-05,4.4425686932184186e-05,0.6666666666666666
20438,20438,봤느데/Noun,3,1,2,3.334444814938313e-05,4.4425686932184186e-05,0.6666666666666666
20439,20439,개국/Noun,3,1,2,3.334444814938313e-05,4.4425686932184186e-05,0.6666666666666666
20440,20440,바토리/Noun,3,1,2,3.334444814938313e-05,4.4425686932184186e-05,0.6666666666666666
20441,20441,소양/Noun,3,1,2,3.334444814938313e-05,4.4425686932184186e-05,0.6666666666666666
20442,20442,잉글랜드/Noun,3,1,2,3.334444814938313e-05,4.4425686932184186e-05,0.6666666666666666
20443,20443,김광규/Noun,3,1,2,3.334444814938313e-05,4.4425686932184186e-05,0.6666666666666666
20444,20444,쩡쩡하다/Adjective,3,2,1,4.445926419917751e-05,3.331926519913814e-05,0.6666666666666666
20445,20445,송전탑/Noun,3,1,2,3.334444814938313e-05,4.4425686932184186e-05,0.6666666666666666
20446,20446,겨를/Noun,3,2,1,4.445926419917751e-05,3.331926519913814e-05,0.6666666666666666
20447,20447,OF/Alpha,3,2,1,4.445926419917751e-05,3.331926519913814e-05,0.6666666666666666
20448,20448,스튜/Noun,3,1,2,3.334444814938313e-05,4.4425686932184186e-05,0.6666666666666666
20449,20449,멸/Noun,3,1,2,3.334444814938313e-05,4.4425686932184186e-05,0.6666666666666666
20450,20450,알라신/Noun,3,1,2,3.334444814938313e-05,4.4425686932184186e-05,0.6666666666666666
20451,20451,강점/Noun,3,2,1,4.445926419917751e-05,3.331926519913814e-05,0.6666666666666666
20452,20452,협/Noun,3,1,2,3.334444814938313e-05,4.4425686932184186e-05,0.6666666666666666
20453,20453,이자웅/Noun,3,2,1,4.445926419917751e-05,3.331926519913814e-05,0.6666666666666666
20454,20454,경위/Noun,3,2,1,4.445926419917751e-05,3.331926519913814e-05,0.6666666666666666
20455,20455,서덜랜드/Noun,3,1,2,3.334444814938313e-05,4.4425686932184186e-05,0.6666666666666666
20456,20456,옆구리/Noun,3,2,1,4.445926419917751e-05,3.331926519913814e-05,0.6666666666666666
20457,20457,하얀색/Noun,3,1,2,3.334444814938313e-05,4.4425686932184186e-05,0.6666666666666666
20458,20458,이승만/Noun,3,1,2,3.334444814938313e-05,4.4425686932184186e-05,0.6666666666666666
20459,20459,왕성/Noun,3,1,2,3.334444814938313e-05,4.4425686932184186e-05,0.6666666666666666
20460,20460,ㅜㅜㅎ/KoreanParticle,3,2,1,4.445926419917751e-05,3.331926519913814e-05,0.6666666666666666
20461,20461,마카오/Noun,3,2,1,4.445926419917751e-05,3.331926519913814e-05,0.6666666666666666
20462,20462,노비/Noun,3,1,2,3.334444814938313e-05,4.4425686932184186e-05,0.6666666666666666
20463,20463,색상/Noun,3,1,2,3.334444814938313e-05,4.4425686932184186e-05,0.6666666666666666
20464,20464,플래시백/Noun,3,1,2,3.334444814938313e-05,4.4425686932184186e-05,0.6666666666666666
20465,20465,다도/Noun,3,1,2,3.334444814938313e-05,4.4425686932184186e-05,0.6666666666666666
20466,20466,Shit/Alpha,3,1,2,3.334444814938313e-05,4.4425686932184186e-05,0.6666666666666666
20467,20467,만우절/Noun,3,1,2,3.334444814938313e-05,4.4425686932184186e-05,0.6666666666666666
20468,20468,down/Alpha,3,2,1,4.445926419917751e-05,3.331926519913814e-05,0.6666666666666666
20469,20469,황실/Noun,3,1,2,3.334444814938313e-05,4.4425686932184186e-05,0.6666666666666666
20470,20470,스케치/Noun,3,1,2,3.334444814938313e-05,4.4425686932184186e-05,0.6666666666666666
20471,20471,드넓다/Adjective,3,2,1,4.445926419917751e-05,3.331926519913814e-05,0.6666666666666666
20472,20472,대오/Noun,3,2,1,4.445926419917751e-05,3.331926519913814e-05,0.6666666666666666
20473,20473,발끈/Noun,3,1,2,3.334444814938313e-05,4.4425686932184186e-05,0.6666666666666666
20474,20474,절름발/Noun,3,2,1,4.445926419917751e-05,3.331926519913814e-05,0.6666666666666666
20475,20475,중공업/Noun,3,1,2,3.334444814938313e-05,4.4425686932184186e-05,0.6666666666666666
20476,20476,호모포비아/Noun,3,2,1,4.445926419917751e-05,3.331926519913814e-05,0.6666666666666666
20477,20477,석상/Noun,3,1,2,3.334444814938313e-05,4.4425686932184186e-05,0.6666666666666666
20478,20478,오드/Noun,3,2,1,4.445926419917751e-05,3.331926519913814e-05,0.6666666666666666
20479,20479,67/Number,3,2,1,4.445926419917751e-05,3.331926519913814e-05,0.6666666666666666
20480,20480,카시오페아/Noun,3,2,1,4.445926419917751e-05,3.331926519913814e-05,0.6666666666666666
20481,20481,중간고사/Noun,3,2,1,4.445926419917751e-05,3.331926519913814e-05,0.6666666666666666
20482,20482,포위/Noun,3,2,1,4.445926419917751e-05,3.331926519913814e-05,0.6666666666666666
20483,20483,5.7/Number,3,2,1,4.445926419917751e-05,3.331926519913814e-05,0.6666666666666666
20484,20484,숀팬/Noun,3,2,1,4.445926419917751e-05,3.331926519913814e-05,0.6666666666666666
20485,20485,ㄴㅅ/KoreanParticle,3,2,1,4.445926419917751e-05,3.331926519913814e-05,0.6666666666666666
20486,20486,괜찬은듯/Noun,3,2,1,4.445926419917751e-05,3.331926519913814e-05,0.6666666666666666
20487,20487,(?)./Punctuation,3,1,2,3.334444814938313e-05,4.4425686932184186e-05,0.6666666666666666
20488,20488,하이텔/Noun,3,1,2,3.334444814938313e-05,4.4425686932184186e-05,0.6666666666666666
20489,20489,3%/Number,3,1,2,3.334444814938313e-05,4.4425686932184186e-05,0.6666666666666666
20490,20490,화씨/Noun,3,2,1,4.445926419917751e-05,3.331926519913814e-05,0.6666666666666666
20491,20491,성배/Noun,3,2,1,4.445926419917751e-05,3.331926519913814e-05,0.6666666666666666
20492,20492,-./Punctuation,3,2,1,4.445926419917751e-05,3.331926519913814e-05,0.6666666666666666
20493,20493,레이토/Noun,3,1,2,3.334444814938313e-05,4.4425686932184186e-05,0.6666666666666666
20494,20494,",....../Punctuation",3,1,2,3.334444814938313e-05,4.4425686932184186e-05,0.6666666666666666
20495,20495,말따/Noun,3,2,1,4.445926419917751e-05,3.331926519913814e-05,0.6666666666666666
20496,20496,15회/Number,3,2,1,4.445926419917751e-05,3.331926519913814e-05,0.6666666666666666
20497,20497,팝업/Noun,3,1,2,3.334444814938313e-05,4.4425686932184186e-05,0.6666666666666666
20498,20498,전구/Noun,3,2,1,4.445926419917751e-05,3.331926519913814e-05,0.6666666666666666
20499,20499,극소/Noun,3,1,2,3.334444814938313e-05,4.4425686932184186e-05,0.6666666666666666
20500,20500,유럽인/Noun,3,1,2,3.334444814938313e-05,4.4425686932184186e-05,0.6666666666666666
20501,20501,언짢다/Adjective,3,1,2,3.334444814938313e-05,4.4425686932184186e-05,0.6666666666666666
20502,20502,does/Alpha,3,2,1,4.445926419917751e-05,3.331926519913814e-05,0.6666666666666666
20503,20503,last/Alpha,3,1,2,3.334444814938313e-05,4.4425686932184186e-05,0.6666666666666666
20504,20504,통로/Noun,3,2,1,4.445926419917751e-05,3.331926519913814e-05,0.6666666666666666
20505,20505,종목/Noun,3,1,2,3.334444814938313e-05,4.4425686932184186e-05,0.6666666666666666
20506,20506,야후/Noun,3,2,1,4.445926419917751e-05,3.331926519913814e-05,0.6666666666666666
20507,20507,800억/Number,3,1,2,3.334444814938313e-05,4.4425686932184186e-05,0.6666666666666666
20508,20508,국사/Noun,3,1,2,3.334444814938313e-05,4.4425686932184186e-05,0.6666666666666666
20509,20509,남진/Noun,3,1,2,3.334444814938313e-05,4.4425686932184186e-05,0.6666666666666666
20510,20510,몰상식/Noun,3,2,1,4.445926419917751e-05,3.331926519913814e-05,0.6666666666666666
20511,20511,도플갱어/Noun,3,1,2,3.334444814938313e-05,4.4425686932184186e-05,0.6666666666666666
20512,20512,천왕/Noun,3,1,2,3.334444814938313e-05,4.4425686932184186e-05,0.6666666666666666
20513,20513,불장난/Noun,3,1,2,3.334444814938313e-05,4.4425686932184186e-05,0.6666666666666666
20514,20514,임지연/Noun,3,1,2,3.334444814938313e-05,4.4425686932184186e-05,0.6666666666666666
20515,20515,보탬/Noun,3,2,1,4.445926419917751e-05,3.331926519913814e-05,0.6666666666666666
20516,20516,625/Number,3,2,1,4.445926419917751e-05,3.331926519913814e-05,0.6666666666666666
20517,20517,로소/Noun,3,2,1,4.445926419917751e-05,3.331926519913814e-05,0.6666666666666666
20518,20518,불발/Noun,3,1,2,3.334444814938313e-05,4.4425686932184186e-05,0.6666666666666666
20519,20519,1-2/Number,3,2,1,4.445926419917751e-05,3.331926519913814e-05,0.6666666666666666
20520,20520,데츠/Noun,3,1,2,3.334444814938313e-05,4.4425686932184186e-05,0.6666666666666666
20521,20521,소말리아/Noun,3,2,1,4.445926419917751e-05,3.331926519913814e-05,0.6666666666666666
20522,20522,통령/Noun,3,2,1,4.445926419917751e-05,3.331926519913814e-05,0.6666666666666666
20523,20523,석현/Noun,3,1,2,3.334444814938313e-05,4.4425686932184186e-05,0.6666666666666666
20524,20524,엘리스/Noun,3,2,1,4.445926419917751e-05,3.331926519913814e-05,0.6666666666666666
20525,20525,데빌/Noun,3,2,1,4.445926419917751e-05,3.331926519913814e-05,0.6666666666666666
20526,20526,황해/Noun,3,2,1,4.445926419917751e-05,3.331926519913814e-05,0.6666666666666666
20527,20527,니니/Noun,3,1,2,3.334444814938313e-05,4.4425686932184186e-05,0.6666666666666666
20528,20528,미니어쳐/Noun,3,1,2,3.334444814938313e-05,4.4425686932184186e-05,0.6666666666666666
20529,20529,견자/Noun,3,1,2,3.334444814938313e-05,4.4425686932184186e-05,0.6666666666666666
20530,20530,리에티/Noun,3,1,2,3.334444814938313e-05,4.4425686932184186e-05,0.6666666666666666
20531,20531,한발/Adverb,3,2,1,4.445926419917751e-05,3.331926519913814e-05,0.6666666666666666
20532,20532,빵셔틀/Noun,3,1,2,3.334444814938313e-05,4.4425686932184186e-05,0.6666666666666666
20533,20533,분위/Noun,3,1,2,3.334444814938313e-05,4.4425686932184186e-05,0.6666666666666666
20534,20534,훨남/Noun,3,1,2,3.334444814938313e-05,4.4425686932184186e-05,0.6666666666666666
20535,20535,땅바닥/Noun,3,1,2,3.334444814938313e-05,4.4425686932184186e-05,0.6666666666666666
20536,20536,클림트/Noun,3,1,2,3.334444814938313e-05,4.4425686932184186e-05,0.6666666666666666
20537,20537,2천/Number,3,1,2,3.334444814938313e-05,4.4425686932184186e-05,0.6666666666666666
20538,20538,반문/Noun,3,2,1,4.445926419917751e-05,3.331926519913814e-05,0.6666666666666666
20539,20539,싱글즈/Noun,3,1,2,3.334444814938313e-05,4.4425686932184186e-05,0.6666666666666666
20540,20540,역기/Noun,3,2,1,4.445926419917751e-05,3.331926519913814e-05,0.6666666666666666
20541,20541,프레스티지/Noun,3,2,1,4.445926419917751e-05,3.331926519913814e-05,0.6666666666666666
20542,20542,한채아/Noun,3,2,1,4.445926419917751e-05,3.331926519913814e-05,0.6666666666666666
20543,20543,트레인스포팅/Noun,3,1,2,3.334444814938313e-05,4.4425686932184186e-05,0.6666666666666666
20544,20544,타이완/Noun,3,2,1,4.445926419917751e-05,3.331926519913814e-05,0.6666666666666666
20545,20545,맏/Noun,3,2,1,4.445926419917751e-05,3.331926519913814e-05,0.6666666666666666
20546,20546,하넹/Noun,3,2,1,4.445926419917751e-05,3.331926519913814e-05,0.6666666666666666
20547,20547,젖소/Noun,3,1,2,3.334444814938313e-05,4.4425686932184186e-05,0.6666666666666666
20548,20548,비속어/Noun,3,1,2,3.334444814938313e-05,4.4425686932184186e-05,0.6666666666666666
20549,20549,보병/Noun,3,2,1,4.445926419917751e-05,3.331926519913814e-05,0.6666666666666666
20550,20550,앳킨스/Noun,3,1,2,3.334444814938313e-05,4.4425686932184186e-05,0.6666666666666666
20551,20551,허리케인/Noun,3,1,2,3.334444814938313e-05,4.4425686932184186e-05,0.6666666666666666
20552,20552,데프콘/Noun,3,2,1,4.445926419917751e-05,3.331926519913814e-05,0.6666666666666666
20553,20553,찰흙/Noun,3,2,1,4.445926419917751e-05,3.331926519913814e-05,0.6666666666666666
20554,20554,전일/Noun,3,2,1,4.445926419917751e-05,3.331926519913814e-05,0.6666666666666666
20555,20555,-&/Punctuation,3,2,1,4.445926419917751e-05,3.331926519913814e-05,0.6666666666666666
20556,20556,연상연하/Noun,3,2,1,4.445926419917751e-05,3.331926519913814e-05,0.6666666666666666
20557,20557,중국집/Noun,3,2,1,4.445926419917751e-05,3.331926519913814e-05,0.6666666666666666
20558,20558,키티/Noun,3,2,1,4.445926419917751e-05,3.331926519913814e-05,0.6666666666666666
20559,20559,호빵/Noun,3,1,2,3.334444814938313e-05,4.4425686932184186e-05,0.6666666666666666
20560,20560,인동/Noun,3,1,2,3.334444814938313e-05,4.4425686932184186e-05,0.6666666666666666
20561,20561,구박/Noun,3,1,2,3.334444814938313e-05,4.4425686932184186e-05,0.6666666666666666
20562,20562,위정/Noun,3,2,1,4.445926419917751e-05,3.331926519913814e-05,0.6666666666666666
20563,20563,특수요원/Noun,3,2,1,4.445926419917751e-05,3.331926519913814e-05,0.6666666666666666
20564,20564,ㄱㅋ/KoreanParticle,3,2,1,4.445926419917751e-05,3.331926519913814e-05,0.6666666666666666
20565,20565,앞쪽/Noun,3,1,2,3.334444814938313e-05,4.4425686932184186e-05,0.6666666666666666
20566,20566,예스맨/Noun,3,1,2,3.334444814938313e-05,4.4425686932184186e-05,0.6666666666666666
20567,20567,참혹/Noun,3,2,1,4.445926419917751e-05,3.331926519913814e-05,0.6666666666666666
20568,20568,한씨/Noun,3,2,1,4.445926419917751e-05,3.331926519913814e-05,0.6666666666666666
20569,20569,데드풀/Noun,3,2,1,4.445926419917751e-05,3.331926519913814e-05,0.6666666666666666
20570,20570,무아/Noun,3,2,1,4.445926419917751e-05,3.331926519913814e-05,0.6666666666666666
20571,20571,톰형/Noun,3,2,1,4.445926419917751e-05,3.331926519913814e-05,0.6666666666666666
20572,20572,참견/Noun,3,1,2,3.334444814938313e-05,4.4425686932184186e-05,0.6666666666666666
20573,20573,오른/Modifier,3,2,1,4.445926419917751e-05,3.331926519913814e-05,0.6666666666666666
20574,20574,씨름/Noun,3,1,2,3.334444814938313e-05,4.4425686932184186e-05,0.6666666666666666
20575,20575,때아닌/Modifier,3,1,2,3.334444814938313e-05,4.4425686932184186e-05,0.6666666666666666
20576,20576,오지은/Noun,3,2,1,4.445926419917751e-05,3.331926519913814e-05,0.6666666666666666
20577,20577,남짓하다/Adjective,3,1,2,3.334444814938313e-05,4.4425686932184186e-05,0.6666666666666666
20578,20578,마르고/Noun,3,2,1,4.445926419917751e-05,3.331926519913814e-05,0.6666666666666666
20579,20579,동양철학/Noun,3,2,1,4.445926419917751e-05,3.331926519913814e-05,0.6666666666666666
20580,20580,110분/Number,3,1,2,3.334444814938313e-05,4.4425686932184186e-05,0.6666666666666666
20581,20581,집필/Noun,3,1,2,3.334444814938313e-05,4.4425686932184186e-05,0.6666666666666666
20582,20582,여친소/Noun,3,1,2,3.334444814938313e-05,4.4425686932184186e-05,0.6666666666666666
20583,20583,중국본토/Noun,3,1,2,3.334444814938313e-05,4.4425686932184186e-05,0.6666666666666666
20584,20584,조씨/Noun,3,1,2,3.334444814938313e-05,4.4425686932184186e-05,0.6666666666666666
20585,20585,오스트레일리아/Noun,3,2,1,4.445926419917751e-05,3.331926519913814e-05,0.6666666666666666
20586,20586,빗겨/Noun,3,2,1,4.445926419917751e-05,3.331926519913814e-05,0.6666666666666666
20587,20587,할떄/Noun,3,2,1,4.445926419917751e-05,3.331926519913814e-05,0.6666666666666666
20588,20588,본자/Noun,3,2,1,4.445926419917751e-05,3.331926519913814e-05,0.6666666666666666
20589,20589,",'/Punctuation",3,1,2,3.334444814938313e-05,4.4425686932184186e-05,0.6666666666666666
20590,20590,세일러문/Noun,3,1,2,3.334444814938313e-05,4.4425686932184186e-05,0.6666666666666666
20591,20591,편두통/Noun,3,1,2,3.334444814938313e-05,4.4425686932184186e-05,0.6666666666666666
20592,20592,5시간/Number,3,2,1,4.445926419917751e-05,3.331926519913814e-05,0.6666666666666666
20593,20593,패틴슨때문/Noun,3,1,2,3.334444814938313e-05,4.4425686932184186e-05,0.6666666666666666
20594,20594,2001/Number,3,2,1,4.445926419917751e-05,3.331926519913814e-05,0.6666666666666666
20595,20595,음지/Noun,3,1,2,3.334444814938313e-05,4.4425686932184186e-05,0.6666666666666666
20596,20596,피티/Noun,3,2,1,4.445926419917751e-05,3.331926519913814e-05,0.6666666666666666
20597,20597,우/Noun,3,2,1,4.445926419917751e-05,3.331926519913814e-05,0.6666666666666666
20598,20598,씹덕/Noun,3,1,2,3.334444814938313e-05,4.4425686932184186e-05,0.6666666666666666
20599,20599,좇는/Noun,3,2,1,4.445926419917751e-05,3.331926519913814e-05,0.6666666666666666
20600,20600,시끌벅적/Adverb,3,2,1,4.445926419917751e-05,3.331926519913814e-05,0.6666666666666666
20601,20601,도청/Noun,3,2,1,4.445926419917751e-05,3.331926519913814e-05,0.6666666666666666
20602,20602,중얼거리다/Verb,3,2,1,4.445926419917751e-05,3.331926519913814e-05,0.6666666666666666
20603,20603,어트케/Noun,3,1,2,3.334444814938313e-05,4.4425686932184186e-05,0.6666666666666666
20604,20604,콘스탄틴/Noun,3,1,2,3.334444814938313e-05,4.4425686932184186e-05,0.6666666666666666
20605,20605,보련/Noun,3,1,2,3.334444814938313e-05,4.4425686932184186e-05,0.6666666666666666
20606,20606,윤후/Noun,3,1,2,3.334444814938313e-05,4.4425686932184186e-05,0.6666666666666666
20607,20607,노루/Noun,3,2,1,4.445926419917751e-05,3.331926519913814e-05,0.6666666666666666
20608,20608,.-_-;;/Punctuation,3,1,2,3.334444814938313e-05,4.4425686932184186e-05,0.6666666666666666
20609,20609,주문진/Noun,3,2,1,4.445926419917751e-05,3.331926519913814e-05,0.6666666666666666
20610,20610,넛/Noun,3,2,1,4.445926419917751e-05,3.331926519913814e-05,0.6666666666666666
20611,20611,국딩때/Noun,3,2,1,4.445926419917751e-05,3.331926519913814e-05,0.6666666666666666
20612,20612,스트리트파이터/Noun,3,1,2,3.334444814938313e-05,4.4425686932184186e-05,0.6666666666666666
20613,20613,렌코/Noun,3,2,1,4.445926419917751e-05,3.331926519913814e-05,0.6666666666666666
20614,20614,쿠릴/Noun,3,2,1,4.445926419917751e-05,3.331926519913814e-05,0.6666666666666666
20615,20615,파이스토리/Noun,3,2,1,4.445926419917751e-05,3.331926519913814e-05,0.6666666666666666
20616,20616,쿨러닝/Noun,3,1,2,3.334444814938313e-05,4.4425686932184186e-05,0.6666666666666666
20617,20617,알못/Noun,3,1,2,3.334444814938313e-05,4.4425686932184186e-05,0.6666666666666666
20618,20618,자넷/Noun,3,2,1,4.445926419917751e-05,3.331926519913814e-05,0.6666666666666666
20619,20619,상대편/Noun,3,1,2,3.334444814938313e-05,4.4425686932184186e-05,0.6666666666666666
20620,20620,계성은/Noun,3,1,2,3.334444814938313e-05,4.4425686932184186e-05,0.6666666666666666
20621,20621,김부선/Noun,3,2,1,4.445926419917751e-05,3.331926519913814e-05,0.6666666666666666
20622,20622,비법/Noun,3,2,1,4.445926419917751e-05,3.331926519913814e-05,0.6666666666666666
20623,20623,용한/Noun,3,1,2,3.334444814938313e-05,4.4425686932184186e-05,0.6666666666666666
20624,20624,효언니/Noun,3,2,1,4.445926419917751e-05,3.331926519913814e-05,0.6666666666666666
20625,20625,맥커너히/Noun,3,2,1,4.445926419917751e-05,3.331926519913814e-05,0.6666666666666666
20626,20626,미리보기/Noun,3,1,2,3.334444814938313e-05,4.4425686932184186e-05,0.6666666666666666
20627,20627,~;/Punctuation,3,1,2,3.334444814938313e-05,4.4425686932184186e-05,0.6666666666666666
20628,20628,베개/Noun,3,2,1,4.445926419917751e-05,3.331926519913814e-05,0.6666666666666666
20629,20629,"^,^/Punctuation",3,2,1,4.445926419917751e-05,3.331926519913814e-05,0.6666666666666666
20630,20630,경건하다/Adjective,3,2,1,4.445926419917751e-05,3.331926519913814e-05,0.6666666666666666
20631,20631,마리화나/Noun,3,2,1,4.445926419917751e-05,3.331926519913814e-05,0.6666666666666666
20632,20632,○○○/Foreign,3,1,2,3.334444814938313e-05,4.4425686932184186e-05,0.6666666666666666
20633,20633,완장/Noun,3,1,2,3.334444814938313e-05,4.4425686932184186e-05,0.6666666666666666
20634,20634,ㅠㅡ/KoreanParticle,3,2,1,4.445926419917751e-05,3.331926519913814e-05,0.6666666666666666
20635,20635,국밥/Noun,3,1,2,3.334444814938313e-05,4.4425686932184186e-05,0.6666666666666666
20636,20636,그렁/Adverb,3,2,1,4.445926419917751e-05,3.331926519913814e-05,0.6666666666666666
20637,20637,바람소리/Noun,3,1,2,3.334444814938313e-05,4.4425686932184186e-05,0.6666666666666666
20638,20638,가마/Noun,3,1,2,3.334444814938313e-05,4.4425686932184186e-05,0.6666666666666666
20639,20639,혹사/Noun,3,2,1,4.445926419917751e-05,3.331926519913814e-05,0.6666666666666666
20640,20640,서원/Noun,3,1,2,3.334444814938313e-05,4.4425686932184186e-05,0.6666666666666666
20641,20641,하겟/Noun,3,1,2,3.334444814938313e-05,4.4425686932184186e-05,0.6666666666666666
20642,20642,겟/PreEomi,3,2,1,4.445926419917751e-05,3.331926519913814e-05,0.6666666666666666
20643,20643,실록/Noun,3,2,1,4.445926419917751e-05,3.331926519913814e-05,0.6666666666666666
20644,20644,어쩜그리/Noun,3,2,1,4.445926419917751e-05,3.331926519913814e-05,0.6666666666666666
20645,20645,발싸개/Noun,3,1,2,3.334444814938313e-05,4.4425686932184186e-05,0.6666666666666666
20646,20646,박원상/Noun,3,1,2,3.334444814938313e-05,4.4425686932184186e-05,0.6666666666666666
20647,20647,배구공/Noun,3,2,1,4.445926419917751e-05,3.331926519913814e-05,0.6666666666666666
20648,20648,당구공/Noun,3,1,2,3.334444814938313e-05,4.4425686932184186e-05,0.6666666666666666
20649,20649,"!!!!""/Punctuation",3,1,2,3.334444814938313e-05,4.4425686932184186e-05,0.6666666666666666
20650,20650,박달/Noun,3,2,1,4.445926419917751e-05,3.331926519913814e-05,0.6666666666666666
20651,20651,월리스/Noun,3,1,2,3.334444814938313e-05,4.4425686932184186e-05,0.6666666666666666
20652,20652,자립/Noun,3,2,1,4.445926419917751e-05,3.331926519913814e-05,0.6666666666666666
20653,20653,총성/Noun,3,2,1,4.445926419917751e-05,3.331926519913814e-05,0.6666666666666666
20654,20654,목구멍/Noun,3,1,2,3.334444814938313e-05,4.4425686932184186e-05,0.6666666666666666
20655,20655,노주현/Noun,3,2,1,4.445926419917751e-05,3.331926519913814e-05,0.6666666666666666
20656,20656,~~~~~~~~~~~~~~/Punctuation,3,2,1,4.445926419917751e-05,3.331926519913814e-05,0.6666666666666666
20657,20657,기울다/Verb,3,1,2,3.334444814938313e-05,4.4425686932184186e-05,0.6666666666666666
20658,20658,ㅎㅁ/KoreanParticle,3,2,1,4.445926419917751e-05,3.331926519913814e-05,0.6666666666666666
20659,20659,뮤지/Noun,3,2,1,4.445926419917751e-05,3.331926519913814e-05,0.6666666666666666
20660,20660,노니/Noun,3,2,1,4.445926419917751e-05,3.331926519913814e-05,0.6666666666666666
20661,20661,커피숍/Noun,3,2,1,4.445926419917751e-05,3.331926519913814e-05,0.6666666666666666
20662,20662,-!!/Punctuation,3,2,1,4.445926419917751e-05,3.331926519913814e-05,0.6666666666666666
20663,20663,폐쇄공포증/Noun,3,2,1,4.445926419917751e-05,3.331926519913814e-05,0.6666666666666666
20664,20664,포주/Noun,3,1,2,3.334444814938313e-05,4.4425686932184186e-05,0.6666666666666666
20665,20665,씨지브이/Noun,3,1,2,3.334444814938313e-05,4.4425686932184186e-05,0.6666666666666666
20666,20666,나불대다/Verb,3,2,1,4.445926419917751e-05,3.331926519913814e-05,0.6666666666666666
20667,20667,재도/Noun,3,2,1,4.445926419917751e-05,3.331926519913814e-05,0.6666666666666666
20668,20668,kg/Alpha,3,1,2,3.334444814938313e-05,4.4425686932184186e-05,0.6666666666666666
20669,20669,마사지/Noun,3,1,2,3.334444814938313e-05,4.4425686932184186e-05,0.6666666666666666
20670,20670,후론/Noun,3,1,2,3.334444814938313e-05,4.4425686932184186e-05,0.6666666666666666
20671,20671,방독면/Noun,3,1,2,3.334444814938313e-05,4.4425686932184186e-05,0.6666666666666666
20672,20672,먹물/Noun,3,1,2,3.334444814938313e-05,4.4425686932184186e-05,0.6666666666666666
20673,20673,까치/Noun,3,1,2,3.334444814938313e-05,4.4425686932184186e-05,0.6666666666666666
20674,20674,반사/Noun,3,1,2,3.334444814938313e-05,4.4425686932184186e-05,0.6666666666666666
20675,20675,Kill/Alpha,3,1,2,3.334444814938313e-05,4.4425686932184186e-05,0.6666666666666666
20676,20676,선원/Noun,3,1,2,3.334444814938313e-05,4.4425686932184186e-05,0.6666666666666666
20677,20677,도킹/Noun,3,1,2,3.334444814938313e-05,4.4425686932184186e-05,0.6666666666666666
20678,20678,얙션/Noun,3,2,1,4.445926419917751e-05,3.331926519913814e-05,0.6666666666666666
20679,20679,부여잡다/Verb,3,2,1,4.445926419917751e-05,3.331926519913814e-05,0.6666666666666666
20680,20680,봉달/Noun,3,2,1,4.445926419917751e-05,3.331926519913814e-05,0.6666666666666666
20681,20681,밀가루/Noun,3,1,2,3.334444814938313e-05,4.4425686932184186e-05,0.6666666666666666
20682,20682,가화/Noun,3,2,1,4.445926419917751e-05,3.331926519913814e-05,0.6666666666666666
20683,20683,cool/Alpha,3,2,1,4.445926419917751e-05,3.331926519913814e-05,0.6666666666666666
20684,20684,유고/Noun,3,2,1,4.445926419917751e-05,3.331926519913814e-05,0.6666666666666666
20685,20685,삼부작/Noun,3,2,1,4.445926419917751e-05,3.331926519913814e-05,0.6666666666666666
20686,20686,킄/Noun,3,1,2,3.334444814938313e-05,4.4425686932184186e-05,0.6666666666666666
20687,20687,괜춘하/Noun,3,1,2,3.334444814938313e-05,4.4425686932184186e-05,0.6666666666666666
20688,20688,애석하다/Adjective,3,2,1,4.445926419917751e-05,3.331926519913814e-05,0.6666666666666666
20689,20689,메카물/Noun,3,2,1,4.445926419917751e-05,3.331926519913814e-05,0.6666666666666666
20690,20690,쌩까다/Verb,3,1,2,3.334444814938313e-05,4.4425686932184186e-05,0.6666666666666666
20691,20691,밤하늘/Noun,3,2,1,4.445926419917751e-05,3.331926519913814e-05,0.6666666666666666
20692,20692,페북/Noun,3,2,1,4.445926419917751e-05,3.331926519913814e-05,0.6666666666666666
20693,20693,무더기/Noun,3,1,2,3.334444814938313e-05,4.4425686932184186e-05,0.6666666666666666
20694,20694,부엌/Noun,3,1,2,3.334444814938313e-05,4.4425686932184186e-05,0.6666666666666666
20695,20695,난파선/Noun,3,2,1,4.445926419917751e-05,3.331926519913814e-05,0.6666666666666666
20696,20696,물방울/Noun,3,1,2,3.334444814938313e-05,4.4425686932184186e-05,0.6666666666666666
20697,20697,꽃처럼/Noun,3,2,1,4.445926419917751e-05,3.331926519913814e-05,0.6666666666666666
20698,20698,유저/Noun,3,2,1,4.445926419917751e-05,3.331926519913814e-05,0.6666666666666666
20699,20699,쏫/Noun,3,2,1,4.445926419917751e-05,3.331926519913814e-05,0.6666666666666666
20700,20700,검토/Noun,3,1,2,3.334444814938313e-05,4.4425686932184186e-05,0.6666666666666666
20701,20701,범접/Noun,3,2,1,4.445926419917751e-05,3.331926519913814e-05,0.6666666666666666
20702,20702,휠체어/Noun,3,1,2,3.334444814938313e-05,4.4425686932184186e-05,0.6666666666666666
20703,20703,이무기/Noun,3,1,2,3.334444814938313e-05,4.4425686932184186e-05,0.6666666666666666
20704,20704,클루/Noun,3,1,2,3.334444814938313e-05,4.4425686932184186e-05,0.6666666666666666
20705,20705,핰/Noun,3,1,2,3.334444814938313e-05,4.4425686932184186e-05,0.6666666666666666
20706,20706,언노운/Noun,3,1,2,3.334444814938313e-05,4.4425686932184186e-05,0.6666666666666666
20707,20707,87/Number,3,1,2,3.334444814938313e-05,4.4425686932184186e-05,0.6666666666666666
20708,20708,총각파티/Noun,3,1,2,3.334444814938313e-05,4.4425686932184186e-05,0.6666666666666666
20709,20709,메디컬탑팀/Noun,3,2,1,4.445926419917751e-05,3.331926519913814e-05,0.6666666666666666
20710,20710,건포도/Noun,3,1,2,3.334444814938313e-05,4.4425686932184186e-05,0.6666666666666666
20711,20711,이동건/Noun,3,2,1,4.445926419917751e-05,3.331926519913814e-05,0.6666666666666666
20712,20712,미스터리물/Noun,3,1,2,3.334444814938313e-05,4.4425686932184186e-05,0.6666666666666666
20713,20713,지칭/Noun,3,1,2,3.334444814938313e-05,4.4425686932184186e-05,0.6666666666666666
20714,20714,크라운/Noun,3,1,2,3.334444814938313e-05,4.4425686932184186e-05,0.6666666666666666
20715,20715,변주곡/Noun,3,2,1,4.445926419917751e-05,3.331926519913814e-05,0.6666666666666666
20716,20716,1954년/Number,3,2,1,4.445926419917751e-05,3.331926519913814e-05,0.6666666666666666
20717,20717,카메런/Noun,3,2,1,4.445926419917751e-05,3.331926519913814e-05,0.6666666666666666
20718,20718,소하/Noun,3,2,1,4.445926419917751e-05,3.331926519913814e-05,0.6666666666666666
20719,20719,이러쿵저러쿵/Adverb,3,2,1,4.445926419917751e-05,3.331926519913814e-05,0.6666666666666666
20720,20720,친미/Noun,3,1,2,3.334444814938313e-05,4.4425686932184186e-05,0.6666666666666666
20721,20721,먄/Noun,3,1,2,3.334444814938313e-05,4.4425686932184186e-05,0.6666666666666666
20722,20722,글쿠/Noun,3,1,2,3.334444814938313e-05,4.4425686932184186e-05,0.6666666666666666
20723,20723,끌때/Noun,3,1,2,3.334444814938313e-05,4.4425686932184186e-05,0.6666666666666666
20724,20724,화산폭발/Noun,3,2,1,4.445926419917751e-05,3.331926519913814e-05,0.6666666666666666
20725,20725,동창/Noun,3,2,1,4.445926419917751e-05,3.331926519913814e-05,0.6666666666666666
20726,20726,코엘료/Noun,3,2,1,4.445926419917751e-05,3.331926519913814e-05,0.6666666666666666
20727,20727,터프가이/Noun,3,2,1,4.445926419917751e-05,3.331926519913814e-05,0.6666666666666666
20728,20728,투톱/Noun,3,1,2,3.334444814938313e-05,4.4425686932184186e-05,0.6666666666666666
20729,20729,이휘재/Noun,3,1,2,3.334444814938313e-05,4.4425686932184186e-05,0.6666666666666666
20730,20730,곤조/Noun,3,2,1,4.445926419917751e-05,3.331926519913814e-05,0.6666666666666666
20731,20731,미믹/Noun,3,2,1,4.445926419917751e-05,3.331926519913814e-05,0.6666666666666666
20732,20732,과학기술/Noun,3,1,2,3.334444814938313e-05,4.4425686932184186e-05,0.6666666666666666
20733,20733,초청/Noun,3,1,2,3.334444814938313e-05,4.4425686932184186e-05,0.6666666666666666
20734,20734,크래쉬/Noun,3,1,2,3.334444814938313e-05,4.4425686932184186e-05,0.6666666666666666
20735,20735,자못/Noun,3,1,2,3.334444814938313e-05,4.4425686932184186e-05,0.6666666666666666
20736,20736,할하/Noun,3,1,2,3.334444814938313e-05,4.4425686932184186e-05,0.6666666666666666
20737,20737,오리진/Noun,3,1,2,3.334444814938313e-05,4.4425686932184186e-05,0.6666666666666666
20738,20738,곧잘/Noun,3,1,2,3.334444814938313e-05,4.4425686932184186e-05,0.6666666666666666
20739,20739,을사/Noun,3,1,2,3.334444814938313e-05,4.4425686932184186e-05,0.6666666666666666
20740,20740,강주희/Noun,3,2,1,4.445926419917751e-05,3.331926519913814e-05,0.6666666666666666
20741,20741,배척/Noun,3,2,1,4.445926419917751e-05,3.331926519913814e-05,0.6666666666666666
20742,20742,옌/Noun,3,2,1,4.445926419917751e-05,3.331926519913814e-05,0.6666666666666666
20743,20743,성격장애/Noun,3,1,2,3.334444814938313e-05,4.4425686932184186e-05,0.6666666666666666
20744,20744,얘내/Noun,3,2,1,4.445926419917751e-05,3.331926519913814e-05,0.6666666666666666
20745,20745,하이에나/Noun,3,1,2,3.334444814938313e-05,4.4425686932184186e-05,0.6666666666666666
20746,20746,냉동인간/Noun,3,1,2,3.334444814938313e-05,4.4425686932184186e-05,0.6666666666666666
20747,20747,자애/Noun,3,2,1,4.445926419917751e-05,3.331926519913814e-05,0.6666666666666666
20748,20748,모모/Modifier,3,1,2,3.334444814938313e-05,4.4425686932184186e-05,0.6666666666666666
20749,20749,애애/Noun,3,1,2,3.334444814938313e-05,4.4425686932184186e-05,0.6666666666666666
20750,20750,"9,000원/Number",3,1,2,3.334444814938313e-05,4.4425686932184186e-05,0.6666666666666666
20751,20751,굶주림/Noun,3,1,2,3.334444814938313e-05,4.4425686932184186e-05,0.6666666666666666
20752,20752,ㅌ/KoreanParticle,3,1,2,3.334444814938313e-05,4.4425686932184186e-05,0.6666666666666666
20753,20753,..~~/Punctuation,3,2,1,4.445926419917751e-05,3.331926519913814e-05,0.6666666666666666
20754,20754,자포자기/Noun,3,1,2,3.334444814938313e-05,4.4425686932184186e-05,0.6666666666666666
20755,20755,페티/Noun,3,2,1,4.445926419917751e-05,3.331926519913814e-05,0.6666666666666666
20756,20756,순환선/Noun,3,2,1,4.445926419917751e-05,3.331926519913814e-05,0.6666666666666666
20757,20757,건축물/Noun,3,2,1,4.445926419917751e-05,3.331926519913814e-05,0.6666666666666666
20758,20758,하나같다/Adjective,3,1,2,3.334444814938313e-05,4.4425686932184186e-05,0.6666666666666666
20759,20759,맥카시/Noun,3,2,1,4.445926419917751e-05,3.331926519913814e-05,0.6666666666666666
20760,20760,8.2/Number,3,2,1,4.445926419917751e-05,3.331926519913814e-05,0.6666666666666666
20761,20761,인수/Noun,3,2,1,4.445926419917751e-05,3.331926519913814e-05,0.6666666666666666
20762,20762,설립/Noun,3,2,1,4.445926419917751e-05,3.331926519913814e-05,0.6666666666666666
20763,20763,김제동/Noun,3,2,1,4.445926419917751e-05,3.331926519913814e-05,0.6666666666666666
20764,20764,부르스/Noun,3,1,2,3.334444814938313e-05,4.4425686932184186e-05,0.6666666666666666
20765,20765,88/Number,3,1,2,3.334444814938313e-05,4.4425686932184186e-05,0.6666666666666666
20766,20766,선역/Noun,3,1,2,3.334444814938313e-05,4.4425686932184186e-05,0.6666666666666666
20767,20767,유니콘/Noun,3,1,2,3.334444814938313e-05,4.4425686932184186e-05,0.6666666666666666
20768,20768,견우/Noun,3,2,1,4.445926419917751e-05,3.331926519913814e-05,0.6666666666666666
20769,20769,분닥/Noun,3,2,1,4.445926419917751e-05,3.331926519913814e-05,0.6666666666666666
20770,20770,표함/Noun,3,1,2,3.334444814938313e-05,4.4425686932184186e-05,0.6666666666666666
20771,20771,조아하다/Verb,3,1,2,3.334444814938313e-05,4.4425686932184186e-05,0.6666666666666666
20772,20772,정창화/Noun,3,1,2,3.334444814938313e-05,4.4425686932184186e-05,0.6666666666666666
20773,20773,스텔스/Noun,3,1,2,3.334444814938313e-05,4.4425686932184186e-05,0.6666666666666666
20774,20774,라야/Josa,3,1,2,3.334444814938313e-05,4.4425686932184186e-05,0.6666666666666666
20775,20775,심지/Noun,3,1,2,3.334444814938313e-05,4.4425686932184186e-05,0.6666666666666666
20776,20776,환호성/Noun,3,2,1,4.445926419917751e-05,3.331926519913814e-05,0.6666666666666666
20777,20777,원전/Noun,3,2,1,4.445926419917751e-05,3.331926519913814e-05,0.6666666666666666
20778,20778,변론/Noun,3,2,1,4.445926419917751e-05,3.331926519913814e-05,0.6666666666666666
20779,20779,파울/Noun,3,2,1,4.445926419917751e-05,3.331926519913814e-05,0.6666666666666666
20780,20780,전문용어/Noun,3,1,2,3.334444814938313e-05,4.4425686932184186e-05,0.6666666666666666
20781,20781,5천만/Number,3,1,2,3.334444814938313e-05,4.4425686932184186e-05,0.6666666666666666
20782,20782,홈런/Noun,3,2,1,4.445926419917751e-05,3.331926519913814e-05,0.6666666666666666
20783,20783,우크라이나/Noun,3,2,1,4.445926419917751e-05,3.331926519913814e-05,0.6666666666666666
20784,20784,쉰/Modifier,3,1,2,3.334444814938313e-05,4.4425686932184186e-05,0.6666666666666666
20785,20785,2006/Number,3,1,2,3.334444814938313e-05,4.4425686932184186e-05,0.6666666666666666
20786,20786,IMF/Alpha,3,2,1,4.445926419917751e-05,3.331926519913814e-05,0.6666666666666666
20787,20787,결투씬/Noun,3,2,1,4.445926419917751e-05,3.331926519913814e-05,0.6666666666666666
20788,20788,트레이닝/Noun,3,1,2,3.334444814938313e-05,4.4425686932184186e-05,0.6666666666666666
20789,20789,장난스럽다/Adjective,3,1,2,3.334444814938313e-05,4.4425686932184186e-05,0.6666666666666666
20790,20790,오페/Noun,3,2,1,4.445926419917751e-05,3.331926519913814e-05,0.6666666666666666
20791,20791,음질/Noun,3,1,2,3.334444814938313e-05,4.4425686932184186e-05,0.6666666666666666
20792,20792,셋째/Modifier,3,2,1,4.445926419917751e-05,3.331926519913814e-05,0.6666666666666666
20793,20793,과부/Noun,3,2,1,4.445926419917751e-05,3.331926519913814e-05,0.6666666666666666
20794,20794,울음소리/Noun,3,2,1,4.445926419917751e-05,3.331926519913814e-05,0.6666666666666666
20795,20795,그레픽/Noun,3,1,2,3.334444814938313e-05,4.4425686932184186e-05,0.6666666666666666
20796,20796,신디사이저/Noun,3,2,1,4.445926419917751e-05,3.331926519913814e-05,0.6666666666666666
20797,20797,따발총/Noun,3,1,2,3.334444814938313e-05,4.4425686932184186e-05,0.6666666666666666
20798,20798,귀인/Noun,3,2,1,4.445926419917751e-05,3.331926519913814e-05,0.6666666666666666
20799,20799,헛구역질/Noun,3,1,2,3.334444814938313e-05,4.4425686932184186e-05,0.6666666666666666
20800,20800,꼴등/Noun,3,1,2,3.334444814938313e-05,4.4425686932184186e-05,0.6666666666666666
20801,20801,치토/Noun,3,2,1,4.445926419917751e-05,3.331926519913814e-05,0.6666666666666666
20802,20802,분수/Noun,3,2,1,4.445926419917751e-05,3.331926519913814e-05,0.6666666666666666
20803,20803,피오/Noun,3,2,1,4.445926419917751e-05,3.331926519913814e-05,0.6666666666666666
20804,20804,송지나/Noun,3,2,1,4.445926419917751e-05,3.331926519913814e-05,0.6666666666666666
20805,20805,죄임/Noun,3,1,2,3.334444814938313e-05,4.4425686932184186e-05,0.6666666666666666
20806,20806,결사/Noun,3,1,2,3.334444814938313e-05,4.4425686932184186e-05,0.6666666666666666
20807,20807,첫방송/Noun,3,2,1,4.445926419917751e-05,3.331926519913814e-05,0.6666666666666666
20808,20808,귓방맹/Noun,3,1,2,3.334444814938313e-05,4.4425686932184186e-05,0.6666666666666666
20809,20809,승차/Noun,3,1,2,3.334444814938313e-05,4.4425686932184186e-05,0.6666666666666666
20810,20810,무임/Noun,3,1,2,3.334444814938313e-05,4.4425686932184186e-05,0.6666666666666666
20811,20811,빨대/Noun,3,1,2,3.334444814938313e-05,4.4425686932184186e-05,0.6666666666666666
20812,20812,겨울연가/Noun,3,1,2,3.334444814938313e-05,4.4425686932184186e-05,0.6666666666666666
20813,20813,안변/Noun,3,1,2,3.334444814938313e-05,4.4425686932184186e-05,0.6666666666666666
20814,20814,의술/Noun,3,2,1,4.445926419917751e-05,3.331926519913814e-05,0.6666666666666666
20815,20815,만지작/Adverb,3,2,1,4.445926419917751e-05,3.331926519913814e-05,0.6666666666666666
20816,20816,렵/Noun,3,1,2,3.334444814938313e-05,4.4425686932184186e-05,0.6666666666666666
20817,20817,보호자/Noun,3,2,1,4.445926419917751e-05,3.331926519913814e-05,0.6666666666666666
20818,20818,비포미드나잇/Noun,3,2,1,4.445926419917751e-05,3.331926519913814e-05,0.6666666666666666
20819,20819,지원이/Noun,3,1,2,3.334444814938313e-05,4.4425686932184186e-05,0.6666666666666666
20820,20820,ㅃㅏ/KoreanParticle,3,2,1,4.445926419917751e-05,3.331926519913814e-05,0.6666666666666666
20821,20821,미시/Noun,3,1,2,3.334444814938313e-05,4.4425686932184186e-05,0.6666666666666666
20822,20822,심화/Noun,3,1,2,3.334444814938313e-05,4.4425686932184186e-05,0.6666666666666666
20823,20823,드웨인존슨/Noun,3,1,2,3.334444814938313e-05,4.4425686932184186e-05,0.6666666666666666
20824,20824,티비영화/Noun,3,1,2,3.334444814938313e-05,4.4425686932184186e-05,0.6666666666666666
20825,20825,예배/Noun,3,2,1,4.445926419917751e-05,3.331926519913814e-05,0.6666666666666666
20826,20826,공기인형/Noun,3,1,2,3.334444814938313e-05,4.4425686932184186e-05,0.6666666666666666
20827,20827,후쿠/Noun,3,1,2,3.334444814938313e-05,4.4425686932184186e-05,0.6666666666666666
20828,20828,-?/Punctuation,3,1,2,3.334444814938313e-05,4.4425686932184186e-05,0.6666666666666666
20829,20829,얘쁘/Noun,3,2,1,4.445926419917751e-05,3.331926519913814e-05,0.6666666666666666
20830,20830,뿜어져/Noun,3,2,1,4.445926419917751e-05,3.331926519913814e-05,0.6666666666666666
20831,20831,장금/Noun,3,2,1,4.445926419917751e-05,3.331926519913814e-05,0.6666666666666666
20832,20832,범블비/Noun,3,1,2,3.334444814938313e-05,4.4425686932184186e-05,0.6666666666666666
20833,20833,거스/Noun,3,1,2,3.334444814938313e-05,4.4425686932184186e-05,0.6666666666666666
20834,20834,어데/Noun,3,1,2,3.334444814938313e-05,4.4425686932184186e-05,0.6666666666666666
20835,20835,연변/Noun,3,1,2,3.334444814938313e-05,4.4425686932184186e-05,0.6666666666666666
20836,20836,카아/Noun,3,1,2,3.334444814938313e-05,4.4425686932184186e-05,0.6666666666666666
20837,20837,부서/Noun,3,1,2,3.334444814938313e-05,4.4425686932184186e-05,0.6666666666666666
20838,20838,키치/Noun,3,1,2,3.334444814938313e-05,4.4425686932184186e-05,0.6666666666666666
20839,20839,ㅌㅌㅌ/KoreanParticle,3,1,2,3.334444814938313e-05,4.4425686932184186e-05,0.6666666666666666
20840,20840,황금박쥐/Noun,3,2,1,4.445926419917751e-05,3.331926519913814e-05,0.6666666666666666
20841,20841,강민/Noun,3,1,2,3.334444814938313e-05,4.4425686932184186e-05,0.6666666666666666
20842,20842,심술/Noun,3,1,2,3.334444814938313e-05,4.4425686932184186e-05,0.6666666666666666
20843,20843,200분/Number,3,1,2,3.334444814938313e-05,4.4425686932184186e-05,0.6666666666666666
20844,20844,자결/Noun,3,2,1,4.445926419917751e-05,3.331926519913814e-05,0.6666666666666666
20845,20845,공룡대탐험/Noun,3,2,1,4.445926419917751e-05,3.331926519913814e-05,0.6666666666666666
20846,20846,헉헉/Adverb,3,2,1,4.445926419917751e-05,3.331926519913814e-05,0.6666666666666666
20847,20847,리릭/Noun,3,1,2,3.334444814938313e-05,4.4425686932184186e-05,0.6666666666666666
20848,20848,개편/Noun,3,1,2,3.334444814938313e-05,4.4425686932184186e-05,0.6666666666666666
20849,20849,때껏/Noun,3,2,1,4.445926419917751e-05,3.331926519913814e-05,0.6666666666666666
20850,20850,조용조/Noun,3,2,1,4.445926419917751e-05,3.331926519913814e-05,0.6666666666666666
20851,20851,백일섭/Noun,3,2,1,4.445926419917751e-05,3.331926519913814e-05,0.6666666666666666
20852,20852,상대역/Noun,3,1,2,3.334444814938313e-05,4.4425686932184186e-05,0.6666666666666666
20853,20853,건장하다/Adjective,3,1,2,3.334444814938313e-05,4.4425686932184186e-05,0.6666666666666666
20854,20854,증세/Noun,3,1,2,3.334444814938313e-05,4.4425686932184186e-05,0.6666666666666666
20855,20855,잘생겻어/Noun,3,2,1,4.445926419917751e-05,3.331926519913814e-05,0.6666666666666666
20856,20856,해령/Noun,3,1,2,3.334444814938313e-05,4.4425686932184186e-05,0.6666666666666666
20857,20857,민재/Noun,3,1,2,3.334444814938313e-05,4.4425686932184186e-05,0.6666666666666666
20858,20858,라따뚜이/Noun,3,2,1,4.445926419917751e-05,3.331926519913814e-05,0.6666666666666666
20859,20859,팩/Noun,3,1,2,3.334444814938313e-05,4.4425686932184186e-05,0.6666666666666666
20860,20860,경제학자/Noun,3,2,1,4.445926419917751e-05,3.331926519913814e-05,0.6666666666666666
20861,20861,비도덕적/Noun,3,1,2,3.334444814938313e-05,4.4425686932184186e-05,0.6666666666666666
20862,20862,스즈키/Noun,3,2,1,4.445926419917751e-05,3.331926519913814e-05,0.6666666666666666
20863,20863,비관/Noun,3,2,1,4.445926419917751e-05,3.331926519913814e-05,0.6666666666666666
20864,20864,마마도/Noun,3,1,2,3.334444814938313e-05,4.4425686932184186e-05,0.6666666666666666
20865,20865,Made/Alpha,3,1,2,3.334444814938313e-05,4.4425686932184186e-05,0.6666666666666666
20866,20866,샬/Noun,3,2,1,4.445926419917751e-05,3.331926519913814e-05,0.6666666666666666
20867,20867,함은정/Noun,3,1,2,3.334444814938313e-05,4.4425686932184186e-05,0.6666666666666666
20868,20868,도에는/Foreign,3,2,1,4.445926419917751e-05,3.331926519913814e-05,0.6666666666666666
20869,20869,고령화/Noun,3,2,1,4.445926419917751e-05,3.331926519913814e-05,0.6666666666666666
20870,20870,행군/Noun,3,1,2,3.334444814938313e-05,4.4425686932184186e-05,0.6666666666666666
20871,20871,서언/Noun,3,2,1,4.445926419917751e-05,3.331926519913814e-05,0.6666666666666666
20872,20872,고별/Noun,3,1,2,3.334444814938313e-05,4.4425686932184186e-05,0.6666666666666666
20873,20873,똥찬/Noun,3,1,2,3.334444814938313e-05,4.4425686932184186e-05,0.6666666666666666
20874,20874,민족성/Noun,3,2,1,4.445926419917751e-05,3.331926519913814e-05,0.6666666666666666
20875,20875,업주/Noun,3,2,1,4.445926419917751e-05,3.331926519913814e-05,0.6666666666666666
20876,20876,*.*/Punctuation,3,2,1,4.445926419917751e-05,3.331926519913814e-05,0.6666666666666666
20877,20877,김흥국/Noun,3,1,2,3.334444814938313e-05,4.4425686932184186e-05,0.6666666666666666
20878,20878,컷던/Noun,3,1,2,3.334444814938313e-05,4.4425686932184186e-05,0.6666666666666666
20879,20879,남자사용설명서/Noun,3,1,2,3.334444814938313e-05,4.4425686932184186e-05,0.6666666666666666
20880,20880,찟/Noun,3,2,1,4.445926419917751e-05,3.331926519913814e-05,0.6666666666666666
20881,20881,짐꾼/Noun,3,2,1,4.445926419917751e-05,3.331926519913814e-05,0.6666666666666666
20882,20882,황정/Noun,3,2,1,4.445926419917751e-05,3.331926519913814e-05,0.6666666666666666
20883,20883,하용/Noun,3,1,2,3.334444814938313e-05,4.4425686932184186e-05,0.6666666666666666
20884,20884,별룬데/Noun,3,2,1,4.445926419917751e-05,3.331926519913814e-05,0.6666666666666666
20885,20885,항일/Noun,3,1,2,3.334444814938313e-05,4.4425686932184186e-05,0.6666666666666666
20886,20886,카리/Noun,3,1,2,3.334444814938313e-05,4.4425686932184186e-05,0.6666666666666666
20887,20887,토박이/Noun,3,1,2,3.334444814938313e-05,4.4425686932184186e-05,0.6666666666666666
20888,20888,티비엔/Noun,3,2,1,4.445926419917751e-05,3.331926519913814e-05,0.6666666666666666
20889,20889,깟/Modifier,3,2,1,4.445926419917751e-05,3.331926519913814e-05,0.6666666666666666
20890,20890,저쩌구/Noun,3,1,2,3.334444814938313e-05,4.4425686932184186e-05,0.6666666666666666
20891,20891,타쿠미/Noun,3,1,2,3.334444814938313e-05,4.4425686932184186e-05,0.6666666666666666
20892,20892,yo/Alpha,3,1,2,3.334444814938313e-05,4.4425686932184186e-05,0.6666666666666666
20893,20893,하관/Noun,3,2,1,4.445926419917751e-05,3.331926519913814e-05,0.6666666666666666
20894,20894,무명시절/Noun,3,2,1,4.445926419917751e-05,3.331926519913814e-05,0.6666666666666666
20895,20895,쫓겨나다/Verb,3,1,2,3.334444814938313e-05,4.4425686932184186e-05,0.6666666666666666
20896,20896,불가사의하다/Adjective,3,2,1,4.445926419917751e-05,3.331926519913814e-05,0.6666666666666666
20897,20897,발랑/Noun,3,1,2,3.334444814938313e-05,4.4425686932184186e-05,0.6666666666666666
20898,20898,영구시/Noun,3,2,1,4.445926419917751e-05,3.331926519913814e-05,0.6666666666666666
20899,20899,곡선/Noun,3,2,1,4.445926419917751e-05,3.331926519913814e-05,0.6666666666666666
20900,20900,욱일기/Noun,3,1,2,3.334444814938313e-05,4.4425686932184186e-05,0.6666666666666666
20901,20901,산지/Noun,3,2,1,4.445926419917751e-05,3.331926519913814e-05,0.6666666666666666
20902,20902,빛바/Noun,3,1,2,3.334444814938313e-05,4.4425686932184186e-05,0.6666666666666666
20903,20903,생기발랄하다/Adjective,3,2,1,4.445926419917751e-05,3.331926519913814e-05,0.6666666666666666
20904,20904,비정/Noun,3,1,2,3.334444814938313e-05,4.4425686932184186e-05,0.6666666666666666
20905,20905,지보면/Noun,3,1,2,3.334444814938313e-05,4.4425686932184186e-05,0.6666666666666666
20906,20906,보이드/Noun,3,2,1,4.445926419917751e-05,3.331926519913814e-05,0.6666666666666666
20907,20907,_=/Punctuation,3,1,2,3.334444814938313e-05,4.4425686932184186e-05,0.6666666666666666
20908,20908,탕진/Noun,3,1,2,3.334444814938313e-05,4.4425686932184186e-05,0.6666666666666666
20909,20909,노역/Noun,3,1,2,3.334444814938313e-05,4.4425686932184186e-05,0.6666666666666666
20910,20910,박종훈/Noun,3,1,2,3.334444814938313e-05,4.4425686932184186e-05,0.6666666666666666
20911,20911,탑블/Noun,3,1,2,3.334444814938313e-05,4.4425686932184186e-05,0.6666666666666666
20912,20912,위대/Noun,3,1,2,3.334444814938313e-05,4.4425686932184186e-05,0.6666666666666666
20913,20913,성정체성/Noun,3,1,2,3.334444814938313e-05,4.4425686932184186e-05,0.6666666666666666
20914,20914,해기스/Noun,3,2,1,4.445926419917751e-05,3.331926519913814e-05,0.6666666666666666
20915,20915,득실대다/Verb,3,2,1,4.445926419917751e-05,3.331926519913814e-05,0.6666666666666666
20916,20916,3.8/Number,3,1,2,3.334444814938313e-05,4.4425686932184186e-05,0.6666666666666666
20917,20917,의연하다/Adjective,3,2,1,4.445926419917751e-05,3.331926519913814e-05,0.6666666666666666
20918,20918,개띠껍/Noun,3,1,2,3.334444814938313e-05,4.4425686932184186e-05,0.6666666666666666
20919,20919,하석진/Noun,3,1,2,3.334444814938313e-05,4.4425686932184186e-05,0.6666666666666666
20920,20920,나잇스탠드/Noun,3,1,2,3.334444814938313e-05,4.4425686932184186e-05,0.6666666666666666
20921,20921,dog/Alpha,3,1,2,3.334444814938313e-05,4.4425686932184186e-05,0.6666666666666666
20922,20922,송곳니/Noun,3,1,2,3.334444814938313e-05,4.4425686932184186e-05,0.6666666666666666
20923,20923,스윙걸즈/Noun,3,2,1,4.445926419917751e-05,3.331926519913814e-05,0.6666666666666666
20924,20924,오연수/Noun,3,2,1,4.445926419917751e-05,3.331926519913814e-05,0.6666666666666666
20925,20925,보물찾기/Noun,3,1,2,3.334444814938313e-05,4.4425686932184186e-05,0.6666666666666666
20926,20926,게린/Noun,3,2,1,4.445926419917751e-05,3.331926519913814e-05,0.6666666666666666
20927,20927,이영하/Noun,3,1,2,3.334444814938313e-05,4.4425686932184186e-05,0.6666666666666666
20928,20928,스텔라/Noun,3,2,1,4.445926419917751e-05,3.331926519913814e-05,0.6666666666666666
20929,20929,피살/Noun,3,1,2,3.334444814938313e-05,4.4425686932184186e-05,0.6666666666666666
20930,20930,아이리쉬/Noun,3,2,1,4.445926419917751e-05,3.331926519913814e-05,0.6666666666666666
20931,20931,영계/Noun,3,2,1,4.445926419917751e-05,3.331926519913814e-05,0.6666666666666666
20932,20932,기분좋은날/Noun,3,2,1,4.445926419917751e-05,3.331926519913814e-05,0.6666666666666666
20933,20933,사방/Noun,3,1,2,3.334444814938313e-05,4.4425686932184186e-05,0.6666666666666666
20934,20934,김창환/Noun,3,2,1,4.445926419917751e-05,3.331926519913814e-05,0.6666666666666666
20935,20935,병인/Noun,3,2,1,4.445926419917751e-05,3.331926519913814e-05,0.6666666666666666
20936,20936,대장군/Noun,3,2,1,4.445926419917751e-05,3.331926519913814e-05,0.6666666666666666
20937,20937,스케이트/Noun,3,2,1,4.445926419917751e-05,3.331926519913814e-05,0.6666666666666666
20938,20938,협객/Noun,3,1,2,3.334444814938313e-05,4.4425686932184186e-05,0.6666666666666666
20939,20939,벌판/Noun,3,1,2,3.334444814938313e-05,4.4425686932184186e-05,0.6666666666666666
20940,20940,바이올렛/Noun,3,1,2,3.334444814938313e-05,4.4425686932184186e-05,0.6666666666666666
20941,20941,혈연/Noun,3,2,1,4.445926419917751e-05,3.331926519913814e-05,0.6666666666666666
20942,20942,슝다이린/Noun,3,2,1,4.445926419917751e-05,3.331926519913814e-05,0.6666666666666666
20943,20943,연두/Noun,3,1,2,3.334444814938313e-05,4.4425686932184186e-05,0.6666666666666666
20944,20944,타임즈/Noun,3,2,1,4.445926419917751e-05,3.331926519913814e-05,0.6666666666666666
20945,20945,플린트/Noun,3,2,1,4.445926419917751e-05,3.331926519913814e-05,0.6666666666666666
20946,20946,숨가쁘다/Adjective,3,1,2,3.334444814938313e-05,4.4425686932184186e-05,0.6666666666666666
20947,20947,45/Number,3,1,2,3.334444814938313e-05,4.4425686932184186e-05,0.6666666666666666
20948,20948,관리자/Noun,3,2,1,4.445926419917751e-05,3.331926519913814e-05,0.6666666666666666
20949,20949,대발/Noun,3,2,1,4.445926419917751e-05,3.331926519913814e-05,0.6666666666666666
20950,20950,사우나/Noun,3,1,2,3.334444814938313e-05,4.4425686932184186e-05,0.6666666666666666
20951,20951,입니다/Foreign,3,1,2,3.334444814938313e-05,4.4425686932184186e-05,0.6666666666666666
20952,20952,이성계/Noun,3,2,1,4.445926419917751e-05,3.331926519913814e-05,0.6666666666666666
20953,20953,무선/Noun,3,1,2,3.334444814938313e-05,4.4425686932184186e-05,0.6666666666666666
20954,20954,(..)/Punctuation,3,1,2,3.334444814938313e-05,4.4425686932184186e-05,0.6666666666666666
20955,20955,때마침/Noun,3,1,2,3.334444814938313e-05,4.4425686932184186e-05,0.6666666666666666
20956,20956,뽀얗다/Adjective,3,2,1,4.445926419917751e-05,3.331926519913814e-05,0.6666666666666666
20957,20957,-../Punctuation,3,1,2,3.334444814938313e-05,4.4425686932184186e-05,0.6666666666666666
20958,20958,간절/Noun,3,1,2,3.334444814938313e-05,4.4425686932184186e-05,0.6666666666666666
20959,20959,시에나/Noun,3,1,2,3.334444814938313e-05,4.4425686932184186e-05,0.6666666666666666
20960,20960,면도칼/Noun,3,1,2,3.334444814938313e-05,4.4425686932184186e-05,0.6666666666666666
20961,20961,........................../Punctuation,3,1,2,3.334444814938313e-05,4.4425686932184186e-05,0.6666666666666666
20962,20962,한세상/Noun,3,2,1,4.445926419917751e-05,3.331926519913814e-05,0.6666666666666666
20963,20963,젛/Noun,3,2,1,4.445926419917751e-05,3.331926519913814e-05,0.6666666666666666
20964,20964,84분/Number,3,1,2,3.334444814938313e-05,4.4425686932184186e-05,0.6666666666666666
20965,20965,끝날떄/Noun,3,1,2,3.334444814938313e-05,4.4425686932184186e-05,0.6666666666666666
20966,20966,신시티/Noun,3,1,2,3.334444814938313e-05,4.4425686932184186e-05,0.6666666666666666
20967,20967,안간힘/Noun,3,1,2,3.334444814938313e-05,4.4425686932184186e-05,0.6666666666666666
20968,20968,하얀거탑/Noun,3,2,1,4.445926419917751e-05,3.331926519913814e-05,0.6666666666666666
20969,20969,1조/Number,3,2,1,4.445926419917751e-05,3.331926519913814e-05,0.6666666666666666
20970,20970,혈전/Noun,3,2,1,4.445926419917751e-05,3.331926519913814e-05,0.6666666666666666
20971,20971,Go/Alpha,3,2,1,4.445926419917751e-05,3.331926519913814e-05,0.6666666666666666
20972,20972,최홍만/Noun,3,1,2,3.334444814938313e-05,4.4425686932184186e-05,0.6666666666666666
20973,20973,숴/Noun,3,1,2,3.334444814938313e-05,4.4425686932184186e-05,0.6666666666666666
20974,20974,천신만고/Noun,3,1,2,3.334444814938313e-05,4.4425686932184186e-05,0.6666666666666666
20975,20975,청취/Noun,3,1,2,3.334444814938313e-05,4.4425686932184186e-05,0.6666666666666666
20976,20976,독고영재/Noun,3,2,1,4.445926419917751e-05,3.331926519913814e-05,0.6666666666666666
20977,20977,전망/Noun,3,2,1,4.445926419917751e-05,3.331926519913814e-05,0.6666666666666666
20978,20978,글코/Noun,3,1,2,3.334444814938313e-05,4.4425686932184186e-05,0.6666666666666666
20979,20979,123456789/Number,3,2,1,4.445926419917751e-05,3.331926519913814e-05,0.6666666666666666
20980,20980,피구왕통키/Noun,3,1,2,3.334444814938313e-05,4.4425686932184186e-05,0.6666666666666666
20981,20981,장로/Noun,3,2,1,4.445926419917751e-05,3.331926519913814e-05,0.6666666666666666
20982,20982,도면/Noun,3,2,1,4.445926419917751e-05,3.331926519913814e-05,0.6666666666666666
20983,20983,트랜스젠더/Noun,3,1,2,3.334444814938313e-05,4.4425686932184186e-05,0.6666666666666666
20984,20984,언론인/Noun,3,2,1,4.445926419917751e-05,3.331926519913814e-05,0.6666666666666666
20985,20985,曰/Foreign,3,1,2,3.334444814938313e-05,4.4425686932184186e-05,0.6666666666666666
20986,20986,코리/Noun,3,2,1,4.445926419917751e-05,3.331926519913814e-05,0.6666666666666666
20987,20987,흣/Noun,3,2,1,4.445926419917751e-05,3.331926519913814e-05,0.6666666666666666
20988,20988,고무/Noun,3,2,1,4.445926419917751e-05,3.331926519913814e-05,0.6666666666666666
20989,20989,동네형/Noun,3,1,2,3.334444814938313e-05,4.4425686932184186e-05,0.6666666666666666
20990,20990,멧/Noun,3,2,1,4.445926419917751e-05,3.331926519913814e-05,0.6666666666666666
20991,20991,장자/Noun,3,2,1,4.445926419917751e-05,3.331926519913814e-05,0.6666666666666666
20992,20992,이라니/Foreign,3,1,2,3.334444814938313e-05,4.4425686932184186e-05,0.6666666666666666
20993,20993,불알/Noun,3,1,2,3.334444814938313e-05,4.4425686932184186e-05,0.6666666666666666
20994,20994,웃겻음/Noun,3,2,1,4.445926419917751e-05,3.331926519913814e-05,0.6666666666666666
20995,20995,부술/Noun,3,1,2,3.334444814938313e-05,4.4425686932184186e-05,0.6666666666666666
20996,20996,이햐/Noun,3,2,1,4.445926419917751e-05,3.331926519913814e-05,0.6666666666666666
20997,20997,숀코넬리/Noun,3,2,1,4.445926419917751e-05,3.331926519913814e-05,0.6666666666666666
20998,20998,업데이트/Noun,3,2,1,4.445926419917751e-05,3.331926519913814e-05,0.6666666666666666
20999,20999,731/Number,3,1,2,3.334444814938313e-05,4.4425686932184186e-05,0.6666666666666666
21000,21000,일변도/Noun,3,1,2,3.334444814938313e-05,4.4425686932184186e-05,0.6666666666666666
21001,21001,동창회/Noun,3,2,1,4.445926419917751e-05,3.331926519913814e-05,0.6666666666666666
21002,21002,장작/Noun,3,1,2,3.334444814938313e-05,4.4425686932184186e-05,0.6666666666666666
21003,21003,참새/Noun,3,1,2,3.334444814938313e-05,4.4425686932184186e-05,0.6666666666666666
21004,21004,이해영/Noun,3,2,1,4.445926419917751e-05,3.331926519913814e-05,0.6666666666666666
21005,21005,자칼/Noun,3,2,1,4.445926419917751e-05,3.331926519913814e-05,0.6666666666666666
21006,21006,정향/Noun,3,1,2,3.334444814938313e-05,4.4425686932184186e-05,0.6666666666666666
21007,21007,개줌/Noun,3,1,2,3.334444814938313e-05,4.4425686932184186e-05,0.6666666666666666
21008,21008,랄랄라/Adverb,3,2,1,4.445926419917751e-05,3.331926519913814e-05,0.6666666666666666
21009,21009,테크/Noun,3,1,2,3.334444814938313e-05,4.4425686932184186e-05,0.6666666666666666
21010,21010,김소희/Noun,3,2,1,4.445926419917751e-05,3.331926519913814e-05,0.6666666666666666
21011,21011,따른/Modifier,3,2,1,4.445926419917751e-05,3.331926519913814e-05,0.6666666666666666
21012,21012,펄프픽션/Noun,3,1,2,3.334444814938313e-05,4.4425686932184186e-05,0.6666666666666666
21013,21013,소나티네/Noun,3,2,1,4.445926419917751e-05,3.331926519913814e-05,0.6666666666666666
21014,21014,장준환/Noun,3,2,1,4.445926419917751e-05,3.331926519913814e-05,0.6666666666666666
21015,21015,설특집/Noun,3,1,2,3.334444814938313e-05,4.4425686932184186e-05,0.6666666666666666
21016,21016,법조/Noun,3,2,1,4.445926419917751e-05,3.331926519913814e-05,0.6666666666666666
21017,21017,빈민/Noun,3,1,2,3.334444814938313e-05,4.4425686932184186e-05,0.6666666666666666
21018,21018,광팬임/Noun,3,2,1,4.445926419917751e-05,3.331926519913814e-05,0.6666666666666666
21019,21019,장동직/Noun,3,1,2,3.334444814938313e-05,4.4425686932184186e-05,0.6666666666666666
21020,21020,오스틴파워/Noun,3,1,2,3.334444814938313e-05,4.4425686932184186e-05,0.6666666666666666
21021,21021,남학생/Noun,3,1,2,3.334444814938313e-05,4.4425686932184186e-05,0.6666666666666666
21022,21022,풀림/Noun,3,2,1,4.445926419917751e-05,3.331926519913814e-05,0.6666666666666666
21023,21023,공중전화/Noun,3,2,1,4.445926419917751e-05,3.331926519913814e-05,0.6666666666666666
21024,21024,역사교육/Noun,3,1,2,3.334444814938313e-05,4.4425686932184186e-05,0.6666666666666666
21025,21025,)-/Punctuation,3,1,2,3.334444814938313e-05,4.4425686932184186e-05,0.6666666666666666
21026,21026,멘탈리스트/Noun,3,1,2,3.334444814938313e-05,4.4425686932184186e-05,0.6666666666666666
21027,21027,주임/Noun,3,1,2,3.334444814938313e-05,4.4425686932184186e-05,0.6666666666666666
21028,21028,오태경/Noun,3,1,2,3.334444814938313e-05,4.4425686932184186e-05,0.6666666666666666
21029,21029,팰트/Noun,3,2,1,4.445926419917751e-05,3.331926519913814e-05,0.6666666666666666
21030,21030,야시/Noun,3,1,2,3.334444814938313e-05,4.4425686932184186e-05,0.6666666666666666
21031,21031,떼돈/Noun,3,1,2,3.334444814938313e-05,4.4425686932184186e-05,0.6666666666666666
21032,21032,지나고/Foreign,3,1,2,3.334444814938313e-05,4.4425686932184186e-05,0.6666666666666666
21033,21033,융통성/Noun,3,1,2,3.334444814938313e-05,4.4425686932184186e-05,0.6666666666666666
21034,21034,가내/Noun,3,2,1,4.445926419917751e-05,3.331926519913814e-05,0.6666666666666666
21035,21035,얜/Noun,3,1,2,3.334444814938313e-05,4.4425686932184186e-05,0.6666666666666666
21036,21036,사회자/Noun,3,1,2,3.334444814938313e-05,4.4425686932184186e-05,0.6666666666666666
21037,21037,장례/Noun,3,2,1,4.445926419917751e-05,3.331926519913814e-05,0.6666666666666666
21038,21038,박성광/Noun,3,1,2,3.334444814938313e-05,4.4425686932184186e-05,0.6666666666666666
21039,21039,??^^/Punctuation,3,2,1,4.445926419917751e-05,3.331926519913814e-05,0.6666666666666666
21040,21040,틴탑/Noun,3,1,2,3.334444814938313e-05,4.4425686932184186e-05,0.6666666666666666
21041,21041,태종/Noun,3,2,1,4.445926419917751e-05,3.331926519913814e-05,0.6666666666666666
21042,21042,허이재/Noun,3,2,1,4.445926419917751e-05,3.331926519913814e-05,0.6666666666666666
21043,21043,럭셔리/Noun,3,1,2,3.334444814938313e-05,4.4425686932184186e-05,0.6666666666666666
21044,21044,또르르/Noun,3,1,2,3.334444814938313e-05,4.4425686932184186e-05,0.6666666666666666
21045,21045,이내/Foreign,3,2,1,4.445926419917751e-05,3.331926519913814e-05,0.6666666666666666
21046,21046,바랫/Noun,3,2,1,4.445926419917751e-05,3.331926519913814e-05,0.6666666666666666
21047,21047,의개/Noun,3,2,1,4.445926419917751e-05,3.331926519913814e-05,0.6666666666666666
21048,21048,응어리/Noun,3,2,1,4.445926419917751e-05,3.331926519913814e-05,0.6666666666666666
21049,21049,say/Alpha,3,2,1,4.445926419917751e-05,3.331926519913814e-05,0.6666666666666666
21050,21050,미수/Noun,3,1,2,3.334444814938313e-05,4.4425686932184186e-05,0.6666666666666666
21051,21051,황신/Noun,3,1,2,3.334444814938313e-05,4.4425686932184186e-05,0.6666666666666666
21052,21052,하멜/Noun,3,1,2,3.334444814938313e-05,4.4425686932184186e-05,0.6666666666666666
21053,21053,짧게하다/Adjective,3,2,1,4.445926419917751e-05,3.331926519913814e-05,0.6666666666666666
21054,21054,불로장생/Noun,3,2,1,4.445926419917751e-05,3.331926519913814e-05,0.6666666666666666
21055,21055,씽/Noun,3,2,1,4.445926419917751e-05,3.331926519913814e-05,0.6666666666666666
21056,21056,투윅스/Noun,3,2,1,4.445926419917751e-05,3.331926519913814e-05,0.6666666666666666
21057,21057,된장찌개/Noun,3,1,2,3.334444814938313e-05,4.4425686932184186e-05,0.6666666666666666
21058,21058,건너오다/Verb,3,1,2,3.334444814938313e-05,4.4425686932184186e-05,0.6666666666666666
21059,21059,극성/Noun,3,1,2,3.334444814938313e-05,4.4425686932184186e-05,0.6666666666666666
21060,21060,문신/Noun,3,1,2,3.334444814938313e-05,4.4425686932184186e-05,0.6666666666666666
21061,21061,마따나/Josa,3,1,2,3.334444814938313e-05,4.4425686932184186e-05,0.6666666666666666
21062,21062,단축/Noun,3,1,2,3.334444814938313e-05,4.4425686932184186e-05,0.6666666666666666
21063,21063,여덟/Determiner,3,2,1,4.445926419917751e-05,3.331926519913814e-05,0.6666666666666666
21064,21064,1985년/Number,3,1,2,3.334444814938313e-05,4.4425686932184186e-05,0.6666666666666666
21065,21065,꾸벅꾸벅/Adverb,3,1,2,3.334444814938313e-05,4.4425686932184186e-05,0.6666666666666666
21066,21066,둘째/Modifier,3,1,2,3.334444814938313e-05,4.4425686932184186e-05,0.6666666666666666
21067,21067,팔지/Noun,3,2,1,4.445926419917751e-05,3.331926519913814e-05,0.6666666666666666
21068,21068,노가리/Noun,3,1,2,3.334444814938313e-05,4.4425686932184186e-05,0.6666666666666666
21069,21069,세간/Noun,3,1,2,3.334444814938313e-05,4.4425686932184186e-05,0.6666666666666666
21070,21070,샘플/Noun,3,1,2,3.334444814938313e-05,4.4425686932184186e-05,0.6666666666666666
21071,21071,김재규/Noun,3,1,2,3.334444814938313e-05,4.4425686932184186e-05,0.6666666666666666
21072,21072,제프리/Noun,3,2,1,4.445926419917751e-05,3.331926519913814e-05,0.6666666666666666
21073,21073,쇼헤이/Noun,3,2,1,4.445926419917751e-05,3.331926519913814e-05,0.6666666666666666
21074,21074,~~~~!!/Punctuation,3,2,1,4.445926419917751e-05,3.331926519913814e-05,0.6666666666666666
21075,21075,고산/Noun,3,2,1,4.445926419917751e-05,3.331926519913814e-05,0.6666666666666666
21076,21076,????????????/Punctuation,3,2,1,4.445926419917751e-05,3.331926519913814e-05,0.6666666666666666
21077,21077,버섯/Noun,3,1,2,3.334444814938313e-05,4.4425686932184186e-05,0.6666666666666666
21078,21078,문물/Noun,3,1,2,3.334444814938313e-05,4.4425686932184186e-05,0.6666666666666666
21079,21079,이또/Noun,3,2,1,4.445926419917751e-05,3.331926519913814e-05,0.6666666666666666
21080,21080,주목할만하다/Adjective,3,2,1,4.445926419917751e-05,3.331926519913814e-05,0.6666666666666666
21081,21081,배꼇다/Noun,3,1,2,3.334444814938313e-05,4.4425686932184186e-05,0.6666666666666666
21082,21082,오류로/Noun,3,1,2,3.334444814938313e-05,4.4425686932184186e-05,0.6666666666666666
21083,21083,김장/Noun,3,2,1,4.445926419917751e-05,3.331926519913814e-05,0.6666666666666666
21084,21084,저스티스리그/Noun,3,2,1,4.445926419917751e-05,3.331926519913814e-05,0.6666666666666666
21085,21085,아들내미/Noun,3,1,2,3.334444814938313e-05,4.4425686932184186e-05,0.6666666666666666
21086,21086,중량/Noun,3,2,1,4.445926419917751e-05,3.331926519913814e-05,0.6666666666666666
21087,21087,파견/Noun,3,1,2,3.334444814938313e-05,4.4425686932184186e-05,0.6666666666666666
21088,21088,렛잇고/Noun,3,2,1,4.445926419917751e-05,3.331926519913814e-05,0.6666666666666666
21089,21089,유즈/Noun,3,2,1,4.445926419917751e-05,3.331926519913814e-05,0.6666666666666666
21090,21090,왕의남자/Noun,3,2,1,4.445926419917751e-05,3.331926519913814e-05,0.6666666666666666
21091,21091,98/Number,3,1,2,3.334444814938313e-05,4.4425686932184186e-05,0.6666666666666666
21092,21092,바둑이/Noun,3,1,2,3.334444814938313e-05,4.4425686932184186e-05,0.6666666666666666
21093,21093,>.../Punctuation,3,2,1,4.445926419917751e-05,3.331926519913814e-05,0.6666666666666666
21094,21094,도를/Foreign,3,2,1,4.445926419917751e-05,3.331926519913814e-05,0.6666666666666666
21095,21095,블리치/Noun,3,2,1,4.445926419917751e-05,3.331926519913814e-05,0.6666666666666666
21096,21096,방심하다/Adjective,3,2,1,4.445926419917751e-05,3.331926519913814e-05,0.6666666666666666
21097,21097,숙모/Noun,3,1,2,3.334444814938313e-05,4.4425686932184186e-05,0.6666666666666666
21098,21098,스파크/Noun,3,2,1,4.445926419917751e-05,3.331926519913814e-05,0.6666666666666666
21099,21099,었/PreEomi,3,2,1,4.445926419917751e-05,3.331926519913814e-05,0.6666666666666666
21100,21100,깽판/Noun,3,1,2,3.334444814938313e-05,4.4425686932184186e-05,0.6666666666666666
21101,21101,민씨/Noun,3,1,2,3.334444814938313e-05,4.4425686932184186e-05,0.6666666666666666
21102,21102,택해/Noun,3,1,2,3.334444814938313e-05,4.4425686932184186e-05,0.6666666666666666
21103,21103,바스터즈/Noun,3,1,2,3.334444814938313e-05,4.4425686932184186e-05,0.6666666666666666
21104,21104,간섭/Noun,3,1,2,3.334444814938313e-05,4.4425686932184186e-05,0.6666666666666666
21105,21105,더랬/Noun,3,1,2,3.334444814938313e-05,4.4425686932184186e-05,0.6666666666666666
21106,21106,벽지/Noun,3,2,1,4.445926419917751e-05,3.331926519913814e-05,0.6666666666666666
21107,21107,치료받다/Verb,3,1,2,3.334444814938313e-05,4.4425686932184186e-05,0.6666666666666666
21108,21108,허트로커/Noun,3,2,1,4.445926419917751e-05,3.331926519913814e-05,0.6666666666666666
21109,21109,강예빈/Noun,3,2,1,4.445926419917751e-05,3.331926519913814e-05,0.6666666666666666
21110,21110,강릉/Noun,3,2,1,4.445926419917751e-05,3.331926519913814e-05,0.6666666666666666
21111,21111,낚인거/Noun,3,1,2,3.334444814938313e-05,4.4425686932184186e-05,0.6666666666666666
21112,21112,메가트론/Noun,3,1,2,3.334444814938313e-05,4.4425686932184186e-05,0.6666666666666666
21113,21113,연모/Noun,3,2,1,4.445926419917751e-05,3.331926519913814e-05,0.6666666666666666
21114,21114,동아시아/Noun,3,1,2,3.334444814938313e-05,4.4425686932184186e-05,0.6666666666666666
21115,21115,렸다/Noun,3,1,2,3.334444814938313e-05,4.4425686932184186e-05,0.6666666666666666
21116,21116,장만/Noun,3,1,2,3.334444814938313e-05,4.4425686932184186e-05,0.6666666666666666
21117,21117,소질/Noun,3,2,1,4.445926419917751e-05,3.331926519913814e-05,0.6666666666666666
21118,21118,무법/Noun,3,1,2,3.334444814938313e-05,4.4425686932184186e-05,0.6666666666666666
21119,21119,더크/Noun,3,1,2,3.334444814938313e-05,4.4425686932184186e-05,0.6666666666666666
21120,21120,???//Punctuation,3,1,2,3.334444814938313e-05,4.4425686932184186e-05,0.6666666666666666
21121,21121,도속/Noun,3,2,1,4.445926419917751e-05,3.331926519913814e-05,0.6666666666666666
21122,21122,관방/Noun,3,1,2,3.334444814938313e-05,4.4425686932184186e-05,0.6666666666666666
21123,21123,미그기/Noun,3,1,2,3.334444814938313e-05,4.4425686932184186e-05,0.6666666666666666
21124,21124,어뜩하다/Adjective,3,2,1,4.445926419917751e-05,3.331926519913814e-05,0.6666666666666666
21125,21125,오창민/Noun,3,2,1,4.445926419917751e-05,3.331926519913814e-05,0.6666666666666666
21126,21126,씩이나/Foreign,3,1,2,3.334444814938313e-05,4.4425686932184186e-05,0.6666666666666666
21127,21127,날아오르다/Verb,3,2,1,4.445926419917751e-05,3.331926519913814e-05,0.6666666666666666
21128,21128,겉보기/Noun,3,2,1,4.445926419917751e-05,3.331926519913814e-05,0.6666666666666666
21129,21129,장의/Noun,3,2,1,4.445926419917751e-05,3.331926519913814e-05,0.6666666666666666
21130,21130,봉투/Noun,3,1,2,3.334444814938313e-05,4.4425686932184186e-05,0.6666666666666666
21131,21131,디네/Noun,3,2,1,4.445926419917751e-05,3.331926519913814e-05,0.6666666666666666
21132,21132,강대성/Noun,3,2,1,4.445926419917751e-05,3.331926519913814e-05,0.6666666666666666
21133,21133,체위/Noun,3,1,2,3.334444814938313e-05,4.4425686932184186e-05,0.6666666666666666
21134,21134,네스트/Noun,3,2,1,4.445926419917751e-05,3.331926519913814e-05,0.6666666666666666
21135,21135,천만이/Noun,3,1,2,3.334444814938313e-05,4.4425686932184186e-05,0.6666666666666666
21136,21136,스트로베리/Noun,3,2,1,4.445926419917751e-05,3.331926519913814e-05,0.6666666666666666
21137,21137,겔러/Noun,3,1,2,3.334444814938313e-05,4.4425686932184186e-05,0.6666666666666666
21138,21138,으으윽/Adverb,3,1,2,3.334444814938313e-05,4.4425686932184186e-05,0.6666666666666666
21139,21139,인프라/Noun,3,1,2,3.334444814938313e-05,4.4425686932184186e-05,0.6666666666666666
21140,21140,돋아나다/Verb,3,1,2,3.334444814938313e-05,4.4425686932184186e-05,0.6666666666666666
21141,21141,유니폼/Noun,3,1,2,3.334444814938313e-05,4.4425686932184186e-05,0.6666666666666666
21142,21142,회부/Noun,3,2,1,4.445926419917751e-05,3.331926519913814e-05,0.6666666666666666
21143,21143,미췬/Noun,3,1,2,3.334444814938313e-05,4.4425686932184186e-05,0.6666666666666666
21144,21144,메이즈/Noun,3,1,2,3.334444814938313e-05,4.4425686932184186e-05,0.6666666666666666
21145,21145,More/Alpha,3,2,1,4.445926419917751e-05,3.331926519913814e-05,0.6666666666666666
21146,21146,콧구멍/Noun,3,2,1,4.445926419917751e-05,3.331926519913814e-05,0.6666666666666666
21147,21147,지질/Noun,3,2,1,4.445926419917751e-05,3.331926519913814e-05,0.6666666666666666
21148,21148,과목/Noun,3,2,1,4.445926419917751e-05,3.331926519913814e-05,0.6666666666666666
21149,21149,Goodbye/Alpha,3,2,1,4.445926419917751e-05,3.331926519913814e-05,0.6666666666666666
21150,21150,히힛/Noun,3,1,2,3.334444814938313e-05,4.4425686932184186e-05,0.6666666666666666
21151,21151,정액/Noun,3,2,1,4.445926419917751e-05,3.331926519913814e-05,0.6666666666666666
21152,21152,유세/Noun,3,1,2,3.334444814938313e-05,4.4425686932184186e-05,0.6666666666666666
21153,21153,숏/Noun,3,2,1,4.445926419917751e-05,3.331926519913814e-05,0.6666666666666666
21154,21154,호령/Noun,3,1,2,3.334444814938313e-05,4.4425686932184186e-05,0.6666666666666666
21155,21155,르그/Noun,3,2,1,4.445926419917751e-05,3.331926519913814e-05,0.6666666666666666
21156,21156,세븐데이즈/Noun,3,2,1,4.445926419917751e-05,3.331926519913814e-05,0.6666666666666666
21157,21157,레너/Noun,3,1,2,3.334444814938313e-05,4.4425686932184186e-05,0.6666666666666666
21158,21158,철거민/Noun,3,1,2,3.334444814938313e-05,4.4425686932184186e-05,0.6666666666666666
21159,21159,Time/Alpha,3,1,2,3.334444814938313e-05,4.4425686932184186e-05,0.6666666666666666
21160,21160,혜빈/Noun,3,2,1,4.445926419917751e-05,3.331926519913814e-05,0.6666666666666666
21161,21161,페임/Noun,3,1,2,3.334444814938313e-05,4.4425686932184186e-05,0.6666666666666666
21162,21162,다야/Noun,3,1,2,3.334444814938313e-05,4.4425686932184186e-05,0.6666666666666666
21163,21163,멤피스/Noun,3,1,2,3.334444814938313e-05,4.4425686932184186e-05,0.6666666666666666
21164,21164,이류/Noun,3,1,2,3.334444814938313e-05,4.4425686932184186e-05,0.6666666666666666
21165,21165,마의/Noun,3,2,1,4.445926419917751e-05,3.331926519913814e-05,0.6666666666666666
21166,21166,금연/Noun,3,1,2,3.334444814938313e-05,4.4425686932184186e-05,0.6666666666666666
21167,21167,페셔널/Noun,3,1,2,3.334444814938313e-05,4.4425686932184186e-05,0.6666666666666666
21168,21168,까지만/Foreign,3,1,2,3.334444814938313e-05,4.4425686932184186e-05,0.6666666666666666
21169,21169,구장/Noun,3,1,2,3.334444814938313e-05,4.4425686932184186e-05,0.6666666666666666
21170,21170,토키/Noun,3,2,1,4.445926419917751e-05,3.331926519913814e-05,0.6666666666666666
21171,21171,둥글다/Adjective,3,1,2,3.334444814938313e-05,4.4425686932184186e-05,0.6666666666666666
21172,21172,섬세/Noun,3,2,1,4.445926419917751e-05,3.331926519913814e-05,0.6666666666666666
21173,21173,만렙/Noun,3,1,2,3.334444814938313e-05,4.4425686932184186e-05,0.6666666666666666
21174,21174,썻어/Noun,3,1,2,3.334444814938313e-05,4.4425686932184186e-05,0.6666666666666666
21175,21175,쒸/Noun,3,1,2,3.334444814938313e-05,4.4425686932184186e-05,0.6666666666666666
21176,21176,우욱/Noun,3,1,2,3.334444814938313e-05,4.4425686932184186e-05,0.6666666666666666
21177,21177,띵하다/Adjective,3,2,1,4.445926419917751e-05,3.331926519913814e-05,0.6666666666666666
21178,21178,넓어지다/Verb,3,2,1,4.445926419917751e-05,3.331926519913814e-05,0.6666666666666666
21179,21179,혁/Noun,3,2,1,4.445926419917751e-05,3.331926519913814e-05,0.6666666666666666
21180,21180,통조림/Noun,3,2,1,4.445926419917751e-05,3.331926519913814e-05,0.6666666666666666
21181,21181,취화선/Noun,3,2,1,4.445926419917751e-05,3.331926519913814e-05,0.6666666666666666
21182,21182,퓨젼/Noun,3,1,2,3.334444814938313e-05,4.4425686932184186e-05,0.6666666666666666
21183,21183,터들/Adverb,3,1,2,3.334444814938313e-05,4.4425686932184186e-05,0.6666666666666666
21184,21184,외인구단/Noun,3,2,1,4.445926419917751e-05,3.331926519913814e-05,0.6666666666666666
21185,21185,꼽아/Noun,3,2,1,4.445926419917751e-05,3.331926519913814e-05,0.6666666666666666
21186,21186,왕호/Noun,3,2,1,4.445926419917751e-05,3.331926519913814e-05,0.6666666666666666
21187,21187,부러진화살/Noun,3,2,1,4.445926419917751e-05,3.331926519913814e-05,0.6666666666666666
21188,21188,오대/Modifier,3,2,1,4.445926419917751e-05,3.331926519913814e-05,0.6666666666666666
21189,21189,나무아미타불/Noun,3,1,2,3.334444814938313e-05,4.4425686932184186e-05,0.6666666666666666
21190,21190,등반/Noun,3,2,1,4.445926419917751e-05,3.331926519913814e-05,0.6666666666666666
21191,21191,스엠/Noun,3,1,2,3.334444814938313e-05,4.4425686932184186e-05,0.6666666666666666
21192,21192,이일/Noun,3,2,1,4.445926419917751e-05,3.331926519913814e-05,0.6666666666666666
21193,21193,명호/Noun,3,1,2,3.334444814938313e-05,4.4425686932184186e-05,0.6666666666666666
21194,21194,종용/Noun,3,1,2,3.334444814938313e-05,4.4425686932184186e-05,0.6666666666666666
21195,21195,와이키키/Noun,3,2,1,4.445926419917751e-05,3.331926519913814e-05,0.6666666666666666
21196,21196,배배/Noun,3,2,1,4.445926419917751e-05,3.331926519913814e-05,0.6666666666666666
21197,21197,레인보우/Noun,3,1,2,3.334444814938313e-05,4.4425686932184186e-05,0.6666666666666666
21198,21198,곽한구/Noun,3,1,2,3.334444814938313e-05,4.4425686932184186e-05,0.6666666666666666
21199,21199,아흐/Noun,3,2,1,4.445926419917751e-05,3.331926519913814e-05,0.6666666666666666
21200,21200,욱김/Noun,3,1,2,3.334444814938313e-05,4.4425686932184186e-05,0.6666666666666666
21201,21201,호나우두/Noun,3,1,2,3.334444814938313e-05,4.4425686932184186e-05,0.6666666666666666
21202,21202,달걀/Noun,3,2,1,4.445926419917751e-05,3.331926519913814e-05,0.6666666666666666
21203,21203,전립선/Noun,3,1,2,3.334444814938313e-05,4.4425686932184186e-05,0.6666666666666666
21204,21204,러더/Noun,3,1,2,3.334444814938313e-05,4.4425686932184186e-05,0.6666666666666666
21205,21205,공방전/Noun,3,2,1,4.445926419917751e-05,3.331926519913814e-05,0.6666666666666666
21206,21206,선구/Noun,3,1,2,3.334444814938313e-05,4.4425686932184186e-05,0.6666666666666666
21207,21207,매트/Noun,3,1,2,3.334444814938313e-05,4.4425686932184186e-05,0.6666666666666666
21208,21208,인디안/Noun,3,2,1,4.445926419917751e-05,3.331926519913814e-05,0.6666666666666666
21209,21209,별장/Noun,3,1,2,3.334444814938313e-05,4.4425686932184186e-05,0.6666666666666666
21210,21210,오금/Noun,3,2,1,4.445926419917751e-05,3.331926519913814e-05,0.6666666666666666
21211,21211,지형/Noun,3,1,2,3.334444814938313e-05,4.4425686932184186e-05,0.6666666666666666
21212,21212,텔런트/Noun,3,1,2,3.334444814938313e-05,4.4425686932184186e-05,0.6666666666666666
21213,21213,어익후/Noun,3,2,1,4.445926419917751e-05,3.331926519913814e-05,0.6666666666666666
21214,21214,교화/Noun,3,1,2,3.334444814938313e-05,4.4425686932184186e-05,0.6666666666666666
21215,21215,삼거리/Noun,3,1,2,3.334444814938313e-05,4.4425686932184186e-05,0.6666666666666666
21216,21216,플라워/Noun,3,2,1,4.445926419917751e-05,3.331926519913814e-05,0.6666666666666666
21217,21217,스테파니/Noun,3,2,1,4.445926419917751e-05,3.331926519913814e-05,0.6666666666666666
21218,21218,시리얼/Noun,3,2,1,4.445926419917751e-05,3.331926519913814e-05,0.6666666666666666
21219,21219,로맨싱/Noun,3,2,1,4.445926419917751e-05,3.331926519913814e-05,0.6666666666666666
21220,21220,Just/Alpha,3,2,1,4.445926419917751e-05,3.331926519913814e-05,0.6666666666666666
21221,21221,유려/Noun,3,1,2,3.334444814938313e-05,4.4425686932184186e-05,0.6666666666666666
21222,21222,변절/Noun,3,1,2,3.334444814938313e-05,4.4425686932184186e-05,0.6666666666666666
21223,21223,Is/Alpha,3,2,1,4.445926419917751e-05,3.331926519913814e-05,0.6666666666666666
21224,21224,보랑/Noun,3,1,2,3.334444814938313e-05,4.4425686932184186e-05,0.6666666666666666
21225,21225,아라가/Noun,3,1,2,3.334444814938313e-05,4.4425686932184186e-05,0.6666666666666666
21226,21226,왜꼭/Noun,3,2,1,4.445926419917751e-05,3.331926519913814e-05,0.6666666666666666
21227,21227,경주마/Noun,3,2,1,4.445926419917751e-05,3.331926519913814e-05,0.6666666666666666
21228,21228,9.8/Number,3,2,1,4.445926419917751e-05,3.331926519913814e-05,0.6666666666666666
21229,21229,식물/Noun,3,1,2,3.334444814938313e-05,4.4425686932184186e-05,0.6666666666666666
21230,21230,흡혈/Noun,3,2,1,4.445926419917751e-05,3.331926519913814e-05,0.6666666666666666
21231,21231,sea/Alpha,3,1,2,3.334444814938313e-05,4.4425686932184186e-05,0.6666666666666666
21232,21232,4~5년/Number,3,2,1,4.445926419917751e-05,3.331926519913814e-05,0.6666666666666666
21233,21233,개명/Noun,3,1,2,3.334444814938313e-05,4.4425686932184186e-05,0.6666666666666666
21234,21234,120회/Number,3,1,2,3.334444814938313e-05,4.4425686932184186e-05,0.6666666666666666
21235,21235,탈북/Noun,3,2,1,4.445926419917751e-05,3.331926519913814e-05,0.6666666666666666
21236,21236,게인/Noun,3,1,2,3.334444814938313e-05,4.4425686932184186e-05,0.6666666666666666
21237,21237,주차장/Noun,3,1,2,3.334444814938313e-05,4.4425686932184186e-05,0.6666666666666666
21238,21238,양치기/Noun,3,1,2,3.334444814938313e-05,4.4425686932184186e-05,0.6666666666666666
21239,21239,곰돌이/Noun,3,1,2,3.334444814938313e-05,4.4425686932184186e-05,0.6666666666666666
21240,21240,탭/Noun,3,2,1,4.445926419917751e-05,3.331926519913814e-05,0.6666666666666666
21241,21241,토코/Noun,3,2,1,4.445926419917751e-05,3.331926519913814e-05,0.6666666666666666
21242,21242,갱단/Noun,3,1,2,3.334444814938313e-05,4.4425686932184186e-05,0.6666666666666666
21243,21243,대초/Foreign,3,2,1,4.445926419917751e-05,3.331926519913814e-05,0.6666666666666666
21244,21244,풍문/Noun,3,2,1,4.445926419917751e-05,3.331926519913814e-05,0.6666666666666666
21245,21245,무력감/Noun,3,2,1,4.445926419917751e-05,3.331926519913814e-05,0.6666666666666666
21246,21246,섭소천/Noun,3,2,1,4.445926419917751e-05,3.331926519913814e-05,0.6666666666666666
21247,21247,9일/Number,3,2,1,4.445926419917751e-05,3.331926519913814e-05,0.6666666666666666
21248,21248,웽크/Noun,3,1,2,3.334444814938313e-05,4.4425686932184186e-05,0.6666666666666666
21249,21249,oo/Alpha,3,2,1,4.445926419917751e-05,3.331926519913814e-05,0.6666666666666666
21250,21250,짜들다/Verb,3,1,2,3.334444814938313e-05,4.4425686932184186e-05,0.6666666666666666
21251,21251,플래닛/Noun,3,1,2,3.334444814938313e-05,4.4425686932184186e-05,0.6666666666666666
21252,21252,9.6/Number,3,1,2,3.334444814938313e-05,4.4425686932184186e-05,0.6666666666666666
21253,21253,기재/Noun,3,2,1,4.445926419917751e-05,3.331926519913814e-05,0.6666666666666666
21254,21254,옥동자/Noun,3,2,1,4.445926419917751e-05,3.331926519913814e-05,0.6666666666666666
21255,21255,난도/Noun,3,2,1,4.445926419917751e-05,3.331926519913814e-05,0.6666666666666666
21256,21256,억이/Noun,3,2,1,4.445926419917751e-05,3.331926519913814e-05,0.6666666666666666
21257,21257,띤/Noun,3,2,1,4.445926419917751e-05,3.331926519913814e-05,0.6666666666666666
21258,21258,럿/Noun,3,1,2,3.334444814938313e-05,4.4425686932184186e-05,0.6666666666666666
21259,21259,변호/Noun,3,1,2,3.334444814938313e-05,4.4425686932184186e-05,0.6666666666666666
21260,21260,MSG/Alpha,3,2,1,4.445926419917751e-05,3.331926519913814e-05,0.6666666666666666
21261,21261,MTV/Alpha,3,1,2,3.334444814938313e-05,4.4425686932184186e-05,0.6666666666666666
21262,21262,옷장/Noun,3,1,2,3.334444814938313e-05,4.4425686932184186e-05,0.6666666666666666
21263,21263,꽹과리/Noun,3,1,2,3.334444814938313e-05,4.4425686932184186e-05,0.6666666666666666
21264,21264,야사/Noun,3,1,2,3.334444814938313e-05,4.4425686932184186e-05,0.6666666666666666
21265,21265,베뎃/Noun,3,1,2,3.334444814938313e-05,4.4425686932184186e-05,0.6666666666666666
21266,21266,괘안/Noun,3,2,1,4.445926419917751e-05,3.331926519913814e-05,0.6666666666666666
21267,21267,똘망똘망/Noun,3,2,1,4.445926419917751e-05,3.331926519913814e-05,0.6666666666666666
21268,21268,정망/Noun,3,2,1,4.445926419917751e-05,3.331926519913814e-05,0.6666666666666666
21269,21269,바캉스/Noun,3,1,2,3.334444814938313e-05,4.4425686932184186e-05,0.6666666666666666
21270,21270,주례/Noun,3,1,2,3.334444814938313e-05,4.4425686932184186e-05,0.6666666666666666
21271,21271,넥스트/Noun,3,2,1,4.445926419917751e-05,3.331926519913814e-05,0.6666666666666666
21272,21272,독기/Noun,3,2,1,4.445926419917751e-05,3.331926519913814e-05,0.6666666666666666
21273,21273,궁궐/Noun,3,2,1,4.445926419917751e-05,3.331926519913814e-05,0.6666666666666666
21274,21274,라고요/Eomi,3,2,1,4.445926419917751e-05,3.331926519913814e-05,0.6666666666666666
21275,21275,전당/Noun,3,1,2,3.334444814938313e-05,4.4425686932184186e-05,0.6666666666666666
21276,21276,롭코헨/Noun,3,2,1,4.445926419917751e-05,3.331926519913814e-05,0.6666666666666666
21277,21277,릭/Noun,3,2,1,4.445926419917751e-05,3.331926519913814e-05,0.6666666666666666
21278,21278,매그니토/Noun,3,2,1,4.445926419917751e-05,3.331926519913814e-05,0.6666666666666666
21279,21279,파란색/Noun,3,2,1,4.445926419917751e-05,3.331926519913814e-05,0.6666666666666666
21280,21280,원체/Adverb,3,2,1,4.445926419917751e-05,3.331926519913814e-05,0.6666666666666666
21281,21281,유희열/Noun,3,2,1,4.445926419917751e-05,3.331926519913814e-05,0.6666666666666666
21282,21282,뻔햇/Noun,3,1,2,3.334444814938313e-05,4.4425686932184186e-05,0.6666666666666666
21283,21283,수비/Noun,3,1,2,3.334444814938313e-05,4.4425686932184186e-05,0.6666666666666666
21284,21284,불금/Noun,3,2,1,4.445926419917751e-05,3.331926519913814e-05,0.6666666666666666
21285,21285,찜방/Noun,3,1,2,3.334444814938313e-05,4.4425686932184186e-05,0.6666666666666666
21286,21286,군복/Noun,3,1,2,3.334444814938313e-05,4.4425686932184186e-05,0.6666666666666666
21287,21287,국전/Noun,3,1,2,3.334444814938313e-05,4.4425686932184186e-05,0.6666666666666666
21288,21288,-;;;/Punctuation,3,2,1,4.445926419917751e-05,3.331926519913814e-05,0.6666666666666666
21289,21289,자명하다/Adjective,3,1,2,3.334444814938313e-05,4.4425686932184186e-05,0.6666666666666666
21290,21290,1950년/Number,3,2,1,4.445926419917751e-05,3.331926519913814e-05,0.6666666666666666
21291,21291,쇼걸/Noun,3,2,1,4.445926419917751e-05,3.331926519913814e-05,0.6666666666666666
21292,21292,존잼임/Noun,3,2,1,4.445926419917751e-05,3.331926519913814e-05,0.6666666666666666
21293,21293,포탄/Noun,3,2,1,4.445926419917751e-05,3.331926519913814e-05,0.6666666666666666
21294,21294,브란/Noun,3,1,2,3.334444814938313e-05,4.4425686932184186e-05,0.6666666666666666
21295,21295,호암/Noun,3,2,1,4.445926419917751e-05,3.331926519913814e-05,0.6666666666666666
21296,21296,구구구/Noun,3,2,1,4.445926419917751e-05,3.331926519913814e-05,0.6666666666666666
21297,21297,화성인/Noun,3,1,2,3.334444814938313e-05,4.4425686932184186e-05,0.6666666666666666
21298,21298,뻥뻥/Noun,3,1,2,3.334444814938313e-05,4.4425686932184186e-05,0.6666666666666666
21299,21299,클라우드/Noun,3,1,2,3.334444814938313e-05,4.4425686932184186e-05,0.6666666666666666
21300,21300,미술품/Noun,3,1,2,3.334444814938313e-05,4.4425686932184186e-05,0.6666666666666666
21301,21301,가평/Noun,3,1,2,3.334444814938313e-05,4.4425686932184186e-05,0.6666666666666666
21302,21302,맬릭/Noun,3,2,1,4.445926419917751e-05,3.331926519913814e-05,0.6666666666666666
21303,21303,지르르/Noun,3,1,2,3.334444814938313e-05,4.4425686932184186e-05,0.6666666666666666
21304,21304,수도승/Noun,3,1,2,3.334444814938313e-05,4.4425686932184186e-05,0.6666666666666666
21305,21305,해롤드/Noun,3,2,1,4.445926419917751e-05,3.331926519913814e-05,0.6666666666666666
21306,21306,족발/Noun,3,2,1,4.445926419917751e-05,3.331926519913814e-05,0.6666666666666666
21307,21307,하층/Noun,3,2,1,4.445926419917751e-05,3.331926519913814e-05,0.6666666666666666
21308,21308,섭취/Noun,3,1,2,3.334444814938313e-05,4.4425686932184186e-05,0.6666666666666666
21309,21309,119/Number,3,1,2,3.334444814938313e-05,4.4425686932184186e-05,0.6666666666666666
21310,21310,밥딜런/Noun,3,2,1,4.445926419917751e-05,3.331926519913814e-05,0.6666666666666666
21311,21311,젖통/Noun,3,1,2,3.334444814938313e-05,4.4425686932184186e-05,0.6666666666666666
21312,21312,신사동/Noun,3,2,1,4.445926419917751e-05,3.331926519913814e-05,0.6666666666666666
21313,21313,리셋/Noun,3,1,2,3.334444814938313e-05,4.4425686932184186e-05,0.6666666666666666
21314,21314,리핑/Noun,3,2,1,4.445926419917751e-05,3.331926519913814e-05,0.6666666666666666
21315,21315,약화/Noun,3,1,2,3.334444814938313e-05,4.4425686932184186e-05,0.6666666666666666
21316,21316,이경이/Noun,3,1,2,3.334444814938313e-05,4.4425686932184186e-05,0.6666666666666666
21317,21317,제자리걸음/Noun,3,1,2,3.334444814938313e-05,4.4425686932184186e-05,0.6666666666666666
21318,21318,삽/Noun,3,2,1,4.445926419917751e-05,3.331926519913814e-05,0.6666666666666666
21319,21319,스카페이스/Noun,3,2,1,4.445926419917751e-05,3.331926519913814e-05,0.6666666666666666
21320,21320,새우/Noun,3,2,1,4.445926419917751e-05,3.331926519913814e-05,0.6666666666666666
21321,21321,어림없다/Adjective,3,1,2,3.334444814938313e-05,4.4425686932184186e-05,0.6666666666666666
21322,21322,렛미인/Noun,3,2,1,4.445926419917751e-05,3.331926519913814e-05,0.6666666666666666
21323,21323,읔/Exclamation,3,1,2,3.334444814938313e-05,4.4425686932184186e-05,0.6666666666666666
21324,21324,유지인/Noun,3,2,1,4.445926419917751e-05,3.331926519913814e-05,0.6666666666666666
21325,21325,삼국/Noun,3,2,1,4.445926419917751e-05,3.331926519913814e-05,0.6666666666666666
21326,21326,무상함/Noun,3,2,1,4.445926419917751e-05,3.331926519913814e-05,0.6666666666666666
21327,21327,키득키득/Adverb,3,1,2,3.334444814938313e-05,4.4425686932184186e-05,0.6666666666666666
21328,21328,변혁/Noun,3,1,2,3.334444814938313e-05,4.4425686932184186e-05,0.6666666666666666
21329,21329,피로하다/Adjective,3,1,2,3.334444814938313e-05,4.4425686932184186e-05,0.6666666666666666
21330,21330,쉬는시간/Noun,3,1,2,3.334444814938313e-05,4.4425686932184186e-05,0.6666666666666666
21331,21331,군번/Noun,3,2,1,4.445926419917751e-05,3.331926519913814e-05,0.6666666666666666
21332,21332,버럭/Noun,3,1,2,3.334444814938313e-05,4.4425686932184186e-05,0.6666666666666666
21333,21333,-..-/Punctuation,3,1,2,3.334444814938313e-05,4.4425686932184186e-05,0.6666666666666666
21334,21334,fucking/Alpha,3,2,1,4.445926419917751e-05,3.331926519913814e-05,0.6666666666666666
21335,21335,막회/Noun,3,1,2,3.334444814938313e-05,4.4425686932184186e-05,0.6666666666666666
21336,21336,서예/Noun,3,1,2,3.334444814938313e-05,4.4425686932184186e-05,0.6666666666666666
21337,21337,성녀/Noun,3,1,2,3.334444814938313e-05,4.4425686932184186e-05,0.6666666666666666
21338,21338,회사원/Noun,3,1,2,3.334444814938313e-05,4.4425686932184186e-05,0.6666666666666666
21339,21339,도돌이표/Noun,3,1,2,3.334444814938313e-05,4.4425686932184186e-05,0.6666666666666666
21340,21340,must/Alpha,3,2,1,4.445926419917751e-05,3.331926519913814e-05,0.6666666666666666
21341,21341,징벌/Noun,3,2,1,4.445926419917751e-05,3.331926519913814e-05,0.6666666666666666
21342,21342,은자/Noun,3,1,2,3.334444814938313e-05,4.4425686932184186e-05,0.6666666666666666
21343,21343,마츠준/Noun,3,2,1,4.445926419917751e-05,3.331926519913814e-05,0.6666666666666666
21344,21344,조춘/Noun,3,1,2,3.334444814938313e-05,4.4425686932184186e-05,0.6666666666666666
21345,21345,피바디/Noun,3,1,2,3.334444814938313e-05,4.4425686932184186e-05,0.6666666666666666
21346,21346,김응수/Noun,3,2,1,4.445926419917751e-05,3.331926519913814e-05,0.6666666666666666
21347,21347,토종/Noun,3,2,1,4.445926419917751e-05,3.331926519913814e-05,0.6666666666666666
21348,21348,억세다/Adjective,3,2,1,4.445926419917751e-05,3.331926519913814e-05,0.6666666666666666
21349,21349,꽈배기/Noun,3,2,1,4.445926419917751e-05,3.331926519913814e-05,0.6666666666666666
21350,21350,불균형/Noun,3,1,2,3.334444814938313e-05,4.4425686932184186e-05,0.6666666666666666
21351,21351,홍진영/Noun,3,2,1,4.445926419917751e-05,3.331926519913814e-05,0.6666666666666666
21352,21352,절판/Noun,3,2,1,4.445926419917751e-05,3.331926519913814e-05,0.6666666666666666
21353,21353,고유키/Noun,3,1,2,3.334444814938313e-05,4.4425686932184186e-05,0.6666666666666666
21354,21354,난간/Noun,3,1,2,3.334444814938313e-05,4.4425686932184186e-05,0.6666666666666666
21355,21355,묶여서/Noun,3,2,1,4.445926419917751e-05,3.331926519913814e-05,0.6666666666666666
21356,21356,휴양지/Noun,3,2,1,4.445926419917751e-05,3.331926519913814e-05,0.6666666666666666
21357,21357,코시/Noun,3,1,2,3.334444814938313e-05,4.4425686932184186e-05,0.6666666666666666
21358,21358,고글/Noun,3,1,2,3.334444814938313e-05,4.4425686932184186e-05,0.6666666666666666
21359,21359,흫/Noun,3,1,2,3.334444814938313e-05,4.4425686932184186e-05,0.6666666666666666
21360,21360,가설/Noun,3,1,2,3.334444814938313e-05,4.4425686932184186e-05,0.6666666666666666
21361,21361,완전범죄/Noun,3,2,1,4.445926419917751e-05,3.331926519913814e-05,0.6666666666666666
21362,21362,예지/Noun,3,2,1,4.445926419917751e-05,3.331926519913814e-05,0.6666666666666666
21363,21363,하규/Noun,3,2,1,4.445926419917751e-05,3.331926519913814e-05,0.6666666666666666
21364,21364,레논/Noun,3,2,1,4.445926419917751e-05,3.331926519913814e-05,0.6666666666666666
21365,21365,황태자/Noun,3,1,2,3.334444814938313e-05,4.4425686932184186e-05,0.6666666666666666
21366,21366,워터보이즈/Noun,3,2,1,4.445926419917751e-05,3.331926519913814e-05,0.6666666666666666
21367,21367,말끔/Adverb,3,2,1,4.445926419917751e-05,3.331926519913814e-05,0.6666666666666666
21368,21368,조무래기/Noun,3,1,2,3.334444814938313e-05,4.4425686932184186e-05,0.6666666666666666
21369,21369,동/Noun,3,2,1,4.445926419917751e-05,3.331926519913814e-05,0.6666666666666666
21370,21370,슬라이드/Noun,3,2,1,4.445926419917751e-05,3.331926519913814e-05,0.6666666666666666
21371,21371,파묻다/Verb,3,2,1,4.445926419917751e-05,3.331926519913814e-05,0.6666666666666666
21372,21372,고시원/Noun,3,2,1,4.445926419917751e-05,3.331926519913814e-05,0.6666666666666666
21373,21373,레이브/Noun,3,1,2,3.334444814938313e-05,4.4425686932184186e-05,0.6666666666666666
21374,21374,신명/Noun,3,2,1,4.445926419917751e-05,3.331926519913814e-05,0.6666666666666666
21375,21375,"...,,/Punctuation",3,1,2,3.334444814938313e-05,4.4425686932184186e-05,0.6666666666666666
21376,21376,강대위/Noun,3,2,1,4.445926419917751e-05,3.331926519913814e-05,0.6666666666666666
21377,21377,컨져링/Noun,3,1,2,3.334444814938313e-05,4.4425686932184186e-05,0.6666666666666666
21378,21378,이었다/Foreign,3,1,2,3.334444814938313e-05,4.4425686932184186e-05,0.6666666666666666
21379,21379,땡잡다/Verb,3,1,2,3.334444814938313e-05,4.4425686932184186e-05,0.6666666666666666
21380,21380,와호장룡/Noun,3,1,2,3.334444814938313e-05,4.4425686932184186e-05,0.6666666666666666
21381,21381,이갑/Noun,3,1,2,3.334444814938313e-05,4.4425686932184186e-05,0.6666666666666666
21382,21382,앍다/Verb,3,1,2,3.334444814938313e-05,4.4425686932184186e-05,0.6666666666666666
21383,21383,릴레이/Noun,3,1,2,3.334444814938313e-05,4.4425686932184186e-05,0.6666666666666666
21384,21384,때기/Noun,3,1,2,3.334444814938313e-05,4.4425686932184186e-05,0.6666666666666666
21385,21385,해심/Noun,3,2,1,4.445926419917751e-05,3.331926519913814e-05,0.6666666666666666
21386,21386,이었음/Eomi,3,1,2,3.334444814938313e-05,4.4425686932184186e-05,0.6666666666666666
21387,21387,리바이/Noun,3,1,2,3.334444814938313e-05,4.4425686932184186e-05,0.6666666666666666
21388,21388,롤러/Noun,3,2,1,4.445926419917751e-05,3.331926519913814e-05,0.6666666666666666
21389,21389,영화제작진/Noun,3,1,2,3.334444814938313e-05,4.4425686932184186e-05,0.6666666666666666
21390,21390,보드카/Noun,3,2,1,4.445926419917751e-05,3.331926519913814e-05,0.6666666666666666
21391,21391,기니/Noun,3,2,1,4.445926419917751e-05,3.331926519913814e-05,0.6666666666666666
21392,21392,모래성/Noun,3,1,2,3.334444814938313e-05,4.4425686932184186e-05,0.6666666666666666
21393,21393,살피/Noun,3,2,1,4.445926419917751e-05,3.331926519913814e-05,0.6666666666666666
21394,21394,실드/Noun,3,1,2,3.334444814938313e-05,4.4425686932184186e-05,0.6666666666666666
21395,21395,같아욤/Noun,3,2,1,4.445926419917751e-05,3.331926519913814e-05,0.6666666666666666
21396,21396,여우비/Noun,3,2,1,4.445926419917751e-05,3.331926519913814e-05,0.6666666666666666
21397,21397,대악/Noun,3,2,1,4.445926419917751e-05,3.331926519913814e-05,0.6666666666666666
21398,21398,정도가/Foreign,3,2,1,4.445926419917751e-05,3.331926519913814e-05,0.6666666666666666
21399,21399,cliche/Alpha,3,1,2,3.334444814938313e-05,4.4425686932184186e-05,0.6666666666666666
21400,21400,명랑만화/Noun,3,1,2,3.334444814938313e-05,4.4425686932184186e-05,0.6666666666666666
21401,21401,스타트/Noun,3,2,1,4.445926419917751e-05,3.331926519913814e-05,0.6666666666666666
21402,21402,샛길/Noun,3,1,2,3.334444814938313e-05,4.4425686932184186e-05,0.6666666666666666
21403,21403,학점/Noun,3,1,2,3.334444814938313e-05,4.4425686932184186e-05,0.6666666666666666
21404,21404,두렁/Noun,3,2,1,4.445926419917751e-05,3.331926519913814e-05,0.6666666666666666
21405,21405,하루키/Noun,3,2,1,4.445926419917751e-05,3.331926519913814e-05,0.6666666666666666
21406,21406,중임/Noun,3,1,2,3.334444814938313e-05,4.4425686932184186e-05,0.6666666666666666
21407,21407,잣음/Noun,3,1,2,3.334444814938313e-05,4.4425686932184186e-05,0.6666666666666666
21408,21408,분쟁/Noun,3,2,1,4.445926419917751e-05,3.331926519913814e-05,0.6666666666666666
21409,21409,불법체류/Noun,3,1,2,3.334444814938313e-05,4.4425686932184186e-05,0.6666666666666666
21410,21410,여관/Noun,3,1,2,3.334444814938313e-05,4.4425686932184186e-05,0.6666666666666666
21411,21411,123분/Number,3,1,2,3.334444814938313e-05,4.4425686932184186e-05,0.6666666666666666
21412,21412,주야/Noun,3,2,1,4.445926419917751e-05,3.331926519913814e-05,0.6666666666666666
21413,21413,적발/Noun,3,2,1,4.445926419917751e-05,3.331926519913814e-05,0.6666666666666666
21414,21414,블루아/Noun,3,1,2,3.334444814938313e-05,4.4425686932184186e-05,0.6666666666666666
21415,21415,케냐/Noun,3,2,1,4.445926419917751e-05,3.331926519913814e-05,0.6666666666666666
21416,21416,워크샵/Noun,3,1,2,3.334444814938313e-05,4.4425686932184186e-05,0.6666666666666666
21417,21417,파파로티/Noun,3,2,1,4.445926419917751e-05,3.331926519913814e-05,0.6666666666666666
21418,21418,秀作/Foreign,3,2,1,4.445926419917751e-05,3.331926519913814e-05,0.6666666666666666
21419,21419,이맘때/Adverb,3,2,1,4.445926419917751e-05,3.331926519913814e-05,0.6666666666666666
21420,21420,빛바랜/Noun,3,1,2,3.334444814938313e-05,4.4425686932184186e-05,0.6666666666666666
21421,21421,수필/Noun,3,2,1,4.445926419917751e-05,3.331926519913814e-05,0.6666666666666666
21422,21422,-.-;;;/Punctuation,3,1,2,3.334444814938313e-05,4.4425686932184186e-05,0.6666666666666666
21423,21423,젋/Noun,3,2,1,4.445926419917751e-05,3.331926519913814e-05,0.6666666666666666
21424,21424,후버/Noun,3,2,1,4.445926419917751e-05,3.331926519913814e-05,0.6666666666666666
21425,21425,목각/Noun,3,2,1,4.445926419917751e-05,3.331926519913814e-05,0.6666666666666666
21426,21426,세대차이/Noun,3,1,2,3.334444814938313e-05,4.4425686932184186e-05,0.6666666666666666
21427,21427,정은우/Noun,3,2,1,4.445926419917751e-05,3.331926519913814e-05,0.6666666666666666
21428,21428,스타더스트/Noun,3,1,2,3.334444814938313e-05,4.4425686932184186e-05,0.6666666666666666
21429,21429,심오/Noun,3,2,1,4.445926419917751e-05,3.331926519913814e-05,0.6666666666666666
21430,21430,인도네시아/Noun,3,2,1,4.445926419917751e-05,3.331926519913814e-05,0.6666666666666666
21431,21431,마터스/Noun,3,1,2,3.334444814938313e-05,4.4425686932184186e-05,0.6666666666666666
21432,21432,기신/Noun,3,2,1,4.445926419917751e-05,3.331926519913814e-05,0.6666666666666666
21433,21433,볼드윈/Noun,3,2,1,4.445926419917751e-05,3.331926519913814e-05,0.6666666666666666
21434,21434,듀크/Noun,3,1,2,3.334444814938313e-05,4.4425686932184186e-05,0.6666666666666666
21435,21435,콸콸/Noun,3,2,1,4.445926419917751e-05,3.331926519913814e-05,0.6666666666666666
21436,21436,플레인/Noun,3,1,2,3.334444814938313e-05,4.4425686932184186e-05,0.6666666666666666
21437,21437,말짱/Adverb,3,2,1,4.445926419917751e-05,3.331926519913814e-05,0.6666666666666666
21438,21438,영국군/Noun,3,1,2,3.334444814938313e-05,4.4425686932184186e-05,0.6666666666666666
21439,21439,국기/Noun,3,2,1,4.445926419917751e-05,3.331926519913814e-05,0.6666666666666666
21440,21440,청산/Noun,3,1,2,3.334444814938313e-05,4.4425686932184186e-05,0.6666666666666666
21441,21441,방송사고/Noun,3,1,2,3.334444814938313e-05,4.4425686932184186e-05,0.6666666666666666
21442,21442,거위/Noun,3,2,1,4.445926419917751e-05,3.331926519913814e-05,0.6666666666666666
21443,21443,붓/Noun,3,1,2,3.334444814938313e-05,4.4425686932184186e-05,0.6666666666666666
21444,21444,미제국/Noun,3,2,1,4.445926419917751e-05,3.331926519913814e-05,0.6666666666666666
21445,21445,43/Number,3,1,2,3.334444814938313e-05,4.4425686932184186e-05,0.6666666666666666
21446,21446,세속/Noun,3,2,1,4.445926419917751e-05,3.331926519913814e-05,0.6666666666666666
21447,21447,펜더/Noun,3,2,1,4.445926419917751e-05,3.331926519913814e-05,0.6666666666666666
21448,21448,Space/Alpha,3,2,1,4.445926419917751e-05,3.331926519913814e-05,0.6666666666666666
21449,21449,마지막방송/Noun,3,2,1,4.445926419917751e-05,3.331926519913814e-05,0.6666666666666666
21450,21450,렬/Noun,3,2,1,4.445926419917751e-05,3.331926519913814e-05,0.6666666666666666
21451,21451,비젼/Noun,3,2,1,4.445926419917751e-05,3.331926519913814e-05,0.6666666666666666
21452,21452,신급/Noun,3,2,1,4.445926419917751e-05,3.331926519913814e-05,0.6666666666666666
21453,21453,푸른빛/Noun,3,2,1,4.445926419917751e-05,3.331926519913814e-05,0.6666666666666666
21454,21454,신기다/Verb,3,2,1,4.445926419917751e-05,3.331926519913814e-05,0.6666666666666666
21455,21455,설현/Noun,3,2,1,4.445926419917751e-05,3.331926519913814e-05,0.6666666666666666
21456,21456,불화/Noun,3,2,1,4.445926419917751e-05,3.331926519913814e-05,0.6666666666666666
21457,21457,변금련/Noun,3,2,1,4.445926419917751e-05,3.331926519913814e-05,0.6666666666666666
21458,21458,플리/Noun,3,2,1,4.445926419917751e-05,3.331926519913814e-05,0.6666666666666666
21459,21459,무제한/Noun,3,2,1,4.445926419917751e-05,3.331926519913814e-05,0.6666666666666666
21460,21460,하이퍼/Noun,3,1,2,3.334444814938313e-05,4.4425686932184186e-05,0.6666666666666666
21461,21461,die/Alpha,3,2,1,4.445926419917751e-05,3.331926519913814e-05,0.6666666666666666
21462,21462,째지다/Verb,3,2,1,4.445926419917751e-05,3.331926519913814e-05,0.6666666666666666
21463,21463,ㄴㅐ/KoreanParticle,3,2,1,4.445926419917751e-05,3.331926519913814e-05,0.6666666666666666
21464,21464,쿤/Noun,3,2,1,4.445926419917751e-05,3.331926519913814e-05,0.6666666666666666
21465,21465,마테/Noun,3,2,1,4.445926419917751e-05,3.331926519913814e-05,0.6666666666666666
21466,21466,서일/Noun,3,2,1,4.445926419917751e-05,3.331926519913814e-05,0.6666666666666666
21467,21467,까진/Foreign,3,1,2,3.334444814938313e-05,4.4425686932184186e-05,0.6666666666666666
21468,21468,정문/Noun,3,2,1,4.445926419917751e-05,3.331926519913814e-05,0.6666666666666666
21469,21469,목도/Noun,3,2,1,4.445926419917751e-05,3.331926519913814e-05,0.6666666666666666
21470,21470,old/Alpha,3,2,1,4.445926419917751e-05,3.331926519913814e-05,0.6666666666666666
21471,21471,한송이/Noun,3,1,2,3.334444814938313e-05,4.4425686932184186e-05,0.6666666666666666
21472,21472,먹고다/Verb,3,1,2,3.334444814938313e-05,4.4425686932184186e-05,0.6666666666666666
21473,21473,8시간/Number,3,2,1,4.445926419917751e-05,3.331926519913814e-05,0.6666666666666666
21474,21474,1959년/Number,3,2,1,4.445926419917751e-05,3.331926519913814e-05,0.6666666666666666
21475,21475,백화/Noun,3,1,2,3.334444814938313e-05,4.4425686932184186e-05,0.6666666666666666
21476,21476,밴디트/Noun,3,2,1,4.445926419917751e-05,3.331926519913814e-05,0.6666666666666666
21477,21477,상품화/Noun,3,1,2,3.334444814938313e-05,4.4425686932184186e-05,0.6666666666666666
21478,21478,삻/Noun,3,2,1,4.445926419917751e-05,3.331926519913814e-05,0.6666666666666666
21479,21479,비통하다/Adjective,3,2,1,4.445926419917751e-05,3.331926519913814e-05,0.6666666666666666
21480,21480,새장/Noun,3,2,1,4.445926419917751e-05,3.331926519913814e-05,0.6666666666666666
21481,21481,발길질/Noun,3,1,2,3.334444814938313e-05,4.4425686932184186e-05,0.6666666666666666
21482,21482,둘째딸/Noun,3,1,2,3.334444814938313e-05,4.4425686932184186e-05,0.6666666666666666
21483,21483,파먹다/Verb,3,2,1,4.445926419917751e-05,3.331926519913814e-05,0.6666666666666666
21484,21484,an/Alpha,3,1,2,3.334444814938313e-05,4.4425686932184186e-05,0.6666666666666666
21485,21485,성차별/Noun,3,1,2,3.334444814938313e-05,4.4425686932184186e-05,0.6666666666666666
21486,21486,캥거루/Noun,3,1,2,3.334444814938313e-05,4.4425686932184186e-05,0.6666666666666666
21487,21487,실정/Noun,3,2,1,4.445926419917751e-05,3.331926519913814e-05,0.6666666666666666
21488,21488,슈워/Noun,3,1,2,3.334444814938313e-05,4.4425686932184186e-05,0.6666666666666666
21489,21489,신생/Noun,3,1,2,3.334444814938313e-05,4.4425686932184186e-05,0.6666666666666666
21490,21490,"....""/Punctuation",3,2,1,4.445926419917751e-05,3.331926519913814e-05,0.6666666666666666
21491,21491,자질구레하다/Adjective,3,2,1,4.445926419917751e-05,3.331926519913814e-05,0.6666666666666666
21492,21492,르와르/Noun,3,1,2,3.334444814938313e-05,4.4425686932184186e-05,0.6666666666666666
21493,21493,주룩/Noun,3,2,1,4.445926419917751e-05,3.331926519913814e-05,0.6666666666666666
21494,21494,강리나/Noun,3,2,1,4.445926419917751e-05,3.331926519913814e-05,0.6666666666666666
21495,21495,"....,./Punctuation",3,1,2,3.334444814938313e-05,4.4425686932184186e-05,0.6666666666666666
21496,21496,풋풋/Noun,3,2,1,4.445926419917751e-05,3.331926519913814e-05,0.6666666666666666
21497,21497,계심/Noun,3,1,2,3.334444814938313e-05,4.4425686932184186e-05,0.6666666666666666
21498,21498,손실/Noun,3,1,2,3.334444814938313e-05,4.4425686932184186e-05,0.6666666666666666
21499,21499,살인의추억/Noun,3,2,1,4.445926419917751e-05,3.331926519913814e-05,0.6666666666666666
21500,21500,영화인데/Foreign,3,1,2,3.334444814938313e-05,4.4425686932184186e-05,0.6666666666666666
21501,21501,알흠답/Noun,3,2,1,4.445926419917751e-05,3.331926519913814e-05,0.6666666666666666
21502,21502,띄엄/Noun,3,2,1,4.445926419917751e-05,3.331926519913814e-05,0.6666666666666666
21503,21503,7~80년/Number,3,1,2,3.334444814938313e-05,4.4425686932184186e-05,0.6666666666666666
21504,21504,눈꽃/Noun,3,2,1,4.445926419917751e-05,3.331926519913814e-05,0.6666666666666666
21505,21505,자켓/Noun,3,2,1,4.445926419917751e-05,3.331926519913814e-05,0.6666666666666666
21506,21506,막노동/Noun,3,1,2,3.334444814938313e-05,4.4425686932184186e-05,0.6666666666666666
21507,21507,온난화/Noun,3,2,1,4.445926419917751e-05,3.331926519913814e-05,0.6666666666666666
21508,21508,얌마/Noun,3,2,1,4.445926419917751e-05,3.331926519913814e-05,0.6666666666666666
21509,21509,치욕스럽다/Adjective,3,1,2,3.334444814938313e-05,4.4425686932184186e-05,0.6666666666666666
21510,21510,만수무강/Noun,3,2,1,4.445926419917751e-05,3.331926519913814e-05,0.6666666666666666
21511,21511,Again/Alpha,3,1,2,3.334444814938313e-05,4.4425686932184186e-05,0.6666666666666666
21512,21512,오션스일레븐/Noun,3,1,2,3.334444814938313e-05,4.4425686932184186e-05,0.6666666666666666
21513,21513,투기/Noun,3,1,2,3.334444814938313e-05,4.4425686932184186e-05,0.6666666666666666
21514,21514,싹둑/Noun,3,1,2,3.334444814938313e-05,4.4425686932184186e-05,0.6666666666666666
21515,21515,상부/Noun,3,2,1,4.445926419917751e-05,3.331926519913814e-05,0.6666666666666666
21516,21516,허름/Noun,3,2,1,4.445926419917751e-05,3.331926519913814e-05,0.6666666666666666
21517,21517,장애우/Noun,3,2,1,4.445926419917751e-05,3.331926519913814e-05,0.6666666666666666
21518,21518,살면서/Foreign,3,1,2,3.334444814938313e-05,4.4425686932184186e-05,0.6666666666666666
21519,21519,김명곤/Noun,3,2,1,4.445926419917751e-05,3.331926519913814e-05,0.6666666666666666
21520,21520,알리바이/Noun,3,1,2,3.334444814938313e-05,4.4425686932184186e-05,0.6666666666666666
21521,21521,모비딕/Noun,3,1,2,3.334444814938313e-05,4.4425686932184186e-05,0.6666666666666666
21522,21522,부티/Noun,3,1,2,3.334444814938313e-05,4.4425686932184186e-05,0.6666666666666666
21523,21523,화초/Noun,3,1,2,3.334444814938313e-05,4.4425686932184186e-05,0.6666666666666666
21524,21524,불빛/Noun,3,1,2,3.334444814938313e-05,4.4425686932184186e-05,0.6666666666666666
21525,21525,나누어지다/Verb,3,1,2,3.334444814938313e-05,4.4425686932184186e-05,0.6666666666666666
21526,21526,경수/Noun,3,2,1,4.445926419917751e-05,3.331926519913814e-05,0.6666666666666666
21527,21527,패스트푸드/Noun,3,2,1,4.445926419917751e-05,3.331926519913814e-05,0.6666666666666666
21528,21528,홀로코스트/Noun,3,2,1,4.445926419917751e-05,3.331926519913814e-05,0.6666666666666666
21529,21529,강문영/Noun,3,1,2,3.334444814938313e-05,4.4425686932184186e-05,0.6666666666666666
21530,21530,억대/Noun,3,2,1,4.445926419917751e-05,3.331926519913814e-05,0.6666666666666666
21531,21531,아이보리/Noun,3,2,1,4.445926419917751e-05,3.331926519913814e-05,0.6666666666666666
21532,21532,!?!/Punctuation,3,1,2,3.334444814938313e-05,4.4425686932184186e-05,0.6666666666666666
21533,21533,월광/Noun,3,2,1,4.445926419917751e-05,3.331926519913814e-05,0.6666666666666666
21534,21534,간단명료/Noun,3,2,1,4.445926419917751e-05,3.331926519913814e-05,0.6666666666666666
21535,21535,군영/Noun,3,1,2,3.334444814938313e-05,4.4425686932184186e-05,0.6666666666666666
21536,21536,헐뜯다/Verb,3,2,1,4.445926419917751e-05,3.331926519913814e-05,0.6666666666666666
21537,21537,정훈/Noun,3,2,1,4.445926419917751e-05,3.331926519913814e-05,0.6666666666666666
21538,21538,남부/Noun,3,2,1,4.445926419917751e-05,3.331926519913814e-05,0.6666666666666666
21539,21539,기분조타/Noun,3,1,2,3.334444814938313e-05,4.4425686932184186e-05,0.6666666666666666
21540,21540,너바나/Noun,3,1,2,3.334444814938313e-05,4.4425686932184186e-05,0.6666666666666666
21541,21541,",...../Punctuation",3,1,2,3.334444814938313e-05,4.4425686932184186e-05,0.6666666666666666
21542,21542,Are/Alpha,3,2,1,4.445926419917751e-05,3.331926519913814e-05,0.6666666666666666
21543,21543,멕시칸/Noun,3,2,1,4.445926419917751e-05,3.331926519913814e-05,0.6666666666666666
21544,21544,노근리/Noun,3,2,1,4.445926419917751e-05,3.331926519913814e-05,0.6666666666666666
21545,21545,짜리몽땅/Noun,3,1,2,3.334444814938313e-05,4.4425686932184186e-05,0.6666666666666666
21546,21546,할꼬/Noun,3,1,2,3.334444814938313e-05,4.4425686932184186e-05,0.6666666666666666
21547,21547,평준화/Noun,3,1,2,3.334444814938313e-05,4.4425686932184186e-05,0.6666666666666666
21548,21548,생인/Noun,3,2,1,4.445926419917751e-05,3.331926519913814e-05,0.6666666666666666
21549,21549,액선/Noun,3,2,1,4.445926419917751e-05,3.331926519913814e-05,0.6666666666666666
21550,21550,환전/Noun,3,2,1,4.445926419917751e-05,3.331926519913814e-05,0.6666666666666666
21551,21551,떠보다/Verb,3,1,2,3.334444814938313e-05,4.4425686932184186e-05,0.6666666666666666
21552,21552,오키나와/Noun,3,2,1,4.445926419917751e-05,3.331926519913814e-05,0.6666666666666666
21553,21553,아이로봇/Noun,3,2,1,4.445926419917751e-05,3.331926519913814e-05,0.6666666666666666
21554,21554,시안/Noun,3,1,2,3.334444814938313e-05,4.4425686932184186e-05,0.6666666666666666
21555,21555,발키리/Noun,3,1,2,3.334444814938313e-05,4.4425686932184186e-05,0.6666666666666666
21556,21556,웨이브/Noun,3,1,2,3.334444814938313e-05,4.4425686932184186e-05,0.6666666666666666
21557,21557,피터지다/Adjective,3,2,1,4.445926419917751e-05,3.331926519913814e-05,0.6666666666666666
21558,21558,송곳/Noun,3,1,2,3.334444814938313e-05,4.4425686932184186e-05,0.6666666666666666
21559,21559,늑대개/Noun,3,1,2,3.334444814938313e-05,4.4425686932184186e-05,0.6666666666666666
21560,21560,카사블랑카/Noun,3,2,1,4.445926419917751e-05,3.331926519913814e-05,0.6666666666666666
21561,21561,미소년/Noun,3,2,1,4.445926419917751e-05,3.331926519913814e-05,0.6666666666666666
21562,21562,학업/Noun,3,2,1,4.445926419917751e-05,3.331926519913814e-05,0.6666666666666666
21563,21563,에블린/Noun,3,2,1,4.445926419917751e-05,3.331926519913814e-05,0.6666666666666666
21564,21564,이맘/Noun,3,2,1,4.445926419917751e-05,3.331926519913814e-05,0.6666666666666666
21565,21565,동안은/Foreign,3,1,2,3.334444814938313e-05,4.4425686932184186e-05,0.6666666666666666
21566,21566,연애영화/Noun,3,2,1,4.445926419917751e-05,3.331926519913814e-05,0.6666666666666666
21567,21567,배스/Noun,3,1,2,3.334444814938313e-05,4.4425686932184186e-05,0.6666666666666666
21568,21568,유니/Noun,3,1,2,3.334444814938313e-05,4.4425686932184186e-05,0.6666666666666666
21569,21569,고여/Noun,3,1,2,3.334444814938313e-05,4.4425686932184186e-05,0.6666666666666666
21570,21570,단속/Noun,3,1,2,3.334444814938313e-05,4.4425686932184186e-05,0.6666666666666666
21571,21571,윤간/Noun,3,1,2,3.334444814938313e-05,4.4425686932184186e-05,0.6666666666666666
21572,21572,류시퍼/Noun,3,1,2,3.334444814938313e-05,4.4425686932184186e-05,0.6666666666666666
21573,21573,기사도/Noun,3,2,1,4.445926419917751e-05,3.331926519913814e-05,0.6666666666666666
21574,21574,장편소설/Noun,3,2,1,4.445926419917751e-05,3.331926519913814e-05,0.6666666666666666
21575,21575,스파이더/Noun,3,1,2,3.334444814938313e-05,4.4425686932184186e-05,0.6666666666666666
21576,21576,전회/Noun,3,2,1,4.445926419917751e-05,3.331926519913814e-05,0.6666666666666666
21577,21577,TVA/Alpha,3,2,1,4.445926419917751e-05,3.331926519913814e-05,0.6666666666666666
21578,21578,아스카/Noun,3,2,1,4.445926419917751e-05,3.331926519913814e-05,0.6666666666666666
21579,21579,보름달/Noun,3,2,1,4.445926419917751e-05,3.331926519913814e-05,0.6666666666666666
21580,21580,크라이스트/Noun,3,1,2,3.334444814938313e-05,4.4425686932184186e-05,0.6666666666666666
21581,21581,주란/Noun,3,1,2,3.334444814938313e-05,4.4425686932184186e-05,0.6666666666666666
21582,21582,진장/Noun,3,2,1,4.445926419917751e-05,3.331926519913814e-05,0.6666666666666666
21583,21583,선후배/Noun,3,2,1,4.445926419917751e-05,3.331926519913814e-05,0.6666666666666666
21584,21584,아른/Noun,3,2,1,4.445926419917751e-05,3.331926519913814e-05,0.6666666666666666
21585,21585,수아/Noun,3,2,1,4.445926419917751e-05,3.331926519913814e-05,0.6666666666666666
21586,21586,빗물/Noun,3,2,1,4.445926419917751e-05,3.331926519913814e-05,0.6666666666666666
21587,21587,태극기휘날리며/Noun,3,2,1,4.445926419917751e-05,3.331926519913814e-05,0.6666666666666666
21588,21588,배구/Noun,3,1,2,3.334444814938313e-05,4.4425686932184186e-05,0.6666666666666666
21589,21589,소수민족/Noun,3,1,2,3.334444814938313e-05,4.4425686932184186e-05,0.6666666666666666
21590,21590,年/Foreign,3,2,1,4.445926419917751e-05,3.331926519913814e-05,0.6666666666666666
21591,21591,기모노/Noun,3,1,2,3.334444814938313e-05,4.4425686932184186e-05,0.6666666666666666
21592,21592,낑기다/Adjective,3,1,2,3.334444814938313e-05,4.4425686932184186e-05,0.6666666666666666
21593,21593,곰플레이어/Noun,3,1,2,3.334444814938313e-05,4.4425686932184186e-05,0.6666666666666666
21594,21594,beauty/Alpha,3,2,1,4.445926419917751e-05,3.331926519913814e-05,0.6666666666666666
21595,21595,sin/Alpha,3,1,2,3.334444814938313e-05,4.4425686932184186e-05,0.6666666666666666
21596,21596,이슬람권/Noun,3,1,2,3.334444814938313e-05,4.4425686932184186e-05,0.6666666666666666
21597,21597,가량/Foreign,3,1,2,3.334444814938313e-05,4.4425686932184186e-05,0.6666666666666666
21598,21598,난적/Noun,3,1,2,3.334444814938313e-05,4.4425686932184186e-05,0.6666666666666666
21599,21599,우리형/Noun,3,2,1,4.445926419917751e-05,3.331926519913814e-05,0.6666666666666666
21600,21600,도부/Noun,3,1,2,3.334444814938313e-05,4.4425686932184186e-05,0.6666666666666666
21601,21601,친목/Noun,3,1,2,3.334444814938313e-05,4.4425686932184186e-05,0.6666666666666666
21602,21602,적대/Noun,3,2,1,4.445926419917751e-05,3.331926519913814e-05,0.6666666666666666
21603,21603,권유리/Noun,3,1,2,3.334444814938313e-05,4.4425686932184186e-05,0.6666666666666666
21604,21604,기습/Noun,3,1,2,3.334444814938313e-05,4.4425686932184186e-05,0.6666666666666666
21605,21605,님말/Noun,3,1,2,3.334444814938313e-05,4.4425686932184186e-05,0.6666666666666666
21606,21606,고행/Noun,3,1,2,3.334444814938313e-05,4.4425686932184186e-05,0.6666666666666666
21607,21607,백점만점/Noun,3,2,1,4.445926419917751e-05,3.331926519913814e-05,0.6666666666666666
21608,21608,신혜수/Noun,3,2,1,4.445926419917751e-05,3.331926519913814e-05,0.6666666666666666
21609,21609,ㄱㅋㅋ/KoreanParticle,3,1,2,3.334444814938313e-05,4.4425686932184186e-05,0.6666666666666666
21610,21610,미역/Noun,3,2,1,4.445926419917751e-05,3.331926519913814e-05,0.6666666666666666
21611,21611,썪/Noun,3,1,2,3.334444814938313e-05,4.4425686932184186e-05,0.6666666666666666
21612,21612,라드/Noun,3,1,2,3.334444814938313e-05,4.4425686932184186e-05,0.6666666666666666
21613,21613,~;;/Punctuation,3,1,2,3.334444814938313e-05,4.4425686932184186e-05,0.6666666666666666
21614,21614,반년/Noun,3,2,1,4.445926419917751e-05,3.331926519913814e-05,0.6666666666666666
21615,21615,○○/Foreign,3,1,2,3.334444814938313e-05,4.4425686932184186e-05,0.6666666666666666
21616,21616,흡연/Noun,3,2,1,4.445926419917751e-05,3.331926519913814e-05,0.6666666666666666
21617,21617,애띤/Noun,3,2,1,4.445926419917751e-05,3.331926519913814e-05,0.6666666666666666
21618,21618,쉐일린/Noun,3,2,1,4.445926419917751e-05,3.331926519913814e-05,0.6666666666666666
21619,21619,개한민국/Noun,3,2,1,4.445926419917751e-05,3.331926519913814e-05,0.6666666666666666
21620,21620,스코틀랜드/Noun,3,2,1,4.445926419917751e-05,3.331926519913814e-05,0.6666666666666666
21621,21621,l/Alpha,3,2,1,4.445926419917751e-05,3.331926519913814e-05,0.6666666666666666
21622,21622,음악회/Noun,3,1,2,3.334444814938313e-05,4.4425686932184186e-05,0.6666666666666666
21623,21623,헤어지자/Noun,3,1,2,3.334444814938313e-05,4.4425686932184186e-05,0.6666666666666666
21624,21624,cia/Alpha,3,1,2,3.334444814938313e-05,4.4425686932184186e-05,0.6666666666666666
21625,21625,피타/Noun,3,1,2,3.334444814938313e-05,4.4425686932184186e-05,0.6666666666666666
21626,21626,산이면/Noun,3,1,2,3.334444814938313e-05,4.4425686932184186e-05,0.6666666666666666
21627,21627,정도는/Foreign,3,1,2,3.334444814938313e-05,4.4425686932184186e-05,0.6666666666666666
21628,21628,브롤/Noun,3,2,1,4.445926419917751e-05,3.331926519913814e-05,0.6666666666666666
21629,21629,떳길/Noun,3,1,2,3.334444814938313e-05,4.4425686932184186e-05,0.6666666666666666
21630,21630,라리사/Noun,3,1,2,3.334444814938313e-05,4.4425686932184186e-05,0.6666666666666666
21631,21631,빅매치/Noun,3,1,2,3.334444814938313e-05,4.4425686932184186e-05,0.6666666666666666
21632,21632,스토크/Noun,3,1,2,3.334444814938313e-05,4.4425686932184186e-05,0.6666666666666666
21633,21633,이도경/Noun,3,1,2,3.334444814938313e-05,4.4425686932184186e-05,0.6666666666666666
21634,21634,완점/Noun,3,2,1,4.445926419917751e-05,3.331926519913814e-05,0.6666666666666666
21635,21635,용광로/Noun,3,2,1,4.445926419917751e-05,3.331926519913814e-05,0.6666666666666666
21636,21636,절루/Noun,3,1,2,3.334444814938313e-05,4.4425686932184186e-05,0.6666666666666666
21637,21637,호스/Noun,3,1,2,3.334444814938313e-05,4.4425686932184186e-05,0.6666666666666666
21638,21638,왜내/Noun,3,2,1,4.445926419917751e-05,3.331926519913814e-05,0.6666666666666666
21639,21639,!?!?/Punctuation,3,1,2,3.334444814938313e-05,4.4425686932184186e-05,0.6666666666666666
21640,21640,주간/Noun,3,1,2,3.334444814938313e-05,4.4425686932184186e-05,0.6666666666666666
21641,21641,진쨔/Noun,3,1,2,3.334444814938313e-05,4.4425686932184186e-05,0.6666666666666666
21642,21642,충혈/Noun,3,2,1,4.445926419917751e-05,3.331926519913814e-05,0.6666666666666666
21643,21643,핸콕/Noun,3,2,1,4.445926419917751e-05,3.331926519913814e-05,0.6666666666666666
21644,21644,드마/Noun,3,1,2,3.334444814938313e-05,4.4425686932184186e-05,0.6666666666666666
21645,21645,종소리/Noun,3,2,1,4.445926419917751e-05,3.331926519913814e-05,0.6666666666666666
21646,21646,장길산/Noun,3,2,1,4.445926419917751e-05,3.331926519913814e-05,0.6666666666666666
21647,21647,간주/Noun,3,1,2,3.334444814938313e-05,4.4425686932184186e-05,0.6666666666666666
21648,21648,망라/Noun,3,2,1,4.445926419917751e-05,3.331926519913814e-05,0.6666666666666666
21649,21649,매달/Noun,3,1,2,3.334444814938313e-05,4.4425686932184186e-05,0.6666666666666666
21650,21650,ㅇㄷ/KoreanParticle,3,2,1,4.445926419917751e-05,3.331926519913814e-05,0.6666666666666666
21651,21651,삼분/Noun,3,1,2,3.334444814938313e-05,4.4425686932184186e-05,0.6666666666666666
21652,21652,렸/Noun,3,1,2,3.334444814938313e-05,4.4425686932184186e-05,0.6666666666666666
21653,21653,악귀/Noun,3,1,2,3.334444814938313e-05,4.4425686932184186e-05,0.6666666666666666
21654,21654,최윤영/Noun,3,2,1,4.445926419917751e-05,3.331926519913814e-05,0.6666666666666666
21655,21655,봣을까/Noun,3,2,1,4.445926419917751e-05,3.331926519913814e-05,0.6666666666666666
21656,21656,쾌걸조로/Noun,3,1,2,3.334444814938313e-05,4.4425686932184186e-05,0.6666666666666666
21657,21657,잡식/Noun,3,1,2,3.334444814938313e-05,4.4425686932184186e-05,0.6666666666666666
21658,21658,XTM/Alpha,3,1,2,3.334444814938313e-05,4.4425686932184186e-05,0.6666666666666666
21659,21659,셧다/Noun,3,2,1,4.445926419917751e-05,3.331926519913814e-05,0.6666666666666666
21660,21660,반적/Noun,3,2,1,4.445926419917751e-05,3.331926519913814e-05,0.6666666666666666
21661,21661,2016년/Number,3,1,2,3.334444814938313e-05,4.4425686932184186e-05,0.6666666666666666
21662,21662,dmb/Alpha,3,1,2,3.334444814938313e-05,4.4425686932184186e-05,0.6666666666666666
21663,21663,好/Foreign,3,1,2,3.334444814938313e-05,4.4425686932184186e-05,0.6666666666666666
21664,21664,아라/Eomi,3,2,1,4.445926419917751e-05,3.331926519913814e-05,0.6666666666666666
21665,21665,왁/Adverb,3,2,1,4.445926419917751e-05,3.331926519913814e-05,0.6666666666666666
21666,21666,소련군/Noun,3,2,1,4.445926419917751e-05,3.331926519913814e-05,0.6666666666666666
21667,21667,53/Number,3,1,2,3.334444814938313e-05,4.4425686932184186e-05,0.6666666666666666
21668,21668,출근길/Noun,3,2,1,4.445926419917751e-05,3.331926519913814e-05,0.6666666666666666
21669,21669,괴력/Noun,3,2,1,4.445926419917751e-05,3.331926519913814e-05,0.6666666666666666
21670,21670,",,.../Punctuation",3,1,2,3.334444814938313e-05,4.4425686932184186e-05,0.6666666666666666
21671,21671,리프트/Noun,3,2,1,4.445926419917751e-05,3.331926519913814e-05,0.6666666666666666
21672,21672,진격의거인/Noun,3,1,2,3.334444814938313e-05,4.4425686932184186e-05,0.6666666666666666
21673,21673,심상/Noun,3,2,1,4.445926419917751e-05,3.331926519913814e-05,0.6666666666666666
21674,21674,조총/Noun,3,2,1,4.445926419917751e-05,3.331926519913814e-05,0.6666666666666666
21675,21675,이라기보다는/Josa,3,2,1,4.445926419917751e-05,3.331926519913814e-05,0.6666666666666666
21676,21676,전인/Foreign,3,2,1,4.445926419917751e-05,3.331926519913814e-05,0.6666666666666666
21677,21677,공역/Noun,3,2,1,4.445926419917751e-05,3.331926519913814e-05,0.6666666666666666
21678,21678,가정사/Noun,3,2,1,4.445926419917751e-05,3.331926519913814e-05,0.6666666666666666
21679,21679,랑/Noun,3,1,2,3.334444814938313e-05,4.4425686932184186e-05,0.6666666666666666
21680,21680,유빈/Noun,3,1,2,3.334444814938313e-05,4.4425686932184186e-05,0.6666666666666666
21681,21681,부친/Noun,3,1,2,3.334444814938313e-05,4.4425686932184186e-05,0.6666666666666666
21682,21682,",,,,,,,,,,/Punctuation",3,1,2,3.334444814938313e-05,4.4425686932184186e-05,0.6666666666666666
21683,21683,연못/Noun,3,2,1,4.445926419917751e-05,3.331926519913814e-05,0.6666666666666666
21684,21684,sun/Alpha,3,2,1,4.445926419917751e-05,3.331926519913814e-05,0.6666666666666666
21685,21685,쑥/Noun,3,1,2,3.334444814938313e-05,4.4425686932184186e-05,0.6666666666666666
21686,21686,뉴요커/Noun,3,2,1,4.445926419917751e-05,3.331926519913814e-05,0.6666666666666666
21687,21687,포크/Noun,3,2,1,4.445926419917751e-05,3.331926519913814e-05,0.6666666666666666
21688,21688,마조히즘/Noun,3,2,1,4.445926419917751e-05,3.331926519913814e-05,0.6666666666666666
21689,21689,가장자리/Noun,3,2,1,4.445926419917751e-05,3.331926519913814e-05,0.6666666666666666
21690,21690,군말/Noun,3,1,2,3.334444814938313e-05,4.4425686932184186e-05,0.6666666666666666
21691,21691,57%/Number,3,1,2,3.334444814938313e-05,4.4425686932184186e-05,0.6666666666666666
21692,21692,데보라/Noun,3,2,1,4.445926419917751e-05,3.331926519913814e-05,0.6666666666666666
21693,21693,스트리퍼/Noun,3,1,2,3.334444814938313e-05,4.4425686932184186e-05,0.6666666666666666
21694,21694,처녀작/Noun,3,2,1,4.445926419917751e-05,3.331926519913814e-05,0.6666666666666666
21695,21695,방정식/Noun,3,1,2,3.334444814938313e-05,4.4425686932184186e-05,0.6666666666666666
21696,21696,데릭/Noun,3,1,2,3.334444814938313e-05,4.4425686932184186e-05,0.6666666666666666
21697,21697,경솔하다/Adjective,3,1,2,3.334444814938313e-05,4.4425686932184186e-05,0.6666666666666666
21698,21698,스폰지/Noun,3,2,1,4.445926419917751e-05,3.331926519913814e-05,0.6666666666666666
21699,21699,망극/Noun,3,1,2,3.334444814938313e-05,4.4425686932184186e-05,0.6666666666666666
21700,21700,평가자/Noun,3,1,2,3.334444814938313e-05,4.4425686932184186e-05,0.6666666666666666
21701,21701,`~/Punctuation,3,1,2,3.334444814938313e-05,4.4425686932184186e-05,0.6666666666666666
21702,21702,스멀스멀/Adverb,3,2,1,4.445926419917751e-05,3.331926519913814e-05,0.6666666666666666
21703,21703,라보/Noun,3,1,2,3.334444814938313e-05,4.4425686932184186e-05,0.6666666666666666
21704,21704,윗/Noun,3,2,1,4.445926419917751e-05,3.331926519913814e-05,0.6666666666666666
21705,21705,넷다/Noun,3,2,1,4.445926419917751e-05,3.331926519913814e-05,0.6666666666666666
21706,21706,정길/Noun,3,1,2,3.334444814938313e-05,4.4425686932184186e-05,0.6666666666666666
21707,21707,피치퍼펙트/Noun,3,2,1,4.445926419917751e-05,3.331926519913814e-05,0.6666666666666666
21708,21708,"....,,/Punctuation",3,1,2,3.334444814938313e-05,4.4425686932184186e-05,0.6666666666666666
21709,21709,6.61/Number,3,1,2,3.334444814938313e-05,4.4425686932184186e-05,0.6666666666666666
21710,21710,뒤쪽/Noun,3,1,2,3.334444814938313e-05,4.4425686932184186e-05,0.6666666666666666
21711,21711,껀줄/Noun,3,1,2,3.334444814938313e-05,4.4425686932184186e-05,0.6666666666666666
21712,21712,혜원/Noun,3,2,1,4.445926419917751e-05,3.331926519913814e-05,0.6666666666666666
21713,21713,수퍼히어로/Noun,3,1,2,3.334444814938313e-05,4.4425686932184186e-05,0.6666666666666666
21714,21714,리칸/Noun,3,1,2,3.334444814938313e-05,4.4425686932184186e-05,0.6666666666666666
21715,21715,오감도/Noun,3,1,2,3.334444814938313e-05,4.4425686932184186e-05,0.6666666666666666
21716,21716,포커/Noun,3,1,2,3.334444814938313e-05,4.4425686932184186e-05,0.6666666666666666
21717,21717,연세/Noun,3,2,1,4.445926419917751e-05,3.331926519913814e-05,0.6666666666666666
21718,21718,정애연/Noun,3,2,1,4.445926419917751e-05,3.331926519913814e-05,0.6666666666666666
21719,21719,상쇄/Noun,3,2,1,4.445926419917751e-05,3.331926519913814e-05,0.6666666666666666
21720,21720,여든/Noun,3,1,2,3.334444814938313e-05,4.4425686932184186e-05,0.6666666666666666
21721,21721,여/Foreign,3,1,2,3.334444814938313e-05,4.4425686932184186e-05,0.6666666666666666
21722,21722,유혈/Noun,3,1,2,3.334444814938313e-05,4.4425686932184186e-05,0.6666666666666666
21723,21723,에스비에스/Noun,3,1,2,3.334444814938313e-05,4.4425686932184186e-05,0.6666666666666666
21724,21724,사법부/Noun,3,2,1,4.445926419917751e-05,3.331926519913814e-05,0.6666666666666666
21725,21725,한적하다/Adjective,3,2,1,4.445926419917751e-05,3.331926519913814e-05,0.6666666666666666
21726,21726,도진/Noun,3,1,2,3.334444814938313e-05,4.4425686932184186e-05,0.6666666666666666
21727,21727,떠들썩하다/Adjective,3,1,2,3.334444814938313e-05,4.4425686932184186e-05,0.6666666666666666
21728,21728,구의/Noun,3,2,1,4.445926419917751e-05,3.331926519913814e-05,0.6666666666666666
21729,21729,이성애/Noun,3,2,1,4.445926419917751e-05,3.331926519913814e-05,0.6666666666666666
21730,21730,사샤/Noun,3,1,2,3.334444814938313e-05,4.4425686932184186e-05,0.6666666666666666
21731,21731,무정/Noun,3,1,2,3.334444814938313e-05,4.4425686932184186e-05,0.6666666666666666
21732,21732,무무/Noun,3,2,1,4.445926419917751e-05,3.331926519913814e-05,0.6666666666666666
21733,21733,에이지/Noun,3,2,1,4.445926419917751e-05,3.331926519913814e-05,0.6666666666666666
21734,21734,머니볼/Noun,3,1,2,3.334444814938313e-05,4.4425686932184186e-05,0.6666666666666666
21735,21735,파코/Noun,3,1,2,3.334444814938313e-05,4.4425686932184186e-05,0.6666666666666666
21736,21736,씨네프/Noun,3,1,2,3.334444814938313e-05,4.4425686932184186e-05,0.6666666666666666
21737,21737,불우하다/Adjective,3,1,2,3.334444814938313e-05,4.4425686932184186e-05,0.6666666666666666
21738,21738,요추/Noun,3,2,1,4.445926419917751e-05,3.331926519913814e-05,0.6666666666666666
21739,21739,얽매이다/Verb,3,2,1,4.445926419917751e-05,3.331926519913814e-05,0.6666666666666666
21740,21740,홍홍/Noun,3,1,2,3.334444814938313e-05,4.4425686932184186e-05,0.6666666666666666
21741,21741,서강준/Noun,3,1,2,3.334444814938313e-05,4.4425686932184186e-05,0.6666666666666666
21742,21742,킥복싱/Noun,3,1,2,3.334444814938313e-05,4.4425686932184186e-05,0.6666666666666666
21743,21743,윙/Noun,3,2,1,4.445926419917751e-05,3.331926519913814e-05,0.6666666666666666
21744,21744,../Foreign,3,2,1,4.445926419917751e-05,3.331926519913814e-05,0.6666666666666666
21745,21745,양멱/Noun,3,1,2,3.334444814938313e-05,4.4425686932184186e-05,0.6666666666666666
21746,21746,케이팝/Noun,3,1,2,3.334444814938313e-05,4.4425686932184186e-05,0.6666666666666666
21747,21747,정시아/Noun,3,1,2,3.334444814938313e-05,4.4425686932184186e-05,0.6666666666666666
21748,21748,막문위/Noun,3,2,1,4.445926419917751e-05,3.331926519913814e-05,0.6666666666666666
21749,21749,지보/Noun,3,1,2,3.334444814938313e-05,4.4425686932184186e-05,0.6666666666666666
21750,21750,○/Foreign,3,2,1,4.445926419917751e-05,3.331926519913814e-05,0.6666666666666666
21751,21751,해악/Noun,3,1,2,3.334444814938313e-05,4.4425686932184186e-05,0.6666666666666666
21752,21752,개선문/Noun,3,2,1,4.445926419917751e-05,3.331926519913814e-05,0.6666666666666666
21753,21753,거뜬하다/Adjective,3,1,2,3.334444814938313e-05,4.4425686932184186e-05,0.6666666666666666
21754,21754,검정/Noun,3,2,1,4.445926419917751e-05,3.331926519913814e-05,0.6666666666666666
21755,21755,열혈남아/Noun,3,2,1,4.445926419917751e-05,3.331926519913814e-05,0.6666666666666666
21756,21756,활기/Noun,3,2,1,4.445926419917751e-05,3.331926519913814e-05,0.6666666666666666
21757,21757,ㅁㄴㅇㄹ/KoreanParticle,3,2,1,4.445926419917751e-05,3.331926519913814e-05,0.6666666666666666
21758,21758,불의/Foreign,3,2,1,4.445926419917751e-05,3.331926519913814e-05,0.6666666666666666
21759,21759,근로/Noun,3,1,2,3.334444814938313e-05,4.4425686932184186e-05,0.6666666666666666
21760,21760,고층/Noun,3,2,1,4.445926419917751e-05,3.331926519913814e-05,0.6666666666666666
21761,21761,대와/Foreign,3,2,1,4.445926419917751e-05,3.331926519913814e-05,0.6666666666666666
21762,21762,건맨/Noun,3,2,1,4.445926419917751e-05,3.331926519913814e-05,0.6666666666666666
21763,21763,몹쓸/Modifier,3,1,2,3.334444814938313e-05,4.4425686932184186e-05,0.6666666666666666
21764,21764,꼇/Noun,3,2,1,4.445926419917751e-05,3.331926519913814e-05,0.6666666666666666
21765,21765,음악인/Noun,3,2,1,4.445926419917751e-05,3.331926519913814e-05,0.6666666666666666
21766,21766,초보자/Noun,3,2,1,4.445926419917751e-05,3.331926519913814e-05,0.6666666666666666
21767,21767,뉴질랜드/Noun,3,2,1,4.445926419917751e-05,3.331926519913814e-05,0.6666666666666666
21768,21768,조정래/Noun,3,2,1,4.445926419917751e-05,3.331926519913814e-05,0.6666666666666666
21769,21769,니트/Noun,3,1,2,3.334444814938313e-05,4.4425686932184186e-05,0.6666666666666666
21770,21770,구절/Noun,3,1,2,3.334444814938313e-05,4.4425686932184186e-05,0.6666666666666666
21771,21771,은빛/Noun,3,1,2,3.334444814938313e-05,4.4425686932184186e-05,0.6666666666666666
21772,21772,루루/Noun,3,1,2,3.334444814938313e-05,4.4425686932184186e-05,0.6666666666666666
21773,21773,학문/Noun,3,2,1,4.445926419917751e-05,3.331926519913814e-05,0.6666666666666666
21774,21774,안느/Noun,3,1,2,3.334444814938313e-05,4.4425686932184186e-05,0.6666666666666666
21775,21775,쪼그/Noun,3,2,1,4.445926419917751e-05,3.331926519913814e-05,0.6666666666666666
21776,21776,사십/Modifier,3,2,1,4.445926419917751e-05,3.331926519913814e-05,0.6666666666666666
21777,21777,점감/Noun,3,1,2,3.334444814938313e-05,4.4425686932184186e-05,0.6666666666666666
21778,21778,웤/Noun,3,1,2,3.334444814938313e-05,4.4425686932184186e-05,0.6666666666666666
21779,21779,어플/Noun,3,2,1,4.445926419917751e-05,3.331926519913814e-05,0.6666666666666666
21780,21780,하소연/Noun,3,1,2,3.334444814938313e-05,4.4425686932184186e-05,0.6666666666666666
21781,21781,트레일러/Noun,3,1,2,3.334444814938313e-05,4.4425686932184186e-05,0.6666666666666666
21782,21782,메디/Noun,3,2,1,4.445926419917751e-05,3.331926519913814e-05,0.6666666666666666
21783,21783,예인/Noun,3,2,1,4.445926419917751e-05,3.331926519913814e-05,0.6666666666666666
21784,21784,농약/Noun,3,1,2,3.334444814938313e-05,4.4425686932184186e-05,0.6666666666666666
21785,21785,이과/Noun,3,1,2,3.334444814938313e-05,4.4425686932184186e-05,0.6666666666666666
21786,21786,비즈니스/Noun,3,1,2,3.334444814938313e-05,4.4425686932184186e-05,0.6666666666666666
21787,21787,비됴가게/Noun,3,2,1,4.445926419917751e-05,3.331926519913814e-05,0.6666666666666666
21788,21788,왓치맨/Noun,3,1,2,3.334444814938313e-05,4.4425686932184186e-05,0.6666666666666666
21789,21789,후궁/Noun,3,2,1,4.445926419917751e-05,3.331926519913814e-05,0.6666666666666666
21790,21790,명가/Noun,3,1,2,3.334444814938313e-05,4.4425686932184186e-05,0.6666666666666666
21791,21791,독약/Noun,3,1,2,3.334444814938313e-05,4.4425686932184186e-05,0.6666666666666666
21792,21792,오리무중/Noun,3,1,2,3.334444814938313e-05,4.4425686932184186e-05,0.6666666666666666
21793,21793,관왕/Noun,3,1,2,3.334444814938313e-05,4.4425686932184186e-05,0.6666666666666666
21794,21794,화창하다/Adjective,3,1,2,3.334444814938313e-05,4.4425686932184186e-05,0.6666666666666666
21795,21795,다재/Noun,3,1,2,3.334444814938313e-05,4.4425686932184186e-05,0.6666666666666666
21796,21796,통키/Noun,3,2,1,4.445926419917751e-05,3.331926519913814e-05,0.6666666666666666
21797,21797,가어/Noun,3,2,1,4.445926419917751e-05,3.331926519913814e-05,0.6666666666666666
21798,21798,거렸/Noun,3,2,1,4.445926419917751e-05,3.331926519913814e-05,0.6666666666666666
21799,21799,프렌차이즈/Noun,3,1,2,3.334444814938313e-05,4.4425686932184186e-05,0.6666666666666666
21800,21800,버퍼링/Noun,3,1,2,3.334444814938313e-05,4.4425686932184186e-05,0.6666666666666666
21801,21801,키무/Noun,3,1,2,3.334444814938313e-05,4.4425686932184186e-05,0.6666666666666666
21802,21802,유관순/Noun,3,2,1,4.445926419917751e-05,3.331926519913814e-05,0.6666666666666666
21803,21803,윤상/Noun,3,2,1,4.445926419917751e-05,3.331926519913814e-05,0.6666666666666666
21804,21804,초고/Noun,3,1,2,3.334444814938313e-05,4.4425686932184186e-05,0.6666666666666666
21805,21805,채린/Noun,3,1,2,3.334444814938313e-05,4.4425686932184186e-05,0.6666666666666666
21806,21806,쉘/Noun,3,2,1,4.445926419917751e-05,3.331926519913814e-05,0.6666666666666666
21807,21807,김동빈/Noun,3,1,2,3.334444814938313e-05,4.4425686932184186e-05,0.6666666666666666
21808,21808,작이지만/Foreign,3,2,1,4.445926419917751e-05,3.331926519913814e-05,0.6666666666666666
21809,21809,양가/Noun,3,1,2,3.334444814938313e-05,4.4425686932184186e-05,0.6666666666666666
21810,21810,강희/Noun,3,1,2,3.334444814938313e-05,4.4425686932184186e-05,0.6666666666666666
21811,21811,지명도/Noun,3,1,2,3.334444814938313e-05,4.4425686932184186e-05,0.6666666666666666
21812,21812,사카/Noun,3,2,1,4.445926419917751e-05,3.331926519913814e-05,0.6666666666666666
21813,21813,레인저/Noun,3,1,2,3.334444814938313e-05,4.4425686932184186e-05,0.6666666666666666
21814,21814,밀덕/Noun,3,2,1,4.445926419917751e-05,3.331926519913814e-05,0.6666666666666666
21815,21815,정남/Noun,3,2,1,4.445926419917751e-05,3.331926519913814e-05,0.6666666666666666
21816,21816,참회/Noun,3,2,1,4.445926419917751e-05,3.331926519913814e-05,0.6666666666666666
21817,21817,량/Noun,3,2,1,4.445926419917751e-05,3.331926519913814e-05,0.6666666666666666
21818,21818,movies/Alpha,3,2,1,4.445926419917751e-05,3.331926519913814e-05,0.6666666666666666
21819,21819,화덕/Noun,3,2,1,4.445926419917751e-05,3.331926519913814e-05,0.6666666666666666
21820,21820,쪼그리다/Verb,3,2,1,4.445926419917751e-05,3.331926519913814e-05,0.6666666666666666
21821,21821,스퀘어/Noun,3,1,2,3.334444814938313e-05,4.4425686932184186e-05,0.6666666666666666
21822,21822,카를/Noun,3,1,2,3.334444814938313e-05,4.4425686932184186e-05,0.6666666666666666
21823,21823,가다듬다/Verb,3,1,2,3.334444814938313e-05,4.4425686932184186e-05,0.6666666666666666
21824,21824,갉다/Verb,3,1,2,3.334444814938313e-05,4.4425686932184186e-05,0.6666666666666666
21825,21825,우뚝/Noun,3,1,2,3.334444814938313e-05,4.4425686932184186e-05,0.6666666666666666
21826,21826,쌀밥/Noun,3,1,2,3.334444814938313e-05,4.4425686932184186e-05,0.6666666666666666
21827,21827,금수/Noun,3,2,1,4.445926419917751e-05,3.331926519913814e-05,0.6666666666666666
21828,21828,만기/Noun,3,2,1,4.445926419917751e-05,3.331926519913814e-05,0.6666666666666666
21829,21829,사자성어/Noun,3,2,1,4.445926419917751e-05,3.331926519913814e-05,0.6666666666666666
21830,21830,수표/Noun,3,1,2,3.334444814938313e-05,4.4425686932184186e-05,0.6666666666666666
21831,21831,박애/Noun,3,2,1,4.445926419917751e-05,3.331926519913814e-05,0.6666666666666666
21832,21832,경극/Noun,3,1,2,3.334444814938313e-05,4.4425686932184186e-05,0.6666666666666666
21833,21833,효진/Noun,3,1,2,3.334444814938313e-05,4.4425686932184186e-05,0.6666666666666666
21834,21834,오뎅/Noun,3,1,2,3.334444814938313e-05,4.4425686932184186e-05,0.6666666666666666
21835,21835,:-/Punctuation,3,1,2,3.334444814938313e-05,4.4425686932184186e-05,0.6666666666666666
21836,21836,엘리어트/Noun,3,2,1,4.445926419917751e-05,3.331926519913814e-05,0.6666666666666666
21837,21837,than/Alpha,3,2,1,4.445926419917751e-05,3.331926519913814e-05,0.6666666666666666
21838,21838,스패/Noun,3,1,2,3.334444814938313e-05,4.4425686932184186e-05,0.6666666666666666
21839,21839,써비스/Noun,3,1,2,3.334444814938313e-05,4.4425686932184186e-05,0.6666666666666666
21840,21840,연때/Noun,3,1,2,3.334444814938313e-05,4.4425686932184186e-05,0.6666666666666666
21841,21841,슬그머니/Noun,3,1,2,3.334444814938313e-05,4.4425686932184186e-05,0.6666666666666666
21842,21842,훤/Noun,3,1,2,3.334444814938313e-05,4.4425686932184186e-05,0.6666666666666666
21843,21843,eye/Alpha,3,1,2,3.334444814938313e-05,4.4425686932184186e-05,0.6666666666666666
21844,21844,알랭들롱/Noun,3,2,1,4.445926419917751e-05,3.331926519913814e-05,0.6666666666666666
21845,21845,미동/Noun,3,2,1,4.445926419917751e-05,3.331926519913814e-05,0.6666666666666666
21846,21846,불가피하다/Adjective,3,2,1,4.445926419917751e-05,3.331926519913814e-05,0.6666666666666666
21847,21847,명소/Noun,3,1,2,3.334444814938313e-05,4.4425686932184186e-05,0.6666666666666666
21848,21848,코베/Noun,3,2,1,4.445926419917751e-05,3.331926519913814e-05,0.6666666666666666
21849,21849,팀버/Noun,3,1,2,3.334444814938313e-05,4.4425686932184186e-05,0.6666666666666666
21850,21850,일약/Noun,3,2,1,4.445926419917751e-05,3.331926519913814e-05,0.6666666666666666
21851,21851,숙취/Noun,3,1,2,3.334444814938313e-05,4.4425686932184186e-05,0.6666666666666666
21852,21852,일곱/Determiner,3,2,1,4.445926419917751e-05,3.331926519913814e-05,0.6666666666666666
21853,21853,;)/Punctuation,3,2,1,4.445926419917751e-05,3.331926519913814e-05,0.6666666666666666
21854,21854,글래스/Noun,3,2,1,4.445926419917751e-05,3.331926519913814e-05,0.6666666666666666
21855,21855,해밀턴/Noun,3,2,1,4.445926419917751e-05,3.331926519913814e-05,0.6666666666666666
21856,21856,오수민/Noun,3,1,2,3.334444814938313e-05,4.4425686932184186e-05,0.6666666666666666
21857,21857,구래/Noun,3,1,2,3.334444814938313e-05,4.4425686932184186e-05,0.6666666666666666
21858,21858,광녀/Noun,3,1,2,3.334444814938313e-05,4.4425686932184186e-05,0.6666666666666666
21859,21859,고공/Noun,3,2,1,4.445926419917751e-05,3.331926519913814e-05,0.6666666666666666
21860,21860,Part/Alpha,3,2,1,4.445926419917751e-05,3.331926519913814e-05,0.6666666666666666
21861,21861,불량품/Noun,3,1,2,3.334444814938313e-05,4.4425686932184186e-05,0.6666666666666666
21862,21862,더군요/Eomi,3,2,1,4.445926419917751e-05,3.331926519913814e-05,0.6666666666666666
21863,21863,일사천리/Noun,3,1,2,3.334444814938313e-05,4.4425686932184186e-05,0.6666666666666666
21864,21864,맥도날드/Noun,3,2,1,4.445926419917751e-05,3.331926519913814e-05,0.6666666666666666
21865,21865,심성/Noun,3,1,2,3.334444814938313e-05,4.4425686932184186e-05,0.6666666666666666
21866,21866,어린이집/Noun,3,1,2,3.334444814938313e-05,4.4425686932184186e-05,0.6666666666666666
21867,21867,원화/Noun,3,2,1,4.445926419917751e-05,3.331926519913814e-05,0.6666666666666666
21868,21868,정립/Noun,3,2,1,4.445926419917751e-05,3.331926519913814e-05,0.6666666666666666
21869,21869,맬깁슨/Noun,3,2,1,4.445926419917751e-05,3.331926519913814e-05,0.6666666666666666
21870,21870,요조/Noun,3,1,2,3.334444814938313e-05,4.4425686932184186e-05,0.6666666666666666
21871,21871,하달/Noun,3,1,2,3.334444814938313e-05,4.4425686932184186e-05,0.6666666666666666
21872,21872,제하/Noun,3,1,2,3.334444814938313e-05,4.4425686932184186e-05,0.6666666666666666
21873,21873,고음/Noun,3,1,2,3.334444814938313e-05,4.4425686932184186e-05,0.6666666666666666
21874,21874,ㅇㅋㅋ/KoreanParticle,3,2,1,4.445926419917751e-05,3.331926519913814e-05,0.6666666666666666
21875,21875,레니할린/Noun,3,2,1,4.445926419917751e-05,3.331926519913814e-05,0.6666666666666666
21876,21876,페스티벌/Noun,3,1,2,3.334444814938313e-05,4.4425686932184186e-05,0.6666666666666666
21877,21877,아역시절/Noun,3,2,1,4.445926419917751e-05,3.331926519913814e-05,0.6666666666666666
21878,21878,10.5/Number,3,1,2,3.334444814938313e-05,4.4425686932184186e-05,0.6666666666666666
21879,21879,평택/Noun,3,1,2,3.334444814938313e-05,4.4425686932184186e-05,0.6666666666666666
21880,21880,이스턴/Noun,3,2,1,4.445926419917751e-05,3.331926519913814e-05,0.6666666666666666
21881,21881,쩌는구/Noun,3,2,1,4.445926419917751e-05,3.331926519913814e-05,0.6666666666666666
21882,21882,!!!~~/Punctuation,3,1,2,3.334444814938313e-05,4.4425686932184186e-05,0.6666666666666666
21883,21883,제지/Noun,3,2,1,4.445926419917751e-05,3.331926519913814e-05,0.6666666666666666
21884,21884,굿윌/Noun,3,2,1,4.445926419917751e-05,3.331926519913814e-05,0.6666666666666666
21885,21885,패러독스/Noun,3,2,1,4.445926419917751e-05,3.331926519913814e-05,0.6666666666666666
21886,21886,이석기/Noun,3,1,2,3.334444814938313e-05,4.4425686932184186e-05,0.6666666666666666
21887,21887,엣/Noun,3,2,1,4.445926419917751e-05,3.331926519913814e-05,0.6666666666666666
21888,21888,장국/Noun,3,1,2,3.334444814938313e-05,4.4425686932184186e-05,0.6666666666666666
21889,21889,켁/Noun,3,1,2,3.334444814938313e-05,4.4425686932184186e-05,0.6666666666666666
21890,21890,홀리데이/Noun,3,2,1,4.445926419917751e-05,3.331926519913814e-05,0.6666666666666666
21891,21891,나뭇잎/Noun,3,1,2,3.334444814938313e-05,4.4425686932184186e-05,0.6666666666666666
21892,21892,한소영/Noun,3,2,1,4.445926419917751e-05,3.331926519913814e-05,0.6666666666666666
21893,21893,05년/Number,3,1,2,3.334444814938313e-05,4.4425686932184186e-05,0.6666666666666666
21894,21894,흑인음악/Noun,3,1,2,3.334444814938313e-05,4.4425686932184186e-05,0.6666666666666666
21895,21895,합창단/Noun,3,2,1,4.445926419917751e-05,3.331926519913814e-05,0.6666666666666666
21896,21896,제조/Noun,3,1,2,3.334444814938313e-05,4.4425686932184186e-05,0.6666666666666666
21897,21897,에세/Noun,3,2,1,4.445926419917751e-05,3.331926519913814e-05,0.6666666666666666
21898,21898,인분/Noun,3,1,2,3.334444814938313e-05,4.4425686932184186e-05,0.6666666666666666
21899,21899,부기/Noun,3,2,1,4.445926419917751e-05,3.331926519913814e-05,0.6666666666666666
21900,21900,스쿨/Noun,3,2,1,4.445926419917751e-05,3.331926519913814e-05,0.6666666666666666
21901,21901,트렌디/Noun,3,2,1,4.445926419917751e-05,3.331926519913814e-05,0.6666666666666666
21902,21902,보셍/Noun,3,2,1,4.445926419917751e-05,3.331926519913814e-05,0.6666666666666666
21903,21903,태반/Noun,3,2,1,4.445926419917751e-05,3.331926519913814e-05,0.6666666666666666
21904,21904,자웅/Noun,3,1,2,3.334444814938313e-05,4.4425686932184186e-05,0.6666666666666666
21905,21905,러버/Noun,3,1,2,3.334444814938313e-05,4.4425686932184186e-05,0.6666666666666666
21906,21906,뿌옇다/Adjective,3,1,2,3.334444814938313e-05,4.4425686932184186e-05,0.6666666666666666
21907,21907,줄라이/Noun,3,2,1,4.445926419917751e-05,3.331926519913814e-05,0.6666666666666666
21908,21908,피폐/Noun,3,2,1,4.445926419917751e-05,3.331926519913814e-05,0.6666666666666666
21909,21909,zzzzzzzzzzzz/Alpha,3,2,1,4.445926419917751e-05,3.331926519913814e-05,0.6666666666666666
21910,21910,에로의/Josa,3,2,1,4.445926419917751e-05,3.331926519913814e-05,0.6666666666666666
21911,21911,정치성향/Noun,3,1,2,3.334444814938313e-05,4.4425686932184186e-05,0.6666666666666666
21912,21912,입성/Noun,3,2,1,4.445926419917751e-05,3.331926519913814e-05,0.6666666666666666
21913,21913,차암/Noun,3,2,1,4.445926419917751e-05,3.331926519913814e-05,0.6666666666666666
21914,21914,발가벗다/Verb,3,1,2,3.334444814938313e-05,4.4425686932184186e-05,0.6666666666666666
21915,21915,익명성/Noun,3,1,2,3.334444814938313e-05,4.4425686932184186e-05,0.6666666666666666
21916,21916,향취/Noun,3,2,1,4.445926419917751e-05,3.331926519913814e-05,0.6666666666666666
21917,21917,인형사/Noun,3,2,1,4.445926419917751e-05,3.331926519913814e-05,0.6666666666666666
21918,21918,ㅡㄱ/KoreanParticle,3,1,2,3.334444814938313e-05,4.4425686932184186e-05,0.6666666666666666
21919,21919,용품/Noun,3,2,1,4.445926419917751e-05,3.331926519913814e-05,0.6666666666666666
21920,21920,사소설/Noun,3,1,2,3.334444814938313e-05,4.4425686932184186e-05,0.6666666666666666
21921,21921,이감/Noun,3,2,1,4.445926419917751e-05,3.331926519913814e-05,0.6666666666666666
21922,21922,7%/Number,3,1,2,3.334444814938313e-05,4.4425686932184186e-05,0.6666666666666666
21923,21923,문과/Noun,3,2,1,4.445926419917751e-05,3.331926519913814e-05,0.6666666666666666
21924,21924,럼스/Noun,3,2,1,4.445926419917751e-05,3.331926519913814e-05,0.6666666666666666
21925,21925,정보전/Noun,3,2,1,4.445926419917751e-05,3.331926519913814e-05,0.6666666666666666
21926,21926,정보기관/Noun,3,1,2,3.334444814938313e-05,4.4425686932184186e-05,0.6666666666666666
21927,21927,2000만/Number,3,1,2,3.334444814938313e-05,4.4425686932184186e-05,0.6666666666666666
21928,21928,데우다/Verb,3,1,2,3.334444814938313e-05,4.4425686932184186e-05,0.6666666666666666
21929,21929,전가/Noun,3,2,1,4.445926419917751e-05,3.331926519913814e-05,0.6666666666666666
21930,21930,용해/Noun,3,1,2,3.334444814938313e-05,4.4425686932184186e-05,0.6666666666666666
21931,21931,뉴라이트/Noun,3,1,2,3.334444814938313e-05,4.4425686932184186e-05,0.6666666666666666
21932,21932,중국말/Noun,3,2,1,4.445926419917751e-05,3.331926519913814e-05,0.6666666666666666
21933,21933,꾸욱/Noun,3,1,2,3.334444814938313e-05,4.4425686932184186e-05,0.6666666666666666
21934,21934,쫄면/Noun,3,2,1,4.445926419917751e-05,3.331926519913814e-05,0.6666666666666666
21935,21935,뽀르노/Noun,3,1,2,3.334444814938313e-05,4.4425686932184186e-05,0.6666666666666666
21936,21936,주석/Noun,3,1,2,3.334444814938313e-05,4.4425686932184186e-05,0.6666666666666666
21937,21937,프라하/Noun,3,2,1,4.445926419917751e-05,3.331926519913814e-05,0.6666666666666666
21938,21938,은데/Eomi,3,2,1,4.445926419917751e-05,3.331926519913814e-05,0.6666666666666666
21939,21939,마빡/Noun,3,2,1,4.445926419917751e-05,3.331926519913814e-05,0.6666666666666666
21940,21940,이사벨/Noun,3,1,2,3.334444814938313e-05,4.4425686932184186e-05,0.6666666666666666
21941,21941,적어지다/Verb,3,1,2,3.334444814938313e-05,4.4425686932184186e-05,0.6666666666666666
21942,21942,움찔움찔/Adverb,3,2,1,4.445926419917751e-05,3.331926519913814e-05,0.6666666666666666
21943,21943,아닐런/Noun,3,2,1,4.445926419917751e-05,3.331926519913814e-05,0.6666666666666666
21944,21944,설화/Noun,3,1,2,3.334444814938313e-05,4.4425686932184186e-05,0.6666666666666666
21945,21945,겟다/Noun,3,1,2,3.334444814938313e-05,4.4425686932184186e-05,0.6666666666666666
21946,21946,임돠/Noun,3,2,1,4.445926419917751e-05,3.331926519913814e-05,0.6666666666666666
21947,21947,원서/Noun,3,1,2,3.334444814938313e-05,4.4425686932184186e-05,0.6666666666666666
21948,21948,환갑/Noun,3,2,1,4.445926419917751e-05,3.331926519913814e-05,0.6666666666666666
21949,21949,폐쇄성/Noun,3,2,1,4.445926419917751e-05,3.331926519913814e-05,0.6666666666666666
21950,21950,특수하다/Adjective,3,2,1,4.445926419917751e-05,3.331926519913814e-05,0.6666666666666666
21951,21951,태작/Noun,3,1,2,3.334444814938313e-05,4.4425686932184186e-05,0.6666666666666666
21952,21952,영진위/Noun,3,2,1,4.445926419917751e-05,3.331926519913814e-05,0.6666666666666666
21953,21953,효가/Noun,3,1,2,3.334444814938313e-05,4.4425686932184186e-05,0.6666666666666666
21954,21954,기독/Noun,3,1,2,3.334444814938313e-05,4.4425686932184186e-05,0.6666666666666666
21955,21955,그랬다고/Conjunction,3,1,2,3.334444814938313e-05,4.4425686932184186e-05,0.6666666666666666
21956,21956,궁금궁금/Noun,3,1,2,3.334444814938313e-05,4.4425686932184186e-05,0.6666666666666666
21957,21957,UFC/Alpha,3,1,2,3.334444814938313e-05,4.4425686932184186e-05,0.6666666666666666
21958,21958,비숫/Noun,3,1,2,3.334444814938313e-05,4.4425686932184186e-05,0.6666666666666666
21959,21959,피온/Noun,3,1,2,3.334444814938313e-05,4.4425686932184186e-05,0.6666666666666666
21960,21960,늣/Noun,3,1,2,3.334444814938313e-05,4.4425686932184186e-05,0.6666666666666666
21961,21961,let/Alpha,3,2,1,4.445926419917751e-05,3.331926519913814e-05,0.6666666666666666
21962,21962,들러붙다/Verb,3,1,2,3.334444814938313e-05,4.4425686932184186e-05,0.6666666666666666
21963,21963,윤지민/Noun,3,2,1,4.445926419917751e-05,3.331926519913814e-05,0.6666666666666666
21964,21964,나으니/Noun,3,1,2,3.334444814938313e-05,4.4425686932184186e-05,0.6666666666666666
21965,21965,선구자/Noun,3,2,1,4.445926419917751e-05,3.331926519913814e-05,0.6666666666666666
21966,21966,적적하다/Adjective,3,2,1,4.445926419917751e-05,3.331926519913814e-05,0.6666666666666666
21967,21967,소로/Noun,3,1,2,3.334444814938313e-05,4.4425686932184186e-05,0.6666666666666666
21968,21968,면회/Noun,3,2,1,4.445926419917751e-05,3.331926519913814e-05,0.6666666666666666
21969,21969,케익/Noun,3,1,2,3.334444814938313e-05,4.4425686932184186e-05,0.6666666666666666
21970,21970,썻다/Noun,3,1,2,3.334444814938313e-05,4.4425686932184186e-05,0.6666666666666666
21971,21971,대냐/Foreign,3,1,2,3.334444814938313e-05,4.4425686932184186e-05,0.6666666666666666
21972,21972,남극일기/Noun,3,1,2,3.334444814938313e-05,4.4425686932184186e-05,0.6666666666666666
21973,21973,옥탑방/Noun,3,2,1,4.445926419917751e-05,3.331926519913814e-05,0.6666666666666666
21974,21974,구함/Noun,3,2,1,4.445926419917751e-05,3.331926519913814e-05,0.6666666666666666
21975,21975,에세이/Noun,3,2,1,4.445926419917751e-05,3.331926519913814e-05,0.6666666666666666
21976,21976,울화/Noun,3,1,2,3.334444814938313e-05,4.4425686932184186e-05,0.6666666666666666
21977,21977,덕인/Noun,3,2,1,4.445926419917751e-05,3.331926519913814e-05,0.6666666666666666
21978,21978,31년/Number,3,1,2,3.334444814938313e-05,4.4425686932184186e-05,0.6666666666666666
21979,21979,압축시키다/Verb,3,1,2,3.334444814938313e-05,4.4425686932184186e-05,0.6666666666666666
21980,21980,레일/Noun,3,2,1,4.445926419917751e-05,3.331926519913814e-05,0.6666666666666666
21981,21981,햄릿/Noun,3,2,1,4.445926419917751e-05,3.331926519913814e-05,0.6666666666666666
21982,21982,금세기/Noun,3,2,1,4.445926419917751e-05,3.331926519913814e-05,0.6666666666666666
21983,21983,~~~./Punctuation,3,2,1,4.445926419917751e-05,3.331926519913814e-05,0.6666666666666666
21984,21984,진씨/Noun,3,1,2,3.334444814938313e-05,4.4425686932184186e-05,0.6666666666666666
21985,21985,짓눌리다/Verb,3,2,1,4.445926419917751e-05,3.331926519913814e-05,0.6666666666666666
21986,21986,워킹타이틀/Noun,3,2,1,4.445926419917751e-05,3.331926519913814e-05,0.6666666666666666
21987,21987,거주/Noun,3,2,1,4.445926419917751e-05,3.331926519913814e-05,0.6666666666666666
21988,21988,고성희/Noun,3,1,2,3.334444814938313e-05,4.4425686932184186e-05,0.6666666666666666
21989,21989,어브/Noun,3,1,2,3.334444814938313e-05,4.4425686932184186e-05,0.6666666666666666
21990,21990,ALL/Alpha,3,1,2,3.334444814938313e-05,4.4425686932184186e-05,0.6666666666666666
21991,21991,월화드라마/Noun,3,1,2,3.334444814938313e-05,4.4425686932184186e-05,0.6666666666666666
21992,21992,안온/Noun,3,1,2,3.334444814938313e-05,4.4425686932184186e-05,0.6666666666666666
21993,21993,래지/Noun,3,2,1,4.445926419917751e-05,3.331926519913814e-05,0.6666666666666666
21994,21994,하랑/Noun,3,1,2,3.334444814938313e-05,4.4425686932184186e-05,0.6666666666666666
21995,21995,엄살/Noun,3,1,2,3.334444814938313e-05,4.4425686932184186e-05,0.6666666666666666
21996,21996,아란/Noun,3,1,2,3.334444814938313e-05,4.4425686932184186e-05,0.6666666666666666
21997,21997,치켜뜨다/Verb,3,1,2,3.334444814938313e-05,4.4425686932184186e-05,0.6666666666666666
21998,21998,베이트/Noun,3,2,1,4.445926419917751e-05,3.331926519913814e-05,0.6666666666666666
21999,21999,소셜/Noun,3,2,1,4.445926419917751e-05,3.331926519913814e-05,0.6666666666666666
22000,22000,게드전기/Noun,3,1,2,3.334444814938313e-05,4.4425686932184186e-05,0.6666666666666666
22001,22001,명상/Noun,3,1,2,3.334444814938313e-05,4.4425686932184186e-05,0.6666666666666666
22002,22002,블랙잭/Noun,3,2,1,4.445926419917751e-05,3.331926519913814e-05,0.6666666666666666
22003,22003,학위/Noun,3,1,2,3.334444814938313e-05,4.4425686932184186e-05,0.6666666666666666
22004,22004,늪/Noun,3,1,2,3.334444814938313e-05,4.4425686932184186e-05,0.6666666666666666
22005,22005,드라마틱/Noun,3,1,2,3.334444814938313e-05,4.4425686932184186e-05,0.6666666666666666
22006,22006,놀이동산/Noun,3,1,2,3.334444814938313e-05,4.4425686932184186e-05,0.6666666666666666
22007,22007,니다/Eomi,3,2,1,4.445926419917751e-05,3.331926519913814e-05,0.6666666666666666
22008,22008,방불/Noun,3,2,1,4.445926419917751e-05,3.331926519913814e-05,0.6666666666666666
22009,22009,보유/Noun,3,2,1,4.445926419917751e-05,3.331926519913814e-05,0.6666666666666666
22010,22010,파프리카/Noun,3,1,2,3.334444814938313e-05,4.4425686932184186e-05,0.6666666666666666
22011,22011,꿈쩍/Noun,3,2,1,4.445926419917751e-05,3.331926519913814e-05,0.6666666666666666
22012,22012,어덜트/Noun,3,1,2,3.334444814938313e-05,4.4425686932184186e-05,0.6666666666666666
22013,22013,화교/Noun,3,1,2,3.334444814938313e-05,4.4425686932184186e-05,0.6666666666666666
22014,22014,천만배/Noun,3,1,2,3.334444814938313e-05,4.4425686932184186e-05,0.6666666666666666
22015,22015,셔틀/Noun,3,1,2,3.334444814938313e-05,4.4425686932184186e-05,0.6666666666666666
22016,22016,떼창/Noun,3,1,2,3.334444814938313e-05,4.4425686932184186e-05,0.6666666666666666
22017,22017,연방/Noun,3,1,2,3.334444814938313e-05,4.4425686932184186e-05,0.6666666666666666
22018,22018,오르내리다/Verb,3,1,2,3.334444814938313e-05,4.4425686932184186e-05,0.6666666666666666
22019,22019,푸네/Noun,3,1,2,3.334444814938313e-05,4.4425686932184186e-05,0.6666666666666666
22020,22020,(???)/Punctuation,3,1,2,3.334444814938313e-05,4.4425686932184186e-05,0.6666666666666666
22021,22021,대애/Noun,3,1,2,3.334444814938313e-05,4.4425686932184186e-05,0.6666666666666666
22022,22022,겨울전쟁/Noun,3,1,2,3.334444814938313e-05,4.4425686932184186e-05,0.6666666666666666
22023,22023,진압하/Noun,3,1,2,3.334444814938313e-05,4.4425686932184186e-05,0.6666666666666666
22024,22024,홍해/Noun,3,2,1,4.445926419917751e-05,3.331926519913814e-05,0.6666666666666666
22025,22025,허우적거리다/Verb,3,2,1,4.445926419917751e-05,3.331926519913814e-05,0.6666666666666666
22026,22026,읊어/Noun,3,2,1,4.445926419917751e-05,3.331926519913814e-05,0.6666666666666666
22027,22027,망측하다/Adjective,3,1,2,3.334444814938313e-05,4.4425686932184186e-05,0.6666666666666666
22028,22028,한희정/Noun,3,2,1,4.445926419917751e-05,3.331926519913814e-05,0.6666666666666666
22029,22029,뉴스데스크/Noun,3,2,1,4.445926419917751e-05,3.331926519913814e-05,0.6666666666666666
22030,22030,헤헷/Exclamation,3,2,1,4.445926419917751e-05,3.331926519913814e-05,0.6666666666666666
22031,22031,깨방정/Noun,3,2,1,4.445926419917751e-05,3.331926519913814e-05,0.6666666666666666
22032,22032,레버/Noun,3,2,1,4.445926419917751e-05,3.331926519913814e-05,0.6666666666666666
22033,22033,포괄/Noun,3,2,1,4.445926419917751e-05,3.331926519913814e-05,0.6666666666666666
22034,22034,복용/Noun,3,1,2,3.334444814938313e-05,4.4425686932184186e-05,0.6666666666666666
22035,22035,스테로이드/Noun,3,2,1,4.445926419917751e-05,3.331926519913814e-05,0.6666666666666666
22036,22036,백허그/Noun,3,1,2,3.334444814938313e-05,4.4425686932184186e-05,0.6666666666666666
22037,22037,고참/Noun,3,2,1,4.445926419917751e-05,3.331926519913814e-05,0.6666666666666666
22038,22038,번주/Noun,3,2,1,4.445926419917751e-05,3.331926519913814e-05,0.6666666666666666
22039,22039,하일/Noun,3,2,1,4.445926419917751e-05,3.331926519913814e-05,0.6666666666666666
22040,22040,파병/Noun,3,2,1,4.445926419917751e-05,3.331926519913814e-05,0.6666666666666666
22041,22041,몸속/Noun,3,1,2,3.334444814938313e-05,4.4425686932184186e-05,0.6666666666666666
22042,22042,아카네/Noun,3,2,1,4.445926419917751e-05,3.331926519913814e-05,0.6666666666666666
22043,22043,금강/Noun,3,1,2,3.334444814938313e-05,4.4425686932184186e-05,0.6666666666666666
22044,22044,힣/Exclamation,3,2,1,4.445926419917751e-05,3.331926519913814e-05,0.6666666666666666
22045,22045,쪼매/Noun,3,1,2,3.334444814938313e-05,4.4425686932184186e-05,0.6666666666666666
22046,22046,물기/Noun,3,1,2,3.334444814938313e-05,4.4425686932184186e-05,0.6666666666666666
22047,22047,달구다/Verb,3,1,2,3.334444814938313e-05,4.4425686932184186e-05,0.6666666666666666
22048,22048,악습/Noun,3,2,1,4.445926419917751e-05,3.331926519913814e-05,0.6666666666666666
22049,22049,................................./Punctuation,3,1,2,3.334444814938313e-05,4.4425686932184186e-05,0.6666666666666666
22050,22050,효력/Noun,3,2,1,4.445926419917751e-05,3.331926519913814e-05,0.6666666666666666
22051,22051,가짐/Noun,3,1,2,3.334444814938313e-05,4.4425686932184186e-05,0.6666666666666666
22052,22052,분임/Noun,3,1,2,3.334444814938313e-05,4.4425686932184186e-05,0.6666666666666666
22053,22053,무빙/Noun,3,1,2,3.334444814938313e-05,4.4425686932184186e-05,0.6666666666666666
22054,22054,개새/Noun,3,1,2,3.334444814938313e-05,4.4425686932184186e-05,0.6666666666666666
22055,22055,델마와루이스/Noun,3,1,2,3.334444814938313e-05,4.4425686932184186e-05,0.6666666666666666
22056,22056,책속/Noun,3,2,1,4.445926419917751e-05,3.331926519913814e-05,0.6666666666666666
22057,22057,검객/Noun,3,2,1,4.445926419917751e-05,3.331926519913814e-05,0.6666666666666666
22058,22058,겜블/Noun,3,1,2,3.334444814938313e-05,4.4425686932184186e-05,0.6666666666666666
22059,22059,드러눕다/Verb,3,1,2,3.334444814938313e-05,4.4425686932184186e-05,0.6666666666666666
22060,22060,tva/Alpha,3,2,1,4.445926419917751e-05,3.331926519913814e-05,0.6666666666666666
22061,22061,틴물/Noun,3,2,1,4.445926419917751e-05,3.331926519913814e-05,0.6666666666666666
22062,22062,한게임/Noun,3,1,2,3.334444814938313e-05,4.4425686932184186e-05,0.6666666666666666
22063,22063,세레나데/Noun,3,1,2,3.334444814938313e-05,4.4425686932184186e-05,0.6666666666666666
22064,22064,인해전술/Noun,3,1,2,3.334444814938313e-05,4.4425686932184186e-05,0.6666666666666666
22065,22065,멜랑꼴리/Noun,3,2,1,4.445926419917751e-05,3.331926519913814e-05,0.6666666666666666
22066,22066,초현/Noun,3,2,1,4.445926419917751e-05,3.331926519913814e-05,0.6666666666666666
22067,22067,윅/Noun,3,2,1,4.445926419917751e-05,3.331926519913814e-05,0.6666666666666666
22068,22068,이타/Noun,3,1,2,3.334444814938313e-05,4.4425686932184186e-05,0.6666666666666666
22069,22069,6.8/Number,3,2,1,4.445926419917751e-05,3.331926519913814e-05,0.6666666666666666
22070,22070,라바/Noun,3,2,1,4.445926419917751e-05,3.331926519913814e-05,0.6666666666666666
22071,22071,박은빈/Noun,3,2,1,4.445926419917751e-05,3.331926519913814e-05,0.6666666666666666
22072,22072,스랑/Noun,3,1,2,3.334444814938313e-05,4.4425686932184186e-05,0.6666666666666666
22073,22073,파파야/Noun,3,1,2,3.334444814938313e-05,4.4425686932184186e-05,0.6666666666666666
22074,22074,~~^-^/Punctuation,3,2,1,4.445926419917751e-05,3.331926519913814e-05,0.6666666666666666
22075,22075,도축/Noun,3,1,2,3.334444814938313e-05,4.4425686932184186e-05,0.6666666666666666
22076,22076,가책/Noun,3,2,1,4.445926419917751e-05,3.331926519913814e-05,0.6666666666666666
22077,22077,일식/Noun,3,2,1,4.445926419917751e-05,3.331926519913814e-05,0.6666666666666666
22078,22078,몇장/Noun,3,1,2,3.334444814938313e-05,4.4425686932184186e-05,0.6666666666666666
22079,22079,김윤혜/Noun,3,1,2,3.334444814938313e-05,4.4425686932184186e-05,0.6666666666666666
22080,22080,가상세계/Noun,3,1,2,3.334444814938313e-05,4.4425686932184186e-05,0.6666666666666666
22081,22081,03/Number,3,2,1,4.445926419917751e-05,3.331926519913814e-05,0.6666666666666666
22082,22082,소변/Noun,3,1,2,3.334444814938313e-05,4.4425686932184186e-05,0.6666666666666666
22083,22083,수하/Noun,3,1,2,3.334444814938313e-05,4.4425686932184186e-05,0.6666666666666666
22084,22084,앞길/Noun,3,2,1,4.445926419917751e-05,3.331926519913814e-05,0.6666666666666666
22085,22085,".,.,.,.,.,/Punctuation",3,1,2,3.334444814938313e-05,4.4425686932184186e-05,0.6666666666666666
22086,22086,철의여인/Noun,3,1,2,3.334444814938313e-05,4.4425686932184186e-05,0.6666666666666666
22087,22087,그따위/Modifier,3,1,2,3.334444814938313e-05,4.4425686932184186e-05,0.6666666666666666
22088,22088,사이즈/Noun,3,2,1,4.445926419917751e-05,3.331926519913814e-05,0.6666666666666666
22089,22089,특정하다/Adjective,3,1,2,3.334444814938313e-05,4.4425686932184186e-05,0.6666666666666666
22090,22090,키자루/Noun,3,2,1,4.445926419917751e-05,3.331926519913814e-05,0.6666666666666666
22091,22091,펀/Noun,3,1,2,3.334444814938313e-05,4.4425686932184186e-05,0.6666666666666666
22092,22092,아무렴/Exclamation,3,1,2,3.334444814938313e-05,4.4425686932184186e-05,0.6666666666666666
22093,22093,용역/Noun,3,2,1,4.445926419917751e-05,3.331926519913814e-05,0.6666666666666666
22094,22094,미러/Noun,3,2,1,4.445926419917751e-05,3.331926519913814e-05,0.6666666666666666
22095,22095,농도/Noun,3,2,1,4.445926419917751e-05,3.331926519913814e-05,0.6666666666666666
22096,22096,군사력/Noun,3,1,2,3.334444814938313e-05,4.4425686932184186e-05,0.6666666666666666
22097,22097,이문열/Noun,3,1,2,3.334444814938313e-05,4.4425686932184186e-05,0.6666666666666666
22098,22098,고관/Noun,3,1,2,3.334444814938313e-05,4.4425686932184186e-05,0.6666666666666666
22099,22099,아이비/Noun,3,2,1,4.445926419917751e-05,3.331926519913814e-05,0.6666666666666666
22100,22100,핵전쟁/Noun,3,2,1,4.445926419917751e-05,3.331926519913814e-05,0.6666666666666666
22101,22101,영은/Noun,3,2,1,4.445926419917751e-05,3.331926519913814e-05,0.6666666666666666
22102,22102,카르텔/Noun,3,1,2,3.334444814938313e-05,4.4425686932184186e-05,0.6666666666666666
22103,22103,플래터/Noun,3,1,2,3.334444814938313e-05,4.4425686932184186e-05,0.6666666666666666
22104,22104,폐막/Noun,3,1,2,3.334444814938313e-05,4.4425686932184186e-05,0.6666666666666666
22105,22105,렌프/Noun,3,2,1,4.445926419917751e-05,3.331926519913814e-05,0.6666666666666666
22106,22106,경찰청/Noun,3,1,2,3.334444814938313e-05,4.4425686932184186e-05,0.6666666666666666
22107,22107,듭/Noun,3,2,1,4.445926419917751e-05,3.331926519913814e-05,0.6666666666666666
22108,22108,휘감다/Verb,3,1,2,3.334444814938313e-05,4.4425686932184186e-05,0.6666666666666666
22109,22109,차사/Noun,3,1,2,3.334444814938313e-05,4.4425686932184186e-05,0.6666666666666666
22110,22110,뿌리깊은나무/Noun,3,2,1,4.445926419917751e-05,3.331926519913814e-05,0.6666666666666666
22111,22111,성화/Noun,3,2,1,4.445926419917751e-05,3.331926519913814e-05,0.6666666666666666
22112,22112,유키에/Noun,3,1,2,3.334444814938313e-05,4.4425686932184186e-05,0.6666666666666666
22113,22113,센티미터/Noun,3,1,2,3.334444814938313e-05,4.4425686932184186e-05,0.6666666666666666
22114,22114,점사/Noun,3,1,2,3.334444814938313e-05,4.4425686932184186e-05,0.6666666666666666
22115,22115,게우다/Verb,3,2,1,4.445926419917751e-05,3.331926519913814e-05,0.6666666666666666
22116,22116,!!!!!!!!!!!!!!!!!!!!!!/Punctuation,3,1,2,3.334444814938313e-05,4.4425686932184186e-05,0.6666666666666666
22117,22117,귀염둥이/Noun,3,2,1,4.445926419917751e-05,3.331926519913814e-05,0.6666666666666666
22118,22118,밍키/Noun,3,2,1,4.445926419917751e-05,3.331926519913814e-05,0.6666666666666666
22119,22119,-;;;;/Punctuation,3,2,1,4.445926419917751e-05,3.331926519913814e-05,0.6666666666666666
22120,22120,해원/Noun,3,2,1,4.445926419917751e-05,3.331926519913814e-05,0.6666666666666666
22121,22121,퀸카/Noun,3,1,2,3.334444814938313e-05,4.4425686932184186e-05,0.6666666666666666
22122,22122,낚았다/Noun,3,1,2,3.334444814938313e-05,4.4425686932184186e-05,0.6666666666666666
22123,22123,신품/Noun,3,2,1,4.445926419917751e-05,3.331926519913814e-05,0.6666666666666666
22124,22124,움켜쥐다/Verb,3,1,2,3.334444814938313e-05,4.4425686932184186e-05,0.6666666666666666
22125,22125,ㅜㅜㅋㅋㅋ/KoreanParticle,3,2,1,4.445926419917751e-05,3.331926519913814e-05,0.6666666666666666
22126,22126,4.6/Number,3,1,2,3.334444814938313e-05,4.4425686932184186e-05,0.6666666666666666
22127,22127,경비행기/Noun,3,1,2,3.334444814938313e-05,4.4425686932184186e-05,0.6666666666666666
22128,22128,김윤아/Noun,3,1,2,3.334444814938313e-05,4.4425686932184186e-05,0.6666666666666666
22129,22129,강약/Noun,3,1,2,3.334444814938313e-05,4.4425686932184186e-05,0.6666666666666666
22130,22130,스킨헤드/Noun,3,2,1,4.445926419917751e-05,3.331926519913814e-05,0.6666666666666666
22131,22131,선화/Noun,3,1,2,3.334444814938313e-05,4.4425686932184186e-05,0.6666666666666666
22132,22132,딜/Noun,3,2,1,4.445926419917751e-05,3.331926519913814e-05,0.6666666666666666
22133,22133,자진/Noun,3,1,2,3.334444814938313e-05,4.4425686932184186e-05,0.6666666666666666
22134,22134,샴쌍둥이/Noun,3,1,2,3.334444814938313e-05,4.4425686932184186e-05,0.6666666666666666
22135,22135,얇다/Adjective,3,1,2,3.334444814938313e-05,4.4425686932184186e-05,0.6666666666666666
22136,22136,장미꽃/Noun,3,1,2,3.334444814938313e-05,4.4425686932184186e-05,0.6666666666666666
22137,22137,흑협/Noun,3,1,2,3.334444814938313e-05,4.4425686932184186e-05,0.6666666666666666
22138,22138,장희진/Noun,3,1,2,3.334444814938313e-05,4.4425686932184186e-05,0.6666666666666666
22139,22139,엉뚱/Noun,3,1,2,3.334444814938313e-05,4.4425686932184186e-05,0.6666666666666666
22140,22140,교육자/Noun,3,2,1,4.445926419917751e-05,3.331926519913814e-05,0.6666666666666666
22141,22141,기러기/Noun,3,1,2,3.334444814938313e-05,4.4425686932184186e-05,0.6666666666666666
22142,22142,충사/Noun,3,1,2,3.334444814938313e-05,4.4425686932184186e-05,0.6666666666666666
22143,22143,로섬/Noun,3,2,1,4.445926419917751e-05,3.331926519913814e-05,0.6666666666666666
22144,22144,무럭무럭/Noun,3,2,1,4.445926419917751e-05,3.331926519913814e-05,0.6666666666666666
22145,22145,어지르다/Verb,3,1,2,3.334444814938313e-05,4.4425686932184186e-05,0.6666666666666666
22146,22146,로빈슨/Noun,3,1,2,3.334444814938313e-05,4.4425686932184186e-05,0.6666666666666666
22147,22147,했슴/Noun,3,2,1,4.445926419917751e-05,3.331926519913814e-05,0.6666666666666666
22148,22148,남았는데/Foreign,3,1,2,3.334444814938313e-05,4.4425686932184186e-05,0.6666666666666666
22149,22149,이태성/Noun,3,2,1,4.445926419917751e-05,3.331926519913814e-05,0.6666666666666666
22150,22150,서클/Noun,3,1,2,3.334444814938313e-05,4.4425686932184186e-05,0.6666666666666666
22151,22151,쉡/Noun,3,1,2,3.334444814938313e-05,4.4425686932184186e-05,0.6666666666666666
22152,22152,담요/Noun,3,2,1,4.445926419917751e-05,3.331926519913814e-05,0.6666666666666666
22153,22153,파마/Noun,3,1,2,3.334444814938313e-05,4.4425686932184186e-05,0.6666666666666666
22154,22154,4.44만/Number,3,2,1,4.445926419917751e-05,3.331926519913814e-05,0.6666666666666666
22155,22155,격차/Noun,3,2,1,4.445926419917751e-05,3.331926519913814e-05,0.6666666666666666
22156,22156,횐/Noun,3,1,2,3.334444814938313e-05,4.4425686932184186e-05,0.6666666666666666
22157,22157,가분/Noun,3,1,2,3.334444814938313e-05,4.4425686932184186e-05,0.6666666666666666
22158,22158,창수/Noun,3,2,1,4.445926419917751e-05,3.331926519913814e-05,0.6666666666666666
22159,22159,자격지심/Noun,3,2,1,4.445926419917751e-05,3.331926519913814e-05,0.6666666666666666
22160,22160,무교인/Noun,3,1,2,3.334444814938313e-05,4.4425686932184186e-05,0.6666666666666666
22161,22161,그림형제/Noun,3,1,2,3.334444814938313e-05,4.4425686932184186e-05,0.6666666666666666
22162,22162,호동/Noun,3,1,2,3.334444814938313e-05,4.4425686932184186e-05,0.6666666666666666
22163,22163,여권/Noun,3,1,2,3.334444814938313e-05,4.4425686932184186e-05,0.6666666666666666
22164,22164,공포증/Noun,3,2,1,4.445926419917751e-05,3.331926519913814e-05,0.6666666666666666
22165,22165,80회/Number,3,1,2,3.334444814938313e-05,4.4425686932184186e-05,0.6666666666666666
22166,22166,양식/Noun,3,2,1,4.445926419917751e-05,3.331926519913814e-05,0.6666666666666666
22167,22167,네가지/Noun,3,1,2,3.334444814938313e-05,4.4425686932184186e-05,0.6666666666666666
22168,22168,상륙작전/Noun,3,1,2,3.334444814938313e-05,4.4425686932184186e-05,0.6666666666666666
22169,22169,스코트/Noun,3,1,2,3.334444814938313e-05,4.4425686932184186e-05,0.6666666666666666
22170,22170,보편성/Noun,3,1,2,3.334444814938313e-05,4.4425686932184186e-05,0.6666666666666666
22171,22171,가약/Noun,3,2,1,4.445926419917751e-05,3.331926519913814e-05,0.6666666666666666
22172,22172,@!!!/Punctuation,3,2,1,4.445926419917751e-05,3.331926519913814e-05,0.6666666666666666
22173,22173,선두/Noun,3,2,1,4.445926419917751e-05,3.331926519913814e-05,0.6666666666666666
22174,22174,츠시마/Noun,3,2,1,4.445926419917751e-05,3.331926519913814e-05,0.6666666666666666
22175,22175,호성/Noun,3,2,1,4.445926419917751e-05,3.331926519913814e-05,0.6666666666666666
22176,22176,분산/Noun,3,1,2,3.334444814938313e-05,4.4425686932184186e-05,0.6666666666666666
22177,22177,퍼시잭슨/Noun,3,1,2,3.334444814938313e-05,4.4425686932184186e-05,0.6666666666666666
22178,22178,셔츠/Noun,3,2,1,4.445926419917751e-05,3.331926519913814e-05,0.6666666666666666
22179,22179,넘는/Foreign,3,1,2,3.334444814938313e-05,4.4425686932184186e-05,0.6666666666666666
22180,22180,무신경/Noun,3,1,2,3.334444814938313e-05,4.4425686932184186e-05,0.6666666666666666
22181,22181,스터리/Noun,3,2,1,4.445926419917751e-05,3.331926519913814e-05,0.6666666666666666
22182,22182,루마니아/Noun,3,2,1,4.445926419917751e-05,3.331926519913814e-05,0.6666666666666666
22183,22183,공형진/Noun,3,1,2,3.334444814938313e-05,4.4425686932184186e-05,0.6666666666666666
22184,22184,37/Number,3,1,2,3.334444814938313e-05,4.4425686932184186e-05,0.6666666666666666
22185,22185,교포/Noun,3,2,1,4.445926419917751e-05,3.331926519913814e-05,0.6666666666666666
22186,22186,월리/Noun,3,2,1,4.445926419917751e-05,3.331926519913814e-05,0.6666666666666666
22187,22187,치질/Noun,3,2,1,4.445926419917751e-05,3.331926519913814e-05,0.6666666666666666
22188,22188,윗사람/Noun,3,1,2,3.334444814938313e-05,4.4425686932184186e-05,0.6666666666666666
22189,22189,연명/Noun,3,1,2,3.334444814938313e-05,4.4425686932184186e-05,0.6666666666666666
22190,22190,뛰어나오다/Verb,3,1,2,3.334444814938313e-05,4.4425686932184186e-05,0.6666666666666666
22191,22191,99분/Number,3,1,2,3.334444814938313e-05,4.4425686932184186e-05,0.6666666666666666
22192,22192,이태민/Noun,3,1,2,3.334444814938313e-05,4.4425686932184186e-05,0.6666666666666666
22193,22193,신우/Noun,3,2,1,4.445926419917751e-05,3.331926519913814e-05,0.6666666666666666
22194,22194,눈밭/Noun,3,1,2,3.334444814938313e-05,4.4425686932184186e-05,0.6666666666666666
22195,22195,옹이/Noun,3,2,1,4.445926419917751e-05,3.331926519913814e-05,0.6666666666666666
22196,22196,연주자/Noun,3,1,2,3.334444814938313e-05,4.4425686932184186e-05,0.6666666666666666
22197,22197,작법/Noun,3,1,2,3.334444814938313e-05,4.4425686932184186e-05,0.6666666666666666
22198,22198,겸허/Noun,3,2,1,4.445926419917751e-05,3.331926519913814e-05,0.6666666666666666
22199,22199,우열/Noun,3,2,1,4.445926419917751e-05,3.331926519913814e-05,0.6666666666666666
22200,22200,낙인/Noun,3,1,2,3.334444814938313e-05,4.4425686932184186e-05,0.6666666666666666
22201,22201,날고기/Noun,3,2,1,4.445926419917751e-05,3.331926519913814e-05,0.6666666666666666
22202,22202,인민/Noun,3,1,2,3.334444814938313e-05,4.4425686932184186e-05,0.6666666666666666
22203,22203,빈민가/Noun,3,2,1,4.445926419917751e-05,3.331926519913814e-05,0.6666666666666666
22204,22204,번뇌/Noun,3,2,1,4.445926419917751e-05,3.331926519913814e-05,0.6666666666666666
22205,22205,갓난아이/Noun,3,1,2,3.334444814938313e-05,4.4425686932184186e-05,0.6666666666666666
22206,22206,근황/Noun,3,2,1,4.445926419917751e-05,3.331926519913814e-05,0.6666666666666666
22207,22207,로선/Noun,3,2,1,4.445926419917751e-05,3.331926519913814e-05,0.6666666666666666
22208,22208,여념/Noun,3,1,2,3.334444814938313e-05,4.4425686932184186e-05,0.6666666666666666
22209,22209,줄암/Noun,3,1,2,3.334444814938313e-05,4.4425686932184186e-05,0.6666666666666666
22210,22210,DD/Alpha,3,2,1,4.445926419917751e-05,3.331926519913814e-05,0.6666666666666666
22211,22211,토달/Adverb,3,2,1,4.445926419917751e-05,3.331926519913814e-05,0.6666666666666666
22212,22212,정혜영/Noun,3,1,2,3.334444814938313e-05,4.4425686932184186e-05,0.6666666666666666
22213,22213,단역배우/Noun,3,2,1,4.445926419917751e-05,3.331926519913814e-05,0.6666666666666666
22214,22214,원더걸스/Noun,3,2,1,4.445926419917751e-05,3.331926519913814e-05,0.6666666666666666
22215,22215,이수완/Noun,3,1,2,3.334444814938313e-05,4.4425686932184186e-05,0.6666666666666666
22216,22216,AI/Alpha,3,2,1,4.445926419917751e-05,3.331926519913814e-05,0.6666666666666666
22217,22217,점마/Noun,3,1,2,3.334444814938313e-05,4.4425686932184186e-05,0.6666666666666666
22218,22218,걸스데이/Noun,3,2,1,4.445926419917751e-05,3.331926519913814e-05,0.6666666666666666
22219,22219,착실하다/Adjective,3,1,2,3.334444814938313e-05,4.4425686932184186e-05,0.6666666666666666
22220,22220,ㅋㅋㄱㅋ/KoreanParticle,3,1,2,3.334444814938313e-05,4.4425686932184186e-05,0.6666666666666666
22221,22221,귀뚜라미/Noun,3,1,2,3.334444814938313e-05,4.4425686932184186e-05,0.6666666666666666
22222,22222,거처/Noun,3,1,2,3.334444814938313e-05,4.4425686932184186e-05,0.6666666666666666
22223,22223,위자/Noun,3,1,2,3.334444814938313e-05,4.4425686932184186e-05,0.6666666666666666
22224,22224,크래커/Noun,3,2,1,4.445926419917751e-05,3.331926519913814e-05,0.6666666666666666
22225,22225,은사/Noun,3,2,1,4.445926419917751e-05,3.331926519913814e-05,0.6666666666666666
22226,22226,싱글/Noun,3,2,1,4.445926419917751e-05,3.331926519913814e-05,0.6666666666666666
22227,22227,ㅋㄱㅋㅋ/KoreanParticle,3,2,1,4.445926419917751e-05,3.331926519913814e-05,0.6666666666666666
22228,22228,병크/Noun,3,2,1,4.445926419917751e-05,3.331926519913814e-05,0.6666666666666666
22229,22229,대칭/Noun,3,1,2,3.334444814938313e-05,4.4425686932184186e-05,0.6666666666666666
22230,22230,억제/Noun,3,2,1,4.445926419917751e-05,3.331926519913814e-05,0.6666666666666666
22231,22231,학자/Noun,3,1,2,3.334444814938313e-05,4.4425686932184186e-05,0.6666666666666666
22232,22232,츠코/Noun,3,2,1,4.445926419917751e-05,3.331926519913814e-05,0.6666666666666666
22233,22233,쥐쥐/Noun,3,1,2,3.334444814938313e-05,4.4425686932184186e-05,0.6666666666666666
22234,22234,웃겻/Noun,3,1,2,3.334444814938313e-05,4.4425686932184186e-05,0.6666666666666666
22235,22235,그렘린/Noun,3,2,1,4.445926419917751e-05,3.331926519913814e-05,0.6666666666666666
22236,22236,ㅃ/KoreanParticle,3,1,2,3.334444814938313e-05,4.4425686932184186e-05,0.6666666666666666
22237,22237,17일/Number,3,2,1,4.445926419917751e-05,3.331926519913814e-05,0.6666666666666666
22238,22238,열성/Noun,3,1,2,3.334444814938313e-05,4.4425686932184186e-05,0.6666666666666666
22239,22239,플라토닉/Noun,3,2,1,4.445926419917751e-05,3.331926519913814e-05,0.6666666666666666
22240,22240,Ctrl/Alpha,3,1,2,3.334444814938313e-05,4.4425686932184186e-05,0.6666666666666666
22241,22241,오마이/Noun,3,1,2,3.334444814938313e-05,4.4425686932184186e-05,0.6666666666666666
22242,22242,하쿠나마타타/Noun,3,2,1,4.445926419917751e-05,3.331926519913814e-05,0.6666666666666666
22243,22243,상주/Noun,3,2,1,4.445926419917751e-05,3.331926519913814e-05,0.6666666666666666
22244,22244,숀빈/Noun,3,2,1,4.445926419917751e-05,3.331926519913814e-05,0.6666666666666666
22245,22245,뚱/Noun,3,2,1,4.445926419917751e-05,3.331926519913814e-05,0.6666666666666666
22246,22246,엠마누엘/Noun,3,1,2,3.334444814938313e-05,4.4425686932184186e-05,0.6666666666666666
22247,22247,득점/Noun,3,1,2,3.334444814938313e-05,4.4425686932184186e-05,0.6666666666666666
22248,22248,칩스/Noun,3,1,2,3.334444814938313e-05,4.4425686932184186e-05,0.6666666666666666
22249,22249,아나키스트/Noun,3,2,1,4.445926419917751e-05,3.331926519913814e-05,0.6666666666666666
22250,22250,주절대다/Verb,3,1,2,3.334444814938313e-05,4.4425686932184186e-05,0.6666666666666666
22251,22251,기록물/Noun,3,1,2,3.334444814938313e-05,4.4425686932184186e-05,0.6666666666666666
22252,22252,박영선/Noun,3,1,2,3.334444814938313e-05,4.4425686932184186e-05,0.6666666666666666
22253,22253,벌점/Noun,3,1,2,3.334444814938313e-05,4.4425686932184186e-05,0.6666666666666666
22254,22254,중첩/Noun,3,2,1,4.445926419917751e-05,3.331926519913814e-05,0.6666666666666666
22255,22255,백신/Noun,3,1,2,3.334444814938313e-05,4.4425686932184186e-05,0.6666666666666666
22256,22256,괘/Noun,3,2,1,4.445926419917751e-05,3.331926519913814e-05,0.6666666666666666
22257,22257,불똥/Noun,3,1,2,3.334444814938313e-05,4.4425686932184186e-05,0.6666666666666666
22258,22258,질때/Noun,3,2,1,4.445926419917751e-05,3.331926519913814e-05,0.6666666666666666
22259,22259,데온/Noun,3,2,1,4.445926419917751e-05,3.331926519913814e-05,0.6666666666666666
22260,22260,갈무리/Noun,3,1,2,3.334444814938313e-05,4.4425686932184186e-05,0.6666666666666666
22261,22261,유리하다/Adjective,3,1,2,3.334444814938313e-05,4.4425686932184186e-05,0.6666666666666666
22262,22262,당국/Noun,3,1,2,3.334444814938313e-05,4.4425686932184186e-05,0.6666666666666666
22263,22263,Mc/Alpha,3,1,2,3.334444814938313e-05,4.4425686932184186e-05,0.6666666666666666
22264,22264,다빈치/Noun,3,1,2,3.334444814938313e-05,4.4425686932184186e-05,0.6666666666666666
22265,22265,언변/Noun,3,1,2,3.334444814938313e-05,4.4425686932184186e-05,0.6666666666666666
22266,22266,상암/Noun,3,1,2,3.334444814938313e-05,4.4425686932184186e-05,0.6666666666666666
22267,22267,반발/Noun,3,1,2,3.334444814938313e-05,4.4425686932184186e-05,0.6666666666666666
22268,22268,일래/Noun,3,2,1,4.445926419917751e-05,3.331926519913814e-05,0.6666666666666666
22269,22269,금일/Noun,3,1,2,3.334444814938313e-05,4.4425686932184186e-05,0.6666666666666666
22270,22270,무도회/Noun,3,2,1,4.445926419917751e-05,3.331926519913814e-05,0.6666666666666666
22271,22271,왓던/Noun,3,2,1,4.445926419917751e-05,3.331926519913814e-05,0.6666666666666666
22272,22272,도크/Noun,3,2,1,4.445926419917751e-05,3.331926519913814e-05,0.6666666666666666
22273,22273,혈통/Noun,3,1,2,3.334444814938313e-05,4.4425686932184186e-05,0.6666666666666666
22274,22274,할복/Noun,3,1,2,3.334444814938313e-05,4.4425686932184186e-05,0.6666666666666666
22275,22275,불변/Noun,3,2,1,4.445926419917751e-05,3.331926519913814e-05,0.6666666666666666
22276,22276,빽빽/Noun,3,1,2,3.334444814938313e-05,4.4425686932184186e-05,0.6666666666666666
22277,22277,신해/Noun,3,2,1,4.445926419917751e-05,3.331926519913814e-05,0.6666666666666666
22278,22278,도널드/Noun,3,2,1,4.445926419917751e-05,3.331926519913814e-05,0.6666666666666666
22279,22279,제천/Noun,3,2,1,4.445926419917751e-05,3.331926519913814e-05,0.6666666666666666
22280,22280,쥑임/Noun,3,1,2,3.334444814938313e-05,4.4425686932184186e-05,0.6666666666666666
22281,22281,스토어/Noun,3,2,1,4.445926419917751e-05,3.331926519913814e-05,0.6666666666666666
22282,22282,N/Alpha,3,1,2,3.334444814938313e-05,4.4425686932184186e-05,0.6666666666666666
22283,22283,친위대/Noun,3,1,2,3.334444814938313e-05,4.4425686932184186e-05,0.6666666666666666
22284,22284,어법/Noun,3,1,2,3.334444814938313e-05,4.4425686932184186e-05,0.6666666666666666
22285,22285,팸/Noun,3,1,2,3.334444814938313e-05,4.4425686932184186e-05,0.6666666666666666
22286,22286,^^&/Punctuation,3,1,2,3.334444814938313e-05,4.4425686932184186e-05,0.6666666666666666
22287,22287,사바나/Noun,3,1,2,3.334444814938313e-05,4.4425686932184186e-05,0.6666666666666666
22288,22288,프리덤/Noun,3,1,2,3.334444814938313e-05,4.4425686932184186e-05,0.6666666666666666
22289,22289,저따위/Modifier,3,2,1,4.445926419917751e-05,3.331926519913814e-05,0.6666666666666666
22290,22290,사감/Noun,3,1,2,3.334444814938313e-05,4.4425686932184186e-05,0.6666666666666666
22291,22291,체벌/Noun,3,1,2,3.334444814938313e-05,4.4425686932184186e-05,0.6666666666666666
22292,22292,믹싱/Noun,3,1,2,3.334444814938313e-05,4.4425686932184186e-05,0.6666666666666666
22293,22293,마카로니웨스턴/Noun,3,1,2,3.334444814938313e-05,4.4425686932184186e-05,0.6666666666666666
22294,22294,정당/Noun,3,1,2,3.334444814938313e-05,4.4425686932184186e-05,0.6666666666666666
22295,22295,요전/Noun,3,1,2,3.334444814938313e-05,4.4425686932184186e-05,0.6666666666666666
22296,22296,김수철/Noun,3,2,1,4.445926419917751e-05,3.331926519913814e-05,0.6666666666666666
22297,22297,호튼/Noun,3,1,2,3.334444814938313e-05,4.4425686932184186e-05,0.6666666666666666
22298,22298,농성/Noun,3,2,1,4.445926419917751e-05,3.331926519913814e-05,0.6666666666666666
22299,22299,는데/Eomi,3,2,1,4.445926419917751e-05,3.331926519913814e-05,0.6666666666666666
22300,22300,카르멘/Noun,3,2,1,4.445926419917751e-05,3.331926519913814e-05,0.6666666666666666
22301,22301,파블로/Noun,3,1,2,3.334444814938313e-05,4.4425686932184186e-05,0.6666666666666666
22302,22302,가넷/Noun,3,2,1,4.445926419917751e-05,3.331926519913814e-05,0.6666666666666666
22303,22303,또박또박/Noun,3,2,1,4.445926419917751e-05,3.331926519913814e-05,0.6666666666666666
22304,22304,그런저런/Modifier,3,2,1,4.445926419917751e-05,3.331926519913814e-05,0.6666666666666666
22305,22305,전부일/Noun,3,1,2,3.334444814938313e-05,4.4425686932184186e-05,0.6666666666666666
22306,22306,누드모델/Noun,3,1,2,3.334444814938313e-05,4.4425686932184186e-05,0.6666666666666666
22307,22307,1980/Number,3,1,2,3.334444814938313e-05,4.4425686932184186e-05,0.6666666666666666
22308,22308,핫칙/Noun,3,2,1,4.445926419917751e-05,3.331926519913814e-05,0.6666666666666666
22309,22309,"...,,,/Punctuation",3,1,2,3.334444814938313e-05,4.4425686932184186e-05,0.6666666666666666
22310,22310,자미/Noun,3,1,2,3.334444814938313e-05,4.4425686932184186e-05,0.6666666666666666
22311,22311,저널리스트/Noun,3,1,2,3.334444814938313e-05,4.4425686932184186e-05,0.6666666666666666
22312,22312,think/Alpha,3,2,1,4.445926419917751e-05,3.331926519913814e-05,0.6666666666666666
22313,22313,예선/Noun,3,2,1,4.445926419917751e-05,3.331926519913814e-05,0.6666666666666666
22314,22314,>>>/Punctuation,3,1,2,3.334444814938313e-05,4.4425686932184186e-05,0.6666666666666666
22315,22315,토익/Noun,3,1,2,3.334444814938313e-05,4.4425686932184186e-05,0.6666666666666666
22316,22316,오유인/Noun,3,1,2,3.334444814938313e-05,4.4425686932184186e-05,0.6666666666666666
22317,22317,이양/Noun,3,2,1,4.445926419917751e-05,3.331926519913814e-05,0.6666666666666666
22318,22318,이원종/Noun,3,2,1,4.445926419917751e-05,3.331926519913814e-05,0.6666666666666666
22319,22319,여현수/Noun,3,2,1,4.445926419917751e-05,3.331926519913814e-05,0.6666666666666666
22320,22320,김보연/Noun,3,1,2,3.334444814938313e-05,4.4425686932184186e-05,0.6666666666666666
22321,22321,부동산/Noun,3,1,2,3.334444814938313e-05,4.4425686932184186e-05,0.6666666666666666
22322,22322,면알/Noun,3,2,1,4.445926419917751e-05,3.331926519913814e-05,0.6666666666666666
22323,22323,조델/Noun,3,2,1,4.445926419917751e-05,3.331926519913814e-05,0.6666666666666666
22324,22324,킬러스/Noun,3,2,1,4.445926419917751e-05,3.331926519913814e-05,0.6666666666666666
22325,22325,촐싹대다/Verb,3,2,1,4.445926419917751e-05,3.331926519913814e-05,0.6666666666666666
22326,22326,조선소/Noun,3,1,2,3.334444814938313e-05,4.4425686932184186e-05,0.6666666666666666
22327,22327,월척/Noun,3,2,1,4.445926419917751e-05,3.331926519913814e-05,0.6666666666666666
22328,22328,카셀/Noun,3,2,1,4.445926419917751e-05,3.331926519913814e-05,0.6666666666666666
22329,22329,링거/Noun,3,2,1,4.445926419917751e-05,3.331926519913814e-05,0.6666666666666666
22330,22330,식견/Noun,3,1,2,3.334444814938313e-05,4.4425686932184186e-05,0.6666666666666666
22331,22331,들고나다/Verb,3,2,1,4.445926419917751e-05,3.331926519913814e-05,0.6666666666666666
22332,22332,크/Noun,3,2,1,4.445926419917751e-05,3.331926519913814e-05,0.6666666666666666
22333,22333,달마시안/Noun,3,1,2,3.334444814938313e-05,4.4425686932184186e-05,0.6666666666666666
22334,22334,장현수/Noun,3,1,2,3.334444814938313e-05,4.4425686932184186e-05,0.6666666666666666
22335,22335,면세/Noun,3,2,1,4.445926419917751e-05,3.331926519913814e-05,0.6666666666666666
22336,22336,파란만장/Noun,3,2,1,4.445926419917751e-05,3.331926519913814e-05,0.6666666666666666
22337,22337,노르망디/Noun,3,2,1,4.445926419917751e-05,3.331926519913814e-05,0.6666666666666666
22338,22338,간파/Noun,3,1,2,3.334444814938313e-05,4.4425686932184186e-05,0.6666666666666666
22339,22339,강경준/Noun,3,1,2,3.334444814938313e-05,4.4425686932184186e-05,0.6666666666666666
22340,22340,왕십리/Noun,3,1,2,3.334444814938313e-05,4.4425686932184186e-05,0.6666666666666666
22341,22341,뜯기다/Verb,3,1,2,3.334444814938313e-05,4.4425686932184186e-05,0.6666666666666666
22342,22342,남도/Noun,3,2,1,4.445926419917751e-05,3.331926519913814e-05,0.6666666666666666
22343,22343,인건비/Noun,3,1,2,3.334444814938313e-05,4.4425686932184186e-05,0.6666666666666666
22344,22344,민종/Noun,3,1,2,3.334444814938313e-05,4.4425686932184186e-05,0.6666666666666666
22345,22345,바킨/Noun,3,2,1,4.445926419917751e-05,3.331926519913814e-05,0.6666666666666666
22346,22346,최최/Noun,3,1,2,3.334444814938313e-05,4.4425686932184186e-05,0.6666666666666666
22347,22347,신촌/Noun,3,2,1,4.445926419917751e-05,3.331926519913814e-05,0.6666666666666666
22348,22348,화상/Noun,3,1,2,3.334444814938313e-05,4.4425686932184186e-05,0.6666666666666666
22349,22349,happy/Alpha,3,2,1,4.445926419917751e-05,3.331926519913814e-05,0.6666666666666666
22350,22350,유언/Noun,3,2,1,4.445926419917751e-05,3.331926519913814e-05,0.6666666666666666
22351,22351,피곤/Noun,3,1,2,3.334444814938313e-05,4.4425686932184186e-05,0.6666666666666666
22352,22352,기립/Noun,3,2,1,4.445926419917751e-05,3.331926519913814e-05,0.6666666666666666
22353,22353,데블/Noun,3,2,1,4.445926419917751e-05,3.331926519913814e-05,0.6666666666666666
22354,22354,꽝꽝/Adverb,3,1,2,3.334444814938313e-05,4.4425686932184186e-05,0.6666666666666666
22355,22355,영양/Noun,3,2,1,4.445926419917751e-05,3.331926519913814e-05,0.6666666666666666
22356,22356,오랑/Noun,3,1,2,3.334444814938313e-05,4.4425686932184186e-05,0.6666666666666666
22357,22357,6.7/Number,3,2,1,4.445926419917751e-05,3.331926519913814e-05,0.6666666666666666
22358,22358,22분/Number,3,1,2,3.334444814938313e-05,4.4425686932184186e-05,0.6666666666666666
22359,22359,이종현/Noun,3,1,2,3.334444814938313e-05,4.4425686932184186e-05,0.6666666666666666
22360,22360,환경보호/Noun,3,2,1,4.445926419917751e-05,3.331926519913814e-05,0.6666666666666666
22361,22361,빳/Noun,3,1,2,3.334444814938313e-05,4.4425686932184186e-05,0.6666666666666666
22362,22362,채령/Noun,3,2,1,4.445926419917751e-05,3.331926519913814e-05,0.6666666666666666
22363,22363,선우용녀/Noun,3,1,2,3.334444814938313e-05,4.4425686932184186e-05,0.6666666666666666
22364,22364,이민우/Noun,3,2,1,4.445926419917751e-05,3.331926519913814e-05,0.6666666666666666
22365,22365,구들/Noun,3,1,2,3.334444814938313e-05,4.4425686932184186e-05,0.6666666666666666
22366,22366,따리/Noun,3,1,2,3.334444814938313e-05,4.4425686932184186e-05,0.6666666666666666
22367,22367,미궁/Noun,3,2,1,4.445926419917751e-05,3.331926519913814e-05,0.6666666666666666
22368,22368,고비/Noun,3,2,1,4.445926419917751e-05,3.331926519913814e-05,0.6666666666666666
22369,22369,내비/Noun,3,1,2,3.334444814938313e-05,4.4425686932184186e-05,0.6666666666666666
22370,22370,미트/Noun,3,1,2,3.334444814938313e-05,4.4425686932184186e-05,0.6666666666666666
22371,22371,강경/Noun,3,1,2,3.334444814938313e-05,4.4425686932184186e-05,0.6666666666666666
22372,22372,하제/Noun,3,2,1,4.445926419917751e-05,3.331926519913814e-05,0.6666666666666666
22373,22373,ㅈㅁ/KoreanParticle,3,1,2,3.334444814938313e-05,4.4425686932184186e-05,0.6666666666666666
22374,22374,샐러리맨/Noun,3,1,2,3.334444814938313e-05,4.4425686932184186e-05,0.6666666666666666
22375,22375,??...../Punctuation,3,2,1,4.445926419917751e-05,3.331926519913814e-05,0.6666666666666666
22376,22376,졋음/Noun,3,1,2,3.334444814938313e-05,4.4425686932184186e-05,0.6666666666666666
22377,22377,왕중/Noun,3,2,1,4.445926419917751e-05,3.331926519913814e-05,0.6666666666666666
22378,22378,베토벤바이러스/Noun,3,2,1,4.445926419917751e-05,3.331926519913814e-05,0.6666666666666666
22379,22379,다세/Noun,3,2,1,4.445926419917751e-05,3.331926519913814e-05,0.6666666666666666
22380,22380,보보/Noun,3,1,2,3.334444814938313e-05,4.4425686932184186e-05,0.6666666666666666
22381,22381,총구/Noun,3,2,1,4.445926419917751e-05,3.331926519913814e-05,0.6666666666666666
22382,22382,특강/Noun,3,2,1,4.445926419917751e-05,3.331926519913814e-05,0.6666666666666666
22383,22383,논산/Noun,3,1,2,3.334444814938313e-05,4.4425686932184186e-05,0.6666666666666666
22384,22384,범고래/Noun,3,2,1,4.445926419917751e-05,3.331926519913814e-05,0.6666666666666666
22385,22385,화영/Noun,3,2,1,4.445926419917751e-05,3.331926519913814e-05,0.6666666666666666
22386,22386,꽃말/Noun,3,2,1,4.445926419917751e-05,3.331926519913814e-05,0.6666666666666666
22387,22387,비합리적/Noun,3,1,2,3.334444814938313e-05,4.4425686932184186e-05,0.6666666666666666
22388,22388,잘생겻다/Noun,3,2,1,4.445926419917751e-05,3.331926519913814e-05,0.6666666666666666
22389,22389,오진희/Noun,3,1,2,3.334444814938313e-05,4.4425686932184186e-05,0.6666666666666666
22390,22390,주작/Noun,3,2,1,4.445926419917751e-05,3.331926519913814e-05,0.6666666666666666
22391,22391,투견/Noun,3,2,1,4.445926419917751e-05,3.331926519913814e-05,0.6666666666666666
22392,22392,패트와매트/Noun,3,1,2,3.334444814938313e-05,4.4425686932184186e-05,0.6666666666666666
22393,22393,보라카이/Noun,3,2,1,4.445926419917751e-05,3.331926519913814e-05,0.6666666666666666
22394,22394,라사/Noun,3,1,2,3.334444814938313e-05,4.4425686932184186e-05,0.6666666666666666
22395,22395,마츠야마켄이치/Noun,3,2,1,4.445926419917751e-05,3.331926519913814e-05,0.6666666666666666
22396,22396,진실인/Noun,3,1,2,3.334444814938313e-05,4.4425686932184186e-05,0.6666666666666666
22397,22397,불공정/Noun,3,1,2,3.334444814938313e-05,4.4425686932184186e-05,0.6666666666666666
22398,22398,절경/Noun,3,2,1,4.445926419917751e-05,3.331926519913814e-05,0.6666666666666666
22399,22399,日/Foreign,3,2,1,4.445926419917751e-05,3.331926519913814e-05,0.6666666666666666
22400,22400,잠그다/Verb,3,1,2,3.334444814938313e-05,4.4425686932184186e-05,0.6666666666666666
22401,22401,어두워지다/Verb,3,1,2,3.334444814938313e-05,4.4425686932184186e-05,0.6666666666666666
22402,22402,면은/Eomi,3,2,1,4.445926419917751e-05,3.331926519913814e-05,0.6666666666666666
22403,22403,나팔/Noun,3,2,1,4.445926419917751e-05,3.331926519913814e-05,0.6666666666666666
22404,22404,자연환경/Noun,3,2,1,4.445926419917751e-05,3.331926519913814e-05,0.6666666666666666
22405,22405,김미화/Noun,3,1,2,3.334444814938313e-05,4.4425686932184186e-05,0.6666666666666666
22406,22406,수원/Noun,3,2,1,4.445926419917751e-05,3.331926519913814e-05,0.6666666666666666
22407,22407,이례/Noun,3,1,2,3.334444814938313e-05,4.4425686932184186e-05,0.6666666666666666
22408,22408,카바/Noun,3,1,2,3.334444814938313e-05,4.4425686932184186e-05,0.6666666666666666
22409,22409,돌멩이/Noun,3,2,1,4.445926419917751e-05,3.331926519913814e-05,0.6666666666666666
22410,22410,악장/Noun,3,2,1,4.445926419917751e-05,3.331926519913814e-05,0.6666666666666666
22411,22411,뚱보/Noun,3,1,2,3.334444814938313e-05,4.4425686932184186e-05,0.6666666666666666
22412,22412,무속/Noun,3,2,1,4.445926419917751e-05,3.331926519913814e-05,0.6666666666666666
22413,22413,박빙/Noun,3,1,2,3.334444814938313e-05,4.4425686932184186e-05,0.6666666666666666
22414,22414,로빈후드/Noun,3,2,1,4.445926419917751e-05,3.331926519913814e-05,0.6666666666666666
22415,22415,비발디/Noun,3,1,2,3.334444814938313e-05,4.4425686932184186e-05,0.6666666666666666
22416,22416,클스/Noun,3,1,2,3.334444814938313e-05,4.4425686932184186e-05,0.6666666666666666
22417,22417,전쯤에/Foreign,3,1,2,3.334444814938313e-05,4.4425686932184186e-05,0.6666666666666666
22418,22418,인사이드아웃/Noun,3,1,2,3.334444814938313e-05,4.4425686932184186e-05,0.6666666666666666
22419,22419,폐쇄/Noun,3,1,2,3.334444814938313e-05,4.4425686932184186e-05,0.6666666666666666
22420,22420,업글/Noun,3,2,1,4.445926419917751e-05,3.331926519913814e-05,0.6666666666666666
22421,22421,청나라/Noun,3,2,1,4.445926419917751e-05,3.331926519913814e-05,0.6666666666666666
22422,22422,!!!!!!!!!!!!!!!!!!!!!/Punctuation,3,1,2,3.334444814938313e-05,4.4425686932184186e-05,0.6666666666666666
22423,22423,걸륜/Noun,3,1,2,3.334444814938313e-05,4.4425686932184186e-05,0.6666666666666666
22424,22424,전체주의/Noun,3,1,2,3.334444814938313e-05,4.4425686932184186e-05,0.6666666666666666
22425,22425,대중문화/Noun,3,2,1,4.445926419917751e-05,3.331926519913814e-05,0.6666666666666666
22426,22426,인삼/Noun,3,1,2,3.334444814938313e-05,4.4425686932184186e-05,0.6666666666666666
22427,22427,손범수/Noun,3,1,2,3.334444814938313e-05,4.4425686932184186e-05,0.6666666666666666
22428,22428,룡/Noun,3,1,2,3.334444814938313e-05,4.4425686932184186e-05,0.6666666666666666
22429,22429,엊/Noun,3,1,2,3.334444814938313e-05,4.4425686932184186e-05,0.6666666666666666
22430,22430,세워지다/Verb,3,2,1,4.445926419917751e-05,3.331926519913814e-05,0.6666666666666666
22431,22431,셀카/Noun,3,1,2,3.334444814938313e-05,4.4425686932184186e-05,0.6666666666666666
22432,22432,?!!!!/Punctuation,3,2,1,4.445926419917751e-05,3.331926519913814e-05,0.6666666666666666
22433,22433,페르시아/Noun,3,1,2,3.334444814938313e-05,4.4425686932184186e-05,0.6666666666666666
22434,22434,이엉/Noun,3,2,1,4.445926419917751e-05,3.331926519913814e-05,0.6666666666666666
22435,22435,웠다/Noun,3,2,1,4.445926419917751e-05,3.331926519913814e-05,0.6666666666666666
22436,22436,아인/Noun,3,2,1,4.445926419917751e-05,3.331926519913814e-05,0.6666666666666666
22437,22437,덤블링/Noun,3,1,2,3.334444814938313e-05,4.4425686932184186e-05,0.6666666666666666
22438,22438,준형/Noun,3,2,1,4.445926419917751e-05,3.331926519913814e-05,0.6666666666666666
22439,22439,의뢰/Noun,3,1,2,3.334444814938313e-05,4.4425686932184186e-05,0.6666666666666666
22440,22440,커브/Noun,3,2,1,4.445926419917751e-05,3.331926519913814e-05,0.6666666666666666
22441,22441,구딩/Noun,3,2,1,4.445926419917751e-05,3.331926519913814e-05,0.6666666666666666
22442,22442,폭넓다/Adjective,3,2,1,4.445926419917751e-05,3.331926519913814e-05,0.6666666666666666
22443,22443,나안/Noun,3,2,1,4.445926419917751e-05,3.331926519913814e-05,0.6666666666666666
22444,22444,오메/Noun,3,1,2,3.334444814938313e-05,4.4425686932184186e-05,0.6666666666666666
22445,22445,포크레인/Noun,3,1,2,3.334444814938313e-05,4.4425686932184186e-05,0.6666666666666666
22446,22446,욕좀/Noun,3,2,1,4.445926419917751e-05,3.331926519913814e-05,0.6666666666666666
22447,22447,400만/Number,3,2,1,4.445926419917751e-05,3.331926519913814e-05,0.6666666666666666
22448,22448,김지원/Noun,3,2,1,4.445926419917751e-05,3.331926519913814e-05,0.6666666666666666
22449,22449,PTA/Alpha,3,2,1,4.445926419917751e-05,3.331926519913814e-05,0.6666666666666666
22450,22450,마구마구/Adverb,3,2,1,4.445926419917751e-05,3.331926519913814e-05,0.6666666666666666
22451,22451,민가/Noun,3,2,1,4.445926419917751e-05,3.331926519913814e-05,0.6666666666666666
22452,22452,ova/Alpha,3,1,2,3.334444814938313e-05,4.4425686932184186e-05,0.6666666666666666
22453,22453,장발/Noun,3,2,1,4.445926419917751e-05,3.331926519913814e-05,0.6666666666666666
22454,22454,답니/Noun,3,1,2,3.334444814938313e-05,4.4425686932184186e-05,0.6666666666666666
22455,22455,money/Alpha,3,1,2,3.334444814938313e-05,4.4425686932184186e-05,0.6666666666666666
22456,22456,녓/Noun,3,2,1,4.445926419917751e-05,3.331926519913814e-05,0.6666666666666666
22457,22457,사자후/Noun,3,2,1,4.445926419917751e-05,3.331926519913814e-05,0.6666666666666666
22458,22458,웜홀/Noun,3,1,2,3.334444814938313e-05,4.4425686932184186e-05,0.6666666666666666
22459,22459,번외/Noun,3,1,2,3.334444814938313e-05,4.4425686932184186e-05,0.6666666666666666
22460,22460,레파토리/Noun,3,1,2,3.334444814938313e-05,4.4425686932184186e-05,0.6666666666666666
22461,22461,인가에/Foreign,3,2,1,4.445926419917751e-05,3.331926519913814e-05,0.6666666666666666
22462,22462,로이스/Noun,3,1,2,3.334444814938313e-05,4.4425686932184186e-05,0.6666666666666666
22463,22463,무심/Noun,3,2,1,4.445926419917751e-05,3.331926519913814e-05,0.6666666666666666
22464,22464,143분/Number,3,1,2,3.334444814938313e-05,4.4425686932184186e-05,0.6666666666666666
22465,22465,세이지/Noun,3,1,2,3.334444814938313e-05,4.4425686932184186e-05,0.6666666666666666
22466,22466,어지럽히다/Verb,3,1,2,3.334444814938313e-05,4.4425686932184186e-05,0.6666666666666666
22467,22467,명민좌/Noun,3,2,1,4.445926419917751e-05,3.331926519913814e-05,0.6666666666666666
22468,22468,지코/Noun,3,1,2,3.334444814938313e-05,4.4425686932184186e-05,0.6666666666666666
22469,22469,캐산/Noun,3,1,2,3.334444814938313e-05,4.4425686932184186e-05,0.6666666666666666
22470,22470,well/Alpha,3,2,1,4.445926419917751e-05,3.331926519913814e-05,0.6666666666666666
22471,22471,미인도/Noun,3,1,2,3.334444814938313e-05,4.4425686932184186e-05,0.6666666666666666
22472,22472,초연/Noun,3,2,1,4.445926419917751e-05,3.331926519913814e-05,0.6666666666666666
22473,22473,한영/Noun,3,2,1,4.445926419917751e-05,3.331926519913814e-05,0.6666666666666666
22474,22474,나가떨어지다/Verb,3,2,1,4.445926419917751e-05,3.331926519913814e-05,0.6666666666666666
22475,22475,공수/Noun,3,2,1,4.445926419917751e-05,3.331926519913814e-05,0.6666666666666666
22476,22476,번쩍번쩍/Adverb,3,1,2,3.334444814938313e-05,4.4425686932184186e-05,0.6666666666666666
22477,22477,중대/Noun,3,2,1,4.445926419917751e-05,3.331926519913814e-05,0.6666666666666666
22478,22478,앤헤/Noun,3,1,2,3.334444814938313e-05,4.4425686932184186e-05,0.6666666666666666
22479,22479,됨됨이/Noun,3,2,1,4.445926419917751e-05,3.331926519913814e-05,0.6666666666666666
22480,22480,제다이/Noun,3,1,2,3.334444814938313e-05,4.4425686932184186e-05,0.6666666666666666
22481,22481,수령/Noun,3,1,2,3.334444814938313e-05,4.4425686932184186e-05,0.6666666666666666
22482,22482,두아/Noun,3,2,1,4.445926419917751e-05,3.331926519913814e-05,0.6666666666666666
22483,22483,예시/Noun,3,1,2,3.334444814938313e-05,4.4425686932184186e-05,0.6666666666666666
22484,22484,엘사/Noun,3,1,2,3.334444814938313e-05,4.4425686932184186e-05,0.6666666666666666
22485,22485,썬더일레븐/Noun,3,2,1,4.445926419917751e-05,3.331926519913814e-05,0.6666666666666666
22486,22486,도열/Noun,3,1,2,3.334444814938313e-05,4.4425686932184186e-05,0.6666666666666666
22487,22487,그녈/Noun,3,2,1,4.445926419917751e-05,3.331926519913814e-05,0.6666666666666666
22488,22488,암호/Noun,3,2,1,4.445926419917751e-05,3.331926519913814e-05,0.6666666666666666
22489,22489,기류/Noun,3,1,2,3.334444814938313e-05,4.4425686932184186e-05,0.6666666666666666
22490,22490,48분/Number,3,1,2,3.334444814938313e-05,4.4425686932184186e-05,0.6666666666666666
22491,22491,곱창/Noun,3,1,2,3.334444814938313e-05,4.4425686932184186e-05,0.6666666666666666
22492,22492,정당방위/Noun,3,2,1,4.445926419917751e-05,3.331926519913814e-05,0.6666666666666666
22493,22493,동독/Noun,3,1,2,3.334444814938313e-05,4.4425686932184186e-05,0.6666666666666666
22494,22494,레퍼토리/Noun,3,1,2,3.334444814938313e-05,4.4425686932184186e-05,0.6666666666666666
22495,22495,질끈/Noun,3,1,2,3.334444814938313e-05,4.4425686932184186e-05,0.6666666666666666
22496,22496,?-_-/Punctuation,3,1,2,3.334444814938313e-05,4.4425686932184186e-05,0.6666666666666666
22497,22497,윤태영/Noun,3,2,1,4.445926419917751e-05,3.331926519913814e-05,0.6666666666666666
22498,22498,귱/Noun,3,1,2,3.334444814938313e-05,4.4425686932184186e-05,0.6666666666666666
22499,22499,애둘/Noun,3,1,2,3.334444814938313e-05,4.4425686932184186e-05,0.6666666666666666
22500,22500,수색/Noun,3,1,2,3.334444814938313e-05,4.4425686932184186e-05,0.6666666666666666
22501,22501,"?,,,/Punctuation",3,1,2,3.334444814938313e-05,4.4425686932184186e-05,0.6666666666666666
22502,22502,피바다/Noun,3,1,2,3.334444814938313e-05,4.4425686932184186e-05,0.6666666666666666
22503,22503,에손/Noun,3,1,2,3.334444814938313e-05,4.4425686932184186e-05,0.6666666666666666
22504,22504,무용수/Noun,3,2,1,4.445926419917751e-05,3.331926519913814e-05,0.6666666666666666
22505,22505,니엘/Noun,3,2,1,4.445926419917751e-05,3.331926519913814e-05,0.6666666666666666
22506,22506,쾌걸/Noun,3,2,1,4.445926419917751e-05,3.331926519913814e-05,0.6666666666666666
22507,22507,바이스/Noun,3,2,1,4.445926419917751e-05,3.331926519913814e-05,0.6666666666666666
22508,22508,안과/Noun,3,2,1,4.445926419917751e-05,3.331926519913814e-05,0.6666666666666666
22509,22509,그르/Noun,3,1,2,3.334444814938313e-05,4.4425686932184186e-05,0.6666666666666666
22510,22510,3/2/Number,3,1,2,3.334444814938313e-05,4.4425686932184186e-05,0.6666666666666666
22511,22511,화들짝/Adverb,3,1,2,3.334444814938313e-05,4.4425686932184186e-05,0.6666666666666666
22512,22512,담시/Noun,3,2,1,4.445926419917751e-05,3.331926519913814e-05,0.6666666666666666
22513,22513,흘/Noun,3,2,1,4.445926419917751e-05,3.331926519913814e-05,0.6666666666666666
22514,22514,미유키/Noun,3,1,2,3.334444814938313e-05,4.4425686932184186e-05,0.6666666666666666
22515,22515,지수원/Noun,3,2,1,4.445926419917751e-05,3.331926519913814e-05,0.6666666666666666
22516,22516,전철/Noun,3,1,2,3.334444814938313e-05,4.4425686932184186e-05,0.6666666666666666
22517,22517,-)/Punctuation,3,2,1,4.445926419917751e-05,3.331926519913814e-05,0.6666666666666666
22518,22518,루터/Noun,3,2,1,4.445926419917751e-05,3.331926519913814e-05,0.6666666666666666
22519,22519,폐하/Noun,3,1,2,3.334444814938313e-05,4.4425686932184186e-05,0.6666666666666666
22520,22520,퍼시/Noun,3,2,1,4.445926419917751e-05,3.331926519913814e-05,0.6666666666666666
22521,22521,신해혁명/Noun,3,2,1,4.445926419917751e-05,3.331926519913814e-05,0.6666666666666666
22522,22522,월동/Noun,3,2,1,4.445926419917751e-05,3.331926519913814e-05,0.6666666666666666
22523,22523,국판/Noun,3,1,2,3.334444814938313e-05,4.4425686932184186e-05,0.6666666666666666
22524,22524,은꼴/Noun,3,1,2,3.334444814938313e-05,4.4425686932184186e-05,0.6666666666666666
22525,22525,박혁권/Noun,3,2,1,4.445926419917751e-05,3.331926519913814e-05,0.6666666666666666
22526,22526,짠지/Noun,3,1,2,3.334444814938313e-05,4.4425686932184186e-05,0.6666666666666666
22527,22527,척박하다/Adjective,3,2,1,4.445926419917751e-05,3.331926519913814e-05,0.6666666666666666
22528,22528,녁/Noun,3,2,1,4.445926419917751e-05,3.331926519913814e-05,0.6666666666666666
22529,22529,운동권/Noun,3,1,2,3.334444814938313e-05,4.4425686932184186e-05,0.6666666666666666
22530,22530,틀어막다/Verb,3,1,2,3.334444814938313e-05,4.4425686932184186e-05,0.6666666666666666
22531,22531,",,,;;/Punctuation",3,1,2,3.334444814938313e-05,4.4425686932184186e-05,0.6666666666666666
22532,22532,스케줄/Noun,3,2,1,4.445926419917751e-05,3.331926519913814e-05,0.6666666666666666
22533,22533,노엘/Noun,3,2,1,4.445926419917751e-05,3.331926519913814e-05,0.6666666666666666
22534,22534,양철북/Noun,3,2,1,4.445926419917751e-05,3.331926519913814e-05,0.6666666666666666
22535,22535,성사/Noun,3,2,1,4.445926419917751e-05,3.331926519913814e-05,0.6666666666666666
22536,22536,인데도/Foreign,3,2,1,4.445926419917751e-05,3.331926519913814e-05,0.6666666666666666
22537,22537,유성/Noun,3,1,2,3.334444814938313e-05,4.4425686932184186e-05,0.6666666666666666
22538,22538,올드먼/Noun,3,2,1,4.445926419917751e-05,3.331926519913814e-05,0.6666666666666666
22539,22539,관찰자/Noun,3,2,1,4.445926419917751e-05,3.331926519913814e-05,0.6666666666666666
22540,22540,가치나/Noun,3,1,2,3.334444814938313e-05,4.4425686932184186e-05,0.6666666666666666
22541,22541,까탈/Noun,3,2,1,4.445926419917751e-05,3.331926519913814e-05,0.6666666666666666
22542,22542,alive/Alpha,3,2,1,4.445926419917751e-05,3.331926519913814e-05,0.6666666666666666
22543,22543,Still/Alpha,3,2,1,4.445926419917751e-05,3.331926519913814e-05,0.6666666666666666
22544,22544,드론/Noun,3,2,1,4.445926419917751e-05,3.331926519913814e-05,0.6666666666666666
22545,22545,문화재/Noun,3,1,2,3.334444814938313e-05,4.4425686932184186e-05,0.6666666666666666
22546,22546,은실/Noun,3,2,1,4.445926419917751e-05,3.331926519913814e-05,0.6666666666666666
22547,22547,오르다/Noun,3,2,1,4.445926419917751e-05,3.331926519913814e-05,0.6666666666666666
22548,22548,폭발력/Noun,3,2,1,4.445926419917751e-05,3.331926519913814e-05,0.6666666666666666
22549,22549,파이널판타지/Noun,3,2,1,4.445926419917751e-05,3.331926519913814e-05,0.6666666666666666
22550,22550,공화당/Noun,3,1,2,3.334444814938313e-05,4.4425686932184186e-05,0.6666666666666666
22551,22551,2초/Number,3,1,2,3.334444814938313e-05,4.4425686932184186e-05,0.6666666666666666
22552,22552,읃/Noun,3,1,2,3.334444814938313e-05,4.4425686932184186e-05,0.6666666666666666
22553,22553,죠죠/Noun,3,1,2,3.334444814938313e-05,4.4425686932184186e-05,0.6666666666666666
22554,22554,복받치다/Verb,3,2,1,4.445926419917751e-05,3.331926519913814e-05,0.6666666666666666
22555,22555,박태환/Noun,3,1,2,3.334444814938313e-05,4.4425686932184186e-05,0.6666666666666666
22556,22556,악용/Noun,3,1,2,3.334444814938313e-05,4.4425686932184186e-05,0.6666666666666666
22557,22557,뭐징/Noun,3,2,1,4.445926419917751e-05,3.331926519913814e-05,0.6666666666666666
22558,22558,용호상박/Noun,3,1,2,3.334444814938313e-05,4.4425686932184186e-05,0.6666666666666666
22559,22559,ㅎㅋㅋ/KoreanParticle,3,2,1,4.445926419917751e-05,3.331926519913814e-05,0.6666666666666666
22560,22560,패치/Noun,3,1,2,3.334444814938313e-05,4.4425686932184186e-05,0.6666666666666666
22561,22561,담당자/Noun,3,1,2,3.334444814938313e-05,4.4425686932184186e-05,0.6666666666666666
22562,22562,어니스트/Noun,3,2,1,4.445926419917751e-05,3.331926519913814e-05,0.6666666666666666
22563,22563,안당/Noun,3,1,2,3.334444814938313e-05,4.4425686932184186e-05,0.6666666666666666
22564,22564,어으/Noun,3,1,2,3.334444814938313e-05,4.4425686932184186e-05,0.6666666666666666
22565,22565,놀이기구/Noun,3,2,1,4.445926419917751e-05,3.331926519913814e-05,0.6666666666666666
22566,22566,디지몬/Noun,3,1,2,3.334444814938313e-05,4.4425686932184186e-05,0.6666666666666666
22567,22567,츠카/Noun,3,2,1,4.445926419917751e-05,3.331926519913814e-05,0.6666666666666666
22568,22568,사업가/Noun,3,2,1,4.445926419917751e-05,3.331926519913814e-05,0.6666666666666666
22569,22569,임정영/Noun,3,2,1,4.445926419917751e-05,3.331926519913814e-05,0.6666666666666666
22570,22570,딘줄/Noun,3,1,2,3.334444814938313e-05,4.4425686932184186e-05,0.6666666666666666
22571,22571,뽕똘/Noun,3,1,2,3.334444814938313e-05,4.4425686932184186e-05,0.6666666666666666
22572,22572,싸매다/Verb,3,1,2,3.334444814938313e-05,4.4425686932184186e-05,0.6666666666666666
22573,22573,호옹이/Noun,3,1,2,3.334444814938313e-05,4.4425686932184186e-05,0.6666666666666666
22574,22574,니콜라/Noun,3,2,1,4.445926419917751e-05,3.331926519913814e-05,0.6666666666666666
22575,22575,용맹하다/Adjective,3,2,1,4.445926419917751e-05,3.331926519913814e-05,0.6666666666666666
