,Unnamed: 0,parameter,counts,counts_H,counts_NH,p_from_H,p_from_NH,priority
0,15,없다/Adjective,16914,5001,11913,0.05560742469712127,0.13233301494924365,0.7043277758070238
1,19,좋다/Adjective,13043,9370,3673,0.10416805601867288,0.040816099868944224,0.7183930077436173
2,22,재밌다/Adjective,11789,9955,1834,0.1106702234078026,0.020391390301872543,0.8444312494698448
3,23,?/Punctuation,11319,3302,8017,0.03672335222852062,0.08906239587729625,0.7082781164413817
4,24,정말/Noun,10702,7082,3620,0.07873735689674335,0.04022745951709279,0.6617454681367969
5,34,!/Punctuation,8565,6415,2150,0.07132377459153051,0.02390101956951509,0.7489784004670169
6,38,만/Josa,7745,2412,5333,0.026831165944203626,0.05925275994580066,0.6885732730794061
7,40,만들다/Verb,7199,2506,4693,0.02787595865288429,0.05214465003665119,0.6518960966800944
8,44,최고/Noun,6671,6143,528,0.06830054462598642,0.005886403518514404,0.9208514465597362
9,51,~/Punctuation,6003,4016,1987,0.0446593308880738,0.022090672827028587,0.6689988339163752
10,55,감동/Noun,5597,4442,1155,0.049394242525286215,0.012850129945134276,0.7936394497051992
11,57,1/Number,5284,1409,3875,0.015683005446259866,0.043059597059019517,0.7333459500378501
12,62,아깝다/Adjective,5167,374,4793,0.004179170834722685,0.0532552922099558,0.9276175730598026
13,66,때/Noun,4940,3220,1720,0.03581193731243748,0.01912525822430529,0.6518218623481782
14,69,재미있다/Adjective,4787,4102,685,0.04561520506835612,0.007630111730602634,0.8569041153123041
15,72,감독/Noun,4688,1515,3173,0.016861175947538068,0.0352628890024212,0.6768344709897611
16,75,내용/Noun,4529,1407,3122,0.015660775814160276,0.03469646149403585,0.6893353941267388
17,76,뭐/Noun,4491,831,3660,0.009258641769478715,0.04067171638641463,0.8149632598530394
18,77,못/VerbPrefix,4418,1474,2944,0.0164054684894965,0.032719518425553665,0.666364870982345
19,78,그냥/Noun,4406,1187,3219,0.013215516283205513,0.035773784402141316,0.7305946436677259
20,83,안/VerbPrefix,4262,1318,2944,0.014671557185728575,0.032719518425553665,0.6907555138432661
21,84,재미없다/Adjective,4205,307,3898,0.0034344781593864623,0.04331504475887958,0.9269916765755052
22,88,지루하다/Adjective,4057,872,3185,0.009714349227520284,0.03539616606321775,0.7850628543258565
23,91,!!/Punctuation,4005,3088,917,0.03434478159386462,0.010206801572669318,0.7710362047440699
24,92,시간/Noun,3956,1077,2879,0.01199288651772813,0.03199760101290566,0.7277553083923155
25,94,쓰레기/Noun,3739,209,3530,0.002345226186506613,0.03922788156111864,0.9441027012570206
26,96,수/Noun,3698,2475,1223,0.027531399355340668,0.013605366622981408,0.6692806922660898
27,105,다시/Noun,3289,2763,526,0.03073246637768145,0.005864190675048313,0.8400729705077531
28,106,10/Number,3248,2158,1090,0.02400800266755585,0.012128212532486284,0.6644088669950738
29,107,마지막/Noun,3201,2151,1050,0.02393019895520729,0.011683955663164441,0.6719775070290535
30,109,사랑/Noun,3190,2523,667,0.0280649105257308,0.0074301961394078065,0.7909090909090909
31,110,잘/VerbPrefix,3151,2150,1001,0.023919084139157498,0.011139740998245185,0.682323072040622
32,116,이다/Adjective,2942,2200,742,0.02447482494164721,0.00826317776938626,0.7477906186267845
33,124,안되다/Adjective,2683,658,2025,0.0073357785928642874,0.022512716852884338,0.7547521431233694
34,131,지금/Noun,2596,1843,753,0.020506835611870625,0.008385348408449766,0.7099383667180277
35,132,ㅠㅠ/KoreanParticle,2589,1842,747,0.020495720795820828,0.008318709878051491,0.7114716106604867
36,133,최악/Noun,2549,32,2517,0.00037790374569300877,0.027977076345542997,0.9874460572773636
37,136,걸/Noun,2493,777,1716,0.008658441702789819,0.01908083253737311,0.6883273164861613
38,140,별로/Noun,2438,320,2118,0.0035789707680337892,0.023545614074057617,0.8687448728465955
39,142,돈/Noun,2433,279,2154,0.00312326330999222,0.023945445256447283,0.8853267570900123
40,148,역시/Noun,2323,1623,700,0.01806157608091586,0.007796708056598325,0.6986655187257856
41,149,넘다/Verb,2286,1520,766,0.01691675002778704,0.008529731890979364,0.6649168853893264
42,150,개/Noun,2277,671,1606,0.007480271201511616,0.017859126146738045,0.7053140096618358
43,151,명작/Noun,2259,1976,283,0.02198510614649328,0.0031653301939181234,0.8747233289065959
44,153,남다/Verb,2231,1452,779,0.016160942536401022,0.008674115373508963,0.6508292245629762
45,157,^^/Punctuation,2162,1921,241,0.021373791263754584,0.002698860481130189,0.8885291396854764
46,159,괜찮다/Adjective,2129,1444,685,0.01607202400800267,0.007630111730602634,0.6782527007984971
47,160,ㅡㅡ/KoreanParticle,2128,211,1917,0.002367455818606202,0.021313223305715362,0.9008458646616542
48,163,버리다/Verb,2073,660,1413,0.007358008224963877,0.015715586752260157,0.6816208393632417
49,164,느끼다/Verb,2066,1442,624,0.016049794375903082,0.006952620004886826,0.6979670861568248
50,167,!!!/Punctuation,2038,1392,646,0.01549405357341336,0.007196961283013839,0.6830225711481845
51,168,또/Noun,2013,1348,665,0.01500500166722241,0.007407983295941714,0.6696472925981123
52,170,해주다/Verb,1945,1324,621,0.014738246082027343,0.0069193007396876885,0.680719794344473
53,173,꼭/Noun,1920,1594,326,0.017739246415471824,0.003642906328439104,0.8302083333333333
54,177,아름답다/Adjective,1901,1659,242,0.01846170945870846,0.0027099669028632354,0.8726985796948974
55,181,마음/Noun,1810,1497,313,0.016661109258641768,0.003498522845909505,0.8270718232044199
56,182,인생/Noun,1810,1304,506,0.014515949761031457,0.005642062240387392,0.7204419889502762
57,185,기억/Noun,1794,1237,557,0.01377125708569523,0.00620848974877274,0.6895206243032329
58,188,끄다/Verb,1754,541,1213,0.006035345115038346,0.013494302405650948,0.6915621436716077
59,189,아쉽다/Adjective,1746,1186,560,0.013204401467155718,0.006241809013971878,0.6792668957617412
60,191,ㅎㅎ/KoreanParticle,1744,1498,246,0.01667222407469156,0.00275439258979542,0.8589449541284404
61,194,못/Noun,1720,544,1176,0.0060686895631877295,0.013083364801528243,0.6837209302325581
62,195,소재/Noun,1714,594,1120,0.006624430365677447,0.012461405184477666,0.6534422403733956
63,196,이나/Josa,1704,527,1177,0.005879737690341225,0.013094471223261291,0.6907276995305164
64,197,어리다/Verb,1690,1270,420,0.014138046015338444,0.004686909971345432,0.7514792899408284
65,198,재다/Verb,1675,1417,258,0.01577192397465822,0.0028876696505919725,0.8459701492537314
66,200,뻔하다/Adjective,1670,457,1213,0.005101700566855619,0.013494302405650948,0.7263473053892215
67,201,애/Noun,1670,576,1094,0.006424363676781149,0.012172638219418469,0.6550898203592814
68,202,수준/Noun,1658,273,1385,0.003056574413693453,0.01540460694373487,0.8353437876960192
69,203,맞다/Verb,1649,477,1172,0.005323996887851506,0.01303893911459606,0.7107337780473014
70,204,한번/Noun,1640,1136,504,0.012648660664666,0.0056198493969213,0.6926829268292682
71,206,네/Josa,1608,469,1139,0.005235078359453151,0.01267242719740554,0.7083333333333334
72,210,현실/Noun,1587,1041,546,0.011592753139935534,0.0060863191097092345,0.6559546313799622
73,211,전개/Noun,1586,418,1168,0.004668222740913638,0.012994513427663876,0.7364438839848676
74,212,매력/Noun,1586,1153,433,0.012837612537512505,0.004831293453875031,0.7269861286254728
75,214,되어다/Verb,1577,1073,504,0.011948427253528954,0.0056198493969213,0.6804058338617628
76,215,가슴/Noun,1575,1376,199,0.01531621651661665,0.002232390768342256,0.8736507936507937
77,216,낮다/Adjective,1560,1254,306,0.013960208958541736,0.0034207778937781824,0.8038461538461539
78,217,말다/Verb,1559,338,1221,0.0037790374569300882,0.013583153779515316,0.7831943553559975
79,219,~~/Punctuation,1556,1038,518,0.011559408691786151,0.005775339301183945,0.6670951156812339
80,220,야/Josa,1543,373,1170,0.00416805601867289,0.013016726271129968,0.7582631237848347
81,222,높다/Adjective,1536,327,1209,0.003656774480382349,0.013449876718718765,0.787109375
82,225,가장/Noun,1534,1006,528,0.011203734578192731,0.005886403518514404,0.6558018252933507
83,226,;;/Punctuation,1523,373,1150,0.00416805601867289,0.012794597836469045,0.7550886408404465
84,228,슬프다/Adjective,1504,1292,212,0.014382571968433922,0.002376774250871854,0.8590425531914894
85,229,??/Punctuation,1503,455,1048,0.0050794709347560295,0.01166174281969835,0.697272122421823
86,231,멋지다/Adjective,1475,1271,204,0.01414916083138824,0.0022879228770074857,0.8616949152542372
87,235,음악/Noun,1452,1077,375,0.01199288651772813,0.00418712099335836,0.7417355371900827
88,237,성/Suffix,1445,496,949,0.005535178392797599,0.010562207068126793,0.6567474048442906
89,239,유치하다/Adjective,1442,282,1160,0.003156607758141603,0.012905662053799508,0.8044382801664355
90,240,아이/Noun,1436,944,492,0.01051461598310548,0.005486572336124747,0.6573816155988857
91,241,죽다/Verb,1435,475,960,0.005301767255751918,0.010684377707190298,0.6689895470383276
92,247,무슨/Noun,1408,215,1193,0.00241191508280538,0.013272173970990026,0.8473011363636364
93,248,추천/Noun,1403,1037,366,0.011548293875736356,0.004087163197760945,0.7391304347826086
94,249,만/Noun,1401,947,454,0.010547960431254862,0.0050645283102689976,0.6759457530335474
95,250,냐/Josa,1392,169,1223,0.0019006335445148387,0.013605366622981408,0.8785919540229885
96,251,인지/Josa,1383,425,958,0.004746026453262197,0.010662164863724205,0.6926970354302241
97,252,쓰다/Verb,1383,430,953,0.0048016005335111715,0.010606632755058977,0.6890817064352857
98,254,눈물/Noun,1378,1156,222,0.012870956985661888,0.0024878384682023146,0.8388969521044993
99,255,인가/Josa,1378,446,932,0.004979437590307881,0.010373397898665008,0.6763425253991292
100,257,번/Noun,1370,945,425,0.010525730799155274,0.004742442080010663,0.6897810218978102
101,259,ㅠ/KoreanParticle,1361,899,462,0.01001444926086473,0.005153379684133366,0.6605437178545187
102,261,저/Determiner,1355,471,884,0.00525730799155274,0.009840289655478798,0.6523985239852399
103,262,우리/Noun,1346,996,350,0.011092586417694788,0.003909460450032209,0.7399702823179792
104,264,네/Suffix,1337,913,424,0.010170056685561854,0.004731335658277615,0.6828721017202692
105,270,허다/Verb,1294,206,1088,0.0023118817383572304,0.01210599968902019,0.8408037094281299
106,272,원작/Noun,1275,429,846,0.004790485717461376,0.009418245629623049,0.6635294117647059
107,273,짜증나다/Adjective,1251,81,1170,0.0009225297321329332,0.013016726271129968,0.9352517985611509
108,278,찍다/Verb,1231,259,972,0.002900966988996332,0.01081765476798685,0.7896019496344435
109,282,기대하다/Adjective,1222,341,881,0.003812381905079471,0.00980697039027966,0.7209492635024549
110,284,여운/Noun,1210,1139,71,0.012682005112815385,0.0008107687865123613,0.9413223140495868
111,288,전혀/Noun,1199,338,861,0.0037790374569300882,0.00958484195561874,0.7180984153461217
112,291,모두/Noun,1194,810,384,0.009025230632433032,0.004287078788955775,0.6783919597989949
113,292,대박/Noun,1180,975,205,0.010859175280649105,0.002299029298740532,0.826271186440678
114,297,별/Noun,1164,304,860,0.003401133711237079,0.009573735533885692,0.7388316151202751
115,300,굿/Noun,1156,1072,84,0.011937312437479159,0.00095515226904196,0.9273356401384084
116,303,모습/Noun,1142,842,300,0.009380904746026451,0.003354139363379907,0.7373029772329247
117,304,별/Modifier,1142,316,826,0.0035345115038346118,0.009196117194962126,0.7232924693520141
118,309,치다/Verb,1122,345,777,0.0038568411692786494,0.00865190253004287,0.6925133689839572
119,310,실망/Noun,1118,115,1003,0.001300433477825942,0.011161953841711278,0.8971377459749553
120,317,보지/Noun,1094,324,770,0.003623430032232967,0.008574157577911549,0.7038391224862889
121,319,건지다/Verb,1093,195,898,0.002189618761809492,0.009995779559741442,0.8215919487648673
122,327,귀엽다/Adjective,1069,881,188,0.009814382571968434,0.0021102201292787486,0.8241347053320861
123,331,대단하다/Adjective,1057,751,306,0.008369456485495166,0.0034207778937781824,0.7105014191106906
124,335,뿐/Noun,1051,311,740,0.0034789374235856397,0.008240964925920167,0.7040913415794482
125,338,ㅎ/KoreanParticle,1048,840,208,0.009358675113926865,0.00233234856393967,0.8015267175572519
126,339,;/Punctuation,1045,287,758,0.0032121818383905746,0.008440880517114994,0.7253588516746412
127,340,표현/Noun,1042,681,361,0.00759141936200956,0.004031631089095715,0.6535508637236085
128,341,OO/Alpha,1033,220,813,0.0024674891630543515,0.009051733712432529,0.7870280735721199
129,343,가족/Noun,1031,710,321,0.007913749027453596,0.0035873742197738727,0.6886517943743938
130,345,잔잔하다/Adjective,1023,897,126,0.009992219628765144,0.001421621981829894,0.8768328445747801
131,349,점도/Noun,1011,91,920,0.001033677892630877,0.010240120837868457,0.9099901088031652
132,352,용/Noun,999,295,704,0.003301100366788929,0.00784113374353051,0.7047047047047047
133,353,떨어지다/Verb,997,207,790,0.0023229965544070245,0.00879628601257247,0.7923771313941825
134,356,4/Number,981,333,648,0.0037234633766811158,0.007219174126479932,0.6605504587155964
135,358,급/Noun,974,237,737,0.002656441035900856,0.00820764566072103,0.7566735112936345
136,362,특히/Adverb,966,665,301,0.007413582305212848,0.0033652457851129523,0.6884057971014492
137,366,개인/Noun,957,633,324,0.007057908191619429,0.003620693484973011,0.6614420062695925
138,369,공포/Noun,951,319,632,0.0035678559519839955,0.007041471378751194,0.6645636172450052
139,372,건/Noun,932,292,640,0.0032677559186395466,0.0071303227526155625,0.6866952789699571
140,373,한테/Josa,931,317,614,0.0035456263198844064,0.006841555787556365,0.6595059076262084
141,374,작가/Noun,929,209,720,0.002345226186506613,0.008018836491259245,0.77502691065662
142,376,나름/Noun,923,600,323,0.006691119261976214,0.003609587063239965,0.6500541711809318
143,379,욕/Noun,910,166,744,0.0018672890963654552,0.00828539061285235,0.8175824175824176
144,380,차라리/Noun,909,59,850,0.0006780037790374569,0.00946267131655523,0.935093509350935
145,381,이상하다/Adjective,909,232,677,0.002600866955651884,0.007541260356738266,0.7447744774477447
146,382,노래/Noun,909,604,305,0.006735578526175392,0.0034096714720451365,0.6644664466446645
147,383,깊다/Adjective,907,808,99,0.009003001000333445,0.0011217485950376508,0.8908489525909592
148,385,짱/Noun,905,842,63,0.009380904746026451,0.0007219174126479931,0.9303867403314916
149,387,울다/Verb,900,695,205,0.00774702678670668,0.002299029298740532,0.7722222222222223
150,388,알바/Noun,897,104,793,0.001178170501278204,0.008829605277771607,0.8840579710144928
151,390,0/Number,888,77,811,0.0008780704679337558,0.009029520868966436,0.9132882882882885
152,392,따뜻하다/Adjective,884,833,51,0.009280871401578305,0.0005886403518514405,0.9423076923076924
153,394,삶/Noun,883,770,113,0.008580637990441259,0.0012772384993002955,0.8720271800679502
154,399,오랜/Modifier,870,699,171,0.007791486050905858,0.0019214109598169665,0.8034482758620691
155,400,기/Noun,869,240,629,0.0026897854840502392,0.007008152113552056,0.7238204833141542
156,401,예쁘다/Adjective,865,571,294,0.006368789596532178,0.00328750083298163,0.6601156069364161
157,404,빼다/Verb,861,250,611,0.002800933644548183,0.006808236522357226,0.7096399535423926
158,405,점수/Noun,857,271,586,0.0030343447815938647,0.006530575979031076,0.6837806301050176
159,409,놈/Noun,846,250,596,0.002800933644548183,0.006641640196361536,0.7044917257683215
160,410,아직도/Adverb,841,631,210,0.00703567855951984,0.002354561407405762,0.7502972651605232
161,411,어설프다/Adjective,834,79,755,0.0009003001000333445,0.008407561251915855,0.9052757793764988
162,412,막장/Noun,834,144,690,0.001622763143269979,0.007685643839267866,0.8273381294964028
163,416,훌륭하다/Adjective,825,663,162,0.007391352673113259,0.001821453164219552,0.8036363636363636
164,422,도대체/Noun,805,101,704,0.0011448260531288204,0.00784113374353051,0.8745341614906832
165,426,생각나다/Verb,795,647,148,0.00721351561631655,0.001665963259956907,0.8138364779874214
166,427,류/Noun,790,141,649,0.0015894186951205956,0.007230280548212976,0.8215189873417722
167,431,절대/Noun,787,263,524,0.0029454262531955103,0.005841977831582221,0.6658195679796697
168,433,뭘/Noun,782,175,607,0.001967322440813605,0.006763810835425043,0.7762148337595908
169,434,잇다/Verb,780,524,256,0.0058463932421918404,0.00286545680712588,0.6717948717948717
170,440,써다/Verb,768,243,525,0.0027231299321996217,0.005853084253315267,0.68359375
171,441,수작/Noun,766,696,70,0.007758141602756475,0.0007996623647793153,0.908616187989556
172,443,걍/Adverb,765,208,557,0.002334111370456819,0.00620848974877274,0.7281045751633987
173,444,설정/Noun,762,139,623,0.0015671890630210071,0.0069415135831537795,0.8175853018372703
174,445,초반/Noun,761,265,496,0.0029676558852950985,0.005530998023056932,0.6517739816031537
175,448,놓다/Verb,755,225,530,0.0025230632433033235,0.005908616361980497,0.7019867549668874
176,449,필요없다/Adjective,754,630,124,0.007024563743470045,0.0013994091383638019,0.8355437665782494
177,451,신선하다/Adjective,748,507,241,0.0056574413693453365,0.002698860481130189,0.6778074866310161
178,452,싫다/Adjective,746,130,616,0.0014671557185728574,0.0068637686310224575,0.8257372654155496
179,453,시나리오/Noun,742,207,535,0.0023229965544070245,0.005964148470645727,0.7210242587601078
180,454,딱/Adverb,742,251,491,0.002812048460597977,0.005475465914391701,0.6617250673854448
181,458,출연/Noun,740,226,514,0.0025341780593531177,0.00573091361425176,0.6945945945945946
182,461,멋있다/Adjective,732,615,117,0.0068578415027231296,0.0013216641862324795,0.8401639344262295
183,462,관객/Noun,732,188,544,0.002111815049460932,0.006064106266243142,0.7431693989071039
184,466,노잼/Noun,724,17,707,0.00021118150494609317,0.007874453008729647,0.9765193370165746
185,468,뭔/Modifier,722,104,618,0.001178170501278204,0.006885981474488549,0.8559556786703602
186,470,답답하다/Adjective,719,131,588,0.001478270534622652,0.006552788822497168,0.8178025034770514
187,471,아프다/Adjective,719,559,160,0.006235411803934645,0.0017992403207534593,0.7774687065368567
188,472,시대/Noun,719,474,245,0.005290652439702123,0.0027432861680623736,0.6592489568845619
189,474,장난/Noun,714,182,532,0.002045126153162165,0.005930829205446589,0.7450980392156863
190,475,죽이다/Verb,713,198,515,0.002222963209958875,0.005742020035984807,0.7223001402524544
191,477,최고다/Noun,711,679,32,0.007569189729909971,0.0003776183389235656,0.9549929676511956
192,478,스럽다/Adjective,711,238,473,0.00266755585195065,0.0052755503231968716,0.6652601969057665
193,480,OOO/Alpha,708,91,617,0.001033677892630877,0.006874875052755503,0.8714689265536724
194,482,지루함/Noun,707,100,607,0.0011337112370790265,0.006763810835425043,0.8585572842998586
195,483,추억/Noun,707,576,131,0.006424363676781149,0.0014771540904951245,0.8147100424328148
196,486,소리/Noun,705,202,503,0.0022674224741580525,0.005608742975188254,0.7134751773049646
197,489,이딴/Modifier,703,26,677,0.00031121484939424253,0.007541260356738266,0.9630156472261736
198,490,더럽다/Adjective,701,81,620,0.0009225297321329332,0.00690819431795464,0.8844507845934381
199,493,마다/Josa,694,480,214,0.005357341336000889,0.0023989870943379463,0.69164265129683
200,495,인상/Noun,689,547,142,0.006102034011337114,0.0015993247295586306,0.7939042089985486
201,497,어이없다/Adjective,686,55,631,0.0006335445148382794,0.007030364957018148,0.9198250728862972
202,498,오늘/Noun,685,462,223,0.005157274647104589,0.002498944889935361,0.6744525547445256
203,499,감정/Noun,684,445,239,0.004968322774258086,0.0026766476376640968,0.6505847953216374
204,501,부족하다/Adjective,681,215,466,0.00241191508280538,0.0051978053710655505,0.6842878120411159
205,503,전/Modifier,680,199,481,0.0022340780260086696,0.005364401697061241,0.7073529411764706
206,504,정신/Noun,678,183,495,0.0020562409692119594,0.0055198916013238855,0.7300884955752213
207,507,접/Noun,676,122,554,0.0013782371901745027,0.006175170483573602,0.8195266272189349
208,509,잊다/Verb,674,570,104,0.0063576747804823825,0.001177280703702881,0.8456973293768546
209,510,졸작/Noun,672,34,638,0.0004001333777925976,0.007108109909149471,0.949404761904762
210,511,제발/Noun,671,179,492,0.002011781705012782,0.005486572336124747,0.7332339791356185
211,514,아무리/Adverb,666,114,552,0.0012893186617761474,0.00615295764010751,0.8288288288288288
212,515,그저/Adverb,666,221,445,0.002478603979104145,0.004964570514671583,0.6681681681681682
213,517,♥/Foreign,660,651,9,0.007257974880515727,0.00012217063906350652,0.9863636363636364
214,519,킬링타임/Noun,659,186,473,0.0020895854173613427,0.0052755503231968716,0.7177541729893778
215,521,함께/Adverb,656,544,112,0.0060686895631877295,0.0012661320775672494,0.8292682926829268
216,525,캐스팅/Noun,653,219,434,0.002456374347004557,0.0048423998756080755,0.664624808575804
217,527,대해/Noun,651,506,145,0.005646326553295543,0.001632643994757769,0.7772657450076805
218,529,어색하다/Adjective,642,123,519,0.001389352006224297,0.0057864457229169905,0.8084112149532711
219,530,포스터/Noun,642,205,437,0.002300766922307436,0.0048757191408072146,0.6806853582554517
220,531,적다/Verb,641,432,209,0.00482383016561076,0.002343454985672716,0.6739469578783152
221,534,엉/Exclamation,636,103,533,0.0011670556852284096,0.005941935627179635,0.8380503144654088
222,535,쓸다/Verb,636,162,474,0.0018228298321662773,0.005286656744929919,0.7452830188679245
223,536,자/Suffix,632,213,419,0.002389685450705791,0.004675803549612386,0.6629746835443038
224,537,갈수록/Noun,631,192,439,0.002156274313660109,0.004897931984273306,0.6957210776545166
225,539,개연/Noun,630,55,575,0.0006335445148382794,0.00640840533996757,0.9126984126984128
226,540,망하다/Adjective,630,89,541,0.0010114482605312882,0.0060307870010440036,0.8587301587301587
227,541,애니메이션/Noun,630,418,212,0.004668222740913638,0.002376774250871854,0.6634920634920635
228,546,!!!!/Punctuation,622,460,162,0.005135045015005002,0.001821453164219552,0.7395498392282959
229,549,문제/Noun,619,201,418,0.002256307658108259,0.00466469712787934,0.6752827140549273
230,550,진부하다/Adjective,618,109,509,0.0012337445815271755,0.005675381505586529,0.8236245954692557
231,554,하/Exclamation,614,213,401,0.002389685450705791,0.004475887958417557,0.6530944625407166
232,555,ㅠㅠㅠ/KoreanParticle,611,496,115,0.005535178392797599,0.0012994513427663874,0.8117839607201309
233,557,나가다/Verb,610,191,419,0.0021451594976103147,0.004675803549612386,0.6868852459016394
234,558,충격/Noun,610,399,211,0.004457041235967545,0.0023656678291388076,0.6540983606557377
235,562,유쾌하다/Adjective,603,554,49,0.006179837723685673,0.0005664275083853486,0.9187396351575456
236,566,완벽하다/Adjective,599,512,87,0.00571301544959431,0.0009884715342410985,0.8547579298831386
237,567,질/Noun,599,104,495,0.001178170501278204,0.0055198916013238855,0.8263772954924875
238,575,적/Noun,593,406,187,0.004534844948316105,0.002099113707545703,0.684654300168634
239,578,강추/Noun,590,547,43,0.006102034011337114,0.0004997889779870722,0.9271186440677966
240,579,행복하다/Adjective,590,524,66,0.0058463932421918404,0.0007552366778471312,0.8881355932203391
241,583,장르/Noun,583,201,382,0.002256307658108259,0.004264865945489682,0.6552315608919382
242,585,더빙/Noun,582,150,432,0.0016894520395687453,0.004820187032141985,0.7422680412371134
243,590,얼굴/Noun,576,199,377,0.0022340780260086696,0.004209333836824453,0.6545138888888888
244,593,즐겁다/Adjective,573,495,78,0.005524063576747805,0.0008885137386436838,0.8638743455497382
245,597,머/Noun,570,97,473,0.0011003667889296432,0.0052755503231968716,0.8298245614035088
246,601,꽤/Noun,562,441,121,0.00492386351005891,0.001366089873164664,0.7846975088967971
247,603,짜증/Noun,558,23,535,0.00027787040124485944,0.005964148470645727,0.9587813620071683
248,604,9/Number,557,382,175,0.00426808936312104,0.00196583664674915,0.6858168761220825
249,606,ㅡ/KoreanParticle,556,157,399,0.0017672557519173055,0.004453675114951465,0.7176258992805755
250,608,ㅎㅎㅎ/KoreanParticle,555,434,121,0.004846059797710348,0.001366089873164664,0.781981981981982
251,610,너무나/Adverb,552,365,187,0.004079137490274536,0.002099113707545703,0.6612318840579711
252,614,???/Punctuation,551,142,409,0.0016005335111703902,0.004564739332281925,0.7422867513611615
253,615,두/Noun,551,362,189,0.004045793042125153,0.002121326551011795,0.6569872958257713
254,617,새롭다/Adjective,549,377,172,0.004212515282872069,0.0019325173815500122,0.6867030965391621
255,619,건가/Noun,546,124,422,0.0014004668222740914,0.004709122814811524,0.7728937728937729
256,620,아직/Adverb,546,363,183,0.004056907858174947,0.0020546880206135185,0.6648351648351648
257,621,생기다/Verb,545,190,355,0.00213404468156052,0.003964992558697439,0.6513761467889908
258,624,멀다/Adjective,544,178,366,0.0020006668889629878,0.004087163197760945,0.6727941176470589
259,625,작/Modifier,544,183,361,0.0020562409692119594,0.004031631089095715,0.6636029411764706
260,626,소름/Noun,540,437,103,0.004879404245859731,0.001166174281969835,0.8092592592592592
261,627,심하다/Adjective,539,81,458,0.0009225297321329332,0.005108953997201182,0.8497217068645642
262,628,충분하다/Adjective,539,414,125,0.004623763476714461,0.001410515560096848,0.7680890538033395
263,632,걸작/Noun,533,459,74,0.005123930198955207,0.0008440880517114996,0.8611632270168855
264,633,그나마/Adverb,532,40,492,0.0004668222740913638,0.005486572336124747,0.924812030075188
265,634,억지/Noun,527,72,455,0.0008224963876847838,0.005075634732002044,0.8633776091081594
266,635,대체/Noun,527,89,438,0.0010114482605312882,0.004886825562540261,0.8311195445920304
267,638,시절/Noun,526,397,129,0.004434811603867956,0.0014549412470290322,0.7547528517110266
268,640,존나/Noun,525,122,403,0.0013782371901745027,0.004498100801883649,0.7676190476190476
269,641,약간/Noun,525,357,168,0.003990218961876181,0.001888091694617828,0.68
270,650,해도/Noun,520,170,350,0.0019117483605646328,0.003909460450032209,0.6730769230769231
271,651,아무/Modifier,518,169,349,0.0019006335445148387,0.0038983540282991626,0.6737451737451737
272,654,B/Alpha,514,133,381,0.001500500166722241,0.004253759523756636,0.7412451361867705
273,655,한마디/Noun,514,156,358,0.0017561409358675113,0.003998311823896578,0.6964980544747081
274,659,순수하다/Adjective,506,433,73,0.004834944981660554,0.0008329816299784535,0.8557312252964426
275,660,휴/Exclamation,506,86,420,0.0009781038123819054,0.004686909971345432,0.8300395256916996
276,661,자기/Noun,506,160,346,0.001800600200066689,0.0038650347631000244,0.6837944664031621
277,670,만점/Noun,501,423,78,0.00472379682116261,0.0008885137386436838,0.844311377245509
278,675,간만/Noun,496,400,96,0.004468156052017339,0.0010884293298385123,0.8064516129032258
279,679,필요하다/Adjective,494,325,169,0.003634544848282761,0.0018991981163508738,0.6578947368421053
280,683,라도/Josa,488,145,343,0.0016338779593197733,0.0038317154979008857,0.7028688524590164
281,684,~!/Punctuation,487,385,102,0.0043014338112704244,0.001155067860236789,0.7905544147843943
282,685,CG/Alpha,487,126,361,0.0014226964543736804,0.004031631089095715,0.7412731006160165
283,686,굉장하다/Adjective,486,338,148,0.0037790374569300882,0.001665963259956907,0.6954732510288066
284,687,전체/Noun,486,158,328,0.0017783705679671,0.003665119171905196,0.6748971193415638
285,690,뿐/Suffix,482,150,332,0.0016894520395687453,0.0037095448588373796,0.6887966804979253
286,693,사회/Noun,481,337,144,0.003767922640880293,0.0016215375730247227,0.7006237006237006
287,697,발연기/Noun,477,34,443,0.0004001333777925976,0.004942357671205491,0.9287211740041929
288,698,무슨/Modifier,476,124,352,0.0014004668222740914,0.0039316732934983,0.7394957983193278
289,707,ㅉㅉ/KoreanParticle,466,72,394,0.0008224963876847838,0.004398143006286235,0.8454935622317596
290,710,꿈/Noun,465,353,112,0.003945759697677003,0.0012661320775672494,0.7591397849462366
291,711,돌리다/Verb,463,161,302,0.0018117150161164836,0.0033763522068459982,0.652267818574514
292,714,에요/Josa,461,357,104,0.003990218961876181,0.001177280703702881,0.7744034707158352
293,715,나이/Noun,460,314,146,0.0035122818717350226,0.001643750416490815,0.6826086956521739
294,718,이/Foreign,458,326,132,0.0036456596643325546,0.0014882605122281704,0.7117903930131004
295,722,;;;/Punctuation,457,106,351,0.0012004001333777929,0.003920566871765255,0.7680525164113785
296,723,사랑스럽다/Adjective,456,433,23,0.004834944981660554,0.00027766054332615115,0.949561403508772
297,724,돋다/Verb,454,348,106,0.003890185617428032,0.0011994935471689732,0.7665198237885462
298,730,이라도/Josa,446,106,340,0.0012004001333777929,0.0037983962327017475,0.7623318385650224
299,732,감사하다/Verb,445,404,41,0.004512615316216518,0.00047757613452098,0.907865168539326
300,736,시즌/Noun,442,315,127,0.003523396687784817,0.00143272840356294,0.7126696832579186
301,741,방송/Noun,436,131,305,0.001478270534622652,0.0034096714720451365,0.6995412844036697
302,742,지나다/Verb,435,309,126,0.003456707791486051,0.001421621981829894,0.7103448275862069
303,746,삼류/Noun,433,33,400,0.00038901856174280313,0.004464781536684511,0.9237875288683602
304,747,몇번/Noun,431,334,97,0.0037345781927309103,0.0010995357515715587,0.7749419953596288
305,748,진정하다/Adjective,431,313,118,0.0035011670556852285,0.0013327706079655256,0.7262180974477959
306,751,독특하다/Adjective,429,293,136,0.003278870734689341,0.0015326861991603546,0.6829836829836831
307,752,잡다/Verb,429,149,280,0.0016783372235189508,0.003132010928718985,0.6526806526806527
308,753,죽/Noun,428,138,290,0.0015560742469712125,0.0032430751460494453,0.677570093457944
309,758,여주/Noun,424,130,294,0.0014671557185728574,0.00328750083298163,0.6933962264150944
310,759,담다/Verb,424,278,146,0.003112148493942425,0.001643750416490815,0.6556603773584906
311,760,가볍다/Adjective,423,287,136,0.0032121818383905746,0.0015326861991603546,0.6784869976359338
312,762,질질/Noun,419,72,347,0.0008224963876847838,0.0038761411848330703,0.8281622911694511
313,763,전부/Noun,418,133,285,0.001500500166722241,0.003187543037384216,0.6818181818181818
314,765,줄거리/Noun,417,136,281,0.0015338446148716238,0.0031431173504520315,0.6738609112709832
315,770,점주/Noun,415,98,317,0.0011114816049794377,0.003542948532841689,0.763855421686747
316,773,망치다/Verb,414,42,372,0.0004890519061909527,0.004153801728159222,0.8985507246376812
317,774,답/Noun,413,100,313,0.0011337112370790265,0.003498522845909505,0.7578692493946732
318,775,넘치다/Adjective,412,298,114,0.003334444814938313,0.0012883449210333415,0.7233009708737864
319,777,성하다/Adjective,410,37,373,0.0004334778259419807,0.004164908149892268,0.9097560975609756
320,779,낭비/Noun,408,8,400,0.00011114816049794375,0.004464781536684511,0.9803921568627452
321,783,각본/Noun,407,121,286,0.0013671223741247086,0.003198649459117261,0.7027027027027027
322,785,맞추다/Verb,404,109,295,0.0012337445815271755,0.0032986072547146763,0.7301980198019802
323,791,순간/Noun,397,263,134,0.0029454262531955103,0.0015104733556942625,0.6624685138539043
324,794,갑자기/Noun,396,103,293,0.0011670556852284096,0.003276394411248584,0.73989898989899
325,797,이하/Noun,395,34,361,0.0004001333777925976,0.004031631089095715,0.9139240506329114
326,800,기다리다/Verb,392,279,113,0.00312326330999222,0.0012772384993002955,0.7117346938775511
327,802,너무하다/Adjective,390,50,340,0.0005779704345893076,0.0037983962327017475,0.8717948717948718
328,803,의도/Noun,390,66,324,0.0007558074913860174,0.003620693484973011,0.8307692307692308
329,804,발/Noun,390,81,309,0.0009225297321329332,0.003454097158977321,0.7923076923076923
330,805,영/Noun,390,107,283,0.001211514949427587,0.0031653301939181234,0.7256410256410256
331,807,밑/Noun,388,119,269,0.0013448927420251196,0.0030098402896554786,0.6932989690721649
332,809,땜/Noun,387,126,261,0.0014226964543736804,0.0029209889157911107,0.6744186046511628
333,810,넣다/Verb,385,86,299,0.0009781038123819054,0.00334303294164686,0.7766233766233767
334,811,아버지/Noun,385,261,124,0.002923196621095921,0.0013994091383638019,0.6779220779220779
335,815,오글거리다/Verb,384,63,321,0.0007224630432366343,0.0035873742197738727,0.8359375
336,816,보내다/Verb,384,257,127,0.0028787373568967428,0.00143272840356294,0.6692708333333334
337,821,굳다/Adjective,381,349,32,0.0039013004334778256,0.0003776183389235656,0.9160104986876642
338,824,볼때/Noun,380,276,104,0.0030899188618428363,0.001177280703702881,0.7263157894736842
339,830,10년/Number,376,276,100,0.0030899188618428363,0.0011328550167706971,0.7340425531914894
340,834,첨/Adverb,374,111,263,0.0012559742136267645,0.002943201759257202,0.7032085561497327
341,839,그때/Noun,371,269,102,0.003012115149494276,0.001155067860236789,0.7250673854447439
342,840,항상/Noun,371,247,124,0.0027675891963988,0.0013994091383638019,0.6657681940700808
343,842,좀비/Noun,370,127,243,0.0014338112704234743,0.0027210733245962818,0.6567567567567567
344,844,치고/Josa,368,112,256,0.0012670890296765588,0.00286545680712588,0.6956521739130435
345,846,뻔/Noun,367,98,269,0.0011114816049794377,0.0030098402896554786,0.7329700272479565
346,849,거지/Noun,366,99,267,0.001122596421029232,0.002987627446189387,0.7295081967213115
347,850,곳/Noun,365,245,120,0.002745359564299211,0.0013549834514316175,0.6712328767123288
348,855,짱/Suffix,361,320,41,0.0035789707680337892,0.00047757613452098,0.8864265927977839
349,857,진행/Noun,360,97,263,0.0011003667889296432,0.002943201759257202,0.7305555555555555
350,862,이에요/Josa,358,286,72,0.0032010670223407804,0.0008218752082454075,0.7988826815642458
351,863,더욱/Noun,358,281,77,0.0031454929420918084,0.0008774073169106378,0.7849162011173184
352,864,tv/Alpha,358,103,255,0.0011670556852284096,0.0028543503853928343,0.7122905027932961
353,865,낫다/Noun,358,124,234,0.0014004668222740914,0.002621115528998867,0.6536312849162011
354,866,탄탄하다/Adjective,357,320,37,0.0035789707680337892,0.0004331504475887958,0.8963585434173671
355,867,돋보이다/Verb,357,275,82,0.003078804045793042,0.000932939425575868,0.7703081232492998
356,870,어이/Noun,355,29,326,0.0003445592975436257,0.003642906328439104,0.9183098591549296
357,871,상미/Noun,355,237,118,0.002656441035900856,0.0013327706079655256,0.6676056338028169
358,874,참고/Noun,354,65,289,0.0007446926753362233,0.0032319687243164,0.8163841807909604
359,875,불편하다/Adjective,354,99,255,0.001122596421029232,0.0028543503853928343,0.7203389830508474
360,876,중국/Noun,354,122,232,0.0013782371901745027,0.002598902685532775,0.655367231638418
361,880,흐르다/Verb,352,282,70,0.003156607758141603,0.0007996623647793153,0.8011363636363636
362,881,그녀/Noun,352,266,86,0.002978770701344893,0.000977365112508052,0.7556818181818182
363,882,억지스럽다/Adjective,351,50,301,0.0005779704345893076,0.0033652457851129523,0.8575498575498576
364,883,걸리다/Verb,351,96,255,0.0010892519728798488,0.0028543503853928343,0.7264957264957265
365,884,끼다/Verb,351,101,250,0.0011448260531288204,0.0027988182767276037,0.7122507122507122
366,886,즐기다/Verb,350,239,111,0.002678670668000445,0.0012550256558342032,0.6828571428571428
367,890,거기/Noun,348,120,228,0.0013560075580749138,0.002554476998600591,0.6551724137931034
368,894,이냐/Josa,345,47,298,0.0005446259864399244,0.003331926519913814,0.8637681159420291
369,896,허무하다/Adjective,344,85,259,0.0009669889963321108,0.0028987760723250184,0.7529069767441859
370,899,술/Noun,342,58,284,0.0006668889629876625,0.0031764366156511693,0.8304093567251462
371,900,전형/Noun,342,64,278,0.0007335778592864287,0.003109798085252893,0.8128654970760234
372,901,똑같다/Adjective,341,86,255,0.0009781038123819054,0.0028543503853928343,0.7478005865102639
373,902,편집/Noun,340,103,237,0.0011670556852284096,0.002654434794198005,0.6970588235294117
374,904,잠/Noun,339,82,257,0.0009336445481827276,0.002876563228858926,0.7581120943952803
375,910,화이팅/Noun,334,296,38,0.0033122151828387236,0.0004442568693218419,0.8862275449101796
376,911,때리다/Verb,334,116,218,0.0013115482938757365,0.0024434127812701305,0.6526946107784432
377,915,식상하다/Adjective,333,37,296,0.0004334778259419807,0.0033097136764477218,0.8888888888888888
378,916,마르다/Adjective,333,116,217,0.0013115482938757365,0.0024323063595370845,0.6516516516516516
379,921,꿀잼/Noun,330,316,14,0.0035345115038346118,0.00017770274772873674,0.9575757575757576
380,922,똥/Noun,330,29,301,0.0003445592975436257,0.0033652457851129523,0.912121212121212
381,923,그게/Noun,330,91,239,0.001033677892630877,0.0026766476376640968,0.7242424242424242
382,931,-_-/Punctuation,327,38,289,0.000444592641991775,0.0032319687243164,0.8837920489296636
383,932,개그/Noun,327,99,228,0.001122596421029232,0.002554476998600591,0.6972477064220184
384,938,엉망/Noun,326,22,304,0.000266755585195065,0.0033985650503120905,0.9325153374233128
385,939,병맛/Noun,326,57,269,0.0006557741469378681,0.0030098402896554786,0.8251533742331288
386,940,티/Noun,325,91,234,0.001033677892630877,0.002621115528998867,0.72
387,941,적당하다/Adjective,325,106,219,0.0012004001333777929,0.0024545192030031764,0.6738461538461539
388,944,뛰어나다/Adjective,324,238,86,0.00266755585195065,0.000977365112508052,0.7345679012345679
389,945,관/Noun,324,221,103,0.002478603979104145,0.001166174281969835,0.6820987654320988
390,951,지겹다/Adjective,323,29,294,0.0003445592975436257,0.00328750083298163,0.9102167182662538
391,952,미화/Noun,323,44,279,0.0005112815382905413,0.003120904506985939,0.8637770897832817
392,953,~!!/Punctuation,323,253,70,0.0028342780926975657,0.0007996623647793153,0.7832817337461301
393,958,헐다/Verb,322,92,230,0.0010447927086806713,0.002576689842066683,0.7142857142857143
394,962,흥미진진/Noun,321,276,45,0.0030899188618428363,0.0005220018214531642,0.8598130841121495
395,967,훈훈하다/Adjective,319,281,38,0.0031454929420918084,0.0004442568693218419,0.8808777429467085
396,969,잘만/Noun,318,239,79,0.002678670668000445,0.0008996201603767299,0.7515723270440252
397,972,만으로도/Josa,316,285,31,0.003189952206290986,0.00036651191719051963,0.9018987341772152
398,973,낫다/Verb,316,91,225,0.001033677892630877,0.0025211577334014533,0.7120253164556962
399,974,나르다/Verb,316,224,92,0.002511948427253529,0.0010440036429063284,0.7088607594936709
400,976,비추다/Verb,315,48,267,0.0005557408024897189,0.002987627446189387,0.8476190476190476
401,977,괜히/Adverb,315,80,235,0.0009114149160831386,0.002632221950731913,0.7460317460317459
402,978,또한/Noun,315,208,107,0.002334111370456819,0.0012105999689020189,0.6603174603174603
403,982,그래픽/Noun,314,78,236,0.00088918528398355,0.0026433283724649594,0.7515923566878981
404,983,ost/Alpha,313,265,48,0.0029676558852950985,0.0005553210866523023,0.8466453674121406
405,984,그냥/Modifier,313,87,226,0.0009892186284316995,0.0025322641551344988,0.7220447284345048
406,987,그만/Adverb,312,21,291,0.00025564076914527065,0.003254181567782492,0.9326923076923076
407,988,장/Suffix,312,89,223,0.0010114482605312882,0.002498944889935361,0.7147435897435898
408,989,20/Number,312,211,101,0.002367455818606202,0.0011439614385037428,0.6762820512820513
409,990,바보/Noun,311,85,226,0.0009669889963321108,0.0025322641551344988,0.7266881028938906
410,991,성우/Noun,310,70,240,0.0008002667555851951,0.002687754059397144,0.7741935483870968
411,992,봣/Noun,308,207,101,0.0023229965544070245,0.0011439614385037428,0.6720779220779219
412,993,소중하다/Adjective,307,226,81,0.0025341780593531177,0.000921833003842822,0.7361563517915309
413,994,죽음/Noun,307,206,101,0.0023118817383572304,0.0011439614385037428,0.6710097719869706
414,997,유치/Noun,306,21,285,0.00025564076914527065,0.003187543037384216,0.931372549019608
415,999,도저히/Noun,305,26,279,0.00031121484939424253,0.003120904506985939,0.9147540983606556
416,1000,한심하다/Adjective,305,33,272,0.00038901856174280313,0.0030431595548546173,0.8918032786885246
417,1001,식/Noun,305,72,233,0.0008224963876847838,0.002610009107265821,0.7639344262295082
418,1002,속편/Noun,305,99,206,0.001122596421029232,0.002310135720473578,0.6754098360655738
419,1006,역겹다/Adjective,304,37,267,0.0004334778259419807,0.002987627446189387,0.8782894736842105
420,1007,울/Noun,304,228,76,0.002556407691452707,0.0008663008951775916,0.75
421,1016,천재/Noun,301,236,65,0.002645326219851061,0.0007441302561140852,0.7840531561461794
422,1018,억지로/Noun,300,42,258,0.0004890519061909527,0.0028876696505919725,0.86
423,1019,우연히/Adverb,300,258,42,0.0028898521729465373,0.0004886825562540262,0.86
424,1020,심리/Noun,300,207,93,0.0023229965544070245,0.0010551100646393743,0.69
425,1021,화가/Noun,299,75,224,0.0008558408358341669,0.0025100513116684065,0.7491638795986622
426,1023,댓글/Noun,297,75,222,0.0008558408358341669,0.0024878384682023146,0.7474747474747475
427,1026,속/Modifier,296,73,223,0.0008336112037345782,0.002498944889935361,0.7533783783783784
428,1029,개다/Verb,295,73,222,0.0008336112037345782,0.0024878384682023146,0.7525423728813561
429,1030,새끼/Noun,295,80,215,0.0009114149160831386,0.0024100935160709922,0.7288135593220338
430,1031,척/Noun,294,58,236,0.0006668889629876625,0.0026433283724649594,0.8027210884353742
431,1032,예고편/Noun,294,69,225,0.0007891519395354007,0.0025211577334014533,0.7653061224489796
432,1033,다가/Noun,293,91,202,0.001033677892630877,0.0022657100335413943,0.6894197952218429
433,1034,최근/Noun,293,195,98,0.002189618761809492,0.0011106421733046046,0.6655290102389079
434,1039,good/Alpha,291,213,78,0.002389685450705791,0.0008885137386436838,0.7319587628865979
435,1042,잊혀지다/Verb,289,255,34,0.002856507724797155,0.00039983118238965764,0.8823529411764706
436,1043,불륜/Noun,289,75,214,0.0008558408358341669,0.0023989870943379463,0.740484429065744
437,1044,젠/Noun,289,80,209,0.0009114149160831386,0.002343454985672716,0.7231833910034602
438,1046,대작/Noun,288,231,57,0.0025897521396020893,0.0006552788822497168,0.8020833333333334
439,1047,짐/Noun,288,189,99,0.002122929865510726,0.0011217485950376508,0.65625
440,1053,미안하다/Adjective,287,74,213,0.0008447260197843727,0.0023878806726049,0.7421602787456446
441,1056,열/Noun,286,78,208,0.00088918528398355,0.00233234856393967,0.7272727272727273
442,1059,2시간/Number,285,95,190,0.0010781371568300542,0.002132432972744841,0.6666666666666666
443,1064,게임/Noun,284,97,187,0.0011003667889296432,0.002099113707545703,0.6584507042253521
444,1068,실망하다/Adjective,283,60,223,0.0006891185950872514,0.002498944889935361,0.7879858657243817
445,1069,짓/Noun,283,70,213,0.0008002667555851951,0.0023878806726049,0.7526501766784452
446,1070,환상/Noun,283,207,76,0.0023229965544070245,0.0008663008951775916,0.7314487632508834
447,1073,오래/Adverb,282,230,52,0.0025786373235522947,0.0005997467735844866,0.8156028368794326
448,1077,그닥/Noun,280,25,255,0.00030010003334444816,0.0028543503853928343,0.9107142857142856
449,1078,귀신/Noun,280,71,209,0.0008113815716349895,0.002343454985672716,0.7464285714285714
450,1082,산/Noun,279,67,212,0.0007669223074358119,0.002376774250871854,0.7598566308243727
451,1083,총/Modifier,279,87,192,0.0009892186284316995,0.0021546458162109328,0.6881720430107527
452,1085,빠져들다/Verb,278,264,14,0.002956541069245304,0.00017770274772873674,0.9496402877697842
453,1086,흘리다/Verb,278,211,67,0.002367455818606202,0.0007663430995801773,0.7589928057553957
454,1087,전작/Noun,277,72,205,0.0008224963876847838,0.002299029298740532,0.740072202166065
455,1088,총/Noun,277,85,192,0.0009669889963321108,0.0021546458162109328,0.6931407942238267
456,1090,♡/Foreign,276,264,12,0.002956541069245304,0.00015548990426264466,0.9565217391304348
457,1092,현재/Noun,275,205,70,0.002300766922307436,0.0007996623647793153,0.7454545454545455
458,1096,쩔다/Verb,274,216,58,0.002423029898855174,0.0006663853039827628,0.7883211678832117
459,1097,여전하다/Adjective,274,191,83,0.0021451594976103147,0.000944045847308914,0.6970802919708029
460,1099,제작비/Noun,273,38,235,0.000444592641991775,0.002632221950731913,0.8608058608058609
461,1100,영원하다/Adjective,273,231,42,0.0025897521396020893,0.0004886825562540262,0.8461538461538461
462,1101,예요/Josa,273,206,67,0.0023118817383572304,0.0007663430995801773,0.7545787545787546
463,1102,스러운/Josa,273,89,184,0.0010114482605312882,0.002065794442346565,0.6739926739926739
464,1106,통해/Noun,271,217,54,0.0024341447149049678,0.0006219596170505788,0.8007380073800738
465,1107,잘생기다/Adjective,271,198,73,0.002222963209958875,0.0008329816299784535,0.7306273062730627
466,1114,망작/Noun,268,16,252,0.0002000666888962988,0.002821031120193696,0.9402985074626866
467,1118,가끔/Noun,267,174,93,0.0019562076247638107,0.0010551100646393743,0.651685393258427
468,1120,드럽다/Adjective,266,24,242,0.0002889852172946538,0.0027099669028632354,0.9097744360902256
469,1121,동화/Noun,266,189,77,0.002122929865510726,0.0008774073169106378,0.7105263157894737
470,1122,80년/Number,266,82,184,0.0009336445481827276,0.002065794442346565,0.6917293233082706
471,1130,예산/Noun,264,65,199,0.0007446926753362233,0.002232390768342256,0.7537878787878788
472,1136,채널/Noun,262,82,180,0.0009336445481827276,0.0020213687554143807,0.6870229007633588
473,1138,멍청하다/Adjective,260,38,222,0.000444592641991775,0.0024878384682023146,0.8538461538461538
474,1139,강/Noun,260,197,63,0.002211848393909081,0.0007219174126479931,0.7576923076923077
475,1147,졸라/Noun,258,75,183,0.0008558408358341669,0.0020546880206135185,0.7093023255813954
476,1150,개/Suffix,257,79,178,0.0009003001000333445,0.001999155911948289,0.6926070038910506
477,1157,외/Noun,256,70,186,0.0008002667555851951,0.0020880072858126568,0.7265625
478,1161,낚/Noun,254,20,234,0.00024452595309547634,0.002621115528998867,0.9212598425196852
479,1164,모/Noun,253,66,187,0.0007558074913860174,0.002099113707545703,0.7391304347826086
480,1167,끌다/Verb,252,68,184,0.0007780371234856063,0.002065794442346565,0.7301587301587301
481,1169,반개/Noun,251,5,246,7.780371234856063e-05,0.00275439258979542,0.9800796812749004
482,1170,짱/VerbPrefix,251,225,26,0.0025230632433033235,0.00031097980852528933,0.896414342629482
483,1171,지루/Noun,250,21,229,0.00025564076914527065,0.002565583420333637,0.9159999999999999
484,1173,황당하다/Adjective,249,38,211,0.000444592641991775,0.0023656678291388076,0.8473895582329317
485,1176,약하다/Adjective,248,71,177,0.0008113815716349895,0.0019880494902152425,0.7137096774193549
486,1181,졸리다/Verb,247,27,220,0.00032232966544403684,0.0024656256247362228,0.8906882591093117
487,1182,용도/Noun,247,57,190,0.0006557741469378681,0.002132432972744841,0.7692307692307693
488,1183,희망/Noun,246,210,36,0.002356341002556408,0.0004220440258557498,0.8536585365853658
489,1186,위대하다/Adjective,245,185,60,0.002078470601311548,0.0006885981474488549,0.7551020408163265
490,1187,청춘/Noun,245,172,73,0.0019339779926642211,0.0008329816299784535,0.7020408163265306
491,1188,......./Punctuation,245,81,164,0.0009225297321329332,0.001843666007685644,0.6693877551020408
492,1189,다만/Noun,245,160,85,0.001800600200066689,0.0009662586907750061,0.6530612244897959
493,1193,깊이/Noun,244,172,72,0.0019339779926642211,0.0008218752082454075,0.7049180327868853
494,1199,cg/Alpha,243,62,181,0.0007113482271868402,0.0020324751771474267,0.7448559670781894
495,1202,기세/Noun,242,7,235,0.0001000333444481494,0.002632221950731913,0.9710743801652892
496,1213,노출/Noun,240,57,183,0.0006557741469378681,0.0020546880206135185,0.7625
497,1214,다시다/Verb,240,72,168,0.0008224963876847838,0.001888091694617828,0.7
498,1215,카메라/Noun,240,73,167,0.0008336112037345782,0.0018769852728847821,0.6958333333333333
499,1216,살아가다/Verb,239,217,22,0.0024341447149049678,0.00026655412159310506,0.9079497907949792
500,1217,미래/Noun,239,164,75,0.0018450594642658664,0.0008551944734445456,0.6861924686192469
501,1220,쏘다/Verb,238,76,162,0.0008669556518839612,0.001821453164219552,0.6806722689075629
502,1224,대안/Noun,237,199,38,0.0022340780260086696,0.0004442568693218419,0.8396624472573839
503,1226,산만하다/Adjective,236,19,217,0.0002334111370456819,0.0024323063595370845,0.9194915254237288
504,1227,능력/Noun,236,81,155,0.0009225297321329332,0.0017437082120882294,0.6567796610169492
505,1228,미소/Noun,235,212,23,0.002378570634655997,0.00027766054332615115,0.9021276595744679
506,1229,결론/Noun,235,63,172,0.0007224630432366343,0.0019325173815500122,0.7319148936170212
507,1233,설레다/Adjective,234,212,22,0.002378570634655997,0.00026655412159310506,0.9059829059829059
508,1234,독립영화/Noun,234,75,159,0.0008558408358341669,0.0017881338990204136,0.6794871794871795
509,1236,OST/Alpha,233,191,42,0.0021451594976103147,0.0004886825562540262,0.8197424892703863
510,1242,지나치다/Verb,230,55,175,0.0006335445148382794,0.00196583664674915,0.7608695652173914
511,1243,리얼/Noun,230,156,74,0.0017561409358675113,0.0008440880517114996,0.6782608695652174
512,1247,젊다/Adjective,229,158,71,0.0017783705679671,0.0008107687865123613,0.6899563318777293
513,1249,왠만하다/Adjective,228,20,208,0.00024452595309547634,0.00233234856393967,0.912280701754386
514,1250,멋/Noun,228,174,54,0.0019562076247638107,0.0006219596170505788,0.7631578947368421
515,1251,범인/Noun,228,62,166,0.0007113482271868402,0.001865878851151736,0.7280701754385965
516,1252,되게/Adverb,227,149,78,0.0016783372235189508,0.0008885137386436838,0.6563876651982379
517,1256,박수/Noun,226,151,75,0.0017005668556185395,0.0008551944734445456,0.668141592920354
518,1260,손발/Noun,225,22,203,0.000266755585195065,0.0022768164552744398,0.9022222222222224
519,1262,고맙다/Adjective,224,180,44,0.0020228965210625765,0.0005108953997201182,0.8035714285714286
520,1264,졸다/Verb,223,13,210,0.00016672224074691566,0.002354561407405762,0.9417040358744396
521,1265,굳이/Noun,223,45,178,0.0005223963543403357,0.001999155911948289,0.7982062780269058
522,1271,거지같다/Adjective,222,19,203,0.0002334111370456819,0.0022768164552744398,0.9144144144144144
523,1272,떠오르다/Verb,222,164,58,0.0018450594642658664,0.0006663853039827628,0.7387387387387387
524,1273,밤/Noun,222,158,64,0.0017783705679671,0.0007330238343810393,0.7117117117117117
525,1277,별루/Noun,220,12,208,0.00015560742469712126,0.00233234856393967,0.9454545454545454
526,1278,슬픔/Noun,220,192,28,0.002156274313660109,0.0003331926519913814,0.8727272727272727
527,1279,용이/Noun,220,69,151,0.0007891519395354007,0.0016992825251560453,0.6863636363636364
528,1284,포장/Noun,219,20,199,0.00024452595309547634,0.002232390768342256,0.9086757990867579
529,1285,주기/Noun,219,40,179,0.0004668222740913638,0.0020102623336813344,0.817351598173516
530,1286,시도/Noun,219,57,162,0.0006557741469378681,0.001821453164219552,0.7397260273972602
531,1287,ㅅㅂ/KoreanParticle,218,20,198,0.00024452595309547634,0.002221284346609209,0.908256880733945
532,1288,아침/Noun,218,56,162,0.0006446593308880737,0.001821453164219552,0.7431192660550459
533,1297,광고/Noun,216,47,169,0.0005446259864399244,0.0018991981163508738,0.7824074074074074
534,1300,짱/Modifier,215,181,34,0.00203401133711237,0.00039983118238965764,0.8418604651162791
535,1301,진실/Noun,215,142,73,0.0016005335111703902,0.0008329816299784535,0.6604651162790698
536,1305,암/Noun,214,59,155,0.0006780037790374569,0.0017437082120882294,0.7242990654205608
537,1309,눈물나다/Verb,213,183,30,0.0020562409692119594,0.0003554054954574735,0.8591549295774648
538,1312,성도/Noun,212,25,187,0.00030010003334444816,0.002099113707545703,0.8820754716981132
539,1313,한계/Noun,212,38,174,0.000444592641991775,0.0019547302250161047,0.8207547169811321
540,1314,그럭저럭/Adverb,212,52,160,0.0006002000666888963,0.0017992403207534593,0.7547169811320755
541,1315,전/Foreign,212,157,55,0.0017672557519173055,0.0006330660387836247,0.7405660377358491
542,1316,조차/Josa,212,56,156,0.0006446593308880737,0.0017548146338212756,0.7358490566037735
543,1317,챙기다/Verb,212,145,67,0.0016338779593197733,0.0007663430995801773,0.6839622641509434
544,1318,심/Noun,212,73,139,0.0008336112037345782,0.0015660054643594926,0.6556603773584906
545,1323,~^^/Punctuation,211,202,9,0.0022674224741580525,0.00012217063906350652,0.957345971563981
546,1324,진정/Noun,211,146,65,0.0016449927753695677,0.0007441302561140852,0.6919431279620853
547,1329,깔끔하다/Adjective,210,167,43,0.0018784039124152493,0.0004997889779870722,0.7952380952380952
548,1330,살짝/Noun,210,140,70,0.0015783038790708015,0.0007996623647793153,0.6666666666666666
549,1333,발견/Noun,209,175,34,0.001967322440813605,0.00039983118238965764,0.8373205741626795
550,1339,개도/Noun,208,25,183,0.00030010003334444816,0.0020546880206135185,0.8798076923076923
551,1340,쩐다/Noun,208,145,63,0.0016338779593197733,0.0007219174126479931,0.6971153846153846
552,1341,범죄/Noun,208,72,136,0.0008224963876847838,0.0015326861991603546,0.6538461538461539
553,1344,짱짱/Noun,207,199,8,0.0022340780260086696,0.00011106421733046048,0.961352657004831
554,1345,부족/Noun,207,29,178,0.0003445592975436257,0.001999155911948289,0.8599033816425121
555,1346,지난/Noun,207,159,48,0.0017894853840168946,0.0005553210866523023,0.7681159420289855
556,1347,20년/Number,207,142,65,0.0016005335111703902,0.0007441302561140852,0.6859903381642513
557,1348,야/Exclamation,207,66,141,0.0007558074913860174,0.0015882183078255846,0.6811594202898551
558,1352,대충/Noun,206,37,169,0.0004334778259419807,0.0018991981163508738,0.8203883495145631
559,1353,영환/Noun,206,64,142,0.0007335778592864287,0.0015993247295586306,0.6893203883495146
560,1360,감탄/Noun,205,177,28,0.001989552072913193,0.0003331926519913814,0.8634146341463415
561,1361,빨/Noun,205,54,151,0.0006224296987884852,0.0016992825251560453,0.7365853658536585
562,1362,자연/Noun,205,142,63,0.0016005335111703902,0.0007219174126479931,0.6926829268292682
563,1363,커플/Noun,205,141,64,0.0015894186951205956,0.0007330238343810393,0.6878048780487804
564,1364,시선/Noun,205,141,64,0.0015894186951205956,0.0007330238343810393,0.6878048780487804
565,1367,시청자/Noun,204,41,163,0.0004779370901411582,0.0018325595859525977,0.7990196078431373
566,1368,홍보/Noun,204,43,161,0.0005001667222407468,0.0018103467424865054,0.7892156862745098
567,1369,담기다/Verb,204,160,44,0.001800600200066689,0.0005108953997201182,0.7843137254901961
568,1370,몸매/Noun,204,67,137,0.0007669223074358119,0.0015437926208934005,0.6715686274509803
569,1375,아오/Exclamation,203,29,174,0.0003445592975436257,0.0019547302250161047,0.8571428571428571
570,1378,울리다/Verb,202,175,27,0.001967322440813605,0.00032208623025833537,0.8663366336633663
571,1379,지르다/Verb,202,42,160,0.0004890519061909527,0.0017992403207534593,0.7920792079207921
572,1380,소름끼치다/Verb,202,155,47,0.001745026119817717,0.0005442146649192564,0.7673267326732673
573,1383,일상/Noun,201,154,47,0.0017339113037679224,0.0005442146649192564,0.7661691542288557
574,1384,포기/Noun,201,56,145,0.0006446593308880737,0.001632643994757769,0.7213930348258707
575,1388,접다/Verb,199,22,177,0.000266755585195065,0.0019880494902152425,0.8894472361809045
576,1389,30분/Number,199,51,148,0.000589085250639102,0.001665963259956907,0.7437185929648241
577,1390,에서의/Josa,199,143,56,0.0016116483272201846,0.0006441724605166707,0.7185929648241206
578,1393,이따위/Modifier,198,8,190,0.00011114816049794375,0.002132432972744841,0.9595959595959596
579,1394,눈빛/Noun,198,175,23,0.001967322440813605,0.00027766054332615115,0.8838383838383839
580,1395,10분/Number,198,36,162,0.00042236300989218633,0.001821453164219552,0.8181818181818182
581,1396,보라/Noun,198,64,134,0.0007335778592864287,0.0015104733556942625,0.6767676767676768
582,1401,말로/Noun,197,140,57,0.0015783038790708015,0.0006552788822497168,0.7106598984771574
583,1404,뜬금/Noun,196,17,179,0.00021118150494609317,0.0020102623336813344,0.9132653061224488
584,1405,핵/Noun,196,37,159,0.0004334778259419807,0.0017881338990204136,0.8112244897959183
585,1406,상처/Noun,196,143,53,0.0016116483272201846,0.0006108531953175326,0.7295918367346939
586,1407,실감/Noun,196,128,68,0.0014449260864732687,0.0007774495213132232,0.6530612244897959
587,1414,끌/Noun,195,22,173,0.000266755585195065,0.0019436238032830586,0.8871794871794871
588,1415,힐링/Noun,195,171,24,0.001922863176614427,0.0002887669650591972,0.8769230769230769
589,1416,혹시/Noun,195,48,147,0.0005557408024897189,0.0016548568382238609,0.7538461538461538
590,1417,막판/Noun,195,58,137,0.0006668889629876625,0.0015437926208934005,0.7025641025641025
591,1418,빛/Noun,195,127,68,0.0014338112704234743,0.0007774495213132232,0.6512820512820513
592,1421,무겁다/Adjective,194,158,36,0.0017783705679671,0.0004220440258557498,0.8144329896907216
593,1422,우정/Noun,194,143,51,0.0016116483272201846,0.0005886403518514405,0.7371134020618557
594,1423,해피엔딩/Noun,194,138,56,0.0015560742469712125,0.0006441724605166707,0.711340206185567
595,1424,죄/Noun,194,67,127,0.0007669223074358119,0.00143272840356294,0.6546391752577321
596,1430,참다/Verb,193,36,157,0.00042236300989218633,0.0017659210555543215,0.8134715025906736
597,1437,몰다/Verb,192,64,128,0.0007335778592864287,0.0014438348252959862,0.6666666666666666
598,1439,아련하다/Adjective,191,184,7,0.002067355785261754,9.995779559741441e-05,0.9633507853403142
599,1440,보아/Noun,191,134,57,0.0015116149827720349,0.0006552788822497168,0.7015706806282722
600,1441,게다가/Noun,191,58,133,0.0006668889629876625,0.0014993669339612163,0.6963350785340314
601,1444,개판/Noun,190,8,182,0.00011114816049794375,0.0020435815988804726,0.9578947368421052
602,1445,뭐임/Noun,190,15,175,0.00018895187284650438,0.00196583664674915,0.9210526315789472
603,1446,나머지/Noun,190,38,152,0.000444592641991775,0.0017103889468890912,0.8
604,1447,벌써/Noun,190,146,44,0.0016449927753695677,0.0005108953997201182,0.7684210526315789
605,1448,조폭/Noun,190,58,132,0.0006668889629876625,0.0014882605122281704,0.6947368421052632
606,1453,소장/Noun,189,173,16,0.001945092808714016,0.00019991559119482882,0.9153439153439152
607,1454,비극/Noun,189,143,46,0.0016116483272201846,0.0005331082431862101,0.7566137566137566
608,1455,까지는/Josa,189,51,138,0.000589085250639102,0.0015548990426264464,0.7301587301587301
609,1460,벗다/Verb,188,41,147,0.0004779370901411582,0.0016548568382238609,0.7819148936170213
610,1461,난해하다/Adjective,188,45,143,0.0005223963543403357,0.001610431151291677,0.7606382978723404
611,1462,섹스/Noun,188,51,137,0.000589085250639102,0.0015437926208934005,0.7287234042553191
612,1463,부끄럽다/Adjective,188,65,123,0.0007446926753362233,0.0013883027166307562,0.6542553191489362
613,1467,형편/Noun,187,18,169,0.0002222963209958875,0.0018991981163508738,0.9037433155080212
614,1468,본방/Noun,187,166,21,0.0018672890963654552,0.0002554476998600591,0.8877005347593583
615,1469,감명/Noun,187,164,23,0.0018450594642658664,0.00027766054332615115,0.8770053475935828
616,1473,펑펑/Noun,186,179,7,0.002011781705012782,9.995779559741441e-05,0.9623655913978496
617,1474,끝내다/Verb,186,63,123,0.0007224630432366343,0.0013883027166307562,0.6612903225806451
618,1482,그다지/Noun,185,18,167,0.0002222963209958875,0.0018769852728847821,0.9027027027027028
619,1483,토/Noun,185,44,141,0.0005112815382905413,0.0015882183078255846,0.7621621621621621
620,1484,떼다/Verb,185,140,45,0.0015783038790708015,0.0005220018214531642,0.7567567567567568
621,1485,인가요/Josa,185,57,128,0.0006557741469378681,0.0014438348252959862,0.6918918918918919
622,1486,결과/Noun,185,64,121,0.0007335778592864287,0.001366089873164664,0.6540540540540539
623,1487,불가/Noun,184,41,143,0.0004779370901411582,0.001610431151291677,0.7771739130434783
624,1488,자유/Noun,184,128,56,0.0014449260864732687,0.0006441724605166707,0.6956521739130435
625,1489,암튼/Adverb,184,123,61,0.001389352006224297,0.0006997045691819009,0.6684782608695652
626,1490,새벽/Noun,184,122,62,0.0013782371901745027,0.000710810990914947,0.6630434782608695
627,1491,꼴/Noun,183,23,160,0.00027787040124485944,0.0017992403207534593,0.8743169398907104
628,1492,표절/Noun,183,24,159,0.0002889852172946538,0.0017881338990204136,0.8688524590163934
629,1493,행복/Noun,183,153,30,0.0017227964877181282,0.0003554054954574735,0.8360655737704918
630,1494,딱하다/Adjective,183,31,152,0.00036678892964321435,0.0017103889468890912,0.8306010928961749
631,1495,지도/Noun,183,60,123,0.0006891185950872514,0.0013883027166307562,0.6721311475409836
632,1496,느와르/Noun,183,123,60,0.001389352006224297,0.0006885981474488549,0.6721311475409836
633,1498,글쎄/Noun,182,21,161,0.00025564076914527065,0.0018103467424865054,0.8846153846153846
634,1499,색다르다/Adjective,182,141,41,0.0015894186951205956,0.00047757613452098,0.7747252747252747
635,1500,기본/Noun,182,50,132,0.0005779704345893076,0.0014882605122281704,0.7252747252747253
636,1501,오버/Noun,182,51,131,0.000589085250639102,0.0014771540904951245,0.7197802197802198
637,1506,에만/Josa,181,44,137,0.0005112815382905413,0.0015437926208934005,0.7569060773480663
638,1507,에게는/Josa,181,120,61,0.0013560075580749138,0.0006997045691819009,0.6629834254143646
639,1508,따위/Noun,181,63,118,0.0007224630432366343,0.0013327706079655256,0.6519337016574586
640,1514,쓰래/Noun,180,10,170,0.0001333777925975325,0.00191030453808392,0.9444444444444444
641,1515,불쾌하다/Adjective,180,23,157,0.00027787040124485944,0.0017659210555543215,0.8722222222222222
642,1516,느리다/Adjective,180,42,138,0.0004890519061909527,0.0015548990426264464,0.7666666666666667
643,1517,까진/Josa,180,62,118,0.0007113482271868402,0.0013327706079655256,0.6555555555555556
644,1521,싸다/Verb,179,41,138,0.0004779370901411582,0.0015548990426264464,0.770949720670391
645,1522,촌스럽다/Adjective,179,50,129,0.0005779704345893076,0.0014549412470290322,0.7206703910614525
646,1531,그렇다고/Conjunction,178,34,144,0.0004001333777925976,0.0016215375730247227,0.8089887640449438
647,1536,이제야/Noun,177,157,20,0.0017672557519173055,0.00024434127812701304,0.8870056497175142
648,1537,적절하다/Adjective,177,137,40,0.0015449594309214182,0.000466469712787934,0.7740112994350282
649,1538,깨닫다/Verb,177,133,44,0.001500500166722241,0.0005108953997201182,0.7514124293785308
650,1543,오그라들다/Verb,176,19,157,0.0002334111370456819,0.0017659210555543215,0.8920454545454546
651,1544,긴장/Noun,176,134,42,0.0015116149827720349,0.0004886825562540262,0.7613636363636364
652,1545,게이/Noun,176,47,129,0.0005446259864399244,0.0014549412470290322,0.7329545454545454
653,1546,어쩔/Adverb,176,57,119,0.0006557741469378681,0.0013438770296985718,0.6761363636363636
654,1547,외국/Noun,176,57,119,0.0006557741469378681,0.0013438770296985718,0.6761363636363636
655,1550,언제나/Adverb,175,128,47,0.0014449260864732687,0.0005442146649192564,0.7314285714285714
656,1554,열정/Noun,174,148,26,0.0016672224074691564,0.00031097980852528933,0.8505747126436781
657,1555,소소하다/Adjective,174,143,31,0.0016116483272201846,0.00036651191719051963,0.8218390804597702
658,1556,빛나다/Verb,174,131,43,0.001478270534622652,0.0004997889779870722,0.7528735632183908
659,1557,이루다/Verb,174,126,48,0.0014226964543736804,0.0005553210866523023,0.7241379310344828
660,1559,아픔/Noun,173,146,27,0.0016449927753695677,0.00032208623025833537,0.8439306358381503
661,1560,창/Noun,173,31,142,0.00036678892964321435,0.0015993247295586306,0.8208092485549133
662,1561,선생님/Noun,173,129,44,0.0014560409025230633,0.0005108953997201182,0.7456647398843931
663,1562,병/Noun,173,51,122,0.000589085250639102,0.0013771962948977098,0.7052023121387283
664,1563,쇼/Noun,173,55,118,0.0006335445148382794,0.0013327706079655256,0.6820809248554913
665,1565,강렬하다/Adjective,172,147,25,0.0016561075914193618,0.0002998733867922433,0.8546511627906976
666,1566,화나다/Verb,172,30,142,0.00035567411359342004,0.0015993247295586306,0.8255813953488372
667,1567,짝/Noun,172,34,138,0.0004001333777925976,0.0015548990426264464,0.8023255813953488
668,1568,양/Modifier,172,52,120,0.0006002000666888963,0.0013549834514316175,0.6976744186046512
669,1569,디즈니/Noun,172,114,58,0.0012893186617761474,0.0006663853039827628,0.6627906976744186
670,1574,질리/Noun,171,160,11,0.001800600200066689,0.0001443834825295986,0.935672514619883
671,1575,쩝/Adverb,171,28,143,0.0003334444814938313,0.001610431151291677,0.8362573099415205
672,1576,극치/Noun,171,28,143,0.0003334444814938313,0.001610431151291677,0.8362573099415205
673,1577,까지도/Josa,171,135,36,0.0015227297988218294,0.0004220440258557498,0.7894736842105263
674,1578,밥/Noun,171,47,124,0.0005446259864399244,0.0013994091383638019,0.7251461988304093
675,1579,희생/Noun,171,112,59,0.0012670890296765588,0.0006774917257158089,0.6549707602339181
676,1583,찡하다/Adjective,170,165,5,0.001856174280315661,7.774495213132233e-05,0.9705882352941176
677,1584,주기도/Noun,170,6,164,8.891852839835501e-05,0.001843666007685644,0.9647058823529412
678,1585,노답/Noun,170,14,156,0.00017783705679671002,0.0017548146338212756,0.9176470588235294
679,1586,빡치다/Adjective,170,27,143,0.00032232966544403684,0.001610431151291677,0.8411764705882353
680,1587,남편/Noun,170,55,115,0.0006335445148382794,0.0012994513427663874,0.6764705882352942
681,1593,죄다/Adverb,169,19,150,0.0002334111370456819,0.0016881761034229991,0.8875739644970414
682,1594,싸구려/Noun,169,21,148,0.00025564076914527065,0.001665963259956907,0.8757396449704142
683,1595,때우다/Verb,169,36,133,0.00042236300989218633,0.0014993669339612163,0.7869822485207101
684,1596,에로/Josa,169,39,130,0.00045570745804156943,0.0014660476687620785,0.7692307692307693
685,1597,마저/Josa,169,51,118,0.000589085250639102,0.0013327706079655256,0.6982248520710059
686,1598,헐리우드/Noun,169,52,117,0.0006002000666888963,0.0013216641862324795,0.6923076923076923
687,1601,섬세하다/Adjective,168,146,22,0.0016449927753695677,0.00026655412159310506,0.8690476190476191
688,1602,풋풋하다/Adjective,168,144,24,0.001622763143269979,0.0002887669650591972,0.8571428571428571
689,1603,어머니/Noun,168,123,45,0.001389352006224297,0.0005220018214531642,0.7321428571428571
690,1604,=/Punctuation,168,55,113,0.0006335445148382794,0.0012772384993002955,0.6726190476190477
691,1611,제로/Noun,167,16,151,0.0002000666888962988,0.0016992825251560453,0.9041916167664672
692,1612,유발/Noun,167,21,146,0.00025564076914527065,0.001643750416490815,0.8742514970059879
693,1613,필름/Noun,167,34,133,0.0004001333777925976,0.0014993669339612163,0.7964071856287425
694,1614,조절/Noun,167,40,127,0.0004668222740913638,0.00143272840356294,0.7604790419161677
695,1615,놓치다/Verb,167,125,42,0.0014115816383238858,0.0004886825562540262,0.7485029940119761
696,1616,본인/Noun,167,56,111,0.0006446593308880737,0.0012550256558342032,0.6646706586826348
697,1622,미드/Noun,166,111,55,0.0012559742136267645,0.0006330660387836247,0.6686746987951807
698,1623,실력/Noun,166,57,109,0.0006557741469378681,0.0012328128123681114,0.6566265060240963
699,1627,조잡하다/Adjective,165,7,158,0.0001000333444481494,0.0017770274772873676,0.9575757575757576
700,1636,굿굿/Noun,164,161,3,0.0018117150161164836,5.553210866523024e-05,0.9817073170731708
701,1637,좋아지다/Verb,164,134,30,0.0015116149827720349,0.0003554054954574735,0.8170731707317073
702,1638,통쾌하다/Adjective,164,128,36,0.0014449260864732687,0.0004220440258557498,0.7804878048780488
703,1639,심각하다/Adjective,164,43,121,0.0005001667222407468,0.001366089873164664,0.7378048780487805
704,1646,어휴/Exclamation,163,21,142,0.00025564076914527065,0.0015993247295586306,0.8711656441717791
705,1647,실패/Noun,163,27,136,0.00032232966544403684,0.0015326861991603546,0.8343558282208589
706,1648,아줌마/Noun,163,46,117,0.00053351117039013,0.0013216641862324795,0.7177914110429447
707,1654,다가오다/Verb,162,132,30,0.0014893853506724466,0.0003554054954574735,0.8148148148148148
708,1655,은근/Noun,162,127,35,0.0014338112704234743,0.0004109376041227037,0.7839506172839507
709,1656,심장/Noun,162,126,36,0.0014226964543736804,0.0004220440258557498,0.7777777777777778
710,1657,바라보다/Verb,162,126,36,0.0014226964543736804,0.0004220440258557498,0.7777777777777778
711,1658,씁쓸하다/Adjective,162,120,42,0.0013560075580749138,0.0004886825562540262,0.7407407407407407
712,1659,편하다/Adjective,162,108,54,0.0012226297654773814,0.0006219596170505788,0.6666666666666666
713,1660,따라가다/Verb,162,56,106,0.0006446593308880737,0.0011994935471689732,0.654320987654321
714,1666,없어지다/Verb,161,37,124,0.0004334778259419807,0.0013994091383638019,0.7701863354037267
715,1667,숨다/Verb,161,121,40,0.0013671223741247086,0.000466469712787934,0.7515527950310559
716,1671,1시간/Number,160,35,125,0.0004112481938423919,0.001410515560096848,0.78125
717,1672,늦다/Verb,160,123,37,0.001389352006224297,0.0004331504475887958,0.76875
718,1673,아이돌/Noun,160,54,106,0.0006224296987884852,0.0011994935471689732,0.6625
719,1680,명품/Noun,159,135,24,0.0015227297988218294,0.0002887669650591972,0.8490566037735849
720,1681,존경/Noun,159,126,33,0.0014226964543736804,0.00038872476065661166,0.7924528301886793
721,1682,더불다/Verb,159,117,42,0.0013226631099255307,0.0004886825562540262,0.7358490566037735
722,1683,신나다/Adjective,159,111,48,0.0012559742136267645,0.0005553210866523023,0.6981132075471698
723,1686,시트콤/Noun,158,109,49,0.0012337445815271755,0.0005664275083853486,0.689873417721519
724,1687,어쩔/Modifier,158,50,108,0.0005779704345893076,0.0012217063906350652,0.6835443037974683
725,1693,짠하다/Adjective,157,146,11,0.0016449927753695677,0.0001443834825295986,0.929936305732484
726,1694,푹/Noun,157,137,20,0.0015449594309214182,0.00024434127812701304,0.8726114649681529
727,1695,만족/Noun,157,113,44,0.0012782038457263534,0.0005108953997201182,0.7197452229299363
728,1699,쵝오/Noun,156,151,5,0.0017005668556185395,7.774495213132233e-05,0.9679487179487181
729,1703,거슬리다/Verb,155,35,120,0.0004112481938423919,0.0013549834514316175,0.7741935483870968
730,1704,전개도/Noun,155,54,101,0.0006224296987884852,0.0011439614385037428,0.6516129032258065
731,1709,짝퉁/Noun,154,7,147,0.0001000333444481494,0.0016548568382238609,0.9545454545454546
732,1710,개뿔/Noun,154,7,147,0.0001000333444481494,0.0016548568382238609,0.9545454545454546
733,1711,양심/Noun,154,28,126,0.0003334444814938313,0.001421621981829894,0.8181818181818182
734,1712,????/Punctuation,154,36,118,0.00042236300989218633,0.0013327706079655256,0.7662337662337663
735,1713,누군가/Noun,154,118,36,0.001333777925975325,0.0004220440258557498,0.7662337662337663
736,1714,그거/Noun,154,45,109,0.0005223963543403357,0.0012328128123681114,0.7077922077922078
737,1715,개념/Noun,154,49,105,0.0005668556185395131,0.001188387125435927,0.6818181818181818
738,1716,이자/Noun,154,103,51,0.0011670556852284096,0.0005886403518514405,0.6688311688311688
739,1717,시원하다/Adjective,154,103,51,0.0011670556852284096,0.0005886403518514405,0.6688311688311688
740,1721,민망하다/Adjective,153,16,137,0.0002000666888962988,0.0015437926208934005,0.8954248366013072
741,1722,망/Noun,153,19,134,0.0002334111370456819,0.0015104733556942625,0.8758169934640523
742,1723,연예인/Noun,153,27,126,0.00032232966544403684,0.001421621981829894,0.8235294117647058
743,1724,도안/Noun,153,38,115,0.000444592641991775,0.0012994513427663874,0.7516339869281046
744,1725,해내다/Verb,153,114,39,0.0012893186617761474,0.000455363291054888,0.7450980392156863
745,1726,가요/Noun,153,39,114,0.00045570745804156943,0.0012883449210333415,0.7450980392156863
746,1727,전반/Noun,153,49,104,0.0005668556185395131,0.001177280703702881,0.6797385620915033
747,1728,진리/Noun,153,101,52,0.0011448260531288204,0.0005997467735844866,0.6601307189542484
748,1733,돌아보다/Verb,152,143,9,0.0016116483272201846,0.00012217063906350652,0.9407894736842104
749,1734,의외로/Adverb,152,129,23,0.0014560409025230633,0.00027766054332615115,0.8486842105263158
750,1735,여행/Noun,152,104,48,0.001178170501278204,0.0005553210866523023,0.6842105263157895
751,1736,향/Noun,152,100,52,0.0011337112370790265,0.0005997467735844866,0.6578947368421053
752,1740,찝찝하다/Adjective,151,30,121,0.00035567411359342004,0.001366089873164664,0.8013245033112583
753,1741,사기/Noun,151,33,118,0.00038901856174280313,0.0013327706079655256,0.7814569536423841
754,1742,과장/Noun,151,51,100,0.000589085250639102,0.0011328550167706971,0.6622516556291391
755,1750,라지/Noun,150,18,132,0.0002222963209958875,0.0014882605122281704,0.88
756,1751,날리다/Verb,150,30,120,0.00035567411359342004,0.0013549834514316175,0.8
757,1761,낭비하다/Adjective,149,2,147,4.445926419917751e-05,0.0016548568382238609,0.9865771812080536
758,1762,단연/Noun,149,128,21,0.0014449260864732687,0.0002554476998600591,0.8590604026845637
759,1763,무척/Noun,149,114,35,0.0012893186617761474,0.0004109376041227037,0.7651006711409396
760,1764,성장/Noun,149,110,39,0.00124485939757697,0.000455363291054888,0.7382550335570469
761,1765,......../Punctuation,149,45,104,0.0005223963543403357,0.001177280703702881,0.6979865771812079
762,1775,이도/Noun,148,5,143,7.780371234856063e-05,0.001610431151291677,0.9662162162162162
763,1776,상/Noun,148,44,104,0.0005112815382905413,0.001177280703702881,0.7027027027027027
764,1777,피해자/Noun,148,44,104,0.0005112815382905413,0.001177280703702881,0.7027027027027027
765,1778,감히/Noun,148,97,51,0.0011003667889296432,0.0005886403518514405,0.6554054054054054
766,1781,꽝/Noun,147,8,139,0.00011114816049794375,0.0015660054643594926,0.9455782312925172
767,1782,라이/Noun,147,28,119,0.0003334444814938313,0.0013438770296985718,0.8095238095238095
768,1783,편견/Noun,147,103,44,0.0011670556852284096,0.0005108953997201182,0.7006802721088435
769,1784,베스트/Noun,147,97,50,0.0011003667889296432,0.0005775339301183945,0.6598639455782312
770,1789,사수/Noun,146,132,14,0.0014893853506724466,0.00017770274772873674,0.9041095890410958
771,1790,허세/Noun,146,18,128,0.0002222963209958875,0.0014438348252959862,0.8767123287671232
772,1791,와우/Noun,146,125,21,0.0014115816383238858,0.0002554476998600591,0.8561643835616438
773,1792,명성/Noun,146,25,121,0.00030010003334444816,0.001366089873164664,0.8287671232876712
774,1793,얘/Noun,146,40,106,0.0004668222740913638,0.0011994935471689732,0.726027397260274
775,1794,올라가다/Verb,146,98,48,0.0011114816049794377,0.0005553210866523023,0.6712328767123288
776,1795,확/Noun,146,50,96,0.0005779704345893076,0.0010884293298385123,0.6575342465753424
777,1803,개막/Noun,145,9,136,0.00012226297654773814,0.0015326861991603546,0.9379310344827586
778,1804,생생하다/Adjective,145,134,11,0.0015116149827720349,0.0001443834825295986,0.9241379310344828
779,1805,^/Punctuation,145,102,43,0.0011559408691786152,0.0004997889779870722,0.7034482758620689
780,1806,연결/Noun,145,50,95,0.0005779704345893076,0.0010773229081054666,0.6551724137931034
781,1809,뭉클하다/Adjective,144,139,5,0.0015671890630210071,7.774495213132233e-05,0.9652777777777778
782,1810,마이너스/Noun,144,7,137,0.0001000333444481494,0.0015437926208934005,0.9513888888888888
783,1811,밋밋하다/Adjective,144,18,126,0.0002222963209958875,0.001421621981829894,0.875
784,1812,묘/Noun,144,118,26,0.001333777925975325,0.00031097980852528933,0.8194444444444444
785,1817,저/Modifier,143,26,117,0.00031121484939424253,0.0013216641862324795,0.8181818181818182
786,1818,풍경/Noun,143,101,42,0.0011448260531288204,0.0004886825562540262,0.7062937062937062
787,1819,처/Noun,143,44,99,0.0005112815382905413,0.0011217485950376508,0.6923076923076923
788,1820,드물다/Adjective,143,98,45,0.0011114816049794377,0.0005220018214531642,0.6853146853146853
789,1821,무언가/Noun,143,97,46,0.0011003667889296432,0.0005331082431862101,0.6783216783216783
790,1824,ㅉㅉㅉ/KoreanParticle,142,15,127,0.00018895187284650438,0.00143272840356294,0.8943661971830986
791,1825,싸이코/Noun,142,29,113,0.0003445592975436257,0.0012772384993002955,0.7957746478873241
792,1826,만들기/Noun,142,30,112,0.00035567411359342004,0.0012661320775672494,0.7887323943661971
793,1827,자연스럽다/Adjective,142,112,30,0.0012670890296765588,0.0003554054954574735,0.7887323943661971
794,1831,달달/Noun,141,125,16,0.0014115816383238858,0.00019991559119482882,0.8865248226950354
795,1832,어린시절/Noun,141,123,18,0.001389352006224297,0.00022212843466092096,0.8723404255319149
796,1833,정체/Noun,141,30,111,0.00035567411359342004,0.0012550256558342032,0.7872340425531915
797,1834,막장드라마/Noun,141,32,109,0.00037790374569300877,0.0012328128123681114,0.7730496453900709
798,1835,왠/Modifier,141,33,108,0.00038901856174280313,0.0012217063906350652,0.7659574468085106
799,1842,♥♥/Foreign,140,140,0,0.0015783038790708015,2.2212843466092093e-05,1.0
800,1843,숨기다/Verb,140,114,26,0.0012893186617761474,0.00031097980852528933,0.8142857142857143
801,1844,세월/Noun,140,105,35,0.0011892853173279985,0.0004109376041227037,0.75
802,1845,캐리/Noun,140,104,36,0.001178170501278204,0.0004220440258557498,0.7428571428571429
803,1846,변화/Noun,140,91,49,0.001033677892630877,0.0005664275083853486,0.65
804,1852,일품/Noun,139,126,13,0.0014226964543736804,0.0001665963259956907,0.9064748201438848
805,1853,젠장/Noun,139,22,117,0.000266755585195065,0.0013216641862324795,0.8417266187050358
806,1854,기회/Noun,139,106,33,0.0012004001333777929,0.00038872476065661166,0.7625899280575541
807,1855,카리스마/Noun,139,105,34,0.0011892853173279985,0.00039983118238965764,0.7553956834532374
808,1856,남아/Noun,139,97,42,0.0011003667889296432,0.0004886825562540262,0.6978417266187049
809,1858,아/Noun,138,27,111,0.00032232966544403684,0.0012550256558342032,0.8043478260869565
810,1859,칼/Noun,138,41,97,0.0004779370901411582,0.0010995357515715587,0.7028985507246377
811,1860,신경/Noun,138,42,96,0.0004890519061909527,0.0010884293298385123,0.6956521739130435
812,1861,자살/Noun,138,43,95,0.0005001667222407468,0.0010773229081054666,0.6884057971014492
813,1862,오빠/Noun,138,95,43,0.0010781371568300542,0.0004997889779870722,0.6884057971014492
814,1869,포르노/Noun,137,16,121,0.0002000666888962988,0.001366089873164664,0.8832116788321168
815,1870,C/Alpha,137,16,121,0.0002000666888962988,0.001366089873164664,0.8832116788321168
816,1871,응원/Noun,137,116,21,0.0013115482938757365,0.0002554476998600591,0.8467153284671532
817,1872,겨/Noun,137,26,111,0.00031121484939424253,0.0012550256558342032,0.8102189781021898
818,1873,압권/Noun,137,111,26,0.0012559742136267645,0.00031097980852528933,0.8102189781021898
819,1874,다양하다/Adjective,137,99,38,0.001122596421029232,0.0004442568693218419,0.7226277372262774
820,1875,모으다/Verb,137,39,98,0.00045570745804156943,0.0011106421733046046,0.7153284671532847
821,1876,형사/Noun,137,43,94,0.0005001667222407468,0.0010662164863724202,0.6861313868613139
822,1877,만해/Noun,137,91,46,0.001033677892630877,0.0005331082431862101,0.6642335766423357
823,1886,시시하다/Adjective,136,23,113,0.00027787040124485944,0.0012772384993002955,0.8308823529411765
824,1887,세번/Noun,136,110,26,0.00124485939757697,0.00031097980852528933,0.8088235294117647
825,1888,냥/Josa,136,31,105,0.00036678892964321435,0.001188387125435927,0.7720588235294118
826,1889,만에/Josa,136,101,35,0.0011448260531288204,0.0004109376041227037,0.7426470588235294
827,1890,내면/Noun,136,99,37,0.001122596421029232,0.0004331504475887958,0.7279411764705882
828,1891,성격/Noun,136,41,95,0.0004779370901411582,0.0010773229081054666,0.6985294117647058
829,1892,선물/Noun,136,95,41,0.0010781371568300542,0.00047757613452098,0.6985294117647058
830,1893,동시/Noun,136,90,46,0.0010225630765810826,0.0005331082431862101,0.6617647058823529
831,1897,에로영화/Noun,135,22,113,0.000266755585195065,0.0012772384993002955,0.837037037037037
832,1898,겨우/Noun,135,22,113,0.000266755585195065,0.0012772384993002955,0.837037037037037
833,1899,추하다/Adjective,135,108,27,0.0012226297654773814,0.00032208623025833537,0.8
834,1900,적임/Noun,135,96,39,0.0010892519728798488,0.000455363291054888,0.7111111111111111
835,1901,만족하다/Adjective,135,93,42,0.0010559075247304657,0.0004886825562540262,0.6888888888888889
836,1902,형제/Noun,135,91,44,0.001033677892630877,0.0005108953997201182,0.674074074074074
837,1903,조용하다/Adjective,135,90,45,0.0010225630765810826,0.0005220018214531642,0.6666666666666666
838,1910,야동/Noun,134,25,109,0.00030010003334444816,0.0012328128123681114,0.8134328358208955
839,1911,롭고/Josa,134,108,26,0.0012226297654773814,0.00031097980852528933,0.8059701492537313
840,1912,당/Suffix,134,44,90,0.0005112815382905413,0.0010217907994402363,0.6716417910447762
841,1913,[/Punctuation,134,44,90,0.0005112815382905413,0.0010217907994402363,0.6716417910447762
842,1924,투자/Noun,133,20,113,0.00024452595309547634,0.0012772384993002955,0.849624060150376
843,1925,레전드/Noun,133,108,25,0.0012226297654773814,0.0002998733867922433,0.8120300751879699
844,1926,지우다/Verb,133,30,103,0.00035567411359342004,0.001166174281969835,0.7744360902255639
845,1927,고통/Noun,133,95,38,0.0010781371568300542,0.0004442568693218419,0.7142857142857143
846,1928,비현실적/Noun,133,41,92,0.0004779370901411582,0.0010440036429063284,0.6917293233082706
847,1929,욕망/Noun,133,90,43,0.0010225630765810826,0.0004997889779870722,0.6766917293233082
848,1930,쉬/Noun,133,90,43,0.0010225630765810826,0.0004997889779870722,0.6766917293233082
849,1937,진하다/Adjective,132,119,13,0.0013448927420251196,0.0001665963259956907,0.9015151515151516
850,1938,초등학교/Noun,132,99,33,0.001122596421029232,0.00038872476065661166,0.75
851,1939,학년/Noun,132,96,36,0.0010892519728798488,0.0004220440258557498,0.7272727272727273
852,1940,로그인/Noun,132,41,91,0.0004779370901411582,0.0010328972211732824,0.6893939393939394
853,1941,베/Noun,132,45,87,0.0005223963543403357,0.0009884715342410985,0.6590909090909091
854,1942,을/Foreign,132,45,87,0.0005223963543403357,0.0009884715342410985,0.6590909090909091
855,1950,M/Alpha,131,5,126,7.780371234856063e-05,0.001421621981829894,0.9618320610687024
856,1951,잠들다/Verb,131,17,114,0.00021118150494609317,0.0012883449210333415,0.8702290076335878
857,1952,감흥/Noun,131,19,112,0.0002334111370456819,0.0012661320775672494,0.8549618320610687
858,1953,붙이다/Verb,131,21,110,0.00025564076914527065,0.0012439192341011573,0.8396946564885496
859,1954,부럽다/Adjective,131,106,25,0.0012004001333777929,0.0002998733867922433,0.8091603053435115
860,1955,설득/Noun,131,30,101,0.00035567411359342004,0.0011439614385037428,0.7709923664122137
861,1956,따로/Adverb,131,31,100,0.00036678892964321435,0.0011328550167706971,0.7633587786259542
862,1957,]/Punctuation,131,38,93,0.000444592641991775,0.0010551100646393743,0.7099236641221374
863,1958,끝내주다/Adjective,131,91,40,0.001033677892630877,0.000466469712787934,0.6946564885496184
864,1959,놀랍다/Adjective,131,91,40,0.001033677892630877,0.000466469712787934,0.6946564885496184
865,1964,반하다/Adjective,130,112,18,0.0012670890296765588,0.00022212843466092096,0.8615384615384616
866,1965,점준/Noun,130,23,107,0.00027787040124485944,0.0012105999689020189,0.823076923076923
867,1966,인지도/Noun,130,26,104,0.00031121484939424253,0.001177280703702881,0.8
868,1967,x/Alpha,130,34,96,0.0004001333777925976,0.0010884293298385123,0.7384615384615385
869,1968,루/Noun,130,36,94,0.00042236300989218633,0.0010662164863724202,0.7230769230769231
870,1969,기발하다/Adjective,130,92,38,0.0010447927086806713,0.0004442568693218419,0.7076923076923077
871,1970,최강/Noun,130,88,42,0.0010003334444814939,0.0004886825562540262,0.676923076923077
872,1975,안습/Noun,129,16,113,0.0002000666888962988,0.0012772384993002955,0.875968992248062
873,1976,우려/Noun,129,18,111,0.0002222963209958875,0.0012550256558342032,0.8604651162790697
874,1977,기만/Noun,129,25,104,0.00030010003334444816,0.001177280703702881,0.8062015503875969
875,1978,조작/Noun,129,25,104,0.00030010003334444816,0.001177280703702881,0.8062015503875969
876,1979,고르다/Verb,129,29,100,0.0003445592975436257,0.0011328550167706971,0.7751937984496124
877,1980,오랫/Modifier,129,97,32,0.0011003667889296432,0.0003776183389235656,0.751937984496124
878,1981,스트레스/Noun,129,35,94,0.0004112481938423919,0.0010662164863724202,0.7286821705426356
879,1982,색감/Noun,129,91,38,0.001033677892630877,0.0004442568693218419,0.7054263565891473
880,1988,공짜/Noun,128,5,123,7.780371234856063e-05,0.0013883027166307562,0.9609375
881,1989,18/Number,128,28,100,0.0003334444814938313,0.0011328550167706971,0.78125
882,1990,놀다/Verb,128,36,92,0.00042236300989218633,0.0010440036429063284,0.71875
883,1991,아무렇다/Adjective,128,37,91,0.0004334778259419807,0.0010328972211732824,0.7109375
884,1992,데리/Noun,128,41,87,0.0004779370901411582,0.0009884715342410985,0.6796875
885,1993,포인트/Noun,128,42,86,0.0004890519061909527,0.000977365112508052,0.671875
886,2001,정신병/Noun,127,21,106,0.00025564076914527065,0.0011994935471689732,0.8346456692913385
887,2002,깨우다/Verb,127,105,22,0.0011892853173279985,0.00026655412159310506,0.8267716535433071
888,2003,아예/Noun,127,26,101,0.00031121484939424253,0.0011439614385037428,0.7952755905511811
889,2004,여러가지/Noun,127,95,32,0.0010781371568300542,0.0003776183389235656,0.7480314960629921
890,2005,미가/Noun,127,94,33,0.00106702234078026,0.00038872476065661166,0.7401574803149606
891,2006,넘어가다/Verb,127,40,87,0.0004668222740913638,0.0009884715342410985,0.6850393700787402
892,2015,틈/Noun,126,106,20,0.0012004001333777929,0.00024434127812701304,0.8412698412698413
893,2016,;;;;/Punctuation,126,26,100,0.00031121484939424253,0.0011328550167706971,0.7936507936507936
894,2017,껏/Noun,126,28,98,0.0003334444814938313,0.0011106421733046046,0.7777777777777778
895,2018,위로/Noun,126,91,35,0.001033677892630877,0.0004109376041227037,0.7222222222222222
896,2019,전쟁영화/Noun,126,88,38,0.0010003334444814939,0.0004442568693218419,0.6984126984126984
897,2027,효/Noun,125,24,101,0.0002889852172946538,0.0011439614385037428,0.8079999999999999
898,2028,용기/Noun,125,98,27,0.0011114816049794377,0.00032208623025833537,0.784
899,2029,뜨겁다/Adjective,125,97,28,0.0011003667889296432,0.0003331926519913814,0.7759999999999999
900,2030,패/Noun,125,38,87,0.000444592641991775,0.0009884715342410985,0.696
901,2031,공포물/Noun,125,40,85,0.0004668222740913638,0.0009662586907750061,0.68
902,2032,근래/Noun,125,84,41,0.0009558741802823164,0.00047757613452098,0.672
903,2033,수고/Noun,125,82,43,0.0009336445481827276,0.0004997889779870722,0.6559999999999999
904,2039,말아먹다/Verb,124,12,112,0.00015560742469712126,0.0012661320775672494,0.9032258064516128
905,2040,운명/Noun,124,93,31,0.0010559075247304657,0.00036651191719051963,0.75
906,2041,연인/Noun,124,91,33,0.001033677892630877,0.00038872476065661166,0.7338709677419355
907,2042,이용/Noun,124,38,86,0.000444592641991775,0.000977365112508052,0.6935483870967742
908,2043,",./Punctuation",124,41,83,0.0004779370901411582,0.000944045847308914,0.6693548387096774
909,2053,썩다/Verb,123,33,90,0.00038901856174280313,0.0010217907994402363,0.7317073170731707
910,2054,확인/Noun,123,35,88,0.0004112481938423919,0.0009995779559741444,0.7154471544715447
911,2055,해결/Noun,123,42,81,0.0004890519061909527,0.000921833003842822,0.6585365853658537
912,2064,았/Noun,122,13,109,0.00016672224074691566,0.0012328128123681114,0.8934426229508197
913,2065,번은/Noun,122,102,20,0.0011559408691786152,0.00024434127812701304,0.8360655737704918
914,2066,설마/Noun,122,22,100,0.000266755585195065,0.0011328550167706971,0.819672131147541
915,2067,결코/Noun,122,91,31,0.001033677892630877,0.00036651191719051963,0.7459016393442623
916,2068,원/Noun,122,31,91,0.00036678892964321435,0.0010328972211732824,0.7459016393442623
917,2069,잖다/Verb,122,34,88,0.0004001333777925976,0.0009995779559741444,0.7213114754098361
918,2070,갠/Noun,122,84,38,0.0009558741802823164,0.0004442568693218419,0.6885245901639344
919,2071,갖추다/Verb,122,82,40,0.0009336445481827276,0.000466469712787934,0.6721311475409836
920,2078,낮추다/Verb,121,16,105,0.0002000666888962988,0.001188387125435927,0.8677685950413223
921,2079,셈/Noun,121,20,101,0.00024452595309547634,0.0011439614385037428,0.8347107438016529
922,2080,변태/Noun,121,21,100,0.00025564076914527065,0.0011328550167706971,0.8264462809917356
923,2081,심지어/Noun,121,31,90,0.00036678892964321435,0.0010217907994402363,0.743801652892562
924,2082,자르다/Verb,121,40,81,0.0004668222740913638,0.000921833003842822,0.6694214876033058
925,2086,잔뜩/Noun,120,15,105,0.00018895187284650438,0.001188387125435927,0.875
926,2087,5분/Number,120,18,102,0.0002222963209958875,0.001155067860236789,0.85
927,2088,크리스마스/Noun,120,89,31,0.0010114482605312882,0.00036651191719051963,0.7416666666666667
928,2089,X/Alpha,120,31,89,0.00036678892964321435,0.0010106843777071904,0.7416666666666667
929,2090,스런/Josa,120,39,81,0.00045570745804156943,0.000921833003842822,0.675
930,2091,여러/Noun,120,79,41,0.0009003001000333445,0.00047757613452098,0.6583333333333333
931,2100,전율/Noun,119,110,9,0.00124485939757697,0.00012217063906350652,0.9243697478991596
932,2101,둘째/Noun,119,14,105,0.00017783705679671002,0.001188387125435927,0.8823529411764706
933,2102,려고/Noun,119,23,96,0.00027787040124485944,0.0010884293298385123,0.8067226890756303
934,2103,아동/Noun,119,28,91,0.0003334444814938313,0.0010328972211732824,0.7647058823529411
935,2104,그립다/Adjective,119,86,33,0.0009781038123819054,0.00038872476065661166,0.7226890756302521
936,2105,탓/Noun,119,35,84,0.0004112481938423919,0.00095515226904196,0.7058823529411765
937,2106,뛰어넘다/Verb,119,83,36,0.0009447593642325221,0.0004220440258557498,0.6974789915966386
938,2116,오빠/Suffix,118,106,12,0.0012004001333777929,0.00015548990426264466,0.8983050847457628
939,2117,작위/Noun,118,17,101,0.00021118150494609317,0.0011439614385037428,0.8559322033898306
940,2118,대본/Noun,118,24,94,0.0002889852172946538,0.0010662164863724202,0.7966101694915254
941,2119,부모님/Noun,118,89,29,0.0010114482605312882,0.00034429907372442745,0.7542372881355932
942,2120,톰/Noun,118,83,35,0.0009447593642325221,0.0004109376041227037,0.7033898305084746
943,2121,두번째/Noun,118,81,37,0.0009225297321329332,0.0004331504475887958,0.6864406779661016
944,2122,에나/Josa,118,38,80,0.000444592641991775,0.000910726582109776,0.6779661016949152
945,2126,:)/Punctuation,117,114,3,0.0012893186617761474,5.553210866523024e-05,0.9743589743589745
946,2127,한개/Modifier,117,10,107,0.0001333777925975325,0.0012105999689020189,0.9145299145299144
947,2128,애쓰다/Verb,117,25,92,0.00030010003334444816,0.0010440036429063284,0.7863247863247863
948,2129,하나같이/Adverb,117,28,89,0.0003334444814938313,0.0010106843777071904,0.7606837606837606
949,2130,가족영화/Noun,117,77,40,0.0008780704679337558,0.000466469712787934,0.6581196581196581
950,2139,그만/Modifier,116,9,107,0.00012226297654773814,0.0012105999689020189,0.9224137931034484
951,2140,하자/Noun,116,24,92,0.0002889852172946538,0.0010440036429063284,0.7931034482758621
952,2141,정작/Noun,116,29,87,0.0003445592975436257,0.0009884715342410985,0.75
953,2142,거나/Noun,116,33,83,0.00038901856174280313,0.000944045847308914,0.7155172413793104
954,2143,신의/Noun,116,79,37,0.0009003001000333445,0.0004331504475887958,0.6810344827586207
955,2144,장가/Noun,116,37,79,0.0004334778259419807,0.0008996201603767299,0.6810344827586207
956,2145,무료/Noun,116,40,76,0.0004668222740913638,0.0008663008951775916,0.6551724137931034
957,2146,예/Noun,116,40,76,0.0004668222740913638,0.0008663008951775916,0.6551724137931034
958,2147,꺼/Suffix,116,40,76,0.0004668222740913638,0.0008663008951775916,0.6551724137931034
959,2152,대놓고/Adverb,115,17,98,0.00021118150494609317,0.0011106421733046046,0.8521739130434782
960,2153,ㅠㅜ/KoreanParticle,115,89,26,0.0010114482605312882,0.00031097980852528933,0.7739130434782608
961,2154,소년/Noun,115,84,31,0.0009558741802823164,0.00036651191719051963,0.7304347826086957
962,2155,열연/Noun,115,80,35,0.0009114149160831386,0.0004109376041227037,0.6956521739130435
963,2156,성은/Noun,115,36,79,0.00042236300989218633,0.0008996201603767299,0.6869565217391305
964,2157,목적/Noun,115,37,78,0.0004334778259419807,0.0008885137386436838,0.6782608695652174
965,2158,충실하다/Adjective,115,77,38,0.0008780704679337558,0.0004442568693218419,0.6695652173913044
966,2159,의심/Noun,115,40,75,0.0004668222740913638,0.0008551944734445456,0.6521739130434783
967,2160,메/Noun,115,75,40,0.0008558408358341669,0.000466469712787934,0.6521739130434783
968,2166,힘내다/Verb,114,95,19,0.0010781371568300542,0.000233234856393967,0.8333333333333334
969,2167,겪다/Verb,114,87,27,0.0009892186284316995,0.00032208623025833537,0.7631578947368421
970,2168,씹다/Verb,114,31,83,0.00036678892964321435,0.000944045847308914,0.7280701754385965
971,2169,패러디/Noun,114,36,78,0.00042236300989218633,0.0008885137386436838,0.6842105263157895
972,2170,꿈꾸다/Verb,114,77,37,0.0008780704679337558,0.0004331504475887958,0.6754385964912281
973,2181,20분/Number,113,18,95,0.0002222963209958875,0.0010773229081054666,0.8407079646017699
974,2182,ㅜㅜㅜ/KoreanParticle,113,83,30,0.0009447593642325221,0.0003554054954574735,0.7345132743362832
975,2183,..;;/Punctuation,113,31,82,0.00036678892964321435,0.000932939425575868,0.7256637168141593
976,2188,명화/Noun,112,90,22,0.0010225630765810826,0.00026655412159310506,0.8035714285714286
977,2189,값/Noun,112,27,85,0.00032232966544403684,0.0009662586907750061,0.7589285714285714
978,2190,감각/Noun,112,73,39,0.0008336112037345782,0.000455363291054888,0.6517857142857143
979,2198,낚였다/Noun,111,2,109,4.445926419917751e-05,0.0012328128123681114,0.981981981981982
980,2199,참나/Noun,111,10,101,0.0001333777925975325,0.0011439614385037428,0.90990990990991
981,2200,오래전/Adverb,111,85,26,0.0009669889963321108,0.00031097980852528933,0.7657657657657657
982,2201,!!!!!/Punctuation,111,81,30,0.0009225297321329332,0.0003554054954574735,0.7297297297297297
983,2202,뇌/Noun,111,37,74,0.0004334778259419807,0.0008440880517114996,0.6666666666666666
984,2208,울컥/Adverb,110,108,2,0.0012226297654773814,4.4425686932184186e-05,0.9818181818181818
985,2209,짜지다/Verb,110,12,98,0.00015560742469712126,0.0011106421733046046,0.8909090909090909
986,2210,신파/Noun,110,16,94,0.0002000666888962988,0.0010662164863724202,0.8545454545454545
987,2211,첫사랑/Noun,110,90,20,0.0010225630765810826,0.00024434127812701304,0.8181818181818182
988,2212,업다/Verb,110,29,81,0.0003445592975436257,0.000921833003842822,0.7363636363636363
989,2213,몇몇/Noun,110,33,77,0.00038901856174280313,0.0008774073169106378,0.7
990,2214,모양/Noun,110,36,74,0.00042236300989218633,0.0008440880517114996,0.6727272727272727
991,2215,70년/Number,110,37,73,0.0004334778259419807,0.0008329816299784535,0.6636363636363637
992,2221,한숨/Noun,109,12,97,0.00015560742469712126,0.0010995357515715587,0.8899082568807339
993,2222,시끄럽다/Adjective,109,15,94,0.00018895187284650438,0.0010662164863724202,0.8623853211009175
994,2223,세련되다/Adjective,109,94,15,0.00106702234078026,0.0001888091694617828,0.8623853211009175
995,2224,고전/Noun,109,80,29,0.0009114149160831386,0.00034429907372442745,0.7339449541284404
996,2225,삭제/Noun,109,31,78,0.00036678892964321435,0.0008885137386436838,0.7155963302752294
997,2226,빵빵/Noun,109,77,32,0.0008780704679337558,0.0003776183389235656,0.7064220183486238
998,2227,졸/Noun,109,33,76,0.00038901856174280313,0.0008663008951775916,0.6972477064220184
999,2228,철/Noun,109,35,74,0.0004112481938423919,0.0008440880517114996,0.6788990825688074
1000,2233,.^^/Punctuation,108,97,11,0.0011003667889296432,0.0001443834825295986,0.8981481481481481
1001,2234,말고는/Josa,108,11,97,0.0001444926086473269,0.0010995357515715587,0.8981481481481481
1002,2235,십/Modifier,108,76,32,0.0008669556518839612,0.0003776183389235656,0.7037037037037037
1003,2236,그만큼/Adverb,108,76,32,0.0008669556518839612,0.0003776183389235656,0.7037037037037037
1004,2237,최대/Noun,108,37,71,0.0004334778259419807,0.0008107687865123613,0.6574074074074074
1005,2248,빈약하다/Adjective,107,12,95,0.00015560742469712126,0.0010773229081054666,0.8878504672897196
1006,2249,떨다/Verb,107,36,71,0.00042236300989218633,0.0008107687865123613,0.6635514018691588
1007,2253,어처구니/Noun,106,11,95,0.0001444926086473269,0.0010773229081054666,0.8962264150943396
1008,2254,..^^/Punctuation,106,92,14,0.0010447927086806713,0.00017770274772873674,0.8679245283018868
1009,2255,중독/Noun,106,87,19,0.0009892186284316995,0.000233234856393967,0.8207547169811321
1010,2256,폐지/Noun,106,30,76,0.00035567411359342004,0.0008663008951775916,0.7169811320754716
1011,2257,치밀하다/Adjective,106,73,33,0.0008336112037345782,0.00038872476065661166,0.6886792452830188
1012,2258,흑/Adverb,106,72,34,0.0008224963876847838,0.00039983118238965764,0.6792452830188679
1013,2263,선동/Noun,105,10,95,0.0001333777925975325,0.0010773229081054666,0.9047619047619048
1014,2264,팔이/Noun,105,11,94,0.0001444926086473269,0.0010662164863724202,0.8952380952380953
1015,2265,여름/Noun,105,85,20,0.0009669889963321108,0.00024434127812701304,0.8095238095238095
1016,2266,안감/Noun,105,22,83,0.000266755585195065,0.000944045847308914,0.7904761904761904
1017,2267,늘어지다/Verb,105,24,81,0.0002889852172946538,0.000921833003842822,0.7714285714285715
1018,2268,또다른/Modifier,105,78,27,0.00088918528398355,0.00032208623025833537,0.7428571428571429
1019,2269,중학교/Noun,105,77,28,0.0008780704679337558,0.0003331926519913814,0.7333333333333333
1020,2270,바탕/Noun,105,73,32,0.0008336112037345782,0.0003776183389235656,0.6952380952380952
1021,2271,목숨/Noun,105,70,35,0.0008002667555851951,0.0004109376041227037,0.6666666666666666
1022,2272,잡/Noun,105,36,69,0.00042236300989218633,0.0007885559430462694,0.6571428571428571
1023,2280,끼우다/Verb,104,10,94,0.0001333777925975325,0.0010662164863724202,0.903846153846154
1024,2281,메이드/Noun,104,91,13,0.001033677892630877,0.0001665963259956907,0.875
1025,2282,캬/Noun,104,89,15,0.0010114482605312882,0.0001888091694617828,0.8557692307692307
1026,2283,어쩌/Noun,104,16,88,0.0002000666888962988,0.0009995779559741444,0.8461538461538461
1027,2284,구리/Noun,104,16,88,0.0002000666888962988,0.0009995779559741444,0.8461538461538461
1028,2285,호구/Noun,104,17,87,0.00021118150494609317,0.0009884715342410985,0.8365384615384616
1029,2286,부터가/Josa,104,22,82,0.000266755585195065,0.000932939425575868,0.7884615384615384
1030,2287,하아/Exclamation,104,23,81,0.00027787040124485944,0.000921833003842822,0.7788461538461539
1031,2288,~!!!/Punctuation,104,79,25,0.0009003001000333445,0.0002998733867922433,0.7596153846153846
1032,2289,반갑다/Adjective,104,73,31,0.0008336112037345782,0.00036651191719051963,0.7019230769230769
1033,2290,장국영/Noun,104,73,31,0.0008336112037345782,0.00036651191719051963,0.7019230769230769
1034,2291,졸리/Noun,104,33,71,0.00038901856174280313,0.0008107687865123613,0.6826923076923077
1035,2292,표현/Modifier,104,68,36,0.0007780371234856063,0.0004220440258557498,0.6538461538461539
1036,2302,내놓다/Verb,103,23,80,0.00027787040124485944,0.000910726582109776,0.7766990291262136
1037,2303,이어서/Josa,103,75,28,0.0008558408358341669,0.0003331926519913814,0.7281553398058253
1038,2304,벌다/Verb,103,29,74,0.0003445592975436257,0.0008440880517114996,0.7184466019417476
1039,2305,로버트/Noun,103,70,33,0.0008002667555851951,0.00038872476065661166,0.6796116504854369
1040,2306,보이지/Noun,103,36,67,0.00042236300989218633,0.0007663430995801773,0.6504854368932039
1041,2314,빵점/Noun,102,2,100,4.445926419917751e-05,0.0011328550167706971,0.9803921568627452
1042,2315,하품/Noun,102,2,100,4.445926419917751e-05,0.0011328550167706971,0.9803921568627452
1043,2316,편안하다/Adjective,102,90,12,0.0010225630765810826,0.00015548990426264466,0.8823529411764706
1044,2317,지경/Noun,102,14,88,0.00017783705679671002,0.0009995779559741444,0.8627450980392157
1045,2318,재미나/Noun,102,87,15,0.0009892186284316995,0.0001888091694617828,0.8529411764705882
1046,2319,조화/Noun,102,82,20,0.0009336445481827276,0.00024434127812701304,0.8039215686274509
1047,2320,곡/Noun,102,78,24,0.00088918528398355,0.0002887669650591972,0.7647058823529411
1048,2321,팔/Modifier,102,24,78,0.0002889852172946538,0.0008885137386436838,0.7647058823529411
1049,2322,로코/Noun,102,75,27,0.0008558408358341669,0.00032208623025833537,0.7352941176470589
1050,2323,숨/Noun,102,75,27,0.0008558408358341669,0.00032208623025833537,0.7352941176470589
1051,2324,곱다/Adjective,102,69,33,0.0007891519395354007,0.00038872476065661166,0.6764705882352942
1052,2332,인내심/Noun,101,8,93,0.00011114816049794375,0.0010551100646393743,0.9207920792079208
1053,2333,잠시/Noun,101,75,26,0.0008558408358341669,0.00031097980852528933,0.7425742574257426
1054,2334,묻히다/Verb,101,68,33,0.0007780371234856063,0.00038872476065661166,0.6732673267326733
1055,2335,사운드/Noun,101,67,34,0.0007669223074358119,0.00039983118238965764,0.6633663366336634
1056,2351,앞뒤/Noun,100,11,89,0.0001444926086473269,0.0010106843777071904,0.89
1057,2352,울면/Noun,100,87,13,0.0009892186284316995,0.0001665963259956907,0.87
1058,2353,플롯/Noun,100,29,71,0.0003445592975436257,0.0008107687865123613,0.71
1059,2354,일본인/Noun,100,30,70,0.00035567411359342004,0.0007996623647793153,0.7
1060,2355,........./Punctuation,100,31,69,0.00036678892964321435,0.0007885559430462694,0.69
1061,2356,상관없다/Adjective,100,34,66,0.0004001333777925976,0.0007552366778471312,0.66
1062,2364,손색/Noun,99,90,9,0.0010225630765810826,0.00012217063906350652,0.9090909090909092
1063,2365,그만하다/Adjective,99,19,80,0.0002334111370456819,0.000910726582109776,0.8080808080808081
1064,2366,현대/Noun,99,72,27,0.0008224963876847838,0.00032208623025833537,0.7272727272727273
1065,2367,끔찍하다/Adjective,99,28,71,0.0003334444814938313,0.0008107687865123613,0.7171717171717171
1066,2368,꼬/Noun,99,31,68,0.00036678892964321435,0.0007774495213132232,0.6868686868686869
1067,2369,케빈/Noun,99,66,33,0.0007558074913860174,0.00038872476065661166,0.6666666666666666
1068,2370,공간/Noun,99,65,34,0.0007446926753362233,0.00039983118238965764,0.6565656565656566
1069,2371,착각/Noun,99,34,65,0.0004001333777925976,0.0007441302561140852,0.6565656565656566
1070,2381,어디가/Noun,98,16,82,0.0002000666888962988,0.000932939425575868,0.8367346938775511
1071,2382,우뢰매/Noun,98,18,80,0.0002222963209958875,0.000910726582109776,0.8163265306122449
1072,2383,토록/Josa,98,72,26,0.0008224963876847838,0.00031097980852528933,0.7346938775510204
1073,2384,실패하다/Adjective,98,28,70,0.0003334444814938313,0.0007996623647793153,0.7142857142857143
1074,2385,박진/Noun,98,65,33,0.0007446926753362233,0.00038872476065661166,0.6632653061224489
1075,2392,디워/Noun,97,10,87,0.0001333777925975325,0.0009884715342410985,0.8969072164948454
1076,2393,낚시/Noun,97,11,86,0.0001444926086473269,0.000977365112508052,0.8865979381443299
1077,2394,부실하다/Adjective,97,13,84,0.00016672224074691566,0.00095515226904196,0.865979381443299
1078,2395,쓸데없이/Adverb,97,14,83,0.00017783705679671002,0.000944045847308914,0.8556701030927835
1079,2396,사투리/Noun,97,23,74,0.00027787040124485944,0.0008440880517114996,0.7628865979381443
1080,2397,교과서/Noun,97,73,24,0.0008336112037345782,0.0002887669650591972,0.7525773195876289
1081,2398,밝다/Verb,97,71,26,0.0008113815716349895,0.00031097980852528933,0.7319587628865979
1082,2399,이군/Noun,97,33,64,0.00038901856174280313,0.0007330238343810393,0.6597938144329897
1083,2405,자고/Noun,96,11,85,0.0001444926086473269,0.0009662586907750061,0.8854166666666666
1084,2406,심형래/Noun,96,13,83,0.00016672224074691566,0.000944045847308914,0.8645833333333334
1085,2407,여친/Noun,96,23,73,0.00027787040124485944,0.0008329816299784535,0.7604166666666666
1086,2408,제임스/Noun,96,70,26,0.0008002667555851951,0.00031097980852528933,0.7291666666666666
1087,2409,일부러/Noun,96,28,68,0.0003334444814938313,0.0007774495213132232,0.7083333333333334
1088,2410,유덕화/Noun,96,66,30,0.0007558074913860174,0.0003554054954574735,0.6875
1089,2411,호기심/Noun,96,30,66,0.00035567411359342004,0.0007552366778471312,0.6875
1090,2412,너무도/Adverb,96,63,33,0.0007224630432366343,0.00038872476065661166,0.65625
1091,2419,체적/Noun,95,10,85,0.0001333777925975325,0.0009662586907750061,0.8947368421052632
1092,2420,이만/Noun,95,82,13,0.0009336445481827276,0.0001665963259956907,0.8631578947368421
1093,2421,팔/Noun,95,16,79,0.0002000666888962988,0.0008996201603767299,0.8315789473684211
1094,2422,듭니/Noun,95,77,18,0.0008780704679337558,0.00022212843466092096,0.8105263157894737
1095,2423,여자애/Noun,95,21,74,0.00025564076914527065,0.0008440880517114996,0.7789473684210526
1096,2424,던데/Noun,95,26,69,0.00031121484939424253,0.0007885559430462694,0.7263157894736842
1097,2425,당황/Noun,95,26,69,0.00031121484939424253,0.0007885559430462694,0.7263157894736842
1098,2426,꽃/Noun,95,68,27,0.0007780371234856063,0.00032208623025833537,0.7157894736842105
1099,2427,에다/Josa,95,28,67,0.0003334444814938313,0.0007663430995801773,0.7052631578947368
1100,2428,평균/Noun,95,28,67,0.0003334444814938313,0.0007663430995801773,0.7052631578947368
1101,2429,조카/Noun,95,66,29,0.0007558074913860174,0.00034429907372442745,0.6947368421052632
1102,2430,100%/Number,95,62,33,0.0007113482271868402,0.00038872476065661166,0.6526315789473685
1103,2431,겁/Noun,95,33,62,0.00038901856174280313,0.000710810990914947,0.6526315789473685
1104,2432,선정/Noun,95,33,62,0.00038901856174280313,0.000710810990914947,0.6526315789473685
1105,2441,겨울/Noun,94,77,17,0.0008780704679337558,0.0002110220129278749,0.8191489361702128
1106,2442,말투/Noun,94,24,70,0.0002889852172946538,0.0007996623647793153,0.7446808510638298
1107,2443,상실/Noun,94,24,70,0.0002889852172946538,0.0007996623647793153,0.7446808510638298
1108,2444,ㅈ/KoreanParticle,94,27,67,0.00032232966544403684,0.0007663430995801773,0.7127659574468085
1109,2445,베드/Noun,94,29,65,0.0003445592975436257,0.0007441302561140852,0.6914893617021277
1110,2446,에게도/Josa,94,65,29,0.0007446926753362233,0.00034429907372442745,0.6914893617021277
1111,2455,류작/Noun,93,5,88,7.780371234856063e-05,0.0009995779559741444,0.946236559139785
1112,2456,도무지/Noun,93,7,86,0.0001000333444481494,0.000977365112508052,0.9247311827956988
1113,2457,I/Alpha,93,76,17,0.0008669556518839612,0.0002110220129278749,0.8172043010752689
1114,2458,녹다/Verb,93,76,17,0.0008669556518839612,0.0002110220129278749,0.8172043010752689
1115,2459,성의/Noun,93,23,70,0.00027787040124485944,0.0007996623647793153,0.7526881720430108
1116,2460,차갑다/Adjective,93,68,25,0.0007780371234856063,0.0002998733867922433,0.7311827956989247
1117,2461,애초/Noun,93,30,63,0.00035567411359342004,0.0007219174126479931,0.6774193548387096
1118,2462,반대/Noun,93,32,61,0.00037790374569300877,0.0006997045691819009,0.6559139784946236
1119,2463,거치다/Verb,93,61,32,0.0007002334111370457,0.0003776183389235656,0.6559139784946236
1120,2473,수입/Noun,92,12,80,0.00015560742469712126,0.000910726582109776,0.8695652173913043
1121,2474,처절하다/Adjective,92,74,18,0.0008447260197843727,0.00022212843466092096,0.8043478260869565
1122,2475,딴/Modifier,92,19,73,0.0002334111370456819,0.0008329816299784535,0.7934782608695652
1123,2476,컨셉/Noun,92,20,72,0.00024452595309547634,0.0008218752082454075,0.7826086956521741
1124,2477,고프다/Adjective,92,71,21,0.0008113815716349895,0.0002554476998600591,0.7717391304347826
1125,2478,절/Noun,92,23,69,0.00027787040124485944,0.0007885559430462694,0.75
1126,2479,드디어/Adverb,92,68,24,0.0007780371234856063,0.0002887669650591972,0.7391304347826086
1127,2480,흥/Noun,92,66,26,0.0007558074913860174,0.00031097980852528933,0.7173913043478259
1128,2481,반드시/Noun,92,65,27,0.0007446926753362233,0.00032208623025833537,0.7065217391304348
1129,2482,진수/Noun,92,64,28,0.0007335778592864287,0.0003331926519913814,0.6956521739130435
1130,2495,웰/Noun,91,86,5,0.0009781038123819054,7.774495213132233e-05,0.9450549450549449
1131,2496,어우러지다/Verb,91,85,6,0.0009669889963321108,8.885137386436837e-05,0.934065934065934
1132,2497,만드/Noun,91,14,77,0.00017783705679671002,0.0008774073169106378,0.8461538461538461
1133,2498,혐오/Noun,91,15,76,0.00018895187284650438,0.0008663008951775916,0.8351648351648352
1134,2499,명대사/Noun,91,72,19,0.0008224963876847838,0.000233234856393967,0.7912087912087912
1135,2500,살인마/Noun,91,21,70,0.00025564076914527065,0.0007996623647793153,0.7692307692307693
1136,2501,실수/Noun,91,25,66,0.00030010003334444816,0.0007552366778471312,0.7252747252747253
1137,2502,베리/Noun,91,65,26,0.0007446926753362233,0.00031097980852528933,0.7142857142857143
1138,2503,비중/Noun,91,30,61,0.00035567411359342004,0.0006997045691819009,0.6703296703296703
1139,2504,무게/Noun,91,60,31,0.0006891185950872514,0.00036651191719051963,0.6593406593406593
1140,2505,잭/Noun,91,60,31,0.0006891185950872514,0.00036651191719051963,0.6593406593406593
1141,2506,붙다/Verb,91,31,60,0.00036678892964321435,0.0006885981474488549,0.6593406593406593
1142,2514,계기/Noun,90,72,18,0.0008224963876847838,0.00022212843466092096,0.8
1143,2515,논리/Noun,90,20,70,0.00024452595309547634,0.0007996623647793153,0.7777777777777778
1144,2516,최고봉/Noun,90,68,22,0.0007780371234856063,0.00026655412159310506,0.7555555555555555
1145,2517,운/Noun,90,65,25,0.0007446926753362233,0.0002998733867922433,0.7222222222222222
1146,2518,어떻/Modifier,90,25,65,0.00030010003334444816,0.0007441302561140852,0.7222222222222222
1147,2519,레/Noun,90,25,65,0.00030010003334444816,0.0007441302561140852,0.7222222222222222
1148,2520,암/Modifier,90,26,64,0.00031121484939424253,0.0007330238343810393,0.7111111111111111
1149,2521,매일/Noun,90,62,28,0.0007113482271868402,0.0003331926519913814,0.6888888888888889
1150,2522,쿡/Noun,90,30,60,0.00035567411359342004,0.0006885981474488549,0.6666666666666666
1151,2523,깍/Adverb,90,31,59,0.00036678892964321435,0.0006774917257158089,0.6555555555555556
1152,2524,및/Noun,90,31,59,0.00036678892964321435,0.0006774917257158089,0.6555555555555556
1153,2525,데뷔/Noun,90,59,31,0.0006780037790374569,0.00036651191719051963,0.6555555555555556
1154,2535,게뭐/Noun,89,7,82,0.0001000333444481494,0.000932939425575868,0.9213483146067416
1155,2536,감사/Noun,89,78,11,0.00088918528398355,0.0001443834825295986,0.8764044943820225
1156,2537,빨갱이/Noun,89,18,71,0.0002222963209958875,0.0008107687865123613,0.797752808988764
1157,2538,ㅉ/KoreanParticle,89,18,71,0.0002222963209958875,0.0008107687865123613,0.797752808988764
1158,2539,강력/Noun,89,70,19,0.0008002667555851951,0.000233234856393967,0.7865168539325843
1159,2540,아무튼/Adverb,89,62,27,0.0007113482271868402,0.00032208623025833537,0.6966292134831461
1160,2541,섞다/Verb,89,28,61,0.0003334444814938313,0.0006997045691819009,0.6853932584269663
1161,2542,박중훈/Noun,89,58,31,0.0006668889629876625,0.00036651191719051963,0.651685393258427
1162,2543,폭발/Noun,89,58,31,0.0006668889629876625,0.00036651191719051963,0.651685393258427
1163,2557,개그맨/Noun,88,4,84,6.668889629876625e-05,0.00095515226904196,0.9545454545454546
1164,2558,마음속/Noun,88,83,5,0.0009447593642325221,7.774495213132233e-05,0.9431818181818182
1165,2559,ㅄ/KoreanParticle,88,15,73,0.00018895187284650438,0.0008329816299784535,0.8295454545454546
1166,2560,동심/Noun,88,64,24,0.0007335778592864287,0.0002887669650591972,0.7272727272727273
1167,2561,폴/Noun,88,64,24,0.0007335778592864287,0.0002887669650591972,0.7272727272727273
1168,2562,피해/Noun,88,24,64,0.0002889852172946538,0.0007330238343810393,0.7272727272727273
1169,2563,에이/Noun,88,26,62,0.00031121484939424253,0.000710810990914947,0.7045454545454546
1170,2564,만화책/Noun,88,26,62,0.00031121484939424253,0.000710810990914947,0.7045454545454546
1171,2565,?.../Punctuation,88,30,58,0.00035567411359342004,0.0006663853039827628,0.6590909090909091
1172,2577,♥♥♥/Foreign,87,86,1,0.0009781038123819054,3.331926519913814e-05,0.9885057471264368
1173,2578,어거지/Noun,87,8,79,0.00011114816049794375,0.0008996201603767299,0.9080459770114944
1174,2579,난잡하다/Adjective,87,8,79,0.00011114816049794375,0.0008996201603767299,0.9080459770114944
1175,2580,발음/Noun,87,17,70,0.00021118150494609317,0.0007996623647793153,0.8045977011494253
1176,2581,듣기/Noun,87,21,66,0.00025564076914527065,0.0007552366778471312,0.7586206896551724
1177,2582,친/Noun,87,25,62,0.00030010003334444816,0.000710810990914947,0.7126436781609196
1178,2583,무한/Noun,87,60,27,0.0006891185950872514,0.00032208623025833537,0.6896551724137931
1179,2596,토나오다/Verb,86,4,82,6.668889629876625e-05,0.000932939425575868,0.9534883720930232
1180,2597,별하나/Noun,86,4,82,6.668889629876625e-05,0.000932939425575868,0.9534883720930232
1181,2598,다세포/Noun,86,8,78,0.00011114816049794375,0.0008885137386436838,0.9069767441860463
1182,2599,개콘/Noun,86,9,77,0.00012226297654773814,0.0008774073169106378,0.8953488372093024
1183,2600,황당/Noun,86,9,77,0.00012226297654773814,0.0008774073169106378,0.8953488372093024
1184,2601,영화감독/Noun,86,14,72,0.00017783705679671002,0.0008218752082454075,0.8372093023255814
1185,2602,언니/Suffix,86,70,16,0.0008002667555851951,0.00019991559119482882,0.813953488372093
1186,2603,최소한/Noun,86,18,68,0.0002222963209958875,0.0007774495213132232,0.7906976744186046
1187,2604,컴퓨터/Noun,86,20,66,0.00024452595309547634,0.0007552366778471312,0.7674418604651163
1188,2605,경우/Noun,86,27,59,0.00032232966544403684,0.0006774917257158089,0.686046511627907
1189,2606,해리포터/Noun,86,57,29,0.0006557741469378681,0.00034429907372442745,0.6627906976744186
1190,2607,추/Noun,86,56,30,0.0006446593308880737,0.0003554054954574735,0.6511627906976745
1191,2608,나레이션/Noun,86,30,56,0.00035567411359342004,0.0006441724605166707,0.6511627906976745
1192,2621,겉멋/Noun,85,7,78,0.0001000333444481494,0.0008885137386436838,0.9176470588235294
1193,2622,싫어지다/Adjective,85,9,76,0.00012226297654773814,0.0008663008951775916,0.8941176470588236
1194,2623,압도/Noun,85,75,10,0.0008558408358341669,0.00013327706079655256,0.8823529411764706
1195,2624,담담하다/Adjective,85,71,14,0.0008113815716349895,0.00017770274772873674,0.8352941176470589
1196,2625,누군지/Adverb,85,21,64,0.00025564076914527065,0.0007330238343810393,0.7529411764705882
1197,2626,딱/VerbPrefix,85,23,62,0.00027787040124485944,0.000710810990914947,0.7294117647058823
1198,2627,정말/Exclamation,85,60,25,0.0006891185950872514,0.0002998733867922433,0.7058823529411765
1199,2628,여인/Noun,85,57,28,0.0006557741469378681,0.0003331926519913814,0.6705882352941176
1200,2636,깨알/Noun,84,76,8,0.0008669556518839612,0.00011106421733046048,0.9047619047619048
1201,2637,민폐/Noun,84,11,73,0.0001444926086473269,0.0008329816299784535,0.8690476190476191
1202,2638,쓸데없다/Adjective,84,14,70,0.00017783705679671002,0.0007996623647793153,0.8333333333333334
1203,2639,부리다/Verb,84,17,67,0.00021118150494609317,0.0007663430995801773,0.7976190476190477
1204,2640,이루어지다/Verb,84,66,18,0.0007558074913860174,0.00022212843466092096,0.7857142857142857
1205,2641,--/Punctuation,84,19,65,0.0002334111370456819,0.0007441302561140852,0.7738095238095238
1206,2642,어쩌면/Noun,84,62,22,0.0007113482271868402,0.00026655412159310506,0.7380952380952381
1207,2643,임창정/Noun,84,58,26,0.0006668889629876625,0.00031097980852528933,0.6904761904761905
1208,2644,화일/Noun,84,26,58,0.00031121484939424253,0.0006663853039827628,0.6904761904761905
1209,2654,..!/Punctuation,83,74,9,0.0008447260197843727,0.00012217063906350652,0.891566265060241
1210,2655,흉내/Noun,83,11,72,0.0001444926086473269,0.0008218752082454075,0.8674698795180723
1211,2656,달콤하다/Adjective,83,68,15,0.0007780371234856063,0.0001888091694617828,0.8192771084337349
1212,2657,방해/Noun,83,18,65,0.0002222963209958875,0.0007441302561140852,0.7831325301204819
1213,2658,김치/Noun,83,22,61,0.000266755585195065,0.0006997045691819009,0.7349397590361446
1214,2659,분량/Noun,83,25,58,0.00030010003334444816,0.0006663853039827628,0.6987951807228916
1215,2660,향수/Noun,83,57,26,0.0006557741469378681,0.00031097980852528933,0.6867469879518072
1216,2661,코메디/Noun,83,27,56,0.00032232966544403684,0.0006441724605166707,0.6746987951807228
1217,2662,사/Noun,83,56,27,0.0006446593308880737,0.00032208623025833537,0.6746987951807228
1218,2672,명복/Noun,82,74,8,0.0008447260197843727,0.00011106421733046048,0.902439024390244
1219,2673,거품/Noun,82,12,70,0.00015560742469712126,0.0007996623647793153,0.8536585365853658
1220,2674,동영상/Noun,82,12,70,0.00015560742469712126,0.0007996623647793153,0.8536585365853658
1221,2675,고뇌/Noun,82,57,25,0.0006557741469378681,0.0002998733867922433,0.6951219512195121
1222,2676,늘리다/Verb,82,25,57,0.00030010003334444816,0.0006552788822497168,0.6951219512195121
1223,2677,능/Noun,82,55,27,0.0006335445148382794,0.00032208623025833537,0.6707317073170732
1224,2693,탁월하다/Adjective,81,73,8,0.0008336112037345782,0.00011106421733046048,0.9012345679012346
1225,2694,도데/Noun,81,8,73,0.00011114816049794375,0.0008329816299784535,0.9012345679012346
1226,2695,짜리/Foreign,81,12,69,0.00015560742469712126,0.0007885559430462694,0.8518518518518519
1227,2696,속지/Noun,81,13,68,0.00016672224074691566,0.0007774495213132232,0.8395061728395061
1228,2697,역량/Noun,81,13,68,0.00016672224074691566,0.0007774495213132232,0.8395061728395061
1229,2698,배급사/Noun,81,15,66,0.00018895187284650438,0.0007552366778471312,0.8148148148148148
1230,2699,징그럽다/Adjective,81,17,64,0.00021118150494609317,0.0007330238343810393,0.7901234567901234
1231,2700,이해도/Noun,81,17,64,0.00021118150494609317,0.0007330238343810393,0.7901234567901234
1232,2701,염/Noun,81,60,21,0.0006891185950872514,0.0002554476998600591,0.7407407407407407
1233,2702,몽환/Noun,81,59,22,0.0006780037790374569,0.00026655412159310506,0.7283950617283951
1234,2703,박다/Verb,81,22,59,0.000266755585195065,0.0006774917257158089,0.7283950617283951
1235,2704,짜이다/Verb,81,56,25,0.0006446593308880737,0.0002998733867922433,0.6913580246913579
1236,2705,약/Modifier,81,26,55,0.00031121484939424253,0.0006330660387836247,0.6790123456790124
1237,2706,그렇지만/Conjunction,81,55,26,0.0006335445148382794,0.00031097980852528933,0.6790123456790124
1238,2707,옴/Noun,81,26,55,0.00031121484939424253,0.0006330660387836247,0.6790123456790124
1239,2722,담백하다/Adjective,80,75,5,0.0008558408358341669,7.774495213132233e-05,0.9375
1240,2723,삶다/Verb,80,68,12,0.0007780371234856063,0.00015548990426264466,0.85
1241,2724,가히/Adverb,80,68,12,0.0007780371234856063,0.00015548990426264466,0.85
1242,2725,지리다/Verb,80,63,17,0.0007224630432366343,0.0002110220129278749,0.7875
1243,2726,킬링/Noun,80,22,58,0.000266755585195065,0.0006663853039827628,0.725
1244,2727,장점/Noun,80,23,57,0.00027787040124485944,0.0006552788822497168,0.7125
1245,2728,등록/Noun,80,23,57,0.00027787040124485944,0.0006552788822497168,0.7125
1246,2729,망가지다/Verb,80,26,54,0.00031121484939424253,0.0006219596170505788,0.675
1247,2730,하정우/Noun,80,53,27,0.0006113148827386907,0.00032208623025833537,0.6625
1248,2744,완벽/Noun,79,71,8,0.0008113815716349895,0.00011106421733046048,0.8987341772151899
1249,2745,그럴듯하다/Adjective,79,8,71,0.00011114816049794375,0.0008107687865123613,0.8987341772151899
1250,2746,의외/Noun,79,65,14,0.0007446926753362233,0.00017770274772873674,0.8227848101265823
1251,2747,딱/Modifier,79,16,63,0.0002000666888962988,0.0007219174126479931,0.7974683544303798
1252,2748,분장/Noun,79,17,62,0.00021118150494609317,0.000710810990914947,0.7848101265822784
1253,2749,언젠가/Adverb,79,59,20,0.0006780037790374569,0.00024434127812701304,0.7468354430379747
1254,2750,파다/Verb,79,24,55,0.0002889852172946538,0.0006330660387836247,0.6962025316455697
1255,2751,샘/Noun,79,53,26,0.0006113148827386907,0.00031097980852528933,0.6708860759493671
1256,2752,중딩/Noun,79,27,52,0.00032232966544403684,0.0005997467735844866,0.6582278481012658
1257,2753,정상/Noun,79,27,52,0.00032232966544403684,0.0005997467735844866,0.6582278481012658
1258,2762,위트/Noun,78,66,12,0.0007558074913860174,0.00015548990426264466,0.8461538461538461
1259,2763,치유/Noun,78,66,12,0.0007558074913860174,0.00015548990426264466,0.8461538461538461
1260,2764,아치/Noun,78,14,64,0.00017783705679671002,0.0007330238343810393,0.8205128205128205
1261,2765,만도/Josa,78,15,63,0.00018895187284650438,0.0007219174126479931,0.8076923076923077
1262,2766,애절하다/Adjective,78,62,16,0.0007113482271868402,0.00019991559119482882,0.7948717948717948
1263,2767,알려지다/Verb,78,58,20,0.0006668889629876625,0.00024434127812701304,0.7435897435897436
1264,2768,이구만/Josa,78,20,58,0.00024452595309547634,0.0006663853039827628,0.7435897435897436
1265,2769,왜곡/Noun,78,22,56,0.000266755585195065,0.0006441724605166707,0.7179487179487181
1266,2770,상어/Noun,78,25,53,0.00030010003334444816,0.0006108531953175326,0.6794871794871795
1267,2771,절망/Noun,78,53,25,0.0006113148827386907,0.0002998733867922433,0.6794871794871795
1268,2785,뒤죽박죽/Noun,77,9,68,0.00012226297654773814,0.0007774495213132232,0.8831168831168831
1269,2786,절제/Noun,77,64,13,0.0007335778592864287,0.0001665963259956907,0.8311688311688312
1270,2787,소화/Noun,77,62,15,0.0007113482271868402,0.0001888091694617828,0.8051948051948052
1271,2788,떠올리다/Verb,77,62,15,0.0007113482271868402,0.0001888091694617828,0.8051948051948052
1272,2789,찬양/Noun,77,19,58,0.0002334111370456819,0.0006663853039827628,0.7532467532467533
1273,2790,내일/Noun,77,56,21,0.0006446593308880737,0.0002554476998600591,0.7272727272727273
1274,2791,닥/Noun,77,21,56,0.00025564076914527065,0.0006441724605166707,0.7272727272727273
1275,2792,난무/Noun,77,22,55,0.000266755585195065,0.0006330660387836247,0.7142857142857143
1276,2793,낼/Noun,77,53,24,0.0006113148827386907,0.0002887669650591972,0.6883116883116883
1277,2806,매미/Noun,76,4,72,6.668889629876625e-05,0.0008218752082454075,0.9473684210526316
1278,2807,뜬금없이/Adverb,76,4,72,6.668889629876625e-05,0.0008218752082454075,0.9473684210526316
1279,2808,미스/Noun,76,13,63,0.00016672224074691566,0.0007219174126479931,0.8289473684210527
1280,2809,욕먹다/Verb,76,13,63,0.00016672224074691566,0.0007219174126479931,0.8289473684210527
1281,2810,보임/Noun,76,16,60,0.0002000666888962988,0.0006885981474488549,0.7894736842105263
1282,2811,버티다/Verb,76,17,59,0.00021118150494609317,0.0006774917257158089,0.7763157894736842
1283,2812,전성기/Noun,76,59,17,0.0006780037790374569,0.0002110220129278749,0.7763157894736842
1284,2813,ㅎㄷㄷ/KoreanParticle,76,55,21,0.0006335445148382794,0.0002554476998600591,0.7236842105263158
1285,2814,범/Noun,76,22,54,0.000266755585195065,0.0006219596170505788,0.7105263157894737
1286,2815,달라지다/Verb,76,53,23,0.0006113148827386907,0.00027766054332615115,0.6973684210526315
1287,2816,리가/Noun,76,24,52,0.0002889852172946538,0.0005997467735844866,0.6842105263157895
1288,2817,년도/Noun,76,25,51,0.00030010003334444816,0.0005886403518514405,0.6710526315789473
1289,2818,각자/Noun,76,50,26,0.0005779704345893076,0.00031097980852528933,0.6578947368421053
1290,2819,그대/Noun,76,50,26,0.0005779704345893076,0.00031097980852528933,0.6578947368421053
1291,2834,과대/Noun,75,5,70,7.780371234856063e-05,0.0007996623647793153,0.9333333333333332
1292,2835,도중/Noun,75,7,68,0.0001000333444481494,0.0007774495213132232,0.9066666666666666
1293,2836,따분하다/Adjective,75,8,67,0.00011114816049794375,0.0007663430995801773,0.8933333333333333
1294,2837,여신/Noun,75,61,14,0.0007002334111370457,0.00017770274772873674,0.8133333333333334
1295,2838,낭만/Noun,75,57,18,0.0006557741469378681,0.00022212843466092096,0.76
1296,2839,선사/Noun,75,54,21,0.0006224296987884852,0.0002554476998600591,0.72
1297,2840,꺼지다/Verb,75,24,51,0.0002889852172946538,0.0005886403518514405,0.68
1298,2841,폭풍/Noun,75,51,24,0.000589085250639102,0.0002887669650591972,0.68
1299,2842,공룡/Noun,75,26,49,0.00031121484939424253,0.0005664275083853486,0.6533333333333333
1300,2843,급하다/Adjective,75,26,49,0.00031121484939424253,0.0005664275083853486,0.6533333333333333
1301,2858,바닥/Noun,74,9,65,0.00012226297654773814,0.0007441302561140852,0.8783783783783784
1302,2859,졸업/Noun,74,14,60,0.00017783705679671002,0.0006885981474488549,0.8108108108108109
1303,2860,어지럽다/Adjective,74,16,58,0.0002000666888962988,0.0006663853039827628,0.7837837837837838
1304,2861,EBS/Alpha,74,57,17,0.0006557741469378681,0.0002110220129278749,0.7702702702702703
1305,2862,끊기다/Verb,74,17,57,0.00021118150494609317,0.0006552788822497168,0.7702702702702703
1306,2863,웬/Noun,74,19,55,0.0002334111370456819,0.0006330660387836247,0.7432432432432432
1307,2864,지나/Noun,74,53,21,0.0006113148827386907,0.0002554476998600591,0.7162162162162162
1308,2865,딸리다/Verb,74,22,52,0.000266755585195065,0.0005997467735844866,0.7027027027027027
1309,2866,드니/Noun,74,51,23,0.000589085250639102,0.00027766054332615115,0.6891891891891891
1310,2867,한가지/Noun,74,23,51,0.00027787040124485944,0.0005886403518514405,0.6891891891891891
1311,2868,거짓/Noun,74,24,50,0.0002889852172946538,0.0005775339301183945,0.6756756756756757
1312,2869,송강호/Noun,74,50,24,0.0005779704345893076,0.0002887669650591972,0.6756756756756757
1313,2870,재난/Noun,74,25,49,0.00030010003334444816,0.0005664275083853486,0.6621621621621622
1314,2871,워낙/Noun,74,49,25,0.0005668556185395131,0.0002998733867922433,0.6621621621621622
1315,2889,애잔하다/Adjective,73,69,4,0.0007891519395354007,6.663853039827628e-05,0.9452054794520548
1316,2890,애매하다/Adjective,73,12,61,0.00015560742469712126,0.0006997045691819009,0.8356164383561644
1317,2891,이별/Noun,73,57,16,0.0006557741469378681,0.00019991559119482882,0.7808219178082192
1318,2892,쟁이/Suffix,73,19,54,0.0002334111370456819,0.0006219596170505788,0.7397260273972602
1319,2893,쌍/Noun,73,21,52,0.00025564076914527065,0.0005997467735844866,0.7123287671232876
1320,2894,부인/Noun,73,21,52,0.00025564076914527065,0.0005997467735844866,0.7123287671232876
1321,2895,원숭이/Noun,73,22,51,0.000266755585195065,0.0005886403518514405,0.6986301369863014
1322,2896,단편/Noun,73,22,51,0.000266755585195065,0.0005886403518514405,0.6986301369863014
1323,2897,시종일관/Noun,73,22,51,0.000266755585195065,0.0005886403518514405,0.6986301369863014
1324,2898,깡패/Noun,73,23,50,0.00027787040124485944,0.0005775339301183945,0.6849315068493149
1325,2899,신하균/Noun,73,50,23,0.0005779704345893076,0.00027766054332615115,0.6849315068493149
1326,2900,본격/Noun,73,23,50,0.00027787040124485944,0.0005775339301183945,0.6849315068493149
1327,2901,에서나/Josa,73,24,49,0.0002889852172946538,0.0005664275083853486,0.6712328767123288
1328,2902,광기/Noun,73,49,24,0.0005668556185395131,0.0002887669650591972,0.6712328767123288
1329,2903,처리/Noun,73,25,48,0.00030010003334444816,0.0005553210866523023,0.6575342465753424
1330,2904,만세/Noun,73,48,25,0.0005557408024897189,0.0002998733867922433,0.6575342465753424
1331,2921,답답/Noun,72,2,70,4.445926419917751e-05,0.0007996623647793153,0.9722222222222222
1332,2922,Good/Alpha,72,69,3,0.0007891519395354007,5.553210866523024e-05,0.9583333333333334
1333,2923,어색/Noun,72,3,69,5.5574080248971876e-05,0.0007885559430462694,0.9583333333333334
1334,2924,명불허전/Noun,72,64,8,0.0007335778592864287,0.00011106421733046048,0.8888888888888888
1335,2925,비록/Noun,72,64,8,0.0007335778592864287,0.00011106421733046048,0.8888888888888888
1336,2926,애틋하다/Adjective,72,61,11,0.0007002334111370457,0.0001443834825295986,0.8472222222222222
1337,2927,광구/Noun,72,12,60,0.00015560742469712126,0.0006885981474488549,0.8333333333333334
1338,2928,쓴다/Verb,72,12,60,0.00015560742469712126,0.0006885981474488549,0.8333333333333334
1339,2929,짜릿하다/Adjective,72,59,13,0.0006780037790374569,0.0001665963259956907,0.8194444444444444
1340,2930,땀/Noun,72,58,14,0.0006668889629876625,0.00017770274772873674,0.8055555555555556
1341,2931,배꼽/Noun,72,58,14,0.0006668889629876625,0.00017770274772873674,0.8055555555555556
1342,2932,뎅/Noun,72,57,15,0.0006557741469378681,0.0001888091694617828,0.7916666666666666
1343,2933,누나/Suffix,72,56,16,0.0006446593308880737,0.00019991559119482882,0.7777777777777778
1344,2934,아무나/Noun,72,17,55,0.00021118150494609317,0.0006330660387836247,0.7638888888888888
1345,2935,기획/Noun,72,22,50,0.000266755585195065,0.0005775339301183945,0.6944444444444444
1346,2936,호흡/Noun,72,49,23,0.0005668556185395131,0.00027766054332615115,0.6805555555555556
1347,2937,고전/Modifier,72,49,23,0.0005668556185395131,0.00027766054332615115,0.6805555555555556
1348,2953,아마추어/Noun,71,5,66,7.780371234856063e-05,0.0007552366778471312,0.9295774647887324
1349,2954,케미/Noun,71,66,5,0.0007558074913860174,7.774495213132233e-05,0.9295774647887324
1350,2955,오글오글/Adverb,71,6,65,8.891852839835501e-05,0.0007441302561140852,0.9154929577464788
1351,2956,...^^/Punctuation,71,65,6,0.0007446926753362233,8.885137386436837e-05,0.9154929577464788
1352,2957,쓸쓸하다/Adjective,71,63,8,0.0007224630432366343,0.00011106421733046048,0.8873239436619719
1353,2958,15년/Number,71,60,11,0.0006891185950872514,0.0001443834825295986,0.8450704225352113
1354,2959,고인/Noun,71,60,11,0.0006891185950872514,0.0001443834825295986,0.8450704225352113
1355,2960,데리다/Verb,71,12,59,0.00015560742469712126,0.0006774917257158089,0.8309859154929577
1356,2961,제작자/Noun,71,12,59,0.00015560742469712126,0.0006774917257158089,0.8309859154929577
1357,2962,정점/Noun,71,55,16,0.0006335445148382794,0.00019991559119482882,0.7746478873239436
1358,2963,상식/Noun,71,16,55,0.0002000666888962988,0.0006330660387836247,0.7746478873239436
1359,2964,명장/Noun,71,52,19,0.0006002000666888963,0.000233234856393967,0.7323943661971831
1360,2965,ㅜㅠ/KoreanParticle,71,50,21,0.0005779704345893076,0.0002554476998600591,0.7042253521126759
1361,2966,고증/Noun,71,21,50,0.00025564076914527065,0.0005775339301183945,0.7042253521126759
1362,2967,괴롭다/Adjective,71,22,49,0.000266755585195065,0.0005664275083853486,0.6901408450704225
1363,2984,진창/Noun,70,4,66,6.668889629876625e-05,0.0007552366778471312,0.9428571428571428
1364,2985,돌려주다/Verb,70,6,64,8.891852839835501e-05,0.0007330238343810393,0.9142857142857144
1365,2986,찬사/Noun,70,61,9,0.0007002334111370457,0.00012217063906350652,0.8714285714285714
1366,2987,you/Alpha,70,59,11,0.0006780037790374569,0.0001443834825295986,0.8428571428571429
1367,2988,일반인/Noun,70,11,59,0.0001444926086473269,0.0006774917257158089,0.8428571428571429
1368,2989,의심스럽다/Adjective,70,11,59,0.0001444926086473269,0.0006774917257158089,0.8428571428571429
1369,2990,티나/Noun,70,14,56,0.00017783705679671002,0.0006441724605166707,0.8
1370,2991,피아노/Noun,70,56,14,0.0006446593308880737,0.00017770274772873674,0.8
1371,2992,이기도/Josa,70,55,15,0.0006335445148382794,0.0001888091694617828,0.7857142857142857
1372,2993,90분/Number,70,15,55,0.00018895187284650438,0.0006330660387836247,0.7857142857142857
1373,2994,미스터리/Noun,70,17,53,0.00021118150494609317,0.0006108531953175326,0.7571428571428571
1374,2995,믿음/Noun,70,52,18,0.0006002000666888963,0.00022212843466092096,0.7428571428571429
1375,2996,디테일/Noun,70,50,20,0.0005779704345893076,0.00024434127812701304,0.7142857142857143
1376,2997,닥치고/Noun,70,49,21,0.0005668556185395131,0.0002554476998600591,0.7
1377,2998,위험하다/Adjective,70,22,48,0.000266755585195065,0.0005553210866523023,0.6857142857142857
1378,2999,멜로영화/Noun,70,46,24,0.00053351117039013,0.0002887669650591972,0.6571428571428571
1379,3000,오로지/Adverb,70,24,46,0.0002889852172946538,0.0005331082431862101,0.6571428571428571
1380,3001,스필버그/Noun,70,46,24,0.00053351117039013,0.0002887669650591972,0.6571428571428571
1381,3002,놀란/Noun,70,46,24,0.00053351117039013,0.0002887669650591972,0.6571428571428571
1382,3018,수면제/Noun,69,3,66,5.5574080248971876e-05,0.0007552366778471312,0.9565217391304348
1383,3019,짬뽕/Noun,69,4,65,6.668889629876625e-05,0.0007441302561140852,0.9420289855072465
1384,3020,비호감/Noun,69,7,62,0.0001000333444481494,0.000710810990914947,0.8985507246376812
1385,3021,명연기/Noun,69,61,8,0.0007002334111370457,0.00011106421733046048,0.8840579710144928
1386,3022,꿀/Noun,69,61,8,0.0007002334111370457,0.00011106421733046048,0.8840579710144928
1387,3023,국어/Noun,69,9,60,0.00012226297654773814,0.0006885981474488549,0.8695652173913043
1388,3024,전문/Noun,69,13,56,0.00016672224074691566,0.0006441724605166707,0.8115942028985508
1389,3025,많아지다/Verb,69,55,14,0.0006335445148382794,0.00017770274772873674,0.7971014492753623
1390,3026,순수/Noun,69,54,15,0.0006224296987884852,0.0001888091694617828,0.7826086956521741
1391,3027,초월/Noun,69,53,16,0.0006113148827386907,0.00019991559119482882,0.7681159420289855
1392,3028,연관/Noun,69,16,53,0.0002000666888962988,0.0006108531953175326,0.7681159420289855
1393,3029,출연자/Noun,69,17,52,0.00021118150494609317,0.0005997467735844866,0.7536231884057971
1394,3030,저지르다/Verb,69,18,51,0.0002222963209958875,0.0005886403518514405,0.7391304347826086
1395,3031,혁명/Noun,69,50,19,0.0005779704345893076,0.000233234856393967,0.7246376811594203
1396,3032,하나님/Noun,69,48,21,0.0005557408024897189,0.0002554476998600591,0.6956521739130435
1397,3033,마찬가지/Noun,69,21,48,0.00025564076914527065,0.0005553210866523023,0.6956521739130435
1398,3034,스포츠/Noun,69,47,22,0.0005446259864399244,0.00026655412159310506,0.6811594202898551
1399,3035,가까이/Noun,69,47,22,0.0005446259864399244,0.00026655412159310506,0.6811594202898551
1400,3036,빌다/Verb,69,46,23,0.00053351117039013,0.00027766054332615115,0.6666666666666666
1401,3052,~~^^/Punctuation,68,65,3,0.0007446926753362233,5.553210866523024e-05,0.9558823529411764
1402,3053,유아/Noun,68,8,60,0.00011114816049794375,0.0006885981474488549,0.8823529411764706
1403,3054,게스트/Noun,68,10,58,0.0001333777925975325,0.0006663853039827628,0.8529411764705882
1404,3055,대박나다/Verb,68,58,10,0.0006668889629876625,0.00013327706079655256,0.8529411764705882
1405,3056,알파/Noun,68,56,12,0.0006446593308880737,0.00015548990426264466,0.8235294117647058
1406,3057,세대/Noun,68,54,14,0.0006224296987884852,0.00017770274772873674,0.7941176470588235
1407,3058,즐거움/Noun,68,53,15,0.0006113148827386907,0.0001888091694617828,0.7794117647058824
1408,3059,고문/Noun,68,15,53,0.00018895187284650438,0.0006108531953175326,0.7794117647058824
1409,3060,연습/Noun,68,16,52,0.0002000666888962988,0.0005997467735844866,0.7647058823529411
1410,3061,40분/Number,68,16,52,0.0002000666888962988,0.0005997467735844866,0.7647058823529411
1411,3062,숨막히다/Adjective,68,52,16,0.0006002000666888963,0.00019991559119482882,0.7647058823529411
1412,3063,무식하다/Adjective,68,17,51,0.00021118150494609317,0.0005886403518514405,0.75
1413,3064,떡/Noun,68,19,49,0.0002334111370456819,0.0005664275083853486,0.7205882352941176
1414,3065,농담/Noun,68,19,49,0.0002334111370456819,0.0005664275083853486,0.7205882352941176
1415,3066,미스테리/Noun,68,19,49,0.0002334111370456819,0.0005664275083853486,0.7205882352941176
1416,3067,로빈/Noun,68,48,20,0.0005557408024897189,0.00024434127812701304,0.7058823529411765
1417,3068,미학/Noun,68,48,20,0.0005557408024897189,0.00024434127812701304,0.7058823529411765
1418,3069,뺏다/Verb,68,20,48,0.00024452595309547634,0.0005553210866523023,0.7058823529411765
1419,3070,쏟다/Verb,68,46,22,0.00053351117039013,0.00026655412159310506,0.6764705882352942
1420,3071,타란티노/Noun,68,45,23,0.0005223963543403357,0.00027766054332615115,0.6617647058823529
1421,3087,굿굿굿/Noun,67,67,0,0.0007669223074358119,2.2212843466092093e-05,1.0
1422,3088,부자연스럽다/Adjective,67,8,59,0.00011114816049794375,0.0006774917257158089,0.8805970149253731
1423,3089,~~!!/Punctuation,67,55,12,0.0006335445148382794,0.00015548990426264466,0.8208955223880597
1424,3090,강간/Noun,67,12,55,0.00015560742469712126,0.0006330660387836247,0.8208955223880597
1425,3091,뭣/Noun,67,15,52,0.00018895187284650438,0.0005997467735844866,0.7761194029850746
1426,3092,한동안/Adverb,67,51,16,0.000589085250639102,0.00019991559119482882,0.7611940298507462
1427,3093,까지만/Josa,67,16,51,0.0002000666888962988,0.0005886403518514405,0.7611940298507462
1428,3094,간지/Noun,67,50,17,0.0005779704345893076,0.0002110220129278749,0.746268656716418
1429,3095,외국인/Noun,67,18,49,0.0002222963209958875,0.0005664275083853486,0.7313432835820896
1430,3096,ㅈㄴ/KoreanParticle,67,18,49,0.0002222963209958875,0.0005664275083853486,0.7313432835820896
1431,3097,s/Alpha,67,47,20,0.0005446259864399244,0.00024434127812701304,0.7014925373134329
1432,3098,마저도/Josa,67,21,46,0.00025564076914527065,0.0005331082431862101,0.6865671641791045
1433,3099,칭찬/Noun,67,22,45,0.000266755585195065,0.0005220018214531642,0.6716417910447762
1434,3100,리도/Noun,67,22,45,0.000266755585195065,0.0005220018214531642,0.6716417910447762
1435,3101,유치원/Noun,67,22,45,0.000266755585195065,0.0005220018214531642,0.6716417910447762
1436,3102,권력/Noun,67,44,23,0.0005112815382905413,0.00027766054332615115,0.6567164179104478
1437,3115,떨어뜨리다/Verb,66,4,62,6.668889629876625e-05,0.000710810990914947,0.9393939393939394
1438,3116,칠하다/Adjective,66,8,58,0.00011114816049794375,0.0006663853039827628,0.8787878787878788
1439,3117,영구/Noun,66,10,56,0.0001333777925975325,0.0006441724605166707,0.8484848484848485
1440,3118,디카프리오/Noun,66,56,10,0.0006446593308880737,0.00013327706079655256,0.8484848484848485
1441,3119,콩/Noun,66,10,56,0.0001333777925975325,0.0006441724605166707,0.8484848484848485
1442,3120,화중/Noun,66,54,12,0.0006224296987884852,0.00015548990426264466,0.8181818181818182
1443,3121,한석규/Noun,66,54,12,0.0006224296987884852,0.00015548990426264466,0.8181818181818182
1444,3122,외롭다/Adjective,66,49,17,0.0005668556185395131,0.0002110220129278749,0.7424242424242424
1445,3123,머릿속/Noun,66,47,19,0.0005446259864399244,0.000233234856393967,0.7121212121212122
1446,3124,상징/Noun,66,45,21,0.0005223963543403357,0.0002554476998600591,0.6818181818181818
1447,3125,커서/Noun,66,44,22,0.0005112815382905413,0.00026655412159310506,0.6666666666666666
1448,3126,이따/Noun,66,23,43,0.00027787040124485944,0.0004997889779870722,0.6515151515151515
1449,3127,억울하다/Adjective,66,23,43,0.00027787040124485944,0.0004997889779870722,0.6515151515151515
1450,3142,빠순이/Noun,65,5,60,7.780371234856063e-05,0.0006885981474488549,0.9230769230769232
1451,3143,적당/Noun,65,9,56,0.00012226297654773814,0.0006441724605166707,0.8615384615384616
1452,3144,아우/Noun,65,10,55,0.0001333777925975325,0.0006330660387836247,0.8461538461538461
1453,3145,다시금/Noun,65,54,11,0.0006224296987884852,0.0001443834825295986,0.8307692307692308
1454,3146,마누라/Noun,65,12,53,0.00015560742469712126,0.0006108531953175326,0.8153846153846154
1455,3147,미스캐스팅/Noun,65,12,53,0.00015560742469712126,0.0006108531953175326,0.8153846153846154
1456,3148,올려주다/Verb,65,51,14,0.000589085250639102,0.00017770274772873674,0.7846153846153846
1457,3149,시체/Noun,65,16,49,0.0002000666888962988,0.0005664275083853486,0.7538461538461538
1458,3150,죄송하다/Adjective,65,17,48,0.00021118150494609317,0.0005553210866523023,0.7384615384615385
1459,3151,거임/Noun,65,18,47,0.0002222963209958875,0.0005442146649192564,0.7230769230769231
1460,3152,마다/Noun,65,45,20,0.0005223963543403357,0.00024434127812701304,0.6923076923076923
1461,3153,안쓰럽다/Adjective,65,22,43,0.000266755585195065,0.0004997889779870722,0.6615384615384615
1462,3154,차승원/Noun,65,43,22,0.0005001667222407468,0.00026655412159310506,0.6615384615384615
1463,3155,백인/Noun,65,22,43,0.000266755585195065,0.0004997889779870722,0.6615384615384615
1464,3168,역작/Noun,64,59,5,0.0006780037790374569,7.774495213132233e-05,0.921875
1465,3169,싱겁다/Adjective,64,7,57,0.0001000333444481494,0.0006552788822497168,0.890625
1466,3170,치노/Noun,64,53,11,0.0006113148827386907,0.0001443834825295986,0.828125
1467,3171,잘나가다/Verb,64,11,53,0.0001444926086473269,0.0006108531953175326,0.828125
1468,3172,뒤늦다/Adjective,64,52,12,0.0006002000666888963,0.00015548990426264466,0.8125
1469,3173,납득/Noun,64,12,52,0.00015560742469712126,0.0005997467735844866,0.8125
1470,3174,조차/Noun,64,13,51,0.00016672224074691566,0.0005886403518514405,0.796875
1471,3175,사람과/Noun,64,51,13,0.000589085250639102,0.0001665963259956907,0.796875
1472,3176,클래식/Noun,64,50,14,0.0005779704345893076,0.00017770274772873674,0.78125
1473,3177,...!/Punctuation,64,48,16,0.0005557408024897189,0.00019991559119482882,0.75
1474,3178,재방/Noun,64,48,16,0.0005557408024897189,0.00019991559119482882,0.75
1475,3179,우드/Noun,64,48,16,0.0005557408024897189,0.00019991559119482882,0.75
1476,3180,두렵다/Adjective,64,48,16,0.0005557408024897189,0.00019991559119482882,0.75
1477,3181,떨리다/Verb,64,47,17,0.0005446259864399244,0.0002110220129278749,0.734375
1478,3182,차리다/Verb,64,17,47,0.00021118150494609317,0.0005442146649192564,0.734375
1479,3183,!!!!!!/Punctuation,64,47,17,0.0005446259864399244,0.0002110220129278749,0.734375
1480,3184,찍/Noun,64,18,46,0.0002222963209958875,0.0005331082431862101,0.71875
1481,3185,신화/Noun,64,46,18,0.00053351117039013,0.00022212843466092096,0.71875
1482,3186,난후/Noun,64,44,20,0.0005112815382905413,0.00024434127812701304,0.6875
1483,3187,발랄하다/Adjective,64,44,20,0.0005112815382905413,0.00024434127812701304,0.6875
1484,3188,스펙/Noun,64,43,21,0.0005001667222407468,0.0002554476998600591,0.671875
1485,3189,인걸/Josa,64,22,42,0.000266755585195065,0.0004886825562540262,0.65625
1486,3190,세계관/Noun,64,22,42,0.000266755585195065,0.0004886825562540262,0.65625
1487,3191,찌르다/Verb,64,22,42,0.000266755585195065,0.0004886825562540262,0.65625
1488,3204,4.44/Number,63,9,54,0.00012226297654773814,0.0006219596170505788,0.8571428571428571
1489,3205,-_-;;/Punctuation,63,9,54,0.00012226297654773814,0.0006219596170505788,0.8571428571428571
1490,3206,재앙/Noun,63,10,53,0.0001333777925975325,0.0006108531953175326,0.8412698412698413
1491,3207,해지/Noun,63,51,12,0.000589085250639102,0.00015548990426264466,0.8095238095238095
1492,3208,다치다/Verb,63,16,47,0.0002000666888962988,0.0005442146649192564,0.7460317460317459
1493,3209,허무/Noun,63,16,47,0.0002000666888962988,0.0005442146649192564,0.7460317460317459
1494,3210,앙/Adverb,63,45,18,0.0005223963543403357,0.00022212843466092096,0.7142857142857143
1495,3211,승부/Noun,63,18,45,0.0002222963209958875,0.0005220018214531642,0.7142857142857143
1496,3212,김희선/Noun,63,20,43,0.00024452595309547634,0.0004997889779870722,0.6825396825396826
1497,3213,벌어지다/Verb,63,42,21,0.0004890519061909527,0.0002554476998600591,0.6666666666666666
1498,3214,첨으로/Adverb,63,22,41,0.000266755585195065,0.00047757613452098,0.6507936507936508
1499,3215,만화가/Noun,63,22,41,0.000266755585195065,0.00047757613452098,0.6507936507936508
1500,3231,bb/Alpha,62,59,3,0.0006780037790374569,5.553210866523024e-05,0.9516129032258064
1501,3232,에로물/Noun,62,6,56,8.891852839835501e-05,0.0006441724605166707,0.9032258064516128
1502,3233,살때/Noun,62,54,8,0.0006224296987884852,0.00011106421733046048,0.8709677419354839
1503,3234,알바생/Noun,62,8,54,0.00011114816049794375,0.0006219596170505788,0.8709677419354839
1504,3235,벅차다/Adjective,62,53,9,0.0006113148827386907,0.00012217063906350652,0.8548387096774194
1505,3236,로운/Josa,62,51,11,0.000589085250639102,0.0001443834825295986,0.8225806451612904
1506,3237,^-^/Punctuation,62,50,12,0.0005779704345893076,0.00015548990426264466,0.8064516129032258
1507,3238,꼽/Noun,62,49,13,0.0005668556185395131,0.0001665963259956907,0.7903225806451613
1508,3239,관대하다/Adjective,62,14,48,0.00017783705679671002,0.0005553210866523023,0.7741935483870968
1509,3240,뿌리다/Verb,62,14,48,0.00017783705679671002,0.0005553210866523023,0.7741935483870968
1510,3241,페이크/Noun,62,14,48,0.00017783705679671002,0.0005553210866523023,0.7741935483870968
1511,3242,망치/Noun,62,16,46,0.0002000666888962988,0.0005331082431862101,0.7419354838709677
1512,3243,올레/Noun,62,16,46,0.0002000666888962988,0.0005331082431862101,0.7419354838709677
1513,3244,강요/Noun,62,16,46,0.0002000666888962988,0.0005331082431862101,0.7419354838709677
1514,3245,밀다/Verb,62,17,45,0.00021118150494609317,0.0005220018214531642,0.7258064516129032
1515,3246,다섯/Determiner,62,45,17,0.0005223963543403357,0.0002110220129278749,0.7258064516129032
1516,3247,짜내다/Verb,62,18,44,0.0002222963209958875,0.0005108953997201182,0.7096774193548387
1517,3248,가짜/Noun,62,19,43,0.0002334111370456819,0.0004997889779870722,0.6935483870967742
1518,3249,소품/Noun,62,20,42,0.00024452595309547634,0.0004886825562540262,0.6774193548387096
1519,3250,아담/Noun,62,42,20,0.0004890519061909527,0.00024434127812701304,0.6774193548387096
1520,3251,다녀오다/Verb,62,42,20,0.0004890519061909527,0.00024434127812701304,0.6774193548387096
1521,3252,만난/Noun,62,41,21,0.0004779370901411582,0.0002554476998600591,0.6612903225806451
1522,3253,원조/Noun,62,41,21,0.0004779370901411582,0.0002554476998600591,0.6612903225806451
1523,3254,구석/Noun,62,21,41,0.00025564076914527065,0.00047757613452098,0.6612903225806451
1524,3273,두고두고/Noun,61,55,6,0.0006335445148382794,8.885137386436837e-05,0.9016393442622952
1525,3274,짱짱맨/Noun,61,52,9,0.0006002000666888963,0.00012217063906350652,0.8524590163934426
1526,3275,관리/Noun,61,11,50,0.0001444926086473269,0.0005775339301183945,0.819672131147541
1527,3276,창피하다/Adjective,61,12,49,0.00015560742469712126,0.0005664275083853486,0.8032786885245902
1528,3277,과도/Noun,61,15,46,0.00018895187284650438,0.0005331082431862101,0.7540983606557377
1529,3278,싸하다/Adjective,61,15,46,0.00018895187284650438,0.0005331082431862101,0.7540983606557377
1530,3279,남친/Noun,61,16,45,0.0002000666888962988,0.0005220018214531642,0.7377049180327869
1531,3280,공연/Noun,61,45,16,0.0005223963543403357,0.00019991559119482882,0.7377049180327869
1532,3281,떠들다/Verb,61,17,44,0.00021118150494609317,0.0005108953997201182,0.7213114754098361
1533,3282,방황/Noun,61,43,18,0.0005001667222407468,0.00022212843466092096,0.7049180327868853
1534,3283,덩어리/Noun,61,18,43,0.0002222963209958875,0.0004997889779870722,0.7049180327868853
1535,3284,태국/Noun,61,18,43,0.0002222963209958875,0.0004997889779870722,0.7049180327868853
1536,3285,밝혀지다/Verb,61,19,42,0.0002334111370456819,0.0004886825562540262,0.6885245901639344
1537,3286,톤/Noun,61,20,41,0.00024452595309547634,0.00047757613452098,0.6721311475409836
1538,3287,타인/Noun,61,41,20,0.0004779370901411582,0.00024434127812701304,0.6721311475409836
1539,3288,음향/Noun,61,20,41,0.00024452595309547634,0.00047757613452098,0.6721311475409836
1540,3289,볼라/Noun,61,21,40,0.00025564076914527065,0.000466469712787934,0.6557377049180327
1541,3290,지내다/Verb,61,40,21,0.0004668222740913638,0.0002554476998600591,0.6557377049180327
1542,3307,OOOO/Alpha,60,2,58,4.445926419917751e-05,0.0006663853039827628,0.9666666666666668
1543,3308,쯧쯧/Noun,60,3,57,5.5574080248971876e-05,0.0006552788822497168,0.95
1544,3309,모욕/Noun,60,4,56,6.668889629876625e-05,0.0006441724605166707,0.9333333333333332
1545,3310,홧팅/Noun,60,56,4,0.0006446593308880737,6.663853039827628e-05,0.9333333333333332
1546,3311,심사/Noun,60,5,55,7.780371234856063e-05,0.0006330660387836247,0.9166666666666666
1547,3312,울림/Noun,60,55,5,0.0006335445148382794,7.774495213132233e-05,0.9166666666666666
1548,3313,고독/Noun,60,51,9,0.000589085250639102,0.00012217063906350652,0.85
1549,3314,깨달음/Noun,60,49,11,0.0005668556185395131,0.0001443834825295986,0.8166666666666667
1550,3315,어째/Noun,60,12,48,0.00015560742469712126,0.0005553210866523023,0.8
1551,3316,상큼/Noun,60,48,12,0.0005557408024897189,0.00015548990426264466,0.8
1552,3317,..!!/Punctuation,60,47,13,0.0005446259864399244,0.0001665963259956907,0.7833333333333333
1553,3318,젊은이/Noun,60,47,13,0.0005446259864399244,0.0001665963259956907,0.7833333333333333
1554,3319,자랑/Noun,60,14,46,0.00017783705679671002,0.0005331082431862101,0.7666666666666667
1555,3320,맙시/Noun,60,15,45,0.00018895187284650438,0.0005220018214531642,0.75
1556,3321,짙다/Adjective,60,44,16,0.0005112815382905413,0.00019991559119482882,0.7333333333333333
1557,3322,ㅂ/KoreanParticle,60,18,42,0.0002222963209958875,0.0004886825562540262,0.7
1558,3323,사과/Noun,60,18,42,0.0002222963209958875,0.0004886825562540262,0.7
1559,3324,떄/Noun,60,41,19,0.0004779370901411582,0.000233234856393967,0.6833333333333333
1560,3325,신비/Noun,60,41,19,0.0004779370901411582,0.000233234856393967,0.6833333333333333
1561,3326,백배/Noun,60,40,20,0.0004668222740913638,0.00024434127812701304,0.6666666666666666
1562,3327,다이하드/Noun,60,21,39,0.00025564076914527065,0.000455363291054888,0.65
1563,3350,볼일/Noun,59,3,56,5.5574080248971876e-05,0.0006441724605166707,0.9491525423728814
1564,3351,미달/Noun,59,4,55,6.668889629876625e-05,0.0006330660387836247,0.9322033898305084
1565,3352,거북하다/Adjective,59,5,54,7.780371234856063e-05,0.0006219596170505788,0.9152542372881356
1566,3353,군더더기/Noun,59,54,5,0.0006224296987884852,7.774495213132233e-05,0.9152542372881356
1567,3354,bad/Alpha,59,5,54,7.780371234856063e-05,0.0006219596170505788,0.9152542372881356
1568,3355,모독/Noun,59,7,52,0.0001000333444481494,0.0005997467735844866,0.8813559322033898
1569,3356,폼/Noun,59,11,48,0.0001444926086473269,0.0005553210866523023,0.8135593220338984
1570,3357,먹기/Noun,59,11,48,0.0001444926086473269,0.0005553210866523023,0.8135593220338984
1571,3358,천사/Noun,59,48,11,0.0005557408024897189,0.0001443834825295986,0.8135593220338984
1572,3359,부담/Noun,59,46,13,0.00053351117039013,0.0001665963259956907,0.7796610169491526
1573,3360,엔딩크레딧/Noun,59,46,13,0.00053351117039013,0.0001665963259956907,0.7796610169491526
1574,3361,누님/Noun,59,45,14,0.0005223963543403357,0.00017770274772873674,0.7627118644067796
1575,3362,칠/Noun,59,14,45,0.00017783705679671002,0.0005220018214531642,0.7627118644067796
1576,3363,짓/VerbPrefix,59,15,44,0.00018895187284650438,0.0005108953997201182,0.7457627118644068
1577,3364,반감/Noun,59,15,44,0.00018895187284650438,0.0005108953997201182,0.7457627118644068
1578,3365,성형/Noun,59,16,43,0.0002000666888962988,0.0004997889779870722,0.7288135593220338
1579,3366,뉴스/Noun,59,17,42,0.00021118150494609317,0.0004886825562540262,0.7118644067796609
1580,3367,떡밥/Noun,59,18,41,0.0002222963209958875,0.00047757613452098,0.6949152542372882
1581,3368,인연/Noun,59,40,19,0.0004668222740913638,0.000233234856393967,0.6779661016949152
1582,3369,고작/Noun,59,19,40,0.0002334111370456819,0.000466469712787934,0.6779661016949152
1583,3370,눈치/Noun,59,19,40,0.0002334111370456819,0.000466469712787934,0.6779661016949152
1584,3395,새록새록/Noun,58,57,1,0.0006557741469378681,3.331926519913814e-05,0.9827586206896552
1585,3396,우롱/Noun,58,3,55,5.5574080248971876e-05,0.0006330660387836247,0.9482758620689656
1586,3397,개똥/Noun,58,4,54,6.668889629876625e-05,0.0006219596170505788,0.9310344827586208
1587,3398,진영화/Noun,58,53,5,0.0006113148827386907,7.774495213132233e-05,0.913793103448276
1588,3399,아기자기하다/Adjective,58,51,7,0.000589085250639102,9.995779559741441e-05,0.8793103448275862
1589,3400,렉/Noun,58,8,50,0.00011114816049794375,0.0005775339301183945,0.8620689655172413
1590,3401,기쁘다/Adjective,58,49,9,0.0005668556185395131,0.00012217063906350652,0.8448275862068966
1591,3402,남고/Noun,58,48,10,0.0005557408024897189,0.00013327706079655256,0.8275862068965517
1592,3403,문득/Noun,58,47,11,0.0005446259864399244,0.0001443834825295986,0.8103448275862069
1593,3404,성장하다/Adjective,58,44,14,0.0005112815382905413,0.00017770274772873674,0.7586206896551724
1594,3405,향기/Noun,58,44,14,0.0005112815382905413,0.00017770274772873674,0.7586206896551724
1595,3406,왕조현/Noun,58,43,15,0.0005001667222407468,0.0001888091694617828,0.7413793103448276
1596,3407,타이틀/Noun,58,15,43,0.00018895187284650438,0.0004997889779870722,0.7413793103448276
1597,3408,사이코/Noun,58,15,43,0.00018895187284650438,0.0004997889779870722,0.7413793103448276
1598,3409,벌/Noun,58,16,42,0.0002000666888962988,0.0004886825562540262,0.7241379310344828
1599,3410,기승/Noun,58,16,42,0.0002000666888962988,0.0004886825562540262,0.7241379310344828
1600,3411,습/Noun,58,41,17,0.0004779370901411582,0.0002110220129278749,0.7068965517241379
1601,3412,레이첼/Noun,58,40,18,0.0004668222740913638,0.00022212843466092096,0.6896551724137931
1602,3413,영활/Noun,58,18,40,0.0002222963209958875,0.000466469712787934,0.6896551724137931
1603,3414,".""/Punctuation",58,40,18,0.0004668222740913638,0.00022212843466092096,0.6896551724137931
1604,3415,디테/Noun,58,39,19,0.00045570745804156943,0.000233234856393967,0.6724137931034483
1605,3416,썩/Noun,58,19,39,0.0002334111370456819,0.000455363291054888,0.6724137931034483
1606,3417,피곤하다/Adjective,58,20,38,0.00024452595309547634,0.0004442568693218419,0.6551724137931034
1607,3418,어떠하다/Adjective,58,38,20,0.000444592641991775,0.00024434127812701304,0.6551724137931034
1608,3436,반도/Noun,57,2,55,4.445926419917751e-05,0.0006330660387836247,0.9649122807017544
1609,3437,커녕/Noun,57,3,54,5.5574080248971876e-05,0.0006219596170505788,0.9473684210526316
1610,3438,헛웃음/Noun,57,4,53,6.668889629876625e-05,0.0006108531953175326,0.9298245614035088
1611,3439,차분하다/Adjective,57,48,9,0.0005557408024897189,0.00012217063906350652,0.8421052631578947
1612,3440,어지간하다/Adjective,57,11,46,0.0001444926086473269,0.0005331082431862101,0.8070175438596491
1613,3441,압/Noun,57,46,11,0.00053351117039013,0.0001443834825295986,0.8070175438596491
1614,3442,학창시절/Noun,57,44,13,0.0005112815382905413,0.0001665963259956907,0.7719298245614035
1615,3443,더욱더/Noun,57,44,13,0.0005112815382905413,0.0001665963259956907,0.7719298245614035
1616,3444,주온/Noun,57,14,43,0.00017783705679671002,0.0004997889779870722,0.7543859649122807
1617,3445,적극/Noun,57,42,15,0.0004890519061909527,0.0001888091694617828,0.7368421052631579
1618,3446,새삼/Noun,57,41,16,0.0004779370901411582,0.00019991559119482882,0.7192982456140351
1619,3447,환자/Noun,57,18,39,0.0002222963209958875,0.000455363291054888,0.6842105263157895
1620,3448,쎄다/Adjective,57,18,39,0.0002222963209958875,0.000455363291054888,0.6842105263157895
1621,3449,미장센/Noun,57,38,19,0.000444592641991775,0.000233234856393967,0.6666666666666666
1622,3450,각각/Noun,57,38,19,0.000444592641991775,0.000233234856393967,0.6666666666666666
1623,3478,원주율/Noun,56,2,54,4.445926419917751e-05,0.0006219596170505788,0.9642857142857144
1624,3479,난국/Noun,56,2,54,4.445926419917751e-05,0.0006219596170505788,0.9642857142857144
1625,3480,묵직하다/Adjective,56,49,7,0.0005668556185395131,9.995779559741441e-05,0.875
1626,3481,오랫동안/Adverb,56,49,7,0.0005668556185395131,9.995779559741441e-05,0.875
1627,3482,손꼽다/Verb,56,45,11,0.0005223963543403357,0.0001443834825295986,0.8035714285714286
1628,3483,절반/Noun,56,11,45,0.0001444926086473269,0.0005220018214531642,0.8035714285714286
1629,3484,비싸다/Adjective,56,11,45,0.0001444926086473269,0.0005220018214531642,0.8035714285714286
1630,3485,아이고/Exclamation,56,12,44,0.00015560742469712126,0.0005108953997201182,0.7857142857142857
1631,3486,에드/Noun,56,44,12,0.0005112815382905413,0.00015548990426264466,0.7857142857142857
1632,3487,!~/Punctuation,56,43,13,0.0005001667222407468,0.0001665963259956907,0.7678571428571429
1633,3488,의견/Noun,56,15,41,0.00018895187284650438,0.00047757613452098,0.7321428571428571
1634,3489,덤/Noun,56,40,16,0.0004668222740913638,0.00019991559119482882,0.7142857142857143
1635,3490,싸이코패스/Noun,56,16,40,0.0002000666888962988,0.000466469712787934,0.7142857142857143
1636,3491,집안/Noun,56,16,40,0.0002000666888962988,0.000466469712787934,0.7142857142857143
1637,3492,귀찮다/Adjective,56,17,39,0.00021118150494609317,0.000455363291054888,0.6964285714285714
1638,3493,유행/Noun,56,17,39,0.00021118150494609317,0.000455363291054888,0.6964285714285714
1639,3494,공식/Noun,56,17,39,0.00021118150494609317,0.000455363291054888,0.6964285714285714
1640,3495,사장/Noun,56,18,38,0.0002222963209958875,0.0004442568693218419,0.6785714285714286
1641,3496,빼놓다/Verb,56,38,18,0.000444592641991775,0.00022212843466092096,0.6785714285714286
1642,3497,방향/Noun,56,18,38,0.0002222963209958875,0.0004442568693218419,0.6785714285714286
1643,3498,영웅본색/Noun,56,19,37,0.0002334111370456819,0.0004331504475887958,0.6607142857142857
1644,3499,대하/Noun,56,37,19,0.0004334778259419807,0.000233234856393967,0.6607142857142857
1645,3500,크레딧/Noun,56,37,19,0.0004334778259419807,0.000233234856393967,0.6607142857142857
1646,3501,펼치다/Verb,56,37,19,0.0004334778259419807,0.000233234856393967,0.6607142857142857
1647,3532,따스하다/Adjective,55,54,1,0.0006224296987884852,3.331926519913814e-05,0.9818181818181818
1648,3533,만족스럽다/Adjective,55,50,5,0.0005779704345893076,7.774495213132233e-05,0.9090909090909092
1649,3534,흠잡다/Adjective,55,50,5,0.0005779704345893076,7.774495213132233e-05,0.9090909090909092
1650,3535,투성이/Noun,55,6,49,8.891852839835501e-05,0.0005664275083853486,0.8909090909090909
1651,3536,어정쩡하다/Adjective,55,6,49,8.891852839835501e-05,0.0005664275083853486,0.8909090909090909
1652,3537,정화/Noun,55,47,8,0.0005446259864399244,0.00011106421733046048,0.8545454545454545
1653,3538,도망가다/Verb,55,9,46,0.00012226297654773814,0.0005331082431862101,0.8363636363636363
1654,3539,멀쩡하다/Adjective,55,11,44,0.0001444926086473269,0.0005108953997201182,0.8
1655,3540,출현/Noun,55,13,42,0.00016672224074691566,0.0004886825562540262,0.7636363636363637
1656,3541,덜하다/Adjective,55,41,14,0.0004779370901411582,0.00017770274772873674,0.7454545454545455
1657,3542,꼬이다/Adjective,55,15,40,0.00018895187284650438,0.000466469712787934,0.7272727272727273
1658,3543,촌/Noun,55,38,17,0.000444592641991775,0.0002110220129278749,0.6909090909090909
1659,3544,러셀/Noun,55,38,17,0.000444592641991775,0.0002110220129278749,0.6909090909090909
1660,3545,..;/Punctuation,55,17,38,0.00021118150494609317,0.0004442568693218419,0.6909090909090909
1661,3546,하고프다/Verb,55,37,18,0.0004334778259419807,0.00022212843466092096,0.6727272727272727
1662,3547,지독하다/Adjective,55,37,18,0.0004334778259419807,0.00022212843466092096,0.6727272727272727
1663,3548,is/Alpha,55,37,18,0.0004334778259419807,0.00022212843466092096,0.6727272727272727
1664,3568,외로움/Noun,54,52,2,0.0006002000666888963,4.4425686932184186e-05,0.9629629629629628
1665,3569,흑역사/Noun,54,2,52,4.445926419917751e-05,0.0005997467735844866,0.9629629629629628
1666,3570,개꿀잼/Noun,54,51,3,0.000589085250639102,5.553210866523024e-05,0.9444444444444444
1667,3571,쪽팔리다/Verb,54,6,48,8.891852839835501e-05,0.0005553210866523023,0.8888888888888888
1668,3572,3분/Number,54,8,46,0.00011114816049794375,0.0005331082431862101,0.8518518518518519
1669,3573,주행/Noun,54,46,8,0.00053351117039013,0.00011106421733046048,0.8518518518518519
1670,3574,온갖/Noun,54,9,45,0.00012226297654773814,0.0005220018214531642,0.8333333333333334
1671,3575,대역/Noun,54,10,44,0.0001333777925975325,0.0005108953997201182,0.8148148148148148
1672,3576,색채/Noun,54,43,11,0.0005001667222407468,0.0001443834825295986,0.7962962962962963
1673,3577,개발/Noun,54,12,42,0.00015560742469712126,0.0004886825562540262,0.7777777777777778
1674,3578,전라도/Noun,54,12,42,0.00015560742469712126,0.0004886825562540262,0.7777777777777778
1675,3579,차마/Noun,54,13,41,0.00016672224074691566,0.00047757613452098,0.7592592592592593
1676,3580,구경/Noun,54,13,41,0.00016672224074691566,0.00047757613452098,0.7592592592592593
1677,3581,관람객/Noun,54,14,40,0.00017783705679671002,0.000466469712787934,0.7407407407407407
1678,3582,혀/Noun,54,14,40,0.00017783705679671002,0.000466469712787934,0.7407407407407407
1679,3583,일찍/Noun,54,39,15,0.00045570745804156943,0.0001888091694617828,0.7222222222222222
1680,3584,피디/Noun,54,15,39,0.00018895187284650438,0.000455363291054888,0.7222222222222222
1681,3585,본성/Noun,54,38,16,0.000444592641991775,0.00019991559119482882,0.7037037037037037
1682,3586,말리다/Verb,54,16,38,0.0002000666888962988,0.0004442568693218419,0.7037037037037037
1683,3587,절절/Noun,54,38,16,0.000444592641991775,0.00019991559119482882,0.7037037037037037
1684,3588,기용/Noun,54,16,38,0.0002000666888962988,0.0004442568693218419,0.7037037037037037
1685,3589,살기/Noun,54,38,16,0.000444592641991775,0.00019991559119482882,0.7037037037037037
1686,3590,크리스/Noun,54,38,16,0.000444592641991775,0.00019991559119482882,0.7037037037037037
1687,3591,팍팍/Adverb,54,17,37,0.00021118150494609317,0.0004331504475887958,0.6851851851851852
1688,3592,거야/Eomi,54,17,37,0.00021118150494609317,0.0004331504475887958,0.6851851851851852
1689,3593,차태현/Noun,54,37,17,0.0004334778259419807,0.0002110220129278749,0.6851851851851852
1690,3617,헛/Noun,53,5,48,7.780371234856063e-05,0.0005553210866523023,0.9056603773584906
1691,3618,팝콘/Noun,53,6,47,8.891852839835501e-05,0.0005442146649192564,0.8867924528301887
1692,3619,흐지부지/Noun,53,6,47,8.891852839835501e-05,0.0005442146649192564,0.8867924528301887
1693,3620,납치/Noun,53,7,46,0.0001000333444481494,0.0005331082431862101,0.8679245283018868
1694,3621,오유/Noun,53,7,46,0.0001000333444481494,0.0005331082431862101,0.8679245283018868
1695,3622,서정/Noun,53,45,8,0.0005223963543403357,0.00011106421733046048,0.8490566037735849
1696,3623,c/Alpha,53,8,45,0.00011114816049794375,0.0005220018214531642,0.8490566037735849
1697,3624,^^*/Punctuation,53,45,8,0.0005223963543403357,0.00011106421733046048,0.8490566037735849
1698,3625,클라라/Noun,53,9,44,0.00012226297654773814,0.0005108953997201182,0.8301886792452831
1699,3626,최민식/Noun,53,42,11,0.0004890519061909527,0.0001443834825295986,0.7924528301886793
1700,3627,벌리다/Verb,53,11,42,0.0001444926086473269,0.0004886825562540262,0.7924528301886793
1701,3628,살인자/Noun,53,11,42,0.0001444926086473269,0.0004886825562540262,0.7924528301886793
1702,3629,옛/Modifier,53,41,12,0.0004779370901411582,0.00015548990426264466,0.7735849056603774
1703,3630,나머진/Noun,53,12,41,0.00015560742469712126,0.00047757613452098,0.7735849056603774
1704,3631,눈요기/Noun,53,12,41,0.00015560742469712126,0.00047757613452098,0.7735849056603774
1705,3632,깨끗하다/Adjective,53,40,13,0.0004668222740913638,0.0001665963259956907,0.7547169811320755
1706,3633,재치/Noun,53,39,14,0.00045570745804156943,0.00017770274772873674,0.7358490566037735
1707,3634,한국어/Noun,53,14,39,0.00017783705679671002,0.000455363291054888,0.7358490566037735
1708,3635,께서/Josa,53,38,15,0.000444592641991775,0.0001888091694617828,0.7169811320754716
1709,3636,이외/Noun,53,15,38,0.00018895187284650438,0.0004442568693218419,0.7169811320754716
1710,3637,조차도/Josa,53,15,38,0.00018895187284650438,0.0004442568693218419,0.7169811320754716
1711,3638,정석/Noun,53,37,16,0.0004334778259419807,0.00019991559119482882,0.6981132075471698
1712,3639,movie/Alpha,53,37,16,0.0004334778259419807,0.00019991559119482882,0.6981132075471698
1713,3640,틀림없다/Adjective,53,37,16,0.0004334778259419807,0.00019991559119482882,0.6981132075471698
1714,3641,네/Modifier,53,16,37,0.0002000666888962988,0.0004331504475887958,0.6981132075471698
1715,3642,예고/Noun,53,16,37,0.0002000666888962988,0.0004331504475887958,0.6981132075471698
1716,3643,저렇다/Adjective,53,16,37,0.0002000666888962988,0.0004331504475887958,0.6981132075471698
1717,3644,멘탈/Noun,53,16,37,0.0002000666888962988,0.0004331504475887958,0.6981132075471698
1718,3645,1분/Number,53,17,36,0.00021118150494609317,0.0004220440258557498,0.6792452830188679
1719,3646,무의미하다/Adjective,53,17,36,0.00021118150494609317,0.0004220440258557498,0.6792452830188679
1720,3647,★/Foreign,53,35,18,0.0004112481938423919,0.00022212843466092096,0.660377358490566
1721,3648,잘알다/Verb,53,35,18,0.0004112481938423919,0.00022212843466092096,0.660377358490566
1722,3649,부터/Foreign,53,35,18,0.0004112481938423919,0.00022212843466092096,0.660377358490566
1723,3650,레옹/Noun,53,18,35,0.0002222963209958875,0.0004109376041227037,0.660377358490566
1724,3651,신도/Noun,53,18,35,0.0002222963209958875,0.0004109376041227037,0.660377358490566
1725,3652,볼걸/Noun,53,18,35,0.0002222963209958875,0.0004109376041227037,0.660377358490566
1726,3679,...;;/Punctuation,52,4,48,6.668889629876625e-05,0.0005553210866523023,0.9230769230769232
1727,3680,ㅗ/KoreanParticle,52,7,45,0.0001000333444481494,0.0005220018214531642,0.8653846153846154
1728,3681,엉터리/Noun,52,7,45,0.0001000333444481494,0.0005220018214531642,0.8653846153846154
1729,3682,성찰/Noun,52,43,9,0.0005001667222407468,0.00012217063906350652,0.8269230769230769
1730,3683,모방/Noun,52,10,42,0.0001333777925975325,0.0004886825562540262,0.8076923076923077
1731,3684,매주/Adverb,52,42,10,0.0004890519061909527,0.00013327706079655256,0.8076923076923077
1732,3685,파라/Noun,52,11,41,0.0001444926086473269,0.00047757613452098,0.7884615384615384
1733,3686,더니/Noun,52,11,41,0.0001444926086473269,0.00047757613452098,0.7884615384615384
1734,3687,안남/Noun,52,13,39,0.00016672224074691566,0.000455363291054888,0.75
1735,3688,어쩌다/Adverb,52,13,39,0.00016672224074691566,0.000455363291054888,0.75
1736,3689,노튼/Noun,52,38,14,0.000444592641991775,0.00017770274772873674,0.7307692307692307
1737,3690,베이/Noun,52,38,14,0.000444592641991775,0.00017770274772873674,0.7307692307692307
1738,3691,!?/Punctuation,52,15,37,0.00018895187284650438,0.0004331504475887958,0.7115384615384616
1739,3692,펼쳐지다/Verb,52,37,15,0.0004334778259419807,0.0001888091694617828,0.7115384615384616
1740,3693,고어/Noun,52,16,36,0.0002000666888962988,0.0004220440258557498,0.6923076923076923
1741,3694,어딜/Adverb,52,17,35,0.00021118150494609317,0.0004109376041227037,0.6730769230769231
1742,3695,빨갛다/Adjective,52,35,17,0.0004112481938423919,0.0002110220129278749,0.6730769230769231
1743,3696,수없이/Adverb,52,17,35,0.00021118150494609317,0.0004109376041227037,0.6730769230769231
1744,3697,몇개/Noun,52,18,34,0.0002222963209958875,0.00039983118238965764,0.6538461538461539
1745,3698,조명/Noun,52,34,18,0.0004001333777925976,0.00022212843466092096,0.6538461538461539
1746,3699,주네/Noun,52,34,18,0.0004001333777925976,0.00022212843466092096,0.6538461538461539
1747,3721,어수선하다/Adjective,51,3,48,5.5574080248971876e-05,0.0005553210866523023,0.9411764705882352
1748,3722,저급하다/Adjective,51,5,46,7.780371234856063e-05,0.0005331082431862101,0.9019607843137256
1749,3723,씨발/Noun,51,5,46,7.780371234856063e-05,0.0005331082431862101,0.9019607843137256
1750,3724,가관/Noun,51,6,45,8.891852839835501e-05,0.0005220018214531642,0.8823529411764706
1751,3725,불필요하다/Adjective,51,7,44,0.0001000333444481494,0.0005108953997201182,0.8627450980392157
1752,3726,.!/Punctuation,51,44,7,0.0005112815382905413,9.995779559741441e-05,0.8627450980392157
1753,3727,양반/Noun,51,8,43,0.00011114816049794375,0.0004997889779870722,0.8431372549019608
1754,3728,파이팅/Noun,51,42,9,0.0004890519061909527,0.00012217063906350652,0.8235294117647058
1755,3729,뚝뚝/Noun,51,9,42,0.00012226297654773814,0.0004886825562540262,0.8235294117647058
1756,3730,땡/Noun,51,9,42,0.00012226297654773814,0.0004886825562540262,0.8235294117647058
1757,3731,모두/Modifier,51,40,11,0.0004668222740913638,0.0001443834825295986,0.7843137254901961
1758,3732,잠자다/Verb,51,11,40,0.0001444926086473269,0.000466469712787934,0.7843137254901961
1759,3733,덜덜/Noun,51,40,11,0.0004668222740913638,0.0001443834825295986,0.7843137254901961
1760,3734,먼지/Noun,51,12,39,0.00015560742469712126,0.000455363291054888,0.7647058823529411
1761,3735,임청하/Noun,51,39,12,0.00045570745804156943,0.00015548990426264466,0.7647058823529411
1762,3736,다니엘/Noun,51,39,12,0.00045570745804156943,0.00015548990426264466,0.7647058823529411
1763,3737,불과하다/Adjective,51,14,37,0.00017783705679671002,0.0004331504475887958,0.7254901960784313
1764,3738,피식/Adverb,51,15,36,0.00018895187284650438,0.0004220440258557498,0.7058823529411765
1765,3739,텐데/Eomi,51,16,35,0.0002000666888962988,0.0004109376041227037,0.6862745098039216
1766,3740,마틴/Noun,51,35,16,0.0004112481938423919,0.00019991559119482882,0.6862745098039216
1767,3741,첩보/Noun,51,35,16,0.0004112481938423919,0.00019991559119482882,0.6862745098039216
1768,3742,취급/Noun,51,17,34,0.00021118150494609317,0.00039983118238965764,0.6666666666666666
1769,3766,어중간하다/Adjective,50,2,48,4.445926419917751e-05,0.0005553210866523023,0.96
1770,3767,어쩌라고/Adverb,50,3,47,5.5574080248971876e-05,0.0005442146649192564,0.94
1771,3768,극혐/Noun,50,5,45,7.780371234856063e-05,0.0005220018214531642,0.9
1772,3769,전해지다/Verb,50,43,7,0.0005001667222407468,9.995779559741441e-05,0.86
1773,3770,재수없다/Adjective,50,8,42,0.00011114816049794375,0.0004886825562540262,0.84
1774,3771,위원회/Noun,50,8,42,0.00011114816049794375,0.0004886825562540262,0.84
1775,3772,어의/Noun,50,9,41,0.00012226297654773814,0.00047757613452098,0.82
1776,3773,절묘하다/Adjective,50,39,11,0.00045570745804156943,0.0001443834825295986,0.78
1777,3774,먹히다/Verb,50,12,38,0.00015560742469712126,0.0004442568693218419,0.76
1778,3775,연주/Noun,50,38,12,0.000444592641991775,0.00015548990426264466,0.76
1779,3776,이연희/Noun,50,37,13,0.0004334778259419807,0.0001665963259956907,0.74
1780,3777,생존/Noun,50,36,14,0.00042236300989218633,0.00017770274772873674,0.72
1781,3778,망설이다/Verb,50,36,14,0.00042236300989218633,0.00017770274772873674,0.72
1782,3779,원피스/Noun,50,36,14,0.00042236300989218633,0.00017770274772873674,0.72
1783,3780,역다/Adjective,50,14,36,0.00017783705679671002,0.0004220440258557498,0.72
1784,3781,여기저기/Noun,50,14,36,0.00017783705679671002,0.0004220440258557498,0.72
1785,3782,에드워드/Noun,50,35,15,0.0004112481938423919,0.0001888091694617828,0.7
1786,3783,고스/Noun,50,35,15,0.0004112481938423919,0.0001888091694617828,0.7
1787,3784,강력하다/Adjective,50,34,16,0.0004001333777925976,0.00019991559119482882,0.68
1788,3785,오우삼/Noun,50,17,33,0.00021118150494609317,0.00038872476065661166,0.66
1789,3786,안성기/Noun,50,33,17,0.00038901856174280313,0.0002110220129278749,0.66
1790,3787,까지/Foreign,50,17,33,0.00021118150494609317,0.00038872476065661166,0.66
1791,3788,전도연/Noun,50,33,17,0.00038901856174280313,0.0002110220129278749,0.66
1792,3789,엿보다/Verb,50,33,17,0.00038901856174280313,0.0002110220129278749,0.66
1793,3790,영광/Noun,50,33,17,0.00038901856174280313,0.0002110220129278749,0.66
1794,3791,바쁘다/Adjective,50,17,33,0.00021118150494609317,0.00038872476065661166,0.66
1795,3792,전화/Noun,50,17,33,0.00021118150494609317,0.00038872476065661166,0.66
1796,3793,닷/Noun,50,33,17,0.00038901856174280313,0.0002110220129278749,0.66
1797,3819,2.22/Number,49,0,49,2.2229632099588756e-05,0.0005664275083853486,1.0
1798,3820,선율/Noun,49,47,2,0.0005446259864399244,4.4425686932184186e-05,0.9591836734693876
1799,3821,접함/Noun,49,3,46,5.5574080248971876e-05,0.0005331082431862101,0.9387755102040816
1800,3822,김구라/Noun,49,3,46,5.5574080248971876e-05,0.0005331082431862101,0.9387755102040816
1801,3823,지저분하다/Adjective,49,3,46,5.5574080248971876e-05,0.0005331082431862101,0.9387755102040816
1802,3824,배속/Noun,49,4,45,6.668889629876625e-05,0.0005220018214531642,0.9183673469387756
1803,3825,유쾌/Noun,49,45,4,0.0005223963543403357,6.663853039827628e-05,0.9183673469387756
1804,3826,전락/Noun,49,5,44,7.780371234856063e-05,0.0005108953997201182,0.8979591836734694
1805,3827,뽕짝/Noun,49,5,44,7.780371234856063e-05,0.0005108953997201182,0.8979591836734694
1806,3828,부드럽다/Adjective,49,43,6,0.0005001667222407468,8.885137386436837e-05,0.8775510204081632
1807,3829,사기꾼/Noun,49,6,43,8.891852839835501e-05,0.0004997889779870722,0.8775510204081632
1808,3830,스킵/Noun,49,6,43,8.891852839835501e-05,0.0004997889779870722,0.8775510204081632
1809,3831,무리수/Noun,49,6,43,8.891852839835501e-05,0.0004997889779870722,0.8775510204081632
1810,3832,두려움/Noun,49,43,6,0.0005001667222407468,8.885137386436837e-05,0.8775510204081632
1811,3833,재주/Noun,49,8,41,0.00011114816049794375,0.00047757613452098,0.8367346938775511
1812,3834,감기/Noun,49,9,40,0.00012226297654773814,0.000466469712787934,0.8163265306122449
1813,3835,애로/Noun,49,9,40,0.00012226297654773814,0.000466469712787934,0.8163265306122449
1814,3836,시스/Noun,49,40,9,0.0004668222740913638,0.00012217063906350652,0.8163265306122449
1815,3837,록키/Noun,49,39,10,0.00045570745804156943,0.00013327706079655256,0.7959183673469388
1816,3838,The/Alpha,49,39,10,0.00045570745804156943,0.00013327706079655256,0.7959183673469388
1817,3839,스키/Noun,49,38,11,0.000444592641991775,0.0001443834825295986,0.7755102040816326
1818,3840,한두/Modifier,49,11,38,0.0001444926086473269,0.0004442568693218419,0.7755102040816326
1819,3841,흉내내/Noun,49,12,37,0.00015560742469712126,0.0004331504475887958,0.7551020408163265
1820,3842,뜯다/Verb,49,12,37,0.00015560742469712126,0.0004331504475887958,0.7551020408163265
1821,3843,튀어나오다/Verb,49,12,37,0.00015560742469712126,0.0004331504475887958,0.7551020408163265
1822,3844,경의/Noun,49,36,13,0.00042236300989218633,0.0001665963259956907,0.7346938775510204
1823,3845,간직/Noun,49,36,13,0.00042236300989218633,0.0001665963259956907,0.7346938775510204
1824,3846,무색/Noun,49,15,34,0.00018895187284650438,0.00039983118238965764,0.6938775510204082
1825,3847,이탈리아/Noun,49,33,16,0.00038901856174280313,0.00019991559119482882,0.6734693877551021
1826,3848,고치다/Verb,49,16,33,0.0002000666888962988,0.00038872476065661166,0.6734693877551021
1827,3849,충/Noun,49,16,33,0.0002000666888962988,0.00038872476065661166,0.6734693877551021
1828,3850,목사/Noun,49,32,17,0.00037790374569300877,0.0002110220129278749,0.6530612244897959
1829,3851,이웃/Noun,49,17,32,0.00021118150494609317,0.0003776183389235656,0.6530612244897959
1830,3852,셋/Noun,49,17,32,0.00021118150494609317,0.0003776183389235656,0.6530612244897959
1831,3853,일생/Noun,49,32,17,0.00037790374569300877,0.0002110220129278749,0.6530612244897959
1832,3880,내보내다/Verb,48,1,47,3.334444814938313e-05,0.0005442146649192564,0.9791666666666666
1833,3881,주옥/Noun,48,47,1,0.0005446259864399244,3.331926519913814e-05,0.9791666666666666
1834,3882,파워레인저/Noun,48,5,43,7.780371234856063e-05,0.0004997889779870722,0.8958333333333334
1835,3883,엉엉/Noun,48,41,7,0.0004779370901411582,9.995779559741441e-05,0.8541666666666666
1836,3884,이예/Noun,48,40,8,0.0004668222740913638,0.00011106421733046048,0.8333333333333334
1837,3885,그땐/Noun,48,40,8,0.0004668222740913638,0.00011106421733046048,0.8333333333333334
1838,3886,이혼/Noun,48,8,40,0.00011114816049794375,0.000466469712787934,0.8333333333333334
1839,3887,나빠지다/Verb,48,9,39,0.00012226297654773814,0.000455363291054888,0.8125
1840,3888,과잉/Noun,48,9,39,0.00012226297654773814,0.000455363291054888,0.8125
1841,3889,카피/Noun,48,9,39,0.00012226297654773814,0.000455363291054888,0.8125
1842,3890,노골/Noun,48,11,37,0.0001444926086473269,0.0004331504475887958,0.7708333333333334
1843,3891,젖다/Verb,48,36,12,0.00042236300989218633,0.00015548990426264466,0.75
1844,3892,8.5/Number,48,36,12,0.00042236300989218633,0.00015548990426264466,0.75
1845,3893,미국인/Noun,48,13,35,0.00016672224074691566,0.0004109376041227037,0.7291666666666666
1846,3894,품다/Verb,48,35,13,0.0004112481938423919,0.0001665963259956907,0.7291666666666666
1847,3895,려/Noun,48,13,35,0.00016672224074691566,0.0004109376041227037,0.7291666666666666
1848,3896,대고/Noun,48,14,34,0.00017783705679671002,0.00039983118238965764,0.7083333333333334
1849,3897,화판/Noun,48,14,34,0.00017783705679671002,0.00039983118238965764,0.7083333333333334
1850,3898,대감/Noun,48,14,34,0.00017783705679671002,0.00039983118238965764,0.7083333333333334
1851,3899,흥분/Noun,48,34,14,0.0004001333777925976,0.00017770274772873674,0.7083333333333334
1852,3900,마케팅/Noun,48,15,33,0.00018895187284650438,0.00038872476065661166,0.6875
1853,3901,한정/Noun,48,32,16,0.00037790374569300877,0.00019991559119482882,0.6666666666666666
1854,3932,조악하다/Adjective,47,1,46,3.334444814938313e-05,0.0005331082431862101,0.9787234042553192
1855,3933,낚였/Noun,47,1,46,3.334444814938313e-05,0.0005331082431862101,0.9787234042553192
1856,3934,졸잼/Noun,47,43,4,0.0005001667222407468,6.663853039827628e-05,0.9148936170212766
1857,3935,클리셰/Noun,47,5,42,7.780371234856063e-05,0.0004886825562540262,0.8936170212765957
1858,3936,이스트/Noun,47,41,6,0.0004779370901411582,8.885137386436837e-05,0.8723404255319149
1859,3937,구역/Noun,47,8,39,0.00011114816049794375,0.000455363291054888,0.8297872340425532
1860,3938,구려/Noun,47,8,39,0.00011114816049794375,0.000455363291054888,0.8297872340425532
1861,3939,만날/Noun,47,38,9,0.000444592641991775,0.00012217063906350652,0.8085106382978723
1862,3940,대가리/Noun,47,9,38,0.00012226297654773814,0.0004442568693218419,0.8085106382978723
1863,3941,인척/Noun,47,10,37,0.0001333777925975325,0.0004331504475887958,0.7872340425531915
1864,3942,환장하다/Adjective,47,10,37,0.0001333777925975325,0.0004331504475887958,0.7872340425531915
1865,3943,-_-;/Punctuation,47,12,35,0.00015560742469712126,0.0004109376041227037,0.7446808510638298
1866,3944,타령/Noun,47,12,35,0.00015560742469712126,0.0004109376041227037,0.7446808510638298
1867,3945,하드/Noun,47,13,34,0.00016672224074691566,0.00039983118238965764,0.7234042553191491
1868,3946,면도/Noun,47,33,14,0.00038901856174280313,0.00017770274772873674,0.7021276595744681
1869,3947,붉다/Adjective,47,33,14,0.00038901856174280313,0.00017770274772873674,0.7021276595744681
1870,3948,조승우/Noun,47,33,14,0.00038901856174280313,0.00017770274772873674,0.7021276595744681
1871,3949,별다르다/Adjective,47,14,33,0.00017783705679671002,0.00038872476065661166,0.7021276595744681
1872,3950,시사/Noun,47,33,14,0.00038901856174280313,0.00017770274772873674,0.7021276595744681
1873,3951,도라에몽/Noun,47,33,14,0.00038901856174280313,0.00017770274772873674,0.7021276595744681
1874,3952,오페라/Noun,47,33,14,0.00038901856174280313,0.00017770274772873674,0.7021276595744681
1875,3953,신념/Noun,47,32,15,0.00037790374569300877,0.0001888091694617828,0.6808510638297872
1876,3954,아이언맨/Noun,47,32,15,0.00037790374569300877,0.0001888091694617828,0.6808510638297872
1877,3955,애국심/Noun,47,15,32,0.00018895187284650438,0.0003776183389235656,0.6808510638297872
1878,3956,작/Foreign,47,15,32,0.00018895187284650438,0.0003776183389235656,0.6808510638297872
1879,3957,미이라/Noun,47,15,32,0.00018895187284650438,0.0003776183389235656,0.6808510638297872
1880,3958,드래곤볼/Noun,47,15,32,0.00018895187284650438,0.0003776183389235656,0.6808510638297872
1881,3959,전이/Noun,47,31,16,0.00036678892964321435,0.00019991559119482882,0.6595744680851063
1882,3960,크루즈/Noun,47,31,16,0.00036678892964321435,0.00019991559119482882,0.6595744680851063
1883,3998,남발/Noun,46,2,44,4.445926419917751e-05,0.0005108953997201182,0.9565217391304348
1884,3999,용가리/Noun,46,5,41,7.780371234856063e-05,0.00047757613452098,0.8913043478260869
1885,4000,배드/Noun,46,6,40,8.891852839835501e-05,0.000466469712787934,0.8695652173913043
1886,4001,재탕/Noun,46,6,40,8.891852839835501e-05,0.000466469712787934,0.8695652173913043
1887,4002,증말/Noun,46,7,39,0.0001000333444481494,0.000455363291054888,0.8478260869565217
1888,4003,우왕/Noun,46,39,7,0.00045570745804156943,9.995779559741441e-05,0.8478260869565217
1889,4004,재료/Noun,46,7,39,0.0001000333444481494,0.000455363291054888,0.8478260869565217
1890,4005,즐/Noun,46,7,39,0.0001000333444481494,0.000455363291054888,0.8478260869565217
1891,4006,덴젤/Noun,46,38,8,0.000444592641991775,0.00011106421733046048,0.8260869565217391
1892,4007,풍부하다/Adjective,46,37,9,0.0004334778259419807,0.00012217063906350652,0.8043478260869565
1893,4008,벗기다/Verb,46,9,37,0.00012226297654773814,0.0004331504475887958,0.8043478260869565
1894,4009,정당화/Noun,46,9,37,0.00012226297654773814,0.0004331504475887958,0.8043478260869565
1895,4010,저희/Noun,46,34,12,0.0004001333777925976,0.00015548990426264466,0.7391304347826086
1896,4011,땜시/Noun,46,12,34,0.00015560742469712126,0.00039983118238965764,0.7391304347826086
1897,4012,줄이다/Verb,46,13,33,0.00016672224074691566,0.00038872476065661166,0.7173913043478259
1898,4013,특징/Noun,46,13,33,0.00016672224074691566,0.00038872476065661166,0.7173913043478259
1899,4014,태양/Noun,46,33,13,0.00038901856174280313,0.0001665963259956907,0.7173913043478259
1900,4015,조정/Noun,46,13,33,0.00016672224074691566,0.00038872476065661166,0.7173913043478259
1901,4016,정통/Noun,46,32,14,0.00037790374569300877,0.00017770274772873674,0.6956521739130435
1902,4017,역쉬/Noun,46,31,15,0.00036678892964321435,0.0001888091694617828,0.6739130434782609
1903,4018,나와라/Noun,46,31,15,0.00036678892964321435,0.0001888091694617828,0.6739130434782609
1904,4019,6년/Number,46,31,15,0.00036678892964321435,0.0001888091694617828,0.6739130434782609
1905,4020,지원/Noun,46,16,30,0.0002000666888962988,0.0003554054954574735,0.6521739130434783
1906,4021,KBS/Alpha,46,30,16,0.00035567411359342004,0.00019991559119482882,0.6521739130434783
1907,4022,저기/Noun,46,16,30,0.0002000666888962988,0.0003554054954574735,0.6521739130434783
1908,4023,최선/Noun,46,30,16,0.00035567411359342004,0.00019991559119482882,0.6521739130434783
1909,4051,최하/Noun,45,3,42,5.5574080248971876e-05,0.0004886825562540262,0.9333333333333332
1910,4052,어처구니없다/Adjective,45,3,42,5.5574080248971876e-05,0.0004886825562540262,0.9333333333333332
1911,4053,글쎄요/Noun,45,3,42,5.5574080248971876e-05,0.0004886825562540262,0.9333333333333332
1912,4054,흐뭇하다/Adjective,45,42,3,0.0004890519061909527,5.553210866523024e-05,0.9333333333333332
1913,4055,대략/Noun,45,5,40,7.780371234856063e-05,0.000466469712787934,0.8888888888888888
1914,4056,곁/Noun,45,40,5,0.0004668222740913638,7.774495213132233e-05,0.8888888888888888
1915,4057,성함/Noun,45,6,39,8.891852839835501e-05,0.000455363291054888,0.8666666666666667
1916,4058,팔다/Verb,45,7,38,0.0001000333444481494,0.0004442568693218419,0.8444444444444444
1917,4059,간첩/Noun,45,10,35,0.0001333777925975325,0.0004109376041227037,0.7777777777777778
1918,4060,구성은/Noun,45,10,35,0.0001333777925975325,0.0004109376041227037,0.7777777777777778
1919,4061,온몸/Noun,45,34,11,0.0004001333777925976,0.0001443834825295986,0.7555555555555555
1920,4062,수치/Noun,45,11,34,0.0001444926086473269,0.00039983118238965764,0.7555555555555555
1921,4063,행크스/Noun,45,34,11,0.0004001333777925976,0.0001443834825295986,0.7555555555555555
1922,4064,12년/Number,45,33,12,0.00038901856174280313,0.00015548990426264466,0.7333333333333333
1923,4065,직원/Noun,45,12,33,0.00015560742469712126,0.00038872476065661166,0.7333333333333333
1924,4066,도입/Noun,45,12,33,0.00015560742469712126,0.00038872476065661166,0.7333333333333333
1925,4067,모호하다/Adjective,45,13,32,0.00016672224074691566,0.0003776183389235656,0.7111111111111111
1926,4068,감수성/Noun,45,31,14,0.00036678892964321435,0.00017770274772873674,0.6888888888888889
1927,4069,게리/Noun,45,31,14,0.00036678892964321435,0.00017770274772873674,0.6888888888888889
1928,4070,박사/Noun,45,30,15,0.00035567411359342004,0.0001888091694617828,0.6666666666666666
1929,4102,♥♥♥♥/Foreign,44,44,0,0.0005112815382905413,2.2212843466092093e-05,1.0
1930,4103,자위/Noun,44,2,42,4.445926419917751e-05,0.0004886825562540262,0.9545454545454546
1931,4104,용두사미/Noun,44,2,42,4.445926419917751e-05,0.0004886825562540262,0.9545454545454546
1932,4105,모야/Noun,44,3,41,5.5574080248971876e-05,0.00047757613452098,0.9318181818181818
1933,4106,앞서/Noun,44,41,3,0.0004779370901411582,5.553210866523024e-05,0.9318181818181818
1934,4107,구역질/Noun,44,3,41,5.5574080248971876e-05,0.00047757613452098,0.9318181818181818
1935,4108,삼가다/Verb,44,39,5,0.00045570745804156943,7.774495213132233e-05,0.8863636363636364
1936,4109,뽕/Noun,44,6,38,8.891852839835501e-05,0.0004442568693218419,0.8636363636363636
1937,4110,느슨하다/Adjective,44,7,37,0.0001000333444481494,0.0004331504475887958,0.8409090909090909
1938,4111,코스프레/Noun,44,7,37,0.0001000333444481494,0.0004331504475887958,0.8409090909090909
1939,4112,노리다/Verb,44,7,37,0.0001000333444481494,0.0004331504475887958,0.8409090909090909
1940,4113,등급/Noun,44,8,36,0.00011114816049794375,0.0004220440258557498,0.8181818181818182
1941,4114,가을/Noun,44,36,8,0.00042236300989218633,0.00011106421733046048,0.8181818181818182
1942,4115,노말/Noun,44,8,36,0.00011114816049794375,0.0004220440258557498,0.8181818181818182
1943,4116,ㅂㅅ/KoreanParticle,44,8,36,0.00011114816049794375,0.0004220440258557498,0.8181818181818182
1944,4117,펭귄/Noun,44,36,8,0.00042236300989218633,0.00011106421733046048,0.8181818181818182
1945,4118,에러/Noun,44,9,35,0.00012226297654773814,0.0004109376041227037,0.7954545454545454
1946,4119,드립/Noun,44,9,35,0.00012226297654773814,0.0004109376041227037,0.7954545454545454
1947,4120,구리다/Adjective,44,9,35,0.00012226297654773814,0.0004109376041227037,0.7954545454545454
1948,4121,읍/Noun,44,9,35,0.00012226297654773814,0.0004109376041227037,0.7954545454545454
1949,4122,섭외/Noun,44,9,35,0.00012226297654773814,0.0004109376041227037,0.7954545454545454
1950,4123,15분/Number,44,10,34,0.0001333777925975325,0.00039983118238965764,0.7727272727272727
1951,4124,중국인/Noun,44,10,34,0.0001333777925975325,0.00039983118238965764,0.7727272727272727
1952,4125,에여/Josa,44,34,10,0.0004001333777925976,0.00013327706079655256,0.7727272727272727
1953,4126,병원/Noun,44,11,33,0.0001444926086473269,0.00038872476065661166,0.75
1954,4127,불후/Noun,44,32,12,0.00037790374569300877,0.00015548990426264466,0.7272727272727273
1955,4128,성숙하다/Adjective,44,32,12,0.00037790374569300877,0.00015548990426264466,0.7272727272727273
1956,4129,해안가/Noun,44,12,32,0.00015560742469712126,0.0003776183389235656,0.7272727272727273
1957,4130,똑바로/Noun,44,13,31,0.00016672224074691566,0.00036651191719051963,0.7045454545454546
1958,4131,구멍/Noun,44,13,31,0.00016672224074691566,0.00036651191719051963,0.7045454545454546
1959,4132,워커/Noun,44,31,13,0.00036678892964321435,0.0001665963259956907,0.7045454545454546
1960,4133,낙/Noun,44,31,13,0.00036678892964321435,0.0001665963259956907,0.7045454545454546
1961,4134,레오/Noun,44,31,13,0.00036678892964321435,0.0001665963259956907,0.7045454545454546
1962,4135,부재/Noun,44,13,31,0.00016672224074691566,0.00036651191719051963,0.7045454545454546
1963,4136,인터뷰/Noun,44,13,31,0.00016672224074691566,0.00036651191719051963,0.7045454545454546
1964,4137,가져오다/Verb,44,14,30,0.00017783705679671002,0.0003554054954574735,0.6818181818181818
1965,4138,아무래도/Adverb,44,14,30,0.00017783705679671002,0.0003554054954574735,0.6818181818181818
1966,4139,북/Noun,44,14,30,0.00017783705679671002,0.0003554054954574735,0.6818181818181818
1967,4140,절실/Noun,44,30,14,0.00035567411359342004,0.00017770274772873674,0.6818181818181818
1968,4141,비롯/Noun,44,29,15,0.0003445592975436257,0.0001888091694617828,0.6590909090909091
1969,4142,지존/Noun,44,29,15,0.0003445592975436257,0.0001888091694617828,0.6590909090909091
1970,4143,슬래셔/Noun,44,15,29,0.00018895187284650438,0.00034429907372442745,0.6590909090909091
1971,4144,걸치다/Verb,44,15,29,0.00018895187284650438,0.00034429907372442745,0.6590909090909091
1972,4171,곱씹다/Verb,43,42,1,0.0004890519061909527,3.331926519913814e-05,0.9767441860465116
1973,4172,very/Alpha,43,42,1,0.0004890519061909527,3.331926519913814e-05,0.9767441860465116
1974,4173,실종/Noun,43,1,42,3.334444814938313e-05,0.0004886825562540262,0.9767441860465116
1975,4174,나발/Noun,43,2,41,4.445926419917751e-05,0.00047757613452098,0.9534883720930232
1976,4175,리즈시절/Noun,43,40,3,0.0004668222740913638,5.553210866523024e-05,0.9302325581395348
1977,4176,미묘하다/Adjective,43,39,4,0.00045570745804156943,6.663853039827628e-05,0.9069767441860463
1978,4177,허무맹랑/Noun,43,6,37,8.891852839835501e-05,0.0004331504475887958,0.8604651162790697
1979,4178,실소/Noun,43,7,36,0.0001000333444481494,0.0004220440258557498,0.8372093023255814
1980,4179,요약/Noun,43,8,35,0.00011114816049794375,0.0004109376041227037,0.813953488372093
1981,4180,8년/Number,43,35,8,0.0004112481938423919,0.00011106421733046048,0.813953488372093
1982,4181,비명/Noun,43,8,35,0.00011114816049794375,0.0004109376041227037,0.813953488372093
1983,4182,PD/Alpha,43,8,35,0.00011114816049794375,0.0004109376041227037,0.813953488372093
1984,4183,말기/Noun,43,9,34,0.00012226297654773814,0.00039983118238965764,0.7906976744186046
1985,4184,훈남/Noun,43,34,9,0.0004001333777925976,0.00012217063906350652,0.7906976744186046
1986,4185,콤비/Noun,43,33,10,0.00038901856174280313,0.00013327706079655256,0.7674418604651163
1987,4186,박해일/Noun,43,32,11,0.00037790374569300877,0.0001443834825295986,0.7441860465116279
1988,4187,정도/Foreign,43,11,32,0.0001444926086473269,0.0003776183389235656,0.7441860465116279
1989,4188,자랑스럽다/Adjective,43,32,11,0.00037790374569300877,0.0001443834825295986,0.7441860465116279
1990,4189,이념/Noun,43,31,12,0.00036678892964321435,0.00015548990426264466,0.7209302325581395
1991,4190,낯/Noun,43,12,31,0.00015560742469712126,0.00036651191719051963,0.7209302325581395
1992,4191,명도/Noun,43,12,31,0.00015560742469712126,0.00036651191719051963,0.7209302325581395
1993,4192,크리스토퍼/Noun,43,31,12,0.00036678892964321435,0.00015548990426264466,0.7209302325581395
1994,4193,일도/Noun,43,13,30,0.00016672224074691566,0.0003554054954574735,0.6976744186046512
1995,4194,거만/Noun,43,13,30,0.00016672224074691566,0.0003554054954574735,0.6976744186046512
1996,4195,에게서/Josa,43,30,13,0.00035567411359342004,0.0001665963259956907,0.6976744186046512
1997,4196,미국영화/Noun,43,13,30,0.00016672224074691566,0.0003554054954574735,0.6976744186046512
1998,4197,뮤직비디오/Noun,43,13,30,0.00016672224074691566,0.0003554054954574735,0.6976744186046512
1999,4198,모티브/Noun,43,13,30,0.00016672224074691566,0.0003554054954574735,0.6976744186046512
2000,4199,요구/Noun,43,13,30,0.00016672224074691566,0.0003554054954574735,0.6976744186046512
2001,4200,만/Foreign,43,14,29,0.00017783705679671002,0.00034429907372442745,0.6744186046511628
2002,4201,깨지다/Verb,43,14,29,0.00017783705679671002,0.00034429907372442745,0.6744186046511628
2003,4202,호강/Noun,43,29,14,0.0003445592975436257,0.00017770274772873674,0.6744186046511628
2004,4203,뉴욕/Noun,43,29,14,0.0003445592975436257,0.00017770274772873674,0.6744186046511628
2005,4204,끊임없다/Adjective,43,29,14,0.0003445592975436257,0.00017770274772873674,0.6744186046511628
2006,4205,남지/Noun,43,15,28,0.00018895187284650438,0.0003331926519913814,0.6511627906976745
2007,4206,옹/Noun,43,28,15,0.0003334444814938313,0.0001888091694617828,0.6511627906976745
2008,4207,교수/Noun,43,15,28,0.00018895187284650438,0.0003331926519913814,0.6511627906976745
2009,4208,학원/Noun,43,15,28,0.00018895187284650438,0.0003331926519913814,0.6511627906976745
2010,4209,2003년/Number,43,28,15,0.0003334444814938313,0.0001888091694617828,0.6511627906976745
2011,4210,혹평/Noun,43,28,15,0.0003334444814938313,0.0001888091694617828,0.6511627906976745
2012,4211,쫓다/Verb,43,15,28,0.00018895187284650438,0.0003331926519913814,0.6511627906976745
2013,4242,도통/Noun,42,1,41,3.334444814938313e-05,0.00047757613452098,0.9761904761904762
2014,4243,남아돌다/Verb,42,1,41,3.334444814938313e-05,0.00047757613452098,0.9761904761904762
2015,4244,저급/Noun,42,2,40,4.445926419917751e-05,0.000466469712787934,0.9523809523809524
2016,4245,귀요미/Noun,42,38,4,0.000444592641991775,6.663853039827628e-05,0.9047619047619048
2017,4246,화만/Noun,42,4,38,6.668889629876625e-05,0.0004442568693218419,0.9047619047619048
2018,4247,에든/Josa,42,37,5,0.0004334778259419807,7.774495213132233e-05,0.8809523809523809
2019,4248,집어넣다/Verb,42,5,37,7.780371234856063e-05,0.0004331504475887958,0.8809523809523809
2020,4249,미안/Noun,42,6,36,8.891852839835501e-05,0.0004220440258557498,0.8571428571428571
2021,4250,이준기/Noun,42,35,7,0.0004112481938423919,9.995779559741441e-05,0.8333333333333334
2022,4251,망상/Noun,42,8,34,0.00011114816049794375,0.00039983118238965764,0.8095238095238095
2023,4252,눈뜨다/Verb,42,8,34,0.00011114816049794375,0.00039983118238965764,0.8095238095238095
2024,4253,찜찜하다/Adjective,42,8,34,0.00011114816049794375,0.00039983118238965764,0.8095238095238095
2025,4254,매혹/Noun,42,33,9,0.00038901856174280313,0.00012217063906350652,0.7857142857142857
2026,4255,경계/Noun,42,33,9,0.00038901856174280313,0.00012217063906350652,0.7857142857142857
2027,4256,상치/Noun,42,33,9,0.00038901856174280313,0.00012217063906350652,0.7857142857142857
2028,4257,진짜진짜/Noun,42,33,9,0.00038901856174280313,0.00012217063906350652,0.7857142857142857
2029,4258,자유롭다/Adjective,42,33,9,0.00038901856174280313,0.00012217063906350652,0.7857142857142857
2030,4259,사춘기/Noun,42,32,10,0.00037790374569300877,0.00013327706079655256,0.7619047619047619
2031,4260,앵글/Noun,42,10,32,0.0001333777925975325,0.0003776183389235656,0.7619047619047619
2032,4261,내기/Noun,42,11,31,0.0001444926086473269,0.00036651191719051963,0.7380952380952381
2033,4262,원인/Noun,42,11,31,0.0001444926086473269,0.00036651191719051963,0.7380952380952381
2034,4263,..??/Punctuation,42,11,31,0.0001444926086473269,0.00036651191719051963,0.7380952380952381
2035,4264,박신양/Noun,42,30,12,0.00035567411359342004,0.00015548990426264466,0.7142857142857143
2036,4265,덕후/Noun,42,12,30,0.00015560742469712126,0.0003554054954574735,0.7142857142857143
2037,4266,4년/Number,42,29,13,0.0003445592975436257,0.0001665963259956907,0.6904761904761905
2038,4267,주상욱/Noun,42,13,29,0.00016672224074691566,0.00034429907372442745,0.6904761904761905
2039,4268,강제/Noun,42,13,29,0.00016672224074691566,0.00034429907372442745,0.6904761904761905
2040,4269,유아인/Noun,42,28,14,0.0003334444814938313,0.00017770274772873674,0.6666666666666666
2041,4270,............/Punctuation,42,14,28,0.00017783705679671002,0.0003331926519913814,0.6666666666666666
2042,4271,원표/Noun,42,28,14,0.0003334444814938313,0.00017770274772873674,0.6666666666666666
2043,4272,가르다/Verb,42,28,14,0.0003334444814938313,0.00017770274772873674,0.6666666666666666
2044,4306,서프라이즈/Noun,41,2,39,4.445926419917751e-05,0.000455363291054888,0.951219512195122
2045,4307,존잼/Noun,41,39,2,0.00045570745804156943,4.4425686932184186e-05,0.951219512195122
2046,4308,가슴속/Noun,41,39,2,0.00045570745804156943,4.4425686932184186e-05,0.951219512195122
2047,4309,우리네/Noun,41,39,2,0.00045570745804156943,4.4425686932184186e-05,0.951219512195122
2048,4310,소박하다/Adjective,41,38,3,0.000444592641991775,5.553210866523024e-05,0.9268292682926829
2049,4311,짓거리/Noun,41,4,37,6.668889629876625e-05,0.0004331504475887958,0.902439024390244
2050,4312,희망이/Noun,41,36,5,0.00042236300989218633,7.774495213132233e-05,0.8780487804878049
2051,4313,예수님/Noun,41,35,6,0.0004112481938423919,8.885137386436837e-05,0.8536585365853658
2052,4314,충무로/Noun,41,8,33,0.00011114816049794375,0.00038872476065661166,0.8048780487804879
2053,4315,기쁨/Noun,41,33,8,0.00038901856174280313,0.00011106421733046048,0.8048780487804879
2054,4316,두근거리다/Adjective,41,33,8,0.00038901856174280313,0.00011106421733046048,0.8048780487804879
2055,4317,시보/Noun,41,33,8,0.00038901856174280313,0.00011106421733046048,0.8048780487804879
2056,4318,쏙/Noun,41,32,9,0.00037790374569300877,0.00012217063906350652,0.7804878048780488
2057,4319,쌈/Noun,41,9,32,0.00012226297654773814,0.0003776183389235656,0.7804878048780488
2058,4320,멘붕/Noun,41,9,32,0.00012226297654773814,0.0003776183389235656,0.7804878048780488
2059,4321,선하다/Adjective,41,32,9,0.00037790374569300877,0.00012217063906350652,0.7804878048780488
2060,4322,조조/Noun,41,10,31,0.0001333777925975325,0.00036651191719051963,0.7560975609756098
2061,4323,꼴리다/Verb,41,10,31,0.0001333777925975325,0.00036651191719051963,0.7560975609756098
2062,4324,행위/Noun,41,11,30,0.0001444926086473269,0.0003554054954574735,0.7317073170731707
2063,4325,유오성/Noun,41,12,29,0.00015560742469712126,0.00034429907372442745,0.7073170731707317
2064,4326,미흡하다/Adjective,41,12,29,0.00015560742469712126,0.00034429907372442745,0.7073170731707317
2065,4327,^^;/Punctuation,41,29,12,0.0003445592975436257,0.00015548990426264466,0.7073170731707317
2066,4328,오타쿠/Noun,41,12,29,0.00015560742469712126,0.00034429907372442745,0.7073170731707317
2067,4329,어우/Noun,41,12,29,0.00015560742469712126,0.00034429907372442745,0.7073170731707317
2068,4330,피터/Noun,41,29,12,0.0003445592975436257,0.00015548990426264466,0.7073170731707317
2069,4331,쓰기/Noun,41,12,29,0.00015560742469712126,0.00034429907372442745,0.7073170731707317
2070,4332,파고들다/Verb,41,29,12,0.0003445592975436257,0.00015548990426264466,0.7073170731707317
2071,4333,웹툰/Noun,41,12,29,0.00015560742469712126,0.00034429907372442745,0.7073170731707317
2072,4334,이러하다/Adjective,41,29,12,0.0003445592975436257,0.00015548990426264466,0.7073170731707317
2073,4335,->/Punctuation,41,13,28,0.00016672224074691566,0.0003331926519913814,0.6829268292682927
2074,4336,임신/Noun,41,13,28,0.00016672224074691566,0.0003331926519913814,0.6829268292682927
2075,4337,맷/Noun,41,28,13,0.0003334444814938313,0.0001665963259956907,0.6829268292682927
2076,4338,50년/Number,41,28,13,0.0003334444814938313,0.0001665963259956907,0.6829268292682927
2077,4339,디지다/Verb,41,13,28,0.00016672224074691566,0.0003331926519913814,0.6829268292682927
2078,4340,수십/Modifier,41,28,13,0.0003334444814938313,0.0001665963259956907,0.6829268292682927
2079,4341,차이다/Verb,41,13,28,0.00016672224074691566,0.0003331926519913814,0.6829268292682927
2080,4342,2012년/Number,41,14,27,0.00017783705679671002,0.00032208623025833537,0.6585365853658537
2081,4343,언급/Noun,41,14,27,0.00017783705679671002,0.00032208623025833537,0.6585365853658537
2082,4344,통수/Noun,41,14,27,0.00017783705679671002,0.00032208623025833537,0.6585365853658537
2083,4345,대로/Noun,41,14,27,0.00017783705679671002,0.00032208623025833537,0.6585365853658537
2084,4346,부턴/Josa,41,14,27,0.00017783705679671002,0.00032208623025833537,0.6585365853658537
2085,4347,it/Alpha,41,27,14,0.00032232966544403684,0.00017770274772873674,0.6585365853658537
2086,4376,위원/Noun,40,2,38,4.445926419917751e-05,0.0004442568693218419,0.95
2087,4377,찡/Adverb,40,37,3,0.0004334778259419807,5.553210866523024e-05,0.925
2088,4378,!^^/Punctuation,40,36,4,0.00042236300989218633,6.663853039827628e-05,0.9
2089,4379,상투/Noun,40,4,36,6.668889629876625e-05,0.0004220440258557498,0.9
2090,4380,마인드/Noun,40,5,35,7.780371234856063e-05,0.0004109376041227037,0.875
2091,4381,오인혜/Noun,40,5,35,7.780371234856063e-05,0.0004109376041227037,0.875
2092,4382,시리다/Adjective,40,35,5,0.0004112481938423919,7.774495213132233e-05,0.875
2093,4383,신파극/Noun,40,7,33,0.0001000333444481494,0.00038872476065661166,0.825
2094,4384,추락/Noun,40,7,33,0.0001000333444481494,0.00038872476065661166,0.825
2095,4385,이라곤/Josa,40,7,33,0.0001000333444481494,0.00038872476065661166,0.825
2096,4386,여정/Noun,40,32,8,0.00037790374569300877,0.00011106421733046048,0.8
2097,4387,귀가/Noun,40,32,8,0.00037790374569300877,0.00011106421733046048,0.8
2098,4388,증/Noun,40,8,32,0.00011114816049794375,0.0003776183389235656,0.8
2099,4389,어느새다/Adjective,40,32,8,0.00037790374569300877,0.00011106421733046048,0.8
2100,4390,이러니/Conjunction,40,8,32,0.00011114816049794375,0.0003776183389235656,0.8
2101,4391,강조/Noun,40,8,32,0.00011114816049794375,0.0003776183389235656,0.8
2102,4392,남자라면/Noun,40,32,8,0.00037790374569300877,0.00011106421733046048,0.8
2103,4393,ebs/Alpha,40,31,9,0.00036678892964321435,0.00012217063906350652,0.775
2104,4394,불법/Noun,40,9,31,0.00012226297654773814,0.00036651191719051963,0.775
2105,4395,저렴하다/Adjective,40,9,31,0.00012226297654773814,0.00036651191719051963,0.775
2106,4396,방이/Noun,40,30,10,0.00035567411359342004,0.00013327706079655256,0.75
2107,4397,곳곳/Noun,40,30,10,0.00035567411359342004,0.00013327706079655256,0.75
2108,4398,경이/Noun,40,30,10,0.00035567411359342004,0.00013327706079655256,0.75
2109,4399,옹박/Noun,40,10,30,0.0001333777925975325,0.0003554054954574735,0.75
2110,4400,자제/Noun,40,10,30,0.0001333777925975325,0.0003554054954574735,0.75
2111,4401,빼/Noun,40,11,29,0.0001444926086473269,0.00034429907372442745,0.725
2112,4402,우월/Noun,40,11,29,0.0001444926086473269,0.00034429907372442745,0.725
2113,4403,~~!/Punctuation,40,29,11,0.0003445592975436257,0.0001443834825295986,0.725
2114,4404,획/Noun,40,29,11,0.0003445592975436257,0.0001443834825295986,0.725
2115,4405,수업/Noun,40,29,11,0.0003445592975436257,0.0001443834825295986,0.725
2116,4406,호러물/Noun,40,11,29,0.0001444926086473269,0.00034429907372442745,0.725
2117,4407,유명/Noun,40,11,29,0.0001444926086473269,0.00034429907372442745,0.725
2118,4408,우디/Noun,40,28,12,0.0003334444814938313,0.00015548990426264466,0.7
2119,4409,승화/Noun,40,28,12,0.0003334444814938313,0.00015548990426264466,0.7
2120,4410,교감/Noun,40,28,12,0.0003334444814938313,0.00015548990426264466,0.7
2121,4411,외우다/Verb,40,28,12,0.0003334444814938313,0.00015548990426264466,0.7
2122,4412,퀴어/Noun,40,28,12,0.0003334444814938313,0.00015548990426264466,0.7
2123,4413,쫒다/Verb,40,13,27,0.00016672224074691566,0.00032208623025833537,0.675
2124,4414,수정/Noun,40,13,27,0.00016672224074691566,0.00032208623025833537,0.675
2125,4415,저녁/Noun,40,13,27,0.00016672224074691566,0.00032208623025833537,0.675
2126,4416,전의/Noun,40,26,14,0.00031121484939424253,0.00017770274772873674,0.65
2127,4417,상의/Noun,40,26,14,0.00031121484939424253,0.00017770274772873674,0.65
2128,4418,독창/Noun,40,14,26,0.00017783705679671002,0.00031097980852528933,0.65
2129,4419,매트릭스/Noun,40,26,14,0.00031121484939424253,0.00017770274772873674,0.65
2130,4449,투자자/Noun,39,0,39,2.2229632099588756e-05,0.000455363291054888,1.0
2131,4450,졸음/Noun,39,1,38,3.334444814938313e-05,0.0004442568693218419,0.9743589743589745
2132,4451,쓰레기통/Noun,39,1,38,3.334444814938313e-05,0.0004442568693218419,0.9743589743589745
2133,4452,문성우/Noun,39,2,37,4.445926419917751e-05,0.0004331504475887958,0.9487179487179488
2134,4453,환불/Noun,39,3,36,5.5574080248971876e-05,0.0004220440258557498,0.9230769230769232
2135,4454,황홀하다/Adjective,39,36,3,0.00042236300989218633,5.553210866523024e-05,0.9230769230769232
2136,4455,뭡/Noun,39,4,35,6.668889629876625e-05,0.0004109376041227037,0.8974358974358975
2137,4456,은은하다/Adjective,39,35,4,0.0004112481938423919,6.663853039827628e-05,0.8974358974358975
2138,4457,에서야/Josa,39,35,4,0.0004112481938423919,6.663853039827628e-05,0.8974358974358975
2139,4458,후지/Noun,39,4,35,6.668889629876625e-05,0.0004109376041227037,0.8974358974358975
2140,4459,우익/Noun,39,5,34,7.780371234856063e-05,0.00039983118238965764,0.8717948717948718
2141,4460,엉덩이/Noun,39,6,33,8.891852839835501e-05,0.00038872476065661166,0.8461538461538461
2142,4461,에릭/Noun,39,33,6,0.00038901856174280313,8.885137386436837e-05,0.8461538461538461
2143,4462,불면증/Noun,39,7,32,0.0001000333444481494,0.0003776183389235656,0.8205128205128205
2144,4463,찌푸리다/Verb,39,7,32,0.0001000333444481494,0.0003776183389235656,0.8205128205128205
2145,4464,구라/Noun,39,7,32,0.0001000333444481494,0.0003776183389235656,0.8205128205128205
2146,4465,젊음/Noun,39,31,8,0.00036678892964321435,0.00011106421733046048,0.7948717948717948
2147,4466,놀이/Suffix,39,8,31,0.00011114816049794375,0.00036651191719051963,0.7948717948717948
2148,4467,파이다/Verb,39,31,8,0.00036678892964321435,0.00011106421733046048,0.7948717948717948
2149,4468,울음/Noun,39,31,8,0.00036678892964321435,0.00011106421733046048,0.7948717948717948
2150,4469,헤어/Noun,39,30,9,0.00035567411359342004,0.00012217063906350652,0.7692307692307693
2151,4470,mbc/Alpha,39,9,30,0.00012226297654773814,0.0003554054954574735,0.7692307692307693
2152,4471,루이스/Noun,39,29,10,0.0003445592975436257,0.00013327706079655256,0.7435897435897436
2153,4472,에일리언/Noun,39,11,28,0.0001444926086473269,0.0003331926519913814,0.7179487179487181
2154,4473,전기/Noun,39,11,28,0.0001444926086473269,0.0003331926519913814,0.7179487179487181
2155,4474,극한/Noun,39,28,11,0.0003334444814938313,0.0001443834825295986,0.7179487179487181
2156,4475,우아하다/Adjective,39,28,11,0.0003334444814938313,0.0001443834825295986,0.7179487179487181
2157,4476,묘미/Noun,39,28,11,0.0003334444814938313,0.0001443834825295986,0.7179487179487181
2158,4477,관계자/Noun,39,11,28,0.0001444926086473269,0.0003331926519913814,0.7179487179487181
2159,4478,로그/Noun,39,11,28,0.0001444926086473269,0.0003331926519913814,0.7179487179487181
2160,4479,사나이/Noun,39,27,12,0.00032232966544403684,0.00015548990426264466,0.6923076923076923
2161,4480,오류/Noun,39,12,27,0.00015560742469712126,0.00032208623025833537,0.6923076923076923
2162,4481,이민정/Noun,39,27,12,0.00032232966544403684,0.00015548990426264466,0.6923076923076923
2163,4482,완/Noun,39,27,12,0.00032232966544403684,0.00015548990426264466,0.6923076923076923
2164,4483,한쪽/Noun,39,12,27,0.00015560742469712126,0.00032208623025833537,0.6923076923076923
2165,4484,활약/Noun,39,27,12,0.00032232966544403684,0.00015548990426264466,0.6923076923076923
2166,4485,필수/Noun,39,27,12,0.00032232966544403684,0.00015548990426264466,0.6923076923076923
2167,4486,제시/Noun,39,27,12,0.00032232966544403684,0.00015548990426264466,0.6923076923076923
2168,4487,찢다/Verb,39,13,26,0.00016672224074691566,0.00031097980852528933,0.6666666666666666
2169,4488,때메/Noun,39,13,26,0.00016672224074691566,0.00031097980852528933,0.6666666666666666
2170,4489,가사/Noun,39,26,13,0.00031121484939424253,0.0001665963259956907,0.6666666666666666
2171,4490,기간/Noun,39,26,13,0.00031121484939424253,0.0001665963259956907,0.6666666666666666
2172,4491,in/Alpha,39,26,13,0.00031121484939424253,0.0001665963259956907,0.6666666666666666
2173,4492,핸드폰/Noun,39,13,26,0.00016672224074691566,0.00031097980852528933,0.6666666666666666
2174,4493,멍청이/Noun,39,13,26,0.00016672224074691566,0.00031097980852528933,0.6666666666666666
2175,4494,사라/Noun,39,26,13,0.00031121484939424253,0.0001665963259956907,0.6666666666666666
2176,4495,쿠/Noun,39,26,13,0.00031121484939424253,0.0001665963259956907,0.6666666666666666
2177,4534,안질리다/Verb,38,37,1,0.0004334778259419807,3.331926519913814e-05,0.9736842105263158
2178,4535,아리다/Adjective,38,36,2,0.00042236300989218633,4.4425686932184186e-05,0.9473684210526316
2179,4536,자빠지다/Verb,38,3,35,5.5574080248971876e-05,0.0004109376041227037,0.9210526315789472
2180,4537,무니/Noun,38,5,33,7.780371234856063e-05,0.00038872476065661166,0.8684210526315791
2181,4538,불친절하다/Adjective,38,5,33,7.780371234856063e-05,0.00038872476065661166,0.8684210526315791
2182,4539,은지/Noun,38,5,33,7.780371234856063e-05,0.00038872476065661166,0.8684210526315791
2183,4540,거창하다/Adjective,38,5,33,7.780371234856063e-05,0.00038872476065661166,0.8684210526315791
2184,4541,깝/Noun,38,6,32,8.891852839835501e-05,0.0003776183389235656,0.8421052631578947
2185,4542,0.5/Number,38,6,32,8.891852839835501e-05,0.0003776183389235656,0.8421052631578947
2186,4543,허탈하다/Adjective,38,7,31,0.0001000333444481494,0.00036651191719051963,0.8157894736842105
2187,4544,!!!!!!!/Punctuation,38,31,7,0.00036678892964321435,9.995779559741441e-05,0.8157894736842105
2188,4545,현대인/Noun,38,31,7,0.00036678892964321435,9.995779559741441e-05,0.8157894736842105
2189,4546,화평/Noun,38,9,29,0.00012226297654773814,0.00034429907372442745,0.7631578947368421
2190,4547,살아오다/Verb,38,29,9,0.0003445592975436257,0.00012217063906350652,0.7631578947368421
2191,4548,까먹다/Verb,38,9,29,0.00012226297654773814,0.00034429907372442745,0.7631578947368421
2192,4549,치열하다/Adjective,38,28,10,0.0003334444814938313,0.00013327706079655256,0.7368421052631579
2193,4550,제작사/Noun,38,10,28,0.0001333777925975325,0.0003331926519913814,0.7368421052631579
2194,4551,경쾌하다/Adjective,38,28,10,0.0003334444814938313,0.00013327706079655256,0.7368421052631579
2195,4552,연령/Noun,38,10,28,0.0001333777925975325,0.0003331926519913814,0.7368421052631579
2196,4553,F/Alpha,38,11,27,0.0001444926086473269,0.00032208623025833537,0.7105263157894737
2197,4554,간의/Noun,38,27,11,0.00032232966544403684,0.0001443834825295986,0.7105263157894737
2198,4555,생략/Noun,38,11,27,0.0001444926086473269,0.00032208623025833537,0.7105263157894737
2199,4556,14년/Number,38,27,11,0.00032232966544403684,0.0001443834825295986,0.7105263157894737
2200,4557,가버리다/Verb,38,12,26,0.00015560742469712126,0.00031097980852528933,0.6842105263157895
2201,4558,미만/Noun,38,12,26,0.00015560742469712126,0.00031097980852528933,0.6842105263157895
2202,4559,전세계/Noun,38,26,12,0.00031121484939424253,0.00015548990426264466,0.6842105263157895
2203,4560,질주/Noun,38,25,13,0.00030010003334444816,0.0001665963259956907,0.6578947368421053
2204,4561,아카데미/Noun,38,25,13,0.00030010003334444816,0.0001665963259956907,0.6578947368421053
2205,4562,부수/Noun,38,13,25,0.00016672224074691566,0.0002998733867922433,0.6578947368421053
2206,4563,동의/Noun,38,13,25,0.00016672224074691566,0.0002998733867922433,0.6578947368421053
2207,4564,청/Noun,38,13,25,0.00016672224074691566,0.0002998733867922433,0.6578947368421053
2208,4565,멍하다/Adjective,38,25,13,0.00030010003334444816,0.0001665963259956907,0.6578947368421053
2209,4566,물어보다/Verb,38,13,25,0.00016672224074691566,0.0002998733867922433,0.6578947368421053
2210,4602,찬란/Noun,37,0,37,2.2229632099588756e-05,0.0004331504475887958,1.0
2211,4603,채플린/Noun,37,34,3,0.0004001333777925976,5.553210866523024e-05,0.9189189189189191
2212,4604,대책/Noun,37,3,34,5.5574080248971876e-05,0.00039983118238965764,0.9189189189189191
2213,4605,날로/Noun,37,3,34,5.5574080248971876e-05,0.00039983118238965764,0.9189189189189191
2214,4606,개잼/Noun,37,33,4,0.00038901856174280313,6.663853039827628e-05,0.8918918918918919
2215,4607,워싱턴/Noun,37,33,4,0.00038901856174280313,6.663853039827628e-05,0.8918918918918919
2216,4608,꾹/Noun,37,4,33,6.668889629876625e-05,0.00038872476065661166,0.8918918918918919
2217,4609,거뭐/Noun,37,5,32,7.780371234856063e-05,0.0003776183389235656,0.8648648648648649
2218,4610,설레임/Noun,37,32,5,0.00037790374569300877,7.774495213132233e-05,0.8648648648648649
2219,4611,습작/Noun,37,5,32,7.780371234856063e-05,0.0003776183389235656,0.8648648648648649
2220,4612,신들리다/Adjective,37,32,5,0.00037790374569300877,7.774495213132233e-05,0.8648648648648649
2221,4613,두근두근/Adverb,37,31,6,0.00036678892964321435,8.885137386436837e-05,0.8378378378378378
2222,4614,뇌리/Noun,37,31,6,0.00036678892964321435,8.885137386436837e-05,0.8378378378378378
2223,4615,패턴/Noun,37,6,31,8.891852839835501e-05,0.00036651191719051963,0.8378378378378378
2224,4616,공개/Noun,37,6,31,8.891852839835501e-05,0.00036651191719051963,0.8378378378378378
2225,4617,동아리/Noun,37,6,31,8.891852839835501e-05,0.00036651191719051963,0.8378378378378378
2226,4618,몰락/Noun,37,7,30,0.0001000333444481494,0.0003554054954574735,0.8108108108108109
2227,4619,옹호/Noun,37,7,30,0.0001000333444481494,0.0003554054954574735,0.8108108108108109
2228,4620,껄/Noun,37,7,30,0.0001000333444481494,0.0003554054954574735,0.8108108108108109
2229,4621,오로라/Noun,37,7,30,0.0001000333444481494,0.0003554054954574735,0.8108108108108109
2230,4622,신비롭다/Adjective,37,30,7,0.00035567411359342004,9.995779559741441e-05,0.8108108108108109
2231,4623,이라고는/Josa,37,8,29,0.00011114816049794375,0.00034429907372442745,0.7837837837837838
2232,4624,넋/Noun,37,29,8,0.0003445592975436257,0.00011106421733046048,0.7837837837837838
2233,4625,눈부시다/Adjective,37,29,8,0.0003445592975436257,0.00011106421733046048,0.7837837837837838
2234,4626,서우/Noun,37,8,29,0.00011114816049794375,0.00034429907372442745,0.7837837837837838
2235,4627,라곤/Josa,37,8,29,0.00011114816049794375,0.00034429907372442745,0.7837837837837838
2236,4628,닦다/Verb,37,8,29,0.00011114816049794375,0.00034429907372442745,0.7837837837837838
2237,4629,강호동/Noun,37,9,28,0.00012226297654773814,0.0003331926519913814,0.7567567567567568
2238,4630,탕웨이/Noun,37,28,9,0.0003334444814938313,0.00012217063906350652,0.7567567567567568
2239,4631,유도/Noun,37,9,28,0.00012226297654773814,0.0003331926519913814,0.7567567567567568
2240,4632,고질라/Noun,37,9,28,0.00012226297654773814,0.0003331926519913814,0.7567567567567568
2241,4633,엠마/Noun,37,28,9,0.0003334444814938313,0.00012217063906350652,0.7567567567567568
2242,4634,이남/Noun,37,28,9,0.0003334444814938313,0.00012217063906350652,0.7567567567567568
2243,4635,켄/Noun,37,28,9,0.0003334444814938313,0.00012217063906350652,0.7567567567567568
2244,4636,오랜/Adverb,37,27,10,0.00032232966544403684,0.00013327706079655256,0.7297297297297297
2245,4637,.!!/Punctuation,37,27,10,0.00032232966544403684,0.00013327706079655256,0.7297297297297297
2246,4638,근거/Noun,37,10,27,0.0001333777925975325,0.00032208623025833537,0.7297297297297297
2247,4639,브래드피트/Noun,37,27,10,0.00032232966544403684,0.00013327706079655256,0.7297297297297297
2248,4640,엑소시스트/Noun,37,10,27,0.0001333777925975325,0.00032208623025833537,0.7297297297297297
2249,4641,예의/Noun,37,11,26,0.0001444926086473269,0.00031097980852528933,0.7027027027027027
2250,4642,수술/Noun,37,11,26,0.0001444926086473269,0.00031097980852528933,0.7027027027027027
2251,4643,힙합/Noun,37,11,26,0.0001444926086473269,0.00031097980852528933,0.7027027027027027
2252,4644,............./Punctuation,37,11,26,0.0001444926086473269,0.00031097980852528933,0.7027027027027027
2253,4645,마초/Noun,37,11,26,0.0001444926086473269,0.00031097980852528933,0.7027027027027027
2254,4646,부담스럽다/Adjective,37,11,26,0.0001444926086473269,0.00031097980852528933,0.7027027027027027
2255,4647,소문/Noun,37,11,26,0.0001444926086473269,0.00031097980852528933,0.7027027027027027
2256,4648,사서/Noun,37,26,11,0.00031121484939424253,0.0001443834825295986,0.7027027027027027
2257,4649,변호사/Noun,37,26,11,0.00031121484939424253,0.0001443834825295986,0.7027027027027027
2258,4650,신선/Noun,37,25,12,0.00030010003334444816,0.00015548990426264466,0.6756756756756757
2259,4651,성향/Noun,37,12,25,0.00015560742469712126,0.0002998733867922433,0.6756756756756757
2260,4694,낚임/Noun,36,0,36,2.2229632099588756e-05,0.0004220440258557498,1.0
2261,4695,되돌아보다/Verb,36,35,1,0.0004112481938423919,3.331926519913814e-05,0.9722222222222222
2262,4696,보고/Foreign,36,3,33,5.5574080248971876e-05,0.00038872476065661166,0.9166666666666666
2263,4697,치기/Noun,36,3,33,5.5574080248971876e-05,0.00038872476065661166,0.9166666666666666
2264,4698,큐브/Noun,36,4,32,6.668889629876625e-05,0.0003776183389235656,0.8888888888888888
2265,4699,욤/Noun,36,31,5,0.00036678892964321435,7.774495213132233e-05,0.8611111111111112
2266,4700,허니/Noun,36,31,5,0.00036678892964321435,7.774495213132233e-05,0.8611111111111112
2267,4701,100분/Number,36,5,31,7.780371234856063e-05,0.00036651191719051963,0.8611111111111112
2268,4702,발암/Noun,36,5,31,7.780371234856063e-05,0.00036651191719051963,0.8611111111111112
2269,4703,엑스트라/Noun,36,6,30,8.891852839835501e-05,0.0003554054954574735,0.8333333333333334
2270,4704,서극/Noun,36,7,29,0.0001000333444481494,0.00034429907372442745,0.8055555555555556
2271,4705,멋대로/Noun,36,7,29,0.0001000333444481494,0.00034429907372442745,0.8055555555555556
2272,4706,평이하다/Adjective,36,7,29,0.0001000333444481494,0.00034429907372442745,0.8055555555555556
2273,4707,내러티브/Noun,36,8,28,0.00011114816049794375,0.0003331926519913814,0.7777777777777778
2274,4708,볼껄/Noun,36,8,28,0.00011114816049794375,0.0003331926519913814,0.7777777777777778
2275,4709,t/Alpha,36,28,8,0.0003334444814938313,0.00011106421733046048,0.7777777777777778
2276,4710,하차/Noun,36,8,28,0.00011114816049794375,0.0003331926519913814,0.7777777777777778
2277,4711,!!!!!!!!/Punctuation,36,28,8,0.0003334444814938313,0.00011106421733046048,0.7777777777777778
2278,4712,꽉/Noun,36,28,8,0.0003334444814938313,0.00011106421733046048,0.7777777777777778
2279,4713,역사왜곡/Noun,36,9,27,0.00012226297654773814,0.00032208623025833537,0.75
2280,4714,자신감/Noun,36,9,27,0.00012226297654773814,0.00032208623025833537,0.75
2281,4715,진화/Noun,36,26,10,0.00031121484939424253,0.00013327706079655256,0.7222222222222222
2282,4716,자본주의/Noun,36,26,10,0.00031121484939424253,0.00013327706079655256,0.7222222222222222
2283,4717,줄리엣/Noun,36,26,10,0.00031121484939424253,0.00013327706079655256,0.7222222222222222
2284,4718,다가가다/Verb,36,26,10,0.00031121484939424253,0.00013327706079655256,0.7222222222222222
2285,4719,지진희/Noun,36,10,26,0.0001333777925975325,0.00031097980852528933,0.7222222222222222
2286,4720,수애/Noun,36,25,11,0.00030010003334444816,0.0001443834825295986,0.6944444444444444
2287,4721,정신차리다/Adjective,36,11,25,0.0001444926086473269,0.0002998733867922433,0.6944444444444444
2288,4722,먹이다/Verb,36,12,24,0.00015560742469712126,0.0002887669650591972,0.6666666666666666
2289,4723,어찌나/Adverb,36,24,12,0.0002889852172946538,0.00015548990426264466,0.6666666666666666
2290,4724,문근영/Noun,36,24,12,0.0002889852172946538,0.00015548990426264466,0.6666666666666666
2291,4725,호평/Noun,36,12,24,0.00015560742469712126,0.0002887669650591972,0.6666666666666666
2292,4766,♡♡/Foreign,35,35,0,0.0004112481938423919,2.2212843466092093e-05,1.0
2293,4767,최저/Noun,35,1,34,3.334444814938313e-05,0.00039983118238965764,0.9714285714285714
2294,4768,나열/Noun,35,2,33,4.445926419917751e-05,0.00038872476065661166,0.9428571428571428
2295,4769,알맹이/Noun,35,2,33,4.445926419917751e-05,0.00038872476065661166,0.9428571428571428
2296,4770,정신건강/Noun,35,3,32,5.5574080248971876e-05,0.0003776183389235656,0.9142857142857144
2297,4771,도아/Noun,35,3,32,5.5574080248971876e-05,0.0003776183389235656,0.9142857142857144
2298,4772,건강하다/Adjective,35,31,4,0.00036678892964321435,6.663853039827628e-05,0.8857142857142857
2299,4773,^_^/Punctuation,35,30,5,0.00035567411359342004,7.774495213132233e-05,0.8571428571428571
2300,4774,선전/Noun,35,5,30,7.780371234856063e-05,0.0003554054954574735,0.8571428571428571
2301,4775,구매/Noun,35,29,6,0.0003445592975436257,8.885137386436837e-05,0.8285714285714286
2302,4776,진솔하다/Adjective,35,29,6,0.0003445592975436257,8.885137386436837e-05,0.8285714285714286
2303,4777,이나마/Josa,35,29,6,0.0003445592975436257,8.885137386436837e-05,0.8285714285714286
2304,4778,어물/Noun,35,6,29,8.891852839835501e-05,0.00034429907372442745,0.8285714285714286
2305,4779,찰리/Noun,35,28,7,0.0003334444814938313,9.995779559741441e-05,0.8
2306,4780,합리화/Noun,35,7,28,0.0001000333444481494,0.0003331926519913814,0.8
2307,4781,작정/Noun,35,8,27,0.00011114816049794375,0.00032208623025833537,0.7714285714285715
2308,4782,데이먼/Noun,35,27,8,0.00032232966544403684,0.00011106421733046048,0.7714285714285715
2309,4783,잡지/Noun,35,8,27,0.00011114816049794375,0.00032208623025833537,0.7714285714285715
2310,4784,갑갑하다/Adjective,35,8,27,0.00011114816049794375,0.00032208623025833537,0.7714285714285715
2311,4785,인내/Noun,35,9,26,0.00012226297654773814,0.00031097980852528933,0.7428571428571429
2312,4786,미군/Noun,35,9,26,0.00012226297654773814,0.00031097980852528933,0.7428571428571429
2313,4787,발톱/Noun,35,9,26,0.00012226297654773814,0.00031097980852528933,0.7428571428571429
2314,4788,괴롭히다/Verb,35,9,26,0.00012226297654773814,0.00031097980852528933,0.7428571428571429
2315,4789,과도/Josa,35,26,9,0.00031121484939424253,0.00012217063906350652,0.7428571428571429
2316,4790,악몽/Noun,35,9,26,0.00012226297654773814,0.00031097980852528933,0.7428571428571429
2317,4791,ㄴㄴ/KoreanParticle,35,9,26,0.00012226297654773814,0.00031097980852528933,0.7428571428571429
2318,4792,보스/Noun,35,9,26,0.00012226297654773814,0.00031097980852528933,0.7428571428571429
2319,4793,띄우다/Verb,35,9,26,0.00012226297654773814,0.00031097980852528933,0.7428571428571429
2320,4794,치밀다/Verb,35,9,26,0.00012226297654773814,0.00031097980852528933,0.7428571428571429
2321,4795,광주/Noun,35,9,26,0.00012226297654773814,0.00031097980852528933,0.7428571428571429
2322,4796,혼나다/Verb,35,10,25,0.0001333777925975325,0.0002998733867922433,0.7142857142857143
2323,4797,태우다/Verb,35,10,25,0.0001333777925975325,0.0002998733867922433,0.7142857142857143
2324,4798,엘/Noun,35,25,10,0.00030010003334444816,0.00013327706079655256,0.7142857142857143
2325,4799,잣/Noun,35,10,25,0.0001333777925975325,0.0002998733867922433,0.7142857142857143
2326,4800,마구/Noun,35,10,25,0.0001333777925975325,0.0002998733867922433,0.7142857142857143
2327,4801,설치다/Adjective,35,10,25,0.0001333777925975325,0.0002998733867922433,0.7142857142857143
2328,4802,스포일러/Noun,35,24,11,0.0002889852172946538,0.0001443834825295986,0.6857142857142857
2329,4803,여자도/Noun,35,11,24,0.0001444926086473269,0.0002887669650591972,0.6857142857142857
2330,4804,쌓이다/Verb,35,11,24,0.0001444926086473269,0.0002887669650591972,0.6857142857142857
2331,4805,흘러나오다/Verb,35,23,12,0.00027787040124485944,0.00015548990426264466,0.6571428571428571
2332,4806,스티브/Noun,35,23,12,0.00027787040124485944,0.00015548990426264466,0.6571428571428571
2333,4807,이분/Noun,35,23,12,0.00027787040124485944,0.00015548990426264466,0.6571428571428571
2334,4808,한국말/Noun,35,12,23,0.00015560742469712126,0.00027766054332615115,0.6571428571428571
2335,4809,로우/Noun,35,23,12,0.00027787040124485944,0.00015548990426264466,0.6571428571428571
2336,4810,족/Noun,35,12,23,0.00015560742469712126,0.00027766054332615115,0.6571428571428571
2337,4811,듯이/Noun,35,12,23,0.00015560742469712126,0.00027766054332615115,0.6571428571428571
2338,4812,캐서린/Noun,35,12,23,0.00015560742469712126,0.00027766054332615115,0.6571428571428571
2339,4847,퉤/Noun,34,2,32,4.445926419917751e-05,0.0003776183389235656,0.9411764705882352
2340,4848,만큼도/Josa,34,2,32,4.445926419917751e-05,0.0003776183389235656,0.9411764705882352
2341,4849,박신혜/Noun,34,31,3,0.00036678892964321435,5.553210866523024e-05,0.9117647058823528
2342,4850,자질/Noun,34,3,31,5.5574080248971876e-05,0.00036651191719051963,0.9117647058823528
2343,4851,...;;;/Punctuation,34,3,31,5.5574080248971876e-05,0.00036651191719051963,0.9117647058823528
2344,4852,공효진/Noun,34,30,4,0.00035567411359342004,6.663853039827628e-05,0.8823529411764706
2345,4853,톰크루즈/Noun,34,29,5,0.0003445592975436257,7.774495213132233e-05,0.8529411764705882
2346,4854,맑은/Noun,34,29,5,0.0003445592975436257,7.774495213132233e-05,0.8529411764705882
2347,4855,칠이/Noun,34,5,29,7.780371234856063e-05,0.00034429907372442745,0.8529411764705882
2348,4856,동호/Noun,34,5,29,7.780371234856063e-05,0.00034429907372442745,0.8529411764705882
2349,4857,이동욱/Noun,34,29,5,0.0003445592975436257,7.774495213132233e-05,0.8529411764705882
2350,4858,동기/Noun,34,6,28,8.891852839835501e-05,0.0003331926519913814,0.8235294117647058
2351,4859,~!!!!/Punctuation,34,27,7,0.00032232966544403684,9.995779559741441e-05,0.7941176470588235
2352,4860,가시/Noun,34,27,7,0.00032232966544403684,9.995779559741441e-05,0.7941176470588235
2353,4861,급전/Noun,34,7,27,0.0001000333444481494,0.00032208623025833537,0.7941176470588235
2354,4862,또한/Modifier,34,27,7,0.00032232966544403684,9.995779559741441e-05,0.7941176470588235
2355,4863,고려/Noun,34,7,27,0.0001000333444481494,0.00032208623025833537,0.7941176470588235
2356,4864,지다/Noun,34,27,7,0.00032232966544403684,9.995779559741441e-05,0.7941176470588235
2357,4865,카타르/Noun,34,27,7,0.00032232966544403684,9.995779559741441e-05,0.7941176470588235
2358,4866,숭고하다/Adjective,34,27,7,0.00032232966544403684,9.995779559741441e-05,0.7941176470588235
2359,4867,화이/Noun,34,27,7,0.00032232966544403684,9.995779559741441e-05,0.7941176470588235
2360,4868,뺨/Noun,34,8,26,0.00011114816049794375,0.00031097980852528933,0.7647058823529411
2361,4869,아웃/Noun,34,8,26,0.00011114816049794375,0.00031097980852528933,0.7647058823529411
2362,4870,출연료/Noun,34,8,26,0.00011114816049794375,0.00031097980852528933,0.7647058823529411
2363,4871,흥겹다/Adjective,34,26,8,0.00031121484939424253,0.00011106421733046048,0.7647058823529411
2364,4872,비급/Noun,34,8,26,0.00011114816049794375,0.00031097980852528933,0.7647058823529411
2365,4873,통한/Noun,34,26,8,0.00031121484939424253,0.00011106421733046048,0.7647058823529411
2366,4874,저예산영화/Noun,34,8,26,0.00011114816049794375,0.00031097980852528933,0.7647058823529411
2367,4875,멜깁슨/Noun,34,26,8,0.00031121484939424253,0.00011106421733046048,0.7647058823529411
2368,4876,어딨다/Verb,34,8,26,0.00011114816049794375,0.00031097980852528933,0.7647058823529411
2369,4877,행운/Noun,34,25,9,0.00030010003334444816,0.00012217063906350652,0.7352941176470589
2370,4878,도망/Noun,34,9,25,0.00012226297654773814,0.0002998733867922433,0.7352941176470589
2371,4879,린치/Noun,34,25,9,0.00030010003334444816,0.00012217063906350652,0.7352941176470589
2372,4880,잘쓰다/Verb,34,9,25,0.00012226297654773814,0.0002998733867922433,0.7352941176470589
2373,4881,또다시/Adverb,34,25,9,0.00030010003334444816,0.00012217063906350652,0.7352941176470589
2374,4882,처참하다/Adjective,34,9,25,0.00012226297654773814,0.0002998733867922433,0.7352941176470589
2375,4883,두/Modifier,34,9,25,0.00012226297654773814,0.0002998733867922433,0.7352941176470589
2376,4884,흐/Noun,34,25,9,0.00030010003334444816,0.00012217063906350652,0.7352941176470589
2377,4885,속도/Noun,34,10,24,0.0001333777925975325,0.0002887669650591972,0.7058823529411765
2378,4886,일본어/Noun,34,10,24,0.0001333777925975325,0.0002887669650591972,0.7058823529411765
2379,4887,털리다/Verb,34,10,24,0.0001333777925975325,0.0002887669650591972,0.7058823529411765
2380,4888,나아가다/Verb,34,24,10,0.0002889852172946538,0.00013327706079655256,0.7058823529411765
2381,4889,질투/Noun,34,24,10,0.0002889852172946538,0.00013327706079655256,0.7058823529411765
2382,4890,사이코패스/Noun,34,10,24,0.0001333777925975325,0.0002887669650591972,0.7058823529411765
2383,4891,2010년/Number,34,10,24,0.0001333777925975325,0.0002887669650591972,0.7058823529411765
2384,4892,김남길/Noun,34,24,10,0.0002889852172946538,0.00013327706079655256,0.7058823529411765
2385,4893,스치다/Verb,34,24,10,0.0002889852172946538,0.00013327706079655256,0.7058823529411765
2386,4894,파일/Noun,34,23,11,0.00027787040124485944,0.0001443834825295986,0.6764705882352942
2387,4895,S/Alpha,34,23,11,0.00027787040124485944,0.0001443834825295986,0.6764705882352942
2388,4896,떼/Noun,34,11,23,0.0001444926086473269,0.00027766054332615115,0.6764705882352942
2389,4897,토미/Noun,34,23,11,0.00027787040124485944,0.0001443834825295986,0.6764705882352942
2390,4956,!!^^/Punctuation,33,33,0,0.00038901856174280313,2.2212843466092093e-05,1.0
2391,4957,앓이/Noun,33,33,0,0.00038901856174280313,2.2212843466092093e-05,1.0
2392,4958,서세원/Noun,33,1,32,3.334444814938313e-05,0.0003776183389235656,0.9696969696969696
2393,4959,모처럼/Noun,33,32,1,0.00037790374569300877,3.331926519913814e-05,0.9696969696969696
2394,4960,알차다/Adjective,33,31,2,0.00036678892964321435,4.4425686932184186e-05,0.9393939393939394
2395,4961,조아/Adverb,33,31,2,0.00036678892964321435,4.4425686932184186e-05,0.9393939393939394
2396,4962,국뽕/Noun,33,3,30,5.5574080248971876e-05,0.0003554054954574735,0.9090909090909092
2397,4963,듣보잡/Noun,33,3,30,5.5574080248971876e-05,0.0003554054954574735,0.9090909090909092
2398,4964,best/Alpha,33,30,3,0.00035567411359342004,5.553210866523024e-05,0.9090909090909092
2399,4965,혹성탈출/Noun,33,6,27,8.891852839835501e-05,0.00032208623025833537,0.8181818181818182
2400,4966,어줍다/Adjective,33,6,27,8.891852839835501e-05,0.00032208623025833537,0.8181818181818182
2401,4967,매회/Adverb,33,27,6,0.00032232966544403684,8.885137386436837e-05,0.8181818181818182
2402,4968,놀이/Noun,33,7,26,0.0001000333444481494,0.00031097980852528933,0.7878787878787878
2403,4969,각인/Noun,33,26,7,0.00031121484939424253,9.995779559741441e-05,0.7878787878787878
2404,4970,공격/Noun,33,7,26,0.0001000333444481494,0.00031097980852528933,0.7878787878787878
2405,4971,사랑과전쟁/Noun,33,8,25,0.00011114816049794375,0.0002998733867922433,0.7575757575757576
2406,4972,마련/Noun,33,25,8,0.00030010003334444816,0.00011106421733046048,0.7575757575757576
2407,4973,발레/Noun,33,25,8,0.00030010003334444816,0.00011106421733046048,0.7575757575757576
2408,4974,해대/Noun,33,8,25,0.00011114816049794375,0.0002998733867922433,0.7575757575757576
2409,4975,전결/Noun,33,8,25,0.00011114816049794375,0.0002998733867922433,0.7575757575757576
2410,4976,진구/Noun,33,24,9,0.0002889852172946538,0.00012217063906350652,0.7272727272727273
2411,4977,서서히/Noun,33,24,9,0.0002889852172946538,0.00012217063906350652,0.7272727272727273
2412,4978,갑작스럽다/Adjective,33,9,24,0.00012226297654773814,0.0002887669650591972,0.7272727272727273
2413,4979,자아내다/Verb,33,24,9,0.0002889852172946538,0.00012217063906350652,0.7272727272727273
2414,4980,대의/Foreign,33,24,9,0.0002889852172946538,0.00012217063906350652,0.7272727272727273
2415,4981,대도/Noun,33,9,24,0.00012226297654773814,0.0002887669650591972,0.7272727272727273
2416,4982,나이트/Noun,33,10,23,0.0001333777925975325,0.00027766054332615115,0.696969696969697
2417,4983,얼른/Noun,33,23,10,0.00027787040124485944,0.00013327706079655256,0.696969696969697
2418,4984,재회/Noun,33,23,10,0.00027787040124485944,0.00013327706079655256,0.696969696969697
2419,4985,좌파/Noun,33,10,23,0.0001333777925975325,0.00027766054332615115,0.696969696969697
2420,4986,회장/Noun,33,10,23,0.0001333777925975325,0.00027766054332615115,0.696969696969697
2421,4987,돌아다니다/Verb,33,10,23,0.0001333777925975325,0.00027766054332615115,0.696969696969697
2422,4988,부러/Noun,33,23,10,0.00027787040124485944,0.00013327706079655256,0.696969696969697
2423,4989,승/Noun,33,11,22,0.0001444926086473269,0.00026655412159310506,0.6666666666666666
2424,4990,…/Punctuation,33,11,22,0.0001444926086473269,0.00026655412159310506,0.6666666666666666
2425,4991,후유증/Noun,33,22,11,0.000266755585195065,0.0001443834825295986,0.6666666666666666
2426,4992,안녕/Noun,33,22,11,0.000266755585195065,0.0001443834825295986,0.6666666666666666
2427,4993,에게나/Josa,33,22,11,0.000266755585195065,0.0001443834825295986,0.6666666666666666
2428,4994,효민/Noun,33,11,22,0.0001444926086473269,0.00026655412159310506,0.6666666666666666
2429,4995,피우다/Verb,33,11,22,0.0001444926086473269,0.00026655412159310506,0.6666666666666666
2430,4996,까지가/Josa,33,11,22,0.0001444926086473269,0.00026655412159310506,0.6666666666666666
2431,4997,케이스/Noun,33,11,22,0.0001444926086473269,0.00026655412159310506,0.6666666666666666
2432,4998,낯선/Noun,33,22,11,0.000266755585195065,0.0001443834825295986,0.6666666666666666
2433,5051,보석같다/Adjective,32,31,1,0.00036678892964321435,3.331926519913814e-05,0.96875
2434,5052,명곡/Noun,32,30,2,0.00035567411359342004,4.4425686932184186e-05,0.9375
2435,5053,유행어/Noun,32,2,30,4.445926419917751e-05,0.0003554054954574735,0.9375
2436,5054,AV/Alpha,32,2,30,4.445926419917751e-05,0.0003554054954574735,0.9375
2437,5055,얄팍하다/Adjective,32,2,30,4.445926419917751e-05,0.0003554054954574735,0.9375
2438,5056,></Punctuation,32,30,2,0.00035567411359342004,4.4425686932184186e-05,0.9375
2439,5057,썰렁하다/Adjective,32,3,29,5.5574080248971876e-05,0.00034429907372442745,0.90625
2440,5058,Very/Alpha,32,29,3,0.0003445592975436257,5.553210866523024e-05,0.90625
2441,5059,테스트/Noun,32,3,29,5.5574080248971876e-05,0.00034429907372442745,0.90625
2442,5060,love/Alpha,32,28,4,0.0003334444814938313,6.663853039827628e-05,0.875
2443,5061,괴작/Noun,32,4,28,6.668889629876625e-05,0.0003331926519913814,0.875
2444,5062,보석/Noun,32,28,4,0.0003334444814938313,6.663853039827628e-05,0.875
2445,5063,되새기다/Verb,32,28,4,0.0003334444814938313,6.663853039827628e-05,0.875
2446,5064,참혹하다/Adjective,32,27,5,0.00032232966544403684,7.774495213132233e-05,0.84375
2447,5065,어필/Noun,32,5,27,7.780371234856063e-05,0.00032208623025833537,0.84375
2448,5066,슈스케/Noun,32,5,27,7.780371234856063e-05,0.00032208623025833537,0.84375
2449,5067,마주/Noun,32,27,5,0.00032232966544403684,7.774495213132233e-05,0.84375
2450,5068,변명/Noun,32,6,26,8.891852839835501e-05,0.00031097980852528933,0.8125
2451,5069,감독판/Noun,32,26,6,0.00031121484939424253,8.885137386436837e-05,0.8125
2452,5070,아리/Noun,32,26,6,0.00031121484939424253,8.885137386436837e-05,0.8125
2453,5071,침몰/Noun,32,6,26,8.891852839835501e-05,0.00031097980852528933,0.8125
2454,5072,뽀로로/Noun,32,7,25,0.0001000333444481494,0.0002998733867922433,0.78125
2455,5073,맛깔나다/Adjective,32,25,7,0.00030010003334444816,9.995779559741441e-05,0.78125
2456,5074,토요명화/Noun,32,25,7,0.00030010003334444816,9.995779559741441e-05,0.78125
2457,5075,사소하다/Adjective,32,25,7,0.00030010003334444816,9.995779559741441e-05,0.78125
2458,5076,된장/Noun,32,8,24,0.00011114816049794375,0.0002887669650591972,0.75
2459,5077,쌍욕/Noun,32,8,24,0.00011114816049794375,0.0002887669650591972,0.75
2460,5078,어쨋/Noun,32,24,8,0.0002889852172946538,0.00011106421733046048,0.75
2461,5079,안달/Noun,32,8,24,0.00011114816049794375,0.0002887669650591972,0.75
2462,5080,취미/Noun,32,8,24,0.00011114816049794375,0.0002887669650591972,0.75
2463,5081,튀기다/Verb,32,8,24,0.00011114816049794375,0.0002887669650591972,0.75
2464,5082,my/Alpha,32,23,9,0.00027787040124485944,0.00012217063906350652,0.71875
2465,5083,콘서트/Noun,32,23,9,0.00027787040124485944,0.00012217063906350652,0.71875
2466,5084,토마스/Noun,32,23,9,0.00027787040124485944,0.00012217063906350652,0.71875
2467,5085,희극/Noun,32,22,10,0.000266755585195065,0.00013327706079655256,0.6875
2468,5086,싸/VerbPrefix,32,10,22,0.0001333777925975325,0.00026655412159310506,0.6875
2469,5087,압축/Noun,32,10,22,0.0001333777925975325,0.00026655412159310506,0.6875
2470,5088,아랫/Modifier,32,22,10,0.000266755585195065,0.00013327706079655256,0.6875
2471,5089,통일/Noun,32,22,10,0.000266755585195065,0.00013327706079655256,0.6875
2472,5090,me/Alpha,32,22,10,0.000266755585195065,0.00013327706079655256,0.6875
2473,5091,일베/Noun,32,10,22,0.0001333777925975325,0.00026655412159310506,0.6875
2474,5092,원빈/Noun,32,22,10,0.000266755585195065,0.00013327706079655256,0.6875
2475,5093,다한/Noun,32,10,22,0.0001333777925975325,0.00026655412159310506,0.6875
2476,5094,녹화/Noun,32,21,11,0.00025564076914527065,0.0001443834825295986,0.65625
2477,5095,기차/Noun,32,21,11,0.00025564076914527065,0.0001443834825295986,0.65625
2478,5096,주지훈/Noun,32,21,11,0.00025564076914527065,0.0001443834825295986,0.65625
2479,5097,공리/Noun,32,21,11,0.00025564076914527065,0.0001443834825295986,0.65625
2480,5098,정답/Noun,32,21,11,0.00025564076914527065,0.0001443834825295986,0.65625
2481,5099,최지우/Noun,32,21,11,0.00025564076914527065,0.0001443834825295986,0.65625
2482,5100,즘/Noun,32,11,21,0.0001444926086473269,0.0002554476998600591,0.65625
2483,5101,치르다/Verb,32,11,21,0.0001444926086473269,0.0002554476998600591,0.65625
2484,5102,벌이다/Verb,32,11,21,0.0001444926086473269,0.0002554476998600591,0.65625
2485,5103,치가/Noun,32,11,21,0.0001444926086473269,0.0002554476998600591,0.65625
2486,5104,무작정/Noun,32,11,21,0.0001444926086473269,0.0002554476998600591,0.65625
2487,5105,뱉다/Verb,32,11,21,0.0001444926086473269,0.0002554476998600591,0.65625
2488,5141,안듬/Noun,31,1,30,3.334444814938313e-05,0.0003554054954574735,0.967741935483871
2489,5142,참내/Noun,31,1,30,3.334444814938313e-05,0.0003554054954574735,0.967741935483871
2490,5143,이상형/Noun,31,28,3,0.0003334444814938313,5.553210866523024e-05,0.9032258064516128
2491,5144,못지않다/Adjective,31,28,3,0.0003334444814938313,5.553210866523024e-05,0.9032258064516128
2492,5145,그만두다/Verb,31,3,28,5.5574080248971876e-05,0.0003331926519913814,0.9032258064516128
2493,5146,잘맞다/Adjective,31,27,4,0.00032232966544403684,6.663853039827628e-05,0.8709677419354839
2494,5147,수습/Noun,31,4,27,6.668889629876625e-05,0.00032208623025833537,0.8709677419354839
2495,5148,발악/Noun,31,4,27,6.668889629876625e-05,0.00032208623025833537,0.8709677419354839
2496,5149,랍시고/Noun,31,4,27,6.668889629876625e-05,0.00032208623025833537,0.8709677419354839
2497,5150,자마자/Noun,31,5,26,7.780371234856063e-05,0.00031097980852528933,0.8387096774193549
2498,5151,공존/Noun,31,26,5,0.00031121484939424253,7.774495213132233e-05,0.8387096774193549
2499,5152,팬심/Noun,31,5,26,7.780371234856063e-05,0.00031097980852528933,0.8387096774193549
2500,5153,제이/Noun,31,26,5,0.00031121484939424253,7.774495213132233e-05,0.8387096774193549
2501,5154,봣던/Noun,31,25,6,0.00030010003334444816,8.885137386436837e-05,0.8064516129032258
2502,5155,통틀어/Noun,31,25,6,0.00030010003334444816,8.885137386436837e-05,0.8064516129032258
2503,5156,메리/Noun,31,25,6,0.00030010003334444816,8.885137386436837e-05,0.8064516129032258
2504,5157,쪽바리/Noun,31,6,25,8.891852839835501e-05,0.0002998733867922433,0.8064516129032258
2505,5158,결제/Noun,31,6,25,8.891852839835501e-05,0.0002998733867922433,0.8064516129032258
2506,5159,서인국/Noun,31,25,6,0.00030010003334444816,8.885137386436837e-05,0.8064516129032258
2507,5160,으로/Foreign,31,7,24,0.0001000333444481494,0.0002887669650591972,0.7741935483870968
2508,5161,히치콕/Noun,31,24,7,0.0002889852172946538,9.995779559741441e-05,0.7741935483870968
2509,5162,클린트/Noun,31,24,7,0.0002889852172946538,9.995779559741441e-05,0.7741935483870968
2510,5163,윌리엄스/Noun,31,24,7,0.0002889852172946538,9.995779559741441e-05,0.7741935483870968
2511,5164,혼/Noun,31,24,7,0.0002889852172946538,9.995779559741441e-05,0.7741935483870968
2512,5165,때론/Noun,31,24,7,0.0002889852172946538,9.995779559741441e-05,0.7741935483870968
2513,5166,기막히다/Adjective,31,23,8,0.00027787040124485944,0.00011106421733046048,0.7419354838709677
2514,5167,크리스틴/Noun,31,23,8,0.00027787040124485944,0.00011106421733046048,0.7419354838709677
2515,5168,부대/Noun,31,8,23,0.00011114816049794375,0.00027766054332615115,0.7419354838709677
2516,5169,이틀/Noun,31,23,8,0.00027787040124485944,0.00011106421733046048,0.7419354838709677
2517,5170,봣음/Noun,31,23,8,0.00027787040124485944,0.00011106421733046048,0.7419354838709677
2518,5171,욕설/Noun,31,8,23,0.00011114816049794375,0.00027766054332615115,0.7419354838709677
2519,5172,하필/Noun,31,9,22,0.00012226297654773814,0.00026655412159310506,0.7096774193548387
2520,5173,희한하다/Adjective,31,9,22,0.00012226297654773814,0.00026655412159310506,0.7096774193548387
2521,5174,윤계상/Noun,31,22,9,0.000266755585195065,0.00012217063906350652,0.7096774193548387
2522,5175,미니/Noun,31,22,9,0.000266755585195065,0.00012217063906350652,0.7096774193548387
2523,5176,대면/Noun,31,9,22,0.00012226297654773814,0.00026655412159310506,0.7096774193548387
2524,5177,약자/Noun,31,22,9,0.000266755585195065,0.00012217063906350652,0.7096774193548387
2525,5178,1억/Number,31,9,22,0.00012226297654773814,0.00026655412159310506,0.7096774193548387
2526,5179,사다코/Noun,31,9,22,0.00012226297654773814,0.00026655412159310506,0.7096774193548387
2527,5180,공상/Noun,31,9,22,0.00012226297654773814,0.00026655412159310506,0.7096774193548387
2528,5181,엑/Exclamation,31,9,22,0.00012226297654773814,0.00026655412159310506,0.7096774193548387
2529,5182,미개하다/Adjective,31,9,22,0.00012226297654773814,0.00026655412159310506,0.7096774193548387
2530,5183,....?/Punctuation,31,10,21,0.0001333777925975325,0.0002554476998600591,0.6774193548387096
2531,5184,츠/Noun,31,21,10,0.00025564076914527065,0.00013327706079655256,0.6774193548387096
2532,5185,인셉션/Noun,31,21,10,0.00025564076914527065,0.00013327706079655256,0.6774193548387096
2533,5186,스트립/Noun,31,21,10,0.00025564076914527065,0.00013327706079655256,0.6774193548387096
2534,5187,큰일/Noun,31,10,21,0.0001333777925975325,0.0002554476998600591,0.6774193548387096
2535,5188,오우/Noun,31,21,10,0.00025564076914527065,0.00013327706079655256,0.6774193548387096
2536,5189,무장/Noun,31,10,21,0.0001333777925975325,0.0002554476998600591,0.6774193548387096
2537,5190,끊어지다/Verb,31,10,21,0.0001333777925975325,0.0002554476998600591,0.6774193548387096
2538,5191,미남/Noun,31,21,10,0.00025564076914527065,0.00013327706079655256,0.6774193548387096
2539,5192,부류/Noun,31,10,21,0.0001333777925975325,0.0002554476998600591,0.6774193548387096
2540,5193,내주다/Verb,31,21,10,0.00025564076914527065,0.00013327706079655256,0.6774193548387096
2541,5247,난감하다/Adjective,30,1,29,3.334444814938313e-05,0.00034429907372442745,0.9666666666666668
2542,5248,흠뻑/Noun,30,29,1,0.0003445592975436257,3.331926519913814e-05,0.9666666666666668
2543,5249,난방/Noun,30,1,29,3.334444814938313e-05,0.00034429907372442745,0.9666666666666668
2544,5250,한물가다/Verb,30,2,28,4.445926419917751e-05,0.0003331926519913814,0.9333333333333332
2545,5251,중구/Noun,30,2,28,4.445926419917751e-05,0.0003331926519913814,0.9333333333333332
2546,5252,더러워지다/Verb,30,2,28,4.445926419917751e-05,0.0003331926519913814,0.9333333333333332
2547,5253,유승준/Noun,30,3,27,5.5574080248971876e-05,0.00032208623025833537,0.9
2548,5254,망신/Noun,30,3,27,5.5574080248971876e-05,0.00032208623025833537,0.9
2549,5255,인간미/Noun,30,26,4,0.00031121484939424253,6.663853039827628e-05,0.8666666666666667
2550,5256,무책임하다/Adjective,30,4,26,6.668889629876625e-05,0.00031097980852528933,0.8666666666666667
2551,5257,안남다/Adjective,30,4,26,6.668889629876625e-05,0.00031097980852528933,0.8666666666666667
2552,5258,진실되다/Adjective,30,26,4,0.00031121484939424253,6.663853039827628e-05,0.8666666666666667
2553,5259,괴/Noun,30,4,26,6.668889629876625e-05,0.00031097980852528933,0.8666666666666667
2554,5260,무표정/Noun,30,5,25,7.780371234856063e-05,0.0002998733867922433,0.8333333333333334
2555,5261,거도/Noun,30,6,24,8.891852839835501e-05,0.0002887669650591972,0.8
2556,5262,영화음악/Noun,30,24,6,0.0002889852172946538,8.885137386436837e-05,0.8
2557,5263,걸레/Noun,30,6,24,8.891852839835501e-05,0.0002887669650591972,0.8
2558,5264,ㅁㅊ/KoreanParticle,30,6,24,8.891852839835501e-05,0.0002887669650591972,0.8
2559,5265,쬐다/Verb,30,6,24,8.891852839835501e-05,0.0002887669650591972,0.8
2560,5266,잠수함/Noun,30,24,6,0.0002889852172946538,8.885137386436837e-05,0.8
2561,5267,관성/Noun,30,6,24,8.891852839835501e-05,0.0002887669650591972,0.8
2562,5268,으으/Exclamation,30,6,24,8.891852839835501e-05,0.0002887669650591972,0.8
2563,5269,패기/Noun,30,6,24,8.891852839835501e-05,0.0002887669650591972,0.8
2564,5270,진주/Noun,30,24,6,0.0002889852172946538,8.885137386436837e-05,0.8
2565,5271,은희/Noun,30,7,23,0.0001000333444481494,0.00027766054332615115,0.7666666666666667
2566,5272,미루다/Verb,30,23,7,0.00027787040124485944,9.995779559741441e-05,0.7666666666666667
2567,5273,피하/Noun,30,7,23,0.0001000333444481494,0.00027766054332615115,0.7666666666666667
2568,5274,여고괴담/Noun,30,7,23,0.0001000333444481494,0.00027766054332615115,0.7666666666666667
2569,5275,콧물/Noun,30,23,7,0.00027787040124485944,9.995779559741441e-05,0.7666666666666667
2570,5276,오점/Noun,30,8,22,0.00011114816049794375,0.00026655412159310506,0.7333333333333333
2571,5277,기념/Noun,30,8,22,0.00011114816049794375,0.00026655412159310506,0.7333333333333333
2572,5278,and/Alpha,30,22,8,0.000266755585195065,0.00011106421733046048,0.7333333333333333
2573,5279,토이스토리/Noun,30,22,8,0.000266755585195065,0.00011106421733046048,0.7333333333333333
2574,5280,교차/Noun,30,22,8,0.000266755585195065,0.00011106421733046048,0.7333333333333333
2575,5281,나마/Josa,30,22,8,0.000266755585195065,0.00011106421733046048,0.7333333333333333
2576,5282,평범/Noun,30,8,22,0.00011114816049794375,0.00026655412159310506,0.7333333333333333
2577,5283,무능하다/Adjective,30,9,21,0.00012226297654773814,0.0002554476998600591,0.7
2578,5284,아야/Noun,30,9,21,0.00012226297654773814,0.0002554476998600591,0.7
2579,5285,작업/Noun,30,9,21,0.00012226297654773814,0.0002554476998600591,0.7
2580,5286,처벌/Noun,30,9,21,0.00012226297654773814,0.0002554476998600591,0.7
2581,5287,구해/Noun,30,21,9,0.00025564076914527065,0.00012217063906350652,0.7
2582,5288,의존/Noun,30,9,21,0.00012226297654773814,0.0002554476998600591,0.7
2583,5289,에너지/Noun,30,20,10,0.00024452595309547634,0.00013327706079655256,0.6666666666666666
2584,5290,sbs/Alpha,30,10,20,0.0001333777925975325,0.00024434127812701304,0.6666666666666666
2585,5291,안정/Noun,30,20,10,0.00024452595309547634,0.00013327706079655256,0.6666666666666666
2586,5292,지능/Noun,30,10,20,0.0001333777925975325,0.00024434127812701304,0.6666666666666666
2587,5293,조재현/Noun,30,20,10,0.00024452595309547634,0.00013327706079655256,0.6666666666666666
2588,5294,축/Noun,30,10,20,0.0001333777925975325,0.00024434127812701304,0.6666666666666666
2589,5295,간접/Noun,30,20,10,0.00024452595309547634,0.00013327706079655256,0.6666666666666666
2590,5296,정적/Noun,30,20,10,0.00024452595309547634,0.00013327706079655256,0.6666666666666666
2591,5297,로드무비/Noun,30,20,10,0.00024452595309547634,0.00013327706079655256,0.6666666666666666
2592,5358,주고/Foreign,29,1,28,3.334444814938313e-05,0.0003331926519913814,0.9655172413793104
2593,5359,맑다/Adjective,29,28,1,0.0003334444814938313,3.331926519913814e-05,0.9655172413793104
2594,5360,남아도/Noun,29,2,27,4.445926419917751e-05,0.00032208623025833537,0.9310344827586208
2595,5361,간신히/Adverb,29,2,27,4.445926419917751e-05,0.00032208623025833537,0.9310344827586208
2596,5362,거중/Noun,29,2,27,4.445926419917751e-05,0.00032208623025833537,0.9310344827586208
2597,5363,성질/Noun,29,2,27,4.445926419917751e-05,0.00032208623025833537,0.9310344827586208
2598,5364,MC/Alpha,29,3,26,5.5574080248971876e-05,0.00031097980852528933,0.8965517241379308
2599,5365,입가/Noun,29,26,3,0.00031121484939424253,5.553210866523024e-05,0.8965517241379308
2600,5366,취지/Noun,29,3,26,5.5574080248971876e-05,0.00031097980852528933,0.8965517241379308
2601,5367,말장난/Noun,29,3,26,5.5574080248971876e-05,0.00031097980852528933,0.8965517241379308
2602,5368,나소/Noun,29,4,25,6.668889629876625e-05,0.0002998733867922433,0.8620689655172413
2603,5369,두서/Noun,29,4,25,6.668889629876625e-05,0.0002998733867922433,0.8620689655172413
2604,5370,"..,,/Punctuation",29,4,25,6.668889629876625e-05,0.0002998733867922433,0.8620689655172413
2605,5371,백미/Noun,29,25,4,0.00030010003334444816,6.663853039827628e-05,0.8620689655172413
2606,5372,미성년/Noun,29,4,25,6.668889629876625e-05,0.0002998733867922433,0.8620689655172413
2607,5373,잡아먹다/Verb,29,4,25,6.668889629876625e-05,0.0002998733867922433,0.8620689655172413
2608,5374,성냥/Noun,29,4,25,6.668889629876625e-05,0.0002998733867922433,0.8620689655172413
2609,5375,전파/Noun,29,4,25,6.668889629876625e-05,0.0002998733867922433,0.8620689655172413
2610,5376,틀어놓다/Verb,29,5,24,7.780371234856063e-05,0.0002887669650591972,0.8275862068965517
2611,5377,김규리/Noun,29,5,24,7.780371234856063e-05,0.0002887669650591972,0.8275862068965517
2612,5378,돌이키다/Verb,29,24,5,0.0002889852172946538,7.774495213132233e-05,0.8275862068965517
2613,5379,눈알/Noun,29,5,24,7.780371234856063e-05,0.0002887669650591972,0.8275862068965517
2614,5380,좆/Noun,29,5,24,7.780371234856063e-05,0.0002887669650591972,0.8275862068965517
2615,5381,으로의/Josa,29,24,5,0.0002889852172946538,7.774495213132233e-05,0.8275862068965517
2616,5382,똥폼/Noun,29,5,24,7.780371234856063e-05,0.0002887669650591972,0.8275862068965517
2617,5383,통쾌/Noun,29,23,6,0.00027787040124485944,8.885137386436837e-05,0.7931034482758621
2618,5384,퍼펙트/Noun,29,23,6,0.00027787040124485944,8.885137386436837e-05,0.7931034482758621
2619,5385,’/Punctuation,29,6,23,8.891852839835501e-05,0.00027766054332615115,0.7931034482758621
2620,5386,오늘날/Noun,29,23,6,0.00027787040124485944,8.885137386436837e-05,0.7931034482758621
2621,5387,깜찍하다/Adjective,29,23,6,0.00027787040124485944,8.885137386436837e-05,0.7931034482758621
2622,5388,사납다/Adjective,29,6,23,8.891852839835501e-05,0.00027766054332615115,0.7931034482758621
2623,5389,대치/Noun,29,7,22,0.0001000333444481494,0.00026655412159310506,0.7586206896551724
2624,5390,엇어/Noun,29,22,7,0.000266755585195065,9.995779559741441e-05,0.7586206896551724
2625,5391,별반/Noun,29,7,22,0.0001000333444481494,0.00026655412159310506,0.7586206896551724
2626,5392,단막극/Noun,29,7,22,0.0001000333444481494,0.00026655412159310506,0.7586206896551724
2627,5393,조롱/Noun,29,7,22,0.0001000333444481494,0.00026655412159310506,0.7586206896551724
2628,5394,",.../Punctuation",29,7,22,0.0001000333444481494,0.00026655412159310506,0.7586206896551724
2629,5395,운전/Noun,29,7,22,0.0001000333444481494,0.00026655412159310506,0.7586206896551724
2630,5396,가왜/Noun,29,7,22,0.0001000333444481494,0.00026655412159310506,0.7586206896551724
2631,5397,사전/Noun,29,22,7,0.000266755585195065,9.995779559741441e-05,0.7586206896551724
2632,5398,몬/Noun,29,7,22,0.0001000333444481494,0.00026655412159310506,0.7586206896551724
2633,5399,찌들다/Verb,29,22,7,0.000266755585195065,9.995779559741441e-05,0.7586206896551724
2634,5400,인공/Noun,29,8,21,0.00011114816049794375,0.0002554476998600591,0.7241379310344828
2635,5401,뮤직/Noun,29,21,8,0.00025564076914527065,0.00011106421733046048,0.7241379310344828
2636,5402,사례/Noun,29,8,21,0.00011114816049794375,0.0002554476998600591,0.7241379310344828
2637,5403,신기/Noun,29,8,21,0.00011114816049794375,0.0002554476998600591,0.7241379310344828
2638,5404,-.-/Punctuation,29,8,21,0.00011114816049794375,0.0002554476998600591,0.7241379310344828
2639,5405,영화니/Noun,29,8,21,0.00011114816049794375,0.0002554476998600591,0.7241379310344828
2640,5406,☆/Foreign,29,21,8,0.00025564076914527065,0.00011106421733046048,0.7241379310344828
2641,5407,당한/Noun,29,8,21,0.00011114816049794375,0.0002554476998600591,0.7241379310344828
2642,5408,사로자다/Verb,29,21,8,0.00025564076914527065,0.00011106421733046048,0.7241379310344828
2643,5409,길들이다/Verb,29,21,8,0.00025564076914527065,0.00011106421733046048,0.7241379310344828
2644,5410,연민/Noun,29,20,9,0.00024452595309547634,0.00012217063906350652,0.6896551724137931
2645,5411,금발/Noun,29,9,20,0.00012226297654773814,0.00024434127812701304,0.6896551724137931
2646,5412,치중/Noun,29,9,20,0.00012226297654773814,0.00024434127812701304,0.6896551724137931
2647,5413,가위/Noun,29,9,20,0.00012226297654773814,0.00024434127812701304,0.6896551724137931
2648,5414,짝사랑/Noun,29,20,9,0.00024452595309547634,0.00012217063906350652,0.6896551724137931
2649,5415,거들다/Verb,29,9,20,0.00012226297654773814,0.00024434127812701304,0.6896551724137931
2650,5416,보물/Noun,29,20,9,0.00024452595309547634,0.00012217063906350652,0.6896551724137931
2651,5417,17/Number,29,19,10,0.0002334111370456819,0.00013327706079655256,0.6551724137931034
2652,5418,여실히/Noun,29,10,19,0.0001333777925975325,0.000233234856393967,0.6551724137931034
2653,5419,타잔/Noun,29,10,19,0.0001333777925975325,0.000233234856393967,0.6551724137931034
2654,5420,토르/Noun,29,19,10,0.0002334111370456819,0.00013327706079655256,0.6551724137931034
2655,5421,무도/Noun,29,10,19,0.0001333777925975325,0.000233234856393967,0.6551724137931034
2656,5422,이성/Noun,29,19,10,0.0002334111370456819,0.00013327706079655256,0.6551724137931034
2657,5423,시원/Noun,29,19,10,0.0002334111370456819,0.00013327706079655256,0.6551724137931034
2658,5424,보호/Noun,29,19,10,0.0002334111370456819,0.00013327706079655256,0.6551724137931034
2659,5425,오기/Noun,29,10,19,0.0001333777925975325,0.000233234856393967,0.6551724137931034
2660,5426,시킴/Noun,29,10,19,0.0001333777925975325,0.000233234856393967,0.6551724137931034
2661,5427,해달라다/Verb,29,10,19,0.0001333777925975325,0.000233234856393967,0.6551724137931034
2662,5428,폭탄/Noun,29,10,19,0.0001333777925975325,0.000233234856393967,0.6551724137931034
2663,5480,구림/Noun,28,0,28,2.2229632099588756e-05,0.0003331926519913814,1.0
2664,5481,당췌/Noun,28,1,27,3.334444814938313e-05,0.00032208623025833537,0.9642857142857144
2665,5482,물결/Noun,28,26,2,0.00031121484939424253,4.4425686932184186e-05,0.9285714285714286
2666,5483,날림/Noun,28,3,25,5.5574080248971876e-05,0.0002998733867922433,0.8928571428571429
2667,5484,배슬기/Noun,28,3,25,5.5574080248971876e-05,0.0002998733867922433,0.8928571428571429
2668,5485,통찰/Noun,28,24,4,0.0002889852172946538,6.663853039827628e-05,0.8571428571428571
2669,5486,천박하다/Adjective,28,4,24,6.668889629876625e-05,0.0002887669650591972,0.8571428571428571
2670,5487,이면/Foreign,28,4,24,6.668889629876625e-05,0.0002887669650591972,0.8571428571428571
2671,5488,추잡하다/Adjective,28,4,24,6.668889629876625e-05,0.0002887669650591972,0.8571428571428571
2672,5489,결과물/Noun,28,4,24,6.668889629876625e-05,0.0002887669650591972,0.8571428571428571
2673,5490,로맨스영화/Noun,28,24,4,0.0002889852172946538,6.663853039827628e-05,0.8571428571428571
2674,5491,늘어놓다/Verb,28,4,24,6.668889629876625e-05,0.0002887669650591972,0.8571428571428571
2675,5492,봣습니/Noun,28,24,4,0.0002889852172946538,6.663853039827628e-05,0.8571428571428571
2676,5493,진부/Noun,28,5,23,7.780371234856063e-05,0.00027766054332615115,0.8214285714285714
2677,5494,심은하/Noun,28,23,5,0.00027787040124485944,7.774495213132233e-05,0.8214285714285714
2678,5495,농락/Noun,28,5,23,7.780371234856063e-05,0.00027766054332615115,0.8214285714285714
2679,5496,오열/Noun,28,23,5,0.00027787040124485944,7.774495213132233e-05,0.8214285714285714
2680,5497,주어지다/Verb,28,23,5,0.00027787040124485944,7.774495213132233e-05,0.8214285714285714
2681,5498,지못미/Noun,28,5,23,7.780371234856063e-05,0.00027766054332615115,0.8214285714285714
2682,5499,i/Alpha,28,22,6,0.000266755585195065,8.885137386436837e-05,0.7857142857142857
2683,5500,해설/Noun,28,6,22,8.891852839835501e-05,0.00026655412159310506,0.7857142857142857
2684,5501,좌좀/Noun,28,6,22,8.891852839835501e-05,0.00026655412159310506,0.7857142857142857
2685,5502,남겨지다/Verb,28,22,6,0.000266755585195065,8.885137386436837e-05,0.7857142857142857
2686,5503,‘/Foreign,28,6,22,8.891852839835501e-05,0.00026655412159310506,0.7857142857142857
2687,5504,아키라/Noun,28,21,7,0.00025564076914527065,9.995779559741441e-05,0.75
2688,5505,폭파/Noun,28,7,21,0.0001000333444481494,0.0002554476998600591,0.75
2689,5506,빠져나오다/Verb,28,21,7,0.00025564076914527065,9.995779559741441e-05,0.75
2690,5507,소유/Noun,28,21,7,0.00025564076914527065,9.995779559741441e-05,0.75
2691,5508,파멸/Noun,28,21,7,0.00025564076914527065,9.995779559741441e-05,0.75
2692,5509,보상/Noun,28,7,21,0.0001000333444481494,0.0002554476998600591,0.75
2693,5510,짐작/Noun,28,7,21,0.0001000333444481494,0.0002554476998600591,0.75
2694,5511,감우성/Noun,28,21,7,0.00025564076914527065,9.995779559741441e-05,0.75
2695,5512,후의/Noun,28,21,7,0.00025564076914527065,9.995779559741441e-05,0.75
2696,5513,거여/Noun,28,7,21,0.0001000333444481494,0.0002554476998600591,0.75
2697,5514,오묘하다/Adjective,28,21,7,0.00025564076914527065,9.995779559741441e-05,0.75
2698,5515,조커/Noun,28,21,7,0.00025564076914527065,9.995779559741441e-05,0.75
2699,5516,타이밍/Noun,28,7,21,0.0001000333444481494,0.0002554476998600591,0.75
2700,5517,스탤론/Noun,28,20,8,0.00024452595309547634,0.00011106421733046048,0.7142857142857143
2701,5518,느끼하다/Adjective,28,8,20,0.00011114816049794375,0.00024434127812701304,0.7142857142857143
2702,5519,시바/Noun,28,8,20,0.00011114816049794375,0.00024434127812701304,0.7142857142857143
2703,5520,고집/Noun,28,8,20,0.00011114816049794375,0.00024434127812701304,0.7142857142857143
2704,5521,이민호/Noun,28,20,8,0.00024452595309547634,0.00011106421733046048,0.7142857142857143
2705,5522,동참/Noun,28,8,20,0.00011114816049794375,0.00024434127812701304,0.7142857142857143
2706,5523,이모/Noun,28,20,8,0.00024452595309547634,0.00011106421733046048,0.7142857142857143
2707,5524,반면/Noun,28,8,20,0.00011114816049794375,0.00024434127812701304,0.7142857142857143
2708,5525,장만옥/Noun,28,20,8,0.00024452595309547634,0.00011106421733046048,0.7142857142857143
2709,5526,늑대인간/Noun,28,8,20,0.00011114816049794375,0.00024434127812701304,0.7142857142857143
2710,5527,이리저리/Adverb,28,8,20,0.00011114816049794375,0.00024434127812701304,0.7142857142857143
2711,5528,말리/Noun,28,8,20,0.00011114816049794375,0.00024434127812701304,0.7142857142857143
2712,5529,어메이징/Noun,28,19,9,0.0002334111370456819,0.00012217063906350652,0.6785714285714286
2713,5530,24/Number,28,19,9,0.0002334111370456819,0.00012217063906350652,0.6785714285714286
2714,5531,퀸/Noun,28,19,9,0.0002334111370456819,0.00012217063906350652,0.6785714285714286
2715,5532,예정/Noun,28,19,9,0.0002334111370456819,0.00012217063906350652,0.6785714285714286
2716,5533,노무/Noun,28,9,19,0.00012226297654773814,0.000233234856393967,0.6785714285714286
2717,5534,자료/Noun,28,19,9,0.0002334111370456819,0.00012217063906350652,0.6785714285714286
2718,5535,덤덤하다/Adjective,28,19,9,0.0002334111370456819,0.00012217063906350652,0.6785714285714286
2719,5536,권리/Noun,28,19,9,0.0002334111370456819,0.00012217063906350652,0.6785714285714286
2720,5537,스콜/Noun,28,19,9,0.0002334111370456819,0.00012217063906350652,0.6785714285714286
2721,5538,눈감다/Verb,28,9,19,0.00012226297654773814,0.000233234856393967,0.6785714285714286
2722,5539,o/Alpha,28,19,9,0.0002334111370456819,0.00012217063906350652,0.6785714285714286
2723,5540,화장/Noun,28,9,19,0.00012226297654773814,0.000233234856393967,0.6785714285714286
2724,5610,에혀/Noun,27,1,26,3.334444814938313e-05,0.00031097980852528933,0.9629629629629628
2725,5611,술함/Noun,27,3,24,5.5574080248971876e-05,0.0002887669650591972,0.8888888888888888
2726,5612,댓글알바/Noun,27,3,24,5.5574080248971876e-05,0.0002887669650591972,0.8888888888888888
2727,5613,초보/Noun,27,3,24,5.5574080248971876e-05,0.0002887669650591972,0.8888888888888888
2728,5614,쉣/Noun,27,3,24,5.5574080248971876e-05,0.0002887669650591972,0.8888888888888888
2729,5615,맡기다/Verb,27,3,24,5.5574080248971876e-05,0.0002887669650591972,0.8888888888888888
2730,5616,허망/Noun,27,4,23,6.668889629876625e-05,0.00027766054332615115,0.8518518518518519
2731,5617,오오/Exclamation,27,23,4,0.00027787040124485944,6.663853039827628e-05,0.8518518518518519
2732,5618,맥락/Noun,27,4,23,6.668889629876625e-05,0.00027766054332615115,0.8518518518518519
2733,5619,그리움/Noun,27,23,4,0.00027787040124485944,6.663853039827628e-05,0.8518518518518519
2734,5620,경지/Noun,27,23,4,0.00027787040124485944,6.663853039827628e-05,0.8518518518518519
2735,5621,제한/Noun,27,4,23,6.668889629876625e-05,0.00027766054332615115,0.8518518518518519
2736,5622,사하나/Noun,27,23,4,0.00027787040124485944,6.663853039827628e-05,0.8518518518518519
2737,5623,푸른/Noun,27,23,4,0.00027787040124485944,6.663853039827628e-05,0.8518518518518519
2738,5624,알아주다/Verb,27,22,5,0.000266755585195065,7.774495213132233e-05,0.8148148148148148
2739,5625,이정현/Noun,27,22,5,0.000266755585195065,7.774495213132233e-05,0.8148148148148148
2740,5626,전용/Noun,27,5,22,7.780371234856063e-05,0.00026655412159310506,0.8148148148148148
2741,5627,가상하다/Adjective,27,5,22,7.780371234856063e-05,0.00026655412159310506,0.8148148148148148
2742,5628,맙소사/Exclamation,27,5,22,7.780371234856063e-05,0.00026655412159310506,0.8148148148148148
2743,5629,훼손/Noun,27,5,22,7.780371234856063e-05,0.00026655412159310506,0.8148148148148148
2744,5630,av/Alpha,27,5,22,7.780371234856063e-05,0.00026655412159310506,0.8148148148148148
2745,5631,자칫/Noun,27,22,5,0.000266755585195065,7.774495213132233e-05,0.8148148148148148
2746,5632,궁금/Noun,27,5,22,7.780371234856063e-05,0.00026655412159310506,0.8148148148148148
2747,5633,--;/Punctuation,27,5,22,7.780371234856063e-05,0.00026655412159310506,0.8148148148148148
2748,5634,자비/Noun,27,21,6,0.00025564076914527065,8.885137386436837e-05,0.7777777777777778
2749,5635,본받다/Verb,27,21,6,0.00025564076914527065,8.885137386436837e-05,0.7777777777777778
2750,5636,웨스턴/Noun,27,21,6,0.00025564076914527065,8.885137386436837e-05,0.7777777777777778
2751,5637,피라냐/Noun,27,6,21,8.891852839835501e-05,0.0002554476998600591,0.7777777777777778
2752,5638,비노/Noun,27,21,6,0.00025564076914527065,8.885137386436837e-05,0.7777777777777778
2753,5639,헌신/Noun,27,21,6,0.00025564076914527065,8.885137386436837e-05,0.7777777777777778
2754,5640,탐욕/Noun,27,21,6,0.00025564076914527065,8.885137386436837e-05,0.7777777777777778
2755,5641,슬슬/Noun,27,6,21,8.891852839835501e-05,0.0002554476998600591,0.7777777777777778
2756,5642,평화롭다/Adjective,27,21,6,0.00025564076914527065,8.885137386436837e-05,0.7777777777777778
2757,5643,숨쉬다/Verb,27,21,6,0.00025564076914527065,8.885137386436837e-05,0.7777777777777778
2758,5644,박유천/Noun,27,21,6,0.00025564076914527065,8.885137386436837e-05,0.7777777777777778
2759,5645,삘/Noun,27,6,21,8.891852839835501e-05,0.0002554476998600591,0.7777777777777778
2760,5646,과언/Noun,27,21,6,0.00025564076914527065,8.885137386436837e-05,0.7777777777777778
2761,5647,지껄이다/Verb,27,7,20,0.0001000333444481494,0.00024434127812701304,0.7407407407407407
2762,5648,좌/Noun,27,20,7,0.00024452595309547634,9.995779559741441e-05,0.7407407407407407
2763,5649,용하다/Adjective,27,7,20,0.0001000333444481494,0.00024434127812701304,0.7407407407407407
2764,5650,컬/Noun,27,20,7,0.00024452595309547634,9.995779559741441e-05,0.7407407407407407
2765,5651,침대/Noun,27,7,20,0.0001000333444481494,0.00024434127812701304,0.7407407407407407
2766,5652,조선족/Noun,27,7,20,0.0001000333444481494,0.00024434127812701304,0.7407407407407407
2767,5653,성장기/Noun,27,20,7,0.00024452595309547634,9.995779559741441e-05,0.7407407407407407
2768,5654,브로디/Noun,27,7,20,0.0001000333444481494,0.00024434127812701304,0.7407407407407407
2769,5655,치부/Noun,27,20,7,0.00024452595309547634,9.995779559741441e-05,0.7407407407407407
2770,5656,치우다/Verb,27,7,20,0.0001000333444481494,0.00024434127812701304,0.7407407407407407
2771,5657,사이트/Noun,27,7,20,0.0001000333444481494,0.00024434127812701304,0.7407407407407407
2772,5658,구입/Noun,27,20,7,0.00024452595309547634,9.995779559741441e-05,0.7407407407407407
2773,5659,자리/Suffix,27,7,20,0.0001000333444481494,0.00024434127812701304,0.7407407407407407
2774,5660,평타/Noun,27,7,20,0.0001000333444481494,0.00024434127812701304,0.7407407407407407
2775,5661,모니터/Noun,27,7,20,0.0001000333444481494,0.00024434127812701304,0.7407407407407407
2776,5662,일방/Noun,27,7,20,0.0001000333444481494,0.00024434127812701304,0.7407407407407407
2777,5663,가나다/Noun,27,7,20,0.0001000333444481494,0.00024434127812701304,0.7407407407407407
2778,5664,허준/Noun,27,20,7,0.00024452595309547634,9.995779559741441e-05,0.7407407407407407
2779,5665,레저/Noun,27,19,8,0.0002334111370456819,0.00011106421733046048,0.7037037037037037
2780,5666,패스/Noun,27,8,19,0.00011114816049794375,0.000233234856393967,0.7037037037037037
2781,5667,오싹하다/Adjective,27,19,8,0.0002334111370456819,0.00011106421733046048,0.7037037037037037
2782,5668,석/Noun,27,8,19,0.00011114816049794375,0.000233234856393967,0.7037037037037037
2783,5669,종종/Noun,27,19,8,0.0002334111370456819,0.00011106421733046048,0.7037037037037037
2784,5670,쌓다/Verb,27,8,19,0.00011114816049794375,0.000233234856393967,0.7037037037037037
2785,5671,모자라/Noun,27,8,19,0.00011114816049794375,0.000233234856393967,0.7037037037037037
2786,5672,기절/Noun,27,8,19,0.00011114816049794375,0.000233234856393967,0.7037037037037037
2787,5673,깔깔/Noun,27,18,9,0.0002222963209958875,0.00012217063906350652,0.6666666666666666
2788,5674,질린다/Verb,27,9,18,0.00012226297654773814,0.00022212843466092096,0.6666666666666666
2789,5675,팬티/Noun,27,9,18,0.00012226297654773814,0.00022212843466092096,0.6666666666666666
2790,5676,솜씨/Noun,27,18,9,0.0002222963209958875,0.00012217063906350652,0.6666666666666666
2791,5677,치닫다/Verb,27,9,18,0.00012226297654773814,0.00022212843466092096,0.6666666666666666
2792,5678,이브/Noun,27,18,9,0.0002222963209958875,0.00012217063906350652,0.6666666666666666
2793,5679,최강희/Noun,27,18,9,0.0002222963209958875,0.00012217063906350652,0.6666666666666666
2794,5680,고릴라/Noun,27,9,18,0.00012226297654773814,0.00022212843466092096,0.6666666666666666
2795,5681,꺄/Noun,27,18,9,0.0002222963209958875,0.00012217063906350652,0.6666666666666666
2796,5682,리치/Noun,27,18,9,0.0002222963209958875,0.00012217063906350652,0.6666666666666666
2797,5683,괜찬/Noun,27,18,9,0.0002222963209958875,0.00012217063906350652,0.6666666666666666
2798,5684,난생/Noun,27,9,18,0.00012226297654773814,0.00022212843466092096,0.6666666666666666
2799,5685,삼촌/Noun,27,9,18,0.00012226297654773814,0.00022212843466092096,0.6666666666666666
2800,5686,투쟁/Noun,27,18,9,0.0002222963209958875,0.00012217063906350652,0.6666666666666666
2801,5687,피어/Noun,27,18,9,0.0002222963209958875,0.00012217063906350652,0.6666666666666666
2802,5753,안드로메다/Noun,26,0,26,2.2229632099588756e-05,0.00031097980852528933,1.0
2803,5754,돌림/Noun,26,1,25,3.334444814938313e-05,0.0002998733867922433,0.9615384615384616
2804,5755,불우/Noun,26,1,25,3.334444814938313e-05,0.0002998733867922433,0.9615384615384616
2805,5756,녹이다/Verb,26,25,1,0.00030010003334444816,3.331926519913814e-05,0.9615384615384616
2806,5757,한시/Noun,26,25,1,0.00030010003334444816,3.331926519913814e-05,0.9615384615384616
2807,5758,무리하다/Adjective,26,1,25,3.334444814938313e-05,0.0002998733867922433,0.9615384615384616
2808,5759,맘대로/Adverb,26,2,24,4.445926419917751e-05,0.0002887669650591972,0.9230769230769232
2809,5760,싸가지/Noun,26,2,24,4.445926419917751e-05,0.0002887669650591972,0.9230769230769232
2810,5761,니미/Noun,26,2,24,4.445926419917751e-05,0.0002887669650591972,0.9230769230769232
2811,5762,!!!!!!!!!/Punctuation,26,23,3,0.00027787040124485944,5.553210866523024e-05,0.8846153846153846
2812,5763,해학/Noun,26,23,3,0.00027787040124485944,5.553210866523024e-05,0.8846153846153846
2813,5764,정신병원/Noun,26,3,23,5.5574080248971876e-05,0.00027766054332615115,0.8846153846153846
2814,5765,괴상하다/Adjective,26,4,22,6.668889629876625e-05,0.00026655412159310506,0.8461538461538461
2815,5766,。/Foreign,26,22,4,0.000266755585195065,6.663853039827628e-05,0.8461538461538461
2816,5767,저건/Noun,26,4,22,6.668889629876625e-05,0.00026655412159310506,0.8461538461538461
2817,5768,사랑받다/Verb,26,22,4,0.000266755585195065,6.663853039827628e-05,0.8461538461538461
2818,5769,비용/Noun,26,4,22,6.668889629876625e-05,0.00026655412159310506,0.8461538461538461
2819,5770,침략/Noun,26,4,22,6.668889629876625e-05,0.00026655412159310506,0.8461538461538461
2820,5771,매년/Noun,26,22,4,0.000266755585195065,6.663853039827628e-05,0.8461538461538461
2821,5772,하루하루/Noun,26,22,4,0.000266755585195065,6.663853039827628e-05,0.8461538461538461
2822,5773,걸왜/Noun,26,4,22,6.668889629876625e-05,0.00026655412159310506,0.8461538461538461
2823,5774,절용/Noun,26,4,22,6.668889629876625e-05,0.00026655412159310506,0.8461538461538461
2824,5775,9년/Number,26,22,4,0.000266755585195065,6.663853039827628e-05,0.8461538461538461
2825,5776,장진영/Noun,26,21,5,0.00025564076914527065,7.774495213132233e-05,0.8076923076923077
2826,5777,드라마틱하다/Adjective,26,21,5,0.00025564076914527065,7.774495213132233e-05,0.8076923076923077
2827,5778,쯧/Adverb,26,5,21,7.780371234856063e-05,0.0002554476998600591,0.8076923076923077
2828,5779,류덕환/Noun,26,21,5,0.00025564076914527065,7.774495213132233e-05,0.8076923076923077
2829,5780,징징대다/Adjective,26,5,21,7.780371234856063e-05,0.0002554476998600591,0.8076923076923077
2830,5781,만원/Noun,26,5,21,7.780371234856063e-05,0.0002554476998600591,0.8076923076923077
2831,5782,나열하다/Adjective,26,5,21,7.780371234856063e-05,0.0002554476998600591,0.8076923076923077
2832,5783,피터팬/Noun,26,21,5,0.00025564076914527065,7.774495213132233e-05,0.8076923076923077
2833,5784,답습/Noun,26,5,21,7.780371234856063e-05,0.0002554476998600591,0.8076923076923077
2834,5785,싸이/Noun,26,6,20,8.891852839835501e-05,0.00024434127812701304,0.7692307692307693
2835,5786,코너/Noun,26,6,20,8.891852839835501e-05,0.00024434127812701304,0.7692307692307693
2836,5787,50분/Number,26,6,20,8.891852839835501e-05,0.00024434127812701304,0.7692307692307693
2837,5788,편지/Noun,26,20,6,0.00024452595309547634,8.885137386436837e-05,0.7692307692307693
2838,5789,봉준호/Noun,26,20,6,0.00024452595309547634,8.885137386436837e-05,0.7692307692307693
2839,5790,퇴보하다/Adjective,26,6,20,8.891852839835501e-05,0.00024434127812701304,0.7692307692307693
2840,5791,z/Alpha,26,6,20,8.891852839835501e-05,0.00024434127812701304,0.7692307692307693
2841,5792,한잔/Noun,26,20,6,0.00024452595309547634,8.885137386436837e-05,0.7692307692307693
2842,5793,쌤/Noun,26,20,6,0.00024452595309547634,8.885137386436837e-05,0.7692307692307693
2843,5794,살해/Noun,26,6,20,8.891852839835501e-05,0.00024434127812701304,0.7692307692307693
2844,5795,하든/Noun,26,6,20,8.891852839835501e-05,0.00024434127812701304,0.7692307692307693
2845,5796,주어/Noun,26,20,6,0.00024452595309547634,8.885137386436837e-05,0.7692307692307693
2846,5797,흐흐/Noun,26,19,7,0.0002334111370456819,9.995779559741441e-05,0.7307692307692307
2847,5798,진도/Noun,26,7,19,0.0001000333444481494,0.000233234856393967,0.7307692307692307
2848,5799,ㅈㄹ/KoreanParticle,26,7,19,0.0001000333444481494,0.000233234856393967,0.7307692307692307
2849,5800,메릴/Noun,26,19,7,0.0002334111370456819,9.995779559741441e-05,0.7307692307692307
2850,5801,주제곡/Noun,26,19,7,0.0002334111370456819,9.995779559741441e-05,0.7307692307692307
2851,5802,심심/Noun,26,7,19,0.0001000333444481494,0.000233234856393967,0.7307692307692307
2852,5803,선입견/Noun,26,19,7,0.0002334111370456819,9.995779559741441e-05,0.7307692307692307
2853,5804,형태/Noun,26,19,7,0.0002334111370456819,9.995779559741441e-05,0.7307692307692307
2854,5805,한수/Noun,26,19,7,0.0002334111370456819,9.995779559741441e-05,0.7307692307692307
2855,5806,재벌/Noun,26,7,19,0.0001000333444481494,0.000233234856393967,0.7307692307692307
2856,5807,부영/Noun,26,18,8,0.0002222963209958875,0.00011106421733046048,0.6923076923076923
2857,5808,.............../Punctuation,26,8,18,0.00011114816049794375,0.00022212843466092096,0.6923076923076923
2858,5809,닌자/Noun,26,8,18,0.00011114816049794375,0.00022212843466092096,0.6923076923076923
2859,5810,얕다/Adjective,26,8,18,0.00011114816049794375,0.00022212843466092096,0.6923076923076923
2860,5811,1.2/Number,26,18,8,0.0002222963209958875,0.00011106421733046048,0.6923076923076923
2861,5812,잘리다/Verb,26,8,18,0.00011114816049794375,0.00022212843466092096,0.6923076923076923
2862,5813,기네/Noun,26,8,18,0.00011114816049794375,0.00022212843466092096,0.6923076923076923
2863,5814,맞서다/Verb,26,18,8,0.0002222963209958875,0.00011106421733046048,0.6923076923076923
2864,5815,나뉘다/Verb,26,17,9,0.00021118150494609317,0.00012217063906350652,0.6538461538461539
2865,5816,키스신/Noun,26,17,9,0.00021118150494609317,0.00012217063906350652,0.6538461538461539
2866,5817,반지의제왕/Noun,26,17,9,0.00021118150494609317,0.00012217063906350652,0.6538461538461539
2867,5818,올인/Noun,26,17,9,0.00021118150494609317,0.00012217063906350652,0.6538461538461539
2868,5819,so/Alpha,26,17,9,0.00021118150494609317,0.00012217063906350652,0.6538461538461539
2869,5820,회의/Noun,26,9,17,0.00012226297654773814,0.0002110220129278749,0.6538461538461539
2870,5821,어요/Noun,26,17,9,0.00021118150494609317,0.00012217063906350652,0.6538461538461539
2871,5822,시간여행/Noun,26,17,9,0.00021118150494609317,0.00012217063906350652,0.6538461538461539
2872,5823,김래원/Noun,26,17,9,0.00021118150494609317,0.00012217063906350652,0.6538461538461539
2873,5824,원한/Noun,26,9,17,0.00012226297654773814,0.0002110220129278749,0.6538461538461539
2874,5825,해리/Noun,26,17,9,0.00021118150494609317,0.00012217063906350652,0.6538461538461539
2875,5826,수지/Noun,26,17,9,0.00021118150494609317,0.00012217063906350652,0.6538461538461539
2876,5890,Bad/Alpha,25,1,24,3.334444814938313e-05,0.0002887669650591972,0.96
2877,5891,꾸밈/Noun,25,24,1,0.0002889852172946538,3.331926519913814e-05,0.96
2878,5892,쏠쏠하다/Adjective,25,24,1,0.0002889852172946538,3.331926519913814e-05,0.96
2879,5893,기부/Noun,25,1,24,3.334444814938313e-05,0.0002887669650591972,0.96
2880,5894,ㅅㄱ/KoreanParticle,25,2,23,4.445926419917751e-05,0.00027766054332615115,0.92
2881,5895,인피니트/Noun,25,23,2,0.00027787040124485944,4.4425686932184186e-05,0.92
2882,5896,부실/Noun,25,2,23,4.445926419917751e-05,0.00027766054332615115,0.92
2883,5897,오래오래/Noun,25,23,2,0.00027787040124485944,4.4425686932184186e-05,0.92
2884,5898,탄탄/Noun,25,23,2,0.00027787040124485944,4.4425686932184186e-05,0.92
2885,5899,조잡/Noun,25,2,23,4.445926419917751e-05,0.00027766054332615115,0.92
2886,5900,지망/Noun,25,3,22,5.5574080248971876e-05,0.00026655412159310506,0.88
2887,5901,예상외/Noun,25,22,3,0.000266755585195065,5.553210866523024e-05,0.88
2888,5902,클릭/Noun,25,3,22,5.5574080248971876e-05,0.00026655412159310506,0.88
2889,5903,?./Punctuation,25,3,22,5.5574080248971876e-05,0.00026655412159310506,0.88
2890,5904,같잖다/Adjective,25,3,22,5.5574080248971876e-05,0.00026655412159310506,0.88
2891,5905,ㅡㅡㅋ/KoreanParticle,25,4,21,6.668889629876625e-05,0.0002554476998600591,0.84
2892,5906,윽/Noun,25,4,21,6.668889629876625e-05,0.0002554476998600591,0.84
2893,5907,훌륭/Noun,25,21,4,0.00025564076914527065,6.663853039827628e-05,0.84
2894,5908,엠씨/Noun,25,4,21,6.668889629876625e-05,0.0002554476998600591,0.84
2895,5909,쿠바/Noun,25,21,4,0.00025564076914527065,6.663853039827628e-05,0.84
2896,5910,축복/Noun,25,21,4,0.00025564076914527065,6.663853039827628e-05,0.84
2897,5911,온건/Noun,25,4,21,6.668889629876625e-05,0.0002554476998600591,0.84
2898,5912,4000원/Number,25,4,21,6.668889629876625e-05,0.0002554476998600591,0.84
2899,5913,붕/Noun,25,4,21,6.668889629876625e-05,0.0002554476998600591,0.84
2900,5914,...-_-/Punctuation,25,5,20,7.780371234856063e-05,0.00024434127812701304,0.8
2901,5915,양산/Noun,25,5,20,7.780371234856063e-05,0.00024434127812701304,0.8
2902,5916,슬로우/Noun,25,5,20,7.780371234856063e-05,0.00024434127812701304,0.8
2903,5917,바램/Noun,25,20,5,0.00024452595309547634,7.774495213132233e-05,0.8
2904,5918,쩔어요/Noun,25,20,5,0.00024452595309547634,7.774495213132233e-05,0.8
2905,5919,썅/Noun,25,5,20,7.780371234856063e-05,0.00024434127812701304,0.8
2906,5920,-_/Punctuation,25,5,20,7.780371234856063e-05,0.00024434127812701304,0.8
2907,5921,아이디/Noun,25,5,20,7.780371234856063e-05,0.00024434127812701304,0.8
2908,5922,따오다/Verb,25,5,20,7.780371234856063e-05,0.00024434127812701304,0.8
2909,5923,97년/Number,25,20,5,0.00024452595309547634,7.774495213132233e-05,0.8
2910,5924,소방관/Noun,25,20,5,0.00024452595309547634,7.774495213132233e-05,0.8
2911,5925,붕괴/Noun,25,5,20,7.780371234856063e-05,0.00024434127812701304,0.8
2912,5926,멸망/Noun,25,6,19,8.891852839835501e-05,0.000233234856393967,0.76
2913,5927,된장녀/Noun,25,6,19,8.891852839835501e-05,0.000233234856393967,0.76
2914,5928,진가/Noun,25,19,6,0.0002334111370456819,8.885137386436837e-05,0.76
2915,5929,고갈/Noun,25,6,19,8.891852839835501e-05,0.000233234856393967,0.76
2916,5930,브금/Noun,25,19,6,0.0002334111370456819,8.885137386436837e-05,0.76
2917,5931,서양인/Noun,25,6,19,8.891852839835501e-05,0.000233234856393967,0.76
2918,5932,요란하다/Adjective,25,6,19,8.891852839835501e-05,0.000233234856393967,0.76
2919,5933,억압/Noun,25,19,6,0.0002334111370456819,8.885137386436837e-05,0.76
2920,5934,김승우/Noun,25,6,19,8.891852839835501e-05,0.000233234856393967,0.76
2921,5935,1980년/Number,25,6,19,8.891852839835501e-05,0.000233234856393967,0.76
2922,5936,자전거/Noun,25,19,6,0.0002334111370456819,8.885137386436837e-05,0.76
2923,5937,껍데기/Noun,25,7,18,0.0001000333444481494,0.00022212843466092096,0.72
2924,5938,정상인/Noun,25,7,18,0.0001000333444481494,0.00022212843466092096,0.72
2925,5939,멘트/Noun,25,7,18,0.0001000333444481494,0.00022212843466092096,0.72
2926,5940,k/Alpha,25,7,18,0.0001000333444481494,0.00022212843466092096,0.72
2927,5941,분투/Noun,25,7,18,0.0001000333444481494,0.00022212843466092096,0.72
2928,5942,첩보물/Noun,25,18,7,0.0002222963209958875,9.995779559741441e-05,0.72
2929,5943,건달/Noun,25,7,18,0.0001000333444481494,0.00022212843466092096,0.72
2930,5944,윤발/Noun,25,7,18,0.0001000333444481494,0.00022212843466092096,0.72
2931,5945,제국주의/Noun,25,7,18,0.0001000333444481494,0.00022212843466092096,0.72
2932,5946,바사/Noun,25,7,18,0.0001000333444481494,0.00022212843466092096,0.72
2933,5947,애국/Noun,25,7,18,0.0001000333444481494,0.00022212843466092096,0.72
2934,5948,집합/Noun,25,8,17,0.00011114816049794375,0.0002110220129278749,0.68
2935,5949,삼국지/Noun,25,8,17,0.00011114816049794375,0.0002110220129278749,0.68
2936,5950,별개/Noun,25,8,17,0.00011114816049794375,0.0002110220129278749,0.68
2937,5951,분류/Noun,25,8,17,0.00011114816049794375,0.0002110220129278749,0.68
2938,5952,마셈/Noun,25,8,17,0.00011114816049794375,0.0002110220129278749,0.68
2939,5953,단말/Noun,25,8,17,0.00011114816049794375,0.0002110220129278749,0.68
2940,5954,러브레터/Noun,25,17,8,0.00021118150494609317,0.00011106421733046048,0.68
2941,5955,헌/Modifier,25,17,8,0.00021118150494609317,0.00011106421733046048,0.68
2942,5956,중견/Noun,25,8,17,0.00011114816049794375,0.0002110220129278749,0.68
2943,5957,박스/Noun,25,8,17,0.00011114816049794375,0.0002110220129278749,0.68
2944,5958,구지/Noun,25,8,17,0.00011114816049794375,0.0002110220129278749,0.68
2945,5959,No/Alpha,25,8,17,0.00011114816049794375,0.0002110220129278749,0.68
2946,5960,프리드/Noun,25,17,8,0.00021118150494609317,0.00011106421733046048,0.68
2947,5961,베를린/Noun,25,17,8,0.00021118150494609317,0.00011106421733046048,0.68
2948,5962,내지/Noun,25,8,17,0.00011114816049794375,0.0002110220129278749,0.68
2949,5963,제적/Noun,25,8,17,0.00011114816049794375,0.0002110220129278749,0.68
2950,5964,본드/Noun,25,17,8,0.00021118150494609317,0.00011106421733046048,0.68
2951,5965,알렉스/Noun,25,17,8,0.00021118150494609317,0.00011106421733046048,0.68
2952,5966,친일/Noun,25,8,17,0.00011114816049794375,0.0002110220129278749,0.68
2953,5967,귀하다/Adjective,25,17,8,0.00021118150494609317,0.00011106421733046048,0.68
2954,5968,고루/Noun,25,8,17,0.00011114816049794375,0.0002110220129278749,0.68
2955,5969,회복/Noun,25,17,8,0.00021118150494609317,0.00011106421733046048,0.68
2956,6049,♡♡♡/Foreign,24,24,0,0.0002889852172946538,2.2212843466092093e-05,1.0
2957,6050,乃/Foreign,24,24,0,0.0002889852172946538,2.2212843466092093e-05,1.0
2958,6051,낚였어/Noun,24,0,24,2.2229632099588756e-05,0.0002887669650591972,1.0
2959,6052,관광/Noun,24,0,24,2.2229632099588756e-05,0.0002887669650591972,1.0
2960,6053,조치/Noun,24,1,23,3.334444814938313e-05,0.00027766054332615115,0.9583333333333334
2961,6054,맥빠지다/Adjective,24,1,23,3.334444814938313e-05,0.00027766054332615115,0.9583333333333334
2962,6055,빠르기/Noun,24,1,23,3.334444814938313e-05,0.00027766054332615115,0.9583333333333334
2963,6056,학예회/Noun,24,1,23,3.334444814938313e-05,0.00027766054332615115,0.9583333333333334
2964,6057,오그/Noun,24,1,23,3.334444814938313e-05,0.00027766054332615115,0.9583333333333334
2965,6058,반점/Noun,24,2,22,4.445926419917751e-05,0.00026655412159310506,0.9166666666666666
2966,6059,심금/Noun,24,22,2,0.000266755585195065,4.4425686932184186e-05,0.9166666666666666
2967,6060,닭살/Noun,24,2,22,4.445926419917751e-05,0.00026655412159310506,0.9166666666666666
2968,6061,전범/Noun,24,2,22,4.445926419917751e-05,0.00026655412159310506,0.9166666666666666
2969,6062,상쾌하다/Adjective,24,22,2,0.000266755585195065,4.4425686932184186e-05,0.9166666666666666
2970,6063,날카롭다/Adjective,24,22,2,0.000266755585195065,4.4425686932184186e-05,0.9166666666666666
2971,6064,소외/Noun,24,22,2,0.000266755585195065,4.4425686932184186e-05,0.9166666666666666
2972,6065,수면/Noun,24,2,22,4.445926419917751e-05,0.00026655412159310506,0.9166666666666666
2973,6066,방어율/Noun,24,2,22,4.445926419917751e-05,0.00026655412159310506,0.9166666666666666
2974,6067,구지성/Noun,24,2,22,4.445926419917751e-05,0.00026655412159310506,0.9166666666666666
2975,6068,뿐더러/Noun,24,3,21,5.5574080248971876e-05,0.0002554476998600591,0.875
2976,6069,거참/Noun,24,3,21,5.5574080248971876e-05,0.0002554476998600591,0.875
2977,6070,오래도록/Adverb,24,21,3,0.00025564076914527065,5.553210866523024e-05,0.875
2978,6071,캡틴/Noun,24,21,3,0.00025564076914527065,5.553210866523024e-05,0.875
2979,6072,어렷을때/Noun,24,21,3,0.00025564076914527065,5.553210866523024e-05,0.875
2980,6073,와나/Noun,24,4,20,6.668889629876625e-05,0.00024434127812701304,0.8333333333333334
2981,6074,대륙/Noun,24,4,20,6.668889629876625e-05,0.00024434127812701304,0.8333333333333334
2982,6075,브라질/Noun,24,20,4,0.00024452595309547634,6.663853039827628e-05,0.8333333333333334
2983,6076,실적/Noun,24,20,4,0.00024452595309547634,6.663853039827628e-05,0.8333333333333334
2984,6077,죽겠네/Noun,24,4,20,6.668889629876625e-05,0.00024434127812701304,0.8333333333333334
2985,6078,문명/Noun,24,20,4,0.00024452595309547634,6.663853039827628e-05,0.8333333333333334
2986,6079,장창/Noun,24,4,20,6.668889629876625e-05,0.00024434127812701304,0.8333333333333334
2987,6080,13년/Number,24,20,4,0.00024452595309547634,6.663853039827628e-05,0.8333333333333334
2988,6081,올려놓다/Verb,24,5,19,7.780371234856063e-05,0.000233234856393967,0.7916666666666666
2989,6082,흐리다/Verb,24,5,19,7.780371234856063e-05,0.000233234856393967,0.7916666666666666
2990,6083,렌트/Noun,24,5,19,7.780371234856063e-05,0.000233234856393967,0.7916666666666666
2991,6084,반의/Noun,24,5,19,7.780371234856063e-05,0.000233234856393967,0.7916666666666666
2992,6085,스무살/Noun,24,19,5,0.0002334111370456819,7.774495213132233e-05,0.7916666666666666
2993,6086,저능/Noun,24,5,19,7.780371234856063e-05,0.000233234856393967,0.7916666666666666
2994,6087,으악/Adverb,24,5,19,7.780371234856063e-05,0.000233234856393967,0.7916666666666666
2995,6088,박정희/Noun,24,5,19,7.780371234856063e-05,0.000233234856393967,0.7916666666666666
2996,6089,놔두다/Verb,24,5,19,7.780371234856063e-05,0.000233234856393967,0.7916666666666666
2997,6090,아따/Noun,24,5,19,7.780371234856063e-05,0.000233234856393967,0.7916666666666666
2998,6091,상속/Noun,24,19,5,0.0002334111370456819,7.774495213132233e-05,0.7916666666666666
2999,6092,진상/Noun,24,5,19,7.780371234856063e-05,0.000233234856393967,0.7916666666666666
3000,6093,적합하다/Adjective,24,5,19,7.780371234856063e-05,0.000233234856393967,0.7916666666666666
3001,6094,조디/Noun,24,19,5,0.0002334111370456819,7.774495213132233e-05,0.7916666666666666
3002,6095,액/Noun,24,5,19,7.780371234856063e-05,0.000233234856393967,0.7916666666666666
3003,6096,피고/Noun,24,6,18,8.891852839835501e-05,0.00022212843466092096,0.75
3004,6097,앵/Adverb,24,6,18,8.891852839835501e-05,0.00022212843466092096,0.75
3005,6098,가두다/Verb,24,6,18,8.891852839835501e-05,0.00022212843466092096,0.75
3006,6099,엠비씨/Noun,24,6,18,8.891852839835501e-05,0.00022212843466092096,0.75
3007,6100,하찮다/Adjective,24,6,18,8.891852839835501e-05,0.00022212843466092096,0.75
3008,6101,진국/Noun,24,18,6,0.0002222963209958875,8.885137386436837e-05,0.75
3009,6102,소비/Noun,24,6,18,8.891852839835501e-05,0.00022212843466092096,0.75
3010,6103,아주아주/Adverb,24,18,6,0.0002222963209958875,8.885137386436837e-05,0.75
3011,6104,ㅅㅅ/KoreanParticle,24,6,18,8.891852839835501e-05,0.00022212843466092096,0.75
3012,6105,축하/Noun,24,18,6,0.0002222963209958875,8.885137386436837e-05,0.75
3013,6106,게다/Noun,24,6,18,8.891852839835501e-05,0.00022212843466092096,0.75
3014,6107,이경영/Noun,24,6,18,8.891852839835501e-05,0.00022212843466092096,0.75
3015,6108,도배/Noun,24,7,17,0.0001000333444481494,0.0002110220129278749,0.7083333333333334
3016,6109,녹음/Noun,24,7,17,0.0001000333444481494,0.0002110220129278749,0.7083333333333334
3017,6110,존예/Noun,24,17,7,0.00021118150494609317,9.995779559741441e-05,0.7083333333333334
3018,6111,박살/Noun,24,7,17,0.0001000333444481494,0.0002110220129278749,0.7083333333333334
3019,6112,기기/Noun,24,7,17,0.0001000333444481494,0.0002110220129278749,0.7083333333333334
3020,6113,계단/Noun,24,17,7,0.00021118150494609317,9.995779559741441e-05,0.7083333333333334
3021,6114,명언/Noun,24,17,7,0.00021118150494609317,9.995779559741441e-05,0.7083333333333334
3022,6115,..!!!/Punctuation,24,17,7,0.00021118150494609317,9.995779559741441e-05,0.7083333333333334
3023,6116,브라이언/Noun,24,17,7,0.00021118150494609317,9.995779559741441e-05,0.7083333333333334
3024,6117,퀴/Noun,24,7,17,0.0001000333444481494,0.0002110220129278749,0.7083333333333334
3025,6118,90/Number,24,7,17,0.0001000333444481494,0.0002110220129278749,0.7083333333333334
3026,6119,완존/Noun,24,17,7,0.00021118150494609317,9.995779559741441e-05,0.7083333333333334
3027,6120,".,./Punctuation",24,7,17,0.0001000333444481494,0.0002110220129278749,0.7083333333333334
3028,6121,눈물샘/Noun,24,17,7,0.00021118150494609317,9.995779559741441e-05,0.7083333333333334
3029,6122,민호/Noun,24,17,7,0.00021118150494609317,9.995779559741441e-05,0.7083333333333334
3030,6123,장선우/Noun,24,7,17,0.0001000333444481494,0.0002110220129278749,0.7083333333333334
3031,6124,창문/Noun,24,7,17,0.0001000333444481494,0.0002110220129278749,0.7083333333333334
3032,6125,이빨/Noun,24,7,17,0.0001000333444481494,0.0002110220129278749,0.7083333333333334
3033,6126,파치노/Noun,24,17,7,0.00021118150494609317,9.995779559741441e-05,0.7083333333333334
3034,6127,낡다/Adjective,24,7,17,0.0001000333444481494,0.0002110220129278749,0.7083333333333334
3035,6128,초라하다/Adjective,24,7,17,0.0001000333444481494,0.0002110220129278749,0.7083333333333334
3036,6129,해소/Noun,24,17,7,0.00021118150494609317,9.995779559741441e-05,0.7083333333333334
3037,6130,이문식/Noun,24,7,17,0.0001000333444481494,0.0002110220129278749,0.7083333333333334
3038,6131,이뤄지다/Verb,24,17,7,0.00021118150494609317,9.995779559741441e-05,0.7083333333333334
3039,6132,스티븐시걸/Noun,24,8,16,0.00011114816049794375,0.00019991559119482882,0.6666666666666666
3040,6133,비우다/Verb,24,8,16,0.00011114816049794375,0.00019991559119482882,0.6666666666666666
3041,6134,부조리/Noun,24,16,8,0.0002000666888962988,0.00011106421733046048,0.6666666666666666
3042,6135,대립/Noun,24,16,8,0.0002000666888962988,0.00011106421733046048,0.6666666666666666
3043,6136,스님/Noun,24,16,8,0.0002000666888962988,0.00011106421733046048,0.6666666666666666
3044,6137,장영/Noun,24,16,8,0.0002000666888962988,0.00011106421733046048,0.6666666666666666
3045,6138,분노하다/Adjective,24,8,16,0.00011114816049794375,0.00019991559119482882,0.6666666666666666
3046,6139,월드컵/Noun,24,16,8,0.0002000666888962988,0.00011106421733046048,0.6666666666666666
3047,6140,?????/Punctuation,24,8,16,0.00011114816049794375,0.00019991559119482882,0.6666666666666666
3048,6141,쇼킹/Noun,24,16,8,0.0002000666888962988,0.00011106421733046048,0.6666666666666666
3049,6142,문구/Noun,24,8,16,0.00011114816049794375,0.00019991559119482882,0.6666666666666666
3050,6143,야쿠자/Noun,24,8,16,0.00011114816049794375,0.00019991559119482882,0.6666666666666666
3051,6144,택/Noun,24,8,16,0.00011114816049794375,0.00019991559119482882,0.6666666666666666
3052,6145,호랑이/Noun,24,16,8,0.0002000666888962988,0.00011106421733046048,0.6666666666666666
3053,6146,빈틈/Noun,24,16,8,0.0002000666888962988,0.00011106421733046048,0.6666666666666666
3054,6147,리차드/Noun,24,16,8,0.0002000666888962988,0.00011106421733046048,0.6666666666666666
3055,6148,움직임/Noun,24,16,8,0.0002000666888962988,0.00011106421733046048,0.6666666666666666
3056,6149,유준상/Noun,24,8,16,0.00011114816049794375,0.00019991559119482882,0.6666666666666666
3057,6150,류승룡/Noun,24,16,8,0.0002000666888962988,0.00011106421733046048,0.6666666666666666
3058,6225,포근하다/Adjective,23,23,0,0.00027787040124485944,2.2212843466092093e-05,1.0
3059,6226,물체/Noun,23,0,23,2.2229632099588756e-05,0.00027766054332615115,1.0
3060,6227,긴급/Noun,23,1,22,3.334444814938313e-05,0.00026655412159310506,0.9565217391304348
3061,6228,난감/Noun,23,1,22,3.334444814938313e-05,0.00026655412159310506,0.9565217391304348
3062,6229,추강/Noun,23,22,1,0.000266755585195065,3.331926519913814e-05,0.9565217391304348
3063,6230,잡탕/Noun,23,1,22,3.334444814938313e-05,0.00026655412159310506,0.9565217391304348
3064,6231,꼽는/Noun,23,22,1,0.000266755585195065,3.331926519913814e-05,0.9565217391304348
3065,6232,못만드/Noun,23,2,21,4.445926419917751e-05,0.0002554476998600591,0.9130434782608696
3066,6233,박영화/Noun,23,21,2,0.00025564076914527065,4.4425686932184186e-05,0.9130434782608696
3067,6234,바람나다/Verb,23,2,21,4.445926419917751e-05,0.0002554476998600591,0.9130434782608696
3068,6235,존잘/Noun,23,20,3,0.00024452595309547634,5.553210866523024e-05,0.8695652173913043
3069,6236,경력/Noun,23,3,20,5.5574080248971876e-05,0.00024434127812701304,0.8695652173913043
3070,6237,11년/Number,23,20,3,0.00024452595309547634,5.553210866523024e-05,0.8695652173913043
3071,6238,나대다/Verb,23,3,20,5.5574080248971876e-05,0.00024434127812701304,0.8695652173913043
3072,6239,-;/Punctuation,23,3,20,5.5574080248971876e-05,0.00024434127812701304,0.8695652173913043
3073,6240,^.^/Punctuation,23,20,3,0.00024452595309547634,5.553210866523024e-05,0.8695652173913043
3074,6241,노아/Noun,23,3,20,5.5574080248971876e-05,0.00024434127812701304,0.8695652173913043
3075,6242,욧/Noun,23,20,3,0.00024452595309547634,5.553210866523024e-05,0.8695652173913043
3076,6243,스며들다/Verb,23,20,3,0.00024452595309547634,5.553210866523024e-05,0.8695652173913043
3077,6244,호프/Noun,23,20,3,0.00024452595309547634,5.553210866523024e-05,0.8695652173913043
3078,6245,직장인/Noun,23,20,3,0.00024452595309547634,5.553210866523024e-05,0.8695652173913043
3079,6246,볼바/Noun,23,3,20,5.5574080248971876e-05,0.00024434127812701304,0.8695652173913043
3080,6247,반쪽/Noun,23,3,20,5.5574080248971876e-05,0.00024434127812701304,0.8695652173913043
3081,6248,꾸역꾸역/Adverb,23,3,20,5.5574080248971876e-05,0.00024434127812701304,0.8695652173913043
3082,6249,데드/Noun,23,4,19,6.668889629876625e-05,0.000233234856393967,0.8260869565217391
3083,6250,파탄/Noun,23,4,19,6.668889629876625e-05,0.000233234856393967,0.8260869565217391
3084,6251,사골/Noun,23,4,19,6.668889629876625e-05,0.000233234856393967,0.8260869565217391
3085,6252,동양인/Noun,23,4,19,6.668889629876625e-05,0.000233234856393967,0.8260869565217391
3086,6253,요가/Noun,23,4,19,6.668889629876625e-05,0.000233234856393967,0.8260869565217391
3087,6254,잼남/Noun,23,19,4,0.0002334111370456819,6.663853039827628e-05,0.8260869565217391
3088,6255,후진/Noun,23,4,19,6.668889629876625e-05,0.000233234856393967,0.8260869565217391
3089,6256,킹왕짱/Noun,23,19,4,0.0002334111370456819,6.663853039827628e-05,0.8260869565217391
3090,6257,갈망/Noun,23,19,4,0.0002334111370456819,6.663853039827628e-05,0.8260869565217391
3091,6258,구식/Noun,23,4,19,6.668889629876625e-05,0.000233234856393967,0.8260869565217391
3092,6259,세심/Noun,23,19,4,0.0002334111370456819,6.663853039827628e-05,0.8260869565217391
3093,6260,추상/Noun,23,4,19,6.668889629876625e-05,0.000233234856393967,0.8260869565217391
3094,6261,남우/Noun,23,19,4,0.0002334111370456819,6.663853039827628e-05,0.8260869565217391
3095,6262,밍밍/Noun,23,4,19,6.668889629876625e-05,0.000233234856393967,0.8260869565217391
3096,6263,?;;/Punctuation,23,4,19,6.668889629876625e-05,0.000233234856393967,0.8260869565217391
3097,6264,보너스/Noun,23,18,5,0.0002222963209958875,7.774495213132233e-05,0.7826086956521741
3098,6265,수호/Noun,23,18,5,0.0002222963209958875,7.774495213132233e-05,0.7826086956521741
3099,6266,토요일/Noun,23,18,5,0.0002222963209958875,7.774495213132233e-05,0.7826086956521741
3100,6267,람/Noun,23,5,18,7.780371234856063e-05,0.00022212843466092096,0.7826086956521741
3101,6268,화신/Noun,23,5,18,7.780371234856063e-05,0.00022212843466092096,0.7826086956521741
3102,6269,저학년/Noun,23,5,18,7.780371234856063e-05,0.00022212843466092096,0.7826086956521741
3103,6270,유부녀/Noun,23,5,18,7.780371234856063e-05,0.00022212843466092096,0.7826086956521741
3104,6271,기다림/Noun,23,18,5,0.0002222963209958875,7.774495213132233e-05,0.7826086956521741
3105,6272,왕국/Noun,23,5,18,7.780371234856063e-05,0.00022212843466092096,0.7826086956521741
3106,6273,불신/Noun,23,5,18,7.780371234856063e-05,0.00022212843466092096,0.7826086956521741
3107,6274,에반게리온/Noun,23,17,6,0.00021118150494609317,8.885137386436837e-05,0.7391304347826086
3108,6275,나탈리/Noun,23,17,6,0.00021118150494609317,8.885137386436837e-05,0.7391304347826086
3109,6276,온통/Noun,23,6,17,8.891852839835501e-05,0.0002110220129278749,0.7391304347826086
3110,6277,현상/Noun,23,6,17,8.891852839835501e-05,0.0002110220129278749,0.7391304347826086
3111,6278,25년/Number,23,17,6,0.00021118150494609317,8.885137386436837e-05,0.7391304347826086
3112,6279,뵙다/Verb,23,17,6,0.00021118150494609317,8.885137386436837e-05,0.7391304347826086
3113,6280,단조롭다/Adjective,23,6,17,8.891852839835501e-05,0.0002110220129278749,0.7391304347826086
3114,6281,나른하다/Adjective,23,17,6,0.00021118150494609317,8.885137386436837e-05,0.7391304347826086
3115,6282,후배/Noun,23,6,17,8.891852839835501e-05,0.0002110220129278749,0.7391304347826086
3116,6283,탱/Adverb,23,6,17,8.891852839835501e-05,0.0002110220129278749,0.7391304347826086
3117,6284,긁다/Verb,23,6,17,8.891852839835501e-05,0.0002110220129278749,0.7391304347826086
3118,6285,이기심/Noun,23,17,6,0.00021118150494609317,8.885137386436837e-05,0.7391304347826086
3119,6286,레고/Noun,23,17,6,0.00021118150494609317,8.885137386436837e-05,0.7391304347826086
3120,6287,?..../Punctuation,23,6,17,8.891852839835501e-05,0.0002110220129278749,0.7391304347826086
3121,6288,함축/Noun,23,17,6,0.00021118150494609317,8.885137386436837e-05,0.7391304347826086
3122,6289,쭈욱/Noun,23,17,6,0.00021118150494609317,8.885137386436837e-05,0.7391304347826086
3123,6290,먹고살다/Verb,23,7,16,0.0001000333444481494,0.00019991559119482882,0.6956521739130435
3124,6291,길거리/Noun,23,7,16,0.0001000333444481494,0.00019991559119482882,0.6956521739130435
3125,6292,오덕/Noun,23,7,16,0.0001000333444481494,0.00019991559119482882,0.6956521739130435
3126,6293,태권도/Noun,23,7,16,0.0001000333444481494,0.00019991559119482882,0.6956521739130435
3127,6294,lt/Alpha,23,16,7,0.0002000666888962988,9.995779559741441e-05,0.6956521739130435
3128,6295,송윤아/Noun,23,16,7,0.0002000666888962988,9.995779559741441e-05,0.6956521739130435
3129,6296,사신/Noun,23,7,16,0.0001000333444481494,0.00019991559119482882,0.6956521739130435
3130,6297,영화광/Noun,23,7,16,0.0001000333444481494,0.00019991559119482882,0.6956521739130435
3131,6298,고아라/Noun,23,16,7,0.0002000666888962988,9.995779559741441e-05,0.6956521739130435
3132,6299,건너/Noun,23,7,16,0.0001000333444481494,0.00019991559119482882,0.6956521739130435
3133,6300,반미/Noun,23,7,16,0.0001000333444481494,0.00019991559119482882,0.6956521739130435
3134,6301,인격/Noun,23,7,16,0.0001000333444481494,0.00019991559119482882,0.6956521739130435
3135,6302,에잇/Exclamation,23,7,16,0.0001000333444481494,0.00019991559119482882,0.6956521739130435
3136,6303,동정/Noun,23,7,16,0.0001000333444481494,0.00019991559119482882,0.6956521739130435
3137,6304,지하/Noun,23,7,16,0.0001000333444481494,0.00019991559119482882,0.6956521739130435
3138,6305,시위/Noun,23,7,16,0.0001000333444481494,0.00019991559119482882,0.6956521739130435
3139,6306,싱크로/Noun,23,15,8,0.00018895187284650438,0.00011106421733046048,0.6521739130434783
3140,6307,심판/Noun,23,8,15,0.00011114816049794375,0.0001888091694617828,0.6521739130434783
3141,6308,잘나오다/Verb,23,8,15,0.00011114816049794375,0.0001888091694617828,0.6521739130434783
3142,6309,리그/Noun,23,8,15,0.00011114816049794375,0.0001888091694617828,0.6521739130434783
3143,6310,꽃미남/Noun,23,15,8,0.00018895187284650438,0.00011106421733046048,0.6521739130434783
3144,6311,김수미/Noun,23,8,15,0.00011114816049794375,0.0001888091694617828,0.6521739130434783
3145,6312,치킨/Noun,23,8,15,0.00011114816049794375,0.0001888091694617828,0.6521739130434783
3146,6313,윤시윤/Noun,23,15,8,0.00018895187284650438,0.00011106421733046048,0.6521739130434783
3147,6314,gt/Alpha,23,15,8,0.00018895187284650438,0.00011106421733046048,0.6521739130434783
3148,6315,광해/Noun,23,15,8,0.00018895187284650438,0.00011106421733046048,0.6521739130434783
3149,6316,기선/Noun,23,8,15,0.00011114816049794375,0.0001888091694617828,0.6521739130434783
3150,6317,여서/Noun,23,15,8,0.00018895187284650438,0.00011106421733046048,0.6521739130434783
3151,6318,경/Noun,23,15,8,0.00018895187284650438,0.00011106421733046048,0.6521739130434783
3152,6319,에밀리/Noun,23,15,8,0.00018895187284650438,0.00011106421733046048,0.6521739130434783
3153,6320,페/Noun,23,15,8,0.00018895187284650438,0.00011106421733046048,0.6521739130434783
3154,6321,연락/Noun,23,15,8,0.00018895187284650438,0.00011106421733046048,0.6521739130434783
3155,6322,XX/Alpha,23,8,15,0.00011114816049794375,0.0001888091694617828,0.6521739130434783
3156,6323,밑바닥/Noun,23,8,15,0.00011114816049794375,0.0001888091694617828,0.6521739130434783
3157,6324,이자벨/Noun,23,15,8,0.00018895187284650438,0.00011106421733046048,0.6521739130434783
3158,6325,설리/Noun,23,15,8,0.00018895187284650438,0.00011106421733046048,0.6521739130434783
3159,6326,도망치다/Verb,23,8,15,0.00011114816049794375,0.0001888091694617828,0.6521739130434783
3160,6327,꼬집다/Verb,23,15,8,0.00018895187284650438,0.00011106421733046048,0.6521739130434783
3161,6328,라이더/Noun,23,15,8,0.00018895187284650438,0.00011106421733046048,0.6521739130434783
3162,6329,신앙/Noun,23,15,8,0.00018895187284650438,0.00011106421733046048,0.6521739130434783
3163,6330,들려주다/Verb,23,15,8,0.00018895187284650438,0.00011106421733046048,0.6521739130434783
3164,6331,6.5/Number,23,8,15,0.00011114816049794375,0.0001888091694617828,0.6521739130434783
3165,6332,뛰어다니다/Verb,23,8,15,0.00011114816049794375,0.0001888091694617828,0.6521739130434783
3166,6333,성폭행/Noun,23,8,15,0.00011114816049794375,0.0001888091694617828,0.6521739130434783
3167,6402,뭘말/Noun,22,0,22,2.2229632099588756e-05,0.00026655412159310506,1.0
3168,6403,어장/Noun,22,0,22,2.2229632099588756e-05,0.00026655412159310506,1.0
3169,6404,엇/Noun,22,21,1,0.00025564076914527065,3.331926519913814e-05,0.9545454545454546
3170,6405,멀미/Noun,22,1,21,3.334444814938313e-05,0.0002554476998600591,0.9545454545454546
3171,6406,비약/Noun,22,1,21,3.334444814938313e-05,0.0002554476998600591,0.9545454545454546
3172,6407,뭉클/Noun,22,21,1,0.00025564076914527065,3.331926519913814e-05,0.9545454545454546
3173,6408,그이/Noun,22,1,21,3.334444814938313e-05,0.0002554476998600591,0.9545454545454546
3174,6409,면상/Noun,22,2,20,4.445926419917751e-05,0.00024434127812701304,0.9090909090909092
3175,6410,시시/Noun,22,2,20,4.445926419917751e-05,0.00024434127812701304,0.9090909090909092
3176,6411,레즈비언/Noun,22,2,20,4.445926419917751e-05,0.00024434127812701304,0.9090909090909092
3177,6412,주님/Noun,22,20,2,0.00024452595309547634,4.4425686932184186e-05,0.9090909090909092
3178,6413,막무가내/Noun,22,2,20,4.445926419917751e-05,0.00024434127812701304,0.9090909090909092
3179,6414,연출자/Noun,22,2,20,4.445926419917751e-05,0.00024434127812701304,0.9090909090909092
3180,6415,장사/Noun,22,2,20,4.445926419917751e-05,0.00024434127812701304,0.9090909090909092
3181,6416,..;;;/Punctuation,22,2,20,4.445926419917751e-05,0.00024434127812701304,0.9090909090909092
3182,6417,에/Noun,22,3,19,5.5574080248971876e-05,0.000233234856393967,0.8636363636363636
3183,6418,쟤/Noun,22,3,19,5.5574080248971876e-05,0.000233234856393967,0.8636363636363636
3184,6419,공익/Noun,22,3,19,5.5574080248971876e-05,0.000233234856393967,0.8636363636363636
3185,6420,쯤/Foreign,22,3,19,5.5574080248971876e-05,0.000233234856393967,0.8636363636363636
3186,6421,저그/Noun,22,3,19,5.5574080248971876e-05,0.000233234856393967,0.8636363636363636
3187,6422,고사/Noun,22,3,19,5.5574080248971876e-05,0.000233234856393967,0.8636363636363636
3188,6423,바하/Noun,22,4,18,6.668889629876625e-05,0.00022212843466092096,0.8181818181818182
3189,6424,악행/Noun,22,4,18,6.668889629876625e-05,0.00022212843466092096,0.8181818181818182
3190,6425,쫙/Noun,22,18,4,0.0002222963209958875,6.663853039827628e-05,0.8181818181818182
3191,6426,윤진서/Noun,22,4,18,6.668889629876625e-05,0.00022212843466092096,0.8181818181818182
3192,6427,연설/Noun,22,18,4,0.0002222963209958875,6.663853039827628e-05,0.8181818181818182
3193,6428,가시다/Verb,22,18,4,0.0002222963209958875,6.663853039827628e-05,0.8181818181818182
3194,6429,",,,,,/Punctuation",22,4,18,6.668889629876625e-05,0.00022212843466092096,0.8181818181818182
3195,6430,꼴다/Verb,22,4,18,6.668889629876625e-05,0.00022212843466092096,0.8181818181818182
3196,6431,최수종/Noun,22,18,4,0.0002222963209958875,6.663853039827628e-05,0.8181818181818182
3197,6432,베드씬/Noun,22,4,18,6.668889629876625e-05,0.00022212843466092096,0.8181818181818182
3198,6433,대인/Noun,22,18,4,0.0002222963209958875,6.663853039827628e-05,0.8181818181818182
3199,6434,쿵푸팬더/Noun,22,4,18,6.668889629876625e-05,0.00022212843466092096,0.8181818181818182
3200,6435,민주화/Noun,22,4,18,6.668889629876625e-05,0.00022212843466092096,0.8181818181818182
3201,6436,미숙/Noun,22,4,18,6.668889629876625e-05,0.00022212843466092096,0.8181818181818182
3202,6437,소유진/Noun,22,4,18,6.668889629876625e-05,0.00022212843466092096,0.8181818181818182
3203,6438,일관/Noun,22,4,18,6.668889629876625e-05,0.00022212843466092096,0.8181818181818182
3204,6439,월화/Noun,22,17,5,0.00021118150494609317,7.774495213132233e-05,0.7727272727272727
3205,6440,위성/Noun,22,5,17,7.780371234856063e-05,0.0002110220129278749,0.7727272727272727
3206,6441,외로/Noun,22,17,5,0.00021118150494609317,7.774495213132233e-05,0.7727272727272727
3207,6442,초콜릿/Noun,22,17,5,0.00021118150494609317,7.774495213132233e-05,0.7727272727272727
3208,6443,김민희/Noun,22,17,5,0.00021118150494609317,7.774495213132233e-05,0.7727272727272727
3209,6444,나잇/Noun,22,5,17,7.780371234856063e-05,0.0002110220129278749,0.7727272727272727
3210,6445,낯설다/Adjective,22,17,5,0.00021118150494609317,7.774495213132233e-05,0.7727272727272727
3211,6446,라기보단/Josa,22,5,17,7.780371234856063e-05,0.0002110220129278749,0.7727272727272727
3212,6447,치우치다/Verb,22,5,17,7.780371234856063e-05,0.0002110220129278749,0.7727272727272727
3213,6448,냉소/Noun,22,17,5,0.00021118150494609317,7.774495213132233e-05,0.7727272727272727
3214,6449,하하/Exclamation,22,5,17,7.780371234856063e-05,0.0002110220129278749,0.7727272727272727
3215,6450,40년/Number,22,17,5,0.00021118150494609317,7.774495213132233e-05,0.7727272727272727
3216,6451,변질/Noun,22,5,17,7.780371234856063e-05,0.0002110220129278749,0.7727272727272727
3217,6452,마녀사냥/Noun,22,17,5,0.00021118150494609317,7.774495213132233e-05,0.7727272727272727
3218,6453,쨩/Suffix,22,17,5,0.00021118150494609317,7.774495213132233e-05,0.7727272727272727
3219,6454,연구/Noun,22,5,17,7.780371234856063e-05,0.0002110220129278749,0.7727272727272727
3220,6455,종교영화/Noun,22,6,16,8.891852839835501e-05,0.00019991559119482882,0.7272727272727273
3221,6456,조선시대/Noun,22,6,16,8.891852839835501e-05,0.00019991559119482882,0.7272727272727273
3222,6457,비틀즈/Noun,22,16,6,0.0002000666888962988,8.885137386436837e-05,0.7272727272727273
3223,6458,배달/Noun,22,6,16,8.891852839835501e-05,0.00019991559119482882,0.7272727272727273
3224,6459,입맛/Noun,22,6,16,8.891852839835501e-05,0.00019991559119482882,0.7272727272727273
3225,6460,사태/Noun,22,6,16,8.891852839835501e-05,0.00019991559119482882,0.7272727272727273
3226,6461,울버린/Noun,22,6,16,8.891852839835501e-05,0.00019991559119482882,0.7272727272727273
3227,6462,바이올린/Noun,22,16,6,0.0002000666888962988,8.885137386436837e-05,0.7272727272727273
3228,6463,ㅇㅅㅇ/KoreanParticle,22,16,6,0.0002000666888962988,8.885137386436837e-05,0.7272727272727273
3229,6464,마시다/Verb,22,6,16,8.891852839835501e-05,0.00019991559119482882,0.7272727272727273
3230,6465,간지나다/Verb,22,16,6,0.0002000666888962988,8.885137386436837e-05,0.7272727272727273
3231,6466,이지나/Noun,22,16,6,0.0002000666888962988,8.885137386436837e-05,0.7272727272727273
3232,6467,올바르다/Adjective,22,16,6,0.0002000666888962988,8.885137386436837e-05,0.7272727272727273
3233,6468,95년/Number,22,15,7,0.00018895187284650438,9.995779559741441e-05,0.6818181818181818
3234,6469,털/Noun,22,7,15,0.0001000333444481494,0.0001888091694617828,0.6818181818181818
3235,6470,서바이벌/Noun,22,7,15,0.0001000333444481494,0.0001888091694617828,0.6818181818181818
3236,6471,김윤진/Noun,22,7,15,0.0001000333444481494,0.0001888091694617828,0.6818181818181818
3237,6472,E/Alpha,22,7,15,0.0001000333444481494,0.0001888091694617828,0.6818181818181818
3238,6473,청춘영화/Noun,22,15,7,0.00018895187284650438,9.995779559741441e-05,0.6818181818181818
3239,6474,무덤/Noun,22,7,15,0.0001000333444481494,0.0001888091694617828,0.6818181818181818
3240,6475,심해/Noun,22,7,15,0.0001000333444481494,0.0001888091694617828,0.6818181818181818
3241,6476,덜다/Verb,22,7,15,0.0001000333444481494,0.0001888091694617828,0.6818181818181818
3242,6477,무고/Noun,22,7,15,0.0001000333444481494,0.0001888091694617828,0.6818181818181818
3243,6478,지라/Noun,22,15,7,0.00018895187284650438,9.995779559741441e-05,0.6818181818181818
3244,6479,보영/Noun,22,15,7,0.00018895187284650438,9.995779559741441e-05,0.6818181818181818
3245,6480,그따위/Noun,22,7,15,0.0001000333444481494,0.0001888091694617828,0.6818181818181818
3246,6481,헌터/Noun,22,7,15,0.0001000333444481494,0.0001888091694617828,0.6818181818181818
3247,6482,지상파/Noun,22,15,7,0.00018895187284650438,9.995779559741441e-05,0.6818181818181818
3248,6483,동화책/Noun,22,15,7,0.00018895187284650438,9.995779559741441e-05,0.6818181818181818
3249,6484,엑소/Noun,22,15,7,0.00018895187284650438,9.995779559741441e-05,0.6818181818181818
3250,6485,시어머니/Noun,22,7,15,0.0001000333444481494,0.0001888091694617828,0.6818181818181818
3251,6486,개월/Noun,22,15,7,0.00018895187284650438,9.995779559741441e-05,0.6818181818181818
3252,6487,조니/Noun,22,7,15,0.0001000333444481494,0.0001888091694617828,0.6818181818181818
3253,6488,싸지르다/Verb,22,7,15,0.0001000333444481494,0.0001888091694617828,0.6818181818181818
3254,6489,뱀/Noun,22,7,15,0.0001000333444481494,0.0001888091694617828,0.6818181818181818
3255,6490,저격/Noun,22,15,7,0.00018895187284650438,9.995779559741441e-05,0.6818181818181818
3256,6491,~~!!!/Punctuation,22,15,7,0.00018895187284650438,9.995779559741441e-05,0.6818181818181818
3257,6492,번방/Noun,22,15,7,0.00018895187284650438,9.995779559741441e-05,0.6818181818181818
3258,6580,박현지/Noun,21,0,21,2.2229632099588756e-05,0.0002554476998600591,1.0
3259,6581,유머러스하다/Adjective,21,21,0,0.00025564076914527065,2.2212843466092093e-05,1.0
3260,6582,똥망/Noun,21,0,21,2.2229632099588756e-05,0.0002554476998600591,1.0
3261,6583,이수근/Noun,21,0,21,2.2229632099588756e-05,0.0002554476998600591,1.0
3262,6584,재즈/Noun,21,20,1,0.00024452595309547634,3.331926519913814e-05,0.9523809523809524
3263,6585,인내력/Noun,21,1,20,3.334444814938313e-05,0.00024434127812701304,0.9523809523809524
3264,6586,입력/Noun,21,1,20,3.334444814938313e-05,0.00024434127812701304,0.9523809523809524
3265,6587,조장/Noun,21,1,20,3.334444814938313e-05,0.00024434127812701304,0.9523809523809524
3266,6588,봣어/Noun,21,20,1,0.00024452595309547634,3.331926519913814e-05,0.9523809523809524
3267,6589,김현주/Noun,21,20,1,0.00024452595309547634,3.331926519913814e-05,0.9523809523809524
3268,6590,후레쉬맨/Noun,21,1,20,3.334444814938313e-05,0.00024434127812701304,0.9523809523809524
3269,6591,접영/Noun,21,1,20,3.334444814938313e-05,0.00024434127812701304,0.9523809523809524
3270,6592,멎다/Verb,21,20,1,0.00024452595309547634,3.331926519913814e-05,0.9523809523809524
3271,6593,개망작/Noun,21,1,20,3.334444814938313e-05,0.00024434127812701304,0.9523809523809524
3272,6594,긴지/Noun,21,1,20,3.334444814938313e-05,0.00024434127812701304,0.9523809523809524
3273,6595,퇴보/Noun,21,2,19,4.445926419917751e-05,0.000233234856393967,0.9047619047619048
3274,6596,우스꽝스럽다/Adjective,21,2,19,4.445926419917751e-05,0.000233234856393967,0.9047619047619048
3275,6597,귓가/Noun,21,19,2,0.0002334111370456819,4.4425686932184186e-05,0.9047619047619048
3276,6598,협박/Noun,21,2,19,4.445926419917751e-05,0.000233234856393967,0.9047619047619048
3277,6599,과분/Noun,21,2,19,4.445926419917751e-05,0.000233234856393967,0.9047619047619048
3278,6600,훌쩍/Noun,21,19,2,0.0002334111370456819,4.4425686932184186e-05,0.9047619047619048
3279,6601,탱고/Noun,21,19,2,0.0002334111370456819,4.4425686932184186e-05,0.9047619047619048
3280,6602,핑계/Noun,21,2,19,4.445926419917751e-05,0.000233234856393967,0.9047619047619048
3281,6603,개떡같다/Adjective,21,2,19,4.445926419917751e-05,0.000233234856393967,0.9047619047619048
3282,6604,이래도/Josa,21,2,19,4.445926419917751e-05,0.000233234856393967,0.9047619047619048
3283,6605,..-_-/Punctuation,21,3,18,5.5574080248971876e-05,0.00022212843466092096,0.8571428571428571
3284,6606,99년/Number,21,18,3,0.0002222963209958875,5.553210866523024e-05,0.8571428571428571
3285,6607,참패/Noun,21,3,18,5.5574080248971876e-05,0.00022212843466092096,0.8571428571428571
3286,6608,성지순례/Noun,21,3,18,5.5574080248971876e-05,0.00022212843466092096,0.8571428571428571
3287,6609,문채원/Noun,21,18,3,0.0002222963209958875,5.553210866523024e-05,0.8571428571428571
3288,6610,저따위/Noun,21,3,18,5.5574080248971876e-05,0.00022212843466092096,0.8571428571428571
3289,6611,매료/Noun,21,18,3,0.0002222963209958875,5.553210866523024e-05,0.8571428571428571
3290,6612,조국/Noun,21,18,3,0.0002222963209958875,5.553210866523024e-05,0.8571428571428571
3291,6613,장동민/Noun,21,18,3,0.0002222963209958875,5.553210866523024e-05,0.8571428571428571
3292,6614,하모니/Noun,21,18,3,0.0002222963209958875,5.553210866523024e-05,0.8571428571428571
3293,6615,장황하다/Adjective,21,3,18,5.5574080248971876e-05,0.00022212843466092096,0.8571428571428571
3294,6616,진실하다/Adjective,21,18,3,0.0002222963209958875,5.553210866523024e-05,0.8571428571428571
3295,6617,하트/Noun,21,18,3,0.0002222963209958875,5.553210866523024e-05,0.8571428571428571
3296,6618,둔갑/Noun,21,3,18,5.5574080248971876e-05,0.00022212843466092096,0.8571428571428571
3297,6619,꾀/Noun,21,18,3,0.0002222963209958875,5.553210866523024e-05,0.8571428571428571
3298,6620,끼들/Adverb,21,3,18,5.5574080248971876e-05,0.00022212843466092096,0.8571428571428571
3299,6621,으로부터/Josa,21,18,3,0.0002222963209958875,5.553210866523024e-05,0.8571428571428571
3300,6622,강원도/Noun,21,3,18,5.5574080248971876e-05,0.00022212843466092096,0.8571428571428571
3301,6623,한층/Noun,21,18,3,0.0002222963209958875,5.553210866523024e-05,0.8571428571428571
3302,6624,마스터피스/Noun,21,18,3,0.0002222963209958875,5.553210866523024e-05,0.8571428571428571
3303,6625,굵다/Adjective,21,17,4,0.00021118150494609317,6.663853039827628e-05,0.8095238095238095
3304,6626,하다못해/Adverb,21,4,17,6.668889629876625e-05,0.0002110220129278749,0.8095238095238095
3305,6627,방지/Noun,21,4,17,6.668889629876625e-05,0.0002110220129278749,0.8095238095238095
3306,6628,가다가/Noun,21,4,17,6.668889629876625e-05,0.0002110220129278749,0.8095238095238095
3307,6629,범작/Noun,21,4,17,6.668889629876625e-05,0.0002110220129278749,0.8095238095238095
3308,6630,시원시원하다/Adjective,21,17,4,0.00021118150494609317,6.663853039827628e-05,0.8095238095238095
3309,6631,어쩌구/Noun,21,4,17,6.668889629876625e-05,0.0002110220129278749,0.8095238095238095
3310,6632,오오오/Noun,21,17,4,0.00021118150494609317,6.663853039827628e-05,0.8095238095238095
3311,6633,눈살/Noun,21,4,17,6.668889629876625e-05,0.0002110220129278749,0.8095238095238095
3312,6634,미셸/Noun,21,17,4,0.00021118150494609317,6.663853039827628e-05,0.8095238095238095
3313,6635,줄라/Noun,21,4,17,6.668889629876625e-05,0.0002110220129278749,0.8095238095238095
3314,6636,편향/Noun,21,4,17,6.668889629876625e-05,0.0002110220129278749,0.8095238095238095
3315,6637,긴장도/Noun,21,4,17,6.668889629876625e-05,0.0002110220129278749,0.8095238095238095
3316,6638,동떨어지다/Adjective,21,4,17,6.668889629876625e-05,0.0002110220129278749,0.8095238095238095
3317,6639,뚝/Noun,21,5,16,7.780371234856063e-05,0.00019991559119482882,0.7619047619047619
3318,6640,트루/Noun,21,5,16,7.780371234856063e-05,0.00019991559119482882,0.7619047619047619
3319,6641,재림/Noun,21,5,16,7.780371234856063e-05,0.00019991559119482882,0.7619047619047619
3320,6642,레즈/Noun,21,5,16,7.780371234856063e-05,0.00019991559119482882,0.7619047619047619
3321,6643,오죽하다/Adjective,21,5,16,7.780371234856063e-05,0.00019991559119482882,0.7619047619047619
3322,6644,파도/Noun,21,16,5,0.0002000666888962988,7.774495213132233e-05,0.7619047619047619
3323,6645,젖/Noun,21,5,16,7.780371234856063e-05,0.00019991559119482882,0.7619047619047619
3324,6646,결여/Noun,21,5,16,7.780371234856063e-05,0.00019991559119482882,0.7619047619047619
3325,6647,절때/Noun,21,5,16,7.780371234856063e-05,0.00019991559119482882,0.7619047619047619
3326,6648,“/Foreign,21,5,16,7.780371234856063e-05,0.00019991559119482882,0.7619047619047619
3327,6649,콩가루/Noun,21,5,16,7.780371234856063e-05,0.00019991559119482882,0.7619047619047619
3328,6650,쌩뚱맞/Noun,21,5,16,7.780371234856063e-05,0.00019991559119482882,0.7619047619047619
3329,6651,댄서/Noun,21,5,16,7.780371234856063e-05,0.00019991559119482882,0.7619047619047619
3330,6652,느님/Noun,21,16,5,0.0002000666888962988,7.774495213132233e-05,0.7619047619047619
3331,6653,짚다/Verb,21,15,6,0.00018895187284650438,8.885137386436837e-05,0.7142857142857143
3332,6654,인용/Noun,21,6,15,8.891852839835501e-05,0.0001888091694617828,0.7142857142857143
3333,6655,음모론/Noun,21,6,15,8.891852839835501e-05,0.0001888091694617828,0.7142857142857143
3334,6656,!!!!!!!!!!!/Punctuation,21,15,6,0.00018895187284650438,8.885137386436837e-05,0.7142857142857143
3335,6657,재연/Noun,21,6,15,8.891852839835501e-05,0.0001888091694617828,0.7142857142857143
3336,6658,작고/Noun,21,6,15,8.891852839835501e-05,0.0001888091694617828,0.7142857142857143
3337,6659,대서/Noun,21,6,15,8.891852839835501e-05,0.0001888091694617828,0.7142857142857143
3338,6660,걸음/Noun,21,15,6,0.00018895187284650438,8.885137386436837e-05,0.7142857142857143
3339,6661,지향/Noun,21,6,15,8.891852839835501e-05,0.0001888091694617828,0.7142857142857143
3340,6662,보람/Noun,21,15,6,0.00018895187284650438,8.885137386436837e-05,0.7142857142857143
3341,6663,강우석/Noun,21,6,15,8.891852839835501e-05,0.0001888091694617828,0.7142857142857143
3342,6664,일진/Noun,21,6,15,8.891852839835501e-05,0.0001888091694617828,0.7142857142857143
3343,6665,금도/Noun,21,15,6,0.00018895187284650438,8.885137386436837e-05,0.7142857142857143
3344,6666,다짐/Noun,21,15,6,0.00018895187284650438,8.885137386436837e-05,0.7142857142857143
3345,6667,화재/Noun,21,6,15,8.891852839835501e-05,0.0001888091694617828,0.7142857142857143
3346,6668,ㅇㅋ/KoreanParticle,21,6,15,8.891852839835501e-05,0.0001888091694617828,0.7142857142857143
3347,6669,명분/Noun,21,6,15,8.891852839835501e-05,0.0001888091694617828,0.7142857142857143
3348,6670,영애/Noun,21,15,6,0.00018895187284650438,8.885137386436837e-05,0.7142857142857143
3349,6671,무었/Noun,21,15,6,0.00018895187284650438,8.885137386436837e-05,0.7142857142857143
3350,6672,에이미/Noun,21,14,7,0.00017783705679671002,9.995779559741441e-05,0.6666666666666666
3351,6673,악녀/Noun,21,7,14,0.0001000333444481494,0.00017770274772873674,0.6666666666666666
3352,6674,싱어/Noun,21,14,7,0.00017783705679671002,9.995779559741441e-05,0.6666666666666666
3353,6675,수능/Noun,21,14,7,0.00017783705679671002,9.995779559741441e-05,0.6666666666666666
3354,6676,시가/Noun,21,14,7,0.00017783705679671002,9.995779559741441e-05,0.6666666666666666
3355,6677,괴담/Noun,21,7,14,0.0001000333444481494,0.00017770274772873674,0.6666666666666666
3356,6678,일제/Noun,21,7,14,0.0001000333444481494,0.00017770274772873674,0.6666666666666666
3357,6679,****/Punctuation,21,14,7,0.00017783705679671002,9.995779559741441e-05,0.6666666666666666
3358,6680,푸하하하/Noun,21,7,14,0.0001000333444481494,0.00017770274772873674,0.6666666666666666
3359,6681,재수/Noun,21,7,14,0.0001000333444481494,0.00017770274772873674,0.6666666666666666
3360,6682,김민준/Noun,21,7,14,0.0001000333444481494,0.00017770274772873674,0.6666666666666666
3361,6683,둘이서/Noun,21,7,14,0.0001000333444481494,0.00017770274772873674,0.6666666666666666
3362,6684,핸드/Noun,21,7,14,0.0001000333444481494,0.00017770274772873674,0.6666666666666666
3363,6685,제격/Noun,21,14,7,0.00017783705679671002,9.995779559741441e-05,0.6666666666666666
3364,6686,정녕/Noun,21,7,14,0.0001000333444481494,0.00017770274772873674,0.6666666666666666
3365,6687,을해/Noun,21,7,14,0.0001000333444481494,0.00017770274772873674,0.6666666666666666
3366,6688,근대/Noun,21,14,7,0.00017783705679671002,9.995779559741441e-05,0.6666666666666666
3367,6689,쑤다/Verb,21,7,14,0.0001000333444481494,0.00017770274772873674,0.6666666666666666
3368,6690,동경/Noun,21,14,7,0.00017783705679671002,9.995779559741441e-05,0.6666666666666666
3369,6691,사업/Noun,21,7,14,0.0001000333444481494,0.00017770274772873674,0.6666666666666666
3370,6692,베토벤/Noun,21,14,7,0.00017783705679671002,9.995779559741441e-05,0.6666666666666666
3371,6693,런/Noun,21,14,7,0.00017783705679671002,9.995779559741441e-05,0.6666666666666666
3372,6694,넘버/Noun,21,14,7,0.00017783705679671002,9.995779559741441e-05,0.6666666666666666
3373,6695,댓글달다/Verb,21,7,14,0.0001000333444481494,0.00017770274772873674,0.6666666666666666
3374,6696,차기작/Noun,21,14,7,0.00017783705679671002,9.995779559741441e-05,0.6666666666666666
3375,6697,훅/Noun,21,7,14,0.0001000333444481494,0.00017770274772873674,0.6666666666666666
3376,6698,주요/Modifier,21,7,14,0.0001000333444481494,0.00017770274772873674,0.6666666666666666
3377,6699,나래/Noun,21,7,14,0.0001000333444481494,0.00017770274772873674,0.6666666666666666
3378,6700,한결같다/Adjective,21,7,14,0.0001000333444481494,0.00017770274772873674,0.6666666666666666
3379,6701,연평해전/Noun,21,7,14,0.0001000333444481494,0.00017770274772873674,0.6666666666666666
3380,6702,잊어버리다/Verb,21,14,7,0.00017783705679671002,9.995779559741441e-05,0.6666666666666666
3381,6703,어이없이/Adverb,21,7,14,0.0001000333444481494,0.00017770274772873674,0.6666666666666666
3382,6787,낭패/Noun,20,0,20,2.2229632099588756e-05,0.00024434127812701304,1.0
3383,6788,낚시질/Noun,20,0,20,2.2229632099588756e-05,0.00024434127812701304,1.0
3384,6789,GOOD/Alpha,20,19,1,0.0002334111370456819,3.331926519913814e-05,0.95
3385,6790,맛없다/Adjective,20,1,19,3.334444814938313e-05,0.000233234856393967,0.95
3386,6791,자연스레/Adverb,20,19,1,0.0002334111370456819,3.331926519913814e-05,0.95
3387,6792,^^~/Punctuation,20,19,1,0.0002334111370456819,3.331926519913814e-05,0.95
3388,6793,우기다/Verb,20,1,19,3.334444814938313e-05,0.000233234856393967,0.95
3389,6794,어따/Exclamation,20,1,19,3.334444814938313e-05,0.000233234856393967,0.95
3390,6795,잔치/Noun,20,1,19,3.334444814938313e-05,0.000233234856393967,0.95
3391,6796,무미건조하다/Adjective,20,1,19,3.334444814938313e-05,0.000233234856393967,0.95
3392,6797,꽉차다/Verb,20,18,2,0.0002222963209958875,4.4425686932184186e-05,0.9
3393,6798,기한/Noun,20,2,18,4.445926419917751e-05,0.00022212843466092096,0.9
3394,6799,뷁/Noun,20,2,18,4.445926419917751e-05,0.00022212843466092096,0.9
3395,6800,보다/Foreign,20,2,18,4.445926419917751e-05,0.00022212843466092096,0.9
3396,6801,노소/Noun,20,18,2,0.0002222963209958875,4.4425686932184186e-05,0.9
3397,6802,한구석/Noun,20,18,2,0.0002222963209958875,4.4425686932184186e-05,0.9
3398,6803,유년/Noun,20,18,2,0.0002222963209958875,4.4425686932184186e-05,0.9
3399,6804,mc/Alpha,20,2,18,4.445926419917751e-05,0.00022212843466092096,0.9
3400,6805,양키/Noun,20,2,18,4.445926419917751e-05,0.00022212843466092096,0.9
3401,6806,미워하다/Adjective,20,17,3,0.00021118150494609317,5.553210866523024e-05,0.85
3402,6807,고추/Noun,20,3,17,5.5574080248971876e-05,0.0002110220129278749,0.85
3403,6808,박진영/Noun,20,3,17,5.5574080248971876e-05,0.0002110220129278749,0.85
3404,6809,>_</Punctuation,20,17,3,0.00021118150494609317,5.553210866523024e-05,0.85
3405,6810,자국/Noun,20,3,17,5.5574080248971876e-05,0.0002110220129278749,0.85
3406,6811,쫄깃/Noun,20,17,3,0.00021118150494609317,5.553210866523024e-05,0.85
3407,6812,테일러/Noun,20,17,3,0.00021118150494609317,5.553210866523024e-05,0.85
3408,6813,명백하다/Adjective,20,3,17,5.5574080248971876e-05,0.0002110220129278749,0.85
3409,6814,드릅/Noun,20,3,17,5.5574080248971876e-05,0.0002110220129278749,0.85
3410,6815,탈락/Noun,20,3,17,5.5574080248971876e-05,0.0002110220129278749,0.85
3411,6816,나위/Noun,20,17,3,0.00021118150494609317,5.553210866523024e-05,0.85
3412,6817,삼천포/Noun,20,3,17,5.5574080248971876e-05,0.0002110220129278749,0.85
3413,6818,섹/Noun,20,3,17,5.5574080248971876e-05,0.0002110220129278749,0.85
3414,6819,...;/Punctuation,20,3,17,5.5574080248971876e-05,0.0002110220129278749,0.85
3415,6820,떨구다/Verb,20,3,17,5.5574080248971876e-05,0.0002110220129278749,0.85
3416,6821,마더/Noun,20,17,3,0.00021118150494609317,5.553210866523024e-05,0.85
3417,6822,It/Alpha,20,17,3,0.00021118150494609317,5.553210866523024e-05,0.85
3418,6823,생동감/Noun,20,16,4,0.0002000666888962988,6.663853039827628e-05,0.8
3419,6824,CF/Alpha,20,4,16,6.668889629876625e-05,0.00019991559119482882,0.8
3420,6825,더러/Noun,20,4,16,6.668889629876625e-05,0.00019991559119482882,0.8
3421,6826,친일파/Noun,20,4,16,6.668889629876625e-05,0.00019991559119482882,0.8
3422,6827,쫓기다/Verb,20,4,16,6.668889629876625e-05,0.00019991559119482882,0.8
3423,6828,부진하다/Adjective,20,4,16,6.668889629876625e-05,0.00019991559119482882,0.8
3424,6829,교묘하다/Adjective,20,4,16,6.668889629876625e-05,0.00019991559119482882,0.8
3425,6830,우물/Noun,20,4,16,6.668889629876625e-05,0.00019991559119482882,0.8
3426,6831,읍니/Noun,20,16,4,0.0002000666888962988,6.663853039827628e-05,0.8
3427,6832,허비하다/Adjective,20,4,16,6.668889629876625e-05,0.00019991559119482882,0.8
3428,6833,수식어/Noun,20,16,4,0.0002000666888962988,6.663853039827628e-05,0.8
3429,6834,기름/Noun,20,4,16,6.668889629876625e-05,0.00019991559119482882,0.8
3430,6835,박용우/Noun,20,16,4,0.0002000666888962988,6.663853039827628e-05,0.8
3431,6836,나하/Noun,20,4,16,6.668889629876625e-05,0.00019991559119482882,0.8
3432,6837,람사/Noun,20,16,4,0.0002000666888962988,6.663853039827628e-05,0.8
3433,6838,앞두다/Verb,20,16,4,0.0002000666888962988,6.663853039827628e-05,0.8
3434,6839,서글프다/Adjective,20,16,4,0.0002000666888962988,6.663853039827628e-05,0.8
3435,6840,학적/Noun,20,4,16,6.668889629876625e-05,0.00019991559119482882,0.8
3436,6841,월요일/Noun,20,16,4,0.0002000666888962988,6.663853039827628e-05,0.8
3437,6842,프랭크/Noun,20,16,4,0.0002000666888962988,6.663853039827628e-05,0.8
3438,6843,총기/Noun,20,15,5,0.00018895187284650438,7.774495213132233e-05,0.75
3439,6844,시계/Noun,20,5,15,7.780371234856063e-05,0.0001888091694617828,0.75
3440,6845,소리내다/Verb,20,15,5,0.00018895187284650438,7.774495213132233e-05,0.75
3441,6846,머리카락/Noun,20,5,15,7.780371234856063e-05,0.0001888091694617828,0.75
3442,6847,가르침/Noun,20,15,5,0.00018895187284650438,7.774495213132233e-05,0.75
3443,6848,짜장면/Noun,20,5,15,7.780371234856063e-05,0.0001888091694617828,0.75
3444,6849,여사/Noun,20,15,5,0.00018895187284650438,7.774495213132233e-05,0.75
3445,6850,합작/Noun,20,5,15,7.780371234856063e-05,0.0001888091694617828,0.75
3446,6851,무심코/Noun,20,15,5,0.00018895187284650438,7.774495213132233e-05,0.75
3447,6852,전무후무/Noun,20,15,5,0.00018895187284650438,7.774495213132233e-05,0.75
3448,6853,시달리다/Verb,20,5,15,7.780371234856063e-05,0.0001888091694617828,0.75
3449,6854,관해/Noun,20,15,5,0.00018895187284650438,7.774495213132233e-05,0.75
3450,6855,ever/Alpha,20,15,5,0.00018895187284650438,7.774495213132233e-05,0.75
3451,6856,얄밉다/Adjective,20,15,5,0.00018895187284650438,7.774495213132233e-05,0.75
3452,6857,오만하다/Adjective,20,5,15,7.780371234856063e-05,0.0001888091694617828,0.75
3453,6858,노릇/Noun,20,5,15,7.780371234856063e-05,0.0001888091694617828,0.75
3454,6859,경상도/Noun,20,5,15,7.780371234856063e-05,0.0001888091694617828,0.75
3455,6860,학대/Noun,20,5,15,7.780371234856063e-05,0.0001888091694617828,0.75
3456,6861,.~/Punctuation,20,15,5,0.00018895187284650438,7.774495213132233e-05,0.75
3457,6862,연예/Noun,20,5,15,7.780371234856063e-05,0.0001888091694617828,0.75
3458,6863,세금/Noun,20,5,15,7.780371234856063e-05,0.0001888091694617828,0.75
3459,6864,순정만화/Noun,20,5,15,7.780371234856063e-05,0.0001888091694617828,0.75
3460,6865,이로/Noun,20,14,6,0.00017783705679671002,8.885137386436837e-05,0.7
3461,6866,몰려오다/Verb,20,6,14,8.891852839835501e-05,0.00017770274772873674,0.7
3462,6867,벨라/Noun,20,6,14,8.891852839835501e-05,0.00017770274772873674,0.7
3463,6868,번하다/Adjective,20,6,14,8.891852839835501e-05,0.00017770274772873674,0.7
3464,6869,폰부스/Noun,20,6,14,8.891852839835501e-05,0.00017770274772873674,0.7
3465,6870,유희/Noun,20,14,6,0.00017783705679671002,8.885137386436837e-05,0.7
3466,6871,잡스/Noun,20,6,14,8.891852839835501e-05,0.00017770274772873674,0.7
3467,6872,쿵푸/Noun,20,6,14,8.891852839835501e-05,0.00017770274772873674,0.7
3468,6873,사토시/Noun,20,14,6,0.00017783705679671002,8.885137386436837e-05,0.7
3469,6874,무성영화/Noun,20,14,6,0.00017783705679671002,8.885137386436837e-05,0.7
3470,6875,인데/Foreign,20,6,14,8.891852839835501e-05,0.00017770274772873674,0.7
3471,6876,안에/Foreign,20,6,14,8.891852839835501e-05,0.00017770274772873674,0.7
3472,6877,리플/Noun,20,6,14,8.891852839835501e-05,0.00017770274772873674,0.7
3473,6878,신비하다/Adjective,20,14,6,0.00017783705679671002,8.885137386436837e-05,0.7
3474,6879,켈리/Noun,20,14,6,0.00017783705679671002,8.885137386436837e-05,0.7
3475,6880,페미니즘/Noun,20,6,14,8.891852839835501e-05,0.00017770274772873674,0.7
3476,6881,몰아치다/Verb,20,14,6,0.00017783705679671002,8.885137386436837e-05,0.7
3477,6882,티라노/Noun,20,6,14,8.891852839835501e-05,0.00017770274772873674,0.7
3478,6883,다섯손가락/Noun,20,14,6,0.00017783705679671002,8.885137386436837e-05,0.7
3479,6884,SM/Alpha,20,6,14,8.891852839835501e-05,0.00017770274772873674,0.7
3480,6885,서툴다/Adjective,20,14,6,0.00017783705679671002,8.885137386436837e-05,0.7
3481,6886,불멸/Noun,20,14,6,0.00017783705679671002,8.885137386436837e-05,0.7
3482,6887,은애/Noun,20,6,14,8.891852839835501e-05,0.00017770274772873674,0.7
3483,6888,허각/Noun,20,14,6,0.00017783705679671002,8.885137386436837e-05,0.7
3484,6889,원망/Noun,20,6,14,8.891852839835501e-05,0.00017770274772873674,0.7
3485,6890,송새벽/Noun,20,6,14,8.891852839835501e-05,0.00017770274772873674,0.7
3486,6891,울부짖다/Verb,20,14,6,0.00017783705679671002,8.885137386436837e-05,0.7
3487,6892,꽁/Adverb,20,6,14,8.891852839835501e-05,0.00017770274772873674,0.7
3488,6893,한치/Noun,20,6,14,8.891852839835501e-05,0.00017770274772873674,0.7
3489,6894,즈음/Noun,20,14,6,0.00017783705679671002,8.885137386436837e-05,0.7
3490,6895,pd/Alpha,20,6,14,8.891852839835501e-05,0.00017770274772873674,0.7
3491,6896,마돈나/Noun,20,6,14,8.891852839835501e-05,0.00017770274772873674,0.7
3492,6897,스티/Noun,20,7,13,0.0001000333444481494,0.0001665963259956907,0.65
3493,6898,김주혁/Noun,20,13,7,0.00016672224074691566,9.995779559741441e-05,0.65
3494,6899,고함/Noun,20,7,13,0.0001000333444481494,0.0001665963259956907,0.65
3495,6900,밸런스/Noun,20,7,13,0.0001000333444481494,0.0001665963259956907,0.65
3496,6901,판도/Noun,20,13,7,0.00016672224074691566,9.995779559741441e-05,0.65
3497,6902,연대기/Noun,20,13,7,0.00016672224074691566,9.995779559741441e-05,0.65
3498,6903,신들/Noun,20,7,13,0.0001000333444481494,0.0001665963259956907,0.65
3499,6904,소라/Noun,20,7,13,0.0001000333444481494,0.0001665963259956907,0.65
3500,6905,어스/Noun,20,13,7,0.00016672224074691566,9.995779559741441e-05,0.65
3501,6906,모범/Noun,20,13,7,0.00016672224074691566,9.995779559741441e-05,0.65
3502,6907,부각시키다/Verb,20,7,13,0.0001000333444481494,0.0001665963259956907,0.65
3503,6908,다우니/Noun,20,13,7,0.00016672224074691566,9.995779559741441e-05,0.65
3504,6909,탐험/Noun,20,7,13,0.0001000333444481494,0.0001665963259956907,0.65
3505,6910,대다수/Noun,20,7,13,0.0001000333444481494,0.0001665963259956907,0.65
3506,6911,이크/Noun,20,7,13,0.0001000333444481494,0.0001665963259956907,0.65
3507,6912,대중성/Noun,20,7,13,0.0001000333444481494,0.0001665963259956907,0.65
3508,6913,부천/Noun,20,13,7,0.00016672224074691566,9.995779559741441e-05,0.65
3509,6914,13일/Number,20,7,13,0.0001000333444481494,0.0001665963259956907,0.65
3510,6915,김창완/Noun,20,7,13,0.0001000333444481494,0.0001665963259956907,0.65
3511,6916,미지/Noun,20,13,7,0.00016672224074691566,9.995779559741441e-05,0.65
3512,6917,탐정/Noun,20,7,13,0.0001000333444481494,0.0001665963259956907,0.65
3513,6918,아이템/Noun,20,7,13,0.0001000333444481494,0.0001665963259956907,0.65
3514,6919,존트라볼타/Noun,20,13,7,0.00016672224074691566,9.995779559741441e-05,0.65
3515,6998,영점/Noun,19,0,19,2.2229632099588756e-05,0.000233234856393967,1.0
3516,6999,해롭다/Adjective,19,0,19,2.2229632099588756e-05,0.000233234856393967,1.0
3517,7000,맘에듬/Noun,19,19,0,0.0002334111370456819,2.2212843466092093e-05,1.0
3518,7001,쒸레기/Noun,19,0,19,2.2229632099588756e-05,0.000233234856393967,1.0
3519,7002,빼어나다/Adjective,19,18,1,0.0002222963209958875,3.331926519913814e-05,0.9473684210526316
3520,7003,발정/Noun,19,1,18,3.334444814938313e-05,0.00022212843466092096,0.9473684210526316
3521,7004,~~~^^/Punctuation,19,18,1,0.0002222963209958875,3.331926519913814e-05,0.9473684210526316
3522,7005,ㅆㄹㄱ/KoreanParticle,19,1,18,3.334444814938313e-05,0.00022212843466092096,0.9473684210526316
3523,7006,빈약/Noun,19,1,18,3.334444814938313e-05,0.00022212843466092096,0.9473684210526316
3524,7007,상쾌/Noun,19,18,1,0.0002222963209958875,3.331926519913814e-05,0.9473684210526316
3525,7008,짜증스럽다/Adjective,19,1,18,3.334444814938313e-05,0.00022212843466092096,0.9473684210526316
3526,7009,냉혹하다/Adjective,19,18,1,0.0002222963209958875,3.331926519913814e-05,0.9473684210526316
3527,7010,짜깁다/Verb,19,1,18,3.334444814938313e-05,0.00022212843466092096,0.9473684210526316
3528,7011,Ost/Alpha,19,18,1,0.0002222963209958875,3.331926519913814e-05,0.9473684210526316
3529,7012,재밌엇음/Noun,19,18,1,0.0002222963209958875,3.331926519913814e-05,0.9473684210526316
3530,7013,진전/Noun,19,1,18,3.334444814938313e-05,0.00022212843466092096,0.9473684210526316
3531,7014,발성/Noun,19,1,18,3.334444814938313e-05,0.00022212843466092096,0.9473684210526316
3532,7015,우웩/Noun,19,1,18,3.334444814938313e-05,0.00022212843466092096,0.9473684210526316
3533,7016,남다르다/Adjective,19,17,2,0.00021118150494609317,4.4425686932184186e-05,0.8947368421052632
3534,7017,최상/Noun,19,17,2,0.00021118150494609317,4.4425686932184186e-05,0.8947368421052632
3535,7018,80%/Number,19,2,17,4.445926419917751e-05,0.0002110220129278749,0.8947368421052632
3536,7019,9~10/Number,19,2,17,4.445926419917751e-05,0.0002110220129278749,0.8947368421052632
3537,7020,완소/Noun,19,17,2,0.00021118150494609317,4.4425686932184186e-05,0.8947368421052632
3538,7021,다인/Noun,19,2,17,4.445926419917751e-05,0.0002110220129278749,0.8947368421052632
3539,7022,생뚱맞/Noun,19,2,17,4.445926419917751e-05,0.0002110220129278749,0.8947368421052632
3540,7023,이글/Noun,19,2,17,4.445926419917751e-05,0.0002110220129278749,0.8947368421052632
3541,7024,툭툭/Noun,19,3,16,5.5574080248971876e-05,0.00019991559119482882,0.8421052631578947
3542,7025,실천/Noun,19,16,3,0.0002000666888962988,5.553210866523024e-05,0.8421052631578947
3543,7026,관우/Noun,19,3,16,5.5574080248971876e-05,0.00019991559119482882,0.8421052631578947
3544,7027,망정/Noun,19,3,16,5.5574080248971876e-05,0.00019991559119482882,0.8421052631578947
3545,7028,고질/Noun,19,3,16,5.5574080248971876e-05,0.00019991559119482882,0.8421052631578947
3546,7029,김혜선/Noun,19,3,16,5.5574080248971876e-05,0.00019991559119482882,0.8421052631578947
3547,7030,때로는/Noun,19,16,3,0.0002000666888962988,5.553210866523024e-05,0.8421052631578947
3548,7031,안중근/Noun,19,3,16,5.5574080248971876e-05,0.00019991559119482882,0.8421052631578947
3549,7032,호연/Noun,19,16,3,0.0002000666888962988,5.553210866523024e-05,0.8421052631578947
3550,7033,박시후/Noun,19,16,3,0.0002000666888962988,5.553210866523024e-05,0.8421052631578947
3551,7034,이쯤/Noun,19,3,16,5.5574080248971876e-05,0.00019991559119482882,0.8421052631578947
3552,7035,천천히/Adverb,19,16,3,0.0002000666888962988,5.553210866523024e-05,0.8421052631578947
3553,7036,애비/Noun,19,3,16,5.5574080248971876e-05,0.00019991559119482882,0.8421052631578947
3554,7037,알아듣다/Verb,19,3,16,5.5574080248971876e-05,0.00019991559119482882,0.8421052631578947
3555,7038,멜로디/Noun,19,15,4,0.00018895187284650438,6.663853039827628e-05,0.7894736842105263
3556,7039,지게/Noun,19,15,4,0.00018895187284650438,6.663853039827628e-05,0.7894736842105263
3557,7040,오래간만/Adverb,19,15,4,0.00018895187284650438,6.663853039827628e-05,0.7894736842105263
3558,7041,맴도/Noun,19,15,4,0.00018895187284650438,6.663853039827628e-05,0.7894736842105263
3559,7042,소스/Noun,19,4,15,6.668889629876625e-05,0.0001888091694617828,0.7894736842105263
3560,7043,................/Punctuation,19,4,15,6.668889629876625e-05,0.0001888091694617828,0.7894736842105263
3561,7044,수영/Noun,19,15,4,0.00018895187284650438,6.663853039827628e-05,0.7894736842105263
3562,7045,짝짝/Noun,19,15,4,0.00018895187284650438,6.663853039827628e-05,0.7894736842105263
3563,7046,”/Foreign,19,4,15,6.668889629876625e-05,0.0001888091694617828,0.7894736842105263
3564,7047,창의/Noun,19,15,4,0.00018895187284650438,6.663853039827628e-05,0.7894736842105263
3565,7048,액션연기/Noun,19,15,4,0.00018895187284650438,6.663853039827628e-05,0.7894736842105263
3566,7049,천/Noun,19,14,5,0.00017783705679671002,7.774495213132233e-05,0.7368421052631579
3567,7050,도의/Noun,19,14,5,0.00017783705679671002,7.774495213132233e-05,0.7368421052631579
3568,7051,추모/Noun,19,14,5,0.00017783705679671002,7.774495213132233e-05,0.7368421052631579
3569,7052,육/Modifier,19,5,14,7.780371234856063e-05,0.00017770274772873674,0.7368421052631579
3570,7053,제라드/Noun,19,14,5,0.00017783705679671002,7.774495213132233e-05,0.7368421052631579
3571,7054,자도/Noun,19,5,14,7.780371234856063e-05,0.00017770274772873674,0.7368421052631579
3572,7055,덩/Noun,19,5,14,7.780371234856063e-05,0.00017770274772873674,0.7368421052631579
3573,7056,슴가/Noun,19,5,14,7.780371234856063e-05,0.00017770274772873674,0.7368421052631579
3574,7057,90%/Number,19,5,14,7.780371234856063e-05,0.00017770274772873674,0.7368421052631579
3575,7058,샹/Noun,19,5,14,7.780371234856063e-05,0.00017770274772873674,0.7368421052631579
3576,7059,쾌락/Noun,19,14,5,0.00017783705679671002,7.774495213132233e-05,0.7368421052631579
3577,7060,김고은/Noun,19,5,14,7.780371234856063e-05,0.00017770274772873674,0.7368421052631579
3578,7061,흑백영화/Noun,19,14,5,0.00017783705679671002,7.774495213132233e-05,0.7368421052631579
3579,7062,퓨전/Noun,19,5,14,7.780371234856063e-05,0.00017770274772873674,0.7368421052631579
3580,7063,박진희/Noun,19,14,5,0.00017783705679671002,7.774495213132233e-05,0.7368421052631579
3581,7064,한판/Noun,19,5,14,7.780371234856063e-05,0.00017770274772873674,0.7368421052631579
3582,7065,새기다/Verb,19,14,5,0.00017783705679671002,7.774495213132233e-05,0.7368421052631579
3583,7066,난생처음/Noun,19,5,14,7.780371234856063e-05,0.00017770274772873674,0.7368421052631579
3584,7067,금성무/Noun,19,14,5,0.00017783705679671002,7.774495213132233e-05,0.7368421052631579
3585,7068,세련/Noun,19,14,5,0.00017783705679671002,7.774495213132233e-05,0.7368421052631579
3586,7069,재활용/Noun,19,5,14,7.780371234856063e-05,0.00017770274772873674,0.7368421052631579
3587,7070,진호/Noun,19,5,14,7.780371234856063e-05,0.00017770274772873674,0.7368421052631579
3588,7071,스승/Noun,19,14,5,0.00017783705679671002,7.774495213132233e-05,0.7368421052631579
3589,7072,~./Punctuation,19,14,5,0.00017783705679671002,7.774495213132233e-05,0.7368421052631579
3590,7073,인질/Noun,19,5,14,7.780371234856063e-05,0.00017770274772873674,0.7368421052631579
3591,7074,별것/Noun,19,5,14,7.780371234856063e-05,0.00017770274772873674,0.7368421052631579
3592,7075,휼륭하다/Adjective,19,14,5,0.00017783705679671002,7.774495213132233e-05,0.7368421052631579
3593,7076,민간인/Noun,19,5,14,7.780371234856063e-05,0.00017770274772873674,0.7368421052631579
3594,7077,샤말란/Noun,19,5,14,7.780371234856063e-05,0.00017770274772873674,0.7368421052631579
3595,7078,다분하다/Adjective,19,5,14,7.780371234856063e-05,0.00017770274772873674,0.7368421052631579
3596,7079,Z/Alpha,19,5,14,7.780371234856063e-05,0.00017770274772873674,0.7368421052631579
3597,7080,바가지/Noun,19,6,13,8.891852839835501e-05,0.0001665963259956907,0.6842105263157895
3598,7081,이처럼/Noun,19,13,6,0.00016672224074691566,8.885137386436837e-05,0.6842105263157895
3599,7082,가필드/Noun,19,13,6,0.00016672224074691566,8.885137386436837e-05,0.6842105263157895
3600,7083,for/Alpha,19,13,6,0.00016672224074691566,8.885137386436837e-05,0.6842105263157895
3601,7084,사고방식/Noun,19,6,13,8.891852839835501e-05,0.0001665963259956907,0.6842105263157895
3602,7085,허락/Noun,19,6,13,8.891852839835501e-05,0.0001665963259956907,0.6842105263157895
3603,7086,조한선/Noun,19,6,13,8.891852839835501e-05,0.0001665963259956907,0.6842105263157895
3604,7087,톡톡/Noun,19,13,6,0.00016672224074691566,8.885137386436837e-05,0.6842105263157895
3605,7088,넨/Noun,19,13,6,0.00016672224074691566,8.885137386436837e-05,0.6842105263157895
3606,7089,포스트/Noun,19,6,13,8.891852839835501e-05,0.0001665963259956907,0.6842105263157895
3607,7090,특정/Noun,19,6,13,8.891852839835501e-05,0.0001665963259956907,0.6842105263157895
3608,7091,후보/Noun,19,6,13,8.891852839835501e-05,0.0001665963259956907,0.6842105263157895
3609,7092,애환/Noun,19,13,6,0.00016672224074691566,8.885137386436837e-05,0.6842105263157895
3610,7093,순식간/Noun,19,6,13,8.891852839835501e-05,0.0001665963259956907,0.6842105263157895
3611,7094,싸인/Noun,19,13,6,0.00016672224074691566,8.885137386436837e-05,0.6842105263157895
3612,7095,영역/Noun,19,13,6,0.00016672224074691566,8.885137386436837e-05,0.6842105263157895
3613,7096,구로/Noun,19,13,6,0.00016672224074691566,8.885137386436837e-05,0.6842105263157895
3614,7097,생방송/Noun,19,6,13,8.891852839835501e-05,0.0001665963259956907,0.6842105263157895
3615,7098,며느리/Noun,19,6,13,8.891852839835501e-05,0.0001665963259956907,0.6842105263157895
3616,7099,업그레이드/Noun,19,13,6,0.00016672224074691566,8.885137386436837e-05,0.6842105263157895
3617,7100,곽지민/Noun,19,6,13,8.891852839835501e-05,0.0001665963259956907,0.6842105263157895
3618,7101,영리하다/Adjective,19,13,6,0.00016672224074691566,8.885137386436837e-05,0.6842105263157895
3619,7102,킹콩/Noun,19,6,13,8.891852839835501e-05,0.0001665963259956907,0.6842105263157895
3620,7103,해치다/Verb,19,6,13,8.891852839835501e-05,0.0001665963259956907,0.6842105263157895
3621,7104,별그대/Noun,19,13,6,0.00016672224074691566,8.885137386436837e-05,0.6842105263157895
3622,7105,스페셜/Noun,19,6,13,8.891852839835501e-05,0.0001665963259956907,0.6842105263157895
3623,7106,자꾸만/Noun,19,13,6,0.00016672224074691566,8.885137386436837e-05,0.6842105263157895
3624,7200,늦추다/Verb,18,18,0,0.0002222963209958875,2.2212843466092093e-05,1.0
3625,7201,다려지다/Verb,18,18,0,0.0002222963209958875,2.2212843466092093e-05,1.0
3626,7202,보고또보고/Noun,18,18,0,0.0002222963209958875,2.2212843466092093e-05,1.0
3627,7203,김준호/Noun,18,0,18,2.2229632099588756e-05,0.00022212843466092096,1.0
3628,7204,오광록/Noun,18,0,18,2.2229632099588756e-05,0.00022212843466092096,1.0
3629,7205,놨/Noun,18,0,18,2.2229632099588756e-05,0.00022212843466092096,1.0
3630,7206,굿잡/Noun,18,17,1,0.00021118150494609317,3.331926519913814e-05,0.9444444444444444
3631,7207,여비/Noun,18,1,17,3.334444814938313e-05,0.0002110220129278749,0.9444444444444444
3632,7208,여균동/Noun,18,1,17,3.334444814938313e-05,0.0002110220129278749,0.9444444444444444
3633,7209,혈압/Noun,18,1,17,3.334444814938313e-05,0.0002110220129278749,0.9444444444444444
3634,7210,평온하다/Adjective,18,17,1,0.00021118150494609317,3.331926519913814e-05,0.9444444444444444
3635,7211,불법체류자/Noun,18,1,17,3.334444814938313e-05,0.0002110220129278749,0.9444444444444444
3636,7212,출품/Noun,18,1,17,3.334444814938313e-05,0.0002110220129278749,0.9444444444444444
3637,7213,발가락/Noun,18,1,17,3.334444814938313e-05,0.0002110220129278749,0.9444444444444444
3638,7214,좀해/Noun,18,2,16,4.445926419917751e-05,0.00019991559119482882,0.8888888888888888
3639,7215,성해/Noun,18,2,16,4.445926419917751e-05,0.00019991559119482882,0.8888888888888888
3640,7216,충돌/Noun,18,16,2,0.0002000666888962988,4.4425686932184186e-05,0.8888888888888888
3641,7217,+_+/Punctuation,18,16,2,0.0002000666888962988,4.4425686932184186e-05,0.8888888888888888
3642,7218,신랄하다/Adjective,18,16,2,0.0002000666888962988,4.4425686932184186e-05,0.8888888888888888
3643,7219,졸귀/Noun,18,16,2,0.0002000666888962988,4.4425686932184186e-05,0.8888888888888888
3644,7220,만만하다/Adjective,18,2,16,4.445926419917751e-05,0.00019991559119482882,0.8888888888888888
3645,7221,엘렌/Noun,18,16,2,0.0002000666888962988,4.4425686932184186e-05,0.8888888888888888
3646,7222,테잎/Noun,18,16,2,0.0002000666888962988,4.4425686932184186e-05,0.8888888888888888
3647,7223,가차/Noun,18,2,16,4.445926419917751e-05,0.00019991559119482882,0.8888888888888888
3648,7224,테이프/Noun,18,16,2,0.0002000666888962988,4.4425686932184186e-05,0.8888888888888888
3649,7225,갈팡질팡/Noun,18,2,16,4.445926419917751e-05,0.00019991559119482882,0.8888888888888888
3650,7226,신발/Noun,18,2,16,4.445926419917751e-05,0.00019991559119482882,0.8888888888888888
3651,7227,용인/Noun,18,2,16,4.445926419917751e-05,0.00019991559119482882,0.8888888888888888
3652,7228,....;;/Punctuation,18,2,16,4.445926419917751e-05,0.00019991559119482882,0.8888888888888888
3653,7229,불과/Noun,18,2,16,4.445926419917751e-05,0.00019991559119482882,0.8888888888888888
3654,7230,전설의고향/Noun,18,2,16,4.445926419917751e-05,0.00019991559119482882,0.8888888888888888
3655,7231,혁신/Noun,18,16,2,0.0002000666888962988,4.4425686932184186e-05,0.8888888888888888
3656,7232,444/Number,18,2,16,4.445926419917751e-05,0.00019991559119482882,0.8888888888888888
3657,7233,비로소/Noun,18,16,2,0.0002000666888962988,4.4425686932184186e-05,0.8888888888888888
3658,7234,윗/Modifier,18,3,15,5.5574080248971876e-05,0.0001888091694617828,0.8333333333333334
3659,7235,장비/Noun,18,3,15,5.5574080248971876e-05,0.0001888091694617828,0.8333333333333334
3660,7236,니콜슨/Noun,18,15,3,0.00018895187284650438,5.553210866523024e-05,0.8333333333333334
3661,7237,부풀리다/Verb,18,3,15,5.5574080248971876e-05,0.0001888091694617828,0.8333333333333334
3662,7238,5~6/Number,18,3,15,5.5574080248971876e-05,0.0001888091694617828,0.8333333333333334
3663,7239,산뜻하다/Adjective,18,15,3,0.00018895187284650438,5.553210866523024e-05,0.8333333333333334
3664,7240,칙칙하다/Adjective,18,3,15,5.5574080248971876e-05,0.0001888091694617828,0.8333333333333334
3665,7241,더군다나/Noun,18,3,15,5.5574080248971876e-05,0.0001888091694617828,0.8333333333333334
3666,7242,교통사고/Noun,18,3,15,5.5574080248971876e-05,0.0001888091694617828,0.8333333333333334
3667,7243,레기/Noun,18,3,15,5.5574080248971876e-05,0.0001888091694617828,0.8333333333333334
3668,7244,통제/Noun,18,14,4,0.00017783705679671002,6.663853039827628e-05,0.7777777777777778
3669,7245,기능/Noun,18,4,14,6.668889629876625e-05,0.00017770274772873674,0.7777777777777778
3670,7246,주걸륜/Noun,18,4,14,6.668889629876625e-05,0.00017770274772873674,0.7777777777777778
3671,7247,천지/Noun,18,4,14,6.668889629876625e-05,0.00017770274772873674,0.7777777777777778
3672,7248,매기/Noun,18,4,14,6.668889629876625e-05,0.00017770274772873674,0.7777777777777778
3673,7249,폭동/Noun,18,4,14,6.668889629876625e-05,0.00017770274772873674,0.7777777777777778
3674,7250,엇갈리다/Verb,18,14,4,0.00017783705679671002,6.663853039827628e-05,0.7777777777777778
3675,7251,김소연/Noun,18,14,4,0.00017783705679671002,6.663853039827628e-05,0.7777777777777778
3676,7252,17년/Number,18,14,4,0.00017783705679671002,6.663853039827628e-05,0.7777777777777778
3677,7253,권장/Noun,18,4,14,6.668889629876625e-05,0.00017770274772873674,0.7777777777777778
3678,7254,나무라다/Verb,18,14,4,0.00017783705679671002,6.663853039827628e-05,0.7777777777777778
3679,7255,SBS/Alpha,18,4,14,6.668889629876625e-05,0.00017770274772873674,0.7777777777777778
3680,7256,전화하다/Adjective,18,4,14,6.668889629876625e-05,0.00017770274772873674,0.7777777777777778
3681,7257,김동욱/Noun,18,14,4,0.00017783705679671002,6.663853039827628e-05,0.7777777777777778
3682,7258,무관심/Noun,18,14,4,0.00017783705679671002,6.663853039827628e-05,0.7777777777777778
3683,7259,사운드트랙/Noun,18,14,4,0.00017783705679671002,6.663853039827628e-05,0.7777777777777778
3684,7260,황우슬혜/Noun,18,4,14,6.668889629876625e-05,0.00017770274772873674,0.7777777777777778
3685,7261,무한도전/Noun,18,4,14,6.668889629876625e-05,0.00017770274772873674,0.7777777777777778
3686,7262,리얼리즘/Noun,18,14,4,0.00017783705679671002,6.663853039827628e-05,0.7777777777777778
3687,7263,천정명/Noun,18,4,14,6.668889629876625e-05,0.00017770274772873674,0.7777777777777778
3688,7264,상한/Noun,18,5,13,7.780371234856063e-05,0.0001665963259956907,0.7222222222222222
3689,7265,식겁하다/Adjective,18,5,13,7.780371234856063e-05,0.0001665963259956907,0.7222222222222222
3690,7266,해품달/Noun,18,13,5,0.00016672224074691566,7.774495213132233e-05,0.7222222222222222
3691,7267,쥬/Noun,18,13,5,0.00016672224074691566,7.774495213132233e-05,0.7222222222222222
3692,7268,....!/Punctuation,18,13,5,0.00016672224074691566,7.774495213132233e-05,0.7222222222222222
3693,7269,능청/Noun,18,13,5,0.00016672224074691566,7.774495213132233e-05,0.7222222222222222
3694,7270,자화상/Noun,18,13,5,0.00016672224074691566,7.774495213132233e-05,0.7222222222222222
3695,7271,화살/Noun,18,5,13,7.780371234856063e-05,0.0001665963259956907,0.7222222222222222
3696,7272,강수연/Noun,18,5,13,7.780371234856063e-05,0.0001665963259956907,0.7222222222222222
3697,7273,국회의원/Noun,18,5,13,7.780371234856063e-05,0.0001665963259956907,0.7222222222222222
3698,7274,드라큐라/Noun,18,13,5,0.00016672224074691566,7.774495213132233e-05,0.7222222222222222
3699,7275,페넬로페/Noun,18,13,5,0.00016672224074691566,7.774495213132233e-05,0.7222222222222222
3700,7276,막말/Noun,18,5,13,7.780371234856063e-05,0.0001665963259956907,0.7222222222222222
3701,7277,누굴/Noun,18,5,13,7.780371234856063e-05,0.0001665963259956907,0.7222222222222222
3702,7278,훗날/Noun,18,13,5,0.00016672224074691566,7.774495213132233e-05,0.7222222222222222
3703,7279,풋/Noun,18,5,13,7.780371234856063e-05,0.0001665963259956907,0.7222222222222222
3704,7280,우주전쟁/Noun,18,5,13,7.780371234856063e-05,0.0001665963259956907,0.7222222222222222
3705,7281,키이라/Noun,18,13,5,0.00016672224074691566,7.774495213132233e-05,0.7222222222222222
3706,7282,곤란하다/Adjective,18,5,13,7.780371234856063e-05,0.0001665963259956907,0.7222222222222222
3707,7283,절규/Noun,18,13,5,0.00016672224074691566,7.774495213132233e-05,0.7222222222222222
3708,7284,정우/Noun,18,13,5,0.00016672224074691566,7.774495213132233e-05,0.7222222222222222
3709,7285,경향/Noun,18,5,13,7.780371234856063e-05,0.0001665963259956907,0.7222222222222222
3710,7286,가든/Noun,18,5,13,7.780371234856063e-05,0.0001665963259956907,0.7222222222222222
3711,7287,싸대기/Noun,18,5,13,7.780371234856063e-05,0.0001665963259956907,0.7222222222222222
3712,7288,복잡/Noun,18,13,5,0.00016672224074691566,7.774495213132233e-05,0.7222222222222222
3713,7289,이필/Noun,18,13,5,0.00016672224074691566,7.774495213132233e-05,0.7222222222222222
3714,7290,공자/Noun,18,13,5,0.00016672224074691566,7.774495213132233e-05,0.7222222222222222
3715,7291,치매/Noun,18,5,13,7.780371234856063e-05,0.0001665963259956907,0.7222222222222222
3716,7292,친근하다/Adjective,18,13,5,0.00016672224074691566,7.774495213132233e-05,0.7222222222222222
3717,7293,정교하다/Adjective,18,13,5,0.00016672224074691566,7.774495213132233e-05,0.7222222222222222
3718,7294,고서/Noun,18,5,13,7.780371234856063e-05,0.0001665963259956907,0.7222222222222222
3719,7295,주저/Noun,18,13,5,0.00016672224074691566,7.774495213132233e-05,0.7222222222222222
3720,7296,.;;/Punctuation,18,5,13,7.780371234856063e-05,0.0001665963259956907,0.7222222222222222
3721,7297,열차/Noun,18,5,13,7.780371234856063e-05,0.0001665963259956907,0.7222222222222222
3722,7298,이득/Noun,18,5,13,7.780371234856063e-05,0.0001665963259956907,0.7222222222222222
3723,7299,라네/Josa,18,6,12,8.891852839835501e-05,0.00015548990426264466,0.6666666666666666
3724,7300,내부/Noun,18,12,6,0.00015560742469712126,8.885137386436837e-05,0.6666666666666666
3725,7301,천원/Noun,18,6,12,8.891852839835501e-05,0.00015548990426264466,0.6666666666666666
3726,7302,악령/Noun,18,6,12,8.891852839835501e-05,0.00015548990426264466,0.6666666666666666
3727,7303,가오/Noun,18,6,12,8.891852839835501e-05,0.00015548990426264466,0.6666666666666666
3728,7304,투모로우/Noun,18,6,12,8.891852839835501e-05,0.00015548990426264466,0.6666666666666666
3729,7305,딱지/Noun,18,6,12,8.891852839835501e-05,0.00015548990426264466,0.6666666666666666
3730,7306,짤/Noun,18,6,12,8.891852839835501e-05,0.00015548990426264466,0.6666666666666666
3731,7307,강의/Noun,18,12,6,0.00015560742469712126,8.885137386436837e-05,0.6666666666666666
3732,7308,대우/Noun,18,12,6,0.00015560742469712126,8.885137386436837e-05,0.6666666666666666
3733,7309,고마/Noun,18,6,12,8.891852839835501e-05,0.00015548990426264466,0.6666666666666666
3734,7310,종편/Noun,18,12,6,0.00015560742469712126,8.885137386436837e-05,0.6666666666666666
3735,7311,미지근하다/Adjective,18,6,12,8.891852839835501e-05,0.00015548990426264466,0.6666666666666666
3736,7312,자부/Noun,18,12,6,0.00015560742469712126,8.885137386436837e-05,0.6666666666666666
3737,7313,세뇌/Noun,18,6,12,8.891852839835501e-05,0.00015548990426264466,0.6666666666666666
3738,7314,정사씬/Noun,18,6,12,8.891852839835501e-05,0.00015548990426264466,0.6666666666666666
3739,7315,오만/Noun,18,6,12,8.891852839835501e-05,0.00015548990426264466,0.6666666666666666
3740,7316,더더/Noun,18,12,6,0.00015560742469712126,8.885137386436837e-05,0.6666666666666666
3741,7317,김사랑/Noun,18,6,12,8.891852839835501e-05,0.00015548990426264466,0.6666666666666666
3742,7318,가져가다/Verb,18,6,12,8.891852839835501e-05,0.00015548990426264466,0.6666666666666666
3743,7319,140/Number,18,12,6,0.00015560742469712126,8.885137386436837e-05,0.6666666666666666
3744,7320,베니/Noun,18,12,6,0.00015560742469712126,8.885137386436837e-05,0.6666666666666666
3745,7321,"~""/Punctuation",18,12,6,0.00015560742469712126,8.885137386436837e-05,0.6666666666666666
3746,7322,추격자/Noun,18,6,12,8.891852839835501e-05,0.00015548990426264466,0.6666666666666666
3747,7323,건데/Noun,18,6,12,8.891852839835501e-05,0.00015548990426264466,0.6666666666666666
3748,7324,주니어/Noun,18,12,6,0.00015560742469712126,8.885137386436837e-05,0.6666666666666666
3749,7325,날수/Noun,18,12,6,0.00015560742469712126,8.885137386436837e-05,0.6666666666666666
3750,7326,핀처/Noun,18,12,6,0.00015560742469712126,8.885137386436837e-05,0.6666666666666666
3751,7327,김대중/Noun,18,6,12,8.891852839835501e-05,0.00015548990426264466,0.6666666666666666
3752,7328,삽질/Noun,18,6,12,8.891852839835501e-05,0.00015548990426264466,0.6666666666666666
3753,7329,위험/Noun,18,6,12,8.891852839835501e-05,0.00015548990426264466,0.6666666666666666
3754,7330,기해/Noun,18,6,12,8.891852839835501e-05,0.00015548990426264466,0.6666666666666666
3755,7331,정당하다/Adjective,18,6,12,8.891852839835501e-05,0.00015548990426264466,0.6666666666666666
3756,7332,정준/Noun,18,12,6,0.00015560742469712126,8.885137386436837e-05,0.6666666666666666
3757,7333,심각/Noun,18,12,6,0.00015560742469712126,8.885137386436837e-05,0.6666666666666666
3758,7452,패륜/Noun,17,0,17,2.2229632099588756e-05,0.0002110220129278749,1.0
3759,7453,김대희/Noun,17,0,17,2.2229632099588756e-05,0.0002110220129278749,1.0
3760,7454,이러니까/Conjunction,17,0,17,2.2229632099588756e-05,0.0002110220129278749,1.0
3761,7455,*^^*/Punctuation,17,17,0,0.00021118150494609317,2.2212843466092093e-05,1.0
3762,7456,숙면/Noun,17,0,17,2.2229632099588756e-05,0.0002110220129278749,1.0
3763,7457,클레이/Noun,17,17,0,0.00021118150494609317,2.2212843466092093e-05,1.0
3764,7458,조음/Noun,17,17,0,0.00021118150494609317,2.2212843466092093e-05,1.0
3765,7459,8~10/Number,17,0,17,2.2229632099588756e-05,0.0002110220129278749,1.0
3766,7460,0.1/Number,17,1,16,3.334444814938313e-05,0.00019991559119482882,0.9411764705882352
3767,7461,하락/Noun,17,1,16,3.334444814938313e-05,0.00019991559119482882,0.9411764705882352
3768,7462,죄송/Noun,17,1,16,3.334444814938313e-05,0.00019991559119482882,0.9411764705882352
3769,7463,ㅡㅡㅡ/KoreanParticle,17,1,16,3.334444814938313e-05,0.00019991559119482882,0.9411764705882352
3770,7464,임성한/Noun,17,1,16,3.334444814938313e-05,0.00019991559119482882,0.9411764705882352
3771,7465,데려오다/Verb,17,1,16,3.334444814938313e-05,0.00019991559119482882,0.9411764705882352
3772,7466,눈시울/Noun,17,16,1,0.0002000666888962988,3.331926519913814e-05,0.9411764705882352
3773,7467,끓이다/Verb,17,1,16,3.334444814938313e-05,0.00019991559119482882,0.9411764705882352
3774,7468,원주고/Noun,17,1,16,3.334444814938313e-05,0.00019991559119482882,0.9411764705882352
3775,7469,고리타분하다/Adjective,17,2,15,4.445926419917751e-05,0.0001888091694617828,0.8823529411764706
3776,7470,훈녀/Noun,17,15,2,0.00018895187284650438,4.4425686932184186e-05,0.8823529411764706
3777,7471,궁합/Noun,17,15,2,0.00018895187284650438,4.4425686932184186e-05,0.8823529411764706
3778,7472,작자/Noun,17,2,15,4.445926419917751e-05,0.0001888091694617828,0.8823529411764706
3779,7473,암만/Noun,17,2,15,4.445926419917751e-05,0.0001888091694617828,0.8823529411764706
3780,7474,폐/Noun,17,2,15,4.445926419917751e-05,0.0001888091694617828,0.8823529411764706
3781,7475,신음/Noun,17,2,15,4.445926419917751e-05,0.0001888091694617828,0.8823529411764706
3782,7476,랄프/Noun,17,15,2,0.00018895187284650438,4.4425686932184186e-05,0.8823529411764706
3783,7477,쨋/Noun,17,15,2,0.00018895187284650438,4.4425686932184186e-05,0.8823529411764706
3784,7478,로더/Noun,17,2,15,4.445926419917751e-05,0.0001888091694617828,0.8823529411764706
3785,7479,bbb/Alpha,17,15,2,0.00018895187284650438,4.4425686932184186e-05,0.8823529411764706
3786,7480,야망/Noun,17,15,2,0.00018895187284650438,4.4425686932184186e-05,0.8823529411764706
3787,7481,파란만장하다/Adjective,17,15,2,0.00018895187284650438,4.4425686932184186e-05,0.8823529411764706
3788,7482,or/Alpha,17,2,15,4.445926419917751e-05,0.0001888091694617828,0.8823529411764706
3789,7483,서른/Noun,17,15,2,0.00018895187284650438,4.4425686932184186e-05,0.8823529411764706
3790,7484,앞세우다/Verb,17,2,15,4.445926419917751e-05,0.0001888091694617828,0.8823529411764706
3791,7485,심플/Noun,17,14,3,0.00017783705679671002,5.553210866523024e-05,0.8235294117647058
3792,7486,단면/Noun,17,14,3,0.00017783705679671002,5.553210866523024e-05,0.8235294117647058
3793,7487,사지/Noun,17,3,14,5.5574080248971876e-05,0.00017770274772873674,0.8235294117647058
3794,7488,딘/Noun,17,14,3,0.00017783705679671002,5.553210866523024e-05,0.8235294117647058
3795,7489,심보/Noun,17,3,14,5.5574080248971876e-05,0.00017770274772873674,0.8235294117647058
3796,7490,악어/Noun,17,3,14,5.5574080248971876e-05,0.00017770274772873674,0.8235294117647058
3797,7491,거저/Noun,17,3,14,5.5574080248971876e-05,0.00017770274772873674,0.8235294117647058
3798,7492,상위/Noun,17,14,3,0.00017783705679671002,5.553210866523024e-05,0.8235294117647058
3799,7493,생생/Noun,17,14,3,0.00017783705679671002,5.553210866523024e-05,0.8235294117647058
3800,7494,앤드류/Noun,17,14,3,0.00017783705679671002,5.553210866523024e-05,0.8235294117647058
3801,7495,폐인/Noun,17,14,3,0.00017783705679671002,5.553210866523024e-05,0.8235294117647058
3802,7496,ok/Alpha,17,3,14,5.5574080248971876e-05,0.00017770274772873674,0.8235294117647058
3803,7497,시리/Noun,17,14,3,0.00017783705679671002,5.553210866523024e-05,0.8235294117647058
3804,7498,제멋대로/Noun,17,3,14,5.5574080248971876e-05,0.00017770274772873674,0.8235294117647058
3805,7499,서비스/Noun,17,3,14,5.5574080248971876e-05,0.00017770274772873674,0.8235294117647058
3806,7500,쏠리다/Verb,17,3,14,5.5574080248971876e-05,0.00017770274772873674,0.8235294117647058
3807,7501,꽥꽥/Adverb,17,3,14,5.5574080248971876e-05,0.00017770274772873674,0.8235294117647058
3808,7502,빙빙/Noun,17,3,14,5.5574080248971876e-05,0.00017770274772873674,0.8235294117647058
3809,7503,뮤/Noun,17,14,3,0.00017783705679671002,5.553210866523024e-05,0.8235294117647058
3810,7504,쑤시다/Verb,17,3,14,5.5574080248971876e-05,0.00017770274772873674,0.8235294117647058
3811,7505,저희/Modifier,17,14,3,0.00017783705679671002,5.553210866523024e-05,0.8235294117647058
3812,7506,일색/Noun,17,3,14,5.5574080248971876e-05,0.00017770274772873674,0.8235294117647058
3813,7507,진진/Noun,17,14,3,0.00017783705679671002,5.553210866523024e-05,0.8235294117647058
3814,7508,배급/Noun,17,3,14,5.5574080248971876e-05,0.00017770274772873674,0.8235294117647058
3815,7509,운지/Noun,17,3,14,5.5574080248971876e-05,0.00017770274772873674,0.8235294117647058
3816,7510,토크/Noun,17,4,13,6.668889629876625e-05,0.0001665963259956907,0.7647058823529411
3817,7511,교/Noun,17,4,13,6.668889629876625e-05,0.0001665963259956907,0.7647058823529411
3818,7512,커트/Noun,17,13,4,0.00016672224074691566,6.663853039827628e-05,0.7647058823529411
3819,7513,우상/Noun,17,13,4,0.00016672224074691566,6.663853039827628e-05,0.7647058823529411
3820,7514,웠/Noun,17,13,4,0.00016672224074691566,6.663853039827628e-05,0.7647058823529411
3821,7515,미생/Noun,17,13,4,0.00016672224074691566,6.663853039827628e-05,0.7647058823529411
3822,7516,1998년/Number,17,13,4,0.00016672224074691566,6.663853039827628e-05,0.7647058823529411
3823,7517,내사/Noun,17,13,4,0.00016672224074691566,6.663853039827628e-05,0.7647058823529411
3824,7518,토시/Noun,17,4,13,6.668889629876625e-05,0.0001665963259956907,0.7647058823529411
3825,7519,아비/Noun,17,4,13,6.668889629876625e-05,0.0001665963259956907,0.7647058823529411
3826,7520,웨스/Noun,17,13,4,0.00016672224074691566,6.663853039827628e-05,0.7647058823529411
3827,7521,붙이/Noun,17,4,13,6.668889629876625e-05,0.0001665963259956907,0.7647058823529411
3828,7522,넘사벽/Noun,17,13,4,0.00016672224074691566,6.663853039827628e-05,0.7647058823529411
3829,7523,--;;/Punctuation,17,4,13,6.668889629876625e-05,0.0001665963259956907,0.7647058823529411
3830,7524,맘마미아/Noun,17,4,13,6.668889629876625e-05,0.0001665963259956907,0.7647058823529411
3831,7525,처지다/Verb,17,4,13,6.668889629876625e-05,0.0001665963259956907,0.7647058823529411
3832,7526,쉰/Noun,17,13,4,0.00016672224074691566,6.663853039827628e-05,0.7647058823529411
3833,7527,뽑히다/Verb,17,4,13,6.668889629876625e-05,0.0001665963259956907,0.7647058823529411
3834,7528,거려/Noun,17,4,13,6.668889629876625e-05,0.0001665963259956907,0.7647058823529411
3835,7529,..~/Punctuation,17,13,4,0.00016672224074691566,6.663853039827628e-05,0.7647058823529411
3836,7530,기립박수/Noun,17,13,4,0.00016672224074691566,6.663853039827628e-05,0.7647058823529411
3837,7531,래서/Noun,17,4,13,6.668889629876625e-05,0.0001665963259956907,0.7647058823529411
3838,7532,만능/Noun,17,13,4,0.00016672224074691566,6.663853039827628e-05,0.7647058823529411
3839,7533,마당/Noun,17,4,13,6.668889629876625e-05,0.0001665963259956907,0.7647058823529411
3840,7534,시궁창/Noun,17,4,13,6.668889629876625e-05,0.0001665963259956907,0.7647058823529411
3841,7535,발랄/Noun,17,13,4,0.00016672224074691566,6.663853039827628e-05,0.7647058823529411
3842,7536,항/Noun,17,4,13,6.668889629876625e-05,0.0001665963259956907,0.7647058823529411
3843,7537,시원찮다/Adjective,17,4,13,6.668889629876625e-05,0.0001665963259956907,0.7647058823529411
3844,7538,릴/Noun,17,5,12,7.780371234856063e-05,0.00015548990426264466,0.7058823529411765
3845,7539,연쇄/Noun,17,5,12,7.780371234856063e-05,0.00015548990426264466,0.7058823529411765
3846,7540,회수/Noun,17,5,12,7.780371234856063e-05,0.00015548990426264466,0.7058823529411765
3847,7541,소금/Noun,17,5,12,7.780371234856063e-05,0.00015548990426264466,0.7058823529411765
3848,7542,아가씨/Noun,17,5,12,7.780371234856063e-05,0.00015548990426264466,0.7058823529411765
3849,7543,머임/Noun,17,5,12,7.780371234856063e-05,0.00015548990426264466,0.7058823529411765
3850,7544,위엄/Noun,17,5,12,7.780371234856063e-05,0.00015548990426264466,0.7058823529411765
3851,7545,스탭/Noun,17,12,5,0.00015560742469712126,7.774495213132233e-05,0.7058823529411765
3852,7546,다행하다/Adjective,17,12,5,0.00015560742469712126,7.774495213132233e-05,0.7058823529411765
3853,7547,비위/Noun,17,5,12,7.780371234856063e-05,0.00015548990426264466,0.7058823529411765
3854,7548,특수부대/Noun,17,5,12,7.780371234856063e-05,0.00015548990426264466,0.7058823529411765
3855,7549,신영화/Noun,17,5,12,7.780371234856063e-05,0.00015548990426264466,0.7058823529411765
3856,7550,더럽히다/Verb,17,5,12,7.780371234856063e-05,0.00015548990426264466,0.7058823529411765
3857,7551,은밀/Noun,17,5,12,7.780371234856063e-05,0.00015548990426264466,0.7058823529411765
3858,7552,요한/Noun,17,12,5,0.00015560742469712126,7.774495213132233e-05,0.7058823529411765
3859,7553,p/Alpha,17,5,12,7.780371234856063e-05,0.00015548990426264466,0.7058823529411765
3860,7554,어쩌다가/Noun,17,5,12,7.780371234856063e-05,0.00015548990426264466,0.7058823529411765
3861,7555,아버/Noun,17,5,12,7.780371234856063e-05,0.00015548990426264466,0.7058823529411765
3862,7556,뒷모습/Noun,17,12,5,0.00015560742469712126,7.774495213132233e-05,0.7058823529411765
3863,7557,우습다/Adjective,17,5,12,7.780371234856063e-05,0.00015548990426264466,0.7058823529411765
3864,7558,................../Punctuation,17,5,12,7.780371234856063e-05,0.00015548990426264466,0.7058823529411765
3865,7559,당첨/Noun,17,5,12,7.780371234856063e-05,0.00015548990426264466,0.7058823529411765
3866,7560,물어/Noun,17,5,12,7.780371234856063e-05,0.00015548990426264466,0.7058823529411765
3867,7561,9.5/Number,17,12,5,0.00015560742469712126,7.774495213132233e-05,0.7058823529411765
3868,7562,종결/Noun,17,5,12,7.780371234856063e-05,0.00015548990426264466,0.7058823529411765
3869,7563,드럼/Noun,17,12,5,0.00015560742469712126,7.774495213132233e-05,0.7058823529411765
3870,7564,영화제작/Noun,17,5,12,7.780371234856063e-05,0.00015548990426264466,0.7058823529411765
3871,7565,입술/Noun,17,5,12,7.780371234856063e-05,0.00015548990426264466,0.7058823529411765
3872,7566,졋/Noun,17,5,12,7.780371234856063e-05,0.00015548990426264466,0.7058823529411765
3873,7567,맴/Noun,17,12,5,0.00015560742469712126,7.774495213132233e-05,0.7058823529411765
3874,7568,아부/Noun,17,5,12,7.780371234856063e-05,0.00015548990426264466,0.7058823529411765
3875,7569,전기영/Noun,17,12,5,0.00015560742469712126,7.774495213132233e-05,0.7058823529411765
3876,7570,윤제문/Noun,17,12,5,0.00015560742469712126,7.774495213132233e-05,0.7058823529411765
3877,7571,라가/Noun,17,5,12,7.780371234856063e-05,0.00015548990426264466,0.7058823529411765
3878,7572,해바라기/Noun,17,5,12,7.780371234856063e-05,0.00015548990426264466,0.7058823529411765
3879,7573,이보영/Noun,17,12,5,0.00015560742469712126,7.774495213132233e-05,0.7058823529411765
3880,7574,클로즈업/Noun,17,5,12,7.780371234856063e-05,0.00015548990426264466,0.7058823529411765
3881,7700,ㅁㅈㅎ/KoreanParticle,16,0,16,2.2229632099588756e-05,0.00019991559119482882,1.0
3882,7701,이뭐병/Noun,16,0,16,2.2229632099588756e-05,0.00019991559119482882,1.0
3883,7702,코끝/Noun,16,16,0,0.0002000666888962988,2.2212843466092093e-05,1.0
3884,7703,루고/Noun,16,0,16,2.2229632099588756e-05,0.00019991559119482882,1.0
3885,7704,감격/Noun,16,16,0,0.0002000666888962988,2.2212843466092093e-05,1.0
3886,7705,bbbb/Alpha,16,16,0,0.0002000666888962988,2.2212843466092093e-05,1.0
3887,7706,박하/Noun,16,16,0,0.0002000666888962988,2.2212843466092093e-05,1.0
3888,7707,좆망/Noun,16,1,15,3.334444814938313e-05,0.0001888091694617828,0.9375
3889,7708,찰스/Noun,16,15,1,0.00018895187284650438,3.331926519913814e-05,0.9375
3890,7709,상술/Noun,16,1,15,3.334444814938313e-05,0.0001888091694617828,0.9375
3891,7710,넘침/Noun,16,15,1,0.00018895187284650438,3.331926519913814e-05,0.9375
3892,7711,공군/Noun,16,1,15,3.334444814938313e-05,0.0001888091694617828,0.9375
3893,7712,모도/Noun,16,15,1,0.00018895187284650438,3.331926519913814e-05,0.9375
3894,7713,짱깨/Noun,16,1,15,3.334444814938313e-05,0.0001888091694617828,0.9375
3895,7714,씌우다/Verb,16,1,15,3.334444814938313e-05,0.0001888091694617828,0.9375
3896,7715,am/Alpha,16,15,1,0.00018895187284650438,3.331926519913814e-05,0.9375
3897,7716,빙자/Noun,16,1,15,3.334444814938313e-05,0.0001888091694617828,0.9375
3898,7717,윤재/Noun,16,1,15,3.334444814938313e-05,0.0001888091694617828,0.9375
3899,7718,얼렁뚱땅/Noun,16,1,15,3.334444814938313e-05,0.0001888091694617828,0.9375
3900,7719,하비에르/Noun,16,15,1,0.00018895187284650438,3.331926519913814e-05,0.9375
3901,7720,표지/Noun,16,2,14,4.445926419917751e-05,0.00017770274772873674,0.875
3902,7721,부추기다/Verb,16,2,14,4.445926419917751e-05,0.00017770274772873674,0.875
3903,7722,전과/Noun,16,14,2,0.00017783705679671002,4.4425686932184186e-05,0.875
3904,7723,우수/Noun,16,14,2,0.00017783705679671002,4.4425686932184186e-05,0.875
3905,7724,샤크/Noun,16,2,14,4.445926419917751e-05,0.00017770274772873674,0.875
3906,7725,과소/Noun,16,14,2,0.00017783705679671002,4.4425686932184186e-05,0.875
3907,7726,신중하다/Adjective,16,2,14,4.445926419917751e-05,0.00017770274772873674,0.875
3908,7727,유부/Noun,16,2,14,4.445926419917751e-05,0.00017770274772873674,0.875
3909,7728,돌아이/Noun,16,2,14,4.445926419917751e-05,0.00017770274772873674,0.875
3910,7729,!!!!!!!!!!/Punctuation,16,14,2,0.00017783705679671002,4.4425686932184186e-05,0.875
3911,7730,프렌즈/Noun,16,14,2,0.00017783705679671002,4.4425686932184186e-05,0.875
3912,7731,사죄/Noun,16,2,14,4.445926419917751e-05,0.00017770274772873674,0.875
3913,7732,어렴풋이/Adverb,16,14,2,0.00017783705679671002,4.4425686932184186e-05,0.875
3914,7733,막연하다/Adjective,16,14,2,0.00017783705679671002,4.4425686932184186e-05,0.875
3915,7734,값지다/Adjective,16,14,2,0.00017783705679671002,4.4425686932184186e-05,0.875
3916,7735,수박/Noun,16,2,14,4.445926419917751e-05,0.00017770274772873674,0.875
3917,7736,찌꺼기/Noun,16,2,14,4.445926419917751e-05,0.00017770274772873674,0.875
3918,7737,사먹다/Verb,16,2,14,4.445926419917751e-05,0.00017770274772873674,0.875
3919,7738,벗/Noun,16,2,14,4.445926419917751e-05,0.00017770274772873674,0.875
3920,7739,타겟/Noun,16,2,14,4.445926419917751e-05,0.00017770274772873674,0.875
3921,7740,직설/Noun,16,14,2,0.00017783705679671002,4.4425686932184186e-05,0.875
3922,7741,볼품/Noun,16,2,14,4.445926419917751e-05,0.00017770274772873674,0.875
3923,7742,sm/Alpha,16,2,14,4.445926419917751e-05,0.00017770274772873674,0.875
3924,7743,쓰시/Noun,16,3,13,5.5574080248971876e-05,0.0001665963259956907,0.8125
3925,7744,야마카시/Noun,16,3,13,5.5574080248971876e-05,0.0001665963259956907,0.8125
3926,7745,훈훈/Noun,16,13,3,0.00016672224074691566,5.553210866523024e-05,0.8125
3927,7746,지리하다/Adjective,16,3,13,5.5574080248971876e-05,0.0001665963259956907,0.8125
3928,7747,김아중/Noun,16,13,3,0.00016672224074691566,5.553210866523024e-05,0.8125
3929,7748,연성/Noun,16,3,13,5.5574080248971876e-05,0.0001665963259956907,0.8125
3930,7749,여학생/Noun,16,3,13,5.5574080248971876e-05,0.0001665963259956907,0.8125
3931,7750,찔끔/Adverb,16,13,3,0.00016672224074691566,5.553210866523024e-05,0.8125
3932,7751,개무시/Noun,16,3,13,5.5574080248971876e-05,0.0001665963259956907,0.8125
3933,7752,하트넷/Noun,16,13,3,0.00016672224074691566,5.553210866523024e-05,0.8125
3934,7753,;;;;;;/Punctuation,16,3,13,5.5574080248971876e-05,0.0001665963259956907,0.8125
3935,7754,입사/Noun,16,3,13,5.5574080248971876e-05,0.0001665963259956907,0.8125
3936,7755,지혜/Noun,16,13,3,0.00016672224074691566,5.553210866523024e-05,0.8125
3937,7756,살의/Noun,16,13,3,0.00016672224074691566,5.553210866523024e-05,0.8125
3938,7757,리나/Noun,16,3,13,5.5574080248971876e-05,0.0001665963259956907,0.8125
3939,7758,황정음/Noun,16,13,3,0.00016672224074691566,5.553210866523024e-05,0.8125
3940,7759,강정/Noun,16,3,13,5.5574080248971876e-05,0.0001665963259956907,0.8125
3941,7760,방화/Noun,16,3,13,5.5574080248971876e-05,0.0001665963259956907,0.8125
3942,7761,색기/Noun,16,3,13,5.5574080248971876e-05,0.0001665963259956907,0.8125
3943,7762,현기증/Noun,16,13,3,0.00016672224074691566,5.553210866523024e-05,0.8125
3944,7763,갈피/Noun,16,3,13,5.5574080248971876e-05,0.0001665963259956907,0.8125
3945,7764,차려/Noun,16,3,13,5.5574080248971876e-05,0.0001665963259956907,0.8125
3946,7765,이시영/Noun,16,13,3,0.00016672224074691566,5.553210866523024e-05,0.8125
3947,7766,퇴/Noun,16,3,13,5.5574080248971876e-05,0.0001665963259956907,0.8125
3948,7767,불허/Noun,16,13,3,0.00016672224074691566,5.553210866523024e-05,0.8125
3949,7768,배틀로얄/Noun,16,3,13,5.5574080248971876e-05,0.0001665963259956907,0.8125
3950,7769,국민학교/Noun,16,13,3,0.00016672224074691566,5.553210866523024e-05,0.8125
3951,7770,무당/Noun,16,3,13,5.5574080248971876e-05,0.0001665963259956907,0.8125
3952,7771,유동근/Noun,16,13,3,0.00016672224074691566,5.553210866523024e-05,0.8125
3953,7772,매염방/Noun,16,12,4,0.00015560742469712126,6.663853039827628e-05,0.75
3954,7773,꼬박꼬박/Noun,16,12,4,0.00015560742469712126,6.663853039827628e-05,0.75
3955,7774,넘버원/Noun,16,12,4,0.00015560742469712126,6.663853039827628e-05,0.75
3956,7775,쥑/Noun,16,12,4,0.00015560742469712126,6.663853039827628e-05,0.75
3957,7776,사무엘/Noun,16,12,4,0.00015560742469712126,6.663853039827628e-05,0.75
3958,7777,be/Alpha,16,12,4,0.00015560742469712126,6.663853039827628e-05,0.75
3959,7778,자폐/Noun,16,4,12,6.668889629876625e-05,0.00015548990426264466,0.75
3960,7779,빠돌이/Noun,16,4,12,6.668889629876625e-05,0.00015548990426264466,0.75
3961,7780,세기말/Noun,16,12,4,0.00015560742469712126,6.663853039827628e-05,0.75
3962,7781,김지운/Noun,16,12,4,0.00015560742469712126,6.663853039827628e-05,0.75
3963,7782,럼/Noun,16,4,12,6.668889629876625e-05,0.00015548990426264466,0.75
3964,7783,_-/Punctuation,16,4,12,6.668889629876625e-05,0.00015548990426264466,0.75
3965,7784,화구/Noun,16,4,12,6.668889629876625e-05,0.00015548990426264466,0.75
3966,7785,가물가물/Adverb,16,12,4,0.00015560742469712126,6.663853039827628e-05,0.75
3967,7786,1995년/Number,16,12,4,0.00015560742469712126,6.663853039827628e-05,0.75
3968,7787,-_-;;;/Punctuation,16,4,12,6.668889629876625e-05,0.00015548990426264466,0.75
3969,7788,한채영/Noun,16,4,12,6.668889629876625e-05,0.00015548990426264466,0.75
3970,7789,연속극/Noun,16,4,12,6.668889629876625e-05,0.00015548990426264466,0.75
3971,7790,뜻밖/Noun,16,12,4,0.00015560742469712126,6.663853039827628e-05,0.75
3972,7791,손녀/Noun,16,4,12,6.668889629876625e-05,0.00015548990426264466,0.75
3973,7792,상품/Noun,16,4,12,6.668889629876625e-05,0.00015548990426264466,0.75
3974,7793,장엄하다/Adjective,16,12,4,0.00015560742469712126,6.663853039827628e-05,0.75
3975,7794,꼽으라/Noun,16,12,4,0.00015560742469712126,6.663853039827628e-05,0.75
3976,7795,앙상블/Noun,16,12,4,0.00015560742469712126,6.663853039827628e-05,0.75
3977,7796,피닉스/Noun,16,12,4,0.00015560742469712126,6.663853039827628e-05,0.75
3978,7797,건축/Noun,16,12,4,0.00015560742469712126,6.663853039827628e-05,0.75
3979,7798,알콩달콩/Noun,16,12,4,0.00015560742469712126,6.663853039827628e-05,0.75
3980,7799,개쩜/Noun,16,12,4,0.00015560742469712126,6.663853039827628e-05,0.75
3981,7800,두기/Noun,16,12,4,0.00015560742469712126,6.663853039827628e-05,0.75
3982,7801,...??/Punctuation,16,4,12,6.668889629876625e-05,0.00015548990426264466,0.75
3983,7802,시내/Noun,16,4,12,6.668889629876625e-05,0.00015548990426264466,0.75
3984,7803,김상경/Noun,16,12,4,0.00015560742469712126,6.663853039827628e-05,0.75
3985,7804,우기/Noun,16,4,12,6.668889629876625e-05,0.00015548990426264466,0.75
3986,7805,숙제/Noun,16,12,4,0.00015560742469712126,6.663853039827628e-05,0.75
3987,7806,"...""/Punctuation",16,4,12,6.668889629876625e-05,0.00015548990426264466,0.75
3988,7807,설계/Noun,16,4,12,6.668889629876625e-05,0.00015548990426264466,0.75
3989,7808,베댓/Noun,16,4,12,6.668889629876625e-05,0.00015548990426264466,0.75
3990,7809,불편/Noun,16,4,12,6.668889629876625e-05,0.00015548990426264466,0.75
3991,7810,코메/Noun,16,4,12,6.668889629876625e-05,0.00015548990426264466,0.75
3992,7811,바리/Noun,16,4,12,6.668889629876625e-05,0.00015548990426264466,0.75
3993,7812,파커/Noun,16,12,4,0.00015560742469712126,6.663853039827628e-05,0.75
3994,7813,십분/Noun,16,4,12,6.668889629876625e-05,0.00015548990426264466,0.75
3995,7814,바둑/Noun,16,4,12,6.668889629876625e-05,0.00015548990426264466,0.75
3996,7815,제압/Noun,16,4,12,6.668889629876625e-05,0.00015548990426264466,0.75
3997,7816,집어치우다/Verb,16,4,12,6.668889629876625e-05,0.00015548990426264466,0.75
3998,7817,치의/Noun,16,12,4,0.00015560742469712126,6.663853039827628e-05,0.75
3999,7818,간혹/Noun,16,5,11,7.780371234856063e-05,0.0001443834825295986,0.6875
4000,7819,힘차다/Adjective,16,5,11,7.780371234856063e-05,0.0001443834825295986,0.6875
4001,7820,맥과이어/Noun,16,11,5,0.0001444926086473269,7.774495213132233e-05,0.6875
4002,7821,쉐프/Noun,16,5,11,7.780371234856063e-05,0.0001443834825295986,0.6875
4003,7822,민영화/Noun,16,11,5,0.0001444926086473269,7.774495213132233e-05,0.6875
4004,7823,외설/Noun,16,5,11,7.780371234856063e-05,0.0001443834825295986,0.6875
4005,7824,도서관/Noun,16,11,5,0.0001444926086473269,7.774495213132233e-05,0.6875
4006,7825,나마/Noun,16,11,5,0.0001444926086473269,7.774495213132233e-05,0.6875
4007,7826,후딱/Adverb,16,11,5,0.0001444926086473269,7.774495213132233e-05,0.6875
4008,7827,도둑질/Noun,16,5,11,7.780371234856063e-05,0.0001443834825295986,0.6875
4009,7828,일과/Noun,16,11,5,0.0001444926086473269,7.774495213132233e-05,0.6875
4010,7829,다다/Noun,16,5,11,7.780371234856063e-05,0.0001443834825295986,0.6875
4011,7830,혼합/Noun,16,5,11,7.780371234856063e-05,0.0001443834825295986,0.6875
4012,7831,끈끈/Noun,16,11,5,0.0001444926086473269,7.774495213132233e-05,0.6875
4013,7832,사위/Noun,16,5,11,7.780371234856063e-05,0.0001443834825295986,0.6875
4014,7833,타고나다/Verb,16,11,5,0.0001444926086473269,7.774495213132233e-05,0.6875
4015,7834,TOP/Alpha,16,11,5,0.0001444926086473269,7.774495213132233e-05,0.6875
4016,7835,괴리감/Noun,16,5,11,7.780371234856063e-05,0.0001443834825295986,0.6875
4017,7836,지로/Noun,16,5,11,7.780371234856063e-05,0.0001443834825295986,0.6875
4018,7837,확장/Noun,16,11,5,0.0001444926086473269,7.774495213132233e-05,0.6875
4019,7838,김민정/Noun,16,11,5,0.0001444926086473269,7.774495213132233e-05,0.6875
4020,7839,세포/Noun,16,11,5,0.0001444926086473269,7.774495213132233e-05,0.6875
4021,7840,시티/Noun,16,11,5,0.0001444926086473269,7.774495213132233e-05,0.6875
4022,7841,이영애/Noun,16,11,5,0.0001444926086473269,7.774495213132233e-05,0.6875
4023,7842,줄어들다/Verb,16,11,5,0.0001444926086473269,7.774495213132233e-05,0.6875
4024,7843,대회/Noun,16,5,11,7.780371234856063e-05,0.0001443834825295986,0.6875
4025,7844,똥파리/Noun,16,5,11,7.780371234856063e-05,0.0001443834825295986,0.6875
4026,7845,극우/Noun,16,5,11,7.780371234856063e-05,0.0001443834825295986,0.6875
4027,7846,곽경택/Noun,16,5,11,7.780371234856063e-05,0.0001443834825295986,0.6875
4028,7847,세로/Noun,16,5,11,7.780371234856063e-05,0.0001443834825295986,0.6875
4029,7848,수출/Noun,16,5,11,7.780371234856063e-05,0.0001443834825295986,0.6875
4030,7849,쌀/Noun,16,11,5,0.0001444926086473269,7.774495213132233e-05,0.6875
4031,7850,겜/Noun,16,11,5,0.0001444926086473269,7.774495213132233e-05,0.6875
4032,7851,고정관념/Noun,16,11,5,0.0001444926086473269,7.774495213132233e-05,0.6875
4033,7852,치도/Noun,16,11,5,0.0001444926086473269,7.774495213132233e-05,0.6875
4034,7853,민중/Noun,16,11,5,0.0001444926086473269,7.774495213132233e-05,0.6875
4035,7854,고하/Noun,16,5,11,7.780371234856063e-05,0.0001443834825295986,0.6875
4036,7855,23/Number,16,11,5,0.0001444926086473269,7.774495213132233e-05,0.6875
4037,7856,으아아/Exclamation,16,5,11,7.780371234856063e-05,0.0001443834825295986,0.6875
4038,7857,오마이갓/Noun,16,5,11,7.780371234856063e-05,0.0001443834825295986,0.6875
4039,7858,효과음/Noun,16,5,11,7.780371234856063e-05,0.0001443834825295986,0.6875
4040,7859,모조리/Noun,16,5,11,7.780371234856063e-05,0.0001443834825295986,0.6875
4041,7860,쇼생크탈출/Noun,16,11,5,0.0001444926086473269,7.774495213132233e-05,0.6875
4042,7985,다임/Noun,15,0,15,2.2229632099588756e-05,0.0001888091694617828,1.0
4043,7986,감회/Noun,15,15,0,0.00018895187284650438,2.2212843466092093e-05,1.0
4044,7987,리좀/Noun,15,0,15,2.2229632099588756e-05,0.0001888091694617828,1.0
4045,7988,이상자/Noun,15,0,15,2.2229632099588756e-05,0.0001888091694617828,1.0
4046,7989,이수정/Noun,15,0,15,2.2229632099588756e-05,0.0001888091694617828,1.0
4047,7990,어루만지다/Verb,15,15,0,0.00018895187284650438,2.2212843466092093e-05,1.0
4048,7991,보다가/Foreign,15,0,15,2.2229632099588756e-05,0.0001888091694617828,1.0
4049,7992,왕정/Noun,15,0,15,2.2229632099588756e-05,0.0001888091694617828,1.0
4050,7993,폭풍눈물/Noun,15,15,0,0.00018895187284650438,2.2212843466092093e-05,1.0
4051,7994,착오/Noun,15,0,15,2.2229632099588756e-05,0.0001888091694617828,1.0
4052,7995,밋/Noun,15,15,0,0.00018895187284650438,2.2212843466092093e-05,1.0
4053,7996,대자연/Noun,15,15,0,0.00018895187284650438,2.2212843466092093e-05,1.0
4054,7997,중국산/Noun,15,0,15,2.2229632099588756e-05,0.0001888091694617828,1.0
4055,7998,잼슴/Noun,15,14,1,0.00017783705679671002,3.331926519913814e-05,0.9333333333333332
4056,7999,설마설마/Adverb,15,1,14,3.334444814938313e-05,0.00017770274772873674,0.9333333333333332
4057,8000,핫세/Noun,15,14,1,0.00017783705679671002,3.331926519913814e-05,0.9333333333333332
4058,8001,넣기/Noun,15,1,14,3.334444814938313e-05,0.00017770274772873674,0.9333333333333332
4059,8002,음미/Noun,15,14,1,0.00017783705679671002,3.331926519913814e-05,0.9333333333333332
4060,8003,boring/Alpha,15,1,14,3.334444814938313e-05,0.00017770274772873674,0.9333333333333332
4061,8004,아포칼립토/Noun,15,1,14,3.334444814938313e-05,0.00017770274772873674,0.9333333333333332
4062,8005,잘봣어/Noun,15,14,1,0.00017783705679671002,3.331926519913814e-05,0.9333333333333332
4063,8006,신소율/Noun,15,1,14,3.334444814938313e-05,0.00017770274772873674,0.9333333333333332
4064,8007,더티/Noun,15,1,14,3.334444814938313e-05,0.00017770274772873674,0.9333333333333332
4065,8008,무능력하다/Adjective,15,1,14,3.334444814938313e-05,0.00017770274772873674,0.9333333333333332
4066,8009,대소/Noun,15,14,1,0.00017783705679671002,3.331926519913814e-05,0.9333333333333332
4067,8010,성관계/Noun,15,1,14,3.334444814938313e-05,0.00017770274772873674,0.9333333333333332
4068,8011,핥다/Verb,15,1,14,3.334444814938313e-05,0.00017770274772873674,0.9333333333333332
4069,8012,보듬다/Verb,15,14,1,0.00017783705679671002,3.331926519913814e-05,0.9333333333333332
4070,8013,Best/Alpha,15,14,1,0.00017783705679671002,3.331926519913814e-05,0.9333333333333332
4071,8014,반했어/Noun,15,14,1,0.00017783705679671002,3.331926519913814e-05,0.9333333333333332
4072,8015,호모/Noun,15,1,14,3.334444814938313e-05,0.00017770274772873674,0.9333333333333332
4073,8016,로치/Noun,15,14,1,0.00017783705679671002,3.331926519913814e-05,0.9333333333333332
4074,8017,아른거리다/Verb,15,14,1,0.00017783705679671002,3.331926519913814e-05,0.9333333333333332
4075,8018,리슨/Noun,15,13,2,0.00016672224074691566,4.4425686932184186e-05,0.8666666666666667
4076,8019,참되다/Adjective,15,13,2,0.00016672224074691566,4.4425686932184186e-05,0.8666666666666667
4077,8020,아청법/Noun,15,2,13,4.445926419917751e-05,0.0001665963259956907,0.8666666666666667
4078,8021,편승/Noun,15,2,13,4.445926419917751e-05,0.0001665963259956907,0.8666666666666667
4079,8022,도현/Noun,15,2,13,4.445926419917751e-05,0.0001665963259956907,0.8666666666666667
4080,8023,버겁다/Adjective,15,2,13,4.445926419917751e-05,0.0001665963259956907,0.8666666666666667
4081,8024,잡다하다/Adjective,15,2,13,4.445926419917751e-05,0.0001665963259956907,0.8666666666666667
4082,8025,귀여니/Noun,15,2,13,4.445926419917751e-05,0.0001665963259956907,0.8666666666666667
4083,8026,오지랖/Noun,15,2,13,4.445926419917751e-05,0.0001665963259956907,0.8666666666666667
4084,8027,노년/Noun,15,13,2,0.00016672224074691566,4.4425686932184186e-05,0.8666666666666667
4085,8028,헬/Noun,15,2,13,4.445926419917751e-05,0.0001665963259956907,0.8666666666666667
4086,8029,조사/Noun,15,2,13,4.445926419917751e-05,0.0001665963259956907,0.8666666666666667
4087,8030,나니아/Noun,15,13,2,0.00016672224074691566,4.4425686932184186e-05,0.8666666666666667
4088,8031,위력/Noun,15,13,2,0.00016672224074691566,4.4425686932184186e-05,0.8666666666666667
4089,8032,우어/Noun,15,13,2,0.00016672224074691566,4.4425686932184186e-05,0.8666666666666667
4090,8033,쒯/Noun,15,2,13,4.445926419917751e-05,0.0001665963259956907,0.8666666666666667
4091,8034,투영/Noun,15,13,2,0.00016672224074691566,4.4425686932184186e-05,0.8666666666666667
4092,8035,임상수/Noun,15,2,13,4.445926419917751e-05,0.0001665963259956907,0.8666666666666667
4093,8036,워스트/Noun,15,2,13,4.445926419917751e-05,0.0001665963259956907,0.8666666666666667
4094,8037,히로/Noun,15,13,2,0.00016672224074691566,4.4425686932184186e-05,0.8666666666666667
4095,8038,박아/Noun,15,2,13,4.445926419917751e-05,0.0001665963259956907,0.8666666666666667
4096,8039,도신/Noun,15,2,13,4.445926419917751e-05,0.0001665963259956907,0.8666666666666667
4097,8040,사족/Noun,15,2,13,4.445926419917751e-05,0.0001665963259956907,0.8666666666666667
4098,8041,챔피언/Noun,15,13,2,0.00016672224074691566,4.4425686932184186e-05,0.8666666666666667
4099,8042,무차별/Noun,15,2,13,4.445926419917751e-05,0.0001665963259956907,0.8666666666666667
4100,8043,;;;;;/Punctuation,15,2,13,4.445926419917751e-05,0.0001665963259956907,0.8666666666666667
4101,8044,발매/Noun,15,13,2,0.00016672224074691566,4.4425686932184186e-05,0.8666666666666667
4102,8045,독수리/Noun,15,2,13,4.445926419917751e-05,0.0001665963259956907,0.8666666666666667
4103,8046,무관/Noun,15,2,13,4.445926419917751e-05,0.0001665963259956907,0.8666666666666667
4104,8047,연예계/Noun,15,2,13,4.445926419917751e-05,0.0001665963259956907,0.8666666666666667
4105,8048,소망/Noun,15,13,2,0.00016672224074691566,4.4425686932184186e-05,0.8666666666666667
4106,8049,차예련/Noun,15,2,13,4.445926419917751e-05,0.0001665963259956907,0.8666666666666667
4107,8050,안무/Noun,15,2,13,4.445926419917751e-05,0.0001665963259956907,0.8666666666666667
4108,8051,장학우/Noun,15,12,3,0.00015560742469712126,5.553210866523024e-05,0.8
4109,8052,분만/Noun,15,3,12,5.5574080248971876e-05,0.00015548990426264466,0.8
4110,8053,누드/Noun,15,3,12,5.5574080248971876e-05,0.00015548990426264466,0.8
4111,8054,다지/Noun,15,3,12,5.5574080248971876e-05,0.00015548990426264466,0.8
4112,8055,자칭/Noun,15,3,12,5.5574080248971876e-05,0.00015548990426264466,0.8
4113,8056,R/Alpha,15,12,3,0.00015560742469712126,5.553210866523024e-05,0.8
4114,8057,능력자/Noun,15,3,12,5.5574080248971876e-05,0.00015548990426264466,0.8
4115,8058,꿀잼임/Noun,15,12,3,0.00015560742469712126,5.553210866523024e-05,0.8
4116,8059,잠기다/Verb,15,12,3,0.00015560742469712126,5.553210866523024e-05,0.8
4117,8060,인양/Noun,15,3,12,5.5574080248971876e-05,0.00015548990426264466,0.8
4118,8061,지수/Noun,15,3,12,5.5574080248971876e-05,0.00015548990426264466,0.8
4119,8062,눈가/Noun,15,12,3,0.00015560742469712126,5.553210866523024e-05,0.8
4120,8063,카펜터/Noun,15,3,12,5.5574080248971876e-05,0.00015548990426264466,0.8
4121,8064,오버액션/Noun,15,3,12,5.5574080248971876e-05,0.00015548990426264466,0.8
4122,8065,가려진/Noun,15,12,3,0.00015560742469712126,5.553210866523024e-05,0.8
4123,8066,that/Alpha,15,12,3,0.00015560742469712126,5.553210866523024e-05,0.8
4124,8067,맴돈다/Verb,15,12,3,0.00015560742469712126,5.553210866523024e-05,0.8
4125,8068,노부/Noun,15,12,3,0.00015560742469712126,5.553210866523024e-05,0.8
4126,8069,정준하/Noun,15,3,12,5.5574080248971876e-05,0.00015548990426264466,0.8
4127,8070,사치/Noun,15,3,12,5.5574080248971876e-05,0.00015548990426264466,0.8
4128,8071,갈구다/Verb,15,12,3,0.00015560742469712126,5.553210866523024e-05,0.8
4129,8072,폭행/Noun,15,3,12,5.5574080248971876e-05,0.00015548990426264466,0.8
4130,8073,선명하다/Adjective,15,12,3,0.00015560742469712126,5.553210866523024e-05,0.8
4131,8074,황진이/Noun,15,12,3,0.00015560742469712126,5.553210866523024e-05,0.8
4132,8075,장하다/Adjective,15,3,12,5.5574080248971876e-05,0.00015548990426264466,0.8
4133,8076,티켓/Noun,15,3,12,5.5574080248971876e-05,0.00015548990426264466,0.8
4134,8077,장님/Noun,15,12,3,0.00015560742469712126,5.553210866523024e-05,0.8
4135,8078,세밀/Noun,15,12,3,0.00015560742469712126,5.553210866523024e-05,0.8
4136,8079,각본가/Noun,15,3,12,5.5574080248971876e-05,0.00015548990426264466,0.8
4137,8080,뿅/Adverb,15,12,3,0.00015560742469712126,5.553210866523024e-05,0.8
4138,8081,깊숙하다/Adjective,15,12,3,0.00015560742469712126,5.553210866523024e-05,0.8
4139,8082,버릇/Noun,15,4,11,6.668889629876625e-05,0.0001443834825295986,0.7333333333333333
4140,8083,혼신/Noun,15,11,4,0.0001444926086473269,6.663853039827628e-05,0.7333333333333333
4141,8084,토리/Noun,15,4,11,6.668889629876625e-05,0.0001443834825295986,0.7333333333333333
4142,8085,웅/Noun,15,11,4,0.0001444926086473269,6.663853039827628e-05,0.7333333333333333
4143,8086,로멘틱/Noun,15,11,4,0.0001444926086473269,6.663853039827628e-05,0.7333333333333333
4144,8087,격정/Noun,15,11,4,0.0001444926086473269,6.663853039827628e-05,0.7333333333333333
4145,8088,커다랗다/Adjective,15,11,4,0.0001444926086473269,6.663853039827628e-05,0.7333333333333333
4146,8089,불문/Noun,15,4,11,6.668889629876625e-05,0.0001443834825295986,0.7333333333333333
4147,8090,료/Noun,15,4,11,6.668889629876625e-05,0.0001443834825295986,0.7333333333333333
4148,8091,가발/Noun,15,4,11,6.668889629876625e-05,0.0001443834825295986,0.7333333333333333
4149,8092,걸어가다/Verb,15,11,4,0.0001444926086473269,6.663853039827628e-05,0.7333333333333333
4150,8093,고조/Noun,15,11,4,0.0001444926086473269,6.663853039827628e-05,0.7333333333333333
4151,8094,단언컨대/Noun,15,11,4,0.0001444926086473269,6.663853039827628e-05,0.7333333333333333
4152,8095,바람직하다/Adjective,15,11,4,0.0001444926086473269,6.663853039827628e-05,0.7333333333333333
4153,8096,꿈속/Noun,15,11,4,0.0001444926086473269,6.663853039827628e-05,0.7333333333333333
4154,8097,매달리다/Verb,15,4,11,6.668889629876625e-05,0.0001443834825295986,0.7333333333333333
4155,8098,모음/Noun,15,4,11,6.668889629876625e-05,0.0001443834825295986,0.7333333333333333
4156,8099,88년/Number,15,11,4,0.0001444926086473269,6.663853039827628e-05,0.7333333333333333
4157,8100,발끝/Noun,15,4,11,6.668889629876625e-05,0.0001443834825295986,0.7333333333333333
4158,8101,데스티네이션/Noun,15,4,11,6.668889629876625e-05,0.0001443834825295986,0.7333333333333333
4159,8102,편협/Noun,15,4,11,6.668889629876625e-05,0.0001443834825295986,0.7333333333333333
4160,8103,이하나/Noun,15,11,4,0.0001444926086473269,6.663853039827628e-05,0.7333333333333333
4161,8104,우애/Noun,15,11,4,0.0001444926086473269,6.663853039827628e-05,0.7333333333333333
4162,8105,썰전/Noun,15,4,11,6.668889629876625e-05,0.0001443834825295986,0.7333333333333333
4163,8106,비스트/Noun,15,11,4,0.0001444926086473269,6.663853039827628e-05,0.7333333333333333
4164,8107,are/Alpha,15,11,4,0.0001444926086473269,6.663853039827628e-05,0.7333333333333333
4165,8108,멘타리/Noun,15,4,11,6.668889629876625e-05,0.0001443834825295986,0.7333333333333333
4166,8109,깨달/Noun,15,11,4,0.0001444926086473269,6.663853039827628e-05,0.7333333333333333
4167,8110,쓸모없다/Adjective,15,4,11,6.668889629876625e-05,0.0001443834825295986,0.7333333333333333
4168,8111,루나/Noun,15,4,11,6.668889629876625e-05,0.0001443834825295986,0.7333333333333333
4169,8112,체감/Noun,15,11,4,0.0001444926086473269,6.663853039827628e-05,0.7333333333333333
4170,8113,생명력/Noun,15,11,4,0.0001444926086473269,6.663853039827628e-05,0.7333333333333333
4171,8114,|/Punctuation,15,4,11,6.668889629876625e-05,0.0001443834825295986,0.7333333333333333
4172,8115,켜/Noun,15,4,11,6.668889629876625e-05,0.0001443834825295986,0.7333333333333333
4173,8116,갈아/Adverb,15,4,11,6.668889629876625e-05,0.0001443834825295986,0.7333333333333333
4174,8117,뇨/Noun,15,4,11,6.668889629876625e-05,0.0001443834825295986,0.7333333333333333
4175,8118,샤이니/Noun,15,11,4,0.0001444926086473269,6.663853039827628e-05,0.7333333333333333
4176,8119,....;;;/Punctuation,15,4,11,6.668889629876625e-05,0.0001443834825295986,0.7333333333333333
4177,8120,부처/Noun,15,4,11,6.668889629876625e-05,0.0001443834825295986,0.7333333333333333
4178,8121,유전자/Noun,15,4,11,6.668889629876625e-05,0.0001443834825295986,0.7333333333333333
4179,8122,이기주의/Noun,15,4,11,6.668889629876625e-05,0.0001443834825295986,0.7333333333333333
4180,8123,를/Foreign,15,11,4,0.0001444926086473269,6.663853039827628e-05,0.7333333333333333
4181,8124,포맷/Noun,15,4,11,6.668889629876625e-05,0.0001443834825295986,0.7333333333333333
4182,8125,3시/Number,15,11,4,0.0001444926086473269,6.663853039827628e-05,0.7333333333333333
4183,8126,간결하다/Adjective,15,11,4,0.0001444926086473269,6.663853039827628e-05,0.7333333333333333
4184,8127,해체/Noun,15,4,11,6.668889629876625e-05,0.0001443834825295986,0.7333333333333333
4185,8128,모녀/Noun,15,5,10,7.780371234856063e-05,0.00013327706079655256,0.6666666666666666
4186,8129,책보/Noun,15,10,5,0.0001333777925975325,7.774495213132233e-05,0.6666666666666666
4187,8130,소림사/Noun,15,5,10,7.780371234856063e-05,0.00013327706079655256,0.6666666666666666
4188,8131,미스터빈/Noun,15,10,5,0.0001333777925975325,7.774495213132233e-05,0.6666666666666666
4189,8132,팝/Noun,15,5,10,7.780371234856063e-05,0.00013327706079655256,0.6666666666666666
4190,8133,출근/Noun,15,10,5,0.0001333777925975325,7.774495213132233e-05,0.6666666666666666
4191,8134,독특/Noun,15,10,5,0.0001333777925975325,7.774495213132233e-05,0.6666666666666666
4192,8135,스턴트맨/Noun,15,5,10,7.780371234856063e-05,0.00013327706079655256,0.6666666666666666
4193,8136,갈기/Noun,15,5,10,7.780371234856063e-05,0.00013327706079655256,0.6666666666666666
4194,8137,분야/Noun,15,5,10,7.780371234856063e-05,0.00013327706079655256,0.6666666666666666
4195,8138,아야세/Noun,15,10,5,0.0001333777925975325,7.774495213132233e-05,0.6666666666666666
4196,8139,프로도/Noun,15,5,10,7.780371234856063e-05,0.00013327706079655256,0.6666666666666666
4197,8140,타임슬립/Noun,15,5,10,7.780371234856063e-05,0.00013327706079655256,0.6666666666666666
4198,8141,은주/Noun,15,10,5,0.0001333777925975325,7.774495213132233e-05,0.6666666666666666
4199,8142,세운/Noun,15,5,10,7.780371234856063e-05,0.00013327706079655256,0.6666666666666666
4200,8143,일상생활/Noun,15,10,5,0.0001333777925975325,7.774495213132233e-05,0.6666666666666666
4201,8144,29/Number,15,5,10,7.780371234856063e-05,0.00013327706079655256,0.6666666666666666
4202,8145,박상민/Noun,15,5,10,7.780371234856063e-05,0.00013327706079655256,0.6666666666666666
4203,8146,무참/Noun,15,5,10,7.780371234856063e-05,0.00013327706079655256,0.6666666666666666
4204,8147,상류층/Noun,15,5,10,7.780371234856063e-05,0.00013327706079655256,0.6666666666666666
4205,8148,투니버스/Noun,15,5,10,7.780371234856063e-05,0.00013327706079655256,0.6666666666666666
4206,8149,심은경/Noun,15,10,5,0.0001333777925975325,7.774495213132233e-05,0.6666666666666666
4207,8150,천하다/Adjective,15,5,10,7.780371234856063e-05,0.00013327706079655256,0.6666666666666666
4208,8151,시오/Noun,15,10,5,0.0001333777925975325,7.774495213132233e-05,0.6666666666666666
4209,8152,동일/Noun,15,5,10,7.780371234856063e-05,0.00013327706079655256,0.6666666666666666
4210,8153,슬랩/Noun,15,5,10,7.780371234856063e-05,0.00013327706079655256,0.6666666666666666
4211,8154,손님/Noun,15,5,10,7.780371234856063e-05,0.00013327706079655256,0.6666666666666666
4212,8155,니야/Noun,15,5,10,7.780371234856063e-05,0.00013327706079655256,0.6666666666666666
4213,8156,설치/Noun,15,5,10,7.780371234856063e-05,0.00013327706079655256,0.6666666666666666
4214,8157,고든/Noun,15,10,5,0.0001333777925975325,7.774495213132233e-05,0.6666666666666666
4215,8158,뚫리다/Verb,15,5,10,7.780371234856063e-05,0.00013327706079655256,0.6666666666666666
4216,8159,철철/Noun,15,10,5,0.0001333777925975325,7.774495213132233e-05,0.6666666666666666
4217,8160,고리/Noun,15,10,5,0.0001333777925975325,7.774495213132233e-05,0.6666666666666666
4218,8161,93년/Number,15,10,5,0.0001333777925975325,7.774495213132233e-05,0.6666666666666666
4219,8162,잘해야/Noun,15,10,5,0.0001333777925975325,7.774495213132233e-05,0.6666666666666666
4220,8163,ㅕ/KoreanParticle,15,5,10,7.780371234856063e-05,0.00013327706079655256,0.6666666666666666
4221,8164,로랑/Noun,15,10,5,0.0001333777925975325,7.774495213132233e-05,0.6666666666666666
4222,8165,캐리비안/Noun,15,10,5,0.0001333777925975325,7.774495213132233e-05,0.6666666666666666
4223,8166,모토/Noun,15,10,5,0.0001333777925975325,7.774495213132233e-05,0.6666666666666666
4224,8167,돌파/Noun,15,10,5,0.0001333777925975325,7.774495213132233e-05,0.6666666666666666
4225,8168,거미/Noun,15,5,10,7.780371234856063e-05,0.00013327706079655256,0.6666666666666666
4226,8169,명치/Noun,15,5,10,7.780371234856063e-05,0.00013327706079655256,0.6666666666666666
4227,8170,진중하다/Adjective,15,10,5,0.0001333777925975325,7.774495213132233e-05,0.6666666666666666
4228,8171,89년/Number,15,10,5,0.0001333777925975325,7.774495213132233e-05,0.6666666666666666
4229,8172,매국노/Noun,15,5,10,7.780371234856063e-05,0.00013327706079655256,0.6666666666666666
4230,8173,컨텐츠/Noun,15,5,10,7.780371234856063e-05,0.00013327706079655256,0.6666666666666666
4231,8174,시나/Noun,15,5,10,7.780371234856063e-05,0.00013327706079655256,0.6666666666666666
4232,8175,비열하다/Adjective,15,10,5,0.0001333777925975325,7.774495213132233e-05,0.6666666666666666
4233,8176,what/Alpha,15,5,10,7.780371234856063e-05,0.00013327706079655256,0.6666666666666666
4234,8177,거두다/Verb,15,10,5,0.0001333777925975325,7.774495213132233e-05,0.6666666666666666
4235,8178,노리/Noun,15,5,10,7.780371234856063e-05,0.00013327706079655256,0.6666666666666666
4236,8296,조이다/Verb,14,14,0,0.00017783705679671002,2.2212843466092093e-05,1.0
4237,8297,밥맛/Noun,14,0,14,2.2229632099588756e-05,0.00017770274772873674,1.0
4238,8298,분신사바/Noun,14,0,14,2.2229632099588756e-05,0.00017770274772873674,1.0
4239,8299,혐/Noun,14,0,14,2.2229632099588756e-05,0.00017770274772873674,1.0
4240,8300,짱개/Noun,14,0,14,2.2229632099588756e-05,0.00017770274772873674,1.0
4241,8301,잘봣습니/Noun,14,14,0,0.00017783705679671002,2.2212843466092093e-05,1.0
4242,8302,햇살/Noun,14,14,0,0.00017783705679671002,2.2212843466092093e-05,1.0
4243,8303,영아/Noun,14,0,14,2.2229632099588756e-05,0.00017770274772873674,1.0
4244,8304,..-/Punctuation,14,0,14,2.2229632099588756e-05,0.00017770274772873674,1.0
4245,8305,졸림/Noun,14,0,14,2.2229632099588756e-05,0.00017770274772873674,1.0
4246,8306,..-_-;;/Punctuation,14,0,14,2.2229632099588756e-05,0.00017770274772873674,1.0
4247,8307,심슨/Noun,14,14,0,0.00017783705679671002,2.2212843466092093e-05,1.0
4248,8308,빠져듬/Noun,14,14,0,0.00017783705679671002,2.2212843466092093e-05,1.0
4249,8309,최선정/Noun,14,0,14,2.2229632099588756e-05,0.00017770274772873674,1.0
4250,8310,홍석천/Noun,14,0,14,2.2229632099588756e-05,0.00017770274772873674,1.0
4251,8311,어쩌자/Noun,14,0,14,2.2229632099588756e-05,0.00017770274772873674,1.0
4252,8312,성준/Noun,14,13,1,0.00016672224074691566,3.331926519913814e-05,0.9285714285714286
4253,8313,으뜸/Noun,14,13,1,0.00016672224074691566,3.331926519913814e-05,0.9285714285714286
4254,8314,독보/Noun,14,13,1,0.00016672224074691566,3.331926519913814e-05,0.9285714285714286
4255,8315,옷벗다/Verb,14,1,13,3.334444814938313e-05,0.0001665963259956907,0.9285714285714286
4256,8316,소송/Noun,14,1,13,3.334444814938313e-05,0.0001665963259956907,0.9285714285714286
4257,8317,인간관계/Noun,14,13,1,0.00016672224074691566,3.331926519913814e-05,0.9285714285714286
4258,8318,탁재훈/Noun,14,1,13,3.334444814938313e-05,0.0001665963259956907,0.9285714285714286
4259,8319,케이온/Noun,14,13,1,0.00016672224074691566,3.331926519913814e-05,0.9285714285714286
4260,8320,인간극장/Noun,14,1,13,3.334444814938313e-05,0.0001665963259956907,0.9285714285714286
4261,8321,무조/Noun,14,13,1,0.00016672224074691566,3.331926519913814e-05,0.9285714285714286
4262,8322,박예진/Noun,14,1,13,3.334444814938313e-05,0.0001665963259956907,0.9285714285714286
4263,8323,강츄/Noun,14,13,1,0.00016672224074691566,3.331926519913814e-05,0.9285714285714286
4264,8324,표방/Noun,14,1,13,3.334444814938313e-05,0.0001665963259956907,0.9285714285714286
4265,8325,더스틴/Noun,14,13,1,0.00016672224074691566,3.331926519913814e-05,0.9285714285714286
4266,8326,현저/Noun,14,1,13,3.334444814938313e-05,0.0001665963259956907,0.9285714285714286
4267,8327,주몽/Noun,14,13,1,0.00016672224074691566,3.331926519913814e-05,0.9285714285714286
4268,8328,강인하다/Adjective,14,13,1,0.00016672224074691566,3.331926519913814e-05,0.9285714285714286
4269,8329,호프만/Noun,14,13,1,0.00016672224074691566,3.331926519913814e-05,0.9285714285714286
4270,8330,불명/Noun,14,1,13,3.334444814938313e-05,0.0001665963259956907,0.9285714285714286
4271,8331,16년/Number,14,13,1,0.00016672224074691566,3.331926519913814e-05,0.9285714285714286
4272,8332,민주/Noun,14,1,13,3.334444814938313e-05,0.0001665963259956907,0.9285714285714286
4273,8333,산만/Noun,14,1,13,3.334444814938313e-05,0.0001665963259956907,0.9285714285714286
4274,8334,모시다/Verb,14,1,13,3.334444814938313e-05,0.0001665963259956907,0.9285714285714286
4275,8335,노민우/Noun,14,13,1,0.00016672224074691566,3.331926519913814e-05,0.9285714285714286
4276,8336,삽입곡/Noun,14,13,1,0.00016672224074691566,3.331926519913814e-05,0.9285714285714286
4277,8337,외전/Noun,14,1,13,3.334444814938313e-05,0.0001665963259956907,0.9285714285714286
4278,8338,반말/Noun,14,1,13,3.334444814938313e-05,0.0001665963259956907,0.9285714285714286
4279,8339,유사라/Noun,14,1,13,3.334444814938313e-05,0.0001665963259956907,0.9285714285714286
4280,8340,능욕/Noun,14,1,13,3.334444814938313e-05,0.0001665963259956907,0.9285714285714286
4281,8341,마담/Noun,14,2,12,4.445926419917751e-05,0.00015548990426264466,0.8571428571428571
4282,8342,주입/Noun,14,2,12,4.445926419917751e-05,0.00015548990426264466,0.8571428571428571
4283,8343,탄도/Noun,14,12,2,0.00015560742469712126,4.4425686932184186e-05,0.8571428571428571
4284,8344,오로라공주/Noun,14,2,12,4.445926419917751e-05,0.00015548990426264466,0.8571428571428571
4285,8345,소란/Noun,14,2,12,4.445926419917751e-05,0.00015548990426264466,0.8571428571428571
4286,8346,무렵/Noun,14,12,2,0.00015560742469712126,4.4425686932184186e-05,0.8571428571428571
4287,8347,연말/Noun,14,12,2,0.00015560742469712126,4.4425686932184186e-05,0.8571428571428571
4288,8348,주룩주룩/Noun,14,12,2,0.00015560742469712126,4.4425686932184186e-05,0.8571428571428571
4289,8349,폴리스스토리/Noun,14,12,2,0.00015560742469712126,4.4425686932184186e-05,0.8571428571428571
4290,8350,8천원/Number,14,2,12,4.445926419917751e-05,0.00015548990426264466,0.8571428571428571
4291,8351,스탭들/Noun,14,2,12,4.445926419917751e-05,0.00015548990426264466,0.8571428571428571
4292,8352,로다주/Noun,14,12,2,0.00015560742469712126,4.4425686932184186e-05,0.8571428571428571
4293,8353,힛걸/Noun,14,12,2,0.00015560742469712126,4.4425686932184186e-05,0.8571428571428571
4294,8354,늙은이/Noun,14,2,12,4.445926419917751e-05,0.00015548990426264466,0.8571428571428571
4295,8355,작작하다/Adjective,14,2,12,4.445926419917751e-05,0.00015548990426264466,0.8571428571428571
4296,8356,끼어들다/Verb,14,2,12,4.445926419917751e-05,0.00015548990426264466,0.8571428571428571
4297,8357,화이자/Noun,14,12,2,0.00015560742469712126,4.4425686932184186e-05,0.8571428571428571
4298,8358,로군/Josa,14,2,12,4.445926419917751e-05,0.00015548990426264466,0.8571428571428571
4299,8359,포트/Noun,14,12,2,0.00015560742469712126,4.4425686932184186e-05,0.8571428571428571
4300,8360,엑소시즘/Noun,14,2,12,4.445926419917751e-05,0.00015548990426264466,0.8571428571428571
4301,8361,감탄사/Noun,14,12,2,0.00015560742469712126,4.4425686932184186e-05,0.8571428571428571
4302,8362,노출하다/Adjective,14,2,12,4.445926419917751e-05,0.00015548990426264466,0.8571428571428571
4303,8363,왜봄/Noun,14,2,12,4.445926419917751e-05,0.00015548990426264466,0.8571428571428571
4304,8364,ㅗㅗ/KoreanParticle,14,2,12,4.445926419917751e-05,0.00015548990426264466,0.8571428571428571
4305,8365,겨냥/Noun,14,2,12,4.445926419917751e-05,0.00015548990426264466,0.8571428571428571
4306,8366,내리막/Noun,14,2,12,4.445926419917751e-05,0.00015548990426264466,0.8571428571428571
4307,8367,따먹다/Verb,14,2,12,4.445926419917751e-05,0.00015548990426264466,0.8571428571428571
4308,8368,뻘/Noun,14,2,12,4.445926419917751e-05,0.00015548990426264466,0.8571428571428571
4309,8369,메우다/Verb,14,2,12,4.445926419917751e-05,0.00015548990426264466,0.8571428571428571
4310,8370,부제/Noun,14,2,12,4.445926419917751e-05,0.00015548990426264466,0.8571428571428571
4311,8371,휘두르다/Verb,14,2,12,4.445926419917751e-05,0.00015548990426264466,0.8571428571428571
4312,8372,일어서다/Verb,14,12,2,0.00015560742469712126,4.4425686932184186e-05,0.8571428571428571
4313,8373,핵꿀잼/Noun,14,12,2,0.00015560742469712126,4.4425686932184186e-05,0.8571428571428571
4314,8374,회한/Noun,14,12,2,0.00015560742469712126,4.4425686932184186e-05,0.8571428571428571
4315,8375,벌이/Noun,14,2,12,4.445926419917751e-05,0.00015548990426264466,0.8571428571428571
4316,8376,치장/Noun,14,2,12,4.445926419917751e-05,0.00015548990426264466,0.8571428571428571
4317,8377,야호/Noun,14,12,2,0.00015560742469712126,4.4425686932184186e-05,0.8571428571428571
4318,8378,우왕좌왕/Noun,14,2,12,4.445926419917751e-05,0.00015548990426264466,0.8571428571428571
4319,8379,교체/Noun,14,2,12,4.445926419917751e-05,0.00015548990426264466,0.8571428571428571
4320,8380,지도자/Noun,14,12,2,0.00015560742469712126,4.4425686932184186e-05,0.8571428571428571
4321,8381,서늘하다/Adjective,14,12,2,0.00015560742469712126,4.4425686932184186e-05,0.8571428571428571
4322,8382,막심/Noun,14,3,11,5.5574080248971876e-05,0.0001443834825295986,0.7857142857142857
4323,8383,붐/Noun,14,3,11,5.5574080248971876e-05,0.0001443834825295986,0.7857142857142857
4324,8384,오늘이/Noun,14,11,3,0.0001444926086473269,5.553210866523024e-05,0.7857142857142857
4325,8385,복장/Noun,14,3,11,5.5574080248971876e-05,0.0001443834825295986,0.7857142857142857
4326,8386,>.</Punctuation,14,11,3,0.0001444926086473269,5.553210866523024e-05,0.7857142857142857
4327,8387,상기/Noun,14,11,3,0.0001444926086473269,5.553210866523024e-05,0.7857142857142857
4328,8388,조형기/Noun,14,3,11,5.5574080248971876e-05,0.0001443834825295986,0.7857142857142857
4329,8389,불량/Noun,14,3,11,5.5574080248971876e-05,0.0001443834825295986,0.7857142857142857
4330,8390,가만있다/Verb,14,3,11,5.5574080248971876e-05,0.0001443834825295986,0.7857142857142857
4331,8391,수목/Noun,14,11,3,0.0001444926086473269,5.553210866523024e-05,0.7857142857142857
4332,8392,번개/Noun,14,11,3,0.0001444926086473269,5.553210866523024e-05,0.7857142857142857
4333,8393,미술관/Noun,14,11,3,0.0001444926086473269,5.553210866523024e-05,0.7857142857142857
4334,8394,정려원/Noun,14,11,3,0.0001444926086473269,5.553210866523024e-05,0.7857142857142857
4335,8395,오마주/Noun,14,3,11,5.5574080248971876e-05,0.0001443834825295986,0.7857142857142857
4336,8396,뽀뽀/Noun,14,3,11,5.5574080248971876e-05,0.0001443834825295986,0.7857142857142857
4337,8397,닷/Modifier,14,11,3,0.0001444926086473269,5.553210866523024e-05,0.7857142857142857
4338,8398,느릿느릿/Noun,14,3,11,5.5574080248971876e-05,0.0001443834825295986,0.7857142857142857
4339,8399,오즈/Noun,14,11,3,0.0001444926086473269,5.553210866523024e-05,0.7857142857142857
4340,8400,푼/Noun,14,3,11,5.5574080248971876e-05,0.0001443834825295986,0.7857142857142857
4341,8401,지니/Noun,14,11,3,0.0001444926086473269,5.553210866523024e-05,0.7857142857142857
4342,8402,개밥/Noun,14,3,11,5.5574080248971876e-05,0.0001443834825295986,0.7857142857142857
4343,8403,이색/Noun,14,11,3,0.0001444926086473269,5.553210866523024e-05,0.7857142857142857
4344,8404,오리엔탈리즘/Noun,14,3,11,5.5574080248971876e-05,0.0001443834825295986,0.7857142857142857
4345,8405,젬/Noun,14,11,3,0.0001444926086473269,5.553210866523024e-05,0.7857142857142857
4346,8406,브라보/Noun,14,11,3,0.0001444926086473269,5.553210866523024e-05,0.7857142857142857
4347,8407,작작/Noun,14,3,11,5.5574080248971876e-05,0.0001443834825295986,0.7857142857142857
4348,8408,이듬/Noun,14,3,11,5.5574080248971876e-05,0.0001443834825295986,0.7857142857142857
4349,8409,지긋지긋하다/Adjective,14,3,11,5.5574080248971876e-05,0.0001443834825295986,0.7857142857142857
4350,8410,시초/Noun,14,11,3,0.0001444926086473269,5.553210866523024e-05,0.7857142857142857
4351,8411,청순/Noun,14,11,3,0.0001444926086473269,5.553210866523024e-05,0.7857142857142857
4352,8412,.................../Punctuation,14,3,11,5.5574080248971876e-05,0.0001443834825295986,0.7857142857142857
4353,8413,맹/Noun,14,3,11,5.5574080248971876e-05,0.0001443834825295986,0.7857142857142857
4354,8414,비상/Noun,14,3,11,5.5574080248971876e-05,0.0001443834825295986,0.7857142857142857
4355,8415,리버/Noun,14,11,3,0.0001444926086473269,5.553210866523024e-05,0.7857142857142857
4356,8416,불평/Noun,14,11,3,0.0001444926086473269,5.553210866523024e-05,0.7857142857142857
4357,8417,머레이/Noun,14,11,3,0.0001444926086473269,5.553210866523024e-05,0.7857142857142857
4358,8418,주름/Noun,14,3,11,5.5574080248971876e-05,0.0001443834825295986,0.7857142857142857
4359,8419,대머리/Noun,14,3,11,5.5574080248971876e-05,0.0001443834825295986,0.7857142857142857
4360,8420,저조하다/Adjective,14,11,3,0.0001444926086473269,5.553210866523024e-05,0.7857142857142857
4361,8421,노숙자/Noun,14,3,11,5.5574080248971876e-05,0.0001443834825295986,0.7857142857142857
4362,8422,점차/Noun,14,11,3,0.0001444926086473269,5.553210866523024e-05,0.7857142857142857
4363,8423,적용/Noun,14,3,11,5.5574080248971876e-05,0.0001443834825295986,0.7857142857142857
4364,8424,몽골/Noun,14,3,11,5.5574080248971876e-05,0.0001443834825295986,0.7857142857142857
4365,8425,난장판/Noun,14,3,11,5.5574080248971876e-05,0.0001443834825295986,0.7857142857142857
4366,8426,시인/Noun,14,11,3,0.0001444926086473269,5.553210866523024e-05,0.7857142857142857
4367,8427,몰락하다/Adjective,14,3,11,5.5574080248971876e-05,0.0001443834825295986,0.7857142857142857
4368,8428,할인/Noun,14,3,11,5.5574080248971876e-05,0.0001443834825295986,0.7857142857142857
4369,8429,결승전/Noun,14,3,11,5.5574080248971876e-05,0.0001443834825295986,0.7857142857142857
4370,8430,헬렌/Noun,14,11,3,0.0001444926086473269,5.553210866523024e-05,0.7857142857142857
4371,8431,밨/Noun,14,11,3,0.0001444926086473269,5.553210866523024e-05,0.7857142857142857
4372,8432,무례하다/Adjective,14,3,11,5.5574080248971876e-05,0.0001443834825295986,0.7857142857142857
4373,8433,호호/Noun,14,11,3,0.0001444926086473269,5.553210866523024e-05,0.7857142857142857
4374,8434,연쇄살인/Noun,14,3,11,5.5574080248971876e-05,0.0001443834825295986,0.7857142857142857
4375,8435,찌라시/Noun,14,3,11,5.5574080248971876e-05,0.0001443834825295986,0.7857142857142857
4376,8436,~~!!!!/Punctuation,14,11,3,0.0001444926086473269,5.553210866523024e-05,0.7857142857142857
4377,8437,갈증/Noun,14,10,4,0.0001333777925975325,6.663853039827628e-05,0.7142857142857143
4378,8438,무식/Noun,14,4,10,6.668889629876625e-05,0.00013327706079655256,0.7142857142857143
4379,8439,역경/Noun,14,10,4,0.0001333777925975325,6.663853039827628e-05,0.7142857142857143
4380,8440,태권브이/Noun,14,4,10,6.668889629876625e-05,0.00013327706079655256,0.7142857142857143
4381,8441,발달/Noun,14,10,4,0.0001333777925975325,6.663853039827628e-05,0.7142857142857143
4382,8442,센세이션/Noun,14,10,4,0.0001333777925975325,6.663853039827628e-05,0.7142857142857143
4383,8443,개입/Noun,14,4,10,6.668889629876625e-05,0.00013327706079655256,0.7142857142857143
4384,8444,의무/Noun,14,10,4,0.0001333777925975325,6.663853039827628e-05,0.7142857142857143
4385,8445,퍽/Noun,14,4,10,6.668889629876625e-05,0.00013327706079655256,0.7142857142857143
4386,8446,줄기/Noun,14,10,4,0.0001333777925975325,6.663853039827628e-05,0.7142857142857143
4387,8447,다섯/Modifier,14,10,4,0.0001333777925975325,6.663853039827628e-05,0.7142857142857143
4388,8448,애니스톤/Noun,14,4,10,6.668889629876625e-05,0.00013327706079655256,0.7142857142857143
4389,8449,?!!/Punctuation,14,4,10,6.668889629876625e-05,0.00013327706079655256,0.7142857142857143
4390,8450,김재원/Noun,14,10,4,0.0001333777925975325,6.663853039827628e-05,0.7142857142857143
4391,8451,조미료/Noun,14,4,10,6.668889629876625e-05,0.00013327706079655256,0.7142857142857143
4392,8452,수상한/Noun,14,10,4,0.0001333777925975325,6.663853039827628e-05,0.7142857142857143
4393,8453,흠/Exclamation,14,4,10,6.668889629876625e-05,0.00013327706079655256,0.7142857142857143
4394,8454,타의/Noun,14,10,4,0.0001333777925975325,6.663853039827628e-05,0.7142857142857143
4395,8455,이만/Modifier,14,10,4,0.0001333777925975325,6.663853039827628e-05,0.7142857142857143
4396,8456,리듬/Noun,14,10,4,0.0001333777925975325,6.663853039827628e-05,0.7142857142857143
4397,8457,르노/Noun,14,4,10,6.668889629876625e-05,0.00013327706079655256,0.7142857142857143
4398,8458,정규/Noun,14,10,4,0.0001333777925975325,6.663853039827628e-05,0.7142857142857143
4399,8459,레디/Noun,14,4,10,6.668889629876625e-05,0.00013327706079655256,0.7142857142857143
4400,8460,덕화/Noun,14,10,4,0.0001333777925975325,6.663853039827628e-05,0.7142857142857143
4401,8461,혼돈/Noun,14,10,4,0.0001333777925975325,6.663853039827628e-05,0.7142857142857143
4402,8462,박철수/Noun,14,4,10,6.668889629876625e-05,0.00013327706079655256,0.7142857142857143
4403,8463,드라큘라/Noun,14,4,10,6.668889629876625e-05,0.00013327706079655256,0.7142857142857143
4404,8464,흡혈귀/Noun,14,4,10,6.668889629876625e-05,0.00013327706079655256,0.7142857142857143
4405,8465,가중/Noun,14,4,10,6.668889629876625e-05,0.00013327706079655256,0.7142857142857143
4406,8466,메가박스/Noun,14,10,4,0.0001333777925975325,6.663853039827628e-05,0.7142857142857143
4407,8467,학원물/Noun,14,4,10,6.668889629876625e-05,0.00013327706079655256,0.7142857142857143
4408,8468,앗다/Verb,14,4,10,6.668889629876625e-05,0.00013327706079655256,0.7142857142857143
4409,8469,상실하다/Adjective,14,4,10,6.668889629876625e-05,0.00013327706079655256,0.7142857142857143
4410,8470,치자/Noun,14,4,10,6.668889629876625e-05,0.00013327706079655256,0.7142857142857143
4411,8471,셜록홈즈/Noun,14,10,4,0.0001333777925975325,6.663853039827628e-05,0.7142857142857143
4412,8472,에고/Noun,14,4,10,6.668889629876625e-05,0.00013327706079655256,0.7142857142857143
4413,8473,이벤트/Noun,14,4,10,6.668889629876625e-05,0.00013327706079655256,0.7142857142857143
4414,8474,굴욕/Noun,14,4,10,6.668889629876625e-05,0.00013327706079655256,0.7142857142857143
4415,8475,사이비/Noun,14,4,10,6.668889629876625e-05,0.00013327706079655256,0.7142857142857143
4416,8476,시련/Noun,14,10,4,0.0001333777925975325,6.663853039827628e-05,0.7142857142857143
4417,8477,면모/Noun,14,10,4,0.0001333777925975325,6.663853039827628e-05,0.7142857142857143
4418,8478,대적/Noun,14,4,10,6.668889629876625e-05,0.00013327706079655256,0.7142857142857143
4419,8479,아우르다/Verb,14,10,4,0.0001333777925975325,6.663853039827628e-05,0.7142857142857143
4420,8480,우디앨런/Noun,14,10,4,0.0001333777925975325,6.663853039827628e-05,0.7142857142857143
4421,8481,미쉘/Noun,14,10,4,0.0001333777925975325,6.663853039827628e-05,0.7142857142857143
4422,8482,이수경/Noun,14,10,4,0.0001333777925975325,6.663853039827628e-05,0.7142857142857143
4423,8483,랬/Noun,14,4,10,6.668889629876625e-05,0.00013327706079655256,0.7142857142857143
4424,8484,1시/Number,14,4,10,6.668889629876625e-05,0.00013327706079655256,0.7142857142857143
4425,8485,사채/Noun,14,4,10,6.668889629876625e-05,0.00013327706079655256,0.7142857142857143
4426,8690,휴지통/Noun,13,0,13,2.2229632099588756e-05,0.0001665963259956907,1.0
4427,8691,동남아/Noun,13,0,13,2.2229632099588756e-05,0.0001665963259956907,1.0
4428,8692,we/Alpha,13,13,0,0.00016672224074691566,2.2212843466092093e-05,1.0
4429,8693,저리다/Adjective,13,13,0,0.00016672224074691566,2.2212843466092093e-05,1.0
4430,8694,졷/Noun,13,0,13,2.2229632099588756e-05,0.0001665963259956907,1.0
4431,8695,이화영/Noun,13,0,13,2.2229632099588756e-05,0.0001665963259956907,1.0
4432,8696,라그/Noun,13,0,13,2.2229632099588756e-05,0.0001665963259956907,1.0
4433,8697,정윤희/Noun,13,13,0,0.00016672224074691566,2.2212843466092093e-05,1.0
4434,8698,정도껏해/Noun,13,0,13,2.2229632099588756e-05,0.0001665963259956907,1.0
4435,8699,나사/Noun,13,0,13,2.2229632099588756e-05,0.0001665963259956907,1.0
4436,8700,이상준/Noun,13,0,13,2.2229632099588756e-05,0.0001665963259956907,1.0
4437,8701,죽도/Noun,13,0,13,2.2229632099588756e-05,0.0001665963259956907,1.0
4438,8702,아려/Noun,13,13,0,0.00016672224074691566,2.2212843466092093e-05,1.0
4439,8703,댕기/Noun,13,0,13,2.2229632099588756e-05,0.0001665963259956907,1.0
4440,8704,지스토리/Noun,13,0,13,2.2229632099588756e-05,0.0001665963259956907,1.0
4441,8705,씩씩하다/Adjective,13,13,0,0.00016672224074691566,2.2212843466092093e-05,1.0
4442,8706,모욕감/Noun,13,0,13,2.2229632099588756e-05,0.0001665963259956907,1.0
4443,8707,질색/Noun,13,0,13,2.2229632099588756e-05,0.0001665963259956907,1.0
4444,8708,최우식/Noun,13,13,0,0.00016672224074691566,2.2212843466092093e-05,1.0
4445,8709,오호/Exclamation,13,12,1,0.00015560742469712126,3.331926519913814e-05,0.9230769230769232
4446,8710,무뇌/Noun,13,1,12,3.334444814938313e-05,0.00015548990426264466,0.9230769230769232
4447,8711,전날/Noun,13,12,1,0.00015560742469712126,3.331926519913814e-05,0.9230769230769232
4448,8712,잠듬/Noun,13,1,12,3.334444814938313e-05,0.00015548990426264466,0.9230769230769232
4449,8713,사뭇/Noun,13,12,1,0.00015560742469712126,3.331926519913814e-05,0.9230769230769232
4450,8714,ㅅㄲ/KoreanParticle,13,1,12,3.334444814938313e-05,0.00015548990426264466,0.9230769230769232
4451,8715,life/Alpha,13,12,1,0.00015560742469712126,3.331926519913814e-05,0.9230769230769232
4452,8716,상남자/Noun,13,12,1,0.00015560742469712126,3.331926519913814e-05,0.9230769230769232
4453,8717,툭하면/Noun,13,1,12,3.334444814938313e-05,0.00015548990426264466,0.9230769230769232
4454,8718,Cg/Alpha,13,1,12,3.334444814938313e-05,0.00015548990426264466,0.9230769230769232
4455,8719,이창동/Noun,13,12,1,0.00015560742469712126,3.331926519913814e-05,0.9230769230769232
4456,8720,노망/Noun,13,1,12,3.334444814938313e-05,0.00015548990426264466,0.9230769230769232
4457,8721,로빈윌리엄스/Noun,13,12,1,0.00015560742469712126,3.331926519913814e-05,0.9230769230769232
4458,8722,박기웅/Noun,13,12,1,0.00015560742469712126,3.331926519913814e-05,0.9230769230769232
4459,8723,한스/Noun,13,12,1,0.00015560742469712126,3.331926519913814e-05,0.9230769230769232
4460,8724,괜춘/Noun,13,12,1,0.00015560742469712126,3.331926519913814e-05,0.9230769230769232
4461,8725,아낌없이/Adverb,13,12,1,0.00015560742469712126,3.331926519913814e-05,0.9230769230769232
4462,8726,잘껄/Noun,13,1,12,3.334444814938313e-05,0.00015548990426264466,0.9230769230769232
4463,8727,미끼/Noun,13,1,12,3.334444814938313e-05,0.00015548990426264466,0.9230769230769232
4464,8728,밋밋/Noun,13,1,12,3.334444814938313e-05,0.00015548990426264466,0.9230769230769232
4465,8729,휴그랜트/Noun,13,12,1,0.00015560742469712126,3.331926519913814e-05,0.9230769230769232
4466,8730,분단/Noun,13,12,1,0.00015560742469712126,3.331926519913814e-05,0.9230769230769232
4467,8731,on/Alpha,13,12,1,0.00015560742469712126,3.331926519913814e-05,0.9230769230769232
4468,8732,타오르다/Verb,13,12,1,0.00015560742469712126,3.331926519913814e-05,0.9230769230769232
4469,8733,퉷/Noun,13,1,12,3.334444814938313e-05,0.00015548990426264466,0.9230769230769232
4470,8734,삭막하다/Adjective,13,12,1,0.00015560742469712126,3.331926519913814e-05,0.9230769230769232
4471,8735,쯔쯔/Noun,13,1,12,3.334444814938313e-05,0.00015548990426264466,0.9230769230769232
4472,8736,로건/Noun,13,12,1,0.00015560742469712126,3.331926519913814e-05,0.9230769230769232
4473,8737,따분함/Noun,13,1,12,3.334444814938313e-05,0.00015548990426264466,0.9230769230769232
4474,8738,바르뎀/Noun,13,12,1,0.00015560742469712126,3.331926519913814e-05,0.9230769230769232
4475,8739,쯧/Exclamation,13,2,11,4.445926419917751e-05,0.0001443834825295986,0.8461538461538461
4476,8740,쯧쯧/Exclamation,13,2,11,4.445926419917751e-05,0.0001443834825295986,0.8461538461538461
4477,8741,기껏/Noun,13,2,11,4.445926419917751e-05,0.0001443834825295986,0.8461538461538461
4478,8742,하기는/Adverb,13,2,11,4.445926419917751e-05,0.0001443834825295986,0.8461538461538461
4479,8743,.!!!/Punctuation,13,11,2,0.0001444926086473269,4.4425686932184186e-05,0.8461538461538461
4480,8744,별도/Noun,13,2,11,4.445926419917751e-05,0.0001443834825295986,0.8461538461538461
4481,8745,캠코더/Noun,13,2,11,4.445926419917751e-05,0.0001443834825295986,0.8461538461538461
4482,8746,방구/Noun,13,2,11,4.445926419917751e-05,0.0001443834825295986,0.8461538461538461
4483,8747,요런/Noun,13,11,2,0.0001444926086473269,4.4425686932184186e-05,0.8461538461538461
4484,8748,분전/Noun,13,2,11,4.445926419917751e-05,0.0001443834825295986,0.8461538461538461
4485,8749,부당하다/Adjective,13,11,2,0.0001444926086473269,4.4425686932184186e-05,0.8461538461538461
4486,8750,당근/Noun,13,11,2,0.0001444926086473269,4.4425686932184186e-05,0.8461538461538461
4487,8751,독립영화관/Noun,13,11,2,0.0001444926086473269,4.4425686932184186e-05,0.8461538461538461
4488,8752,농촌/Noun,13,11,2,0.0001444926086473269,4.4425686932184186e-05,0.8461538461538461
4489,8753,델피/Noun,13,11,2,0.0001444926086473269,4.4425686932184186e-05,0.8461538461538461
4490,8754,은정/Noun,13,2,11,4.445926419917751e-05,0.0001443834825295986,0.8461538461538461
4491,8755,지모/Noun,13,11,2,0.0001444926086473269,4.4425686932184186e-05,0.8461538461538461
4492,8756,캠/Noun,13,2,11,4.445926419917751e-05,0.0001443834825295986,0.8461538461538461
4493,8757,반한/Noun,13,11,2,0.0001444926086473269,4.4425686932184186e-05,0.8461538461538461
4494,8758,빽/Noun,13,2,11,4.445926419917751e-05,0.0001443834825295986,0.8461538461538461
4495,8759,래미/Noun,13,2,11,4.445926419917751e-05,0.0001443834825295986,0.8461538461538461
4496,8760,브랜든/Noun,13,11,2,0.0001444926086473269,4.4425686932184186e-05,0.8461538461538461
4497,8761,깍/Noun,13,2,11,4.445926419917751e-05,0.0001443834825295986,0.8461538461538461
4498,8762,애착/Noun,13,11,2,0.0001444926086473269,4.4425686932184186e-05,0.8461538461538461
4499,8763,재밌슴/Noun,13,11,2,0.0001444926086473269,4.4425686932184186e-05,0.8461538461538461
4500,8764,핑/Noun,13,11,2,0.0001444926086473269,4.4425686932184186e-05,0.8461538461538461
4501,8765,극악/Noun,13,2,11,4.445926419917751e-05,0.0001443834825295986,0.8461538461538461
4502,8766,해피앤딩/Noun,13,11,2,0.0001444926086473269,4.4425686932184186e-05,0.8461538461538461
4503,8767,기인/Noun,13,2,11,4.445926419917751e-05,0.0001443834825295986,0.8461538461538461
4504,8768,돈벌이/Noun,13,2,11,4.445926419917751e-05,0.0001443834825295986,0.8461538461538461
4505,8769,정감/Noun,13,11,2,0.0001444926086473269,4.4425686932184186e-05,0.8461538461538461
4506,8770,흡인/Noun,13,11,2,0.0001444926086473269,4.4425686932184186e-05,0.8461538461538461
4507,8771,삼각관계/Noun,13,2,11,4.445926419917751e-05,0.0001443834825295986,0.8461538461538461
4508,8772,특촬물/Noun,13,2,11,4.445926419917751e-05,0.0001443834825295986,0.8461538461538461
4509,8773,디도/Noun,13,2,11,4.445926419917751e-05,0.0001443834825295986,0.8461538461538461
4510,8774,야심/Noun,13,2,11,4.445926419917751e-05,0.0001443834825295986,0.8461538461538461
4511,8775,블레어/Noun,13,2,11,4.445926419917751e-05,0.0001443834825295986,0.8461538461538461
4512,8776,부리고/Noun,13,2,11,4.445926419917751e-05,0.0001443834825295986,0.8461538461538461
4513,8777,반대편/Noun,13,11,2,0.0001444926086473269,4.4425686932184186e-05,0.8461538461538461
4514,8778,습니/Noun,13,11,2,0.0001444926086473269,4.4425686932184186e-05,0.8461538461538461
4515,8779,무스/Noun,13,11,2,0.0001444926086473269,4.4425686932184186e-05,0.8461538461538461
4516,8780,REC/Alpha,13,2,11,4.445926419917751e-05,0.0001443834825295986,0.8461538461538461
4517,8781,꼽는다/Noun,13,11,2,0.0001444926086473269,4.4425686932184186e-05,0.8461538461538461
4518,8782,정은지/Noun,13,11,2,0.0001444926086473269,4.4425686932184186e-05,0.8461538461538461
4519,8783,분발/Noun,13,2,11,4.445926419917751e-05,0.0001443834825295986,0.8461538461538461
4520,8784,4~5/Number,13,2,11,4.445926419917751e-05,0.0001443834825295986,0.8461538461538461
4521,8785,애매모호하다/Adjective,13,2,11,4.445926419917751e-05,0.0001443834825295986,0.8461538461538461
4522,8786,업자/Noun,13,2,11,4.445926419917751e-05,0.0001443834825295986,0.8461538461538461
4523,8787,버프/Noun,13,2,11,4.445926419917751e-05,0.0001443834825295986,0.8461538461538461
4524,8788,코비/Noun,13,11,2,0.0001444926086473269,4.4425686932184186e-05,0.8461538461538461
4525,8789,썸띵/Noun,13,2,11,4.445926419917751e-05,0.0001443834825295986,0.8461538461538461
4526,8790,김정훈/Noun,13,3,10,5.5574080248971876e-05,0.00013327706079655256,0.7692307692307693
4527,8791,소감/Noun,13,3,10,5.5574080248971876e-05,0.00013327706079655256,0.7692307692307693
4528,8792,외로워/Noun,13,10,3,0.0001333777925975325,5.553210866523024e-05,0.7692307692307693
4529,8793,imdb/Alpha,13,3,10,5.5574080248971876e-05,0.00013327706079655256,0.7692307692307693
4530,8794,!!!!!!!!!!!!!/Punctuation,13,10,3,0.0001333777925975325,5.553210866523024e-05,0.7692307692307693
4531,8795,점령/Noun,13,3,10,5.5574080248971876e-05,0.00013327706079655256,0.7692307692307693
4532,8796,캠프/Noun,13,3,10,5.5574080248971876e-05,0.00013327706079655256,0.7692307692307693
4533,8797,숨소리/Noun,13,10,3,0.0001333777925975325,5.553210866523024e-05,0.7692307692307693
4534,8798,거림/Noun,13,10,3,0.0001333777925975325,5.553210866523024e-05,0.7692307692307693
4535,8799,도쿄/Noun,13,10,3,0.0001333777925975325,5.553210866523024e-05,0.7692307692307693
4536,8800,....^^/Punctuation,13,10,3,0.0001333777925975325,5.553210866523024e-05,0.7692307692307693
4537,8801,욥/Noun,13,10,3,0.0001333777925975325,5.553210866523024e-05,0.7692307692307693
4538,8802,인주/Noun,13,3,10,5.5574080248971876e-05,0.00013327706079655256,0.7692307692307693
4539,8803,평가절하/Noun,13,10,3,0.0001333777925975325,5.553210866523024e-05,0.7692307692307693
4540,8804,노홍철/Noun,13,10,3,0.0001333777925975325,5.553210866523024e-05,0.7692307692307693
4541,8805,굴곡/Noun,13,3,10,5.5574080248971876e-05,0.00013327706079655256,0.7692307692307693
4542,8806,소문나다/Verb,13,3,10,5.5574080248971876e-05,0.00013327706079655256,0.7692307692307693
4543,8807,십자/Noun,13,3,10,5.5574080248971876e-05,0.00013327706079655256,0.7692307692307693
4544,8808,쩔/Noun,13,10,3,0.0001333777925975325,5.553210866523024e-05,0.7692307692307693
4545,8809,맛깔/Noun,13,10,3,0.0001333777925975325,5.553210866523024e-05,0.7692307692307693
4546,8810,서유리/Noun,13,3,10,5.5574080248971876e-05,0.00013327706079655256,0.7692307692307693
4547,8811,햐/Noun,13,3,10,5.5574080248971876e-05,0.00013327706079655256,0.7692307692307693
4548,8812,끝임/Noun,13,3,10,5.5574080248971876e-05,0.00013327706079655256,0.7692307692307693
4549,8813,복사/Noun,13,3,10,5.5574080248971876e-05,0.00013327706079655256,0.7692307692307693
4550,8814,조미/Noun,13,10,3,0.0001333777925975325,5.553210866523024e-05,0.7692307692307693
4551,8815,수염/Noun,13,3,10,5.5574080248971876e-05,0.00013327706079655256,0.7692307692307693
4552,8816,빡/Noun,13,3,10,5.5574080248971876e-05,0.00013327706079655256,0.7692307692307693
4553,8817,카렐/Noun,13,10,3,0.0001333777925975325,5.553210866523024e-05,0.7692307692307693
4554,8818,간의/Foreign,13,10,3,0.0001333777925975325,5.553210866523024e-05,0.7692307692307693
4555,8819,이재은/Noun,13,3,10,5.5574080248971876e-05,0.00013327706079655256,0.7692307692307693
4556,8820,배출/Noun,13,10,3,0.0001333777925975325,5.553210866523024e-05,0.7692307692307693
4557,8821,누리/Noun,13,10,3,0.0001333777925975325,5.553210866523024e-05,0.7692307692307693
4558,8822,비겁하다/Adjective,13,3,10,5.5574080248971876e-05,0.00013327706079655256,0.7692307692307693
4559,8823,부들부들/Noun,13,3,10,5.5574080248971876e-05,0.00013327706079655256,0.7692307692307693
4560,8824,수트/Noun,13,10,3,0.0001333777925975325,5.553210866523024e-05,0.7692307692307693
4561,8825,뻑/Noun,13,3,10,5.5574080248971876e-05,0.00013327706079655256,0.7692307692307693
4562,8826,기수/Noun,13,3,10,5.5574080248971876e-05,0.00013327706079655256,0.7692307692307693
4563,8827,스럽지도/Josa,13,3,10,5.5574080248971876e-05,0.00013327706079655256,0.7692307692307693
4564,8828,예언/Noun,13,10,3,0.0001333777925975325,5.553210866523024e-05,0.7692307692307693
4565,8829,120/Number,13,3,10,5.5574080248971876e-05,0.00013327706079655256,0.7692307692307693
4566,8830,넘어오다/Verb,13,3,10,5.5574080248971876e-05,0.00013327706079655256,0.7692307692307693
4567,8831,히트치다/Verb,13,3,10,5.5574080248971876e-05,0.00013327706079655256,0.7692307692307693
4568,8832,고창석/Noun,13,3,10,5.5574080248971876e-05,0.00013327706079655256,0.7692307692307693
4569,8833,조로/Noun,13,3,10,5.5574080248971876e-05,0.00013327706079655256,0.7692307692307693
4570,8834,안대/Noun,13,3,10,5.5574080248971876e-05,0.00013327706079655256,0.7692307692307693
4571,8835,선장/Noun,13,10,3,0.0001333777925975325,5.553210866523024e-05,0.7692307692307693
4572,8836,시적/Noun,13,10,3,0.0001333777925975325,5.553210866523024e-05,0.7692307692307693
4573,8837,방송사/Noun,13,3,10,5.5574080248971876e-05,0.00013327706079655256,0.7692307692307693
4574,8838,국경/Noun,13,10,3,0.0001333777925975325,5.553210866523024e-05,0.7692307692307693
4575,8839,버디/Noun,13,10,3,0.0001333777925975325,5.553210866523024e-05,0.7692307692307693
4576,8840,신체/Noun,13,3,10,5.5574080248971876e-05,0.00013327706079655256,0.7692307692307693
4577,8841,마리옹/Noun,13,10,3,0.0001333777925975325,5.553210866523024e-05,0.7692307692307693
4578,8842,만끽/Noun,13,10,3,0.0001333777925975325,5.553210866523024e-05,0.7692307692307693
4579,8843,봉하/Noun,13,10,3,0.0001333777925975325,5.553210866523024e-05,0.7692307692307693
4580,8844,재개/Noun,13,10,3,0.0001333777925975325,5.553210866523024e-05,0.7692307692307693
4581,8845,살찌다/Adjective,13,3,10,5.5574080248971876e-05,0.00013327706079655256,0.7692307692307693
4582,8846,무의식/Noun,13,10,3,0.0001333777925975325,5.553210866523024e-05,0.7692307692307693
4583,8847,워킹/Noun,13,3,10,5.5574080248971876e-05,0.00013327706079655256,0.7692307692307693
4584,8848,우산/Noun,13,10,3,0.0001333777925975325,5.553210866523024e-05,0.7692307692307693
4585,8849,1960년/Number,13,3,10,5.5574080248971876e-05,0.00013327706079655256,0.7692307692307693
4586,8850,영원/Noun,13,10,3,0.0001333777925975325,5.553210866523024e-05,0.7692307692307693
4587,8851,마리아/Noun,13,10,3,0.0001333777925975325,5.553210866523024e-05,0.7692307692307693
4588,8852,계절/Noun,13,10,3,0.0001333777925975325,5.553210866523024e-05,0.7692307692307693
4589,8853,최루성/Noun,13,4,9,6.668889629876625e-05,0.00012217063906350652,0.6923076923076923
4590,8854,손길/Noun,13,9,4,0.00012226297654773814,6.663853039827628e-05,0.6923076923076923
4591,8855,한고은/Noun,13,4,9,6.668889629876625e-05,0.00012217063906350652,0.6923076923076923
4592,8856,문란하다/Adjective,13,4,9,6.668889629876625e-05,0.00012217063906350652,0.6923076923076923
4593,8857,꺅/Adverb,13,9,4,0.00012226297654773814,6.663853039827628e-05,0.6923076923076923
4594,8858,이영환/Noun,13,4,9,6.668889629876625e-05,0.00012217063906350652,0.6923076923076923
4595,8859,미취/Noun,13,4,9,6.668889629876625e-05,0.00012217063906350652,0.6923076923076923
4596,8860,갑옷/Noun,13,4,9,6.668889629876625e-05,0.00012217063906350652,0.6923076923076923
4597,8861,가르시아/Noun,13,9,4,0.00012226297654773814,6.663853039827628e-05,0.6923076923076923
4598,8862,이어도/Noun,13,9,4,0.00012226297654773814,6.663853039827628e-05,0.6923076923076923
4599,8863,천안함/Noun,13,4,9,6.668889629876625e-05,0.00012217063906350652,0.6923076923076923
4600,8864,하류/Noun,13,4,9,6.668889629876625e-05,0.00012217063906350652,0.6923076923076923
4601,8865,나미/Noun,13,4,9,6.668889629876625e-05,0.00012217063906350652,0.6923076923076923
4602,8866,엿/Noun,13,4,9,6.668889629876625e-05,0.00012217063906350652,0.6923076923076923
4603,8867,아찔하다/Adjective,13,9,4,0.00012226297654773814,6.663853039827628e-05,0.6923076923076923
4604,8868,소신/Noun,13,9,4,0.00012226297654773814,6.663853039827628e-05,0.6923076923076923
4605,8869,엘리/Noun,13,9,4,0.00012226297654773814,6.663853039827628e-05,0.6923076923076923
4606,8870,로미오/Noun,13,9,4,0.00012226297654773814,6.663853039827628e-05,0.6923076923076923
4607,8871,이씨/Noun,13,4,9,6.668889629876625e-05,0.00012217063906350652,0.6923076923076923
4608,8872,모모/Noun,13,4,9,6.668889629876625e-05,0.00012217063906350652,0.6923076923076923
4609,8873,비율/Noun,13,4,9,6.668889629876625e-05,0.00012217063906350652,0.6923076923076923
4610,8874,게이트/Noun,13,9,4,0.00012226297654773814,6.663853039827628e-05,0.6923076923076923
4611,8875,5.5/Number,13,4,9,6.668889629876625e-05,0.00012217063906350652,0.6923076923076923
4612,8876,고대/Noun,13,9,4,0.00012226297654773814,6.663853039827628e-05,0.6923076923076923
4613,8877,인가/Foreign,13,9,4,0.00012226297654773814,6.663853039827628e-05,0.6923076923076923
4614,8878,첩혈쌍웅/Noun,13,9,4,0.00012226297654773814,6.663853039827628e-05,0.6923076923076923
4615,8879,무쟈/Noun,13,4,9,6.668889629876625e-05,0.00012217063906350652,0.6923076923076923
4616,8880,왕가네/Noun,13,4,9,6.668889629876625e-05,0.00012217063906350652,0.6923076923076923
4617,8881,gg/Alpha,13,4,9,6.668889629876625e-05,0.00012217063906350652,0.6923076923076923
4618,8882,가출/Noun,13,4,9,6.668889629876625e-05,0.00012217063906350652,0.6923076923076923
4619,8883,캔디/Noun,13,9,4,0.00012226297654773814,6.663853039827628e-05,0.6923076923076923
4620,8884,취업/Noun,13,9,4,0.00012226297654773814,6.663853039827628e-05,0.6923076923076923
4621,8885,장통/Noun,13,9,4,0.00012226297654773814,6.663853039827628e-05,0.6923076923076923
4622,8886,조온나/Noun,13,4,9,6.668889629876625e-05,0.00012217063906350652,0.6923076923076923
4623,8887,설교/Noun,13,4,9,6.668889629876625e-05,0.00012217063906350652,0.6923076923076923
4624,8888,애증/Noun,13,9,4,0.00012226297654773814,6.663853039827628e-05,0.6923076923076923
4625,8889,빼앗다/Verb,13,4,9,6.668889629876625e-05,0.00012217063906350652,0.6923076923076923
4626,8890,강인/Noun,13,4,9,6.668889629876625e-05,0.00012217063906350652,0.6923076923076923
4627,8891,약점/Noun,13,4,9,6.668889629876625e-05,0.00012217063906350652,0.6923076923076923
4628,8892,올라서다/Verb,13,9,4,0.00012226297654773814,6.663853039827628e-05,0.6923076923076923
4629,8893,BEST/Alpha,13,9,4,0.00012226297654773814,6.663853039827628e-05,0.6923076923076923
4630,8894,왜냐하면/Adverb,13,9,4,0.00012226297654773814,6.663853039827628e-05,0.6923076923076923
4631,8895,훑다/Verb,13,4,9,6.668889629876625e-05,0.00012217063906350652,0.6923076923076923
4632,8896,동해/Noun,13,4,9,6.668889629876625e-05,0.00012217063906350652,0.6923076923076923
4633,8897,휴일/Noun,13,9,4,0.00012226297654773814,6.663853039827628e-05,0.6923076923076923
4634,8898,주된/Modifier,13,4,9,6.668889629876625e-05,0.00012217063906350652,0.6923076923076923
4635,8899,불사신/Noun,13,4,9,6.668889629876625e-05,0.00012217063906350652,0.6923076923076923
4636,8900,선악/Noun,13,9,4,0.00012226297654773814,6.663853039827628e-05,0.6923076923076923
4637,8901,공평하다/Adjective,13,9,4,0.00012226297654773814,6.663853039827628e-05,0.6923076923076923
4638,8902,신경안/Noun,13,4,9,6.668889629876625e-05,0.00012217063906350652,0.6923076923076923
4639,8903,성취/Noun,13,9,4,0.00012226297654773814,6.663853039827628e-05,0.6923076923076923
4640,8904,근원/Noun,13,9,4,0.00012226297654773814,6.663853039827628e-05,0.6923076923076923
4641,8905,민아/Noun,13,9,4,0.00012226297654773814,6.663853039827628e-05,0.6923076923076923
4642,8906,알렌/Noun,13,9,4,0.00012226297654773814,6.663853039827628e-05,0.6923076923076923
4643,8907,광수/Noun,13,4,9,6.668889629876625e-05,0.00012217063906350652,0.6923076923076923
4644,8908,시급하다/Adjective,13,4,9,6.668889629876625e-05,0.00012217063906350652,0.6923076923076923
4645,8909,남극/Noun,13,9,4,0.00012226297654773814,6.663853039827628e-05,0.6923076923076923
4646,8910,절벽/Noun,13,4,9,6.668889629876625e-05,0.00012217063906350652,0.6923076923076923
4647,8911,브레드/Noun,13,4,9,6.668889629876625e-05,0.00012217063906350652,0.6923076923076923
4648,8912,실현/Noun,13,9,4,0.00012226297654773814,6.663853039827628e-05,0.6923076923076923
4649,8913,아부지/Noun,13,9,4,0.00012226297654773814,6.663853039827628e-05,0.6923076923076923
4650,8914,27/Number,13,9,4,0.00012226297654773814,6.663853039827628e-05,0.6923076923076923
4651,8915,노출씬/Noun,13,4,9,6.668889629876625e-05,0.00012217063906350652,0.6923076923076923
4652,8916,달려들다/Verb,13,4,9,6.668889629876625e-05,0.00012217063906350652,0.6923076923076923
4653,8917,문어/Noun,13,4,9,6.668889629876625e-05,0.00012217063906350652,0.6923076923076923
4654,8918,동반/Noun,13,9,4,0.00012226297654773814,6.663853039827628e-05,0.6923076923076923
4655,8919,♪/Foreign,13,9,4,0.00012226297654773814,6.663853039827628e-05,0.6923076923076923
4656,8920,최다니엘/Noun,13,9,4,0.00012226297654773814,6.663853039827628e-05,0.6923076923076923
4657,8921,차량/Noun,13,4,9,6.668889629876625e-05,0.00012217063906350652,0.6923076923076923
4658,8922,주도/Noun,13,4,9,6.668889629876625e-05,0.00012217063906350652,0.6923076923076923
4659,8923,히든싱어/Noun,13,9,4,0.00012226297654773814,6.663853039827628e-05,0.6923076923076923
4660,8924,마자/Noun,13,4,9,6.668889629876625e-05,0.00012217063906350652,0.6923076923076923
4661,8925,시공간/Noun,13,9,4,0.00012226297654773814,6.663853039827628e-05,0.6923076923076923
4662,8926,신작/Noun,13,4,9,6.668889629876625e-05,0.00012217063906350652,0.6923076923076923
4663,8927,기여/Noun,13,9,4,0.00012226297654773814,6.663853039827628e-05,0.6923076923076923
4664,8928,른/Noun,13,9,4,0.00012226297654773814,6.663853039827628e-05,0.6923076923076923
4665,8929,수백/Modifier,13,4,9,6.668889629876625e-05,0.00012217063906350652,0.6923076923076923
4666,8930,무덥다/Adjective,13,9,4,0.00012226297654773814,6.663853039827628e-05,0.6923076923076923
4667,8931,김인권/Noun,13,4,9,6.668889629876625e-05,0.00012217063906350652,0.6923076923076923
4668,8932,성별/Noun,13,4,9,6.668889629876625e-05,0.00012217063906350652,0.6923076923076923
4669,8933,오징어/Noun,13,4,9,6.668889629876625e-05,0.00012217063906350652,0.6923076923076923
4670,8934,허드/Noun,13,4,9,6.668889629876625e-05,0.00012217063906350652,0.6923076923076923
4671,8935,치정/Noun,13,4,9,6.668889629876625e-05,0.00012217063906350652,0.6923076923076923
4672,8936,회도/Noun,13,9,4,0.00012226297654773814,6.663853039827628e-05,0.6923076923076923
4673,8937,구가/Noun,13,4,9,6.668889629876625e-05,0.00012217063906350652,0.6923076923076923
4674,9114,달콤/Noun,12,12,0,0.00015560742469712126,2.2212843466092093e-05,1.0
4675,9115,아동학대/Noun,12,0,12,2.2229632099588756e-05,0.00015548990426264466,1.0
4676,9116,함량/Noun,12,0,12,2.2229632099588756e-05,0.00015548990426264466,1.0
4677,9117,언플/Noun,12,0,12,2.2229632099588756e-05,0.00015548990426264466,1.0
4678,9118,알몸/Noun,12,0,12,2.2229632099588756e-05,0.00015548990426264466,1.0
4679,9119,뭐/Exclamation,12,0,12,2.2229632099588756e-05,0.00015548990426264466,1.0
4680,9120,박시환/Noun,12,0,12,2.2229632099588756e-05,0.00015548990426264466,1.0
4681,9121,넘겨보다/Verb,12,0,12,2.2229632099588756e-05,0.00015548990426264466,1.0
4682,9122,예스/Noun,12,12,0,0.00015560742469712126,2.2212843466092093e-05,1.0
4683,9123,허접스럽다/Adjective,12,0,12,2.2229632099588756e-05,0.00015548990426264466,1.0
4684,9124,붙여넣기/Noun,12,0,12,2.2229632099588756e-05,0.00015548990426264466,1.0
4685,9125,횡설수설/Noun,12,0,12,2.2229632099588756e-05,0.00015548990426264466,1.0
4686,9126,故/Foreign,12,12,0,0.00015560742469712126,2.2212843466092093e-05,1.0
4687,9127,아이폰/Noun,12,0,12,2.2229632099588756e-05,0.00015548990426264466,1.0
4688,9128,게머/Noun,12,0,12,2.2229632099588756e-05,0.00015548990426264466,1.0
4689,9129,요점/Noun,12,0,12,2.2229632099588756e-05,0.00015548990426264466,1.0
4690,9130,쵝/Noun,12,12,0,0.00015560742469712126,2.2212843466092093e-05,1.0
4691,9131,정색/Noun,12,0,12,2.2229632099588756e-05,0.00015548990426264466,1.0
4692,9132,가지가지/Noun,12,0,12,2.2229632099588756e-05,0.00015548990426264466,1.0
4693,9133,화남/Noun,12,0,12,2.2229632099588756e-05,0.00015548990426264466,1.0
4694,9134,다망/Noun,12,0,12,2.2229632099588756e-05,0.00015548990426264466,1.0
4695,9135,서동요/Noun,12,11,1,0.0001444926086473269,3.331926519913814e-05,0.9166666666666666
4696,9136,에구/Exclamation,12,1,11,3.334444814938313e-05,0.0001443834825295986,0.9166666666666666
4697,9137,샬롯/Noun,12,11,1,0.0001444926086473269,3.331926519913814e-05,0.9166666666666666
4698,9138,화표/Noun,12,1,11,3.334444814938313e-05,0.0001443834825295986,0.9166666666666666
4699,9139,국물/Noun,12,1,11,3.334444814938313e-05,0.0001443834825295986,0.9166666666666666
4700,9140,겉도/Noun,12,1,11,3.334444814938313e-05,0.0001443834825295986,0.9166666666666666
4701,9141,온갖/Modifier,12,1,11,3.334444814938313e-05,0.0001443834825295986,0.9166666666666666
4702,9142,참상/Noun,12,11,1,0.0001444926086473269,3.331926519913814e-05,0.9166666666666666
4703,9143,챙/Noun,12,1,11,3.334444814938313e-05,0.0001443834825295986,0.9166666666666666
4704,9144,쉴드/Noun,12,1,11,3.334444814938313e-05,0.0001443834825295986,0.9166666666666666
4705,9145,비범하다/Adjective,12,11,1,0.0001444926086473269,3.331926519913814e-05,0.9166666666666666
4706,9146,갈비/Noun,12,1,11,3.334444814938313e-05,0.0001443834825295986,0.9166666666666666
4707,9147,~^/Punctuation,12,11,1,0.0001444926086473269,3.331926519913814e-05,0.9166666666666666
4708,9148,콩콩/Adverb,12,1,11,3.334444814938313e-05,0.0001443834825295986,0.9166666666666666
4709,9149,퇴마록/Noun,12,1,11,3.334444814938313e-05,0.0001443834825295986,0.9166666666666666
4710,9150,색안경/Noun,12,11,1,0.0001444926086473269,3.331926519913814e-05,0.9166666666666666
4711,9151,똥칠/Noun,12,1,11,3.334444814938313e-05,0.0001443834825295986,0.9166666666666666
4712,9152,장대/Noun,12,11,1,0.0001444926086473269,3.331926519913814e-05,0.9166666666666666
4713,9153,~*/Punctuation,12,11,1,0.0001444926086473269,3.331926519913814e-05,0.9166666666666666
4714,9154,My/Alpha,12,11,1,0.0001444926086473269,3.331926519913814e-05,0.9166666666666666
4715,9155,가까워지다/Verb,12,11,1,0.0001444926086473269,3.331926519913814e-05,0.9166666666666666
4716,9156,취재/Noun,12,1,11,3.334444814938313e-05,0.0001443834825295986,0.9166666666666666
4717,9157,시망/Noun,12,1,11,3.334444814938313e-05,0.0001443834825295986,0.9166666666666666
4718,9158,퉤퉤/Noun,12,1,11,3.334444814938313e-05,0.0001443834825295986,0.9166666666666666
4719,9159,유식/Noun,12,1,11,3.334444814938313e-05,0.0001443834825295986,0.9166666666666666
4720,9160,글썽/Noun,12,11,1,0.0001444926086473269,3.331926519913814e-05,0.9166666666666666
4721,9161,뻘짓/Noun,12,1,11,3.334444814938313e-05,0.0001443834825295986,0.9166666666666666
4722,9162,세도/Noun,12,1,11,3.334444814938313e-05,0.0001443834825295986,0.9166666666666666
4723,9163,초강추/Noun,12,11,1,0.0001444926086473269,3.331926519913814e-05,0.9166666666666666
4724,9164,친자/Noun,12,1,11,3.334444814938313e-05,0.0001443834825295986,0.9166666666666666
4725,9165,아이큐/Noun,12,1,11,3.334444814938313e-05,0.0001443834825295986,0.9166666666666666
4726,9166,마구잡이/Noun,12,1,11,3.334444814938313e-05,0.0001443834825295986,0.9166666666666666
4727,9167,위노나/Noun,12,11,1,0.0001444926086473269,3.331926519913814e-05,0.9166666666666666
4728,9168,개떡/Noun,12,1,11,3.334444814938313e-05,0.0001443834825295986,0.9166666666666666
4729,9169,당혹스럽다/Adjective,12,1,11,3.334444814938313e-05,0.0001443834825295986,0.9166666666666666
4730,9170,10억/Number,12,1,11,3.334444814938313e-05,0.0001443834825295986,0.9166666666666666
4731,9171,삼생이/Noun,12,1,11,3.334444814938313e-05,0.0001443834825295986,0.9166666666666666
4732,9172,뿌듯하다/Adjective,12,11,1,0.0001444926086473269,3.331926519913814e-05,0.9166666666666666
4733,9173,얼척/Noun,12,1,11,3.334444814938313e-05,0.0001443834825295986,0.9166666666666666
4734,9174,어정쩡/Adverb,12,1,11,3.334444814938313e-05,0.0001443834825295986,0.9166666666666666
4735,9175,미녀삼총사/Noun,12,1,11,3.334444814938313e-05,0.0001443834825295986,0.9166666666666666
4736,9176,봣네/Noun,12,11,1,0.0001444926086473269,3.331926519913814e-05,0.9166666666666666
4737,9177,11시/Number,12,11,1,0.0001444926086473269,3.331926519913814e-05,0.9166666666666666
4738,9178,눈꼽/Noun,12,1,11,3.334444814938313e-05,0.0001443834825295986,0.9166666666666666
4739,9179,화병/Noun,12,2,10,4.445926419917751e-05,0.00013327706079655256,0.8333333333333334
4740,9180,법적/Noun,12,2,10,4.445926419917751e-05,0.00013327706079655256,0.8333333333333334
4741,9181,캡/Noun,12,10,2,0.0001333777925975325,4.4425686932184186e-05,0.8333333333333334
4742,9182,",,,,,,/Punctuation",12,2,10,4.445926419917751e-05,0.00013327706079655256,0.8333333333333334
4743,9183,재일교포/Noun,12,10,2,0.0001333777925975325,4.4425686932184186e-05,0.8333333333333334
4744,9184,소속사/Noun,12,2,10,4.445926419917751e-05,0.00013327706079655256,0.8333333333333334
4745,9185,중단/Noun,12,2,10,4.445926419917751e-05,0.00013327706079655256,0.8333333333333334
4746,9186,손목/Noun,12,2,10,4.445926419917751e-05,0.00013327706079655256,0.8333333333333334
4747,9187,무인/Noun,12,10,2,0.0001333777925975325,4.4425686932184186e-05,0.8333333333333334
4748,9188,불사조/Noun,12,2,10,4.445926419917751e-05,0.00013327706079655256,0.8333333333333334
4749,9189,고소하다/Adjective,12,2,10,4.445926419917751e-05,0.00013327706079655256,0.8333333333333334
4750,9190,비긴즈/Noun,12,10,2,0.0001333777925975325,4.4425686932184186e-05,0.8333333333333334
4751,9191,직시/Noun,12,10,2,0.0001333777925975325,4.4425686932184186e-05,0.8333333333333334
4752,9192,84년/Number,12,10,2,0.0001333777925975325,4.4425686932184186e-05,0.8333333333333334
4753,9193,메르스/Noun,12,10,2,0.0001333777925975325,4.4425686932184186e-05,0.8333333333333334
4754,9194,르네젤위거/Noun,12,10,2,0.0001333777925975325,4.4425686932184186e-05,0.8333333333333334
4755,9195,후벼파다/Verb,12,10,2,0.0001333777925975325,4.4425686932184186e-05,0.8333333333333334
4756,9196,징기스칸/Noun,12,2,10,4.445926419917751e-05,0.00013327706079655256,0.8333333333333334
4757,9197,급작/Noun,12,2,10,4.445926419917751e-05,0.00013327706079655256,0.8333333333333334
4758,9198,김동완/Noun,12,10,2,0.0001333777925975325,4.4425686932184186e-05,0.8333333333333334
4759,9199,린지/Noun,12,2,10,4.445926419917751e-05,0.00013327706079655256,0.8333333333333334
4760,9200,애뜻/Noun,12,10,2,0.0001333777925975325,4.4425686932184186e-05,0.8333333333333334
4761,9201,라푼젤/Noun,12,10,2,0.0001333777925975325,4.4425686932184186e-05,0.8333333333333334
4762,9202,내적/Noun,12,10,2,0.0001333777925975325,4.4425686932184186e-05,0.8333333333333334
4763,9203,어후/Noun,12,2,10,4.445926419917751e-05,0.00013327706079655256,0.8333333333333334
4764,9204,아키/Noun,12,10,2,0.0001333777925975325,4.4425686932184186e-05,0.8333333333333334
4765,9205,마부/Noun,12,10,2,0.0001333777925975325,4.4425686932184186e-05,0.8333333333333334
4766,9206,스푼/Noun,12,2,10,4.445926419917751e-05,0.00013327706079655256,0.8333333333333334
4767,9207,정치가/Noun,12,10,2,0.0001333777925975325,4.4425686932184186e-05,0.8333333333333334
4768,9208,음슴다/Verb,12,2,10,4.445926419917751e-05,0.00013327706079655256,0.8333333333333334
4769,9209,훗/Noun,12,10,2,0.0001333777925975325,4.4425686932184186e-05,0.8333333333333334
4770,9210,더러/Josa,12,2,10,4.445926419917751e-05,0.00013327706079655256,0.8333333333333334
4771,9211,골빈/Noun,12,2,10,4.445926419917751e-05,0.00013327706079655256,0.8333333333333334
4772,9212,~~~!/Punctuation,12,10,2,0.0001333777925975325,4.4425686932184186e-05,0.8333333333333334
4773,9213,기질/Noun,12,2,10,4.445926419917751e-05,0.00013327706079655256,0.8333333333333334
4774,9214,들뜨다/Adjective,12,10,2,0.0001333777925975325,4.4425686932184186e-05,0.8333333333333334
4775,9215,최시원/Noun,12,2,10,4.445926419917751e-05,0.00013327706079655256,0.8333333333333334
4776,9216,부하/Noun,12,2,10,4.445926419917751e-05,0.00013327706079655256,0.8333333333333334
4777,9217,허리/Noun,12,2,10,4.445926419917751e-05,0.00013327706079655256,0.8333333333333334
4778,9218,인과/Noun,12,2,10,4.445926419917751e-05,0.00013327706079655256,0.8333333333333334
4779,9219,수채화/Noun,12,10,2,0.0001333777925975325,4.4425686932184186e-05,0.8333333333333334
4780,9220,팬더/Noun,12,2,10,4.445926419917751e-05,0.00013327706079655256,0.8333333333333334
4781,9221,본래/Noun,12,2,10,4.445926419917751e-05,0.00013327706079655256,0.8333333333333334
4782,9222,해답/Noun,12,10,2,0.0001333777925975325,4.4425686932184186e-05,0.8333333333333334
4783,9223,제자리/Noun,12,2,10,4.445926419917751e-05,0.00013327706079655256,0.8333333333333334
4784,9224,테드/Noun,12,10,2,0.0001333777925975325,4.4425686932184186e-05,0.8333333333333334
4785,9225,신물/Noun,12,2,10,4.445926419917751e-05,0.00013327706079655256,0.8333333333333334
4786,9226,볼빠/Noun,12,2,10,4.445926419917751e-05,0.00013327706079655256,0.8333333333333334
4787,9227,역행/Noun,12,2,10,4.445926419917751e-05,0.00013327706079655256,0.8333333333333334
4788,9228,당초/Noun,12,2,10,4.445926419917751e-05,0.00013327706079655256,0.8333333333333334
4789,9229,고요하다/Adjective,12,10,2,0.0001333777925975325,4.4425686932184186e-05,0.8333333333333334
4790,9230,킥/Noun,12,2,10,4.445926419917751e-05,0.00013327706079655256,0.8333333333333334
4791,9231,제이크/Noun,12,10,2,0.0001333777925975325,4.4425686932184186e-05,0.8333333333333334
4792,9232,연달/Noun,12,10,2,0.0001333777925975325,4.4425686932184186e-05,0.8333333333333334
4793,9233,강박증/Noun,12,9,3,0.00012226297654773814,5.553210866523024e-05,0.75
4794,9234,연재/Noun,12,9,3,0.00012226297654773814,5.553210866523024e-05,0.75
4795,9235,대로의/Josa,12,9,3,0.00012226297654773814,5.553210866523024e-05,0.75
4796,9236,암담하다/Adjective,12,3,9,5.5574080248971876e-05,0.00012217063906350652,0.75
4797,9237,왓으/Noun,12,9,3,0.00012226297654773814,5.553210866523024e-05,0.75
4798,9238,가상/Noun,12,9,3,0.00012226297654773814,5.553210866523024e-05,0.75
4799,9239,So/Alpha,12,9,3,0.00012226297654773814,5.553210866523024e-05,0.75
4800,9240,이래저래/Adverb,12,3,9,5.5574080248971876e-05,0.00012217063906350652,0.75
4801,9241,순전하다/Adjective,12,3,9,5.5574080248971876e-05,0.00012217063906350652,0.75
4802,9242,라이어/Noun,12,3,9,5.5574080248971876e-05,0.00012217063906350652,0.75
4803,9243,배치/Noun,12,9,3,0.00012226297654773814,5.553210866523024e-05,0.75
4804,9244,축소/Noun,12,9,3,0.00012226297654773814,5.553210866523024e-05,0.75
4805,9245,다듬어지다/Verb,12,9,3,0.00012226297654773814,5.553210866523024e-05,0.75
4806,9246,내년/Noun,12,9,3,0.00012226297654773814,5.553210866523024e-05,0.75
4807,9247,윌리암스/Noun,12,9,3,0.00012226297654773814,5.553210866523024e-05,0.75
4808,9248,해명/Noun,12,3,9,5.5574080248971876e-05,0.00012217063906350652,0.75
4809,9249,연연하다/Adjective,12,9,3,0.00012226297654773814,5.553210866523024e-05,0.75
4810,9250,정심/Noun,12,3,9,5.5574080248971876e-05,0.00012217063906350652,0.75
4811,9251,엘리자베스/Noun,12,9,3,0.00012226297654773814,5.553210866523024e-05,0.75
4812,9252,홍어/Noun,12,3,9,5.5574080248971876e-05,0.00012217063906350652,0.75
4813,9253,무법자/Noun,12,9,3,0.00012226297654773814,5.553210866523024e-05,0.75
4814,9254,여름방학/Noun,12,9,3,0.00012226297654773814,5.553210866523024e-05,0.75
4815,9255,사냥꾼/Noun,12,3,9,5.5574080248971876e-05,0.00012217063906350652,0.75
4816,9256,쇼핑/Noun,12,3,9,5.5574080248971876e-05,0.00012217063906350652,0.75
4817,9257,사무/Noun,12,3,9,5.5574080248971876e-05,0.00012217063906350652,0.75
4818,9258,깽/Noun,12,3,9,5.5574080248971876e-05,0.00012217063906350652,0.75
4819,9259,애물/Noun,12,3,9,5.5574080248971876e-05,0.00012217063906350652,0.75
4820,9260,헬드/Noun,12,3,9,5.5574080248971876e-05,0.00012217063906350652,0.75
4821,9261,쩌네/Noun,12,9,3,0.00012226297654773814,5.553210866523024e-05,0.75
4822,9262,고대로/Noun,12,3,9,5.5574080248971876e-05,0.00012217063906350652,0.75
4823,9263,덤앤더머/Noun,12,9,3,0.00012226297654773814,5.553210866523024e-05,0.75
4824,9264,호들갑/Noun,12,3,9,5.5574080248971876e-05,0.00012217063906350652,0.75
4825,9265,포토/Noun,12,3,9,5.5574080248971876e-05,0.00012217063906350652,0.75
4826,9266,격투기/Noun,12,3,9,5.5574080248971876e-05,0.00012217063906350652,0.75
4827,9267,서편제/Noun,12,9,3,0.00012226297654773814,5.553210866523024e-05,0.75
4828,9268,부질없다/Adjective,12,3,9,5.5574080248971876e-05,0.00012217063906350652,0.75
4829,9269,100회/Number,12,3,9,5.5574080248971876e-05,0.00012217063906350652,0.75
4830,9270,야경/Noun,12,3,9,5.5574080248971876e-05,0.00012217063906350652,0.75
4831,9271,고만/Modifier,12,3,9,5.5574080248971876e-05,0.00012217063906350652,0.75
4832,9272,",..../Punctuation",12,3,9,5.5574080248971876e-05,0.00012217063906350652,0.75
4833,9273,전역/Noun,12,9,3,0.00012226297654773814,5.553210866523024e-05,0.75
4834,9274,분도/Noun,12,9,3,0.00012226297654773814,5.553210866523024e-05,0.75
4835,9275,아대/Noun,12,3,9,5.5574080248971876e-05,0.00012217063906350652,0.75
4836,9276,즐감/Noun,12,9,3,0.00012226297654773814,5.553210866523024e-05,0.75
4837,9277,김소현/Noun,12,9,3,0.00012226297654773814,5.553210866523024e-05,0.75
4838,9278,아따맘마/Noun,12,9,3,0.00012226297654773814,5.553210866523024e-05,0.75
4839,9279,고장/Noun,12,3,9,5.5574080248971876e-05,0.00012217063906350652,0.75
4840,9280,차기/Noun,12,9,3,0.00012226297654773814,5.553210866523024e-05,0.75
4841,9281,김범/Noun,12,3,9,5.5574080248971876e-05,0.00012217063906350652,0.75
4842,9282,찰나/Noun,12,9,3,0.00012226297654773814,5.553210866523024e-05,0.75
4843,9283,부러지다/Verb,12,3,9,5.5574080248971876e-05,0.00012217063906350652,0.75
4844,9284,찰리채플린/Noun,12,9,3,0.00012226297654773814,5.553210866523024e-05,0.75
4845,9285,나락/Noun,12,3,9,5.5574080248971876e-05,0.00012217063906350652,0.75
4846,9286,로스/Noun,12,9,3,0.00012226297654773814,5.553210866523024e-05,0.75
4847,9287,풍운/Noun,12,3,9,5.5574080248971876e-05,0.00012217063906350652,0.75
4848,9288,일종/Noun,12,3,9,5.5574080248971876e-05,0.00012217063906350652,0.75
4849,9289,저딴/Modifier,12,3,9,5.5574080248971876e-05,0.00012217063906350652,0.75
4850,9290,생기지/Noun,12,3,9,5.5574080248971876e-05,0.00012217063906350652,0.75
4851,9291,~~~!!!/Punctuation,12,9,3,0.00012226297654773814,5.553210866523024e-05,0.75
4852,9292,크리스천/Noun,12,9,3,0.00012226297654773814,5.553210866523024e-05,0.75
4853,9293,10초/Number,12,3,9,5.5574080248971876e-05,0.00012217063906350652,0.75
4854,9294,스킬/Noun,12,3,9,5.5574080248971876e-05,0.00012217063906350652,0.75
4855,9295,노노/Noun,12,3,9,5.5574080248971876e-05,0.00012217063906350652,0.75
4856,9296,에프/Noun,12,9,3,0.00012226297654773814,5.553210866523024e-05,0.75
4857,9297,조보아/Noun,12,9,3,0.00012226297654773814,5.553210866523024e-05,0.75
4858,9298,교실/Noun,12,9,3,0.00012226297654773814,5.553210866523024e-05,0.75
4859,9299,만회/Noun,12,3,9,5.5574080248971876e-05,0.00012217063906350652,0.75
4860,9300,구먼/Noun,12,3,9,5.5574080248971876e-05,0.00012217063906350652,0.75
4861,9301,서막/Noun,12,9,3,0.00012226297654773814,5.553210866523024e-05,0.75
4862,9302,선진국/Noun,12,9,3,0.00012226297654773814,5.553210866523024e-05,0.75
4863,9303,전의/Foreign,12,9,3,0.00012226297654773814,5.553210866523024e-05,0.75
4864,9304,올린다/Noun,12,9,3,0.00012226297654773814,5.553210866523024e-05,0.75
4865,9305,천만다행/Noun,12,3,9,5.5574080248971876e-05,0.00012217063906350652,0.75
4866,9306,오연서/Noun,12,9,3,0.00012226297654773814,5.553210866523024e-05,0.75
4867,9307,입문/Noun,12,9,3,0.00012226297654773814,5.553210866523024e-05,0.75
4868,9308,가죽/Noun,12,3,9,5.5574080248971876e-05,0.00012217063906350652,0.75
4869,9309,인제/Noun,12,3,9,5.5574080248971876e-05,0.00012217063906350652,0.75
4870,9310,류현경/Noun,12,9,3,0.00012226297654773814,5.553210866523024e-05,0.75
4871,9311,4시간/Number,12,9,3,0.00012226297654773814,5.553210866523024e-05,0.75
4872,9312,논스톱/Noun,12,9,3,0.00012226297654773814,5.553210866523024e-05,0.75
4873,9313,작일/Noun,12,3,9,5.5574080248971876e-05,0.00012217063906350652,0.75
4874,9314,007시/Number,12,9,3,0.00012226297654773814,5.553210866523024e-05,0.75
4875,9315,전태일/Noun,12,9,3,0.00012226297654773814,5.553210866523024e-05,0.75
4876,9316,원수/Noun,12,3,9,5.5574080248971876e-05,0.00012217063906350652,0.75
4877,9317,눈동자/Noun,12,9,3,0.00012226297654773814,5.553210866523024e-05,0.75
4878,9318,심취/Noun,12,8,4,0.00011114816049794375,6.663853039827628e-05,0.6666666666666666
4879,9319,리플리/Noun,12,8,4,0.00011114816049794375,6.663853039827628e-05,0.6666666666666666
4880,9320,안내상/Noun,12,4,8,6.668889629876625e-05,0.00011106421733046048,0.6666666666666666
4881,9321,글로리아/Noun,12,8,4,0.00011114816049794375,6.663853039827628e-05,0.6666666666666666
4882,9322,만으론/Josa,12,4,8,6.668889629876625e-05,0.00011106421733046048,0.6666666666666666
4883,9323,사적/Noun,12,8,4,0.00011114816049794375,6.663853039827628e-05,0.6666666666666666
4884,9324,격인/Noun,12,4,8,6.668889629876625e-05,0.00011106421733046048,0.6666666666666666
4885,9325,입증/Noun,12,4,8,6.668889629876625e-05,0.00011106421733046048,0.6666666666666666
4886,9326,케인/Noun,12,8,4,0.00011114816049794375,6.663853039827628e-05,0.6666666666666666
4887,9327,시크릿/Noun,12,8,4,0.00011114816049794375,6.663853039827628e-05,0.6666666666666666
4888,9328,미라/Noun,12,4,8,6.668889629876625e-05,0.00011106421733046048,0.6666666666666666
4889,9329,퍼레이드/Noun,12,4,8,6.668889629876625e-05,0.00011106421733046048,0.6666666666666666
4890,9330,아이콘/Noun,12,4,8,6.668889629876625e-05,0.00011106421733046048,0.6666666666666666
4891,9331,처럼/Foreign,12,4,8,6.668889629876625e-05,0.00011106421733046048,0.6666666666666666
4892,9332,필자/Noun,12,4,8,6.668889629876625e-05,0.00011106421733046048,0.6666666666666666
4893,9333,우결/Noun,12,4,8,6.668889629876625e-05,0.00011106421733046048,0.6666666666666666
4894,9334,어떨/Modifier,12,8,4,0.00011114816049794375,6.663853039827628e-05,0.6666666666666666
4895,9335,아마존/Noun,12,8,4,0.00011114816049794375,6.663853039827628e-05,0.6666666666666666
4896,9336,다다르다/Verb,12,8,4,0.00011114816049794375,6.663853039827628e-05,0.6666666666666666
4897,9337,갖은/Noun,12,4,8,6.668889629876625e-05,0.00011106421733046048,0.6666666666666666
4898,9338,전생/Noun,12,8,4,0.00011114816049794375,6.663853039827628e-05,0.6666666666666666
4899,9339,모차르트/Noun,12,8,4,0.00011114816049794375,6.663853039827628e-05,0.6666666666666666
4900,9340,밀러/Noun,12,8,4,0.00011114816049794375,6.663853039827628e-05,0.6666666666666666
4901,9341,병헌/Noun,12,8,4,0.00011114816049794375,6.663853039827628e-05,0.6666666666666666
4902,9342,미란다/Noun,12,8,4,0.00011114816049794375,6.663853039827628e-05,0.6666666666666666
4903,9343,무지개/Noun,12,8,4,0.00011114816049794375,6.663853039827628e-05,0.6666666666666666
4904,9344,곤충/Noun,12,8,4,0.00011114816049794375,6.663853039827628e-05,0.6666666666666666
4905,9345,부패/Noun,12,8,4,0.00011114816049794375,6.663853039827628e-05,0.6666666666666666
4906,9346,대를/Foreign,12,8,4,0.00011114816049794375,6.663853039827628e-05,0.6666666666666666
4907,9347,진영/Noun,12,8,4,0.00011114816049794375,6.663853039827628e-05,0.6666666666666666
4908,9348,못난이/Noun,12,8,4,0.00011114816049794375,6.663853039827628e-05,0.6666666666666666
4909,9349,앤디/Noun,12,8,4,0.00011114816049794375,6.663853039827628e-05,0.6666666666666666
4910,9350,설원/Noun,12,8,4,0.00011114816049794375,6.663853039827628e-05,0.6666666666666666
4911,9351,뒷맛/Noun,12,4,8,6.668889629876625e-05,0.00011106421733046048,0.6666666666666666
4912,9352,맘껏/Noun,12,8,4,0.00011114816049794375,6.663853039827628e-05,0.6666666666666666
4913,9353,리틀/Noun,12,8,4,0.00011114816049794375,6.663853039827628e-05,0.6666666666666666
4914,9354,할로윈/Noun,12,4,8,6.668889629876625e-05,0.00011106421733046048,0.6666666666666666
4915,9355,여장/Noun,12,4,8,6.668889629876625e-05,0.00011106421733046048,0.6666666666666666
4916,9356,너머/Noun,12,8,4,0.00011114816049794375,6.663853039827628e-05,0.6666666666666666
4917,9357,되다/Adjective,12,4,8,6.668889629876625e-05,0.00011106421733046048,0.6666666666666666
4918,9358,우리엄마/Noun,12,8,4,0.00011114816049794375,6.663853039827628e-05,0.6666666666666666
4919,9359,임원희/Noun,12,4,8,6.668889629876625e-05,0.00011106421733046048,0.6666666666666666
4920,9360,흥얼거리다/Verb,12,8,4,0.00011114816049794375,6.663853039827628e-05,0.6666666666666666
4921,9361,자이언트/Noun,12,8,4,0.00011114816049794375,6.663853039827628e-05,0.6666666666666666
4922,9362,ㄱㄱㄱ/KoreanParticle,12,4,8,6.668889629876625e-05,0.00011106421733046048,0.6666666666666666
4923,9363,박근혜/Noun,12,8,4,0.00011114816049794375,6.663853039827628e-05,0.6666666666666666
4924,9364,버러지/Noun,12,4,8,6.668889629876625e-05,0.00011106421733046048,0.6666666666666666
4925,9365,특이/Noun,12,8,4,0.00011114816049794375,6.663853039827628e-05,0.6666666666666666
4926,9366,부서지다/Verb,12,4,8,6.668889629876625e-05,0.00011106421733046048,0.6666666666666666
4927,9367,우스/Noun,12,4,8,6.668889629876625e-05,0.00011106421733046048,0.6666666666666666
4928,9368,컬트영화/Noun,12,8,4,0.00011114816049794375,6.663853039827628e-05,0.6666666666666666
4929,9369,대견하다/Adjective,12,4,8,6.668889629876625e-05,0.00011106421733046048,0.6666666666666666
4930,9370,조의/Noun,12,8,4,0.00011114816049794375,6.663853039827628e-05,0.6666666666666666
4931,9371,파란/Noun,12,8,4,0.00011114816049794375,6.663853039827628e-05,0.6666666666666666
4932,9372,닐슨/Noun,12,8,4,0.00011114816049794375,6.663853039827628e-05,0.6666666666666666
4933,9373,인조/Noun,12,4,8,6.668889629876625e-05,0.00011106421733046048,0.6666666666666666
4934,9374,렌스/Noun,12,8,4,0.00011114816049794375,6.663853039827628e-05,0.6666666666666666
4935,9375,넬/Noun,12,8,4,0.00011114816049794375,6.663853039827628e-05,0.6666666666666666
4936,9376,모하/Noun,12,4,8,6.668889629876625e-05,0.00011106421733046048,0.6666666666666666
4937,9377,과장하다/Adjective,12,4,8,6.668889629876625e-05,0.00011106421733046048,0.6666666666666666
4938,9378,재결합/Noun,12,4,8,6.668889629876625e-05,0.00011106421733046048,0.6666666666666666
4939,9379,셜록/Noun,12,8,4,0.00011114816049794375,6.663853039827628e-05,0.6666666666666666
4940,9380,잡혀가다/Verb,12,4,8,6.668889629876625e-05,0.00011106421733046048,0.6666666666666666
4941,9381,각도/Noun,12,4,8,6.668889629876625e-05,0.00011106421733046048,0.6666666666666666
4942,9382,티아라/Noun,12,4,8,6.668889629876625e-05,0.00011106421733046048,0.6666666666666666
4943,9383,행성/Noun,12,4,8,6.668889629876625e-05,0.00011106421733046048,0.6666666666666666
4944,9384,런던/Noun,12,8,4,0.00011114816049794375,6.663853039827628e-05,0.6666666666666666
4945,9385,미노/Noun,12,4,8,6.668889629876625e-05,0.00011106421733046048,0.6666666666666666
4946,9386,미켈슨/Noun,12,8,4,0.00011114816049794375,6.663853039827628e-05,0.6666666666666666
4947,9387,사로잡히다/Verb,12,4,8,6.668889629876625e-05,0.00011106421733046048,0.6666666666666666
4948,9388,도자기/Noun,12,4,8,6.668889629876625e-05,0.00011106421733046048,0.6666666666666666
4949,9389,기와/Noun,12,8,4,0.00011114816049794375,6.663853039827628e-05,0.6666666666666666
4950,9390,홀리/Noun,12,4,8,6.668889629876625e-05,0.00011106421733046048,0.6666666666666666
4951,9391,솟다/Verb,12,8,4,0.00011114816049794375,6.663853039827628e-05,0.6666666666666666
4952,9392,일말/Noun,12,4,8,6.668889629876625e-05,0.00011106421733046048,0.6666666666666666
4953,9393,일부분/Noun,12,8,4,0.00011114816049794375,6.663853039827628e-05,0.6666666666666666
4954,9394,간호사/Noun,12,8,4,0.00011114816049794375,6.663853039827628e-05,0.6666666666666666
4955,9395,사촌동생/Noun,12,4,8,6.668889629876625e-05,0.00011106421733046048,0.6666666666666666
4956,9396,히히히/Noun,12,4,8,6.668889629876625e-05,0.00011106421733046048,0.6666666666666666
4957,9397,드뎌/Noun,12,8,4,0.00011114816049794375,6.663853039827628e-05,0.6666666666666666
4958,9398,문장/Noun,12,4,8,6.668889629876625e-05,0.00011106421733046048,0.6666666666666666
4959,9399,한껏/Adverb,12,8,4,0.00011114816049794375,6.663853039827628e-05,0.6666666666666666
4960,9400,33/Number,12,4,8,6.668889629876625e-05,0.00011106421733046048,0.6666666666666666
4961,9401,이주승/Noun,12,8,4,0.00011114816049794375,6.663853039827628e-05,0.6666666666666666
4962,9402,전병/Noun,12,4,8,6.668889629876625e-05,0.00011106421733046048,0.6666666666666666
4963,9403,스텔론/Noun,12,8,4,0.00011114816049794375,6.663853039827628e-05,0.6666666666666666
4964,9404,나리/Noun,12,4,8,6.668889629876625e-05,0.00011106421733046048,0.6666666666666666
4965,9405,종료/Noun,12,4,8,6.668889629876625e-05,0.00011106421733046048,0.6666666666666666
4966,9406,소나기/Noun,12,8,4,0.00011114816049794375,6.663853039827628e-05,0.6666666666666666
4967,9407,명과/Noun,12,8,4,0.00011114816049794375,6.663853039827628e-05,0.6666666666666666
4968,9408,기함/Noun,12,4,8,6.668889629876625e-05,0.00011106421733046048,0.6666666666666666
4969,9409,가세/Noun,12,4,8,6.668889629876625e-05,0.00011106421733046048,0.6666666666666666
4970,9410,다이아몬드/Noun,12,8,4,0.00011114816049794375,6.663853039827628e-05,0.6666666666666666
4971,9411,양쪽/Noun,12,4,8,6.668889629876625e-05,0.00011106421733046048,0.6666666666666666
4972,9412,히데/Noun,12,4,8,6.668889629876625e-05,0.00011106421733046048,0.6666666666666666
4973,9413,남궁민/Noun,12,8,4,0.00011114816049794375,6.663853039827628e-05,0.6666666666666666
4974,9414,김지영/Noun,12,4,8,6.668889629876625e-05,0.00011106421733046048,0.6666666666666666
4975,9415,주더/Noun,12,4,8,6.668889629876625e-05,0.00011106421733046048,0.6666666666666666
4976,9416,팔레스타인/Noun,12,8,4,0.00011114816049794375,6.663853039827628e-05,0.6666666666666666
4977,9417,필연/Noun,12,8,4,0.00011114816049794375,6.663853039827628e-05,0.6666666666666666
4978,9418,순풍/Noun,12,8,4,0.00011114816049794375,6.663853039827628e-05,0.6666666666666666
4979,9419,이중성/Noun,12,4,8,6.668889629876625e-05,0.00011106421733046048,0.6666666666666666
4980,9420,강박/Noun,12,4,8,6.668889629876625e-05,0.00011106421733046048,0.6666666666666666
4981,9421,트리오/Noun,12,8,4,0.00011114816049794375,6.663853039827628e-05,0.6666666666666666
4982,9422,엠버/Noun,12,4,8,6.668889629876625e-05,0.00011106421733046048,0.6666666666666666
4983,9423,유독/Noun,12,4,8,6.668889629876625e-05,0.00011106421733046048,0.6666666666666666
4984,9424,색즉시공/Noun,12,4,8,6.668889629876625e-05,0.00011106421733046048,0.6666666666666666
4985,9594,쨔응/Noun,11,11,0,0.0001444926086473269,2.2212843466092093e-05,1.0
4986,9595,깝깝/Noun,11,0,11,2.2229632099588756e-05,0.0001443834825295986,1.0
4987,9596,고은아/Noun,11,0,11,2.2229632099588756e-05,0.0001443834825295986,1.0
4988,9597,애하/Noun,11,0,11,2.2229632099588756e-05,0.0001443834825295986,1.0
4989,9598,폭도/Noun,11,0,11,2.2229632099588756e-05,0.0001443834825295986,1.0
4990,9599,티남/Noun,11,0,11,2.2229632099588756e-05,0.0001443834825295986,1.0
4991,9600,찍지마라/Noun,11,0,11,2.2229632099588756e-05,0.0001443834825295986,1.0
4992,9601,아하/Exclamation,11,0,11,2.2229632099588756e-05,0.0001443834825295986,1.0
4993,9602,500/Number,11,0,11,2.2229632099588756e-05,0.0001443834825295986,1.0
4994,9603,청소년기/Noun,11,11,0,0.0001444926086473269,2.2212843466092093e-05,1.0
4995,9604,손은서/Noun,11,0,11,2.2229632099588756e-05,0.0001443834825295986,1.0
4996,9605,유사/Noun,11,0,11,2.2229632099588756e-05,0.0001443834825295986,1.0
4997,9606,울화통/Noun,11,0,11,2.2229632099588756e-05,0.0001443834825295986,1.0
4998,9607,부릉부릉/Adverb,11,0,11,2.2229632099588756e-05,0.0001443834825295986,1.0
4999,9608,편파/Noun,11,0,11,2.2229632099588756e-05,0.0001443834825295986,1.0
5000,9609,과욕/Noun,11,0,11,2.2229632099588756e-05,0.0001443834825295986,1.0
5001,9610,싱그럽다/Adjective,11,11,0,0.0001444926086473269,2.2212843466092093e-05,1.0
5002,9611,탈세/Noun,11,0,11,2.2229632099588756e-05,0.0001443834825295986,1.0
5003,9612,까비/Noun,11,0,11,2.2229632099588756e-05,0.0001443834825295986,1.0
5004,9613,추기경/Noun,11,11,0,0.0001444926086473269,2.2212843466092093e-05,1.0
5005,9614,휴식/Noun,11,11,0,0.0001444926086473269,2.2212843466092093e-05,1.0
5006,9615,배종옥/Noun,11,11,0,0.0001444926086473269,2.2212843466092093e-05,1.0
5007,9616,노랑/Noun,11,0,11,2.2229632099588756e-05,0.0001443834825295986,1.0
5008,9617,말좀/Noun,11,0,11,2.2229632099588756e-05,0.0001443834825295986,1.0
5009,9618,후광/Noun,11,0,11,2.2229632099588756e-05,0.0001443834825295986,1.0
5010,9619,복수초/Noun,11,0,11,2.2229632099588756e-05,0.0001443834825295986,1.0
5011,9620,ㅠㅠㅜ/KoreanParticle,11,11,0,0.0001444926086473269,2.2212843466092093e-05,1.0
5012,9621,아나킨/Noun,11,11,0,0.0001444926086473269,2.2212843466092093e-05,1.0
5013,9622,윌슨/Noun,11,11,0,0.0001444926086473269,2.2212843466092093e-05,1.0
5014,9623,별루임/Noun,11,0,11,2.2229632099588756e-05,0.0001443834825295986,1.0
5015,9624,짱짱걸/Noun,11,10,1,0.0001333777925975325,3.331926519913814e-05,0.9090909090909092
5016,9625,벤허/Noun,11,10,1,0.0001333777925975325,3.331926519913814e-05,0.9090909090909092
5017,9626,애매/Noun,11,1,10,3.334444814938313e-05,0.00013327706079655256,0.9090909090909092
5018,9627,울트라/Noun,11,1,10,3.334444814938313e-05,0.00013327706079655256,0.9090909090909092
5019,9628,오바이트/Noun,11,1,10,3.334444814938313e-05,0.00013327706079655256,0.9090909090909092
5020,9629,구토/Noun,11,1,10,3.334444814938313e-05,0.00013327706079655256,0.9090909090909092
5021,9630,갓파더/Noun,11,1,10,3.334444814938313e-05,0.00013327706079655256,0.9090909090909092
5022,9631,덱스터/Noun,11,10,1,0.0001333777925975325,3.331926519913814e-05,0.9090909090909092
5023,9632,페미/Noun,11,1,10,3.334444814938313e-05,0.00013327706079655256,0.9090909090909092
5024,9633,4천원/Number,11,1,10,3.334444814938313e-05,0.00013327706079655256,0.9090909090909092
5025,9634,입담/Noun,11,10,1,0.0001333777925975325,3.331926519913814e-05,0.9090909090909092
5026,9635,알라딘/Noun,11,10,1,0.0001333777925975325,3.331926519913814e-05,0.9090909090909092
5027,9636,감금/Noun,11,1,10,3.334444814938313e-05,0.00013327706079655256,0.9090909090909092
5028,9637,수신료/Noun,11,1,10,3.334444814938313e-05,0.00013327706079655256,0.9090909090909092
5029,9638,소모/Noun,11,1,10,3.334444814938313e-05,0.00013327706079655256,0.9090909090909092
5030,9639,없슴/Noun,11,1,10,3.334444814938313e-05,0.00013327706079655256,0.9090909090909092
5031,9640,프로파간다/Noun,11,1,10,3.334444814938313e-05,0.00013327706079655256,0.9090909090909092
5032,9641,다이빙/Noun,11,1,10,3.334444814938313e-05,0.00013327706079655256,0.9090909090909092
5033,9642,유물/Noun,11,1,10,3.334444814938313e-05,0.00013327706079655256,0.9090909090909092
5034,9643,、/Foreign,11,10,1,0.0001333777925975325,3.331926519913814e-05,0.9090909090909092
5035,9644,먹듯/Noun,11,1,10,3.334444814938313e-05,0.00013327706079655256,0.9090909090909092
5036,9645,고역/Noun,11,1,10,3.334444814938313e-05,0.00013327706079655256,0.9090909090909092
5037,9646,개폼/Noun,11,1,10,3.334444814938313e-05,0.00013327706079655256,0.9090909090909092
5038,9647,골다/Verb,11,1,10,3.334444814938313e-05,0.00013327706079655256,0.9090909090909092
5039,9648,워터/Noun,11,1,10,3.334444814938313e-05,0.00013327706079655256,0.9090909090909092
5040,9649,world/Alpha,11,10,1,0.0001333777925975325,3.331926519913814e-05,0.9090909090909092
5041,9650,석양/Noun,11,10,1,0.0001333777925975325,3.331926519913814e-05,0.9090909090909092
5042,9651,이지현/Noun,11,1,10,3.334444814938313e-05,0.00013327706079655256,0.9090909090909092
5043,9652,징징거리다/Adjective,11,1,10,3.334444814938313e-05,0.00013327706079655256,0.9090909090909092
5044,9653,비키니/Noun,11,1,10,3.334444814938313e-05,0.00013327706079655256,0.9090909090909092
5045,9654,답시고/Noun,11,1,10,3.334444814938313e-05,0.00013327706079655256,0.9090909090909092
5046,9655,(-/Punctuation,11,1,10,3.334444814938313e-05,0.00013327706079655256,0.9090909090909092
5047,9656,압니/Noun,11,10,1,0.0001333777925975325,3.331926519913814e-05,0.9090909090909092
5048,9657,OTL/Alpha,11,1,10,3.334444814938313e-05,0.00013327706079655256,0.9090909090909092
5049,9658,퉁/Noun,11,1,10,3.334444814938313e-05,0.00013327706079655256,0.9090909090909092
5050,9659,오지호/Noun,11,1,10,3.334444814938313e-05,0.00013327706079655256,0.9090909090909092
5051,9660,KTX/Alpha,11,1,10,3.334444814938313e-05,0.00013327706079655256,0.9090909090909092
5052,9661,동행/Noun,11,10,1,0.0001333777925975325,3.331926519913814e-05,0.9090909090909092
5053,9662,8~9/Number,11,10,1,0.0001333777925975325,3.331926519913814e-05,0.9090909090909092
5054,9663,게이물/Noun,11,1,10,3.334444814938313e-05,0.00013327706079655256,0.9090909090909092
5055,9664,오분/Noun,11,1,10,3.334444814938313e-05,0.00013327706079655256,0.9090909090909092
5056,9665,개망/Noun,11,1,10,3.334444814938313e-05,0.00013327706079655256,0.9090909090909092
5057,9666,극화/Noun,11,1,10,3.334444814938313e-05,0.00013327706079655256,0.9090909090909092
5058,9667,킬러조/Noun,11,1,10,3.334444814938313e-05,0.00013327706079655256,0.9090909090909092
5059,9668,마음껏/Noun,11,10,1,0.0001333777925975325,3.331926519913814e-05,0.9090909090909092
5060,9669,팔고/Noun,11,1,10,3.334444814938313e-05,0.00013327706079655256,0.9090909090909092
5061,9670,OUT/Alpha,11,1,10,3.334444814938313e-05,0.00013327706079655256,0.9090909090909092
5062,9671,제안/Noun,11,1,10,3.334444814938313e-05,0.00013327706079655256,0.9090909090909092
5063,9672,착신아리/Noun,11,1,10,3.334444814938313e-05,0.00013327706079655256,0.9090909090909092
5064,9673,다스베이더/Noun,11,10,1,0.0001333777925975325,3.331926519913814e-05,0.9090909090909092
5065,9674,!!!^^/Punctuation,11,10,1,0.0001333777925975325,3.331926519913814e-05,0.9090909090909092
5066,9675,반함/Noun,11,10,1,0.0001333777925975325,3.331926519913814e-05,0.9090909090909092
5067,9676,엇습/Noun,11,10,1,0.0001333777925975325,3.331926519913814e-05,0.9090909090909092
5068,9677,궈/Noun,11,1,10,3.334444814938313e-05,0.00013327706079655256,0.9090909090909092
5069,9678,어릴떄/Noun,11,10,1,0.0001333777925975325,3.331926519913814e-05,0.9090909090909092
5070,9679,퀼리티/Noun,11,1,10,3.334444814938313e-05,0.00013327706079655256,0.9090909090909092
5071,9680,판정/Noun,11,2,9,4.445926419917751e-05,0.00012217063906350652,0.8181818181818182
5072,9681,구사/Noun,11,2,9,4.445926419917751e-05,0.00012217063906350652,0.8181818181818182
5073,9682,가려지다/Verb,11,9,2,0.00012226297654773814,4.4425686932184186e-05,0.8181818181818182
5074,9683,메리다/Noun,11,2,9,4.445926419917751e-05,0.00012217063906350652,0.8181818181818182
5075,9684,비디오테잎/Noun,11,9,2,0.00012226297654773814,4.4425686932184186e-05,0.8181818181818182
5076,9685,관통/Noun,11,9,2,0.00012226297654773814,4.4425686932184186e-05,0.8181818181818182
5077,9686,간지럽다/Adjective,11,2,9,4.445926419917751e-05,0.00012217063906350652,0.8181818181818182
5078,9687,광신도/Noun,11,2,9,4.445926419917751e-05,0.00012217063906350652,0.8181818181818182
5079,9688,34/Number,11,9,2,0.00012226297654773814,4.4425686932184186e-05,0.8181818181818182
5080,9689,윤/Noun,11,9,2,0.00012226297654773814,4.4425686932184186e-05,0.8181818181818182
5081,9690,깡통/Noun,11,2,9,4.445926419917751e-05,0.00012217063906350652,0.8181818181818182
5082,9691,70분/Number,11,2,9,4.445926419917751e-05,0.00012217063906350652,0.8181818181818182
5083,9692,계약/Noun,11,2,9,4.445926419917751e-05,0.00012217063906350652,0.8181818181818182
5084,9693,타락/Noun,11,2,9,4.445926419917751e-05,0.00012217063906350652,0.8181818181818182
5085,9694,분간/Noun,11,2,9,4.445926419917751e-05,0.00012217063906350652,0.8181818181818182
5086,9695,죤나/Noun,11,2,9,4.445926419917751e-05,0.00012217063906350652,0.8181818181818182
5087,9696,민망/Noun,11,2,9,4.445926419917751e-05,0.00012217063906350652,0.8181818181818182
5088,9697,축제/Noun,11,9,2,0.00012226297654773814,4.4425686932184186e-05,0.8181818181818182
5089,9698,방학/Noun,11,9,2,0.00012226297654773814,4.4425686932184186e-05,0.8181818181818182
5090,9699,되찾다/Verb,11,9,2,0.00012226297654773814,4.4425686932184186e-05,0.8181818181818182
5091,9700,음울하다/Adjective,11,9,2,0.00012226297654773814,4.4425686932184186e-05,0.8181818181818182
5092,9701,한주/Noun,11,9,2,0.00012226297654773814,4.4425686932184186e-05,0.8181818181818182
5093,9702,...................../Punctuation,11,2,9,4.445926419917751e-05,0.00012217063906350652,0.8181818181818182
5094,9703,들려오다/Verb,11,9,2,0.00012226297654773814,4.4425686932184186e-05,0.8181818181818182
5095,9704,취소/Noun,11,2,9,4.445926419917751e-05,0.00012217063906350652,0.8181818181818182
5096,9705,린즈링/Noun,11,2,9,4.445926419917751e-05,0.00012217063906350652,0.8181818181818182
5097,9706,동거/Noun,11,2,9,4.445926419917751e-05,0.00012217063906350652,0.8181818181818182
5098,9707,버틀러/Noun,11,9,2,0.00012226297654773814,4.4425686932184186e-05,0.8181818181818182
5099,9708,염병/Noun,11,2,9,4.445926419917751e-05,0.00012217063906350652,0.8181818181818182
5100,9709,80~90년/Number,11,2,9,4.445926419917751e-05,0.00012217063906350652,0.8181818181818182
5101,9710,센터/Noun,11,2,9,4.445926419917751e-05,0.00012217063906350652,0.8181818181818182
5102,9711,관계도/Noun,11,2,9,4.445926419917751e-05,0.00012217063906350652,0.8181818181818182
5103,9712,스탠리/Noun,11,9,2,0.00012226297654773814,4.4425686932184186e-05,0.8181818181818182
5104,9713,선교사/Noun,11,9,2,0.00012226297654773814,4.4425686932184186e-05,0.8181818181818182
5105,9714,양익준/Noun,11,9,2,0.00012226297654773814,4.4425686932184186e-05,0.8181818181818182
5106,9715,무민/Noun,11,9,2,0.00012226297654773814,4.4425686932184186e-05,0.8181818181818182
5107,9716,자지/Noun,11,2,9,4.445926419917751e-05,0.00012217063906350652,0.8181818181818182
5108,9717,go/Alpha,11,9,2,0.00012226297654773814,4.4425686932184186e-05,0.8181818181818182
5109,9718,랑께/Josa,11,2,9,4.445926419917751e-05,0.00012217063906350652,0.8181818181818182
5110,9719,서론/Noun,11,2,9,4.445926419917751e-05,0.00012217063906350652,0.8181818181818182
5111,9720,환각/Noun,11,2,9,4.445926419917751e-05,0.00012217063906350652,0.8181818181818182
5112,9721,미미하다/Adjective,11,2,9,4.445926419917751e-05,0.00012217063906350652,0.8181818181818182
5113,9722,고립/Noun,11,9,2,0.00012226297654773814,4.4425686932184186e-05,0.8181818181818182
5114,9723,저딴/Noun,11,2,9,4.445926419917751e-05,0.00012217063906350652,0.8181818181818182
5115,9724,사발/Noun,11,2,9,4.445926419917751e-05,0.00012217063906350652,0.8181818181818182
5116,9725,바스코/Noun,11,2,9,4.445926419917751e-05,0.00012217063906350652,0.8181818181818182
5117,9726,셰익스피어/Noun,11,9,2,0.00012226297654773814,4.4425686932184186e-05,0.8181818181818182
5118,9727,쿵후/Noun,11,2,9,4.445926419917751e-05,0.00012217063906350652,0.8181818181818182
5119,9728,난해/Noun,11,2,9,4.445926419917751e-05,0.00012217063906350652,0.8181818181818182
5120,9729,바퀴벌레/Noun,11,2,9,4.445926419917751e-05,0.00012217063906350652,0.8181818181818182
5121,9730,know/Alpha,11,9,2,0.00012226297654773814,4.4425686932184186e-05,0.8181818181818182
5122,9731,질렌할/Noun,11,9,2,0.00012226297654773814,4.4425686932184186e-05,0.8181818181818182
5123,9732,리다/Noun,11,2,9,4.445926419917751e-05,0.00012217063906350652,0.8181818181818182
5124,9733,연출가/Noun,11,2,9,4.445926419917751e-05,0.00012217063906350652,0.8181818181818182
5125,9734,호빗/Noun,11,9,2,0.00012226297654773814,4.4425686932184186e-05,0.8181818181818182
5126,9735,의욕/Noun,11,2,9,4.445926419917751e-05,0.00012217063906350652,0.8181818181818182
5127,9736,was/Alpha,11,9,2,0.00012226297654773814,4.4425686932184186e-05,0.8181818181818182
5128,9737,기무라/Noun,11,9,2,0.00012226297654773814,4.4425686932184186e-05,0.8181818181818182
5129,9738,안봣/Noun,11,9,2,0.00012226297654773814,4.4425686932184186e-05,0.8181818181818182
5130,9739,브랜드/Noun,11,9,2,0.00012226297654773814,4.4425686932184186e-05,0.8181818181818182
5131,9740,버킷리스트/Noun,11,9,2,0.00012226297654773814,4.4425686932184186e-05,0.8181818181818182
5132,9741,요인/Noun,11,2,9,4.445926419917751e-05,0.00012217063906350652,0.8181818181818182
5133,9742,"...,/Punctuation",11,2,9,4.445926419917751e-05,0.00012217063906350652,0.8181818181818182
5134,9743,무신론자/Noun,11,2,9,4.445926419917751e-05,0.00012217063906350652,0.8181818181818182
5135,9744,레슬링/Noun,11,2,9,4.445926419917751e-05,0.00012217063906350652,0.8181818181818182
5136,9745,노처녀/Noun,11,2,9,4.445926419917751e-05,0.00012217063906350652,0.8181818181818182
5137,9746,조엘/Noun,11,2,9,4.445926419917751e-05,0.00012217063906350652,0.8181818181818182
5138,9747,無/Foreign,11,2,9,4.445926419917751e-05,0.00012217063906350652,0.8181818181818182
5139,9748,쪽지/Noun,11,9,2,0.00012226297654773814,4.4425686932184186e-05,0.8181818181818182
5140,9749,형용/Noun,11,9,2,0.00012226297654773814,4.4425686932184186e-05,0.8181818181818182
5141,9750,zzz/Alpha,11,2,9,4.445926419917751e-05,0.00012217063906350652,0.8181818181818182
5142,9751,남북/Noun,11,9,2,0.00012226297654773814,4.4425686932184186e-05,0.8181818181818182
5143,9752,왕년/Noun,11,2,9,4.445926419917751e-05,0.00012217063906350652,0.8181818181818182
5144,9753,4월/Number,11,9,2,0.00012226297654773814,4.4425686932184186e-05,0.8181818181818182
5145,9754,댕/Noun,11,2,9,4.445926419917751e-05,0.00012217063906350652,0.8181818181818182
5146,9755,번지르르하다/Adjective,11,2,9,4.445926419917751e-05,0.00012217063906350652,0.8181818181818182
5147,9756,평보/Noun,11,2,9,4.445926419917751e-05,0.00012217063906350652,0.8181818181818182
5148,9757,김원효/Noun,11,2,9,4.445926419917751e-05,0.00012217063906350652,0.8181818181818182
5149,9758,사유/Noun,11,9,2,0.00012226297654773814,4.4425686932184186e-05,0.8181818181818182
5150,9759,행각/Noun,11,2,9,4.445926419917751e-05,0.00012217063906350652,0.8181818181818182
5151,9760,수치심/Noun,11,2,9,4.445926419917751e-05,0.00012217063906350652,0.8181818181818182
5152,9761,욜라/Noun,11,2,9,4.445926419917751e-05,0.00012217063906350652,0.8181818181818182
5153,9762,승희/Noun,11,2,9,4.445926419917751e-05,0.00012217063906350652,0.8181818181818182
5154,9763,오케이/Noun,11,2,9,4.445926419917751e-05,0.00012217063906350652,0.8181818181818182
5155,9764,팬텀/Noun,11,9,2,0.00012226297654773814,4.4425686932184186e-05,0.8181818181818182
5156,9765,하비/Noun,11,9,2,0.00012226297654773814,4.4425686932184186e-05,0.8181818181818182
5157,9766,김성수/Noun,11,2,9,4.445926419917751e-05,0.00012217063906350652,0.8181818181818182
5158,9767,달튼/Noun,11,9,2,0.00012226297654773814,4.4425686932184186e-05,0.8181818181818182
5159,9768,발라/Noun,11,2,9,4.445926419917751e-05,0.00012217063906350652,0.8181818181818182
5160,9769,박준형/Noun,11,2,9,4.445926419917751e-05,0.00012217063906350652,0.8181818181818182
5161,9770,불급/Noun,11,2,9,4.445926419917751e-05,0.00012217063906350652,0.8181818181818182
5162,9771,진지희/Noun,11,2,9,4.445926419917751e-05,0.00012217063906350652,0.8181818181818182
5163,9772,횟수/Noun,11,2,9,4.445926419917751e-05,0.00012217063906350652,0.8181818181818182
5164,9773,악플달다/Verb,11,9,2,0.00012226297654773814,4.4425686932184186e-05,0.8181818181818182
5165,9774,2.2/Number,11,2,9,4.445926419917751e-05,0.00012217063906350652,0.8181818181818182
5166,9775,레젼드/Noun,11,9,2,0.00012226297654773814,4.4425686932184186e-05,0.8181818181818182
5167,9776,김꽃비/Noun,11,2,9,4.445926419917751e-05,0.00012217063906350652,0.8181818181818182
5168,9777,무성의/Noun,11,2,9,4.445926419917751e-05,0.00012217063906350652,0.8181818181818182
5169,9778,일본사람/Noun,11,2,9,4.445926419917751e-05,0.00012217063906350652,0.8181818181818182
5170,9779,r/Alpha,11,3,8,5.5574080248971876e-05,0.00011106421733046048,0.7272727272727273
5171,9780,독고/Noun,11,8,3,0.00011114816049794375,5.553210866523024e-05,0.7272727272727273
5172,9781,나왓으/Noun,11,8,3,0.00011114816049794375,5.553210866523024e-05,0.7272727272727273
5173,9782,바티칸/Noun,11,3,8,5.5574080248971876e-05,0.00011106421733046048,0.7272727272727273
5174,9783,후퇴/Noun,11,3,8,5.5574080248971876e-05,0.00011106421733046048,0.7272727272727273
5175,9784,CD/Alpha,11,8,3,0.00011114816049794375,5.553210866523024e-05,0.7272727272727273
5176,9785,NG/Alpha,11,8,3,0.00011114816049794375,5.553210866523024e-05,0.7272727272727273
5177,9786,".,../Punctuation",11,3,8,5.5574080248971876e-05,0.00011106421733046048,0.7272727272727273
5178,9787,팝핀현준/Noun,11,3,8,5.5574080248971876e-05,0.00011106421733046048,0.7272727272727273
5179,9788,불협화음/Noun,11,3,8,5.5574080248971876e-05,0.00011106421733046048,0.7272727272727273
5180,9789,카터/Noun,11,8,3,0.00011114816049794375,5.553210866523024e-05,0.7272727272727273
5181,9790,뚜껑/Noun,11,3,8,5.5574080248971876e-05,0.00011106421733046048,0.7272727272727273
5182,9791,당사자/Noun,11,8,3,0.00011114816049794375,5.553210866523024e-05,0.7272727272727273
5183,9792,브란도/Noun,11,8,3,0.00011114816049794375,5.553210866523024e-05,0.7272727272727273
5184,9793,에르/Noun,11,8,3,0.00011114816049794375,5.553210866523024e-05,0.7272727272727273
5185,9794,참가/Noun,11,3,8,5.5574080248971876e-05,0.00011106421733046048,0.7272727272727273
5186,9795,승승장구/Noun,11,8,3,0.00011114816049794375,5.553210866523024e-05,0.7272727272727273
5187,9796,딥블루씨/Noun,11,3,8,5.5574080248971876e-05,0.00011106421733046048,0.7272727272727273
5188,9797,변경/Noun,11,3,8,5.5574080248971876e-05,0.00011106421733046048,0.7272727272727273
5189,9798,유효하다/Adjective,11,8,3,0.00011114816049794375,5.553210866523024e-05,0.7272727272727273
5190,9799,고달프다/Adjective,11,8,3,0.00011114816049794375,5.553210866523024e-05,0.7272727272727273
5191,9800,대조/Noun,11,8,3,0.00011114816049794375,5.553210866523024e-05,0.7272727272727273
5192,9801,근친상간/Noun,11,3,8,5.5574080248971876e-05,0.00011106421733046048,0.7272727272727273
5193,9802,충전/Noun,11,3,8,5.5574080248971876e-05,0.00011106421733046048,0.7272727272727273
5194,9803,추리물/Noun,11,3,8,5.5574080248971876e-05,0.00011106421733046048,0.7272727272727273
5195,9804,지오/Noun,11,8,3,0.00011114816049794375,5.553210866523024e-05,0.7272727272727273
5196,9805,들것/Noun,11,3,8,5.5574080248971876e-05,0.00011106421733046048,0.7272727272727273
5197,9806,근처/Noun,11,8,3,0.00011114816049794375,5.553210866523024e-05,0.7272727272727273
5198,9807,쉬리/Noun,11,3,8,5.5574080248971876e-05,0.00011106421733046048,0.7272727272727273
5199,9808,건너다/Verb,11,3,8,5.5574080248971876e-05,0.00011106421733046048,0.7272727272727273
5200,9809,로리타/Noun,11,3,8,5.5574080248971876e-05,0.00011106421733046048,0.7272727272727273
5201,9810,감방/Noun,11,3,8,5.5574080248971876e-05,0.00011106421733046048,0.7272727272727273
5202,9811,쑈/Noun,11,3,8,5.5574080248971876e-05,0.00011106421733046048,0.7272727272727273
5203,9812,피라미드/Noun,11,3,8,5.5574080248971876e-05,0.00011106421733046048,0.7272727272727273
5204,9813,마사미/Noun,11,8,3,0.00011114816049794375,5.553210866523024e-05,0.7272727272727273
5205,9814,개차반/Noun,11,3,8,5.5574080248971876e-05,0.00011106421733046048,0.7272727272727273
5206,9815,하드코어/Noun,11,3,8,5.5574080248971876e-05,0.00011106421733046048,0.7272727272727273
5207,9816,계몽/Noun,11,8,3,0.00011114816049794375,5.553210866523024e-05,0.7272727272727273
5208,9817,고구마/Noun,11,8,3,0.00011114816049794375,5.553210866523024e-05,0.7272727272727273
5209,9818,뭐길/Noun,11,3,8,5.5574080248971876e-05,0.00011106421733046048,0.7272727272727273
5210,9819,왓츠/Noun,11,8,3,0.00011114816049794375,5.553210866523024e-05,0.7272727272727273
5211,9820,꿀잠/Noun,11,3,8,5.5574080248971876e-05,0.00011106421733046048,0.7272727272727273
5212,9821,경기도/Noun,11,8,3,0.00011114816049794375,5.553210866523024e-05,0.7272727272727273
5213,9822,여분/Noun,11,3,8,5.5574080248971876e-05,0.00011106421733046048,0.7272727272727273
5214,9823,연작/Noun,11,8,3,0.00011114816049794375,5.553210866523024e-05,0.7272727272727273
5215,9824,전인/Noun,11,8,3,0.00011114816049794375,5.553210866523024e-05,0.7272727272727273
5216,9825,수첩/Noun,11,3,8,5.5574080248971876e-05,0.00011106421733046048,0.7272727272727273
5217,9826,려원/Noun,11,8,3,0.00011114816049794375,5.553210866523024e-05,0.7272727272727273
5218,9827,나이틀리/Noun,11,8,3,0.00011114816049794375,5.553210866523024e-05,0.7272727272727273
5219,9828,외침/Noun,11,8,3,0.00011114816049794375,5.553210866523024e-05,0.7272727272727273
5220,9829,시력/Noun,11,3,8,5.5574080248971876e-05,0.00011106421733046048,0.7272727272727273
5221,9830,밀고/Noun,11,3,8,5.5574080248971876e-05,0.00011106421733046048,0.7272727272727273
5222,9831,졸지/Noun,11,3,8,5.5574080248971876e-05,0.00011106421733046048,0.7272727272727273
5223,9832,패틴슨/Noun,11,3,8,5.5574080248971876e-05,0.00011106421733046048,0.7272727272727273
5224,9833,영국영화/Noun,11,8,3,0.00011114816049794375,5.553210866523024e-05,0.7272727272727273
5225,9834,이자스민/Noun,11,3,8,5.5574080248971876e-05,0.00011106421733046048,0.7272727272727273
5226,9835,합성/Noun,11,3,8,5.5574080248971876e-05,0.00011106421733046048,0.7272727272727273
5227,9836,대루/Noun,11,3,8,5.5574080248971876e-05,0.00011106421733046048,0.7272727272727273
5228,9837,뿜었다/Noun,11,3,8,5.5574080248971876e-05,0.00011106421733046048,0.7272727272727273
5229,9838,뻣뻣하다/Adjective,11,3,8,5.5574080248971876e-05,0.00011106421733046048,0.7272727272727273
5230,9839,각시탈/Noun,11,8,3,0.00011114816049794375,5.553210866523024e-05,0.7272727272727273
5231,9840,500원/Number,11,3,8,5.5574080248971876e-05,0.00011106421733046048,0.7272727272727273
5232,9841,하염없이/Adverb,11,8,3,0.00011114816049794375,5.553210866523024e-05,0.7272727272727273
5233,9842,이태임/Noun,11,3,8,5.5574080248971876e-05,0.00011106421733046048,0.7272727272727273
5234,9843,엽/Noun,11,8,3,0.00011114816049794375,5.553210866523024e-05,0.7272727272727273
5235,9844,박은혜/Noun,11,3,8,5.5574080248971876e-05,0.00011106421733046048,0.7272727272727273
5236,9845,상하/Noun,11,3,8,5.5574080248971876e-05,0.00011106421733046048,0.7272727272727273
5237,9846,This/Alpha,11,8,3,0.00011114816049794375,5.553210866523024e-05,0.7272727272727273
5238,9847,히로스에/Noun,11,3,8,5.5574080248971876e-05,0.00011106421733046048,0.7272727272727273
5239,9848,양은/Noun,11,3,8,5.5574080248971876e-05,0.00011106421733046048,0.7272727272727273
5240,9849,자서전/Noun,11,3,8,5.5574080248971876e-05,0.00011106421733046048,0.7272727272727273
5241,9850,고이/Noun,11,3,8,5.5574080248971876e-05,0.00011106421733046048,0.7272727272727273
5242,9851,콱/Noun,11,3,8,5.5574080248971876e-05,0.00011106421733046048,0.7272727272727273
5243,9852,이중인격/Noun,11,3,8,5.5574080248971876e-05,0.00011106421733046048,0.7272727272727273
5244,9853,허공/Noun,11,3,8,5.5574080248971876e-05,0.00011106421733046048,0.7272727272727273
5245,9854,임요환/Noun,11,3,8,5.5574080248971876e-05,0.00011106421733046048,0.7272727272727273
5246,9855,스리/Noun,11,8,3,0.00011114816049794375,5.553210866523024e-05,0.7272727272727273
5247,9856,가레스/Noun,11,3,8,5.5574080248971876e-05,0.00011106421733046048,0.7272727272727273
5248,9857,트렁크/Noun,11,3,8,5.5574080248971876e-05,0.00011106421733046048,0.7272727272727273
5249,9858,골든타임/Noun,11,3,8,5.5574080248971876e-05,0.00011106421733046048,0.7272727272727273
5250,9859,얼간이/Noun,11,3,8,5.5574080248971876e-05,0.00011106421733046048,0.7272727272727273
5251,9860,씩/Foreign,11,3,8,5.5574080248971876e-05,0.00011106421733046048,0.7272727272727273
5252,9861,섭섭하다/Adjective,11,8,3,0.00011114816049794375,5.553210866523024e-05,0.7272727272727273
5253,9862,여타/Noun,11,8,3,0.00011114816049794375,5.553210866523024e-05,0.7272727272727273
5254,9863,효율/Noun,11,3,8,5.5574080248971876e-05,0.00011106421733046048,0.7272727272727273
5255,9864,미처/Noun,11,8,3,0.00011114816049794375,5.553210866523024e-05,0.7272727272727273
5256,9865,하울/Noun,11,8,3,0.00011114816049794375,5.553210866523024e-05,0.7272727272727273
5257,9866,애처롭다/Adjective,11,8,3,0.00011114816049794375,5.553210866523024e-05,0.7272727272727273
5258,9867,꼬띠/Noun,11,8,3,0.00011114816049794375,5.553210866523024e-05,0.7272727272727273
5259,9868,숭배/Noun,11,3,8,5.5574080248971876e-05,0.00011106421733046048,0.7272727272727273
5260,9869,비키/Noun,11,3,8,5.5574080248971876e-05,0.00011106421733046048,0.7272727272727273
5261,9870,꾼/Noun,11,8,3,0.00011114816049794375,5.553210866523024e-05,0.7272727272727273
5262,9871,열망/Noun,11,8,3,0.00011114816049794375,5.553210866523024e-05,0.7272727272727273
5263,9872,추적자/Noun,11,8,3,0.00011114816049794375,5.553210866523024e-05,0.7272727272727273
5264,9873,또래/Noun,11,8,3,0.00011114816049794375,5.553210866523024e-05,0.7272727272727273
5265,9874,원장/Noun,11,3,8,5.5574080248971876e-05,0.00011106421733046048,0.7272727272727273
5266,9875,빙/Noun,11,3,8,5.5574080248971876e-05,0.00011106421733046048,0.7272727272727273
5267,9876,지식인/Noun,11,8,3,0.00011114816049794375,5.553210866523024e-05,0.7272727272727273
5268,9877,정수/Noun,11,8,3,0.00011114816049794375,5.553210866523024e-05,0.7272727272727273
5269,9878,미치광이/Noun,11,3,8,5.5574080248971876e-05,0.00011106421733046048,0.7272727272727273
5270,9879,쵸/VerbPrefix,11,8,3,0.00011114816049794375,5.553210866523024e-05,0.7272727272727273
5271,9880,화끈/Noun,11,8,3,0.00011114816049794375,5.553210866523024e-05,0.7272727272727273
5272,9881,증인/Noun,11,3,8,5.5574080248971876e-05,0.00011106421733046048,0.7272727272727273
5273,9882,악순환/Noun,11,8,3,0.00011114816049794375,5.553210866523024e-05,0.7272727272727273
5274,9883,최상급/Noun,11,8,3,0.00011114816049794375,5.553210866523024e-05,0.7272727272727273
5275,9884,유주/Noun,11,8,3,0.00011114816049794375,5.553210866523024e-05,0.7272727272727273
5276,9885,이제일/Noun,11,8,3,0.00011114816049794375,5.553210866523024e-05,0.7272727272727273
5277,9886,안심/Noun,11,8,3,0.00011114816049794375,5.553210866523024e-05,0.7272727272727273
5278,9887,쿵/Noun,11,8,3,0.00011114816049794375,5.553210866523024e-05,0.7272727272727273
5279,9888,고간/Noun,11,3,8,5.5574080248971876e-05,0.00011106421733046048,0.7272727272727273
5280,9889,김태우/Noun,11,8,3,0.00011114816049794375,5.553210866523024e-05,0.7272727272727273
5281,9890,이종혁/Noun,11,8,3,0.00011114816049794375,5.553210866523024e-05,0.7272727272727273
5282,9891,서른/Modifier,11,8,3,0.00011114816049794375,5.553210866523024e-05,0.7272727272727273
5283,10146,의젖/Noun,10,0,10,2.2229632099588756e-05,0.00013327706079655256,1.0
5284,10147,본전/Noun,10,0,10,2.2229632099588756e-05,0.00013327706079655256,1.0
5285,10148,forever/Alpha,10,10,0,0.0001333777925975325,2.2212843466092093e-05,1.0
5286,10149,로고/Noun,10,0,10,2.2229632099588756e-05,0.00013327706079655256,1.0
5287,10150,정겨운/Noun,10,10,0,0.0001333777925975325,2.2212843466092093e-05,1.0
5288,10151,검증/Noun,10,0,10,2.2229632099588756e-05,0.00013327706079655256,1.0
5289,10152,마틸다/Noun,10,10,0,0.0001333777925975325,2.2212843466092093e-05,1.0
5290,10153,주르륵/Noun,10,10,0,0.0001333777925975325,2.2212843466092093e-05,1.0
5291,10154,쟈니/Noun,10,10,0,0.0001333777925975325,2.2212843466092093e-05,1.0
5292,10155,소나/Noun,10,0,10,2.2229632099588756e-05,0.00013327706079655256,1.0
5293,10156,에스티/Noun,10,10,0,0.0001333777925975325,2.2212843466092093e-05,1.0
5294,10157,trash/Alpha,10,0,10,2.2229632099588756e-05,0.00013327706079655256,1.0
5295,10158,벅차오르다/Adjective,10,10,0,0.0001333777925975325,2.2212843466092093e-05,1.0
5296,10159,증발/Noun,10,0,10,2.2229632099588756e-05,0.00013327706079655256,1.0
5297,10160,제데로/Adverb,10,0,10,2.2229632099588756e-05,0.00013327706079655256,1.0
5298,10161,비디오영화/Noun,10,0,10,2.2229632099588756e-05,0.00013327706079655256,1.0
5299,10162,욱일승천기/Noun,10,0,10,2.2229632099588756e-05,0.00013327706079655256,1.0
5300,10163,베르세르크/Noun,10,10,0,0.0001333777925975325,2.2212843466092093e-05,1.0
5301,10164,미자/Noun,10,10,0,0.0001333777925975325,2.2212843466092093e-05,1.0
5302,10165,숨죽/Noun,10,10,0,0.0001333777925975325,2.2212843466092093e-05,1.0
5303,10166,안재욱/Noun,10,10,0,0.0001333777925975325,2.2212843466092093e-05,1.0
5304,10167,8.0/Number,10,10,0,0.0001333777925975325,2.2212843466092093e-05,1.0
5305,10168,아낌없다/Adjective,10,10,0,0.0001333777925975325,2.2212843466092093e-05,1.0
5306,10169,떡칠/Noun,10,0,10,2.2229632099588756e-05,0.00013327706079655256,1.0
5307,10170,부조화/Noun,10,0,10,2.2229632099588756e-05,0.00013327706079655256,1.0
5308,10171,great/Alpha,10,10,0,0.0001333777925975325,2.2212843466092093e-05,1.0
5309,10172,베끼기/Noun,10,0,10,2.2229632099588756e-05,0.00013327706079655256,1.0
5310,10173,마음씨/Noun,10,10,0,0.0001333777925975325,2.2212843466092093e-05,1.0
5311,10174,송희진/Noun,10,0,10,2.2229632099588756e-05,0.00013327706079655256,1.0
5312,10175,정선희/Noun,10,0,10,2.2229632099588756e-05,0.00013327706079655256,1.0
5313,10176,:-)/Punctuation,10,10,0,0.0001333777925975325,2.2212843466092093e-05,1.0
5314,10177,불체/Noun,10,0,10,2.2229632099588756e-05,0.00013327706079655256,1.0
5315,10178,집기/Noun,10,0,10,2.2229632099588756e-05,0.00013327706079655256,1.0
5316,10179,존멋/Noun,10,10,0,0.0001333777925975325,2.2212843466092093e-05,1.0
5317,10180,♥♥♥♥♥/Foreign,10,10,0,0.0001333777925975325,2.2212843466092093e-05,1.0
5318,10181,~!^^/Punctuation,10,10,0,0.0001333777925975325,2.2212843466092093e-05,1.0
5319,10182,생쇼/Noun,10,0,10,2.2229632099588756e-05,0.00013327706079655256,1.0
5320,10183,이지마/Noun,10,0,10,2.2229632099588756e-05,0.00013327706079655256,1.0
5321,10184,영문/Noun,10,0,10,2.2229632099588756e-05,0.00013327706079655256,1.0
5322,10185,차만/Noun,10,0,10,2.2229632099588756e-05,0.00013327706079655256,1.0
5323,10186,벡터맨/Noun,10,0,10,2.2229632099588756e-05,0.00013327706079655256,1.0
5324,10187,ㅗㅗㅗ/KoreanParticle,10,0,10,2.2229632099588756e-05,0.00013327706079655256,1.0
5325,10188,ㅠㅜㅠ/KoreanParticle,10,10,0,0.0001333777925975325,2.2212843466092093e-05,1.0
5326,10189,윤제균/Noun,10,0,10,2.2229632099588756e-05,0.00013327706079655256,1.0
5327,10190,우연찮/Noun,10,10,0,0.0001333777925975325,2.2212843466092093e-05,1.0
5328,10191,루비/Noun,10,1,9,3.334444814938313e-05,0.00012217063906350652,0.9
5329,10192,안면/Noun,10,1,9,3.334444814938313e-05,0.00012217063906350652,0.9
5330,10193,공사/Noun,10,1,9,3.334444814938313e-05,0.00012217063906350652,0.9
5331,10194,이기만/Noun,10,1,9,3.334444814938313e-05,0.00012217063906350652,0.9
5332,10195,하희라/Noun,10,1,9,3.334444814938313e-05,0.00012217063906350652,0.9
5333,10196,사살/Noun,10,1,9,3.334444814938313e-05,0.00012217063906350652,0.9
5334,10197,차도/Noun,10,1,9,3.334444814938313e-05,0.00012217063906350652,0.9
5335,10198,맘속/Noun,10,9,1,0.00012226297654773814,3.331926519913814e-05,0.9
5336,10199,고삐/Noun,10,1,9,3.334444814938313e-05,0.00012217063906350652,0.9
5337,10200,도용/Noun,10,1,9,3.334444814938313e-05,0.00012217063906350652,0.9
5338,10201,쉴드치다/Verb,10,1,9,3.334444814938313e-05,0.00012217063906350652,0.9
5339,10202,몰살/Noun,10,1,9,3.334444814938313e-05,0.00012217063906350652,0.9
5340,10203,모시/Noun,10,9,1,0.00012226297654773814,3.331926519913814e-05,0.9
5341,10204,이데올로기/Noun,10,9,1,0.00012226297654773814,3.331926519913814e-05,0.9
5342,10205,왈칵/Noun,10,9,1,0.00012226297654773814,3.331926519913814e-05,0.9
5343,10206,박서준/Noun,10,9,1,0.00012226297654773814,3.331926519913814e-05,0.9
5344,10207,익살스럽다/Adjective,10,9,1,0.00012226297654773814,3.331926519913814e-05,0.9
5345,10208,지민/Noun,10,9,1,0.00012226297654773814,3.331926519913814e-05,0.9
5346,10209,기획사/Noun,10,1,9,3.334444814938313e-05,0.00012217063906350652,0.9
5347,10210,대게/Noun,10,9,1,0.00012226297654773814,3.331926519913814e-05,0.9
5348,10211,하향/Noun,10,1,9,3.334444814938313e-05,0.00012217063906350652,0.9
5349,10212,0%/Number,10,1,9,3.334444814938313e-05,0.00012217063906350652,0.9
5350,10213,ㅜㅠㅠ/KoreanParticle,10,9,1,0.00012226297654773814,3.331926519913814e-05,0.9
5351,10214,엠/Noun,10,1,9,3.334444814938313e-05,0.00012217063906350652,0.9
5352,10215,...-_-;/Punctuation,10,1,9,3.334444814938313e-05,0.00012217063906350652,0.9
5353,10216,발단/Noun,10,1,9,3.334444814938313e-05,0.00012217063906350652,0.9
5354,10217,줏대/Noun,10,1,9,3.334444814938313e-05,0.00012217063906350652,0.9
5355,10218,비밥/Noun,10,9,1,0.00012226297654773814,3.331926519913814e-05,0.9
5356,10219,처분/Noun,10,1,9,3.334444814938313e-05,0.00012217063906350652,0.9
5357,10220,통렬/Noun,10,9,1,0.00012226297654773814,3.331926519913814e-05,0.9
5358,10221,지리멸렬하다/Adjective,10,1,9,3.334444814938313e-05,0.00012217063906350652,0.9
5359,10222,^^!/Punctuation,10,9,1,0.00012226297654773814,3.331926519913814e-05,0.9
5360,10223,2~3/Number,10,1,9,3.334444814938313e-05,0.00012217063906350652,0.9
5361,10224,그루지/Noun,10,1,9,3.334444814938313e-05,0.00012217063906350652,0.9
5362,10225,타지/Noun,10,9,1,0.00012226297654773814,3.331926519913814e-05,0.9
5363,10226,추잡/Noun,10,1,9,3.334444814938313e-05,0.00012217063906350652,0.9
5364,10227,사회생활/Noun,10,9,1,0.00012226297654773814,3.331926519913814e-05,0.9
5365,10228,120분/Number,10,1,9,3.334444814938313e-05,0.00012217063906350652,0.9
5366,10229,단서/Noun,10,1,9,3.334444814938313e-05,0.00012217063906350652,0.9
5367,10230,전주/Noun,10,9,1,0.00012226297654773814,3.331926519913814e-05,0.9
5368,10231,캐스퍼/Noun,10,9,1,0.00012226297654773814,3.331926519913814e-05,0.9
5369,10232,구제/Noun,10,1,9,3.334444814938313e-05,0.00012217063906350652,0.9
5370,10233,70%/Number,10,1,9,3.334444814938313e-05,0.00012217063906350652,0.9
5371,10234,처녀/Noun,10,1,9,3.334444814938313e-05,0.00012217063906350652,0.9
5372,10235,조만간/Noun,10,9,1,0.00012226297654773814,3.331926519913814e-05,0.9
5373,10236,장구/Noun,10,1,9,3.334444814938313e-05,0.00012217063906350652,0.9
5374,10237,육성/Noun,10,1,9,3.334444814938313e-05,0.00012217063906350652,0.9
5375,10238,개꿀/Noun,10,9,1,0.00012226297654773814,3.331926519913814e-05,0.9
5376,10239,스톰/Noun,10,1,9,3.334444814938313e-05,0.00012217063906350652,0.9
5377,10240,봣더/Noun,10,1,9,3.334444814938313e-05,0.00012217063906350652,0.9
5378,10241,공략/Noun,10,1,9,3.334444814938313e-05,0.00012217063906350652,0.9
5379,10242,개간/Noun,10,9,1,0.00012226297654773814,3.331926519913814e-05,0.9
5380,10243,딸년/Noun,10,1,9,3.334444814938313e-05,0.00012217063906350652,0.9
5381,10244,러블리/Noun,10,9,1,0.00012226297654773814,3.331926519913814e-05,0.9
5382,10245,구숙정/Noun,10,9,1,0.00012226297654773814,3.331926519913814e-05,0.9
5383,10246,레나/Noun,10,9,1,0.00012226297654773814,3.331926519913814e-05,0.9
5384,10247,자금/Noun,10,1,9,3.334444814938313e-05,0.00012217063906350652,0.9
5385,10248,！/Foreign,10,9,1,0.00012226297654773814,3.331926519913814e-05,0.9
5386,10249,단조/Noun,10,1,9,3.334444814938313e-05,0.00012217063906350652,0.9
5387,10250,결재/Noun,10,1,9,3.334444814938313e-05,0.00012217063906350652,0.9
5388,10251,다작/Noun,10,1,9,3.334444814938313e-05,0.00012217063906350652,0.9
5389,10252,하위/Noun,10,1,9,3.334444814938313e-05,0.00012217063906350652,0.9
5390,10253,메이퀸/Noun,10,9,1,0.00012226297654773814,3.331926519913814e-05,0.9
5391,10254,꿈틀/Noun,10,9,1,0.00012226297654773814,3.331926519913814e-05,0.9
5392,10255,백조/Noun,10,9,1,0.00012226297654773814,3.331926519913814e-05,0.9
5393,10256,존엄/Noun,10,9,1,0.00012226297654773814,3.331926519913814e-05,0.9
5394,10257,은지원/Noun,10,2,8,4.445926419917751e-05,0.00011106421733046048,0.8
5395,10258,대응/Noun,10,2,8,4.445926419917751e-05,0.00011106421733046048,0.8
5396,10259,성숙/Noun,10,8,2,0.00011114816049794375,4.4425686932184186e-05,0.8
5397,10260,키도/Noun,10,2,8,4.445926419917751e-05,0.00011106421733046048,0.8
5398,10261,일지매/Noun,10,8,2,0.00011114816049794375,4.4425686932184186e-05,0.8
5399,10262,위반/Noun,10,2,8,4.445926419917751e-05,0.00011106421733046048,0.8
5400,10263,전투력/Noun,10,2,8,4.445926419917751e-05,0.00011106421733046048,0.8
5401,10264,정해/Noun,10,2,8,4.445926419917751e-05,0.00011106421733046048,0.8
5402,10265,위장/Noun,10,2,8,4.445926419917751e-05,0.00011106421733046048,0.8
5403,10266,다모/Noun,10,8,2,0.00011114816049794375,4.4425686932184186e-05,0.8
5404,10267,J/Alpha,10,2,8,4.445926419917751e-05,0.00011106421733046048,0.8
5405,10268,자시/Noun,10,2,8,4.445926419917751e-05,0.00011106421733046048,0.8
5406,10269,매춘부/Noun,10,2,8,4.445926419917751e-05,0.00011106421733046048,0.8
5407,10270,ㅠㅜㅜ/KoreanParticle,10,8,2,0.00011114816049794375,4.4425686932184186e-05,0.8
5408,10271,!!~~/Punctuation,10,8,2,0.00011114816049794375,4.4425686932184186e-05,0.8
5409,10272,죄값/Noun,10,2,8,4.445926419917751e-05,0.00011106421733046048,0.8
5410,10273,사형수/Noun,10,2,8,4.445926419917751e-05,0.00011106421733046048,0.8
5411,10274,줄평/Noun,10,2,8,4.445926419917751e-05,0.00011106421733046048,0.8
5412,10275,퇴색/Noun,10,2,8,4.445926419917751e-05,0.00011106421733046048,0.8
5413,10276,카톡/Noun,10,2,8,4.445926419917751e-05,0.00011106421733046048,0.8
5414,10277,신경질/Noun,10,2,8,4.445926419917751e-05,0.00011106421733046048,0.8
5415,10278,조던/Noun,10,8,2,0.00011114816049794375,4.4425686932184186e-05,0.8
5416,10279,객/Noun,10,2,8,4.445926419917751e-05,0.00011106421733046048,0.8
5417,10280,홍은희/Noun,10,2,8,4.445926419917751e-05,0.00011106421733046048,0.8
5418,10281,한다해/Noun,10,2,8,4.445926419917751e-05,0.00011106421733046048,0.8
5419,10282,개그콘서트/Noun,10,2,8,4.445926419917751e-05,0.00011106421733046048,0.8
5420,10283,구태의연하다/Adjective,10,2,8,4.445926419917751e-05,0.00011106421733046048,0.8
5421,10284,구두/Noun,10,8,2,0.00011114816049794375,4.4425686932184186e-05,0.8
5422,10285,박희순/Noun,10,8,2,0.00011114816049794375,4.4425686932184186e-05,0.8
5423,10286,무분별/Noun,10,2,8,4.445926419917751e-05,0.00011106421733046048,0.8
5424,10287,리즈중/Noun,10,8,2,0.00011114816049794375,4.4425686932184186e-05,0.8
5425,10288,유전/Noun,10,8,2,0.00011114816049794375,4.4425686932184186e-05,0.8
5426,10289,송재림/Noun,10,8,2,0.00011114816049794375,4.4425686932184186e-05,0.8
5427,10290,명탐정코난/Noun,10,8,2,0.00011114816049794375,4.4425686932184186e-05,0.8
5428,10291,집합소/Noun,10,2,8,4.445926419917751e-05,0.00011106421733046048,0.8
5429,10292,평면/Noun,10,2,8,4.445926419917751e-05,0.00011106421733046048,0.8
5430,10293,느닷없다/Adjective,10,2,8,4.445926419917751e-05,0.00011106421733046048,0.8
5431,10294,빠리/Noun,10,2,8,4.445926419917751e-05,0.00011106421733046048,0.8
5432,10295,과격하다/Adjective,10,2,8,4.445926419917751e-05,0.00011106421733046048,0.8
5433,10296,희생양/Noun,10,2,8,4.445926419917751e-05,0.00011106421733046048,0.8
5434,10297,짤/Suffix,10,2,8,4.445926419917751e-05,0.00011106421733046048,0.8
5435,10298,맞짱/Noun,10,2,8,4.445926419917751e-05,0.00011106421733046048,0.8
5436,10299,고시/Noun,10,2,8,4.445926419917751e-05,0.00011106421733046048,0.8
5437,10300,구시대/Noun,10,2,8,4.445926419917751e-05,0.00011106421733046048,0.8
5438,10301,코스모스/Noun,10,8,2,0.00011114816049794375,4.4425686932184186e-05,0.8
5439,10302,낌/Noun,10,8,2,0.00011114816049794375,4.4425686932184186e-05,0.8
5440,10303,가해/Noun,10,2,8,4.445926419917751e-05,0.00011106421733046048,0.8
5441,10304,찐빵/Noun,10,2,8,4.445926419917751e-05,0.00011106421733046048,0.8
5442,10305,뮤지션/Noun,10,8,2,0.00011114816049794375,4.4425686932184186e-05,0.8
5443,10306,이덕화/Noun,10,8,2,0.00011114816049794375,4.4425686932184186e-05,0.8
5444,10307,달기/Noun,10,2,8,4.445926419917751e-05,0.00011106421733046048,0.8
5445,10308,뚱땡이/Noun,10,2,8,4.445926419917751e-05,0.00011106421733046048,0.8
5446,10309,날짜/Noun,10,2,8,4.445926419917751e-05,0.00011106421733046048,0.8
5447,10310,with/Alpha,10,8,2,0.00011114816049794375,4.4425686932184186e-05,0.8
5448,10311,왜그러지/Noun,10,8,2,0.00011114816049794375,4.4425686932184186e-05,0.8
5449,10312,지휘/Noun,10,8,2,0.00011114816049794375,4.4425686932184186e-05,0.8
5450,10313,공이/Noun,10,2,8,4.445926419917751e-05,0.00011106421733046048,0.8
5451,10314,구만/Eomi,10,2,8,4.445926419917751e-05,0.00011106421733046048,0.8
5452,10315,계보/Noun,10,2,8,4.445926419917751e-05,0.00011106421733046048,0.8
5453,10316,퇴화/Noun,10,2,8,4.445926419917751e-05,0.00011106421733046048,0.8
5454,10317,김갑수/Noun,10,8,2,0.00011114816049794375,4.4425686932184186e-05,0.8
5455,10318,족하/Noun,10,2,8,4.445926419917751e-05,0.00011106421733046048,0.8
5456,10319,현수/Noun,10,2,8,4.445926419917751e-05,0.00011106421733046048,0.8
5457,10320,Top/Alpha,10,8,2,0.00011114816049794375,4.4425686932184186e-05,0.8
5458,10321,우파/Noun,10,8,2,0.00011114816049794375,4.4425686932184186e-05,0.8
5459,10322,ktx/Alpha,10,2,8,4.445926419917751e-05,0.00011106421733046048,0.8
5460,10323,거론/Noun,10,2,8,4.445926419917751e-05,0.00011106421733046048,0.8
5461,10324,IMDB/Alpha,10,2,8,4.445926419917751e-05,0.00011106421733046048,0.8
5462,10325,골로/Noun,10,2,8,4.445926419917751e-05,0.00011106421733046048,0.8
5463,10326,1000만/Number,10,2,8,4.445926419917751e-05,0.00011106421733046048,0.8
5464,10327,치욕/Noun,10,2,8,4.445926419917751e-05,0.00011106421733046048,0.8
5465,10328,개개인/Noun,10,8,2,0.00011114816049794375,4.4425686932184186e-05,0.8
5466,10329,에코/Noun,10,2,8,4.445926419917751e-05,0.00011106421733046048,0.8
5467,10330,재연배우/Noun,10,2,8,4.445926419917751e-05,0.00011106421733046048,0.8
5468,10331,8회/Number,10,8,2,0.00011114816049794375,4.4425686932184186e-05,0.8
5469,10332,개신교/Noun,10,2,8,4.445926419917751e-05,0.00011106421733046048,0.8
5470,10333,미아/Noun,10,8,2,0.00011114816049794375,4.4425686932184186e-05,0.8
5471,10334,낙하산/Noun,10,2,8,4.445926419917751e-05,0.00011106421733046048,0.8
5472,10335,중국사람/Noun,10,2,8,4.445926419917751e-05,0.00011106421733046048,0.8
5473,10336,로보트/Noun,10,2,8,4.445926419917751e-05,0.00011106421733046048,0.8
5474,10337,장관/Noun,10,8,2,0.00011114816049794375,4.4425686932184186e-05,0.8
5475,10338,썻/Noun,10,2,8,4.445926419917751e-05,0.00011106421733046048,0.8
5476,10339,대식/Foreign,10,2,8,4.445926419917751e-05,0.00011106421733046048,0.8
5477,10340,끈질기다/Adjective,10,8,2,0.00011114816049794375,4.4425686932184186e-05,0.8
5478,10341,방귀/Noun,10,2,8,4.445926419917751e-05,0.00011106421733046048,0.8
5479,10342,치즈/Noun,10,8,2,0.00011114816049794375,4.4425686932184186e-05,0.8
5480,10343,피에르/Noun,10,8,2,0.00011114816049794375,4.4425686932184186e-05,0.8
5481,10344,왕창/Noun,10,2,8,4.445926419917751e-05,0.00011106421733046048,0.8
5482,10345,클리/Noun,10,2,8,4.445926419917751e-05,0.00011106421733046048,0.8
5483,10346,개멋/Noun,10,8,2,0.00011114816049794375,4.4425686932184186e-05,0.8
5484,10347,쭈쭈/Noun,10,2,8,4.445926419917751e-05,0.00011106421733046048,0.8
5485,10348,26/Number,10,8,2,0.00011114816049794375,4.4425686932184186e-05,0.8
5486,10349,드라마스페셜/Noun,10,2,8,4.445926419917751e-05,0.00011106421733046048,0.8
5487,10350,추측/Noun,10,8,2,0.00011114816049794375,4.4425686932184186e-05,0.8
5488,10351,폭팔/Noun,10,8,2,0.00011114816049794375,4.4425686932184186e-05,0.8
5489,10352,쥐뿔/Noun,10,2,8,4.445926419917751e-05,0.00011106421733046048,0.8
5490,10353,데미/Noun,10,2,8,4.445926419917751e-05,0.00011106421733046048,0.8
5491,10354,테두리/Noun,10,2,8,4.445926419917751e-05,0.00011106421733046048,0.8
5492,10355,건방지다/Adjective,10,2,8,4.445926419917751e-05,0.00011106421733046048,0.8
5493,10356,♡♡♡♡/Foreign,10,8,2,0.00011114816049794375,4.4425686932184186e-05,0.8
5494,10357,부다/Noun,10,2,8,4.445926419917751e-05,0.00011106421733046048,0.8
5495,10358,질풍/Noun,10,8,2,0.00011114816049794375,4.4425686932184186e-05,0.8
5496,10359,동포/Noun,10,8,2,0.00011114816049794375,4.4425686932184186e-05,0.8
5497,10360,따라다니다/Verb,10,2,8,4.445926419917751e-05,0.00011106421733046048,0.8
5498,10361,전무하다/Adjective,10,2,8,4.445926419917751e-05,0.00011106421733046048,0.8
5499,10362,과유/Noun,10,2,8,4.445926419917751e-05,0.00011106421733046048,0.8
5500,10363,자의식/Noun,10,2,8,4.445926419917751e-05,0.00011106421733046048,0.8
5501,10364,합창/Noun,10,8,2,0.00011114816049794375,4.4425686932184186e-05,0.8
5502,10365,위태/Noun,10,8,2,0.00011114816049794375,4.4425686932184186e-05,0.8
5503,10366,이슬/Noun,10,8,2,0.00011114816049794375,4.4425686932184186e-05,0.8
5504,10367,튀어/Noun,10,2,8,4.445926419917751e-05,0.00011106421733046048,0.8
5505,10368,순박하다/Adjective,10,8,2,0.00011114816049794375,4.4425686932184186e-05,0.8
5506,10369,쩍/Noun,10,2,8,4.445926419917751e-05,0.00011106421733046048,0.8
5507,10370,슈트/Noun,10,3,7,5.5574080248971876e-05,9.995779559741441e-05,0.7
5508,10371,정선경/Noun,10,3,7,5.5574080248971876e-05,9.995779559741441e-05,0.7
5509,10372,통과/Noun,10,7,3,0.0001000333444481494,5.553210866523024e-05,0.7
5510,10373,웃음소리/Noun,10,3,7,5.5574080248971876e-05,9.995779559741441e-05,0.7
5511,10374,댜/Noun,10,7,3,0.0001000333444481494,5.553210866523024e-05,0.7
5512,10375,고귀하다/Adjective,10,7,3,0.0001000333444481494,5.553210866523024e-05,0.7
5513,10376,촌티/Noun,10,3,7,5.5574080248971876e-05,9.995779559741441e-05,0.7
5514,10377,파이어/Noun,10,7,3,0.0001000333444481494,5.553210866523024e-05,0.7
5515,10378,김정태/Noun,10,7,3,0.0001000333444481494,5.553210866523024e-05,0.7
5516,10379,파업/Noun,10,3,7,5.5574080248971876e-05,9.995779559741441e-05,0.7
5517,10380,월터/Noun,10,7,3,0.0001000333444481494,5.553210866523024e-05,0.7
5518,10381,가드/Noun,10,3,7,5.5574080248971876e-05,9.995779559741441e-05,0.7
5519,10382,패션왕/Noun,10,3,7,5.5574080248971876e-05,9.995779559741441e-05,0.7
5520,10383,킨/Noun,10,7,3,0.0001000333444481494,5.553210866523024e-05,0.7
5521,10384,니드/Noun,10,7,3,0.0001000333444481494,5.553210866523024e-05,0.7
5522,10385,미신/Noun,10,3,7,5.5574080248971876e-05,9.995779559741441e-05,0.7
5523,10386,김석훈/Noun,10,3,7,5.5574080248971876e-05,9.995779559741441e-05,0.7
5524,10387,실재/Noun,10,7,3,0.0001000333444481494,5.553210866523024e-05,0.7
5525,10388,부작용/Noun,10,3,7,5.5574080248971876e-05,9.995779559741441e-05,0.7
5526,10389,베닝/Noun,10,7,3,0.0001000333444481494,5.553210866523024e-05,0.7
5527,10390,백수/Noun,10,3,7,5.5574080248971876e-05,9.995779559741441e-05,0.7
5528,10391,네러티브/Noun,10,3,7,5.5574080248971876e-05,9.995779559741441e-05,0.7
5529,10392,정신분열증/Noun,10,3,7,5.5574080248971876e-05,9.995779559741441e-05,0.7
5530,10393,신의한수/Noun,10,7,3,0.0001000333444481494,5.553210866523024e-05,0.7
5531,10394,옥상/Noun,10,7,3,0.0001000333444481494,5.553210866523024e-05,0.7
5532,10395,노조미/Noun,10,7,3,0.0001000333444481494,5.553210866523024e-05,0.7
5533,10396,day/Alpha,10,7,3,0.0001000333444481494,5.553210866523024e-05,0.7
5534,10397,헤치다/Verb,10,7,3,0.0001000333444481494,5.553210866523024e-05,0.7
5535,10398,모양새/Noun,10,3,7,5.5574080248971876e-05,9.995779559741441e-05,0.7
5536,10399,자평/Noun,10,3,7,5.5574080248971876e-05,9.995779559741441e-05,0.7
5537,10400,잦다/Verb,10,3,7,5.5574080248971876e-05,9.995779559741441e-05,0.7
5538,10401,딧/Noun,10,7,3,0.0001000333444481494,5.553210866523024e-05,0.7
5539,10402,??../Punctuation,10,3,7,5.5574080248971876e-05,9.995779559741441e-05,0.7
5540,10403,롯/Noun,10,7,3,0.0001000333444481494,5.553210866523024e-05,0.7
5541,10404,이성민/Noun,10,7,3,0.0001000333444481494,5.553210866523024e-05,0.7
5542,10405,1.5/Number,10,3,7,5.5574080248971876e-05,9.995779559741441e-05,0.7
5543,10406,마우스/Noun,10,3,7,5.5574080248971876e-05,9.995779559741441e-05,0.7
5544,10407,닥터후/Noun,10,7,3,0.0001000333444481494,5.553210866523024e-05,0.7
5545,10408,갈리/Noun,10,7,3,0.0001000333444481494,5.553210866523024e-05,0.7
5546,10409,시온/Noun,10,7,3,0.0001000333444481494,5.553210866523024e-05,0.7
5547,10410,점퍼/Noun,10,3,7,5.5574080248971876e-05,9.995779559741441e-05,0.7
5548,10411,연정훈/Noun,10,7,3,0.0001000333444481494,5.553210866523024e-05,0.7
5549,10412,명목/Noun,10,3,7,5.5574080248971876e-05,9.995779559741441e-05,0.7
5550,10413,하의/Noun,10,3,7,5.5574080248971876e-05,9.995779559741441e-05,0.7
5551,10414,듯해/Noun,10,7,3,0.0001000333444481494,5.553210866523024e-05,0.7
5552,10415,군단/Noun,10,3,7,5.5574080248971876e-05,9.995779559741441e-05,0.7
5553,10416,조성하/Noun,10,3,7,5.5574080248971876e-05,9.995779559741441e-05,0.7
5554,10417,과학자/Noun,10,3,7,5.5574080248971876e-05,9.995779559741441e-05,0.7
5555,10418,all/Alpha,10,7,3,0.0001000333444481494,5.553210866523024e-05,0.7
5556,10419,행세/Noun,10,3,7,5.5574080248971876e-05,9.995779559741441e-05,0.7
5557,10420,실어/Noun,10,7,3,0.0001000333444481494,5.553210866523024e-05,0.7
5558,10421,말세/Noun,10,3,7,5.5574080248971876e-05,9.995779559741441e-05,0.7
5559,10422,이산/Noun,10,3,7,5.5574080248971876e-05,9.995779559741441e-05,0.7
5560,10423,.-/Punctuation,10,3,7,5.5574080248971876e-05,9.995779559741441e-05,0.7
5561,10424,북극/Noun,10,7,3,0.0001000333444481494,5.553210866523024e-05,0.7
5562,10425,불상/Noun,10,3,7,5.5574080248971876e-05,9.995779559741441e-05,0.7
5563,10426,달랑/Noun,10,3,7,5.5574080248971876e-05,9.995779559741441e-05,0.7
5564,10427,은교/Noun,10,3,7,5.5574080248971876e-05,9.995779559741441e-05,0.7
5565,10428,헤어스타일/Noun,10,3,7,5.5574080248971876e-05,9.995779559741441e-05,0.7
5566,10429,램버트/Noun,10,7,3,0.0001000333444481494,5.553210866523024e-05,0.7
5567,10430,쌩/Noun,10,3,7,5.5574080248971876e-05,9.995779559741441e-05,0.7
5568,10431,투혼/Noun,10,3,7,5.5574080248971876e-05,9.995779559741441e-05,0.7
5569,10432,로고/Josa,10,3,7,5.5574080248971876e-05,9.995779559741441e-05,0.7
5570,10433,그래비티/Noun,10,7,3,0.0001000333444481494,5.553210866523024e-05,0.7
5571,10434,격추/Noun,10,3,7,5.5574080248971876e-05,9.995779559741441e-05,0.7
5572,10435,불쌍타/Noun,10,3,7,5.5574080248971876e-05,9.995779559741441e-05,0.7
5573,10436,률/Noun,10,3,7,5.5574080248971876e-05,9.995779559741441e-05,0.7
5574,10437,비장하다/Adjective,10,7,3,0.0001000333444481494,5.553210866523024e-05,0.7
5575,10438,임마/Noun,10,3,7,5.5574080248971876e-05,9.995779559741441e-05,0.7
5576,10439,12월/Number,10,7,3,0.0001000333444481494,5.553210866523024e-05,0.7
5577,10440,징징/Noun,10,3,7,5.5574080248971876e-05,9.995779559741441e-05,0.7
5578,10441,공권력/Noun,10,7,3,0.0001000333444481494,5.553210866523024e-05,0.7
5579,10442,쪼/Noun,10,7,3,0.0001000333444481494,5.553210866523024e-05,0.7
5580,10443,죵/Noun,10,3,7,5.5574080248971876e-05,9.995779559741441e-05,0.7
5581,10444,일수록/Josa,10,3,7,5.5574080248971876e-05,9.995779559741441e-05,0.7
5582,10445,모텔/Noun,10,3,7,5.5574080248971876e-05,9.995779559741441e-05,0.7
5583,10446,잠재우다/Verb,10,3,7,5.5574080248971876e-05,9.995779559741441e-05,0.7
5584,10447,분신/Noun,10,3,7,5.5574080248971876e-05,9.995779559741441e-05,0.7
5585,10448,기생/Noun,10,3,7,5.5574080248971876e-05,9.995779559741441e-05,0.7
5586,10449,인가가/Josa,10,7,3,0.0001000333444481494,5.553210866523024e-05,0.7
5587,10450,볼륨/Noun,10,3,7,5.5574080248971876e-05,9.995779559741441e-05,0.7
5588,10451,로구나/Josa,10,3,7,5.5574080248971876e-05,9.995779559741441e-05,0.7
5589,10452,해서웨이/Noun,10,7,3,0.0001000333444481494,5.553210866523024e-05,0.7
5590,10453,초원/Noun,10,7,3,0.0001000333444481494,5.553210866523024e-05,0.7
5591,10454,자괴/Noun,10,3,7,5.5574080248971876e-05,9.995779559741441e-05,0.7
5592,10455,매진/Noun,10,7,3,0.0001000333444481494,5.553210866523024e-05,0.7
5593,10456,상호/Noun,10,7,3,0.0001000333444481494,5.553210866523024e-05,0.7
5594,10457,스타크래프트/Noun,10,7,3,0.0001000333444481494,5.553210866523024e-05,0.7
5595,10458,시각장애인/Noun,10,7,3,0.0001000333444481494,5.553210866523024e-05,0.7
5596,10459,인원/Noun,10,3,7,5.5574080248971876e-05,9.995779559741441e-05,0.7
5597,10460,격렬하다/Adjective,10,7,3,0.0001000333444481494,5.553210866523024e-05,0.7
5598,10461,허수아비/Noun,10,3,7,5.5574080248971876e-05,9.995779559741441e-05,0.7
5599,10462,스칼렛요한슨/Noun,10,7,3,0.0001000333444481494,5.553210866523024e-05,0.7
5600,10463,연도/Noun,10,7,3,0.0001000333444481494,5.553210866523024e-05,0.7
5601,10464,급격하다/Adjective,10,3,7,5.5574080248971876e-05,9.995779559741441e-05,0.7
5602,10465,물든/Noun,10,7,3,0.0001000333444481494,5.553210866523024e-05,0.7
5603,10466,리모컨/Noun,10,3,7,5.5574080248971876e-05,9.995779559741441e-05,0.7
5604,10467,비고/Noun,10,7,3,0.0001000333444481494,5.553210866523024e-05,0.7
5605,10468,one/Alpha,10,7,3,0.0001000333444481494,5.553210866523024e-05,0.7
5606,10469,서너/Modifier,10,7,3,0.0001000333444481494,5.553210866523024e-05,0.7
5607,10470,레아/Noun,10,7,3,0.0001000333444481494,5.553210866523024e-05,0.7
5608,10471,필리핀/Noun,10,3,7,5.5574080248971876e-05,9.995779559741441e-05,0.7
5609,10472,ET/Alpha,10,7,3,0.0001000333444481494,5.553210866523024e-05,0.7
5610,10473,비포/Noun,10,7,3,0.0001000333444481494,5.553210866523024e-05,0.7
5611,10474,오맹달/Noun,10,7,3,0.0001000333444481494,5.553210866523024e-05,0.7
5612,10475,좌익/Noun,10,3,7,5.5574080248971876e-05,9.995779559741441e-05,0.7
5613,10476,리브스/Noun,10,7,3,0.0001000333444481494,5.553210866523024e-05,0.7
5614,10477,덧글/Noun,10,3,7,5.5574080248971876e-05,9.995779559741441e-05,0.7
5615,10478,150/Number,10,3,7,5.5574080248971876e-05,9.995779559741441e-05,0.7
5616,10479,선호/Noun,10,7,3,0.0001000333444481494,5.553210866523024e-05,0.7
5617,10480,맞이/Noun,10,7,3,0.0001000333444481494,5.553210866523024e-05,0.7
5618,10481,방한/Noun,10,3,7,5.5574080248971876e-05,9.995779559741441e-05,0.7
5619,10482,크레이븐/Noun,10,7,3,0.0001000333444481494,5.553210866523024e-05,0.7
5620,10483,이효리/Noun,10,3,7,5.5574080248971876e-05,9.995779559741441e-05,0.7
5621,10484,자잘하다/Adjective,10,7,3,0.0001000333444481494,5.553210866523024e-05,0.7
5622,10485,방향성/Noun,10,3,7,5.5574080248971876e-05,9.995779559741441e-05,0.7
5623,10486,피스/Noun,10,7,3,0.0001000333444481494,5.553210866523024e-05,0.7
5624,10487,돌대가리/Noun,10,3,7,5.5574080248971876e-05,9.995779559741441e-05,0.7
5625,10488,의료/Noun,10,7,3,0.0001000333444481494,5.553210866523024e-05,0.7
5626,10489,실비/Noun,10,7,3,0.0001000333444481494,5.553210866523024e-05,0.7
5627,10490,코트/Noun,10,7,3,0.0001000333444481494,5.553210866523024e-05,0.7
5628,10491,지평/Noun,10,7,3,0.0001000333444481494,5.553210866523024e-05,0.7
5629,10492,ㆍ/Foreign,10,7,3,0.0001000333444481494,5.553210866523024e-05,0.7
5630,10493,로지/Noun,10,3,7,5.5574080248971876e-05,9.995779559741441e-05,0.7
5631,10494,열매/Noun,10,7,3,0.0001000333444481494,5.553210866523024e-05,0.7
5632,10495,안재모/Noun,10,7,3,0.0001000333444481494,5.553210866523024e-05,0.7
5633,10496,마츠코/Noun,10,3,7,5.5574080248971876e-05,9.995779559741441e-05,0.7
5634,10497,로페즈/Noun,10,3,7,5.5574080248971876e-05,9.995779559741441e-05,0.7
5635,10498,일일이/Noun,10,3,7,5.5574080248971876e-05,9.995779559741441e-05,0.7
5636,10499,배신자/Noun,10,3,7,5.5574080248971876e-05,9.995779559741441e-05,0.7
5637,10500,이주/Noun,10,7,3,0.0001000333444481494,5.553210866523024e-05,0.7
5638,10501,간판/Noun,10,3,7,5.5574080248971876e-05,9.995779559741441e-05,0.7
5639,10502,연애시대/Noun,10,7,3,0.0001000333444481494,5.553210866523024e-05,0.7
5640,10503,러브액츄얼리/Noun,10,7,3,0.0001000333444481494,5.553210866523024e-05,0.7
5641,10504,로비/Noun,10,3,7,5.5574080248971876e-05,9.995779559741441e-05,0.7
5642,10505,주드로/Noun,10,7,3,0.0001000333444481494,5.553210866523024e-05,0.7
5643,10506,히로인/Noun,10,3,7,5.5574080248971876e-05,9.995779559741441e-05,0.7
5644,10507,What/Alpha,10,3,7,5.5574080248971876e-05,9.995779559741441e-05,0.7
5645,10508,LA/Alpha,10,7,3,0.0001000333444481494,5.553210866523024e-05,0.7
5646,10509,박재정/Noun,10,3,7,5.5574080248971876e-05,9.995779559741441e-05,0.7
5647,10510,눈망울/Noun,10,7,3,0.0001000333444481494,5.553210866523024e-05,0.7
5648,10511,중국무협/Noun,10,3,7,5.5574080248971876e-05,9.995779559741441e-05,0.7
5649,10512,이용철/Noun,10,7,3,0.0001000333444481494,5.553210866523024e-05,0.7
5650,10513,포레스트검프/Noun,10,7,3,0.0001000333444481494,5.553210866523024e-05,0.7
5651,10514,정당성/Noun,10,3,7,5.5574080248971876e-05,9.995779559741441e-05,0.7
5652,10515,김신/Noun,10,3,7,5.5574080248971876e-05,9.995779559741441e-05,0.7
5653,10516,걔/Noun,10,3,7,5.5574080248971876e-05,9.995779559741441e-05,0.7
5654,10517,똥개/Noun,10,3,7,5.5574080248971876e-05,9.995779559741441e-05,0.7
5655,10518,아름/Noun,10,7,3,0.0001000333444481494,5.553210866523024e-05,0.7
5656,10519,개지/Noun,10,3,7,5.5574080248971876e-05,9.995779559741441e-05,0.7
5657,10520,'./Punctuation,10,7,3,0.0001000333444481494,5.553210866523024e-05,0.7
5658,10521,거고/Eomi,10,3,7,5.5574080248971876e-05,9.995779559741441e-05,0.7
5659,10522,떠나가다/Verb,10,7,3,0.0001000333444481494,5.553210866523024e-05,0.7
5660,10523,라오스/Noun,10,7,3,0.0001000333444481494,5.553210866523024e-05,0.7
5661,10524,공항/Noun,10,7,3,0.0001000333444481494,5.553210866523024e-05,0.7
5662,10525,아이엠/Noun,10,7,3,0.0001000333444481494,5.553210866523024e-05,0.7
5663,10526,더듬다/Verb,10,7,3,0.0001000333444481494,5.553210866523024e-05,0.7
