,Unnamed: 0,parameter,counts,counts_H,counts_NH,p_from_H,p_from_NH,priority
0,3,보다/Verb,38094,21677,16417,0.2409580971434923,0.18235633843488305,0.5690397437916732
1,5,의/Josa,29457,17487,11970,0.19438701789485385,0.13296608098802729,0.593644974029942
2,6,가/Josa,27737,12332,15405,0.13709014115816384,0.17111663964104046,0.5553953203302447
3,8,../Punctuation,25849,11706,14143,0.13013226631099256,0.15710033541393634,0.547139154319316
4,9,을/Josa,23027,12500,10527,0.13895743025452928,0.11693951442724185,0.5428410127241934
5,10,.../Punctuation,22073,9139,12934,0.1016005335111704,0.14367267153868366,0.5859647533185339
6,11,은/Josa,19690,7739,11951,0.08603979104145826,0.1327550589750994,0.6069578466226511
7,12,도/Josa,18990,7903,11087,0.08786262087362454,0.12315911059774763,0.5838335966298052
8,14,는/Josa,18035,7669,10366,0.08526175391797265,0.11515138052822142,0.5747712780704186
9,15,없다/Adjective,16914,5001,11913,0.05560742469712127,0.13233301494924365,0.7043277758070238
10,18,있다/Adjective,13419,8187,5232,0.09101922863176616,0.05813101135076301,0.6101050748938073
11,19,좋다/Adjective,13043,9370,3673,0.10416805601867288,0.040816099868944224,0.7183930077436173
12,20,이/Determiner,12373,4495,7878,0.04998332777592531,0.08751860325640286,0.6367089630647378
13,21,너무/Adverb,11905,6629,5276,0.0737023452261865,0.05861969390701704,0.55682486350273
14,22,재밌다/Adjective,11789,9955,1834,0.1106702234078026,0.020391390301872543,0.8444312494698448
15,23,?/Punctuation,11319,3302,8017,0.03672335222852062,0.08906239587729625,0.7082781164413817
16,24,정말/Noun,10702,7082,3620,0.07873735689674335,0.04022745951709279,0.6617454681367969
17,25,것/Noun,10293,4088,6205,0.045459597643659005,0.06893755969701681,0.6028368794326241
18,26,되다/Verb,9887,5453,4434,0.06063132155162833,0.04926808680779226,0.5515323151613231
19,30,적/Suffix,9003,5486,3517,0.06099811048127154,0.03908349807858904,0.6093524380761969
20,31,으로/Josa,8921,4168,4753,0.046348782927642544,0.052811035340633965,0.5327878040578411
21,32,아니다/Adjective,8754,3210,5544,0.035700789151939534,0.061596214931473374,0.6333104866346813
22,34,!/Punctuation,8565,6415,2150,0.07132377459153051,0.02390101956951509,0.7489784004670169
23,35,로/Josa,7951,3351,4600,0.037267978214960536,0.05111175281547791,0.5785435794239718
24,36,에서/Josa,7910,4218,3692,0.04690452373013226,0.041027121881872096,0.5332490518331227
25,37,점/Noun,7843,3227,4616,0.03588974102478604,0.05128945556320665,0.5885502996302435
26,38,만/Josa,7745,2412,5333,0.026831165944203626,0.05925275994580066,0.6885732730794061
27,39,나오다/Verb,7213,2894,4319,0.03218850728020451,0.04799084830849197,0.5987799805906003
28,40,만들다/Verb,7199,2506,4693,0.02787595865288429,0.05214465003665119,0.6518960966800944
29,41,연기/Noun,7089,4106,2983,0.0456596643325553,0.03315266887314245,0.5792072224573283
30,42,평점/Noun,7068,2994,4074,0.03329998888518395,0.045269774983895686,0.5764006791171478
31,43,과/Josa,6768,4231,2537,0.0470490163387796,0.028199204780203917,0.6251477541371159
32,44,최고/Noun,6671,6143,528,0.06830054462598642,0.005886403518514404,0.9208514465597362
33,45,한/Josa,6635,3102,3533,0.034500389018561735,0.039261200826317774,0.5324792765636774
34,46,이다/Verb,6524,4043,2481,0.04495943092141825,0.02757724516315333,0.6197118332311465
35,47,왜/Noun,6247,2241,4006,0.024930532399688784,0.04451453830604856,0.6412678085481031
36,48,스토리/Noun,6075,2176,3899,0.02420806935645215,0.04332615118061263,0.6418106995884774
37,49,인/Josa,6018,3216,2802,0.0357674780482383,0.03114240653946112,0.5343968095712861
38,50,생각/Noun,6005,3771,2234,0.04193620095587418,0.02483395899509096,0.6279766860949209
39,51,~/Punctuation,6003,4016,1987,0.0446593308880738,0.022090672827028587,0.6689988339163752
40,53,다/Adverb,5790,2454,3336,0.027297988218294992,0.037073235744907715,0.5761658031088083
41,55,감동/Noun,5597,4442,1155,0.049394242525286215,0.012850129945134276,0.7936394497051992
42,56,..../Punctuation,5580,2218,3362,0.024674891630543514,0.0373620027099669,0.6025089605734767
43,57,1/Number,5284,1409,3875,0.015683005446259866,0.043059597059019517,0.7333459500378501
44,59,이렇다/Adjective,5240,2243,2997,0.02495276203178837,0.033308158777405096,0.5719465648854962
45,60,보고/Noun,5209,3038,2171,0.0337890407913749,0.024134254425909062,0.5832213476674986
46,62,아깝다/Adjective,5167,374,4793,0.004179170834722685,0.0532552922099558,0.9276175730598026
47,64,드라마/Noun,5005,3017,1988,0.03355562965432922,0.022101779248761638,0.6027972027972028
48,66,때/Noun,4940,3220,1720,0.03581193731243748,0.01912525822430529,0.6518218623481782
49,69,재미있다/Adjective,4787,4102,685,0.04561520506835612,0.007630111730602634,0.8569041153123041
50,70,거/Noun,4783,1959,2824,0.02179615427364677,0.03138674781758813,0.5904244198201966
51,71,와/Josa,4779,2774,2005,0.03085472935422919,0.022290588418223414,0.5804561623770663
52,72,감독/Noun,4688,1515,3173,0.016861175947538068,0.0352628890024212,0.6768344709897611
53,73,ㅋㅋ/KoreanParticle,4594,2777,1817,0.03088807380237857,0.02020258113241076,0.6044841097083152
54,74,재미/Noun,4538,1752,2786,0.01949538735133934,0.03096470379173238,0.6139268400176289
55,75,내용/Noun,4529,1407,3122,0.015660775814160276,0.03469646149403585,0.6893353941267388
56,76,뭐/Noun,4491,831,3660,0.009258641769478715,0.04067171638641463,0.8149632598530394
57,77,못/VerbPrefix,4418,1474,2944,0.0164054684894965,0.032719518425553665,0.666364870982345
58,78,그냥/Noun,4406,1187,3219,0.013215516283205513,0.035773784402141316,0.7305946436677259
59,79,고/Josa,4377,1761,2616,0.019595420695787485,0.02907661209711455,0.5976696367374914
60,81,게/Josa,4340,1723,2617,0.0191730576858953,0.0290877185188476,0.6029953917050691
61,82,주다/Verb,4321,1728,2593,0.01922863176614427,0.028821164397254493,0.6000925711640824
62,83,안/VerbPrefix,4262,1318,2944,0.014671557185728575,0.032719518425553665,0.6907555138432661
63,84,재미없다/Adjective,4205,307,3898,0.0034344781593864623,0.04331504475887958,0.9269916765755052
64,85,자다/Verb,4114,2658,1456,0.029565410692453036,0.01619316288678114,0.6460865337870686
65,86,좀/Noun,4111,1455,2656,0.0161942869845504,0.029520868966436395,0.6460715154463634
66,87,그/Noun,4099,2400,1699,0.02669778815160609,0.018892023367911327,0.5855086606489388
67,88,지루하다/Adjective,4057,872,3185,0.009714349227520284,0.03539616606321775,0.7850628543258565
68,91,!!/Punctuation,4005,3088,917,0.03434478159386462,0.010206801572669318,0.7710362047440699
69,92,시간/Noun,3956,1077,2879,0.01199288651772813,0.03199760101290566,0.7277553083923155
70,93,한/Determiner,3920,1604,2316,0.01785039457596977,0.025744685577200742,0.5908163265306122
71,94,쓰레기/Noun,3739,209,3530,0.002345226186506613,0.03922788156111864,0.9441027012570206
72,96,수/Noun,3698,2475,1223,0.027531399355340668,0.013605366622981408,0.6692806922660898
73,97,모르다/Verb,3669,1654,2015,0.018406135378459487,0.02240165263555388,0.5491959662033251
74,99,그렇다/Adjective,3501,1397,2104,0.01554962765366233,0.02339012416979497,0.6009711510996858
75,101,아/Exclamation,3469,1327,2142,0.014771590530176725,0.023812168195650726,0.6174690112424329
76,102,알다/Verb,3393,1393,2000,0.015505168389463152,0.022235056309558188,0.5894488653109343
77,103,볼/Noun,3386,1865,1521,0.0207513615649661,0.01691508029942913,0.5507974010632014
78,104,작품/Noun,3308,2050,1258,0.02280760253417806,0.01399409138363802,0.6197097944377267
79,105,다시/Noun,3289,2763,526,0.03073246637768145,0.005864190675048313,0.8400729705077531
80,106,10/Number,3248,2158,1090,0.02400800266755585,0.012128212532486284,0.6644088669950738
81,107,마지막/Noun,3201,2151,1050,0.02393019895520729,0.011683955663164441,0.6719775070290535
82,109,사랑/Noun,3190,2523,667,0.0280649105257308,0.0074301961394078065,0.7909090909090909
83,110,잘/VerbPrefix,3151,2150,1001,0.023919084139157498,0.011139740998245185,0.682323072040622
84,111,하나/Noun,3087,1267,1820,0.014104701567189062,0.020235900397609898,0.5895691609977324
85,113,이렇게/Adverb,3042,1309,1733,0.014571523841280428,0.01926964170683489,0.5696909927679158
86,114,요/Josa,3013,1950,1063,0.02169612092919862,0.01182833914569404,0.6471954862263525
87,115,처음/Noun,2995,1342,1653,0.014938312770923641,0.01838112796819121,0.5519198664440734
88,116,이다/Adjective,2942,2200,742,0.02447482494164721,0.00826317776938626,0.7477906186267845
89,117,나/Josa,2916,1029,1887,0.011459375347338,0.020980030653723985,0.647119341563786
90,118,정도/Noun,2909,1293,1616,0.014393686784483715,0.0179701903640685,0.5555173599174974
91,119,2/Number,2878,1225,1653,0.0136378792930977,0.01838112796819121,0.5743571924947879
92,120,많다/Adjective,2857,1696,1161,0.01887295765255085,0.012916768475532551,0.5936296814840742
93,121,완전/Noun,2851,1545,1306,0.0171946204290319,0.014527199626824227,0.5419151175026307
94,122,ㅋ/KoreanParticle,2712,1574,1138,0.017516950094475937,0.012661320775672492,0.5803834808259587
95,123,주인공/Noun,2708,1083,1625,0.012059575414026896,0.018070148159665917,0.6000738552437223
96,124,안되다/Adjective,2683,658,2025,0.0073357785928642874,0.022512716852884338,0.7547521431233694
97,129,장면/Noun,2611,1425,1186,0.015860842503056576,0.013194429018858705,0.5457679050172348
98,130,중/Suffix,2597,1568,1029,0.017450261198177167,0.011450720806770473,0.6037735849056604
99,131,지금/Noun,2596,1843,753,0.020506835611870625,0.008385348408449766,0.7099383667180277
100,132,ㅠㅠ/KoreanParticle,2589,1842,747,0.020495720795820828,0.008318709878051491,0.7114716106604867
101,133,최악/Noun,2549,32,2517,0.00037790374569300877,0.027977076345542997,0.9874460572773636
102,134,지/Josa,2511,993,1518,0.011059241969545405,0.01688176103422999,0.6045400238948626
103,135,임/Noun,2511,1059,1452,0.01179281982883183,0.016148737199848953,0.5782556750298686
104,136,걸/Noun,2493,777,1716,0.008658441702789819,0.01908083253737311,0.6883273164861613
105,137,3/Number,2481,918,1563,0.010225630765810827,0.017381550012217063,0.6299879081015719
106,138,이야기/Noun,2465,1372,1093,0.015271757252417473,0.012161531797685421,0.5565922920892495
107,139,연출/Noun,2454,975,1479,0.010859175280649105,0.016448610586641196,0.6026894865525673
108,140,별로/Noun,2438,320,2118,0.0035789707680337892,0.023545614074057617,0.8687448728465955
109,141,끝/Noun,2438,862,1576,0.009603201067022341,0.01752593349474666,0.6464315012305168
110,142,돈/Noun,2433,279,2154,0.00312326330999222,0.023945445256447283,0.8853267570900123
111,144,좋아하다/Adjective,2390,1427,963,0.015883072135156162,0.010717696972389435,0.597071129707113
112,146,라/Josa,2373,987,1386,0.010992553073246638,0.015415713365467912,0.584070796460177
113,147,그리고/Conjunction,2339,1419,920,0.01579415360675781,0.010240120837868457,0.6066695168875588
114,148,역시/Noun,2323,1623,700,0.01806157608091586,0.007796708056598325,0.6986655187257856
115,149,넘다/Verb,2286,1520,766,0.01691675002778704,0.008529731890979364,0.6649168853893264
116,150,개/Noun,2277,671,1606,0.007480271201511616,0.017859126146738045,0.7053140096618358
117,151,명작/Noun,2259,1976,283,0.02198510614649328,0.0031653301939181234,0.8747233289065959
118,153,남다/Verb,2231,1452,779,0.016160942536401022,0.008674115373508963,0.6508292245629762
119,154,이런/Modifier,2201,819,1382,0.009125263976881185,0.015371287678535732,0.6278964107223989
120,155,그/Determiner,2183,1013,1170,0.011281538290541291,0.013016726271129968,0.5359596885020614
121,156,이해/Noun,2164,866,1298,0.00964766033122152,0.014438348252959863,0.5998151571164511
122,157,^^/Punctuation,2162,1921,241,0.021373791263754584,0.002698860481130189,0.8885291396854764
123,158,라고/Josa,2147,777,1370,0.008658441702789819,0.015238010617739176,0.6380996739636703
124,159,괜찮다/Adjective,2129,1444,685,0.01607202400800267,0.007630111730602634,0.6782527007984971
125,160,ㅡㅡ/KoreanParticle,2128,211,1917,0.002367455818606202,0.021313223305715362,0.9008458646616542
126,161,이영화/Noun,2102,1147,955,0.012770923641213738,0.01062884559852507,0.5456707897240723
127,162,안/Noun,2100,842,1258,0.009380904746026451,0.01399409138363802,0.599047619047619
128,163,버리다/Verb,2073,660,1413,0.007358008224963877,0.015715586752260157,0.6816208393632417
129,164,느끼다/Verb,2066,1442,624,0.016049794375903082,0.006952620004886826,0.6979670861568248
130,165,많이/Adverb,2064,1130,934,0.012581971768367234,0.0103956107421311,0.5474806201550387
131,166,때문/Noun,2060,810,1250,0.009025230632433032,0.013905240009773652,0.6067961165048543
132,167,!!!/Punctuation,2038,1392,646,0.01549405357341336,0.007196961283013839,0.6830225711481845
133,168,또/Noun,2013,1348,665,0.01500500166722241,0.007407983295941714,0.6696472925981123
134,169,중/Noun,1957,1139,818,0.012682005112815385,0.009107265821097759,0.5820132856412877
135,170,해주다/Verb,1945,1324,621,0.014738246082027343,0.0069193007396876885,0.680719794344473
136,171,여자/Noun,1944,757,1187,0.008436145381793929,0.01320553544059175,0.61059670781893
137,172,난/Noun,1928,1196,732,0.013315549627653665,0.0081521135520558,0.6203319502074689
138,173,꼭/Noun,1920,1594,326,0.017739246415471824,0.003642906328439104,0.8302083333333333
139,174,내/Determiner,1911,839,1072,0.00934756029787707,0.011928296941291454,0.5609628466771324
140,175,에게/Josa,1907,1144,763,0.012737579193064357,0.008496412625780226,0.5998951232302046
141,176,보기/Noun,1903,847,1056,0.009436478826275423,0.01175059419356272,0.5549132947976878
142,177,아름답다/Adjective,1901,1659,242,0.01846170945870846,0.0027099669028632354,0.8726985796948974
143,178,하/Suffix,1862,787,1075,0.008769589863287762,0.011961616206490592,0.5773361976369495
144,180,어떻다/Adjective,1819,805,1014,0.008969656552184062,0.011284124480774784,0.5574491478834525
145,181,마음/Noun,1810,1497,313,0.016661109258641768,0.003498522845909505,0.8270718232044199
146,182,인생/Noun,1810,1304,506,0.014515949761031457,0.005642062240387392,0.7204419889502762
147,184,엔/Josa,1801,827,974,0.009214182505279538,0.010839867611452942,0.5408106607440311
148,185,기억/Noun,1794,1237,557,0.01377125708569523,0.00620848974877274,0.6895206243032329
149,186,부터/Josa,1791,743,1048,0.008280537957096809,0.01166174281969835,0.5851479620323842
150,187,결말/Noun,1777,729,1048,0.008124930532399691,0.01166174281969835,0.5897580191333709
151,188,끄다/Verb,1754,541,1213,0.006035345115038346,0.013494302405650948,0.6915621436716077
152,189,아쉽다/Adjective,1746,1186,560,0.013204401467155718,0.006241809013971878,0.6792668957617412
153,191,ㅎㅎ/KoreanParticle,1744,1498,246,0.01667222407469156,0.00275439258979542,0.8589449541284404
154,192,보여주다/Verb,1738,936,802,0.010425697454707124,0.008929563073369022,0.5385500575373993
155,193,랑/Josa,1721,744,977,0.008291652773146604,0.010873186876652079,0.5676932016269611
156,194,못/Noun,1720,544,1176,0.0060686895631877295,0.013083364801528243,0.6837209302325581
157,195,소재/Noun,1714,594,1120,0.006624430365677447,0.012461405184477666,0.6534422403733956
158,196,이나/Josa,1704,527,1177,0.005879737690341225,0.013094471223261291,0.6907276995305164
159,197,어리다/Verb,1690,1270,420,0.014138046015338444,0.004686909971345432,0.7514792899408284
160,198,재다/Verb,1675,1417,258,0.01577192397465822,0.0028876696505919725,0.8459701492537314
161,199,없이/Adverb,1675,902,773,0.010047793709014116,0.008607476843110686,0.5385074626865671
162,200,뻔하다/Adjective,1670,457,1213,0.005101700566855619,0.013494302405650948,0.7263473053892215
163,201,애/Noun,1670,576,1094,0.006424363676781149,0.012172638219418469,0.6550898203592814
164,202,수준/Noun,1658,273,1385,0.003056574413693453,0.01540460694373487,0.8353437876960192
165,203,맞다/Verb,1649,477,1172,0.005323996887851506,0.01303893911459606,0.7107337780473014
166,204,한번/Noun,1640,1136,504,0.012648660664666,0.0056198493969213,0.6926829268292682
167,205,편/Noun,1613,721,892,0.008036012004001334,0.009929141029343166,0.5530068195908245
168,206,네/Josa,1608,469,1139,0.005235078359453151,0.01267242719740554,0.7083333333333334
169,207,먹다/Verb,1594,709,885,0.007902634211403801,0.009851396077211843,0.5552070263488079
170,210,현실/Noun,1587,1041,546,0.011592753139935534,0.0060863191097092345,0.6559546313799622
171,211,전개/Noun,1586,418,1168,0.004668222740913638,0.012994513427663876,0.7364438839848676
172,212,매력/Noun,1586,1153,433,0.012837612537512505,0.004831293453875031,0.7269861286254728
173,213,무섭다/Adjective,1580,677,903,0.0075469600978103814,0.010051311668406672,0.5715189873417722
174,214,되어다/Verb,1577,1073,504,0.011948427253528954,0.0056198493969213,0.6804058338617628
175,215,가슴/Noun,1575,1376,199,0.01531621651661665,0.002232390768342256,0.8736507936507937
176,216,낮다/Adjective,1560,1254,306,0.013960208958541736,0.0034207778937781824,0.8038461538461539
177,217,말다/Verb,1559,338,1221,0.0037790374569300882,0.013583153779515316,0.7831943553559975
178,218,끝나다/Verb,1557,666,891,0.007424697121262644,0.009918034607610121,0.5722543352601156
179,219,~~/Punctuation,1556,1038,518,0.011559408691786151,0.005775339301183945,0.6670951156812339
180,220,야/Josa,1543,373,1170,0.00416805601867289,0.013016726271129968,0.7582631237848347
181,222,높다/Adjective,1536,327,1209,0.003656774480382349,0.013449876718718765,0.787109375
182,223,님/Suffix,1536,948,588,0.010559075247304657,0.006552788822497168,0.6171875
183,224,알/Noun,1535,886,649,0.009869956652217406,0.007230280548212976,0.5771986970684039
184,225,가장/Noun,1534,1006,528,0.011203734578192731,0.005886403518514404,0.6558018252933507
185,226,;;/Punctuation,1523,373,1150,0.00416805601867289,0.012794597836469045,0.7550886408404465
186,227,저/Noun,1522,907,615,0.010103367789263087,0.006852662209289411,0.5959264126149802
187,228,슬프다/Adjective,1504,1292,212,0.014382571968433922,0.002376774250871854,0.8590425531914894
188,229,??/Punctuation,1503,455,1048,0.0050794709347560295,0.01166174281969835,0.697272122421823
189,231,멋지다/Adjective,1475,1271,204,0.01414916083138824,0.0022879228770074857,0.8616949152542372
190,233,아/Josa,1457,606,851,0.006757808158274981,0.00947377773828828,0.5840768702814001
191,234,하지만/Conjunction,1453,772,681,0.008602867622540847,0.00758568604367045,0.5313145216792843
192,235,음악/Noun,1452,1077,375,0.01199288651772813,0.00418712099335836,0.7417355371900827
193,237,성/Suffix,1445,496,949,0.005535178392797599,0.010562207068126793,0.6567474048442906
194,238,늘다/Verb,1443,678,765,0.0075580749138601765,0.008518625469246319,0.5301455301455301
195,239,유치하다/Adjective,1442,282,1160,0.003156607758141603,0.012905662053799508,0.8044382801664355
196,240,아이/Noun,1436,944,492,0.01051461598310548,0.005486572336124747,0.6573816155988857
197,241,죽다/Verb,1435,475,960,0.005301767255751918,0.010684377707190298,0.6689895470383276
198,242,함/Noun,1425,758,667,0.008447260197843727,0.0074301961394078065,0.5319298245614035
199,244,솔직하다/Adjective,1420,500,920,0.005579637656996777,0.010240120837868457,0.647887323943662
200,246,줄/Noun,1411,605,806,0.006746693342225186,0.008973988760301206,0.5712260807937632
201,247,무슨/Noun,1408,215,1193,0.00241191508280538,0.013272173970990026,0.8473011363636364
202,248,추천/Noun,1403,1037,366,0.011548293875736356,0.004087163197760945,0.7391304347826086
203,249,만/Noun,1401,947,454,0.010547960431254862,0.0050645283102689976,0.6759457530335474
204,250,냐/Josa,1392,169,1223,0.0019006335445148387,0.013605366622981408,0.8785919540229885
205,251,인지/Josa,1383,425,958,0.004746026453262197,0.010662164863724205,0.6926970354302241
206,252,쓰다/Verb,1383,430,953,0.0048016005335111715,0.010606632755058977,0.6890817064352857
207,253,게/Noun,1380,485,895,0.005412915416249861,0.009962460294542305,0.6485507246376812
208,254,눈물/Noun,1378,1156,222,0.012870956985661888,0.0024878384682023146,0.8388969521044993
209,255,인가/Josa,1378,446,932,0.004979437590307881,0.010373397898665008,0.6763425253991292
210,257,번/Noun,1370,945,425,0.010525730799155274,0.004742442080010663,0.6897810218978102
211,259,ㅠ/KoreanParticle,1361,899,462,0.01001444926086473,0.005153379684133366,0.6605437178545187
212,260,자체/Noun,1360,582,778,0.006491052573079916,0.008663008951775917,0.5720588235294117
213,261,저/Determiner,1355,471,884,0.00525730799155274,0.009840289655478798,0.6523985239852399
214,262,우리/Noun,1346,996,350,0.011092586417694788,0.003909460450032209,0.7399702823179792
215,263,인간/Noun,1346,839,507,0.00934756029787707,0.005653168662120438,0.6233283803863299
216,264,네/Suffix,1337,913,424,0.010170056685561854,0.004731335658277615,0.6828721017202692
217,265,야하다/Adjective,1322,769,553,0.008569523174391464,0.006164064061840557,0.5816944024205749
218,267,지만/Josa,1312,784,528,0.00873624541513838,0.005886403518514404,0.5975609756097561
219,268,속/Noun,1307,819,488,0.009125263976881185,0.005442146649192564,0.6266258607498087
220,270,허다/Verb,1294,206,1088,0.0023118817383572304,0.01210599968902019,0.8408037094281299
221,272,원작/Noun,1275,429,846,0.004790485717461376,0.009418245629623049,0.6635294117647059
222,273,짜증나다/Adjective,1251,81,1170,0.0009225297321329332,0.013016726271129968,0.9352517985611509
223,274,그래도/Adverb,1246,736,510,0.00820273424474825,0.005686487927319576,0.5906902086677368
224,275,살다/Verb,1239,732,507,0.008158274980549073,0.005653168662120438,0.5907990314769975
225,276,뭔가/Noun,1237,502,735,0.005601867289096366,0.008185432817254937,0.5941794664510913
226,277,코미디/Noun,1235,485,750,0.005412915416249861,0.008352029143250627,0.6072874493927125
227,278,찍다/Verb,1231,259,972,0.002900966988996332,0.01081765476798685,0.7896019496344435
228,279,보이다/Verb,1231,504,727,0.005624096921195954,0.00809658144339057,0.5905767668562144
229,280,연기력/Noun,1225,680,545,0.007580304545959766,0.006075212687976188,0.5551020408163265
230,281,캐릭터/Noun,1225,562,663,0.0062687562520840285,0.00738577045247562,0.5412244897959184
231,282,기대하다/Adjective,1222,341,881,0.003812381905079471,0.00980697039027966,0.7209492635024549
232,284,여운/Noun,1210,1139,71,0.012682005112815385,0.0008107687865123613,0.9413223140495868
233,286,움/Noun,1204,432,772,0.00482383016561076,0.00859637042137764,0.6411960132890365
234,287,이네/Josa,1200,505,695,0.005635211737245747,0.007741175947933095,0.5791666666666667
235,288,전혀/Noun,1199,338,861,0.0037790374569300882,0.00958484195561874,0.7180984153461217
236,289,기대/Noun,1198,745,453,0.008302767589196399,0.005053421888535951,0.6218697829716193
237,290,지다/Verb,1197,523,674,0.005835278426142047,0.0075079410915391285,0.5630743525480367
238,291,모두/Noun,1194,810,384,0.009025230632433032,0.004287078788955775,0.6783919597989949
239,292,대박/Noun,1180,975,205,0.010859175280649105,0.002299029298740532,0.826271186440678
240,293,대한/Noun,1173,715,458,0.00796932310770257,0.005108953997201182,0.6095481670929241
241,294,공감/Noun,1172,643,529,0.0071690563521173735,0.005897509940247452,0.5486348122866894
242,295,씨/Suffix,1170,706,464,0.00786928976325442,0.005175592527599458,0.6034188034188034
243,296,근데/Adverb,1165,632,533,0.007046793375569634,0.005941935627179635,0.5424892703862659
244,297,별/Noun,1164,304,860,0.003401133711237079,0.009573735533885692,0.7388316151202751
245,298,이쁘다/Adjective,1161,733,428,0.008169389796598866,0.0047757613452098,0.6313522825150732
246,299,계속/Noun,1161,707,454,0.007880404579304213,0.0050645283102689976,0.6089577950043066
247,300,굿/Noun,1156,1072,84,0.011937312437479159,0.00095515226904196,0.9273356401384084
248,301,아주/Noun,1152,682,470,0.007602534178059353,0.005242231057997734,0.5920138888888888
249,302,시리즈/Noun,1149,660,489,0.007358008224963877,0.005453253070925609,0.5744125326370757
250,303,모습/Noun,1142,842,300,0.009380904746026451,0.003354139363379907,0.7373029772329247
251,304,별/Modifier,1142,316,826,0.0035345115038346118,0.009196117194962126,0.7232924693520141
252,305,미치다/Adjective,1139,415,724,0.004634878292764255,0.00806326217819143,0.6356453028972783
253,306,개봉/Noun,1138,496,642,0.005535178392797599,0.007152535596081654,0.5641476274165202
254,307,에는/Josa,1137,526,611,0.005868622874291431,0.006808236522357226,0.5373790677220757
255,308,전/Noun,1126,674,452,0.007513615649660998,0.0050423154668029066,0.5985790408525755
256,309,치다/Verb,1122,345,777,0.0038568411692786494,0.00865190253004287,0.6925133689839572
257,310,실망/Noun,1118,115,1003,0.001300433477825942,0.011161953841711278,0.8971377459749553
258,311,영상/Noun,1114,626,488,0.006980104479270868,0.005442146649192564,0.5619389587073609
259,313,요/Noun,1099,666,433,0.007424697121262644,0.004831293453875031,0.6060054595086443
260,315,일본/Noun,1098,391,707,0.004368122707569189,0.007874453008729647,0.6438979963570127
261,316,시키다/Verb,1097,384,713,0.0042903189952206286,0.007941091539127924,0.649954421148587
262,317,보지/Noun,1094,324,770,0.003623430032232967,0.008574157577911549,0.7038391224862889
263,318,진심/Noun,1094,415,679,0.004634878292764255,0.007563473200204358,0.6206581352833638
264,319,건지다/Verb,1093,195,898,0.002189618761809492,0.009995779559741442,0.8215919487648673
265,321,화/Suffix,1089,474,615,0.005290652439702123,0.006852662209289411,0.5647382920110193
266,323,다른/Noun,1077,615,462,0.0068578415027231296,0.005153379684133366,0.5710306406685237
267,324,이랑/Josa,1077,470,607,0.005246193175502945,0.006763810835425043,0.5636025998142989
268,325,일/Modifier,1074,387,687,0.004323663443370012,0.007652324574068727,0.6396648044692738
269,326,제목/Noun,1073,405,668,0.004523730132266311,0.007441302561140851,0.6225535880708295
270,327,귀엽다/Adjective,1069,881,188,0.009814382571968434,0.0021102201292787486,0.8241347053320861
271,329,몰입/Noun,1061,631,430,0.00703567855951984,0.004797974188675893,0.5947219604147032
272,331,대단하다/Adjective,1057,751,306,0.008369456485495166,0.0034207778937781824,0.7105014191106906
273,332,밖에/Josa,1056,430,626,0.0048016005335111715,0.006974832848352918,0.5928030303030303
274,335,뿐/Noun,1051,311,740,0.0034789374235856397,0.008240964925920167,0.7040913415794482
275,336,두/Determiner,1051,585,466,0.006524397021229299,0.0051978053710655505,0.5566127497621313
276,338,ㅎ/KoreanParticle,1048,840,208,0.009358675113926865,0.00233234856393967,0.8015267175572519
277,339,;/Punctuation,1045,287,758,0.0032121818383905746,0.008440880517114994,0.7253588516746412
278,340,표현/Noun,1042,681,361,0.00759141936200956,0.004031631089095715,0.6535508637236085
279,341,OO/Alpha,1033,220,813,0.0024674891630543515,0.009051733712432529,0.7870280735721199
280,343,가족/Noun,1031,710,321,0.007913749027453596,0.0035873742197738727,0.6886517943743938
281,345,잔잔하다/Adjective,1023,897,126,0.009992219628765144,0.001421621981829894,0.8768328445747801
282,347,요즘/Noun,1013,643,370,0.0071690563521173735,0.00413158888469313,0.6347482724580454
283,348,감/Noun,1013,542,471,0.0060464599310881394,0.005253337479730781,0.5350444225074038
284,349,점도/Noun,1011,91,920,0.001033677892630877,0.010240120837868457,0.9099901088031652
285,352,용/Noun,999,295,704,0.003301100366788929,0.00784113374353051,0.7047047047047047
286,353,떨어지다/Verb,997,207,790,0.0023229965544070245,0.00879628601257247,0.7923771313941825
287,354,ㅜㅜ/KoreanParticle,996,633,363,0.007057908191619429,0.004053843932561807,0.6355421686746988
288,355,모든/Noun,986,630,356,0.007024563743470045,0.003976098980430485,0.6389452332657201
289,356,4/Number,981,333,648,0.0037234633766811158,0.007219174126479932,0.6605504587155964
290,358,급/Noun,974,237,737,0.002656441035900856,0.00820764566072103,0.7566735112936345
291,359,웃다/Verb,974,598,376,0.006668889629876626,0.004198227415091406,0.6139630390143738
292,360,위/Noun,973,445,528,0.004968322774258086,0.005886403518514404,0.5426515930113053
293,361,조금/Noun,967,582,385,0.006491052573079916,0.00429818521068882,0.6018614270941055
294,362,특히/Adverb,966,665,301,0.007413582305212848,0.0033652457851129523,0.6884057971014492
295,363,여/Modifier,966,412,554,0.004601533844614872,0.006175170483573602,0.5734989648033126
296,364,빠지다/Verb,964,602,362,0.006713348894075803,0.0040427375108287615,0.6244813278008299
297,366,개인/Noun,957,633,324,0.007057908191619429,0.003620693484973011,0.6614420062695925
298,367,분/Noun,957,530,427,0.005913082138490608,0.0047646549234767535,0.5538140020898642
299,368,스릴러/Noun,954,424,530,0.004734911637212404,0.005908616361980497,0.5555555555555556
300,369,공포/Noun,951,319,632,0.0035678559519839955,0.007041471378751194,0.6645636172450052
301,370,짜다/Verb,947,361,586,0.00403467822607536,0.006530575979031076,0.6187961985216474
302,372,건/Noun,932,292,640,0.0032677559186395466,0.0071303227526155625,0.6866952789699571
303,373,한테/Josa,931,317,614,0.0035456263198844064,0.006841555787556365,0.6595059076262084
304,374,작가/Noun,929,209,720,0.002345226186506613,0.008018836491259245,0.77502691065662
305,375,이유/Noun,928,364,564,0.00406802267422474,0.006286234700904063,0.6077586206896551
306,376,나름/Noun,923,600,323,0.006691119261976214,0.003609587063239965,0.6500541711809318
307,377,잼/Noun,923,524,399,0.0058463932421918404,0.004453675114951465,0.5677139761646804
308,378,시작/Noun,922,432,490,0.00482383016561076,0.0054643594926586546,0.5314533622559653
309,379,욕/Noun,910,166,744,0.0018672890963654552,0.00828539061285235,0.8175824175824176
310,380,차라리/Noun,909,59,850,0.0006780037790374569,0.00946267131655523,0.935093509350935
311,381,이상하다/Adjective,909,232,677,0.002600866955651884,0.007541260356738266,0.7447744774477447
312,382,노래/Noun,909,604,305,0.006735578526175392,0.0034096714720451365,0.6644664466446645
313,383,깊다/Adjective,907,808,99,0.009003001000333445,0.0011217485950376508,0.8908489525909592
314,384,제대로/Noun,907,366,541,0.00409025230632433,0.0060307870010440036,0.5964718853362734
315,385,짱/Noun,905,842,63,0.009380904746026451,0.0007219174126479931,0.9303867403314916
316,386,중간/Noun,905,328,577,0.0036678892964321437,0.0064306181834336605,0.6375690607734806
317,387,울다/Verb,900,695,205,0.00774702678670668,0.002299029298740532,0.7722222222222223
318,388,알바/Noun,897,104,793,0.001178170501278204,0.008829605277771607,0.8840579710144928
319,390,0/Number,888,77,811,0.0008780704679337558,0.009029520868966436,0.9132882882882885
320,392,따뜻하다/Adjective,884,833,51,0.009280871401578305,0.0005886403518514405,0.9423076923076924
321,393,느껴지다/Verb,884,553,331,0.0061687229076358785,0.0036984384371043337,0.6255656108597285
322,394,삶/Noun,883,770,113,0.008580637990441259,0.0012772384993002955,0.8720271800679502
323,395,에도/Josa,881,473,408,0.0052795376236523285,0.0045536329105488795,0.5368898978433598
324,396,",,/Punctuation",879,413,466,0.004612648660664666,0.0051978053710655505,0.5301478953356087
325,397,...../Punctuation,877,327,550,0.003656774480382349,0.006130744796641418,0.6271379703534777
326,398,제/Noun,874,553,321,0.0061687229076358785,0.0035873742197738727,0.6327231121281465
327,399,오랜/Modifier,870,699,171,0.007791486050905858,0.0019214109598169665,0.8034482758620691
328,400,기/Noun,869,240,629,0.0026897854840502392,0.007008152113552056,0.7238204833141542
329,401,예쁘다/Adjective,865,571,294,0.006368789596532178,0.00328750083298163,0.6601156069364161
330,402,제일/Noun,865,507,358,0.0056574413693453365,0.003998311823896578,0.5861271676300578
331,403,당시/Noun,862,550,312,0.006135378459486495,0.003487416424176459,0.6380510440835266
332,404,빼다/Verb,861,250,611,0.002800933644548183,0.006808236522357226,0.7096399535423926
333,405,점수/Noun,857,271,586,0.0030343447815938647,0.006530575979031076,0.6837806301050176
334,406,해보다/Verb,855,496,359,0.005535178392797599,0.004009418245629622,0.5801169590643275
335,408,영화로/Noun,847,377,470,0.004212515282872069,0.005242231057997734,0.5548996458087367
336,409,놈/Noun,846,250,596,0.002800933644548183,0.006641640196361536,0.7044917257683215
337,410,아직도/Adverb,841,631,210,0.00703567855951984,0.002354561407405762,0.7502972651605232
338,411,어설프다/Adjective,834,79,755,0.0009003001000333445,0.008407561251915855,0.9052757793764988
339,412,막장/Noun,834,144,690,0.001622763143269979,0.007685643839267866,0.8273381294964028
340,413,력/Suffix,830,347,483,0.003879070801378237,0.005386614540527333,0.5819277108433735
341,416,훌륭하다/Adjective,825,663,162,0.007391352673113259,0.001821453164219552,0.8036363636363636
342,417,세상/Noun,824,533,291,0.00594642658663999,0.003254181567782492,0.6468446601941747
343,418,이지/Josa,815,332,483,0.003712348560631322,0.005386614540527333,0.5926380368098161
344,419,이라고/Josa,815,342,473,0.003823496721129265,0.0052755503231968716,0.5803680981595092
345,420,공포영화/Noun,809,293,516,0.003278870734689341,0.005753126457717852,0.6378244746600742
346,422,도대체/Noun,805,101,704,0.0011448260531288204,0.00784113374353051,0.8745341614906832
347,424,힘들다/Adjective,799,310,489,0.0034678226075358447,0.005453253070925609,0.6120150187734669
348,425,앞/Noun,797,485,312,0.005412915416249861,0.003487416424176459,0.6085319949811794
349,426,생각나다/Verb,795,647,148,0.00721351561631655,0.001665963259956907,0.8138364779874214
350,427,류/Noun,790,141,649,0.0015894186951205956,0.007230280548212976,0.8215189873417722
351,428,로/Noun,790,335,455,0.0037456930087807045,0.005075634732002044,0.5759493670886076
352,430,의/Noun,788,444,344,0.00495720795820829,0.003842821919633933,0.5634517766497462
353,431,절대/Noun,787,263,524,0.0029454262531955103,0.005841977831582221,0.6658195679796697
354,432,그리다/Verb,785,442,343,0.004934978326108703,0.0038317154979008857,0.5630573248407643
355,433,뭘/Noun,782,175,607,0.001967322440813605,0.006763810835425043,0.7762148337595908
356,434,잇다/Verb,780,524,256,0.0058463932421918404,0.00286545680712588,0.6717948717948717
357,435,우리나라/Noun,778,423,355,0.00472379682116261,0.003964992558697439,0.5437017994858612
358,437,물/Noun,777,295,482,0.003301100366788929,0.005375508118794287,0.6203346203346203
359,438,제/Modifier,775,314,461,0.0035122818717350226,0.00514227326240032,0.5948387096774194
360,439,미국/Noun,774,361,413,0.00403467822607536,0.0046091650192141105,0.5335917312661499
361,440,써다/Verb,768,243,525,0.0027231299321996217,0.005853084253315267,0.68359375
362,441,수작/Noun,766,696,70,0.007758141602756475,0.0007996623647793153,0.908616187989556
363,442,엄청/Adverb,766,465,301,0.0051906190952539745,0.0033652457851129523,0.6070496083550914
364,443,걍/Adverb,765,208,557,0.002334111370456819,0.00620848974877274,0.7281045751633987
365,444,설정/Noun,762,139,623,0.0015671890630210071,0.0069415135831537795,0.8175853018372703
366,445,초반/Noun,761,265,496,0.0029676558852950985,0.005530998023056932,0.6517739816031537
367,446,찾다/Verb,758,431,327,0.004812715349560965,0.003654012750172149,0.5686015831134564
368,447,5/Number,758,346,412,0.0038679559853284423,0.004598058597481063,0.5435356200527705
369,448,놓다/Verb,755,225,530,0.0025230632433033235,0.005908616361980497,0.7019867549668874
370,449,필요없다/Adjective,754,630,124,0.007024563743470045,0.0013994091383638019,0.8355437665782494
371,450,일/Noun,751,400,351,0.004468156052017339,0.003920566871765255,0.5326231691078562
372,451,신선하다/Adjective,748,507,241,0.0056574413693453365,0.002698860481130189,0.6778074866310161
373,452,싫다/Adjective,746,130,616,0.0014671557185728574,0.0068637686310224575,0.8257372654155496
374,453,시나리오/Noun,742,207,535,0.0023229965544070245,0.005964148470645727,0.7210242587601078
375,454,딱/Adverb,742,251,491,0.002812048460597977,0.005475465914391701,0.6617250673854448
376,455,이란/Josa,742,435,307,0.004857174613760142,0.0034318843155112288,0.5862533692722371
377,456,사실/Noun,742,429,313,0.004790485717461376,0.003498522845909505,0.578167115902965
378,458,출연/Noun,740,226,514,0.0025341780593531177,0.00573091361425176,0.6945945945945946
379,461,멋있다/Adjective,732,615,117,0.0068578415027231296,0.0013216641862324795,0.8401639344262295
380,462,관객/Noun,732,188,544,0.002111815049460932,0.006064106266243142,0.7431693989071039
381,463,한국영/Noun,731,295,436,0.003301100366788929,0.004864612719074169,0.5964432284541724
382,464,이야/Josa,730,298,432,0.003334444814938313,0.004820187032141985,0.5917808219178082
383,465,가지/Noun,725,278,447,0.003112148493942425,0.004986783358137676,0.616551724137931
384,466,노잼/Noun,724,17,707,0.00021118150494609317,0.007874453008729647,0.9765193370165746
385,468,뭔/Modifier,722,104,618,0.001178170501278204,0.006885981474488549,0.8559556786703602
386,469,분위기/Noun,721,443,278,0.004946093142158497,0.003109798085252893,0.6144244105409153
387,470,답답하다/Adjective,719,131,588,0.001478270534622652,0.006552788822497168,0.8178025034770514
388,471,아프다/Adjective,719,559,160,0.006235411803934645,0.0017992403207534593,0.7774687065368567
389,472,시대/Noun,719,474,245,0.005290652439702123,0.0027432861680623736,0.6592489568845619
390,473,봄/Noun,718,398,320,0.00444592641991775,0.003576267798040827,0.5543175487465181
391,474,장난/Noun,714,182,532,0.002045126153162165,0.005930829205446589,0.7450980392156863
392,475,죽이다/Verb,713,198,515,0.002222963209958875,0.005742020035984807,0.7223001402524544
393,477,최고다/Noun,711,679,32,0.007569189729909971,0.0003776183389235656,0.9549929676511956
394,478,스럽다/Adjective,711,238,473,0.00266755585195065,0.0052755503231968716,0.6652601969057665
395,479,명/Noun,711,303,408,0.0033900188951872853,0.0045536329105488795,0.5738396624472574
396,480,OOO/Alpha,708,91,617,0.001033677892630877,0.006874875052755503,0.8714689265536724
397,481,결국/Adverb,708,253,455,0.0028342780926975657,0.005075634732002044,0.6426553672316384
398,482,지루함/Noun,707,100,607,0.0011337112370790265,0.006763810835425043,0.8585572842998586
399,483,추억/Noun,707,576,131,0.006424363676781149,0.0014771540904951245,0.8147100424328148
400,484,나쁘다/Adjective,707,269,438,0.003012115149494276,0.004886825562540261,0.6195190947666195
401,485,대/Suffix,707,376,331,0.0042014004668222745,0.0036984384371043337,0.5318246110325319
402,486,소리/Noun,705,202,503,0.0022674224741580525,0.005608742975188254,0.7134751773049646
403,487,니/Josa,705,294,411,0.0032899855507391353,0.004586952175748018,0.5829787234042553
404,488,따다/Verb,704,382,322,0.00426808936312104,0.0035984806415069195,0.5426136363636364
405,489,이딴/Modifier,703,26,677,0.00031121484939424253,0.007541260356738266,0.9630156472261736
406,490,더럽다/Adjective,701,81,620,0.0009225297321329332,0.00690819431795464,0.8844507845934381
407,491,준/Noun,699,391,308,0.004368122707569189,0.003442990737244275,0.5593705293276109
408,492,영화관/Noun,695,298,397,0.003334444814938313,0.004431462271485373,0.5712230215827339
409,493,마다/Josa,694,480,214,0.005357341336000889,0.0023989870943379463,0.69164265129683
410,494,살/Noun,690,420,270,0.004690452373013226,0.003020946711388525,0.6086956521739131
411,495,인상/Noun,689,547,142,0.006102034011337114,0.0015993247295586306,0.7939042089985486
412,496,이지만/Josa,687,427,260,0.0047682560853617864,0.0029098824940580643,0.6215429403202329
413,497,어이없다/Adjective,686,55,631,0.0006335445148382794,0.007030364957018148,0.9198250728862972
414,498,오늘/Noun,685,462,223,0.005157274647104589,0.002498944889935361,0.6744525547445256
415,499,감정/Noun,684,445,239,0.004968322774258086,0.0026766476376640968,0.6505847953216374
416,500,서다/Verb,684,373,311,0.00416805601867289,0.003476310002443413,0.5453216374269005
417,501,부족하다/Adjective,681,215,466,0.00241191508280538,0.0051978053710655505,0.6842878120411159
418,502,안타깝다/Adjective,681,384,297,0.0042903189952206286,0.003320820098180768,0.5638766519823789
419,503,전/Modifier,680,199,481,0.0022340780260086696,0.005364401697061241,0.7073529411764706
420,504,정신/Noun,678,183,495,0.0020562409692119594,0.0055198916013238855,0.7300884955752213
421,505,엔딩/Noun,678,431,247,0.004812715349560965,0.002765499011528466,0.6356932153392331
422,506,라면/Noun,678,389,289,0.004345893075469601,0.0032319687243164,0.5737463126843658
423,507,접/Noun,676,122,554,0.0013782371901745027,0.006175170483573602,0.8195266272189349
424,508,팬/Noun,676,366,310,0.00409025230632433,0.0034652035807103665,0.5414201183431953
425,509,잊다/Verb,674,570,104,0.0063576747804823825,0.001177280703702881,0.8456973293768546
426,510,졸작/Noun,672,34,638,0.0004001333777925976,0.007108109909149471,0.949404761904762
427,511,제발/Noun,671,179,492,0.002011781705012782,0.005486572336124747,0.7332339791356185
428,512,자신/Noun,671,422,249,0.004712682005112816,0.002787711854994558,0.6289120715350224
429,513,니까/Josa,668,282,386,0.003156607758141603,0.0043092916324218656,0.5778443113772455
430,514,아무리/Adverb,666,114,552,0.0012893186617761474,0.00615295764010751,0.8288288288288288
431,515,그저/Adverb,666,221,445,0.002478603979104145,0.004964570514671583,0.6681681681681682
432,516,코믹/Noun,662,371,291,0.004145826386573302,0.003254181567782492,0.5604229607250756
433,517,♥/Foreign,660,651,9,0.007257974880515727,0.00012217063906350652,0.9863636363636364
434,518,평가/Noun,660,352,308,0.00393464488162721,0.003442990737244275,0.5333333333333333
435,519,킬링타임/Noun,659,186,473,0.0020895854173613427,0.0052755503231968716,0.7177541729893778
436,520,~~~/Punctuation,657,400,257,0.004468156052017339,0.002876563228858926,0.60882800608828
437,521,함께/Adverb,656,544,112,0.0060686895631877295,0.0012661320775672494,0.8292682926829268
438,522,그렇게/Adverb,656,251,405,0.002812048460597977,0.00452031364534974,0.6173780487804879
439,523,음/Noun,654,290,364,0.003245526286539958,0.004064950354294853,0.5565749235474006
440,525,캐스팅/Noun,653,219,434,0.002456374347004557,0.0048423998756080755,0.664624808575804
441,526,8/Number,653,388,265,0.004334778259419807,0.0029654146027232944,0.5941807044410413
442,527,대해/Noun,651,506,145,0.005646326553295543,0.001632643994757769,0.7772657450076805
443,529,어색하다/Adjective,642,123,519,0.001389352006224297,0.0057864457229169905,0.8084112149532711
444,530,포스터/Noun,642,205,437,0.002300766922307436,0.0048757191408072146,0.6806853582554517
445,531,적다/Verb,641,432,209,0.00482383016561076,0.002343454985672716,0.6739469578783152
446,532,몰입도/Noun,638,412,226,0.004601533844614872,0.0025322641551344988,0.64576802507837
447,533,뒤/Noun,637,294,343,0.0032899855507391353,0.0038317154979008857,0.5384615384615384
448,534,엉/Exclamation,636,103,533,0.0011670556852284096,0.005941935627179635,0.8380503144654088
449,535,쓸다/Verb,636,162,474,0.0018228298321662773,0.005286656744929919,0.7452830188679245
450,536,자/Suffix,632,213,419,0.002389685450705791,0.004675803549612386,0.6629746835443038
451,537,갈수록/Noun,631,192,439,0.002156274313660109,0.004897931984273306,0.6957210776545166
452,538,스릴/Noun,631,370,261,0.004134711570523508,0.0029209889157911107,0.5863708399366085
453,539,개연/Noun,630,55,575,0.0006335445148382794,0.00640840533996757,0.9126984126984128
454,540,망하다/Adjective,630,89,541,0.0010114482605312882,0.0060307870010440036,0.8587301587301587
455,541,애니메이션/Noun,630,418,212,0.004668222740913638,0.002376774250871854,0.6634920634920635
456,542,시/Modifier,626,284,342,0.003178837390241192,0.00382060907616784,0.5463258785942492
457,543,배경/Noun,625,369,256,0.004123596754473714,0.00286545680712588,0.5904
458,544,데/Noun,624,271,353,0.0030343447815938647,0.003942779715231347,0.5657051282051282
459,545,든/Josa,623,361,262,0.00403467822607536,0.002932095337524157,0.579454253611557
460,546,!!!!/Punctuation,622,460,162,0.005135045015005002,0.001821453164219552,0.7395498392282959
461,547,엄마/Noun,622,344,278,0.003845726353228854,0.003109798085252893,0.5530546623794212
462,549,문제/Noun,619,201,418,0.002256307658108259,0.00466469712787934,0.6752827140549273
463,550,진부하다/Adjective,618,109,509,0.0012337445815271755,0.005675381505586529,0.8236245954692557
464,551,살리다/Verb,618,260,358,0.0029120818050461265,0.003998311823896578,0.5792880258899676
465,552,이름/Noun,617,239,378,0.002678670668000445,0.004220440258557497,0.6126418152350082
466,553,지/Modifier,617,246,371,0.002756474380349005,0.004142695306426175,0.6012965964343598
467,554,하/Exclamation,614,213,401,0.002389685450705791,0.004475887958417557,0.6530944625407166
468,555,ㅠㅠㅠ/KoreanParticle,611,496,115,0.005535178392797599,0.0012994513427663874,0.8117839607201309
469,556,두다/Verb,611,285,326,0.003189952206290986,0.003642906328439104,0.5335515548281505
470,557,나가다/Verb,610,191,419,0.0021451594976103147,0.004675803549612386,0.6868852459016394
471,558,충격/Noun,610,399,211,0.004457041235967545,0.0023656678291388076,0.6540983606557377
472,559,비다/Verb,610,253,357,0.0028342780926975657,0.003987205402163531,0.5852459016393443
473,560,맘/Noun,609,373,236,0.00416805601867289,0.0026433283724649594,0.6124794745484401
474,562,유쾌하다/Adjective,603,554,49,0.006179837723685673,0.0005664275083853486,0.9187396351575456
475,563,머리/Noun,603,235,368,0.002634211403801267,0.004109376041227037,0.6102819237147595
476,565,보단/Josa,600,239,361,0.002678670668000445,0.004031631089095715,0.6016666666666667
477,566,완벽하다/Adjective,599,512,87,0.00571301544959431,0.0009884715342410985,0.8547579298831386
478,567,질/Noun,599,104,495,0.001178170501278204,0.0055198916013238855,0.8263772954924875
479,568,여/Josa,598,263,335,0.0029454262531955103,0.003742864124036518,0.560200668896321
480,569,를/Noun,597,280,317,0.0031343781260420142,0.003542948532841689,0.5309882747068677
481,570,영화인/Noun,596,336,260,0.003756807824830499,0.0029098824940580643,0.5637583892617449
482,572,만화/Noun,595,266,329,0.002978770701344893,0.0036762255936382423,0.5529411764705883
483,574,놀라다/Verb,594,366,228,0.00409025230632433,0.002554476998600591,0.6161616161616161
484,575,적/Noun,593,406,187,0.004534844948316105,0.002099113707545703,0.684654300168634
485,576,예술/Noun,593,258,335,0.0028898521729465373,0.003742864124036518,0.5649241146711635
486,577,기도/Noun,591,342,249,0.003823496721129265,0.002787711854994558,0.5786802030456852
487,578,강추/Noun,590,547,43,0.006102034011337114,0.0004997889779870722,0.9271186440677966
488,579,행복하다/Adjective,590,524,66,0.0058463932421918404,0.0007552366778471312,0.8881355932203391
489,580,얘기/Noun,590,217,373,0.0024341447149049678,0.004164908149892268,0.6322033898305085
490,581,대/Foreign,587,217,370,0.0024341447149049678,0.00413158888469313,0.6303236797274276
491,583,장르/Noun,583,201,382,0.002256307658108259,0.004264865945489682,0.6552315608919382
492,585,더빙/Noun,582,150,432,0.0016894520395687453,0.004820187032141985,0.7422680412371134
493,586,어울리다/Verb,581,319,262,0.0035678559519839955,0.002932095337524157,0.5490533562822719
494,587,만/Suffix,580,315,265,0.003523396687784817,0.0029654146027232944,0.5431034482758621
495,588,어디/Noun,579,237,342,0.002656441035900856,0.00382060907616784,0.5906735751295337
496,589,주연/Noun,577,225,352,0.0025230632433033235,0.0039316732934983,0.6100519930675911
497,590,얼굴/Noun,576,199,377,0.0022340780260086696,0.004209333836824453,0.6545138888888888
498,591,은/Noun,576,256,320,0.0028676225408469486,0.003576267798040827,0.5555555555555556
499,592,후반/Noun,574,266,308,0.002978770701344893,0.003442990737244275,0.5365853658536586
500,593,즐겁다/Adjective,573,495,78,0.005524063576747805,0.0008885137386436838,0.8638743455497382
501,594,들이다/Verb,573,233,340,0.0026119817717016785,0.0037983962327017475,0.5933682373472949
502,595,같이/Adverb,572,327,245,0.003656774480382349,0.0027432861680623736,0.5716783216783217
503,596,웃기/Noun,571,344,227,0.003845726353228854,0.0025433705768675447,0.6024518388791593
504,597,머/Noun,570,97,473,0.0011003667889296432,0.0052755503231968716,0.8298245614035088
505,598,집중/Noun,568,252,316,0.002823163276647772,0.003531842111108643,0.5563380281690141
506,599,비/Noun,563,225,338,0.0025230632433033235,0.003776183389235656,0.6003552397868561
507,600,여기/Noun,563,228,335,0.002556407691452707,0.003742864124036518,0.5950266429840142
508,601,꽤/Noun,562,441,121,0.00492386351005891,0.001366089873164664,0.7846975088967971
509,603,짜증/Noun,558,23,535,0.00027787040124485944,0.005964148470645727,0.9587813620071683
510,604,9/Number,557,382,175,0.00426808936312104,0.00196583664674915,0.6858168761220825
511,605,매우/Noun,557,343,214,0.0038346115371790603,0.0023989870943379463,0.6157989228007181
512,606,ㅡ/KoreanParticle,556,157,399,0.0017672557519173055,0.004453675114951465,0.7176258992805755
513,607,날/Noun,556,337,219,0.003767922640880293,0.0024545192030031764,0.6061151079136691
514,608,ㅎㅎㅎ/KoreanParticle,555,434,121,0.004846059797710348,0.001366089873164664,0.781981981981982
515,609,읽다/Verb,555,242,313,0.0027120151161498275,0.003498522845909505,0.563963963963964
516,610,너무나/Adverb,552,365,187,0.004079137490274536,0.002099113707545703,0.6612318840579711
517,611,이리/Adverb,552,199,353,0.0022340780260086696,0.003942779715231347,0.6394927536231884
518,612,진/Noun,552,216,336,0.002423029898855174,0.0037539705457695642,0.6086956521739131
519,613,누구/Noun,552,311,241,0.0034789374235856397,0.002698860481130189,0.5634057971014492
520,614,???/Punctuation,551,142,409,0.0016005335111703902,0.004564739332281925,0.7422867513611615
521,615,두/Noun,551,362,189,0.004045793042125153,0.002121326551011795,0.6569872958257713
522,617,새롭다/Adjective,549,377,172,0.004212515282872069,0.0019325173815500122,0.6867030965391621
523,618,전쟁/Noun,549,326,223,0.0036456596643325546,0.002498944889935361,0.5938069216757741
524,619,건가/Noun,546,124,422,0.0014004668222740914,0.004709122814811524,0.7728937728937729
525,620,아직/Adverb,546,363,183,0.004056907858174947,0.0020546880206135185,0.6648351648351648
526,621,생기다/Verb,545,190,355,0.00213404468156052,0.003964992558697439,0.6513761467889908
527,622,상황/Noun,545,243,302,0.0027231299321996217,0.0033763522068459982,0.5541284403669725
528,623,언제/Noun,545,290,255,0.003245526286539958,0.0028543503853928343,0.5321100917431193
529,624,멀다/Adjective,544,178,366,0.0020006668889629878,0.004087163197760945,0.6727941176470589
530,625,작/Modifier,544,183,361,0.0020562409692119594,0.004031631089095715,0.6636029411764706
531,626,소름/Noun,540,437,103,0.004879404245859731,0.001166174281969835,0.8092592592592592
532,627,심하다/Adjective,539,81,458,0.0009225297321329332,0.005108953997201182,0.8497217068645642
533,628,충분하다/Adjective,539,414,125,0.004623763476714461,0.001410515560096848,0.7680890538033395
534,629,불쌍하다/Adjective,539,206,333,0.0023118817383572304,0.0037206512805704256,0.6178107606679035
535,630,글/Noun,538,195,343,0.002189618761809492,0.0038317154979008857,0.6375464684014871
536,631,식/Suffix,534,210,324,0.002356341002556408,0.003620693484973011,0.6067415730337079
537,632,걸작/Noun,533,459,74,0.005123930198955207,0.0008440880517114996,0.8611632270168855
538,633,그나마/Adverb,532,40,492,0.0004668222740913638,0.005486572336124747,0.924812030075188
539,634,억지/Noun,527,72,455,0.0008224963876847838,0.005075634732002044,0.8633776091081594
540,635,대체/Noun,527,89,438,0.0010114482605312882,0.004886825562540261,0.8311195445920304
541,636,다큐/Noun,527,223,304,0.0025008336112037344,0.0033985650503120905,0.5768500948766604
542,638,시절/Noun,526,397,129,0.004434811603867956,0.0014549412470290322,0.7547528517110266
543,640,존나/Noun,525,122,403,0.0013782371901745027,0.004498100801883649,0.7676190476190476
544,641,약간/Noun,525,357,168,0.003990218961876181,0.001888091694617828,0.68
545,642,역사/Noun,525,318,207,0.0035567411359342,0.002321242142206624,0.6057142857142858
546,643,궁금하다/Adjective,524,199,325,0.0022340780260086696,0.003631799906706057,0.6202290076335878
547,644,분들/Suffix,524,307,217,0.0034344781593864623,0.0024323063595370845,0.5858778625954199
548,646,실화/Noun,522,331,191,0.0037012337445815275,0.0021435393944778877,0.6340996168582376
549,647,인물/Noun,521,236,285,0.002645326219851061,0.003187543037384216,0.5470249520153551
550,648,예전/Noun,521,277,244,0.003101033677892631,0.002732179746329328,0.5316698656429942
551,650,해도/Noun,520,170,350,0.0019117483605646328,0.003909460450032209,0.6730769230769231
552,651,아무/Modifier,518,169,349,0.0019006335445148387,0.0038983540282991626,0.6737451737451737
553,652,극/Modifier,518,220,298,0.0024674891630543515,0.003331926519913814,0.5752895752895753
554,653,씬/Noun,515,279,236,0.00312326330999222,0.0026433283724649594,0.541747572815534
555,654,B/Alpha,514,133,381,0.001500500166722241,0.004253759523756636,0.7412451361867705
556,655,한마디/Noun,514,156,358,0.0017561409358675113,0.003998311823896578,0.6964980544747081
557,656,6/Number,513,237,276,0.002656441035900856,0.003087585241786801,0.5380116959064327
558,657,그대로/Noun,512,274,238,0.003067689229743248,0.0026655412159310517,0.53515625
559,659,순수하다/Adjective,506,433,73,0.004834944981660554,0.0008329816299784535,0.8557312252964426
560,660,휴/Exclamation,506,86,420,0.0009781038123819054,0.004686909971345432,0.8300395256916996
561,661,자기/Noun,506,160,346,0.001800600200066689,0.0038650347631000244,0.6837944664031621
562,662,누가/Noun,504,180,324,0.0020228965210625765,0.003620693484973011,0.6428571428571429
563,663,급/Suffix,504,211,293,0.002367455818606202,0.003276394411248584,0.5813492063492064
564,664,비교/Noun,504,220,284,0.0024674891630543515,0.0031764366156511693,0.5634920634920635
565,665,상당하다/Adjective,503,306,197,0.003423363343336668,0.0022101779248761637,0.6083499005964215
566,666,작/Noun,503,224,279,0.002511948427253529,0.003120904506985939,0.5546719681908548
567,667,",,,/Punctuation",503,232,271,0.002600866955651884,0.003032053133121571,0.5387673956262425
568,668,보/Noun,502,287,215,0.0032121818383905746,0.0024100935160709922,0.5717131474103586
569,669,니/Noun,502,220,282,0.0024674891630543515,0.003154223772185077,0.5617529880478087
570,670,만점/Noun,501,423,78,0.00472379682116261,0.0008885137386436838,0.844311377245509
571,671,초딩/Noun,501,192,309,0.002156274313660109,0.003454097158977321,0.6167664670658682
572,672,주/Modifier,501,217,284,0.0024341447149049678,0.0031764366156511693,0.5668662674650699
573,673,비디오/Noun,500,226,274,0.0025341780593531177,0.003065372398320709,0.5479999999999999
574,675,간만/Noun,496,400,96,0.004468156052017339,0.0010884293298385123,0.8064516129032258
575,677,몇/Modifier,495,218,277,0.0024452595309547628,0.0030986916635198478,0.5595959595959596
576,678,드리다/Verb,495,270,225,0.0030232299655440697,0.0025211577334014533,0.5454545454545454
577,679,필요하다/Adjective,494,325,169,0.003634544848282761,0.0018991981163508738,0.6578947368421053
578,680,부/Noun,494,227,267,0.0025452928754029127,0.002987627446189387,0.5404858299595142
579,681,만나다/Verb,491,299,192,0.003345559630988107,0.0021546458162109328,0.6089613034623218
580,682,자/Noun,489,199,290,0.0022340780260086696,0.0032430751460494453,0.5930470347648262
581,683,라도/Josa,488,145,343,0.0016338779593197733,0.0038317154979008857,0.7028688524590164
582,684,~!/Punctuation,487,385,102,0.0043014338112704244,0.001155067860236789,0.7905544147843943
583,685,CG/Alpha,487,126,361,0.0014226964543736804,0.004031631089095715,0.7412731006160165
584,686,굉장하다/Adjective,486,338,148,0.0037790374569300882,0.001665963259956907,0.6954732510288066
585,687,전체/Noun,486,158,328,0.0017783705679671,0.003665119171905196,0.6748971193415638
586,689,떠나다/Verb,484,271,213,0.0030343447815938647,0.0023878806726049,0.5599173553719008
587,690,뿐/Suffix,482,150,332,0.0016894520395687453,0.0037095448588373796,0.6887966804979253
588,691,감성/Noun,482,311,171,0.0034789374235856397,0.0019214109598169665,0.6452282157676349
589,692,다음/Noun,482,299,183,0.003345559630988107,0.0020546880206135185,0.6203319502074689
590,693,사회/Noun,481,337,144,0.003767922640880293,0.0016215375730247227,0.7006237006237006
591,694,오/Modifier,481,187,294,0.0021007002334111373,0.00328750083298163,0.6112266112266113
592,695,네이버/Noun,480,179,301,0.002011781705012782,0.0033652457851129523,0.6270833333333333
593,696,아들/Noun,480,261,219,0.002923196621095921,0.0024545192030031764,0.54375
594,697,발연기/Noun,477,34,443,0.0004001333777925976,0.004942357671205491,0.9287211740041929
595,698,무슨/Modifier,476,124,352,0.0014004668222740914,0.0039316732934983,0.7394957983193278
596,699,그런/Modifier,475,189,286,0.002122929865510726,0.003198649459117261,0.6021052631578947
597,700,ㅜ/KoreanParticle,474,275,199,0.003078804045793042,0.002232390768342256,0.5801687763713079
598,701,당하다/Adjective,473,184,289,0.002067355785261754,0.0032319687243164,0.6109936575052854
599,703,남기다/Verb,471,253,218,0.0028342780926975657,0.0024434127812701305,0.5371549893842887
600,704,따르다/Verb,470,174,296,0.0019562076247638107,0.0033097136764477218,0.6297872340425532
601,705,바로/Noun,469,253,216,0.0028342780926975657,0.0024211999378040377,0.5394456289978679
602,706,판/Noun,468,203,265,0.002278537290207847,0.0029654146027232944,0.5662393162393162
603,707,ㅉㅉ/KoreanParticle,466,72,394,0.0008224963876847838,0.004398143006286235,0.8454935622317596
604,708,이르다/Verb,466,177,289,0.001989552072913193,0.0032319687243164,0.6201716738197425
605,709,여배우/Noun,466,198,268,0.002222963209958875,0.0029987338679224327,0.575107296137339
606,710,꿈/Noun,465,353,112,0.003945759697677003,0.0012661320775672494,0.7591397849462366
607,711,돌리다/Verb,463,161,302,0.0018117150161164836,0.0033763522068459982,0.652267818574514
608,712,주제/Noun,463,191,272,0.0021451594976103147,0.0030431595548546173,0.5874730021598272
609,713,혼자/Noun,462,213,249,0.002389685450705791,0.002787711854994558,0.5389610389610391
610,714,에요/Josa,461,357,104,0.003990218961876181,0.001177280703702881,0.7744034707158352
611,715,나이/Noun,460,314,146,0.0035122818717350226,0.001643750416490815,0.6826086956521739
612,716,반/Modifier,460,206,254,0.0023118817383572304,0.002843243963659788,0.5521739130434783
613,718,이/Foreign,458,326,132,0.0036456596643325546,0.0014882605122281704,0.7117903930131004
614,719,터지다/Verb,458,267,191,0.0029898855173946877,0.0021435393944778877,0.5829694323144105
615,720,코/Noun,458,203,255,0.002278537290207847,0.0028543503853928343,0.5567685589519651
616,721,화려하다/Adjective,458,251,207,0.002812048460597977,0.002321242142206624,0.5480349344978166
617,722,;;;/Punctuation,457,106,351,0.0012004001333777929,0.003920566871765255,0.7680525164113785
618,723,사랑스럽다/Adjective,456,433,23,0.004834944981660554,0.00027766054332615115,0.949561403508772
619,724,돋다/Verb,454,348,106,0.003890185617428032,0.0011994935471689732,0.7665198237885462
620,725,교훈/Noun,454,274,180,0.003067689229743248,0.0020213687554143807,0.6035242290748899
621,726,엄청나다/Adjective,453,290,163,0.003245526286539958,0.0018325595859525977,0.6401766004415012
622,728,소설/Noun,449,173,276,0.001945092808714016,0.003087585241786801,0.6146993318485523
623,729,죠/Josa,448,250,198,0.002800933644548183,0.002221284346609209,0.5580357142857143
624,730,이라도/Josa,446,106,340,0.0012004001333777929,0.0037983962327017475,0.7623318385650224
625,731,잔인하다/Adjective,446,190,256,0.00213404468156052,0.00286545680712588,0.5739910313901345
626,732,감사하다/Verb,445,404,41,0.004512615316216518,0.00047757613452098,0.907865168539326
627,733,바라다/Verb,444,271,173,0.0030343447815938647,0.0019436238032830586,0.6103603603603603
628,734,힘/Noun,443,266,177,0.002978770701344893,0.0019880494902152425,0.6004514672686229
629,735,거의/Noun,443,201,242,0.002256307658108259,0.0027099669028632354,0.54627539503386
630,736,시즌/Noun,442,315,127,0.003523396687784817,0.00143272840356294,0.7126696832579186
631,738,너/Noun,438,183,255,0.0020562409692119594,0.0028543503853928343,0.5821917808219178
632,739,빨리/Adverb,437,191,246,0.0021451594976103147,0.00275439258979542,0.562929061784897
633,741,방송/Noun,436,131,305,0.001478270534622652,0.0034096714720451365,0.6995412844036697
634,742,지나다/Verb,435,309,126,0.003456707791486051,0.001421621981829894,0.7103448275862069
635,743,모든/Modifier,434,259,175,0.002900966988996332,0.00196583664674915,0.5967741935483871
636,744,존재/Noun,434,257,177,0.0028787373568967428,0.0019880494902152425,0.5921658986175116
637,746,삼류/Noun,433,33,400,0.00038901856174280313,0.004464781536684511,0.9237875288683602
638,747,몇번/Noun,431,334,97,0.0037345781927309103,0.0010995357515715587,0.7749419953596288
639,748,진정하다/Adjective,431,313,118,0.0035011670556852285,0.0013327706079655256,0.7262180974477959
640,749,말고/Josa,431,182,249,0.002045126153162165,0.002787711854994558,0.5777262180974478
641,751,독특하다/Adjective,429,293,136,0.003278870734689341,0.0015326861991603546,0.6829836829836831
642,752,잡다/Verb,429,149,280,0.0016783372235189508,0.003132010928718985,0.6526806526806527
643,753,죽/Noun,428,138,290,0.0015560742469712125,0.0032430751460494453,0.677570093457944
644,754,....../Punctuation,427,155,272,0.001745026119817717,0.0030431595548546173,0.6370023419203747
645,755,당신/Noun,427,243,184,0.0027231299321996217,0.002065794442346565,0.5690866510538641
646,756,+/Punctuation,426,174,252,0.0019562076247638107,0.002821031120193696,0.5915492957746479
647,757,목소리/Noun,426,184,242,0.002067355785261754,0.0027099669028632354,0.5680751173708921
648,758,여주/Noun,424,130,294,0.0014671557185728574,0.00328750083298163,0.6933962264150944
649,759,담다/Verb,424,278,146,0.003112148493942425,0.001643750416490815,0.6556603773584906
650,760,가볍다/Adjective,423,287,136,0.0032121818383905746,0.0015326861991603546,0.6784869976359338
651,762,질질/Noun,419,72,347,0.0008224963876847838,0.0038761411848330703,0.8281622911694511
652,763,전부/Noun,418,133,285,0.001500500166722241,0.003187543037384216,0.6818181818181818
653,764,바/Noun,418,165,253,0.001856174280315661,0.0028321375419267424,0.6052631578947368
654,765,줄거리/Noun,417,136,281,0.0015338446148716238,0.0031431173504520315,0.6738609112709832
655,766,맛/Noun,417,190,227,0.00213404468156052,0.0025433705768675447,0.5443645083932853
656,768,신/Noun,416,182,234,0.002045126153162165,0.002621115528998867,0.5625
657,769,라니/Josa,416,226,190,0.0025341780593531177,0.002132432972744841,0.5432692307692307
658,770,점주/Noun,415,98,317,0.0011114816049794377,0.003542948532841689,0.763855421686747
659,771,실제/Noun,415,250,165,0.002800933644548183,0.0018547724294186894,0.6024096385542169
660,773,망치다/Verb,414,42,372,0.0004890519061909527,0.004153801728159222,0.8985507246376812
661,774,답/Noun,413,100,313,0.0011337112370790265,0.003498522845909505,0.7578692493946732
662,775,넘치다/Adjective,412,298,114,0.003334444814938313,0.0012883449210333415,0.7233009708737864
663,776,에선/Josa,411,226,185,0.0025341780593531177,0.002076900864079611,0.5498783454987834
664,777,성하다/Adjective,410,37,373,0.0004334778259419807,0.004164908149892268,0.9097560975609756
665,779,낭비/Noun,408,8,400,0.00011114816049794375,0.004464781536684511,0.9803921568627452
666,780,뜨다/Verb,408,147,261,0.0016561075914193618,0.0029209889157911107,0.6397058823529411
667,781,으로도/Josa,408,240,168,0.0026897854840502392,0.001888091694617828,0.5882352941176471
668,783,각본/Noun,407,121,286,0.0013671223741247086,0.003198649459117261,0.7027027027027027
669,785,맞추다/Verb,404,109,295,0.0012337445815271755,0.0032986072547146763,0.7301980198019802
670,786,재/Noun,401,255,146,0.002856507724797155,0.001643750416490815,0.6359102244389028
671,787,필요/Noun,401,226,175,0.0025341780593531177,0.00196583664674915,0.5635910224438903
672,789,성룡/Noun,398,235,163,0.002634211403801267,0.0018325595859525977,0.5904522613065326
673,790,란/Noun,398,215,183,0.00241191508280538,0.0020546880206135185,0.5402010050251256
674,791,순간/Noun,397,263,134,0.0029454262531955103,0.0015104733556942625,0.6624685138539043
675,792,어른/Noun,397,249,148,0.0027898188284983887,0.001665963259956907,0.6272040302267002
676,793,평론가/Noun,397,239,158,0.002678670668000445,0.0017770274772873676,0.6020151133501259
677,794,갑자기/Noun,396,103,293,0.0011670556852284096,0.003276394411248584,0.73989898989899
678,795,제작/Noun,396,143,253,0.0016116483272201846,0.0028321375419267424,0.6388888888888888
679,796,판타지/Noun,396,181,215,0.00203401133711237,0.0024100935160709922,0.5429292929292929
680,797,이하/Noun,395,34,361,0.0004001333777925976,0.004031631089095715,0.9139240506329114
681,800,기다리다/Verb,392,279,113,0.00312326330999222,0.0012772384993002955,0.7117346938775511
682,801,간다/Noun,392,151,241,0.0017005668556185395,0.002698860481130189,0.6147959183673469
683,802,너무하다/Adjective,390,50,340,0.0005779704345893076,0.0037983962327017475,0.8717948717948718
684,803,의도/Noun,390,66,324,0.0007558074913860174,0.003620693484973011,0.8307692307692308
685,804,발/Noun,390,81,309,0.0009225297321329332,0.003454097158977321,0.7923076923076923
686,805,영/Noun,390,107,283,0.001211514949427587,0.0031653301939181234,0.7256410256410256
687,807,밑/Noun,388,119,269,0.0013448927420251196,0.0030098402896554786,0.6932989690721649
688,808,TV/Alpha,388,158,230,0.0017783705679671,0.002576689842066683,0.5927835051546392
689,809,땜/Noun,387,126,261,0.0014226964543736804,0.0029209889157911107,0.6744186046511628
690,810,넣다/Verb,385,86,299,0.0009781038123819054,0.00334303294164686,0.7766233766233767
691,811,아버지/Noun,385,261,124,0.002923196621095921,0.0013994091383638019,0.6779220779220779
692,812,히/Adverb,385,222,163,0.00248971879515394,0.0018325595859525977,0.5766233766233766
693,813,단순하다/Adjective,385,218,167,0.0024452595309547628,0.0018769852728847821,0.5662337662337662
694,814,다른/Modifier,385,175,210,0.001967322440813605,0.002354561407405762,0.5454545454545454
695,815,오글거리다/Verb,384,63,321,0.0007224630432366343,0.0035873742197738727,0.8359375
696,816,보내다/Verb,384,257,127,0.0028787373568967428,0.00143272840356294,0.6692708333333334
697,817,만들어지다/Verb,384,249,135,0.0027898188284983887,0.0015215797774273086,0.6484375
698,818,한편/Noun,384,232,152,0.002600866955651884,0.0017103889468890912,0.6041666666666666
699,819,피/Noun,384,156,228,0.0017561409358675113,0.002554476998600591,0.59375
700,820,상/Suffix,383,204,179,0.002289652106257641,0.0020102623336813344,0.5326370757180157
701,821,굳다/Adjective,381,349,32,0.0039013004334778256,0.0003776183389235656,0.9160104986876642
702,824,볼때/Noun,380,276,104,0.0030899188618428363,0.001177280703702881,0.7263157894736842
703,825,바꾸다/Verb,379,143,236,0.0016116483272201846,0.0026433283724649594,0.6226912928759895
704,826,들어가다/Verb,379,156,223,0.0017561409358675113,0.002498944889935361,0.5883905013192612
705,827,힘드다/Adjective,378,165,213,0.001856174280315661,0.0023878806726049,0.5634920634920635
706,828,화면/Noun,378,168,210,0.0018895187284650441,0.002354561407405762,0.5555555555555556
707,829,면/Noun,377,205,172,0.002300766922307436,0.0019325173815500122,0.5437665782493368
708,830,10년/Number,376,276,100,0.0030899188618428363,0.0011328550167706971,0.7340425531914894
709,831,세계/Noun,376,224,152,0.002511948427253529,0.0017103889468890912,0.5957446808510638
710,832,달다/Verb,376,176,200,0.001978437256863399,0.002243497190075301,0.5319148936170213
711,833,에서도/Josa,375,204,171,0.002289652106257641,0.0019214109598169665,0.544
712,834,첨/Adverb,374,111,263,0.0012559742136267645,0.002943201759257202,0.7032085561497327
713,835,막/Noun,373,133,240,0.001500500166722241,0.002687754059397144,0.6434316353887399
714,836,흥행/Noun,373,171,202,0.001922863176614427,0.0022657100335413943,0.5415549597855228
715,839,그때/Noun,371,269,102,0.003012115149494276,0.001155067860236789,0.7250673854447439
716,840,항상/Noun,371,247,124,0.0027675891963988,0.0013994091383638019,0.6657681940700808
717,841,갖다/Verb,371,162,209,0.0018228298321662773,0.002343454985672716,0.5633423180592992
718,842,좀비/Noun,370,127,243,0.0014338112704234743,0.0027210733245962818,0.6567567567567567
719,843,평/Noun,370,164,206,0.0018450594642658664,0.002310135720473578,0.5567567567567567
720,844,치고/Josa,368,112,256,0.0012670890296765588,0.00286545680712588,0.6956521739130435
721,846,뻔/Noun,367,98,269,0.0011114816049794377,0.0030098402896554786,0.7329700272479565
722,849,거지/Noun,366,99,267,0.001122596421029232,0.002987627446189387,0.7295081967213115
723,850,곳/Noun,365,245,120,0.002745359564299211,0.0013549834514316175,0.6712328767123288
724,851,원/Modifier,364,158,206,0.0017783705679671,0.002310135720473578,0.5659340659340659
725,854,에서는/Josa,362,194,168,0.0021785039457596976,0.001888091694617828,0.5359116022099447
726,855,짱/Suffix,361,320,41,0.0035789707680337892,0.00047757613452098,0.8864265927977839
727,856,성/Modifier,361,130,231,0.0014671557185728574,0.002587796263799729,0.6398891966759003
728,857,진행/Noun,360,97,263,0.0011003667889296432,0.002943201759257202,0.7305555555555555
729,860,동안/Noun,359,206,153,0.0023118817383572304,0.0017214953686221373,0.5738161559888579
730,862,이에요/Josa,358,286,72,0.0032010670223407804,0.0008218752082454075,0.7988826815642458
731,863,더욱/Noun,358,281,77,0.0031454929420918084,0.0008774073169106378,0.7849162011173184
732,864,tv/Alpha,358,103,255,0.0011670556852284096,0.0028543503853928343,0.7122905027932961
733,865,낫다/Noun,358,124,234,0.0014004668222740914,0.002621115528998867,0.6536312849162011
734,866,탄탄하다/Adjective,357,320,37,0.0035789707680337892,0.0004331504475887958,0.8963585434173671
735,867,돋보이다/Verb,357,275,82,0.003078804045793042,0.000932939425575868,0.7703081232492998
736,868,초/Noun,357,148,209,0.0016672224074691564,0.002343454985672716,0.5854341736694678
737,869,극장판/Noun,357,194,163,0.0021785039457596976,0.0018325595859525977,0.5434173669467787
738,870,어이/Noun,355,29,326,0.0003445592975436257,0.003642906328439104,0.9183098591549296
739,871,상미/Noun,355,237,118,0.002656441035900856,0.0013327706079655256,0.6676056338028169
740,872,래/Josa,355,138,217,0.0015560742469712125,0.0024323063595370845,0.6112676056338028
741,873,가보다/Verb,355,163,192,0.0018339446482160719,0.0021546458162109328,0.5408450704225352
742,874,참고/Noun,354,65,289,0.0007446926753362233,0.0032319687243164,0.8163841807909604
743,875,불편하다/Adjective,354,99,255,0.001122596421029232,0.0028543503853928343,0.7203389830508474
744,876,중국/Noun,354,122,232,0.0013782371901745027,0.002598902685532775,0.655367231638418
745,877,완성/Noun,354,212,142,0.002378570634655997,0.0015993247295586306,0.5988700564971752
746,878,딸/Noun,354,158,196,0.0017783705679671,0.0021990715031431174,0.5536723163841808
747,879,몇/Noun,353,222,131,0.00248971879515394,0.0014771540904951245,0.6288951841359773
748,880,흐르다/Verb,352,282,70,0.003156607758141603,0.0007996623647793153,0.8011363636363636
749,881,그녀/Noun,352,266,86,0.002978770701344893,0.000977365112508052,0.7556818181818182
750,882,억지스럽다/Adjective,351,50,301,0.0005779704345893076,0.0033652457851129523,0.8575498575498576
751,883,걸리다/Verb,351,96,255,0.0010892519728798488,0.0028543503853928343,0.7264957264957265
752,884,끼다/Verb,351,101,250,0.0011448260531288204,0.0027988182767276037,0.7122507122507122
753,886,즐기다/Verb,350,239,111,0.002678670668000445,0.0012550256558342032,0.6828571428571428
754,887,물론/Adverb,350,195,155,0.002189618761809492,0.0017437082120882294,0.5571428571428572
755,888,세/Noun,350,161,189,0.0018117150161164836,0.002121326551011795,0.54
756,889,세/Modifier,349,186,163,0.0020895854173613427,0.0018325595859525977,0.5329512893982808
757,890,거기/Noun,348,120,228,0.0013560075580749138,0.002554476998600591,0.6551724137931034
758,892,점점/Noun,347,138,209,0.0015560742469712125,0.002343454985672716,0.6023054755043228
759,893,듣다/Verb,346,185,161,0.002078470601311548,0.0018103467424865054,0.5346820809248555
760,894,이냐/Josa,345,47,298,0.0005446259864399244,0.003331926519913814,0.8637681159420291
761,895,수가/Noun,345,151,194,0.0017005668556185395,0.002176858659677025,0.5623188405797102
762,896,허무하다/Adjective,344,85,259,0.0009669889963321108,0.0028987760723250184,0.7529069767441859
763,897,어디서/Adverb,343,123,220,0.001389352006224297,0.0024656256247362228,0.641399416909621
764,898,관람/Noun,343,149,194,0.0016783372235189508,0.002176858659677025,0.5655976676384841
765,899,술/Noun,342,58,284,0.0006668889629876625,0.0031764366156511693,0.8304093567251462
766,900,전형/Noun,342,64,278,0.0007335778592864287,0.003109798085252893,0.8128654970760234
767,901,똑같다/Adjective,341,86,255,0.0009781038123819054,0.0028543503853928343,0.7478005865102639
768,902,편집/Noun,340,103,237,0.0011670556852284096,0.002654434794198005,0.6970588235294117
769,904,잠/Noun,339,82,257,0.0009336445481827276,0.002876563228858926,0.7581120943952803
770,905,프랑스/Noun,339,185,154,0.002078470601311548,0.0017326017903551833,0.5457227138643068
771,906,사건/Noun,337,130,207,0.0014671557185728574,0.002321242142206624,0.6142433234421365
772,907,쯤/Suffix,336,199,137,0.0022340780260086696,0.0015437926208934005,0.5922619047619048
773,908,화보/Noun,335,124,211,0.0014004668222740914,0.0023656678291388076,0.6298507462686567
774,909,잃다/Verb,335,152,183,0.001711681671668334,0.0020546880206135185,0.5462686567164179
775,910,화이팅/Noun,334,296,38,0.0033122151828387236,0.0004442568693218419,0.8862275449101796
776,911,때리다/Verb,334,116,218,0.0013115482938757365,0.0024434127812701305,0.6526946107784432
777,912,짧다/Adjective,334,217,117,0.0024341447149049678,0.0013216641862324795,0.6497005988023952
778,913,드/Noun,334,183,151,0.0020562409692119594,0.0016992825251560453,0.5479041916167665
779,914,에/Foreign,334,155,179,0.001745026119817717,0.0020102623336813344,0.5359281437125748
780,915,식상하다/Adjective,333,37,296,0.0004334778259419807,0.0033097136764477218,0.8888888888888888
781,916,마르다/Adjective,333,116,217,0.0013115482938757365,0.0024323063595370845,0.6516516516516516
782,917,리/Noun,333,148,185,0.0016672224074691564,0.002076900864079611,0.5555555555555556
783,918,메다/Verb,332,150,182,0.0016894520395687453,0.0020435815988804726,0.5481927710843374
784,919,평범하다/Adjective,332,154,178,0.0017339113037679224,0.001999155911948289,0.536144578313253
785,921,꿀잼/Noun,330,316,14,0.0035345115038346118,0.00017770274772873674,0.9575757575757576
786,922,똥/Noun,330,29,301,0.0003445592975436257,0.0033652457851129523,0.912121212121212
787,923,그게/Noun,330,91,239,0.001033677892630877,0.0026766476376640968,0.7242424242424242
788,926,가지다/Verb,329,198,131,0.002222963209958875,0.0014771540904951245,0.6018237082066871
789,927,키/Noun,329,152,177,0.001711681671668334,0.0019880494902152425,0.5379939209726444
790,928,중반/Noun,328,125,203,0.0014115816383238858,0.0022768164552744398,0.6189024390243902
791,929,취향/Noun,328,127,201,0.0014338112704234743,0.0022546036118083475,0.6128048780487805
792,931,-_-/Punctuation,327,38,289,0.000444592641991775,0.0032319687243164,0.8837920489296636
793,932,개그/Noun,327,99,228,0.001122596421029232,0.002554476998600591,0.6972477064220184
794,933,싸우다/Verb,327,124,203,0.0014004668222740914,0.0022768164552744398,0.6207951070336392
795,934,뭐라다/Verb,327,141,186,0.0015894186951205956,0.0020880072858126568,0.5688073394495413
796,935,감상/Noun,327,185,142,0.002078470601311548,0.0015993247295586306,0.5657492354740061
797,936,마무리/Noun,327,148,179,0.0016672224074691564,0.0020102623336813344,0.5474006116207951
798,938,엉망/Noun,326,22,304,0.000266755585195065,0.0033985650503120905,0.9325153374233128
799,939,병맛/Noun,326,57,269,0.0006557741469378681,0.0030098402896554786,0.8251533742331288
800,940,티/Noun,325,91,234,0.001033677892630877,0.002621115528998867,0.72
801,941,적당하다/Adjective,325,106,219,0.0012004001333777929,0.0024545192030031764,0.6738461538461539
802,942,복수/Noun,325,128,197,0.0014449260864732687,0.0022101779248761637,0.6061538461538462
803,943,대로/Josa,325,143,182,0.0016116483272201846,0.0020435815988804726,0.56
804,944,뛰어나다/Adjective,324,238,86,0.00266755585195065,0.000977365112508052,0.7345679012345679
805,945,관/Noun,324,221,103,0.002478603979104145,0.001166174281969835,0.6820987654320988
806,946,걸다/Verb,324,116,208,0.0013115482938757365,0.00233234856393967,0.6419753086419753
807,947,ㄷㄷ/KoreanParticle,324,200,124,0.002245192842058464,0.0013994091383638019,0.6172839506172839
808,948,액션영화/Noun,324,192,132,0.002156274313660109,0.0014882605122281704,0.5925925925925926
809,949,난/Josa,324,152,172,0.001711681671668334,0.0019325173815500122,0.5308641975308642
810,951,지겹다/Adjective,323,29,294,0.0003445592975436257,0.00328750083298163,0.9102167182662538
811,952,미화/Noun,323,44,279,0.0005112815382905413,0.003120904506985939,0.8637770897832817
812,953,~!!/Punctuation,323,253,70,0.0028342780926975657,0.0007996623647793153,0.7832817337461301
813,954,흥미/Noun,323,125,198,0.0014115816383238858,0.002221284346609209,0.6130030959752322
814,955,//Punctuation,323,130,193,0.0014671557185728574,0.0021657522379439787,0.5975232198142415
815,956,예상/Noun,323,138,185,0.0015560742469712125,0.002076900864079611,0.5727554179566563
816,957,자극/Noun,323,174,149,0.0019562076247638107,0.0016770696816899534,0.5386996904024768
817,958,헐다/Verb,322,92,230,0.0010447927086806713,0.002576689842066683,0.7142857142857143
818,959,몸/Noun,322,132,190,0.0014893853506724466,0.002132432972744841,0.5900621118012422
819,960,과/Noun,322,138,184,0.0015560742469712125,0.002065794442346565,0.5714285714285714
820,961,간/Suffix,322,178,144,0.0020006668889629878,0.0016215375730247227,0.5527950310559007
821,962,흥미진진/Noun,321,276,45,0.0030899188618428363,0.0005220018214531642,0.8598130841121495
822,963,거리/Noun,321,142,179,0.0016005335111703902,0.0020102623336813344,0.557632398753894
823,964,원래/Noun,321,149,172,0.0016783372235189508,0.0019325173815500122,0.5358255451713395
824,965,손/Noun,320,175,145,0.001967322440813605,0.001632643994757769,0.546875
825,967,훈훈하다/Adjective,319,281,38,0.0031454929420918084,0.0004442568693218419,0.8808777429467085
826,968,여서/Josa,319,132,187,0.0014893853506724466,0.002099113707545703,0.5862068965517241
827,969,잘만/Noun,318,239,79,0.002678670668000445,0.0008996201603767299,0.7515723270440252
828,970,에겐/Josa,317,194,123,0.0021785039457596976,0.0013883027166307562,0.61198738170347
829,971,노력/Noun,317,132,185,0.0014893853506724466,0.002076900864079611,0.583596214511041
830,972,만으로도/Josa,316,285,31,0.003189952206290986,0.00036651191719051963,0.9018987341772152
831,973,낫다/Verb,316,91,225,0.001033677892630877,0.0025211577334014533,0.7120253164556962
832,974,나르다/Verb,316,224,92,0.002511948427253529,0.0010440036429063284,0.7088607594936709
833,975,학교/Noun,316,192,124,0.002156274313660109,0.0013994091383638019,0.6075949367088608
834,976,비추다/Verb,315,48,267,0.0005557408024897189,0.002987627446189387,0.8476190476190476
835,977,괜히/Adverb,315,80,235,0.0009114149160831386,0.002632221950731913,0.7460317460317459
836,978,또한/Noun,315,208,107,0.002334111370456819,0.0012105999689020189,0.6603174603174603
837,979,과거/Noun,315,196,119,0.0022007335778592863,0.0013438770296985718,0.6222222222222222
838,980,오/Noun,315,182,133,0.002045126153162165,0.0014993669339612163,0.5777777777777777
839,981,배/Noun,315,144,171,0.001622763143269979,0.0019214109598169665,0.5428571428571428
840,982,그래픽/Noun,314,78,236,0.00088918528398355,0.0026433283724649594,0.7515923566878981
841,983,ost/Alpha,313,265,48,0.0029676558852950985,0.0005553210866523023,0.8466453674121406
842,984,그냥/Modifier,313,87,226,0.0009892186284316995,0.0025322641551344988,0.7220447284345048
843,985,이라니/Josa,313,116,197,0.0013115482938757365,0.0022101779248761637,0.6293929712460063
844,986,무/Noun,313,127,186,0.0014338112704234743,0.0020880072858126568,0.5942492012779552
845,987,그만/Adverb,312,21,291,0.00025564076914527065,0.003254181567782492,0.9326923076923076
846,988,장/Suffix,312,89,223,0.0010114482605312882,0.002498944889935361,0.7147435897435898
847,989,20/Number,312,211,101,0.002367455818606202,0.0011439614385037428,0.6762820512820513
848,990,바보/Noun,311,85,226,0.0009669889963321108,0.0025322641551344988,0.7266881028938906
849,991,성우/Noun,310,70,240,0.0008002667555851951,0.002687754059397144,0.7741935483870968
850,992,봣/Noun,308,207,101,0.0023229965544070245,0.0011439614385037428,0.6720779220779219
851,993,소중하다/Adjective,307,226,81,0.0025341780593531177,0.000921833003842822,0.7361563517915309
852,994,죽음/Noun,307,206,101,0.0023118817383572304,0.0011439614385037428,0.6710097719869706
853,995,대한민국/Noun,307,185,122,0.002078470601311548,0.0013771962948977098,0.6026058631921825
854,997,유치/Noun,306,21,285,0.00025564076914527065,0.003187543037384216,0.931372549019608
855,998,나서다/Verb,306,139,167,0.0015671890630210071,0.0018769852728847821,0.5457516339869279
856,999,도저히/Noun,305,26,279,0.00031121484939424253,0.003120904506985939,0.9147540983606556
857,1000,한심하다/Adjective,305,33,272,0.00038901856174280313,0.0030431595548546173,0.8918032786885246
858,1001,식/Noun,305,72,233,0.0008224963876847838,0.002610009107265821,0.7639344262295082
859,1002,속편/Noun,305,99,206,0.001122596421029232,0.002310135720473578,0.6754098360655738
860,1003,씩/Suffix,305,164,141,0.0018450594642658664,0.0015882183078255846,0.5377049180327869
861,1006,역겹다/Adjective,304,37,267,0.0004334778259419807,0.002987627446189387,0.8782894736842105
862,1007,울/Noun,304,228,76,0.002556407691452707,0.0008663008951775916,0.75
863,1008,무조건/Noun,304,193,111,0.0021673891297099034,0.0012550256558342032,0.6348684210526315
864,1009,닿다/Verb,303,192,111,0.002156274313660109,0.0012550256558342032,0.6336633663366337
865,1010,전달/Noun,303,115,188,0.001300433477825942,0.0021102201292787486,0.6204620462046204
866,1011,땐/Noun,303,183,120,0.0020562409692119594,0.0013549834514316175,0.6039603960396039
867,1012,상상/Noun,303,173,130,0.001945092808714016,0.0014660476687620785,0.570957095709571
868,1014,보이/Noun,302,130,172,0.0014671557185728574,0.0019325173815500122,0.5695364238410596
869,1016,천재/Noun,301,236,65,0.002645326219851061,0.0007441302561140852,0.7840531561461794
870,1017,설명/Noun,301,133,168,0.001500500166722241,0.001888091694617828,0.5581395348837209
871,1018,억지로/Noun,300,42,258,0.0004890519061909527,0.0028876696505919725,0.86
872,1019,우연히/Adverb,300,258,42,0.0028898521729465373,0.0004886825562540262,0.86
873,1020,심리/Noun,300,207,93,0.0023229965544070245,0.0010551100646393743,0.69
874,1021,화가/Noun,299,75,224,0.0008558408358341669,0.0025100513116684065,0.7491638795986622
875,1022,강하다/Adjective,299,187,112,0.0021007002334111373,0.0012661320775672494,0.6254180602006689
876,1023,댓글/Noun,297,75,222,0.0008558408358341669,0.0024878384682023146,0.7474747474747475
877,1024,자꾸/Noun,297,119,178,0.0013448927420251196,0.001999155911948289,0.5993265993265994
878,1026,속/Modifier,296,73,223,0.0008336112037345782,0.002498944889935361,0.7533783783783784
879,1027,아무/Noun,296,116,180,0.0013115482938757365,0.0020213687554143807,0.6081081081081081
880,1028,타임/Noun,296,130,166,0.0014671557185728574,0.001865878851151736,0.5608108108108109
881,1029,개다/Verb,295,73,222,0.0008336112037345782,0.0024878384682023146,0.7525423728813561
882,1030,새끼/Noun,295,80,215,0.0009114149160831386,0.0024100935160709922,0.7288135593220338
883,1031,척/Noun,294,58,236,0.0006668889629876625,0.0026433283724649594,0.8027210884353742
884,1032,예고편/Noun,294,69,225,0.0007891519395354007,0.0025211577334014533,0.7653061224489796
885,1033,다가/Noun,293,91,202,0.001033677892630877,0.0022657100335413943,0.6894197952218429
886,1034,최근/Noun,293,195,98,0.002189618761809492,0.0011106421733046046,0.6655290102389079
887,1035,길다/Adjective,293,136,157,0.0015338446148716238,0.0017659210555543215,0.5358361774744027
888,1038,현/Modifier,292,181,111,0.00203401133711237,0.0012550256558342032,0.6198630136986302
889,1039,good/Alpha,291,213,78,0.002389685450705791,0.0008885137386436838,0.7319587628865979
890,1040,어느/Modifier,291,104,187,0.001178170501278204,0.002099113707545703,0.6426116838487973
891,1041,그림/Noun,291,164,127,0.0018450594642658664,0.00143272840356294,0.5635738831615121
892,1042,잊혀지다/Verb,289,255,34,0.002856507724797155,0.00039983118238965764,0.8823529411764706
893,1043,불륜/Noun,289,75,214,0.0008558408358341669,0.0023989870943379463,0.740484429065744
894,1044,젠/Noun,289,80,209,0.0009114149160831386,0.002343454985672716,0.7231833910034602
895,1045,터/Noun,289,126,163,0.0014226964543736804,0.0018325595859525977,0.5640138408304498
896,1046,대작/Noun,288,231,57,0.0025897521396020893,0.0006552788822497168,0.8020833333333334
897,1047,짐/Noun,288,189,99,0.002122929865510726,0.0011217485950376508,0.65625
898,1048,다니다/Verb,288,105,183,0.0011892853173279985,0.0020546880206135185,0.6354166666666666
899,1049,무비/Noun,288,124,164,0.0014004668222740914,0.001843666007685644,0.5694444444444444
900,1050,불다/Verb,288,127,161,0.0014338112704234743,0.0018103467424865054,0.5590277777777778
901,1053,미안하다/Adjective,287,74,213,0.0008447260197843727,0.0023878806726049,0.7421602787456446
902,1054,촬영/Noun,287,121,166,0.0013671223741247086,0.001865878851151736,0.5783972125435539
903,1055,전편/Noun,287,125,162,0.0014115816383238858,0.001821453164219552,0.5644599303135889
904,1056,열/Noun,286,78,208,0.00088918528398355,0.00233234856393967,0.7272727272727273
905,1057,90년/Number,286,134,152,0.0015116149827720349,0.0017103889468890912,0.5314685314685315
906,1059,2시간/Number,285,95,190,0.0010781371568300542,0.002132432972744841,0.6666666666666666
907,1060,표정/Noun,285,161,124,0.0018117150161164836,0.0013994091383638019,0.5649122807017544
908,1061,동/Modifier,285,124,161,0.0014004668222740914,0.0018103467424865054,0.5649122807017544
909,1062,기억나다/Verb,285,157,128,0.0017672557519173055,0.0014438348252959862,0.5508771929824562
910,1063,아저씨/Noun,285,155,130,0.001745026119817717,0.0014660476687620785,0.543859649122807
911,1064,게임/Noun,284,97,187,0.0011003667889296432,0.002099113707545703,0.6584507042253521
912,1065,행동/Noun,284,103,181,0.0011670556852284096,0.0020324751771474267,0.6373239436619719
913,1066,고/Modifier,284,123,161,0.001389352006224297,0.0018103467424865054,0.5669014084507042
914,1068,실망하다/Adjective,283,60,223,0.0006891185950872514,0.002498944889935361,0.7879858657243817
915,1069,짓/Noun,283,70,213,0.0008002667555851951,0.0023878806726049,0.7526501766784452
916,1070,환상/Noun,283,207,76,0.0023229965544070245,0.0008663008951775916,0.7314487632508834
917,1071,여/Noun,283,178,105,0.0020006668889629878,0.001188387125435927,0.6289752650176679
918,1073,오래/Adverb,282,230,52,0.0025786373235522947,0.0005997467735844866,0.8156028368794326
919,1074,작다/Adjective,281,156,125,0.0017561409358675113,0.001410515560096848,0.5551601423487544
920,1075,결혼/Noun,281,130,151,0.0014671557185728574,0.0016992825251560453,0.5373665480427047
921,1076,참신하다/Adjective,281,149,132,0.0016783372235189508,0.0014882605122281704,0.5302491103202847
922,1077,그닥/Noun,280,25,255,0.00030010003334444816,0.0028543503853928343,0.9107142857142856
923,1078,귀신/Noun,280,71,209,0.0008113815716349895,0.002343454985672716,0.7464285714285714
924,1079,전설/Noun,280,175,105,0.001967322440813605,0.001188387125435927,0.625
925,1080,입/Noun,280,115,165,0.001300433477825942,0.0018547724294186894,0.5892857142857143
926,1082,산/Noun,279,67,212,0.0007669223074358119,0.002376774250871854,0.7598566308243727
927,1083,총/Modifier,279,87,192,0.0009892186284316995,0.0021546458162109328,0.6881720430107527
928,1084,회/Noun,279,177,102,0.001989552072913193,0.001155067860236789,0.6344086021505376
929,1085,빠져들다/Verb,278,264,14,0.002956541069245304,0.00017770274772873674,0.9496402877697842
930,1086,흘리다/Verb,278,211,67,0.002367455818606202,0.0007663430995801773,0.7589928057553957
931,1087,전작/Noun,277,72,205,0.0008224963876847838,0.002299029298740532,0.740072202166065
932,1088,총/Noun,277,85,192,0.0009669889963321108,0.0021546458162109328,0.6931407942238267
933,1089,유머/Noun,277,161,116,0.0018117150161164836,0.0013105577644994335,0.5812274368231047
934,1090,♡/Foreign,276,264,12,0.002956541069245304,0.00015548990426264466,0.9565217391304348
935,1091,돌아가다/Verb,276,167,109,0.0018784039124152493,0.0012328128123681114,0.605072463768116
936,1092,현재/Noun,275,205,70,0.002300766922307436,0.0007996623647793153,0.7454545454545455
937,1093,극/Suffix,275,114,161,0.0012893186617761474,0.0018103467424865054,0.5854545454545454
938,1094,마/Noun,275,119,156,0.0013448927420251196,0.0017548146338212756,0.5672727272727273
939,1096,쩔다/Verb,274,216,58,0.002423029898855174,0.0006663853039827628,0.7883211678832117
940,1097,여전하다/Adjective,274,191,83,0.0021451594976103147,0.000944045847308914,0.6970802919708029
941,1098,울/Modifier,274,178,96,0.0020006668889629878,0.0010884293298385123,0.6496350364963503
942,1099,제작비/Noun,273,38,235,0.000444592641991775,0.002632221950731913,0.8608058608058609
943,1100,영원하다/Adjective,273,231,42,0.0025897521396020893,0.0004886825562540262,0.8461538461538461
944,1101,예요/Josa,273,206,67,0.0023118817383572304,0.0007663430995801773,0.7545787545787546
945,1102,스러운/Josa,273,89,184,0.0010114482605312882,0.002065794442346565,0.6739926739926739
946,1103,다행/Noun,273,104,169,0.001178170501278204,0.0018991981163508738,0.6190476190476191
947,1104,흠/Noun,272,105,167,0.0011892853173279985,0.0018769852728847821,0.6139705882352942
948,1105,나중/Noun,272,151,121,0.0017005668556185395,0.001366089873164664,0.5551470588235294
949,1106,통해/Noun,271,217,54,0.0024341447149049678,0.0006219596170505788,0.8007380073800738
950,1107,잘생기다/Adjective,271,198,73,0.002222963209958875,0.0008329816299784535,0.7306273062730627
951,1108,노/Noun,271,96,175,0.0010892519728798488,0.00196583664674915,0.6457564575645757
952,1109,주의/Noun,271,113,158,0.0012782038457263534,0.0017770274772873676,0.5830258302583026
953,1111,이미/Adverb,270,114,156,0.0012893186617761474,0.0017548146338212756,0.5777777777777777
954,1112,아쉬움/Noun,269,159,110,0.0017894853840168946,0.0012439192341011573,0.5910780669144982
955,1114,망작/Noun,268,16,252,0.0002000666888962988,0.002821031120193696,0.9402985074626866
956,1115,억/Modifier,268,114,154,0.0012893186617761474,0.0017326017903551833,0.5746268656716418
957,1116,소녀/Noun,268,117,151,0.0013226631099255307,0.0016992825251560453,0.5634328358208955
958,1118,가끔/Noun,267,174,93,0.0019562076247638107,0.0010551100646393743,0.651685393258427
959,1119,만의/Josa,267,167,100,0.0018784039124152493,0.0011328550167706971,0.6254681647940075
960,1120,드럽다/Adjective,266,24,242,0.0002889852172946538,0.0027099669028632354,0.9097744360902256
961,1121,동화/Noun,266,189,77,0.002122929865510726,0.0008774073169106378,0.7105263157894737
962,1122,80년/Number,266,82,184,0.0009336445481827276,0.002065794442346565,0.6917293233082706
963,1123,:/Punctuation,266,106,160,0.0012004001333777929,0.0017992403207534593,0.6015037593984962
964,1124,사라지다/Verb,266,107,159,0.001211514949427587,0.0017881338990204136,0.5977443609022557
965,1125,먼저/Noun,266,153,113,0.0017227964877181282,0.0012772384993002955,0.575187969924812
966,1127,100/Number,265,171,94,0.001922863176614427,0.0010662164863724202,0.6452830188679245
967,1128,묘사/Noun,265,170,95,0.0019117483605646328,0.0010773229081054666,0.6415094339622641
968,1129,씨/Noun,265,120,145,0.0013560075580749138,0.001632643994757769,0.5471698113207547
969,1130,예산/Noun,264,65,199,0.0007446926753362233,0.002232390768342256,0.7537878787878788
970,1131,으/Adverb,263,97,166,0.0011003667889296432,0.001865878851151736,0.6311787072243346
971,1132,여러/Modifier,263,165,98,0.001856174280315661,0.0011106421733046046,0.6273764258555133
972,1136,채널/Noun,262,82,180,0.0009336445481827276,0.0020213687554143807,0.6870229007633588
973,1137,살인/Noun,262,97,165,0.0011003667889296432,0.0018547724294186894,0.6297709923664122
974,1138,멍청하다/Adjective,260,38,222,0.000444592641991775,0.0024878384682023146,0.8538461538461538
975,1139,강/Noun,260,197,63,0.002211848393909081,0.0007219174126479931,0.7576923076923077
976,1140,인하다/Adjective,260,152,108,0.001711681671668334,0.0012217063906350652,0.5846153846153846
977,1141,만큼/Josa,260,150,110,0.0016894520395687453,0.0012439192341011573,0.5769230769230769
978,1142,리메이크/Noun,260,113,147,0.0012782038457263534,0.0016548568382238609,0.5653846153846154
979,1144,특유/Noun,259,151,108,0.0017005668556185395,0.0012217063906350652,0.5830115830115831
980,1145,바람/Noun,259,114,145,0.0012893186617761474,0.001632643994757769,0.5598455598455598
981,1147,졸라/Noun,258,75,183,0.0008558408358341669,0.0020546880206135185,0.7093023255813954
982,1148,프로그램/Noun,258,102,156,0.0011559408691786152,0.0017548146338212756,0.6046511627906976
983,1149,관계/Noun,258,137,121,0.0015449594309214182,0.001366089873164664,0.5310077519379846
984,1150,개/Suffix,257,79,178,0.0009003001000333445,0.001999155911948289,0.6926070038910506
985,1151,틀다/Verb,257,149,108,0.0016783372235189508,0.0012217063906350652,0.5797665369649806
986,1152,등장/Noun,257,108,149,0.0012226297654773814,0.0016770696816899534,0.5797665369649806
987,1157,외/Noun,256,70,186,0.0008002667555851951,0.0020880072858126568,0.7265625
988,1158,서로/Noun,256,161,95,0.0018117150161164836,0.0010773229081054666,0.62890625
989,1159,존/Noun,256,111,145,0.0012559742136267645,0.001632643994757769,0.56640625
990,1161,낚/Noun,254,20,234,0.00024452595309547634,0.002621115528998867,0.9212598425196852
991,1162,경찰/Noun,254,98,156,0.0011114816049794377,0.0017548146338212756,0.6141732283464567
992,1164,모/Noun,253,66,187,0.0007558074913860174,0.002099113707545703,0.7391304347826086
993,1165,프로/Noun,253,104,149,0.001178170501278204,0.0016770696816899534,0.5889328063241107
994,1167,끌다/Verb,252,68,184,0.0007780371234856063,0.002065794442346565,0.7301587301587301
995,1168,런가/Noun,252,97,155,0.0011003667889296432,0.0017437082120882294,0.6150793650793651
996,1169,반개/Noun,251,5,246,7.780371234856063e-05,0.00275439258979542,0.9800796812749004
997,1170,짱/VerbPrefix,251,225,26,0.0025230632433033235,0.00031097980852528933,0.896414342629482
998,1171,지루/Noun,250,21,229,0.00025564076914527065,0.002565583420333637,0.9159999999999999
999,1173,황당하다/Adjective,249,38,211,0.000444592641991775,0.0023656678291388076,0.8473895582329317
1000,1174,착하다/Adjective,249,109,140,0.0012337445815271755,0.0015771118860925387,0.5622489959839357
1001,1176,약하다/Adjective,248,71,177,0.0008113815716349895,0.0019880494902152425,0.7137096774193549
1002,1177,흔하다/Adjective,248,92,156,0.0010447927086806713,0.0017548146338212756,0.6290322580645161
1003,1178,과정/Noun,248,142,106,0.0016005335111703902,0.0011994935471689732,0.5725806451612904
1004,1179,철학/Noun,248,134,114,0.0015116149827720349,0.0012883449210333415,0.5403225806451613
1005,1181,졸리다/Verb,247,27,220,0.00032232966544403684,0.0024656256247362228,0.8906882591093117
1006,1182,용도/Noun,247,57,190,0.0006557741469378681,0.002132432972744841,0.7692307692307693
1007,1183,희망/Noun,246,210,36,0.002356341002556408,0.0004220440258557498,0.8536585365853658
1008,1184,같이/Josa,246,108,138,0.0012226297654773814,0.0015548990426264464,0.5609756097560976
1009,1186,위대하다/Adjective,245,185,60,0.002078470601311548,0.0006885981474488549,0.7551020408163265
1010,1187,청춘/Noun,245,172,73,0.0019339779926642211,0.0008329816299784535,0.7020408163265306
1011,1188,......./Punctuation,245,81,164,0.0009225297321329332,0.001843666007685644,0.6693877551020408
1012,1189,다만/Noun,245,160,85,0.001800600200066689,0.0009662586907750061,0.6530612244897959
1013,1190,상상력/Noun,245,158,87,0.0017783705679671,0.0009884715342410985,0.6448979591836734
1014,1191,너무나도/Adverb,245,151,94,0.0017005668556185395,0.0010662164863724202,0.6163265306122448
1015,1193,깊이/Noun,244,172,72,0.0019339779926642211,0.0008218752082454075,0.7049180327868853
1016,1194,생애/Noun,244,140,104,0.0015783038790708015,0.001177280703702881,0.5737704918032787
1017,1195,묻다/Verb,244,139,105,0.0015671890630210071,0.001188387125435927,0.569672131147541
1018,1196,효과/Noun,244,108,136,0.0012226297654773814,0.0015326861991603546,0.5573770491803278
1019,1197,스케일/Noun,244,134,110,0.0015116149827720349,0.0012439192341011573,0.5491803278688525
1020,1199,cg/Alpha,243,62,181,0.0007113482271868402,0.0020324751771474267,0.7448559670781894
1021,1200,엇/VerbPrefix,243,144,99,0.001622763143269979,0.0011217485950376508,0.5925925925925926
1022,1201,바뀌다/Verb,243,103,140,0.0011670556852284096,0.0015771118860925387,0.5761316872427984
1023,1202,기세/Noun,242,7,235,0.0001000333444481494,0.002632221950731913,0.9710743801652892
1024,1203,어느/Adverb,242,103,139,0.0011670556852284096,0.0015660054643594926,0.5743801652892562
1025,1204,생/Noun,242,105,137,0.0011892853173279985,0.0015437926208934005,0.5661157024793388
1026,1205,빌리다/Verb,242,107,135,0.001211514949427587,0.0015215797774273086,0.5578512396694215
1027,1206,며/Josa,242,113,129,0.0012782038457263534,0.0014549412470290322,0.5330578512396694
1028,1208,형님/Noun,241,155,86,0.001745026119817717,0.000977365112508052,0.6431535269709544
1029,1209,깔다/Verb,241,91,150,0.001033677892630877,0.0016881761034229991,0.6224066390041494
1030,1210,이며/Josa,241,142,99,0.0016005335111703902,0.0011217485950376508,0.5892116182572614
1031,1211,다소/Noun,241,140,101,0.0015783038790708015,0.0011439614385037428,0.5809128630705395
1032,1212,께/Josa,241,140,101,0.0015783038790708015,0.0011439614385037428,0.5809128630705395
1033,1213,노출/Noun,240,57,183,0.0006557741469378681,0.0020546880206135185,0.7625
1034,1214,다시다/Verb,240,72,168,0.0008224963876847838,0.001888091694617828,0.7
1035,1215,카메라/Noun,240,73,167,0.0008336112037345782,0.0018769852728847821,0.6958333333333333
1036,1216,살아가다/Verb,239,217,22,0.0024341447149049678,0.00026655412159310506,0.9079497907949792
1037,1217,미래/Noun,239,164,75,0.0018450594642658664,0.0008551944734445456,0.6861924686192469
1038,1218,왠지/Adverb,239,138,101,0.0015560742469712125,0.0011439614385037428,0.5774058577405857
1039,1219,태어나다/Verb,239,134,105,0.0015116149827720349,0.001188387125435927,0.5606694560669456
1040,1220,쏘다/Verb,238,76,162,0.0008669556518839612,0.001821453164219552,0.6806722689075629
1041,1221,체/Noun,238,92,146,0.0010447927086806713,0.001643750416490815,0.6134453781512605
1042,1222,단/Noun,238,107,131,0.001211514949427587,0.0014771540904951245,0.5504201680672269
1043,1224,대안/Noun,237,199,38,0.0022340780260086696,0.0004442568693218419,0.8396624472573839
1044,1225,로는/Josa,237,110,127,0.00124485939757697,0.00143272840356294,0.5358649789029536
1045,1226,산만하다/Adjective,236,19,217,0.0002334111370456819,0.0024323063595370845,0.9194915254237288
1046,1227,능력/Noun,236,81,155,0.0009225297321329332,0.0017437082120882294,0.6567796610169492
1047,1228,미소/Noun,235,212,23,0.002378570634655997,0.00027766054332615115,0.9021276595744679
1048,1229,결론/Noun,235,63,172,0.0007224630432366343,0.0019325173815500122,0.7319148936170212
1049,1230,반/Noun,235,83,152,0.0009447593642325221,0.0017103889468890912,0.6468085106382979
1050,1231,치/Noun,235,90,145,0.0010225630765810826,0.001632643994757769,0.6170212765957447
1051,1233,설레다/Adjective,234,212,22,0.002378570634655997,0.00026655412159310506,0.9059829059829059
1052,1234,독립영화/Noun,234,75,159,0.0008558408358341669,0.0017881338990204136,0.6794871794871795
1053,1236,OST/Alpha,233,191,42,0.0021451594976103147,0.0004886825562540262,0.8197424892703863
1054,1237,잘못/Noun,233,83,150,0.0009447593642325221,0.0016881761034229991,0.6437768240343348
1055,1238,네/Noun,233,103,130,0.0011670556852284096,0.0014660476687620785,0.5579399141630901
1056,1239,얻다/Verb,232,135,97,0.0015227297988218294,0.0010995357515715587,0.5818965517241379
1057,1240,귀/Modifier,231,137,94,0.0015449594309214182,0.0010662164863724202,0.5930735930735931
1058,1242,지나치다/Verb,230,55,175,0.0006335445148382794,0.00196583664674915,0.7608695652173914
1059,1243,리얼/Noun,230,156,74,0.0017561409358675113,0.0008440880517114996,0.6782608695652174
1060,1244,평생/Noun,230,147,83,0.0016561075914193618,0.000944045847308914,0.6391304347826087
1061,1245,요/Modifier,230,129,101,0.0014560409025230633,0.0011439614385037428,0.5608695652173913
1062,1246,ㅇㅇ/KoreanParticle,230,126,104,0.0014226964543736804,0.001177280703702881,0.5478260869565217
1063,1247,젊다/Adjective,229,158,71,0.0017783705679671,0.0008107687865123613,0.6899563318777293
1064,1248,원하다/Adjective,229,129,100,0.0014560409025230633,0.0011328550167706971,0.5633187772925764
1065,1249,왠만하다/Adjective,228,20,208,0.00024452595309547634,0.00233234856393967,0.912280701754386
1066,1250,멋/Noun,228,174,54,0.0019562076247638107,0.0006219596170505788,0.7631578947368421
1067,1251,범인/Noun,228,62,166,0.0007113482271868402,0.001865878851151736,0.7280701754385965
1068,1252,되게/Adverb,227,149,78,0.0016783372235189508,0.0008885137386436838,0.6563876651982379
1069,1253,어린이/Noun,227,87,140,0.0009892186284316995,0.0015771118860925387,0.6167400881057269
1070,1254,D/Alpha,227,103,124,0.0011670556852284096,0.0013994091383638019,0.5462555066079295
1071,1256,박수/Noun,226,151,75,0.0017005668556185395,0.0008551944734445456,0.668141592920354
1072,1257,고민/Noun,226,128,98,0.0014449260864732687,0.0011106421733046046,0.5663716814159292
1073,1258,얼/Noun,226,99,127,0.001122596421029232,0.00143272840356294,0.5619469026548672
1074,1260,손발/Noun,225,22,203,0.000266755585195065,0.0022768164552744398,0.9022222222222224
1075,1261,고생/Noun,225,87,138,0.0009892186284316995,0.0015548990426264464,0.6133333333333333
1076,1262,고맙다/Adjective,224,180,44,0.0020228965210625765,0.0005108953997201182,0.8035714285714286
1077,1264,졸다/Verb,223,13,210,0.00016672224074691566,0.002354561407405762,0.9417040358744396
1078,1265,굳이/Noun,223,45,178,0.0005223963543403357,0.001999155911948289,0.7982062780269058
1079,1266,로맨틱/Noun,223,141,82,0.0015894186951205956,0.000932939425575868,0.6322869955156951
1080,1267,랄/Noun,223,119,104,0.0013448927420251196,0.001177280703702881,0.5336322869955157
1081,1271,거지같다/Adjective,222,19,203,0.0002334111370456819,0.0022768164552744398,0.9144144144144144
1082,1272,떠오르다/Verb,222,164,58,0.0018450594642658664,0.0006663853039827628,0.7387387387387387
1083,1273,밤/Noun,222,158,64,0.0017783705679671,0.0007330238343810393,0.7117117117117117
1084,1274,심심하다/Adjective,221,88,133,0.0010003334444814939,0.0014993669339612163,0.6018099547511312
1085,1275,만/Modifier,221,119,102,0.0013448927420251196,0.001155067860236789,0.5384615384615384
1086,1277,별루/Noun,220,12,208,0.00015560742469712126,0.00233234856393967,0.9454545454545454
1087,1278,슬픔/Noun,220,192,28,0.002156274313660109,0.0003331926519913814,0.8727272727272727
1088,1279,용이/Noun,220,69,151,0.0007891519395354007,0.0016992825251560453,0.6863636363636364
1089,1280,차/Noun,220,84,136,0.0009558741802823164,0.0015326861991603546,0.6181818181818182
1090,1281,스/Noun,220,131,89,0.001478270534622652,0.0010106843777071904,0.5954545454545455
1091,1282,저렇게/Adverb,220,91,129,0.001033677892630877,0.0014549412470290322,0.5863636363636363
1092,1284,포장/Noun,219,20,199,0.00024452595309547634,0.002232390768342256,0.9086757990867579
1093,1285,주기/Noun,219,40,179,0.0004668222740913638,0.0020102623336813344,0.817351598173516
1094,1286,시도/Noun,219,57,162,0.0006557741469378681,0.001821453164219552,0.7397260273972602
1095,1287,ㅅㅂ/KoreanParticle,218,20,198,0.00024452595309547634,0.002221284346609209,0.908256880733945
1096,1288,아침/Noun,218,56,162,0.0006446593308880737,0.001821453164219552,0.7431192660550459
1097,1289,인기/Noun,218,90,128,0.0010225630765810826,0.0014438348252959862,0.5871559633027523
1098,1290,추다/Verb,218,116,102,0.0013115482938757365,0.001155067860236789,0.5321100917431193
1099,1292,늙다/Verb,217,85,132,0.0009669889963321108,0.0014882605122281704,0.6082949308755761
1100,1293,줌/Noun,217,87,130,0.0009892186284316995,0.0014660476687620785,0.5990783410138248
1101,1294,덕분/Noun,217,122,95,0.0013782371901745027,0.0010773229081054666,0.5622119815668203
1102,1297,광고/Noun,216,47,169,0.0005446259864399244,0.0018991981163508738,0.7824074074074074
1103,1298,군대/Noun,216,97,119,0.0011003667889296432,0.0013438770296985718,0.5509259259259259
1104,1300,짱/Modifier,215,181,34,0.00203401133711237,0.00039983118238965764,0.8418604651162791
1105,1301,진실/Noun,215,142,73,0.0016005335111703902,0.0008329816299784535,0.6604651162790698
1106,1302,이래/Josa,215,118,97,0.001333777925975325,0.0010995357515715587,0.5488372093023256
1107,1303,자막/Noun,215,101,114,0.0011448260531288204,0.0012883449210333415,0.5302325581395348
1108,1305,암/Noun,214,59,155,0.0006780037790374569,0.0017437082120882294,0.7242990654205608
1109,1306,흐름/Noun,214,83,131,0.0009447593642325221,0.0014771540904951245,0.6121495327102804
1110,1309,눈물나다/Verb,213,183,30,0.0020562409692119594,0.0003554054954574735,0.8591549295774648
1111,1310,젤/Noun,213,123,90,0.001389352006224297,0.0010217907994402363,0.5774647887323944
1112,1312,성도/Noun,212,25,187,0.00030010003334444816,0.002099113707545703,0.8820754716981132
1113,1313,한계/Noun,212,38,174,0.000444592641991775,0.0019547302250161047,0.8207547169811321
1114,1314,그럭저럭/Adverb,212,52,160,0.0006002000666888963,0.0017992403207534593,0.7547169811320755
1115,1315,전/Foreign,212,157,55,0.0017672557519173055,0.0006330660387836247,0.7405660377358491
1116,1316,조차/Josa,212,56,156,0.0006446593308880737,0.0017548146338212756,0.7358490566037735
1117,1317,챙기다/Verb,212,145,67,0.0016338779593197733,0.0007663430995801773,0.6839622641509434
1118,1318,심/Noun,212,73,139,0.0008336112037345782,0.0015660054643594926,0.6556603773584906
1119,1319,빠르다/Adjective,212,128,84,0.0014449260864732687,0.00095515226904196,0.6037735849056604
1120,1320,싫어하다/Adjective,212,90,122,0.0010225630765810826,0.0013771962948977098,0.5754716981132075
1121,1321,사이/Noun,212,119,93,0.0013448927420251196,0.0010551100646393743,0.5613207547169812
1122,1323,~^^/Punctuation,211,202,9,0.0022674224741580525,0.00012217063906350652,0.957345971563981
1123,1324,진정/Noun,211,146,65,0.0016449927753695677,0.0007441302561140852,0.6919431279620853
1124,1325,..?/Punctuation,211,82,129,0.0009336445481827276,0.0014549412470290322,0.6113744075829384
1125,1326,웬만하다/Adjective,211,83,128,0.0009447593642325221,0.0014438348252959862,0.6066350710900474
1126,1327,보시/Noun,211,113,98,0.0012782038457263534,0.0011106421733046046,0.5355450236966824
1127,1329,깔끔하다/Adjective,210,167,43,0.0018784039124152493,0.0004997889779870722,0.7952380952380952
1128,1330,살짝/Noun,210,140,70,0.0015783038790708015,0.0007996623647793153,0.6666666666666666
1129,1331,희다/Adjective,210,96,114,0.0010892519728798488,0.0012883449210333415,0.5428571428571428
1130,1332,만이/Josa,210,112,98,0.0012670890296765588,0.0011106421733046046,0.5333333333333333
1131,1333,발견/Noun,209,175,34,0.001967322440813605,0.00039983118238965764,0.8373205741626795
1132,1334,리뷰/Noun,209,80,129,0.0009114149160831386,0.0014549412470290322,0.6172248803827751
1133,1335,일어나다/Verb,209,129,80,0.0014560409025230633,0.000910726582109776,0.6172248803827751
1134,1336,볼거리/Noun,209,93,116,0.0010559075247304657,0.0013105577644994335,0.5550239234449761
1135,1337,스럽게/Josa,209,111,98,0.0012559742136267645,0.0011106421733046046,0.5311004784688995
1136,1339,개도/Noun,208,25,183,0.00030010003334444816,0.0020546880206135185,0.8798076923076923
1137,1340,쩐다/Noun,208,145,63,0.0016338779593197733,0.0007219174126479931,0.6971153846153846
1138,1341,범죄/Noun,208,72,136,0.0008224963876847838,0.0015326861991603546,0.6538461538461539
1139,1342,뜻/Noun,208,122,86,0.0013782371901745027,0.000977365112508052,0.5865384615384616
1140,1343,첫/Noun,208,116,92,0.0013115482938757365,0.0010440036429063284,0.5576923076923077
1141,1344,짱짱/Noun,207,199,8,0.0022340780260086696,0.00011106421733046048,0.961352657004831
1142,1345,부족/Noun,207,29,178,0.0003445592975436257,0.001999155911948289,0.8599033816425121
1143,1346,지난/Noun,207,159,48,0.0017894853840168946,0.0005553210866523023,0.7681159420289855
1144,1347,20년/Number,207,142,65,0.0016005335111703902,0.0007441302561140852,0.6859903381642513
1145,1348,야/Exclamation,207,66,141,0.0007558074913860174,0.0015882183078255846,0.6811594202898551
1146,1349,오락/Noun,207,125,82,0.0014115816383238858,0.000932939425575868,0.6038647342995169
1147,1350,와는/Josa,207,118,89,0.001333777925975325,0.0010106843777071904,0.5700483091787439
1148,1351,던지다/Verb,207,110,97,0.00124485939757697,0.0010995357515715587,0.5314009661835749
1149,1352,대충/Noun,206,37,169,0.0004334778259419807,0.0018991981163508738,0.8203883495145631
1150,1353,영환/Noun,206,64,142,0.0007335778592864287,0.0015993247295586306,0.6893203883495146
1151,1354,~~~~/Punctuation,206,123,83,0.001389352006224297,0.000944045847308914,0.5970873786407767
1152,1355,로서/Noun,206,116,90,0.0013115482938757365,0.0010217907994402363,0.5631067961165048
1153,1360,감탄/Noun,205,177,28,0.001989552072913193,0.0003331926519913814,0.8634146341463415
1154,1361,빨/Noun,205,54,151,0.0006224296987884852,0.0016992825251560453,0.7365853658536585
1155,1362,자연/Noun,205,142,63,0.0016005335111703902,0.0007219174126479931,0.6926829268292682
1156,1363,커플/Noun,205,141,64,0.0015894186951205956,0.0007330238343810393,0.6878048780487804
1157,1364,시선/Noun,205,141,64,0.0015894186951205956,0.0007330238343810393,0.6878048780487804
1158,1365,정서/Noun,205,76,129,0.0008669556518839612,0.0014549412470290322,0.6292682926829268
1159,1366,정말로/Adverb,205,125,80,0.0014115816383238858,0.000910726582109776,0.6097560975609756
1160,1367,시청자/Noun,204,41,163,0.0004779370901411582,0.0018325595859525977,0.7990196078431373
1161,1368,홍보/Noun,204,43,161,0.0005001667222407468,0.0018103467424865054,0.7892156862745098
1162,1369,담기다/Verb,204,160,44,0.001800600200066689,0.0005108953997201182,0.7843137254901961
1163,1370,몸매/Noun,204,67,137,0.0007669223074358119,0.0015437926208934005,0.6715686274509803
1164,1371,우울하다/Adjective,204,123,81,0.001389352006224297,0.000921833003842822,0.6029411764705882
1165,1372,폭력/Noun,204,94,110,0.00106702234078026,0.0012439192341011573,0.5392156862745098
1166,1375,아오/Exclamation,203,29,174,0.0003445592975436257,0.0019547302250161047,0.8571428571428571
1167,1376,뛰다/Verb,203,88,115,0.0010003334444814939,0.0012994513427663874,0.5665024630541872
1168,1377,방/Noun,203,92,111,0.0010447927086806713,0.0012550256558342032,0.5467980295566502
1169,1378,울리다/Verb,202,175,27,0.001967322440813605,0.00032208623025833537,0.8663366336633663
1170,1379,지르다/Verb,202,42,160,0.0004890519061909527,0.0017992403207534593,0.7920792079207921
1171,1380,소름끼치다/Verb,202,155,47,0.001745026119817717,0.0005442146649192564,0.7673267326732673
1172,1381,더하다/Adjective,202,117,85,0.0013226631099255307,0.0009662586907750061,0.5792079207920792
1173,1383,일상/Noun,201,154,47,0.0017339113037679224,0.0005442146649192564,0.7661691542288557
1174,1384,포기/Noun,201,56,145,0.0006446593308880737,0.001632643994757769,0.7213930348258707
1175,1385,코드/Noun,201,76,125,0.0008669556518839612,0.001410515560096848,0.6218905472636815
1176,1386,첨/Noun,201,77,124,0.0008780704679337558,0.0013994091383638019,0.6169154228855721
1177,1387,유일하다/Adjective,200,119,81,0.0013448927420251196,0.000921833003842822,0.595
1178,1388,접다/Verb,199,22,177,0.000266755585195065,0.0019880494902152425,0.8894472361809045
1179,1389,30분/Number,199,51,148,0.000589085250639102,0.001665963259956907,0.7437185929648241
1180,1390,에서의/Josa,199,143,56,0.0016116483272201846,0.0006441724605166707,0.7185929648241206
1181,1391,일이/Noun,199,115,84,0.001300433477825942,0.00095515226904196,0.5778894472361809
1182,1392,용서/Noun,199,85,114,0.0009669889963321108,0.0012883449210333415,0.5728643216080402
1183,1393,이따위/Modifier,198,8,190,0.00011114816049794375,0.002132432972744841,0.9595959595959596
1184,1394,눈빛/Noun,198,175,23,0.001967322440813605,0.00027766054332615115,0.8838383838383839
1185,1395,10분/Number,198,36,162,0.00042236300989218633,0.001821453164219552,0.8181818181818182
1186,1396,보라/Noun,198,64,134,0.0007335778592864287,0.0015104733556942625,0.6767676767676768
1187,1397,끼리/Noun,198,71,127,0.0008113815716349895,0.00143272840356294,0.6414141414141414
1188,1398,사극/Noun,198,123,75,0.001389352006224297,0.0008551944734445456,0.6212121212121212
1189,1399,대의/Noun,198,106,92,0.0012004001333777929,0.0010440036429063284,0.5353535353535354
1190,1401,말로/Noun,197,140,57,0.0015783038790708015,0.0006552788822497168,0.7106598984771574
1191,1402,들어오다/Verb,197,87,110,0.0009892186284316995,0.0012439192341011573,0.5583756345177665
1192,1404,뜬금/Noun,196,17,179,0.00021118150494609317,0.0020102623336813344,0.9132653061224488
1193,1405,핵/Noun,196,37,159,0.0004334778259419807,0.0017881338990204136,0.8112244897959183
1194,1406,상처/Noun,196,143,53,0.0016116483272201846,0.0006108531953175326,0.7295918367346939
1195,1407,실감/Noun,196,128,68,0.0014449260864732687,0.0007774495213132232,0.6530612244897959
1196,1408,괴물/Noun,196,81,115,0.0009225297321329332,0.0012994513427663874,0.5867346938775511
1197,1409,달/Noun,196,89,107,0.0010114482605312882,0.0012105999689020189,0.5459183673469388
1198,1410,다큐멘터리/Noun,196,92,104,0.0010447927086806713,0.001177280703702881,0.5306122448979592
1199,1411,반성/Noun,196,92,104,0.0010447927086806713,0.001177280703702881,0.5306122448979592
1200,1414,끌/Noun,195,22,173,0.000266755585195065,0.0019436238032830586,0.8871794871794871
1201,1415,힐링/Noun,195,171,24,0.001922863176614427,0.0002887669650591972,0.8769230769230769
1202,1416,혹시/Noun,195,48,147,0.0005557408024897189,0.0016548568382238609,0.7538461538461538
1203,1417,막판/Noun,195,58,137,0.0006668889629876625,0.0015437926208934005,0.7025641025641025
1204,1418,빛/Noun,195,127,68,0.0014338112704234743,0.0007774495213132232,0.6512820512820513
1205,1419,당연하다/Adjective,195,106,89,0.0012004001333777929,0.0010106843777071904,0.5435897435897435
1206,1420,연애/Noun,195,105,90,0.0011892853173279985,0.0010217907994402363,0.5384615384615384
1207,1421,무겁다/Adjective,194,158,36,0.0017783705679671,0.0004220440258557498,0.8144329896907216
1208,1422,우정/Noun,194,143,51,0.0016116483272201846,0.0005886403518514405,0.7371134020618557
1209,1423,해피엔딩/Noun,194,138,56,0.0015560742469712125,0.0006441724605166707,0.711340206185567
1210,1424,죄/Noun,194,67,127,0.0007669223074358119,0.00143272840356294,0.6546391752577321
1211,1425,하루/Noun,194,110,84,0.00124485939757697,0.00095515226904196,0.5670103092783505
1212,1426,표/Noun,194,109,85,0.0012337445815271755,0.0009662586907750061,0.5618556701030928
1213,1427,우/Adverb,194,89,105,0.0010114482605312882,0.001188387125435927,0.5412371134020618
1214,1430,참다/Verb,193,36,157,0.00042236300989218633,0.0017659210555543215,0.8134715025906736
1215,1431,으론/Josa,193,112,81,0.0012670890296765588,0.000921833003842822,0.5803108808290155
1216,1432,남녀/Noun,193,111,82,0.0012559742136267645,0.000932939425575868,0.5751295336787565
1217,1433,정치/Noun,193,109,84,0.0012337445815271755,0.00095515226904196,0.5647668393782384
1218,1434,이어지다/Verb,193,107,86,0.001211514949427587,0.000977365112508052,0.5544041450777202
1219,1437,몰다/Verb,192,64,128,0.0007335778592864287,0.0014438348252959862,0.6666666666666666
1220,1439,아련하다/Adjective,191,184,7,0.002067355785261754,9.995779559741441e-05,0.9633507853403142
1221,1440,보아/Noun,191,134,57,0.0015116149827720349,0.0006552788822497168,0.7015706806282722
1222,1441,게다가/Noun,191,58,133,0.0006668889629876625,0.0014993669339612163,0.6963350785340314
1223,1442,만큼/Noun,191,115,76,0.001300433477825942,0.0008663008951775916,0.6020942408376964
1224,1443,어제/Noun,191,112,79,0.0012670890296765588,0.0008996201603767299,0.5863874345549738
1225,1444,개판/Noun,190,8,182,0.00011114816049794375,0.0020435815988804726,0.9578947368421052
1226,1445,뭐임/Noun,190,15,175,0.00018895187284650438,0.00196583664674915,0.9210526315789472
1227,1446,나머지/Noun,190,38,152,0.000444592641991775,0.0017103889468890912,0.8
1228,1447,벌써/Noun,190,146,44,0.0016449927753695677,0.0005108953997201182,0.7684210526315789
1229,1448,조폭/Noun,190,58,132,0.0006668889629876625,0.0014882605122281704,0.6947368421052632
1230,1449,간/Noun,190,72,118,0.0008224963876847838,0.0013327706079655256,0.6210526315789474
1231,1450,이기/Noun,190,114,76,0.0012893186617761474,0.0008663008951775916,0.6
1232,1451,만으로/Josa,190,112,78,0.0012670890296765588,0.0008885137386436838,0.5894736842105263
1233,1453,소장/Noun,189,173,16,0.001945092808714016,0.00019991559119482882,0.9153439153439152
1234,1454,비극/Noun,189,143,46,0.0016116483272201846,0.0005331082431862101,0.7566137566137566
1235,1455,까지는/Josa,189,51,138,0.000589085250639102,0.0015548990426264464,0.7301587301587301
1236,1456,주/Noun,189,73,116,0.0008336112037345782,0.0013105577644994335,0.6137566137566137
1237,1457,안좋다/Adjective,189,81,108,0.0009225297321329332,0.0012217063906350652,0.5714285714285714
1238,1458,(?)/Punctuation,189,86,103,0.0009781038123819054,0.001166174281969835,0.544973544973545
1239,1460,벗다/Verb,188,41,147,0.0004779370901411582,0.0016548568382238609,0.7819148936170213
1240,1461,난해하다/Adjective,188,45,143,0.0005223963543403357,0.001610431151291677,0.7606382978723404
1241,1462,섹스/Noun,188,51,137,0.000589085250639102,0.0015437926208934005,0.7287234042553191
1242,1463,부끄럽다/Adjective,188,65,123,0.0007446926753362233,0.0013883027166307562,0.6542553191489362
1243,1464,등장인물/Noun,188,69,119,0.0007891519395354007,0.0013438770296985718,0.6329787234042553
1244,1465,공부/Noun,188,83,105,0.0009447593642325221,0.001188387125435927,0.5585106382978723
1245,1467,형편/Noun,187,18,169,0.0002222963209958875,0.0018991981163508738,0.9037433155080212
1246,1468,본방/Noun,187,166,21,0.0018672890963654552,0.0002554476998600591,0.8877005347593583
1247,1469,감명/Noun,187,164,23,0.0018450594642658664,0.00027766054332615115,0.8770053475935828
1248,1470,뮤지컬/Noun,187,117,70,0.0013226631099255307,0.0007996623647793153,0.6256684491978609
1249,1471,올해/Noun,187,111,76,0.0012559742136267645,0.0008663008951775916,0.5935828877005348
1250,1473,펑펑/Noun,186,179,7,0.002011781705012782,9.995779559741441e-05,0.9623655913978496
1251,1474,끝내다/Verb,186,63,123,0.0007224630432366343,0.0013883027166307562,0.6612903225806451
1252,1475,의문/Noun,186,67,119,0.0007669223074358119,0.0013438770296985718,0.6397849462365591
1253,1476,이연걸/Noun,186,117,69,0.0013226631099255307,0.0007885559430462694,0.6290322580645161
1254,1477,국민/Noun,186,106,80,0.0012004001333777929,0.000910726582109776,0.5698924731182796
1255,1478,불구/Noun,186,104,82,0.001178170501278204,0.000932939425575868,0.5591397849462365
1256,1479,이라서/Josa,186,99,87,0.001122596421029232,0.0009884715342410985,0.532258064516129
1257,1480,분/Suffix,186,99,87,0.001122596421029232,0.0009884715342410985,0.532258064516129
1258,1482,그다지/Noun,185,18,167,0.0002222963209958875,0.0018769852728847821,0.9027027027027028
1259,1483,토/Noun,185,44,141,0.0005112815382905413,0.0015882183078255846,0.7621621621621621
1260,1484,떼다/Verb,185,140,45,0.0015783038790708015,0.0005220018214531642,0.7567567567567568
1261,1485,인가요/Josa,185,57,128,0.0006557741469378681,0.0014438348252959862,0.6918918918918919
1262,1486,결과/Noun,185,64,121,0.0007335778592864287,0.001366089873164664,0.6540540540540539
1263,1487,불가/Noun,184,41,143,0.0004779370901411582,0.001610431151291677,0.7771739130434783
1264,1488,자유/Noun,184,128,56,0.0014449260864732687,0.0006441724605166707,0.6956521739130435
1265,1489,암튼/Adverb,184,123,61,0.001389352006224297,0.0006997045691819009,0.6684782608695652
1266,1490,새벽/Noun,184,122,62,0.0013782371901745027,0.000710810990914947,0.6630434782608695
1267,1491,꼴/Noun,183,23,160,0.00027787040124485944,0.0017992403207534593,0.8743169398907104
1268,1492,표절/Noun,183,24,159,0.0002889852172946538,0.0017881338990204136,0.8688524590163934
1269,1493,행복/Noun,183,153,30,0.0017227964877181282,0.0003554054954574735,0.8360655737704918
1270,1494,딱하다/Adjective,183,31,152,0.00036678892964321435,0.0017103889468890912,0.8306010928961749
1271,1495,지도/Noun,183,60,123,0.0006891185950872514,0.0013883027166307562,0.6721311475409836
1272,1496,느와르/Noun,183,123,60,0.001389352006224297,0.0006885981474488549,0.6721311475409836
1273,1497,기적/Noun,183,104,79,0.001178170501278204,0.0008996201603767299,0.5683060109289617
1274,1498,글쎄/Noun,182,21,161,0.00025564076914527065,0.0018103467424865054,0.8846153846153846
1275,1499,색다르다/Adjective,182,141,41,0.0015894186951205956,0.00047757613452098,0.7747252747252747
1276,1500,기본/Noun,182,50,132,0.0005779704345893076,0.0014882605122281704,0.7252747252747253
1277,1501,오버/Noun,182,51,131,0.000589085250639102,0.0014771540904951245,0.7197802197802198
1278,1502,차이/Noun,182,68,114,0.0007780371234856063,0.0012883449210333415,0.6263736263736264
1279,1503,홍콩/Noun,182,82,100,0.0009336445481827276,0.0011328550167706971,0.5494505494505495
1280,1506,에만/Josa,181,44,137,0.0005112815382905413,0.0015437926208934005,0.7569060773480663
1281,1507,에게는/Josa,181,120,61,0.0013560075580749138,0.0006997045691819009,0.6629834254143646
1282,1508,따위/Noun,181,63,118,0.0007224630432366343,0.0013327706079655256,0.6519337016574586
1283,1509,가면/Noun,181,65,116,0.0007446926753362233,0.0013105577644994335,0.6408839779005525
1284,1510,자식/Noun,181,83,98,0.0009447593642325221,0.0011106421733046046,0.5414364640883977
1285,1511,발전/Noun,181,83,98,0.0009447593642325221,0.0011106421733046046,0.5414364640883977
1286,1514,쓰래/Noun,180,10,170,0.0001333777925975325,0.00191030453808392,0.9444444444444444
1287,1515,불쾌하다/Adjective,180,23,157,0.00027787040124485944,0.0017659210555543215,0.8722222222222222
1288,1516,느리다/Adjective,180,42,138,0.0004890519061909527,0.0015548990426264464,0.7666666666666667
1289,1517,까진/Josa,180,62,118,0.0007113482271868402,0.0013327706079655256,0.6555555555555556
1290,1518,악당/Noun,180,65,115,0.0007446926753362233,0.0012994513427663874,0.6388888888888888
1291,1519,완전하다/Adjective,180,78,102,0.00088918528398355,0.001155067860236789,0.5666666666666667
1292,1520,세다/Verb,180,96,84,0.0010892519728798488,0.00095515226904196,0.5333333333333333
1293,1521,싸다/Verb,179,41,138,0.0004779370901411582,0.0015548990426264464,0.770949720670391
1294,1522,촌스럽다/Adjective,179,50,129,0.0005779704345893076,0.0014549412470290322,0.7206703910614525
1295,1523,모/Modifier,179,67,112,0.0007669223074358119,0.0012661320775672494,0.6256983240223464
1296,1524,많이/Modifier,179,99,80,0.001122596421029232,0.000910726582109776,0.553072625698324
1297,1525,인지/Noun,179,82,97,0.0009336445481827276,0.0010995357515715587,0.5418994413407822
1298,1531,그렇다고/Conjunction,178,34,144,0.0004001333777925976,0.0016215375730247227,0.8089887640449438
1299,1532,그걸/Adverb,178,70,108,0.0008002667555851951,0.0012217063906350652,0.6067415730337079
1300,1533,기술/Noun,178,72,106,0.0008224963876847838,0.0011994935471689732,0.5955056179775281
1301,1534,새/Modifier,178,74,104,0.0008447260197843727,0.001177280703702881,0.5842696629213483
1302,1535,무시/Noun,178,74,104,0.0008447260197843727,0.001177280703702881,0.5842696629213483
1303,1536,이제야/Noun,177,157,20,0.0017672557519173055,0.00024434127812701304,0.8870056497175142
1304,1537,적절하다/Adjective,177,137,40,0.0015449594309214182,0.000466469712787934,0.7740112994350282
1305,1538,깨닫다/Verb,177,133,44,0.001500500166722241,0.0005108953997201182,0.7514124293785308
1306,1539,반복/Noun,177,68,109,0.0007780371234856063,0.0012328128123681114,0.615819209039548
1307,1540,공/Modifier,177,70,107,0.0008002667555851951,0.0012105999689020189,0.6045197740112994
1308,1541,입장/Noun,177,83,94,0.0009447593642325221,0.0010662164863724202,0.5310734463276836
1309,1543,오그라들다/Verb,176,19,157,0.0002334111370456819,0.0017659210555543215,0.8920454545454546
1310,1544,긴장/Noun,176,134,42,0.0015116149827720349,0.0004886825562540262,0.7613636363636364
1311,1545,게이/Noun,176,47,129,0.0005446259864399244,0.0014549412470290322,0.7329545454545454
1312,1546,어쩔/Adverb,176,57,119,0.0006557741469378681,0.0013438770296985718,0.6761363636363636
1313,1547,외국/Noun,176,57,119,0.0006557741469378681,0.0013438770296985718,0.6761363636363636
1314,1548,예/Modifier,176,97,79,0.0011003667889296432,0.0008996201603767299,0.5511363636363636
1315,1550,언제나/Adverb,175,128,47,0.0014449260864732687,0.0005442146649192564,0.7314285714285714
1316,1551,북한/Noun,175,65,110,0.0007446926753362233,0.0012439192341011573,0.6285714285714286
1317,1552,과는/Josa,175,101,74,0.0011448260531288204,0.0008440880517114996,0.5771428571428572
1318,1553,그린/Noun,175,93,82,0.0010559075247304657,0.000932939425575868,0.5314285714285715
1319,1554,열정/Noun,174,148,26,0.0016672224074691564,0.00031097980852528933,0.8505747126436781
1320,1555,소소하다/Adjective,174,143,31,0.0016116483272201846,0.00036651191719051963,0.8218390804597702
1321,1556,빛나다/Verb,174,131,43,0.001478270534622652,0.0004997889779870722,0.7528735632183908
1322,1557,이루다/Verb,174,126,48,0.0014226964543736804,0.0005553210866523023,0.7241379310344828
1323,1558,불/Noun,174,77,97,0.0008780704679337558,0.0010995357515715587,0.5574712643678161
1324,1559,아픔/Noun,173,146,27,0.0016449927753695677,0.00032208623025833537,0.8439306358381503
1325,1560,창/Noun,173,31,142,0.00036678892964321435,0.0015993247295586306,0.8208092485549133
1326,1561,선생님/Noun,173,129,44,0.0014560409025230633,0.0005108953997201182,0.7456647398843931
1327,1562,병/Noun,173,51,122,0.000589085250639102,0.0013771962948977098,0.7052023121387283
1328,1563,쇼/Noun,173,55,118,0.0006335445148382794,0.0013327706079655256,0.6820809248554913
1329,1564,달라/Noun,173,81,92,0.0009225297321329332,0.0010440036429063284,0.5317919075144508
1330,1565,강렬하다/Adjective,172,147,25,0.0016561075914193618,0.0002998733867922433,0.8546511627906976
1331,1566,화나다/Verb,172,30,142,0.00035567411359342004,0.0015993247295586306,0.8255813953488372
1332,1567,짝/Noun,172,34,138,0.0004001333777925976,0.0015548990426264464,0.8023255813953488
1333,1568,양/Modifier,172,52,120,0.0006002000666888963,0.0013549834514316175,0.6976744186046512
1334,1569,디즈니/Noun,172,114,58,0.0012893186617761474,0.0006663853039827628,0.6627906976744186
1335,1570,늘/Noun,172,101,71,0.0011448260531288204,0.0008107687865123613,0.5872093023255814
1336,1571,종교/Noun,172,80,92,0.0009114149160831386,0.0010440036429063284,0.5348837209302325
1337,1574,질리/Noun,171,160,11,0.001800600200066689,0.0001443834825295986,0.935672514619883
1338,1575,쩝/Adverb,171,28,143,0.0003334444814938313,0.001610431151291677,0.8362573099415205
1339,1576,극치/Noun,171,28,143,0.0003334444814938313,0.001610431151291677,0.8362573099415205
1340,1577,까지도/Josa,171,135,36,0.0015227297988218294,0.0004220440258557498,0.7894736842105263
1341,1578,밥/Noun,171,47,124,0.0005446259864399244,0.0013994091383638019,0.7251461988304093
1342,1579,희생/Noun,171,112,59,0.0012670890296765588,0.0006774917257158089,0.6549707602339181
1343,1580,채우다/Verb,171,74,97,0.0008447260197843727,0.0010995357515715587,0.5672514619883041
1344,1581,외모/Noun,171,95,76,0.0010781371568300542,0.0008663008951775916,0.5555555555555556
1345,1583,찡하다/Adjective,170,165,5,0.001856174280315661,7.774495213132233e-05,0.9705882352941176
1346,1584,주기도/Noun,170,6,164,8.891852839835501e-05,0.001843666007685644,0.9647058823529412
1347,1585,노답/Noun,170,14,156,0.00017783705679671002,0.0017548146338212756,0.9176470588235294
1348,1586,빡치다/Adjective,170,27,143,0.00032232966544403684,0.001610431151291677,0.8411764705882353
1349,1587,남편/Noun,170,55,115,0.0006335445148382794,0.0012994513427663874,0.6764705882352942
1350,1588,분노/Noun,170,67,103,0.0007669223074358119,0.001166174281969835,0.6058823529411764
1351,1589,맡다/Verb,170,74,96,0.0008447260197843727,0.0010884293298385123,0.5647058823529412
1352,1590,대표/Noun,170,75,95,0.0008558408358341669,0.0010773229081054666,0.5588235294117647
1353,1591,흘러가다/Verb,170,75,95,0.0008558408358341669,0.0010773229081054666,0.5588235294117647
1354,1593,죄다/Adverb,169,19,150,0.0002334111370456819,0.0016881761034229991,0.8875739644970414
1355,1594,싸구려/Noun,169,21,148,0.00025564076914527065,0.001665963259956907,0.8757396449704142
1356,1595,때우다/Verb,169,36,133,0.00042236300989218633,0.0014993669339612163,0.7869822485207101
1357,1596,에로/Josa,169,39,130,0.00045570745804156943,0.0014660476687620785,0.7692307692307693
1358,1597,마저/Josa,169,51,118,0.000589085250639102,0.0013327706079655256,0.6982248520710059
1359,1598,헐리우드/Noun,169,52,117,0.0006002000666888963,0.0013216641862324795,0.6923076923076923
1360,1599,춤/Noun,169,96,73,0.0010892519728798488,0.0008329816299784535,0.5680473372781065
1361,1600,지는/Josa,169,93,76,0.0010559075247304657,0.0008663008951775916,0.5502958579881657
1362,1601,섬세하다/Adjective,168,146,22,0.0016449927753695677,0.00026655412159310506,0.8690476190476191
1363,1602,풋풋하다/Adjective,168,144,24,0.001622763143269979,0.0002887669650591972,0.8571428571428571
1364,1603,어머니/Noun,168,123,45,0.001389352006224297,0.0005220018214531642,0.7321428571428571
1365,1604,=/Punctuation,168,55,113,0.0006335445148382794,0.0012772384993002955,0.6726190476190477
1366,1605,청소년/Noun,168,62,106,0.0007113482271868402,0.0011994935471689732,0.6309523809523809
1367,1606,시각/Noun,168,102,66,0.0011559408691786152,0.0007552366778471312,0.6071428571428571
1368,1607,왕/Noun,168,75,93,0.0008558408358341669,0.0010551100646393743,0.5535714285714286
1369,1608,로만/Noun,168,78,90,0.00088918528398355,0.0010217907994402363,0.5357142857142857
1370,1611,제로/Noun,167,16,151,0.0002000666888962988,0.0016992825251560453,0.9041916167664672
1371,1612,유발/Noun,167,21,146,0.00025564076914527065,0.001643750416490815,0.8742514970059879
1372,1613,필름/Noun,167,34,133,0.0004001333777925976,0.0014993669339612163,0.7964071856287425
1373,1614,조절/Noun,167,40,127,0.0004668222740913638,0.00143272840356294,0.7604790419161677
1374,1615,놓치다/Verb,167,125,42,0.0014115816383238858,0.0004886825562540262,0.7485029940119761
1375,1616,본인/Noun,167,56,111,0.0006446593308880737,0.0012550256558342032,0.6646706586826348
1376,1617,_/Punctuation,167,106,61,0.0012004001333777929,0.0006997045691819009,0.6347305389221557
1377,1618,싸움/Noun,167,66,101,0.0007558074913860174,0.0011439614385037428,0.6047904191616766
1378,1619,이미지/Noun,167,71,96,0.0008113815716349895,0.0010884293298385123,0.5748502994011976
1379,1620,이나/Noun,167,72,95,0.0008224963876847838,0.0010773229081054666,0.5688622754491018
1380,1622,미드/Noun,166,111,55,0.0012559742136267645,0.0006330660387836247,0.6686746987951807
1381,1623,실력/Noun,166,57,109,0.0006557741469378681,0.0012328128123681114,0.6566265060240963
1382,1624,학생/Noun,166,95,71,0.0010781371568300542,0.0008107687865123613,0.572289156626506
1383,1625,오래되다/Adjective,166,90,76,0.0010225630765810826,0.0008663008951775916,0.5421686746987951
1384,1627,조잡하다/Adjective,165,7,158,0.0001000333444481494,0.0017770274772873676,0.9575757575757576
1385,1628,호러/Noun,165,58,107,0.0006668889629876625,0.0012105999689020189,0.6484848484848484
1386,1629,방금/Noun,165,104,61,0.001178170501278204,0.0006997045691819009,0.6303030303030303
1387,1630,금/Noun,165,61,104,0.0007002334111370457,0.001177280703702881,0.6303030303030303
1388,1631,라인/Noun,165,63,102,0.0007224630432366343,0.001155067860236789,0.6181818181818182
1389,1632,깨다/Verb,165,69,96,0.0007891519395354007,0.0010884293298385123,0.5818181818181818
1390,1633,비판/Noun,165,94,71,0.00106702234078026,0.0008107687865123613,0.5696969696969697
1391,1634,편의/Noun,165,73,92,0.0008336112037345782,0.0010440036429063284,0.5575757575757576
1392,1636,굿굿/Noun,164,161,3,0.0018117150161164836,5.553210866523024e-05,0.9817073170731708
1393,1637,좋아지다/Verb,164,134,30,0.0015116149827720349,0.0003554054954574735,0.8170731707317073
1394,1638,통쾌하다/Adjective,164,128,36,0.0014449260864732687,0.0004220440258557498,0.7804878048780488
1395,1639,심각하다/Adjective,164,43,121,0.0005001667222407468,0.001366089873164664,0.7378048780487805
1396,1640,맨날/Adverb,164,58,106,0.0006668889629876625,0.0011994935471689732,0.6463414634146342
1397,1641,쫌/Noun,164,59,105,0.0006780037790374569,0.001188387125435927,0.6402439024390244
1398,1642,과의/Josa,164,92,72,0.0010447927086806713,0.0008218752082454075,0.5609756097560976
1399,1643,해석/Noun,164,88,76,0.0010003334444814939,0.0008663008951775916,0.5365853658536586
1400,1644,전문가/Noun,164,87,77,0.0009892186284316995,0.0008774073169106378,0.5304878048780488
1401,1645,지구/Noun,164,87,77,0.0009892186284316995,0.0008774073169106378,0.5304878048780488
1402,1646,어휴/Exclamation,163,21,142,0.00025564076914527065,0.0015993247295586306,0.8711656441717791
1403,1647,실패/Noun,163,27,136,0.00032232966544403684,0.0015326861991603546,0.8343558282208589
1404,1648,아줌마/Noun,163,46,117,0.00053351117039013,0.0013216641862324795,0.7177914110429447
1405,1649,닮다/Verb,163,99,64,0.001122596421029232,0.0007330238343810393,0.6073619631901841
1406,1650,동안/Foreign,163,70,93,0.0008002667555851951,0.0010551100646393743,0.5705521472392638
1407,1651,동물/Noun,163,92,71,0.0010447927086806713,0.0008107687865123613,0.5644171779141104
1408,1652,담/Noun,163,75,88,0.0008558408358341669,0.0009995779559741444,0.5398773006134969
1409,1653,훨/Noun,163,75,88,0.0008558408358341669,0.0009995779559741444,0.5398773006134969
1410,1654,다가오다/Verb,162,132,30,0.0014893853506724466,0.0003554054954574735,0.8148148148148148
1411,1655,은근/Noun,162,127,35,0.0014338112704234743,0.0004109376041227037,0.7839506172839507
1412,1656,심장/Noun,162,126,36,0.0014226964543736804,0.0004220440258557498,0.7777777777777778
1413,1657,바라보다/Verb,162,126,36,0.0014226964543736804,0.0004220440258557498,0.7777777777777778
1414,1658,씁쓸하다/Adjective,162,120,42,0.0013560075580749138,0.0004886825562540262,0.7407407407407407
1415,1659,편하다/Adjective,162,108,54,0.0012226297654773814,0.0006219596170505788,0.6666666666666666
1416,1660,따라가다/Verb,162,56,106,0.0006446593308880737,0.0011994935471689732,0.654320987654321
1417,1661,조합/Noun,162,98,64,0.0011114816049794377,0.0007330238343810393,0.6049382716049383
1418,1662,낳다/Verb,162,89,73,0.0010114482605312882,0.0008329816299784535,0.5493827160493827
1419,1663,방법/Noun,162,86,76,0.0009781038123819054,0.0008663008951775916,0.5308641975308642
1420,1666,없어지다/Verb,161,37,124,0.0004334778259419807,0.0013994091383638019,0.7701863354037267
1421,1667,숨다/Verb,161,121,40,0.0013671223741247086,0.000466469712787934,0.7515527950310559
1422,1668,ㄷㄷㄷ/KoreanParticle,161,96,65,0.0010892519728798488,0.0007441302561140852,0.5962732919254659
1423,1669,즈/Modifier,161,92,69,0.0010447927086806713,0.0007885559430462694,0.5714285714285714
1424,1670,인/Suffix,161,70,91,0.0008002667555851951,0.0010328972211732824,0.5652173913043478
1425,1671,1시간/Number,160,35,125,0.0004112481938423919,0.001410515560096848,0.78125
1426,1672,늦다/Verb,160,123,37,0.001389352006224297,0.0004331504475887958,0.76875
1427,1673,아이돌/Noun,160,54,106,0.0006224296987884852,0.0011994935471689732,0.6625
1428,1674,한국인/Noun,160,57,103,0.0006557741469378681,0.001166174281969835,0.64375
1429,1675,입다/Verb,160,59,101,0.0006780037790374569,0.0011439614385037428,0.63125
1430,1676,히어로/Noun,160,97,63,0.0011003667889296432,0.0007219174126479931,0.60625
1431,1677,뽑다/Verb,160,68,92,0.0007780371234856063,0.0010440036429063284,0.575
1432,1678,악/Noun,160,74,86,0.0008447260197843727,0.000977365112508052,0.5375
1433,1680,명품/Noun,159,135,24,0.0015227297988218294,0.0002887669650591972,0.8490566037735849
1434,1681,존경/Noun,159,126,33,0.0014226964543736804,0.00038872476065661166,0.7924528301886793
1435,1682,더불다/Verb,159,117,42,0.0013226631099255307,0.0004886825562540262,0.7358490566037735
1436,1683,신나다/Adjective,159,111,48,0.0012559742136267645,0.0005553210866523023,0.6981132075471698
1437,1684,이끌다/Verb,159,94,65,0.00106702234078026,0.0007441302561140852,0.5911949685534591
1438,1686,시트콤/Noun,158,109,49,0.0012337445815271755,0.0005664275083853486,0.689873417721519
1439,1687,어쩔/Modifier,158,50,108,0.0005779704345893076,0.0012217063906350652,0.6835443037974683
1440,1688,성/Noun,158,56,102,0.0006446593308880737,0.001155067860236789,0.6455696202531646
1441,1689,대부분/Noun,158,60,98,0.0006891185950872514,0.0011106421733046046,0.620253164556962
1442,1690,겁니다/Verb,158,93,65,0.0010559075247304657,0.0007441302561140852,0.5886075949367089
1443,1691,국내/Noun,158,87,71,0.0009892186284316995,0.0008107687865123613,0.5506329113924051
1444,1693,짠하다/Adjective,157,146,11,0.0016449927753695677,0.0001443834825295986,0.929936305732484
1445,1694,푹/Noun,157,137,20,0.0015449594309214182,0.00024434127812701304,0.8726114649681529
1446,1695,만족/Noun,157,113,44,0.0012782038457263534,0.0005108953997201182,0.7197452229299363
1447,1696,이니/Josa,157,56,101,0.0006446593308880737,0.0011439614385037428,0.643312101910828
1448,1697,주말/Noun,157,99,58,0.001122596421029232,0.0006663853039827628,0.6305732484076433
1449,1698,신분/Noun,157,99,58,0.001122596421029232,0.0006663853039827628,0.6305732484076433
1450,1699,쵝오/Noun,156,151,5,0.0017005668556185395,7.774495213132233e-05,0.9679487179487181
1451,1700,세기/Noun,156,90,66,0.0010225630765810826,0.0007552366778471312,0.5769230769230769
1452,1701,직접/Noun,156,87,69,0.0009892186284316995,0.0007885559430462694,0.5576923076923077
1453,1702,분명/Noun,156,73,83,0.0008336112037345782,0.000944045847308914,0.532051282051282
1454,1703,거슬리다/Verb,155,35,120,0.0004112481938423919,0.0013549834514316175,0.7741935483870968
1455,1704,전개도/Noun,155,54,101,0.0006224296987884852,0.0011439614385037428,0.6516129032258065
1456,1705,30/Number,155,98,57,0.0011114816049794377,0.0006552788822497168,0.6322580645161291
1457,1706,의리/Noun,155,89,66,0.0010114482605312882,0.0007552366778471312,0.5741935483870968
1458,1707,미모/Noun,155,88,67,0.0010003334444814939,0.0007663430995801773,0.567741935483871
1459,1708,줍다/Verb,155,72,83,0.0008224963876847838,0.000944045847308914,0.535483870967742
1460,1709,짝퉁/Noun,154,7,147,0.0001000333444481494,0.0016548568382238609,0.9545454545454546
1461,1710,개뿔/Noun,154,7,147,0.0001000333444481494,0.0016548568382238609,0.9545454545454546
1462,1711,양심/Noun,154,28,126,0.0003334444814938313,0.001421621981829894,0.8181818181818182
1463,1712,????/Punctuation,154,36,118,0.00042236300989218633,0.0013327706079655256,0.7662337662337663
1464,1713,누군가/Noun,154,118,36,0.001333777925975325,0.0004220440258557498,0.7662337662337663
1465,1714,그거/Noun,154,45,109,0.0005223963543403357,0.0012328128123681114,0.7077922077922078
1466,1715,개념/Noun,154,49,105,0.0005668556185395131,0.001188387125435927,0.6818181818181818
1467,1716,이자/Noun,154,103,51,0.0011670556852284096,0.0005886403518514405,0.6688311688311688
1468,1717,시원하다/Adjective,154,103,51,0.0011670556852284096,0.0005886403518514405,0.6688311688311688
1469,1718,으로만/Josa,154,55,99,0.0006335445148382794,0.0011217485950376508,0.6428571428571429
1470,1719,끼/Noun,154,58,96,0.0006668889629876625,0.0010884293298385123,0.6233766233766234
1471,1720,돌아오다/Verb,154,93,61,0.0010559075247304657,0.0006997045691819009,0.6038961038961039
1472,1721,민망하다/Adjective,153,16,137,0.0002000666888962988,0.0015437926208934005,0.8954248366013072
1473,1722,망/Noun,153,19,134,0.0002334111370456819,0.0015104733556942625,0.8758169934640523
1474,1723,연예인/Noun,153,27,126,0.00032232966544403684,0.001421621981829894,0.8235294117647058
1475,1724,도안/Noun,153,38,115,0.000444592641991775,0.0012994513427663874,0.7516339869281046
1476,1725,해내다/Verb,153,114,39,0.0012893186617761474,0.000455363291054888,0.7450980392156863
1477,1726,가요/Noun,153,39,114,0.00045570745804156943,0.0012883449210333415,0.7450980392156863
1478,1727,전반/Noun,153,49,104,0.0005668556185395131,0.001177280703702881,0.6797385620915033
1479,1728,진리/Noun,153,101,52,0.0011448260531288204,0.0005997467735844866,0.6601307189542484
1480,1729,이정/Noun,153,60,93,0.0006891185950872514,0.0010551100646393743,0.6078431372549019
1481,1730,이란/Noun,153,91,62,0.001033677892630877,0.000710810990914947,0.5947712418300654
1482,1731,에피소드/Noun,153,70,83,0.0008002667555851951,0.000944045847308914,0.5424836601307189
1483,1733,돌아보다/Verb,152,143,9,0.0016116483272201846,0.00012217063906350652,0.9407894736842104
1484,1734,의외로/Adverb,152,129,23,0.0014560409025230633,0.00027766054332615115,0.8486842105263158
1485,1735,여행/Noun,152,104,48,0.001178170501278204,0.0005553210866523023,0.6842105263157895
1486,1736,향/Noun,152,100,52,0.0011337112370790265,0.0005997467735844866,0.6578947368421053
1487,1737,19/Number,152,56,96,0.0006446593308880737,0.0010884293298385123,0.631578947368421
1488,1738,레알/Noun,152,63,89,0.0007224630432366343,0.0010106843777071904,0.5855263157894737
1489,1739,생활/Noun,152,87,65,0.0009892186284316995,0.0007441302561140852,0.5723684210526315
1490,1740,찝찝하다/Adjective,151,30,121,0.00035567411359342004,0.001366089873164664,0.8013245033112583
1491,1741,사기/Noun,151,33,118,0.00038901856174280313,0.0013327706079655256,0.7814569536423841
1492,1742,과장/Noun,151,51,100,0.000589085250639102,0.0011328550167706971,0.6622516556291391
1493,1743,스스로/Noun,151,86,65,0.0009781038123819054,0.0007441302561140852,0.5695364238410596
1494,1750,라지/Noun,150,18,132,0.0002222963209958875,0.0014882605122281704,0.88
1495,1751,날리다/Verb,150,30,120,0.00035567411359342004,0.0013549834514316175,0.8
1496,1752,갈등/Noun,150,95,55,0.0010781371568300542,0.0006330660387836247,0.6333333333333333
1497,1753,하나로/Noun,150,88,62,0.0010003334444814939,0.000710810990914947,0.5866666666666667
1498,1754,한참/Noun,150,62,88,0.0007113482271868402,0.0009995779559741444,0.5866666666666667
1499,1755,헐리웃/Noun,150,66,84,0.0007558074913860174,0.00095515226904196,0.56
1500,1756,막히다/Verb,150,84,66,0.0009558741802823164,0.0007552366778471312,0.56
1501,1757,로봇/Noun,150,83,67,0.0009447593642325221,0.0007663430995801773,0.5533333333333333
1502,1758,문/Modifier,150,67,83,0.0007669223074358119,0.000944045847308914,0.5533333333333333
1503,1759,유/Noun,150,68,82,0.0007780371234856063,0.000932939425575868,0.5466666666666666
1504,1761,낭비하다/Adjective,149,2,147,4.445926419917751e-05,0.0016548568382238609,0.9865771812080536
1505,1762,단연/Noun,149,128,21,0.0014449260864732687,0.0002554476998600591,0.8590604026845637
1506,1763,무척/Noun,149,114,35,0.0012893186617761474,0.0004109376041227037,0.7651006711409396
1507,1764,성장/Noun,149,110,39,0.00124485939757697,0.000455363291054888,0.7382550335570469
1508,1765,......../Punctuation,149,45,104,0.0005223963543403357,0.001177280703702881,0.6979865771812079
1509,1766,번째/Suffix,149,95,54,0.0010781371568300542,0.0006219596170505788,0.6375838926174496
1510,1767,초등학생/Noun,149,56,93,0.0006446593308880737,0.0010551100646393743,0.6241610738255033
1511,1768,연속/Noun,149,59,90,0.0006780037790374569,0.0010217907994402363,0.6040268456375839
1512,1769,주변/Noun,149,88,61,0.0010003334444814939,0.0006997045691819009,0.5906040268456376
1513,1770,경험/Noun,149,87,62,0.0009892186284316995,0.000710810990914947,0.5838926174496645
1514,1771,한데/Eomi,149,63,86,0.0007224630432366343,0.000977365112508052,0.5771812080536913
1515,1772,섹시하다/Adjective,149,84,65,0.0009558741802823164,0.0007441302561140852,0.5637583892617449
1516,1773,&/Punctuation,149,81,68,0.0009225297321329332,0.0007774495213132232,0.5436241610738255
1517,1774,오르다/Verb,149,81,68,0.0009225297321329332,0.0007774495213132232,0.5436241610738255
1518,1775,이도/Noun,148,5,143,7.780371234856063e-05,0.001610431151291677,0.9662162162162162
1519,1776,상/Noun,148,44,104,0.0005112815382905413,0.001177280703702881,0.7027027027027027
1520,1777,피해자/Noun,148,44,104,0.0005112815382905413,0.001177280703702881,0.7027027027027027
1521,1778,감히/Noun,148,97,51,0.0011003667889296432,0.0005886403518514405,0.6554054054054054
1522,1779,뒷/Modifier,148,53,95,0.0006113148827386907,0.0010773229081054666,0.6418918918918919
1523,1780,김기덕/Noun,148,63,85,0.0007224630432366343,0.0009662586907750061,0.5743243243243243
1524,1781,꽝/Noun,147,8,139,0.00011114816049794375,0.0015660054643594926,0.9455782312925172
1525,1782,라이/Noun,147,28,119,0.0003334444814938313,0.0013438770296985718,0.8095238095238095
1526,1783,편견/Noun,147,103,44,0.0011670556852284096,0.0005108953997201182,0.7006802721088435
1527,1784,베스트/Noun,147,97,50,0.0011003667889296432,0.0005775339301183945,0.6598639455782312
1528,1785,이여/Josa,147,86,61,0.0009781038123819054,0.0006997045691819009,0.5850340136054422
1529,1786,견자단/Noun,147,68,79,0.0007780371234856063,0.0008996201603767299,0.5374149659863946
1530,1789,사수/Noun,146,132,14,0.0014893853506724466,0.00017770274772873674,0.9041095890410958
1531,1790,허세/Noun,146,18,128,0.0002222963209958875,0.0014438348252959862,0.8767123287671232
1532,1791,와우/Noun,146,125,21,0.0014115816383238858,0.0002554476998600591,0.8561643835616438
1533,1792,명성/Noun,146,25,121,0.00030010003334444816,0.001366089873164664,0.8287671232876712
1534,1793,얘/Noun,146,40,106,0.0004668222740913638,0.0011994935471689732,0.726027397260274
1535,1794,올라가다/Verb,146,98,48,0.0011114816049794377,0.0005553210866523023,0.6712328767123288
1536,1795,확/Noun,146,50,96,0.0005779704345893076,0.0010884293298385123,0.6575342465753424
1537,1796,의식/Noun,146,61,85,0.0007002334111370457,0.0009662586907750061,0.5821917808219178
1538,1797,부모/Noun,146,80,66,0.0009114149160831386,0.0007552366778471312,0.547945205479452
1539,1798,아마/Noun,146,78,68,0.00088918528398355,0.0007774495213132232,0.5342465753424658
1540,1799,검색/Noun,146,78,68,0.00088918528398355,0.0007774495213132232,0.5342465753424658
1541,1803,개막/Noun,145,9,136,0.00012226297654773814,0.0015326861991603546,0.9379310344827586
1542,1804,생생하다/Adjective,145,134,11,0.0015116149827720349,0.0001443834825295986,0.9241379310344828
1543,1805,^/Punctuation,145,102,43,0.0011559408691786152,0.0004997889779870722,0.7034482758620689
1544,1806,연결/Noun,145,50,95,0.0005779704345893076,0.0010773229081054666,0.6551724137931034
1545,1807,영어/Noun,145,59,86,0.0006780037790374569,0.000977365112508052,0.593103448275862
1546,1808,외계인/Noun,145,64,81,0.0007335778592864287,0.000921833003842822,0.5586206896551724
1547,1809,뭉클하다/Adjective,144,139,5,0.0015671890630210071,7.774495213132233e-05,0.9652777777777778
1548,1810,마이너스/Noun,144,7,137,0.0001000333444481494,0.0015437926208934005,0.9513888888888888
1549,1811,밋밋하다/Adjective,144,18,126,0.0002222963209958875,0.001421621981829894,0.875
1550,1812,묘/Noun,144,118,26,0.001333777925975325,0.00031097980852528933,0.8194444444444444
1551,1813,...?/Punctuation,144,54,90,0.0006224296987884852,0.0010217907994402363,0.625
1552,1814,만큼은/Josa,144,90,54,0.0010225630765810826,0.0006219596170505788,0.625
1553,1815,쪽/Noun,144,57,87,0.0006557741469378681,0.0009884715342410985,0.6041666666666666
1554,1817,저/Modifier,143,26,117,0.00031121484939424253,0.0013216641862324795,0.8181818181818182
1555,1818,풍경/Noun,143,101,42,0.0011448260531288204,0.0004886825562540262,0.7062937062937062
1556,1819,처/Noun,143,44,99,0.0005112815382905413,0.0011217485950376508,0.6923076923076923
1557,1820,드물다/Adjective,143,98,45,0.0011114816049794377,0.0005220018214531642,0.6853146853146853
1558,1821,무언가/Noun,143,97,46,0.0011003667889296432,0.0005331082431862101,0.6783216783216783
1559,1822,이보/Noun,143,79,64,0.0009003001000333445,0.0007330238343810393,0.5524475524475524
1560,1823,이든/Josa,143,77,66,0.0008780704679337558,0.0007552366778471312,0.5384615384615384
1561,1824,ㅉㅉㅉ/KoreanParticle,142,15,127,0.00018895187284650438,0.00143272840356294,0.8943661971830986
1562,1825,싸이코/Noun,142,29,113,0.0003445592975436257,0.0012772384993002955,0.7957746478873241
1563,1826,만들기/Noun,142,30,112,0.00035567411359342004,0.0012661320775672494,0.7887323943661971
1564,1827,자연스럽다/Adjective,142,112,30,0.0012670890296765588,0.0003554054954574735,0.7887323943661971
1565,1828,복잡하다/Adjective,142,92,50,0.0010447927086806713,0.0005775339301183945,0.647887323943662
1566,1829,개성/Noun,142,87,55,0.0009892186284316995,0.0006330660387836247,0.6126760563380281
1567,1831,달달/Noun,141,125,16,0.0014115816383238858,0.00019991559119482882,0.8865248226950354
1568,1832,어린시절/Noun,141,123,18,0.001389352006224297,0.00022212843466092096,0.8723404255319149
1569,1833,정체/Noun,141,30,111,0.00035567411359342004,0.0012550256558342032,0.7872340425531915
1570,1834,막장드라마/Noun,141,32,109,0.00037790374569300877,0.0012328128123681114,0.7730496453900709
1571,1835,왠/Modifier,141,33,108,0.00038901856174280313,0.0012217063906350652,0.7659574468085106
1572,1836,마이클/Noun,141,91,50,0.001033677892630877,0.0005775339301183945,0.6453900709219859
1573,1837,옆/Noun,141,63,78,0.0007224630432366343,0.0008885137386436838,0.5531914893617021
1574,1838,무지/Noun,141,77,64,0.0008780704679337558,0.0007330238343810393,0.5460992907801419
1575,1839,조/Noun,141,65,76,0.0007446926753362233,0.0008663008951775916,0.5390070921985816
1576,1840,기준/Noun,141,75,66,0.0008558408358341669,0.0007552366778471312,0.5319148936170213
1577,1842,♥♥/Foreign,140,140,0,0.0015783038790708015,2.2212843466092093e-05,1.0
1578,1843,숨기다/Verb,140,114,26,0.0012893186617761474,0.00031097980852528933,0.8142857142857143
1579,1844,세월/Noun,140,105,35,0.0011892853173279985,0.0004109376041227037,0.75
1580,1845,캐리/Noun,140,104,36,0.001178170501278204,0.0004220440258557498,0.7428571428571429
1581,1846,변화/Noun,140,91,49,0.001033677892630877,0.0005664275083853486,0.65
1582,1847,빨다/Verb,140,54,86,0.0006224296987884852,0.000977365112508052,0.6142857142857143
1583,1848,으로써/Josa,140,83,57,0.0009447593642325221,0.0006552788822497168,0.5928571428571429
1584,1849,코난/Noun,140,82,58,0.0009336445481827276,0.0006663853039827628,0.5857142857142857
1585,1852,일품/Noun,139,126,13,0.0014226964543736804,0.0001665963259956907,0.9064748201438848
1586,1853,젠장/Noun,139,22,117,0.000266755585195065,0.0013216641862324795,0.8417266187050358
1587,1854,기회/Noun,139,106,33,0.0012004001333777929,0.00038872476065661166,0.7625899280575541
1588,1855,카리스마/Noun,139,105,34,0.0011892853173279985,0.00039983118238965764,0.7553956834532374
1589,1856,남아/Noun,139,97,42,0.0011003667889296432,0.0004886825562540262,0.6978417266187049
1590,1857,깎다/Verb,139,61,78,0.0007002334111370457,0.0008885137386436838,0.5611510791366906
1591,1858,아/Noun,138,27,111,0.00032232966544403684,0.0012550256558342032,0.8043478260869565
1592,1859,칼/Noun,138,41,97,0.0004779370901411582,0.0010995357515715587,0.7028985507246377
1593,1860,신경/Noun,138,42,96,0.0004890519061909527,0.0010884293298385123,0.6956521739130435
1594,1861,자살/Noun,138,43,95,0.0005001667222407468,0.0010773229081054666,0.6884057971014492
1595,1862,오빠/Noun,138,95,43,0.0010781371568300542,0.0004997889779870722,0.6884057971014492
1596,1863,맨/Modifier,138,51,87,0.000589085250639102,0.0009884715342410985,0.6304347826086957
1597,1864,면서/Noun,138,84,54,0.0009558741802823164,0.0006219596170505788,0.6086956521739131
1598,1865,덜/Noun,138,57,81,0.0006557741469378681,0.000921833003842822,0.5869565217391305
1599,1866,시청/Noun,138,74,64,0.0008447260197843727,0.0007330238343810393,0.5362318840579711
1600,1867,니깐/Josa,138,74,64,0.0008447260197843727,0.0007330238343810393,0.5362318840579711
1601,1869,포르노/Noun,137,16,121,0.0002000666888962988,0.001366089873164664,0.8832116788321168
1602,1870,C/Alpha,137,16,121,0.0002000666888962988,0.001366089873164664,0.8832116788321168
1603,1871,응원/Noun,137,116,21,0.0013115482938757365,0.0002554476998600591,0.8467153284671532
1604,1872,겨/Noun,137,26,111,0.00031121484939424253,0.0012550256558342032,0.8102189781021898
1605,1873,압권/Noun,137,111,26,0.0012559742136267645,0.00031097980852528933,0.8102189781021898
1606,1874,다양하다/Adjective,137,99,38,0.001122596421029232,0.0004442568693218419,0.7226277372262774
1607,1875,모으다/Verb,137,39,98,0.00045570745804156943,0.0011106421733046046,0.7153284671532847
1608,1876,형사/Noun,137,43,94,0.0005001667222407468,0.0010662164863724202,0.6861313868613139
1609,1877,만해/Noun,137,91,46,0.001033677892630877,0.0005331082431862101,0.6642335766423357
1610,1878,",,,,/Punctuation",137,50,87,0.0005779704345893076,0.0009884715342410985,0.635036496350365
1611,1879,잠깐/Noun,137,52,85,0.0006002000666888963,0.0009662586907750061,0.6204379562043796
1612,1880,매/Modifier,137,82,55,0.0009336445481827276,0.0006330660387836247,0.5985401459854015
1613,1881,뿐이다/Adjective,137,56,81,0.0006446593308880737,0.000921833003842822,0.5912408759124088
1614,1882,기자/Noun,137,79,58,0.0009003001000333445,0.0006663853039827628,0.5766423357664233
1615,1883,살아나다/Verb,137,78,59,0.00088918528398355,0.0006774917257158089,0.5693430656934306
1616,1884,?!/Punctuation,137,64,73,0.0007335778592864287,0.0008329816299784535,0.5328467153284672
1617,1886,시시하다/Adjective,136,23,113,0.00027787040124485944,0.0012772384993002955,0.8308823529411765
1618,1887,세번/Noun,136,110,26,0.00124485939757697,0.00031097980852528933,0.8088235294117647
1619,1888,냥/Josa,136,31,105,0.00036678892964321435,0.001188387125435927,0.7720588235294118
1620,1889,만에/Josa,136,101,35,0.0011448260531288204,0.0004109376041227037,0.7426470588235294
1621,1890,내면/Noun,136,99,37,0.001122596421029232,0.0004331504475887958,0.7279411764705882
1622,1891,성격/Noun,136,41,95,0.0004779370901411582,0.0010773229081054666,0.6985294117647058
1623,1892,선물/Noun,136,95,41,0.0010781371568300542,0.00047757613452098,0.6985294117647058
1624,1893,동시/Noun,136,90,46,0.0010225630765810826,0.0005331082431862101,0.6617647058823529
1625,1897,에로영화/Noun,135,22,113,0.000266755585195065,0.0012772384993002955,0.837037037037037
1626,1898,겨우/Noun,135,22,113,0.000266755585195065,0.0012772384993002955,0.837037037037037
1627,1899,추하다/Adjective,135,108,27,0.0012226297654773814,0.00032208623025833537,0.8
1628,1900,적임/Noun,135,96,39,0.0010892519728798488,0.000455363291054888,0.7111111111111111
1629,1901,만족하다/Adjective,135,93,42,0.0010559075247304657,0.0004886825562540262,0.6888888888888889
1630,1902,형제/Noun,135,91,44,0.001033677892630877,0.0005108953997201182,0.674074074074074
1631,1903,조용하다/Adjective,135,90,45,0.0010225630765810826,0.0005220018214531642,0.6666666666666666
1632,1904,할머니/Noun,135,87,48,0.0009892186284316995,0.0005553210866523023,0.6444444444444445
1633,1905,빈/Noun,135,57,78,0.0006557741469378681,0.0008885137386436838,0.5777777777777777
1634,1910,야동/Noun,134,25,109,0.00030010003334444816,0.0012328128123681114,0.8134328358208955
1635,1911,롭고/Josa,134,108,26,0.0012226297654773814,0.00031097980852528933,0.8059701492537313
1636,1912,당/Suffix,134,44,90,0.0005112815382905413,0.0010217907994402363,0.6716417910447762
1637,1913,[/Punctuation,134,44,90,0.0005112815382905413,0.0010217907994402363,0.6716417910447762
1638,1914,스럽지/Josa,134,87,47,0.0009892186284316995,0.0005442146649192564,0.6492537313432836
1639,1915,멈추다/Verb,134,84,50,0.0009558741802823164,0.0005775339301183945,0.6268656716417911
1640,1916,넌/Noun,134,54,80,0.0006224296987884852,0.000910726582109776,0.5970149253731343
1641,1917,우와/Exclamation,134,80,54,0.0009114149160831386,0.0006219596170505788,0.5970149253731343
1642,1918,인들/Josa,134,57,77,0.0006557741469378681,0.0008774073169106378,0.5746268656716418
1643,1919,정의/Noun,134,77,57,0.0008780704679337558,0.0006552788822497168,0.5746268656716418
1644,1924,투자/Noun,133,20,113,0.00024452595309547634,0.0012772384993002955,0.849624060150376
1645,1925,레전드/Noun,133,108,25,0.0012226297654773814,0.0002998733867922433,0.8120300751879699
1646,1926,지우다/Verb,133,30,103,0.00035567411359342004,0.001166174281969835,0.7744360902255639
1647,1927,고통/Noun,133,95,38,0.0010781371568300542,0.0004442568693218419,0.7142857142857143
1648,1928,비현실적/Noun,133,41,92,0.0004779370901411582,0.0010440036429063284,0.6917293233082706
1649,1929,욕망/Noun,133,90,43,0.0010225630765810826,0.0004997889779870722,0.6766917293233082
1650,1930,쉬/Noun,133,90,43,0.0010225630765810826,0.0004997889779870722,0.6766917293233082
1651,1931,방영/Noun,133,85,48,0.0009669889963321108,0.0005553210866523023,0.6390977443609023
1652,1932,영혼/Noun,133,82,51,0.0009336445481827276,0.0005886403518514405,0.6165413533834586
1653,1933,관점/Noun,133,77,56,0.0008780704679337558,0.0006441724605166707,0.5789473684210527
1654,1934,온/Modifier,133,61,72,0.0007002334111370457,0.0008218752082454075,0.5413533834586466
1655,1937,진하다/Adjective,132,119,13,0.0013448927420251196,0.0001665963259956907,0.9015151515151516
1656,1938,초등학교/Noun,132,99,33,0.001122596421029232,0.00038872476065661166,0.75
1657,1939,학년/Noun,132,96,36,0.0010892519728798488,0.0004220440258557498,0.7272727272727273
1658,1940,로그인/Noun,132,41,91,0.0004779370901411582,0.0010328972211732824,0.6893939393939394
1659,1941,베/Noun,132,45,87,0.0005223963543403357,0.0009884715342410985,0.6590909090909091
1660,1942,을/Foreign,132,45,87,0.0005223963543403357,0.0009884715342410985,0.6590909090909091
1661,1943,특수/Noun,132,48,84,0.0005557408024897189,0.00095515226904196,0.6363636363636364
1662,1944,감안/Noun,132,51,81,0.000589085250639102,0.000921833003842822,0.6136363636363636
1663,1945,21/Number,132,79,53,0.0009003001000333445,0.0006108531953175326,0.5984848484848485
1664,1946,12/Number,132,54,78,0.0006224296987884852,0.0008885137386436838,0.5909090909090909
1665,1947,상업/Noun,132,55,77,0.0006335445148382794,0.0008774073169106378,0.5833333333333334
1666,1948,타/Noun,132,76,56,0.0008669556518839612,0.0006441724605166707,0.5757575757575758
1667,1949,의/Foreign,132,70,62,0.0008002667555851951,0.000710810990914947,0.5303030303030303
1668,1950,M/Alpha,131,5,126,7.780371234856063e-05,0.001421621981829894,0.9618320610687024
1669,1951,잠들다/Verb,131,17,114,0.00021118150494609317,0.0012883449210333415,0.8702290076335878
1670,1952,감흥/Noun,131,19,112,0.0002334111370456819,0.0012661320775672494,0.8549618320610687
1671,1953,붙이다/Verb,131,21,110,0.00025564076914527065,0.0012439192341011573,0.8396946564885496
1672,1954,부럽다/Adjective,131,106,25,0.0012004001333777929,0.0002998733867922433,0.8091603053435115
1673,1955,설득/Noun,131,30,101,0.00035567411359342004,0.0011439614385037428,0.7709923664122137
1674,1956,따로/Adverb,131,31,100,0.00036678892964321435,0.0011328550167706971,0.7633587786259542
1675,1957,]/Punctuation,131,38,93,0.000444592641991775,0.0010551100646393743,0.7099236641221374
1676,1958,끝내주다/Adjective,131,91,40,0.001033677892630877,0.000466469712787934,0.6946564885496184
1677,1959,놀랍다/Adjective,131,91,40,0.001033677892630877,0.000466469712787934,0.6946564885496184
1678,1960,권/Suffix,131,84,47,0.0009558741802823164,0.0005442146649192564,0.6412213740458015
1679,1961,그건/Adverb,131,55,76,0.0006335445148382794,0.0008663008951775916,0.5801526717557252
1680,1962,채/Noun,131,59,72,0.0006780037790374569,0.0008218752082454075,0.5496183206106869
1681,1964,반하다/Adjective,130,112,18,0.0012670890296765588,0.00022212843466092096,0.8615384615384616
1682,1965,점준/Noun,130,23,107,0.00027787040124485944,0.0012105999689020189,0.823076923076923
1683,1966,인지도/Noun,130,26,104,0.00031121484939424253,0.001177280703702881,0.8
1684,1967,x/Alpha,130,34,96,0.0004001333777925976,0.0010884293298385123,0.7384615384615385
1685,1968,루/Noun,130,36,94,0.00042236300989218633,0.0010662164863724202,0.7230769230769231
1686,1969,기발하다/Adjective,130,92,38,0.0010447927086806713,0.0004442568693218419,0.7076923076923077
1687,1970,최강/Noun,130,88,42,0.0010003334444814939,0.0004886825562540262,0.676923076923077
1688,1971,주성치/Noun,130,81,49,0.0009225297321329332,0.0005664275083853486,0.6230769230769231
1689,1972,키우다/Verb,130,60,70,0.0006891185950872514,0.0007996623647793153,0.5384615384615384
1690,1975,안습/Noun,129,16,113,0.0002000666888962988,0.0012772384993002955,0.875968992248062
1691,1976,우려/Noun,129,18,111,0.0002222963209958875,0.0012550256558342032,0.8604651162790697
1692,1977,기만/Noun,129,25,104,0.00030010003334444816,0.001177280703702881,0.8062015503875969
1693,1978,조작/Noun,129,25,104,0.00030010003334444816,0.001177280703702881,0.8062015503875969
1694,1979,고르다/Verb,129,29,100,0.0003445592975436257,0.0011328550167706971,0.7751937984496124
1695,1980,오랫/Modifier,129,97,32,0.0011003667889296432,0.0003776183389235656,0.751937984496124
1696,1981,스트레스/Noun,129,35,94,0.0004112481938423919,0.0010662164863724202,0.7286821705426356
1697,1982,색감/Noun,129,91,38,0.001033677892630877,0.0004442568693218419,0.7054263565891473
1698,1983,결정/Noun,129,55,74,0.0006335445148382794,0.0008440880517114996,0.5736434108527132
1699,1984,자리/Noun,129,74,55,0.0008447260197843727,0.0006330660387836247,0.5736434108527132
1700,1985,놀래다/Adjective,129,56,73,0.0006446593308880737,0.0008329816299784535,0.5658914728682171
1701,1986,본적/Noun,129,70,59,0.0008002667555851951,0.0006774917257158089,0.5426356589147286
1702,1988,공짜/Noun,128,5,123,7.780371234856063e-05,0.0013883027166307562,0.9609375
1703,1989,18/Number,128,28,100,0.0003334444814938313,0.0011328550167706971,0.78125
1704,1990,놀다/Verb,128,36,92,0.00042236300989218633,0.0010440036429063284,0.71875
1705,1991,아무렇다/Adjective,128,37,91,0.0004334778259419807,0.0010328972211732824,0.7109375
1706,1992,데리/Noun,128,41,87,0.0004779370901411582,0.0009884715342410985,0.6796875
1707,1993,포인트/Noun,128,42,86,0.0004890519061909527,0.000977365112508052,0.671875
1708,1994,ㄱ/KoreanParticle,128,45,83,0.0005223963543403357,0.000944045847308914,0.6484375
1709,1995,저러다/Verb,128,45,83,0.0005223963543403357,0.000944045847308914,0.6484375
1710,1996,갑/Noun,128,83,45,0.0009447593642325221,0.0005220018214531642,0.6484375
1711,1997,바다/Noun,128,75,53,0.0008558408358341669,0.0006108531953175326,0.5859375
1712,1998,홍콩영화/Noun,128,59,69,0.0006780037790374569,0.0007885559430462694,0.5390625
1713,2001,정신병/Noun,127,21,106,0.00025564076914527065,0.0011994935471689732,0.8346456692913385
1714,2002,깨우다/Verb,127,105,22,0.0011892853173279985,0.00026655412159310506,0.8267716535433071
1715,2003,아예/Noun,127,26,101,0.00031121484939424253,0.0011439614385037428,0.7952755905511811
1716,2004,여러가지/Noun,127,95,32,0.0010781371568300542,0.0003776183389235656,0.7480314960629921
1717,2005,미가/Noun,127,94,33,0.00106702234078026,0.00038872476065661166,0.7401574803149606
1718,2006,넘어가다/Verb,127,40,87,0.0004668222740913638,0.0009884715342410985,0.6850393700787402
1719,2007,김/Noun,127,52,75,0.0006002000666888963,0.0008551944734445456,0.5905511811023622
1720,2008,풍자/Noun,127,75,52,0.0008558408358341669,0.0005997467735844866,0.5905511811023622
1721,2009,냄새/Noun,127,55,72,0.0006335445148382794,0.0008218752082454075,0.5669291338582677
1722,2010,아래/Noun,127,57,70,0.0006557741469378681,0.0007996623647793153,0.5511811023622047
1723,2015,틈/Noun,126,106,20,0.0012004001333777929,0.00024434127812701304,0.8412698412698413
1724,2016,;;;;/Punctuation,126,26,100,0.00031121484939424253,0.0011328550167706971,0.7936507936507936
1725,2017,껏/Noun,126,28,98,0.0003334444814938313,0.0011106421733046046,0.7777777777777778
1726,2018,위로/Noun,126,91,35,0.001033677892630877,0.0004109376041227037,0.7222222222222222
1727,2019,전쟁영화/Noun,126,88,38,0.0010003334444814939,0.0004442568693218419,0.6984126984126984
1728,2020,보고오다/Verb,126,78,48,0.00088918528398355,0.0005553210866523023,0.6190476190476191
1729,2021,잔/Noun,126,49,77,0.0005668556185395131,0.0008774073169106378,0.6111111111111112
1730,2022,녀/Noun,126,51,75,0.000589085250639102,0.0008551944734445456,0.5952380952380952
1731,2023,약/Noun,126,52,74,0.0006002000666888963,0.0008440880517114996,0.5873015873015873
1732,2024,관련/Noun,126,57,69,0.0006557741469378681,0.0007885559430462694,0.5476190476190477
1733,2027,효/Noun,125,24,101,0.0002889852172946538,0.0011439614385037428,0.8079999999999999
1734,2028,용기/Noun,125,98,27,0.0011114816049794377,0.00032208623025833537,0.784
1735,2029,뜨겁다/Adjective,125,97,28,0.0011003667889296432,0.0003331926519913814,0.7759999999999999
1736,2030,패/Noun,125,38,87,0.000444592641991775,0.0009884715342410985,0.696
1737,2031,공포물/Noun,125,40,85,0.0004668222740913638,0.0009662586907750061,0.68
1738,2032,근래/Noun,125,84,41,0.0009558741802823164,0.00047757613452098,0.672
1739,2033,수고/Noun,125,82,43,0.0009336445481827276,0.0004997889779870722,0.6559999999999999
1740,2034,만남/Noun,125,80,45,0.0009114149160831386,0.0005220018214531642,0.64
1741,2035,깜짝/Noun,125,73,52,0.0008336112037345782,0.0005997467735844866,0.584
1742,2036,우주/Noun,125,72,53,0.0008224963876847838,0.0006108531953175326,0.5760000000000001
1743,2037,달리다/Verb,125,55,70,0.0006335445148382794,0.0007996623647793153,0.56
1744,2038,나타나다/Verb,125,58,67,0.0006668889629876625,0.0007663430995801773,0.536
1745,2039,말아먹다/Verb,124,12,112,0.00015560742469712126,0.0012661320775672494,0.9032258064516128
1746,2040,운명/Noun,124,93,31,0.0010559075247304657,0.00036651191719051963,0.75
1747,2041,연인/Noun,124,91,33,0.001033677892630877,0.00038872476065661166,0.7338709677419355
1748,2042,이용/Noun,124,38,86,0.000444592641991775,0.000977365112508052,0.6935483870967742
1749,2043,",./Punctuation",124,41,83,0.0004779370901411582,0.000944045847308914,0.6693548387096774
1750,2044,007/Number,124,79,45,0.0009003001000333445,0.0005220018214531642,0.6370967741935484
1751,2045,DVD/Alpha,124,79,45,0.0009003001000333445,0.0005220018214531642,0.6370967741935484
1752,2046,거짓말/Noun,124,46,78,0.00053351117039013,0.0008885137386436838,0.6290322580645161
1753,2047,영화계/Noun,124,47,77,0.0005446259864399244,0.0008774073169106378,0.6209677419354839
1754,2048,파/Noun,124,68,56,0.0007780371234856063,0.0006441724605166707,0.5483870967741935
1755,2049,심오하다/Adjective,124,68,56,0.0007780371234856063,0.0006441724605166707,0.5483870967741935
1756,2050,물이/Noun,124,58,66,0.0006668889629876625,0.0007552366778471312,0.532258064516129
1757,2053,썩다/Verb,123,33,90,0.00038901856174280313,0.0010217907994402363,0.7317073170731707
1758,2054,확인/Noun,123,35,88,0.0004112481938423919,0.0009995779559741444,0.7154471544715447
1759,2055,해결/Noun,123,42,81,0.0004890519061909527,0.000921833003842822,0.6585365853658537
1760,2056,군/Noun,123,46,77,0.00053351117039013,0.0008774073169106378,0.6260162601626016
1761,2057,캐/Noun,123,50,73,0.0005779704345893076,0.0008329816299784535,0.5934959349593496
1762,2058,만을/Josa,123,54,69,0.0006224296987884852,0.0007885559430462694,0.5609756097560976
1763,2059,리즈/Noun,123,55,68,0.0006335445148382794,0.0007774495213132232,0.5528455284552846
1764,2060,단어/Noun,123,57,66,0.0006557741469378681,0.0007552366778471312,0.5365853658536586
1765,2064,았/Noun,122,13,109,0.00016672224074691566,0.0012328128123681114,0.8934426229508197
1766,2065,번은/Noun,122,102,20,0.0011559408691786152,0.00024434127812701304,0.8360655737704918
1767,2066,설마/Noun,122,22,100,0.000266755585195065,0.0011328550167706971,0.819672131147541
1768,2067,결코/Noun,122,91,31,0.001033677892630877,0.00036651191719051963,0.7459016393442623
1769,2068,원/Noun,122,31,91,0.00036678892964321435,0.0010328972211732824,0.7459016393442623
1770,2069,잖다/Verb,122,34,88,0.0004001333777925976,0.0009995779559741444,0.7213114754098361
1771,2070,갠/Noun,122,84,38,0.0009558741802823164,0.0004442568693218419,0.6885245901639344
1772,2071,갖추다/Verb,122,82,40,0.0009336445481827276,0.000466469712787934,0.6721311475409836
1773,2072,전에/Foreign,122,79,43,0.0009003001000333445,0.0004997889779870722,0.6475409836065574
1774,2073,예능/Noun,122,51,71,0.000589085250639102,0.0008107687865123613,0.5819672131147541
1775,2074,점줌/Noun,122,51,71,0.000589085250639102,0.0008107687865123613,0.5819672131147541
1776,2075,내생/Noun,122,69,53,0.0007891519395354007,0.0006108531953175326,0.5655737704918032
1777,2076,백/Modifier,122,66,56,0.0007558074913860174,0.0006441724605166707,0.5409836065573771
1778,2078,낮추다/Verb,121,16,105,0.0002000666888962988,0.001188387125435927,0.8677685950413223
1779,2079,셈/Noun,121,20,101,0.00024452595309547634,0.0011439614385037428,0.8347107438016529
1780,2080,변태/Noun,121,21,100,0.00025564076914527065,0.0011328550167706971,0.8264462809917356
1781,2081,심지어/Noun,121,31,90,0.00036678892964321435,0.0010217907994402363,0.743801652892562
1782,2082,자르다/Verb,121,40,81,0.0004668222740913638,0.000921833003842822,0.6694214876033058
1783,2083,째/Suffix,121,69,52,0.0007891519395354007,0.0005997467735844866,0.5702479338842975
1784,2084,들어서다/Verb,121,65,56,0.0007446926753362233,0.0006441724605166707,0.5371900826446281
1785,2086,잔뜩/Noun,120,15,105,0.00018895187284650438,0.001188387125435927,0.875
1786,2087,5분/Number,120,18,102,0.0002222963209958875,0.001155067860236789,0.85
1787,2088,크리스마스/Noun,120,89,31,0.0010114482605312882,0.00036651191719051963,0.7416666666666667
1788,2089,X/Alpha,120,31,89,0.00036678892964321435,0.0010106843777071904,0.7416666666666667
1789,2090,스런/Josa,120,39,81,0.00045570745804156943,0.000921833003842822,0.675
1790,2091,여러/Noun,120,79,41,0.0009003001000333445,0.00047757613452098,0.6583333333333333
1791,2092,넘기다/Verb,120,43,77,0.0005001667222407468,0.0008774073169106378,0.6416666666666667
1792,2093,편도/Noun,120,77,43,0.0008780704679337558,0.0004997889779870722,0.6416666666666667
1793,2094,이래서/Josa,120,46,74,0.00053351117039013,0.0008440880517114996,0.6166666666666667
1794,2095,스크린/Noun,120,71,49,0.0008113815716349895,0.0005664275083853486,0.5916666666666667
1795,2096,상태/Noun,120,53,67,0.0006113148827386907,0.0007663430995801773,0.5583333333333333
1796,2097,달리/Noun,120,54,66,0.0006224296987884852,0.0007552366778471312,0.55
1797,2098,국가/Noun,120,65,55,0.0007446926753362233,0.0006330660387836247,0.5416666666666666
1798,2099,ㅅ/KoreanParticle,120,56,64,0.0006446593308880737,0.0007330238343810393,0.5333333333333333
1799,2100,전율/Noun,119,110,9,0.00124485939757697,0.00012217063906350652,0.9243697478991596
1800,2101,둘째/Noun,119,14,105,0.00017783705679671002,0.001188387125435927,0.8823529411764706
1801,2102,려고/Noun,119,23,96,0.00027787040124485944,0.0010884293298385123,0.8067226890756303
1802,2103,아동/Noun,119,28,91,0.0003334444814938313,0.0010328972211732824,0.7647058823529411
1803,2104,그립다/Adjective,119,86,33,0.0009781038123819054,0.00038872476065661166,0.7226890756302521
1804,2105,탓/Noun,119,35,84,0.0004112481938423919,0.00095515226904196,0.7058823529411765
1805,2106,뛰어넘다/Verb,119,83,36,0.0009447593642325221,0.0004220440258557498,0.6974789915966386
1806,2107,제외/Noun,119,43,76,0.0005001667222407468,0.0008663008951775916,0.6386554621848739
1807,2108,자주/Noun,119,76,43,0.0008669556518839612,0.0004997889779870722,0.6386554621848739
1808,2109,옷/Noun,119,48,71,0.0005557408024897189,0.0008107687865123613,0.5966386554621849
1809,2110,통/Noun,119,49,70,0.0005668556185395131,0.0007996623647793153,0.5882352941176471
1810,2111,케/Noun,119,51,68,0.000589085250639102,0.0007774495213132232,0.5714285714285714
1811,2112,넘어서다/Verb,119,67,52,0.0007669223074358119,0.0005997467735844866,0.5630252100840336
1812,2113,기법/Noun,119,53,66,0.0006113148827386907,0.0007552366778471312,0.5546218487394958
1813,2114,의하다/Adjective,119,66,53,0.0007558074913860174,0.0006108531953175326,0.5546218487394958
1814,2116,오빠/Suffix,118,106,12,0.0012004001333777929,0.00015548990426264466,0.8983050847457628
1815,2117,작위/Noun,118,17,101,0.00021118150494609317,0.0011439614385037428,0.8559322033898306
1816,2118,대본/Noun,118,24,94,0.0002889852172946538,0.0010662164863724202,0.7966101694915254
1817,2119,부모님/Noun,118,89,29,0.0010114482605312882,0.00034429907372442745,0.7542372881355932
1818,2120,톰/Noun,118,83,35,0.0009447593642325221,0.0004109376041227037,0.7033898305084746
1819,2121,두번째/Noun,118,81,37,0.0009225297321329332,0.0004331504475887958,0.6864406779661016
1820,2122,에나/Josa,118,38,80,0.000444592641991775,0.000910726582109776,0.6779661016949152
1821,2123,짜임새/Noun,118,71,47,0.0008113815716349895,0.0005442146649192564,0.6016949152542372
1822,2124,꼬마/Noun,118,67,51,0.0007669223074358119,0.0005886403518514405,0.5677966101694916
1823,2125,매니아/Noun,118,55,63,0.0006335445148382794,0.0007219174126479931,0.5338983050847458
1824,2126,:)/Punctuation,117,114,3,0.0012893186617761474,5.553210866523024e-05,0.9743589743589745
1825,2127,한개/Modifier,117,10,107,0.0001333777925975325,0.0012105999689020189,0.9145299145299144
1826,2128,애쓰다/Verb,117,25,92,0.00030010003334444816,0.0010440036429063284,0.7863247863247863
1827,2129,하나같이/Adverb,117,28,89,0.0003334444814938313,0.0010106843777071904,0.7606837606837606
1828,2130,가족영화/Noun,117,77,40,0.0008780704679337558,0.000466469712787934,0.6581196581196581
1829,2131,케릭/Noun,117,44,73,0.0005112815382905413,0.0008329816299784535,0.6239316239316239
1830,2132,사상/Noun,117,46,71,0.00053351117039013,0.0008107687865123613,0.6068376068376068
1831,2133,흑인/Noun,117,47,70,0.0005446259864399244,0.0007996623647793153,0.5982905982905983
1832,2134,비밀/Noun,117,51,66,0.000589085250639102,0.0007552366778471312,0.5641025641025641
1833,2135,감정이입/Noun,117,53,64,0.0006113148827386907,0.0007330238343810393,0.5470085470085471
1834,2136,대중/Noun,117,54,63,0.0006224296987884852,0.0007219174126479931,0.5384615384615384
1835,2139,그만/Modifier,116,9,107,0.00012226297654773814,0.0012105999689020189,0.9224137931034484
1836,2140,하자/Noun,116,24,92,0.0002889852172946538,0.0010440036429063284,0.7931034482758621
1837,2141,정작/Noun,116,29,87,0.0003445592975436257,0.0009884715342410985,0.75
1838,2142,거나/Noun,116,33,83,0.00038901856174280313,0.000944045847308914,0.7155172413793104
1839,2143,신의/Noun,116,79,37,0.0009003001000333445,0.0004331504475887958,0.6810344827586207
1840,2144,장가/Noun,116,37,79,0.0004334778259419807,0.0008996201603767299,0.6810344827586207
1841,2145,무료/Noun,116,40,76,0.0004668222740913638,0.0008663008951775916,0.6551724137931034
1842,2146,예/Noun,116,40,76,0.0004668222740913638,0.0008663008951775916,0.6551724137931034
1843,2147,꺼/Suffix,116,40,76,0.0004668222740913638,0.0008663008951775916,0.6551724137931034
1844,2148,워/Noun,116,49,67,0.0005668556185395131,0.0007663430995801773,0.5775862068965517
1845,2149,박/Noun,116,64,52,0.0007335778592864287,0.0005997467735844866,0.5517241379310345
1846,2150,와의/Josa,116,64,52,0.0007335778592864287,0.0005997467735844866,0.5517241379310345
1847,2152,대놓고/Adverb,115,17,98,0.00021118150494609317,0.0011106421733046046,0.8521739130434782
1848,2153,ㅠㅜ/KoreanParticle,115,89,26,0.0010114482605312882,0.00031097980852528933,0.7739130434782608
1849,2154,소년/Noun,115,84,31,0.0009558741802823164,0.00036651191719051963,0.7304347826086957
1850,2155,열연/Noun,115,80,35,0.0009114149160831386,0.0004109376041227037,0.6956521739130435
1851,2156,성은/Noun,115,36,79,0.00042236300989218633,0.0008996201603767299,0.6869565217391305
1852,2157,목적/Noun,115,37,78,0.0004334778259419807,0.0008885137386436838,0.6782608695652174
1853,2158,충실하다/Adjective,115,77,38,0.0008780704679337558,0.0004442568693218419,0.6695652173913044
1854,2159,의심/Noun,115,40,75,0.0004668222740913638,0.0008551944734445456,0.6521739130434783
1855,2160,메/Noun,115,75,40,0.0008558408358341669,0.000466469712787934,0.6521739130434783
1856,2161,낫/Noun,115,43,72,0.0005001667222407468,0.0008218752082454075,0.6260869565217392
1857,2162,으리/Noun,115,71,44,0.0008113815716349895,0.0005108953997201182,0.6173913043478261
1858,2163,탄생/Noun,115,63,52,0.0007224630432366343,0.0005997467735844866,0.5478260869565217
1859,2164,무술/Noun,115,53,62,0.0006113148827386907,0.000710810990914947,0.5391304347826087
1860,2166,힘내다/Verb,114,95,19,0.0010781371568300542,0.000233234856393967,0.8333333333333334
1861,2167,겪다/Verb,114,87,27,0.0009892186284316995,0.00032208623025833537,0.7631578947368421
1862,2168,씹다/Verb,114,31,83,0.00036678892964321435,0.000944045847308914,0.7280701754385965
1863,2169,패러디/Noun,114,36,78,0.00042236300989218633,0.0008885137386436838,0.6842105263157895
1864,2170,꿈꾸다/Verb,114,77,37,0.0008780704679337558,0.0004331504475887958,0.6754385964912281
1865,2171,새다/Verb,114,42,72,0.0004890519061909527,0.0008218752082454075,0.631578947368421
1866,2172,the/Alpha,114,71,43,0.0008113815716349895,0.0004997889779870722,0.6228070175438597
1867,2173,구나/Noun,114,44,70,0.0005112815382905413,0.0007996623647793153,0.6140350877192983
1868,2174,15/Number,114,45,69,0.0005223963543403357,0.0007885559430462694,0.6052631578947368
1869,2175,지나가다/Verb,114,68,46,0.0007780371234856063,0.0005331082431862101,0.5964912280701754
1870,2176,화끈하다/Adjective,114,65,49,0.0007446926753362233,0.0005664275083853486,0.5701754385964912
1871,2177,애가/Noun,114,50,64,0.0005779704345893076,0.0007330238343810393,0.5614035087719298
1872,2178,명의/Noun,114,61,53,0.0007002334111370457,0.0006108531953175326,0.5350877192982456
1873,2181,20분/Number,113,18,95,0.0002222963209958875,0.0010773229081054666,0.8407079646017699
1874,2182,ㅜㅜㅜ/KoreanParticle,113,83,30,0.0009447593642325221,0.0003554054954574735,0.7345132743362832
1875,2183,..;;/Punctuation,113,31,82,0.00036678892964321435,0.000932939425575868,0.7256637168141593
1876,2184,무서움/Noun,113,47,66,0.0005446259864399244,0.0007552366778471312,0.584070796460177
1877,2185,브루스/Noun,113,48,65,0.0005557408024897189,0.0007441302561140852,0.5752212389380531
1878,2188,명화/Noun,112,90,22,0.0010225630765810826,0.00026655412159310506,0.8035714285714286
1879,2189,값/Noun,112,27,85,0.00032232966544403684,0.0009662586907750061,0.7589285714285714
1880,2190,감각/Noun,112,73,39,0.0008336112037345782,0.000455363291054888,0.6517857142857143
1881,2191,부부/Noun,112,68,44,0.0007780371234856063,0.0005108953997201182,0.6071428571428571
1882,2192,집착/Noun,112,45,67,0.0005223963543403357,0.0007663430995801773,0.5982142857142857
1883,2193,틀/Noun,112,51,61,0.000589085250639102,0.0006997045691819009,0.5446428571428571
1884,2194,주제가/Noun,112,51,61,0.000589085250639102,0.0006997045691819009,0.5446428571428571
1885,2195,골/Noun,112,51,61,0.000589085250639102,0.0006997045691819009,0.5446428571428571
1886,2198,낚였다/Noun,111,2,109,4.445926419917751e-05,0.0012328128123681114,0.981981981981982
1887,2199,참나/Noun,111,10,101,0.0001333777925975325,0.0011439614385037428,0.90990990990991
1888,2200,오래전/Adverb,111,85,26,0.0009669889963321108,0.00031097980852528933,0.7657657657657657
1889,2201,!!!!!/Punctuation,111,81,30,0.0009225297321329332,0.0003554054954574735,0.7297297297297297
1890,2202,뇌/Noun,111,37,74,0.0004334778259419807,0.0008440880517114996,0.6666666666666666
1891,2203,시기/Noun,111,68,43,0.0007780371234856063,0.0004997889779870722,0.6126126126126126
1892,2204,앉다/Verb,111,44,67,0.0005112815382905413,0.0007663430995801773,0.6036036036036037
1893,2205,피다/Verb,111,48,63,0.0005557408024897189,0.0007219174126479931,0.5675675675675675
1894,2206,어둡다/Adjective,111,49,62,0.0005668556185395131,0.000710810990914947,0.5585585585585585
1895,2207,모험/Noun,111,60,51,0.0006891185950872514,0.0005886403518514405,0.5405405405405406
1896,2208,울컥/Adverb,110,108,2,0.0012226297654773814,4.4425686932184186e-05,0.9818181818181818
1897,2209,짜지다/Verb,110,12,98,0.00015560742469712126,0.0011106421733046046,0.8909090909090909
1898,2210,신파/Noun,110,16,94,0.0002000666888962988,0.0010662164863724202,0.8545454545454545
1899,2211,첫사랑/Noun,110,90,20,0.0010225630765810826,0.00024434127812701304,0.8181818181818182
1900,2212,업다/Verb,110,29,81,0.0003445592975436257,0.000921833003842822,0.7363636363636363
1901,2213,몇몇/Noun,110,33,77,0.00038901856174280313,0.0008774073169106378,0.7
1902,2214,모양/Noun,110,36,74,0.00042236300989218633,0.0008440880517114996,0.6727272727272727
1903,2215,70년/Number,110,37,73,0.0004334778259419807,0.0008329816299784535,0.6636363636363637
1904,2216,담배/Noun,110,40,70,0.0004668222740913638,0.0007996623647793153,0.6363636363636364
1905,2217,할아버지/Noun,110,67,43,0.0007669223074358119,0.0004997889779870722,0.6090909090909091
1906,2218,탑/Noun,110,66,44,0.0007558074913860174,0.0005108953997201182,0.6
1907,2219,물다/Verb,110,51,59,0.000589085250639102,0.0006774917257158089,0.5363636363636364
1908,2221,한숨/Noun,109,12,97,0.00015560742469712126,0.0010995357515715587,0.8899082568807339
1909,2222,시끄럽다/Adjective,109,15,94,0.00018895187284650438,0.0010662164863724202,0.8623853211009175
1910,2223,세련되다/Adjective,109,94,15,0.00106702234078026,0.0001888091694617828,0.8623853211009175
1911,2224,고전/Noun,109,80,29,0.0009114149160831386,0.00034429907372442745,0.7339449541284404
1912,2225,삭제/Noun,109,31,78,0.00036678892964321435,0.0008885137386436838,0.7155963302752294
1913,2226,빵빵/Noun,109,77,32,0.0008780704679337558,0.0003776183389235656,0.7064220183486238
1914,2227,졸/Noun,109,33,76,0.00038901856174280313,0.0008663008951775916,0.6972477064220184
1915,2228,철/Noun,109,35,74,0.0004112481938423919,0.0008440880517114996,0.6788990825688074
1916,2229,적어도/Adverb,109,63,46,0.0007224630432366343,0.0005331082431862101,0.5779816513761468
1917,2230,어쩜/Noun,109,47,62,0.0005446259864399244,0.000710810990914947,0.5688073394495413
1918,2231,거부/Noun,109,49,60,0.0005668556185395131,0.0006885981474488549,0.5504587155963303
1919,2233,.^^/Punctuation,108,97,11,0.0011003667889296432,0.0001443834825295986,0.8981481481481481
1920,2234,말고는/Josa,108,11,97,0.0001444926086473269,0.0010995357515715587,0.8981481481481481
1921,2235,십/Modifier,108,76,32,0.0008669556518839612,0.0003776183389235656,0.7037037037037037
1922,2236,그만큼/Adverb,108,76,32,0.0008669556518839612,0.0003776183389235656,0.7037037037037037
1923,2237,최대/Noun,108,37,71,0.0004334778259419807,0.0008107687865123613,0.6574074074074074
1924,2238,언니/Noun,108,69,39,0.0007891519395354007,0.000455363291054888,0.6388888888888888
1925,2239,화의/Noun,108,39,69,0.00045570745804156943,0.0007885559430462694,0.6388888888888888
1926,2240,마이/Noun,108,40,68,0.0004668222740913638,0.0007774495213132232,0.6296296296296297
1927,2241,탈/Noun,108,40,68,0.0004668222740913638,0.0007774495213132232,0.6296296296296297
1928,2242,누나/Noun,108,65,43,0.0007446926753362233,0.0004997889779870722,0.6018518518518519
1929,2243,포스/Noun,108,65,43,0.0007446926753362233,0.0004997889779870722,0.6018518518518519
1930,2244,ㅁ/KoreanParticle,108,63,45,0.0007224630432366343,0.0005220018214531642,0.5833333333333334
1931,2245,기독교/Noun,108,46,62,0.00053351117039013,0.000710810990914947,0.5740740740740741
1932,2246,아이디어/Noun,108,49,59,0.0005668556185395131,0.0006774917257158089,0.5462962962962963
1933,2247,sf/Alpha,108,58,50,0.0006668889629876625,0.0005775339301183945,0.5370370370370371
1934,2248,빈약하다/Adjective,107,12,95,0.00015560742469712126,0.0010773229081054666,0.8878504672897196
1935,2249,떨다/Verb,107,36,71,0.00042236300989218633,0.0008107687865123613,0.6635514018691588
1936,2250,여태/Noun,107,63,44,0.0007224630432366343,0.0005108953997201182,0.5887850467289719
1937,2251,하늘/Noun,107,63,44,0.0007224630432366343,0.0005108953997201182,0.5887850467289719
1938,2252,종영/Noun,107,60,47,0.0006891185950872514,0.0005442146649192564,0.5607476635514018
1939,2253,어처구니/Noun,106,11,95,0.0001444926086473269,0.0010773229081054666,0.8962264150943396
1940,2254,..^^/Punctuation,106,92,14,0.0010447927086806713,0.00017770274772873674,0.8679245283018868
1941,2255,중독/Noun,106,87,19,0.0009892186284316995,0.000233234856393967,0.8207547169811321
1942,2256,폐지/Noun,106,30,76,0.00035567411359342004,0.0008663008951775916,0.7169811320754716
1943,2257,치밀하다/Adjective,106,73,33,0.0008336112037345782,0.00038872476065661166,0.6886792452830188
1944,2258,흑/Adverb,106,72,34,0.0008224963876847838,0.00039983118238965764,0.6792452830188679
1945,2259,수많다/Adjective,106,61,45,0.0007002334111370457,0.0005220018214531642,0.5754716981132075
1946,2260,재능/Noun,106,47,59,0.0005446259864399244,0.0006774917257158089,0.5566037735849056
1947,2261,바르다/Verb,106,49,57,0.0005668556185395131,0.0006552788822497168,0.5377358490566038
1948,2263,선동/Noun,105,10,95,0.0001333777925975325,0.0010773229081054666,0.9047619047619048
1949,2264,팔이/Noun,105,11,94,0.0001444926086473269,0.0010662164863724202,0.8952380952380953
1950,2265,여름/Noun,105,85,20,0.0009669889963321108,0.00024434127812701304,0.8095238095238095
1951,2266,안감/Noun,105,22,83,0.000266755585195065,0.000944045847308914,0.7904761904761904
1952,2267,늘어지다/Verb,105,24,81,0.0002889852172946538,0.000921833003842822,0.7714285714285715
1953,2268,또다른/Modifier,105,78,27,0.00088918528398355,0.00032208623025833537,0.7428571428571429
1954,2269,중학교/Noun,105,77,28,0.0008780704679337558,0.0003331926519913814,0.7333333333333333
1955,2270,바탕/Noun,105,73,32,0.0008336112037345782,0.0003776183389235656,0.6952380952380952
1956,2271,목숨/Noun,105,70,35,0.0008002667555851951,0.0004109376041227037,0.6666666666666666
1957,2272,잡/Noun,105,36,69,0.00042236300989218633,0.0007885559430462694,0.6571428571428571
1958,2273,버전/Noun,105,38,67,0.000444592641991775,0.0007663430995801773,0.6380952380952379
1959,2274,보구/Noun,105,62,43,0.0007113482271868402,0.0004997889779870722,0.5904761904761905
1960,2275,대신/Noun,105,44,61,0.0005112815382905413,0.0006997045691819009,0.580952380952381
1961,2276,삼/Noun,105,45,60,0.0005223963543403357,0.0006885981474488549,0.5714285714285714
1962,2277,혹은/Adverb,105,56,49,0.0006446593308880737,0.0005664275083853486,0.5333333333333333
1963,2280,끼우다/Verb,104,10,94,0.0001333777925975325,0.0010662164863724202,0.903846153846154
1964,2281,메이드/Noun,104,91,13,0.001033677892630877,0.0001665963259956907,0.875
1965,2282,캬/Noun,104,89,15,0.0010114482605312882,0.0001888091694617828,0.8557692307692307
1966,2283,어쩌/Noun,104,16,88,0.0002000666888962988,0.0009995779559741444,0.8461538461538461
1967,2284,구리/Noun,104,16,88,0.0002000666888962988,0.0009995779559741444,0.8461538461538461
1968,2285,호구/Noun,104,17,87,0.00021118150494609317,0.0009884715342410985,0.8365384615384616
1969,2286,부터가/Josa,104,22,82,0.000266755585195065,0.000932939425575868,0.7884615384615384
1970,2287,하아/Exclamation,104,23,81,0.00027787040124485944,0.000921833003842822,0.7788461538461539
1971,2288,~!!!/Punctuation,104,79,25,0.0009003001000333445,0.0002998733867922433,0.7596153846153846
1972,2289,반갑다/Adjective,104,73,31,0.0008336112037345782,0.00036651191719051963,0.7019230769230769
1973,2290,장국영/Noun,104,73,31,0.0008336112037345782,0.00036651191719051963,0.7019230769230769
1974,2291,졸리/Noun,104,33,71,0.00038901856174280313,0.0008107687865123613,0.6826923076923077
1975,2292,표현/Modifier,104,68,36,0.0007780371234856063,0.0004220440258557498,0.6538461538461539
1976,2293,야구/Noun,104,66,38,0.0007558074913860174,0.0004442568693218419,0.6346153846153846
1977,2294,틱/Suffix,104,39,65,0.00045570745804156943,0.0007441302561140852,0.625
1978,2295,고등학교/Noun,104,65,39,0.0007446926753362233,0.000455363291054888,0.625
1979,2296,따름/Noun,104,41,63,0.0004779370901411582,0.0007219174126479931,0.6057692307692307
1980,2297,드림/Noun,104,42,62,0.0004890519061909527,0.000710810990914947,0.5961538461538461
1981,2298,재난영화/Noun,104,59,45,0.0006780037790374569,0.0005220018214531642,0.5673076923076923
1982,2299,라이언/Noun,104,57,47,0.0006557741469378681,0.0005442146649192564,0.5480769230769231
1983,2300,매다/Verb,104,48,56,0.0005557408024897189,0.0006441724605166707,0.5384615384615384
1984,2302,내놓다/Verb,103,23,80,0.00027787040124485944,0.000910726582109776,0.7766990291262136
1985,2303,이어서/Josa,103,75,28,0.0008558408358341669,0.0003331926519913814,0.7281553398058253
1986,2304,벌다/Verb,103,29,74,0.0003445592975436257,0.0008440880517114996,0.7184466019417476
1987,2305,로버트/Noun,103,70,33,0.0008002667555851951,0.00038872476065661166,0.6796116504854369
1988,2306,보이지/Noun,103,36,67,0.00042236300989218633,0.0007663430995801773,0.6504854368932039
1989,2307,막다/Verb,103,38,65,0.000444592641991775,0.0007441302561140852,0.6310679611650486
1990,2308,배경음악/Noun,103,64,39,0.0007335778592864287,0.000455363291054888,0.6213592233009708
1991,2309,욕심/Noun,103,39,64,0.00045570745804156943,0.0007330238343810393,0.6213592233009708
1992,2310,웃/Noun,103,64,39,0.0007335778592864287,0.000455363291054888,0.6213592233009708
1993,2311,정확하다/Adjective,103,45,58,0.0005223963543403357,0.0006663853039827628,0.5631067961165048
1994,2312,30년/Number,103,57,46,0.0006557741469378681,0.0005331082431862101,0.5533980582524272
1995,2314,빵점/Noun,102,2,100,4.445926419917751e-05,0.0011328550167706971,0.9803921568627452
1996,2315,하품/Noun,102,2,100,4.445926419917751e-05,0.0011328550167706971,0.9803921568627452
1997,2316,편안하다/Adjective,102,90,12,0.0010225630765810826,0.00015548990426264466,0.8823529411764706
1998,2317,지경/Noun,102,14,88,0.00017783705679671002,0.0009995779559741444,0.8627450980392157
1999,2318,재미나/Noun,102,87,15,0.0009892186284316995,0.0001888091694617828,0.8529411764705882
2000,2319,조화/Noun,102,82,20,0.0009336445481827276,0.00024434127812701304,0.8039215686274509
2001,2320,곡/Noun,102,78,24,0.00088918528398355,0.0002887669650591972,0.7647058823529411
2002,2321,팔/Modifier,102,24,78,0.0002889852172946538,0.0008885137386436838,0.7647058823529411
2003,2322,로코/Noun,102,75,27,0.0008558408358341669,0.00032208623025833537,0.7352941176470589
2004,2323,숨/Noun,102,75,27,0.0008558408358341669,0.00032208623025833537,0.7352941176470589
2005,2324,곱다/Adjective,102,69,33,0.0007891519395354007,0.00038872476065661166,0.6764705882352942
2006,2325,절정/Noun,102,64,38,0.0007335778592864287,0.0004442568693218419,0.6274509803921569
2007,2326,클레멘타인/Noun,102,39,63,0.00045570745804156943,0.0007219174126479931,0.6176470588235294
2008,2327,끊다/Verb,102,39,63,0.00045570745804156943,0.0007219174126479931,0.6176470588235294
2009,2328,헤어지다/Verb,102,62,40,0.0007113482271868402,0.000466469712787934,0.6078431372549019
2010,2329,만약/Noun,102,57,45,0.0006557741469378681,0.0005220018214531642,0.5588235294117647
2011,2332,인내심/Noun,101,8,93,0.00011114816049794375,0.0010551100646393743,0.9207920792079208
2012,2333,잠시/Noun,101,75,26,0.0008558408358341669,0.00031097980852528933,0.7425742574257426
2013,2334,묻히다/Verb,101,68,33,0.0007780371234856063,0.00038872476065661166,0.6732673267326733
2014,2335,사운드/Noun,101,67,34,0.0007669223074358119,0.00039983118238965764,0.6633663366336634
2015,2336,그동안/Noun,101,65,36,0.0007446926753362233,0.0004220440258557498,0.6435643564356436
2016,2337,린다/Noun,101,64,37,0.0007335778592864287,0.0004331504475887958,0.6336633663366337
2017,2338,조니뎁/Noun,101,63,38,0.0007224630432366343,0.0004442568693218419,0.6237623762376238
2018,2339,틴/Noun,101,40,61,0.0004668222740913638,0.0006997045691819009,0.6039603960396039
2019,2340,탈출/Noun,101,56,45,0.0006446593308880737,0.0005220018214531642,0.5544554455445545
2020,2341,된거/Noun,101,55,46,0.0006335445148382794,0.0005331082431862101,0.5445544554455446
2021,2342,가정/Noun,101,55,46,0.0006335445148382794,0.0005331082431862101,0.5445544554455446
2022,2343,사고/Noun,101,55,46,0.0006335445148382794,0.0005331082431862101,0.5445544554455446
2023,2344,승리/Noun,101,54,47,0.0006224296987884852,0.0005442146649192564,0.5346534653465347
2024,2351,앞뒤/Noun,100,11,89,0.0001444926086473269,0.0010106843777071904,0.89
2025,2352,울면/Noun,100,87,13,0.0009892186284316995,0.0001665963259956907,0.87
2026,2353,플롯/Noun,100,29,71,0.0003445592975436257,0.0008107687865123613,0.71
2027,2354,일본인/Noun,100,30,70,0.00035567411359342004,0.0007996623647793153,0.7
2028,2355,........./Punctuation,100,31,69,0.00036678892964321435,0.0007885559430462694,0.69
2029,2356,상관없다/Adjective,100,34,66,0.0004001333777925976,0.0007552366778471312,0.66
2030,2357,만이/Noun,100,37,63,0.0004334778259419807,0.0007219174126479931,0.63
2031,2358,딱이다/Adjective,100,59,41,0.0006780037790374569,0.00047757613452098,0.59
2032,2359,그야말로/Adverb,100,59,41,0.0006780037790374569,0.00047757613452098,0.59
2033,2360,나누다/Verb,100,58,42,0.0006668889629876625,0.0004886825562540262,0.58
2034,2361,추리/Noun,100,43,57,0.0005001667222407468,0.0006552788822497168,0.57
2035,2362,배다/Verb,100,45,55,0.0005223963543403357,0.0006330660387836247,0.55
2036,2363,파괴/Noun,100,46,54,0.00053351117039013,0.0006219596170505788,0.54
2037,2364,손색/Noun,99,90,9,0.0010225630765810826,0.00012217063906350652,0.9090909090909092
2038,2365,그만하다/Adjective,99,19,80,0.0002334111370456819,0.000910726582109776,0.8080808080808081
2039,2366,현대/Noun,99,72,27,0.0008224963876847838,0.00032208623025833537,0.7272727272727273
2040,2367,끔찍하다/Adjective,99,28,71,0.0003334444814938313,0.0008107687865123613,0.7171717171717171
2041,2368,꼬/Noun,99,31,68,0.00036678892964321435,0.0007774495213132232,0.6868686868686869
2042,2369,케빈/Noun,99,66,33,0.0007558074913860174,0.00038872476065661166,0.6666666666666666
2043,2370,공간/Noun,99,65,34,0.0007446926753362233,0.00039983118238965764,0.6565656565656566
2044,2371,착각/Noun,99,34,65,0.0004001333777925976,0.0007441302561140852,0.6565656565656566
2045,2372,돼지/Noun,99,35,64,0.0004112481938423919,0.0007330238343810393,0.6464646464646465
2046,2373,임팩트/Noun,99,40,59,0.0004668222740913638,0.0006774917257158089,0.5959595959595959
2047,2374,영화제/Noun,99,58,41,0.0006668889629876625,0.00047757613452098,0.5858585858585859
2048,2375,정이/Noun,99,55,44,0.0006335445148382794,0.0005108953997201182,0.5555555555555556
2049,2376,터미네이터/Noun,99,53,46,0.0006113148827386907,0.0005331082431862101,0.5353535353535354
2050,2381,어디가/Noun,98,16,82,0.0002000666888962988,0.000932939425575868,0.8367346938775511
2051,2382,우뢰매/Noun,98,18,80,0.0002222963209958875,0.000910726582109776,0.8163265306122449
2052,2383,토록/Josa,98,72,26,0.0008224963876847838,0.00031097980852528933,0.7346938775510204
2053,2384,실패하다/Adjective,98,28,70,0.0003334444814938313,0.0007996623647793153,0.7142857142857143
2054,2385,박진/Noun,98,65,33,0.0007446926753362233,0.00038872476065661166,0.6632653061224489
2055,2386,겉/Noun,98,35,63,0.0004112481938423919,0.0007219174126479931,0.6428571428571429
2056,2387,논/Noun,98,41,57,0.0004779370901411582,0.0006552788822497168,0.5816326530612245
2057,2388,도에/Foreign,98,53,45,0.0006113148827386907,0.0005220018214531642,0.5408163265306123
2058,2392,디워/Noun,97,10,87,0.0001333777925975325,0.0009884715342410985,0.8969072164948454
2059,2393,낚시/Noun,97,11,86,0.0001444926086473269,0.000977365112508052,0.8865979381443299
2060,2394,부실하다/Adjective,97,13,84,0.00016672224074691566,0.00095515226904196,0.865979381443299
2061,2395,쓸데없이/Adverb,97,14,83,0.00017783705679671002,0.000944045847308914,0.8556701030927835
2062,2396,사투리/Noun,97,23,74,0.00027787040124485944,0.0008440880517114996,0.7628865979381443
2063,2397,교과서/Noun,97,73,24,0.0008336112037345782,0.0002887669650591972,0.7525773195876289
2064,2398,밝다/Verb,97,71,26,0.0008113815716349895,0.00031097980852528933,0.7319587628865979
2065,2399,이군/Noun,97,33,64,0.00038901856174280313,0.0007330238343810393,0.6597938144329897
2066,2400,인터넷/Noun,97,40,57,0.0004668222740913638,0.0006552788822497168,0.5876288659793815
2067,2401,발상/Noun,97,40,57,0.0004668222740913638,0.0006552788822497168,0.5876288659793815
2068,2402,연극/Noun,97,42,55,0.0004890519061909527,0.0006330660387836247,0.5670103092783505
2069,2405,자고/Noun,96,11,85,0.0001444926086473269,0.0009662586907750061,0.8854166666666666
2070,2406,심형래/Noun,96,13,83,0.00016672224074691566,0.000944045847308914,0.8645833333333334
2071,2407,여친/Noun,96,23,73,0.00027787040124485944,0.0008329816299784535,0.7604166666666666
2072,2408,제임스/Noun,96,70,26,0.0008002667555851951,0.00031097980852528933,0.7291666666666666
2073,2409,일부러/Noun,96,28,68,0.0003334444814938313,0.0007774495213132232,0.7083333333333334
2074,2410,유덕화/Noun,96,66,30,0.0007558074913860174,0.0003554054954574735,0.6875
2075,2411,호기심/Noun,96,30,66,0.00035567411359342004,0.0007552366778471312,0.6875
2076,2412,너무도/Adverb,96,63,33,0.0007224630432366343,0.00038872476065661166,0.65625
2077,2413,대결/Noun,96,61,35,0.0007002334111370457,0.0004109376041227037,0.6354166666666666
2078,2414,대통령/Noun,96,38,58,0.000444592641991775,0.0006663853039827628,0.6041666666666666
2079,2415,무기/Noun,96,39,57,0.00045570745804156943,0.0006552788822497168,0.59375
2080,2416,고딩/Noun,96,40,56,0.0004668222740913638,0.0006441724605166707,0.5833333333333334
2081,2417,음식/Noun,96,40,56,0.0004668222740913638,0.0006441724605166707,0.5833333333333334
2082,2419,체적/Noun,95,10,85,0.0001333777925975325,0.0009662586907750061,0.8947368421052632
2083,2420,이만/Noun,95,82,13,0.0009336445481827276,0.0001665963259956907,0.8631578947368421
2084,2421,팔/Noun,95,16,79,0.0002000666888962988,0.0008996201603767299,0.8315789473684211
2085,2422,듭니/Noun,95,77,18,0.0008780704679337558,0.00022212843466092096,0.8105263157894737
2086,2423,여자애/Noun,95,21,74,0.00025564076914527065,0.0008440880517114996,0.7789473684210526
2087,2424,던데/Noun,95,26,69,0.00031121484939424253,0.0007885559430462694,0.7263157894736842
2088,2425,당황/Noun,95,26,69,0.00031121484939424253,0.0007885559430462694,0.7263157894736842
2089,2426,꽃/Noun,95,68,27,0.0007780371234856063,0.00032208623025833537,0.7157894736842105
2090,2427,에다/Josa,95,28,67,0.0003334444814938313,0.0007663430995801773,0.7052631578947368
2091,2428,평균/Noun,95,28,67,0.0003334444814938313,0.0007663430995801773,0.7052631578947368
2092,2429,조카/Noun,95,66,29,0.0007558074913860174,0.00034429907372442745,0.6947368421052632
2093,2430,100%/Number,95,62,33,0.0007113482271868402,0.00038872476065661166,0.6526315789473685
2094,2431,겁/Noun,95,33,62,0.00038901856174280313,0.000710810990914947,0.6526315789473685
2095,2432,선정/Noun,95,33,62,0.00038901856174280313,0.000710810990914947,0.6526315789473685
2096,2433,잡고/Noun,95,38,57,0.000444592641991775,0.0006552788822497168,0.6
2097,2434,옛/Adverb,95,54,41,0.0006224296987884852,0.00047757613452098,0.5684210526315789
2098,2435,제니퍼/Noun,95,44,51,0.0005112815382905413,0.0005886403518514405,0.5368421052631579
2099,2441,겨울/Noun,94,77,17,0.0008780704679337558,0.0002110220129278749,0.8191489361702128
2100,2442,말투/Noun,94,24,70,0.0002889852172946538,0.0007996623647793153,0.7446808510638298
2101,2443,상실/Noun,94,24,70,0.0002889852172946538,0.0007996623647793153,0.7446808510638298
2102,2444,ㅈ/KoreanParticle,94,27,67,0.00032232966544403684,0.0007663430995801773,0.7127659574468085
2103,2445,베드/Noun,94,29,65,0.0003445592975436257,0.0007441302561140852,0.6914893617021277
2104,2446,에게도/Josa,94,65,29,0.0007446926753362233,0.00034429907372442745,0.6914893617021277
2105,2447,루즈/Noun,94,34,60,0.0004001333777925976,0.0006885981474488549,0.6382978723404256
2106,2448,난리/Noun,94,34,60,0.0004001333777925976,0.0006885981474488549,0.6382978723404256
2107,2449,주지/Noun,94,36,58,0.00042236300989218633,0.0006663853039827628,0.6170212765957447
2108,2450,찬/Noun,94,55,39,0.0006335445148382794,0.000455363291054888,0.5851063829787234
2109,2451,링/Noun,94,41,53,0.0004779370901411582,0.0006108531953175326,0.5638297872340425
2110,2452,니콜/Noun,94,41,53,0.0004779370901411582,0.0006108531953175326,0.5638297872340425
2111,2453,드러나다/Verb,94,51,43,0.000589085250639102,0.0004997889779870722,0.5425531914893617
2112,2454,정보/Noun,94,51,43,0.000589085250639102,0.0004997889779870722,0.5425531914893617
2113,2455,류작/Noun,93,5,88,7.780371234856063e-05,0.0009995779559741444,0.946236559139785
2114,2456,도무지/Noun,93,7,86,0.0001000333444481494,0.000977365112508052,0.9247311827956988
2115,2457,I/Alpha,93,76,17,0.0008669556518839612,0.0002110220129278749,0.8172043010752689
2116,2458,녹다/Verb,93,76,17,0.0008669556518839612,0.0002110220129278749,0.8172043010752689
2117,2459,성의/Noun,93,23,70,0.00027787040124485944,0.0007996623647793153,0.7526881720430108
2118,2460,차갑다/Adjective,93,68,25,0.0007780371234856063,0.0002998733867922433,0.7311827956989247
2119,2461,애초/Noun,93,30,63,0.00035567411359342004,0.0007219174126479931,0.6774193548387096
2120,2462,반대/Noun,93,32,61,0.00037790374569300877,0.0006997045691819009,0.6559139784946236
2121,2463,거치다/Verb,93,61,32,0.0007002334111370457,0.0003776183389235656,0.6559139784946236
2122,2464,무난/Noun,93,34,59,0.0004001333777925976,0.0006774917257158089,0.6344086021505376
2123,2465,단체/Noun,93,34,59,0.0004001333777925976,0.0006774917257158089,0.6344086021505376
2124,2466,단순/Noun,93,38,55,0.000444592641991775,0.0006330660387836247,0.5913978494623656
2125,2467,틀어주다/Verb,93,38,55,0.000444592641991775,0.0006330660387836247,0.5913978494623656
2126,2468,레이/Noun,93,54,39,0.0006224296987884852,0.000455363291054888,0.5806451612903226
2127,2469,치고는/Josa,93,40,53,0.0004668222740913638,0.0006108531953175326,0.5698924731182796
2128,2470,주윤발/Noun,93,42,51,0.0004890519061909527,0.0005886403518514405,0.5483870967741935
2129,2471,베다/Verb,93,50,43,0.0005779704345893076,0.0004997889779870722,0.5376344086021505
2130,2473,수입/Noun,92,12,80,0.00015560742469712126,0.000910726582109776,0.8695652173913043
2131,2474,처절하다/Adjective,92,74,18,0.0008447260197843727,0.00022212843466092096,0.8043478260869565
2132,2475,딴/Modifier,92,19,73,0.0002334111370456819,0.0008329816299784535,0.7934782608695652
2133,2476,컨셉/Noun,92,20,72,0.00024452595309547634,0.0008218752082454075,0.7826086956521741
2134,2477,고프다/Adjective,92,71,21,0.0008113815716349895,0.0002554476998600591,0.7717391304347826
2135,2478,절/Noun,92,23,69,0.00027787040124485944,0.0007885559430462694,0.75
2136,2479,드디어/Adverb,92,68,24,0.0007780371234856063,0.0002887669650591972,0.7391304347826086
2137,2480,흥/Noun,92,66,26,0.0007558074913860174,0.00031097980852528933,0.7173913043478259
2138,2481,반드시/Noun,92,65,27,0.0007446926753362233,0.00032208623025833537,0.7065217391304348
2139,2482,진수/Noun,92,64,28,0.0007335778592864287,0.0003331926519913814,0.6956521739130435
2140,2483,쥐다/Verb,92,34,58,0.0004001333777925976,0.0006663853039827628,0.6304347826086957
2141,2484,13/Number,92,34,58,0.0004001333777925976,0.0006663853039827628,0.6304347826086957
2142,2485,대사도/Noun,92,35,57,0.0004112481938423919,0.0006552788822497168,0.6195652173913043
2143,2486,속이다/Verb,92,37,55,0.0004334778259419807,0.0006330660387836247,0.5978260869565217
2144,2487,중심/Noun,92,38,54,0.000444592641991775,0.0006219596170505788,0.5869565217391305
2145,2488,다리/Noun,92,38,54,0.000444592641991775,0.0006219596170505788,0.5869565217391305
2146,2489,어/Eomi,92,38,54,0.000444592641991775,0.0006219596170505788,0.5869565217391305
2147,2490,빵터지다/Adjective,92,40,52,0.0004668222740913638,0.0005997467735844866,0.5652173913043478
2148,2491,푸다/Verb,92,40,52,0.0004668222740913638,0.0005997467735844866,0.5652173913043478
2149,2495,웰/Noun,91,86,5,0.0009781038123819054,7.774495213132233e-05,0.9450549450549449
2150,2496,어우러지다/Verb,91,85,6,0.0009669889963321108,8.885137386436837e-05,0.934065934065934
2151,2497,만드/Noun,91,14,77,0.00017783705679671002,0.0008774073169106378,0.8461538461538461
2152,2498,혐오/Noun,91,15,76,0.00018895187284650438,0.0008663008951775916,0.8351648351648352
2153,2499,명대사/Noun,91,72,19,0.0008224963876847838,0.000233234856393967,0.7912087912087912
2154,2500,살인마/Noun,91,21,70,0.00025564076914527065,0.0007996623647793153,0.7692307692307693
2155,2501,실수/Noun,91,25,66,0.00030010003334444816,0.0007552366778471312,0.7252747252747253
2156,2502,베리/Noun,91,65,26,0.0007446926753362233,0.00031097980852528933,0.7142857142857143
2157,2503,비중/Noun,91,30,61,0.00035567411359342004,0.0006997045691819009,0.6703296703296703
2158,2504,무게/Noun,91,60,31,0.0006891185950872514,0.00036651191719051963,0.6593406593406593
2159,2505,잭/Noun,91,60,31,0.0006891185950872514,0.00036651191719051963,0.6593406593406593
2160,2506,붙다/Verb,91,31,60,0.00036678892964321435,0.0006885981474488549,0.6593406593406593
2161,2507,........../Punctuation,91,34,57,0.0004001333777925976,0.0006552788822497168,0.6263736263736264
2162,2508,영향/Noun,91,56,35,0.0006446593308880737,0.0004109376041227037,0.6153846153846154
2163,2509,키드/Noun,91,39,52,0.00045570745804156943,0.0005997467735844866,0.5714285714285714
2164,2510,화란/Noun,91,39,52,0.00045570745804156943,0.0005997467735844866,0.5714285714285714
2165,2511,론/Noun,91,39,52,0.00045570745804156943,0.0005997467735844866,0.5714285714285714
2166,2514,계기/Noun,90,72,18,0.0008224963876847838,0.00022212843466092096,0.8
2167,2515,논리/Noun,90,20,70,0.00024452595309547634,0.0007996623647793153,0.7777777777777778
2168,2516,최고봉/Noun,90,68,22,0.0007780371234856063,0.00026655412159310506,0.7555555555555555
2169,2517,운/Noun,90,65,25,0.0007446926753362233,0.0002998733867922433,0.7222222222222222
2170,2518,어떻/Modifier,90,25,65,0.00030010003334444816,0.0007441302561140852,0.7222222222222222
2171,2519,레/Noun,90,25,65,0.00030010003334444816,0.0007441302561140852,0.7222222222222222
2172,2520,암/Modifier,90,26,64,0.00031121484939424253,0.0007330238343810393,0.7111111111111111
2173,2521,매일/Noun,90,62,28,0.0007113482271868402,0.0003331926519913814,0.6888888888888889
2174,2522,쿡/Noun,90,30,60,0.00035567411359342004,0.0006885981474488549,0.6666666666666666
2175,2523,깍/Adverb,90,31,59,0.00036678892964321435,0.0006774917257158089,0.6555555555555556
2176,2524,및/Noun,90,31,59,0.00036678892964321435,0.0006774917257158089,0.6555555555555556
2177,2525,데뷔/Noun,90,59,31,0.0006780037790374569,0.00036651191719051963,0.6555555555555556
2178,2526,걱정/Noun,90,58,32,0.0006668889629876625,0.0003776183389235656,0.6444444444444445
2179,2527,다/Noun,90,33,57,0.00038901856174280313,0.0006552788822497168,0.6333333333333333
2180,2528,여자친구/Noun,90,33,57,0.00038901856174280313,0.0006552788822497168,0.6333333333333333
2181,2529,동성애/Noun,90,35,55,0.0004112481938423919,0.0006330660387836247,0.6111111111111112
2182,2530,자동차/Noun,90,40,50,0.0004668222740913638,0.0005775339301183945,0.5555555555555556
2183,2531,앤/Noun,90,50,40,0.0005779704345893076,0.000466469712787934,0.5555555555555556
2184,2532,의지/Noun,90,49,41,0.0005668556185395131,0.00047757613452098,0.5444444444444444
2185,2533,차원/Noun,90,48,42,0.0005557408024897189,0.0004886825562540262,0.5333333333333333
2186,2535,게뭐/Noun,89,7,82,0.0001000333444481494,0.000932939425575868,0.9213483146067416
2187,2536,감사/Noun,89,78,11,0.00088918528398355,0.0001443834825295986,0.8764044943820225
2188,2537,빨갱이/Noun,89,18,71,0.0002222963209958875,0.0008107687865123613,0.797752808988764
2189,2538,ㅉ/KoreanParticle,89,18,71,0.0002222963209958875,0.0008107687865123613,0.797752808988764
2190,2539,강력/Noun,89,70,19,0.0008002667555851951,0.000233234856393967,0.7865168539325843
2191,2540,아무튼/Adverb,89,62,27,0.0007113482271868402,0.00032208623025833537,0.6966292134831461
2192,2541,섞다/Verb,89,28,61,0.0003334444814938313,0.0006997045691819009,0.6853932584269663
2193,2542,박중훈/Noun,89,58,31,0.0006668889629876625,0.00036651191719051963,0.651685393258427
2194,2543,폭발/Noun,89,58,31,0.0006668889629876625,0.00036651191719051963,0.651685393258427
2195,2544,각색/Noun,89,32,57,0.00037790374569300877,0.0006552788822497168,0.6404494382022472
2196,2545,포/Noun,89,33,56,0.00038901856174280313,0.0006441724605166707,0.6292134831460674
2197,2546,dvd/Alpha,89,56,33,0.0006446593308880737,0.00038872476065661166,0.6292134831460674
2198,2547,부작/Noun,89,55,34,0.0006335445148382794,0.00039983118238965764,0.6179775280898876
2199,2548,ㄴ/KoreanParticle,89,34,55,0.0004001333777925976,0.0006330660387836247,0.6179775280898876
2200,2549,필/Noun,89,35,54,0.0004112481938423919,0.0006219596170505788,0.6067415730337079
2201,2550,와도/Josa,89,51,38,0.000589085250639102,0.0004442568693218419,0.5730337078651685
2202,2551,아아/Noun,89,48,41,0.0005557408024897189,0.00047757613452098,0.5393258426966292
2203,2557,개그맨/Noun,88,4,84,6.668889629876625e-05,0.00095515226904196,0.9545454545454546
2204,2558,마음속/Noun,88,83,5,0.0009447593642325221,7.774495213132233e-05,0.9431818181818182
2205,2559,ㅄ/KoreanParticle,88,15,73,0.00018895187284650438,0.0008329816299784535,0.8295454545454546
2206,2560,동심/Noun,88,64,24,0.0007335778592864287,0.0002887669650591972,0.7272727272727273
2207,2561,폴/Noun,88,64,24,0.0007335778592864287,0.0002887669650591972,0.7272727272727273
2208,2562,피해/Noun,88,24,64,0.0002889852172946538,0.0007330238343810393,0.7272727272727273
2209,2563,에이/Noun,88,26,62,0.00031121484939424253,0.000710810990914947,0.7045454545454546
2210,2564,만화책/Noun,88,26,62,0.00031121484939424253,0.000710810990914947,0.7045454545454546
2211,2565,?.../Punctuation,88,30,58,0.00035567411359342004,0.0006663853039827628,0.6590909090909091
2212,2566,출신/Noun,88,33,55,0.00038901856174280313,0.0006330660387836247,0.625
2213,2567,ㅣ/KoreanParticle,88,34,54,0.0004001333777925976,0.0006219596170505788,0.6136363636363636
2214,2568,끝내/Noun,88,34,54,0.0004001333777925976,0.0006219596170505788,0.6136363636363636
2215,2569,부정/Noun,88,54,34,0.0006224296987884852,0.00039983118238965764,0.6136363636363636
2216,2570,아놀드/Noun,88,52,36,0.0006002000666888963,0.0004220440258557498,0.5909090909090909
2217,2571,조/Suffix,88,52,36,0.0006002000666888963,0.0004220440258557498,0.5909090909090909
2218,2572,극단/Noun,88,37,51,0.0004334778259419807,0.0005886403518514405,0.5795454545454546
2219,2577,♥♥♥/Foreign,87,86,1,0.0009781038123819054,3.331926519913814e-05,0.9885057471264368
2220,2578,어거지/Noun,87,8,79,0.00011114816049794375,0.0008996201603767299,0.9080459770114944
2221,2579,난잡하다/Adjective,87,8,79,0.00011114816049794375,0.0008996201603767299,0.9080459770114944
2222,2580,발음/Noun,87,17,70,0.00021118150494609317,0.0007996623647793153,0.8045977011494253
2223,2581,듣기/Noun,87,21,66,0.00025564076914527065,0.0007552366778471312,0.7586206896551724
2224,2582,친/Noun,87,25,62,0.00030010003334444816,0.000710810990914947,0.7126436781609196
2225,2583,무한/Noun,87,60,27,0.0006891185950872514,0.00032208623025833537,0.6896551724137931
2226,2584,배신/Noun,87,32,55,0.00037790374569300877,0.0006330660387836247,0.632183908045977
2227,2585,알아보다/Verb,87,33,54,0.00038901856174280313,0.0006219596170505788,0.6206896551724138
2228,2586,하니/Noun,87,34,53,0.0004001333777925976,0.0006108531953175326,0.6091954022988506
2229,2587,역사상/Noun,87,52,35,0.0006002000666888963,0.0004109376041227037,0.5977011494252874
2230,2588,파리/Noun,87,50,37,0.0005779704345893076,0.0004331504475887958,0.5747126436781609
2231,2589,요새/Noun,87,50,37,0.0005779704345893076,0.0004331504475887958,0.5747126436781609
2232,2590,인게/Josa,87,38,49,0.000444592641991775,0.0005664275083853486,0.5632183908045977
2233,2591,///Punctuation,87,47,40,0.0005446259864399244,0.000466469712787934,0.5402298850574713
2234,2592,평소/Noun,87,47,40,0.0005446259864399244,0.000466469712787934,0.5402298850574713
2235,2596,토나오다/Verb,86,4,82,6.668889629876625e-05,0.000932939425575868,0.9534883720930232
2236,2597,별하나/Noun,86,4,82,6.668889629876625e-05,0.000932939425575868,0.9534883720930232
2237,2598,다세포/Noun,86,8,78,0.00011114816049794375,0.0008885137386436838,0.9069767441860463
2238,2599,개콘/Noun,86,9,77,0.00012226297654773814,0.0008774073169106378,0.8953488372093024
2239,2600,황당/Noun,86,9,77,0.00012226297654773814,0.0008774073169106378,0.8953488372093024
2240,2601,영화감독/Noun,86,14,72,0.00017783705679671002,0.0008218752082454075,0.8372093023255814
2241,2602,언니/Suffix,86,70,16,0.0008002667555851951,0.00019991559119482882,0.813953488372093
2242,2603,최소한/Noun,86,18,68,0.0002222963209958875,0.0007774495213132232,0.7906976744186046
2243,2604,컴퓨터/Noun,86,20,66,0.00024452595309547634,0.0007552366778471312,0.7674418604651163
2244,2605,경우/Noun,86,27,59,0.00032232966544403684,0.0006774917257158089,0.686046511627907
2245,2606,해리포터/Noun,86,57,29,0.0006557741469378681,0.00034429907372442745,0.6627906976744186
2246,2607,추/Noun,86,56,30,0.0006446593308880737,0.0003554054954574735,0.6511627906976745
2247,2608,나레이션/Noun,86,30,56,0.00035567411359342004,0.0006441724605166707,0.6511627906976745
2248,2609,손가락/Noun,86,53,33,0.0006113148827386907,0.00038872476065661166,0.6162790697674418
2249,2610,거장/Noun,86,52,34,0.0006002000666888963,0.00039983118238965764,0.6046511627906976
2250,2611,얼다/Verb,86,36,50,0.00042236300989218633,0.0005775339301183945,0.5813953488372093
2251,2612,판단/Noun,86,49,37,0.0005668556185395131,0.0004331504475887958,0.5697674418604651
2252,2613,배트맨/Noun,86,48,38,0.0005557408024897189,0.0004442568693218419,0.5581395348837209
2253,2614,심다/Verb,86,39,47,0.00045570745804156943,0.0005442146649192564,0.5465116279069767
2254,2615,스티븐/Noun,86,39,47,0.00045570745804156943,0.0005442146649192564,0.5465116279069767
2255,2616,하지원/Noun,86,46,40,0.00053351117039013,0.000466469712787934,0.5348837209302325
2256,2621,겉멋/Noun,85,7,78,0.0001000333444481494,0.0008885137386436838,0.9176470588235294
2257,2622,싫어지다/Adjective,85,9,76,0.00012226297654773814,0.0008663008951775916,0.8941176470588236
2258,2623,압도/Noun,85,75,10,0.0008558408358341669,0.00013327706079655256,0.8823529411764706
2259,2624,담담하다/Adjective,85,71,14,0.0008113815716349895,0.00017770274772873674,0.8352941176470589
2260,2625,누군지/Adverb,85,21,64,0.00025564076914527065,0.0007330238343810393,0.7529411764705882
2261,2626,딱/VerbPrefix,85,23,62,0.00027787040124485944,0.000710810990914947,0.7294117647058823
2262,2627,정말/Exclamation,85,60,25,0.0006891185950872514,0.0002998733867922433,0.7058823529411765
2263,2628,여인/Noun,85,57,28,0.0006557741469378681,0.0003331926519913814,0.6705882352941176
2264,2629,환경/Noun,85,55,30,0.0006335445148382794,0.0003554054954574735,0.6470588235294118
2265,2630,곧/Noun,85,54,31,0.0006224296987884852,0.00036651191719051963,0.6352941176470588
2266,2631,ㄷ/KoreanParticle,85,54,31,0.0006224296987884852,0.00036651191719051963,0.6352941176470588
2267,2632,찌질하다/Adjective,85,33,52,0.00038901856174280313,0.0005997467735844866,0.611764705882353
2268,2633,누르다/Verb,85,34,51,0.0004001333777925976,0.0005886403518514405,0.6
2269,2636,깨알/Noun,84,76,8,0.0008669556518839612,0.00011106421733046048,0.9047619047619048
2270,2637,민폐/Noun,84,11,73,0.0001444926086473269,0.0008329816299784535,0.8690476190476191
2271,2638,쓸데없다/Adjective,84,14,70,0.00017783705679671002,0.0007996623647793153,0.8333333333333334
2272,2639,부리다/Verb,84,17,67,0.00021118150494609317,0.0007663430995801773,0.7976190476190477
2273,2640,이루어지다/Verb,84,66,18,0.0007558074913860174,0.00022212843466092096,0.7857142857142857
2274,2641,--/Punctuation,84,19,65,0.0002334111370456819,0.0007441302561140852,0.7738095238095238
2275,2642,어쩌면/Noun,84,62,22,0.0007113482271868402,0.00026655412159310506,0.7380952380952381
2276,2643,임창정/Noun,84,58,26,0.0006668889629876625,0.00031097980852528933,0.6904761904761905
2277,2644,화일/Noun,84,26,58,0.00031121484939424253,0.0006663853039827628,0.6904761904761905
2278,2645,성적/Noun,84,32,52,0.00037790374569300877,0.0005997467735844866,0.6190476190476191
2279,2646,이니까/Josa,84,49,35,0.0005668556185395131,0.0004109376041227037,0.5833333333333334
2280,2647,연/Noun,84,49,35,0.0005668556185395131,0.0004109376041227037,0.5833333333333334
2281,2648,오프닝/Noun,84,48,36,0.0005557408024897189,0.0004220440258557498,0.5714285714285714
2282,2649,".,/Punctuation",84,47,37,0.0005446259864399244,0.0004331504475887958,0.5595238095238095
2283,2650,남성/Noun,84,45,39,0.0005223963543403357,0.000455363291054888,0.5357142857142857
2284,2651,단점/Noun,84,39,45,0.00045570745804156943,0.0005220018214531642,0.5357142857142857
2285,2654,..!/Punctuation,83,74,9,0.0008447260197843727,0.00012217063906350652,0.891566265060241
2286,2655,흉내/Noun,83,11,72,0.0001444926086473269,0.0008218752082454075,0.8674698795180723
2287,2656,달콤하다/Adjective,83,68,15,0.0007780371234856063,0.0001888091694617828,0.8192771084337349
2288,2657,방해/Noun,83,18,65,0.0002222963209958875,0.0007441302561140852,0.7831325301204819
2289,2658,김치/Noun,83,22,61,0.000266755585195065,0.0006997045691819009,0.7349397590361446
2290,2659,분량/Noun,83,25,58,0.00030010003334444816,0.0006663853039827628,0.6987951807228916
2291,2660,향수/Noun,83,57,26,0.0006557741469378681,0.00031097980852528933,0.6867469879518072
2292,2661,코메디/Noun,83,27,56,0.00032232966544403684,0.0006441724605166707,0.6746987951807228
2293,2662,사/Noun,83,56,27,0.0006446593308880737,0.00032208623025833537,0.6746987951807228
2294,2663,매/Noun,83,53,30,0.0006113148827386907,0.0003554054954574735,0.6385542168674698
2295,2664,판이/Noun,83,33,50,0.00038901856174280313,0.0005775339301183945,0.6024096385542169
2296,2665,만화영화/Noun,83,47,36,0.0005446259864399244,0.0004220440258557498,0.5662650602409639
2297,2666,무너지다/Verb,83,36,47,0.00042236300989218633,0.0005442146649192564,0.5662650602409639
2298,2667,쉽다/Adjective,83,37,46,0.0004334778259419807,0.0005331082431862101,0.5542168674698795
2299,2668,전하/Noun,83,38,45,0.000444592641991775,0.0005220018214531642,0.5421686746987951
2300,2672,명복/Noun,82,74,8,0.0008447260197843727,0.00011106421733046048,0.902439024390244
2301,2673,거품/Noun,82,12,70,0.00015560742469712126,0.0007996623647793153,0.8536585365853658
2302,2674,동영상/Noun,82,12,70,0.00015560742469712126,0.0007996623647793153,0.8536585365853658
2303,2675,고뇌/Noun,82,57,25,0.0006557741469378681,0.0002998733867922433,0.6951219512195121
2304,2676,늘리다/Verb,82,25,57,0.00030010003334444816,0.0006552788822497168,0.6951219512195121
2305,2677,능/Noun,82,55,27,0.0006335445148382794,0.00032208623025833537,0.6707317073170732
2306,2678,흡입/Noun,82,53,29,0.0006113148827386907,0.00034429907372442745,0.6463414634146342
2307,2679,윌리스/Noun,82,29,53,0.0003445592975436257,0.0006108531953175326,0.6463414634146342
2308,2680,때매/Noun,82,30,52,0.00035567411359342004,0.0005997467735844866,0.6341463414634146
2309,2681,인도/Noun,82,51,31,0.000589085250639102,0.00036651191719051963,0.6219512195121951
2310,2682,잡히다/Verb,82,31,51,0.00036678892964321435,0.0005886403518514405,0.6219512195121951
2311,2683,매끄럽다/Adjective,82,32,50,0.00037790374569300877,0.0005775339301183945,0.6097560975609756
2312,2684,든지/Josa,82,32,50,0.00037790374569300877,0.0005775339301183945,0.6097560975609756
2313,2685,길이/Noun,82,49,33,0.0005668556185395131,0.00038872476065661166,0.5975609756097561
2314,2686,중년/Noun,82,48,34,0.0005557408024897189,0.00039983118238965764,0.5853658536585366
2315,2687,부족함/Noun,82,35,47,0.0004112481938423919,0.0005442146649192564,0.573170731707317
2316,2688,일으키다/Verb,82,37,45,0.0004334778259419807,0.0005220018214531642,0.5487804878048781
2317,2689,전투/Noun,82,45,37,0.0005223963543403357,0.0004331504475887958,0.5487804878048781
2318,2693,탁월하다/Adjective,81,73,8,0.0008336112037345782,0.00011106421733046048,0.9012345679012346
2319,2694,도데/Noun,81,8,73,0.00011114816049794375,0.0008329816299784535,0.9012345679012346
2320,2695,짜리/Foreign,81,12,69,0.00015560742469712126,0.0007885559430462694,0.8518518518518519
2321,2696,속지/Noun,81,13,68,0.00016672224074691566,0.0007774495213132232,0.8395061728395061
2322,2697,역량/Noun,81,13,68,0.00016672224074691566,0.0007774495213132232,0.8395061728395061
2323,2698,배급사/Noun,81,15,66,0.00018895187284650438,0.0007552366778471312,0.8148148148148148
2324,2699,징그럽다/Adjective,81,17,64,0.00021118150494609317,0.0007330238343810393,0.7901234567901234
2325,2700,이해도/Noun,81,17,64,0.00021118150494609317,0.0007330238343810393,0.7901234567901234
2326,2701,염/Noun,81,60,21,0.0006891185950872514,0.0002554476998600591,0.7407407407407407
2327,2702,몽환/Noun,81,59,22,0.0006780037790374569,0.00026655412159310506,0.7283950617283951
2328,2703,박다/Verb,81,22,59,0.000266755585195065,0.0006774917257158089,0.7283950617283951
2329,2704,짜이다/Verb,81,56,25,0.0006446593308880737,0.0002998733867922433,0.6913580246913579
2330,2705,약/Modifier,81,26,55,0.00031121484939424253,0.0006330660387836247,0.6790123456790124
2331,2706,그렇지만/Conjunction,81,55,26,0.0006335445148382794,0.00031097980852528933,0.6790123456790124
2332,2707,옴/Noun,81,26,55,0.00031121484939424253,0.0006330660387836247,0.6790123456790124
2333,2708,실험/Noun,81,29,52,0.0003445592975436257,0.0005997467735844866,0.6419753086419753
2334,2709,극복/Noun,81,51,30,0.000589085250639102,0.0003554054954574735,0.6296296296296297
2335,2710,사용/Noun,81,31,50,0.00036678892964321435,0.0005775339301183945,0.6172839506172839
2336,2711,1회/Number,81,49,32,0.0005668556185395131,0.0003776183389235656,0.6049382716049383
2337,2712,이소룡/Noun,81,48,33,0.0005557408024897189,0.00038872476065661166,0.5925925925925926
2338,2713,왕/Suffix,81,33,48,0.00038901856174280313,0.0005553210866523023,0.5925925925925926
2339,2714,스포/Noun,81,47,34,0.0005446259864399244,0.00039983118238965764,0.5802469135802469
2340,2715,화장실/Noun,81,34,47,0.0004001333777925976,0.0005442146649192564,0.5802469135802469
2341,2716,d/Alpha,81,35,46,0.0004112481938423919,0.0005331082431862101,0.5679012345679012
2342,2717,도시/Noun,81,46,35,0.00053351117039013,0.0004109376041227037,0.5679012345679012
2343,2718,멍/Noun,81,36,45,0.00042236300989218633,0.0005220018214531642,0.5555555555555556
2344,2722,담백하다/Adjective,80,75,5,0.0008558408358341669,7.774495213132233e-05,0.9375
2345,2723,삶다/Verb,80,68,12,0.0007780371234856063,0.00015548990426264466,0.85
2346,2724,가히/Adverb,80,68,12,0.0007780371234856063,0.00015548990426264466,0.85
2347,2725,지리다/Verb,80,63,17,0.0007224630432366343,0.0002110220129278749,0.7875
2348,2726,킬링/Noun,80,22,58,0.000266755585195065,0.0006663853039827628,0.725
2349,2727,장점/Noun,80,23,57,0.00027787040124485944,0.0006552788822497168,0.7125
2350,2728,등록/Noun,80,23,57,0.00027787040124485944,0.0006552788822497168,0.7125
2351,2729,망가지다/Verb,80,26,54,0.00031121484939424253,0.0006219596170505788,0.675
2352,2730,하정우/Noun,80,53,27,0.0006113148827386907,0.00032208623025833537,0.6625
2353,2731,미녀/Noun,80,30,50,0.00035567411359342004,0.0005775339301183945,0.625
2354,2732,독일/Noun,80,48,32,0.0005557408024897189,0.0003776183389235656,0.6
2355,2733,가리다/Verb,80,33,47,0.00038901856174280313,0.0005442146649192564,0.5875
2356,2734,마약/Noun,80,33,47,0.00038901856174280313,0.0005442146649192564,0.5875
2357,2735,은/Foreign,80,33,47,0.00038901856174280313,0.0005442146649192564,0.5875
2358,2736,군인/Noun,80,34,46,0.0004001333777925976,0.0005331082431862101,0.575
2359,2737,에서만/Josa,80,35,45,0.0004112481938423919,0.0005220018214531642,0.5625
2360,2738,버튼/Noun,80,45,35,0.0005223963543403357,0.0004109376041227037,0.5625
2361,2744,완벽/Noun,79,71,8,0.0008113815716349895,0.00011106421733046048,0.8987341772151899
2362,2745,그럴듯하다/Adjective,79,8,71,0.00011114816049794375,0.0008107687865123613,0.8987341772151899
2363,2746,의외/Noun,79,65,14,0.0007446926753362233,0.00017770274772873674,0.8227848101265823
2364,2747,딱/Modifier,79,16,63,0.0002000666888962988,0.0007219174126479931,0.7974683544303798
2365,2748,분장/Noun,79,17,62,0.00021118150494609317,0.000710810990914947,0.7848101265822784
2366,2749,언젠가/Adverb,79,59,20,0.0006780037790374569,0.00024434127812701304,0.7468354430379747
2367,2750,파다/Verb,79,24,55,0.0002889852172946538,0.0006330660387836247,0.6962025316455697
2368,2751,샘/Noun,79,53,26,0.0006113148827386907,0.00031097980852528933,0.6708860759493671
2369,2752,중딩/Noun,79,27,52,0.00032232966544403684,0.0005997467735844866,0.6582278481012658
2370,2753,정상/Noun,79,27,52,0.00032232966544403684,0.0005997467735844866,0.6582278481012658
2371,2754,에다가/Josa,79,29,50,0.0003445592975436257,0.0005775339301183945,0.6329113924050633
2372,2755,라기/Josa,79,30,49,0.00035567411359342004,0.0005664275083853486,0.620253164556962
2373,2756,미도/Noun,79,48,31,0.0005557408024897189,0.00036651191719051963,0.6075949367088608
2374,2757,of/Alpha,79,48,31,0.0005557408024897189,0.00036651191719051963,0.6075949367088608
2375,2758,순/Modifier,79,45,34,0.0005223963543403357,0.00039983118238965764,0.569620253164557
2376,2759,후회되다/Adjective,79,35,44,0.0004112481938423919,0.0005108953997201182,0.5569620253164557
2377,2762,위트/Noun,78,66,12,0.0007558074913860174,0.00015548990426264466,0.8461538461538461
2378,2763,치유/Noun,78,66,12,0.0007558074913860174,0.00015548990426264466,0.8461538461538461
2379,2764,아치/Noun,78,14,64,0.00017783705679671002,0.0007330238343810393,0.8205128205128205
2380,2765,만도/Josa,78,15,63,0.00018895187284650438,0.0007219174126479931,0.8076923076923077
2381,2766,애절하다/Adjective,78,62,16,0.0007113482271868402,0.00019991559119482882,0.7948717948717948
2382,2767,알려지다/Verb,78,58,20,0.0006668889629876625,0.00024434127812701304,0.7435897435897436
2383,2768,이구만/Josa,78,20,58,0.00024452595309547634,0.0006663853039827628,0.7435897435897436
2384,2769,왜곡/Noun,78,22,56,0.000266755585195065,0.0006441724605166707,0.7179487179487181
2385,2770,상어/Noun,78,25,53,0.00030010003334444816,0.0006108531953175326,0.6794871794871795
2386,2771,절망/Noun,78,53,25,0.0006113148827386907,0.0002998733867922433,0.6794871794871795
2387,2772,서부/Noun,78,50,28,0.0005779704345893076,0.0003331926519913814,0.6410256410256411
2388,2773,허허/Adverb,78,29,49,0.0003445592975436257,0.0005664275083853486,0.6282051282051282
2389,2774,계시다/Adjective,78,49,29,0.0005668556185395131,0.00034429907372442745,0.6282051282051282
2390,2775,칠/Modifier,78,29,49,0.0003445592975436257,0.0005664275083853486,0.6282051282051282
2391,2776,라스트/Noun,78,48,30,0.0005557408024897189,0.0003554054954574735,0.6153846153846154
2392,2777,컷/Noun,78,30,48,0.00035567411359342004,0.0005553210866523023,0.6153846153846154
2393,2778,무리/Noun,78,30,48,0.00035567411359342004,0.0005553210866523023,0.6153846153846154
2394,2779,한순간/Noun,78,48,30,0.0005557408024897189,0.0003554054954574735,0.6153846153846154
2395,2780,서도/Noun,78,47,31,0.0005446259864399244,0.00036651191719051963,0.6025641025641025
2396,2781,최소/Noun,78,47,31,0.0005446259864399244,0.00036651191719051963,0.6025641025641025
2397,2782,절로/Noun,78,45,33,0.0005223963543403357,0.00038872476065661166,0.5769230769230769
2398,2783,랑은/Josa,78,35,43,0.0004112481938423919,0.0004997889779870722,0.5512820512820513
2399,2784,들어주다/Verb,78,36,42,0.00042236300989218633,0.0004886825562540262,0.5384615384615384
2400,2785,뒤죽박죽/Noun,77,9,68,0.00012226297654773814,0.0007774495213132232,0.8831168831168831
2401,2786,절제/Noun,77,64,13,0.0007335778592864287,0.0001665963259956907,0.8311688311688312
2402,2787,소화/Noun,77,62,15,0.0007113482271868402,0.0001888091694617828,0.8051948051948052
2403,2788,떠올리다/Verb,77,62,15,0.0007113482271868402,0.0001888091694617828,0.8051948051948052
2404,2789,찬양/Noun,77,19,58,0.0002334111370456819,0.0006663853039827628,0.7532467532467533
2405,2790,내일/Noun,77,56,21,0.0006446593308880737,0.0002554476998600591,0.7272727272727273
2406,2791,닥/Noun,77,21,56,0.00025564076914527065,0.0006441724605166707,0.7272727272727273
2407,2792,난무/Noun,77,22,55,0.000266755585195065,0.0006330660387836247,0.7142857142857143
2408,2793,낼/Noun,77,53,24,0.0006113148827386907,0.0002887669650591972,0.6883116883116883
2409,2794,동네/Noun,77,29,48,0.0003445592975436257,0.0005553210866523023,0.6233766233766234
2410,2795,향연/Noun,77,32,45,0.00037790374569300877,0.0005220018214531642,0.5844155844155844
2411,2796,2년/Number,77,45,32,0.0005223963543403357,0.0003776183389235656,0.5844155844155844
2412,2797,안해/Noun,77,32,45,0.00037790374569300877,0.0005220018214531642,0.5844155844155844
2413,2798,에가/Josa,77,34,43,0.0004001333777925976,0.0004997889779870722,0.5584415584415584
2414,2799,선생/Noun,77,34,43,0.0004001333777925976,0.0004997889779870722,0.5584415584415584
2415,2800,똑같이/Adverb,77,34,43,0.0004001333777925976,0.0004997889779870722,0.5584415584415584
2416,2801,우선/Noun,77,36,41,0.00042236300989218633,0.00047757613452098,0.5324675324675324
2417,2806,매미/Noun,76,4,72,6.668889629876625e-05,0.0008218752082454075,0.9473684210526316
2418,2807,뜬금없이/Adverb,76,4,72,6.668889629876625e-05,0.0008218752082454075,0.9473684210526316
2419,2808,미스/Noun,76,13,63,0.00016672224074691566,0.0007219174126479931,0.8289473684210527
2420,2809,욕먹다/Verb,76,13,63,0.00016672224074691566,0.0007219174126479931,0.8289473684210527
2421,2810,보임/Noun,76,16,60,0.0002000666888962988,0.0006885981474488549,0.7894736842105263
2422,2811,버티다/Verb,76,17,59,0.00021118150494609317,0.0006774917257158089,0.7763157894736842
2423,2812,전성기/Noun,76,59,17,0.0006780037790374569,0.0002110220129278749,0.7763157894736842
2424,2813,ㅎㄷㄷ/KoreanParticle,76,55,21,0.0006335445148382794,0.0002554476998600591,0.7236842105263158
2425,2814,범/Noun,76,22,54,0.000266755585195065,0.0006219596170505788,0.7105263157894737
2426,2815,달라지다/Verb,76,53,23,0.0006113148827386907,0.00027766054332615115,0.6973684210526315
2427,2816,리가/Noun,76,24,52,0.0002889852172946538,0.0005997467735844866,0.6842105263157895
2428,2817,년도/Noun,76,25,51,0.00030010003334444816,0.0005886403518514405,0.6710526315789473
2429,2818,각자/Noun,76,50,26,0.0005779704345893076,0.00031097980852528933,0.6578947368421053
2430,2819,그대/Noun,76,50,26,0.0005779704345893076,0.00031097980852528933,0.6578947368421053
2431,2820,하라/Noun,76,28,48,0.0003334444814938313,0.0005553210866523023,0.631578947368421
2432,2821,글자/Noun,76,28,48,0.0003334444814938313,0.0005553210866523023,0.631578947368421
2433,2822,하고는/Josa,76,29,47,0.0003445592975436257,0.0005442146649192564,0.618421052631579
2434,2823,절대로/Noun,76,29,47,0.0003445592975436257,0.0005442146649192564,0.618421052631579
2435,2824,끼치다/Verb,76,46,30,0.00053351117039013,0.0003554054954574735,0.6052631578947368
2436,2825,형식/Noun,76,30,46,0.00035567411359342004,0.0005331082431862101,0.6052631578947368
2437,2826,변신/Noun,76,32,44,0.00037790374569300877,0.0005108953997201182,0.5789473684210527
2438,2827,케이/Noun,76,32,44,0.00037790374569300877,0.0005108953997201182,0.5789473684210527
2439,2828,각/Modifier,76,35,41,0.0004112481938423919,0.00047757613452098,0.5394736842105263
2440,2829,튀다/Verb,76,35,41,0.0004112481938423919,0.00047757613452098,0.5394736842105263
2441,2834,과대/Noun,75,5,70,7.780371234856063e-05,0.0007996623647793153,0.9333333333333332
2442,2835,도중/Noun,75,7,68,0.0001000333444481494,0.0007774495213132232,0.9066666666666666
2443,2836,따분하다/Adjective,75,8,67,0.00011114816049794375,0.0007663430995801773,0.8933333333333333
2444,2837,여신/Noun,75,61,14,0.0007002334111370457,0.00017770274772873674,0.8133333333333334
2445,2838,낭만/Noun,75,57,18,0.0006557741469378681,0.00022212843466092096,0.76
2446,2839,선사/Noun,75,54,21,0.0006224296987884852,0.0002554476998600591,0.72
2447,2840,꺼지다/Verb,75,24,51,0.0002889852172946538,0.0005886403518514405,0.68
2448,2841,폭풍/Noun,75,51,24,0.000589085250639102,0.0002887669650591972,0.68
2449,2842,공룡/Noun,75,26,49,0.00031121484939424253,0.0005664275083853486,0.6533333333333333
2450,2843,급하다/Adjective,75,26,49,0.00031121484939424253,0.0005664275083853486,0.6533333333333333
2451,2844,잔혹하다/Adjective,75,48,27,0.0005557408024897189,0.00032208623025833537,0.64
2452,2845,빠/Noun,75,27,48,0.00032232966544403684,0.0005553210866523023,0.64
2453,2846,소통/Noun,75,47,28,0.0005446259864399244,0.0003331926519913814,0.6266666666666667
2454,2847,추가/Noun,75,28,47,0.0003334444814938313,0.0005442146649192564,0.6266666666666667
2455,2848,년전/Noun,75,45,30,0.0005223963543403357,0.0003554054954574735,0.6
2456,2849,식이/Noun,75,30,45,0.00035567411359342004,0.0005220018214531642,0.6
2457,2850,1년/Number,75,45,30,0.0005223963543403357,0.0003554054954574735,0.6
2458,2851,축구/Noun,75,30,45,0.00035567411359342004,0.0005220018214531642,0.6
2459,2852,아만다/Noun,75,44,31,0.0005112815382905413,0.00036651191719051963,0.5866666666666667
2460,2853,부활/Noun,75,44,31,0.0005112815382905413,0.00036651191719051963,0.5866666666666667
2461,2854,모이다/Verb,75,32,43,0.00037790374569300877,0.0004997889779870722,0.5733333333333334
2462,2855,용다/Verb,75,43,32,0.0005001667222407468,0.0003776183389235656,0.5733333333333334
2463,2856,직업/Noun,75,34,41,0.0004001333777925976,0.00047757613452098,0.5466666666666666
2464,2858,바닥/Noun,74,9,65,0.00012226297654773814,0.0007441302561140852,0.8783783783783784
2465,2859,졸업/Noun,74,14,60,0.00017783705679671002,0.0006885981474488549,0.8108108108108109
2466,2860,어지럽다/Adjective,74,16,58,0.0002000666888962988,0.0006663853039827628,0.7837837837837838
2467,2861,EBS/Alpha,74,57,17,0.0006557741469378681,0.0002110220129278749,0.7702702702702703
2468,2862,끊기다/Verb,74,17,57,0.00021118150494609317,0.0006552788822497168,0.7702702702702703
2469,2863,웬/Noun,74,19,55,0.0002334111370456819,0.0006330660387836247,0.7432432432432432
2470,2864,지나/Noun,74,53,21,0.0006113148827386907,0.0002554476998600591,0.7162162162162162
2471,2865,딸리다/Verb,74,22,52,0.000266755585195065,0.0005997467735844866,0.7027027027027027
2472,2866,드니/Noun,74,51,23,0.000589085250639102,0.00027766054332615115,0.6891891891891891
2473,2867,한가지/Noun,74,23,51,0.00027787040124485944,0.0005886403518514405,0.6891891891891891
2474,2868,거짓/Noun,74,24,50,0.0002889852172946538,0.0005775339301183945,0.6756756756756757
2475,2869,송강호/Noun,74,50,24,0.0005779704345893076,0.0002887669650591972,0.6756756756756757
2476,2870,재난/Noun,74,25,49,0.00030010003334444816,0.0005664275083853486,0.6621621621621622
2477,2871,워낙/Noun,74,49,25,0.0005668556185395131,0.0002998733867922433,0.6621621621621622
2478,2872,a/Alpha,74,48,26,0.0005557408024897189,0.00031097980852528933,0.6486486486486487
2479,2873,가나/Noun,74,27,47,0.00032232966544403684,0.0005442146649192564,0.6351351351351351
2480,2874,일주일/Noun,74,47,27,0.0005446259864399244,0.00032208623025833537,0.6351351351351351
2481,2875,범죄자/Noun,74,28,46,0.0003334444814938313,0.0005331082431862101,0.6216216216216216
2482,2876,부탁/Noun,74,29,45,0.0003445592975436257,0.0005220018214531642,0.6081081081081081
2483,2877,이안/Noun,74,29,45,0.0003445592975436257,0.0005220018214531642,0.6081081081081081
2484,2878,캐릭/Noun,74,29,45,0.0003445592975436257,0.0005220018214531642,0.6081081081081081
2485,2879,생명/Noun,74,45,29,0.0005223963543403357,0.00034429907372442745,0.6081081081081081
2486,2880,나타내다/Verb,74,44,30,0.0005112815382905413,0.0003554054954574735,0.5945945945945946
2487,2881,트리/Noun,74,31,43,0.00036678892964321435,0.0004997889779870722,0.581081081081081
2488,2882,류승범/Noun,74,42,32,0.0004890519061909527,0.0003776183389235656,0.5675675675675675
2489,2883,높이다/Verb,74,42,32,0.0004890519061909527,0.0003776183389235656,0.5675675675675675
2490,2889,애잔하다/Adjective,73,69,4,0.0007891519395354007,6.663853039827628e-05,0.9452054794520548
2491,2890,애매하다/Adjective,73,12,61,0.00015560742469712126,0.0006997045691819009,0.8356164383561644
2492,2891,이별/Noun,73,57,16,0.0006557741469378681,0.00019991559119482882,0.7808219178082192
2493,2892,쟁이/Suffix,73,19,54,0.0002334111370456819,0.0006219596170505788,0.7397260273972602
2494,2893,쌍/Noun,73,21,52,0.00025564076914527065,0.0005997467735844866,0.7123287671232876
2495,2894,부인/Noun,73,21,52,0.00025564076914527065,0.0005997467735844866,0.7123287671232876
2496,2895,원숭이/Noun,73,22,51,0.000266755585195065,0.0005886403518514405,0.6986301369863014
2497,2896,단편/Noun,73,22,51,0.000266755585195065,0.0005886403518514405,0.6986301369863014
2498,2897,시종일관/Noun,73,22,51,0.000266755585195065,0.0005886403518514405,0.6986301369863014
2499,2898,깡패/Noun,73,23,50,0.00027787040124485944,0.0005775339301183945,0.6849315068493149
2500,2899,신하균/Noun,73,50,23,0.0005779704345893076,0.00027766054332615115,0.6849315068493149
2501,2900,본격/Noun,73,23,50,0.00027787040124485944,0.0005775339301183945,0.6849315068493149
2502,2901,에서나/Josa,73,24,49,0.0002889852172946538,0.0005664275083853486,0.6712328767123288
2503,2902,광기/Noun,73,49,24,0.0005668556185395131,0.0002887669650591972,0.6712328767123288
2504,2903,처리/Noun,73,25,48,0.00030010003334444816,0.0005553210866523023,0.6575342465753424
2505,2904,만세/Noun,73,48,25,0.0005557408024897189,0.0002998733867922433,0.6575342465753424
2506,2905,낮/Noun,73,47,26,0.0005446259864399244,0.00031097980852528933,0.6438356164383562
2507,2906,블랙코미디/Noun,73,46,27,0.00053351117039013,0.00032208623025833537,0.6301369863013698
2508,2907,솔/Noun,73,27,46,0.00032232966544403684,0.0005331082431862101,0.6301369863013698
2509,2908,로움/Noun,73,44,29,0.0005112815382905413,0.00034429907372442745,0.6027397260273972
2510,2909,바치다/Verb,73,43,30,0.0005001667222407468,0.0003554054954574735,0.589041095890411
2511,2910,스타워즈/Noun,73,43,30,0.0005001667222407468,0.0003554054954574735,0.589041095890411
2512,2911,중학생/Noun,73,42,31,0.0004890519061909527,0.00036651191719051963,0.5753424657534246
2513,2912,50/Number,73,41,32,0.0004779370901411582,0.0003776183389235656,0.5616438356164384
2514,2913,매번/Noun,73,41,32,0.0004779370901411582,0.0003776183389235656,0.5616438356164384
2515,2914,녀석/Noun,73,33,40,0.00038901856174280313,0.000466469712787934,0.547945205479452
2516,2915,흔들다/Verb,73,39,34,0.00045570745804156943,0.00039983118238965764,0.5342465753424658
2517,2916,풀리다/Verb,73,39,34,0.00045570745804156943,0.00039983118238965764,0.5342465753424658
2518,2921,답답/Noun,72,2,70,4.445926419917751e-05,0.0007996623647793153,0.9722222222222222
2519,2922,Good/Alpha,72,69,3,0.0007891519395354007,5.553210866523024e-05,0.9583333333333334
2520,2923,어색/Noun,72,3,69,5.5574080248971876e-05,0.0007885559430462694,0.9583333333333334
2521,2924,명불허전/Noun,72,64,8,0.0007335778592864287,0.00011106421733046048,0.8888888888888888
2522,2925,비록/Noun,72,64,8,0.0007335778592864287,0.00011106421733046048,0.8888888888888888
2523,2926,애틋하다/Adjective,72,61,11,0.0007002334111370457,0.0001443834825295986,0.8472222222222222
2524,2927,광구/Noun,72,12,60,0.00015560742469712126,0.0006885981474488549,0.8333333333333334
2525,2928,쓴다/Verb,72,12,60,0.00015560742469712126,0.0006885981474488549,0.8333333333333334
2526,2929,짜릿하다/Adjective,72,59,13,0.0006780037790374569,0.0001665963259956907,0.8194444444444444
2527,2930,땀/Noun,72,58,14,0.0006668889629876625,0.00017770274772873674,0.8055555555555556
2528,2931,배꼽/Noun,72,58,14,0.0006668889629876625,0.00017770274772873674,0.8055555555555556
2529,2932,뎅/Noun,72,57,15,0.0006557741469378681,0.0001888091694617828,0.7916666666666666
2530,2933,누나/Suffix,72,56,16,0.0006446593308880737,0.00019991559119482882,0.7777777777777778
2531,2934,아무나/Noun,72,17,55,0.00021118150494609317,0.0006330660387836247,0.7638888888888888
2532,2935,기획/Noun,72,22,50,0.000266755585195065,0.0005775339301183945,0.6944444444444444
2533,2936,호흡/Noun,72,49,23,0.0005668556185395131,0.00027766054332615115,0.6805555555555556
2534,2937,고전/Modifier,72,49,23,0.0005668556185395131,0.00027766054332615115,0.6805555555555556
2535,2938,대부/Noun,72,46,26,0.00053351117039013,0.00031097980852528933,0.6388888888888888
2536,2939,일지/Noun,72,46,26,0.00053351117039013,0.00031097980852528933,0.6388888888888888
2537,2940,못자다/Verb,72,26,46,0.00031121484939424253,0.0005331082431862101,0.6388888888888888
2538,2941,구분/Noun,72,27,45,0.00032232966544403684,0.0005220018214531642,0.625
2539,2942,이지/Noun,72,27,45,0.00032232966544403684,0.0005220018214531642,0.625
2540,2943,수록/Noun,72,44,28,0.0005112815382905413,0.0003331926519913814,0.6111111111111112
2541,2944,풀/Noun,72,28,44,0.0003334444814938313,0.0005108953997201182,0.6111111111111112
2542,2945,본질/Noun,72,44,28,0.0005112815382905413,0.0003331926519913814,0.6111111111111112
2543,2946,찾아가다/Verb,72,42,30,0.0004890519061909527,0.0003554054954574735,0.5833333333333334
2544,2947,객관/Noun,72,30,42,0.00035567411359342004,0.0004886825562540262,0.5833333333333334
2545,2948,혼란/Noun,72,33,39,0.00038901856174280313,0.000455363291054888,0.5416666666666666
2546,2953,아마추어/Noun,71,5,66,7.780371234856063e-05,0.0007552366778471312,0.9295774647887324
2547,2954,케미/Noun,71,66,5,0.0007558074913860174,7.774495213132233e-05,0.9295774647887324
2548,2955,오글오글/Adverb,71,6,65,8.891852839835501e-05,0.0007441302561140852,0.9154929577464788
2549,2956,...^^/Punctuation,71,65,6,0.0007446926753362233,8.885137386436837e-05,0.9154929577464788
2550,2957,쓸쓸하다/Adjective,71,63,8,0.0007224630432366343,0.00011106421733046048,0.8873239436619719
2551,2958,15년/Number,71,60,11,0.0006891185950872514,0.0001443834825295986,0.8450704225352113
2552,2959,고인/Noun,71,60,11,0.0006891185950872514,0.0001443834825295986,0.8450704225352113
2553,2960,데리다/Verb,71,12,59,0.00015560742469712126,0.0006774917257158089,0.8309859154929577
2554,2961,제작자/Noun,71,12,59,0.00015560742469712126,0.0006774917257158089,0.8309859154929577
2555,2962,정점/Noun,71,55,16,0.0006335445148382794,0.00019991559119482882,0.7746478873239436
2556,2963,상식/Noun,71,16,55,0.0002000666888962988,0.0006330660387836247,0.7746478873239436
2557,2964,명장/Noun,71,52,19,0.0006002000666888963,0.000233234856393967,0.7323943661971831
2558,2965,ㅜㅠ/KoreanParticle,71,50,21,0.0005779704345893076,0.0002554476998600591,0.7042253521126759
2559,2966,고증/Noun,71,21,50,0.00025564076914527065,0.0005775339301183945,0.7042253521126759
2560,2967,괴롭다/Adjective,71,22,49,0.000266755585195065,0.0005664275083853486,0.6901408450704225
2561,2968,살이/Noun,71,45,26,0.0005223963543403357,0.00031097980852528933,0.6338028169014085
2562,2969,회사/Noun,71,26,45,0.00031121484939424253,0.0005220018214531642,0.6338028169014085
2563,2970,커버/Noun,71,44,27,0.0005112815382905413,0.00032208623025833537,0.6197183098591549
2564,2971,별거/Noun,71,28,43,0.0003334444814938313,0.0004997889779870722,0.6056338028169014
2565,2972,합/Noun,71,28,43,0.0003334444814938313,0.0004997889779870722,0.6056338028169014
2566,2973,돌/Noun,71,29,42,0.0003445592975436257,0.0004886825562540262,0.5915492957746479
2567,2974,안기다/Verb,71,42,29,0.0004890519061909527,0.00034429907372442745,0.5915492957746479
2568,2975,공유/Noun,71,42,29,0.0004890519061909527,0.00034429907372442745,0.5915492957746479
2569,2976,두운/Noun,71,42,29,0.0004890519061909527,0.00034429907372442745,0.5915492957746479
2570,2977,님/Noun,71,40,31,0.0004668222740913638,0.00036651191719051963,0.5633802816901409
2571,2978,기괴하다/Adjective,71,40,31,0.0004668222740913638,0.00036651191719051963,0.5633802816901409
2572,2979,노인/Noun,71,31,40,0.00036678892964321435,0.000466469712787934,0.5633802816901409
2573,2980,받아들이다/Verb,71,38,33,0.000444592641991775,0.00038872476065661166,0.5352112676056338
2574,2981,스릴러물/Noun,71,38,33,0.000444592641991775,0.00038872476065661166,0.5352112676056338
2575,2984,진창/Noun,70,4,66,6.668889629876625e-05,0.0007552366778471312,0.9428571428571428
2576,2985,돌려주다/Verb,70,6,64,8.891852839835501e-05,0.0007330238343810393,0.9142857142857144
2577,2986,찬사/Noun,70,61,9,0.0007002334111370457,0.00012217063906350652,0.8714285714285714
2578,2987,you/Alpha,70,59,11,0.0006780037790374569,0.0001443834825295986,0.8428571428571429
2579,2988,일반인/Noun,70,11,59,0.0001444926086473269,0.0006774917257158089,0.8428571428571429
2580,2989,의심스럽다/Adjective,70,11,59,0.0001444926086473269,0.0006774917257158089,0.8428571428571429
2581,2990,티나/Noun,70,14,56,0.00017783705679671002,0.0006441724605166707,0.8
2582,2991,피아노/Noun,70,56,14,0.0006446593308880737,0.00017770274772873674,0.8
2583,2992,이기도/Josa,70,55,15,0.0006335445148382794,0.0001888091694617828,0.7857142857142857
2584,2993,90분/Number,70,15,55,0.00018895187284650438,0.0006330660387836247,0.7857142857142857
2585,2994,미스터리/Noun,70,17,53,0.00021118150494609317,0.0006108531953175326,0.7571428571428571
2586,2995,믿음/Noun,70,52,18,0.0006002000666888963,0.00022212843466092096,0.7428571428571429
2587,2996,디테일/Noun,70,50,20,0.0005779704345893076,0.00024434127812701304,0.7142857142857143
2588,2997,닥치고/Noun,70,49,21,0.0005668556185395131,0.0002554476998600591,0.7
2589,2998,위험하다/Adjective,70,22,48,0.000266755585195065,0.0005553210866523023,0.6857142857142857
2590,2999,멜로영화/Noun,70,46,24,0.00053351117039013,0.0002887669650591972,0.6571428571428571
2591,3000,오로지/Adverb,70,24,46,0.0002889852172946538,0.0005331082431862101,0.6571428571428571
2592,3001,스필버그/Noun,70,46,24,0.00053351117039013,0.0002887669650591972,0.6571428571428571
2593,3002,놀란/Noun,70,46,24,0.00053351117039013,0.0002887669650591972,0.6571428571428571
2594,3003,업/Noun,70,26,44,0.00031121484939424253,0.0005108953997201182,0.6285714285714286
2595,3004,남자배우/Noun,70,28,42,0.0003334444814938313,0.0004886825562540262,0.6
2596,3005,본능/Noun,70,41,29,0.0004779370901411582,0.00034429907372442745,0.5857142857142857
2597,3006,고등학생/Noun,70,40,30,0.0004668222740913638,0.0003554054954574735,0.5714285714285714
2598,3007,가르치다/Verb,70,39,31,0.00045570745804156943,0.00036651191719051963,0.5571428571428572
2599,3008,만큼이나/Josa,70,39,31,0.00045570745804156943,0.00036651191719051963,0.5571428571428572
2600,3009,아누/Noun,70,38,32,0.000444592641991775,0.0003776183389235656,0.5428571428571428
2601,3010,다해/Noun,70,32,38,0.00037790374569300877,0.0004442568693218419,0.5428571428571428
2602,3011,권상우/Noun,70,38,32,0.000444592641991775,0.0003776183389235656,0.5428571428571428
2603,3018,수면제/Noun,69,3,66,5.5574080248971876e-05,0.0007552366778471312,0.9565217391304348
2604,3019,짬뽕/Noun,69,4,65,6.668889629876625e-05,0.0007441302561140852,0.9420289855072465
2605,3020,비호감/Noun,69,7,62,0.0001000333444481494,0.000710810990914947,0.8985507246376812
2606,3021,명연기/Noun,69,61,8,0.0007002334111370457,0.00011106421733046048,0.8840579710144928
2607,3022,꿀/Noun,69,61,8,0.0007002334111370457,0.00011106421733046048,0.8840579710144928
2608,3023,국어/Noun,69,9,60,0.00012226297654773814,0.0006885981474488549,0.8695652173913043
2609,3024,전문/Noun,69,13,56,0.00016672224074691566,0.0006441724605166707,0.8115942028985508
2610,3025,많아지다/Verb,69,55,14,0.0006335445148382794,0.00017770274772873674,0.7971014492753623
2611,3026,순수/Noun,69,54,15,0.0006224296987884852,0.0001888091694617828,0.7826086956521741
2612,3027,초월/Noun,69,53,16,0.0006113148827386907,0.00019991559119482882,0.7681159420289855
2613,3028,연관/Noun,69,16,53,0.0002000666888962988,0.0006108531953175326,0.7681159420289855
2614,3029,출연자/Noun,69,17,52,0.00021118150494609317,0.0005997467735844866,0.7536231884057971
2615,3030,저지르다/Verb,69,18,51,0.0002222963209958875,0.0005886403518514405,0.7391304347826086
2616,3031,혁명/Noun,69,50,19,0.0005779704345893076,0.000233234856393967,0.7246376811594203
2617,3032,하나님/Noun,69,48,21,0.0005557408024897189,0.0002554476998600591,0.6956521739130435
2618,3033,마찬가지/Noun,69,21,48,0.00025564076914527065,0.0005553210866523023,0.6956521739130435
2619,3034,스포츠/Noun,69,47,22,0.0005446259864399244,0.00026655412159310506,0.6811594202898551
2620,3035,가까이/Noun,69,47,22,0.0005446259864399244,0.00026655412159310506,0.6811594202898551
2621,3036,빌다/Verb,69,46,23,0.00053351117039013,0.00027766054332615115,0.6666666666666666
2622,3037,엽기/Noun,69,26,43,0.00031121484939424253,0.0004997889779870722,0.6231884057971014
2623,3038,계/Noun,69,26,43,0.00031121484939424253,0.0004997889779870722,0.6231884057971014
2624,3039,선수/Noun,69,42,27,0.0004890519061909527,0.00032208623025833537,0.6086956521739131
2625,3040,홀로/Noun,69,42,27,0.0004890519061909527,0.00032208623025833537,0.6086956521739131
2626,3041,애정/Noun,69,41,28,0.0004779370901411582,0.0003331926519913814,0.5942028985507246
2627,3042,정리/Noun,69,28,41,0.0003334444814938313,0.00047757613452098,0.5942028985507246
2628,3043,민족/Noun,69,40,29,0.0004668222740913638,0.00034429907372442745,0.5797101449275363
2629,3044,2000년/Number,69,29,40,0.0003445592975436257,0.000466469712787934,0.5797101449275363
2630,3045,뎀/Noun,69,38,31,0.000444592641991775,0.00036651191719051963,0.5507246376811594
2631,3046,부터는/Josa,69,32,37,0.00037790374569300877,0.0004331504475887958,0.5362318840579711
2632,3047,무어/Noun,69,32,37,0.00037790374569300877,0.0004331504475887958,0.5362318840579711
2633,3048,밀/Noun,69,37,32,0.0004334778259419807,0.0003776183389235656,0.5362318840579711
2634,3049,잃어버리다/Verb,69,32,37,0.00037790374569300877,0.0004331504475887958,0.5362318840579711
2635,3052,~~^^/Punctuation,68,65,3,0.0007446926753362233,5.553210866523024e-05,0.9558823529411764
2636,3053,유아/Noun,68,8,60,0.00011114816049794375,0.0006885981474488549,0.8823529411764706
2637,3054,게스트/Noun,68,10,58,0.0001333777925975325,0.0006663853039827628,0.8529411764705882
2638,3055,대박나다/Verb,68,58,10,0.0006668889629876625,0.00013327706079655256,0.8529411764705882
2639,3056,알파/Noun,68,56,12,0.0006446593308880737,0.00015548990426264466,0.8235294117647058
2640,3057,세대/Noun,68,54,14,0.0006224296987884852,0.00017770274772873674,0.7941176470588235
2641,3058,즐거움/Noun,68,53,15,0.0006113148827386907,0.0001888091694617828,0.7794117647058824
2642,3059,고문/Noun,68,15,53,0.00018895187284650438,0.0006108531953175326,0.7794117647058824
2643,3060,연습/Noun,68,16,52,0.0002000666888962988,0.0005997467735844866,0.7647058823529411
2644,3061,40분/Number,68,16,52,0.0002000666888962988,0.0005997467735844866,0.7647058823529411
2645,3062,숨막히다/Adjective,68,52,16,0.0006002000666888963,0.00019991559119482882,0.7647058823529411
2646,3063,무식하다/Adjective,68,17,51,0.00021118150494609317,0.0005886403518514405,0.75
2647,3064,떡/Noun,68,19,49,0.0002334111370456819,0.0005664275083853486,0.7205882352941176
2648,3065,농담/Noun,68,19,49,0.0002334111370456819,0.0005664275083853486,0.7205882352941176
2649,3066,미스테리/Noun,68,19,49,0.0002334111370456819,0.0005664275083853486,0.7205882352941176
2650,3067,로빈/Noun,68,48,20,0.0005557408024897189,0.00024434127812701304,0.7058823529411765
2651,3068,미학/Noun,68,48,20,0.0005557408024897189,0.00024434127812701304,0.7058823529411765
2652,3069,뺏다/Verb,68,20,48,0.00024452595309547634,0.0005553210866523023,0.7058823529411765
2653,3070,쏟다/Verb,68,46,22,0.00053351117039013,0.00026655412159310506,0.6764705882352942
2654,3071,타란티노/Noun,68,45,23,0.0005223963543403357,0.00027766054332615115,0.6617647058823529
2655,3072,반영/Noun,68,44,24,0.0005112815382905413,0.0002887669650591972,0.6470588235294118
2656,3073,자세하다/Adjective,68,44,24,0.0005112815382905413,0.0002887669650591972,0.6470588235294118
2657,3074,세트/Noun,68,25,43,0.00030010003334444816,0.0004997889779870722,0.6323529411764706
2658,3075,위주/Noun,68,25,43,0.00030010003334444816,0.0004997889779870722,0.6323529411764706
2659,3076,다른사람/Noun,68,25,43,0.00030010003334444816,0.0004997889779870722,0.6323529411764706
2660,3077,쭉/Noun,68,43,25,0.0005001667222407468,0.0002998733867922433,0.6323529411764706
2661,3078,스텝/Noun,68,28,40,0.0003334444814938313,0.000466469712787934,0.5882352941176471
2662,3079,상이/Noun,68,40,28,0.0004668222740913638,0.0003331926519913814,0.5882352941176471
2663,3080,소개/Noun,68,30,38,0.00035567411359342004,0.0004442568693218419,0.5588235294117647
2664,3081,?../Punctuation,68,30,38,0.00035567411359342004,0.0004442568693218419,0.5588235294117647
2665,3087,굿굿굿/Noun,67,67,0,0.0007669223074358119,2.2212843466092093e-05,1.0
2666,3088,부자연스럽다/Adjective,67,8,59,0.00011114816049794375,0.0006774917257158089,0.8805970149253731
2667,3089,~~!!/Punctuation,67,55,12,0.0006335445148382794,0.00015548990426264466,0.8208955223880597
2668,3090,강간/Noun,67,12,55,0.00015560742469712126,0.0006330660387836247,0.8208955223880597
2669,3091,뭣/Noun,67,15,52,0.00018895187284650438,0.0005997467735844866,0.7761194029850746
2670,3092,한동안/Adverb,67,51,16,0.000589085250639102,0.00019991559119482882,0.7611940298507462
2671,3093,까지만/Josa,67,16,51,0.0002000666888962988,0.0005886403518514405,0.7611940298507462
2672,3094,간지/Noun,67,50,17,0.0005779704345893076,0.0002110220129278749,0.746268656716418
2673,3095,외국인/Noun,67,18,49,0.0002222963209958875,0.0005664275083853486,0.7313432835820896
2674,3096,ㅈㄴ/KoreanParticle,67,18,49,0.0002222963209958875,0.0005664275083853486,0.7313432835820896
2675,3097,s/Alpha,67,47,20,0.0005446259864399244,0.00024434127812701304,0.7014925373134329
2676,3098,마저도/Josa,67,21,46,0.00025564076914527065,0.0005331082431862101,0.6865671641791045
2677,3099,칭찬/Noun,67,22,45,0.000266755585195065,0.0005220018214531642,0.6716417910447762
2678,3100,리도/Noun,67,22,45,0.000266755585195065,0.0005220018214531642,0.6716417910447762
2679,3101,유치원/Noun,67,22,45,0.000266755585195065,0.0005220018214531642,0.6716417910447762
2680,3102,권력/Noun,67,44,23,0.0005112815382905413,0.00027766054332615115,0.6567164179104478
2681,3103,데이빗/Noun,67,43,24,0.0005001667222407468,0.0002887669650591972,0.6417910447761194
2682,3104,원/Suffix,67,25,42,0.00030010003334444816,0.0004886825562540262,0.6268656716417911
2683,3105,능가/Noun,67,42,25,0.0004890519061909527,0.0002998733867922433,0.6268656716417911
2684,3106,우린/Noun,67,42,25,0.0004890519061909527,0.0002998733867922433,0.6268656716417911
2685,3107,데이/Noun,67,42,25,0.0004890519061909527,0.0002998733867922433,0.6268656716417911
2686,3108,문/Noun,67,26,41,0.00031121484939424253,0.00047757613452098,0.6119402985074627
2687,3109,나로/Noun,67,26,41,0.00031121484939424253,0.00047757613452098,0.6119402985074627
2688,3110,지식/Noun,67,40,27,0.0004668222740913638,0.00032208623025833537,0.5970149253731343
2689,3111,베일/Noun,67,38,29,0.000444592641991775,0.00034429907372442745,0.5671641791044776
2690,3112,박보영/Noun,67,36,31,0.00042236300989218633,0.00036651191719051963,0.5373134328358209
2691,3115,떨어뜨리다/Verb,66,4,62,6.668889629876625e-05,0.000710810990914947,0.9393939393939394
2692,3116,칠하다/Adjective,66,8,58,0.00011114816049794375,0.0006663853039827628,0.8787878787878788
2693,3117,영구/Noun,66,10,56,0.0001333777925975325,0.0006441724605166707,0.8484848484848485
2694,3118,디카프리오/Noun,66,56,10,0.0006446593308880737,0.00013327706079655256,0.8484848484848485
2695,3119,콩/Noun,66,10,56,0.0001333777925975325,0.0006441724605166707,0.8484848484848485
2696,3120,화중/Noun,66,54,12,0.0006224296987884852,0.00015548990426264466,0.8181818181818182
2697,3121,한석규/Noun,66,54,12,0.0006224296987884852,0.00015548990426264466,0.8181818181818182
2698,3122,외롭다/Adjective,66,49,17,0.0005668556185395131,0.0002110220129278749,0.7424242424242424
2699,3123,머릿속/Noun,66,47,19,0.0005446259864399244,0.000233234856393967,0.7121212121212122
2700,3124,상징/Noun,66,45,21,0.0005223963543403357,0.0002554476998600591,0.6818181818181818
2701,3125,커서/Noun,66,44,22,0.0005112815382905413,0.00026655412159310506,0.6666666666666666
2702,3126,이따/Noun,66,23,43,0.00027787040124485944,0.0004997889779870722,0.6515151515151515
2703,3127,억울하다/Adjective,66,23,43,0.00027787040124485944,0.0004997889779870722,0.6515151515151515
2704,3128,견디다/Verb,66,24,42,0.0002889852172946538,0.0004886825562540262,0.6363636363636364
2705,3129,포함/Noun,66,24,42,0.0002889852172946538,0.0004886825562540262,0.6363636363636364
2706,3130,강아지/Noun,66,41,25,0.0004779370901411582,0.0002998733867922433,0.6212121212121212
2707,3131,호불호/Noun,66,41,25,0.0004779370901411582,0.0002998733867922433,0.6212121212121212
2708,3132,드네/Noun,66,39,27,0.00045570745804156943,0.00032208623025833537,0.5909090909090909
2709,3133,장애인/Noun,66,38,28,0.000444592641991775,0.0003331926519913814,0.5757575757575758
2710,3134,반응/Noun,66,28,38,0.0003334444814938313,0.0004442568693218419,0.5757575757575758
2711,3135,부산/Noun,66,38,28,0.000444592641991775,0.0003331926519913814,0.5757575757575758
2712,3136,너희/Noun,66,29,37,0.0003445592975436257,0.0004331504475887958,0.5606060606060606
2713,3137,당장/Noun,66,36,30,0.00042236300989218633,0.0003554054954574735,0.5454545454545454
2714,3138,옳다/Adjective,66,30,36,0.00035567411359342004,0.0004220440258557498,0.5454545454545454
2715,3139,해봤다/Verb,66,35,31,0.0004112481938423919,0.00036651191719051963,0.5303030303030303
2716,3140,니콜라스/Noun,66,31,35,0.00036678892964321435,0.0004109376041227037,0.5303030303030303
2717,3142,빠순이/Noun,65,5,60,7.780371234856063e-05,0.0006885981474488549,0.9230769230769232
2718,3143,적당/Noun,65,9,56,0.00012226297654773814,0.0006441724605166707,0.8615384615384616
2719,3144,아우/Noun,65,10,55,0.0001333777925975325,0.0006330660387836247,0.8461538461538461
2720,3145,다시금/Noun,65,54,11,0.0006224296987884852,0.0001443834825295986,0.8307692307692308
2721,3146,마누라/Noun,65,12,53,0.00015560742469712126,0.0006108531953175326,0.8153846153846154
2722,3147,미스캐스팅/Noun,65,12,53,0.00015560742469712126,0.0006108531953175326,0.8153846153846154
2723,3148,올려주다/Verb,65,51,14,0.000589085250639102,0.00017770274772873674,0.7846153846153846
2724,3149,시체/Noun,65,16,49,0.0002000666888962988,0.0005664275083853486,0.7538461538461538
2725,3150,죄송하다/Adjective,65,17,48,0.00021118150494609317,0.0005553210866523023,0.7384615384615385
2726,3151,거임/Noun,65,18,47,0.0002222963209958875,0.0005442146649192564,0.7230769230769231
2727,3152,마다/Noun,65,45,20,0.0005223963543403357,0.00024434127812701304,0.6923076923076923
2728,3153,안쓰럽다/Adjective,65,22,43,0.000266755585195065,0.0004997889779870722,0.6615384615384615
2729,3154,차승원/Noun,65,43,22,0.0005001667222407468,0.00026655412159310506,0.6615384615384615
2730,3155,백인/Noun,65,22,43,0.000266755585195065,0.0004997889779870722,0.6615384615384615
2731,3156,도와주다/Verb,65,23,42,0.00027787040124485944,0.0004886825562540262,0.6461538461538462
2732,3157,구만/Noun,65,23,42,0.00027787040124485944,0.0004886825562540262,0.6461538461538462
2733,3158,.........../Punctuation,65,24,41,0.0002889852172946538,0.00047757613452098,0.6307692307692307
2734,3159,인식/Noun,65,26,39,0.00031121484939424253,0.000455363291054888,0.6
2735,3160,어쨌든/Noun,65,38,27,0.000444592641991775,0.00032208623025833537,0.5846153846153846
2736,3161,동감/Noun,65,27,38,0.00032232966544403684,0.0004442568693218419,0.5846153846153846
2737,3162,일부/Noun,65,29,36,0.0003445592975436257,0.0004220440258557498,0.5538461538461539
2738,3163,어차피/Noun,65,29,36,0.0003445592975436257,0.0004220440258557498,0.5538461538461539
2739,3164,공주/Noun,65,36,29,0.00042236300989218633,0.00034429907372442745,0.5538461538461539
2740,3165,이드/Noun,65,35,30,0.0004112481938423919,0.0003554054954574735,0.5384615384615384
2741,3168,역작/Noun,64,59,5,0.0006780037790374569,7.774495213132233e-05,0.921875
2742,3169,싱겁다/Adjective,64,7,57,0.0001000333444481494,0.0006552788822497168,0.890625
2743,3170,치노/Noun,64,53,11,0.0006113148827386907,0.0001443834825295986,0.828125
2744,3171,잘나가다/Verb,64,11,53,0.0001444926086473269,0.0006108531953175326,0.828125
2745,3172,뒤늦다/Adjective,64,52,12,0.0006002000666888963,0.00015548990426264466,0.8125
2746,3173,납득/Noun,64,12,52,0.00015560742469712126,0.0005997467735844866,0.8125
2747,3174,조차/Noun,64,13,51,0.00016672224074691566,0.0005886403518514405,0.796875
2748,3175,사람과/Noun,64,51,13,0.000589085250639102,0.0001665963259956907,0.796875
2749,3176,클래식/Noun,64,50,14,0.0005779704345893076,0.00017770274772873674,0.78125
2750,3177,...!/Punctuation,64,48,16,0.0005557408024897189,0.00019991559119482882,0.75
2751,3178,재방/Noun,64,48,16,0.0005557408024897189,0.00019991559119482882,0.75
2752,3179,우드/Noun,64,48,16,0.0005557408024897189,0.00019991559119482882,0.75
2753,3180,두렵다/Adjective,64,48,16,0.0005557408024897189,0.00019991559119482882,0.75
2754,3181,떨리다/Verb,64,47,17,0.0005446259864399244,0.0002110220129278749,0.734375
2755,3182,차리다/Verb,64,17,47,0.00021118150494609317,0.0005442146649192564,0.734375
2756,3183,!!!!!!/Punctuation,64,47,17,0.0005446259864399244,0.0002110220129278749,0.734375
2757,3184,찍/Noun,64,18,46,0.0002222963209958875,0.0005331082431862101,0.71875
2758,3185,신화/Noun,64,46,18,0.00053351117039013,0.00022212843466092096,0.71875
2759,3186,난후/Noun,64,44,20,0.0005112815382905413,0.00024434127812701304,0.6875
2760,3187,발랄하다/Adjective,64,44,20,0.0005112815382905413,0.00024434127812701304,0.6875
2761,3188,스펙/Noun,64,43,21,0.0005001667222407468,0.0002554476998600591,0.671875
2762,3189,인걸/Josa,64,22,42,0.000266755585195065,0.0004886825562540262,0.65625
2763,3190,세계관/Noun,64,22,42,0.000266755585195065,0.0004886825562540262,0.65625
2764,3191,찌르다/Verb,64,22,42,0.000266755585195065,0.0004886825562540262,0.65625
2765,3192,화질/Noun,64,23,41,0.00027787040124485944,0.00047757613452098,0.640625
2766,3193,설/Noun,64,24,40,0.0002889852172946538,0.000466469712787934,0.625
2767,3194,화하다/Adjective,64,27,37,0.00032232966544403684,0.0004331504475887958,0.578125
2768,3195,추격/Noun,64,36,28,0.00042236300989218633,0.0003331926519913814,0.5625
2769,3196,리암/Noun,64,36,28,0.00042236300989218633,0.0003331926519913814,0.5625
2770,3197,도르다/Verb,64,29,35,0.0003445592975436257,0.0004109376041227037,0.546875
2771,3198,각/Noun,64,34,30,0.0004001333777925976,0.0003554054954574735,0.53125
2772,3199,구조/Noun,64,30,34,0.00035567411359342004,0.00039983118238965764,0.53125
2773,3200,열다/Verb,64,34,30,0.0004001333777925976,0.0003554054954574735,0.53125
2774,3201,한지/Noun,64,30,34,0.00035567411359342004,0.00039983118238965764,0.53125
2775,3204,4.44/Number,63,9,54,0.00012226297654773814,0.0006219596170505788,0.8571428571428571
2776,3205,-_-;;/Punctuation,63,9,54,0.00012226297654773814,0.0006219596170505788,0.8571428571428571
2777,3206,재앙/Noun,63,10,53,0.0001333777925975325,0.0006108531953175326,0.8412698412698413
2778,3207,해지/Noun,63,51,12,0.000589085250639102,0.00015548990426264466,0.8095238095238095
2779,3208,다치다/Verb,63,16,47,0.0002000666888962988,0.0005442146649192564,0.7460317460317459
2780,3209,허무/Noun,63,16,47,0.0002000666888962988,0.0005442146649192564,0.7460317460317459
2781,3210,앙/Adverb,63,45,18,0.0005223963543403357,0.00022212843466092096,0.7142857142857143
2782,3211,승부/Noun,63,18,45,0.0002222963209958875,0.0005220018214531642,0.7142857142857143
2783,3212,김희선/Noun,63,20,43,0.00024452595309547634,0.0004997889779870722,0.6825396825396826
2784,3213,벌어지다/Verb,63,42,21,0.0004890519061909527,0.0002554476998600591,0.6666666666666666
2785,3214,첨으로/Adverb,63,22,41,0.000266755585195065,0.00047757613452098,0.6507936507936508
2786,3215,만화가/Noun,63,22,41,0.000266755585195065,0.00047757613452098,0.6507936507936508
2787,3216,작화/Noun,63,40,23,0.0004668222740913638,0.00027766054332615115,0.6349206349206349
2788,3217,거듭/Noun,63,40,23,0.0004668222740913638,0.00027766054332615115,0.6349206349206349
2789,3218,메이/Noun,63,40,23,0.0004668222740913638,0.00027766054332615115,0.6349206349206349
2790,3219,오직/Noun,63,24,39,0.0002889852172946538,0.000455363291054888,0.6190476190476191
2791,3220,강동원/Noun,63,39,24,0.00045570745804156943,0.0002887669650591972,0.6190476190476191
2792,3221,장진/Noun,63,26,37,0.00031121484939424253,0.0004331504475887958,0.5873015873015873
2793,3222,비쥬/Noun,63,26,37,0.00031121484939424253,0.0004331504475887958,0.5873015873015873
2794,3223,3시간/Number,63,36,27,0.00042236300989218633,0.00032208623025833537,0.5714285714285714
2795,3224,섬/Noun,63,36,27,0.00042236300989218633,0.00032208623025833537,0.5714285714285714
2796,3225,깜놀/Noun,63,36,27,0.00042236300989218633,0.00032208623025833537,0.5714285714285714
2797,3226,주가/Noun,63,28,35,0.0003334444814938313,0.0004109376041227037,0.5555555555555556
2798,3227,슈퍼맨/Noun,63,28,35,0.0003334444814938313,0.0004109376041227037,0.5555555555555556
2799,3228,열자/Noun,63,28,35,0.0003334444814938313,0.0004109376041227037,0.5555555555555556
2800,3229,오해/Noun,63,34,29,0.0004001333777925976,0.00034429907372442745,0.5396825396825397
2801,3231,bb/Alpha,62,59,3,0.0006780037790374569,5.553210866523024e-05,0.9516129032258064
2802,3232,에로물/Noun,62,6,56,8.891852839835501e-05,0.0006441724605166707,0.9032258064516128
2803,3233,살때/Noun,62,54,8,0.0006224296987884852,0.00011106421733046048,0.8709677419354839
2804,3234,알바생/Noun,62,8,54,0.00011114816049794375,0.0006219596170505788,0.8709677419354839
2805,3235,벅차다/Adjective,62,53,9,0.0006113148827386907,0.00012217063906350652,0.8548387096774194
2806,3236,로운/Josa,62,51,11,0.000589085250639102,0.0001443834825295986,0.8225806451612904
2807,3237,^-^/Punctuation,62,50,12,0.0005779704345893076,0.00015548990426264466,0.8064516129032258
2808,3238,꼽/Noun,62,49,13,0.0005668556185395131,0.0001665963259956907,0.7903225806451613
2809,3239,관대하다/Adjective,62,14,48,0.00017783705679671002,0.0005553210866523023,0.7741935483870968
2810,3240,뿌리다/Verb,62,14,48,0.00017783705679671002,0.0005553210866523023,0.7741935483870968
2811,3241,페이크/Noun,62,14,48,0.00017783705679671002,0.0005553210866523023,0.7741935483870968
2812,3242,망치/Noun,62,16,46,0.0002000666888962988,0.0005331082431862101,0.7419354838709677
2813,3243,올레/Noun,62,16,46,0.0002000666888962988,0.0005331082431862101,0.7419354838709677
2814,3244,강요/Noun,62,16,46,0.0002000666888962988,0.0005331082431862101,0.7419354838709677
2815,3245,밀다/Verb,62,17,45,0.00021118150494609317,0.0005220018214531642,0.7258064516129032
2816,3246,다섯/Determiner,62,45,17,0.0005223963543403357,0.0002110220129278749,0.7258064516129032
2817,3247,짜내다/Verb,62,18,44,0.0002222963209958875,0.0005108953997201182,0.7096774193548387
2818,3248,가짜/Noun,62,19,43,0.0002334111370456819,0.0004997889779870722,0.6935483870967742
2819,3249,소품/Noun,62,20,42,0.00024452595309547634,0.0004886825562540262,0.6774193548387096
2820,3250,아담/Noun,62,42,20,0.0004890519061909527,0.00024434127812701304,0.6774193548387096
2821,3251,다녀오다/Verb,62,42,20,0.0004890519061909527,0.00024434127812701304,0.6774193548387096
2822,3252,만난/Noun,62,41,21,0.0004779370901411582,0.0002554476998600591,0.6612903225806451
2823,3253,원조/Noun,62,41,21,0.0004779370901411582,0.0002554476998600591,0.6612903225806451
2824,3254,구석/Noun,62,21,41,0.00025564076914527065,0.00047757613452098,0.6612903225806451
2825,3255,드러내다/Verb,62,40,22,0.0004668222740913638,0.00026655412159310506,0.6451612903225806
2826,3256,섬뜩하다/Adjective,62,39,23,0.00045570745804156943,0.00027766054332615115,0.6290322580645161
2827,3257,흑백/Noun,62,38,24,0.000444592641991775,0.0002887669650591972,0.6129032258064516
2828,3258,가라/Noun,62,24,38,0.0002889852172946538,0.0004442568693218419,0.6129032258064516
2829,3259,행/Noun,62,38,24,0.000444592641991775,0.0002887669650591972,0.6129032258064516
2830,3260,철저하다/Adjective,62,24,38,0.0002889852172946538,0.0004442568693218419,0.6129032258064516
2831,3261,지지/Noun,62,24,38,0.0002889852172946538,0.0004442568693218419,0.6129032258064516
2832,3262,곤/Noun,62,25,37,0.00030010003334444816,0.0004331504475887958,0.5967741935483871
2833,3263,파워/Noun,62,26,36,0.00031121484939424253,0.0004220440258557498,0.5806451612903226
2834,3264,대에/Foreign,62,26,36,0.00031121484939424253,0.0004220440258557498,0.5806451612903226
2835,3265,옥/Noun,62,36,26,0.00042236300989218633,0.00031097980852528933,0.5806451612903226
2836,3266,외면/Noun,62,35,27,0.0004112481938423919,0.00032208623025833537,0.5645161290322581
2837,3267,갓/Noun,62,28,34,0.0003334444814938313,0.00039983118238965764,0.5483870967741935
2838,3268,최민수/Noun,62,33,29,0.00038901856174280313,0.00034429907372442745,0.532258064516129
2839,3273,두고두고/Noun,61,55,6,0.0006335445148382794,8.885137386436837e-05,0.9016393442622952
2840,3274,짱짱맨/Noun,61,52,9,0.0006002000666888963,0.00012217063906350652,0.8524590163934426
2841,3275,관리/Noun,61,11,50,0.0001444926086473269,0.0005775339301183945,0.819672131147541
2842,3276,창피하다/Adjective,61,12,49,0.00015560742469712126,0.0005664275083853486,0.8032786885245902
2843,3277,과도/Noun,61,15,46,0.00018895187284650438,0.0005331082431862101,0.7540983606557377
2844,3278,싸하다/Adjective,61,15,46,0.00018895187284650438,0.0005331082431862101,0.7540983606557377
2845,3279,남친/Noun,61,16,45,0.0002000666888962988,0.0005220018214531642,0.7377049180327869
2846,3280,공연/Noun,61,45,16,0.0005223963543403357,0.00019991559119482882,0.7377049180327869
2847,3281,떠들다/Verb,61,17,44,0.00021118150494609317,0.0005108953997201182,0.7213114754098361
2848,3282,방황/Noun,61,43,18,0.0005001667222407468,0.00022212843466092096,0.7049180327868853
2849,3283,덩어리/Noun,61,18,43,0.0002222963209958875,0.0004997889779870722,0.7049180327868853
2850,3284,태국/Noun,61,18,43,0.0002222963209958875,0.0004997889779870722,0.7049180327868853
2851,3285,밝혀지다/Verb,61,19,42,0.0002334111370456819,0.0004886825562540262,0.6885245901639344
2852,3286,톤/Noun,61,20,41,0.00024452595309547634,0.00047757613452098,0.6721311475409836
2853,3287,타인/Noun,61,41,20,0.0004779370901411582,0.00024434127812701304,0.6721311475409836
2854,3288,음향/Noun,61,20,41,0.00024452595309547634,0.00047757613452098,0.6721311475409836
2855,3289,볼라/Noun,61,21,40,0.00025564076914527065,0.000466469712787934,0.6557377049180327
2856,3290,지내다/Verb,61,40,21,0.0004668222740913638,0.0002554476998600591,0.6557377049180327
2857,3291,택시/Noun,61,23,38,0.00027787040124485944,0.0004442568693218419,0.6229508196721312
2858,3292,특집/Noun,61,23,38,0.00027787040124485944,0.0004442568693218419,0.6229508196721312
2859,3293,여지/Noun,61,37,24,0.0004334778259419807,0.0002887669650591972,0.6065573770491803
2860,3294,층/Noun,61,25,36,0.00030010003334444816,0.0004220440258557498,0.5901639344262295
2861,3295,띄다/Verb,61,25,36,0.00030010003334444816,0.0004220440258557498,0.5901639344262295
2862,3296,엄정화/Noun,61,36,25,0.00042236300989218633,0.0002998733867922433,0.5901639344262295
2863,3297,포드/Noun,61,35,26,0.0004112481938423919,0.00031097980852528933,0.5737704918032787
2864,3298,밝히다/Verb,61,26,35,0.00031121484939424253,0.0004109376041227037,0.5737704918032787
2865,3299,해오다/Verb,61,34,27,0.0004001333777925976,0.00032208623025833537,0.5573770491803278
2866,3300,언어/Noun,61,34,27,0.0004001333777925976,0.00032208623025833537,0.5573770491803278
2867,3301,킬러/Noun,61,27,34,0.00032232966544403684,0.00039983118238965764,0.5573770491803278
2868,3302,정선/Noun,61,33,28,0.00038901856174280313,0.0003331926519913814,0.5409836065573771
2869,3307,OOOO/Alpha,60,2,58,4.445926419917751e-05,0.0006663853039827628,0.9666666666666668
2870,3308,쯧쯧/Noun,60,3,57,5.5574080248971876e-05,0.0006552788822497168,0.95
2871,3309,모욕/Noun,60,4,56,6.668889629876625e-05,0.0006441724605166707,0.9333333333333332
2872,3310,홧팅/Noun,60,56,4,0.0006446593308880737,6.663853039827628e-05,0.9333333333333332
2873,3311,심사/Noun,60,5,55,7.780371234856063e-05,0.0006330660387836247,0.9166666666666666
2874,3312,울림/Noun,60,55,5,0.0006335445148382794,7.774495213132233e-05,0.9166666666666666
2875,3313,고독/Noun,60,51,9,0.000589085250639102,0.00012217063906350652,0.85
2876,3314,깨달음/Noun,60,49,11,0.0005668556185395131,0.0001443834825295986,0.8166666666666667
2877,3315,어째/Noun,60,12,48,0.00015560742469712126,0.0005553210866523023,0.8
2878,3316,상큼/Noun,60,48,12,0.0005557408024897189,0.00015548990426264466,0.8
2879,3317,..!!/Punctuation,60,47,13,0.0005446259864399244,0.0001665963259956907,0.7833333333333333
2880,3318,젊은이/Noun,60,47,13,0.0005446259864399244,0.0001665963259956907,0.7833333333333333
2881,3319,자랑/Noun,60,14,46,0.00017783705679671002,0.0005331082431862101,0.7666666666666667
2882,3320,맙시/Noun,60,15,45,0.00018895187284650438,0.0005220018214531642,0.75
2883,3321,짙다/Adjective,60,44,16,0.0005112815382905413,0.00019991559119482882,0.7333333333333333
2884,3322,ㅂ/KoreanParticle,60,18,42,0.0002222963209958875,0.0004886825562540262,0.7
2885,3323,사과/Noun,60,18,42,0.0002222963209958875,0.0004886825562540262,0.7
2886,3324,떄/Noun,60,41,19,0.0004779370901411582,0.000233234856393967,0.6833333333333333
2887,3325,신비/Noun,60,41,19,0.0004779370901411582,0.000233234856393967,0.6833333333333333
2888,3326,백배/Noun,60,40,20,0.0004668222740913638,0.00024434127812701304,0.6666666666666666
2889,3327,다이하드/Noun,60,21,39,0.00025564076914527065,0.000455363291054888,0.65
2890,3328,에바/Noun,60,22,38,0.000266755585195065,0.0004442568693218419,0.6333333333333333
2891,3329,유익하다/Adjective,60,37,23,0.0004334778259419807,0.00027766054332615115,0.6166666666666667
2892,3330,애니매이션/Noun,60,37,23,0.0004334778259419807,0.00027766054332615115,0.6166666666666667
2893,3331,김혜수/Noun,60,36,24,0.00042236300989218633,0.0002887669650591972,0.6
2894,3332,덮다/Verb,60,24,36,0.0002889852172946538,0.0004220440258557498,0.6
2895,3333,슨/Noun,60,36,24,0.00042236300989218633,0.0002887669650591972,0.6
2896,3334,박하다/Adjective,60,35,25,0.0004112481938423919,0.0002998733867922433,0.5833333333333334
2897,3335,넹/Noun,60,25,35,0.00030010003334444816,0.0004109376041227037,0.5833333333333334
2898,3336,무간도/Noun,60,25,35,0.00030010003334444816,0.0004109376041227037,0.5833333333333334
2899,3337,조선/Noun,60,25,35,0.00030010003334444816,0.0004109376041227037,0.5833333333333334
2900,3338,주위/Noun,60,34,26,0.0004001333777925976,0.00031097980852528933,0.5666666666666667
2901,3339,인권/Noun,60,34,26,0.0004001333777925976,0.00031097980852528933,0.5666666666666667
2902,3340,집다/Verb,60,26,34,0.00031121484939424253,0.00039983118238965764,0.5666666666666667
2903,3341,도둑/Noun,60,27,33,0.00032232966544403684,0.00038872476065661166,0.55
2904,3342,자본/Noun,60,28,32,0.0003334444814938313,0.0003776183389235656,0.5333333333333333
2905,3343,혹/Noun,60,28,32,0.0003334444814938313,0.0003776183389235656,0.5333333333333333
2906,3344,차별/Noun,60,32,28,0.00037790374569300877,0.0003331926519913814,0.5333333333333333
2907,3345,침/Noun,60,28,32,0.0003334444814938313,0.0003776183389235656,0.5333333333333333
2908,3350,볼일/Noun,59,3,56,5.5574080248971876e-05,0.0006441724605166707,0.9491525423728814
2909,3351,미달/Noun,59,4,55,6.668889629876625e-05,0.0006330660387836247,0.9322033898305084
2910,3352,거북하다/Adjective,59,5,54,7.780371234856063e-05,0.0006219596170505788,0.9152542372881356
2911,3353,군더더기/Noun,59,54,5,0.0006224296987884852,7.774495213132233e-05,0.9152542372881356
2912,3354,bad/Alpha,59,5,54,7.780371234856063e-05,0.0006219596170505788,0.9152542372881356
2913,3355,모독/Noun,59,7,52,0.0001000333444481494,0.0005997467735844866,0.8813559322033898
2914,3356,폼/Noun,59,11,48,0.0001444926086473269,0.0005553210866523023,0.8135593220338984
2915,3357,먹기/Noun,59,11,48,0.0001444926086473269,0.0005553210866523023,0.8135593220338984
2916,3358,천사/Noun,59,48,11,0.0005557408024897189,0.0001443834825295986,0.8135593220338984
2917,3359,부담/Noun,59,46,13,0.00053351117039013,0.0001665963259956907,0.7796610169491526
2918,3360,엔딩크레딧/Noun,59,46,13,0.00053351117039013,0.0001665963259956907,0.7796610169491526
2919,3361,누님/Noun,59,45,14,0.0005223963543403357,0.00017770274772873674,0.7627118644067796
2920,3362,칠/Noun,59,14,45,0.00017783705679671002,0.0005220018214531642,0.7627118644067796
2921,3363,짓/VerbPrefix,59,15,44,0.00018895187284650438,0.0005108953997201182,0.7457627118644068
2922,3364,반감/Noun,59,15,44,0.00018895187284650438,0.0005108953997201182,0.7457627118644068
2923,3365,성형/Noun,59,16,43,0.0002000666888962988,0.0004997889779870722,0.7288135593220338
2924,3366,뉴스/Noun,59,17,42,0.00021118150494609317,0.0004886825562540262,0.7118644067796609
2925,3367,떡밥/Noun,59,18,41,0.0002222963209958875,0.00047757613452098,0.6949152542372882
2926,3368,인연/Noun,59,40,19,0.0004668222740913638,0.000233234856393967,0.6779661016949152
2927,3369,고작/Noun,59,19,40,0.0002334111370456819,0.000466469712787934,0.6779661016949152
2928,3370,눈치/Noun,59,19,40,0.0002334111370456819,0.000466469712787934,0.6779661016949152
2929,3371,찾아오다/Verb,59,38,21,0.000444592641991775,0.0002554476998600591,0.6440677966101694
2930,3372,토니/Noun,59,37,22,0.0004334778259419807,0.00026655412159310506,0.6271186440677966
2931,3373,스콧/Noun,59,37,22,0.0004334778259419807,0.00026655412159310506,0.6271186440677966
2932,3374,테이큰/Noun,59,36,23,0.00042236300989218633,0.00027766054332615115,0.6101694915254238
2933,3375,리기/Noun,59,36,23,0.00042236300989218633,0.00027766054332615115,0.6101694915254238
2934,3376,밖에는/Josa,59,24,35,0.0002889852172946538,0.0004109376041227037,0.5932203389830508
2935,3377,스파이더맨/Noun,59,35,24,0.0004112481938423919,0.0002887669650591972,0.5932203389830508
2936,3378,나루토/Noun,59,35,24,0.0004112481938423919,0.0002887669650591972,0.5932203389830508
2937,3379,그려지다/Verb,59,35,24,0.0004112481938423919,0.0002887669650591972,0.5932203389830508
2938,3380,아이유/Noun,59,34,25,0.0004001333777925976,0.0002998733867922433,0.576271186440678
2939,3381,뒤지다/Verb,59,25,34,0.00030010003334444816,0.00039983118238965764,0.576271186440678
2940,3382,박평/Noun,59,34,25,0.0004001333777925976,0.0002998733867922433,0.576271186440678
2941,3383,기사/Noun,59,25,34,0.00030010003334444816,0.00039983118238965764,0.576271186440678
2942,3384,버스/Noun,59,33,26,0.00038901856174280313,0.00031097980852528933,0.559322033898305
2943,3385,흔들리다/Verb,59,26,33,0.00031121484939424253,0.00038872476065661166,0.559322033898305
2944,3386,불가능하다/Adjective,59,26,33,0.00031121484939424253,0.00038872476065661166,0.559322033898305
2945,3387,쓰이다/Verb,59,27,32,0.00032232966544403684,0.0003776183389235656,0.5423728813559322
2946,3388,징/Noun,59,27,32,0.00032232966544403684,0.0003776183389235656,0.5423728813559322
2947,3389,클라스/Noun,59,32,27,0.00037790374569300877,0.00032208623025833537,0.5423728813559322
2948,3390,던/Noun,59,27,32,0.00032232966544403684,0.0003776183389235656,0.5423728813559322
2949,3395,새록새록/Noun,58,57,1,0.0006557741469378681,3.331926519913814e-05,0.9827586206896552
2950,3396,우롱/Noun,58,3,55,5.5574080248971876e-05,0.0006330660387836247,0.9482758620689656
2951,3397,개똥/Noun,58,4,54,6.668889629876625e-05,0.0006219596170505788,0.9310344827586208
2952,3398,진영화/Noun,58,53,5,0.0006113148827386907,7.774495213132233e-05,0.913793103448276
2953,3399,아기자기하다/Adjective,58,51,7,0.000589085250639102,9.995779559741441e-05,0.8793103448275862
2954,3400,렉/Noun,58,8,50,0.00011114816049794375,0.0005775339301183945,0.8620689655172413
2955,3401,기쁘다/Adjective,58,49,9,0.0005668556185395131,0.00012217063906350652,0.8448275862068966
2956,3402,남고/Noun,58,48,10,0.0005557408024897189,0.00013327706079655256,0.8275862068965517
2957,3403,문득/Noun,58,47,11,0.0005446259864399244,0.0001443834825295986,0.8103448275862069
2958,3404,성장하다/Adjective,58,44,14,0.0005112815382905413,0.00017770274772873674,0.7586206896551724
2959,3405,향기/Noun,58,44,14,0.0005112815382905413,0.00017770274772873674,0.7586206896551724
2960,3406,왕조현/Noun,58,43,15,0.0005001667222407468,0.0001888091694617828,0.7413793103448276
2961,3407,타이틀/Noun,58,15,43,0.00018895187284650438,0.0004997889779870722,0.7413793103448276
2962,3408,사이코/Noun,58,15,43,0.00018895187284650438,0.0004997889779870722,0.7413793103448276
2963,3409,벌/Noun,58,16,42,0.0002000666888962988,0.0004886825562540262,0.7241379310344828
2964,3410,기승/Noun,58,16,42,0.0002000666888962988,0.0004886825562540262,0.7241379310344828
2965,3411,습/Noun,58,41,17,0.0004779370901411582,0.0002110220129278749,0.7068965517241379
2966,3412,레이첼/Noun,58,40,18,0.0004668222740913638,0.00022212843466092096,0.6896551724137931
2967,3413,영활/Noun,58,18,40,0.0002222963209958875,0.000466469712787934,0.6896551724137931
2968,3414,".""/Punctuation",58,40,18,0.0004668222740913638,0.00022212843466092096,0.6896551724137931
2969,3415,디테/Noun,58,39,19,0.00045570745804156943,0.000233234856393967,0.6724137931034483
2970,3416,썩/Noun,58,19,39,0.0002334111370456819,0.000455363291054888,0.6724137931034483
2971,3417,피곤하다/Adjective,58,20,38,0.00024452595309547634,0.0004442568693218419,0.6551724137931034
2972,3418,어떠하다/Adjective,58,38,20,0.000444592641991775,0.00024434127812701304,0.6551724137931034
2973,3419,양/Suffix,58,37,21,0.0004334778259419807,0.0002554476998600591,0.6379310344827587
2974,3420,...(/Punctuation,58,21,37,0.00025564076914527065,0.0004331504475887958,0.6379310344827587
2975,3421,지켜보다/Verb,58,37,21,0.0004334778259419807,0.0002554476998600591,0.6379310344827587
2976,3422,평화/Noun,58,36,22,0.00042236300989218633,0.00026655412159310506,0.6206896551724138
2977,3423,합치다/Verb,58,23,35,0.00027787040124485944,0.0004109376041227037,0.603448275862069
2978,3424,황정민/Noun,58,35,23,0.0004112481938423919,0.00027766054332615115,0.603448275862069
2979,3425,시골/Noun,58,34,24,0.0004001333777925976,0.0002887669650591972,0.5862068965517241
2980,3426,해외/Noun,58,25,33,0.00030010003334444816,0.00038872476065661166,0.5689655172413793
2981,3427,김수현/Noun,58,32,26,0.00037790374569300877,0.00031097980852528933,0.5517241379310345
2982,3428,까맣다/Adjective,58,32,26,0.00037790374569300877,0.00031097980852528933,0.5517241379310345
2983,3429,손예진/Noun,58,27,31,0.00032232966544403684,0.00036651191719051963,0.5344827586206896
2984,3430,한효주/Noun,58,27,31,0.00032232966544403684,0.00036651191719051963,0.5344827586206896
2985,3431,제시카/Noun,58,27,31,0.00032232966544403684,0.00036651191719051963,0.5344827586206896
2986,3432,맺다/Verb,58,31,27,0.00036678892964321435,0.00032208623025833537,0.5344827586206896
2987,3436,반도/Noun,57,2,55,4.445926419917751e-05,0.0006330660387836247,0.9649122807017544
2988,3437,커녕/Noun,57,3,54,5.5574080248971876e-05,0.0006219596170505788,0.9473684210526316
2989,3438,헛웃음/Noun,57,4,53,6.668889629876625e-05,0.0006108531953175326,0.9298245614035088
2990,3439,차분하다/Adjective,57,48,9,0.0005557408024897189,0.00012217063906350652,0.8421052631578947
2991,3440,어지간하다/Adjective,57,11,46,0.0001444926086473269,0.0005331082431862101,0.8070175438596491
2992,3441,압/Noun,57,46,11,0.00053351117039013,0.0001443834825295986,0.8070175438596491
2993,3442,학창시절/Noun,57,44,13,0.0005112815382905413,0.0001665963259956907,0.7719298245614035
2994,3443,더욱더/Noun,57,44,13,0.0005112815382905413,0.0001665963259956907,0.7719298245614035
2995,3444,주온/Noun,57,14,43,0.00017783705679671002,0.0004997889779870722,0.7543859649122807
2996,3445,적극/Noun,57,42,15,0.0004890519061909527,0.0001888091694617828,0.7368421052631579
2997,3446,새삼/Noun,57,41,16,0.0004779370901411582,0.00019991559119482882,0.7192982456140351
2998,3447,환자/Noun,57,18,39,0.0002222963209958875,0.000455363291054888,0.6842105263157895
2999,3448,쎄다/Adjective,57,18,39,0.0002222963209958875,0.000455363291054888,0.6842105263157895
3000,3449,미장센/Noun,57,38,19,0.000444592641991775,0.000233234856393967,0.6666666666666666
3001,3450,각각/Noun,57,38,19,0.000444592641991775,0.000233234856393967,0.6666666666666666
3002,3451,대학생/Noun,57,20,37,0.00024452595309547634,0.0004331504475887958,0.6491228070175439
3003,3452,겨울왕국/Noun,57,37,20,0.0004334778259419807,0.00024434127812701304,0.6491228070175439
3004,3453,내려가다/Verb,57,20,37,0.00024452595309547634,0.0004331504475887958,0.6491228070175439
3005,3454,청년/Noun,57,37,20,0.0004334778259419807,0.00024434127812701304,0.6491228070175439
3006,3455,5년/Number,57,36,21,0.00042236300989218633,0.0002554476998600591,0.631578947368421
3007,3456,T/Alpha,57,36,21,0.00042236300989218633,0.0002554476998600591,0.631578947368421
3008,3457,스파이/Noun,57,36,21,0.00042236300989218633,0.0002554476998600591,0.631578947368421
3009,3458,오지/Noun,57,22,35,0.000266755585195065,0.0004109376041227037,0.6140350877192983
3010,3459,신세계/Noun,57,35,22,0.0004112481938423919,0.00026655412159310506,0.6140350877192983
3011,3460,송승헌/Noun,57,23,34,0.00027787040124485944,0.00039983118238965764,0.5964912280701754
3012,3461,쿨하다/Adjective,57,34,23,0.0004001333777925976,0.00027766054332615115,0.5964912280701754
3013,3462,색깔/Noun,57,34,23,0.0004001333777925976,0.00027766054332615115,0.5964912280701754
3014,3463,질문/Noun,57,33,24,0.00038901856174280313,0.0002887669650591972,0.5789473684210527
3015,3464,대학/Noun,57,24,33,0.0002889852172946538,0.00038872476065661166,0.5789473684210527
3016,3465,이정재/Noun,57,33,24,0.00038901856174280313,0.0002887669650591972,0.5789473684210527
3017,3466,이나/Foreign,57,25,32,0.00030010003334444816,0.0003776183389235656,0.5614035087719298
3018,3467,장애/Noun,57,25,32,0.00030010003334444816,0.0003776183389235656,0.5614035087719298
3019,3468,무리다/Adjective,57,25,32,0.00030010003334444816,0.0003776183389235656,0.5614035087719298
3020,3469,60년/Number,57,26,31,0.00031121484939424253,0.00036651191719051963,0.543859649122807
3021,3470,롱/Noun,57,31,26,0.00036678892964321435,0.00031097980852528933,0.543859649122807
3022,3471,재현/Noun,57,31,26,0.00036678892964321435,0.00031097980852528933,0.543859649122807
3023,3472,자라다/Verb,57,31,26,0.00036678892964321435,0.00031097980852528933,0.543859649122807
3024,3473,래야/Noun,57,26,31,0.00031121484939424253,0.00036651191719051963,0.543859649122807
3025,3478,원주율/Noun,56,2,54,4.445926419917751e-05,0.0006219596170505788,0.9642857142857144
3026,3479,난국/Noun,56,2,54,4.445926419917751e-05,0.0006219596170505788,0.9642857142857144
3027,3480,묵직하다/Adjective,56,49,7,0.0005668556185395131,9.995779559741441e-05,0.875
3028,3481,오랫동안/Adverb,56,49,7,0.0005668556185395131,9.995779559741441e-05,0.875
3029,3482,손꼽다/Verb,56,45,11,0.0005223963543403357,0.0001443834825295986,0.8035714285714286
3030,3483,절반/Noun,56,11,45,0.0001444926086473269,0.0005220018214531642,0.8035714285714286
3031,3484,비싸다/Adjective,56,11,45,0.0001444926086473269,0.0005220018214531642,0.8035714285714286
3032,3485,아이고/Exclamation,56,12,44,0.00015560742469712126,0.0005108953997201182,0.7857142857142857
3033,3486,에드/Noun,56,44,12,0.0005112815382905413,0.00015548990426264466,0.7857142857142857
3034,3487,!~/Punctuation,56,43,13,0.0005001667222407468,0.0001665963259956907,0.7678571428571429
3035,3488,의견/Noun,56,15,41,0.00018895187284650438,0.00047757613452098,0.7321428571428571
3036,3489,덤/Noun,56,40,16,0.0004668222740913638,0.00019991559119482882,0.7142857142857143
3037,3490,싸이코패스/Noun,56,16,40,0.0002000666888962988,0.000466469712787934,0.7142857142857143
3038,3491,집안/Noun,56,16,40,0.0002000666888962988,0.000466469712787934,0.7142857142857143
3039,3492,귀찮다/Adjective,56,17,39,0.00021118150494609317,0.000455363291054888,0.6964285714285714
3040,3493,유행/Noun,56,17,39,0.00021118150494609317,0.000455363291054888,0.6964285714285714
3041,3494,공식/Noun,56,17,39,0.00021118150494609317,0.000455363291054888,0.6964285714285714
3042,3495,사장/Noun,56,18,38,0.0002222963209958875,0.0004442568693218419,0.6785714285714286
3043,3496,빼놓다/Verb,56,38,18,0.000444592641991775,0.00022212843466092096,0.6785714285714286
3044,3497,방향/Noun,56,18,38,0.0002222963209958875,0.0004442568693218419,0.6785714285714286
3045,3498,영웅본색/Noun,56,19,37,0.0002334111370456819,0.0004331504475887958,0.6607142857142857
3046,3499,대하/Noun,56,37,19,0.0004334778259419807,0.000233234856393967,0.6607142857142857
3047,3500,크레딧/Noun,56,37,19,0.0004334778259419807,0.000233234856393967,0.6607142857142857
3048,3501,펼치다/Verb,56,37,19,0.0004334778259419807,0.000233234856393967,0.6607142857142857
3049,3502,추악하다/Adjective,56,36,20,0.00042236300989218633,0.00024434127812701304,0.6428571428571429
3050,3503,사무라이/Noun,56,20,36,0.00024452595309547634,0.0004220440258557498,0.6428571428571429
3051,3504,잘나다/Adjective,56,20,36,0.00024452595309547634,0.0004220440258557498,0.6428571428571429
3052,3505,주관/Noun,56,20,36,0.00024452595309547634,0.0004220440258557498,0.6428571428571429
3053,3506,고해/Noun,56,20,36,0.00024452595309547634,0.0004220440258557498,0.6428571428571429
3054,3507,유혹/Noun,56,20,36,0.00024452595309547634,0.0004220440258557498,0.6428571428571429
3055,3508,적나라하다/Adjective,56,35,21,0.0004112481938423919,0.0002554476998600591,0.625
3056,3509,장혁/Noun,56,35,21,0.0004112481938423919,0.0002554476998600591,0.625
3057,3510,콜린/Noun,56,35,21,0.0004112481938423919,0.0002554476998600591,0.625
3058,3511,옮기다/Verb,56,22,34,0.000266755585195065,0.00039983118238965764,0.6071428571428571
3059,3512,전지현/Noun,56,22,34,0.000266755585195065,0.00039983118238965764,0.6071428571428571
3060,3513,눕다/Verb,56,22,34,0.000266755585195065,0.00039983118238965764,0.6071428571428571
3061,3514,박찬욱/Noun,56,22,34,0.000266755585195065,0.00039983118238965764,0.6071428571428571
3062,3515,따지다/Verb,56,33,23,0.00038901856174280313,0.00027766054332615115,0.5892857142857143
3063,3516,훔치다/Verb,56,23,33,0.00027787040124485944,0.00038872476065661166,0.5892857142857143
3064,3517,지대/Noun,56,23,33,0.00027787040124485944,0.00038872476065661166,0.5892857142857143
3065,3518,걸이/Noun,56,23,33,0.00027787040124485944,0.00038872476065661166,0.5892857142857143
3066,3519,명/Suffix,56,24,32,0.0002889852172946538,0.0003776183389235656,0.5714285714285714
3067,3520,아바타/Noun,56,32,24,0.00037790374569300877,0.0002887669650591972,0.5714285714285714
3068,3521,회상/Noun,56,31,25,0.00036678892964321435,0.0002998733867922433,0.5535714285714286
3069,3522,공허하다/Adjective,56,31,25,0.00036678892964321435,0.0002998733867922433,0.5535714285714286
3070,3523,애인/Noun,56,26,30,0.00031121484939424253,0.0003554054954574735,0.5357142857142857
3071,3524,엑스맨/Noun,56,30,26,0.00035567411359342004,0.00031097980852528933,0.5357142857142857
3072,3525,왕자/Noun,56,30,26,0.00035567411359342004,0.00031097980852528933,0.5357142857142857
3073,3526,섹시/Noun,56,30,26,0.00035567411359342004,0.00031097980852528933,0.5357142857142857
3074,3532,따스하다/Adjective,55,54,1,0.0006224296987884852,3.331926519913814e-05,0.9818181818181818
3075,3533,만족스럽다/Adjective,55,50,5,0.0005779704345893076,7.774495213132233e-05,0.9090909090909092
3076,3534,흠잡다/Adjective,55,50,5,0.0005779704345893076,7.774495213132233e-05,0.9090909090909092
3077,3535,투성이/Noun,55,6,49,8.891852839835501e-05,0.0005664275083853486,0.8909090909090909
3078,3536,어정쩡하다/Adjective,55,6,49,8.891852839835501e-05,0.0005664275083853486,0.8909090909090909
3079,3537,정화/Noun,55,47,8,0.0005446259864399244,0.00011106421733046048,0.8545454545454545
3080,3538,도망가다/Verb,55,9,46,0.00012226297654773814,0.0005331082431862101,0.8363636363636363
3081,3539,멀쩡하다/Adjective,55,11,44,0.0001444926086473269,0.0005108953997201182,0.8
3082,3540,출현/Noun,55,13,42,0.00016672224074691566,0.0004886825562540262,0.7636363636363637
3083,3541,덜하다/Adjective,55,41,14,0.0004779370901411582,0.00017770274772873674,0.7454545454545455
3084,3542,꼬이다/Adjective,55,15,40,0.00018895187284650438,0.000466469712787934,0.7272727272727273
3085,3543,촌/Noun,55,38,17,0.000444592641991775,0.0002110220129278749,0.6909090909090909
3086,3544,러셀/Noun,55,38,17,0.000444592641991775,0.0002110220129278749,0.6909090909090909
3087,3545,..;/Punctuation,55,17,38,0.00021118150494609317,0.0004442568693218419,0.6909090909090909
3088,3546,하고프다/Verb,55,37,18,0.0004334778259419807,0.00022212843466092096,0.6727272727272727
3089,3547,지독하다/Adjective,55,37,18,0.0004334778259419807,0.00022212843466092096,0.6727272727272727
3090,3548,is/Alpha,55,37,18,0.0004334778259419807,0.00022212843466092096,0.6727272727272727
3091,3549,가식/Noun,55,20,35,0.00024452595309547634,0.0004109376041227037,0.6363636363636364
3092,3550,재방송/Noun,55,35,20,0.0004112481938423919,0.00024434127812701304,0.6363636363636364
3093,3551,다크나이트/Noun,55,35,20,0.0004112481938423919,0.00024434127812701304,0.6363636363636364
3094,3552,끝판/Noun,55,20,35,0.00024452595309547634,0.0004109376041227037,0.6363636363636364
3095,3553,신부/Noun,55,35,20,0.0004112481938423919,0.00024434127812701304,0.6363636363636364
3096,3554,번역/Noun,55,20,35,0.00024452595309547634,0.0004109376041227037,0.6363636363636364
3097,3555,작년/Noun,55,35,20,0.0004112481938423919,0.00024434127812701304,0.6363636363636364
3098,3556,스피드/Noun,55,23,32,0.00027787040124485944,0.0003776183389235656,0.5818181818181818
3099,3557,조지/Noun,55,31,24,0.00036678892964321435,0.0002887669650591972,0.5636363636363636
3100,3558,어딘가/Noun,55,31,24,0.00036678892964321435,0.0002887669650591972,0.5636363636363636
3101,3559,기타/Noun,55,30,25,0.00035567411359342004,0.0002998733867922433,0.5454545454545454
3102,3560,폰/Noun,55,25,30,0.00030010003334444816,0.0003554054954574735,0.5454545454545454
3103,3561,대상/Noun,55,25,30,0.00030010003334444816,0.0003554054954574735,0.5454545454545454
3104,3562,마디/Noun,55,25,30,0.00030010003334444816,0.0003554054954574735,0.5454545454545454
3105,3563,픽션/Noun,55,25,30,0.00030010003334444816,0.0003554054954574735,0.5454545454545454
3106,3564,람보/Noun,55,30,25,0.00035567411359342004,0.0002998733867922433,0.5454545454545454
3107,3568,외로움/Noun,54,52,2,0.0006002000666888963,4.4425686932184186e-05,0.9629629629629628
3108,3569,흑역사/Noun,54,2,52,4.445926419917751e-05,0.0005997467735844866,0.9629629629629628
3109,3570,개꿀잼/Noun,54,51,3,0.000589085250639102,5.553210866523024e-05,0.9444444444444444
3110,3571,쪽팔리다/Verb,54,6,48,8.891852839835501e-05,0.0005553210866523023,0.8888888888888888
3111,3572,3분/Number,54,8,46,0.00011114816049794375,0.0005331082431862101,0.8518518518518519
3112,3573,주행/Noun,54,46,8,0.00053351117039013,0.00011106421733046048,0.8518518518518519
3113,3574,온갖/Noun,54,9,45,0.00012226297654773814,0.0005220018214531642,0.8333333333333334
3114,3575,대역/Noun,54,10,44,0.0001333777925975325,0.0005108953997201182,0.8148148148148148
3115,3576,색채/Noun,54,43,11,0.0005001667222407468,0.0001443834825295986,0.7962962962962963
3116,3577,개발/Noun,54,12,42,0.00015560742469712126,0.0004886825562540262,0.7777777777777778
3117,3578,전라도/Noun,54,12,42,0.00015560742469712126,0.0004886825562540262,0.7777777777777778
3118,3579,차마/Noun,54,13,41,0.00016672224074691566,0.00047757613452098,0.7592592592592593
3119,3580,구경/Noun,54,13,41,0.00016672224074691566,0.00047757613452098,0.7592592592592593
3120,3581,관람객/Noun,54,14,40,0.00017783705679671002,0.000466469712787934,0.7407407407407407
3121,3582,혀/Noun,54,14,40,0.00017783705679671002,0.000466469712787934,0.7407407407407407
3122,3583,일찍/Noun,54,39,15,0.00045570745804156943,0.0001888091694617828,0.7222222222222222
3123,3584,피디/Noun,54,15,39,0.00018895187284650438,0.000455363291054888,0.7222222222222222
3124,3585,본성/Noun,54,38,16,0.000444592641991775,0.00019991559119482882,0.7037037037037037
3125,3586,말리다/Verb,54,16,38,0.0002000666888962988,0.0004442568693218419,0.7037037037037037
3126,3587,절절/Noun,54,38,16,0.000444592641991775,0.00019991559119482882,0.7037037037037037
3127,3588,기용/Noun,54,16,38,0.0002000666888962988,0.0004442568693218419,0.7037037037037037
3128,3589,살기/Noun,54,38,16,0.000444592641991775,0.00019991559119482882,0.7037037037037037
3129,3590,크리스/Noun,54,38,16,0.000444592641991775,0.00019991559119482882,0.7037037037037037
3130,3591,팍팍/Adverb,54,17,37,0.00021118150494609317,0.0004331504475887958,0.6851851851851852
3131,3592,거야/Eomi,54,17,37,0.00021118150494609317,0.0004331504475887958,0.6851851851851852
3132,3593,차태현/Noun,54,37,17,0.0004334778259419807,0.0002110220129278749,0.6851851851851852
3133,3594,그나저나/Adverb,54,35,19,0.0004112481938423919,0.000233234856393967,0.6481481481481481
3134,3595,권/Noun,54,35,19,0.0004112481938423919,0.000233234856393967,0.6481481481481481
3135,3596,가기/Noun,54,20,34,0.00024452595309547634,0.00039983118238965764,0.6296296296296297
3136,3597,잭슨/Noun,54,34,20,0.0004001333777925976,0.00024434127812701304,0.6296296296296297
3137,3598,거대하다/Adjective,54,34,20,0.0004001333777925976,0.00024434127812701304,0.6296296296296297
3138,3599,버그/Noun,54,34,20,0.0004001333777925976,0.00024434127812701304,0.6296296296296297
3139,3600,밟다/Verb,54,21,33,0.00025564076914527065,0.00038872476065661166,0.6111111111111112
3140,3601,상관/Noun,54,21,33,0.00025564076914527065,0.00038872476065661166,0.6111111111111112
3141,3602,격/Noun,54,21,33,0.00025564076914527065,0.00038872476065661166,0.6111111111111112
3142,3603,다운로드/Noun,54,21,33,0.00025564076914527065,0.00038872476065661166,0.6111111111111112
3143,3604,밀리다/Verb,54,22,32,0.000266755585195065,0.0003776183389235656,0.5925925925925926
3144,3605,가안/Noun,54,22,32,0.000266755585195065,0.0003776183389235656,0.5925925925925926
3145,3606,호감/Noun,54,32,22,0.00037790374569300877,0.00026655412159310506,0.5925925925925926
3146,3607,마블/Noun,54,31,23,0.00036678892964321435,0.00027766054332615115,0.5740740740740741
3147,3608,막상/Noun,54,24,30,0.0002889852172946538,0.0003554054954574735,0.5555555555555556
3148,3609,픽사/Noun,54,25,29,0.00030010003334444816,0.00034429907372442745,0.5370370370370371
3149,3610,만큼의/Josa,54,29,25,0.0003445592975436257,0.0002998733867922433,0.5370370370370371
3150,3617,헛/Noun,53,5,48,7.780371234856063e-05,0.0005553210866523023,0.9056603773584906
3151,3618,팝콘/Noun,53,6,47,8.891852839835501e-05,0.0005442146649192564,0.8867924528301887
3152,3619,흐지부지/Noun,53,6,47,8.891852839835501e-05,0.0005442146649192564,0.8867924528301887
3153,3620,납치/Noun,53,7,46,0.0001000333444481494,0.0005331082431862101,0.8679245283018868
3154,3621,오유/Noun,53,7,46,0.0001000333444481494,0.0005331082431862101,0.8679245283018868
3155,3622,서정/Noun,53,45,8,0.0005223963543403357,0.00011106421733046048,0.8490566037735849
3156,3623,c/Alpha,53,8,45,0.00011114816049794375,0.0005220018214531642,0.8490566037735849
3157,3624,^^*/Punctuation,53,45,8,0.0005223963543403357,0.00011106421733046048,0.8490566037735849
3158,3625,클라라/Noun,53,9,44,0.00012226297654773814,0.0005108953997201182,0.8301886792452831
3159,3626,최민식/Noun,53,42,11,0.0004890519061909527,0.0001443834825295986,0.7924528301886793
3160,3627,벌리다/Verb,53,11,42,0.0001444926086473269,0.0004886825562540262,0.7924528301886793
3161,3628,살인자/Noun,53,11,42,0.0001444926086473269,0.0004886825562540262,0.7924528301886793
3162,3629,옛/Modifier,53,41,12,0.0004779370901411582,0.00015548990426264466,0.7735849056603774
3163,3630,나머진/Noun,53,12,41,0.00015560742469712126,0.00047757613452098,0.7735849056603774
3164,3631,눈요기/Noun,53,12,41,0.00015560742469712126,0.00047757613452098,0.7735849056603774
3165,3632,깨끗하다/Adjective,53,40,13,0.0004668222740913638,0.0001665963259956907,0.7547169811320755
3166,3633,재치/Noun,53,39,14,0.00045570745804156943,0.00017770274772873674,0.7358490566037735
3167,3634,한국어/Noun,53,14,39,0.00017783705679671002,0.000455363291054888,0.7358490566037735
3168,3635,께서/Josa,53,38,15,0.000444592641991775,0.0001888091694617828,0.7169811320754716
3169,3636,이외/Noun,53,15,38,0.00018895187284650438,0.0004442568693218419,0.7169811320754716
3170,3637,조차도/Josa,53,15,38,0.00018895187284650438,0.0004442568693218419,0.7169811320754716
3171,3638,정석/Noun,53,37,16,0.0004334778259419807,0.00019991559119482882,0.6981132075471698
3172,3639,movie/Alpha,53,37,16,0.0004334778259419807,0.00019991559119482882,0.6981132075471698
3173,3640,틀림없다/Adjective,53,37,16,0.0004334778259419807,0.00019991559119482882,0.6981132075471698
3174,3641,네/Modifier,53,16,37,0.0002000666888962988,0.0004331504475887958,0.6981132075471698
3175,3642,예고/Noun,53,16,37,0.0002000666888962988,0.0004331504475887958,0.6981132075471698
3176,3643,저렇다/Adjective,53,16,37,0.0002000666888962988,0.0004331504475887958,0.6981132075471698
3177,3644,멘탈/Noun,53,16,37,0.0002000666888962988,0.0004331504475887958,0.6981132075471698
3178,3645,1분/Number,53,17,36,0.00021118150494609317,0.0004220440258557498,0.6792452830188679
3179,3646,무의미하다/Adjective,53,17,36,0.00021118150494609317,0.0004220440258557498,0.6792452830188679
3180,3647,★/Foreign,53,35,18,0.0004112481938423919,0.00022212843466092096,0.660377358490566
3181,3648,잘알다/Verb,53,35,18,0.0004112481938423919,0.00022212843466092096,0.660377358490566
3182,3649,부터/Foreign,53,35,18,0.0004112481938423919,0.00022212843466092096,0.660377358490566
3183,3650,레옹/Noun,53,18,35,0.0002222963209958875,0.0004109376041227037,0.660377358490566
3184,3651,신도/Noun,53,18,35,0.0002222963209958875,0.0004109376041227037,0.660377358490566
3185,3652,볼걸/Noun,53,18,35,0.0002222963209958875,0.0004109376041227037,0.660377358490566
3186,3653,일리/Noun,53,34,19,0.0004001333777925976,0.000233234856393967,0.6415094339622641
3187,3654,긴박/Noun,53,19,34,0.0002334111370456819,0.00039983118238965764,0.6415094339622641
3188,3655,이의/Noun,53,33,20,0.00038901856174280313,0.00024434127812701304,0.6226415094339622
3189,3656,꼽히다/Verb,53,33,20,0.00038901856174280313,0.00024434127812701304,0.6226415094339622
3190,3657,태도/Noun,53,20,33,0.00024452595309547634,0.00038872476065661166,0.6226415094339622
3191,3658,감옥/Noun,53,21,32,0.00025564076914527065,0.0003776183389235656,0.6037735849056604
3192,3659,할배/Noun,53,21,32,0.00025564076914527065,0.0003776183389235656,0.6037735849056604
3193,3660,사귀다/Verb,53,21,32,0.00025564076914527065,0.0003776183389235656,0.6037735849056604
3194,3661,신데렐라/Noun,53,22,31,0.000266755585195065,0.00036651191719051963,0.5849056603773585
3195,3662,꺼내다/Verb,53,31,22,0.00036678892964321435,0.00026655412159310506,0.5849056603773585
3196,3663,작전/Noun,53,22,31,0.000266755585195065,0.00036651191719051963,0.5849056603773585
3197,3664,공원/Noun,53,22,31,0.000266755585195065,0.00036651191719051963,0.5849056603773585
3198,3665,어서/Noun,53,31,22,0.00036678892964321435,0.00026655412159310506,0.5849056603773585
3199,3666,프리/Noun,53,31,22,0.00036678892964321435,0.00026655412159310506,0.5849056603773585
3200,3667,당/Noun,53,30,23,0.00035567411359342004,0.00027766054332615115,0.5660377358490566
3201,3668,꾸미다/Verb,53,30,23,0.00035567411359342004,0.00027766054332615115,0.5660377358490566
3202,3669,늑대/Noun,53,24,29,0.0002889852172946538,0.00034429907372442745,0.5471698113207547
3203,3670,마법/Noun,53,29,24,0.0003445592975436257,0.0002887669650591972,0.5471698113207547
3204,3671,반지/Noun,53,29,24,0.0003445592975436257,0.0002887669650591972,0.5471698113207547
3205,3679,...;;/Punctuation,52,4,48,6.668889629876625e-05,0.0005553210866523023,0.9230769230769232
3206,3680,ㅗ/KoreanParticle,52,7,45,0.0001000333444481494,0.0005220018214531642,0.8653846153846154
3207,3681,엉터리/Noun,52,7,45,0.0001000333444481494,0.0005220018214531642,0.8653846153846154
3208,3682,성찰/Noun,52,43,9,0.0005001667222407468,0.00012217063906350652,0.8269230769230769
3209,3683,모방/Noun,52,10,42,0.0001333777925975325,0.0004886825562540262,0.8076923076923077
3210,3684,매주/Adverb,52,42,10,0.0004890519061909527,0.00013327706079655256,0.8076923076923077
3211,3685,파라/Noun,52,11,41,0.0001444926086473269,0.00047757613452098,0.7884615384615384
3212,3686,더니/Noun,52,11,41,0.0001444926086473269,0.00047757613452098,0.7884615384615384
3213,3687,안남/Noun,52,13,39,0.00016672224074691566,0.000455363291054888,0.75
3214,3688,어쩌다/Adverb,52,13,39,0.00016672224074691566,0.000455363291054888,0.75
3215,3689,노튼/Noun,52,38,14,0.000444592641991775,0.00017770274772873674,0.7307692307692307
3216,3690,베이/Noun,52,38,14,0.000444592641991775,0.00017770274772873674,0.7307692307692307
3217,3691,!?/Punctuation,52,15,37,0.00018895187284650438,0.0004331504475887958,0.7115384615384616
3218,3692,펼쳐지다/Verb,52,37,15,0.0004334778259419807,0.0001888091694617828,0.7115384615384616
3219,3693,고어/Noun,52,16,36,0.0002000666888962988,0.0004220440258557498,0.6923076923076923
3220,3694,어딜/Adverb,52,17,35,0.00021118150494609317,0.0004109376041227037,0.6730769230769231
3221,3695,빨갛다/Adjective,52,35,17,0.0004112481938423919,0.0002110220129278749,0.6730769230769231
3222,3696,수없이/Adverb,52,17,35,0.00021118150494609317,0.0004109376041227037,0.6730769230769231
3223,3697,몇개/Noun,52,18,34,0.0002222963209958875,0.00039983118238965764,0.6538461538461539
3224,3698,조명/Noun,52,34,18,0.0004001333777925976,0.00022212843466092096,0.6538461538461539
3225,3699,주네/Noun,52,34,18,0.0004001333777925976,0.00022212843466092096,0.6538461538461539
3226,3700,금지/Noun,52,19,33,0.0002334111370456819,0.00038872476065661166,0.6346153846153846
3227,3701,예수/Noun,52,19,33,0.0002334111370456819,0.00038872476065661166,0.6346153846153846
3228,3702,커피/Noun,52,33,19,0.00038901856174280313,0.000233234856393967,0.6346153846153846
3229,3703,불만/Noun,52,20,32,0.00024452595309547634,0.0003776183389235656,0.6153846153846154
3230,3704,장이/Suffix,52,20,32,0.00024452595309547634,0.0003776183389235656,0.6153846153846154
3231,3705,헉/Adverb,52,20,32,0.00024452595309547634,0.0003776183389235656,0.6153846153846154
3232,3706,MBC/Alpha,52,20,32,0.00024452595309547634,0.0003776183389235656,0.6153846153846154
3233,3707,성유리/Noun,52,32,20,0.00037790374569300877,0.00024434127812701304,0.6153846153846154
3234,3708,일수/Noun,52,31,21,0.00036678892964321435,0.0002554476998600591,0.5961538461538461
3235,3709,님들/Noun,52,21,31,0.00025564076914527065,0.00036651191719051963,0.5961538461538461
3236,3710,여유/Noun,52,31,21,0.00036678892964321435,0.0002554476998600591,0.5961538461538461
3237,3711,국제/Noun,52,30,22,0.00035567411359342004,0.00026655412159310506,0.5769230769230769
3238,3712,인도영화/Noun,52,30,22,0.00035567411359342004,0.00026655412159310506,0.5769230769230769
3239,3713,라스/Noun,52,29,23,0.0003445592975436257,0.00027766054332615115,0.5576923076923077
3240,3714,경악/Noun,52,23,29,0.00027787040124485944,0.00034429907372442745,0.5576923076923077
3241,3715,극본/Noun,52,23,29,0.00027787040124485944,0.00034429907372442745,0.5576923076923077
3242,3716,또는/Adverb,52,24,28,0.0002889852172946538,0.0003331926519913814,0.5384615384615384
3243,3717,실상/Noun,52,24,28,0.0002889852172946538,0.0003331926519913814,0.5384615384615384
3244,3718,비참하다/Adjective,52,28,24,0.0003334444814938313,0.0002887669650591972,0.5384615384615384
3245,3721,어수선하다/Adjective,51,3,48,5.5574080248971876e-05,0.0005553210866523023,0.9411764705882352
3246,3722,저급하다/Adjective,51,5,46,7.780371234856063e-05,0.0005331082431862101,0.9019607843137256
3247,3723,씨발/Noun,51,5,46,7.780371234856063e-05,0.0005331082431862101,0.9019607843137256
3248,3724,가관/Noun,51,6,45,8.891852839835501e-05,0.0005220018214531642,0.8823529411764706
3249,3725,불필요하다/Adjective,51,7,44,0.0001000333444481494,0.0005108953997201182,0.8627450980392157
3250,3726,.!/Punctuation,51,44,7,0.0005112815382905413,9.995779559741441e-05,0.8627450980392157
3251,3727,양반/Noun,51,8,43,0.00011114816049794375,0.0004997889779870722,0.8431372549019608
3252,3728,파이팅/Noun,51,42,9,0.0004890519061909527,0.00012217063906350652,0.8235294117647058
3253,3729,뚝뚝/Noun,51,9,42,0.00012226297654773814,0.0004886825562540262,0.8235294117647058
3254,3730,땡/Noun,51,9,42,0.00012226297654773814,0.0004886825562540262,0.8235294117647058
3255,3731,모두/Modifier,51,40,11,0.0004668222740913638,0.0001443834825295986,0.7843137254901961
3256,3732,잠자다/Verb,51,11,40,0.0001444926086473269,0.000466469712787934,0.7843137254901961
3257,3733,덜덜/Noun,51,40,11,0.0004668222740913638,0.0001443834825295986,0.7843137254901961
3258,3734,먼지/Noun,51,12,39,0.00015560742469712126,0.000455363291054888,0.7647058823529411
3259,3735,임청하/Noun,51,39,12,0.00045570745804156943,0.00015548990426264466,0.7647058823529411
3260,3736,다니엘/Noun,51,39,12,0.00045570745804156943,0.00015548990426264466,0.7647058823529411
3261,3737,불과하다/Adjective,51,14,37,0.00017783705679671002,0.0004331504475887958,0.7254901960784313
3262,3738,피식/Adverb,51,15,36,0.00018895187284650438,0.0004220440258557498,0.7058823529411765
3263,3739,텐데/Eomi,51,16,35,0.0002000666888962988,0.0004109376041227037,0.6862745098039216
3264,3740,마틴/Noun,51,35,16,0.0004112481938423919,0.00019991559119482882,0.6862745098039216
3265,3741,첩보/Noun,51,35,16,0.0004112481938423919,0.00019991559119482882,0.6862745098039216
3266,3742,취급/Noun,51,17,34,0.00021118150494609317,0.00039983118238965764,0.6666666666666666
3267,3743,허구/Noun,51,18,33,0.0002222963209958875,0.00038872476065661166,0.6470588235294118
3268,3744,vs/Alpha,51,18,33,0.0002222963209958875,0.00038872476065661166,0.6470588235294118
3269,3745,흔적/Noun,51,18,33,0.0002222963209958875,0.00038872476065661166,0.6470588235294118
3270,3746,7.5/Number,51,33,18,0.00038901856174280313,0.00022212843466092096,0.6470588235294118
3271,3747,리스/Noun,51,32,19,0.00037790374569300877,0.000233234856393967,0.6274509803921569
3272,3748,이은주/Noun,51,32,19,0.00037790374569300877,0.000233234856393967,0.6274509803921569
3273,3749,7년/Number,51,31,20,0.00036678892964321435,0.00024434127812701304,0.6078431372549019
3274,3750,생기/Noun,51,20,31,0.00024452595309547634,0.00036651191719051963,0.6078431372549019
3275,3751,와중/Noun,51,20,31,0.00024452595309547634,0.00036651191719051963,0.6078431372549019
3276,3752,장치/Noun,51,30,21,0.00035567411359342004,0.0002554476998600591,0.5882352941176471
3277,3753,밖엔/Josa,51,21,30,0.00025564076914527065,0.0003554054954574735,0.5882352941176471
3278,3754,후기/Noun,51,21,30,0.00025564076914527065,0.0003554054954574735,0.5882352941176471
3279,3755,체험/Noun,51,21,30,0.00025564076914527065,0.0003554054954574735,0.5882352941176471
3280,3756,파악/Noun,51,21,30,0.00025564076914527065,0.0003554054954574735,0.5882352941176471
3281,3757,간/Foreign,51,22,29,0.000266755585195065,0.00034429907372442745,0.5686274509803921
3282,3758,특/Noun,51,29,22,0.0003445592975436257,0.00026655412159310506,0.5686274509803921
3283,3759,누/Noun,51,22,29,0.000266755585195065,0.00034429907372442745,0.5686274509803921
3284,3760,장동건/Noun,51,22,29,0.000266755585195065,0.00034429907372442745,0.5686274509803921
3285,3761,활동/Noun,51,22,29,0.000266755585195065,0.00034429907372442745,0.5686274509803921
3286,3766,어중간하다/Adjective,50,2,48,4.445926419917751e-05,0.0005553210866523023,0.96
3287,3767,어쩌라고/Adverb,50,3,47,5.5574080248971876e-05,0.0005442146649192564,0.94
3288,3768,극혐/Noun,50,5,45,7.780371234856063e-05,0.0005220018214531642,0.9
3289,3769,전해지다/Verb,50,43,7,0.0005001667222407468,9.995779559741441e-05,0.86
3290,3770,재수없다/Adjective,50,8,42,0.00011114816049794375,0.0004886825562540262,0.84
3291,3771,위원회/Noun,50,8,42,0.00011114816049794375,0.0004886825562540262,0.84
3292,3772,어의/Noun,50,9,41,0.00012226297654773814,0.00047757613452098,0.82
3293,3773,절묘하다/Adjective,50,39,11,0.00045570745804156943,0.0001443834825295986,0.78
3294,3774,먹히다/Verb,50,12,38,0.00015560742469712126,0.0004442568693218419,0.76
3295,3775,연주/Noun,50,38,12,0.000444592641991775,0.00015548990426264466,0.76
3296,3776,이연희/Noun,50,37,13,0.0004334778259419807,0.0001665963259956907,0.74
3297,3777,생존/Noun,50,36,14,0.00042236300989218633,0.00017770274772873674,0.72
3298,3778,망설이다/Verb,50,36,14,0.00042236300989218633,0.00017770274772873674,0.72
3299,3779,원피스/Noun,50,36,14,0.00042236300989218633,0.00017770274772873674,0.72
3300,3780,역다/Adjective,50,14,36,0.00017783705679671002,0.0004220440258557498,0.72
3301,3781,여기저기/Noun,50,14,36,0.00017783705679671002,0.0004220440258557498,0.72
3302,3782,에드워드/Noun,50,35,15,0.0004112481938423919,0.0001888091694617828,0.7
3303,3783,고스/Noun,50,35,15,0.0004112481938423919,0.0001888091694617828,0.7
3304,3784,강력하다/Adjective,50,34,16,0.0004001333777925976,0.00019991559119482882,0.68
3305,3785,오우삼/Noun,50,17,33,0.00021118150494609317,0.00038872476065661166,0.66
3306,3786,안성기/Noun,50,33,17,0.00038901856174280313,0.0002110220129278749,0.66
3307,3787,까지/Foreign,50,17,33,0.00021118150494609317,0.00038872476065661166,0.66
3308,3788,전도연/Noun,50,33,17,0.00038901856174280313,0.0002110220129278749,0.66
3309,3789,엿보다/Verb,50,33,17,0.00038901856174280313,0.0002110220129278749,0.66
3310,3790,영광/Noun,50,33,17,0.00038901856174280313,0.0002110220129278749,0.66
3311,3791,바쁘다/Adjective,50,17,33,0.00021118150494609317,0.00038872476065661166,0.66
3312,3792,전화/Noun,50,17,33,0.00021118150494609317,0.00038872476065661166,0.66
3313,3793,닷/Noun,50,33,17,0.00038901856174280313,0.0002110220129278749,0.66
3314,3794,증명/Noun,50,18,32,0.0002222963209958875,0.0003776183389235656,0.64
3315,3795,구도/Noun,50,18,32,0.0002222963209958875,0.0003776183389235656,0.64
3316,3796,종합/Noun,50,18,32,0.0002222963209958875,0.0003776183389235656,0.64
3317,3797,검사/Noun,50,19,31,0.0002334111370456819,0.00036651191719051963,0.62
3318,3798,소지섭/Noun,50,31,19,0.00036678892964321435,0.000233234856393967,0.62
3319,3799,추구/Noun,50,31,19,0.00036678892964321435,0.000233234856393967,0.62
3320,3800,로버츠/Noun,50,30,20,0.00035567411359342004,0.00024434127812701304,0.6
3321,3801,카메론/Noun,50,30,20,0.00035567411359342004,0.00024434127812701304,0.6
3322,3802,장근석/Noun,50,20,30,0.00024452595309547634,0.0003554054954574735,0.6
3323,3803,언론/Noun,50,30,20,0.00035567411359342004,0.00024434127812701304,0.6
3324,3804,구혜선/Noun,50,20,30,0.00024452595309547634,0.0003554054954574735,0.6
3325,3805,나니/Noun,50,29,21,0.0003445592975436257,0.0002554476998600591,0.58
3326,3806,유의/Noun,50,29,21,0.0003445592975436257,0.0002554476998600591,0.58
3327,3807,역활/Noun,50,22,28,0.000266755585195065,0.0003331926519913814,0.56
3328,3808,죽지/Noun,50,28,22,0.0003334444814938313,0.00026655412159310506,0.56
3329,3809,심정/Noun,50,22,28,0.000266755585195065,0.0003331926519913814,0.56
3330,3810,멤버/Noun,50,28,22,0.0003334444814938313,0.00026655412159310506,0.56
3331,3811,댄스/Noun,50,22,28,0.000266755585195065,0.0003331926519913814,0.56
3332,3812,지적/Noun,50,28,22,0.0003334444814938313,0.00026655412159310506,0.56
3333,3813,출발/Noun,50,23,27,0.00027787040124485944,0.00032208623025833537,0.54
3334,3819,2.22/Number,49,0,49,2.2229632099588756e-05,0.0005664275083853486,1.0
3335,3820,선율/Noun,49,47,2,0.0005446259864399244,4.4425686932184186e-05,0.9591836734693876
3336,3821,접함/Noun,49,3,46,5.5574080248971876e-05,0.0005331082431862101,0.9387755102040816
3337,3822,김구라/Noun,49,3,46,5.5574080248971876e-05,0.0005331082431862101,0.9387755102040816
3338,3823,지저분하다/Adjective,49,3,46,5.5574080248971876e-05,0.0005331082431862101,0.9387755102040816
3339,3824,배속/Noun,49,4,45,6.668889629876625e-05,0.0005220018214531642,0.9183673469387756
3340,3825,유쾌/Noun,49,45,4,0.0005223963543403357,6.663853039827628e-05,0.9183673469387756
3341,3826,전락/Noun,49,5,44,7.780371234856063e-05,0.0005108953997201182,0.8979591836734694
3342,3827,뽕짝/Noun,49,5,44,7.780371234856063e-05,0.0005108953997201182,0.8979591836734694
3343,3828,부드럽다/Adjective,49,43,6,0.0005001667222407468,8.885137386436837e-05,0.8775510204081632
3344,3829,사기꾼/Noun,49,6,43,8.891852839835501e-05,0.0004997889779870722,0.8775510204081632
3345,3830,스킵/Noun,49,6,43,8.891852839835501e-05,0.0004997889779870722,0.8775510204081632
3346,3831,무리수/Noun,49,6,43,8.891852839835501e-05,0.0004997889779870722,0.8775510204081632
3347,3832,두려움/Noun,49,43,6,0.0005001667222407468,8.885137386436837e-05,0.8775510204081632
3348,3833,재주/Noun,49,8,41,0.00011114816049794375,0.00047757613452098,0.8367346938775511
3349,3834,감기/Noun,49,9,40,0.00012226297654773814,0.000466469712787934,0.8163265306122449
3350,3835,애로/Noun,49,9,40,0.00012226297654773814,0.000466469712787934,0.8163265306122449
3351,3836,시스/Noun,49,40,9,0.0004668222740913638,0.00012217063906350652,0.8163265306122449
3352,3837,록키/Noun,49,39,10,0.00045570745804156943,0.00013327706079655256,0.7959183673469388
3353,3838,The/Alpha,49,39,10,0.00045570745804156943,0.00013327706079655256,0.7959183673469388
3354,3839,스키/Noun,49,38,11,0.000444592641991775,0.0001443834825295986,0.7755102040816326
3355,3840,한두/Modifier,49,11,38,0.0001444926086473269,0.0004442568693218419,0.7755102040816326
3356,3841,흉내내/Noun,49,12,37,0.00015560742469712126,0.0004331504475887958,0.7551020408163265
3357,3842,뜯다/Verb,49,12,37,0.00015560742469712126,0.0004331504475887958,0.7551020408163265
3358,3843,튀어나오다/Verb,49,12,37,0.00015560742469712126,0.0004331504475887958,0.7551020408163265
3359,3844,경의/Noun,49,36,13,0.00042236300989218633,0.0001665963259956907,0.7346938775510204
3360,3845,간직/Noun,49,36,13,0.00042236300989218633,0.0001665963259956907,0.7346938775510204
3361,3846,무색/Noun,49,15,34,0.00018895187284650438,0.00039983118238965764,0.6938775510204082
3362,3847,이탈리아/Noun,49,33,16,0.00038901856174280313,0.00019991559119482882,0.6734693877551021
3363,3848,고치다/Verb,49,16,33,0.0002000666888962988,0.00038872476065661166,0.6734693877551021
3364,3849,충/Noun,49,16,33,0.0002000666888962988,0.00038872476065661166,0.6734693877551021
3365,3850,목사/Noun,49,32,17,0.00037790374569300877,0.0002110220129278749,0.6530612244897959
3366,3851,이웃/Noun,49,17,32,0.00021118150494609317,0.0003776183389235656,0.6530612244897959
3367,3852,셋/Noun,49,17,32,0.00021118150494609317,0.0003776183389235656,0.6530612244897959
3368,3853,일생/Noun,49,32,17,0.00037790374569300877,0.0002110220129278749,0.6530612244897959
3369,3854,홍/Noun,49,18,31,0.0002222963209958875,0.00036651191719051963,0.6326530612244898
3370,3855,학살/Noun,49,18,31,0.0002222963209958875,0.00036651191719051963,0.6326530612244898
3371,3856,저절로/Noun,49,30,19,0.00035567411359342004,0.000233234856393967,0.6122448979591837
3372,3857,로망/Noun,49,30,19,0.00035567411359342004,0.000233234856393967,0.6122448979591837
3373,3858,품/Noun,49,29,20,0.0003445592975436257,0.00024434127812701304,0.5918367346938775
3374,3859,왕가위/Noun,49,29,20,0.0003445592975436257,0.00024434127812701304,0.5918367346938775
3375,3860,아시/Noun,49,29,20,0.0003445592975436257,0.00024434127812701304,0.5918367346938775
3376,3861,락/Noun,49,20,29,0.00024452595309547634,0.00034429907372442745,0.5918367346938775
3377,3862,도로/Noun,49,20,29,0.00024452595309547634,0.00034429907372442745,0.5918367346938775
3378,3863,예술가/Noun,49,29,20,0.0003445592975436257,0.00024434127812701304,0.5918367346938775
3379,3864,초기/Noun,49,20,29,0.00024452595309547634,0.00034429907372442745,0.5918367346938775
3380,3865,직/Noun,49,20,29,0.00024452595309547634,0.00034429907372442745,0.5918367346938775
3381,3866,비슷/Noun,49,21,28,0.00025564076914527065,0.0003331926519913814,0.5714285714285714
3382,3867,말르다/Adjective,49,21,28,0.00025564076914527065,0.0003331926519913814,0.5714285714285714
3383,3868,양조위/Noun,49,28,21,0.0003334444814938313,0.0002554476998600591,0.5714285714285714
3384,3869,월/Noun,49,28,21,0.0003334444814938313,0.0002554476998600591,0.5714285714285714
3385,3870,.(/Punctuation,49,22,27,0.000266755585195065,0.00032208623025833537,0.5510204081632653
3386,3871,채다/Verb,49,22,27,0.000266755585195065,0.00032208623025833537,0.5510204081632653
3387,3872,모순/Noun,49,27,22,0.00032232966544403684,0.00026655412159310506,0.5510204081632653
3388,3873,ㅇㅇㅇ/KoreanParticle,49,26,23,0.00031121484939424253,0.00027766054332615115,0.5306122448979592
3389,3874,올라오다/Verb,49,26,23,0.00031121484939424253,0.00027766054332615115,0.5306122448979592
3390,3875,자아/Noun,49,23,26,0.00027787040124485944,0.00031097980852528933,0.5306122448979592
3391,3876,테/Noun,49,26,23,0.00031121484939424253,0.00027766054332615115,0.5306122448979592
3392,3877,양/Noun,49,23,26,0.00027787040124485944,0.00031097980852528933,0.5306122448979592
3393,3880,내보내다/Verb,48,1,47,3.334444814938313e-05,0.0005442146649192564,0.9791666666666666
3394,3881,주옥/Noun,48,47,1,0.0005446259864399244,3.331926519913814e-05,0.9791666666666666
3395,3882,파워레인저/Noun,48,5,43,7.780371234856063e-05,0.0004997889779870722,0.8958333333333334
3396,3883,엉엉/Noun,48,41,7,0.0004779370901411582,9.995779559741441e-05,0.8541666666666666
3397,3884,이예/Noun,48,40,8,0.0004668222740913638,0.00011106421733046048,0.8333333333333334
3398,3885,그땐/Noun,48,40,8,0.0004668222740913638,0.00011106421733046048,0.8333333333333334
3399,3886,이혼/Noun,48,8,40,0.00011114816049794375,0.000466469712787934,0.8333333333333334
3400,3887,나빠지다/Verb,48,9,39,0.00012226297654773814,0.000455363291054888,0.8125
3401,3888,과잉/Noun,48,9,39,0.00012226297654773814,0.000455363291054888,0.8125
3402,3889,카피/Noun,48,9,39,0.00012226297654773814,0.000455363291054888,0.8125
3403,3890,노골/Noun,48,11,37,0.0001444926086473269,0.0004331504475887958,0.7708333333333334
3404,3891,젖다/Verb,48,36,12,0.00042236300989218633,0.00015548990426264466,0.75
3405,3892,8.5/Number,48,36,12,0.00042236300989218633,0.00015548990426264466,0.75
3406,3893,미국인/Noun,48,13,35,0.00016672224074691566,0.0004109376041227037,0.7291666666666666
3407,3894,품다/Verb,48,35,13,0.0004112481938423919,0.0001665963259956907,0.7291666666666666
3408,3895,려/Noun,48,13,35,0.00016672224074691566,0.0004109376041227037,0.7291666666666666
3409,3896,대고/Noun,48,14,34,0.00017783705679671002,0.00039983118238965764,0.7083333333333334
3410,3897,화판/Noun,48,14,34,0.00017783705679671002,0.00039983118238965764,0.7083333333333334
3411,3898,대감/Noun,48,14,34,0.00017783705679671002,0.00039983118238965764,0.7083333333333334
3412,3899,흥분/Noun,48,34,14,0.0004001333777925976,0.00017770274772873674,0.7083333333333334
3413,3900,마케팅/Noun,48,15,33,0.00018895187284650438,0.00038872476065661166,0.6875
3414,3901,한정/Noun,48,32,16,0.00037790374569300877,0.00019991559119482882,0.6666666666666666
3415,3902,아이러니/Noun,48,31,17,0.00036678892964321435,0.0002110220129278749,0.6458333333333334
3416,3903,따라오다/Verb,48,31,17,0.00036678892964321435,0.0002110220129278749,0.6458333333333334
3417,3904,송혜교/Noun,48,17,31,0.00021118150494609317,0.00036651191719051963,0.6458333333333334
3418,3905,신세경/Noun,48,17,31,0.00021118150494609317,0.00036651191719051963,0.6458333333333334
3419,3906,위기/Noun,48,17,31,0.00021118150494609317,0.00036651191719051963,0.6458333333333334
3420,3907,침묵/Noun,48,30,18,0.00035567411359342004,0.00022212843466092096,0.625
3421,3908,송지효/Noun,48,30,18,0.00035567411359342004,0.00022212843466092096,0.625
3422,3909,일요일/Noun,48,30,18,0.00035567411359342004,0.00022212843466092096,0.625
3423,3910,주원/Noun,48,30,18,0.00035567411359342004,0.00022212843466092096,0.625
3424,3911,저주/Noun,48,18,30,0.0002222963209958875,0.0003554054954574735,0.625
3425,3912,마르/Noun,48,29,19,0.0003445592975436257,0.000233234856393967,0.6041666666666666
3426,3913,지고/Noun,48,29,19,0.0003445592975436257,0.000233234856393967,0.6041666666666666
3427,3914,고자/Noun,48,19,29,0.0002334111370456819,0.00034429907372442745,0.6041666666666666
3428,3915,이구/Noun,48,28,20,0.0003334444814938313,0.00024434127812701304,0.5833333333333334
3429,3916,후속/Noun,48,28,20,0.0003334444814938313,0.00024434127812701304,0.5833333333333334
3430,3917,쏟아지다/Verb,48,28,20,0.0003334444814938313,0.00024434127812701304,0.5833333333333334
3431,3918,째다/Verb,48,20,28,0.00024452595309547634,0.0003331926519913814,0.5833333333333334
3432,3919,물건/Noun,48,20,28,0.00024452595309547634,0.0003331926519913814,0.5833333333333334
3433,3920,유우/Noun,48,20,28,0.00024452595309547634,0.0003331926519913814,0.5833333333333334
3434,3921,로다/Josa,48,21,27,0.00025564076914527065,0.00032208623025833537,0.5625
3435,3922,불안하다/Adjective,48,27,21,0.00032232966544403684,0.0002554476998600591,0.5625
3436,3923,증거/Noun,48,21,27,0.00025564076914527065,0.00032208623025833537,0.5625
3437,3924,줄리아/Noun,48,22,26,0.000266755585195065,0.00031097980852528933,0.5416666666666666
3438,3925,극/Noun,48,22,26,0.000266755585195065,0.00031097980852528933,0.5416666666666666
3439,3926,들보/Noun,48,22,26,0.000266755585195065,0.00031097980852528933,0.5416666666666666
3440,3932,조악하다/Adjective,47,1,46,3.334444814938313e-05,0.0005331082431862101,0.9787234042553192
3441,3933,낚였/Noun,47,1,46,3.334444814938313e-05,0.0005331082431862101,0.9787234042553192
3442,3934,졸잼/Noun,47,43,4,0.0005001667222407468,6.663853039827628e-05,0.9148936170212766
3443,3935,클리셰/Noun,47,5,42,7.780371234856063e-05,0.0004886825562540262,0.8936170212765957
3444,3936,이스트/Noun,47,41,6,0.0004779370901411582,8.885137386436837e-05,0.8723404255319149
3445,3937,구역/Noun,47,8,39,0.00011114816049794375,0.000455363291054888,0.8297872340425532
3446,3938,구려/Noun,47,8,39,0.00011114816049794375,0.000455363291054888,0.8297872340425532
3447,3939,만날/Noun,47,38,9,0.000444592641991775,0.00012217063906350652,0.8085106382978723
3448,3940,대가리/Noun,47,9,38,0.00012226297654773814,0.0004442568693218419,0.8085106382978723
3449,3941,인척/Noun,47,10,37,0.0001333777925975325,0.0004331504475887958,0.7872340425531915
3450,3942,환장하다/Adjective,47,10,37,0.0001333777925975325,0.0004331504475887958,0.7872340425531915
3451,3943,-_-;/Punctuation,47,12,35,0.00015560742469712126,0.0004109376041227037,0.7446808510638298
3452,3944,타령/Noun,47,12,35,0.00015560742469712126,0.0004109376041227037,0.7446808510638298
3453,3945,하드/Noun,47,13,34,0.00016672224074691566,0.00039983118238965764,0.7234042553191491
3454,3946,면도/Noun,47,33,14,0.00038901856174280313,0.00017770274772873674,0.7021276595744681
3455,3947,붉다/Adjective,47,33,14,0.00038901856174280313,0.00017770274772873674,0.7021276595744681
3456,3948,조승우/Noun,47,33,14,0.00038901856174280313,0.00017770274772873674,0.7021276595744681
3457,3949,별다르다/Adjective,47,14,33,0.00017783705679671002,0.00038872476065661166,0.7021276595744681
3458,3950,시사/Noun,47,33,14,0.00038901856174280313,0.00017770274772873674,0.7021276595744681
3459,3951,도라에몽/Noun,47,33,14,0.00038901856174280313,0.00017770274772873674,0.7021276595744681
3460,3952,오페라/Noun,47,33,14,0.00038901856174280313,0.00017770274772873674,0.7021276595744681
3461,3953,신념/Noun,47,32,15,0.00037790374569300877,0.0001888091694617828,0.6808510638297872
3462,3954,아이언맨/Noun,47,32,15,0.00037790374569300877,0.0001888091694617828,0.6808510638297872
3463,3955,애국심/Noun,47,15,32,0.00018895187284650438,0.0003776183389235656,0.6808510638297872
3464,3956,작/Foreign,47,15,32,0.00018895187284650438,0.0003776183389235656,0.6808510638297872
3465,3957,미이라/Noun,47,15,32,0.00018895187284650438,0.0003776183389235656,0.6808510638297872
3466,3958,드래곤볼/Noun,47,15,32,0.00018895187284650438,0.0003776183389235656,0.6808510638297872
3467,3959,전이/Noun,47,31,16,0.00036678892964321435,0.00019991559119482882,0.6595744680851063
3468,3960,크루즈/Noun,47,31,16,0.00036678892964321435,0.00019991559119482882,0.6595744680851063
3469,3961,김명민/Noun,47,30,17,0.00035567411359342004,0.0002110220129278749,0.6382978723404256
3470,3962,웅장/Noun,47,30,17,0.00035567411359342004,0.0002110220129278749,0.6382978723404256
3471,3963,지브리/Noun,47,30,17,0.00035567411359342004,0.0002110220129278749,0.6382978723404256
3472,3964,홍금보/Noun,47,30,17,0.00035567411359342004,0.0002110220129278749,0.6382978723404256
3473,3965,쩜/Noun,47,29,18,0.0003445592975436257,0.00022212843466092096,0.6170212765957447
3474,3966,2015년/Number,47,29,18,0.0003445592975436257,0.00022212843466092096,0.6170212765957447
3475,3967,부여/Noun,47,18,29,0.0002222963209958875,0.00034429907372442745,0.6170212765957447
3476,3968,뻥/Noun,47,18,29,0.0002222963209958875,0.00034429907372442745,0.6170212765957447
3477,3969,국적/Noun,47,29,18,0.0003445592975436257,0.00022212843466092096,0.6170212765957447
3478,3970,독립/Noun,47,29,18,0.0003445592975436257,0.00022212843466092096,0.6170212765957447
3479,3971,메인/Noun,47,18,29,0.0002222963209958875,0.00034429907372442745,0.6170212765957447
3480,3972,밧다/Verb,47,29,18,0.0003445592975436257,0.00022212843466092096,0.6170212765957447
3481,3973,보고서/Noun,47,29,18,0.0003445592975436257,0.00022212843466092096,0.6170212765957447
3482,3974,자의/Noun,47,29,18,0.0003445592975436257,0.00022212843466092096,0.6170212765957447
3483,3975,겹/Noun,47,28,19,0.0003334444814938313,0.000233234856393967,0.5957446808510638
3484,3976,한글/Noun,47,28,19,0.0003334444814938313,0.000233234856393967,0.5957446808510638
3485,3977,간단하다/Adjective,47,19,28,0.0002334111370456819,0.0003331926519913814,0.5957446808510638
3486,3978,초점/Noun,47,20,27,0.00024452595309547634,0.00032208623025833537,0.5744680851063829
3487,3979,봉/Noun,47,20,27,0.00024452595309547634,0.00032208623025833537,0.5744680851063829
3488,3980,인종차별/Noun,47,20,27,0.00024452595309547634,0.00032208623025833537,0.5744680851063829
3489,3981,다크/Noun,47,26,21,0.00031121484939424253,0.0002554476998600591,0.5531914893617021
3490,3982,미리/Noun,47,21,26,0.00025564076914527065,0.00031097980852528933,0.5531914893617021
3491,3983,ㅐ/KoreanParticle,47,21,26,0.00025564076914527065,0.00031097980852528933,0.5531914893617021
3492,3984,꼬맹이/Noun,47,26,21,0.00031121484939424253,0.0002554476998600591,0.5531914893617021
3493,3985,쥬라기/Noun,47,21,26,0.00025564076914527065,0.00031097980852528933,0.5531914893617021
3494,3986,고수/Noun,47,21,26,0.00025564076914527065,0.00031097980852528933,0.5531914893617021
3495,3987,커지다/Verb,47,22,25,0.000266755585195065,0.0002998733867922433,0.5319148936170213
3496,3988,스탈/Noun,47,22,25,0.000266755585195065,0.0002998733867922433,0.5319148936170213
3497,3989,무지하다/Adjective,47,25,22,0.00030010003334444816,0.00026655412159310506,0.5319148936170213
3498,3990,비치/Noun,47,22,25,0.000266755585195065,0.0002998733867922433,0.5319148936170213
3499,3991,불쌍/Noun,47,22,25,0.000266755585195065,0.0002998733867922433,0.5319148936170213
3500,3992,배려/Noun,47,25,22,0.00030010003334444816,0.00026655412159310506,0.5319148936170213
3501,3993,열광하다/Adjective,47,22,25,0.000266755585195065,0.0002998733867922433,0.5319148936170213
3502,3998,남발/Noun,46,2,44,4.445926419917751e-05,0.0005108953997201182,0.9565217391304348
3503,3999,용가리/Noun,46,5,41,7.780371234856063e-05,0.00047757613452098,0.8913043478260869
3504,4000,배드/Noun,46,6,40,8.891852839835501e-05,0.000466469712787934,0.8695652173913043
3505,4001,재탕/Noun,46,6,40,8.891852839835501e-05,0.000466469712787934,0.8695652173913043
3506,4002,증말/Noun,46,7,39,0.0001000333444481494,0.000455363291054888,0.8478260869565217
3507,4003,우왕/Noun,46,39,7,0.00045570745804156943,9.995779559741441e-05,0.8478260869565217
3508,4004,재료/Noun,46,7,39,0.0001000333444481494,0.000455363291054888,0.8478260869565217
3509,4005,즐/Noun,46,7,39,0.0001000333444481494,0.000455363291054888,0.8478260869565217
3510,4006,덴젤/Noun,46,38,8,0.000444592641991775,0.00011106421733046048,0.8260869565217391
3511,4007,풍부하다/Adjective,46,37,9,0.0004334778259419807,0.00012217063906350652,0.8043478260869565
3512,4008,벗기다/Verb,46,9,37,0.00012226297654773814,0.0004331504475887958,0.8043478260869565
3513,4009,정당화/Noun,46,9,37,0.00012226297654773814,0.0004331504475887958,0.8043478260869565
3514,4010,저희/Noun,46,34,12,0.0004001333777925976,0.00015548990426264466,0.7391304347826086
3515,4011,땜시/Noun,46,12,34,0.00015560742469712126,0.00039983118238965764,0.7391304347826086
3516,4012,줄이다/Verb,46,13,33,0.00016672224074691566,0.00038872476065661166,0.7173913043478259
3517,4013,특징/Noun,46,13,33,0.00016672224074691566,0.00038872476065661166,0.7173913043478259
3518,4014,태양/Noun,46,33,13,0.00038901856174280313,0.0001665963259956907,0.7173913043478259
3519,4015,조정/Noun,46,13,33,0.00016672224074691566,0.00038872476065661166,0.7173913043478259
3520,4016,정통/Noun,46,32,14,0.00037790374569300877,0.00017770274772873674,0.6956521739130435
3521,4017,역쉬/Noun,46,31,15,0.00036678892964321435,0.0001888091694617828,0.6739130434782609
3522,4018,나와라/Noun,46,31,15,0.00036678892964321435,0.0001888091694617828,0.6739130434782609
3523,4019,6년/Number,46,31,15,0.00036678892964321435,0.0001888091694617828,0.6739130434782609
3524,4020,지원/Noun,46,16,30,0.0002000666888962988,0.0003554054954574735,0.6521739130434783
3525,4021,KBS/Alpha,46,30,16,0.00035567411359342004,0.00019991559119482882,0.6521739130434783
3526,4022,저기/Noun,46,16,30,0.0002000666888962988,0.0003554054954574735,0.6521739130434783
3527,4023,최선/Noun,46,30,16,0.00035567411359342004,0.00019991559119482882,0.6521739130434783
3528,4024,부자/Noun,46,17,29,0.00021118150494609317,0.00034429907372442745,0.6304347826086957
3529,4025,하나요/Noun,46,17,29,0.00021118150494609317,0.00034429907372442745,0.6304347826086957
3530,4026,만듬/Noun,46,17,29,0.00021118150494609317,0.00034429907372442745,0.6304347826086957
3531,4027,줄리/Noun,46,29,17,0.0003445592975436257,0.0002110220129278749,0.6304347826086957
3532,4028,헷갈리다/Adjective,46,18,28,0.0002222963209958875,0.0003331926519913814,0.6086956521739131
3533,4029,주먹/Noun,46,18,28,0.0002222963209958875,0.0003331926519913814,0.6086956521739131
3534,4030,환타지/Noun,46,18,28,0.0002222963209958875,0.0003331926519913814,0.6086956521739131
3535,4031,격투/Noun,46,27,19,0.00032232966544403684,0.000233234856393967,0.5869565217391305
3536,4032,ㄹㅇ/KoreanParticle,46,19,27,0.0002334111370456819,0.00032208623025833537,0.5869565217391305
3537,4033,칸/Noun,46,20,26,0.00024452595309547634,0.00031097980852528933,0.5652173913043478
3538,4034,호화/Noun,46,20,26,0.00024452595309547634,0.00031097980852528933,0.5652173913043478
3539,4035,패션/Noun,46,26,20,0.00031121484939424253,0.00024434127812701304,0.5652173913043478
3540,4036,짱구/Noun,46,20,26,0.00024452595309547634,0.00031097980852528933,0.5652173913043478
3541,4037,장난감/Noun,46,21,25,0.00025564076914527065,0.0002998733867922433,0.5434782608695652
3542,4038,대비/Noun,46,25,21,0.00030010003334444816,0.0002554476998600591,0.5434782608695652
3543,4039,하디/Noun,46,21,25,0.00025564076914527065,0.0002998733867922433,0.5434782608695652
3544,4040,서스펜스/Noun,46,25,21,0.00030010003334444816,0.0002554476998600591,0.5434782608695652
3545,4041,`/Punctuation,46,21,25,0.00025564076914527065,0.0002998733867922433,0.5434782608695652
3546,4042,검다/Adjective,46,21,25,0.00025564076914527065,0.0002998733867922433,0.5434782608695652
3547,4043,으로가/Josa,46,21,25,0.00025564076914527065,0.0002998733867922433,0.5434782608695652
3548,4044,여왕/Noun,46,21,25,0.00025564076914527065,0.0002998733867922433,0.5434782608695652
3549,4051,최하/Noun,45,3,42,5.5574080248971876e-05,0.0004886825562540262,0.9333333333333332
3550,4052,어처구니없다/Adjective,45,3,42,5.5574080248971876e-05,0.0004886825562540262,0.9333333333333332
3551,4053,글쎄요/Noun,45,3,42,5.5574080248971876e-05,0.0004886825562540262,0.9333333333333332
3552,4054,흐뭇하다/Adjective,45,42,3,0.0004890519061909527,5.553210866523024e-05,0.9333333333333332
3553,4055,대략/Noun,45,5,40,7.780371234856063e-05,0.000466469712787934,0.8888888888888888
3554,4056,곁/Noun,45,40,5,0.0004668222740913638,7.774495213132233e-05,0.8888888888888888
3555,4057,성함/Noun,45,6,39,8.891852839835501e-05,0.000455363291054888,0.8666666666666667
3556,4058,팔다/Verb,45,7,38,0.0001000333444481494,0.0004442568693218419,0.8444444444444444
3557,4059,간첩/Noun,45,10,35,0.0001333777925975325,0.0004109376041227037,0.7777777777777778
3558,4060,구성은/Noun,45,10,35,0.0001333777925975325,0.0004109376041227037,0.7777777777777778
3559,4061,온몸/Noun,45,34,11,0.0004001333777925976,0.0001443834825295986,0.7555555555555555
3560,4062,수치/Noun,45,11,34,0.0001444926086473269,0.00039983118238965764,0.7555555555555555
3561,4063,행크스/Noun,45,34,11,0.0004001333777925976,0.0001443834825295986,0.7555555555555555
3562,4064,12년/Number,45,33,12,0.00038901856174280313,0.00015548990426264466,0.7333333333333333
3563,4065,직원/Noun,45,12,33,0.00015560742469712126,0.00038872476065661166,0.7333333333333333
3564,4066,도입/Noun,45,12,33,0.00015560742469712126,0.00038872476065661166,0.7333333333333333
3565,4067,모호하다/Adjective,45,13,32,0.00016672224074691566,0.0003776183389235656,0.7111111111111111
3566,4068,감수성/Noun,45,31,14,0.00036678892964321435,0.00017770274772873674,0.6888888888888889
3567,4069,게리/Noun,45,31,14,0.00036678892964321435,0.00017770274772873674,0.6888888888888889
3568,4070,박사/Noun,45,30,15,0.00035567411359342004,0.0001888091694617828,0.6666666666666666
3569,4071,김태희/Noun,45,16,29,0.0002000666888962988,0.00034429907372442745,0.6444444444444445
3570,4072,활용/Noun,45,16,29,0.0002000666888962988,0.00034429907372442745,0.6444444444444445
3571,4073,민/Noun,45,29,16,0.0003445592975436257,0.00019991559119482882,0.6444444444444445
3572,4074,고백/Noun,45,28,17,0.0003334444814938313,0.0002110220129278749,0.6222222222222222
3573,4075,남매/Noun,45,28,17,0.0003334444814938313,0.0002110220129278749,0.6222222222222222
3574,4076,그로/Noun,45,28,17,0.0003334444814938313,0.0002110220129278749,0.6222222222222222
3575,4077,총알/Noun,45,17,28,0.00021118150494609317,0.0003331926519913814,0.6222222222222222
3576,4078,부탁드리다/Adjective,45,28,17,0.0003334444814938313,0.0002110220129278749,0.6222222222222222
3577,4079,수위/Noun,45,17,28,0.00021118150494609317,0.0003331926519913814,0.6222222222222222
3578,4080,삐/Noun,45,17,28,0.00021118150494609317,0.0003331926519913814,0.6222222222222222
3579,4081,시민/Noun,45,17,28,0.00021118150494609317,0.0003331926519913814,0.6222222222222222
3580,4082,긋다/Verb,45,18,27,0.0002222963209958875,0.00032208623025833537,0.6
3581,4083,존내/Noun,45,18,27,0.0002222963209958875,0.00032208623025833537,0.6
3582,4084,노동자/Noun,45,26,19,0.00031121484939424253,0.000233234856393967,0.5777777777777777
3583,4085,영감/Noun,45,26,19,0.00031121484939424253,0.000233234856393967,0.5777777777777777
3584,4086,닫다/Verb,45,19,26,0.0002334111370456819,0.00031097980852528933,0.5777777777777777
3585,4087,법정/Noun,45,26,19,0.00031121484939424253,0.000233234856393967,0.5777777777777777
3586,4088,똑똑하다/Adjective,45,26,19,0.00031121484939424253,0.000233234856393967,0.5777777777777777
3587,4089,부디/Noun,45,25,20,0.00030010003334444816,0.00024434127812701304,0.5555555555555556
3588,4090,모성애/Noun,45,25,20,0.00030010003334444816,0.00024434127812701304,0.5555555555555556
3589,4091,이나영/Noun,45,21,24,0.00025564076914527065,0.0002887669650591972,0.5333333333333333
3590,4092,마녀/Noun,45,24,21,0.0002889852172946538,0.0002554476998600591,0.5333333333333333
3591,4093,간간히/Adverb,45,21,24,0.00025564076914527065,0.0002887669650591972,0.5333333333333333
3592,4094,극찬/Noun,45,21,24,0.00025564076914527065,0.0002887669650591972,0.5333333333333333
3593,4095,리브/Noun,45,24,21,0.0002889852172946538,0.0002554476998600591,0.5333333333333333
3594,4096,가미/Noun,45,21,24,0.00025564076914527065,0.0002887669650591972,0.5333333333333333
3595,4097,복/Noun,45,24,21,0.0002889852172946538,0.0002554476998600591,0.5333333333333333
3596,4098,어째서/Noun,45,24,21,0.0002889852172946538,0.0002554476998600591,0.5333333333333333
3597,4102,♥♥♥♥/Foreign,44,44,0,0.0005112815382905413,2.2212843466092093e-05,1.0
3598,4103,자위/Noun,44,2,42,4.445926419917751e-05,0.0004886825562540262,0.9545454545454546
3599,4104,용두사미/Noun,44,2,42,4.445926419917751e-05,0.0004886825562540262,0.9545454545454546
3600,4105,모야/Noun,44,3,41,5.5574080248971876e-05,0.00047757613452098,0.9318181818181818
3601,4106,앞서/Noun,44,41,3,0.0004779370901411582,5.553210866523024e-05,0.9318181818181818
3602,4107,구역질/Noun,44,3,41,5.5574080248971876e-05,0.00047757613452098,0.9318181818181818
3603,4108,삼가다/Verb,44,39,5,0.00045570745804156943,7.774495213132233e-05,0.8863636363636364
3604,4109,뽕/Noun,44,6,38,8.891852839835501e-05,0.0004442568693218419,0.8636363636363636
3605,4110,느슨하다/Adjective,44,7,37,0.0001000333444481494,0.0004331504475887958,0.8409090909090909
3606,4111,코스프레/Noun,44,7,37,0.0001000333444481494,0.0004331504475887958,0.8409090909090909
3607,4112,노리다/Verb,44,7,37,0.0001000333444481494,0.0004331504475887958,0.8409090909090909
3608,4113,등급/Noun,44,8,36,0.00011114816049794375,0.0004220440258557498,0.8181818181818182
3609,4114,가을/Noun,44,36,8,0.00042236300989218633,0.00011106421733046048,0.8181818181818182
3610,4115,노말/Noun,44,8,36,0.00011114816049794375,0.0004220440258557498,0.8181818181818182
3611,4116,ㅂㅅ/KoreanParticle,44,8,36,0.00011114816049794375,0.0004220440258557498,0.8181818181818182
3612,4117,펭귄/Noun,44,36,8,0.00042236300989218633,0.00011106421733046048,0.8181818181818182
3613,4118,에러/Noun,44,9,35,0.00012226297654773814,0.0004109376041227037,0.7954545454545454
3614,4119,드립/Noun,44,9,35,0.00012226297654773814,0.0004109376041227037,0.7954545454545454
3615,4120,구리다/Adjective,44,9,35,0.00012226297654773814,0.0004109376041227037,0.7954545454545454
3616,4121,읍/Noun,44,9,35,0.00012226297654773814,0.0004109376041227037,0.7954545454545454
3617,4122,섭외/Noun,44,9,35,0.00012226297654773814,0.0004109376041227037,0.7954545454545454
3618,4123,15분/Number,44,10,34,0.0001333777925975325,0.00039983118238965764,0.7727272727272727
3619,4124,중국인/Noun,44,10,34,0.0001333777925975325,0.00039983118238965764,0.7727272727272727
3620,4125,에여/Josa,44,34,10,0.0004001333777925976,0.00013327706079655256,0.7727272727272727
3621,4126,병원/Noun,44,11,33,0.0001444926086473269,0.00038872476065661166,0.75
3622,4127,불후/Noun,44,32,12,0.00037790374569300877,0.00015548990426264466,0.7272727272727273
3623,4128,성숙하다/Adjective,44,32,12,0.00037790374569300877,0.00015548990426264466,0.7272727272727273
3624,4129,해안가/Noun,44,12,32,0.00015560742469712126,0.0003776183389235656,0.7272727272727273
3625,4130,똑바로/Noun,44,13,31,0.00016672224074691566,0.00036651191719051963,0.7045454545454546
3626,4131,구멍/Noun,44,13,31,0.00016672224074691566,0.00036651191719051963,0.7045454545454546
3627,4132,워커/Noun,44,31,13,0.00036678892964321435,0.0001665963259956907,0.7045454545454546
3628,4133,낙/Noun,44,31,13,0.00036678892964321435,0.0001665963259956907,0.7045454545454546
3629,4134,레오/Noun,44,31,13,0.00036678892964321435,0.0001665963259956907,0.7045454545454546
3630,4135,부재/Noun,44,13,31,0.00016672224074691566,0.00036651191719051963,0.7045454545454546
3631,4136,인터뷰/Noun,44,13,31,0.00016672224074691566,0.00036651191719051963,0.7045454545454546
3632,4137,가져오다/Verb,44,14,30,0.00017783705679671002,0.0003554054954574735,0.6818181818181818
3633,4138,아무래도/Adverb,44,14,30,0.00017783705679671002,0.0003554054954574735,0.6818181818181818
3634,4139,북/Noun,44,14,30,0.00017783705679671002,0.0003554054954574735,0.6818181818181818
3635,4140,절실/Noun,44,30,14,0.00035567411359342004,0.00017770274772873674,0.6818181818181818
3636,4141,비롯/Noun,44,29,15,0.0003445592975436257,0.0001888091694617828,0.6590909090909091
3637,4142,지존/Noun,44,29,15,0.0003445592975436257,0.0001888091694617828,0.6590909090909091
3638,4143,슬래셔/Noun,44,15,29,0.00018895187284650438,0.00034429907372442745,0.6590909090909091
3639,4144,걸치다/Verb,44,15,29,0.00018895187284650438,0.00034429907372442745,0.6590909090909091
3640,4145,무적/Noun,44,16,28,0.0002000666888962988,0.0003331926519913814,0.6363636363636364
3641,4146,지금껏/Noun,44,28,16,0.0003334444814938313,0.00019991559119482882,0.6363636363636364
3642,4147,숲/Noun,44,27,17,0.00032232966544403684,0.0002110220129278749,0.6136363636363636
3643,4148,신민아/Noun,44,27,17,0.00032232966544403684,0.0002110220129278749,0.6136363636363636
3644,4149,양동근/Noun,44,17,27,0.00021118150494609317,0.00032208623025833537,0.6136363636363636
3645,4150,괜/Noun,44,26,18,0.00031121484939424253,0.00022212843466092096,0.5909090909090909
3646,4151,뼈/Noun,44,26,18,0.00031121484939424253,0.00022212843466092096,0.5909090909090909
3647,4152,천만/Noun,44,18,26,0.0002222963209958875,0.00031097980852528933,0.5909090909090909
3648,4153,구원/Noun,44,26,18,0.00031121484939424253,0.00022212843466092096,0.5909090909090909
3649,4154,고요/Noun,44,26,18,0.00031121484939424253,0.00022212843466092096,0.5909090909090909
3650,4155,세우다/Verb,44,18,26,0.0002222963209958875,0.00031097980852528933,0.5909090909090909
3651,4156,정사/Noun,44,19,25,0.0002334111370456819,0.0002998733867922433,0.5681818181818182
3652,4157,다기/Noun,44,19,25,0.0002334111370456819,0.0002998733867922433,0.5681818181818182
3653,4158,임권택/Noun,44,19,25,0.0002334111370456819,0.0002998733867922433,0.5681818181818182
3654,4159,대전/Noun,44,19,25,0.0002334111370456819,0.0002998733867922433,0.5681818181818182
3655,4160,16/Number,44,25,19,0.00030010003334444816,0.000233234856393967,0.5681818181818182
3656,4161,광팬/Noun,44,25,19,0.00030010003334444816,0.000233234856393967,0.5681818181818182
3657,4162,진보/Noun,44,24,20,0.0002889852172946538,0.00024434127812701304,0.5454545454545454
3658,4163,드림웍스/Noun,44,20,24,0.00024452595309547634,0.0002887669650591972,0.5454545454545454
3659,4164,유리/Noun,44,20,24,0.00024452595309547634,0.0002887669650591972,0.5454545454545454
3660,4165,실사/Noun,44,20,24,0.00024452595309547634,0.0002887669650591972,0.5454545454545454
3661,4166,스텝업/Noun,44,20,24,0.00024452595309547634,0.0002887669650591972,0.5454545454545454
3662,4171,곱씹다/Verb,43,42,1,0.0004890519061909527,3.331926519913814e-05,0.9767441860465116
3663,4172,very/Alpha,43,42,1,0.0004890519061909527,3.331926519913814e-05,0.9767441860465116
3664,4173,실종/Noun,43,1,42,3.334444814938313e-05,0.0004886825562540262,0.9767441860465116
3665,4174,나발/Noun,43,2,41,4.445926419917751e-05,0.00047757613452098,0.9534883720930232
3666,4175,리즈시절/Noun,43,40,3,0.0004668222740913638,5.553210866523024e-05,0.9302325581395348
3667,4176,미묘하다/Adjective,43,39,4,0.00045570745804156943,6.663853039827628e-05,0.9069767441860463
3668,4177,허무맹랑/Noun,43,6,37,8.891852839835501e-05,0.0004331504475887958,0.8604651162790697
3669,4178,실소/Noun,43,7,36,0.0001000333444481494,0.0004220440258557498,0.8372093023255814
3670,4179,요약/Noun,43,8,35,0.00011114816049794375,0.0004109376041227037,0.813953488372093
3671,4180,8년/Number,43,35,8,0.0004112481938423919,0.00011106421733046048,0.813953488372093
3672,4181,비명/Noun,43,8,35,0.00011114816049794375,0.0004109376041227037,0.813953488372093
3673,4182,PD/Alpha,43,8,35,0.00011114816049794375,0.0004109376041227037,0.813953488372093
3674,4183,말기/Noun,43,9,34,0.00012226297654773814,0.00039983118238965764,0.7906976744186046
3675,4184,훈남/Noun,43,34,9,0.0004001333777925976,0.00012217063906350652,0.7906976744186046
3676,4185,콤비/Noun,43,33,10,0.00038901856174280313,0.00013327706079655256,0.7674418604651163
3677,4186,박해일/Noun,43,32,11,0.00037790374569300877,0.0001443834825295986,0.7441860465116279
3678,4187,정도/Foreign,43,11,32,0.0001444926086473269,0.0003776183389235656,0.7441860465116279
3679,4188,자랑스럽다/Adjective,43,32,11,0.00037790374569300877,0.0001443834825295986,0.7441860465116279
3680,4189,이념/Noun,43,31,12,0.00036678892964321435,0.00015548990426264466,0.7209302325581395
3681,4190,낯/Noun,43,12,31,0.00015560742469712126,0.00036651191719051963,0.7209302325581395
3682,4191,명도/Noun,43,12,31,0.00015560742469712126,0.00036651191719051963,0.7209302325581395
3683,4192,크리스토퍼/Noun,43,31,12,0.00036678892964321435,0.00015548990426264466,0.7209302325581395
3684,4193,일도/Noun,43,13,30,0.00016672224074691566,0.0003554054954574735,0.6976744186046512
3685,4194,거만/Noun,43,13,30,0.00016672224074691566,0.0003554054954574735,0.6976744186046512
3686,4195,에게서/Josa,43,30,13,0.00035567411359342004,0.0001665963259956907,0.6976744186046512
3687,4196,미국영화/Noun,43,13,30,0.00016672224074691566,0.0003554054954574735,0.6976744186046512
3688,4197,뮤직비디오/Noun,43,13,30,0.00016672224074691566,0.0003554054954574735,0.6976744186046512
3689,4198,모티브/Noun,43,13,30,0.00016672224074691566,0.0003554054954574735,0.6976744186046512
3690,4199,요구/Noun,43,13,30,0.00016672224074691566,0.0003554054954574735,0.6976744186046512
3691,4200,만/Foreign,43,14,29,0.00017783705679671002,0.00034429907372442745,0.6744186046511628
3692,4201,깨지다/Verb,43,14,29,0.00017783705679671002,0.00034429907372442745,0.6744186046511628
3693,4202,호강/Noun,43,29,14,0.0003445592975436257,0.00017770274772873674,0.6744186046511628
3694,4203,뉴욕/Noun,43,29,14,0.0003445592975436257,0.00017770274772873674,0.6744186046511628
3695,4204,끊임없다/Adjective,43,29,14,0.0003445592975436257,0.00017770274772873674,0.6744186046511628
3696,4205,남지/Noun,43,15,28,0.00018895187284650438,0.0003331926519913814,0.6511627906976745
3697,4206,옹/Noun,43,28,15,0.0003334444814938313,0.0001888091694617828,0.6511627906976745
3698,4207,교수/Noun,43,15,28,0.00018895187284650438,0.0003331926519913814,0.6511627906976745
3699,4208,학원/Noun,43,15,28,0.00018895187284650438,0.0003331926519913814,0.6511627906976745
3700,4209,2003년/Number,43,28,15,0.0003334444814938313,0.0001888091694617828,0.6511627906976745
3701,4210,혹평/Noun,43,28,15,0.0003334444814938313,0.0001888091694617828,0.6511627906976745
3702,4211,쫓다/Verb,43,15,28,0.00018895187284650438,0.0003331926519913814,0.6511627906976745
3703,4212,지니다/Verb,43,27,16,0.00032232966544403684,0.00019991559119482882,0.627906976744186
3704,4213,꺼리다/Verb,43,16,27,0.0002000666888962988,0.00032208623025833537,0.627906976744186
3705,4214,그/Modifier,43,16,27,0.0002000666888962988,0.00032208623025833537,0.627906976744186
3706,4215,라마/Noun,43,16,27,0.0002000666888962988,0.00032208623025833537,0.627906976744186
3707,4216,저번/Noun,43,17,26,0.00021118150494609317,0.00031097980852528933,0.6046511627906976
3708,4217,쓰러지다/Verb,43,17,26,0.00021118150494609317,0.00031097980852528933,0.6046511627906976
3709,4218,은퇴/Noun,43,17,26,0.00021118150494609317,0.00031097980852528933,0.6046511627906976
3710,4219,주목/Noun,43,26,17,0.00031121484939424253,0.0002110220129278749,0.6046511627906976
3711,4220,종류/Noun,43,26,17,0.00031121484939424253,0.0002110220129278749,0.6046511627906976
3712,4221,벽/Noun,43,26,17,0.00031121484939424253,0.0002110220129278749,0.6046511627906976
3713,4222,물의/Noun,43,25,18,0.00030010003334444816,0.00022212843466092096,0.5813953488372093
3714,4223,계획/Noun,43,25,18,0.00030010003334444816,0.00022212843466092096,0.5813953488372093
3715,4224,아역배우/Noun,43,25,18,0.00030010003334444816,0.00022212843466092096,0.5813953488372093
3716,4225,미술/Noun,43,25,18,0.00030010003334444816,0.00022212843466092096,0.5813953488372093
3717,4226,해적/Noun,43,25,18,0.00030010003334444816,0.00022212843466092096,0.5813953488372093
3718,4227,엽문/Noun,43,19,24,0.0002334111370456819,0.0002887669650591972,0.5581395348837209
3719,4228,밴드/Noun,43,24,19,0.0002889852172946538,0.000233234856393967,0.5581395348837209
3720,4229,몫/Noun,43,19,24,0.0002334111370456819,0.0002887669650591972,0.5581395348837209
3721,4230,노랗다/Adjective,43,20,23,0.00024452595309547634,0.00027766054332615115,0.5348837209302325
3722,4231,공중파/Noun,43,23,20,0.00027787040124485944,0.00024434127812701304,0.5348837209302325
3723,4232,기어/Noun,43,20,23,0.00024452595309547634,0.00027766054332615115,0.5348837209302325
3724,4233,가해자/Noun,43,20,23,0.00024452595309547634,0.00027766054332615115,0.5348837209302325
3725,4234,와이프/Noun,43,23,20,0.00027787040124485944,0.00024434127812701304,0.5348837209302325
3726,4235,명확하다/Adjective,43,23,20,0.00027787040124485944,0.00024434127812701304,0.5348837209302325
3727,4242,도통/Noun,42,1,41,3.334444814938313e-05,0.00047757613452098,0.9761904761904762
3728,4243,남아돌다/Verb,42,1,41,3.334444814938313e-05,0.00047757613452098,0.9761904761904762
3729,4244,저급/Noun,42,2,40,4.445926419917751e-05,0.000466469712787934,0.9523809523809524
3730,4245,귀요미/Noun,42,38,4,0.000444592641991775,6.663853039827628e-05,0.9047619047619048
3731,4246,화만/Noun,42,4,38,6.668889629876625e-05,0.0004442568693218419,0.9047619047619048
3732,4247,에든/Josa,42,37,5,0.0004334778259419807,7.774495213132233e-05,0.8809523809523809
3733,4248,집어넣다/Verb,42,5,37,7.780371234856063e-05,0.0004331504475887958,0.8809523809523809
3734,4249,미안/Noun,42,6,36,8.891852839835501e-05,0.0004220440258557498,0.8571428571428571
3735,4250,이준기/Noun,42,35,7,0.0004112481938423919,9.995779559741441e-05,0.8333333333333334
3736,4251,망상/Noun,42,8,34,0.00011114816049794375,0.00039983118238965764,0.8095238095238095
3737,4252,눈뜨다/Verb,42,8,34,0.00011114816049794375,0.00039983118238965764,0.8095238095238095
3738,4253,찜찜하다/Adjective,42,8,34,0.00011114816049794375,0.00039983118238965764,0.8095238095238095
3739,4254,매혹/Noun,42,33,9,0.00038901856174280313,0.00012217063906350652,0.7857142857142857
3740,4255,경계/Noun,42,33,9,0.00038901856174280313,0.00012217063906350652,0.7857142857142857
3741,4256,상치/Noun,42,33,9,0.00038901856174280313,0.00012217063906350652,0.7857142857142857
3742,4257,진짜진짜/Noun,42,33,9,0.00038901856174280313,0.00012217063906350652,0.7857142857142857
3743,4258,자유롭다/Adjective,42,33,9,0.00038901856174280313,0.00012217063906350652,0.7857142857142857
3744,4259,사춘기/Noun,42,32,10,0.00037790374569300877,0.00013327706079655256,0.7619047619047619
3745,4260,앵글/Noun,42,10,32,0.0001333777925975325,0.0003776183389235656,0.7619047619047619
3746,4261,내기/Noun,42,11,31,0.0001444926086473269,0.00036651191719051963,0.7380952380952381
3747,4262,원인/Noun,42,11,31,0.0001444926086473269,0.00036651191719051963,0.7380952380952381
3748,4263,..??/Punctuation,42,11,31,0.0001444926086473269,0.00036651191719051963,0.7380952380952381
3749,4264,박신양/Noun,42,30,12,0.00035567411359342004,0.00015548990426264466,0.7142857142857143
3750,4265,덕후/Noun,42,12,30,0.00015560742469712126,0.0003554054954574735,0.7142857142857143
3751,4266,4년/Number,42,29,13,0.0003445592975436257,0.0001665963259956907,0.6904761904761905
3752,4267,주상욱/Noun,42,13,29,0.00016672224074691566,0.00034429907372442745,0.6904761904761905
3753,4268,강제/Noun,42,13,29,0.00016672224074691566,0.00034429907372442745,0.6904761904761905
3754,4269,유아인/Noun,42,28,14,0.0003334444814938313,0.00017770274772873674,0.6666666666666666
3755,4270,............/Punctuation,42,14,28,0.00017783705679671002,0.0003331926519913814,0.6666666666666666
3756,4271,원표/Noun,42,28,14,0.0003334444814938313,0.00017770274772873674,0.6666666666666666
3757,4272,가르다/Verb,42,28,14,0.0003334444814938313,0.00017770274772873674,0.6666666666666666
3758,4273,도하/Noun,42,27,15,0.00032232966544403684,0.0001888091694617828,0.6428571428571429
3759,4274,3년/Number,42,27,15,0.00032232966544403684,0.0001888091694617828,0.6428571428571429
3760,4275,그딴/Modifier,42,15,27,0.00018895187284650438,0.00032208623025833537,0.6428571428571429
3761,4276,권하다/Verb,42,15,27,0.00018895187284650438,0.00032208623025833537,0.6428571428571429
3762,4277,아프리카/Noun,42,26,16,0.00031121484939424253,0.00019991559119482882,0.6190476190476191
3763,4278,강지환/Noun,42,26,16,0.00031121484939424253,0.00019991559119482882,0.6190476190476191
3764,4279,포켓몬/Noun,42,17,25,0.00021118150494609317,0.0002998733867922433,0.5952380952380952
3765,4280,ㄱㄱ/KoreanParticle,42,17,25,0.00021118150494609317,0.0002998733867922433,0.5952380952380952
3766,4281,CGV/Alpha,42,17,25,0.00021118150494609317,0.0002998733867922433,0.5952380952380952
3767,4282,고로/Noun,42,18,24,0.0002222963209958875,0.0002887669650591972,0.5714285714285714
3768,4283,휴먼/Noun,42,24,18,0.0002889852172946538,0.00022212843466092096,0.5714285714285714
3769,4284,구르다/Verb,42,18,24,0.0002222963209958875,0.0002887669650591972,0.5714285714285714
3770,4285,여동생/Noun,42,18,24,0.0002222963209958875,0.0002887669650591972,0.5714285714285714
3771,4286,조금씩/Adverb,42,23,19,0.00027787040124485944,0.000233234856393967,0.5476190476190477
3772,4287,아가/Noun,42,23,19,0.00027787040124485944,0.000233234856393967,0.5476190476190477
3773,4288,3일/Number,42,23,19,0.00027787040124485944,0.000233234856393967,0.5476190476190477
3774,4289,고발/Noun,42,19,23,0.0002334111370456819,0.00027766054332615115,0.5476190476190477
3775,4290,랩/Noun,42,19,23,0.0002334111370456819,0.00027766054332615115,0.5476190476190477
3776,4291,닉/Noun,42,23,19,0.00027787040124485944,0.000233234856393967,0.5476190476190477
3777,4292,*/Punctuation,42,19,23,0.0002334111370456819,0.00027766054332615115,0.5476190476190477
3778,4293,땡기다/Verb,42,23,19,0.00027787040124485944,0.000233234856393967,0.5476190476190477
3779,4306,서프라이즈/Noun,41,2,39,4.445926419917751e-05,0.000455363291054888,0.951219512195122
3780,4307,존잼/Noun,41,39,2,0.00045570745804156943,4.4425686932184186e-05,0.951219512195122
3781,4308,가슴속/Noun,41,39,2,0.00045570745804156943,4.4425686932184186e-05,0.951219512195122
3782,4309,우리네/Noun,41,39,2,0.00045570745804156943,4.4425686932184186e-05,0.951219512195122
3783,4310,소박하다/Adjective,41,38,3,0.000444592641991775,5.553210866523024e-05,0.9268292682926829
3784,4311,짓거리/Noun,41,4,37,6.668889629876625e-05,0.0004331504475887958,0.902439024390244
3785,4312,희망이/Noun,41,36,5,0.00042236300989218633,7.774495213132233e-05,0.8780487804878049
3786,4313,예수님/Noun,41,35,6,0.0004112481938423919,8.885137386436837e-05,0.8536585365853658
3787,4314,충무로/Noun,41,8,33,0.00011114816049794375,0.00038872476065661166,0.8048780487804879
3788,4315,기쁨/Noun,41,33,8,0.00038901856174280313,0.00011106421733046048,0.8048780487804879
3789,4316,두근거리다/Adjective,41,33,8,0.00038901856174280313,0.00011106421733046048,0.8048780487804879
3790,4317,시보/Noun,41,33,8,0.00038901856174280313,0.00011106421733046048,0.8048780487804879
3791,4318,쏙/Noun,41,32,9,0.00037790374569300877,0.00012217063906350652,0.7804878048780488
3792,4319,쌈/Noun,41,9,32,0.00012226297654773814,0.0003776183389235656,0.7804878048780488
3793,4320,멘붕/Noun,41,9,32,0.00012226297654773814,0.0003776183389235656,0.7804878048780488
3794,4321,선하다/Adjective,41,32,9,0.00037790374569300877,0.00012217063906350652,0.7804878048780488
3795,4322,조조/Noun,41,10,31,0.0001333777925975325,0.00036651191719051963,0.7560975609756098
3796,4323,꼴리다/Verb,41,10,31,0.0001333777925975325,0.00036651191719051963,0.7560975609756098
3797,4324,행위/Noun,41,11,30,0.0001444926086473269,0.0003554054954574735,0.7317073170731707
3798,4325,유오성/Noun,41,12,29,0.00015560742469712126,0.00034429907372442745,0.7073170731707317
3799,4326,미흡하다/Adjective,41,12,29,0.00015560742469712126,0.00034429907372442745,0.7073170731707317
3800,4327,^^;/Punctuation,41,29,12,0.0003445592975436257,0.00015548990426264466,0.7073170731707317
3801,4328,오타쿠/Noun,41,12,29,0.00015560742469712126,0.00034429907372442745,0.7073170731707317
3802,4329,어우/Noun,41,12,29,0.00015560742469712126,0.00034429907372442745,0.7073170731707317
3803,4330,피터/Noun,41,29,12,0.0003445592975436257,0.00015548990426264466,0.7073170731707317
3804,4331,쓰기/Noun,41,12,29,0.00015560742469712126,0.00034429907372442745,0.7073170731707317
3805,4332,파고들다/Verb,41,29,12,0.0003445592975436257,0.00015548990426264466,0.7073170731707317
3806,4333,웹툰/Noun,41,12,29,0.00015560742469712126,0.00034429907372442745,0.7073170731707317
3807,4334,이러하다/Adjective,41,29,12,0.0003445592975436257,0.00015548990426264466,0.7073170731707317
3808,4335,->/Punctuation,41,13,28,0.00016672224074691566,0.0003331926519913814,0.6829268292682927
3809,4336,임신/Noun,41,13,28,0.00016672224074691566,0.0003331926519913814,0.6829268292682927
3810,4337,맷/Noun,41,28,13,0.0003334444814938313,0.0001665963259956907,0.6829268292682927
3811,4338,50년/Number,41,28,13,0.0003334444814938313,0.0001665963259956907,0.6829268292682927
3812,4339,디지다/Verb,41,13,28,0.00016672224074691566,0.0003331926519913814,0.6829268292682927
3813,4340,수십/Modifier,41,28,13,0.0003334444814938313,0.0001665963259956907,0.6829268292682927
3814,4341,차이다/Verb,41,13,28,0.00016672224074691566,0.0003331926519913814,0.6829268292682927
3815,4342,2012년/Number,41,14,27,0.00017783705679671002,0.00032208623025833537,0.6585365853658537
3816,4343,언급/Noun,41,14,27,0.00017783705679671002,0.00032208623025833537,0.6585365853658537
3817,4344,통수/Noun,41,14,27,0.00017783705679671002,0.00032208623025833537,0.6585365853658537
3818,4345,대로/Noun,41,14,27,0.00017783705679671002,0.00032208623025833537,0.6585365853658537
3819,4346,부턴/Josa,41,14,27,0.00017783705679671002,0.00032208623025833537,0.6585365853658537
3820,4347,it/Alpha,41,27,14,0.00032232966544403684,0.00017770274772873674,0.6585365853658537
3821,4348,황비홍/Noun,41,26,15,0.00031121484939424253,0.0001888091694617828,0.6341463414634146
3822,4349,해피/Noun,41,26,15,0.00031121484939424253,0.0001888091694617828,0.6341463414634146
3823,4350,지역/Noun,41,15,26,0.00018895187284650438,0.00031097980852528933,0.6341463414634146
3824,4351,궁/Noun,41,15,26,0.00018895187284650438,0.00031097980852528933,0.6341463414634146
3825,4352,날아가다/Verb,41,16,25,0.0002000666888962988,0.0002998733867922433,0.6097560975609756
3826,4353,@/Punctuation,41,16,25,0.0002000666888962988,0.0002998733867922433,0.6097560975609756
3827,4354,레드/Noun,41,25,16,0.00030010003334444816,0.00019991559119482882,0.6097560975609756
3828,4355,압박/Noun,41,16,25,0.0002000666888962988,0.0002998733867922433,0.6097560975609756
3829,4356,자매/Noun,41,17,24,0.00021118150494609317,0.0002887669650591972,0.5853658536585366
3830,4357,일베충/Noun,41,24,17,0.0002889852172946538,0.0002110220129278749,0.5853658536585366
3831,4358,독/Noun,41,17,24,0.00021118150494609317,0.0002887669650591972,0.5853658536585366
3832,4359,디자인/Noun,41,17,24,0.00021118150494609317,0.0002887669650591972,0.5853658536585366
3833,4360,재기/Noun,41,24,17,0.0002889852172946538,0.0002110220129278749,0.5853658536585366
3834,4361,작렬/Noun,41,17,24,0.00021118150494609317,0.0002887669650591972,0.5853658536585366
3835,4362,죽여주다/Verb,41,23,18,0.00027787040124485944,0.00022212843466092096,0.5609756097560976
3836,4363,어르다/Verb,41,18,23,0.0002222963209958875,0.00027766054332615115,0.5609756097560976
3837,4364,책임/Noun,41,18,23,0.0002222963209958875,0.00027766054332615115,0.5609756097560976
3838,4365,가능/Noun,41,23,18,0.00027787040124485944,0.00022212843466092096,0.5609756097560976
3839,4366,장나라/Noun,41,23,18,0.00027787040124485944,0.00022212843466092096,0.5609756097560976
3840,4367,휴가/Noun,41,23,18,0.00027787040124485944,0.00022212843466092096,0.5609756097560976
3841,4368,2013년/Number,41,18,23,0.0002222963209958875,0.00027766054332615115,0.5609756097560976
3842,4369,진작/Noun,41,23,18,0.00027787040124485944,0.00022212843466092096,0.5609756097560976
3843,4370,현/Noun,41,19,22,0.0002334111370456819,0.00026655412159310506,0.5365853658536586
3844,4371,빚/Noun,41,19,22,0.0002334111370456819,0.00026655412159310506,0.5365853658536586
3845,4372,식스센스/Noun,41,19,22,0.0002334111370456819,0.00026655412159310506,0.5365853658536586
3846,4376,위원/Noun,40,2,38,4.445926419917751e-05,0.0004442568693218419,0.95
3847,4377,찡/Adverb,40,37,3,0.0004334778259419807,5.553210866523024e-05,0.925
3848,4378,!^^/Punctuation,40,36,4,0.00042236300989218633,6.663853039827628e-05,0.9
3849,4379,상투/Noun,40,4,36,6.668889629876625e-05,0.0004220440258557498,0.9
3850,4380,마인드/Noun,40,5,35,7.780371234856063e-05,0.0004109376041227037,0.875
3851,4381,오인혜/Noun,40,5,35,7.780371234856063e-05,0.0004109376041227037,0.875
3852,4382,시리다/Adjective,40,35,5,0.0004112481938423919,7.774495213132233e-05,0.875
3853,4383,신파극/Noun,40,7,33,0.0001000333444481494,0.00038872476065661166,0.825
3854,4384,추락/Noun,40,7,33,0.0001000333444481494,0.00038872476065661166,0.825
3855,4385,이라곤/Josa,40,7,33,0.0001000333444481494,0.00038872476065661166,0.825
3856,4386,여정/Noun,40,32,8,0.00037790374569300877,0.00011106421733046048,0.8
3857,4387,귀가/Noun,40,32,8,0.00037790374569300877,0.00011106421733046048,0.8
3858,4388,증/Noun,40,8,32,0.00011114816049794375,0.0003776183389235656,0.8
3859,4389,어느새다/Adjective,40,32,8,0.00037790374569300877,0.00011106421733046048,0.8
3860,4390,이러니/Conjunction,40,8,32,0.00011114816049794375,0.0003776183389235656,0.8
3861,4391,강조/Noun,40,8,32,0.00011114816049794375,0.0003776183389235656,0.8
3862,4392,남자라면/Noun,40,32,8,0.00037790374569300877,0.00011106421733046048,0.8
3863,4393,ebs/Alpha,40,31,9,0.00036678892964321435,0.00012217063906350652,0.775
3864,4394,불법/Noun,40,9,31,0.00012226297654773814,0.00036651191719051963,0.775
3865,4395,저렴하다/Adjective,40,9,31,0.00012226297654773814,0.00036651191719051963,0.775
3866,4396,방이/Noun,40,30,10,0.00035567411359342004,0.00013327706079655256,0.75
3867,4397,곳곳/Noun,40,30,10,0.00035567411359342004,0.00013327706079655256,0.75
3868,4398,경이/Noun,40,30,10,0.00035567411359342004,0.00013327706079655256,0.75
3869,4399,옹박/Noun,40,10,30,0.0001333777925975325,0.0003554054954574735,0.75
3870,4400,자제/Noun,40,10,30,0.0001333777925975325,0.0003554054954574735,0.75
3871,4401,빼/Noun,40,11,29,0.0001444926086473269,0.00034429907372442745,0.725
3872,4402,우월/Noun,40,11,29,0.0001444926086473269,0.00034429907372442745,0.725
3873,4403,~~!/Punctuation,40,29,11,0.0003445592975436257,0.0001443834825295986,0.725
3874,4404,획/Noun,40,29,11,0.0003445592975436257,0.0001443834825295986,0.725
3875,4405,수업/Noun,40,29,11,0.0003445592975436257,0.0001443834825295986,0.725
3876,4406,호러물/Noun,40,11,29,0.0001444926086473269,0.00034429907372442745,0.725
3877,4407,유명/Noun,40,11,29,0.0001444926086473269,0.00034429907372442745,0.725
3878,4408,우디/Noun,40,28,12,0.0003334444814938313,0.00015548990426264466,0.7
3879,4409,승화/Noun,40,28,12,0.0003334444814938313,0.00015548990426264466,0.7
3880,4410,교감/Noun,40,28,12,0.0003334444814938313,0.00015548990426264466,0.7
3881,4411,외우다/Verb,40,28,12,0.0003334444814938313,0.00015548990426264466,0.7
3882,4412,퀴어/Noun,40,28,12,0.0003334444814938313,0.00015548990426264466,0.7
3883,4413,쫒다/Verb,40,13,27,0.00016672224074691566,0.00032208623025833537,0.675
3884,4414,수정/Noun,40,13,27,0.00016672224074691566,0.00032208623025833537,0.675
3885,4415,저녁/Noun,40,13,27,0.00016672224074691566,0.00032208623025833537,0.675
3886,4416,전의/Noun,40,26,14,0.00031121484939424253,0.00017770274772873674,0.65
3887,4417,상의/Noun,40,26,14,0.00031121484939424253,0.00017770274772873674,0.65
3888,4418,독창/Noun,40,14,26,0.00017783705679671002,0.00031097980852528933,0.65
3889,4419,매트릭스/Noun,40,26,14,0.00031121484939424253,0.00017770274772873674,0.65
3890,4420,버젼/Noun,40,15,25,0.00018895187284650438,0.0002998733867922433,0.625
3891,4421,김강우/Noun,40,24,16,0.0002889852172946538,0.00019991559119482882,0.6
3892,4422,런닝맨/Noun,40,16,24,0.0002000666888962988,0.0002887669650591972,0.6
3893,4423,리오/Noun,40,24,16,0.0002889852172946538,0.00019991559119482882,0.6
3894,4424,금방/Noun,40,24,16,0.0002889852172946538,0.00019991559119482882,0.6
3895,4425,정재영/Noun,40,24,16,0.0002889852172946538,0.00019991559119482882,0.6
3896,4426,건드리다/Verb,40,16,24,0.0002000666888962988,0.0002887669650591972,0.6
3897,4427,턱/Noun,40,17,23,0.00021118150494609317,0.00027766054332615115,0.575
3898,4428,감당/Noun,40,17,23,0.00021118150494609317,0.00027766054332615115,0.575
3899,4429,산드라/Noun,40,23,17,0.00027787040124485944,0.0002110220129278749,0.575
3900,4430,왓/Noun,40,23,17,0.00027787040124485944,0.0002110220129278749,0.575
3901,4431,애도/Noun,40,17,23,0.00021118150494609317,0.00027766054332615115,0.575
3902,4432,ㄹ/KoreanParticle,40,17,23,0.00021118150494609317,0.00027766054332615115,0.575
3903,4433,2004년/Number,40,23,17,0.00027787040124485944,0.0002110220129278749,0.575
3904,4434,한없이/Adverb,40,22,18,0.000266755585195065,0.00022212843466092096,0.55
3905,4435,높이/Noun,40,18,22,0.0002222963209958875,0.00026655412159310506,0.55
3906,4436,아자/Exclamation,40,22,18,0.000266755585195065,0.00022212843466092096,0.55
3907,4437,막스/Noun,40,22,18,0.000266755585195065,0.00022212843466092096,0.55
3908,4438,김민종/Noun,40,18,22,0.0002222963209958875,0.00026655412159310506,0.55
3909,4439,활/Noun,40,18,22,0.0002222963209958875,0.00026655412159310506,0.55
3910,4449,투자자/Noun,39,0,39,2.2229632099588756e-05,0.000455363291054888,1.0
3911,4450,졸음/Noun,39,1,38,3.334444814938313e-05,0.0004442568693218419,0.9743589743589745
3912,4451,쓰레기통/Noun,39,1,38,3.334444814938313e-05,0.0004442568693218419,0.9743589743589745
3913,4452,문성우/Noun,39,2,37,4.445926419917751e-05,0.0004331504475887958,0.9487179487179488
3914,4453,환불/Noun,39,3,36,5.5574080248971876e-05,0.0004220440258557498,0.9230769230769232
3915,4454,황홀하다/Adjective,39,36,3,0.00042236300989218633,5.553210866523024e-05,0.9230769230769232
3916,4455,뭡/Noun,39,4,35,6.668889629876625e-05,0.0004109376041227037,0.8974358974358975
3917,4456,은은하다/Adjective,39,35,4,0.0004112481938423919,6.663853039827628e-05,0.8974358974358975
3918,4457,에서야/Josa,39,35,4,0.0004112481938423919,6.663853039827628e-05,0.8974358974358975
3919,4458,후지/Noun,39,4,35,6.668889629876625e-05,0.0004109376041227037,0.8974358974358975
3920,4459,우익/Noun,39,5,34,7.780371234856063e-05,0.00039983118238965764,0.8717948717948718
3921,4460,엉덩이/Noun,39,6,33,8.891852839835501e-05,0.00038872476065661166,0.8461538461538461
3922,4461,에릭/Noun,39,33,6,0.00038901856174280313,8.885137386436837e-05,0.8461538461538461
3923,4462,불면증/Noun,39,7,32,0.0001000333444481494,0.0003776183389235656,0.8205128205128205
3924,4463,찌푸리다/Verb,39,7,32,0.0001000333444481494,0.0003776183389235656,0.8205128205128205
3925,4464,구라/Noun,39,7,32,0.0001000333444481494,0.0003776183389235656,0.8205128205128205
3926,4465,젊음/Noun,39,31,8,0.00036678892964321435,0.00011106421733046048,0.7948717948717948
3927,4466,놀이/Suffix,39,8,31,0.00011114816049794375,0.00036651191719051963,0.7948717948717948
3928,4467,파이다/Verb,39,31,8,0.00036678892964321435,0.00011106421733046048,0.7948717948717948
3929,4468,울음/Noun,39,31,8,0.00036678892964321435,0.00011106421733046048,0.7948717948717948
3930,4469,헤어/Noun,39,30,9,0.00035567411359342004,0.00012217063906350652,0.7692307692307693
3931,4470,mbc/Alpha,39,9,30,0.00012226297654773814,0.0003554054954574735,0.7692307692307693
3932,4471,루이스/Noun,39,29,10,0.0003445592975436257,0.00013327706079655256,0.7435897435897436
3933,4472,에일리언/Noun,39,11,28,0.0001444926086473269,0.0003331926519913814,0.7179487179487181
3934,4473,전기/Noun,39,11,28,0.0001444926086473269,0.0003331926519913814,0.7179487179487181
3935,4474,극한/Noun,39,28,11,0.0003334444814938313,0.0001443834825295986,0.7179487179487181
3936,4475,우아하다/Adjective,39,28,11,0.0003334444814938313,0.0001443834825295986,0.7179487179487181
3937,4476,묘미/Noun,39,28,11,0.0003334444814938313,0.0001443834825295986,0.7179487179487181
3938,4477,관계자/Noun,39,11,28,0.0001444926086473269,0.0003331926519913814,0.7179487179487181
3939,4478,로그/Noun,39,11,28,0.0001444926086473269,0.0003331926519913814,0.7179487179487181
3940,4479,사나이/Noun,39,27,12,0.00032232966544403684,0.00015548990426264466,0.6923076923076923
3941,4480,오류/Noun,39,12,27,0.00015560742469712126,0.00032208623025833537,0.6923076923076923
3942,4481,이민정/Noun,39,27,12,0.00032232966544403684,0.00015548990426264466,0.6923076923076923
3943,4482,완/Noun,39,27,12,0.00032232966544403684,0.00015548990426264466,0.6923076923076923
3944,4483,한쪽/Noun,39,12,27,0.00015560742469712126,0.00032208623025833537,0.6923076923076923
3945,4484,활약/Noun,39,27,12,0.00032232966544403684,0.00015548990426264466,0.6923076923076923
3946,4485,필수/Noun,39,27,12,0.00032232966544403684,0.00015548990426264466,0.6923076923076923
3947,4486,제시/Noun,39,27,12,0.00032232966544403684,0.00015548990426264466,0.6923076923076923
3948,4487,찢다/Verb,39,13,26,0.00016672224074691566,0.00031097980852528933,0.6666666666666666
3949,4488,때메/Noun,39,13,26,0.00016672224074691566,0.00031097980852528933,0.6666666666666666
3950,4489,가사/Noun,39,26,13,0.00031121484939424253,0.0001665963259956907,0.6666666666666666
3951,4490,기간/Noun,39,26,13,0.00031121484939424253,0.0001665963259956907,0.6666666666666666
3952,4491,in/Alpha,39,26,13,0.00031121484939424253,0.0001665963259956907,0.6666666666666666
3953,4492,핸드폰/Noun,39,13,26,0.00016672224074691566,0.00031097980852528933,0.6666666666666666
3954,4493,멍청이/Noun,39,13,26,0.00016672224074691566,0.00031097980852528933,0.6666666666666666
3955,4494,사라/Noun,39,26,13,0.00031121484939424253,0.0001665963259956907,0.6666666666666666
3956,4495,쿠/Noun,39,26,13,0.00031121484939424253,0.0001665963259956907,0.6666666666666666
3957,4496,수다/Noun,39,14,25,0.00017783705679671002,0.0002998733867922433,0.6410256410256411
3958,4497,에의/Josa,39,25,14,0.00030010003334444816,0.00017770274772873674,0.6410256410256411
3959,4498,불러일으키다/Verb,39,25,14,0.00030010003334444816,0.00017770274772873674,0.6410256410256411
3960,4499,내겐/Noun,39,25,14,0.00030010003334444816,0.00017770274772873674,0.6410256410256411
3961,4500,크로우/Noun,39,25,14,0.00030010003334444816,0.00017770274772873674,0.6410256410256411
3962,4501,로렌스/Noun,39,25,14,0.00030010003334444816,0.00017770274772873674,0.6410256410256411
3963,4502,다음주/Noun,39,25,14,0.00030010003334444816,0.00017770274772873674,0.6410256410256411
3964,4503,불리다/Verb,39,24,15,0.0002889852172946538,0.0001888091694617828,0.6153846153846154
3965,4504,예매/Noun,39,15,24,0.00018895187284650438,0.0002887669650591972,0.6153846153846154
3966,4505,폭/Noun,39,24,15,0.0002889852172946538,0.0001888091694617828,0.6153846153846154
3967,4506,연장/Noun,39,15,24,0.00018895187284650438,0.0002887669650591972,0.6153846153846154
3968,4507,시르다/Adjective,39,15,24,0.00018895187284650438,0.0002887669650591972,0.6153846153846154
3969,4508,임용/Noun,39,16,23,0.0002000666888962988,0.00027766054332615115,0.5897435897435898
3970,4509,to/Alpha,39,23,16,0.00027787040124485944,0.00019991559119482882,0.5897435897435898
3971,4510,단편영화/Noun,39,16,23,0.0002000666888962988,0.00027766054332615115,0.5897435897435898
3972,4511,맥스/Noun,39,23,16,0.00027787040124485944,0.00019991559119482882,0.5897435897435898
3973,4512,전적/Noun,39,16,23,0.0002000666888962988,0.00027766054332615115,0.5897435897435898
3974,4513,그러면/Adverb,39,16,23,0.0002000666888962988,0.00027766054332615115,0.5897435897435898
3975,4514,창작/Noun,39,16,23,0.0002000666888962988,0.00027766054332615115,0.5897435897435898
3976,4515,볼땐/Noun,39,22,17,0.000266755585195065,0.0002110220129278749,0.5641025641025641
3977,4516,발생/Noun,39,22,17,0.000266755585195065,0.0002110220129278749,0.5641025641025641
3978,4517,사망/Noun,39,17,22,0.00021118150494609317,0.00026655412159310506,0.5641025641025641
3979,4518,다문화/Noun,39,17,22,0.00021118150494609317,0.00026655412159310506,0.5641025641025641
3980,4519,악평/Noun,39,22,17,0.000266755585195065,0.0002110220129278749,0.5641025641025641
3981,4520,호텔/Noun,39,21,18,0.00025564076914527065,0.00022212843466092096,0.5384615384615384
3982,4521,비난/Noun,39,21,18,0.00025564076914527065,0.00022212843466092096,0.5384615384615384
3983,4522,치명/Noun,39,21,18,0.00025564076914527065,0.00022212843466092096,0.5384615384615384
3984,4523,컬트/Noun,39,21,18,0.00025564076914527065,0.00022212843466092096,0.5384615384615384
3985,4524,샤를/Noun,39,21,18,0.00025564076914527065,0.00022212843466092096,0.5384615384615384
3986,4525,종일/Noun,39,18,21,0.0002222963209958875,0.0002554476998600591,0.5384615384615384
3987,4526,조직/Noun,39,21,18,0.00025564076914527065,0.00022212843466092096,0.5384615384615384
3988,4534,안질리다/Verb,38,37,1,0.0004334778259419807,3.331926519913814e-05,0.9736842105263158
3989,4535,아리다/Adjective,38,36,2,0.00042236300989218633,4.4425686932184186e-05,0.9473684210526316
3990,4536,자빠지다/Verb,38,3,35,5.5574080248971876e-05,0.0004109376041227037,0.9210526315789472
3991,4537,무니/Noun,38,5,33,7.780371234856063e-05,0.00038872476065661166,0.8684210526315791
3992,4538,불친절하다/Adjective,38,5,33,7.780371234856063e-05,0.00038872476065661166,0.8684210526315791
3993,4539,은지/Noun,38,5,33,7.780371234856063e-05,0.00038872476065661166,0.8684210526315791
3994,4540,거창하다/Adjective,38,5,33,7.780371234856063e-05,0.00038872476065661166,0.8684210526315791
3995,4541,깝/Noun,38,6,32,8.891852839835501e-05,0.0003776183389235656,0.8421052631578947
3996,4542,0.5/Number,38,6,32,8.891852839835501e-05,0.0003776183389235656,0.8421052631578947
3997,4543,허탈하다/Adjective,38,7,31,0.0001000333444481494,0.00036651191719051963,0.8157894736842105
3998,4544,!!!!!!!/Punctuation,38,31,7,0.00036678892964321435,9.995779559741441e-05,0.8157894736842105
3999,4545,현대인/Noun,38,31,7,0.00036678892964321435,9.995779559741441e-05,0.8157894736842105
4000,4546,화평/Noun,38,9,29,0.00012226297654773814,0.00034429907372442745,0.7631578947368421
4001,4547,살아오다/Verb,38,29,9,0.0003445592975436257,0.00012217063906350652,0.7631578947368421
4002,4548,까먹다/Verb,38,9,29,0.00012226297654773814,0.00034429907372442745,0.7631578947368421
4003,4549,치열하다/Adjective,38,28,10,0.0003334444814938313,0.00013327706079655256,0.7368421052631579
4004,4550,제작사/Noun,38,10,28,0.0001333777925975325,0.0003331926519913814,0.7368421052631579
4005,4551,경쾌하다/Adjective,38,28,10,0.0003334444814938313,0.00013327706079655256,0.7368421052631579
4006,4552,연령/Noun,38,10,28,0.0001333777925975325,0.0003331926519913814,0.7368421052631579
4007,4553,F/Alpha,38,11,27,0.0001444926086473269,0.00032208623025833537,0.7105263157894737
4008,4554,간의/Noun,38,27,11,0.00032232966544403684,0.0001443834825295986,0.7105263157894737
4009,4555,생략/Noun,38,11,27,0.0001444926086473269,0.00032208623025833537,0.7105263157894737
4010,4556,14년/Number,38,27,11,0.00032232966544403684,0.0001443834825295986,0.7105263157894737
4011,4557,가버리다/Verb,38,12,26,0.00015560742469712126,0.00031097980852528933,0.6842105263157895
4012,4558,미만/Noun,38,12,26,0.00015560742469712126,0.00031097980852528933,0.6842105263157895
4013,4559,전세계/Noun,38,26,12,0.00031121484939424253,0.00015548990426264466,0.6842105263157895
4014,4560,질주/Noun,38,25,13,0.00030010003334444816,0.0001665963259956907,0.6578947368421053
4015,4561,아카데미/Noun,38,25,13,0.00030010003334444816,0.0001665963259956907,0.6578947368421053
4016,4562,부수/Noun,38,13,25,0.00016672224074691566,0.0002998733867922433,0.6578947368421053
4017,4563,동의/Noun,38,13,25,0.00016672224074691566,0.0002998733867922433,0.6578947368421053
4018,4564,청/Noun,38,13,25,0.00016672224074691566,0.0002998733867922433,0.6578947368421053
4019,4565,멍하다/Adjective,38,25,13,0.00030010003334444816,0.0001665963259956907,0.6578947368421053
4020,4566,물어보다/Verb,38,13,25,0.00016672224074691566,0.0002998733867922433,0.6578947368421053
4021,4567,빅뱅/Noun,38,24,14,0.0002889852172946538,0.00017770274772873674,0.631578947368421
4022,4568,레인/Noun,38,14,24,0.00017783705679671002,0.0002887669650591972,0.631578947368421
4023,4569,훈련/Noun,38,14,24,0.00017783705679671002,0.0002887669650591972,0.631578947368421
4024,4570,"..,/Punctuation",38,14,24,0.00017783705679671002,0.0002887669650591972,0.631578947368421
4025,4571,법칙/Noun,38,14,24,0.00017783705679671002,0.0002887669650591972,0.631578947368421
4026,4572,삼다/Verb,38,14,24,0.00017783705679671002,0.0002887669650591972,0.631578947368421
4027,4573,보장/Noun,38,24,14,0.0002889852172946538,0.00017770274772873674,0.631578947368421
4028,4574,마마/Noun,38,14,24,0.00017783705679671002,0.0002887669650591972,0.631578947368421
4029,4575,케이트/Noun,38,23,15,0.00027787040124485944,0.0001888091694617828,0.6052631578947368
4030,4576,얽히다/Verb,38,23,15,0.00027787040124485944,0.0001888091694617828,0.6052631578947368
4031,4577,직장/Noun,38,23,15,0.00027787040124485944,0.0001888091694617828,0.6052631578947368
4032,4578,로마/Noun,38,15,23,0.00018895187284650438,0.00027766054332615115,0.6052631578947368
4033,4579,트릭/Noun,38,23,15,0.00027787040124485944,0.0001888091694617828,0.6052631578947368
4034,4580,현빈/Noun,38,23,15,0.00027787040124485944,0.0001888091694617828,0.6052631578947368
4035,4581,허영/Noun,38,15,23,0.00018895187284650438,0.00027766054332615115,0.6052631578947368
4036,4582,에이리언/Noun,38,22,16,0.000266755585195065,0.00019991559119482882,0.5789473684210527
4037,4583,꾼/Suffix,38,16,22,0.0002000666888962988,0.00026655412159310506,0.5789473684210527
4038,4584,코스트/Noun,38,22,16,0.000266755585195065,0.00019991559119482882,0.5789473684210527
4039,4585,가운데/Noun,38,22,16,0.000266755585195065,0.00019991559119482882,0.5789473684210527
4040,4586,무려/Noun,38,22,16,0.000266755585195065,0.00019991559119482882,0.5789473684210527
4041,4587,동료/Noun,38,21,17,0.00025564076914527065,0.0002110220129278749,0.5526315789473685
4042,4588,높아지다/Verb,38,17,21,0.00021118150494609317,0.0002554476998600591,0.5526315789473685
4043,4589,외화/Noun,38,17,21,0.00021118150494609317,0.0002554476998600591,0.5526315789473685
4044,4590,가만히/Adverb,38,17,21,0.00021118150494609317,0.0002554476998600591,0.5526315789473685
4045,4591,자세/Noun,38,17,21,0.00021118150494609317,0.0002554476998600591,0.5526315789473685
4046,4592,나약하다/Adjective,38,21,17,0.00025564076914527065,0.0002110220129278749,0.5526315789473685
4047,4602,찬란/Noun,37,0,37,2.2229632099588756e-05,0.0004331504475887958,1.0
4048,4603,채플린/Noun,37,34,3,0.0004001333777925976,5.553210866523024e-05,0.9189189189189191
4049,4604,대책/Noun,37,3,34,5.5574080248971876e-05,0.00039983118238965764,0.9189189189189191
4050,4605,날로/Noun,37,3,34,5.5574080248971876e-05,0.00039983118238965764,0.9189189189189191
4051,4606,개잼/Noun,37,33,4,0.00038901856174280313,6.663853039827628e-05,0.8918918918918919
4052,4607,워싱턴/Noun,37,33,4,0.00038901856174280313,6.663853039827628e-05,0.8918918918918919
4053,4608,꾹/Noun,37,4,33,6.668889629876625e-05,0.00038872476065661166,0.8918918918918919
4054,4609,거뭐/Noun,37,5,32,7.780371234856063e-05,0.0003776183389235656,0.8648648648648649
4055,4610,설레임/Noun,37,32,5,0.00037790374569300877,7.774495213132233e-05,0.8648648648648649
4056,4611,습작/Noun,37,5,32,7.780371234856063e-05,0.0003776183389235656,0.8648648648648649
4057,4612,신들리다/Adjective,37,32,5,0.00037790374569300877,7.774495213132233e-05,0.8648648648648649
4058,4613,두근두근/Adverb,37,31,6,0.00036678892964321435,8.885137386436837e-05,0.8378378378378378
4059,4614,뇌리/Noun,37,31,6,0.00036678892964321435,8.885137386436837e-05,0.8378378378378378
4060,4615,패턴/Noun,37,6,31,8.891852839835501e-05,0.00036651191719051963,0.8378378378378378
4061,4616,공개/Noun,37,6,31,8.891852839835501e-05,0.00036651191719051963,0.8378378378378378
4062,4617,동아리/Noun,37,6,31,8.891852839835501e-05,0.00036651191719051963,0.8378378378378378
4063,4618,몰락/Noun,37,7,30,0.0001000333444481494,0.0003554054954574735,0.8108108108108109
4064,4619,옹호/Noun,37,7,30,0.0001000333444481494,0.0003554054954574735,0.8108108108108109
4065,4620,껄/Noun,37,7,30,0.0001000333444481494,0.0003554054954574735,0.8108108108108109
4066,4621,오로라/Noun,37,7,30,0.0001000333444481494,0.0003554054954574735,0.8108108108108109
4067,4622,신비롭다/Adjective,37,30,7,0.00035567411359342004,9.995779559741441e-05,0.8108108108108109
4068,4623,이라고는/Josa,37,8,29,0.00011114816049794375,0.00034429907372442745,0.7837837837837838
4069,4624,넋/Noun,37,29,8,0.0003445592975436257,0.00011106421733046048,0.7837837837837838
4070,4625,눈부시다/Adjective,37,29,8,0.0003445592975436257,0.00011106421733046048,0.7837837837837838
4071,4626,서우/Noun,37,8,29,0.00011114816049794375,0.00034429907372442745,0.7837837837837838
4072,4627,라곤/Josa,37,8,29,0.00011114816049794375,0.00034429907372442745,0.7837837837837838
4073,4628,닦다/Verb,37,8,29,0.00011114816049794375,0.00034429907372442745,0.7837837837837838
4074,4629,강호동/Noun,37,9,28,0.00012226297654773814,0.0003331926519913814,0.7567567567567568
4075,4630,탕웨이/Noun,37,28,9,0.0003334444814938313,0.00012217063906350652,0.7567567567567568
4076,4631,유도/Noun,37,9,28,0.00012226297654773814,0.0003331926519913814,0.7567567567567568
4077,4632,고질라/Noun,37,9,28,0.00012226297654773814,0.0003331926519913814,0.7567567567567568
4078,4633,엠마/Noun,37,28,9,0.0003334444814938313,0.00012217063906350652,0.7567567567567568
4079,4634,이남/Noun,37,28,9,0.0003334444814938313,0.00012217063906350652,0.7567567567567568
4080,4635,켄/Noun,37,28,9,0.0003334444814938313,0.00012217063906350652,0.7567567567567568
4081,4636,오랜/Adverb,37,27,10,0.00032232966544403684,0.00013327706079655256,0.7297297297297297
4082,4637,.!!/Punctuation,37,27,10,0.00032232966544403684,0.00013327706079655256,0.7297297297297297
4083,4638,근거/Noun,37,10,27,0.0001333777925975325,0.00032208623025833537,0.7297297297297297
4084,4639,브래드피트/Noun,37,27,10,0.00032232966544403684,0.00013327706079655256,0.7297297297297297
4085,4640,엑소시스트/Noun,37,10,27,0.0001333777925975325,0.00032208623025833537,0.7297297297297297
4086,4641,예의/Noun,37,11,26,0.0001444926086473269,0.00031097980852528933,0.7027027027027027
4087,4642,수술/Noun,37,11,26,0.0001444926086473269,0.00031097980852528933,0.7027027027027027
4088,4643,힙합/Noun,37,11,26,0.0001444926086473269,0.00031097980852528933,0.7027027027027027
4089,4644,............./Punctuation,37,11,26,0.0001444926086473269,0.00031097980852528933,0.7027027027027027
4090,4645,마초/Noun,37,11,26,0.0001444926086473269,0.00031097980852528933,0.7027027027027027
4091,4646,부담스럽다/Adjective,37,11,26,0.0001444926086473269,0.00031097980852528933,0.7027027027027027
4092,4647,소문/Noun,37,11,26,0.0001444926086473269,0.00031097980852528933,0.7027027027027027
4093,4648,사서/Noun,37,26,11,0.00031121484939424253,0.0001443834825295986,0.7027027027027027
4094,4649,변호사/Noun,37,26,11,0.00031121484939424253,0.0001443834825295986,0.7027027027027027
4095,4650,신선/Noun,37,25,12,0.00030010003334444816,0.00015548990426264466,0.6756756756756757
4096,4651,성향/Noun,37,12,25,0.00015560742469712126,0.0002998733867922433,0.6756756756756757
4097,4652,육체/Noun,37,13,24,0.00016672224074691566,0.0002887669650591972,0.6486486486486487
4098,4653,신현준/Noun,37,14,23,0.00017783705679671002,0.00027766054332615115,0.6216216216216216
4099,4654,진의/Noun,37,14,23,0.00017783705679671002,0.00027766054332615115,0.6216216216216216
4100,4655,유작/Noun,37,14,23,0.00017783705679671002,0.00027766054332615115,0.6216216216216216
4101,4656,간절하다/Adjective,37,23,14,0.00027787040124485944,0.00017770274772873674,0.6216216216216216
4102,4657,안경/Noun,37,14,23,0.00017783705679671002,0.00027766054332615115,0.6216216216216216
4103,4658,라지/Josa,37,14,23,0.00017783705679671002,0.00027766054332615115,0.6216216216216216
4104,4659,히트/Noun,37,23,14,0.00027787040124485944,0.00017770274772873674,0.6216216216216216
4105,4660,거울/Noun,37,23,14,0.00027787040124485944,0.00017770274772873674,0.6216216216216216
4106,4661,까지의/Josa,37,23,14,0.00027787040124485944,0.00017770274772873674,0.6216216216216216
4107,4662,용감하다/Adjective,37,22,15,0.000266755585195065,0.0001888091694617828,0.5945945945945946
4108,4663,나라/Suffix,37,15,22,0.00018895187284650438,0.00026655412159310506,0.5945945945945946
4109,4664,버금/Noun,37,22,15,0.000266755585195065,0.0001888091694617828,0.5945945945945946
4110,4665,믄/Modifier,37,15,22,0.00018895187284650438,0.00026655412159310506,0.5945945945945946
4111,4666,싹/Noun,37,15,22,0.00018895187284650438,0.00026655412159310506,0.5945945945945946
4112,4667,이순신/Noun,37,15,22,0.00018895187284650438,0.00026655412159310506,0.5945945945945946
4113,4668,주체/Noun,37,22,15,0.000266755585195065,0.0001888091694617828,0.5945945945945946
4114,4669,한장/Noun,37,22,15,0.000266755585195065,0.0001888091694617828,0.5945945945945946
4115,4670,나아지다/Verb,37,15,22,0.00018895187284650438,0.00026655412159310506,0.5945945945945946
4116,4671,마크/Noun,37,22,15,0.000266755585195065,0.0001888091694617828,0.5945945945945946
4117,4672,앞서다/Verb,37,21,16,0.00025564076914527065,0.00019991559119482882,0.5675675675675675
4118,4673,까메오/Noun,37,16,21,0.0002000666888962988,0.0002554476998600591,0.5675675675675675
4119,4674,홍진호/Noun,37,16,21,0.0002000666888962988,0.0002554476998600591,0.5675675675675675
4120,4675,300/Number,37,16,21,0.0002000666888962988,0.0002554476998600591,0.5675675675675675
4121,4676,제법/Noun,37,21,16,0.00025564076914527065,0.00019991559119482882,0.5675675675675675
4122,4677,더보/Noun,37,16,21,0.0002000666888962988,0.0002554476998600591,0.5675675675675675
4123,4678,페이/Noun,37,21,16,0.00025564076914527065,0.00019991559119482882,0.5675675675675675
4124,4679,이범수/Noun,37,21,16,0.00025564076914527065,0.00019991559119482882,0.5675675675675675
4125,4680,그러니까/Adverb,37,16,21,0.0002000666888962988,0.0002554476998600591,0.5675675675675675
4126,4681,금요일/Noun,37,21,16,0.00025564076914527065,0.00019991559119482882,0.5675675675675675
4127,4682,짐승/Noun,37,16,21,0.0002000666888962988,0.0002554476998600591,0.5675675675675675
4128,4683,부의/Noun,37,21,16,0.00025564076914527065,0.00019991559119482882,0.5675675675675675
4129,4684,지하철/Noun,37,16,21,0.0002000666888962988,0.0002554476998600591,0.5675675675675675
4130,4685,루크/Noun,37,21,16,0.00025564076914527065,0.00019991559119482882,0.5675675675675675
4131,4686,넓다/Adjective,37,17,20,0.00021118150494609317,0.00024434127812701304,0.5405405405405406
4132,4687,율/Noun,37,20,17,0.00024452595309547634,0.0002110220129278749,0.5405405405405406
4133,4688,황금/Noun,37,20,17,0.00024452595309547634,0.0002110220129278749,0.5405405405405406
4134,4689,부가/Noun,37,20,17,0.00024452595309547634,0.0002110220129278749,0.5405405405405406
4135,4690,스톤/Noun,37,17,20,0.00021118150494609317,0.00024434127812701304,0.5405405405405406
4136,4694,낚임/Noun,36,0,36,2.2229632099588756e-05,0.0004220440258557498,1.0
4137,4695,되돌아보다/Verb,36,35,1,0.0004112481938423919,3.331926519913814e-05,0.9722222222222222
4138,4696,보고/Foreign,36,3,33,5.5574080248971876e-05,0.00038872476065661166,0.9166666666666666
4139,4697,치기/Noun,36,3,33,5.5574080248971876e-05,0.00038872476065661166,0.9166666666666666
4140,4698,큐브/Noun,36,4,32,6.668889629876625e-05,0.0003776183389235656,0.8888888888888888
4141,4699,욤/Noun,36,31,5,0.00036678892964321435,7.774495213132233e-05,0.8611111111111112
4142,4700,허니/Noun,36,31,5,0.00036678892964321435,7.774495213132233e-05,0.8611111111111112
4143,4701,100분/Number,36,5,31,7.780371234856063e-05,0.00036651191719051963,0.8611111111111112
4144,4702,발암/Noun,36,5,31,7.780371234856063e-05,0.00036651191719051963,0.8611111111111112
4145,4703,엑스트라/Noun,36,6,30,8.891852839835501e-05,0.0003554054954574735,0.8333333333333334
4146,4704,서극/Noun,36,7,29,0.0001000333444481494,0.00034429907372442745,0.8055555555555556
4147,4705,멋대로/Noun,36,7,29,0.0001000333444481494,0.00034429907372442745,0.8055555555555556
4148,4706,평이하다/Adjective,36,7,29,0.0001000333444481494,0.00034429907372442745,0.8055555555555556
4149,4707,내러티브/Noun,36,8,28,0.00011114816049794375,0.0003331926519913814,0.7777777777777778
4150,4708,볼껄/Noun,36,8,28,0.00011114816049794375,0.0003331926519913814,0.7777777777777778
4151,4709,t/Alpha,36,28,8,0.0003334444814938313,0.00011106421733046048,0.7777777777777778
4152,4710,하차/Noun,36,8,28,0.00011114816049794375,0.0003331926519913814,0.7777777777777778
4153,4711,!!!!!!!!/Punctuation,36,28,8,0.0003334444814938313,0.00011106421733046048,0.7777777777777778
4154,4712,꽉/Noun,36,28,8,0.0003334444814938313,0.00011106421733046048,0.7777777777777778
4155,4713,역사왜곡/Noun,36,9,27,0.00012226297654773814,0.00032208623025833537,0.75
4156,4714,자신감/Noun,36,9,27,0.00012226297654773814,0.00032208623025833537,0.75
4157,4715,진화/Noun,36,26,10,0.00031121484939424253,0.00013327706079655256,0.7222222222222222
4158,4716,자본주의/Noun,36,26,10,0.00031121484939424253,0.00013327706079655256,0.7222222222222222
4159,4717,줄리엣/Noun,36,26,10,0.00031121484939424253,0.00013327706079655256,0.7222222222222222
4160,4718,다가가다/Verb,36,26,10,0.00031121484939424253,0.00013327706079655256,0.7222222222222222
4161,4719,지진희/Noun,36,10,26,0.0001333777925975325,0.00031097980852528933,0.7222222222222222
4162,4720,수애/Noun,36,25,11,0.00030010003334444816,0.0001443834825295986,0.6944444444444444
4163,4721,정신차리다/Adjective,36,11,25,0.0001444926086473269,0.0002998733867922433,0.6944444444444444
4164,4722,먹이다/Verb,36,12,24,0.00015560742469712126,0.0002887669650591972,0.6666666666666666
4165,4723,어찌나/Adverb,36,24,12,0.0002889852172946538,0.00015548990426264466,0.6666666666666666
4166,4724,문근영/Noun,36,24,12,0.0002889852172946538,0.00015548990426264466,0.6666666666666666
4167,4725,호평/Noun,36,12,24,0.00015560742469712126,0.0002887669650591972,0.6666666666666666
4168,4726,호소/Noun,36,13,23,0.00016672224074691566,0.00027766054332615115,0.6388888888888888
4169,4727,신은경/Noun,36,13,23,0.00016672224074691566,0.00027766054332615115,0.6388888888888888
4170,4728,일대기/Noun,36,23,13,0.00027787040124485944,0.0001665963259956907,0.6388888888888888
4171,4729,투표/Noun,36,13,23,0.00016672224074691566,0.00027766054332615115,0.6388888888888888
4172,4730,판치다/Verb,36,13,23,0.00016672224074691566,0.00027766054332615115,0.6388888888888888
4173,4731,휘/Noun,36,13,23,0.00016672224074691566,0.00027766054332615115,0.6388888888888888
4174,4732,놀람/Noun,36,22,14,0.000266755585195065,0.00017770274772873674,0.6111111111111112
4175,4733,런닝/Noun,36,14,22,0.00017783705679671002,0.00026655412159310506,0.6111111111111112
4176,4734,오리/Noun,36,14,22,0.00017783705679671002,0.00026655412159310506,0.6111111111111112
4177,4735,김하늘/Noun,36,22,14,0.000266755585195065,0.00017770274772873674,0.6111111111111112
4178,4736,"?""/Punctuation",36,14,22,0.00017783705679671002,0.00026655412159310506,0.6111111111111112
4179,4737,프레디/Noun,36,15,21,0.00018895187284650438,0.0002554476998600591,0.5833333333333334
4180,4738,사르다/Verb,36,21,15,0.00025564076914527065,0.0001888091694617828,0.5833333333333334
4181,4739,표본/Noun,36,15,21,0.00018895187284650438,0.0002554476998600591,0.5833333333333334
4182,4740,풍기다/Verb,36,15,21,0.00018895187284650438,0.0002554476998600591,0.5833333333333334
4183,4741,판타스틱/Noun,36,21,15,0.00025564076914527065,0.0001888091694617828,0.5833333333333334
4184,4742,미키/Noun,36,21,15,0.00025564076914527065,0.0001888091694617828,0.5833333333333334
4185,4743,퍼즐/Noun,36,15,21,0.00018895187284650438,0.0002554476998600591,0.5833333333333334
4186,4744,비정상/Noun,36,15,21,0.00018895187284650438,0.0002554476998600591,0.5833333333333334
4187,4745,바이러스/Noun,36,15,21,0.00018895187284650438,0.0002554476998600591,0.5833333333333334
4188,4746,받치다/Verb,36,16,20,0.0002000666888962988,0.00024434127812701304,0.5555555555555556
4189,4747,화답/Noun,36,16,20,0.0002000666888962988,0.00024434127812701304,0.5555555555555556
4190,4748,보삼/Noun,36,20,16,0.00024452595309547634,0.00019991559119482882,0.5555555555555556
4191,4749,호러영화/Noun,36,20,16,0.00024452595309547634,0.00019991559119482882,0.5555555555555556
4192,4750,2002년/Number,36,20,16,0.00024452595309547634,0.00019991559119482882,0.5555555555555556
4193,4751,며/Noun,36,20,16,0.00024452595309547634,0.00019991559119482882,0.5555555555555556
4194,4752,으로나/Josa,36,16,20,0.0002000666888962988,0.00024434127812701304,0.5555555555555556
4195,4766,♡♡/Foreign,35,35,0,0.0004112481938423919,2.2212843466092093e-05,1.0
4196,4767,최저/Noun,35,1,34,3.334444814938313e-05,0.00039983118238965764,0.9714285714285714
4197,4768,나열/Noun,35,2,33,4.445926419917751e-05,0.00038872476065661166,0.9428571428571428
4198,4769,알맹이/Noun,35,2,33,4.445926419917751e-05,0.00038872476065661166,0.9428571428571428
4199,4770,정신건강/Noun,35,3,32,5.5574080248971876e-05,0.0003776183389235656,0.9142857142857144
4200,4771,도아/Noun,35,3,32,5.5574080248971876e-05,0.0003776183389235656,0.9142857142857144
4201,4772,건강하다/Adjective,35,31,4,0.00036678892964321435,6.663853039827628e-05,0.8857142857142857
4202,4773,^_^/Punctuation,35,30,5,0.00035567411359342004,7.774495213132233e-05,0.8571428571428571
4203,4774,선전/Noun,35,5,30,7.780371234856063e-05,0.0003554054954574735,0.8571428571428571
4204,4775,구매/Noun,35,29,6,0.0003445592975436257,8.885137386436837e-05,0.8285714285714286
4205,4776,진솔하다/Adjective,35,29,6,0.0003445592975436257,8.885137386436837e-05,0.8285714285714286
4206,4777,이나마/Josa,35,29,6,0.0003445592975436257,8.885137386436837e-05,0.8285714285714286
4207,4778,어물/Noun,35,6,29,8.891852839835501e-05,0.00034429907372442745,0.8285714285714286
4208,4779,찰리/Noun,35,28,7,0.0003334444814938313,9.995779559741441e-05,0.8
4209,4780,합리화/Noun,35,7,28,0.0001000333444481494,0.0003331926519913814,0.8
4210,4781,작정/Noun,35,8,27,0.00011114816049794375,0.00032208623025833537,0.7714285714285715
4211,4782,데이먼/Noun,35,27,8,0.00032232966544403684,0.00011106421733046048,0.7714285714285715
4212,4783,잡지/Noun,35,8,27,0.00011114816049794375,0.00032208623025833537,0.7714285714285715
4213,4784,갑갑하다/Adjective,35,8,27,0.00011114816049794375,0.00032208623025833537,0.7714285714285715
4214,4785,인내/Noun,35,9,26,0.00012226297654773814,0.00031097980852528933,0.7428571428571429
4215,4786,미군/Noun,35,9,26,0.00012226297654773814,0.00031097980852528933,0.7428571428571429
4216,4787,발톱/Noun,35,9,26,0.00012226297654773814,0.00031097980852528933,0.7428571428571429
4217,4788,괴롭히다/Verb,35,9,26,0.00012226297654773814,0.00031097980852528933,0.7428571428571429
4218,4789,과도/Josa,35,26,9,0.00031121484939424253,0.00012217063906350652,0.7428571428571429
4219,4790,악몽/Noun,35,9,26,0.00012226297654773814,0.00031097980852528933,0.7428571428571429
4220,4791,ㄴㄴ/KoreanParticle,35,9,26,0.00012226297654773814,0.00031097980852528933,0.7428571428571429
4221,4792,보스/Noun,35,9,26,0.00012226297654773814,0.00031097980852528933,0.7428571428571429
4222,4793,띄우다/Verb,35,9,26,0.00012226297654773814,0.00031097980852528933,0.7428571428571429
4223,4794,치밀다/Verb,35,9,26,0.00012226297654773814,0.00031097980852528933,0.7428571428571429
4224,4795,광주/Noun,35,9,26,0.00012226297654773814,0.00031097980852528933,0.7428571428571429
4225,4796,혼나다/Verb,35,10,25,0.0001333777925975325,0.0002998733867922433,0.7142857142857143
4226,4797,태우다/Verb,35,10,25,0.0001333777925975325,0.0002998733867922433,0.7142857142857143
4227,4798,엘/Noun,35,25,10,0.00030010003334444816,0.00013327706079655256,0.7142857142857143
4228,4799,잣/Noun,35,10,25,0.0001333777925975325,0.0002998733867922433,0.7142857142857143
4229,4800,마구/Noun,35,10,25,0.0001333777925975325,0.0002998733867922433,0.7142857142857143
4230,4801,설치다/Adjective,35,10,25,0.0001333777925975325,0.0002998733867922433,0.7142857142857143
4231,4802,스포일러/Noun,35,24,11,0.0002889852172946538,0.0001443834825295986,0.6857142857142857
4232,4803,여자도/Noun,35,11,24,0.0001444926086473269,0.0002887669650591972,0.6857142857142857
4233,4804,쌓이다/Verb,35,11,24,0.0001444926086473269,0.0002887669650591972,0.6857142857142857
4234,4805,흘러나오다/Verb,35,23,12,0.00027787040124485944,0.00015548990426264466,0.6571428571428571
4235,4806,스티브/Noun,35,23,12,0.00027787040124485944,0.00015548990426264466,0.6571428571428571
4236,4807,이분/Noun,35,23,12,0.00027787040124485944,0.00015548990426264466,0.6571428571428571
4237,4808,한국말/Noun,35,12,23,0.00015560742469712126,0.00027766054332615115,0.6571428571428571
4238,4809,로우/Noun,35,23,12,0.00027787040124485944,0.00015548990426264466,0.6571428571428571
4239,4810,족/Noun,35,12,23,0.00015560742469712126,0.00027766054332615115,0.6571428571428571
4240,4811,듯이/Noun,35,12,23,0.00015560742469712126,0.00027766054332615115,0.6571428571428571
4241,4812,캐서린/Noun,35,12,23,0.00015560742469712126,0.00027766054332615115,0.6571428571428571
4242,4813,이완/Noun,35,22,13,0.000266755585195065,0.0001665963259956907,0.6285714285714286
4243,4814,주의자/Noun,35,13,22,0.00016672224074691566,0.00026655412159310506,0.6285714285714286
4244,4815,리들리/Noun,35,21,14,0.00025564076914527065,0.00017770274772873674,0.6
4245,4816,직전/Noun,35,14,21,0.00017783705679671002,0.0002554476998600591,0.6
4246,4817,엇음/Noun,35,14,21,0.00017783705679671002,0.0002554476998600591,0.6
4247,4818,낭/Noun,35,14,21,0.00017783705679671002,0.0002554476998600591,0.6
4248,4819,사이/Modifier,35,21,14,0.00025564076914527065,0.00017770274772873674,0.6
4249,4820,기독교인/Noun,35,14,21,0.00017783705679671002,0.0002554476998600591,0.6
4250,4821,프로젝트/Noun,35,14,21,0.00017783705679671002,0.0002554476998600591,0.6
4251,4822,~~~~~~/Punctuation,35,14,21,0.00017783705679671002,0.0002554476998600591,0.6
4252,4823,한지민/Noun,35,21,14,0.00025564076914527065,0.00017770274772873674,0.6
4253,4824,꾸준하다/Adjective,35,15,20,0.00018895187284650438,0.00024434127812701304,0.5714285714285714
4254,4825,cgv/Alpha,35,20,15,0.00024452595309547634,0.0001888091694617828,0.5714285714285714
4255,4826,위안/Noun,35,15,20,0.00018895187284650438,0.00024434127812701304,0.5714285714285714
4256,4827,안주/Noun,35,20,15,0.00024452595309547634,0.0001888091694617828,0.5714285714285714
4257,4828,음모/Noun,35,15,20,0.00018895187284650438,0.00024434127812701304,0.5714285714285714
4258,4829,의아/Noun,35,15,20,0.00018895187284650438,0.00024434127812701304,0.5714285714285714
4259,4830,사연/Noun,35,19,16,0.0002334111370456819,0.00019991559119482882,0.5428571428571428
4260,4831,샤론스톤/Noun,35,19,16,0.0002334111370456819,0.00019991559119482882,0.5428571428571428
4261,4832,2001년/Number,35,19,16,0.0002334111370456819,0.00019991559119482882,0.5428571428571428
4262,4833,확신/Noun,35,16,19,0.0002000666888962988,0.000233234856393967,0.5428571428571428
4263,4834,잘살다/Verb,35,16,19,0.0002000666888962988,0.000233234856393967,0.5428571428571428
4264,4835,우마/Noun,35,19,16,0.0002334111370456819,0.00019991559119482882,0.5428571428571428
4265,4836,의학/Noun,35,16,19,0.0002000666888962988,0.000233234856393967,0.5428571428571428
4266,4837,순진하다/Adjective,35,16,19,0.0002000666888962988,0.000233234856393967,0.5428571428571428
4267,4838,위치/Noun,35,16,19,0.0002000666888962988,0.000233234856393967,0.5428571428571428
4268,4847,퉤/Noun,34,2,32,4.445926419917751e-05,0.0003776183389235656,0.9411764705882352
4269,4848,만큼도/Josa,34,2,32,4.445926419917751e-05,0.0003776183389235656,0.9411764705882352
4270,4849,박신혜/Noun,34,31,3,0.00036678892964321435,5.553210866523024e-05,0.9117647058823528
4271,4850,자질/Noun,34,3,31,5.5574080248971876e-05,0.00036651191719051963,0.9117647058823528
4272,4851,...;;;/Punctuation,34,3,31,5.5574080248971876e-05,0.00036651191719051963,0.9117647058823528
4273,4852,공효진/Noun,34,30,4,0.00035567411359342004,6.663853039827628e-05,0.8823529411764706
4274,4853,톰크루즈/Noun,34,29,5,0.0003445592975436257,7.774495213132233e-05,0.8529411764705882
4275,4854,맑은/Noun,34,29,5,0.0003445592975436257,7.774495213132233e-05,0.8529411764705882
4276,4855,칠이/Noun,34,5,29,7.780371234856063e-05,0.00034429907372442745,0.8529411764705882
4277,4856,동호/Noun,34,5,29,7.780371234856063e-05,0.00034429907372442745,0.8529411764705882
4278,4857,이동욱/Noun,34,29,5,0.0003445592975436257,7.774495213132233e-05,0.8529411764705882
4279,4858,동기/Noun,34,6,28,8.891852839835501e-05,0.0003331926519913814,0.8235294117647058
4280,4859,~!!!!/Punctuation,34,27,7,0.00032232966544403684,9.995779559741441e-05,0.7941176470588235
4281,4860,가시/Noun,34,27,7,0.00032232966544403684,9.995779559741441e-05,0.7941176470588235
4282,4861,급전/Noun,34,7,27,0.0001000333444481494,0.00032208623025833537,0.7941176470588235
4283,4862,또한/Modifier,34,27,7,0.00032232966544403684,9.995779559741441e-05,0.7941176470588235
4284,4863,고려/Noun,34,7,27,0.0001000333444481494,0.00032208623025833537,0.7941176470588235
4285,4864,지다/Noun,34,27,7,0.00032232966544403684,9.995779559741441e-05,0.7941176470588235
4286,4865,카타르/Noun,34,27,7,0.00032232966544403684,9.995779559741441e-05,0.7941176470588235
4287,4866,숭고하다/Adjective,34,27,7,0.00032232966544403684,9.995779559741441e-05,0.7941176470588235
4288,4867,화이/Noun,34,27,7,0.00032232966544403684,9.995779559741441e-05,0.7941176470588235
4289,4868,뺨/Noun,34,8,26,0.00011114816049794375,0.00031097980852528933,0.7647058823529411
4290,4869,아웃/Noun,34,8,26,0.00011114816049794375,0.00031097980852528933,0.7647058823529411
4291,4870,출연료/Noun,34,8,26,0.00011114816049794375,0.00031097980852528933,0.7647058823529411
4292,4871,흥겹다/Adjective,34,26,8,0.00031121484939424253,0.00011106421733046048,0.7647058823529411
4293,4872,비급/Noun,34,8,26,0.00011114816049794375,0.00031097980852528933,0.7647058823529411
4294,4873,통한/Noun,34,26,8,0.00031121484939424253,0.00011106421733046048,0.7647058823529411
4295,4874,저예산영화/Noun,34,8,26,0.00011114816049794375,0.00031097980852528933,0.7647058823529411
4296,4875,멜깁슨/Noun,34,26,8,0.00031121484939424253,0.00011106421733046048,0.7647058823529411
4297,4876,어딨다/Verb,34,8,26,0.00011114816049794375,0.00031097980852528933,0.7647058823529411
4298,4877,행운/Noun,34,25,9,0.00030010003334444816,0.00012217063906350652,0.7352941176470589
4299,4878,도망/Noun,34,9,25,0.00012226297654773814,0.0002998733867922433,0.7352941176470589
4300,4879,린치/Noun,34,25,9,0.00030010003334444816,0.00012217063906350652,0.7352941176470589
4301,4880,잘쓰다/Verb,34,9,25,0.00012226297654773814,0.0002998733867922433,0.7352941176470589
4302,4881,또다시/Adverb,34,25,9,0.00030010003334444816,0.00012217063906350652,0.7352941176470589
4303,4882,처참하다/Adjective,34,9,25,0.00012226297654773814,0.0002998733867922433,0.7352941176470589
4304,4883,두/Modifier,34,9,25,0.00012226297654773814,0.0002998733867922433,0.7352941176470589
4305,4884,흐/Noun,34,25,9,0.00030010003334444816,0.00012217063906350652,0.7352941176470589
4306,4885,속도/Noun,34,10,24,0.0001333777925975325,0.0002887669650591972,0.7058823529411765
4307,4886,일본어/Noun,34,10,24,0.0001333777925975325,0.0002887669650591972,0.7058823529411765
4308,4887,털리다/Verb,34,10,24,0.0001333777925975325,0.0002887669650591972,0.7058823529411765
4309,4888,나아가다/Verb,34,24,10,0.0002889852172946538,0.00013327706079655256,0.7058823529411765
4310,4889,질투/Noun,34,24,10,0.0002889852172946538,0.00013327706079655256,0.7058823529411765
4311,4890,사이코패스/Noun,34,10,24,0.0001333777925975325,0.0002887669650591972,0.7058823529411765
4312,4891,2010년/Number,34,10,24,0.0001333777925975325,0.0002887669650591972,0.7058823529411765
4313,4892,김남길/Noun,34,24,10,0.0002889852172946538,0.00013327706079655256,0.7058823529411765
4314,4893,스치다/Verb,34,24,10,0.0002889852172946538,0.00013327706079655256,0.7058823529411765
4315,4894,파일/Noun,34,23,11,0.00027787040124485944,0.0001443834825295986,0.6764705882352942
4316,4895,S/Alpha,34,23,11,0.00027787040124485944,0.0001443834825295986,0.6764705882352942
4317,4896,떼/Noun,34,11,23,0.0001444926086473269,0.00027766054332615115,0.6764705882352942
4318,4897,토미/Noun,34,23,11,0.00027787040124485944,0.0001443834825295986,0.6764705882352942
4319,4898,?'/Punctuation,34,12,22,0.00015560742469712126,0.00026655412159310506,0.6470588235294118
4320,4899,페이지/Noun,34,22,12,0.000266755585195065,0.00015548990426264466,0.6470588235294118
4321,4900,중이/Noun,34,22,12,0.000266755585195065,0.00015548990426264466,0.6470588235294118
4322,4901,좌절/Noun,34,22,12,0.000266755585195065,0.00015548990426264466,0.6470588235294118
4323,4902,...!!/Punctuation,34,22,12,0.000266755585195065,0.00015548990426264466,0.6470588235294118
4324,4903,아르/Noun,34,22,12,0.000266755585195065,0.00015548990426264466,0.6470588235294118
4325,4904,프레데터/Noun,34,12,22,0.00015560742469712126,0.00026655412159310506,0.6470588235294118
4326,4905,고찰/Noun,34,22,12,0.000266755585195065,0.00015548990426264466,0.6470588235294118
4327,4906,고개/Noun,34,12,22,0.00015560742469712126,0.00026655412159310506,0.6470588235294118
4328,4907,고소영/Noun,34,12,22,0.00015560742469712126,0.00026655412159310506,0.6470588235294118
4329,4908,여우/Noun,34,22,12,0.000266755585195065,0.00015548990426264466,0.6470588235294118
4330,4909,안목/Noun,34,12,22,0.00015560742469712126,0.00026655412159310506,0.6470588235294118
4331,4910,이슈/Noun,34,13,21,0.00016672224074691566,0.0002554476998600591,0.6176470588235294
4332,4911,브리/Noun,34,21,13,0.00025564076914527065,0.0001665963259956907,0.6176470588235294
4333,4912,거대/Noun,34,13,21,0.00016672224074691566,0.0002554476998600591,0.6176470588235294
4334,4913,개독/Noun,34,13,21,0.00016672224074691566,0.0002554476998600591,0.6176470588235294
4335,4914,남자친구/Noun,34,21,13,0.00025564076914527065,0.0001665963259956907,0.6176470588235294
4336,4915,라며/Noun,34,13,21,0.00016672224074691566,0.0002554476998600591,0.6176470588235294
4337,4916,플레이/Noun,34,13,21,0.00016672224074691566,0.0002554476998600591,0.6176470588235294
4338,4917,몸부림/Noun,34,14,20,0.00017783705679671002,0.00024434127812701304,0.5882352941176471
4339,4918,이내/Noun,34,14,20,0.00017783705679671002,0.00024434127812701304,0.5882352941176471
4340,4919,하이킥/Noun,34,20,14,0.00024452595309547634,0.00017770274772873674,0.5882352941176471
4341,4920,스캔들/Noun,34,14,20,0.00017783705679671002,0.00024434127812701304,0.5882352941176471
4342,4921,블루/Noun,34,14,20,0.00017783705679671002,0.00024434127812701304,0.5882352941176471
4343,4922,성경/Noun,34,14,20,0.00017783705679671002,0.00024434127812701304,0.5882352941176471
4344,4923,제인/Noun,34,20,14,0.00024452595309547634,0.00017770274772873674,0.5882352941176471
4345,4924,차지/Noun,34,14,20,0.00017783705679671002,0.00024434127812701304,0.5882352941176471
4346,4925,하여금/Adverb,34,20,14,0.00024452595309547634,0.00017770274772873674,0.5882352941176471
4347,4926,대형/Noun,34,14,20,0.00017783705679671002,0.00024434127812701304,0.5882352941176471
4348,4927,조인성/Noun,34,20,14,0.00024452595309547634,0.00017770274772873674,0.5882352941176471
4349,4928,형성/Noun,34,20,14,0.00024452595309547634,0.00017770274772873674,0.5882352941176471
4350,4929,목표/Noun,34,20,14,0.00024452595309547634,0.00017770274772873674,0.5882352941176471
4351,4930,오토바이/Noun,34,14,20,0.00017783705679671002,0.00024434127812701304,0.5882352941176471
4352,4931,근본/Noun,34,14,20,0.00017783705679671002,0.00024434127812701304,0.5882352941176471
4353,4932,충분/Noun,34,20,14,0.00024452595309547634,0.00017770274772873674,0.5882352941176471
4354,4933,측면/Noun,34,14,20,0.00017783705679671002,0.00024434127812701304,0.5882352941176471
4355,4934,뿌리/Noun,34,19,15,0.0002334111370456819,0.0001888091694617828,0.5588235294117647
4356,4935,2008년/Number,34,19,15,0.0002334111370456819,0.0001888091694617828,0.5588235294117647
4357,4936,따윈/Noun,34,15,19,0.00018895187284650438,0.000233234856393967,0.5588235294117647
4358,4937,.?/Punctuation,34,19,15,0.0002334111370456819,0.0001888091694617828,0.5588235294117647
4359,4938,완결/Noun,34,19,15,0.0002334111370456819,0.0001888091694617828,0.5588235294117647
4360,4939,딱좋다/Adjective,34,19,15,0.0002334111370456819,0.0001888091694617828,0.5588235294117647
4361,4940,김수로/Noun,34,19,15,0.0002334111370456819,0.0001888091694617828,0.5588235294117647
4362,4941,2012/Number,34,15,19,0.00018895187284650438,0.000233234856393967,0.5588235294117647
4363,4942,마땅하다/Adjective,34,19,15,0.0002334111370456819,0.0001888091694617828,0.5588235294117647
4364,4943,뒤통수/Noun,34,15,19,0.00018895187284650438,0.000233234856393967,0.5588235294117647
4365,4956,!!^^/Punctuation,33,33,0,0.00038901856174280313,2.2212843466092093e-05,1.0
4366,4957,앓이/Noun,33,33,0,0.00038901856174280313,2.2212843466092093e-05,1.0
4367,4958,서세원/Noun,33,1,32,3.334444814938313e-05,0.0003776183389235656,0.9696969696969696
4368,4959,모처럼/Noun,33,32,1,0.00037790374569300877,3.331926519913814e-05,0.9696969696969696
4369,4960,알차다/Adjective,33,31,2,0.00036678892964321435,4.4425686932184186e-05,0.9393939393939394
4370,4961,조아/Adverb,33,31,2,0.00036678892964321435,4.4425686932184186e-05,0.9393939393939394
4371,4962,국뽕/Noun,33,3,30,5.5574080248971876e-05,0.0003554054954574735,0.9090909090909092
4372,4963,듣보잡/Noun,33,3,30,5.5574080248971876e-05,0.0003554054954574735,0.9090909090909092
4373,4964,best/Alpha,33,30,3,0.00035567411359342004,5.553210866523024e-05,0.9090909090909092
4374,4965,혹성탈출/Noun,33,6,27,8.891852839835501e-05,0.00032208623025833537,0.8181818181818182
4375,4966,어줍다/Adjective,33,6,27,8.891852839835501e-05,0.00032208623025833537,0.8181818181818182
4376,4967,매회/Adverb,33,27,6,0.00032232966544403684,8.885137386436837e-05,0.8181818181818182
4377,4968,놀이/Noun,33,7,26,0.0001000333444481494,0.00031097980852528933,0.7878787878787878
4378,4969,각인/Noun,33,26,7,0.00031121484939424253,9.995779559741441e-05,0.7878787878787878
4379,4970,공격/Noun,33,7,26,0.0001000333444481494,0.00031097980852528933,0.7878787878787878
4380,4971,사랑과전쟁/Noun,33,8,25,0.00011114816049794375,0.0002998733867922433,0.7575757575757576
4381,4972,마련/Noun,33,25,8,0.00030010003334444816,0.00011106421733046048,0.7575757575757576
4382,4973,발레/Noun,33,25,8,0.00030010003334444816,0.00011106421733046048,0.7575757575757576
4383,4974,해대/Noun,33,8,25,0.00011114816049794375,0.0002998733867922433,0.7575757575757576
4384,4975,전결/Noun,33,8,25,0.00011114816049794375,0.0002998733867922433,0.7575757575757576
4385,4976,진구/Noun,33,24,9,0.0002889852172946538,0.00012217063906350652,0.7272727272727273
4386,4977,서서히/Noun,33,24,9,0.0002889852172946538,0.00012217063906350652,0.7272727272727273
4387,4978,갑작스럽다/Adjective,33,9,24,0.00012226297654773814,0.0002887669650591972,0.7272727272727273
4388,4979,자아내다/Verb,33,24,9,0.0002889852172946538,0.00012217063906350652,0.7272727272727273
4389,4980,대의/Foreign,33,24,9,0.0002889852172946538,0.00012217063906350652,0.7272727272727273
4390,4981,대도/Noun,33,9,24,0.00012226297654773814,0.0002887669650591972,0.7272727272727273
4391,4982,나이트/Noun,33,10,23,0.0001333777925975325,0.00027766054332615115,0.696969696969697
4392,4983,얼른/Noun,33,23,10,0.00027787040124485944,0.00013327706079655256,0.696969696969697
4393,4984,재회/Noun,33,23,10,0.00027787040124485944,0.00013327706079655256,0.696969696969697
4394,4985,좌파/Noun,33,10,23,0.0001333777925975325,0.00027766054332615115,0.696969696969697
4395,4986,회장/Noun,33,10,23,0.0001333777925975325,0.00027766054332615115,0.696969696969697
4396,4987,돌아다니다/Verb,33,10,23,0.0001333777925975325,0.00027766054332615115,0.696969696969697
4397,4988,부러/Noun,33,23,10,0.00027787040124485944,0.00013327706079655256,0.696969696969697
4398,4989,승/Noun,33,11,22,0.0001444926086473269,0.00026655412159310506,0.6666666666666666
4399,4990,…/Punctuation,33,11,22,0.0001444926086473269,0.00026655412159310506,0.6666666666666666
4400,4991,후유증/Noun,33,22,11,0.000266755585195065,0.0001443834825295986,0.6666666666666666
4401,4992,안녕/Noun,33,22,11,0.000266755585195065,0.0001443834825295986,0.6666666666666666
4402,4993,에게나/Josa,33,22,11,0.000266755585195065,0.0001443834825295986,0.6666666666666666
4403,4994,효민/Noun,33,11,22,0.0001444926086473269,0.00026655412159310506,0.6666666666666666
4404,4995,피우다/Verb,33,11,22,0.0001444926086473269,0.00026655412159310506,0.6666666666666666
4405,4996,까지가/Josa,33,11,22,0.0001444926086473269,0.00026655412159310506,0.6666666666666666
4406,4997,케이스/Noun,33,11,22,0.0001444926086473269,0.00026655412159310506,0.6666666666666666
4407,4998,낯선/Noun,33,22,11,0.000266755585195065,0.0001443834825295986,0.6666666666666666
4408,4999,과제/Noun,33,12,21,0.00015560742469712126,0.0002554476998600591,0.6363636363636364
4409,5000,괴수/Noun,33,12,21,0.00015560742469712126,0.0002554476998600591,0.6363636363636364
4410,5001,장인/Noun,33,21,12,0.00025564076914527065,0.00015548990426264466,0.6363636363636364
4411,5002,미로/Noun,33,12,21,0.00015560742469712126,0.0002554476998600591,0.6363636363636364
4412,5003,시청율/Noun,33,12,21,0.00015560742469712126,0.0002554476998600591,0.6363636363636364
4413,5004,탕/Noun,33,12,21,0.00015560742469712126,0.0002554476998600591,0.6363636363636364
4414,5005,지성/Noun,33,21,12,0.00025564076914527065,0.00015548990426264466,0.6363636363636364
4415,5006,↓/Foreign,33,12,21,0.00015560742469712126,0.0002554476998600591,0.6363636363636364
4416,5007,만으로는/Josa,33,13,20,0.00016672224074691566,0.00024434127812701304,0.6060606060606061
4417,5008,대만/Noun,33,13,20,0.00016672224074691566,0.00024434127812701304,0.6060606060606061
4418,5009,신뢰/Noun,33,13,20,0.00016672224074691566,0.00024434127812701304,0.6060606060606061
4419,5010,人/Foreign,33,13,20,0.00016672224074691566,0.00024434127812701304,0.6060606060606061
4420,5011,고정/Noun,33,20,13,0.00024452595309547634,0.0001665963259956907,0.6060606060606061
4421,5012,서방/Noun,33,13,20,0.00016672224074691566,0.00024434127812701304,0.6060606060606061
4422,5013,2회/Number,33,20,13,0.00024452595309547634,0.0001665963259956907,0.6060606060606061
4423,5014,어둠/Noun,33,19,14,0.0002334111370456819,0.00017770274772873674,0.5757575757575758
4424,5015,결합/Noun,33,19,14,0.0002334111370456819,0.00017770274772873674,0.5757575757575758
4425,5016,뚜렷하다/Adjective,33,19,14,0.0002334111370456819,0.00017770274772873674,0.5757575757575758
4426,5017,뵈다/Verb,33,19,14,0.0002334111370456819,0.00017770274772873674,0.5757575757575758
4427,5018,이신/Josa,33,19,14,0.0002334111370456819,0.00017770274772873674,0.5757575757575758
4428,5019,소수/Noun,33,14,19,0.00017783705679671002,0.000233234856393967,0.5757575757575758
4429,5020,명량/Noun,33,19,14,0.0002334111370456819,0.00017770274772873674,0.5757575757575758
4430,5021,검/Noun,33,14,19,0.00017783705679671002,0.000233234856393967,0.5757575757575758
4431,5022,자하/Noun,33,14,19,0.00017783705679671002,0.000233234856393967,0.5757575757575758
4432,5023,도덕/Noun,33,15,18,0.00018895187284650438,0.00022212843466092096,0.5454545454545454
4433,5024,고통스럽다/Adjective,33,18,15,0.0002222963209958875,0.0001888091694617828,0.5454545454545454
4434,5025,패닝/Noun,33,18,15,0.0002222963209958875,0.0001888091694617828,0.5454545454545454
4435,5026,어보/Noun,33,18,15,0.0002222963209958875,0.0001888091694617828,0.5454545454545454
4436,5027,2009년/Number,33,18,15,0.0002222963209958875,0.0001888091694617828,0.5454545454545454
4437,5028,가치관/Noun,33,18,15,0.0002222963209958875,0.0001888091694617828,0.5454545454545454
4438,5029,조각/Noun,33,18,15,0.0002222963209958875,0.0001888091694617828,0.5454545454545454
4439,5030,핵심/Noun,33,15,18,0.00018895187284650438,0.00022212843466092096,0.5454545454545454
4440,5031,해리슨/Noun,33,15,18,0.00018895187284650438,0.00022212843466092096,0.5454545454545454
4441,5032,조심하다/Verb,33,15,18,0.00018895187284650438,0.00022212843466092096,0.5454545454545454
4442,5033,물질/Noun,33,18,15,0.0002222963209958875,0.0001888091694617828,0.5454545454545454
4443,5034,하여튼/Noun,33,15,18,0.00018895187284650438,0.00022212843466092096,0.5454545454545454
4444,5035,수단/Noun,33,18,15,0.0002222963209958875,0.0001888091694617828,0.5454545454545454
4445,5036,영화배우/Noun,33,18,15,0.0002222963209958875,0.0001888091694617828,0.5454545454545454
4446,5037,서민/Noun,33,18,15,0.0002222963209958875,0.0001888091694617828,0.5454545454545454
4447,5038,으아/Exclamation,33,18,15,0.0002222963209958875,0.0001888091694617828,0.5454545454545454
4448,5039,제공/Noun,33,18,15,0.0002222963209958875,0.0001888091694617828,0.5454545454545454
4449,5051,보석같다/Adjective,32,31,1,0.00036678892964321435,3.331926519913814e-05,0.96875
4450,5052,명곡/Noun,32,30,2,0.00035567411359342004,4.4425686932184186e-05,0.9375
4451,5053,유행어/Noun,32,2,30,4.445926419917751e-05,0.0003554054954574735,0.9375
4452,5054,AV/Alpha,32,2,30,4.445926419917751e-05,0.0003554054954574735,0.9375
4453,5055,얄팍하다/Adjective,32,2,30,4.445926419917751e-05,0.0003554054954574735,0.9375
4454,5056,></Punctuation,32,30,2,0.00035567411359342004,4.4425686932184186e-05,0.9375
4455,5057,썰렁하다/Adjective,32,3,29,5.5574080248971876e-05,0.00034429907372442745,0.90625
4456,5058,Very/Alpha,32,29,3,0.0003445592975436257,5.553210866523024e-05,0.90625
4457,5059,테스트/Noun,32,3,29,5.5574080248971876e-05,0.00034429907372442745,0.90625
4458,5060,love/Alpha,32,28,4,0.0003334444814938313,6.663853039827628e-05,0.875
4459,5061,괴작/Noun,32,4,28,6.668889629876625e-05,0.0003331926519913814,0.875
4460,5062,보석/Noun,32,28,4,0.0003334444814938313,6.663853039827628e-05,0.875
4461,5063,되새기다/Verb,32,28,4,0.0003334444814938313,6.663853039827628e-05,0.875
4462,5064,참혹하다/Adjective,32,27,5,0.00032232966544403684,7.774495213132233e-05,0.84375
4463,5065,어필/Noun,32,5,27,7.780371234856063e-05,0.00032208623025833537,0.84375
4464,5066,슈스케/Noun,32,5,27,7.780371234856063e-05,0.00032208623025833537,0.84375
4465,5067,마주/Noun,32,27,5,0.00032232966544403684,7.774495213132233e-05,0.84375
4466,5068,변명/Noun,32,6,26,8.891852839835501e-05,0.00031097980852528933,0.8125
4467,5069,감독판/Noun,32,26,6,0.00031121484939424253,8.885137386436837e-05,0.8125
4468,5070,아리/Noun,32,26,6,0.00031121484939424253,8.885137386436837e-05,0.8125
4469,5071,침몰/Noun,32,6,26,8.891852839835501e-05,0.00031097980852528933,0.8125
4470,5072,뽀로로/Noun,32,7,25,0.0001000333444481494,0.0002998733867922433,0.78125
4471,5073,맛깔나다/Adjective,32,25,7,0.00030010003334444816,9.995779559741441e-05,0.78125
4472,5074,토요명화/Noun,32,25,7,0.00030010003334444816,9.995779559741441e-05,0.78125
4473,5075,사소하다/Adjective,32,25,7,0.00030010003334444816,9.995779559741441e-05,0.78125
4474,5076,된장/Noun,32,8,24,0.00011114816049794375,0.0002887669650591972,0.75
4475,5077,쌍욕/Noun,32,8,24,0.00011114816049794375,0.0002887669650591972,0.75
4476,5078,어쨋/Noun,32,24,8,0.0002889852172946538,0.00011106421733046048,0.75
4477,5079,안달/Noun,32,8,24,0.00011114816049794375,0.0002887669650591972,0.75
4478,5080,취미/Noun,32,8,24,0.00011114816049794375,0.0002887669650591972,0.75
4479,5081,튀기다/Verb,32,8,24,0.00011114816049794375,0.0002887669650591972,0.75
4480,5082,my/Alpha,32,23,9,0.00027787040124485944,0.00012217063906350652,0.71875
4481,5083,콘서트/Noun,32,23,9,0.00027787040124485944,0.00012217063906350652,0.71875
4482,5084,토마스/Noun,32,23,9,0.00027787040124485944,0.00012217063906350652,0.71875
4483,5085,희극/Noun,32,22,10,0.000266755585195065,0.00013327706079655256,0.6875
4484,5086,싸/VerbPrefix,32,10,22,0.0001333777925975325,0.00026655412159310506,0.6875
4485,5087,압축/Noun,32,10,22,0.0001333777925975325,0.00026655412159310506,0.6875
4486,5088,아랫/Modifier,32,22,10,0.000266755585195065,0.00013327706079655256,0.6875
4487,5089,통일/Noun,32,22,10,0.000266755585195065,0.00013327706079655256,0.6875
4488,5090,me/Alpha,32,22,10,0.000266755585195065,0.00013327706079655256,0.6875
4489,5091,일베/Noun,32,10,22,0.0001333777925975325,0.00026655412159310506,0.6875
4490,5092,원빈/Noun,32,22,10,0.000266755585195065,0.00013327706079655256,0.6875
4491,5093,다한/Noun,32,10,22,0.0001333777925975325,0.00026655412159310506,0.6875
4492,5094,녹화/Noun,32,21,11,0.00025564076914527065,0.0001443834825295986,0.65625
4493,5095,기차/Noun,32,21,11,0.00025564076914527065,0.0001443834825295986,0.65625
4494,5096,주지훈/Noun,32,21,11,0.00025564076914527065,0.0001443834825295986,0.65625
4495,5097,공리/Noun,32,21,11,0.00025564076914527065,0.0001443834825295986,0.65625
4496,5098,정답/Noun,32,21,11,0.00025564076914527065,0.0001443834825295986,0.65625
4497,5099,최지우/Noun,32,21,11,0.00025564076914527065,0.0001443834825295986,0.65625
4498,5100,즘/Noun,32,11,21,0.0001444926086473269,0.0002554476998600591,0.65625
4499,5101,치르다/Verb,32,11,21,0.0001444926086473269,0.0002554476998600591,0.65625
4500,5102,벌이다/Verb,32,11,21,0.0001444926086473269,0.0002554476998600591,0.65625
4501,5103,치가/Noun,32,11,21,0.0001444926086473269,0.0002554476998600591,0.65625
4502,5104,무작정/Noun,32,11,21,0.0001444926086473269,0.0002554476998600591,0.65625
4503,5105,뱉다/Verb,32,11,21,0.0001444926086473269,0.0002554476998600591,0.65625
4504,5106,학/Noun,32,12,20,0.00015560742469712126,0.00024434127812701304,0.625
4505,5107,~~~~~~~/Punctuation,32,12,20,0.00015560742469712126,0.00024434127812701304,0.625
4506,5108,휴머니즘/Noun,32,20,12,0.00024452595309547634,0.00015548990426264466,0.625
4507,5109,트와일라잇/Noun,32,12,20,0.00015560742469712126,0.00024434127812701304,0.625
4508,5110,과감/Noun,32,12,20,0.00015560742469712126,0.00024434127812701304,0.625
4509,5111,크리/Noun,32,20,12,0.00024452595309547634,0.00015548990426264466,0.625
4510,5112,디스/Noun,32,12,20,0.00015560742469712126,0.00024434127812701304,0.625
4511,5113,동원/Noun,32,12,20,0.00015560742469712126,0.00024434127812701304,0.625
4512,5114,어벤져스/Noun,32,20,12,0.00024452595309547634,0.00015548990426264466,0.625
4513,5115,줄알/Noun,32,12,20,0.00015560742469712126,0.00024434127812701304,0.625
4514,5116,송중기/Noun,32,20,12,0.00024452595309547634,0.00015548990426264466,0.625
4515,5117,강혜정/Noun,32,13,19,0.00016672224074691566,0.000233234856393967,0.59375
4516,5118,므/Noun,32,19,13,0.0002334111370456819,0.0001665963259956907,0.59375
4517,5119,하우스/Noun,32,14,18,0.00017783705679671002,0.00022212843466092096,0.5625
4518,5120,여야/Noun,32,14,18,0.00017783705679671002,0.00022212843466092096,0.5625
4519,5121,주신/Noun,32,18,14,0.0002222963209958875,0.00017770274772873674,0.5625
4520,5122,쳐다보다/Verb,32,14,18,0.00017783705679671002,0.00022212843466092096,0.5625
4521,5123,2011년/Number,32,14,18,0.00017783705679671002,0.00022212843466092096,0.5625
4522,5124,가도/Noun,32,18,14,0.0002222963209958875,0.00017770274772873674,0.5625
4523,5125,쓰리다/Adjective,32,14,18,0.00017783705679671002,0.00022212843466092096,0.5625
4524,5126,자가/Noun,32,14,18,0.00017783705679671002,0.00022212843466092096,0.5625
4525,5127,적응/Noun,32,14,18,0.00017783705679671002,0.00022212843466092096,0.5625
4526,5128,에야/Josa,32,18,14,0.0002222963209958875,0.00017770274772873674,0.5625
4527,5129,작살/Noun,32,18,14,0.0002222963209958875,0.00017770274772873674,0.5625
4528,5130,뉴/Noun,32,15,17,0.00018895187284650438,0.0002110220129278749,0.53125
4529,5131,농구/Noun,32,17,15,0.00021118150494609317,0.0001888091694617828,0.53125
4530,5132,레이싱/Noun,32,17,15,0.00021118150494609317,0.0001888091694617828,0.53125
4531,5133,이선균/Noun,32,17,15,0.00021118150494609317,0.0001888091694617828,0.53125
4532,5134,갈수/Noun,32,15,17,0.00018895187284650438,0.0002110220129278749,0.53125
4533,5135,2일/Number,32,15,17,0.00018895187284650438,0.0002110220129278749,0.53125
4534,5136,피트/Noun,32,17,15,0.00021118150494609317,0.0001888091694617828,0.53125
4535,5137,여명/Noun,32,17,15,0.00021118150494609317,0.0001888091694617828,0.53125
4536,5141,안듬/Noun,31,1,30,3.334444814938313e-05,0.0003554054954574735,0.967741935483871
4537,5142,참내/Noun,31,1,30,3.334444814938313e-05,0.0003554054954574735,0.967741935483871
4538,5143,이상형/Noun,31,28,3,0.0003334444814938313,5.553210866523024e-05,0.9032258064516128
4539,5144,못지않다/Adjective,31,28,3,0.0003334444814938313,5.553210866523024e-05,0.9032258064516128
4540,5145,그만두다/Verb,31,3,28,5.5574080248971876e-05,0.0003331926519913814,0.9032258064516128
4541,5146,잘맞다/Adjective,31,27,4,0.00032232966544403684,6.663853039827628e-05,0.8709677419354839
4542,5147,수습/Noun,31,4,27,6.668889629876625e-05,0.00032208623025833537,0.8709677419354839
4543,5148,발악/Noun,31,4,27,6.668889629876625e-05,0.00032208623025833537,0.8709677419354839
4544,5149,랍시고/Noun,31,4,27,6.668889629876625e-05,0.00032208623025833537,0.8709677419354839
4545,5150,자마자/Noun,31,5,26,7.780371234856063e-05,0.00031097980852528933,0.8387096774193549
4546,5151,공존/Noun,31,26,5,0.00031121484939424253,7.774495213132233e-05,0.8387096774193549
4547,5152,팬심/Noun,31,5,26,7.780371234856063e-05,0.00031097980852528933,0.8387096774193549
4548,5153,제이/Noun,31,26,5,0.00031121484939424253,7.774495213132233e-05,0.8387096774193549
4549,5154,봣던/Noun,31,25,6,0.00030010003334444816,8.885137386436837e-05,0.8064516129032258
4550,5155,통틀어/Noun,31,25,6,0.00030010003334444816,8.885137386436837e-05,0.8064516129032258
4551,5156,메리/Noun,31,25,6,0.00030010003334444816,8.885137386436837e-05,0.8064516129032258
4552,5157,쪽바리/Noun,31,6,25,8.891852839835501e-05,0.0002998733867922433,0.8064516129032258
4553,5158,결제/Noun,31,6,25,8.891852839835501e-05,0.0002998733867922433,0.8064516129032258
4554,5159,서인국/Noun,31,25,6,0.00030010003334444816,8.885137386436837e-05,0.8064516129032258
4555,5160,으로/Foreign,31,7,24,0.0001000333444481494,0.0002887669650591972,0.7741935483870968
4556,5161,히치콕/Noun,31,24,7,0.0002889852172946538,9.995779559741441e-05,0.7741935483870968
4557,5162,클린트/Noun,31,24,7,0.0002889852172946538,9.995779559741441e-05,0.7741935483870968
4558,5163,윌리엄스/Noun,31,24,7,0.0002889852172946538,9.995779559741441e-05,0.7741935483870968
4559,5164,혼/Noun,31,24,7,0.0002889852172946538,9.995779559741441e-05,0.7741935483870968
4560,5165,때론/Noun,31,24,7,0.0002889852172946538,9.995779559741441e-05,0.7741935483870968
4561,5166,기막히다/Adjective,31,23,8,0.00027787040124485944,0.00011106421733046048,0.7419354838709677
4562,5167,크리스틴/Noun,31,23,8,0.00027787040124485944,0.00011106421733046048,0.7419354838709677
4563,5168,부대/Noun,31,8,23,0.00011114816049794375,0.00027766054332615115,0.7419354838709677
4564,5169,이틀/Noun,31,23,8,0.00027787040124485944,0.00011106421733046048,0.7419354838709677
4565,5170,봣음/Noun,31,23,8,0.00027787040124485944,0.00011106421733046048,0.7419354838709677
4566,5171,욕설/Noun,31,8,23,0.00011114816049794375,0.00027766054332615115,0.7419354838709677
4567,5172,하필/Noun,31,9,22,0.00012226297654773814,0.00026655412159310506,0.7096774193548387
4568,5173,희한하다/Adjective,31,9,22,0.00012226297654773814,0.00026655412159310506,0.7096774193548387
4569,5174,윤계상/Noun,31,22,9,0.000266755585195065,0.00012217063906350652,0.7096774193548387
4570,5175,미니/Noun,31,22,9,0.000266755585195065,0.00012217063906350652,0.7096774193548387
4571,5176,대면/Noun,31,9,22,0.00012226297654773814,0.00026655412159310506,0.7096774193548387
4572,5177,약자/Noun,31,22,9,0.000266755585195065,0.00012217063906350652,0.7096774193548387
4573,5178,1억/Number,31,9,22,0.00012226297654773814,0.00026655412159310506,0.7096774193548387
4574,5179,사다코/Noun,31,9,22,0.00012226297654773814,0.00026655412159310506,0.7096774193548387
4575,5180,공상/Noun,31,9,22,0.00012226297654773814,0.00026655412159310506,0.7096774193548387
4576,5181,엑/Exclamation,31,9,22,0.00012226297654773814,0.00026655412159310506,0.7096774193548387
4577,5182,미개하다/Adjective,31,9,22,0.00012226297654773814,0.00026655412159310506,0.7096774193548387
4578,5183,....?/Punctuation,31,10,21,0.0001333777925975325,0.0002554476998600591,0.6774193548387096
4579,5184,츠/Noun,31,21,10,0.00025564076914527065,0.00013327706079655256,0.6774193548387096
4580,5185,인셉션/Noun,31,21,10,0.00025564076914527065,0.00013327706079655256,0.6774193548387096
4581,5186,스트립/Noun,31,21,10,0.00025564076914527065,0.00013327706079655256,0.6774193548387096
4582,5187,큰일/Noun,31,10,21,0.0001333777925975325,0.0002554476998600591,0.6774193548387096
4583,5188,오우/Noun,31,21,10,0.00025564076914527065,0.00013327706079655256,0.6774193548387096
4584,5189,무장/Noun,31,10,21,0.0001333777925975325,0.0002554476998600591,0.6774193548387096
4585,5190,끊어지다/Verb,31,10,21,0.0001333777925975325,0.0002554476998600591,0.6774193548387096
4586,5191,미남/Noun,31,21,10,0.00025564076914527065,0.00013327706079655256,0.6774193548387096
4587,5192,부류/Noun,31,10,21,0.0001333777925975325,0.0002554476998600591,0.6774193548387096
4588,5193,내주다/Verb,31,21,10,0.00025564076914527065,0.00013327706079655256,0.6774193548387096
4589,5194,마저/Noun,31,11,20,0.0001444926086473269,0.00024434127812701304,0.6451612903225806
4590,5195,라고는/Josa,31,11,20,0.0001444926086473269,0.00024434127812701304,0.6451612903225806
4591,5196,인증/Noun,31,11,20,0.0001444926086473269,0.00024434127812701304,0.6451612903225806
4592,5197,나인/Noun,31,20,11,0.00024452595309547634,0.0001443834825295986,0.6451612903225806
4593,5198,그런대로/Adverb,31,11,20,0.0001444926086473269,0.00024434127812701304,0.6451612903225806
4594,5199,",../Punctuation",31,11,20,0.0001444926086473269,0.00024434127812701304,0.6451612903225806
4595,5200,필립/Noun,31,20,11,0.00024452595309547634,0.0001443834825295986,0.6451612903225806
4596,5201,뎁/Noun,31,20,11,0.00024452595309547634,0.0001443834825295986,0.6451612903225806
4597,5202,써주다/Verb,31,11,20,0.0001444926086473269,0.00024434127812701304,0.6451612903225806
4598,5203,난이/Noun,31,20,11,0.00024452595309547634,0.0001443834825295986,0.6451612903225806
4599,5204,7~8/Number,31,20,11,0.00024452595309547634,0.0001443834825295986,0.6451612903225806
4600,5205,맞먹다/Verb,31,12,19,0.00015560742469712126,0.000233234856393967,0.6129032258064516
4601,5206,불꽃/Noun,31,19,12,0.0002334111370456819,0.00015548990426264466,0.6129032258064516
4602,5207,악의/Noun,31,19,12,0.0002334111370456819,0.00015548990426264466,0.6129032258064516
4603,5208,미스터/Noun,31,19,12,0.0002334111370456819,0.00015548990426264466,0.6129032258064516
4604,5209,진출/Noun,31,13,18,0.00016672224074691566,0.00022212843466092096,0.5806451612903226
4605,5210,기리/Noun,31,18,13,0.0002222963209958875,0.0001665963259956907,0.5806451612903226
4606,5211,주장/Noun,31,13,18,0.00016672224074691566,0.00022212843466092096,0.5806451612903226
4607,5212,불가능/Noun,31,18,13,0.0002222963209958875,0.0001665963259956907,0.5806451612903226
4608,5213,매튜/Noun,31,18,13,0.0002222963209958875,0.0001665963259956907,0.5806451612903226
4609,5214,보더/Noun,31,13,18,0.00016672224074691566,0.00022212843466092096,0.5806451612903226
4610,5215,리스트/Noun,31,18,13,0.0002222963209958875,0.0001665963259956907,0.5806451612903226
4611,5216,달려가다/Verb,31,18,13,0.0002222963209958875,0.0001665963259956907,0.5806451612903226
4612,5217,도박/Noun,31,18,13,0.0002222963209958875,0.0001665963259956907,0.5806451612903226
4613,5218,전투기/Noun,31,13,18,0.00016672224074691566,0.00022212843466092096,0.5806451612903226
4614,5219,창조/Noun,31,18,13,0.0002222963209958875,0.0001665963259956907,0.5806451612903226
4615,5220,정성/Noun,31,13,18,0.00016672224074691566,0.00022212843466092096,0.5806451612903226
4616,5221,미션/Noun,31,13,18,0.00016672224074691566,0.00022212843466092096,0.5806451612903226
4617,5222,큐/Noun,31,13,18,0.00016672224074691566,0.00022212843466092096,0.5806451612903226
4618,5223,좁다/Adjective,31,13,18,0.00016672224074691566,0.00022212843466092096,0.5806451612903226
4619,5224,앤딩/Noun,31,13,18,0.00016672224074691566,0.00022212843466092096,0.5806451612903226
4620,5225,장용/Noun,31,13,18,0.00016672224074691566,0.00022212843466092096,0.5806451612903226
4621,5226,사오다/Verb,31,18,13,0.0002222963209958875,0.0001665963259956907,0.5806451612903226
4622,5227,기반/Noun,31,13,18,0.00016672224074691566,0.00022212843466092096,0.5806451612903226
4623,5228,뜸/Noun,31,18,13,0.0002222963209958875,0.0001665963259956907,0.5806451612903226
4624,5229,궁금증/Noun,31,14,17,0.00017783705679671002,0.0002110220129278749,0.5483870967741935
4625,5230,문제점/Noun,31,14,17,0.00017783705679671002,0.0002110220129278749,0.5483870967741935
4626,5231,천녀유혼/Noun,31,14,17,0.00017783705679671002,0.0002110220129278749,0.5483870967741935
4627,5232,헤/Noun,31,14,17,0.00017783705679671002,0.0002110220129278749,0.5483870967741935
4628,5233,롯데/Noun,31,17,14,0.00021118150494609317,0.00017770274772873674,0.5483870967741935
4629,5234,미우다/Verb,31,17,14,0.00021118150494609317,0.00017770274772873674,0.5483870967741935
4630,5235,며칠/Noun,31,17,14,0.00021118150494609317,0.00017770274772873674,0.5483870967741935
4631,5236,발차기/Noun,31,14,17,0.00017783705679671002,0.0002110220129278749,0.5483870967741935
4632,5237,이겠다/Verb,31,17,14,0.00021118150494609317,0.00017770274772873674,0.5483870967741935
4633,5247,난감하다/Adjective,30,1,29,3.334444814938313e-05,0.00034429907372442745,0.9666666666666668
4634,5248,흠뻑/Noun,30,29,1,0.0003445592975436257,3.331926519913814e-05,0.9666666666666668
4635,5249,난방/Noun,30,1,29,3.334444814938313e-05,0.00034429907372442745,0.9666666666666668
4636,5250,한물가다/Verb,30,2,28,4.445926419917751e-05,0.0003331926519913814,0.9333333333333332
4637,5251,중구/Noun,30,2,28,4.445926419917751e-05,0.0003331926519913814,0.9333333333333332
4638,5252,더러워지다/Verb,30,2,28,4.445926419917751e-05,0.0003331926519913814,0.9333333333333332
4639,5253,유승준/Noun,30,3,27,5.5574080248971876e-05,0.00032208623025833537,0.9
4640,5254,망신/Noun,30,3,27,5.5574080248971876e-05,0.00032208623025833537,0.9
4641,5255,인간미/Noun,30,26,4,0.00031121484939424253,6.663853039827628e-05,0.8666666666666667
4642,5256,무책임하다/Adjective,30,4,26,6.668889629876625e-05,0.00031097980852528933,0.8666666666666667
4643,5257,안남다/Adjective,30,4,26,6.668889629876625e-05,0.00031097980852528933,0.8666666666666667
4644,5258,진실되다/Adjective,30,26,4,0.00031121484939424253,6.663853039827628e-05,0.8666666666666667
4645,5259,괴/Noun,30,4,26,6.668889629876625e-05,0.00031097980852528933,0.8666666666666667
4646,5260,무표정/Noun,30,5,25,7.780371234856063e-05,0.0002998733867922433,0.8333333333333334
4647,5261,거도/Noun,30,6,24,8.891852839835501e-05,0.0002887669650591972,0.8
4648,5262,영화음악/Noun,30,24,6,0.0002889852172946538,8.885137386436837e-05,0.8
4649,5263,걸레/Noun,30,6,24,8.891852839835501e-05,0.0002887669650591972,0.8
4650,5264,ㅁㅊ/KoreanParticle,30,6,24,8.891852839835501e-05,0.0002887669650591972,0.8
4651,5265,쬐다/Verb,30,6,24,8.891852839835501e-05,0.0002887669650591972,0.8
4652,5266,잠수함/Noun,30,24,6,0.0002889852172946538,8.885137386436837e-05,0.8
4653,5267,관성/Noun,30,6,24,8.891852839835501e-05,0.0002887669650591972,0.8
4654,5268,으으/Exclamation,30,6,24,8.891852839835501e-05,0.0002887669650591972,0.8
4655,5269,패기/Noun,30,6,24,8.891852839835501e-05,0.0002887669650591972,0.8
4656,5270,진주/Noun,30,24,6,0.0002889852172946538,8.885137386436837e-05,0.8
4657,5271,은희/Noun,30,7,23,0.0001000333444481494,0.00027766054332615115,0.7666666666666667
4658,5272,미루다/Verb,30,23,7,0.00027787040124485944,9.995779559741441e-05,0.7666666666666667
4659,5273,피하/Noun,30,7,23,0.0001000333444481494,0.00027766054332615115,0.7666666666666667
4660,5274,여고괴담/Noun,30,7,23,0.0001000333444481494,0.00027766054332615115,0.7666666666666667
4661,5275,콧물/Noun,30,23,7,0.00027787040124485944,9.995779559741441e-05,0.7666666666666667
4662,5276,오점/Noun,30,8,22,0.00011114816049794375,0.00026655412159310506,0.7333333333333333
4663,5277,기념/Noun,30,8,22,0.00011114816049794375,0.00026655412159310506,0.7333333333333333
4664,5278,and/Alpha,30,22,8,0.000266755585195065,0.00011106421733046048,0.7333333333333333
4665,5279,토이스토리/Noun,30,22,8,0.000266755585195065,0.00011106421733046048,0.7333333333333333
4666,5280,교차/Noun,30,22,8,0.000266755585195065,0.00011106421733046048,0.7333333333333333
4667,5281,나마/Josa,30,22,8,0.000266755585195065,0.00011106421733046048,0.7333333333333333
4668,5282,평범/Noun,30,8,22,0.00011114816049794375,0.00026655412159310506,0.7333333333333333
4669,5283,무능하다/Adjective,30,9,21,0.00012226297654773814,0.0002554476998600591,0.7
4670,5284,아야/Noun,30,9,21,0.00012226297654773814,0.0002554476998600591,0.7
4671,5285,작업/Noun,30,9,21,0.00012226297654773814,0.0002554476998600591,0.7
4672,5286,처벌/Noun,30,9,21,0.00012226297654773814,0.0002554476998600591,0.7
4673,5287,구해/Noun,30,21,9,0.00025564076914527065,0.00012217063906350652,0.7
4674,5288,의존/Noun,30,9,21,0.00012226297654773814,0.0002554476998600591,0.7
4675,5289,에너지/Noun,30,20,10,0.00024452595309547634,0.00013327706079655256,0.6666666666666666
4676,5290,sbs/Alpha,30,10,20,0.0001333777925975325,0.00024434127812701304,0.6666666666666666
4677,5291,안정/Noun,30,20,10,0.00024452595309547634,0.00013327706079655256,0.6666666666666666
4678,5292,지능/Noun,30,10,20,0.0001333777925975325,0.00024434127812701304,0.6666666666666666
4679,5293,조재현/Noun,30,20,10,0.00024452595309547634,0.00013327706079655256,0.6666666666666666
4680,5294,축/Noun,30,10,20,0.0001333777925975325,0.00024434127812701304,0.6666666666666666
4681,5295,간접/Noun,30,20,10,0.00024452595309547634,0.00013327706079655256,0.6666666666666666
4682,5296,정적/Noun,30,20,10,0.00024452595309547634,0.00013327706079655256,0.6666666666666666
4683,5297,로드무비/Noun,30,20,10,0.00024452595309547634,0.00013327706079655256,0.6666666666666666
4684,5298,이종석/Noun,30,19,11,0.0002334111370456819,0.0001443834825295986,0.6333333333333333
4685,5299,갱/Noun,30,11,19,0.0001444926086473269,0.000233234856393967,0.6333333333333333
4686,5300,도감/Noun,30,19,11,0.0002334111370456819,0.0001443834825295986,0.6333333333333333
4687,5301,모델/Noun,30,11,19,0.0001444926086473269,0.000233234856393967,0.6333333333333333
4688,5302,웨슬리/Noun,30,11,19,0.0001444926086473269,0.000233234856393967,0.6333333333333333
4689,5303,모자/Noun,30,19,11,0.0002334111370456819,0.0001443834825295986,0.6333333333333333
4690,5304,쾌감/Noun,30,19,11,0.0002334111370456819,0.0001443834825295986,0.6333333333333333
4691,5305,안티/Noun,30,11,19,0.0001444926086473269,0.000233234856393967,0.6333333333333333
4692,5306,데이트/Noun,30,11,19,0.0001444926086473269,0.000233234856393967,0.6333333333333333
4693,5307,최진실/Noun,30,19,11,0.0002334111370456819,0.0001443834825295986,0.6333333333333333
4694,5308,속상하다/Adjective,30,19,11,0.0002334111370456819,0.0001443834825295986,0.6333333333333333
4695,5309,나비효과/Noun,30,12,18,0.00015560742469712126,0.00022212843466092096,0.6
4696,5310,무심하다/Adjective,30,12,18,0.00015560742469712126,0.00022212843466092096,0.6
4697,5311,두뇌/Noun,30,18,12,0.0002222963209958875,0.00015548990426264466,0.6
4698,5312,스토리텔링/Noun,30,12,18,0.00015560742469712126,0.00022212843466092096,0.6
4699,5313,평작/Noun,30,12,18,0.00015560742469712126,0.00022212843466092096,0.6
4700,5314,묶다/Verb,30,12,18,0.00015560742469712126,0.00022212843466092096,0.6
4701,5315,헛소리/Noun,30,12,18,0.00015560742469712126,0.00022212843466092096,0.6
4702,5316,일본애니/Noun,30,18,12,0.0002222963209958875,0.00015548990426264466,0.6
4703,5317,대니/Noun,30,18,12,0.0002222963209958875,0.00015548990426264466,0.6
4704,5318,출동/Noun,30,12,18,0.00015560742469712126,0.00022212843466092096,0.6
4705,5319,하여간/Adverb,30,12,18,0.00015560742469712126,0.00022212843466092096,0.6
4706,5320,시스템/Noun,30,18,12,0.0002222963209958875,0.00015548990426264466,0.6
4707,5321,유해진/Noun,30,18,12,0.0002222963209958875,0.00015548990426264466,0.6
4708,5322,가문/Noun,30,12,18,0.00015560742469712126,0.00022212843466092096,0.6
4709,5323,초능력/Noun,30,12,18,0.00015560742469712126,0.00022212843466092096,0.6
4710,5324,그룹/Noun,30,12,18,0.00015560742469712126,0.00022212843466092096,0.6
4711,5325,이승기/Noun,30,18,12,0.0002222963209958875,0.00015548990426264466,0.6
4712,5326,각성/Noun,30,13,17,0.00016672224074691566,0.0002110220129278749,0.5666666666666667
4713,5327,로사/Noun,30,17,13,0.00021118150494609317,0.0001665963259956907,0.5666666666666667
4714,5328,자존심/Noun,30,17,13,0.00021118150494609317,0.0001665963259956907,0.5666666666666667
4715,5329,번만/Noun,30,17,13,0.00021118150494609317,0.0001665963259956907,0.5666666666666667
4716,5330,고향/Noun,30,13,17,0.00016672224074691566,0.0002110220129278749,0.5666666666666667
4717,5331,뚫다/Verb,30,13,17,0.00016672224074691566,0.0002110220129278749,0.5666666666666667
4718,5332,해안/Noun,30,13,17,0.00016672224074691566,0.0002110220129278749,0.5666666666666667
4719,5333,퀄/Noun,30,17,13,0.00021118150494609317,0.0001665963259956907,0.5666666666666667
4720,5334,이입/Noun,30,13,17,0.00016672224074691566,0.0002110220129278749,0.5666666666666667
4721,5335,리언/Noun,30,17,13,0.00021118150494609317,0.0001665963259956907,0.5666666666666667
4722,5336,에서부터/Josa,30,13,17,0.00016672224074691566,0.0002110220129278749,0.5666666666666667
4723,5337,아트/Noun,30,17,13,0.00021118150494609317,0.0001665963259956907,0.5666666666666667
4724,5338,안고/Noun,30,17,13,0.00021118150494609317,0.0001665963259956907,0.5666666666666667
4725,5339,찍히다/Verb,30,14,16,0.00017783705679671002,0.00019991559119482882,0.5333333333333333
4726,5340,식당/Noun,30,14,16,0.00017783705679671002,0.00019991559119482882,0.5333333333333333
4727,5341,1%/Number,30,16,14,0.0002000666888962988,0.00017770274772873674,0.5333333333333333
4728,5342,헐크/Noun,30,16,14,0.0002000666888962988,0.00017770274772873674,0.5333333333333333
4729,5343,대판/Noun,30,16,14,0.0002000666888962988,0.00017770274772873674,0.5333333333333333
4730,5344,봉태규/Noun,30,14,16,0.00017783705679671002,0.00019991559119482882,0.5333333333333333
4731,5345,림/Noun,30,16,14,0.0002000666888962988,0.00017770274772873674,0.5333333333333333
4732,5346,경제/Noun,30,14,16,0.00017783705679671002,0.00019991559119482882,0.5333333333333333
4733,5347,악플/Noun,30,14,16,0.00017783705679671002,0.00019991559119482882,0.5333333333333333
4734,5348,장쯔이/Noun,30,16,14,0.0002000666888962988,0.00017770274772873674,0.5333333333333333
4735,5349,사의/Noun,30,16,14,0.0002000666888962988,0.00017770274772873674,0.5333333333333333
4736,5350,아날로그/Noun,30,16,14,0.0002000666888962988,0.00017770274772873674,0.5333333333333333
