,parameter,counts,counts_H,counts_NH,p_from_H,p_from_NH,priority
0,./Punctuation,52431,26334,26097,0.2927105795522753,0.2898571650709732,0.5022601132917549
1,영화/Noun,50383,25791,24592,0.2866749660983038,0.2731412577470733,0.5118988547724431
2,이/Josa,38256,20012,18244,0.22243958828890914,0.2026345602772286,0.5231074864073609
3,보다/Verb,38094,21677,16417,0.24094657981904274,0.18234222627007574,0.5690397437916732
4,하다/Verb,38002,18125,19877,0.20146499788809105,0.22077215274229736,0.5230514183464028
5,의/Josa,29457,17487,11970,0.19437342996243026,0.13294977452962214,0.593644974029942
6,가/Josa,27737,12332,15405,0.13707400573550008,0.1711020281227092,0.5553953203302447
7,에/Josa,27391,14054,13337,0.15621456994864727,0.1481329275606993,0.5130882406629915
8,../Punctuation,25849,11706,14143,0.13011582153257897,0.15708510118399716,0.547139154319316
9,을/Josa,23027,12500,10527,0.1389413778538559,0.11692249594597597,0.5428410127241934
10,.../Punctuation,22073,9139,12934,0.10158282017651113,0.14365684074905036,0.5859647533185339
11,은/Josa,19690,7739,11951,0.08602138585687927,0.13273874314147988,0.6069578466226511
12,도/Josa,18990,7903,11087,0.08784429673432186,0.12314236843858986,0.5838335966298052
13,들/Suffix,18507,8922,9585,0.09917079785696818,0.10645978186018615,0.5179121413519209
14,는/Josa,18035,7669,10366,0.08524331414089767,0.11513428260434946,0.5747712780704186
15,없다/Adjective,16914,5001,11913,0.05558766645177067,0.13231668036519537,0.7043277758070238
16,를/Josa,16639,8276,8363,0.09199030744948092,0.09288713152808939,0.5026143398040748
17,",/Punctuation",14719,7561,7158,0.08404286063624036,0.07950329875380412,0.513689788708472
18,있다/Adjective,13419,8187,5232,0.09100104483916147,0.05811138014527845,0.6101050748938073
19,좋다/Adjective,13043,9370,3673,0.10415045683925038,0.04079569940244796,0.7183930077436173
20,이/Determiner,12373,4495,7878,0.04996331947624658,0.08750027767287913,0.6367089630647378
21,너무/Adverb,11905,6629,5276,0.07368339150345686,0.05860008441255526,0.55682486350273
22,재밌다/Adjective,11789,9955,1834,0.11065291332281084,0.020370082413310526,0.8444312494698448
23,?/Punctuation,11319,3302,8017,0.036702754373874574,0.08904413888086722,0.7082781164413817
24,정말/Noun,10702,7082,3620,0.0787186270368806,0.04020703289868272,0.6617454681367969
25,것/Noun,10293,4088,6205,0.045439388213325035,0.06891840860119511,0.6028368794326241
26,되다/Verb,9887,5453,4434,0.0606117866749661,0.04924806184330364,0.551532315161323
27,같다/Adjective,9325,4691,4634,0.05214192028099504,0.051469444876380034,0.5030563002680966
28,진짜/Noun,9220,4526,4694,0.050307894093324146,0.05213585978630295,0.5091106290672451
29,이/Noun,9081,4359,4722,0.04845163728519663,0.05244685341093365,0.5199867855963
30,적/Suffix,9003,5486,3517,0.060978591912500275,0.03906302063664838,0.6093524380761969
31,으로/Josa,8921,4168,4753,0.046328613031589715,0.05279116778106049,0.5327878040578411
32,아니다/Adjective,8754,3210,5544,0.03568014583287019,0.06157673767687762,0.6333104866346813
33,않다/Verb,8640,4350,4290,0.048351599493141856,0.047648666059488635,0.5034722222222222
34,!/Punctuation,8565,6415,2150,0.07130471511459885,0.023879867605571228,0.7489784004670169
35,로/Josa,7951,3351,4600,0.03724740457506169,0.05109180976075705,0.5785435794239718
36,에서/Josa,7910,4218,3692,0.04688437854300514,0.04100673079059022,0.5332490518331227
37,점/Noun,7843,3227,4616,0.03586910610675144,0.05126952040340316,0.5885502996302435
38,만/Josa,7745,2412,5333,0.026810128270680033,0.05923317857698203,0.6885732730794061
39,나오다/Verb,7213,2894,4319,0.03216770780072472,0.04797076659928472,0.5987799805906003
40,만들다/Verb,7199,2506,4693,0.027854967432141033,0.05212475287113757,0.6518960966800944
41,연기/Noun,7089,4106,2983,0.04563946379743459,0.03313192793833441,0.5792072224573283
42,평점/Noun,7068,2994,4074,0.03327923882355557,0.04524957238376613,0.5764006791171478
43,과/Josa,6768,4231,2537,0.04702887757597315,0.02817824377457405,0.6251477541371159
44,최고/Noun,6671,6143,528,0.06828135073249894,0.005864451207321679,0.9208514465597362
45,한/Josa,6635,3102,3533,0.03447969232821288,0.03924073127929449,0.5324792765636774
46,이다/Verb,6524,4043,2481,0.044939199253051156,0.02755625652531266,0.6197118332311465
47,왜/Noun,6247,2241,4006,0.024909410221639287,0.044494302152520156,0.6412678085481031
48,스토리/Noun,6075,2176,3899,0.024186915056799235,0.04330586222982429,0.6418106995884774
49,인/Josa,6018,3216,2802,0.035746837694240044,0.03112157629340027,0.5343968095712861
50,생각/Noun,6005,3771,2234,0.04191583487095125,0.024812848479463315,0.6279766860949209
51,~/Punctuation,6003,4016,1987,0.04463908587688682,0.022069440433613967,0.6689988339163752
52,다/Josa,5815,2885,2930,0.03206767000866994,0.03254326143456916,0.5038693035253654
53,다/Adverb,5790,2454,3336,0.02727697130026899,0.03705266899171424,0.5761658031088083
54,이다/Josa,5692,2965,2727,0.03295689482693462,0.030288557655996622,0.5209065354884048
55,감동/Noun,5597,4442,1155,0.04937420803414623,0.012828487016016172,0.7936394497051992
56,..../Punctuation,5580,2218,3362,0.02465375808638819,0.03734144878601417,0.6025089605734767
57,1/Number,5284,1409,3875,0.01566147211168664,0.04303929626585512,0.7333459500378501
58,사람/Noun,5259,2583,2676,0.028710846319720783,0.029722104982562142,0.5088419851682829
59,이렇다/Adjective,5240,2243,2997,0.0249316408420959,0.033287424750649754,0.5719465648854962
60,보고/Noun,5209,3038,2171,0.03376831247360114,0.02411311282404425,0.5832213476674986
61,말/Noun,5179,2468,2711,0.027432585643465308,0.03011084701335051,0.5234601274377293
62,아깝다/Adjective,5167,374,4793,0.004157126025387369,0.053235444387675766,0.9276175730598026
63,더/Noun,5026,2595,2431,0.028844230042460485,0.02700091076704356,0.5163151611619579
64,드라마/Noun,5005,3017,1988,0.033534890958806664,0.02208054734877935,0.6027972027972028
65,내/Noun,4988,2441,2547,0.02713247226730098,0.02828931292622787,0.510625501202887
66,때/Noun,4940,3220,1720,0.03579129893515328,0.019103894084456983,0.6518218623481782
67,배우/Noun,4882,2357,2525,0.02619878620812307,0.028044960792589467,0.5172060630888979
68,ㅋㅋㅋ/KoreanParticle,4833,2528,2305,0.02809950425716382,0.025601439456205435,0.5230705565901097
69,재미있다/Adjective,4787,4102,685,0.04559500255652135,0.007608236888286647,0.8569041153123041
70,거/Noun,4783,1959,2824,0.021774892737256298,0.031365928427038677,0.5904244198201966
71,와/Josa,4779,2774,2005,0.0308338705733277,0.022269364906590844,0.5804561623770663
72,감독/Noun,4688,1515,3173,0.016839694995887337,0.03524224181975698,0.6768344709897611
73,ㅋㅋ/KoreanParticle,4594,2777,1817,0.030867216504012626,0.020181264855499034,0.6044841097083152
74,재미/Noun,4538,1752,2786,0.019474023519996442,0.03094386565075416,0.6139268400176289
75,내용/Noun,4529,1407,3122,0.01563924149123002,0.0346757891463225,0.6893353941267388
76,뭐/Noun,4491,831,3660,0.009236822799724341,0.040651309505298,0.8149632598530394
77,못/VerbPrefix,4418,1474,2944,0.016383967276526686,0.03269875824688451,0.666364870982345
78,그냥/Noun,4406,1187,3219,0.013193873241002156,0.03575315991736455,0.7305946436677259
79,고/Josa,4377,1761,2616,0.01957406131205122,0.029055690072639227,0.5976696367374914
80,까지/Josa,4353,2076,2277,0.023075384033968388,0.025290445831574738,0.5230875258442453
81,게/Josa,4340,1723,2617,0.019151679523375497,0.029066796987804608,0.6029953917050691
82,주다/Verb,4321,1728,2593,0.01920725607451704,0.02880023102383544,0.6000925711640824
83,안/VerbPrefix,4262,1318,2944,0.014649978880910566,0.03269875824688451,0.6907555138432661
84,재미없다/Adjective,4205,307,3898,0.003412400240090701,0.04329475531465891,0.9269916765755053
85,자다/Verb,4114,2658,1456,0.029544494586843918,0.016171668480796143,0.6460865337870686
86,좀/Noun,4111,1455,2656,0.016172776382188826,0.029499966679254502,0.6460715154463634
87,그/Noun,4099,2400,1699,0.026676744547940334,0.018870648865983962,0.5855086606489388
88,지루하다/Adjective,4057,872,3185,0.009692550519084988,0.03537552480174157,0.7850628543258565
89,하고/Josa,4024,1896,2128,0.02107462819287286,0.023635515471932825,0.5288270377733598
90,가다/Verb,4006,1941,2065,0.021574817153146745,0.022935779816513763,0.5154767848227658
91,!!/Punctuation,4005,3088,917,0.03432407798501656,0.010185041206655263,0.7710362047440699
92,시간/Noun,3956,1077,2879,0.011971189115888224,0.031976808761134685,0.7277553083923155
93,한/Determiner,3920,1604,2316,0.01782895760620679,0.025723615523024636,0.5908163265306122
94,쓰레기/Noun,3739,209,3530,0.0023230998377164708,0.039207410533798344,0.9441027012570206
95,들다/Verb,3702,1859,1843,0.02066336171442545,0.020470044649798964,0.5021609940572663
96,수/Noun,3698,2475,1223,0.02751039281506347,0.013583757247262145,0.6692806922660898
97,모르다/Verb,3669,1654,2015,0.018384723117622213,0.022380434058244664,0.5491959662033251
98,싶다/Verb,3517,1833,1684,0.02037436364848943,0.018704045138503232,0.5211828262723912
99,그렇다/Adjective,3501,1397,2104,0.015528088388946936,0.023368949507963657,0.6009711510996858
100,나/Noun,3501,1853,1648,0.0205966698530556,0.01830419619254948,0.5292773493287632
101,아/Exclamation,3469,1327,2142,0.014750016672965343,0.023791012284248174,0.617469011242433
102,알다/Verb,3393,1393,2000,0.015483627148033701,0.022213830330763934,0.5894488653109343
103,볼/Noun,3386,1865,1521,0.020730053575795302,0.01689361796654597,0.5507974010632014
104,작품/Noun,3308,2050,1258,0.02278638596803237,0.013972499278050514,0.6197097944377267
105,다시/Noun,3289,2763,526,0.03071160216081631,0.005842237376990914,0.8400729705077531
106,10/Number,3248,2158,1090,0.023986839472689682,0.012106537530266344,0.6644088669950738
107,마지막/Noun,3201,2151,1050,0.023909032301091523,0.011662260923651064,0.6719775070290535
108,보다/Josa,3196,1681,1515,0.018684836493786543,0.01682697647555368,0.5259699624530664
109,사랑/Noun,3190,2523,667,0.028043927706022275,0.007408312415309772,0.7909090909090909
110,잘/VerbPrefix,3151,2150,1001,0.023897916990863216,0.011118022080547348,0.682323072040622
111,하나/Noun,3087,1267,1820,0.014083098059266835,0.02021458560099518,0.5895691609977324
112,오다/Verb,3064,1619,1445,0.017995687259631417,0.01604949241397694,0.5283942558746736
113,이렇게/Adverb,3042,1309,1733,0.01454994108885579,0.01924828398160695,0.5696909927679158
114,요/Josa,3013,1950,1063,0.02167485494520152,0.011806650820801031,0.6471954862263525
115,처음/Noun,2995,1342,1653,0.014916746326389969,0.01835973076837639,0.5519198664440734
116,이다/Adjective,2942,2200,742,0.02445368250227864,0.00824133105271342,0.7477906186267845
117,나/Josa,2916,1029,1887,0.011437654224929417,0.020958748917075772,0.647119341563786
118,정도/Noun,2909,1293,1616,0.014372096125202854,0.01794877490725726,0.5555173599174974
119,2/Number,2878,1225,1653,0.013616255029677879,0.01835973076837639,0.574357192494788
120,많다/Adjective,2857,1696,1161,0.018851566147211167,0.012895128507008463,0.5936296814840742
121,완전/Noun,2851,1545,1306,0.01717315430273659,0.014505631205988849,0.5419151175026307
122,ㅋ/KoreanParticle,2712,1574,1138,0.017495498299357534,0.012639669458204678,0.5803834808259587
123,주인공/Noun,2708,1083,1625,0.012037880977258076,0.018048737143745695,0.6000738552437223
124,안되다/Adjective,2683,658,2025,0.007313874130226975,0.022491503209898484,0.7547521431233694
125,액션/Noun,2660,1278,1382,0.014205366471778228,0.015349756758557879,0.5195488721804511
126,나다/Verb,2654,1340,1314,0.014894515705933352,0.014594486527311904,0.5048982667671439
127,차다/Verb,2646,1269,1377,0.014105328679723451,0.015294222182730969,0.5204081632653061
128,인데/Josa,2629,1242,1387,0.013805215303559123,0.015405291334384789,0.5275770254849753
129,장면/Noun,2611,1425,1186,0.015839317075339573,0.013172801386143013,0.5457679050172348
130,중/Suffix,2597,1568,1029,0.017428806437987686,0.011429015705178043,0.6037735849056604
131,지금/Noun,2596,1843,753,0.020485516750772512,0.00836350711953262,0.7099383667180277
132,ㅠㅠ/KoreanParticle,2589,1842,747,0.020474401440544205,0.00829686562854033,0.7114716106604867
133,최악/Noun,2549,32,2517,0.0003556899273058711,0.02795610547126641,0.9874460572773637
134,지/Josa,2511,993,1518,0.011037503056710312,0.016860297221049824,0.6045400238948626
135,임/Noun,2511,1059,1452,0.011771113531778671,0.016127240820134617,0.5782556750298686
136,걸/Noun,2493,777,1716,0.008636596047395683,0.019059466423795454,0.6883273164861613
137,3/Number,2481,918,1563,0.010203854789587177,0.017360108403492013,0.6299879081015719
138,이야기/Noun,2465,1372,1093,0.015250205633239224,0.012139858275762489,0.5565922920892495
139,연출/Noun,2454,975,1479,0.01083742747260076,0.01642712752959993,0.6026894865525673
140,별로/Noun,2438,320,2118,0.003556899273058711,0.023524446320279006,0.8687448728465955
141,끝/Noun,2438,862,1576,0.009581397416801902,0.01750449830064198,0.6464315012305168
142,돈/Noun,2433,279,2154,0.0031011715536980638,0.023924295266232756,0.8853267570900123
143,느낌/Noun,2411,1154,1257,0.012827068003467976,0.013961392362885133,0.5213604313562837
144,좋아하다/Adjective,2390,1427,963,0.015861547695796188,0.010695959304262833,0.597071129707113
145,듯/Noun,2374,1137,1237,0.012638107729586732,0.013739254059577493,0.52106149957877
146,라/Josa,2373,987,1386,0.010970811195340461,0.015394184419219406,0.584070796460177
147,그리고/Conjunction,2339,1419,920,0.015772625213969722,0.01021836195215141,0.6066695168875588
148,역시/Noun,2323,1623,700,0.01804014850054465,0.007774840615767377,0.6986655187257856
149,넘다/Verb,2286,1520,766,0.016895271547028877,0.008507897016682586,0.6649168853893264
150,개/Noun,2277,671,1606,0.007458373163194984,0.01783770575560344,0.7053140096618358
151,명작/Noun,2259,1976,283,0.02196385301113754,0.0031432569918030968,0.8747233289065959
152,받다/Verb,2250,1080,1170,0.01200453504657315,0.012995090743496902,0.52
153,남다/Verb,2231,1452,779,0.0161394304515039,0.008652286913832552,0.6508292245629762
154,이런/Modifier,2201,819,1382,0.009103439076984639,0.015349756758557879,0.6278964107223989
155,그/Determiner,2183,1013,1170,0.011259809261276482,0.012995090743496902,0.5359596885020614
156,이해/Noun,2164,866,1298,0.009625858657715137,0.014416775884665793,0.5998151571164511
157,^^/Punctuation,2162,1921,241,0.021352510948580573,0.002676766554857054,0.8885291396854764
158,라고/Josa,2147,777,1370,0.008636596047395683,0.015216473776573295,0.6380996739636703
159,괜찮다/Adjective,2129,1444,685,0.016050507969677434,0.007608236888286647,0.678252700798497
160,ㅡㅡ/KoreanParticle,2128,211,1917,0.0023453304581730876,0.02129195637203723,0.9008458646616542
161,이영화/Noun,2102,1147,955,0.012749260831869818,0.010607103982939778,0.5456707897240723
162,안/Noun,2100,842,1258,0.009359091212235734,0.013972499278050514,0.599047619047619
163,버리다/Verb,2073,660,1413,0.007336104750683591,0.01569407112868472,0.6816208393632417
164,느끼다/Verb,2066,1442,624,0.016028277349220816,0.006930715063198347,0.6979670861568248
165,많이/Adverb,2064,1130,934,0.012560300557988574,0.010373858764466757,0.5474806201550387
166,때문/Noun,2060,810,1250,0.009003401284929862,0.013883643956727459,0.6067961165048543
167,!!!/Punctuation,2038,1392,646,0.015472511837805392,0.00717506719683675,0.6830225711481845
168,또/Noun,2013,1348,665,0.01498343818775982,0.007386098584979008,0.6696472925981123
169,중/Noun,1957,1139,818,0.01266033835004335,0.00908545660528245,0.5820132856412877
170,해주다/Verb,1945,1324,621,0.014716670742280417,0.006897394317702202,0.680719794344473
171,여자/Noun,1944,757,1187,0.008414289842829513,0.013183908301308394,0.61059670781893
172,난/Noun,1928,1196,732,0.013293911033056932,0.0081302619010596,0.6203319502074689
173,꼭/Noun,1920,1594,326,0.017717804503923705,0.003620854343914521,0.8302083333333333
174,내/Determiner,1911,839,1072,0.009325745281550809,0.011906613057289468,0.5609628466771324
175,에게/Josa,1907,1144,763,0.012715914901184892,0.00847457627118644,0.5998951232302046
176,보기/Noun,1903,847,1056,0.009414667763377276,0.011728902414643357,0.5549132947976878
177,아름답다/Adjective,1901,1659,242,0.018440299668763756,0.002687873470022436,0.8726985796948974
178,하/Suffix,1862,787,1075,0.008747749149678767,0.011939933802785614,0.5773361976369495
179,이고/Josa,1836,960,876,0.010670697819176133,0.009729657684874602,0.5228758169934641
180,어떻다/Adjective,1819,805,1014,0.00894782473378832,0.011262411977697314,0.5574491478834525
181,마음/Noun,1810,1497,313,0.016639619411777783,0.0034764644467645558,0.8270718232044199
182,인생/Noun,1810,1304,506,0.014494364537714247,0.0056200990736832756,0.7204419889502762
183,서/Josa,1808,876,932,0.009737011759998221,0.010351644934135993,0.5154867256637168
184,엔/Josa,1801,827,974,0.009192361558811106,0.010818135371082036,0.5408106607440311
185,기억/Noun,1794,1237,557,0.01374963875241758,0.006186551747117756,0.689520624303233
186,부터/Josa,1791,743,1048,0.008258675499633194,0.011640047093320302,0.5851479620323842
187,결말/Noun,1777,729,1048,0.008103061156436876,0.011640047093320302,0.5897580191333709
188,끄다/Verb,1754,541,1213,0.006013382833514883,0.013472688095608325,0.6915621436716077
189,아쉽다/Adjective,1746,1186,560,0.013182757930773848,0.0062198724926139015,0.6792668957617412
190,면/Josa,1746,896,850,0.00995931796456439,0.009440877890574672,0.5131729667812142
191,ㅎㅎ/KoreanParticle,1744,1498,246,0.01665073472200609,0.002732301130683964,0.8589449541284404
192,보여주다/Verb,1738,936,802,0.01040393037369673,0.008907745962636337,0.5385500575373993
193,랑/Josa,1721,744,977,0.008269790809861503,0.010851456116578182,0.567693201626961
194,못/Noun,1720,544,1176,0.006046728764199809,0.013061732234489193,0.6837209302325581
195,소재/Noun,1714,594,1120,0.0066024942756152324,0.012439744985227803,0.6534422403733956
196,이나/Josa,1704,527,1177,0.005857768490318565,0.013072839149654574,0.6907276995305164
197,어리다/Verb,1690,1270,420,0.014116443989951759,0.004664904369460426,0.7514792899408284
198,재다/Verb,1675,1417,258,0.015750394593513104,0.0028655841126685472,0.8459701492537314
199,없이/Adverb,1675,902,773,0.010026009825934242,0.00858564542284026,0.5385074626865671
200,뻔하다/Adjective,1670,457,1213,0.005079696774336972,0.013472688095608325,0.7263473053892215
201,애/Noun,1670,576,1094,0.00640241869150568,0.012150965190927872,0.6550898203592814
202,수준/Noun,1658,273,1385,0.003034479692328213,0.015383077504054024,0.8353437876960192
203,맞다/Verb,1649,477,1172,0.005302002978903141,0.013017304573827665,0.7107337780473014
204,한번/Noun,1640,1136,504,0.012626992419358425,0.005597885243352511,0.6926829268292682
205,편/Noun,1613,721,892,0.008014138674610408,0.009907368327520715,0.5530068195908245
206,네/Josa,1608,469,1139,0.005213080497076673,0.01265077637337006,0.7083333333333334
207,먹다/Verb,1594,709,885,0.007880754951870707,0.009829619921363041,0.555207026348808
208,웃기다/Verb,1590,781,809,0.008681057288308917,0.008985494368794011,0.5088050314465409
209,라는/Josa,1588,783,805,0.008703287908765534,0.008941066708132482,0.506926952141058
210,현실/Noun,1587,1041,546,0.01157103794766912,0.006064375680298554,0.6559546313799622
211,전개/Noun,1586,418,1168,0.0046461996754329415,0.012972876913166138,0.7364438839848676
212,매력/Noun,1586,1153,433,0.012815952693239669,0.004809294266610391,0.7269861286254728
213,무섭다/Adjective,1580,677,903,0.0075250650245648355,0.010029544394339916,0.5715189873417722
214,되어다/Verb,1577,1073,504,0.01192672787497499,0.005597885243352511,0.6804058338617628
215,가슴/Noun,1575,1376,199,0.015294666874152457,0.0022102761179110114,0.8736507936507937
216,낮다/Adjective,1560,1254,306,0.013938599026298824,0.003398716040606882,0.8038461538461539
217,말다/Verb,1559,338,1221,0.0037569748571682636,0.013561543416931382,0.7831943553559975
218,끝나다/Verb,1557,666,891,0.007402796612053442,0.009896261412355332,0.5722543352601156
219,~~/Punctuation,1556,1038,518,0.011537692016984194,0.005753382055667859,0.6670951156812339
220,야/Josa,1543,373,1170,0.00414601071515906,0.012995090743496902,0.7582631237848347
221,한국/Noun,1543,817,726,0.009081208456528022,0.008063620410067309,0.5294880103694103
222,높다/Adjective,1536,327,1209,0.0036347064446568705,0.013428260434946798,0.787109375
223,님/Suffix,1536,948,588,0.01053731409643643,0.006530866117244597,0.6171875
224,알/Noun,1535,886,649,0.009848164862281307,0.007208387942332897,0.5771986970684039
225,가장/Noun,1534,1006,528,0.011182002089678324,0.005864451207321679,0.6558018252933507
226,;;/Punctuation,1523,373,1150,0.00414601071515906,0.012772952440189262,0.7550886408404465
227,저/Noun,1522,907,615,0.010081586377075784,0.0068307528267099096,0.5959264126149802
228,슬프다/Adjective,1504,1292,212,0.014360980814974547,0.002354666015060977,0.8590425531914894
229,??/Punctuation,1503,455,1048,0.005057466153880355,0.011640047093320302,0.697272122421823
230,본/Modifier,1496,741,755,0.008236444879176578,0.008385720949863385,0.5046791443850267
231,멋지다/Adjective,1475,1271,204,0.014127559300180068,0.0022658106937379213,0.8616949152542372
232,남자/Noun,1459,711,748,0.007902985572327324,0.008307972543705711,0.5126799177518848
233,아/Josa,1457,606,851,0.006735877998354934,0.009451984805740055,0.5840768702814001
234,하지만/Conjunction,1453,772,681,0.00858101949625414,0.00756380922762512,0.5313145216792843
235,음악/Noun,1452,1077,375,0.011971189115888224,0.004165093187018238,0.7417355371900827
236,반전/Noun,1452,767,685,0.008525442945112599,0.007608236888286647,0.528236914600551
237,성/Suffix,1445,496,949,0.0055131938732410025,0.010540462491947487,0.6567474048442906
238,늘다/Verb,1443,678,765,0.007536180334793144,0.008496790101517205,0.5301455301455301
239,유치하다/Adjective,1442,282,1160,0.0031345174843829893,0.012884021591843082,0.8044382801664355
240,아이/Noun,1436,944,492,0.010492852855523198,0.005464602261367928,0.6573816155988857
241,죽다/Verb,1435,475,960,0.0052797723584465245,0.010662638558766688,0.6689895470383276
242,함/Noun,1425,758,667,0.008425405153057822,0.007408312415309772,0.5319298245614035
243,기/Modifier,1424,720,704,0.0080030233643821,0.007819268276428905,0.5056179775280899
244,솔직하다/Adjective,1420,500,920,0.005557655114154236,0.01021836195215141,0.647887323943662
245,크다/Verb,1413,727,686,0.008080830535980259,0.0076193438034520295,0.5145081387119603
246,줄/Noun,1411,605,806,0.006724762688126626,0.008952173623297865,0.5712260807937632
247,무슨/Noun,1408,215,1193,0.0023897916990863214,0.013250549792300687,0.8473011363636364
248,추천/Noun,1403,1037,366,0.011526576706755885,0.0040651309505298,0.7391304347826086
249,만/Noun,1401,947,454,0.010526198786208123,0.005042539485083413,0.6759457530335474
250,냐/Josa,1392,169,1223,0.0018784874285841318,0.013583757247262145,0.8785919540229885
251,인지/Josa,1383,425,958,0.004724006847031101,0.010640424728435923,0.6926970354302241
252,쓰다/Verb,1383,430,953,0.004779583398172643,0.010584890152609014,0.6890817064352857
253,게/Noun,1380,485,895,0.005390925460729609,0.00994068907301686,0.6485507246376812
254,눈물/Noun,1378,1156,222,0.012849298623924595,0.0024657351667147966,0.8388969521044993
255,인가/Josa,1378,446,932,0.004957428361825579,0.010351644934135993,0.6763425253991292
256,도/Noun,1374,658,716,0.007313874130226975,0.007952551258413489,0.5211062590975255
257,번/Noun,1370,945,425,0.010503968165751507,0.004720438945287336,0.6897810218978102
258,내다/Verb,1366,686,680,0.007625102816619612,0.0075527023124597375,0.5021961932650073
259,ㅠ/KoreanParticle,1361,899,462,0.009992663895249316,0.005131394806406469,0.6605437178545187
260,자체/Noun,1360,582,778,0.006469110552875531,0.00864117999866717,0.5720588235294117
261,저/Determiner,1355,471,884,0.005235311117533291,0.009818513006197658,0.6523985239852399
262,우리/Noun,1346,996,350,0.011070848987395238,0.0038874203078836885,0.7399702823179792
263,인간/Noun,1346,839,507,0.009325745281550809,0.005631205988848657,0.6233283803863299
264,네/Suffix,1337,913,424,0.010148278238445635,0.004709332030121954,0.6828721017202692
265,야하다/Adjective,1322,769,553,0.008547673565569215,0.006142124086456227,0.5816944024205749
266,'/Punctuation,1314,678,636,0.007536180334793144,0.0070639980451829305,0.5159817351598174
267,지만/Josa,1312,784,528,0.008714403218993843,0.005864451207321679,0.5975609756097561
268,속/Noun,1307,819,488,0.009103439076984639,0.005420174600706399,0.6266258607498087
269,영/Modifier,1305,619,686,0.006880377031322944,0.0076193438034520295,0.5256704980842912
270,허다/Verb,1294,206,1088,0.002289753907031545,0.01208432369993558,0.8408037094281299
271,눈/Noun,1292,674,618,0.00749171909387991,0.006864073572206055,0.521671826625387
272,원작/Noun,1275,429,846,0.004768468087944335,0.009396450229913145,0.6635294117647059
273,짜증나다/Adjective,1251,81,1170,0.0009003401284929862,0.012995090743496902,0.935251798561151
274,그래도/Adverb,1246,736,510,0.008180868328035036,0.005664526734344803,0.5906902086677368
275,살다/Verb,1239,732,507,0.008136407087121801,0.005631205988848657,0.5907990314769975
276,뭔가/Noun,1237,502,735,0.005579885734610853,0.008163582646555746,0.5941794664510913
277,코미디/Noun,1235,485,750,0.005390925460729609,0.008330186374036475,0.6072874493927125
278,찍다/Verb,1231,259,972,0.0028788653491318944,0.010795921540751272,0.7896019496344435
279,보이다/Verb,1231,504,727,0.00560211635506747,0.00807472732523269,0.5905767668562144
280,연기력/Noun,1225,680,545,0.007558410955249761,0.006053268765133172,0.5551020408163265
281,캐릭터/Noun,1225,562,663,0.006246804348309361,0.007363884754648244,0.5412244897959184
282,기대하다/Adjective,1222,341,881,0.003790320787853189,0.009785192260701512,0.720949263502455
283,돼다/Verb,1217,575,642,0.006391303381277372,0.0071306395361752225,0.5275267050123253
284,여운/Noun,1210,1139,71,0.01266033835004335,0.0007885909767421196,0.9413223140495868
285,이상/Noun,1209,637,572,0.007080452615432497,0.006353155474598485,0.5268817204301075
286,움/Noun,1204,432,772,0.00480181401862926,0.00857453850767488,0.6411960132890365
287,이네/Josa,1200,505,695,0.005613231665295778,0.007719306039940467,0.5791666666666667
288,전혀/Noun,1199,338,861,0.0037569748571682636,0.009563053957393873,0.7180984153461217
289,기대/Noun,1198,745,453,0.008280906120089812,0.005031432569918031,0.6218697829716193
290,지다/Verb,1197,523,674,0.005813307249405331,0.007486060821467445,0.5630743525480367
291,모두/Noun,1194,810,384,0.009003401284929862,0.004265055423506675,0.678391959798995
292,대박/Noun,1180,975,205,0.01083742747260076,0.002276917608903303,0.826271186440678
293,대한/Noun,1173,715,458,0.007947446813240557,0.005086967145744941,0.6095481670929241
294,공감/Noun,1172,643,529,0.007147144476802348,0.005875558122487061,0.5486348122866894
295,씨/Suffix,1170,706,464,0.007847409021185782,0.005153608636737233,0.6034188034188034
296,근데/Adverb,1165,632,533,0.007024876064290955,0.0059199857831485885,0.542489270386266
297,별/Noun,1164,304,860,0.0033790543094057756,0.009551947042228491,0.738831615120275
298,이쁘다/Adjective,1161,733,428,0.00814752239735011,0.004753759690783481,0.6313522825150732
299,계속/Noun,1161,707,454,0.00785852433141409,0.005042539485083413,0.6089577950043066
300,굿/Noun,1156,1072,84,0.011915612564746682,0.0009329808738920852,0.9273356401384083
301,아주/Noun,1152,682,470,0.007580641575706378,0.005220250127729524,0.5920138888888888
302,시리즈/Noun,1149,660,489,0.007336104750683591,0.0054312815158717815,0.5744125326370757
303,모습/Noun,1142,842,300,0.009359091212235734,0.00333207454961459,0.7373029772329247
304,별/Modifier,1142,316,826,0.0035124380321454774,0.009174311926605505,0.723292469352014
305,미치다/Adjective,1139,415,724,0.004612853744748016,0.008041406579736544,0.6356453028972783
306,개봉/Noun,1138,496,642,0.0055131938732410025,0.0071306395361752225,0.5641476274165202
307,에는/Josa,1137,526,611,0.005846653180090256,0.006786325166048382,0.5373790677220757
308,전/Noun,1126,674,452,0.00749171909387991,0.005020325654752649,0.5985790408525755
309,치다/Verb,1122,345,777,0.003834782028766423,0.008630073083501789,0.6925133689839572
310,실망/Noun,1118,115,1003,0.0012782606762554744,0.011140235910878113,0.8971377459749553
311,영상/Noun,1114,626,488,0.006958184202921104,0.005420174600706399,0.5619389587073609
312,대/Modifier,1114,550,564,0.00611342062556966,0.006264300153275429,0.5062836624775583
313,요/Noun,1099,666,433,0.007402796612053442,0.004809294266610391,0.6060054595086443
314,내내/Noun,1099,548,551,0.006091190005113043,0.006119910256125464,0.5013648771610555
315,일본/Noun,1098,391,707,0.004346086299268612,0.00785258902192505,0.6438979963570127
316,시키다/Verb,1097,384,713,0.004268279127670453,0.007919230512917342,0.649954421148587
317,보지/Noun,1094,324,770,0.003601360513971945,0.008552324677344115,0.7038391224862889
318,진심/Noun,1094,415,679,0.004612853744748016,0.007541595397294355,0.6206581352833638
319,건지다/Verb,1093,195,898,0.002167485494520152,0.009974009818513006,0.8215919487648673
320,부분/Noun,1092,565,527,0.006280150278994287,0.0058533442921562965,0.5173992673992674
321,화/Suffix,1089,474,615,0.005268657048218215,0.0068307528267099096,0.5647382920110193
322,이제/Noun,1082,522,560,0.0058021919391770226,0.0062198724926139015,0.5175600739371534
323,다른/Noun,1077,615,462,0.0068359157904097105,0.005131394806406469,0.5710306406685237
324,이랑/Josa,1077,470,607,0.005224195807304982,0.006741897505386854,0.5636025998142989
325,일/Modifier,1074,387,687,0.004301625058355379,0.007630450718617411,0.6396648044692738
326,제목/Noun,1073,405,668,0.004501700642464931,0.007419419330475154,0.6225535880708295
327,귀엽다/Adjective,1069,881,188,0.009792588311139765,0.00208810005109181,0.8241347053320861
328,이라/Josa,1066,537,529,0.0059689215926016495,0.005875558122487061,0.5037523452157598
329,몰입/Noun,1061,631,430,0.007013760754062646,0.004775973521114246,0.5947219604147032
330,(/Punctuation,1060,510,550,0.005668808216437321,0.006108803340960082,0.5188679245283019
331,대단하다/Adjective,1057,751,306,0.008347597981459662,0.003398716040606882,0.7105014191106906
332,밖에/Josa,1056,430,626,0.004779583398172643,0.0069529288935291115,0.5928030303030303
333,)/Punctuation,1054,502,552,0.005579885734610853,0.006131017171290846,0.523719165085389
334,기분/Noun,1053,521,532,0.005791076628948714,0.005908878867983206,0.5052231718898386
335,뿐/Noun,1051,311,740,0.003456861481003935,0.008219117222382655,0.7040913415794482
336,두/Determiner,1051,585,466,0.006502456483560456,0.005175822467067996,0.5566127497621313
337,무엇/Noun,1050,539,511,0.005991152213058267,0.0056756336495101855,0.5133333333333333
338,ㅎ/KoreanParticle,1048,840,208,0.009336860591779116,0.002310238354399449,0.8015267175572519
339,;/Punctuation,1045,287,758,0.0031900940355245313,0.00841904169535953,0.7253588516746412
340,표현/Noun,1042,681,361,0.007569526265478069,0.00400959637470289,0.6535508637236085
341,OO/Alpha,1033,220,813,0.002445368250227864,0.00902992202945554,0.78702807357212
342,후/Noun,1032,499,533,0.005546539803925927,0.0059199857831485885,0.5164728682170543
343,가족/Noun,1031,710,321,0.007891870262099015,0.0035653197680876113,0.6886517943743938
344,믿다/Verb,1028,528,500,0.005868883800546874,0.0055534575826909835,0.5136186770428015
345,잔잔하다/Adjective,1023,897,126,0.0099704332747927,0.0013994713108381278,0.8768328445747801
346,처럼/Josa,1023,537,486,0.0059689215926016495,0.005397960770375636,0.5249266862170088
347,요즘/Noun,1013,643,370,0.007147144476802348,0.004109558611191328,0.6347482724580454
348,감/Noun,1013,542,471,0.0060244981437431915,0.005231357042894906,0.5350444225074038
349,점도/Noun,1011,91,920,0.001011493230776071,0.01021836195215141,0.9099901088031652
350,이/Suffix,1007,511,496,0.005679923526665629,0.005509029922029456,0.5074478649453823
351,긴장감/Noun,1001,507,494,0.005635462285752396,0.0054868160916986914,0.5064935064935064
352,용/Noun,999,295,704,0.0032790165173509993,0.007819268276428905,0.7047047047047047
353,떨어지다/Verb,997,207,790,0.002300869217259854,0.008774462980651754,0.7923771313941825
354,ㅜㅜ/KoreanParticle,996,633,363,0.007035991374519263,0.004031810205033654,0.6355421686746988
355,모든/Noun,986,630,356,0.007002645443834337,0.00395406179887598,0.6389452332657201
356,4/Number,981,333,648,0.003701398306026721,0.007197281027167515,0.6605504587155964
357,이라는/Josa,981,510,471,0.005668808216437321,0.005231357042894906,0.5198776758409785
358,급/Noun,974,237,737,0.0026343285241091077,0.00818579647688651,0.7566735112936345
359,웃다/Verb,974,598,376,0.006646955516528466,0.00417620010218362,0.6139630390143738
360,위/Noun,973,445,528,0.00494631305159727,0.005864451207321679,0.5426515930113053
361,조금/Noun,967,582,385,0.006469110552875531,0.004276162338672057,0.6018614270941055
362,특히/Adverb,966,665,301,0.007391681301825134,0.003343181464779972,0.6884057971014492
363,여/Modifier,966,412,554,0.00457950781406309,0.006153231001621609,0.5734989648033126
364,빠지다/Verb,964,602,362,0.0066914167574417,0.004020703289868272,0.6244813278008299
365,대사/Noun,960,476,484,0.005290887668674833,0.005375746940044872,0.5041666666666667
366,개인/Noun,957,633,324,0.007035991374519263,0.0035986405135837573,0.6614420062695925
367,분/Noun,957,530,427,0.00589111442100349,0.0047426527756181,0.5538140020898642
368,스릴러/Noun,954,424,530,0.004712891536802792,0.005886665037652442,0.5555555555555556
369,공포/Noun,951,319,632,0.0035457839628304025,0.007019570384521403,0.6645636172450052
370,짜다/Verb,947,361,586,0.0040126269924193585,0.006508652286913832,0.6187961985216474
371,극장/Noun,938,444,494,0.0049351977413689616,0.0054868160916986914,0.5266524520255863
372,건/Noun,932,292,640,0.0032456705866660738,0.007108425705844459,0.6866952789699571
373,한테/Josa,931,317,614,0.0035235533423737856,0.006819645911544527,0.6595059076262084
374,작가/Noun,929,209,720,0.0023230998377164708,0.007996978919075016,0.77502691065662
375,이유/Noun,928,364,564,0.004045972923104284,0.006264300153275429,0.6077586206896551
376,나름/Noun,923,600,323,0.0066691861369850836,0.003587533598418375,0.6500541711809318
377,잼/Noun,923,524,399,0.005824422559633639,0.004431659150987405,0.5677139761646804
378,시작/Noun,922,432,490,0.00480181401862926,0.005442388431037164,0.5314533622559653
379,욕/Noun,910,166,744,0.0018451414978992065,0.008263544883044184,0.8175824175824176
380,차라리/Noun,909,59,850,0.0006558033034701999,0.009440877890574672,0.935093509350935
381,이상하다/Adjective,909,232,677,0.0025787519729675657,0.007519381566963592,0.7447744774477447
382,노래/Noun,909,604,305,0.006713647377898317,0.0033876091254415,0.6644664466446645
383,깊다/Adjective,907,808,99,0.008981170664473246,0.0010995846013728146,0.8908489525909592
384,제대로/Noun,907,366,541,0.0040682035435609006,0.006008841104471644,0.5964718853362734
385,짱/Noun,905,842,63,0.009359091212235734,0.0006997356554190639,0.9303867403314917
386,중간/Noun,905,328,577,0.0036458217548851787,0.006408690050425395,0.6375690607734806
387,울다/Verb,900,695,205,0.007725140608674388,0.002276917608903303,0.7722222222222223
388,알바/Noun,897,104,793,0.001155992263744081,0.0088077837261479,0.8840579710144928
389,-/Punctuation,894,421,473,0.004679545606117867,0.0052535708732256705,0.529082774049217
390,0/Number,888,77,811,0.0008558788875797523,0.009007708199124775,0.9132882882882883
391,애니/Noun,888,446,442,0.004957428361825579,0.004909256503098829,0.5022522522522522
392,따뜻하다/Adjective,884,833,51,0.009259053420180957,0.0005664526734344803,0.9423076923076923
393,느껴지다/Verb,884,553,331,0.0061467665562545855,0.003676388919741431,0.6255656108597285
394,삶/Noun,883,770,113,0.008558788875797524,0.0012550814136881622,0.8720271800679502
395,에도/Josa,881,473,408,0.005257541737989907,0.004531621387475843,0.5368898978433598
396,",,/Punctuation",879,413,466,0.004590623124291399,0.005175822467067996,0.5301478953356087
397,...../Punctuation,877,327,550,0.0036347064446568705,0.006108803340960082,0.6271379703534777
398,제/Noun,874,553,321,0.0061467665562545855,0.0035653197680876113,0.6327231121281465
399,오랜/Modifier,870,699,171,0.007769601849587622,0.0018992824932803163,0.803448275862069
400,기/Noun,869,240,629,0.0026676744547940332,0.006986249639025257,0.7238204833141542
401,예쁘다/Adjective,865,571,294,0.006346842140364138,0.0032654330586222983,0.6601156069364161
402,제일/Noun,865,507,358,0.005635462285752396,0.0039762756292067445,0.5861271676300578
403,당시/Noun,862,550,312,0.00611342062556966,0.0034653575315991736,0.6380510440835266
404,빼다/Verb,861,250,611,0.002778827557077118,0.006786325166048382,0.7096399535423926
405,점수/Noun,857,271,586,0.0030122490718715957,0.006508652286913832,0.6837806301050176
406,해보다/Verb,855,496,359,0.0055131938732410025,0.003987382544372126,0.5801169590643275
407,의미/Noun,854,412,442,0.00457950781406309,0.004909256503098829,0.5175644028103045
408,영화로/Noun,847,377,470,0.004190471956072294,0.005220250127729524,0.5548996458087367
409,놈/Noun,846,250,596,0.002778827557077118,0.006619721438567652,0.7044917257683215
410,아직도/Adverb,841,631,210,0.007013760754062646,0.002332452184730213,0.7502972651605232
411,어설프다/Adjective,834,79,755,0.0008781095080363693,0.008385720949863385,0.9052757793764988
412,막장/Noun,834,144,690,0.00160060467287642,0.007663771464113557,0.8273381294964028
413,력/Suffix,830,347,483,0.00385701264922304,0.00536464002487949,0.5819277108433735
414,연/Modifier,829,393,436,0.00436831691972523,0.004842615012106538,0.525934861278649
415,친구/Noun,827,432,395,0.00480181401862926,0.004387231490325877,0.5223700120918985
416,훌륭하다/Adjective,825,663,162,0.007369450681368517,0.0017993202567918786,0.8036363636363636
417,세상/Noun,824,533,291,0.005924460351688416,0.0032321123131261523,0.6468446601941747
418,이지/Josa,815,332,483,0.003690282995798413,0.00536464002487949,0.592638036809816
419,이라고/Josa,815,342,473,0.0038014360980814974,0.0052535708732256705,0.5803680981595092
420,공포영화/Noun,809,293,516,0.0032567858968943824,0.0057311682253370945,0.6378244746600742
421,위해/Noun,809,386,423,0.00429050974812707,0.004698225114956572,0.522867737948084
422,도대체/Noun,805,101,704,0.0011226463330591557,0.007819268276428905,0.8745341614906832
423,웃음/Noun,805,380,425,0.004223817886757219,0.004720438945287336,0.5279503105590062
424,힘들다/Adjective,799,310,489,0.0034457461707756262,0.0054312815158717815,0.6120150187734669
425,앞/Noun,797,485,312,0.005390925460729609,0.0034653575315991736,0.6085319949811794
426,생각나다/Verb,795,647,148,0.007191605717715582,0.001643823444476531,0.8138364779874214
427,류/Noun,790,141,649,0.0015672587421914947,0.007208387942332897,0.8215189873417722
428,로/Noun,790,335,455,0.003723628926483338,0.005053646400248795,0.5759493670886076
429,7/Number,790,388,402,0.004312740368583687,0.004464979896483551,0.5088607594936709
430,의/Noun,788,444,344,0.0049351977413689616,0.0038207788168913965,0.5634517766497462
431,절대/Noun,787,263,524,0.002923326590045128,0.005820023546660151,0.6658195679796697
432,그리다/Verb,785,442,343,0.004912967120912345,0.0038096719017260148,0.5630573248407643
433,뭘/Noun,782,175,607,0.0019451792899539827,0.006741897505386854,0.7762148337595908
434,잇다/Verb,780,524,256,0.005824422559633639,0.0028433702823377834,0.6717948717948717
435,우리나라/Noun,778,423,355,0.0047017762265744835,0.003942954883710598,0.5437017994858612
436,다르다/Adjective,778,400,378,0.004446124091323389,0.004198413932514383,0.5141388174807198
437,물/Noun,777,295,482,0.0032790165173509993,0.005353533109714108,0.6203346203346203
438,제/Modifier,775,314,461,0.00349020741168886,0.005120287891241086,0.5948387096774194
439,미국/Noun,774,361,413,0.0040126269924193585,0.0045871559633027525,0.5335917312661499
440,써다/Verb,768,243,525,0.002701020385478959,0.005831130461825532,0.68359375
441,수작/Noun,766,696,70,0.007736255918902696,0.0007774840615767377,0.9086161879895561
442,엄청/Adverb,766,465,301,0.00516861925616344,0.003343181464779972,0.6070496083550914
443,걍/Adverb,765,208,557,0.002311984527488162,0.006186551747117756,0.7281045751633987
444,설정/Noun,762,139,623,0.0015450281217348775,0.006919608148032965,0.8175853018372703
445,초반/Noun,761,265,496,0.002945557210501745,0.005509029922029456,0.6517739816031537
446,찾다/Verb,758,431,327,0.004790698708400951,0.0036319612590799033,0.5686015831134564
447,5/Number,758,346,412,0.003845897338994731,0.00457604904813737,0.5435356200527705
448,놓다/Verb,755,225,530,0.0025009448013694063,0.005886665037652442,0.7019867549668874
449,필요없다/Adjective,754,630,124,0.007002645443834337,0.001377257480507364,0.8355437665782494
450,일/Noun,751,400,351,0.004446124091323389,0.0038985272230490703,0.5326231691078562
451,신선하다/Adjective,748,507,241,0.005635462285752396,0.002676766554857054,0.6778074866310161
452,싫다/Adjective,746,130,616,0.0014449903296801013,0.006841859741875292,0.8257372654155496
453,시나리오/Noun,742,207,535,0.002300869217259854,0.005942199613479352,0.7210242587601078
454,딱/Adverb,742,251,491,0.0027899428673054264,0.005453495346202546,0.6617250673854448
455,이란/Josa,742,435,307,0.004835159949314186,0.0034098229557722637,0.5862533692722371
456,사실/Noun,742,429,313,0.004768468087944335,0.0034764644467645558,0.578167115902965
457,해/Noun,741,351,390,0.0039014738901362736,0.004331696914498967,0.5263157894736842
458,출연/Noun,740,226,514,0.0025120601115977146,0.005708954395006331,0.6945945945945946
459,남/Noun,740,366,374,0.0040682035435609006,0.0041539862718528555,0.5054054054054054
460,대다/Verb,739,359,380,0.003990396371962741,0.0042206277628451475,0.5142083897158322
461,멋있다/Adjective,732,615,117,0.0068359157904097105,0.0012995090743496902,0.8401639344262295
462,관객/Noun,732,188,544,0.0020896783229219927,0.00604216184996779,0.7431693989071039
463,한국영/Noun,731,295,436,0.0032790165173509993,0.004842615012106538,0.5964432284541724
464,이야/Josa,730,298,432,0.003312362448035925,0.00479818735144501,0.5917808219178082
465,가지/Noun,725,278,447,0.003090056243469755,0.004964791078925739,0.616551724137931
466,노잼/Noun,724,17,707,0.00018896027388124403,0.00785258902192505,0.9765193370165746
467,"""/Punctuation",724,358,366,0.003979281061734433,0.0040651309505298,0.505524861878453
468,뭔/Modifier,722,104,618,0.001155992263744081,0.006864073572206055,0.8559556786703602
469,분위기/Noun,721,443,278,0.004924082431140653,0.003087722415976187,0.6144244105409153
470,답답하다/Adjective,719,131,588,0.0014561056399084098,0.006530866117244597,0.8178025034770514
471,아프다/Adjective,719,559,160,0.006213458417624436,0.0017771064264611148,0.7774687065368567
472,시대/Noun,719,474,245,0.005268657048218215,0.002721194215518582,0.6592489568845619
473,봄/Noun,718,398,320,0.004423893470866772,0.0035542128529222295,0.5543175487465181
474,장난/Noun,714,182,532,0.002022986461552142,0.005908878867983206,0.7450980392156863
475,죽이다/Verb,713,198,515,0.0022008314252050776,0.005720061310171713,0.7223001402524544
476,기다/Verb,712,351,361,0.0039014738901362736,0.00400959637470289,0.5070224719101124
477,최고다/Noun,711,679,32,0.007547295645021453,0.0003554212852922229,0.9549929676511955
478,스럽다/Adjective,711,238,473,0.0026454438343374164,0.0052535708732256705,0.6652601969057665
479,명/Noun,711,303,408,0.003367938999177467,0.004531621387475843,0.5738396624472574
480,OOO/Alpha,708,91,617,0.001011493230776071,0.006852966657040674,0.8714689265536724
481,결국/Adverb,708,253,455,0.0028121734877620433,0.005053646400248795,0.6426553672316384
482,지루함/Noun,707,100,607,0.0011115310228308473,0.006741897505386854,0.8585572842998586
483,추억/Noun,707,576,131,0.00640241869150568,0.0014550058866650377,0.8147100424328148
484,나쁘다/Adjective,707,269,438,0.002990018451414979,0.004864828842437301,0.6195190947666195
485,대/Suffix,707,376,331,0.0041793566458439855,0.003676388919741431,0.5318246110325319
486,소리/Noun,705,202,503,0.0022452926661183114,0.005586778328187129,0.7134751773049646
487,니/Josa,705,294,411,0.0032679012071226907,0.004564942132971988,0.5829787234042553
488,따다/Verb,704,382,322,0.0042460485072138366,0.0035764266832529934,0.5426136363636364
489,이딴/Modifier,703,26,677,0.00028899806593602026,0.007519381566963592,0.9630156472261735
490,더럽다/Adjective,701,81,620,0.0009003401284929862,0.0068862874025368195,0.884450784593438
491,준/Noun,699,391,308,0.004346086299268612,0.003420929870937646,0.5593705293276109
492,영화관/Noun,695,298,397,0.003312362448035925,0.004409445320656641,0.5712230215827339
493,마다/Josa,694,480,214,0.0053353489095880665,0.0023768798453917407,0.69164265129683
494,살/Noun,690,420,270,0.004668430295889558,0.002998867094653131,0.6086956521739131
495,인상/Noun,689,547,142,0.006080074694884734,0.0015771819534842392,0.7939042089985486
496,이지만/Josa,687,427,260,0.004746237467487717,0.0028877979429993116,0.6215429403202329
497,어이없다/Adjective,686,55,631,0.000611342062556966,0.007008463469356021,0.9198250728862973
498,오늘/Noun,685,462,223,0.005135273325478514,0.002476842081880179,0.6744525547445256
499,감정/Noun,684,445,239,0.00494631305159727,0.0026545527245262902,0.6505847953216374
500,서다/Verb,684,373,311,0.00414601071515906,0.003454250616433792,0.5453216374269005
501,부족하다/Adjective,681,215,466,0.0023897916990863214,0.005175822467067996,0.684287812041116
502,안타깝다/Adjective,681,384,297,0.004268279127670453,0.0032987538041184443,0.5638766519823789
503,전/Modifier,680,199,481,0.002211946735433386,0.005342426194548726,0.7073529411764706
504,정신/Noun,678,183,495,0.0020341017717804503,0.005497923006864074,0.7300884955752213
505,엔딩/Noun,678,431,247,0.004790698708400951,0.0027434080458493457,0.6356932153392331
506,라면/Noun,678,389,289,0.004323855678811996,0.0032098984827953884,0.5737463126843658
507,접/Noun,676,122,554,0.0013560678478536335,0.006153231001621609,0.8195266272189349
508,팬/Noun,676,366,310,0.0040682035435609006,0.0034431437012684097,0.5414201183431953
509,잊다/Verb,674,570,104,0.006335726830135829,0.0011551191771997245,0.8456973293768546
510,졸작/Noun,672,34,638,0.00037792054776248805,0.007086211875513695,0.9494047619047619
511,제발/Noun,671,179,492,0.0019896405308672165,0.005464602261367928,0.7332339791356185
512,자신/Noun,671,422,249,0.004690660916346175,0.0027656218761801096,0.6289120715350224
513,니까/Josa,668,282,386,0.0031345174843829893,0.00428726925383744,0.5778443113772455
514,아무리/Adverb,666,114,552,0.0012671453660271657,0.006131017171290846,0.8288288288288288
515,그저/Adverb,666,221,445,0.0024564835604561725,0.004942577248594975,0.6681681681681682
516,코믹/Noun,662,371,291,0.0041237800947024434,0.0032321123131261523,0.5604229607250756
517,♥/Foreign,660,651,9,0.007236066958628815,9.99622364884377e-05,0.9863636363636363
518,평가/Noun,660,352,308,0.003912589200364582,0.003420929870937646,0.5333333333333333
519,킬링타임/Noun,659,186,473,0.002067447702465376,0.0052535708732256705,0.7177541729893778
520,~~~/Punctuation,657,400,257,0.004446124091323389,0.0028544771975031655,0.60882800608828
521,함께/Adverb,656,544,112,0.006046728764199809,0.0012439744985227803,0.8292682926829268
522,그렇게/Adverb,656,251,405,0.0027899428673054264,0.004498300641979696,0.6173780487804879
523,음/Noun,654,290,364,0.003223439966209457,0.004042917120199036,0.5565749235474006
524,배우다/Verb,654,334,320,0.00371251361625503,0.0035542128529222295,0.5107033639143731
525,캐스팅/Noun,653,219,434,0.0024342529399995552,0.0048204011817757735,0.664624808575804
526,8/Number,653,388,265,0.004312740368583687,0.002943332518826221,0.5941807044410413
527,대해/Noun,651,506,145,0.0056243469755240865,0.0016105026989803853,0.7772657450076805
528,얼마나/Noun,649,330,319,0.0036680523753417956,0.0035431059377568474,0.5084745762711864
529,어색하다/Adjective,642,123,519,0.001367183158081942,0.005764488970833241,0.8084112149532711
530,포스터/Noun,642,205,437,0.002278638596803237,0.00485372192727192,0.6806853582554517
531,적다/Verb,641,432,209,0.00480181401862926,0.0023213452695648312,0.6739469578783152
532,몰입도/Noun,638,412,226,0.00457950781406309,0.0025101628273763244,0.64576802507837
533,뒤/Noun,637,294,343,0.0032679012071226907,0.0038096719017260148,0.5384615384615384
534,엉/Exclamation,636,103,533,0.0011448769535157726,0.0059199857831485885,0.8380503144654088
535,쓸다/Verb,636,162,474,0.0018006802569859725,0.005264677788391053,0.7452830188679245
536,자/Suffix,632,213,419,0.0023675610786297045,0.004653797454295044,0.6629746835443038
537,갈수록/Noun,631,192,439,0.0021341395638352265,0.004875935757602683,0.6957210776545166
538,스릴/Noun,631,370,261,0.004112664784474134,0.0028989048581646933,0.5863708399366085
539,개연/Noun,630,55,575,0.000611342062556966,0.006386476220094631,0.9126984126984127
540,망하다/Adjective,630,89,541,0.000989262610319454,0.006008841104471644,0.8587301587301587
541,애니메이션/Noun,630,418,212,0.0046461996754329415,0.002354666015060977,0.6634920634920635
542,시/Modifier,626,284,342,0.003156748104839606,0.0037985649865606326,0.5463258785942492
543,배경/Noun,625,369,256,0.004101549474245826,0.0028433702823377834,0.5904
544,데/Noun,624,271,353,0.0030122490718715957,0.0039207410533798346,0.5657051282051282
545,든/Josa,623,361,262,0.0040126269924193585,0.0029100117733300754,0.579454253611557
546,!!!!/Punctuation,622,460,162,0.005113042705021898,0.0017993202567918786,0.7395498392282959
547,엄마/Noun,622,344,278,0.0038236667185381143,0.003087722415976187,0.5530546623794212
548,티비/Noun,621,299,322,0.003323477758264233,0.0035764266832529934,0.5185185185185185
549,문제/Noun,619,201,418,0.0022341773558900027,0.0046426905391296625,0.6752827140549273
550,진부하다/Adjective,618,109,509,0.0012115688148856235,0.005653419819179421,0.8236245954692557
551,살리다/Verb,618,260,358,0.0028899806593602026,0.0039762756292067445,0.5792880258899676
552,이름/Noun,617,239,378,0.002656559144565725,0.004198413932514383,0.6126418152350082
553,지/Modifier,617,246,371,0.002734366316163884,0.00412066552635671,0.6012965964343598
554,하/Exclamation,614,213,401,0.0023675610786297045,0.004453872981318168,0.6530944625407166
555,ㅠㅠㅠ/KoreanParticle,611,496,115,0.0055131938732410025,0.0012772952440189263,0.8117839607201309
556,두다/Verb,611,285,326,0.0031678634150679144,0.003620854343914521,0.5335515548281505
557,나가다/Verb,610,191,419,0.0021230242536069183,0.004653797454295044,0.6868852459016394
558,충격/Noun,610,399,211,0.00443500878109508,0.002343559099895595,0.6540983606557377
559,비다/Verb,610,253,357,0.0028121734877620433,0.003965168714041362,0.5852459016393443
560,맘/Noun,609,373,236,0.00414601071515906,0.002621231979030144,0.6124794745484401
561,구성/Noun,605,285,320,0.0031678634150679144,0.0035542128529222295,0.5289256198347108
562,유쾌하다/Adjective,603,554,49,0.006157881866482894,0.0005442388431037163,0.9187396351575456
563,머리/Noun,603,235,368,0.002612097903652491,0.004087344780860563,0.6102819237147595
564,옛날/Noun,602,317,285,0.0035235533423737856,0.0031654708221338606,0.526578073089701
565,보단/Josa,600,239,361,0.002656559144565725,0.00400959637470289,0.6016666666666667
566,완벽하다/Adjective,599,512,87,0.005691038836893938,0.0009663016193882312,0.8547579298831386
567,질/Noun,599,104,495,0.001155992263744081,0.005497923006864074,0.8263772954924875
568,여/Josa,598,263,335,0.002923326590045128,0.003720816580402959,0.560200668896321
569,를/Noun,597,280,317,0.003112286863926372,0.0035208921074260835,0.5309882747068677
570,영화인/Noun,596,336,260,0.0037347442367116467,0.0028877979429993116,0.5637583892617449
571,이후/Noun,596,301,295,0.00334570837872085,0.00327653997378768,0.5050335570469798
572,만화/Noun,595,266,329,0.0029566725207300537,0.003654175089410667,0.5529411764705883
573,그래서/Adverb,595,288,307,0.00320120934575284,0.0034098229557722637,0.5159663865546219
574,놀라다/Verb,594,366,228,0.0040682035435609006,0.0025323766577070883,0.6161616161616161
575,적/Noun,593,406,187,0.004512815952693239,0.0020769931359264277,0.684654300168634
576,예술/Noun,593,258,335,0.0028677500389035857,0.003720816580402959,0.5649241146711635
577,기도/Noun,591,342,249,0.0038014360980814974,0.0027656218761801096,0.5786802030456852
578,강추/Noun,590,547,43,0.006080074694884734,0.00047759735211142456,0.9271186440677966
579,행복하다/Adjective,590,524,66,0.005824422559633639,0.0007330564009152098,0.888135593220339
580,얘기/Noun,590,217,373,0.0024120223195429383,0.004142879356687473,0.6322033898305085
581,대/Foreign,587,217,370,0.0024120223195429383,0.004109558611191328,0.6303236797274276
582,후회/Noun,587,289,298,0.0032123246559811486,0.003309860719283826,0.5076660988074957
583,장르/Noun,583,201,382,0.0022341773558900027,0.004242841593175911,0.6552315608919382
584,집/Noun,583,280,303,0.003112286863926372,0.003365395295110736,0.5197255574614065
585,더빙/Noun,582,150,432,0.0016672965342462709,0.00479818735144501,0.7422680412371134
586,어울리다/Verb,581,319,262,0.0035457839628304025,0.0029100117733300754,0.5490533562822719
587,만/Suffix,580,315,265,0.0035013227219171687,0.002943332518826221,0.5431034482758621
588,어디/Noun,579,237,342,0.0026343285241091077,0.0037985649865606326,0.5906735751295337
589,주연/Noun,577,225,352,0.0025009448013694063,0.003909634138214452,0.610051993067591
590,얼굴/Noun,576,199,377,0.002211946735433386,0.004187307017349001,0.6545138888888888
591,은/Noun,576,256,320,0.002845519418446969,0.0035542128529222295,0.5555555555555556
592,후반/Noun,574,266,308,0.0029566725207300537,0.003420929870937646,0.5365853658536586
593,즐겁다/Adjective,573,495,78,0.005502078563012693,0.0008663393828997934,0.8638743455497382
594,들이다/Verb,573,233,340,0.002589867283195874,0.0037763511562298687,0.5933682373472949
595,같이/Adverb,572,327,245,0.0036347064446568705,0.002721194215518582,0.5716783216783217
596,웃기/Noun,571,344,227,0.0038236667185381143,0.0025212697425417065,0.6024518388791593
597,머/Noun,570,97,473,0.0010781850921459217,0.0052535708732256705,0.8298245614035088
598,집중/Noun,568,252,316,0.002801058177533735,0.0035097851922607014,0.5563380281690141
599,비/Noun,563,225,338,0.0025009448013694063,0.003754137325899105,0.6003552397868561
600,여기/Noun,563,228,335,0.0025342907320543315,0.003720816580402959,0.5950266429840142
601,꽤/Noun,562,441,121,0.004901851810684036,0.001343936735011218,0.7846975088967971
602,그것/Noun,559,278,281,0.003090056243469755,0.0031210431614723325,0.5026833631484794
603,짜증/Noun,558,23,535,0.00025565213525109487,0.005942199613479352,0.9587813620071685
604,9/Number,557,382,175,0.0042460485072138366,0.0019437101539418443,0.6858168761220825
605,매우/Noun,557,343,214,0.003812551408309806,0.0023768798453917407,0.6157989228007181
606,ㅡ/KoreanParticle,556,157,399,0.00174510370584443,0.004431659150987405,0.7176258992805755
607,날/Noun,556,337,219,0.003745859546939955,0.0024324144212186506,0.6061151079136691
608,ㅎㅎㅎ/KoreanParticle,555,434,121,0.004824044639085877,0.001343936735011218,0.781981981981982
609,읽다/Verb,555,242,313,0.00268990507525065,0.0034764644467645558,0.563963963963964
610,너무나/Adverb,552,365,187,0.004057088233332592,0.0020769931359264277,0.6612318840579711
611,이리/Adverb,552,199,353,0.002211946735433386,0.0039207410533798346,0.6394927536231884
612,진/Noun,552,216,336,0.00240090700931463,0.003731923495568341,0.6086956521739131
613,누구/Noun,552,311,241,0.003456861481003935,0.002676766554857054,0.5634057971014492
614,???/Punctuation,551,142,409,0.001578374052419803,0.004542728302641225,0.7422867513611615
615,두/Noun,551,362,189,0.004023742302647667,0.0020992069662571916,0.6569872958257713
616,다운/Noun,551,275,276,0.00305671031278483,0.003065508585645423,0.5009074410163339
617,새롭다/Adjective,549,377,172,0.004190471956072294,0.0019103894084456982,0.6867030965391621
618,전쟁/Noun,549,326,223,0.003623591134428562,0.002476842081880179,0.5938069216757741
619,건가/Noun,546,124,422,0.0013782984683102506,0.00468711819979119,0.7728937728937729
620,아직/Adverb,546,363,183,0.004034857612875975,0.0020325654752649,0.6648351648351648
621,생기다/Verb,545,190,355,0.0021119089433786096,0.003942954883710598,0.6513761467889908
622,상황/Noun,545,243,302,0.002701020385478959,0.003354288379945354,0.5541284403669725
623,언제/Noun,545,290,255,0.003223439966209457,0.0028322633671724017,0.5321100917431193
624,멀다/Adjective,544,178,366,0.001978525220638908,0.0040651309505298,0.6727941176470589
625,작/Modifier,544,183,361,0.0020341017717804503,0.00400959637470289,0.6636029411764706
626,소름/Noun,540,437,103,0.004857390569770802,0.0011440122620343426,0.8092592592592592
627,심하다/Adjective,539,81,458,0.0009003401284929862,0.005086967145744941,0.849721706864564
628,충분하다/Adjective,539,414,125,0.004601738434519708,0.0013883643956727459,0.7680890538033395
629,불쌍하다/Adjective,539,206,333,0.002289753907031545,0.003698602750072195,0.6178107606679035
630,글/Noun,538,195,343,0.002167485494520152,0.0038096719017260148,0.637546468401487
631,식/Suffix,534,210,324,0.002334215147944779,0.0035986405135837573,0.6067415730337079
632,걸작/Noun,533,459,74,0.0051019273947935885,0.0008219117222382655,0.8611632270168855
633,그나마/Adverb,532,40,492,0.0004446124091323389,0.005464602261367928,0.924812030075188
634,억지/Noun,527,72,455,0.00080030233643821,0.005053646400248795,0.8633776091081594
635,대체/Noun,527,89,438,0.000989262610319454,0.004864828842437301,0.8311195445920304
636,다큐/Noun,527,223,304,0.0024787141809127894,0.003376502210276118,0.5768500948766604
637,비슷하다/Adjective,527,264,263,0.002934441900273437,0.002921118688495457,0.5009487666034156
638,시절/Noun,526,397,129,0.0044127781606384635,0.0014327920563342736,0.7547528517110266
639,등/Noun,526,266,260,0.0029566725207300537,0.0028877979429993116,0.5057034220532319
640,존나/Noun,525,122,403,0.0013560678478536335,0.004476086811648933,0.7676190476190476
641,약간/Noun,525,357,168,0.003968165751506125,0.0018659617477841705,0.68
642,역사/Noun,525,318,207,0.0035346686526020943,0.002299131439234067,0.6057142857142858
643,궁금하다/Adjective,524,199,325,0.002211946735433386,0.003609747428749139,0.6202290076335878
644,분들/Suffix,524,307,217,0.003412400240090701,0.0024102005908878867,0.5858778625954199
645,밉다/Adjective,524,257,267,0.0028566347286752775,0.0029655463491569853,0.5095419847328244
646,실화/Noun,522,331,191,0.0036791676855701043,0.0021214207965879555,0.6340996168582376
647,인물/Noun,521,236,285,0.0026232132138807995,0.0031654708221338606,0.5470249520153551
648,예전/Noun,521,277,244,0.003078940933241447,0.0027100873003531997,0.5316698656429942
649,훨씬/Adverb,521,249,272,0.0027677122468488095,0.003021080924983895,0.5220729366602687
650,해도/Noun,520,170,350,0.0018896027388124403,0.0038874203078836885,0.6730769230769231
651,아무/Modifier,518,169,349,0.0018784874285841318,0.0038763133927183064,0.6737451737451737
652,극/Modifier,518,220,298,0.002445368250227864,0.003309860719283826,0.5752895752895753
653,씬/Noun,515,279,236,0.0031011715536980638,0.002621231979030144,0.541747572815534
654,B/Alpha,514,133,381,0.0014783362603650269,0.00423173467801053,0.7412451361867705
655,한마디/Noun,514,156,358,0.0017339883956161216,0.0039762756292067445,0.6964980544747081
656,6/Number,513,237,276,0.0026343285241091077,0.003065508585645423,0.5380116959064327
657,그대로/Noun,512,274,238,0.0030455950025565213,0.002643445809360908,0.53515625
658,어렵다/Adjective,511,267,244,0.002967787830958362,0.0027100873003531997,0.5225048923679061
659,순수하다/Adjective,506,433,73,0.004812929328857568,0.0008108048070728836,0.8557312252964426
660,휴/Exclamation,506,86,420,0.0009559166796345286,0.004664904369460426,0.8300395256916996
661,자기/Noun,506,160,346,0.0017784496365293556,0.0038429926472221604,0.6837944664031621
662,누가/Noun,504,180,324,0.002000755841095525,0.0035986405135837573,0.6428571428571429
663,급/Suffix,504,211,293,0.0023453304581730876,0.003254326143456916,0.5813492063492064
664,비교/Noun,504,220,284,0.002445368250227864,0.0031543639069684785,0.5634920634920635
665,상당하다/Adjective,503,306,197,0.0034012849298623925,0.0021880622875802475,0.6083499005964215
666,작/Noun,503,224,279,0.0024898294911410977,0.0030988293311415686,0.5546719681908548
667,",,,/Punctuation",503,232,271,0.0025787519729675657,0.003009974009818513,0.5387673956262425
668,보/Noun,502,287,215,0.0031900940355245313,0.002387986760557123,0.5717131474103586
669,니/Noun,502,220,282,0.002445368250227864,0.0031321500766377146,0.5617529880478087
670,만점/Noun,501,423,78,0.0047017762265744835,0.0008663393828997934,0.844311377245509
671,초딩/Noun,501,192,309,0.0021341395638352265,0.0034320367861030276,0.6167664670658682
672,주/Modifier,501,217,284,0.0024120223195429383,0.0031543639069684785,0.5668662674650699
673,비디오/Noun,500,226,274,0.0025120601115977146,0.003043294755314659,0.548
674,책/Noun,499,238,261,0.0026454438343374164,0.0028989048581646933,0.5230460921843687
675,간만/Noun,496,400,96,0.004446124091323389,0.0010662638558766688,0.8064516129032258
676,쉬다/Verb,496,257,239,0.0028566347286752775,0.0026545527245262902,0.5181451612903226
677,몇/Modifier,495,218,277,0.002423137629771247,0.0030766155008108047,0.5595959595959596
678,드리다/Verb,495,270,225,0.0030011337616432875,0.0024990559122109427,0.5454545454545454
679,필요하다/Adjective,494,325,169,0.0036124758242002536,0.0018770686629495524,0.6578947368421053
680,부/Noun,494,227,267,0.0025231754218260232,0.0029655463491569853,0.5404858299595142
681,만나다/Verb,491,299,192,0.003323477758264233,0.0021325277117533376,0.6089613034623218
682,자/Noun,489,199,290,0.002211946735433386,0.0032210053979607705,0.5930470347648262
683,라도/Josa,488,145,343,0.0016117199831047284,0.0038096719017260148,0.7028688524590164
684,~!/Punctuation,487,385,102,0.004279394437898762,0.0011329053468689607,0.7905544147843943
685,CG/Alpha,487,126,361,0.0014005290887668675,0.00400959637470289,0.7412731006160165
686,굉장하다/Adjective,486,338,148,0.0037569748571682636,0.001643823444476531,0.6954732510288066
687,전체/Noun,486,158,328,0.0017562190160727387,0.003643068174245285,0.6748971193415638
688,로맨스/Noun,486,243,243,0.002701020385478959,0.002698980385187818,0.5
689,떠나다/Verb,484,271,213,0.0030122490718715957,0.002365772930226359,0.5599173553719008
690,뿐/Suffix,482,150,332,0.0016672965342462709,0.003687495834906813,0.6887966804979253
691,감성/Noun,482,311,171,0.003456861481003935,0.0018992824932803163,0.6452282157676349
692,다음/Noun,482,299,183,0.003323477758264233,0.0020325654752649,0.6203319502074689
693,사회/Noun,481,337,144,0.003745859546939955,0.0015993957838150031,0.7006237006237006
694,오/Modifier,481,187,294,0.0020785630126936845,0.0032654330586222983,0.6112266112266113
695,네이버/Noun,480,179,301,0.0019896405308672165,0.003343181464779972,0.6270833333333333
696,아들/Noun,480,261,219,0.0029010959695885113,0.0024324144212186506,0.54375
697,발연기/Noun,477,34,443,0.00037792054776248805,0.004920363418264211,0.9287211740041929
698,무슨/Modifier,476,124,352,0.0013782984683102506,0.003909634138214452,0.7394957983193278
699,그런/Modifier,475,189,286,0.0021007936331503014,0.0031765777372992424,0.6021052631578947
700,ㅜ/KoreanParticle,474,275,199,0.00305671031278483,0.0022102761179110114,0.580168776371308
701,당하다/Adjective,473,184,289,0.002045217082008759,0.0032098984827953884,0.6109936575052854
702,네/Determiner,472,250,222,0.002778827557077118,0.0024657351667147966,0.5296610169491526
703,남기다/Verb,471,253,218,0.0028121734877620433,0.002421307506053269,0.5371549893842887
704,따르다/Verb,470,174,296,0.001934063979725674,0.003287646888953062,0.6297872340425532
705,바로/Noun,469,253,216,0.0028121734877620433,0.002399093675722505,0.5394456289978679
706,판/Noun,468,203,265,0.0022564079763466196,0.002943332518826221,0.5662393162393162
707,ㅉㅉ/KoreanParticle,466,72,394,0.00080030233643821,0.004376124575160495,0.8454935622317596
708,이르다/Verb,466,177,289,0.0019674099104105996,0.0032098984827953884,0.6201716738197425
709,여배우/Noun,466,198,268,0.0022008314252050776,0.002976653264322367,0.575107296137339
710,꿈/Noun,465,353,112,0.003923704510592891,0.0012439744985227803,0.7591397849462366
711,돌리다/Verb,463,161,302,0.001789564946757664,0.003354288379945354,0.652267818574514
712,주제/Noun,463,191,272,0.0021230242536069183,0.003021080924983895,0.5874730021598272
713,혼자/Noun,462,213,249,0.0023675610786297045,0.0027656218761801096,0.538961038961039
714,에요/Josa,461,357,104,0.003968165751506125,0.0011551191771997245,0.7744034707158352
715,나이/Noun,460,314,146,0.00349020741168886,0.0016216096141457672,0.6826086956521739
716,반/Modifier,460,206,254,0.002289753907031545,0.0028211564520070195,0.5521739130434783
717,보다는/Josa,459,233,226,0.002589867283195874,0.0025101628273763244,0.5076252723311547
718,이/Foreign,458,326,132,0.003623591134428562,0.0014661128018304197,0.7117903930131004
719,터지다/Verb,458,267,191,0.002967787830958362,0.0021214207965879555,0.5829694323144105
720,코/Noun,458,203,255,0.0022564079763466196,0.0028322633671724017,0.5567685589519651
721,화려하다/Adjective,458,251,207,0.0027899428673054264,0.002299131439234067,0.5480349344978166
722,;;;/Punctuation,457,106,351,0.001178222884200698,0.0038985272230490703,0.7680525164113785
723,사랑스럽다/Adjective,456,433,23,0.004812929328857568,0.0002554590488037852,0.9495614035087719
724,돋다/Verb,454,348,106,0.003868127959451348,0.0011773330075304884,0.7665198237885462
725,교훈/Noun,454,274,180,0.0030455950025565213,0.001999244729768754,0.6035242290748899
726,엄청나다/Adjective,453,290,163,0.003223439966209457,0.0018104271719572606,0.6401766004415012
727,편이/Noun,450,237,213,0.0026343285241091077,0.002365772930226359,0.5266666666666666
728,소설/Noun,449,173,276,0.0019229486694973656,0.003065508585645423,0.6146993318485523
729,죠/Josa,448,250,198,0.002778827557077118,0.0021991692027456293,0.5580357142857143
730,이라도/Josa,446,106,340,0.001178222884200698,0.0037763511562298687,0.7623318385650224
731,잔인하다/Adjective,446,190,256,0.0021119089433786096,0.0028433702823377834,0.5739910313901345
732,감사하다/Verb,445,404,41,0.004490585332236623,0.00045538352178066063,0.9078651685393259
733,바라다/Verb,444,271,173,0.0030122490718715957,0.0019214963236110802,0.6103603603603603
734,힘/Noun,443,266,177,0.0029566725207300537,0.001965923984272608,0.600451467268623
735,거의/Noun,443,201,242,0.0022341773558900027,0.002687873470022436,0.54627539503386
736,시즌/Noun,442,315,127,0.0035013227219171687,0.0014105782260035097,0.7126696832579186
737,안보/Noun,442,216,226,0.00240090700931463,0.0025101628273763244,0.5113122171945701
738,너/Noun,438,183,255,0.0020341017717804503,0.0028322633671724017,0.5821917808219178
739,빨리/Adverb,437,191,246,0.0021230242536069183,0.002732301130683964,0.562929061784897
740,어/Suffix,437,220,217,0.002445368250227864,0.0024102005908878867,0.5034324942791762
741,방송/Noun,436,131,305,0.0014561056399084098,0.0033876091254415,0.6995412844036697
742,지나다/Verb,435,309,126,0.003434630860547318,0.0013994713108381278,0.7103448275862069
743,모든/Modifier,434,259,175,0.0028788653491318944,0.0019437101539418443,0.5967741935483871
744,존재/Noun,434,257,177,0.0028566347286752775,0.001965923984272608,0.5921658986175116
745,년/Noun,434,223,211,0.0024787141809127894,0.002343559099895595,0.5138248847926268
746,삼류/Noun,433,33,400,0.0003668052375341796,0.004442766066152787,0.9237875288683602
747,몇번/Noun,431,334,97,0.00371251361625503,0.0010773707710420508,0.7749419953596288
748,진정하다/Adjective,431,313,118,0.003479092101460552,0.001310615989515072,0.7262180974477959
749,말고/Josa,431,182,249,0.002022986461552142,0.0027656218761801096,0.5777262180974478
750,타다/Verb,431,214,217,0.002378676388858013,0.0024102005908878867,0.5034802784222738
751,독특하다/Adjective,429,293,136,0.0032567858968943824,0.0015105404624919474,0.682983682983683
752,잡다/Verb,429,149,280,0.0016561812240179624,0.0031099362463069507,0.6526806526806527
753,죽/Noun,428,138,290,0.001533912811506569,0.0032210053979607705,0.677570093457944
754,....../Punctuation,427,155,272,0.0017228730853878131,0.003021080924983895,0.6370023419203747
755,당신/Noun,427,243,184,0.002701020385478959,0.0020436723904302817,0.5690866510538641
756,+/Punctuation,426,174,252,0.001934063979725674,0.0027989426216762556,0.5915492957746479
757,목소리/Noun,426,184,242,0.002045217082008759,0.002687873470022436,0.568075117370892
758,여주/Noun,424,130,294,0.0014449903296801013,0.0032654330586222983,0.6933962264150944
759,담다/Verb,424,278,146,0.003090056243469755,0.0016216096141457672,0.6556603773584906
760,가볍다/Adjective,423,287,136,0.0031900940355245313,0.0015105404624919474,0.6784869976359338
761,만하/Noun,422,212,210,0.002356445768401396,0.002332452184730213,0.5023696682464455
762,질질/Noun,419,72,347,0.00080030233643821,0.0038540995623875425,0.8281622911694511
763,전부/Noun,418,133,285,0.0014783362603650269,0.0031654708221338606,0.6818181818181818
764,바/Noun,418,165,253,0.0018340261876708978,0.0028100495368416378,0.6052631578947368
765,줄거리/Noun,417,136,281,0.0015116821910499522,0.0031210431614723325,0.6738609112709832
766,맛/Noun,417,190,227,0.0021119089433786096,0.0025212697425417065,0.5443645083932853
767,흥미롭다/Adjective,417,215,202,0.0023897916990863214,0.0022435968634071574,0.5155875299760192
768,신/Noun,416,182,234,0.002022986461552142,0.0025990181486993803,0.5625
769,라니/Josa,416,226,190,0.0025120601115977146,0.0021103138814225738,0.5432692307692307
770,점주/Noun,415,98,317,0.0010893004023742304,0.0035208921074260835,0.763855421686747
771,실제/Noun,415,250,165,0.002778827557077118,0.0018326410022880245,0.6024096385542169
772,풀다/Verb,415,214,201,0.002378676388858013,0.0022324899482417753,0.5156626506024097
773,망치다/Verb,414,42,372,0.00046684302958895584,0.004131772441522092,0.8985507246376812
774,답/Noun,413,100,313,0.0011115310228308473,0.0034764644467645558,0.7578692493946732
775,넘치다/Adjective,412,298,114,0.003312362448035925,0.0012661883288535441,0.7233009708737864
776,에선/Josa,411,226,185,0.0025120601115977146,0.002054779305595664,0.5498783454987834
777,성하다/Adjective,410,37,373,0.00041126647844741344,0.004142879356687473,0.9097560975609756
778,그러나/Conjunction,409,204,205,0.0022675232865749283,0.002276917608903303,0.5012224938875306
779,낭비/Noun,408,8,400,8.892248182646778e-05,0.004442766066152787,0.9803921568627451
780,뜨다/Verb,408,147,261,0.0016339506035613453,0.0028989048581646933,0.6397058823529411
781,으로도/Josa,408,240,168,0.0026676744547940332,0.0018659617477841705,0.5882352941176471
782,이번/Noun,408,215,193,0.0023897916990863214,0.00214363462691872,0.5269607843137255
783,각본/Noun,407,121,286,0.001344952537625325,0.0031765777372992424,0.7027027027027027
784,나라/Noun,407,193,214,0.002145254874063535,0.0023768798453917407,0.5257985257985258
785,맞추다/Verb,404,109,295,0.0012115688148856235,0.00327653997378768,0.7301980198019802
786,재/Noun,401,255,146,0.0028344041082186606,0.0016216096141457672,0.6359102244389028
787,필요/Noun,401,226,175,0.0025120601115977146,0.0019437101539418443,0.5635910224438903
788,가치/Noun,401,207,194,0.002300869217259854,0.0021547415420841015,0.516209476309227
789,성룡/Noun,398,235,163,0.002612097903652491,0.0018104271719572606,0.5904522613065326
790,란/Noun,398,215,183,0.0023897916990863214,0.0020325654752649,0.5402010050251256
791,순간/Noun,397,263,134,0.002923326590045128,0.0014883266321611835,0.6624685138539043
792,어른/Noun,397,249,148,0.0027677122468488095,0.001643823444476531,0.6272040302267002
793,평론가/Noun,397,239,158,0.002656559144565725,0.0017548925961303507,0.6020151133501259
794,갑자기/Noun,396,103,293,0.0011448769535157726,0.003254326143456916,0.73989898989899
795,제작/Noun,396,143,253,0.0015894893626481115,0.0028100495368416378,0.6388888888888888
796,판타지/Noun,396,181,215,0.0020118711513238334,0.002387986760557123,0.5429292929292929
797,이하/Noun,395,34,361,0.00037792054776248805,0.00400959637470289,0.9139240506329114
798,선/Noun,395,188,207,0.0020896783229219927,0.002299131439234067,0.5240506329113924
799,상영/Noun,393,197,196,0.002189716114976769,0.0021769553724148654,0.5012722646310432
800,기다리다/Verb,392,279,113,0.0031011715536980638,0.0012550814136881622,0.7117346938775511
801,간다/Noun,392,151,241,0.0016784118444745793,0.002676766554857054,0.6147959183673469
802,너무하다/Adjective,390,50,340,0.0005557655114154236,0.0037763511562298687,0.8717948717948718
803,의도/Noun,390,66,324,0.0007336104750683592,0.0035986405135837573,0.8307692307692308
804,발/Noun,390,81,309,0.0009003401284929862,0.0034320367861030276,0.7923076923076923
805,영/Noun,390,107,283,0.0011893381944290066,0.0031432569918030968,0.7256410256410256
806,시청률/Noun,390,206,184,0.002289753907031545,0.0020436723904302817,0.5282051282051282
807,밑/Noun,388,119,269,0.0013227219171687082,0.002987760179487749,0.6932989690721649
808,TV/Alpha,388,158,230,0.0017562190160727387,0.0025545904880378526,0.5927835051546392
809,땜/Noun,387,126,261,0.0014005290887668675,0.0028989048581646933,0.6744186046511628
810,넣다/Verb,385,86,299,0.0009559166796345286,0.003320967634449208,0.7766233766233767
811,아버지/Noun,385,261,124,0.0029010959695885113,0.001377257480507364,0.6779220779220779
812,히/Adverb,385,222,163,0.0024675988706844808,0.0018104271719572606,0.5766233766233766
813,단순하다/Adjective,385,218,167,0.002423137629771247,0.0018548548326187886,0.5662337662337662
814,다른/Modifier,385,175,210,0.0019451792899539827,0.002332452184730213,0.5454545454545454
815,오글거리다/Verb,384,63,321,0.0007002645443834338,0.0035653197680876113,0.8359375
816,보내다/Verb,384,257,127,0.0028566347286752775,0.0014105782260035097,0.6692708333333334
817,만들어지다/Verb,384,249,135,0.0027677122468488095,0.0014994335473265655,0.6484375
818,한편/Noun,384,232,152,0.0025787519729675657,0.001688251105138059,0.6041666666666666
819,피/Noun,384,156,228,0.0017339883956161216,0.0025323766577070883,0.59375
820,상/Suffix,383,204,179,0.0022675232865749283,0.0019881378146033722,0.5326370757180157
821,굳다/Adjective,381,349,32,0.0038792432696796567,0.0003554212852922229,0.916010498687664
822,요소/Noun,381,194,187,0.0021563701842918434,0.0020769931359264277,0.5091863517060368
823,이기다/Verb,381,187,194,0.0020785630126936845,0.0021547415420841015,0.5091863517060368
824,볼때/Noun,380,276,104,0.003067825623013138,0.0011551191771997245,0.7263157894736842
825,바꾸다/Verb,379,143,236,0.0015894893626481115,0.002621231979030144,0.6226912928759895
826,들어가다/Verb,379,156,223,0.0017339883956161216,0.002476842081880179,0.5883905013192612
827,힘드다/Adjective,378,165,213,0.0018340261876708978,0.002365772930226359,0.5634920634920635
828,화면/Noun,378,168,210,0.0018673721183558234,0.002332452184730213,0.5555555555555556
829,면/Noun,377,205,172,0.002278638596803237,0.0019103894084456982,0.5437665782493368
830,10년/Number,376,276,100,0.003067825623013138,0.0011106915165381968,0.7340425531914894
831,세계/Noun,376,224,152,0.0024898294911410977,0.001688251105138059,0.5957446808510638
832,달다/Verb,376,176,200,0.001956294600182291,0.0022213830330763936,0.5319148936170213
833,에서도/Josa,375,204,171,0.0022675232865749283,0.0018992824932803163,0.544
834,첨/Adverb,374,111,263,0.0012337994353422404,0.002921118688495457,0.7032085561497327
835,막/Noun,373,133,240,0.0014783362603650269,0.002665659639691672,0.6434316353887399
836,흥행/Noun,373,171,202,0.0019007180490407487,0.0022435968634071574,0.5415549597855228
837,구/Noun,373,184,189,0.002045217082008759,0.0020992069662571916,0.5067024128686327
838,일단/Noun,372,184,188,0.002045217082008759,0.00208810005109181,0.5053763440860215
839,그때/Noun,371,269,102,0.002990018451414979,0.0011329053468689607,0.7250673854447439
840,항상/Noun,371,247,124,0.0027454816263921926,0.001377257480507364,0.6657681940700808
841,갖다/Verb,371,162,209,0.0018006802569859725,0.0023213452695648312,0.5633423180592992
842,좀비/Noun,370,127,243,0.001411644398995176,0.002698980385187818,0.6567567567567567
843,평/Noun,370,164,206,0.0018229108774425894,0.002288024524068685,0.5567567567567567
844,치고/Josa,368,112,256,0.0012449147455705488,0.0028433702823377834,0.6956521739130435
845,둘/Noun,368,189,179,0.0021007936331503014,0.0019881378146033722,0.5135869565217391
846,뻔/Noun,367,98,269,0.0010893004023742304,0.002987760179487749,0.7329700272479565
847,선택/Noun,367,176,191,0.001956294600182291,0.0021214207965879555,0.5204359673024523
848,스타일/Noun,367,181,186,0.0020118711513238334,0.002065886220761046,0.5068119891008175
849,거지/Noun,366,99,267,0.0011004157126025388,0.0029655463491569853,0.7295081967213115
850,곳/Noun,365,245,120,0.0027232510059355757,0.001332829819845836,0.6712328767123288
851,원/Modifier,364,158,206,0.0017562190160727387,0.002288024524068685,0.5659340659340659
852,역대/Noun,364,192,172,0.0021341395638352265,0.0019103894084456982,0.5274725274725275
853,인거/Josa,363,176,187,0.001956294600182291,0.0020769931359264277,0.5151515151515151
854,에서는/Josa,362,194,168,0.0021563701842918434,0.0018659617477841705,0.5359116022099447
855,짱/Suffix,361,320,41,0.003556899273058711,0.00045538352178066063,0.8864265927977839
856,성/Modifier,361,130,231,0.0014449903296801013,0.0025656974032032343,0.6398891966759003
857,진행/Noun,360,97,263,0.0010781850921459217,0.002921118688495457,0.7305555555555555
858,라서/Josa,360,173,187,0.0019229486694973656,0.0020769931359264277,0.5194444444444445
859,멜로/Noun,360,181,179,0.0020118711513238334,0.0019881378146033722,0.5027777777777778
860,동안/Noun,359,206,153,0.002289753907031545,0.001699358020303441,0.5738161559888579
861,확실하다/Adjective,359,185,174,0.002056332392237067,0.0019326032387764623,0.5153203342618384
862,이에요/Josa,358,286,72,0.003178978725296223,0.0007996978919075016,0.7988826815642458
863,더욱/Noun,358,281,77,0.0031234021741546806,0.0008552324677344115,0.7849162011173184
864,tv/Alpha,358,103,255,0.0011448769535157726,0.0028322633671724017,0.7122905027932961
865,낫다/Noun,358,124,234,0.0013782984683102506,0.0025990181486993803,0.6536312849162011
866,탄탄하다/Adjective,357,320,37,0.003556899273058711,0.00041095586111913277,0.896358543417367
867,돋보이다/Verb,357,275,82,0.00305671031278483,0.0009107670435613213,0.7703081232492998
868,초/Noun,357,148,209,0.0016450659137896538,0.0023213452695648312,0.5854341736694678
869,극장판/Noun,357,194,163,0.0021563701842918434,0.0018104271719572606,0.5434173669467787
870,어이/Noun,355,29,326,0.0003223439966209457,0.003620854343914521,0.9183098591549296
871,상미/Noun,355,237,118,0.0026343285241091077,0.001310615989515072,0.6676056338028169
872,래/Josa,355,138,217,0.001533912811506569,0.0024102005908878867,0.6112676056338028
873,가보다/Verb,355,163,192,0.001811795567214281,0.0021325277117533376,0.5408450704225352
874,참고/Noun,354,65,289,0.0007224951648400507,0.0032098984827953884,0.8163841807909604
875,불편하다/Adjective,354,99,255,0.0011004157126025388,0.0028322633671724017,0.7203389830508474
876,중국/Noun,354,122,232,0.0013560678478536335,0.0025768043183686164,0.655367231638418
877,완성/Noun,354,212,142,0.002356445768401396,0.0015771819534842392,0.5988700564971752
878,딸/Noun,354,158,196,0.0017562190160727387,0.0021769553724148654,0.5536723163841808
879,몇/Noun,353,222,131,0.0024675988706844808,0.0014550058866650377,0.6288951841359773
880,흐르다/Verb,352,282,70,0.0031345174843829893,0.0007774840615767377,0.8011363636363636
881,그녀/Noun,352,266,86,0.0029566725207300537,0.0009551947042228491,0.7556818181818182
882,억지스럽다/Adjective,351,50,301,0.0005557655114154236,0.003343181464779972,0.8575498575498576
883,걸리다/Verb,351,96,255,0.0010670697819176133,0.0028322633671724017,0.7264957264957265
884,끼다/Verb,351,101,250,0.0011226463330591557,0.0027767287913454917,0.7122507122507122
885,올리다/Verb,351,186,165,0.002067447702465376,0.0018326410022880245,0.5299145299145299
886,즐기다/Verb,350,239,111,0.002656559144565725,0.0012328675833573983,0.6828571428571428
887,물론/Adverb,350,195,155,0.002167485494520152,0.0017215718506342049,0.5571428571428572
888,세/Noun,350,161,189,0.001789564946757664,0.0020992069662571916,0.54
889,세/Modifier,349,186,163,0.002067447702465376,0.0018104271719572606,0.5329512893982808
890,거기/Noun,348,120,228,0.0013338372273970166,0.0025323766577070883,0.6551724137931034
891,부르다/Verb,348,172,176,0.0019118333592690571,0.001954817069107226,0.5057471264367817
892,점점/Noun,347,138,209,0.001533912811506569,0.0023213452695648312,0.6023054755043228
893,듣다/Verb,346,185,161,0.002056332392237067,0.0017882133416264967,0.5346820809248555
894,이냐/Josa,345,47,298,0.0005224195807304982,0.003309860719283826,0.863768115942029
895,수가/Noun,345,151,194,0.0016784118444745793,0.0021547415420841015,0.5623188405797102
896,허무하다/Adjective,344,85,259,0.0009448013694062201,0.0028766910278339294,0.752906976744186
897,어디서/Adverb,343,123,220,0.001367183158081942,0.0024435213363840328,0.641399416909621
898,관람/Noun,343,149,194,0.0016561812240179624,0.0021547415420841015,0.565597667638484
899,술/Noun,342,58,284,0.0006446879932418914,0.0031543639069684785,0.8304093567251462
900,전형/Noun,342,64,278,0.0007113798546117422,0.003087722415976187,0.8128654970760234
901,똑같다/Adjective,341,86,255,0.0009559166796345286,0.0028322633671724017,0.7478005865102639
902,편집/Noun,340,103,237,0.0011448769535157726,0.0026323388941955263,0.6970588235294117
903,조/Modifier,340,169,171,0.0018784874285841318,0.0018992824932803163,0.5029411764705882
904,잠/Noun,339,82,257,0.0009114554387212947,0.0028544771975031655,0.7581120943952803
905,프랑스/Noun,339,185,154,0.002056332392237067,0.001710464935468823,0.5457227138643068
906,사건/Noun,337,130,207,0.0014449903296801013,0.002299131439234067,0.6142433234421365
907,쯤/Suffix,336,199,137,0.002211946735433386,0.0015216473776573296,0.5922619047619048
908,화보/Noun,335,124,211,0.0013782984683102506,0.002343559099895595,0.6298507462686567
909,잃다/Verb,335,152,183,0.0016895271547028878,0.0020325654752649,0.5462686567164179
910,화이팅/Noun,334,296,38,0.0032901318275793076,0.00042206277628451476,0.8862275449101796
911,때리다/Verb,334,116,218,0.0012893759864837828,0.002421307506053269,0.6526946107784432
912,짧다/Adjective,334,217,117,0.0024120223195429383,0.0012995090743496902,0.6497005988023952
913,드/Noun,334,183,151,0.0020341017717804503,0.001677144189972677,0.5479041916167665
914,에/Foreign,334,155,179,0.0017228730853878131,0.0019881378146033722,0.5359281437125748
915,식상하다/Adjective,333,37,296,0.00041126647844741344,0.003287646888953062,0.8888888888888888
916,마르다/Adjective,333,116,217,0.0012893759864837828,0.0024102005908878867,0.6516516516516516
917,리/Noun,333,148,185,0.0016450659137896538,0.002054779305595664,0.5555555555555556
918,메다/Verb,332,150,182,0.0016672965342462709,0.002021458560099518,0.5481927710843374
919,평범하다/Adjective,332,154,178,0.0017117577751595047,0.00197703089943799,0.536144578313253
920,찾아보다/Verb,331,168,163,0.0018673721183558234,0.0018104271719572606,0.5075528700906344
921,꿀잼/Noun,330,316,14,0.0035124380321454774,0.00015549681231534753,0.9575757575757575
922,똥/Noun,330,29,301,0.0003223439966209457,0.003343181464779972,0.9121212121212121
923,그게/Noun,330,91,239,0.001011493230776071,0.0026545527245262902,0.7242424242424242
924,갈다/Verb,330,170,160,0.0018896027388124403,0.0017771064264611148,0.5151515151515151
925,아빠/Noun,330,162,168,0.0018006802569859725,0.0018659617477841705,0.509090909090909
926,가지다/Verb,329,198,131,0.0022008314252050776,0.0014550058866650377,0.601823708206687
927,키/Noun,329,152,177,0.0016895271547028878,0.001965923984272608,0.5379939209726444
928,중반/Noun,328,125,203,0.001389413778538559,0.002254703778572539,0.6189024390243902
929,취향/Noun,328,127,201,0.001411644398995176,0.0022324899482417753,0.6128048780487805
930,역/Noun,328,160,168,0.0017784496365293556,0.0018659617477841705,0.5121951219512195
931,-_-/Punctuation,327,38,289,0.00042238178867572195,0.0032098984827953884,0.8837920489296636
932,개그/Noun,327,99,228,0.0011004157126025388,0.0025323766577070883,0.6972477064220184
933,싸우다/Verb,327,124,203,0.0013782984683102506,0.002254703778572539,0.6207951070336392
934,뭐라다/Verb,327,141,186,0.0015672587421914947,0.002065886220761046,0.5688073394495413
935,감상/Noun,327,185,142,0.002056332392237067,0.0015771819534842392,0.5657492354740061
936,마무리/Noun,327,148,179,0.0016450659137896538,0.0019881378146033722,0.5474006116207951
937,사/Modifier,327,164,163,0.0018229108774425894,0.0018104271719572606,0.5015290519877675
938,엉망/Noun,326,22,304,0.00024453682502278637,0.003376502210276118,0.9325153374233128
939,병맛/Noun,326,57,269,0.0006335726830135829,0.002987760179487749,0.8251533742331288
940,티/Noun,325,91,234,0.001011493230776071,0.0025990181486993803,0.72
941,적당하다/Adjective,325,106,219,0.001178222884200698,0.0024324144212186506,0.6738461538461539
942,복수/Noun,325,128,197,0.0014227597092234844,0.0021880622875802475,0.6061538461538462
943,대로/Josa,325,143,182,0.0015894893626481115,0.002021458560099518,0.56
944,뛰어나다/Adjective,324,238,86,0.0026454438343374164,0.0009551947042228491,0.7345679012345679
945,관/Noun,324,221,103,0.0024564835604561725,0.0011440122620343426,0.6820987654320988
946,걸다/Verb,324,116,208,0.0012893759864837828,0.002310238354399449,0.6419753086419753
947,ㄷㄷ/KoreanParticle,324,200,124,0.0022230620456616945,0.001377257480507364,0.6172839506172839
948,액션영화/Noun,324,192,132,0.0021341395638352265,0.0014661128018304197,0.5925925925925926
949,난/Josa,324,152,172,0.0016895271547028878,0.0019103894084456982,0.5308641975308642
950,소/Modifier,324,169,155,0.0018784874285841318,0.0017215718506342049,0.5216049382716049
951,지겹다/Adjective,323,29,294,0.0003223439966209457,0.0032654330586222983,0.9102167182662538
952,미화/Noun,323,44,279,0.0004890736500455727,0.0030988293311415686,0.8637770897832817
953,~!!/Punctuation,323,253,70,0.0028121734877620433,0.0007774840615767377,0.7832817337461301
954,흥미/Noun,323,125,198,0.001389413778538559,0.0021991692027456293,0.6130030959752322
955,//Punctuation,323,130,193,0.0014449903296801013,0.00214363462691872,0.5975232198142415
956,예상/Noun,323,138,185,0.001533912811506569,0.002054779305595664,0.5727554179566563
957,자극/Noun,323,174,149,0.001934063979725674,0.001654930359641913,0.5386996904024768
958,헐다/Verb,322,92,230,0.0010226085410043795,0.0025545904880378526,0.7142857142857143
959,몸/Noun,322,132,190,0.0014672209501367184,0.0021103138814225738,0.5900621118012422
960,과/Noun,322,138,184,0.001533912811506569,0.0020436723904302817,0.5714285714285714
961,간/Suffix,322,178,144,0.001978525220638908,0.0015993957838150031,0.5527950310559007
962,흥미진진/Noun,321,276,45,0.003067825623013138,0.0004998111824421885,0.8598130841121495
963,거리/Noun,321,142,179,0.001578374052419803,0.0019881378146033722,0.557632398753894
964,원래/Noun,321,149,172,0.0016561812240179624,0.0019103894084456982,0.5358255451713395
965,손/Noun,320,175,145,0.0019451792899539827,0.0016105026989803853,0.546875
966,중요하다/Adjective,320,151,169,0.0016784118444745793,0.0018770686629495524,0.528125
967,훈훈하다/Adjective,319,281,38,0.0031234021741546806,0.00042206277628451476,0.8808777429467085
968,여서/Josa,319,132,187,0.0014672209501367184,0.0020769931359264277,0.5862068965517241
969,잘만/Noun,318,239,79,0.002656559144565725,0.0008774462980651753,0.7515723270440252
970,에겐/Josa,317,194,123,0.0021563701842918434,0.001366150565341982,0.61198738170347
971,노력/Noun,317,132,185,0.0014672209501367184,0.002054779305595664,0.583596214511041
972,만으로도/Josa,316,285,31,0.0031678634150679144,0.000344314370126841,0.9018987341772152
973,낫다/Verb,316,91,225,0.001011493230776071,0.0024990559122109427,0.7120253164556962
974,나르다/Verb,316,224,92,0.0024898294911410977,0.0010218361952151409,0.7088607594936709
975,학교/Noun,316,192,124,0.0021341395638352265,0.001377257480507364,0.6075949367088608
976,비추다/Verb,315,48,267,0.0005335348909588066,0.0029655463491569853,0.8476190476190476
977,괜히/Adverb,315,80,235,0.0008892248182646778,0.002610125063864762,0.746031746031746
978,또한/Noun,315,208,107,0.002311984527488162,0.0011884399226958703,0.6603174603174603
979,과거/Noun,315,196,119,0.0021786008047484607,0.001321722904680454,0.6222222222222222
980,오/Noun,315,182,133,0.002022986461552142,0.0014772197169958016,0.5777777777777777
981,배/Noun,315,144,171,0.00160060467287642,0.0018992824932803163,0.5428571428571428
982,그래픽/Noun,314,78,236,0.0008669941978080608,0.002621231979030144,0.7515923566878981
983,ost/Alpha,313,265,48,0.002945557210501745,0.0005331319279383344,0.8466453674121406
984,그냥/Modifier,313,87,226,0.000967031989862837,0.0025101628273763244,0.7220447284345048
985,이라니/Josa,313,116,197,0.0012893759864837828,0.0021880622875802475,0.6293929712460063
986,무/Noun,313,127,186,0.001411644398995176,0.002065886220761046,0.5942492012779552
987,그만/Adverb,312,21,291,0.00023342151479447792,0.0032321123131261523,0.9326923076923077
988,장/Suffix,312,89,223,0.000989262610319454,0.002476842081880179,0.7147435897435898
989,20/Number,312,211,101,0.0023453304581730876,0.0011217984317035787,0.6762820512820513
990,바보/Noun,311,85,226,0.0009448013694062201,0.0025101628273763244,0.7266881028938906
991,성우/Noun,310,70,240,0.000778071715981593,0.002665659639691672,0.7741935483870968
992,봣/Noun,308,207,101,0.002300869217259854,0.0011217984317035787,0.672077922077922
993,소중하다/Adjective,307,226,81,0.0025120601115977146,0.0008996601283959393,0.7361563517915309
994,죽음/Noun,307,206,101,0.002289753907031545,0.0011217984317035787,0.6710097719869706
995,대한민국/Noun,307,185,122,0.002056332392237067,0.0013550436501765998,0.6026058631921825
996,연기자/Noun,307,153,154,0.0017006424649311962,0.001710464935468823,0.501628664495114
997,유치/Noun,306,21,285,0.00023342151479447792,0.0031654708221338606,0.9313725490196079
998,나서다/Verb,306,139,167,0.0015450281217348775,0.0018548548326187886,0.545751633986928
999,도저히/Noun,305,26,279,0.00028899806593602026,0.0030988293311415686,0.9147540983606557
1000,한심하다/Adjective,305,33,272,0.0003668052375341796,0.003021080924983895,0.8918032786885246
1001,식/Noun,305,72,233,0.00080030233643821,0.002587911233533998,0.7639344262295082
1002,속편/Noun,305,99,206,0.0011004157126025388,0.002288024524068685,0.6754098360655738
1003,씩/Suffix,305,164,141,0.0018229108774425894,0.0015660750383188573,0.5377049180327869
1004,오히려/Noun,305,154,151,0.0017117577751595047,0.001677144189972677,0.5049180327868853
1005,한/Modifier,305,152,153,0.0016895271547028878,0.001699358020303441,0.5016393442622951
1006,역겹다/Adjective,304,37,267,0.00041126647844741344,0.0029655463491569853,0.8782894736842105
1007,울/Noun,304,228,76,0.0025342907320543315,0.0008441255525690295,0.75
1008,무조건/Noun,304,193,111,0.002145254874063535,0.0012328675833573983,0.6348684210526315
1009,닿다/Verb,303,192,111,0.0021341395638352265,0.0012328675833573983,0.6336633663366337
1010,전달/Noun,303,115,188,0.0012782606762554744,0.00208810005109181,0.6204620462046204
1011,땐/Noun,303,183,120,0.0020341017717804503,0.001332829819845836,0.6039603960396039
1012,상상/Noun,303,173,130,0.0019229486694973656,0.0014438989714996558,0.570957095709571
1013,고/Noun,303,152,151,0.0016895271547028878,0.001677144189972677,0.5016501650165016
1014,보이/Noun,302,130,172,0.0014449903296801013,0.0019103894084456982,0.5695364238410596
1015,다루다/Verb,302,158,144,0.0017562190160727387,0.0015993957838150031,0.5231788079470199
1016,천재/Noun,301,236,65,0.0026232132138807995,0.0007219494857498279,0.7840531561461794
1017,설명/Noun,301,133,168,0.0014783362603650269,0.0018659617477841705,0.5581395348837209
1018,억지로/Noun,300,42,258,0.00046684302958895584,0.0028655841126685472,0.86
1019,우연히/Adverb,300,258,42,0.0028677500389035857,0.0004664904369460426,0.86
1020,심리/Noun,300,207,93,0.002300869217259854,0.001032943110380523,0.69
1021,화가/Noun,299,75,224,0.0008336482671231354,0.0024879489970455605,0.7491638795986622
1022,강하다/Adjective,299,187,112,0.0020785630126936845,0.0012439744985227803,0.6254180602006689
1023,댓글/Noun,297,75,222,0.0008336482671231354,0.0024657351667147966,0.7474747474747475
1024,자꾸/Noun,297,119,178,0.0013227219171687082,0.00197703089943799,0.5993265993265994
1025,한다는/Modifier,297,150,147,0.0016672965342462709,0.0016327165293111491,0.5050505050505051
1026,속/Modifier,296,73,223,0.0008114176466665184,0.002476842081880179,0.7533783783783784
1027,아무/Noun,296,116,180,0.0012893759864837828,0.001999244729768754,0.6081081081081081
1028,타임/Noun,296,130,166,0.0014449903296801013,0.0018437479174534064,0.5608108108108109
1029,개다/Verb,295,73,222,0.0008114176466665184,0.0024657351667147966,0.752542372881356
1030,새끼/Noun,295,80,215,0.0008892248182646778,0.002387986760557123,0.7288135593220338
1031,척/Noun,294,58,236,0.0006446879932418914,0.002621231979030144,0.8027210884353742
1032,예고편/Noun,294,69,225,0.0007669564057532845,0.0024990559122109427,0.7653061224489796
1033,다가/Noun,293,91,202,0.001011493230776071,0.0022435968634071574,0.689419795221843
1034,최근/Noun,293,195,98,0.002167485494520152,0.0010884776862074327,0.6655290102389079
1035,길다/Adjective,293,136,157,0.0015116821910499522,0.0017437856809649687,0.5358361774744027
1036,구/Modifier,293,152,141,0.0016895271547028878,0.0015660750383188573,0.5187713310580204
1037,법/Noun,293,142,151,0.001578374052419803,0.001677144189972677,0.515358361774744
1038,현/Modifier,292,181,111,0.0020118711513238334,0.0012328675833573983,0.6198630136986302
1039,good/Alpha,291,213,78,0.0023675610786297045,0.0008663393828997934,0.7319587628865979
1040,어느/Modifier,291,104,187,0.001155992263744081,0.0020769931359264277,0.6426116838487973
1041,그림/Noun,291,164,127,0.0018229108774425894,0.0014105782260035097,0.563573883161512
1042,잊혀지다/Verb,289,255,34,0.0028344041082186606,0.00037763511562298685,0.8823529411764706
1043,불륜/Noun,289,75,214,0.0008336482671231354,0.0023768798453917407,0.740484429065744
1044,젠/Noun,289,80,209,0.0008892248182646778,0.0023213452695648312,0.7231833910034602
1045,터/Noun,289,126,163,0.0014005290887668675,0.0018104271719572606,0.5640138408304498
1046,대작/Noun,288,231,57,0.002567636662739257,0.0006330941644267721,0.8020833333333334
1047,짐/Noun,288,189,99,0.0021007936331503014,0.0010995846013728146,0.65625
1048,다니다/Verb,288,105,183,0.0011671075739723895,0.0020325654752649,0.6354166666666666
1049,무비/Noun,288,124,164,0.0013782984683102506,0.0018215340871226425,0.5694444444444444
1050,불다/Verb,288,127,161,0.001411644398995176,0.0017882133416264967,0.5590277777777778
1051,SF/Alpha,288,149,139,0.0016561812240179624,0.0015438612079880934,0.5173611111111112
1052,스타/Noun,288,147,141,0.0016339506035613453,0.0015660750383188573,0.5104166666666666
1053,미안하다/Adjective,287,74,213,0.0008225329568948269,0.002365772930226359,0.7421602787456446
1054,촬영/Noun,287,121,166,0.001344952537625325,0.0018437479174534064,0.578397212543554
1055,전편/Noun,287,125,162,0.001389413778538559,0.0017993202567918786,0.5644599303135889
1056,열/Noun,286,78,208,0.0008669941978080608,0.002310238354399449,0.7272727272727273
1057,90년/Number,286,134,152,0.0014894515705933353,0.001688251105138059,0.5314685314685315
1058,올/Modifier,286,136,150,0.0015116821910499522,0.001666037274807295,0.5244755244755245
1059,2시간/Number,285,95,190,0.0010559544716893048,0.0021103138814225738,0.6666666666666666
1060,표정/Noun,285,161,124,0.001789564946757664,0.001377257480507364,0.5649122807017544
1061,동/Modifier,285,124,161,0.0013782984683102506,0.0017882133416264967,0.5649122807017544
1062,기억나다/Verb,285,157,128,0.00174510370584443,0.0014216851411688917,0.5508771929824562
1063,아저씨/Noun,285,155,130,0.0017228730853878131,0.0014438989714996558,0.543859649122807
1064,게임/Noun,284,97,187,0.0010781850921459217,0.0020769931359264277,0.6584507042253521
1065,행동/Noun,284,103,181,0.0011448769535157726,0.002010351644934136,0.6373239436619719
1066,고/Modifier,284,123,161,0.001367183158081942,0.0017882133416264967,0.5669014084507042
1067,길/Noun,284,140,144,0.001556143431963186,0.0015993957838150031,0.5070422535211268
1068,실망하다/Adjective,283,60,223,0.0006669186136985083,0.002476842081880179,0.7879858657243817
1069,짓/Noun,283,70,213,0.000778071715981593,0.002365772930226359,0.7526501766784452
1070,환상/Noun,283,207,76,0.002300869217259854,0.0008441255525690295,0.7314487632508834
1071,여/Noun,283,178,105,0.001978525220638908,0.0011662260923651065,0.6289752650176679
1072,메세지/Noun,283,143,140,0.0015894893626481115,0.0015549681231534754,0.5053003533568905
1073,오래/Adverb,282,230,52,0.002556521352510949,0.0005775595885998623,0.8156028368794326
1074,작다/Adjective,281,156,125,0.0017339883956161216,0.0013883643956727459,0.5551601423487544
1075,결혼/Noun,281,130,151,0.0014449903296801013,0.001677144189972677,0.5373665480427047
1076,참신하다/Adjective,281,149,132,0.0016561812240179624,0.0014661128018304197,0.5302491103202847
1077,그닥/Noun,280,25,255,0.0002778827557077118,0.0028322633671724017,0.9107142857142857
1078,귀신/Noun,280,71,209,0.0007891870262099015,0.0023213452695648312,0.7464285714285714
1079,전설/Noun,280,175,105,0.0019451792899539827,0.0011662260923651065,0.625
1080,입/Noun,280,115,165,0.0012782606762554744,0.0018326410022880245,0.5892857142857143
1081,조연/Noun,280,137,143,0.0015227975012782607,0.0015882888686496212,0.5107142857142857
1082,산/Noun,279,67,212,0.0007447257852966677,0.002354666015060977,0.7598566308243727
1083,총/Modifier,279,87,192,0.000967031989862837,0.0021325277117533376,0.6881720430107527
1084,회/Noun,279,177,102,0.0019674099104105996,0.0011329053468689607,0.6344086021505376
1085,빠져들다/Verb,278,264,14,0.002934441900273437,0.00015549681231534753,0.9496402877697842
1086,흘리다/Verb,278,211,67,0.0023453304581730876,0.0007441633160805918,0.7589928057553957
1087,전작/Noun,277,72,205,0.00080030233643821,0.002276917608903303,0.740072202166065
1088,총/Noun,277,85,192,0.0009448013694062201,0.0021325277117533376,0.6931407942238267
1089,유머/Noun,277,161,116,0.001789564946757664,0.0012884021591843082,0.5812274368231047
1090,♡/Foreign,276,264,12,0.002934441900273437,0.0001332829819845836,0.9565217391304348
1091,돌아가다/Verb,276,167,109,0.001856256808127515,0.0012106537530266344,0.605072463768116
1092,현재/Noun,275,205,70,0.002278638596803237,0.0007774840615767377,0.7454545454545455
1093,극/Suffix,275,114,161,0.0012671453660271657,0.0017882133416264967,0.5854545454545454
1094,마/Noun,275,119,156,0.0013227219171687082,0.0017326787657995868,0.5672727272727273
1095,진지하다/Adjective,275,145,130,0.0016117199831047284,0.0014438989714996558,0.5272727272727272
1096,쩔다/Verb,274,216,58,0.00240090700931463,0.0006442010795921541,0.7883211678832117
1097,여전하다/Adjective,274,191,83,0.0021230242536069183,0.0009218739587267032,0.6970802919708029
1098,울/Modifier,274,178,96,0.001978525220638908,0.0010662638558766688,0.6496350364963503
1099,제작비/Noun,273,38,235,0.00042238178867572195,0.002610125063864762,0.8608058608058609
1100,영원하다/Adjective,273,231,42,0.002567636662739257,0.0004664904369460426,0.8461538461538461
1101,예요/Josa,273,206,67,0.002289753907031545,0.0007441633160805918,0.7545787545787546
1102,스러운/Josa,273,89,184,0.000989262610319454,0.0020436723904302817,0.673992673992674
1103,다행/Noun,273,104,169,0.001155992263744081,0.0018770686629495524,0.6190476190476191
1104,흠/Noun,272,105,167,0.0011671075739723895,0.0018548548326187886,0.6139705882352942
1105,나중/Noun,272,151,121,0.0016784118444745793,0.001343936735011218,0.5551470588235294
1106,통해/Noun,271,217,54,0.0024120223195429383,0.0005997734189306263,0.8007380073800738
1107,잘생기다/Adjective,271,198,73,0.0022008314252050776,0.0008108048070728836,0.7306273062730627
1108,노/Noun,271,96,175,0.0010670697819176133,0.0019437101539418443,0.6457564575645757
1109,주의/Noun,271,113,158,0.0012560300557988573,0.0017548925961303507,0.5830258302583026
1110,저런/Noun,271,141,130,0.0015672587421914947,0.0014438989714996558,0.5202952029520295
1111,이미/Adverb,270,114,156,0.0012671453660271657,0.0017326787657995868,0.5777777777777777
1112,아쉬움/Noun,269,159,110,0.0017673343263010471,0.0012217606681920164,0.5910780669144982
1113,역할/Noun,269,128,141,0.0014227597092234844,0.0015660750383188573,0.5241635687732342
1114,망작/Noun,268,16,252,0.00017784496365293555,0.0027989426216762556,0.9402985074626866
1115,억/Modifier,268,114,154,0.0012671453660271657,0.001710464935468823,0.5746268656716418
1116,소녀/Noun,268,117,151,0.0013004912967120913,0.001677144189972677,0.5634328358208955
1117,그런데/Conjunction,268,133,135,0.0014783362603650269,0.0014994335473265655,0.503731343283582
1118,가끔/Noun,267,174,93,0.001934063979725674,0.001032943110380523,0.651685393258427
1119,만의/Josa,267,167,100,0.001856256808127515,0.0011106915165381968,0.6254681647940075
1120,드럽다/Adjective,266,24,242,0.0002667674454794033,0.002687873470022436,0.9097744360902256
1121,동화/Noun,266,189,77,0.0021007936331503014,0.0008552324677344115,0.7105263157894737
1122,80년/Number,266,82,184,0.0009114554387212947,0.0020436723904302817,0.6917293233082706
1123,:/Punctuation,266,106,160,0.001178222884200698,0.0017771064264611148,0.6015037593984962
1124,사라지다/Verb,266,107,159,0.0011893381944290066,0.0017659995112957326,0.5977443609022557
1125,먼저/Noun,266,153,113,0.0017006424649311962,0.0012550814136881622,0.575187969924812
1126,겁나다/Verb,266,127,139,0.001411644398995176,0.0015438612079880934,0.5225563909774437
1127,100/Number,265,171,94,0.0019007180490407487,0.001044050025545905,0.6452830188679245
1128,묘사/Noun,265,170,95,0.0018896027388124403,0.0010551569407112869,0.6415094339622641
1129,씨/Noun,265,120,145,0.0013338372273970166,0.0016105026989803853,0.5471698113207547
1130,예산/Noun,264,65,199,0.0007224951648400507,0.0022102761179110114,0.7537878787878788
1131,으/Adverb,263,97,166,0.0010781850921459217,0.0018437479174534064,0.6311787072243346
1132,여러/Modifier,263,165,98,0.0018340261876708978,0.0010884776862074327,0.6273764258555133
1133,화/Noun,263,125,138,0.001389413778538559,0.0015327542928227115,0.5247148288973384
1134,정/Noun,263,132,131,0.0014672209501367184,0.0014550058866650377,0.5019011406844106
1135,도/Foreign,263,131,132,0.0014561056399084098,0.0014661128018304197,0.5019011406844106
1136,채널/Noun,262,82,180,0.0009114554387212947,0.001999244729768754,0.6870229007633588
1137,살인/Noun,262,97,165,0.0010781850921459217,0.0018326410022880245,0.6297709923664122
1138,멍청하다/Adjective,260,38,222,0.00042238178867572195,0.0024657351667147966,0.8538461538461538
1139,강/Noun,260,197,63,0.002189716114976769,0.0006997356554190639,0.7576923076923077
1140,인하다/Adjective,260,152,108,0.0016895271547028878,0.0011995468378612525,0.5846153846153846
1141,만큼/Josa,260,150,110,0.0016672965342462709,0.0012217606681920164,0.5769230769230769
1142,리메이크/Noun,260,113,147,0.0012560300557988573,0.0016327165293111491,0.5653846153846154
1143,덥다/Adjective,260,123,137,0.001367183158081942,0.0015216473776573296,0.5269230769230769
1144,특유/Noun,259,151,108,0.0016784118444745793,0.0011995468378612525,0.583011583011583
1145,바람/Noun,259,114,145,0.0012671453660271657,0.0016105026989803853,0.5598455598455598
1146,마치/Noun,259,132,127,0.0014672209501367184,0.0014105782260035097,0.5096525096525096
1147,졸라/Noun,258,75,183,0.0008336482671231354,0.0020325654752649,0.7093023255813954
1148,프로그램/Noun,258,102,156,0.0011337616432874642,0.0017326787657995868,0.6046511627906976
1149,관계/Noun,258,137,121,0.0015227975012782607,0.001343936735011218,0.5310077519379846
1150,개/Suffix,257,79,178,0.0008781095080363693,0.00197703089943799,0.6926070038910506
1151,틀다/Verb,257,149,108,0.0016561812240179624,0.0011995468378612525,0.5797665369649806
1152,등장/Noun,257,108,149,0.001200453504657315,0.001654930359641913,0.5797665369649806
1153,두/Josa,257,122,135,0.0013560678478536335,0.0014994335473265655,0.5252918287937743
1154,너/Modifier,257,125,132,0.001389413778538559,0.0014661128018304197,0.5136186770428015
1155,ㅇ/KoreanParticle,257,130,127,0.0014449903296801013,0.0014105782260035097,0.5058365758754864
1156,가능하다/Adjective,257,129,128,0.0014338750194517929,0.0014216851411688917,0.5019455252918288
1157,외/Noun,256,70,186,0.000778071715981593,0.002065886220761046,0.7265625
1158,서로/Noun,256,161,95,0.001789564946757664,0.0010551569407112869,0.62890625
1159,존/Noun,256,111,145,0.0012337994353422404,0.0016105026989803853,0.56640625
1160,영웅/Noun,255,121,134,0.001344952537625325,0.0014883266321611835,0.5254901960784314
1161,낚/Noun,254,20,234,0.00022230620456616945,0.0025990181486993803,0.9212598425196851
1162,경찰/Noun,254,98,156,0.0010893004023742304,0.0017326787657995868,0.6141732283464567
1163,관심/Noun,254,132,122,0.0014672209501367184,0.0013550436501765998,0.5196850393700787
1164,모/Noun,253,66,187,0.0007336104750683592,0.0020769931359264277,0.7391304347826086
1165,프로/Noun,253,104,149,0.001155992263744081,0.001654930359641913,0.5889328063241107
1166,안나/Noun,253,119,134,0.0013227219171687082,0.0014883266321611835,0.5296442687747036
1167,끌다/Verb,252,68,184,0.0007558410955249761,0.0020436723904302817,0.7301587301587301
1168,런가/Noun,252,97,155,0.0010781850921459217,0.0017215718506342049,0.6150793650793651
1169,반개/Noun,251,5,246,5.557655114154236e-05,0.002732301130683964,0.9800796812749004
1170,짱/VerbPrefix,251,225,26,0.0025009448013694063,0.00028877979429993113,0.896414342629482
1171,지루/Noun,250,21,229,0.00023342151479447792,0.0025434835728724704,0.916
1172,케이블/Noun,250,126,124,0.0014005290887668675,0.001377257480507364,0.504
1173,황당하다/Adjective,249,38,211,0.00042238178867572195,0.002343559099895595,0.8473895582329317
1174,착하다/Adjective,249,109,140,0.0012115688148856235,0.0015549681231534754,0.5622489959839357
1175,신/Modifier,249,123,126,0.001367183158081942,0.0013994713108381278,0.5060240963855421
1176,약하다/Adjective,248,71,177,0.0007891870262099015,0.001965923984272608,0.7137096774193549
1177,흔하다/Adjective,248,92,156,0.0010226085410043795,0.0017326787657995868,0.6290322580645161
1178,과정/Noun,248,142,106,0.001578374052419803,0.0011773330075304884,0.5725806451612904
1179,철학/Noun,248,134,114,0.0014894515705933353,0.0012661883288535441,0.5403225806451613
1180,햇/Noun,248,120,128,0.0013338372273970166,0.0014216851411688917,0.5161290322580645
1181,졸리다/Verb,247,27,220,0.00030011337616432876,0.0024435213363840328,0.8906882591093117
1182,용도/Noun,247,57,190,0.0006335726830135829,0.0021103138814225738,0.7692307692307693
1183,희망/Noun,246,210,36,0.002334215147944779,0.0003998489459537508,0.8536585365853658
1184,같이/Josa,246,108,138,0.001200453504657315,0.0015327542928227115,0.5609756097560976
1185,안다/Verb,246,122,124,0.0013560678478536335,0.001377257480507364,0.5040650406504065
1186,위대하다/Adjective,245,185,60,0.002056332392237067,0.000666414909922918,0.7551020408163265
1187,청춘/Noun,245,172,73,0.0019118333592690571,0.0008108048070728836,0.7020408163265306
1188,......./Punctuation,245,81,164,0.0009003401284929862,0.0018215340871226425,0.6693877551020408
1189,다만/Noun,245,160,85,0.0017784496365293556,0.0009440877890574672,0.6530612244897959
1190,상상력/Noun,245,158,87,0.0017562190160727387,0.0009663016193882312,0.6448979591836734
1191,너무나도/Adverb,245,151,94,0.0016784118444745793,0.001044050025545905,0.6163265306122448
1192,겠다/Verb,245,116,129,0.0012893759864837828,0.0014327920563342736,0.5265306122448979
1193,깊이/Noun,244,172,72,0.0019118333592690571,0.0007996978919075016,0.7049180327868853
1194,생애/Noun,244,140,104,0.001556143431963186,0.0011551191771997245,0.5737704918032787
1195,묻다/Verb,244,139,105,0.0015450281217348775,0.0011662260923651065,0.569672131147541
1196,효과/Noun,244,108,136,0.001200453504657315,0.0015105404624919474,0.5573770491803278
1197,스케일/Noun,244,134,110,0.0014894515705933353,0.0012217606681920164,0.5491803278688525
1198,인정/Noun,244,121,123,0.001344952537625325,0.001366150565341982,0.5040983606557377
1199,cg/Alpha,243,62,181,0.0006891492341551253,0.002010351644934136,0.7448559670781894
1200,엇/VerbPrefix,243,144,99,0.00160060467287642,0.0010995846013728146,0.5925925925925926
1201,바뀌다/Verb,243,103,140,0.0011448769535157726,0.0015549681231534754,0.5761316872427984
1202,기세/Noun,242,7,235,7.78071715981593e-05,0.002610125063864762,0.9710743801652892
1203,어느/Adverb,242,103,139,0.0011448769535157726,0.0015438612079880934,0.5743801652892562
1204,생/Noun,242,105,137,0.0011671075739723895,0.0015216473776573296,0.5661157024793388
1205,빌리다/Verb,242,107,135,0.0011893381944290066,0.0014994335473265655,0.5578512396694215
1206,며/Josa,242,113,129,0.0012560300557988573,0.0014327920563342736,0.5330578512396694
1207,신기하다/Adjective,242,117,125,0.0013004912967120913,0.0013883643956727459,0.5165289256198347
1208,형님/Noun,241,155,86,0.0017228730853878131,0.0009551947042228491,0.6431535269709544
1209,깔다/Verb,241,91,150,0.001011493230776071,0.001666037274807295,0.6224066390041494
1210,이며/Josa,241,142,99,0.001578374052419803,0.0010995846013728146,0.5892116182572614
1211,다소/Noun,241,140,101,0.001556143431963186,0.0011217984317035787,0.5809128630705395
1212,께/Josa,241,140,101,0.001556143431963186,0.0011217984317035787,0.5809128630705395
1213,노출/Noun,240,57,183,0.0006335726830135829,0.0020325654752649,0.7625
1214,다시다/Verb,240,72,168,0.00080030233643821,0.0018659617477841705,0.7
1215,카메라/Noun,240,73,167,0.0008114176466665184,0.0018548548326187886,0.6958333333333333
1216,살아가다/Verb,239,217,22,0.0024120223195429383,0.0002443521336384033,0.9079497907949791
1217,미래/Noun,239,164,75,0.0018229108774425894,0.0008330186374036475,0.6861924686192469
1218,왠지/Adverb,239,138,101,0.001533912811506569,0.0011217984317035787,0.5774058577405857
1219,태어나다/Verb,239,134,105,0.0014894515705933353,0.0011662260923651065,0.5606694560669456
1220,쏘다/Verb,238,76,162,0.0008447635773514439,0.0017993202567918786,0.680672268907563
1221,체/Noun,238,92,146,0.0010226085410043795,0.0016216096141457672,0.6134453781512605
1222,단/Noun,238,107,131,0.0011893381944290066,0.0014550058866650377,0.5504201680672269
1223,>/Punctuation,238,120,118,0.0013338372273970166,0.001310615989515072,0.5042016806722689
1224,대안/Noun,237,199,38,0.002211946735433386,0.00042206277628451476,0.8396624472573839
1225,로는/Josa,237,110,127,0.001222684125113932,0.0014105782260035097,0.5358649789029536
1226,산만하다/Adjective,236,19,217,0.00021119089433786097,0.0024102005908878867,0.9194915254237288
1227,능력/Noun,236,81,155,0.0009003401284929862,0.0017215718506342049,0.6567796610169492
1228,미소/Noun,235,212,23,0.002356445768401396,0.0002554590488037852,0.902127659574468
1229,결론/Noun,235,63,172,0.0007002645443834338,0.0019103894084456982,0.7319148936170212
1230,반/Noun,235,83,152,0.0009225707489496032,0.001688251105138059,0.6468085106382979
1231,치/Noun,235,90,145,0.0010003779205477626,0.0016105026989803853,0.6170212765957447
1232,시/Noun,235,111,124,0.0012337994353422404,0.001377257480507364,0.5276595744680851
1233,설레다/Adjective,234,212,22,0.002356445768401396,0.0002443521336384033,0.905982905982906
1234,독립영화/Noun,234,75,159,0.0008336482671231354,0.0017659995112957326,0.6794871794871795
1235,부터/Noun,234,122,112,0.0013560678478536335,0.0012439744985227803,0.5213675213675214
1236,OST/Alpha,233,191,42,0.0021230242536069183,0.0004664904369460426,0.8197424892703863
1237,잘못/Noun,233,83,150,0.0009225707489496032,0.001666037274807295,0.6437768240343348
1238,네/Noun,233,103,130,0.0011448769535157726,0.0014438989714996558,0.5579399141630901
1239,얻다/Verb,232,135,97,0.0015005668808216438,0.0010773707710420508,0.5818965517241379
1240,귀/Modifier,231,137,94,0.0015227975012782607,0.001044050025545905,0.5930735930735931
1241,엿/Modifier,231,118,113,0.0013116066069403997,0.0012550814136881622,0.5108225108225108
1242,지나치다/Verb,230,55,175,0.000611342062556966,0.0019437101539418443,0.7608695652173914
1243,리얼/Noun,230,156,74,0.0017339883956161216,0.0008219117222382655,0.6782608695652174
1244,평생/Noun,230,147,83,0.0016339506035613453,0.0009218739587267032,0.6391304347826087
1245,요/Modifier,230,129,101,0.0014338750194517929,0.0011217984317035787,0.5608695652173913
1246,ㅇㅇ/KoreanParticle,230,126,104,0.0014005290887668675,0.0011551191771997245,0.5478260869565217
1247,젊다/Adjective,229,158,71,0.0017562190160727387,0.0007885909767421196,0.6899563318777293
1248,원하다/Adjective,229,129,100,0.0014338750194517929,0.0011106915165381968,0.5633187772925764
1249,왠만하다/Adjective,228,20,208,0.00022230620456616945,0.002310238354399449,0.9122807017543859
1250,멋/Noun,228,174,54,0.001934063979725674,0.0005997734189306263,0.7631578947368421
1251,범인/Noun,228,62,166,0.0006891492341551253,0.0018437479174534064,0.7280701754385965
1252,되게/Adverb,227,149,78,0.0016561812240179624,0.0008663393828997934,0.6563876651982379
1253,어린이/Noun,227,87,140,0.000967031989862837,0.0015549681231534754,0.6167400881057269
1254,D/Alpha,227,103,124,0.0011448769535157726,0.001377257480507364,0.5462555066079295
1255,메시지/Noun,227,115,112,0.0012782606762554744,0.0012439744985227803,0.5066079295154186
1256,박수/Noun,226,151,75,0.0016784118444745793,0.0008330186374036475,0.668141592920354
1257,고민/Noun,226,128,98,0.0014227597092234844,0.0010884776862074327,0.5663716814159292
1258,얼/Noun,226,99,127,0.0011004157126025388,0.0014105782260035097,0.5619469026548672
1259,으로는/Josa,226,119,107,0.0013227219171687082,0.0011884399226958703,0.5265486725663717
1260,손발/Noun,225,22,203,0.00024453682502278637,0.002254703778572539,0.9022222222222223
1261,고생/Noun,225,87,138,0.000967031989862837,0.0015327542928227115,0.6133333333333333
1262,고맙다/Adjective,224,180,44,0.002000755841095525,0.0004887042672768066,0.8035714285714286
1263,온/Noun,224,111,113,0.0012337994353422404,0.0012550814136881622,0.5044642857142857
1264,졸다/Verb,223,13,210,0.00014449903296801013,0.002332452184730213,0.9417040358744395
1265,굳이/Noun,223,45,178,0.0005001889602738813,0.00197703089943799,0.7982062780269058
1266,로맨틱/Noun,223,141,82,0.0015672587421914947,0.0009107670435613213,0.6322869955156951
1267,랄/Noun,223,119,104,0.0013227219171687082,0.0011551191771997245,0.5336322869955157
1268,변하다/Adjective,223,114,109,0.0012671453660271657,0.0012106537530266344,0.5112107623318386
1269,군/Suffix,223,112,111,0.0012449147455705488,0.0012328675833573983,0.5022421524663677
1270,인/Noun,223,112,111,0.0012449147455705488,0.0012328675833573983,0.5022421524663677
1271,거지같다/Adjective,222,19,203,0.00021119089433786097,0.002254703778572539,0.9144144144144144
1272,떠오르다/Verb,222,164,58,0.0018229108774425894,0.0006442010795921541,0.7387387387387387
1273,밤/Noun,222,158,64,0.0017562190160727387,0.0007108425705844458,0.7117117117117117
1274,심심하다/Adjective,221,88,133,0.0009781473000911455,0.0014772197169958016,0.6018099547511312
1275,만/Modifier,221,119,102,0.0013227219171687082,0.0011329053468689607,0.5384615384615384
1276,문화/Noun,221,114,107,0.0012671453660271657,0.0011884399226958703,0.5158371040723982
1277,별루/Noun,220,12,208,0.00013338372273970166,0.002310238354399449,0.9454545454545454
1278,슬픔/Noun,220,192,28,0.0021341395638352265,0.00031099362463069506,0.8727272727272727
1279,용이/Noun,220,69,151,0.0007669564057532845,0.001677144189972677,0.6863636363636364
1280,차/Noun,220,84,136,0.0009336860591779117,0.0015105404624919474,0.6181818181818182
1281,스/Noun,220,131,89,0.0014561056399084098,0.000988515449718995,0.5954545454545455
1282,저렇게/Adverb,220,91,129,0.001011493230776071,0.0014327920563342736,0.5863636363636363
1283,사다/Verb,220,115,105,0.0012782606762554744,0.0011662260923651065,0.5227272727272727
1284,포장/Noun,219,20,199,0.00022230620456616945,0.0022102761179110114,0.908675799086758
1285,주기/Noun,219,40,179,0.0004446124091323389,0.0019881378146033722,0.817351598173516
1286,시도/Noun,219,57,162,0.0006335726830135829,0.0017993202567918786,0.7397260273972602
1287,ㅅㅂ/KoreanParticle,218,20,198,0.00022230620456616945,0.0021991692027456293,0.908256880733945
1288,아침/Noun,218,56,162,0.0006224573727852744,0.0017993202567918786,0.7431192660550459
1289,인기/Noun,218,90,128,0.0010003779205477626,0.0014216851411688917,0.5871559633027523
1290,추다/Verb,218,116,102,0.0012893759864837828,0.0011329053468689607,0.5321100917431193
1291,서/Modifier,218,103,115,0.0011448769535157726,0.0012772952440189263,0.5275229357798165
1292,늙다/Verb,217,85,132,0.0009448013694062201,0.0014661128018304197,0.6082949308755761
1293,줌/Noun,217,87,130,0.000967031989862837,0.0014438989714996558,0.5990783410138248
1294,덕분/Noun,217,122,95,0.0013560678478536335,0.0010551569407112869,0.5622119815668203
1295,과연/Noun,217,113,104,0.0012560300557988573,0.0011551191771997245,0.5207373271889401
1296,어찌/Noun,217,110,107,0.001222684125113932,0.0011884399226958703,0.5069124423963134
1297,광고/Noun,216,47,169,0.0005224195807304982,0.0018770686629495524,0.7824074074074074
1298,군대/Noun,216,97,119,0.0010781850921459217,0.001321722904680454,0.5509259259259259
1299,유명하다/Adjective,216,108,108,0.001200453504657315,0.0011995468378612525,0.5
1300,짱/Modifier,215,181,34,0.0020118711513238334,0.00037763511562298685,0.8418604651162791
1301,진실/Noun,215,142,73,0.001578374052419803,0.0008108048070728836,0.6604651162790698
1302,이래/Josa,215,118,97,0.0013116066069403997,0.0010773707710420508,0.5488372093023256
1303,자막/Noun,215,101,114,0.0011226463330591557,0.0012661883288535441,0.5302325581395348
1304,여성/Noun,215,106,109,0.001178222884200698,0.0012106537530266344,0.5069767441860465
1305,암/Noun,214,59,155,0.0006558033034701999,0.0017215718506342049,0.7242990654205608
1306,흐름/Noun,214,83,131,0.0009225707489496032,0.0014550058866650377,0.6121495327102804
1307,지키다/Verb,214,106,108,0.001178222884200698,0.0011995468378612525,0.5046728971962616
1308,성인/Noun,214,108,106,0.001200453504657315,0.0011773330075304884,0.5046728971962616
1309,눈물나다/Verb,213,183,30,0.0020341017717804503,0.000333207454961459,0.8591549295774648
1310,젤/Noun,213,123,90,0.001367183158081942,0.000999622364884377,0.5774647887323944
1311,어떤/Modifier,213,107,106,0.0011893381944290066,0.0011773330075304884,0.5023474178403756
1312,성도/Noun,212,25,187,0.0002778827557077118,0.0020769931359264277,0.8820754716981132
1313,한계/Noun,212,38,174,0.00042238178867572195,0.0019326032387764623,0.8207547169811321
1314,그럭저럭/Adverb,212,52,160,0.0005779961318720405,0.0017771064264611148,0.7547169811320755
1315,전/Foreign,212,157,55,0.00174510370584443,0.0006108803340960082,0.7405660377358491
1316,조차/Josa,212,56,156,0.0006224573727852744,0.0017326787657995868,0.7358490566037735
1317,챙기다/Verb,212,145,67,0.0016117199831047284,0.0007441633160805918,0.6839622641509434
1318,심/Noun,212,73,139,0.0008114176466665184,0.0015438612079880934,0.6556603773584906
1319,빠르다/Adjective,212,128,84,0.0014227597092234844,0.0009329808738920852,0.6037735849056604
1320,싫어하다/Adjective,212,90,122,0.0010003779205477626,0.0013550436501765998,0.5754716981132075
1321,사이/Noun,212,119,93,0.0013227219171687082,0.001032943110380523,0.5613207547169812
1322,동생/Noun,212,101,111,0.0011226463330591557,0.0012328675833573983,0.5235849056603774
1323,~^^/Punctuation,211,202,9,0.0022452926661183114,9.99622364884377e-05,0.957345971563981
1324,진정/Noun,211,146,65,0.0016228352933330369,0.0007219494857498279,0.6919431279620853
1325,..?/Punctuation,211,82,129,0.0009114554387212947,0.0014327920563342736,0.6113744075829384
1326,웬만하다/Adjective,211,83,128,0.0009225707489496032,0.0014216851411688917,0.6066350710900474
1327,보시/Noun,211,113,98,0.0012560300557988573,0.0010884776862074327,0.5355450236966824
1328,순/Noun,211,102,109,0.0011337616432874642,0.0012106537530266344,0.5165876777251185
1329,깔끔하다/Adjective,210,167,43,0.001856256808127515,0.00047759735211142456,0.7952380952380952
1330,살짝/Noun,210,140,70,0.001556143431963186,0.0007774840615767377,0.6666666666666666
1331,희다/Adjective,210,96,114,0.0010670697819176133,0.0012661883288535441,0.5428571428571428
1332,만이/Josa,210,112,98,0.0012449147455705488,0.0010884776862074327,0.5333333333333333
1333,발견/Noun,209,175,34,0.0019451792899539827,0.00037763511562298685,0.8373205741626795
1334,리뷰/Noun,209,80,129,0.0008892248182646778,0.0014327920563342736,0.6172248803827751
1335,일어나다/Verb,209,129,80,0.0014338750194517929,0.0008885532132305574,0.6172248803827751
1336,볼거리/Noun,209,93,116,0.001033723851232688,0.0012884021591843082,0.5550239234449761
1337,스럽게/Josa,209,111,98,0.0012337994353422404,0.0010884776862074327,0.5311004784688995
1338,수도/Noun,209,108,101,0.001200453504657315,0.0011217984317035787,0.5167464114832536
1339,개도/Noun,208,25,183,0.0002778827557077118,0.0020325654752649,0.8798076923076923
1340,쩐다/Noun,208,145,63,0.0016117199831047284,0.0006997356554190639,0.6971153846153846
1341,범죄/Noun,208,72,136,0.00080030233643821,0.0015105404624919474,0.6538461538461539
1342,뜻/Noun,208,122,86,0.0013560678478536335,0.0009551947042228491,0.5865384615384616
1343,첫/Noun,208,116,92,0.0012893759864837828,0.0010218361952151409,0.5576923076923077
1344,짱짱/Noun,207,199,8,0.002211946735433386,8.885532132305573e-05,0.961352657004831
1345,부족/Noun,207,29,178,0.0003223439966209457,0.00197703089943799,0.8599033816425121
1346,지난/Noun,207,159,48,0.0017673343263010471,0.0005331319279383344,0.7681159420289855
1347,20년/Number,207,142,65,0.001578374052419803,0.0007219494857498279,0.6859903381642513
1348,야/Exclamation,207,66,141,0.0007336104750683592,0.0015660750383188573,0.6811594202898551
1349,오락/Noun,207,125,82,0.001389413778538559,0.0009107670435613213,0.6038647342995169
1350,와는/Josa,207,118,89,0.0013116066069403997,0.000988515449718995,0.5700483091787439
1351,던지다/Verb,207,110,97,0.001222684125113932,0.0010773707710420508,0.5314009661835749
1352,대충/Noun,206,37,169,0.00041126647844741344,0.0018770686629495524,0.8203883495145631
1353,영환/Noun,206,64,142,0.0007113798546117422,0.0015771819534842392,0.6893203883495146
1354,~~~~/Punctuation,206,123,83,0.001367183158081942,0.0009218739587267032,0.5970873786407767
1355,로서/Noun,206,116,90,0.0012893759864837828,0.000999622364884377,0.5631067961165048
1356,찌다/Verb,206,97,109,0.0010781850921459217,0.0012106537530266344,0.529126213592233
1357,퀄리티/Noun,206,109,97,0.0012115688148856235,0.0010773707710420508,0.529126213592233
1358,이면/Noun,206,97,109,0.0010781850921459217,0.0012106537530266344,0.529126213592233
1359,언/Modifier,206,98,108,0.0010893004023742304,0.0011995468378612525,0.5242718446601942
1360,감탄/Noun,205,177,28,0.0019674099104105996,0.00031099362463069506,0.8634146341463415
1361,빨/Noun,205,54,151,0.0006002267523286575,0.001677144189972677,0.7365853658536585
1362,자연/Noun,205,142,63,0.001578374052419803,0.0006997356554190639,0.6926829268292682
1363,커플/Noun,205,141,64,0.0015672587421914947,0.0007108425705844458,0.6878048780487804
1364,시선/Noun,205,141,64,0.0015672587421914947,0.0007108425705844458,0.6878048780487804
1365,정서/Noun,205,76,129,0.0008447635773514439,0.0014327920563342736,0.6292682926829268
1366,정말로/Adverb,205,125,80,0.001389413778538559,0.0008885532132305574,0.6097560975609756
1367,시청자/Noun,204,41,163,0.00045572771936064734,0.0018104271719572606,0.7990196078431373
1368,홍보/Noun,204,43,161,0.0004779583398172643,0.0017882133416264967,0.7892156862745098
1369,담기다/Verb,204,160,44,0.0017784496365293556,0.0004887042672768066,0.7843137254901961
1370,몸매/Noun,204,67,137,0.0007447257852966677,0.0015216473776573296,0.6715686274509803
1371,우울하다/Adjective,204,123,81,0.001367183158081942,0.0008996601283959393,0.6029411764705882
1372,폭력/Noun,204,94,110,0.0010448391614609964,0.0012217606681920164,0.5392156862745098
1373,b/Alpha,204,101,103,0.0011226463330591557,0.0011440122620343426,0.5049019607843137
1374,기대다/Verb,204,103,101,0.0011448769535157726,0.0011217984317035787,0.5049019607843137
1375,아오/Exclamation,203,29,174,0.0003223439966209457,0.0019326032387764623,0.8571428571428571
1376,뛰다/Verb,203,88,115,0.0009781473000911455,0.0012772952440189263,0.5665024630541872
1377,방/Noun,203,92,111,0.0010226085410043795,0.0012328675833573983,0.5467980295566502
1378,울리다/Verb,202,175,27,0.0019451792899539827,0.0002998867094653131,0.8663366336633663
1379,지르다/Verb,202,42,160,0.00046684302958895584,0.0017771064264611148,0.7920792079207921
1380,소름끼치다/Verb,202,155,47,0.0017228730853878131,0.0005220250127729525,0.7673267326732673
1381,더하다/Adjective,202,117,85,0.0013004912967120913,0.0009440877890574672,0.5792079207920792
1382,열심히/Adverb,202,104,98,0.001155992263744081,0.0010884776862074327,0.5148514851485149
1383,일상/Noun,201,154,47,0.0017117577751595047,0.0005220250127729525,0.7661691542288557
1384,포기/Noun,201,56,145,0.0006224573727852744,0.0016105026989803853,0.7213930348258707
1385,코드/Noun,201,76,125,0.0008447635773514439,0.0013883643956727459,0.6218905472636815
1386,첨/Noun,201,77,124,0.0008558788875797523,0.001377257480507364,0.6169154228855721
1387,유일하다/Adjective,200,119,81,0.0013227219171687082,0.0008996601283959393,0.595
1388,접다/Verb,199,22,177,0.00024453682502278637,0.001965923984272608,0.8894472361809045
1389,30분/Number,199,51,148,0.0005668808216437321,0.001643823444476531,0.7437185929648241
1390,에서의/Josa,199,143,56,0.0015894893626481115,0.0006219872492613901,0.7185929648241206
1391,일이/Noun,199,115,84,0.0012782606762554744,0.0009329808738920852,0.5778894472361809
1392,용서/Noun,199,85,114,0.0009448013694062201,0.0012661883288535441,0.5728643216080402
1393,이따위/Modifier,198,8,190,8.892248182646778e-05,0.0021103138814225738,0.9595959595959596
1394,눈빛/Noun,198,175,23,0.0019451792899539827,0.0002554590488037852,0.8838383838383839
1395,10분/Number,198,36,162,0.000400151168219105,0.0017993202567918786,0.8181818181818182
1396,보라/Noun,198,64,134,0.0007113798546117422,0.0014883266321611835,0.6767676767676768
1397,끼리/Noun,198,71,127,0.0007891870262099015,0.0014105782260035097,0.6414141414141414
1398,사극/Noun,198,123,75,0.001367183158081942,0.0008330186374036475,0.6212121212121212
1399,대의/Noun,198,106,92,0.001178222884200698,0.0010218361952151409,0.5353535353535354
1400,보다도/Josa,198,100,98,0.0011115310228308473,0.0010884776862074327,0.5050505050505051
1401,말로/Noun,197,140,57,0.001556143431963186,0.0006330941644267721,0.7106598984771574
1402,들어오다/Verb,197,87,110,0.000967031989862837,0.0012217606681920164,0.5583756345177665
1403,형/Suffix,197,100,97,0.0011115310228308473,0.0010773707710420508,0.5076142131979695
1404,뜬금/Noun,196,17,179,0.00018896027388124403,0.0019881378146033722,0.9132653061224489
1405,핵/Noun,196,37,159,0.00041126647844741344,0.0017659995112957326,0.8112244897959183
1406,상처/Noun,196,143,53,0.0015894893626481115,0.0005886665037652442,0.7295918367346939
1407,실감/Noun,196,128,68,0.0014227597092234844,0.0007552702312459737,0.6530612244897959
1408,괴물/Noun,196,81,115,0.0009003401284929862,0.0012772952440189263,0.5867346938775511
1409,달/Noun,196,89,107,0.000989262610319454,0.0011884399226958703,0.5459183673469388
1410,다큐멘터리/Noun,196,92,104,0.0010226085410043795,0.0011551191771997245,0.5306122448979592
1411,반성/Noun,196,92,104,0.0010226085410043795,0.0011551191771997245,0.5306122448979592
1412,특별하다/Adjective,196,94,102,0.0010448391614609964,0.0011329053468689607,0.5204081632653061
1413,</Punctuation,196,98,98,0.0010893004023742304,0.0010884776862074327,0.5
1414,끌/Noun,195,22,173,0.00024453682502278637,0.0019214963236110802,0.8871794871794871
1415,힐링/Noun,195,171,24,0.0019007180490407487,0.0002665659639691672,0.8769230769230769
1416,혹시/Noun,195,48,147,0.0005335348909588066,0.0016327165293111491,0.7538461538461538
1417,막판/Noun,195,58,137,0.0006446879932418914,0.0015216473776573296,0.7025641025641025
1418,빛/Noun,195,127,68,0.001411644398995176,0.0007552702312459737,0.6512820512820513
1419,당연하다/Adjective,195,106,89,0.001178222884200698,0.000988515449718995,0.5435897435897435
1420,연애/Noun,195,105,90,0.0011671075739723895,0.000999622364884377,0.5384615384615384
1421,무겁다/Adjective,194,158,36,0.0017562190160727387,0.0003998489459537508,0.8144329896907216
1422,우정/Noun,194,143,51,0.0015894893626481115,0.0005664526734344803,0.7371134020618557
1423,해피엔딩/Noun,194,138,56,0.001533912811506569,0.0006219872492613901,0.711340206185567
1424,죄/Noun,194,67,127,0.0007447257852966677,0.0014105782260035097,0.654639175257732
1425,하루/Noun,194,110,84,0.001222684125113932,0.0009329808738920852,0.5670103092783505
1426,표/Noun,194,109,85,0.0012115688148856235,0.0009440877890574672,0.5618556701030928
1427,우/Adverb,194,89,105,0.000989262610319454,0.0011662260923651065,0.5412371134020618
1428,크게/Noun,194,93,101,0.001033723851232688,0.0011217984317035787,0.520618556701031
1429,내리다/Verb,194,96,98,0.0010670697819176133,0.0010884776862074327,0.5051546391752577
1430,참다/Verb,193,36,157,0.000400151168219105,0.0017437856809649687,0.8134715025906736
1431,으론/Josa,193,112,81,0.0012449147455705488,0.0008996601283959393,0.5803108808290155
1432,남녀/Noun,193,111,82,0.0012337994353422404,0.0009107670435613213,0.5751295336787565
1433,정치/Noun,193,109,84,0.0012115688148856235,0.0009329808738920852,0.5647668393782384
1434,이어지다/Verb,193,107,86,0.0011893381944290066,0.0009551947042228491,0.5544041450777202
1435,짓다/Verb,193,102,91,0.0011337616432874642,0.001010729280049759,0.5284974093264249
1436,감다/Verb,193,93,100,0.001033723851232688,0.0011106915165381968,0.5181347150259067
1437,몰다/Verb,192,64,128,0.0007113798546117422,0.0014216851411688917,0.6666666666666666
1438,하하/Noun,192,96,96,0.0010670697819176133,0.0010662638558766688,0.5
1439,아련하다/Adjective,191,184,7,0.002045217082008759,7.774840615767377e-05,0.9633507853403142
1440,보아/Noun,191,134,57,0.0014894515705933353,0.0006330941644267721,0.7015706806282722
1441,게다가/Noun,191,58,133,0.0006446879932418914,0.0014772197169958016,0.6963350785340314
1442,만큼/Noun,191,115,76,0.0012782606762554744,0.0008441255525690295,0.6020942408376964
1443,어제/Noun,191,112,79,0.0012449147455705488,0.0008774462980651753,0.5863874345549738
1444,개판/Noun,190,8,182,8.892248182646778e-05,0.002021458560099518,0.9578947368421052
1445,뭐임/Noun,190,15,175,0.00016672965342462708,0.0019437101539418443,0.9210526315789473
1446,나머지/Noun,190,38,152,0.00042238178867572195,0.001688251105138059,0.8
1447,벌써/Noun,190,146,44,0.0016228352933330369,0.0004887042672768066,0.7684210526315789
1448,조폭/Noun,190,58,132,0.0006446879932418914,0.0014661128018304197,0.6947368421052632
1449,간/Noun,190,72,118,0.00080030233643821,0.001310615989515072,0.6210526315789474
1450,이기/Noun,190,114,76,0.0012671453660271657,0.0008441255525690295,0.6
1451,만으로/Josa,190,112,78,0.0012449147455705488,0.0008663393828997934,0.5894736842105263
1452,처럼/Noun,190,100,90,0.0011115310228308473,0.000999622364884377,0.5263157894736842
1453,소장/Noun,189,173,16,0.0019229486694973656,0.00017771064264611146,0.9153439153439153
1454,비극/Noun,189,143,46,0.0015894893626481115,0.0005109180976075704,0.7566137566137566
1455,까지는/Josa,189,51,138,0.0005668808216437321,0.0015327542928227115,0.7301587301587301
1456,주/Noun,189,73,116,0.0008114176466665184,0.0012884021591843082,0.6137566137566137
1457,안좋다/Adjective,189,81,108,0.0009003401284929862,0.0011995468378612525,0.5714285714285714
1458,(?)/Punctuation,189,86,103,0.0009559166796345286,0.0011440122620343426,0.544973544973545
1459,만에/Foreign,189,93,96,0.001033723851232688,0.0010662638558766688,0.5079365079365079
1460,벗다/Verb,188,41,147,0.00045572771936064734,0.0016327165293111491,0.7819148936170213
1461,난해하다/Adjective,188,45,143,0.0005001889602738813,0.0015882888686496212,0.7606382978723404
1462,섹스/Noun,188,51,137,0.0005668808216437321,0.0015216473776573296,0.7287234042553191
1463,부끄럽다/Adjective,188,65,123,0.0007224951648400507,0.001366150565341982,0.6542553191489362
1464,등장인물/Noun,188,69,119,0.0007669564057532845,0.001321722904680454,0.6329787234042553
1465,공부/Noun,188,83,105,0.0009225707489496032,0.0011662260923651065,0.5585106382978723
1466,수/Modifier,188,96,92,0.0010670697819176133,0.0010218361952151409,0.5106382978723404
1467,형편/Noun,187,18,169,0.0002000755841095525,0.0018770686629495524,0.9037433155080213
1468,본방/Noun,187,166,21,0.0018451414978992065,0.0002332452184730213,0.8877005347593583
1469,감명/Noun,187,164,23,0.0018229108774425894,0.0002554590488037852,0.8770053475935828
1470,뮤지컬/Noun,187,117,70,0.0013004912967120913,0.0007774840615767377,0.6256684491978609
1471,올해/Noun,187,111,76,0.0012337994353422404,0.0008441255525690295,0.5935828877005348
1472,평이/Noun,187,91,96,0.001011493230776071,0.0010662638558766688,0.5133689839572193
1473,펑펑/Noun,186,179,7,0.0019896405308672165,7.774840615767377e-05,0.9623655913978495
1474,끝내다/Verb,186,63,123,0.0007002645443834338,0.001366150565341982,0.6612903225806451
1475,의문/Noun,186,67,119,0.0007447257852966677,0.001321722904680454,0.6397849462365591
1476,이연걸/Noun,186,117,69,0.0013004912967120913,0.0007663771464113557,0.6290322580645161
1477,국민/Noun,186,106,80,0.001178222884200698,0.0008885532132305574,0.5698924731182796
1478,불구/Noun,186,104,82,0.001155992263744081,0.0009107670435613213,0.5591397849462365
1479,이라서/Josa,186,99,87,0.0011004157126025388,0.0009663016193882312,0.532258064516129
1480,분/Suffix,186,99,87,0.0011004157126025388,0.0009663016193882312,0.532258064516129
1481,러닝/Noun,186,92,94,0.0010226085410043795,0.001044050025545905,0.5053763440860215
1482,그다지/Noun,185,18,167,0.0002000755841095525,0.0018548548326187886,0.9027027027027027
1483,토/Noun,185,44,141,0.0004890736500455727,0.0015660750383188573,0.7621621621621621
1484,떼다/Verb,185,140,45,0.001556143431963186,0.0004998111824421885,0.7567567567567568
1485,인가요/Josa,185,57,128,0.0006335726830135829,0.0014216851411688917,0.6918918918918919
1486,결과/Noun,185,64,121,0.0007113798546117422,0.001343936735011218,0.654054054054054
1487,불가/Noun,184,41,143,0.00045572771936064734,0.0015882888686496212,0.7771739130434783
1488,자유/Noun,184,128,56,0.0014227597092234844,0.0006219872492613901,0.6956521739130435
1489,암튼/Adverb,184,123,61,0.001367183158081942,0.0006775218250882999,0.6684782608695652
1490,새벽/Noun,184,122,62,0.0013560678478536335,0.000688628740253682,0.6630434782608695
1491,꼴/Noun,183,23,160,0.00025565213525109487,0.0017771064264611148,0.8743169398907104
1492,표절/Noun,183,24,159,0.0002667674454794033,0.0017659995112957326,0.8688524590163934
1493,행복/Noun,183,153,30,0.0017006424649311962,0.000333207454961459,0.8360655737704918
1494,딱하다/Adjective,183,31,152,0.00034457461707756266,0.001688251105138059,0.8306010928961749
1495,지도/Noun,183,60,123,0.0006669186136985083,0.001366150565341982,0.6721311475409836
1496,느와르/Noun,183,123,60,0.001367183158081942,0.000666414909922918,0.6721311475409836
1497,기적/Noun,183,104,79,0.001155992263744081,0.0008774462980651753,0.5683060109289617
1498,글쎄/Noun,182,21,161,0.00023342151479447792,0.0017882133416264967,0.8846153846153846
1499,색다르다/Adjective,182,141,41,0.0015672587421914947,0.00045538352178066063,0.7747252747252747
1500,기본/Noun,182,50,132,0.0005557655114154236,0.0014661128018304197,0.7252747252747253
1501,오버/Noun,182,51,131,0.0005668808216437321,0.0014550058866650377,0.7197802197802198
1502,차이/Noun,182,68,114,0.0007558410955249761,0.0012661883288535441,0.6263736263736264
1503,홍콩/Noun,182,82,100,0.0009114554387212947,0.0011106915165381968,0.5494505494505495
1504,악역/Noun,182,94,88,0.0010448391614609964,0.000977408534553613,0.5164835164835165
1505,무협/Noun,182,92,90,0.0010226085410043795,0.000999622364884377,0.5054945054945055
1506,에만/Josa,181,44,137,0.0004890736500455727,0.0015216473776573296,0.7569060773480663
1507,에게는/Josa,181,120,61,0.0013338372273970166,0.0006775218250882999,0.6629834254143646
1508,따위/Noun,181,63,118,0.0007002645443834338,0.001310615989515072,0.6519337016574586
1509,가면/Noun,181,65,116,0.0007224951648400507,0.0012884021591843082,0.6408839779005525
1510,자식/Noun,181,83,98,0.0009225707489496032,0.0010884776862074327,0.5414364640883977
1511,발전/Noun,181,83,98,0.0009225707489496032,0.0010884776862074327,0.5414364640883977
1512,대가/Noun,181,89,92,0.000989262610319454,0.0010218361952151409,0.5082872928176796
1513,니/Modifier,181,92,89,0.0010226085410043795,0.000988515449718995,0.5082872928176796
1514,쓰래/Noun,180,10,170,0.00011115310228308472,0.0018881755781149344,0.9444444444444444
1515,불쾌하다/Adjective,180,23,157,0.00025565213525109487,0.0017437856809649687,0.8722222222222222
1516,느리다/Adjective,180,42,138,0.00046684302958895584,0.0015327542928227115,0.7666666666666667
1517,까진/Josa,180,62,118,0.0006891492341551253,0.001310615989515072,0.6555555555555556
1518,악당/Noun,180,65,115,0.0007224951648400507,0.0012772952440189263,0.6388888888888888
1519,완전하다/Adjective,180,78,102,0.0008669941978080608,0.0011329053468689607,0.5666666666666667
1520,세다/Verb,180,96,84,0.0010670697819176133,0.0009329808738920852,0.5333333333333333
1521,싸다/Verb,179,41,138,0.00045572771936064734,0.0015327542928227115,0.770949720670391
1522,촌스럽다/Adjective,179,50,129,0.0005557655114154236,0.0014327920563342736,0.7206703910614525
1523,모/Modifier,179,67,112,0.0007447257852966677,0.0012439744985227803,0.6256983240223464
1524,많이/Modifier,179,99,80,0.0011004157126025388,0.0008885532132305574,0.553072625698324
1525,인지/Noun,179,82,97,0.0009114554387212947,0.0010773707710420508,0.5418994413407822
1526,날다/Verb,179,85,94,0.0009448013694062201,0.001044050025545905,0.5251396648044693
1527,새/Noun,179,93,86,0.001033723851232688,0.0009551947042228491,0.5195530726256983
1528,시사회/Noun,179,86,93,0.0009559166796345286,0.001032943110380523,0.5195530726256983
1529,비주/Noun,179,87,92,0.000967031989862837,0.0010218361952151409,0.5139664804469274
1530,좀더/Noun,179,89,90,0.000989262610319454,0.000999622364884377,0.5027932960893855
1531,그렇다고/Conjunction,178,34,144,0.00037792054776248805,0.0015993957838150031,0.8089887640449438
1532,그걸/Adverb,178,70,108,0.000778071715981593,0.0011995468378612525,0.6067415730337079
1533,기술/Noun,178,72,106,0.00080030233643821,0.0011773330075304884,0.5955056179775281
1534,새/Modifier,178,74,104,0.0008225329568948269,0.0011551191771997245,0.5842696629213483
1535,무시/Noun,178,74,104,0.0008225329568948269,0.0011551191771997245,0.5842696629213483
1536,이제야/Noun,177,157,20,0.00174510370584443,0.00022213830330763935,0.8870056497175142
1537,적절하다/Adjective,177,137,40,0.0015227975012782607,0.0004442766066152787,0.7740112994350282
1538,깨닫다/Verb,177,133,44,0.0014783362603650269,0.0004887042672768066,0.751412429378531
1539,반복/Noun,177,68,109,0.0007558410955249761,0.0012106537530266344,0.615819209039548
1540,공/Modifier,177,70,107,0.000778071715981593,0.0011884399226958703,0.6045197740112994
1541,입장/Noun,177,83,94,0.0009225707489496032,0.001044050025545905,0.5310734463276836
1542,당/Modifier,177,87,90,0.000967031989862837,0.000999622364884377,0.5084745762711864
1543,오그라들다/Verb,176,19,157,0.00021119089433786097,0.0017437856809649687,0.8920454545454546
1544,긴장/Noun,176,134,42,0.0014894515705933353,0.0004664904369460426,0.7613636363636364
1545,게이/Noun,176,47,129,0.0005224195807304982,0.0014327920563342736,0.7329545454545454
1546,어쩔/Adverb,176,57,119,0.0006335726830135829,0.001321722904680454,0.6761363636363636
1547,외국/Noun,176,57,119,0.0006335726830135829,0.001321722904680454,0.6761363636363636
1548,예/Modifier,176,97,79,0.0010781850921459217,0.0008774462980651753,0.5511363636363636
1549,첫/Modifier,176,88,88,0.0009781473000911455,0.000977408534553613,0.5
1550,언제나/Adverb,175,128,47,0.0014227597092234844,0.0005220250127729525,0.7314285714285714
1551,북한/Noun,175,65,110,0.0007224951648400507,0.0012217606681920164,0.6285714285714286
1552,과는/Josa,175,101,74,0.0011226463330591557,0.0008219117222382655,0.5771428571428572
1553,그린/Noun,175,93,82,0.001033723851232688,0.0009107670435613213,0.5314285714285715
1554,열정/Noun,174,148,26,0.0016450659137896538,0.00028877979429993113,0.8505747126436781
1555,소소하다/Adjective,174,143,31,0.0015894893626481115,0.000344314370126841,0.8218390804597702
1556,빛나다/Verb,174,131,43,0.0014561056399084098,0.00047759735211142456,0.7528735632183908
1557,이루다/Verb,174,126,48,0.0014005290887668675,0.0005331319279383344,0.7241379310344828
1558,불/Noun,174,77,97,0.0008558788875797523,0.0010773707710420508,0.5574712643678161
1559,아픔/Noun,173,146,27,0.0016228352933330369,0.0002998867094653131,0.8439306358381503
1560,창/Noun,173,31,142,0.00034457461707756266,0.0015771819534842392,0.8208092485549133
1561,선생님/Noun,173,129,44,0.0014338750194517929,0.0004887042672768066,0.7456647398843931
1562,병/Noun,173,51,122,0.0005668808216437321,0.0013550436501765998,0.7052023121387283
1563,쇼/Noun,173,55,118,0.000611342062556966,0.001310615989515072,0.6820809248554913
1564,달라/Noun,173,81,92,0.0009003401284929862,0.0010218361952151409,0.5317919075144508
1565,강렬하다/Adjective,172,147,25,0.0016339506035613453,0.0002776728791345492,0.8546511627906976
1566,화나다/Verb,172,30,142,0.00033345930684925416,0.0015771819534842392,0.8255813953488372
1567,짝/Noun,172,34,138,0.00037792054776248805,0.0015327542928227115,0.8023255813953488
1568,양/Modifier,172,52,120,0.0005779961318720405,0.001332829819845836,0.6976744186046512
1569,디즈니/Noun,172,114,58,0.0012671453660271657,0.0006442010795921541,0.6627906976744186
1570,늘/Noun,172,101,71,0.0011226463330591557,0.0007885909767421196,0.5872093023255814
1571,종교/Noun,172,80,92,0.0008892248182646778,0.0010218361952151409,0.5348837209302325
1572,는걸/Noun,172,81,91,0.0009003401284929862,0.001010729280049759,0.5290697674418605
1573,대화/Noun,172,86,86,0.0009559166796345286,0.0009551947042228491,0.5
1574,질리/Noun,171,160,11,0.0017784496365293556,0.00012217606681920164,0.935672514619883
1575,쩝/Adverb,171,28,143,0.0003112286863926372,0.0015882888686496212,0.8362573099415205
1576,극치/Noun,171,28,143,0.0003112286863926372,0.0015882888686496212,0.8362573099415205
1577,까지도/Josa,171,135,36,0.0015005668808216438,0.0003998489459537508,0.7894736842105263
1578,밥/Noun,171,47,124,0.0005224195807304982,0.001377257480507364,0.7251461988304093
1579,희생/Noun,171,112,59,0.0012449147455705488,0.000655307994757536,0.6549707602339181
1580,채우다/Verb,171,74,97,0.0008225329568948269,0.0010773707710420508,0.5672514619883041
1581,외모/Noun,171,95,76,0.0010559544716893048,0.0008441255525690295,0.5555555555555556
1582,방식/Noun,171,87,84,0.000967031989862837,0.0009329808738920852,0.5087719298245614
1583,찡하다/Adjective,170,165,5,0.0018340261876708978,5.5534575826909837e-05,0.9705882352941176
1584,주기도/Noun,170,6,164,6.669186136985083e-05,0.0018215340871226425,0.9647058823529412
1585,노답/Noun,170,14,156,0.0001556143431963186,0.0017326787657995868,0.9176470588235294
1586,빡치다/Adjective,170,27,143,0.00030011337616432876,0.0015882888686496212,0.8411764705882353
1587,남편/Noun,170,55,115,0.000611342062556966,0.0012772952440189263,0.6764705882352942
1588,분노/Noun,170,67,103,0.0007447257852966677,0.0011440122620343426,0.6058823529411764
1589,맡다/Verb,170,74,96,0.0008225329568948269,0.0010662638558766688,0.5647058823529412
1590,대표/Noun,170,75,95,0.0008336482671231354,0.0010551569407112869,0.5588235294117647
1591,흘러가다/Verb,170,75,95,0.0008336482671231354,0.0010551569407112869,0.5588235294117647
1592,형/Noun,170,83,87,0.0009225707489496032,0.0009663016193882312,0.5117647058823529
1593,죄다/Adverb,169,19,150,0.00021119089433786097,0.001666037274807295,0.8875739644970414
1594,싸구려/Noun,169,21,148,0.00023342151479447792,0.001643823444476531,0.8757396449704142
1595,때우다/Verb,169,36,133,0.000400151168219105,0.0014772197169958016,0.7869822485207101
1596,에로/Josa,169,39,130,0.0004334970989040304,0.0014438989714996558,0.7692307692307693
1597,마저/Josa,169,51,118,0.0005668808216437321,0.001310615989515072,0.6982248520710059
1598,헐리우드/Noun,169,52,117,0.0005779961318720405,0.0012995090743496902,0.6923076923076923
1599,춤/Noun,169,96,73,0.0010670697819176133,0.0008108048070728836,0.5680473372781065
1600,지는/Josa,169,93,76,0.001033723851232688,0.0008441255525690295,0.5502958579881657
1601,섬세하다/Adjective,168,146,22,0.0016228352933330369,0.0002443521336384033,0.8690476190476191
1602,풋풋하다/Adjective,168,144,24,0.00160060467287642,0.0002665659639691672,0.8571428571428571
1603,어머니/Noun,168,123,45,0.001367183158081942,0.0004998111824421885,0.7321428571428571
1604,=/Punctuation,168,55,113,0.000611342062556966,0.0012550814136881622,0.6726190476190477
1605,청소년/Noun,168,62,106,0.0006891492341551253,0.0011773330075304884,0.6309523809523809
1606,시각/Noun,168,102,66,0.0011337616432874642,0.0007330564009152098,0.6071428571428571
1607,왕/Noun,168,75,93,0.0008336482671231354,0.001032943110380523,0.5535714285714286
1608,로만/Noun,168,78,90,0.0008669941978080608,0.000999622364884377,0.5357142857142857
1609,타/Modifier,168,80,88,0.0008892248182646778,0.000977408534553613,0.5238095238095238
1610,계/Suffix,168,84,84,0.0009336860591779117,0.0009329808738920852,0.5
1611,제로/Noun,167,16,151,0.00017784496365293555,0.001677144189972677,0.9041916167664671
1612,유발/Noun,167,21,146,0.00023342151479447792,0.0016216096141457672,0.874251497005988
1613,필름/Noun,167,34,133,0.00037792054776248805,0.0014772197169958016,0.7964071856287425
1614,조절/Noun,167,40,127,0.0004446124091323389,0.0014105782260035097,0.7604790419161677
1615,놓치다/Verb,167,125,42,0.001389413778538559,0.0004664904369460426,0.7485029940119761
1616,본인/Noun,167,56,111,0.0006224573727852744,0.0012328675833573983,0.6646706586826348
1617,_/Punctuation,167,106,61,0.001178222884200698,0.0006775218250882999,0.6347305389221557
1618,싸움/Noun,167,66,101,0.0007336104750683592,0.0011217984317035787,0.6047904191616766
1619,이미지/Noun,167,71,96,0.0007891870262099015,0.0010662638558766688,0.5748502994011976
1620,이나/Noun,167,72,95,0.00080030233643821,0.0010551569407112869,0.5688622754491018
1621,열/Modifier,167,84,83,0.0009336860591779117,0.0009218739587267032,0.5029940119760479
1622,미드/Noun,166,111,55,0.0012337994353422404,0.0006108803340960082,0.6686746987951807
1623,실력/Noun,166,57,109,0.0006335726830135829,0.0012106537530266344,0.6566265060240963
1624,학생/Noun,166,95,71,0.0010559544716893048,0.0007885909767421196,0.572289156626506
1625,오래되다/Adjective,166,90,76,0.0010003779205477626,0.0008441255525690295,0.5421686746987951
1626,단지/Noun,166,83,83,0.0009225707489496032,0.0009218739587267032,0.5
1627,조잡하다/Adjective,165,7,158,7.78071715981593e-05,0.0017548925961303507,0.9575757575757575
1628,호러/Noun,165,58,107,0.0006446879932418914,0.0011884399226958703,0.6484848484848484
1629,방금/Noun,165,104,61,0.001155992263744081,0.0006775218250882999,0.6303030303030303
1630,금/Noun,165,61,104,0.0006780339239268168,0.0011551191771997245,0.6303030303030303
1631,라인/Noun,165,63,102,0.0007002645443834338,0.0011329053468689607,0.6181818181818182
1632,깨다/Verb,165,69,96,0.0007669564057532845,0.0010662638558766688,0.5818181818181818
1633,비판/Noun,165,94,71,0.0010448391614609964,0.0007885909767421196,0.5696969696969697
1634,편의/Noun,165,73,92,0.0008114176466665184,0.0010218361952151409,0.5575757575757576
1635,최/Noun,165,86,79,0.0009559166796345286,0.0008774462980651753,0.5212121212121212
1636,굿굿/Noun,164,161,3,0.001789564946757664,3.33207454961459e-05,0.9817073170731707
1637,좋아지다/Verb,164,134,30,0.0014894515705933353,0.000333207454961459,0.8170731707317073
1638,통쾌하다/Adjective,164,128,36,0.0014227597092234844,0.0003998489459537508,0.7804878048780488
1639,심각하다/Adjective,164,43,121,0.0004779583398172643,0.001343936735011218,0.7378048780487805
1640,맨날/Adverb,164,58,106,0.0006446879932418914,0.0011773330075304884,0.6463414634146342
1641,쫌/Noun,164,59,105,0.0006558033034701999,0.0011662260923651065,0.6402439024390244
1642,과의/Josa,164,92,72,0.0010226085410043795,0.0007996978919075016,0.5609756097560976
1643,해석/Noun,164,88,76,0.0009781473000911455,0.0008441255525690295,0.5365853658536586
1644,전문가/Noun,164,87,77,0.000967031989862837,0.0008552324677344115,0.5304878048780488
1645,지구/Noun,164,87,77,0.000967031989862837,0.0008552324677344115,0.5304878048780488
1646,어휴/Exclamation,163,21,142,0.00023342151479447792,0.0015771819534842392,0.8711656441717791
1647,실패/Noun,163,27,136,0.00030011337616432876,0.0015105404624919474,0.8343558282208589
1648,아줌마/Noun,163,46,117,0.0005113042705021897,0.0012995090743496902,0.7177914110429447
1649,닮다/Verb,163,99,64,0.0011004157126025388,0.0007108425705844458,0.6073619631901841
1650,동안/Foreign,163,70,93,0.000778071715981593,0.001032943110380523,0.5705521472392638
1651,동물/Noun,163,92,71,0.0010226085410043795,0.0007885909767421196,0.5644171779141104
1652,담/Noun,163,75,88,0.0008336482671231354,0.000977408534553613,0.5398773006134969
1653,훨/Noun,163,75,88,0.0008336482671231354,0.000977408534553613,0.5398773006134969
1654,다가오다/Verb,162,132,30,0.0014672209501367184,0.000333207454961459,0.8148148148148148
1655,은근/Noun,162,127,35,0.001411644398995176,0.00038874203078836884,0.7839506172839507
1656,심장/Noun,162,126,36,0.0014005290887668675,0.0003998489459537508,0.7777777777777778
1657,바라보다/Verb,162,126,36,0.0014005290887668675,0.0003998489459537508,0.7777777777777778
1658,씁쓸하다/Adjective,162,120,42,0.0013338372273970166,0.0004664904369460426,0.7407407407407407
1659,편하다/Adjective,162,108,54,0.001200453504657315,0.0005997734189306263,0.6666666666666666
1660,따라가다/Verb,162,56,106,0.0006224573727852744,0.0011773330075304884,0.654320987654321
1661,조합/Noun,162,98,64,0.0010893004023742304,0.0007108425705844458,0.6049382716049383
1662,낳다/Verb,162,89,73,0.000989262610319454,0.0008108048070728836,0.5493827160493827
1663,방법/Noun,162,86,76,0.0009559166796345286,0.0008441255525690295,0.5308641975308642
1664,돌다/Verb,162,85,77,0.0009448013694062201,0.0008552324677344115,0.5246913580246914
1665,기르다/Verb,162,80,82,0.0008892248182646778,0.0009107670435613213,0.5061728395061729
1666,없어지다/Verb,161,37,124,0.00041126647844741344,0.001377257480507364,0.7701863354037267
1667,숨다/Verb,161,121,40,0.001344952537625325,0.0004442766066152787,0.7515527950310559
1668,ㄷㄷㄷ/KoreanParticle,161,96,65,0.0010670697819176133,0.0007219494857498279,0.5962732919254659
1669,즈/Modifier,161,92,69,0.0010226085410043795,0.0007663771464113557,0.5714285714285714
1670,인/Suffix,161,70,91,0.000778071715981593,0.001010729280049759,0.5652173913043478
1671,1시간/Number,160,35,125,0.0003890358579907965,0.0013883643956727459,0.78125
1672,늦다/Verb,160,123,37,0.001367183158081942,0.00041095586111913277,0.76875
1673,아이돌/Noun,160,54,106,0.0006002267523286575,0.0011773330075304884,0.6625
1674,한국인/Noun,160,57,103,0.0006335726830135829,0.0011440122620343426,0.64375
1675,입다/Verb,160,59,101,0.0006558033034701999,0.0011217984317035787,0.63125
1676,히어로/Noun,160,97,63,0.0010781850921459217,0.0006997356554190639,0.60625
1677,뽑다/Verb,160,68,92,0.0007558410955249761,0.0010218361952151409,0.575
1678,악/Noun,160,74,86,0.0008225329568948269,0.0009551947042228491,0.5375
1679,팀/Noun,160,80,80,0.0008892248182646778,0.0008885532132305574,0.5
1680,명품/Noun,159,135,24,0.0015005668808216438,0.0002665659639691672,0.8490566037735849
1681,존경/Noun,159,126,33,0.0014005290887668675,0.0003665282004576049,0.7924528301886793
1682,더불다/Verb,159,117,42,0.0013004912967120913,0.0004664904369460426,0.7358490566037735
1683,신나다/Adjective,159,111,48,0.0012337994353422404,0.0005331319279383344,0.6981132075471698
1684,이끌다/Verb,159,94,65,0.0010448391614609964,0.0007219494857498279,0.5911949685534591
1685,꾸다/Verb,159,83,76,0.0009225707489496032,0.0008441255525690295,0.5220125786163522
1686,시트콤/Noun,158,109,49,0.0012115688148856235,0.0005442388431037163,0.689873417721519
1687,어쩔/Modifier,158,50,108,0.0005557655114154236,0.0011995468378612525,0.6835443037974683
1688,성/Noun,158,56,102,0.0006224573727852744,0.0011329053468689607,0.6455696202531646
1689,대부분/Noun,158,60,98,0.0006669186136985083,0.0010884776862074327,0.620253164556962
1690,겁니다/Verb,158,93,65,0.001033723851232688,0.0007219494857498279,0.5886075949367089
1691,국내/Noun,158,87,71,0.000967031989862837,0.0007885909767421196,0.5506329113924051
1692,가깝다/Adjective,158,77,81,0.0008558788875797523,0.0008996601283959393,0.5126582278481012
1693,짠하다/Adjective,157,146,11,0.0016228352933330369,0.00012217606681920164,0.9299363057324841
1694,푹/Noun,157,137,20,0.0015227975012782607,0.00022213830330763935,0.8726114649681529
1695,만족/Noun,157,113,44,0.0012560300557988573,0.0004887042672768066,0.7197452229299363
1696,이니/Josa,157,56,101,0.0006224573727852744,0.0011217984317035787,0.643312101910828
1697,주말/Noun,157,99,58,0.0011004157126025388,0.0006442010795921541,0.6305732484076433
1698,신분/Noun,157,99,58,0.0011004157126025388,0.0006442010795921541,0.6305732484076433
1699,쵝오/Noun,156,151,5,0.0016784118444745793,5.5534575826909837e-05,0.967948717948718
1700,세기/Noun,156,90,66,0.0010003779205477626,0.0007330564009152098,0.5769230769230769
1701,직접/Noun,156,87,69,0.000967031989862837,0.0007663771464113557,0.5576923076923077
1702,분명/Noun,156,73,83,0.0008114176466665184,0.0009218739587267032,0.532051282051282
1703,거슬리다/Verb,155,35,120,0.0003890358579907965,0.001332829819845836,0.7741935483870968
1704,전개도/Noun,155,54,101,0.0006002267523286575,0.0011217984317035787,0.6516129032258065
1705,30/Number,155,98,57,0.0010893004023742304,0.0006330941644267721,0.632258064516129
1706,의리/Noun,155,89,66,0.000989262610319454,0.0007330564009152098,0.5741935483870968
1707,미모/Noun,155,88,67,0.0009781473000911455,0.0007441633160805918,0.567741935483871
1708,줍다/Verb,155,72,83,0.00080030233643821,0.0009218739587267032,0.535483870967742
1709,짝퉁/Noun,154,7,147,7.78071715981593e-05,0.0016327165293111491,0.9545454545454546
1710,개뿔/Noun,154,7,147,7.78071715981593e-05,0.0016327165293111491,0.9545454545454546
1711,양심/Noun,154,28,126,0.0003112286863926372,0.0013994713108381278,0.8181818181818182
1712,????/Punctuation,154,36,118,0.000400151168219105,0.001310615989515072,0.7662337662337663
1713,누군가/Noun,154,118,36,0.0013116066069403997,0.0003998489459537508,0.7662337662337663
1714,그거/Noun,154,45,109,0.0005001889602738813,0.0012106537530266344,0.7077922077922078
1715,개념/Noun,154,49,105,0.0005446502011871152,0.0011662260923651065,0.6818181818181818
1716,이자/Noun,154,103,51,0.0011448769535157726,0.0005664526734344803,0.6688311688311688
1717,시원하다/Adjective,154,103,51,0.0011448769535157726,0.0005664526734344803,0.6688311688311688
1718,으로만/Josa,154,55,99,0.000611342062556966,0.0010995846013728146,0.6428571428571429
1719,끼/Noun,154,58,96,0.0006446879932418914,0.0010662638558766688,0.6233766233766234
1720,돌아오다/Verb,154,93,61,0.001033723851232688,0.0006775218250882999,0.6038961038961039
1721,민망하다/Adjective,153,16,137,0.00017784496365293555,0.0015216473776573296,0.8954248366013072
1722,망/Noun,153,19,134,0.00021119089433786097,0.0014883266321611835,0.8758169934640523
1723,연예인/Noun,153,27,126,0.00030011337616432876,0.0013994713108381278,0.8235294117647058
1724,도안/Noun,153,38,115,0.00042238178867572195,0.0012772952440189263,0.7516339869281046
1725,해내다/Verb,153,114,39,0.0012671453660271657,0.0004331696914498967,0.7450980392156863
1726,가요/Noun,153,39,114,0.0004334970989040304,0.0012661883288535441,0.7450980392156863
1727,전반/Noun,153,49,104,0.0005446502011871152,0.0011551191771997245,0.6797385620915033
1728,진리/Noun,153,101,52,0.0011226463330591557,0.0005775595885998623,0.6601307189542484
1729,이정/Noun,153,60,93,0.0006669186136985083,0.001032943110380523,0.6078431372549019
1730,이란/Noun,153,91,62,0.001011493230776071,0.000688628740253682,0.5947712418300654
1731,에피소드/Noun,153,70,83,0.000778071715981593,0.0009218739587267032,0.5424836601307189
1732,애기/Noun,153,74,79,0.0008225329568948269,0.0008774462980651753,0.5163398692810458
1733,돌아보다/Verb,152,143,9,0.0015894893626481115,9.99622364884377e-05,0.9407894736842105
1734,의외로/Adverb,152,129,23,0.0014338750194517929,0.0002554590488037852,0.8486842105263158
1735,여행/Noun,152,104,48,0.001155992263744081,0.0005331319279383344,0.6842105263157895
1736,향/Noun,152,100,52,0.0011115310228308473,0.0005775595885998623,0.6578947368421053
1737,19/Number,152,56,96,0.0006224573727852744,0.0010662638558766688,0.631578947368421
1738,레알/Noun,152,63,89,0.0007002645443834338,0.000988515449718995,0.5855263157894737
1739,생활/Noun,152,87,65,0.000967031989862837,0.0007219494857498279,0.5723684210526315
1740,찝찝하다/Adjective,151,30,121,0.00033345930684925416,0.001343936735011218,0.8013245033112583
1741,사기/Noun,151,33,118,0.0003668052375341796,0.001310615989515072,0.7814569536423841
1742,과장/Noun,151,51,100,0.0005668808216437321,0.0011106915165381968,0.6622516556291391
1743,스스로/Noun,151,86,65,0.0009559166796345286,0.0007219494857498279,0.5695364238410596
1744,쩌/Noun,151,79,72,0.0008781095080363693,0.0007996978919075016,0.5231788079470199
1745,봣는데/Noun,151,79,72,0.0008781095080363693,0.0007996978919075016,0.5231788079470199
1746,단/Modifier,151,72,79,0.00080030233643821,0.0008774462980651753,0.5231788079470199
1747,테러/Noun,151,78,73,0.0008669941978080608,0.0008108048070728836,0.5165562913907285
1748,가득하다/Adjective,151,76,75,0.0008447635773514439,0.0008330186374036475,0.5033112582781457
1749,신다/Verb,151,76,75,0.0008447635773514439,0.0008330186374036475,0.5033112582781457
1750,라지/Noun,150,18,132,0.0002000755841095525,0.0014661128018304197,0.88
1751,날리다/Verb,150,30,120,0.00033345930684925416,0.001332829819845836,0.8
1752,갈등/Noun,150,95,55,0.0010559544716893048,0.0006108803340960082,0.6333333333333333
1753,하나로/Noun,150,88,62,0.0009781473000911455,0.000688628740253682,0.5866666666666667
1754,한참/Noun,150,62,88,0.0006891492341551253,0.000977408534553613,0.5866666666666667
1755,헐리웃/Noun,150,66,84,0.0007336104750683592,0.0009329808738920852,0.56
1756,막히다/Verb,150,84,66,0.0009336860591779117,0.0007330564009152098,0.56
1757,로봇/Noun,150,83,67,0.0009225707489496032,0.0007441633160805918,0.5533333333333333
1758,문/Modifier,150,67,83,0.0007447257852966677,0.0009218739587267032,0.5533333333333333
1759,유/Noun,150,68,82,0.0007558410955249761,0.0009107670435613213,0.5466666666666666
1760,근/Modifier,150,76,74,0.0008447635773514439,0.0008219117222382655,0.5066666666666667
1761,낭비하다/Adjective,149,2,147,2.2230620456616944e-05,0.0016327165293111491,0.9865771812080537
1762,단연/Noun,149,128,21,0.0014227597092234844,0.0002332452184730213,0.8590604026845637
1763,무척/Noun,149,114,35,0.0012671453660271657,0.00038874203078836884,0.7651006711409396
1764,성장/Noun,149,110,39,0.001222684125113932,0.0004331696914498967,0.738255033557047
1765,......../Punctuation,149,45,104,0.0005001889602738813,0.0011551191771997245,0.697986577181208
1766,번째/Suffix,149,95,54,0.0010559544716893048,0.0005997734189306263,0.6375838926174496
1767,초등학생/Noun,149,56,93,0.0006224573727852744,0.001032943110380523,0.6241610738255033
1768,연속/Noun,149,59,90,0.0006558033034701999,0.000999622364884377,0.6040268456375839
1769,주변/Noun,149,88,61,0.0009781473000911455,0.0006775218250882999,0.5906040268456376
1770,경험/Noun,149,87,62,0.000967031989862837,0.000688628740253682,0.5838926174496645
1771,한데/Eomi,149,63,86,0.0007002645443834338,0.0009551947042228491,0.5771812080536913
1772,섹시하다/Adjective,149,84,65,0.0009336860591779117,0.0007219494857498279,0.5637583892617449
1773,&/Punctuation,149,81,68,0.0009003401284929862,0.0007552702312459737,0.5436241610738255
1774,오르다/Verb,149,81,68,0.0009003401284929862,0.0007552702312459737,0.5436241610738255
1775,이도/Noun,148,5,143,5.557655114154236e-05,0.0015882888686496212,0.9662162162162162
1776,상/Noun,148,44,104,0.0004890736500455727,0.0011551191771997245,0.7027027027027027
1777,피해자/Noun,148,44,104,0.0004890736500455727,0.0011551191771997245,0.7027027027027027
1778,감히/Noun,148,97,51,0.0010781850921459217,0.0005664526734344803,0.6554054054054054
1779,뒷/Modifier,148,53,95,0.000589111442100349,0.0010551569407112869,0.6418918918918919
1780,김기덕/Noun,148,63,85,0.0007002645443834338,0.0009440877890574672,0.5743243243243243
1781,꽝/Noun,147,8,139,8.892248182646778e-05,0.0015438612079880934,0.9455782312925171
1782,라이/Noun,147,28,119,0.0003112286863926372,0.001321722904680454,0.8095238095238095
1783,편견/Noun,147,103,44,0.0011448769535157726,0.0004887042672768066,0.7006802721088435
1784,베스트/Noun,147,97,50,0.0010781850921459217,0.0005553457582690984,0.6598639455782312
1785,이여/Josa,147,86,61,0.0009559166796345286,0.0006775218250882999,0.5850340136054422
1786,견자단/Noun,147,68,79,0.0007558410955249761,0.0008774462980651753,0.5374149659863946
1787,맨/Noun,147,77,70,0.0008558788875797523,0.0007774840615767377,0.5238095238095238
1788,으로서/Josa,147,76,71,0.0008447635773514439,0.0007885909767421196,0.5170068027210885
1789,사수/Noun,146,132,14,0.0014672209501367184,0.00015549681231534753,0.9041095890410958
1790,허세/Noun,146,18,128,0.0002000755841095525,0.0014216851411688917,0.8767123287671232
1791,와우/Noun,146,125,21,0.001389413778538559,0.0002332452184730213,0.8561643835616438
1792,명성/Noun,146,25,121,0.0002778827557077118,0.001343936735011218,0.8287671232876712
1793,얘/Noun,146,40,106,0.0004446124091323389,0.0011773330075304884,0.726027397260274
1794,올라가다/Verb,146,98,48,0.0010893004023742304,0.0005331319279383344,0.6712328767123288
1795,확/Noun,146,50,96,0.0005557655114154236,0.0010662638558766688,0.6575342465753424
1796,의식/Noun,146,61,85,0.0006780339239268168,0.0009440877890574672,0.5821917808219178
1797,부모/Noun,146,80,66,0.0008892248182646778,0.0007330564009152098,0.547945205479452
1798,아마/Noun,146,78,68,0.0008669941978080608,0.0007552702312459737,0.5342465753424658
1799,검색/Noun,146,78,68,0.0008669941978080608,0.0007552702312459737,0.5342465753424658
1800,성공하다/Adjective,146,69,77,0.0007669564057532845,0.0008552324677344115,0.5273972602739726
1801,카/Noun,146,76,70,0.0008447635773514439,0.0007774840615767377,0.5205479452054794
1802,맥/Noun,146,76,70,0.0008447635773514439,0.0007774840615767377,0.5205479452054794
1803,개막/Noun,145,9,136,0.00010003779205477625,0.0015105404624919474,0.9379310344827586
1804,생생하다/Adjective,145,134,11,0.0014894515705933353,0.00012217606681920164,0.9241379310344827
1805,^/Punctuation,145,102,43,0.0011337616432874642,0.00047759735211142456,0.7034482758620689
1806,연결/Noun,145,50,95,0.0005557655114154236,0.0010551569407112869,0.6551724137931034
1807,영어/Noun,145,59,86,0.0006558033034701999,0.0009551947042228491,0.593103448275862
1808,외계인/Noun,145,64,81,0.0007113798546117422,0.0008996601283959393,0.5586206896551724
1809,뭉클하다/Adjective,144,139,5,0.0015450281217348775,5.5534575826909837e-05,0.9652777777777778
1810,마이너스/Noun,144,7,137,7.78071715981593e-05,0.0015216473776573296,0.9513888888888888
1811,밋밋하다/Adjective,144,18,126,0.0002000755841095525,0.0013994713108381278,0.875
1812,묘/Noun,144,118,26,0.0013116066069403997,0.00028877979429993113,0.8194444444444444
1813,...?/Punctuation,144,54,90,0.0006002267523286575,0.000999622364884377,0.625
1814,만큼은/Josa,144,90,54,0.0010003779205477626,0.0005997734189306263,0.625
1815,쪽/Noun,144,57,87,0.0006335726830135829,0.0009663016193882312,0.6041666666666666
1816,오브/Noun,144,74,70,0.0008225329568948269,0.0007774840615767377,0.5138888888888888
1817,저/Modifier,143,26,117,0.00028899806593602026,0.0012995090743496902,0.8181818181818182
1818,풍경/Noun,143,101,42,0.0011226463330591557,0.0004664904369460426,0.7062937062937062
1819,처/Noun,143,44,99,0.0004890736500455727,0.0010995846013728146,0.6923076923076923
1820,드물다/Adjective,143,98,45,0.0010893004023742304,0.0004998111824421885,0.6853146853146853
1821,무언가/Noun,143,97,46,0.0010781850921459217,0.0005109180976075704,0.6783216783216783
1822,이보/Noun,143,79,64,0.0008781095080363693,0.0007108425705844458,0.5524475524475524
1823,이든/Josa,143,77,66,0.0008558788875797523,0.0007330564009152098,0.5384615384615384
1824,ㅉㅉㅉ/KoreanParticle,142,15,127,0.00016672965342462708,0.0014105782260035097,0.8943661971830986
1825,싸이코/Noun,142,29,113,0.0003223439966209457,0.0012550814136881622,0.795774647887324
1826,만들기/Noun,142,30,112,0.00033345930684925416,0.0012439744985227803,0.7887323943661971
1827,자연스럽다/Adjective,142,112,30,0.0012449147455705488,0.000333207454961459,0.7887323943661971
1828,복잡하다/Adjective,142,92,50,0.0010226085410043795,0.0005553457582690984,0.647887323943662
1829,개성/Noun,142,87,55,0.000967031989862837,0.0006108803340960082,0.6126760563380281
1830,도전/Noun,142,73,69,0.0008114176466665184,0.0007663771464113557,0.5140845070422535
1831,달달/Noun,141,125,16,0.001389413778538559,0.00017771064264611146,0.8865248226950354
1832,어린시절/Noun,141,123,18,0.001367183158081942,0.0001999244729768754,0.8723404255319149
1833,정체/Noun,141,30,111,0.00033345930684925416,0.0012328675833573983,0.7872340425531915
1834,막장드라마/Noun,141,32,109,0.0003556899273058711,0.0012106537530266344,0.7730496453900709
1835,왠/Modifier,141,33,108,0.0003668052375341796,0.0011995468378612525,0.7659574468085106
1836,마이클/Noun,141,91,50,0.001011493230776071,0.0005553457582690984,0.6453900709219859
1837,옆/Noun,141,63,78,0.0007002645443834338,0.0008663393828997934,0.5531914893617021
1838,무지/Noun,141,77,64,0.0008558788875797523,0.0007108425705844458,0.5460992907801419
1839,조/Noun,141,65,76,0.0007224951648400507,0.0008441255525690295,0.5390070921985816
1840,기준/Noun,141,75,66,0.0008336482671231354,0.0007330564009152098,0.5319148936170213
1841,끌리다/Verb,141,73,68,0.0008114176466665184,0.0007552702312459737,0.5177304964539007
1842,♥♥/Foreign,140,140,0,0.001556143431963186,0.0,1.0
1843,숨기다/Verb,140,114,26,0.0012671453660271657,0.00028877979429993113,0.8142857142857143
1844,세월/Noun,140,105,35,0.0011671075739723895,0.00038874203078836884,0.75
1845,캐리/Noun,140,104,36,0.001155992263744081,0.0003998489459537508,0.7428571428571429
1846,변화/Noun,140,91,49,0.001011493230776071,0.0005442388431037163,0.65
1847,빨다/Verb,140,54,86,0.0006002267523286575,0.0009551947042228491,0.6142857142857143
1848,으로써/Josa,140,83,57,0.0009225707489496032,0.0006330941644267721,0.5928571428571429
1849,코난/Noun,140,82,58,0.0009114554387212947,0.0006442010795921541,0.5857142857142857
1850,이상은/Noun,140,67,73,0.0007447257852966677,0.0008108048070728836,0.5214285714285715
1851,등등/Noun,140,68,72,0.0007558410955249761,0.0007996978919075016,0.5142857142857142
1852,일품/Noun,139,126,13,0.0014005290887668675,0.00014438989714996557,0.9064748201438849
1853,젠장/Noun,139,22,117,0.00024453682502278637,0.0012995090743496902,0.841726618705036
1854,기회/Noun,139,106,33,0.001178222884200698,0.0003665282004576049,0.762589928057554
1855,카리스마/Noun,139,105,34,0.0011671075739723895,0.00037763511562298685,0.7553956834532374
1856,남아/Noun,139,97,42,0.0010781850921459217,0.0004664904369460426,0.697841726618705
1857,깎다/Verb,139,61,78,0.0006780339239268168,0.0008663393828997934,0.5611510791366906
1858,아/Noun,138,27,111,0.00030011337616432876,0.0012328675833573983,0.8043478260869565
1859,칼/Noun,138,41,97,0.00045572771936064734,0.0010773707710420508,0.7028985507246377
1860,신경/Noun,138,42,96,0.00046684302958895584,0.0010662638558766688,0.6956521739130435
1861,자살/Noun,138,43,95,0.0004779583398172643,0.0010551569407112869,0.6884057971014492
1862,오빠/Noun,138,95,43,0.0010559544716893048,0.00047759735211142456,0.6884057971014492
1863,맨/Modifier,138,51,87,0.0005668808216437321,0.0009663016193882312,0.6304347826086957
1864,면서/Noun,138,84,54,0.0009336860591779117,0.0005997734189306263,0.6086956521739131
1865,덜/Noun,138,57,81,0.0006335726830135829,0.0008996601283959393,0.5869565217391305
1866,시청/Noun,138,74,64,0.0008225329568948269,0.0007108425705844458,0.5362318840579711
1867,니깐/Josa,138,74,64,0.0008225329568948269,0.0007108425705844458,0.5362318840579711
1868,얼마/Noun,138,67,71,0.0007447257852966677,0.0007885909767421196,0.5144927536231884
1869,포르노/Noun,137,16,121,0.00017784496365293555,0.001343936735011218,0.8832116788321168
1870,C/Alpha,137,16,121,0.00017784496365293555,0.001343936735011218,0.8832116788321168
1871,응원/Noun,137,116,21,0.0012893759864837828,0.0002332452184730213,0.8467153284671532
1872,겨/Noun,137,26,111,0.00028899806593602026,0.0012328675833573983,0.8102189781021898
1873,압권/Noun,137,111,26,0.0012337994353422404,0.00028877979429993113,0.8102189781021898
1874,다양하다/Adjective,137,99,38,0.0011004157126025388,0.00042206277628451476,0.7226277372262774
1875,모으다/Verb,137,39,98,0.0004334970989040304,0.0010884776862074327,0.7153284671532847
1876,형사/Noun,137,43,94,0.0004779583398172643,0.001044050025545905,0.6861313868613139
1877,만해/Noun,137,91,46,0.001011493230776071,0.0005109180976075704,0.6642335766423357
1878,",,,,/Punctuation",137,50,87,0.0005557655114154236,0.0009663016193882312,0.635036496350365
1879,잠깐/Noun,137,52,85,0.0005779961318720405,0.0009440877890574672,0.6204379562043796
1880,매/Modifier,137,82,55,0.0009114554387212947,0.0006108803340960082,0.5985401459854015
1881,뿐이다/Adjective,137,56,81,0.0006224573727852744,0.0008996601283959393,0.5912408759124088
1882,기자/Noun,137,79,58,0.0008781095080363693,0.0006442010795921541,0.5766423357664233
1883,살아나다/Verb,137,78,59,0.0008669941978080608,0.000655307994757536,0.5693430656934306
1884,?!/Punctuation,137,64,73,0.0007113798546117422,0.0008108048070728836,0.5328467153284672
1885,특이하다/Adjective,137,69,68,0.0007669564057532845,0.0007552702312459737,0.5036496350364964
1886,시시하다/Adjective,136,23,113,0.00025565213525109487,0.0012550814136881622,0.8308823529411765
1887,세번/Noun,136,110,26,0.001222684125113932,0.00028877979429993113,0.8088235294117647
1888,냥/Josa,136,31,105,0.00034457461707756266,0.0011662260923651065,0.7720588235294118
1889,만에/Josa,136,101,35,0.0011226463330591557,0.00038874203078836884,0.7426470588235294
1890,내면/Noun,136,99,37,0.0011004157126025388,0.00041095586111913277,0.7279411764705882
1891,성격/Noun,136,41,95,0.00045572771936064734,0.0010551569407112869,0.6985294117647058
1892,선물/Noun,136,95,41,0.0010559544716893048,0.00045538352178066063,0.6985294117647058
1893,동시/Noun,136,90,46,0.0010003779205477626,0.0005109180976075704,0.6617647058823529
1894,로써/Noun,136,70,66,0.000778071715981593,0.0007330564009152098,0.5147058823529411
1895,신고/Noun,136,66,70,0.0007336104750683592,0.0007774840615767377,0.5147058823529411
1896,러브/Noun,136,69,67,0.0007669564057532845,0.0007441633160805918,0.5073529411764706
1897,에로영화/Noun,135,22,113,0.00024453682502278637,0.0012550814136881622,0.837037037037037
1898,겨우/Noun,135,22,113,0.00024453682502278637,0.0012550814136881622,0.837037037037037
1899,추하다/Adjective,135,108,27,0.001200453504657315,0.0002998867094653131,0.8
1900,적임/Noun,135,96,39,0.0010670697819176133,0.0004331696914498967,0.7111111111111111
1901,만족하다/Adjective,135,93,42,0.001033723851232688,0.0004664904369460426,0.6888888888888889
1902,형제/Noun,135,91,44,0.001011493230776071,0.0004887042672768066,0.674074074074074
1903,조용하다/Adjective,135,90,45,0.0010003779205477626,0.0004998111824421885,0.6666666666666666
1904,할머니/Noun,135,87,48,0.000967031989862837,0.0005331319279383344,0.6444444444444445
1905,빈/Noun,135,57,78,0.0006335726830135829,0.0008663393828997934,0.5777777777777777
1906,고양이/Noun,135,64,71,0.0007113798546117422,0.0007885909767421196,0.5259259259259259
1907,아내/Noun,135,70,65,0.000778071715981593,0.0007219494857498279,0.5185185185185185
1908,참으로/Noun,135,69,66,0.0007669564057532845,0.0007330564009152098,0.5111111111111111
1909,가수/Noun,135,66,69,0.0007336104750683592,0.0007663771464113557,0.5111111111111111
1910,야동/Noun,134,25,109,0.0002778827557077118,0.0012106537530266344,0.8134328358208955
1911,롭고/Josa,134,108,26,0.001200453504657315,0.00028877979429993113,0.8059701492537313
1912,당/Suffix,134,44,90,0.0004890736500455727,0.000999622364884377,0.6716417910447762
1913,[/Punctuation,134,44,90,0.0004890736500455727,0.000999622364884377,0.6716417910447762
1914,스럽지/Josa,134,87,47,0.000967031989862837,0.0005220250127729525,0.6492537313432836
1915,멈추다/Verb,134,84,50,0.0009336860591779117,0.0005553457582690984,0.6268656716417911
1916,넌/Noun,134,54,80,0.0006002267523286575,0.0008885532132305574,0.5970149253731343
1917,우와/Exclamation,134,80,54,0.0008892248182646778,0.0005997734189306263,0.5970149253731343
1918,인들/Josa,134,57,77,0.0006335726830135829,0.0008552324677344115,0.5746268656716418
1919,정의/Noun,134,77,57,0.0008558788875797523,0.0006330941644267721,0.5746268656716418
1920,분명하다/Adjective,134,71,63,0.0007891870262099015,0.0006997356554190639,0.5298507462686567
1921,벗어나다/Verb,134,63,71,0.0007002645443834338,0.0007885909767421196,0.5298507462686567
1922,줄다/Verb,134,64,70,0.0007113798546117422,0.0007774840615767377,0.5223880597014925
1923,장/Noun,134,65,69,0.0007224951648400507,0.0007663771464113557,0.5149253731343284
1924,투자/Noun,133,20,113,0.00022230620456616945,0.0012550814136881622,0.849624060150376
1925,레전드/Noun,133,108,25,0.001200453504657315,0.0002776728791345492,0.8120300751879699
1926,지우다/Verb,133,30,103,0.00033345930684925416,0.0011440122620343426,0.7744360902255639
1927,고통/Noun,133,95,38,0.0010559544716893048,0.00042206277628451476,0.7142857142857143
1928,비현실적/Noun,133,41,92,0.00045572771936064734,0.0010218361952151409,0.6917293233082706
1929,욕망/Noun,133,90,43,0.0010003779205477626,0.00047759735211142456,0.6766917293233082
1930,쉬/Noun,133,90,43,0.0010003779205477626,0.00047759735211142456,0.6766917293233082
1931,방영/Noun,133,85,48,0.0009448013694062201,0.0005331319279383344,0.6390977443609023
1932,영혼/Noun,133,82,51,0.0009114554387212947,0.0005664526734344803,0.6165413533834586
1933,관점/Noun,133,77,56,0.0008558788875797523,0.0006219872492613901,0.5789473684210527
1934,온/Modifier,133,61,72,0.0006780339239268168,0.0007996978919075016,0.5413533834586466
1935,투/Noun,133,68,65,0.0007558410955249761,0.0007219494857498279,0.5112781954887218
1936,듬/Noun,133,68,65,0.0007558410955249761,0.0007219494857498279,0.5112781954887218
1937,진하다/Adjective,132,119,13,0.0013227219171687082,0.00014438989714996557,0.9015151515151515
1938,초등학교/Noun,132,99,33,0.0011004157126025388,0.0003665282004576049,0.75
1939,학년/Noun,132,96,36,0.0010670697819176133,0.0003998489459537508,0.7272727272727273
1940,로그인/Noun,132,41,91,0.00045572771936064734,0.001010729280049759,0.6893939393939394
1941,베/Noun,132,45,87,0.0005001889602738813,0.0009663016193882312,0.6590909090909091
1942,을/Foreign,132,45,87,0.0005001889602738813,0.0009663016193882312,0.6590909090909091
1943,특수/Noun,132,48,84,0.0005335348909588066,0.0009329808738920852,0.6363636363636364
1944,감안/Noun,132,51,81,0.0005668808216437321,0.0008996601283959393,0.6136363636363636
1945,21/Number,132,79,53,0.0008781095080363693,0.0005886665037652442,0.5984848484848485
1946,12/Number,132,54,78,0.0006002267523286575,0.0008663393828997934,0.5909090909090909
1947,상업/Noun,132,55,77,0.000611342062556966,0.0008552324677344115,0.5833333333333334
1948,타/Noun,132,76,56,0.0008447635773514439,0.0006219872492613901,0.5757575757575758
1949,의/Foreign,132,70,62,0.000778071715981593,0.000688628740253682,0.5303030303030303
1950,M/Alpha,131,5,126,5.557655114154236e-05,0.0013994713108381278,0.9618320610687023
1951,잠들다/Verb,131,17,114,0.00018896027388124403,0.0012661883288535441,0.8702290076335878
1952,감흥/Noun,131,19,112,0.00021119089433786097,0.0012439744985227803,0.8549618320610687
1953,붙이다/Verb,131,21,110,0.00023342151479447792,0.0012217606681920164,0.8396946564885496
1954,부럽다/Adjective,131,106,25,0.001178222884200698,0.0002776728791345492,0.8091603053435115
1955,설득/Noun,131,30,101,0.00033345930684925416,0.0011217984317035787,0.7709923664122137
1956,따로/Adverb,131,31,100,0.00034457461707756266,0.0011106915165381968,0.7633587786259542
1957,]/Punctuation,131,38,93,0.00042238178867572195,0.001032943110380523,0.7099236641221374
1958,끝내주다/Adjective,131,91,40,0.001011493230776071,0.0004442766066152787,0.6946564885496184
1959,놀랍다/Adjective,131,91,40,0.001011493230776071,0.0004442766066152787,0.6946564885496184
1960,권/Suffix,131,84,47,0.0009336860591779117,0.0005220250127729525,0.6412213740458015
1961,그건/Adverb,131,55,76,0.000611342062556966,0.0008441255525690295,0.5801526717557252
1962,채/Noun,131,59,72,0.0006558033034701999,0.0007996978919075016,0.549618320610687
1963,일이/Modifier,131,62,69,0.0006891492341551253,0.0007663771464113557,0.5267175572519084
1964,반하다/Adjective,130,112,18,0.0012449147455705488,0.0001999244729768754,0.8615384615384616
1965,점준/Noun,130,23,107,0.00025565213525109487,0.0011884399226958703,0.823076923076923
1966,인지도/Noun,130,26,104,0.00028899806593602026,0.0011551191771997245,0.8
1967,x/Alpha,130,34,96,0.00037792054776248805,0.0010662638558766688,0.7384615384615385
1968,루/Noun,130,36,94,0.000400151168219105,0.001044050025545905,0.7230769230769231
1969,기발하다/Adjective,130,92,38,0.0010226085410043795,0.00042206277628451476,0.7076923076923077
1970,최강/Noun,130,88,42,0.0009781473000911455,0.0004664904369460426,0.676923076923077
1971,주성치/Noun,130,81,49,0.0009003401284929862,0.0005442388431037163,0.6230769230769231
1972,키우다/Verb,130,60,70,0.0006669186136985083,0.0007774840615767377,0.5384615384615384
1973,배역/Noun,130,62,68,0.0006891492341551253,0.0007552702312459737,0.5230769230769231
1974,악마/Noun,130,62,68,0.0006891492341551253,0.0007552702312459737,0.5230769230769231
1975,안습/Noun,129,16,113,0.00017784496365293555,0.0012550814136881622,0.875968992248062
1976,우려/Noun,129,18,111,0.0002000755841095525,0.0012328675833573983,0.8604651162790697
1977,기만/Noun,129,25,104,0.0002778827557077118,0.0011551191771997245,0.8062015503875969
1978,조작/Noun,129,25,104,0.0002778827557077118,0.0011551191771997245,0.8062015503875969
1979,고르다/Verb,129,29,100,0.0003223439966209457,0.0011106915165381968,0.7751937984496124
1980,오랫/Modifier,129,97,32,0.0010781850921459217,0.0003554212852922229,0.751937984496124
1981,스트레스/Noun,129,35,94,0.0003890358579907965,0.001044050025545905,0.7286821705426356
1982,색감/Noun,129,91,38,0.001011493230776071,0.00042206277628451476,0.7054263565891473
1983,결정/Noun,129,55,74,0.000611342062556966,0.0008219117222382655,0.5736434108527132
1984,자리/Noun,129,74,55,0.0008225329568948269,0.0006108803340960082,0.5736434108527132
1985,놀래다/Adjective,129,56,73,0.0006224573727852744,0.0008108048070728836,0.5658914728682171
1986,본적/Noun,129,70,59,0.000778071715981593,0.000655307994757536,0.5426356589147286
1987,모자라다/Verb,129,63,66,0.0007002645443834338,0.0007330564009152098,0.5116279069767442
1988,공짜/Noun,128,5,123,5.557655114154236e-05,0.001366150565341982,0.9609375
1989,18/Number,128,28,100,0.0003112286863926372,0.0011106915165381968,0.78125
1990,놀다/Verb,128,36,92,0.000400151168219105,0.0010218361952151409,0.71875
1991,아무렇다/Adjective,128,37,91,0.00041126647844741344,0.001010729280049759,0.7109375
1992,데리/Noun,128,41,87,0.00045572771936064734,0.0009663016193882312,0.6796875
1993,포인트/Noun,128,42,86,0.00046684302958895584,0.0009551947042228491,0.671875
1994,ㄱ/KoreanParticle,128,45,83,0.0005001889602738813,0.0009218739587267032,0.6484375
1995,저러다/Verb,128,45,83,0.0005001889602738813,0.0009218739587267032,0.6484375
1996,갑/Noun,128,83,45,0.0009225707489496032,0.0004998111824421885,0.6484375
1997,바다/Noun,128,75,53,0.0008336482671231354,0.0005886665037652442,0.5859375
1998,홍콩영화/Noun,128,59,69,0.0006558033034701999,0.0007663771464113557,0.5390625
1999,교육/Noun,128,61,67,0.0006780339239268168,0.0007441633160805918,0.5234375
2000,어/Noun,128,67,61,0.0007447257852966677,0.0006775218250882999,0.5234375
2001,정신병/Noun,127,21,106,0.00023342151479447792,0.0011773330075304884,0.8346456692913385
2002,깨우다/Verb,127,105,22,0.0011671075739723895,0.0002443521336384033,0.8267716535433071
2003,아예/Noun,127,26,101,0.00028899806593602026,0.0011217984317035787,0.7952755905511811
2004,여러가지/Noun,127,95,32,0.0010559544716893048,0.0003554212852922229,0.7480314960629921
2005,미가/Noun,127,94,33,0.0010448391614609964,0.0003665282004576049,0.7401574803149606
2006,넘어가다/Verb,127,40,87,0.0004446124091323389,0.0009663016193882312,0.6850393700787402
2007,김/Noun,127,52,75,0.0005779961318720405,0.0008330186374036475,0.5905511811023622
2008,풍자/Noun,127,75,52,0.0008336482671231354,0.0005775595885998623,0.5905511811023622
2009,냄새/Noun,127,55,72,0.000611342062556966,0.0007996978919075016,0.5669291338582677
2010,아래/Noun,127,57,70,0.0006335726830135829,0.0007774840615767377,0.5511811023622047
2011,저런/Modifier,127,66,61,0.0007336104750683592,0.0006775218250882999,0.5196850393700787
2012,경/Modifier,127,62,65,0.0006891492341551253,0.0007219494857498279,0.5118110236220472
2013,최초/Noun,127,65,62,0.0007224951648400507,0.000688628740253682,0.5118110236220472
2014,영국/Noun,127,63,64,0.0007002645443834338,0.0007108425705844458,0.5039370078740157
2015,틈/Noun,126,106,20,0.001178222884200698,0.00022213830330763935,0.8412698412698413
2016,;;;;/Punctuation,126,26,100,0.00028899806593602026,0.0011106915165381968,0.7936507936507936
2017,껏/Noun,126,28,98,0.0003112286863926372,0.0010884776862074327,0.7777777777777778
2018,위로/Noun,126,91,35,0.001011493230776071,0.00038874203078836884,0.7222222222222222
2019,전쟁영화/Noun,126,88,38,0.0009781473000911455,0.00042206277628451476,0.6984126984126984
2020,보고오다/Verb,126,78,48,0.0008669941978080608,0.0005331319279383344,0.6190476190476191
2021,잔/Noun,126,49,77,0.0005446502011871152,0.0008552324677344115,0.6111111111111112
2022,녀/Noun,126,51,75,0.0005668808216437321,0.0008330186374036475,0.5952380952380952
2023,약/Noun,126,52,74,0.0005779961318720405,0.0008219117222382655,0.5873015873015873
2024,관련/Noun,126,57,69,0.0006335726830135829,0.0007663771464113557,0.5476190476190477
2025,덕/Noun,126,61,65,0.0006780339239268168,0.0007219494857498279,0.5158730158730159
2026,목/Noun,126,65,61,0.0007224951648400507,0.0006775218250882999,0.5158730158730159
2027,효/Noun,125,24,101,0.0002667674454794033,0.0011217984317035787,0.808
2028,용기/Noun,125,98,27,0.0010893004023742304,0.0002998867094653131,0.784
2029,뜨겁다/Adjective,125,97,28,0.0010781850921459217,0.00031099362463069506,0.776
2030,패/Noun,125,38,87,0.00042238178867572195,0.0009663016193882312,0.696
2031,공포물/Noun,125,40,85,0.0004446124091323389,0.0009440877890574672,0.68
2032,근래/Noun,125,84,41,0.0009336860591779117,0.00045538352178066063,0.672
2033,수고/Noun,125,82,43,0.0009114554387212947,0.00047759735211142456,0.656
2034,만남/Noun,125,80,45,0.0008892248182646778,0.0004998111824421885,0.64
2035,깜짝/Noun,125,73,52,0.0008114176466665184,0.0005775595885998623,0.584
2036,우주/Noun,125,72,53,0.00080030233643821,0.0005886665037652442,0.576
2037,달리다/Verb,125,55,70,0.000611342062556966,0.0007774840615767377,0.56
2038,나타나다/Verb,125,58,67,0.0006446879932418914,0.0007441633160805918,0.536
2039,말아먹다/Verb,124,12,112,0.00013338372273970166,0.0012439744985227803,0.9032258064516129
2040,운명/Noun,124,93,31,0.001033723851232688,0.000344314370126841,0.75
2041,연인/Noun,124,91,33,0.001011493230776071,0.0003665282004576049,0.7338709677419355
2042,이용/Noun,124,38,86,0.00042238178867572195,0.0009551947042228491,0.6935483870967742
2043,",./Punctuation",124,41,83,0.00045572771936064734,0.0009218739587267032,0.6693548387096774
2044,007/Number,124,79,45,0.0008781095080363693,0.0004998111824421885,0.6370967741935484
2045,DVD/Alpha,124,79,45,0.0008781095080363693,0.0004998111824421885,0.6370967741935484
2046,거짓말/Noun,124,46,78,0.0005113042705021897,0.0008663393828997934,0.6290322580645161
2047,영화계/Noun,124,47,77,0.0005224195807304982,0.0008552324677344115,0.6209677419354839
2048,파/Noun,124,68,56,0.0007558410955249761,0.0006219872492613901,0.5483870967741935
2049,심오하다/Adjective,124,68,56,0.0007558410955249761,0.0006219872492613901,0.5483870967741935
2050,물이/Noun,124,58,66,0.0006446879932418914,0.0007330564009152098,0.532258064516129
2051,만은/Josa,124,59,65,0.0006558033034701999,0.0007219494857498279,0.5241935483870968
2052,린/Noun,124,64,60,0.0007113798546117422,0.000666414909922918,0.5161290322580645
2053,썩다/Verb,123,33,90,0.0003668052375341796,0.000999622364884377,0.7317073170731707
2054,확인/Noun,123,35,88,0.0003890358579907965,0.000977408534553613,0.7154471544715447
2055,해결/Noun,123,42,81,0.00046684302958895584,0.0008996601283959393,0.6585365853658537
2056,군/Noun,123,46,77,0.0005113042705021897,0.0008552324677344115,0.6260162601626016
2057,캐/Noun,123,50,73,0.0005557655114154236,0.0008108048070728836,0.5934959349593496
2058,만을/Josa,123,54,69,0.0006002267523286575,0.0007663771464113557,0.5609756097560976
2059,리즈/Noun,123,55,68,0.000611342062556966,0.0007552702312459737,0.5528455284552846
2060,단어/Noun,123,57,66,0.0006335726830135829,0.0007330564009152098,0.5365853658536586
2061,사진/Noun,123,59,64,0.0006558033034701999,0.0007108425705844458,0.5203252032520326
2062,깨/Noun,123,62,61,0.0006891492341551253,0.0006775218250882999,0.5040650406504065
2063,가득/Noun,123,62,61,0.0006891492341551253,0.0006775218250882999,0.5040650406504065
2064,았/Noun,122,13,109,0.00014449903296801013,0.0012106537530266344,0.8934426229508197
2065,번은/Noun,122,102,20,0.0011337616432874642,0.00022213830330763935,0.8360655737704918
2066,설마/Noun,122,22,100,0.00024453682502278637,0.0011106915165381968,0.819672131147541
2067,결코/Noun,122,91,31,0.001011493230776071,0.000344314370126841,0.7459016393442623
2068,원/Noun,122,31,91,0.00034457461707756266,0.001010729280049759,0.7459016393442623
2069,잖다/Verb,122,34,88,0.00037792054776248805,0.000977408534553613,0.7213114754098361
2070,갠/Noun,122,84,38,0.0009336860591779117,0.00042206277628451476,0.6885245901639344
2071,갖추다/Verb,122,82,40,0.0009114554387212947,0.0004442766066152787,0.6721311475409836
2072,전에/Foreign,122,79,43,0.0008781095080363693,0.00047759735211142456,0.6475409836065574
2073,예능/Noun,122,51,71,0.0005668808216437321,0.0007885909767421196,0.5819672131147541
2074,점줌/Noun,122,51,71,0.0005668808216437321,0.0007885909767421196,0.5819672131147541
2075,내생/Noun,122,69,53,0.0007669564057532845,0.0005886665037652442,0.5655737704918032
2076,백/Modifier,122,66,56,0.0007336104750683592,0.0006219872492613901,0.5409836065573771
2077,보통/Noun,122,63,59,0.0007002645443834338,0.000655307994757536,0.5163934426229508
2078,낮추다/Verb,121,16,105,0.00017784496365293555,0.0011662260923651065,0.8677685950413223
2079,셈/Noun,121,20,101,0.00022230620456616945,0.0011217984317035787,0.8347107438016529
2080,변태/Noun,121,21,100,0.00023342151479447792,0.0011106915165381968,0.8264462809917356
2081,심지어/Noun,121,31,90,0.00034457461707756266,0.000999622364884377,0.743801652892562
2082,자르다/Verb,121,40,81,0.0004446124091323389,0.0008996601283959393,0.6694214876033058
2083,째/Suffix,121,69,52,0.0007669564057532845,0.0005775595885998623,0.5702479338842975
2084,들어서다/Verb,121,65,56,0.0007224951648400507,0.0006219872492613901,0.5371900826446281
2085,트/Noun,121,63,58,0.0007002645443834338,0.0006442010795921541,0.5206611570247934
2086,잔뜩/Noun,120,15,105,0.00016672965342462708,0.0011662260923651065,0.875
2087,5분/Number,120,18,102,0.0002000755841095525,0.0011329053468689607,0.85
2088,크리스마스/Noun,120,89,31,0.000989262610319454,0.000344314370126841,0.7416666666666667
2089,X/Alpha,120,31,89,0.00034457461707756266,0.000988515449718995,0.7416666666666667
2090,스런/Josa,120,39,81,0.0004334970989040304,0.0008996601283959393,0.675
2091,여러/Noun,120,79,41,0.0008781095080363693,0.00045538352178066063,0.6583333333333333
2092,넘기다/Verb,120,43,77,0.0004779583398172643,0.0008552324677344115,0.6416666666666667
2093,편도/Noun,120,77,43,0.0008558788875797523,0.00047759735211142456,0.6416666666666667
2094,이래서/Josa,120,46,74,0.0005113042705021897,0.0008219117222382655,0.6166666666666667
2095,스크린/Noun,120,71,49,0.0007891870262099015,0.0005442388431037163,0.5916666666666667
2096,상태/Noun,120,53,67,0.000589111442100349,0.0007441633160805918,0.5583333333333333
2097,달리/Noun,120,54,66,0.0006002267523286575,0.0007330564009152098,0.55
2098,국가/Noun,120,65,55,0.0007224951648400507,0.0006108803340960082,0.5416666666666666
2099,ㅅ/KoreanParticle,120,56,64,0.0006224573727852744,0.0007108425705844458,0.5333333333333333
2100,전율/Noun,119,110,9,0.001222684125113932,9.99622364884377e-05,0.9243697478991597
2101,둘째/Noun,119,14,105,0.0001556143431963186,0.0011662260923651065,0.8823529411764706
2102,려고/Noun,119,23,96,0.00025565213525109487,0.0010662638558766688,0.8067226890756303
2103,아동/Noun,119,28,91,0.0003112286863926372,0.001010729280049759,0.7647058823529411
2104,그립다/Adjective,119,86,33,0.0009559166796345286,0.0003665282004576049,0.7226890756302521
2105,탓/Noun,119,35,84,0.0003890358579907965,0.0009329808738920852,0.7058823529411765
2106,뛰어넘다/Verb,119,83,36,0.0009225707489496032,0.0003998489459537508,0.6974789915966386
2107,제외/Noun,119,43,76,0.0004779583398172643,0.0008441255525690295,0.6386554621848739
2108,자주/Noun,119,76,43,0.0008447635773514439,0.00047759735211142456,0.6386554621848739
2109,옷/Noun,119,48,71,0.0005335348909588066,0.0007885909767421196,0.5966386554621849
2110,통/Noun,119,49,70,0.0005446502011871152,0.0007774840615767377,0.5882352941176471
2111,케/Noun,119,51,68,0.0005668808216437321,0.0007552702312459737,0.5714285714285714
2112,넘어서다/Verb,119,67,52,0.0007447257852966677,0.0005775595885998623,0.5630252100840336
2113,기법/Noun,119,53,66,0.000589111442100349,0.0007330564009152098,0.5546218487394958
2114,의하다/Adjective,119,66,53,0.0007336104750683592,0.0005886665037652442,0.5546218487394958
2115,아역/Noun,119,63,56,0.0007002645443834338,0.0006219872492613901,0.5294117647058824
2116,오빠/Suffix,118,106,12,0.001178222884200698,0.0001332829819845836,0.8983050847457628
2117,작위/Noun,118,17,101,0.00018896027388124403,0.0011217984317035787,0.8559322033898306
2118,대본/Noun,118,24,94,0.0002667674454794033,0.001044050025545905,0.7966101694915254
2119,부모님/Noun,118,89,29,0.000989262610319454,0.00032210053979607705,0.7542372881355932
2120,톰/Noun,118,83,35,0.0009225707489496032,0.00038874203078836884,0.7033898305084746
2121,두번째/Noun,118,81,37,0.0009003401284929862,0.00041095586111913277,0.6864406779661016
2122,에나/Josa,118,38,80,0.00042238178867572195,0.0008885532132305574,0.6779661016949152
2123,짜임새/Noun,118,71,47,0.0007891870262099015,0.0005220250127729525,0.6016949152542372
2124,꼬마/Noun,118,67,51,0.0007447257852966677,0.0005664526734344803,0.5677966101694916
2125,매니아/Noun,118,55,63,0.000611342062556966,0.0006997356554190639,0.5338983050847458
2126,:)/Punctuation,117,114,3,0.0012671453660271657,3.33207454961459e-05,0.9743589743589743
2127,한개/Modifier,117,10,107,0.00011115310228308472,0.0011884399226958703,0.9145299145299145
2128,애쓰다/Verb,117,25,92,0.0002778827557077118,0.0010218361952151409,0.7863247863247863
2129,하나같이/Adverb,117,28,89,0.0003112286863926372,0.000988515449718995,0.7606837606837606
2130,가족영화/Noun,117,77,40,0.0008558788875797523,0.0004442766066152787,0.6581196581196581
2131,케릭/Noun,117,44,73,0.0004890736500455727,0.0008108048070728836,0.6239316239316239
2132,사상/Noun,117,46,71,0.0005113042705021897,0.0007885909767421196,0.6068376068376068
2133,흑인/Noun,117,47,70,0.0005224195807304982,0.0007774840615767377,0.5982905982905983
2134,비밀/Noun,117,51,66,0.0005668808216437321,0.0007330564009152098,0.5641025641025641
2135,감정이입/Noun,117,53,64,0.000589111442100349,0.0007108425705844458,0.5470085470085471
2136,대중/Noun,117,54,63,0.0006002267523286575,0.0006997356554190639,0.5384615384615384
2137,땅/Noun,117,62,55,0.0006891492341551253,0.0006108803340960082,0.5299145299145299
2138,쥐/Noun,117,60,57,0.0006669186136985083,0.0006330941644267721,0.5128205128205128
2139,그만/Modifier,116,9,107,0.00010003779205477625,0.0011884399226958703,0.9224137931034483
2140,하자/Noun,116,24,92,0.0002667674454794033,0.0010218361952151409,0.7931034482758621
2141,정작/Noun,116,29,87,0.0003223439966209457,0.0009663016193882312,0.75
2142,거나/Noun,116,33,83,0.0003668052375341796,0.0009218739587267032,0.7155172413793104
2143,신의/Noun,116,79,37,0.0008781095080363693,0.00041095586111913277,0.6810344827586207
2144,장가/Noun,116,37,79,0.00041126647844741344,0.0008774462980651753,0.6810344827586207
2145,무료/Noun,116,40,76,0.0004446124091323389,0.0008441255525690295,0.6551724137931034
2146,예/Noun,116,40,76,0.0004446124091323389,0.0008441255525690295,0.6551724137931034
2147,꺼/Suffix,116,40,76,0.0004446124091323389,0.0008441255525690295,0.6551724137931034
2148,워/Noun,116,49,67,0.0005446502011871152,0.0007441633160805918,0.5775862068965517
2149,박/Noun,116,64,52,0.0007113798546117422,0.0005775595885998623,0.5517241379310345
2150,와의/Josa,116,64,52,0.0007113798546117422,0.0005775595885998623,0.5517241379310345
2151,디/Noun,116,61,55,0.0006780339239268168,0.0006108803340960082,0.5258620689655172
2152,대놓고/Adverb,115,17,98,0.00018896027388124403,0.0010884776862074327,0.8521739130434782
2153,ㅠㅜ/KoreanParticle,115,89,26,0.000989262610319454,0.00028877979429993113,0.7739130434782608
2154,소년/Noun,115,84,31,0.0009336860591779117,0.000344314370126841,0.7304347826086957
2155,열연/Noun,115,80,35,0.0008892248182646778,0.00038874203078836884,0.6956521739130435
2156,성은/Noun,115,36,79,0.000400151168219105,0.0008774462980651753,0.6869565217391305
2157,목적/Noun,115,37,78,0.00041126647844741344,0.0008663393828997934,0.6782608695652174
2158,충실하다/Adjective,115,77,38,0.0008558788875797523,0.00042206277628451476,0.6695652173913044
2159,의심/Noun,115,40,75,0.0004446124091323389,0.0008330186374036475,0.6521739130434783
2160,메/Noun,115,75,40,0.0008336482671231354,0.0004442766066152787,0.6521739130434783
2161,낫/Noun,115,43,72,0.0004779583398172643,0.0007996978919075016,0.6260869565217392
2162,으리/Noun,115,71,44,0.0007891870262099015,0.0004887042672768066,0.6173913043478261
2163,탄생/Noun,115,63,52,0.0007002645443834338,0.0005775595885998623,0.5478260869565217
2164,무술/Noun,115,53,62,0.000589111442100349,0.000688628740253682,0.5391304347826087
2165,금보/Noun,115,58,57,0.0006446879932418914,0.0006330941644267721,0.5043478260869565
2166,힘내다/Verb,114,95,19,0.0010559544716893048,0.00021103138814225738,0.8333333333333334
2167,겪다/Verb,114,87,27,0.000967031989862837,0.0002998867094653131,0.7631578947368421
2168,씹다/Verb,114,31,83,0.00034457461707756266,0.0009218739587267032,0.7280701754385965
2169,패러디/Noun,114,36,78,0.000400151168219105,0.0008663393828997934,0.6842105263157895
2170,꿈꾸다/Verb,114,77,37,0.0008558788875797523,0.00041095586111913277,0.6754385964912281
2171,새다/Verb,114,42,72,0.00046684302958895584,0.0007996978919075016,0.631578947368421
2172,the/Alpha,114,71,43,0.0007891870262099015,0.00047759735211142456,0.6228070175438597
2173,구나/Noun,114,44,70,0.0004890736500455727,0.0007774840615767377,0.6140350877192983
2174,15/Number,114,45,69,0.0005001889602738813,0.0007663771464113557,0.6052631578947368
2175,지나가다/Verb,114,68,46,0.0007558410955249761,0.0005109180976075704,0.5964912280701754
2176,화끈하다/Adjective,114,65,49,0.0007224951648400507,0.0005442388431037163,0.5701754385964912
2177,애가/Noun,114,50,64,0.0005557655114154236,0.0007108425705844458,0.5614035087719298
2178,명의/Noun,114,61,53,0.0006780339239268168,0.0005886665037652442,0.5350877192982456
2179,여러분/Noun,114,58,56,0.0006446879932418914,0.0006219872492613901,0.5087719298245614
2180,시점/Noun,114,58,56,0.0006446879932418914,0.0006219872492613901,0.5087719298245614
2181,20분/Number,113,18,95,0.0002000755841095525,0.0010551569407112869,0.8407079646017699
2182,ㅜㅜㅜ/KoreanParticle,113,83,30,0.0009225707489496032,0.000333207454961459,0.7345132743362832
2183,..;;/Punctuation,113,31,82,0.00034457461707756266,0.0009107670435613213,0.7256637168141593
2184,무서움/Noun,113,47,66,0.0005224195807304982,0.0007330564009152098,0.584070796460177
2185,브루스/Noun,113,48,65,0.0005335348909588066,0.0007219494857498279,0.5752212389380531
2186,움직이다/Verb,113,59,54,0.0006558033034701999,0.0005997734189306263,0.5221238938053098
2187,블록버스터/Noun,113,58,55,0.0006446879932418914,0.0006108803340960082,0.5132743362831859
2188,명화/Noun,112,90,22,0.0010003779205477626,0.0002443521336384033,0.8035714285714286
2189,값/Noun,112,27,85,0.00030011337616432876,0.0009440877890574672,0.7589285714285714
2190,감각/Noun,112,73,39,0.0008114176466665184,0.0004331696914498967,0.6517857142857143
2191,부부/Noun,112,68,44,0.0007558410955249761,0.0004887042672768066,0.6071428571428571
2192,집착/Noun,112,45,67,0.0005001889602738813,0.0007441633160805918,0.5982142857142857
2193,틀/Noun,112,51,61,0.0005668808216437321,0.0006775218250882999,0.5446428571428571
2194,주제가/Noun,112,51,61,0.0005668808216437321,0.0006775218250882999,0.5446428571428571
2195,골/Noun,112,51,61,0.0005668808216437321,0.0006775218250882999,0.5446428571428571
2196,후속작/Noun,112,53,59,0.000589111442100349,0.000655307994757536,0.5267857142857143
2197,찾기/Noun,112,55,57,0.000611342062556966,0.0006330941644267721,0.5089285714285714
2198,낚였다/Noun,111,2,109,2.2230620456616944e-05,0.0012106537530266344,0.9819819819819819
2199,참나/Noun,111,10,101,0.00011115310228308472,0.0011217984317035787,0.9099099099099099
2200,오래전/Adverb,111,85,26,0.0009448013694062201,0.00028877979429993113,0.7657657657657657
2201,!!!!!/Punctuation,111,81,30,0.0009003401284929862,0.000333207454961459,0.7297297297297297
2202,뇌/Noun,111,37,74,0.00041126647844741344,0.0008219117222382655,0.6666666666666666
2203,시기/Noun,111,68,43,0.0007558410955249761,0.00047759735211142456,0.6126126126126126
2204,앉다/Verb,111,44,67,0.0004890736500455727,0.0007441633160805918,0.6036036036036037
2205,피다/Verb,111,48,63,0.0005335348909588066,0.0006997356554190639,0.5675675675675675
2206,어둡다/Adjective,111,49,62,0.0005446502011871152,0.000688628740253682,0.5585585585585585
2207,모험/Noun,111,60,51,0.0006669186136985083,0.0005664526734344803,0.5405405405405406
2208,울컥/Adverb,110,108,2,0.001200453504657315,2.2213830330763933e-05,0.9818181818181818
2209,짜지다/Verb,110,12,98,0.00013338372273970166,0.0010884776862074327,0.8909090909090909
2210,신파/Noun,110,16,94,0.00017784496365293555,0.001044050025545905,0.8545454545454545
2211,첫사랑/Noun,110,90,20,0.0010003779205477626,0.00022213830330763935,0.8181818181818182
2212,업다/Verb,110,29,81,0.0003223439966209457,0.0008996601283959393,0.7363636363636363
2213,몇몇/Noun,110,33,77,0.0003668052375341796,0.0008552324677344115,0.7
2214,모양/Noun,110,36,74,0.000400151168219105,0.0008219117222382655,0.6727272727272727
2215,70년/Number,110,37,73,0.00041126647844741344,0.0008108048070728836,0.6636363636363637
2216,담배/Noun,110,40,70,0.0004446124091323389,0.0007774840615767377,0.6363636363636364
2217,할아버지/Noun,110,67,43,0.0007447257852966677,0.00047759735211142456,0.6090909090909091
2218,탑/Noun,110,66,44,0.0007336104750683592,0.0004887042672768066,0.6
2219,물다/Verb,110,51,59,0.0005668808216437321,0.000655307994757536,0.5363636363636364
2220,타고/Noun,110,54,56,0.0006002267523286575,0.0006219872492613901,0.509090909090909
2221,한숨/Noun,109,12,97,0.00013338372273970166,0.0010773707710420508,0.8899082568807339
2222,시끄럽다/Adjective,109,15,94,0.00016672965342462708,0.001044050025545905,0.8623853211009175
2223,세련되다/Adjective,109,94,15,0.0010448391614609964,0.0001666037274807295,0.8623853211009175
2224,고전/Noun,109,80,29,0.0008892248182646778,0.00032210053979607705,0.7339449541284404
2225,삭제/Noun,109,31,78,0.00034457461707756266,0.0008663393828997934,0.7155963302752294
2226,빵빵/Noun,109,77,32,0.0008558788875797523,0.0003554212852922229,0.7064220183486238
2227,졸/Noun,109,33,76,0.0003668052375341796,0.0008441255525690295,0.6972477064220184
2228,철/Noun,109,35,74,0.0003890358579907965,0.0008219117222382655,0.6788990825688074
2229,적어도/Adverb,109,63,46,0.0007002645443834338,0.0005109180976075704,0.5779816513761468
2230,어쩜/Noun,109,47,62,0.0005224195807304982,0.000688628740253682,0.5688073394495413
2231,거부/Noun,109,49,60,0.0005446502011871152,0.000666414909922918,0.5504587155963303
2232,11/Number,109,52,57,0.0005779961318720405,0.0006330941644267721,0.5229357798165137
2233,.^^/Punctuation,108,97,11,0.0010781850921459217,0.00012217606681920164,0.8981481481481481
2234,말고는/Josa,108,11,97,0.00012226841251139318,0.0010773707710420508,0.8981481481481481
2235,십/Modifier,108,76,32,0.0008447635773514439,0.0003554212852922229,0.7037037037037037
2236,그만큼/Adverb,108,76,32,0.0008447635773514439,0.0003554212852922229,0.7037037037037037
2237,최대/Noun,108,37,71,0.00041126647844741344,0.0007885909767421196,0.6574074074074074
2238,언니/Noun,108,69,39,0.0007669564057532845,0.0004331696914498967,0.6388888888888888
2239,화의/Noun,108,39,69,0.0004334970989040304,0.0007663771464113557,0.6388888888888888
2240,마이/Noun,108,40,68,0.0004446124091323389,0.0007552702312459737,0.6296296296296297
2241,탈/Noun,108,40,68,0.0004446124091323389,0.0007552702312459737,0.6296296296296297
2242,누나/Noun,108,65,43,0.0007224951648400507,0.00047759735211142456,0.6018518518518519
2243,포스/Noun,108,65,43,0.0007224951648400507,0.00047759735211142456,0.6018518518518519
2244,ㅁ/KoreanParticle,108,63,45,0.0007002645443834338,0.0004998111824421885,0.5833333333333334
2245,기독교/Noun,108,46,62,0.0005113042705021897,0.000688628740253682,0.5740740740740741
2246,아이디어/Noun,108,49,59,0.0005446502011871152,0.000655307994757536,0.5462962962962963
2247,sf/Alpha,108,58,50,0.0006446879932418914,0.0005553457582690984,0.5370370370370371
2248,빈약하다/Adjective,107,12,95,0.00013338372273970166,0.0010551569407112869,0.8878504672897196
2249,떨다/Verb,107,36,71,0.000400151168219105,0.0007885909767421196,0.6635514018691588
2250,여태/Noun,107,63,44,0.0007002645443834338,0.0004887042672768066,0.5887850467289719
2251,하늘/Noun,107,63,44,0.0007002645443834338,0.0004887042672768066,0.5887850467289719
2252,종영/Noun,107,60,47,0.0006669186136985083,0.0005220250127729525,0.5607476635514018
2253,어처구니/Noun,106,11,95,0.00012226841251139318,0.0010551569407112869,0.8962264150943396
2254,..^^/Punctuation,106,92,14,0.0010226085410043795,0.00015549681231534753,0.8679245283018868
2255,중독/Noun,106,87,19,0.000967031989862837,0.00021103138814225738,0.8207547169811321
2256,폐지/Noun,106,30,76,0.00033345930684925416,0.0008441255525690295,0.7169811320754716
2257,치밀하다/Adjective,106,73,33,0.0008114176466665184,0.0003665282004576049,0.6886792452830188
2258,흑/Adverb,106,72,34,0.00080030233643821,0.00037763511562298685,0.6792452830188679
2259,수많다/Adjective,106,61,45,0.0006780339239268168,0.0004998111824421885,0.5754716981132075
2260,재능/Noun,106,47,59,0.0005224195807304982,0.000655307994757536,0.5566037735849056
2261,바르다/Verb,106,49,57,0.0005446502011871152,0.0006330941644267721,0.5377358490566038
2262,A/Alpha,106,53,53,0.000589111442100349,0.0005886665037652442,0.5
2263,선동/Noun,105,10,95,0.00011115310228308472,0.0010551569407112869,0.9047619047619048
2264,팔이/Noun,105,11,94,0.00012226841251139318,0.001044050025545905,0.8952380952380953
2265,여름/Noun,105,85,20,0.0009448013694062201,0.00022213830330763935,0.8095238095238095
2266,안감/Noun,105,22,83,0.00024453682502278637,0.0009218739587267032,0.7904761904761904
2267,늘어지다/Verb,105,24,81,0.0002667674454794033,0.0008996601283959393,0.7714285714285715
2268,또다른/Modifier,105,78,27,0.0008669941978080608,0.0002998867094653131,0.7428571428571429
2269,중학교/Noun,105,77,28,0.0008558788875797523,0.00031099362463069506,0.7333333333333333
2270,바탕/Noun,105,73,32,0.0008114176466665184,0.0003554212852922229,0.6952380952380952
2271,목숨/Noun,105,70,35,0.000778071715981593,0.00038874203078836884,0.6666666666666666
2272,잡/Noun,105,36,69,0.000400151168219105,0.0007663771464113557,0.6571428571428571
2273,버전/Noun,105,38,67,0.00042238178867572195,0.0007441633160805918,0.638095238095238
2274,보구/Noun,105,62,43,0.0006891492341551253,0.00047759735211142456,0.5904761904761905
2275,대신/Noun,105,44,61,0.0004890736500455727,0.0006775218250882999,0.580952380952381
2276,삼/Noun,105,45,60,0.0005001889602738813,0.000666414909922918,0.5714285714285714
2277,혹은/Adverb,105,56,49,0.0006224573727852744,0.0005442388431037163,0.5333333333333333
2278,마리/Noun,105,51,54,0.0005668808216437321,0.0005997734189306263,0.5142857142857142
2279,여기다/Verb,105,52,53,0.0005779961318720405,0.0005886665037652442,0.5047619047619047
2280,끼우다/Verb,104,10,94,0.00011115310228308472,0.001044050025545905,0.9038461538461539
2281,메이드/Noun,104,91,13,0.001011493230776071,0.00014438989714996557,0.875
2282,캬/Noun,104,89,15,0.000989262610319454,0.0001666037274807295,0.8557692307692307
2283,어쩌/Noun,104,16,88,0.00017784496365293555,0.000977408534553613,0.8461538461538461
2284,구리/Noun,104,16,88,0.00017784496365293555,0.000977408534553613,0.8461538461538461
2285,호구/Noun,104,17,87,0.00018896027388124403,0.0009663016193882312,0.8365384615384616
2286,부터가/Josa,104,22,82,0.00024453682502278637,0.0009107670435613213,0.7884615384615384
2287,하아/Exclamation,104,23,81,0.00025565213525109487,0.0008996601283959393,0.7788461538461539
2288,~!!!/Punctuation,104,79,25,0.0008781095080363693,0.0002776728791345492,0.7596153846153846
2289,반갑다/Adjective,104,73,31,0.0008114176466665184,0.000344314370126841,0.7019230769230769
2290,장국영/Noun,104,73,31,0.0008114176466665184,0.000344314370126841,0.7019230769230769
2291,졸리/Noun,104,33,71,0.0003668052375341796,0.0007885909767421196,0.6826923076923077
2292,표현/Modifier,104,68,36,0.0007558410955249761,0.0003998489459537508,0.6538461538461539
2293,야구/Noun,104,66,38,0.0007336104750683592,0.00042206277628451476,0.6346153846153846
2294,틱/Suffix,104,39,65,0.0004334970989040304,0.0007219494857498279,0.625
2295,고등학교/Noun,104,65,39,0.0007224951648400507,0.0004331696914498967,0.625
2296,따름/Noun,104,41,63,0.00045572771936064734,0.0006997356554190639,0.6057692307692307
2297,드림/Noun,104,42,62,0.00046684302958895584,0.000688628740253682,0.5961538461538461
2298,재난영화/Noun,104,59,45,0.0006558033034701999,0.0004998111824421885,0.5673076923076923
2299,라이언/Noun,104,57,47,0.0006335726830135829,0.0005220250127729525,0.5480769230769231
2300,매다/Verb,104,48,56,0.0005335348909588066,0.0006219872492613901,0.5384615384615384
2301,틀리다/Verb,104,50,54,0.0005557655114154236,0.0005997734189306263,0.5192307692307693
2302,내놓다/Verb,103,23,80,0.00025565213525109487,0.0008885532132305574,0.7766990291262136
2303,이어서/Josa,103,75,28,0.0008336482671231354,0.00031099362463069506,0.7281553398058253
2304,벌다/Verb,103,29,74,0.0003223439966209457,0.0008219117222382655,0.7184466019417476
2305,로버트/Noun,103,70,33,0.000778071715981593,0.0003665282004576049,0.6796116504854369
2306,보이지/Noun,103,36,67,0.000400151168219105,0.0007441633160805918,0.6504854368932039
2307,막다/Verb,103,38,65,0.00042238178867572195,0.0007219494857498279,0.6310679611650486
2308,배경음악/Noun,103,64,39,0.0007113798546117422,0.0004331696914498967,0.6213592233009708
2309,욕심/Noun,103,39,64,0.0004334970989040304,0.0007108425705844458,0.6213592233009708
2310,웃/Noun,103,64,39,0.0007113798546117422,0.0004331696914498967,0.6213592233009708
2311,정확하다/Adjective,103,45,58,0.0005001889602738813,0.0006442010795921541,0.5631067961165048
2312,30년/Number,103,57,46,0.0006335726830135829,0.0005109180976075704,0.5533980582524272
2313,풍/Adverb,103,50,53,0.0005557655114154236,0.0005886665037652442,0.5145631067961165
2314,빵점/Noun,102,2,100,2.2230620456616944e-05,0.0011106915165381968,0.9803921568627451
2315,하품/Noun,102,2,100,2.2230620456616944e-05,0.0011106915165381968,0.9803921568627451
2316,편안하다/Adjective,102,90,12,0.0010003779205477626,0.0001332829819845836,0.8823529411764706
2317,지경/Noun,102,14,88,0.0001556143431963186,0.000977408534553613,0.8627450980392157
2318,재미나/Noun,102,87,15,0.000967031989862837,0.0001666037274807295,0.8529411764705882
2319,조화/Noun,102,82,20,0.0009114554387212947,0.00022213830330763935,0.803921568627451
2320,곡/Noun,102,78,24,0.0008669941978080608,0.0002665659639691672,0.7647058823529411
2321,팔/Modifier,102,24,78,0.0002667674454794033,0.0008663393828997934,0.7647058823529411
2322,로코/Noun,102,75,27,0.0008336482671231354,0.0002998867094653131,0.7352941176470589
2323,숨/Noun,102,75,27,0.0008336482671231354,0.0002998867094653131,0.7352941176470589
2324,곱다/Adjective,102,69,33,0.0007669564057532845,0.0003665282004576049,0.6764705882352942
2325,절정/Noun,102,64,38,0.0007113798546117422,0.00042206277628451476,0.6274509803921569
2326,클레멘타인/Noun,102,39,63,0.0004334970989040304,0.0006997356554190639,0.6176470588235294
2327,끊다/Verb,102,39,63,0.0004334970989040304,0.0006997356554190639,0.6176470588235294
2328,헤어지다/Verb,102,62,40,0.0006891492341551253,0.0004442766066152787,0.6078431372549019
2329,만약/Noun,102,57,45,0.0006335726830135829,0.0004998111824421885,0.5588235294117647
2330,빵/Noun,102,49,53,0.0005446502011871152,0.0005886665037652442,0.5196078431372549
2331,호/Noun,102,50,52,0.0005557655114154236,0.0005775595885998623,0.5098039215686274
2332,인내심/Noun,101,8,93,8.892248182646778e-05,0.001032943110380523,0.9207920792079208
2333,잠시/Noun,101,75,26,0.0008336482671231354,0.00028877979429993113,0.7425742574257426
2334,묻히다/Verb,101,68,33,0.0007558410955249761,0.0003665282004576049,0.6732673267326733
2335,사운드/Noun,101,67,34,0.0007447257852966677,0.00037763511562298685,0.6633663366336634
2336,그동안/Noun,101,65,36,0.0007224951648400507,0.0003998489459537508,0.6435643564356436
2337,린다/Noun,101,64,37,0.0007113798546117422,0.00041095586111913277,0.6336633663366337
2338,조니뎁/Noun,101,63,38,0.0007002645443834338,0.00042206277628451476,0.6237623762376238
2339,틴/Noun,101,40,61,0.0004446124091323389,0.0006775218250882999,0.6039603960396039
2340,탈출/Noun,101,56,45,0.0006224573727852744,0.0004998111824421885,0.5544554455445545
2341,된거/Noun,101,55,46,0.000611342062556966,0.0005109180976075704,0.5445544554455446
2342,가정/Noun,101,55,46,0.000611342062556966,0.0005109180976075704,0.5445544554455446
2343,사고/Noun,101,55,46,0.000611342062556966,0.0005109180976075704,0.5445544554455446
2344,승리/Noun,101,54,47,0.0006002267523286575,0.0005220250127729525,0.5346534653465347
2345,공/Noun,101,48,53,0.0005335348909588066,0.0005886665037652442,0.5247524752475248
2346,성공/Noun,101,52,49,0.0005779961318720405,0.0005442388431037163,0.5148514851485149
2347,귀/Noun,101,52,49,0.0005779961318720405,0.0005442388431037163,0.5148514851485149
2348,제이슨/Noun,101,50,51,0.0005557655114154236,0.0005664526734344803,0.504950495049505
2349,색/Noun,101,50,51,0.0005557655114154236,0.0005664526734344803,0.504950495049505
2350,마냥/Noun,101,50,51,0.0005557655114154236,0.0005664526734344803,0.504950495049505
2351,앞뒤/Noun,100,11,89,0.00012226841251139318,0.000988515449718995,0.89
2352,울면/Noun,100,87,13,0.000967031989862837,0.00014438989714996557,0.87
2353,플롯/Noun,100,29,71,0.0003223439966209457,0.0007885909767421196,0.71
2354,일본인/Noun,100,30,70,0.00033345930684925416,0.0007774840615767377,0.7
2355,........./Punctuation,100,31,69,0.00034457461707756266,0.0007663771464113557,0.69
2356,상관없다/Adjective,100,34,66,0.00037792054776248805,0.0007330564009152098,0.66
2357,만이/Noun,100,37,63,0.00041126647844741344,0.0006997356554190639,0.63
2358,딱이다/Adjective,100,59,41,0.0006558033034701999,0.00045538352178066063,0.59
2359,그야말로/Adverb,100,59,41,0.0006558033034701999,0.00045538352178066063,0.59
2360,나누다/Verb,100,58,42,0.0006446879932418914,0.0004664904369460426,0.58
2361,추리/Noun,100,43,57,0.0004779583398172643,0.0006330941644267721,0.57
2362,배다/Verb,100,45,55,0.0005001889602738813,0.0006108803340960082,0.55
2363,파괴/Noun,100,46,54,0.0005113042705021897,0.0005997734189306263,0.54
2364,손색/Noun,99,90,9,0.0010003779205477626,9.99622364884377e-05,0.9090909090909091
2365,그만하다/Adjective,99,19,80,0.00021119089433786097,0.0008885532132305574,0.8080808080808081
2366,현대/Noun,99,72,27,0.00080030233643821,0.0002998867094653131,0.7272727272727273
2367,끔찍하다/Adjective,99,28,71,0.0003112286863926372,0.0007885909767421196,0.7171717171717171
2368,꼬/Noun,99,31,68,0.00034457461707756266,0.0007552702312459737,0.6868686868686869
2369,케빈/Noun,99,66,33,0.0007336104750683592,0.0003665282004576049,0.6666666666666666
2370,공간/Noun,99,65,34,0.0007224951648400507,0.00037763511562298685,0.6565656565656566
2371,착각/Noun,99,34,65,0.00037792054776248805,0.0007219494857498279,0.6565656565656566
2372,돼지/Noun,99,35,64,0.0003890358579907965,0.0007108425705844458,0.6464646464646465
2373,임팩트/Noun,99,40,59,0.0004446124091323389,0.000655307994757536,0.5959595959595959
2374,영화제/Noun,99,58,41,0.0006446879932418914,0.00045538352178066063,0.5858585858585859
2375,정이/Noun,99,55,44,0.000611342062556966,0.0004887042672768066,0.5555555555555556
2376,터미네이터/Noun,99,53,46,0.000589111442100349,0.0005109180976075704,0.5353535353535354
2377,저리/Noun,99,51,48,0.0005668808216437321,0.0005331319279383344,0.5151515151515151
2378,센스/Noun,99,48,51,0.0005335348909588066,0.0005664526734344803,0.5151515151515151
2379,이전/Noun,99,49,50,0.0005446502011871152,0.0005553457582690984,0.5050505050505051
2380,나은/Noun,99,49,50,0.0005446502011871152,0.0005553457582690984,0.5050505050505051
2381,어디가/Noun,98,16,82,0.00017784496365293555,0.0009107670435613213,0.8367346938775511
2382,우뢰매/Noun,98,18,80,0.0002000755841095525,0.0008885532132305574,0.8163265306122449
2383,토록/Josa,98,72,26,0.00080030233643821,0.00028877979429993113,0.7346938775510204
2384,실패하다/Adjective,98,28,70,0.0003112286863926372,0.0007774840615767377,0.7142857142857143
2385,박진/Noun,98,65,33,0.0007224951648400507,0.0003665282004576049,0.6632653061224489
2386,겉/Noun,98,35,63,0.0003890358579907965,0.0006997356554190639,0.6428571428571429
2387,논/Noun,98,41,57,0.00045572771936064734,0.0006330941644267721,0.5816326530612245
2388,도에/Foreign,98,53,45,0.000589111442100349,0.0004998111824421885,0.5408163265306123
2389,지치다/Verb,98,48,50,0.0005335348909588066,0.0005553457582690984,0.5102040816326531
2390,뱀파이어/Noun,98,50,48,0.0005557655114154236,0.0005331319279383344,0.5102040816326531
2391,도움/Noun,98,49,49,0.0005446502011871152,0.0005442388431037163,0.5
2392,디워/Noun,97,10,87,0.00011115310228308472,0.0009663016193882312,0.8969072164948454
2393,낚시/Noun,97,11,86,0.00012226841251139318,0.0009551947042228491,0.8865979381443299
2394,부실하다/Adjective,97,13,84,0.00014449903296801013,0.0009329808738920852,0.865979381443299
2395,쓸데없이/Adverb,97,14,83,0.0001556143431963186,0.0009218739587267032,0.8556701030927835
2396,사투리/Noun,97,23,74,0.00025565213525109487,0.0008219117222382655,0.7628865979381443
2397,교과서/Noun,97,73,24,0.0008114176466665184,0.0002665659639691672,0.7525773195876289
2398,밝다/Verb,97,71,26,0.0007891870262099015,0.00028877979429993113,0.7319587628865979
2399,이군/Noun,97,33,64,0.0003668052375341796,0.0007108425705844458,0.6597938144329897
2400,인터넷/Noun,97,40,57,0.0004446124091323389,0.0006330941644267721,0.5876288659793815
2401,발상/Noun,97,40,57,0.0004446124091323389,0.0006330941644267721,0.5876288659793815
2402,연극/Noun,97,42,55,0.00046684302958895584,0.0006108803340960082,0.5670103092783505
2403,들리다/Verb,97,51,46,0.0005668808216437321,0.0005109180976075704,0.5257731958762887
2404,응/Noun,97,46,51,0.0005113042705021897,0.0005664526734344803,0.5257731958762887
2405,자고/Noun,96,11,85,0.00012226841251139318,0.0009440877890574672,0.8854166666666666
2406,심형래/Noun,96,13,83,0.00014449903296801013,0.0009218739587267032,0.8645833333333334
2407,여친/Noun,96,23,73,0.00025565213525109487,0.0008108048070728836,0.7604166666666666
2408,제임스/Noun,96,70,26,0.000778071715981593,0.00028877979429993113,0.7291666666666666
2409,일부러/Noun,96,28,68,0.0003112286863926372,0.0007552702312459737,0.7083333333333334
2410,유덕화/Noun,96,66,30,0.0007336104750683592,0.000333207454961459,0.6875
2411,호기심/Noun,96,30,66,0.00033345930684925416,0.0007330564009152098,0.6875
2412,너무도/Adverb,96,63,33,0.0007002645443834338,0.0003665282004576049,0.65625
2413,대결/Noun,96,61,35,0.0006780339239268168,0.00038874203078836884,0.6354166666666666
2414,대통령/Noun,96,38,58,0.00042238178867572195,0.0006442010795921541,0.6041666666666666
2415,무기/Noun,96,39,57,0.0004334970989040304,0.0006330941644267721,0.59375
2416,고딩/Noun,96,40,56,0.0004446124091323389,0.0006219872492613901,0.5833333333333334
2417,음식/Noun,96,40,56,0.0004446124091323389,0.0006219872492613901,0.5833333333333334
2418,펴다/Verb,96,48,48,0.0005335348909588066,0.0005331319279383344,0.5
2419,체적/Noun,95,10,85,0.00011115310228308472,0.0009440877890574672,0.8947368421052632
2420,이만/Noun,95,82,13,0.0009114554387212947,0.00014438989714996557,0.8631578947368421
2421,팔/Noun,95,16,79,0.00017784496365293555,0.0008774462980651753,0.8315789473684211
2422,듭니/Noun,95,77,18,0.0008558788875797523,0.0001999244729768754,0.8105263157894737
2423,여자애/Noun,95,21,74,0.00023342151479447792,0.0008219117222382655,0.7789473684210526
2424,던데/Noun,95,26,69,0.00028899806593602026,0.0007663771464113557,0.7263157894736842
2425,당황/Noun,95,26,69,0.00028899806593602026,0.0007663771464113557,0.7263157894736842
2426,꽃/Noun,95,68,27,0.0007558410955249761,0.0002998867094653131,0.7157894736842105
2427,에다/Josa,95,28,67,0.0003112286863926372,0.0007441633160805918,0.7052631578947368
2428,평균/Noun,95,28,67,0.0003112286863926372,0.0007441633160805918,0.7052631578947368
2429,조카/Noun,95,66,29,0.0007336104750683592,0.00032210053979607705,0.6947368421052632
2430,100%/Number,95,62,33,0.0006891492341551253,0.0003665282004576049,0.6526315789473685
2431,겁/Noun,95,33,62,0.0003668052375341796,0.000688628740253682,0.6526315789473685
2432,선정/Noun,95,33,62,0.0003668052375341796,0.000688628740253682,0.6526315789473685
2433,잡고/Noun,95,38,57,0.00042238178867572195,0.0006330941644267721,0.6
2434,옛/Adverb,95,54,41,0.0006002267523286575,0.00045538352178066063,0.5684210526315789
2435,제니퍼/Noun,95,44,51,0.0004890736500455727,0.0005664526734344803,0.5368421052631579
2436,삼/Modifier,95,45,50,0.0005001889602738813,0.0005553457582690984,0.5263157894736842
2437,40/Number,95,49,46,0.0005446502011871152,0.0005109180976075704,0.5157894736842106
2438,아끼다/Verb,95,46,49,0.0005113042705021897,0.0005442388431037163,0.5157894736842106
2439,요리/Noun,95,46,49,0.0005113042705021897,0.0005442388431037163,0.5157894736842106
2440,의상/Noun,95,47,48,0.0005224195807304982,0.0005331319279383344,0.5052631578947369
2441,겨울/Noun,94,77,17,0.0008558788875797523,0.00018881755781149343,0.8191489361702128
2442,말투/Noun,94,24,70,0.0002667674454794033,0.0007774840615767377,0.7446808510638298
2443,상실/Noun,94,24,70,0.0002667674454794033,0.0007774840615767377,0.7446808510638298
2444,ㅈ/KoreanParticle,94,27,67,0.00030011337616432876,0.0007441633160805918,0.7127659574468085
2445,베드/Noun,94,29,65,0.0003223439966209457,0.0007219494857498279,0.6914893617021277
2446,에게도/Josa,94,65,29,0.0007224951648400507,0.00032210053979607705,0.6914893617021277
2447,루즈/Noun,94,34,60,0.00037792054776248805,0.000666414909922918,0.6382978723404256
2448,난리/Noun,94,34,60,0.00037792054776248805,0.000666414909922918,0.6382978723404256
2449,주지/Noun,94,36,58,0.000400151168219105,0.0006442010795921541,0.6170212765957447
2450,찬/Noun,94,55,39,0.000611342062556966,0.0004331696914498967,0.5851063829787234
2451,링/Noun,94,41,53,0.00045572771936064734,0.0005886665037652442,0.5638297872340425
2452,니콜/Noun,94,41,53,0.00045572771936064734,0.0005886665037652442,0.5638297872340425
2453,드러나다/Verb,94,51,43,0.0005668808216437321,0.00047759735211142456,0.5425531914893617
2454,정보/Noun,94,51,43,0.0005668808216437321,0.00047759735211142456,0.5425531914893617
2455,류작/Noun,93,5,88,5.557655114154236e-05,0.000977408534553613,0.946236559139785
2456,도무지/Noun,93,7,86,7.78071715981593e-05,0.0009551947042228491,0.9247311827956989
2457,I/Alpha,93,76,17,0.0008447635773514439,0.00018881755781149343,0.8172043010752689
2458,녹다/Verb,93,76,17,0.0008447635773514439,0.00018881755781149343,0.8172043010752689
2459,성의/Noun,93,23,70,0.00025565213525109487,0.0007774840615767377,0.7526881720430108
2460,차갑다/Adjective,93,68,25,0.0007558410955249761,0.0002776728791345492,0.7311827956989247
2461,애초/Noun,93,30,63,0.00033345930684925416,0.0006997356554190639,0.6774193548387096
2462,반대/Noun,93,32,61,0.0003556899273058711,0.0006775218250882999,0.6559139784946236
2463,거치다/Verb,93,61,32,0.0006780339239268168,0.0003554212852922229,0.6559139784946236
2464,무난/Noun,93,34,59,0.00037792054776248805,0.000655307994757536,0.6344086021505376
2465,단체/Noun,93,34,59,0.00037792054776248805,0.000655307994757536,0.6344086021505376
2466,단순/Noun,93,38,55,0.00042238178867572195,0.0006108803340960082,0.5913978494623656
2467,틀어주다/Verb,93,38,55,0.00042238178867572195,0.0006108803340960082,0.5913978494623656
2468,레이/Noun,93,54,39,0.0006002267523286575,0.0004331696914498967,0.5806451612903226
2469,치고는/Josa,93,40,53,0.0004446124091323389,0.0005886665037652442,0.5698924731182796
2470,주윤발/Noun,93,42,51,0.00046684302958895584,0.0005664526734344803,0.5483870967741935
2471,베다/Verb,93,50,43,0.0005557655114154236,0.00047759735211142456,0.5376344086021505
2472,하이/Noun,93,48,45,0.0005335348909588066,0.0004998111824421885,0.5161290322580645
2473,수입/Noun,92,12,80,0.00013338372273970166,0.0008885532132305574,0.8695652173913043
2474,처절하다/Adjective,92,74,18,0.0008225329568948269,0.0001999244729768754,0.8043478260869565
2475,딴/Modifier,92,19,73,0.00021119089433786097,0.0008108048070728836,0.7934782608695652
2476,컨셉/Noun,92,20,72,0.00022230620456616945,0.0007996978919075016,0.782608695652174
2477,고프다/Adjective,92,71,21,0.0007891870262099015,0.0002332452184730213,0.7717391304347826
2478,절/Noun,92,23,69,0.00025565213525109487,0.0007663771464113557,0.75
2479,드디어/Adverb,92,68,24,0.0007558410955249761,0.0002665659639691672,0.7391304347826086
2480,흥/Noun,92,66,26,0.0007336104750683592,0.00028877979429993113,0.717391304347826
2481,반드시/Noun,92,65,27,0.0007224951648400507,0.0002998867094653131,0.7065217391304348
2482,진수/Noun,92,64,28,0.0007113798546117422,0.00031099362463069506,0.6956521739130435
2483,쥐다/Verb,92,34,58,0.00037792054776248805,0.0006442010795921541,0.6304347826086957
2484,13/Number,92,34,58,0.00037792054776248805,0.0006442010795921541,0.6304347826086957
2485,대사도/Noun,92,35,57,0.0003890358579907965,0.0006330941644267721,0.6195652173913043
2486,속이다/Verb,92,37,55,0.00041126647844741344,0.0006108803340960082,0.5978260869565217
2487,중심/Noun,92,38,54,0.00042238178867572195,0.0005997734189306263,0.5869565217391305
2488,다리/Noun,92,38,54,0.00042238178867572195,0.0005997734189306263,0.5869565217391305
2489,어/Eomi,92,38,54,0.00042238178867572195,0.0005997734189306263,0.5869565217391305
2490,빵터지다/Adjective,92,40,52,0.0004446124091323389,0.0005775595885998623,0.5652173913043478
2491,푸다/Verb,92,40,52,0.0004446124091323389,0.0005775595885998623,0.5652173913043478
2492,준비/Noun,92,48,44,0.0005335348909588066,0.0004887042672768066,0.5217391304347826
2493,2014년/Number,92,47,45,0.0005224195807304982,0.0004998111824421885,0.5108695652173914
2494,아기/Noun,92,47,45,0.0005224195807304982,0.0004998111824421885,0.5108695652173914
2495,웰/Noun,91,86,5,0.0009559166796345286,5.5534575826909837e-05,0.945054945054945
2496,어우러지다/Verb,91,85,6,0.0009448013694062201,6.66414909922918e-05,0.9340659340659341
2497,만드/Noun,91,14,77,0.0001556143431963186,0.0008552324677344115,0.8461538461538461
2498,혐오/Noun,91,15,76,0.00016672965342462708,0.0008441255525690295,0.8351648351648352
2499,명대사/Noun,91,72,19,0.00080030233643821,0.00021103138814225738,0.7912087912087912
2500,살인마/Noun,91,21,70,0.00023342151479447792,0.0007774840615767377,0.7692307692307693
2501,실수/Noun,91,25,66,0.0002778827557077118,0.0007330564009152098,0.7252747252747253
2502,베리/Noun,91,65,26,0.0007224951648400507,0.00028877979429993113,0.7142857142857143
2503,비중/Noun,91,30,61,0.00033345930684925416,0.0006775218250882999,0.6703296703296703
2504,무게/Noun,91,60,31,0.0006669186136985083,0.000344314370126841,0.6593406593406593
2505,잭/Noun,91,60,31,0.0006669186136985083,0.000344314370126841,0.6593406593406593
2506,붙다/Verb,91,31,60,0.00034457461707756266,0.000666414909922918,0.6593406593406593
2507,........../Punctuation,91,34,57,0.00037792054776248805,0.0006330941644267721,0.6263736263736264
2508,영향/Noun,91,56,35,0.0006224573727852744,0.00038874203078836884,0.6153846153846154
2509,키드/Noun,91,39,52,0.0004334970989040304,0.0005775595885998623,0.5714285714285714
2510,화란/Noun,91,39,52,0.0004334970989040304,0.0005775595885998623,0.5714285714285714
2511,론/Noun,91,39,52,0.0004334970989040304,0.0005775595885998623,0.5714285714285714
2512,의사/Noun,91,43,48,0.0004779583398172643,0.0005331319279383344,0.5274725274725275
2513,기존/Noun,91,44,47,0.0004890736500455727,0.0005220250127729525,0.5164835164835165
2514,계기/Noun,90,72,18,0.00080030233643821,0.0001999244729768754,0.8
2515,논리/Noun,90,20,70,0.00022230620456616945,0.0007774840615767377,0.7777777777777778
2516,최고봉/Noun,90,68,22,0.0007558410955249761,0.0002443521336384033,0.7555555555555555
2517,운/Noun,90,65,25,0.0007224951648400507,0.0002776728791345492,0.7222222222222222
2518,어떻/Modifier,90,25,65,0.0002778827557077118,0.0007219494857498279,0.7222222222222222
2519,레/Noun,90,25,65,0.0002778827557077118,0.0007219494857498279,0.7222222222222222
2520,암/Modifier,90,26,64,0.00028899806593602026,0.0007108425705844458,0.7111111111111111
2521,매일/Noun,90,62,28,0.0006891492341551253,0.00031099362463069506,0.6888888888888889
2522,쿡/Noun,90,30,60,0.00033345930684925416,0.000666414909922918,0.6666666666666666
2523,깍/Adverb,90,31,59,0.00034457461707756266,0.000655307994757536,0.6555555555555556
2524,및/Noun,90,31,59,0.00034457461707756266,0.000655307994757536,0.6555555555555556
2525,데뷔/Noun,90,59,31,0.0006558033034701999,0.000344314370126841,0.6555555555555556
2526,걱정/Noun,90,58,32,0.0006446879932418914,0.0003554212852922229,0.6444444444444445
2527,다/Noun,90,33,57,0.0003668052375341796,0.0006330941644267721,0.6333333333333333
2528,여자친구/Noun,90,33,57,0.0003668052375341796,0.0006330941644267721,0.6333333333333333
2529,동성애/Noun,90,35,55,0.0003890358579907965,0.0006108803340960082,0.6111111111111112
2530,자동차/Noun,90,40,50,0.0004446124091323389,0.0005553457582690984,0.5555555555555556
2531,앤/Noun,90,50,40,0.0005557655114154236,0.0004442766066152787,0.5555555555555556
2532,의지/Noun,90,49,41,0.0005446502011871152,0.00045538352178066063,0.5444444444444444
2533,차원/Noun,90,48,42,0.0005335348909588066,0.0004664904369460426,0.5333333333333333
2534,네티즌/Noun,90,45,45,0.0005001889602738813,0.0004998111824421885,0.5
2535,게뭐/Noun,89,7,82,7.78071715981593e-05,0.0009107670435613213,0.9213483146067416
2536,감사/Noun,89,78,11,0.0008669941978080608,0.00012217606681920164,0.8764044943820225
2537,빨갱이/Noun,89,18,71,0.0002000755841095525,0.0007885909767421196,0.797752808988764
2538,ㅉ/KoreanParticle,89,18,71,0.0002000755841095525,0.0007885909767421196,0.797752808988764
2539,강력/Noun,89,70,19,0.000778071715981593,0.00021103138814225738,0.7865168539325843
2540,아무튼/Adverb,89,62,27,0.0006891492341551253,0.0002998867094653131,0.6966292134831461
2541,섞다/Verb,89,28,61,0.0003112286863926372,0.0006775218250882999,0.6853932584269663
2542,박중훈/Noun,89,58,31,0.0006446879932418914,0.000344314370126841,0.651685393258427
2543,폭발/Noun,89,58,31,0.0006446879932418914,0.000344314370126841,0.651685393258427
2544,각색/Noun,89,32,57,0.0003556899273058711,0.0006330941644267721,0.6404494382022472
2545,포/Noun,89,33,56,0.0003668052375341796,0.0006219872492613901,0.6292134831460674
2546,dvd/Alpha,89,56,33,0.0006224573727852744,0.0003665282004576049,0.6292134831460674
2547,부작/Noun,89,55,34,0.000611342062556966,0.00037763511562298685,0.6179775280898876
2548,ㄴ/KoreanParticle,89,34,55,0.00037792054776248805,0.0006108803340960082,0.6179775280898876
2549,필/Noun,89,35,54,0.0003890358579907965,0.0005997734189306263,0.6067415730337079
2550,와도/Josa,89,51,38,0.0005668808216437321,0.00042206277628451476,0.5730337078651685
2551,아아/Noun,89,48,41,0.0005335348909588066,0.00045538352178066063,0.5393258426966292
2552,ㅏ/KoreanParticle,89,47,42,0.0005224195807304982,0.0004664904369460426,0.5280898876404494
2553,신인/Noun,89,47,42,0.0005224195807304982,0.0004664904369460426,0.5280898876404494
2554,할리우드/Noun,89,46,43,0.0005113042705021897,0.00047759735211142456,0.5168539325842697
2555,과학/Noun,89,46,43,0.0005113042705021897,0.00047759735211142456,0.5168539325842697
2556,리얼리티/Noun,89,46,43,0.0005113042705021897,0.00047759735211142456,0.5168539325842697
2557,개그맨/Noun,88,4,84,4.446124091323389e-05,0.0009329808738920852,0.9545454545454546
2558,마음속/Noun,88,83,5,0.0009225707489496032,5.5534575826909837e-05,0.9431818181818182
2559,ㅄ/KoreanParticle,88,15,73,0.00016672965342462708,0.0008108048070728836,0.8295454545454546
2560,동심/Noun,88,64,24,0.0007113798546117422,0.0002665659639691672,0.7272727272727273
2561,폴/Noun,88,64,24,0.0007113798546117422,0.0002665659639691672,0.7272727272727273
2562,피해/Noun,88,24,64,0.0002667674454794033,0.0007108425705844458,0.7272727272727273
2563,에이/Noun,88,26,62,0.00028899806593602026,0.000688628740253682,0.7045454545454546
2564,만화책/Noun,88,26,62,0.00028899806593602026,0.000688628740253682,0.7045454545454546
2565,?.../Punctuation,88,30,58,0.00033345930684925416,0.0006442010795921541,0.6590909090909091
2566,출신/Noun,88,33,55,0.0003668052375341796,0.0006108803340960082,0.625
2567,ㅣ/KoreanParticle,88,34,54,0.00037792054776248805,0.0005997734189306263,0.6136363636363636
2568,끝내/Noun,88,34,54,0.00037792054776248805,0.0005997734189306263,0.6136363636363636
2569,부정/Noun,88,54,34,0.0006002267523286575,0.00037763511562298685,0.6136363636363636
2570,아놀드/Noun,88,52,36,0.0005779961318720405,0.0003998489459537508,0.5909090909090909
2571,조/Suffix,88,52,36,0.0005779961318720405,0.0003998489459537508,0.5909090909090909
2572,극단/Noun,88,37,51,0.00041126647844741344,0.0005664526734344803,0.5795454545454546
2573,유럽/Noun,88,42,46,0.00046684302958895584,0.0005109180976075704,0.5227272727272727
2574,블랙/Noun,88,45,43,0.0005001889602738813,0.00047759735211142456,0.5113636363636364
2575,리지/Noun,88,43,45,0.0004779583398172643,0.0004998111824421885,0.5113636363636364
2576,보신/Noun,88,45,43,0.0005001889602738813,0.00047759735211142456,0.5113636363636364
2577,♥♥♥/Foreign,87,86,1,0.0009559166796345286,1.1106915165381966e-05,0.9885057471264368
2578,어거지/Noun,87,8,79,8.892248182646778e-05,0.0008774462980651753,0.9080459770114943
2579,난잡하다/Adjective,87,8,79,8.892248182646778e-05,0.0008774462980651753,0.9080459770114943
2580,발음/Noun,87,17,70,0.00018896027388124403,0.0007774840615767377,0.8045977011494253
2581,듣기/Noun,87,21,66,0.00023342151479447792,0.0007330564009152098,0.7586206896551724
2582,친/Noun,87,25,62,0.0002778827557077118,0.000688628740253682,0.7126436781609196
2583,무한/Noun,87,60,27,0.0006669186136985083,0.0002998867094653131,0.6896551724137931
2584,배신/Noun,87,32,55,0.0003556899273058711,0.0006108803340960082,0.632183908045977
2585,알아보다/Verb,87,33,54,0.0003668052375341796,0.0005997734189306263,0.6206896551724138
2586,하니/Noun,87,34,53,0.00037792054776248805,0.0005886665037652442,0.6091954022988506
2587,역사상/Noun,87,52,35,0.0005779961318720405,0.00038874203078836884,0.5977011494252874
2588,파리/Noun,87,50,37,0.0005557655114154236,0.00041095586111913277,0.5747126436781609
2589,요새/Noun,87,50,37,0.0005557655114154236,0.00041095586111913277,0.5747126436781609
2590,인게/Josa,87,38,49,0.00042238178867572195,0.0005442388431037163,0.5632183908045977
2591,///Punctuation,87,47,40,0.0005224195807304982,0.0004442766066152787,0.5402298850574713
2592,평소/Noun,87,47,40,0.0005224195807304982,0.0004442766066152787,0.5402298850574713
2593,질리다/Verb,87,41,46,0.00045572771936064734,0.0005109180976075704,0.5287356321839081
2594,일반/Noun,87,41,46,0.00045572771936064734,0.0005109180976075704,0.5287356321839081
2595,무대/Noun,87,43,44,0.0004779583398172643,0.0004887042672768066,0.5057471264367817
2596,토나오다/Verb,86,4,82,4.446124091323389e-05,0.0009107670435613213,0.9534883720930233
2597,별하나/Noun,86,4,82,4.446124091323389e-05,0.0009107670435613213,0.9534883720930233
2598,다세포/Noun,86,8,78,8.892248182646778e-05,0.0008663393828997934,0.9069767441860465
2599,개콘/Noun,86,9,77,0.00010003779205477625,0.0008552324677344115,0.8953488372093024
2600,황당/Noun,86,9,77,0.00010003779205477625,0.0008552324677344115,0.8953488372093024
2601,영화감독/Noun,86,14,72,0.0001556143431963186,0.0007996978919075016,0.8372093023255814
2602,언니/Suffix,86,70,16,0.000778071715981593,0.00017771064264611146,0.813953488372093
2603,최소한/Noun,86,18,68,0.0002000755841095525,0.0007552702312459737,0.7906976744186046
2604,컴퓨터/Noun,86,20,66,0.00022230620456616945,0.0007330564009152098,0.7674418604651163
2605,경우/Noun,86,27,59,0.00030011337616432876,0.000655307994757536,0.686046511627907
2606,해리포터/Noun,86,57,29,0.0006335726830135829,0.00032210053979607705,0.6627906976744186
2607,추/Noun,86,56,30,0.0006224573727852744,0.000333207454961459,0.6511627906976745
2608,나레이션/Noun,86,30,56,0.00033345930684925416,0.0006219872492613901,0.6511627906976745
2609,손가락/Noun,86,53,33,0.000589111442100349,0.0003665282004576049,0.6162790697674418
2610,거장/Noun,86,52,34,0.0005779961318720405,0.00037763511562298685,0.6046511627906976
2611,얼다/Verb,86,36,50,0.000400151168219105,0.0005553457582690984,0.5813953488372093
2612,판단/Noun,86,49,37,0.0005446502011871152,0.00041095586111913277,0.5697674418604651
2613,배트맨/Noun,86,48,38,0.0005335348909588066,0.00042206277628451476,0.5581395348837209
2614,심다/Verb,86,39,47,0.0004334970989040304,0.0005220250127729525,0.5465116279069767
2615,스티븐/Noun,86,39,47,0.0004334970989040304,0.0005220250127729525,0.5465116279069767
2616,하지원/Noun,86,46,40,0.0005113042705021897,0.0004442766066152787,0.5348837209302325
2617,인형/Noun,86,41,45,0.00045572771936064734,0.0004998111824421885,0.5232558139534884
2618,한국판/Noun,86,45,41,0.0005001889602738813,0.00045538352178066063,0.5232558139534884
2619,홍상수/Noun,86,44,42,0.0004890736500455727,0.0004664904369460426,0.5116279069767442
2620,인류/Noun,86,44,42,0.0004890736500455727,0.0004664904369460426,0.5116279069767442
2621,겉멋/Noun,85,7,78,7.78071715981593e-05,0.0008663393828997934,0.9176470588235294
2622,싫어지다/Adjective,85,9,76,0.00010003779205477625,0.0008441255525690295,0.8941176470588236
2623,압도/Noun,85,75,10,0.0008336482671231354,0.00011106915165381967,0.8823529411764706
2624,담담하다/Adjective,85,71,14,0.0007891870262099015,0.00015549681231534753,0.8352941176470589
2625,누군지/Adverb,85,21,64,0.00023342151479447792,0.0007108425705844458,0.7529411764705882
2626,딱/VerbPrefix,85,23,62,0.00025565213525109487,0.000688628740253682,0.7294117647058823
2627,정말/Exclamation,85,60,25,0.0006669186136985083,0.0002776728791345492,0.7058823529411765
2628,여인/Noun,85,57,28,0.0006335726830135829,0.00031099362463069506,0.6705882352941176
2629,환경/Noun,85,55,30,0.000611342062556966,0.000333207454961459,0.6470588235294118
2630,곧/Noun,85,54,31,0.0006002267523286575,0.000344314370126841,0.6352941176470588
2631,ㄷ/KoreanParticle,85,54,31,0.0006002267523286575,0.000344314370126841,0.6352941176470588
2632,찌질하다/Adjective,85,33,52,0.0003668052375341796,0.0005775595885998623,0.611764705882353
2633,누르다/Verb,85,34,51,0.00037792054776248805,0.0005664526734344803,0.6
2634,밖/Noun,85,45,40,0.0005001889602738813,0.0004442766066152787,0.5294117647058824
2635,션/Noun,85,43,42,0.0004779583398172643,0.0004664904369460426,0.5058823529411764
2636,깨알/Noun,84,76,8,0.0008447635773514439,8.885532132305573e-05,0.9047619047619048
2637,민폐/Noun,84,11,73,0.00012226841251139318,0.0008108048070728836,0.8690476190476191
2638,쓸데없다/Adjective,84,14,70,0.0001556143431963186,0.0007774840615767377,0.8333333333333334
2639,부리다/Verb,84,17,67,0.00018896027388124403,0.0007441633160805918,0.7976190476190477
2640,이루어지다/Verb,84,66,18,0.0007336104750683592,0.0001999244729768754,0.7857142857142857
2641,--/Punctuation,84,19,65,0.00021119089433786097,0.0007219494857498279,0.7738095238095238
2642,어쩌면/Noun,84,62,22,0.0006891492341551253,0.0002443521336384033,0.7380952380952381
2643,임창정/Noun,84,58,26,0.0006446879932418914,0.00028877979429993113,0.6904761904761905
2644,화일/Noun,84,26,58,0.00028899806593602026,0.0006442010795921541,0.6904761904761905
2645,성적/Noun,84,32,52,0.0003556899273058711,0.0005775595885998623,0.6190476190476191
2646,이니까/Josa,84,49,35,0.0005446502011871152,0.00038874203078836884,0.5833333333333334
2647,연/Noun,84,49,35,0.0005446502011871152,0.00038874203078836884,0.5833333333333334
2648,오프닝/Noun,84,48,36,0.0005335348909588066,0.0003998489459537508,0.5714285714285714
2649,".,/Punctuation",84,47,37,0.0005224195807304982,0.00041095586111913277,0.5595238095238095
2650,남성/Noun,84,45,39,0.0005001889602738813,0.0004331696914498967,0.5357142857142857
2651,단점/Noun,84,39,45,0.0004334970989040304,0.0004998111824421885,0.5357142857142857
2652,러시아/Noun,84,43,41,0.0004779583398172643,0.00045538352178066063,0.5119047619047619
2653,영화사/Noun,84,42,42,0.00046684302958895584,0.0004664904369460426,0.5
2654,..!/Punctuation,83,74,9,0.0008225329568948269,9.99622364884377e-05,0.891566265060241
2655,흉내/Noun,83,11,72,0.00012226841251139318,0.0007996978919075016,0.8674698795180723
2656,달콤하다/Adjective,83,68,15,0.0007558410955249761,0.0001666037274807295,0.8192771084337349
2657,방해/Noun,83,18,65,0.0002000755841095525,0.0007219494857498279,0.7831325301204819
2658,김치/Noun,83,22,61,0.00024453682502278637,0.0006775218250882999,0.7349397590361446
2659,분량/Noun,83,25,58,0.0002778827557077118,0.0006442010795921541,0.6987951807228916
2660,향수/Noun,83,57,26,0.0006335726830135829,0.00028877979429993113,0.6867469879518072
2661,코메디/Noun,83,27,56,0.00030011337616432876,0.0006219872492613901,0.6746987951807228
2662,사/Noun,83,56,27,0.0006224573727852744,0.0002998867094653131,0.6746987951807228
2663,매/Noun,83,53,30,0.000589111442100349,0.000333207454961459,0.6385542168674698
2664,판이/Noun,83,33,50,0.0003668052375341796,0.0005553457582690984,0.6024096385542169
2665,만화영화/Noun,83,47,36,0.0005224195807304982,0.0003998489459537508,0.5662650602409639
2666,무너지다/Verb,83,36,47,0.000400151168219105,0.0005220250127729525,0.5662650602409639
2667,쉽다/Adjective,83,37,46,0.00041126647844741344,0.0005109180976075704,0.5542168674698795
2668,전하/Noun,83,38,45,0.00042238178867572195,0.0004998111824421885,0.5421686746987951
2669,널/Noun,83,42,41,0.00046684302958895584,0.00045538352178066063,0.5060240963855421
2670,슈퍼/Noun,83,42,41,0.00046684302958895584,0.00045538352178066063,0.5060240963855421
2671,키스/Noun,83,42,41,0.00046684302958895584,0.00045538352178066063,0.5060240963855421
2672,명복/Noun,82,74,8,0.0008225329568948269,8.885532132305573e-05,0.9024390243902439
2673,거품/Noun,82,12,70,0.00013338372273970166,0.0007774840615767377,0.8536585365853658
2674,동영상/Noun,82,12,70,0.00013338372273970166,0.0007774840615767377,0.8536585365853658
2675,고뇌/Noun,82,57,25,0.0006335726830135829,0.0002776728791345492,0.6951219512195121
2676,늘리다/Verb,82,25,57,0.0002778827557077118,0.0006330941644267721,0.6951219512195121
2677,능/Noun,82,55,27,0.000611342062556966,0.0002998867094653131,0.6707317073170732
2678,흡입/Noun,82,53,29,0.000589111442100349,0.00032210053979607705,0.6463414634146342
2679,윌리스/Noun,82,29,53,0.0003223439966209457,0.0005886665037652442,0.6463414634146342
2680,때매/Noun,82,30,52,0.00033345930684925416,0.0005775595885998623,0.6341463414634146
2681,인도/Noun,82,51,31,0.0005668808216437321,0.000344314370126841,0.6219512195121951
2682,잡히다/Verb,82,31,51,0.00034457461707756266,0.0005664526734344803,0.6219512195121951
2683,매끄럽다/Adjective,82,32,50,0.0003556899273058711,0.0005553457582690984,0.6097560975609756
2684,든지/Josa,82,32,50,0.0003556899273058711,0.0005553457582690984,0.6097560975609756
2685,길이/Noun,82,49,33,0.0005446502011871152,0.0003665282004576049,0.5975609756097561
2686,중년/Noun,82,48,34,0.0005335348909588066,0.00037763511562298685,0.5853658536585366
2687,부족함/Noun,82,35,47,0.0003890358579907965,0.0005220250127729525,0.573170731707317
2688,일으키다/Verb,82,37,45,0.00041126647844741344,0.0004998111824421885,0.5487804878048781
2689,전투/Noun,82,45,37,0.0005001889602738813,0.00041095586111913277,0.5487804878048781
2690,이병헌/Noun,82,39,43,0.0004334970989040304,0.00047759735211142456,0.524390243902439
2691,슴/Noun,82,39,43,0.0004334970989040304,0.00047759735211142456,0.524390243902439
2692,섞이다/Verb,82,41,41,0.00045572771936064734,0.00045538352178066063,0.5
2693,탁월하다/Adjective,81,73,8,0.0008114176466665184,8.885532132305573e-05,0.9012345679012346
2694,도데/Noun,81,8,73,8.892248182646778e-05,0.0008108048070728836,0.9012345679012346
2695,짜리/Foreign,81,12,69,0.00013338372273970166,0.0007663771464113557,0.8518518518518519
2696,속지/Noun,81,13,68,0.00014449903296801013,0.0007552702312459737,0.8395061728395061
2697,역량/Noun,81,13,68,0.00014449903296801013,0.0007552702312459737,0.8395061728395061
2698,배급사/Noun,81,15,66,0.00016672965342462708,0.0007330564009152098,0.8148148148148148
2699,징그럽다/Adjective,81,17,64,0.00018896027388124403,0.0007108425705844458,0.7901234567901234
2700,이해도/Noun,81,17,64,0.00018896027388124403,0.0007108425705844458,0.7901234567901234
2701,염/Noun,81,60,21,0.0006669186136985083,0.0002332452184730213,0.7407407407407407
2702,몽환/Noun,81,59,22,0.0006558033034701999,0.0002443521336384033,0.7283950617283951
2703,박다/Verb,81,22,59,0.00024453682502278637,0.000655307994757536,0.7283950617283951
2704,짜이다/Verb,81,56,25,0.0006224573727852744,0.0002776728791345492,0.691358024691358
2705,약/Modifier,81,26,55,0.00028899806593602026,0.0006108803340960082,0.6790123456790124
2706,그렇지만/Conjunction,81,55,26,0.000611342062556966,0.00028877979429993113,0.6790123456790124
2707,옴/Noun,81,26,55,0.00028899806593602026,0.0006108803340960082,0.6790123456790124
2708,실험/Noun,81,29,52,0.0003223439966209457,0.0005775595885998623,0.6419753086419753
2709,극복/Noun,81,51,30,0.0005668808216437321,0.000333207454961459,0.6296296296296297
2710,사용/Noun,81,31,50,0.00034457461707756266,0.0005553457582690984,0.6172839506172839
2711,1회/Number,81,49,32,0.0005446502011871152,0.0003554212852922229,0.6049382716049383
2712,이소룡/Noun,81,48,33,0.0005335348909588066,0.0003665282004576049,0.5925925925925926
2713,왕/Suffix,81,33,48,0.0003668052375341796,0.0005331319279383344,0.5925925925925926
2714,스포/Noun,81,47,34,0.0005224195807304982,0.00037763511562298685,0.5802469135802469
2715,화장실/Noun,81,34,47,0.00037792054776248805,0.0005220250127729525,0.5802469135802469
2716,d/Alpha,81,35,46,0.0003890358579907965,0.0005109180976075704,0.5679012345679012
2717,도시/Noun,81,46,35,0.0005113042705021897,0.00038874203078836884,0.5679012345679012
2718,멍/Noun,81,36,45,0.000400151168219105,0.0004998111824421885,0.5555555555555556
2719,파격/Noun,81,42,39,0.00046684302958895584,0.0004331696914498967,0.5185185185185185
2720,중국영화/Noun,81,39,42,0.0004334970989040304,0.0004664904369460426,0.5185185185185185
2721,천국/Noun,81,40,41,0.0004446124091323389,0.00045538352178066063,0.5061728395061729
2722,담백하다/Adjective,80,75,5,0.0008336482671231354,5.5534575826909837e-05,0.9375
2723,삶다/Verb,80,68,12,0.0007558410955249761,0.0001332829819845836,0.85
2724,가히/Adverb,80,68,12,0.0007558410955249761,0.0001332829819845836,0.85
2725,지리다/Verb,80,63,17,0.0007002645443834338,0.00018881755781149343,0.7875
2726,킬링/Noun,80,22,58,0.00024453682502278637,0.0006442010795921541,0.725
2727,장점/Noun,80,23,57,0.00025565213525109487,0.0006330941644267721,0.7125
2728,등록/Noun,80,23,57,0.00025565213525109487,0.0006330941644267721,0.7125
2729,망가지다/Verb,80,26,54,0.00028899806593602026,0.0005997734189306263,0.675
2730,하정우/Noun,80,53,27,0.000589111442100349,0.0002998867094653131,0.6625
2731,미녀/Noun,80,30,50,0.00033345930684925416,0.0005553457582690984,0.625
2732,독일/Noun,80,48,32,0.0005335348909588066,0.0003554212852922229,0.6
2733,가리다/Verb,80,33,47,0.0003668052375341796,0.0005220250127729525,0.5875
2734,마약/Noun,80,33,47,0.0003668052375341796,0.0005220250127729525,0.5875
2735,은/Foreign,80,33,47,0.0003668052375341796,0.0005220250127729525,0.5875
2736,군인/Noun,80,34,46,0.00037792054776248805,0.0005109180976075704,0.575
2737,에서만/Josa,80,35,45,0.0003890358579907965,0.0004998111824421885,0.5625
2738,버튼/Noun,80,45,35,0.0005001889602738813,0.00038874203078836884,0.5625
2739,액션씬/Noun,80,42,38,0.00046684302958895584,0.00042206277628451476,0.525
2740,정우성/Noun,80,39,41,0.0004334970989040304,0.00045538352178066063,0.5125
2741,밀려오다/Verb,80,41,39,0.00045572771936064734,0.0004331696914498967,0.5125
2742,오는/Modifier,80,41,39,0.00045572771936064734,0.0004331696914498967,0.5125
2743,천/Modifier,80,41,39,0.00045572771936064734,0.0004331696914498967,0.5125
2744,완벽/Noun,79,71,8,0.0007891870262099015,8.885532132305573e-05,0.8987341772151899
2745,그럴듯하다/Adjective,79,8,71,8.892248182646778e-05,0.0007885909767421196,0.8987341772151899
2746,의외/Noun,79,65,14,0.0007224951648400507,0.00015549681231534753,0.8227848101265823
2747,딱/Modifier,79,16,63,0.00017784496365293555,0.0006997356554190639,0.7974683544303798
2748,분장/Noun,79,17,62,0.00018896027388124403,0.000688628740253682,0.7848101265822784
2749,언젠가/Adverb,79,59,20,0.0006558033034701999,0.00022213830330763935,0.7468354430379747
2750,파다/Verb,79,24,55,0.0002667674454794033,0.0006108803340960082,0.6962025316455697
2751,샘/Noun,79,53,26,0.000589111442100349,0.00028877979429993113,0.6708860759493671
2752,중딩/Noun,79,27,52,0.00030011337616432876,0.0005775595885998623,0.6582278481012658
2753,정상/Noun,79,27,52,0.00030011337616432876,0.0005775595885998623,0.6582278481012658
2754,에다가/Josa,79,29,50,0.0003223439966209457,0.0005553457582690984,0.6329113924050633
2755,라기/Josa,79,30,49,0.00033345930684925416,0.0005442388431037163,0.620253164556962
2756,미도/Noun,79,48,31,0.0005335348909588066,0.000344314370126841,0.6075949367088608
2757,of/Alpha,79,48,31,0.0005335348909588066,0.000344314370126841,0.6075949367088608
2758,순/Modifier,79,45,34,0.0005001889602738813,0.00037763511562298685,0.569620253164557
2759,후회되다/Adjective,79,35,44,0.0003890358579907965,0.0004887042672768066,0.5569620253164557
2760,유지/Noun,79,39,40,0.0004334970989040304,0.0004442766066152787,0.5063291139240507
2761,순위/Noun,79,39,40,0.0004334970989040304,0.0004442766066152787,0.5063291139240507
2762,위트/Noun,78,66,12,0.0007336104750683592,0.0001332829819845836,0.8461538461538461
2763,치유/Noun,78,66,12,0.0007336104750683592,0.0001332829819845836,0.8461538461538461
2764,아치/Noun,78,14,64,0.0001556143431963186,0.0007108425705844458,0.8205128205128205
2765,만도/Josa,78,15,63,0.00016672965342462708,0.0006997356554190639,0.8076923076923077
2766,애절하다/Adjective,78,62,16,0.0006891492341551253,0.00017771064264611146,0.7948717948717948
2767,알려지다/Verb,78,58,20,0.0006446879932418914,0.00022213830330763935,0.7435897435897436
2768,이구만/Josa,78,20,58,0.00022230620456616945,0.0006442010795921541,0.7435897435897436
2769,왜곡/Noun,78,22,56,0.00024453682502278637,0.0006219872492613901,0.717948717948718
2770,상어/Noun,78,25,53,0.0002778827557077118,0.0005886665037652442,0.6794871794871795
2771,절망/Noun,78,53,25,0.000589111442100349,0.0002776728791345492,0.6794871794871795
2772,서부/Noun,78,50,28,0.0005557655114154236,0.00031099362463069506,0.6410256410256411
2773,허허/Adverb,78,29,49,0.0003223439966209457,0.0005442388431037163,0.6282051282051282
2774,계시다/Adjective,78,49,29,0.0005446502011871152,0.00032210053979607705,0.6282051282051282
2775,칠/Modifier,78,29,49,0.0003223439966209457,0.0005442388431037163,0.6282051282051282
2776,라스트/Noun,78,48,30,0.0005335348909588066,0.000333207454961459,0.6153846153846154
2777,컷/Noun,78,30,48,0.00033345930684925416,0.0005331319279383344,0.6153846153846154
2778,무리/Noun,78,30,48,0.00033345930684925416,0.0005331319279383344,0.6153846153846154
2779,한순간/Noun,78,48,30,0.0005335348909588066,0.000333207454961459,0.6153846153846154
2780,서도/Noun,78,47,31,0.0005224195807304982,0.000344314370126841,0.6025641025641025
2781,최소/Noun,78,47,31,0.0005224195807304982,0.000344314370126841,0.6025641025641025
2782,절로/Noun,78,45,33,0.0005001889602738813,0.0003665282004576049,0.5769230769230769
2783,랑은/Josa,78,35,43,0.0003890358579907965,0.00047759735211142456,0.5512820512820513
2784,들어주다/Verb,78,36,42,0.000400151168219105,0.0004664904369460426,0.5384615384615384
2785,뒤죽박죽/Noun,77,9,68,0.00010003779205477625,0.0007552702312459737,0.8831168831168831
2786,절제/Noun,77,64,13,0.0007113798546117422,0.00014438989714996557,0.8311688311688312
2787,소화/Noun,77,62,15,0.0006891492341551253,0.0001666037274807295,0.8051948051948052
2788,떠올리다/Verb,77,62,15,0.0006891492341551253,0.0001666037274807295,0.8051948051948052
2789,찬양/Noun,77,19,58,0.00021119089433786097,0.0006442010795921541,0.7532467532467533
2790,내일/Noun,77,56,21,0.0006224573727852744,0.0002332452184730213,0.7272727272727273
2791,닥/Noun,77,21,56,0.00023342151479447792,0.0006219872492613901,0.7272727272727273
2792,난무/Noun,77,22,55,0.00024453682502278637,0.0006108803340960082,0.7142857142857143
2793,낼/Noun,77,53,24,0.000589111442100349,0.0002665659639691672,0.6883116883116883
2794,동네/Noun,77,29,48,0.0003223439966209457,0.0005331319279383344,0.6233766233766234
2795,향연/Noun,77,32,45,0.0003556899273058711,0.0004998111824421885,0.5844155844155844
2796,2년/Number,77,45,32,0.0005001889602738813,0.0003554212852922229,0.5844155844155844
2797,안해/Noun,77,32,45,0.0003556899273058711,0.0004998111824421885,0.5844155844155844
2798,에가/Josa,77,34,43,0.00037792054776248805,0.00047759735211142456,0.5584415584415584
2799,선생/Noun,77,34,43,0.00037792054776248805,0.00047759735211142456,0.5584415584415584
2800,똑같이/Adverb,77,34,43,0.00037792054776248805,0.00047759735211142456,0.5584415584415584
2801,우선/Noun,77,36,41,0.000400151168219105,0.00045538352178066063,0.5324675324675324
2802,모로/Noun,77,37,40,0.00041126647844741344,0.0004442766066152787,0.5194805194805194
2803,켜다/Verb,77,40,37,0.0004446124091323389,0.00041095586111913277,0.5194805194805194
2804,버/Noun,77,37,40,0.00041126647844741344,0.0004442766066152787,0.5194805194805194
2805,상대/Noun,77,39,38,0.0004334970989040304,0.00042206277628451476,0.5064935064935064
2806,매미/Noun,76,4,72,4.446124091323389e-05,0.0007996978919075016,0.9473684210526315
2807,뜬금없이/Adverb,76,4,72,4.446124091323389e-05,0.0007996978919075016,0.9473684210526315
2808,미스/Noun,76,13,63,0.00014449903296801013,0.0006997356554190639,0.8289473684210527
2809,욕먹다/Verb,76,13,63,0.00014449903296801013,0.0006997356554190639,0.8289473684210527
2810,보임/Noun,76,16,60,0.00017784496365293555,0.000666414909922918,0.7894736842105263
2811,버티다/Verb,76,17,59,0.00018896027388124403,0.000655307994757536,0.7763157894736842
2812,전성기/Noun,76,59,17,0.0006558033034701999,0.00018881755781149343,0.7763157894736842
2813,ㅎㄷㄷ/KoreanParticle,76,55,21,0.000611342062556966,0.0002332452184730213,0.7236842105263158
2814,범/Noun,76,22,54,0.00024453682502278637,0.0005997734189306263,0.7105263157894737
2815,달라지다/Verb,76,53,23,0.000589111442100349,0.0002554590488037852,0.6973684210526315
2816,리가/Noun,76,24,52,0.0002667674454794033,0.0005775595885998623,0.6842105263157895
2817,년도/Noun,76,25,51,0.0002778827557077118,0.0005664526734344803,0.6710526315789473
2818,각자/Noun,76,50,26,0.0005557655114154236,0.00028877979429993113,0.6578947368421053
2819,그대/Noun,76,50,26,0.0005557655114154236,0.00028877979429993113,0.6578947368421053
2820,하라/Noun,76,28,48,0.0003112286863926372,0.0005331319279383344,0.631578947368421
2821,글자/Noun,76,28,48,0.0003112286863926372,0.0005331319279383344,0.631578947368421
2822,하고는/Josa,76,29,47,0.0003223439966209457,0.0005220250127729525,0.618421052631579
2823,절대로/Noun,76,29,47,0.0003223439966209457,0.0005220250127729525,0.618421052631579
2824,끼치다/Verb,76,46,30,0.0005113042705021897,0.000333207454961459,0.6052631578947368
2825,형식/Noun,76,30,46,0.00033345930684925416,0.0005109180976075704,0.6052631578947368
2826,변신/Noun,76,32,44,0.0003556899273058711,0.0004887042672768066,0.5789473684210527
2827,케이/Noun,76,32,44,0.0003556899273058711,0.0004887042672768066,0.5789473684210527
2828,각/Modifier,76,35,41,0.0003890358579907965,0.00045538352178066063,0.5394736842105263
2829,튀다/Verb,76,35,41,0.0003890358579907965,0.00045538352178066063,0.5394736842105263
2830,박히다/Verb,76,40,36,0.0004446124091323389,0.0003998489459537508,0.5263157894736842
2831,서울/Noun,76,40,36,0.0004446124091323389,0.0003998489459537508,0.5263157894736842
2832,잉/Noun,76,38,38,0.00042238178867572195,0.00042206277628451476,0.5
2833,우연/Noun,76,38,38,0.00042238178867572195,0.00042206277628451476,0.5
2834,과대/Noun,75,5,70,5.557655114154236e-05,0.0007774840615767377,0.9333333333333333
2835,도중/Noun,75,7,68,7.78071715981593e-05,0.0007552702312459737,0.9066666666666666
2836,따분하다/Adjective,75,8,67,8.892248182646778e-05,0.0007441633160805918,0.8933333333333333
2837,여신/Noun,75,61,14,0.0006780339239268168,0.00015549681231534753,0.8133333333333334
2838,낭만/Noun,75,57,18,0.0006335726830135829,0.0001999244729768754,0.76
2839,선사/Noun,75,54,21,0.0006002267523286575,0.0002332452184730213,0.72
2840,꺼지다/Verb,75,24,51,0.0002667674454794033,0.0005664526734344803,0.68
2841,폭풍/Noun,75,51,24,0.0005668808216437321,0.0002665659639691672,0.68
2842,공룡/Noun,75,26,49,0.00028899806593602026,0.0005442388431037163,0.6533333333333333
2843,급하다/Adjective,75,26,49,0.00028899806593602026,0.0005442388431037163,0.6533333333333333
2844,잔혹하다/Adjective,75,48,27,0.0005335348909588066,0.0002998867094653131,0.64
2845,빠/Noun,75,27,48,0.00030011337616432876,0.0005331319279383344,0.64
2846,소통/Noun,75,47,28,0.0005224195807304982,0.00031099362463069506,0.6266666666666667
2847,추가/Noun,75,28,47,0.0003112286863926372,0.0005220250127729525,0.6266666666666667
2848,년전/Noun,75,45,30,0.0005001889602738813,0.000333207454961459,0.6
2849,식이/Noun,75,30,45,0.00033345930684925416,0.0004998111824421885,0.6
2850,1년/Number,75,45,30,0.0005001889602738813,0.000333207454961459,0.6
2851,축구/Noun,75,30,45,0.00033345930684925416,0.0004998111824421885,0.6
2852,아만다/Noun,75,44,31,0.0004890736500455727,0.000344314370126841,0.5866666666666667
2853,부활/Noun,75,44,31,0.0004890736500455727,0.000344314370126841,0.5866666666666667
2854,모이다/Verb,75,32,43,0.0003556899273058711,0.00047759735211142456,0.5733333333333334
2855,용다/Verb,75,43,32,0.0004779583398172643,0.0003554212852922229,0.5733333333333334
2856,직업/Noun,75,34,41,0.00037792054776248805,0.00045538352178066063,0.5466666666666666
2857,예측/Noun,75,36,39,0.000400151168219105,0.0004331696914498967,0.52
2858,바닥/Noun,74,9,65,0.00010003779205477625,0.0007219494857498279,0.8783783783783784
2859,졸업/Noun,74,14,60,0.0001556143431963186,0.000666414909922918,0.8108108108108109
2860,어지럽다/Adjective,74,16,58,0.00017784496365293555,0.0006442010795921541,0.7837837837837838
2861,EBS/Alpha,74,57,17,0.0006335726830135829,0.00018881755781149343,0.7702702702702703
2862,끊기다/Verb,74,17,57,0.00018896027388124403,0.0006330941644267721,0.7702702702702703
2863,웬/Noun,74,19,55,0.00021119089433786097,0.0006108803340960082,0.7432432432432432
2864,지나/Noun,74,53,21,0.000589111442100349,0.0002332452184730213,0.7162162162162162
2865,딸리다/Verb,74,22,52,0.00024453682502278637,0.0005775595885998623,0.7027027027027027
2866,드니/Noun,74,51,23,0.0005668808216437321,0.0002554590488037852,0.6891891891891891
2867,한가지/Noun,74,23,51,0.00025565213525109487,0.0005664526734344803,0.6891891891891891
2868,거짓/Noun,74,24,50,0.0002667674454794033,0.0005553457582690984,0.6756756756756757
2869,송강호/Noun,74,50,24,0.0005557655114154236,0.0002665659639691672,0.6756756756756757
2870,재난/Noun,74,25,49,0.0002778827557077118,0.0005442388431037163,0.6621621621621622
2871,워낙/Noun,74,49,25,0.0005446502011871152,0.0002776728791345492,0.6621621621621622
2872,a/Alpha,74,48,26,0.0005335348909588066,0.00028877979429993113,0.6486486486486487
2873,가나/Noun,74,27,47,0.00030011337616432876,0.0005220250127729525,0.6351351351351351
2874,일주일/Noun,74,47,27,0.0005224195807304982,0.0002998867094653131,0.6351351351351351
2875,범죄자/Noun,74,28,46,0.0003112286863926372,0.0005109180976075704,0.6216216216216216
2876,부탁/Noun,74,29,45,0.0003223439966209457,0.0004998111824421885,0.6081081081081081
2877,이안/Noun,74,29,45,0.0003223439966209457,0.0004998111824421885,0.6081081081081081
2878,캐릭/Noun,74,29,45,0.0003223439966209457,0.0004998111824421885,0.6081081081081081
2879,생명/Noun,74,45,29,0.0005001889602738813,0.00032210053979607705,0.6081081081081081
2880,나타내다/Verb,74,44,30,0.0004890736500455727,0.000333207454961459,0.5945945945945946
2881,트리/Noun,74,31,43,0.00034457461707756266,0.00047759735211142456,0.581081081081081
2882,류승범/Noun,74,42,32,0.00046684302958895584,0.0003554212852922229,0.5675675675675675
2883,높이다/Verb,74,42,32,0.00046684302958895584,0.0003554212852922229,0.5675675675675675
2884,극적/Noun,74,39,35,0.0004334970989040304,0.00038874203078836884,0.527027027027027
2885,이구나/Josa,74,39,35,0.0004334970989040304,0.00038874203078836884,0.527027027027027
2886,흔/Modifier,74,35,39,0.0003890358579907965,0.0004331696914498967,0.527027027027027
2887,존스/Noun,74,37,37,0.00041126647844741344,0.00041095586111913277,0.5
2888,최후/Noun,74,37,37,0.00041126647844741344,0.00041095586111913277,0.5
2889,애잔하다/Adjective,73,69,4,0.0007669564057532845,4.4427660661527865e-05,0.9452054794520548
2890,애매하다/Adjective,73,12,61,0.00013338372273970166,0.0006775218250882999,0.8356164383561644
2891,이별/Noun,73,57,16,0.0006335726830135829,0.00017771064264611146,0.7808219178082192
2892,쟁이/Suffix,73,19,54,0.00021119089433786097,0.0005997734189306263,0.7397260273972602
2893,쌍/Noun,73,21,52,0.00023342151479447792,0.0005775595885998623,0.7123287671232876
2894,부인/Noun,73,21,52,0.00023342151479447792,0.0005775595885998623,0.7123287671232876
2895,원숭이/Noun,73,22,51,0.00024453682502278637,0.0005664526734344803,0.6986301369863014
2896,단편/Noun,73,22,51,0.00024453682502278637,0.0005664526734344803,0.6986301369863014
2897,시종일관/Noun,73,22,51,0.00024453682502278637,0.0005664526734344803,0.6986301369863014
2898,깡패/Noun,73,23,50,0.00025565213525109487,0.0005553457582690984,0.684931506849315
2899,신하균/Noun,73,50,23,0.0005557655114154236,0.0002554590488037852,0.684931506849315
2900,본격/Noun,73,23,50,0.00025565213525109487,0.0005553457582690984,0.684931506849315
2901,에서나/Josa,73,24,49,0.0002667674454794033,0.0005442388431037163,0.6712328767123288
2902,광기/Noun,73,49,24,0.0005446502011871152,0.0002665659639691672,0.6712328767123288
2903,처리/Noun,73,25,48,0.0002778827557077118,0.0005331319279383344,0.6575342465753424
2904,만세/Noun,73,48,25,0.0005335348909588066,0.0002776728791345492,0.6575342465753424
2905,낮/Noun,73,47,26,0.0005224195807304982,0.00028877979429993113,0.6438356164383562
2906,블랙코미디/Noun,73,46,27,0.0005113042705021897,0.0002998867094653131,0.6301369863013698
2907,솔/Noun,73,27,46,0.00030011337616432876,0.0005109180976075704,0.6301369863013698
2908,로움/Noun,73,44,29,0.0004890736500455727,0.00032210053979607705,0.6027397260273972
2909,바치다/Verb,73,43,30,0.0004779583398172643,0.000333207454961459,0.589041095890411
2910,스타워즈/Noun,73,43,30,0.0004779583398172643,0.000333207454961459,0.589041095890411
2911,중학생/Noun,73,42,31,0.00046684302958895584,0.000344314370126841,0.5753424657534246
2912,50/Number,73,41,32,0.00045572771936064734,0.0003554212852922229,0.5616438356164384
2913,매번/Noun,73,41,32,0.00045572771936064734,0.0003554212852922229,0.5616438356164384
2914,녀석/Noun,73,33,40,0.0003668052375341796,0.0004442766066152787,0.547945205479452
2915,흔들다/Verb,73,39,34,0.0004334970989040304,0.00037763511562298685,0.5342465753424658
2916,풀리다/Verb,73,39,34,0.0004334970989040304,0.00037763511562298685,0.5342465753424658
2917,갈리다/Verb,73,38,35,0.00042238178867572195,0.00038874203078836884,0.5205479452054794
2918,맛있다/Adjective,73,37,36,0.00041126647844741344,0.0003998489459537508,0.5068493150684932
2919,지옥/Noun,73,36,37,0.000400151168219105,0.00041095586111913277,0.5068493150684932
2920,익숙하다/Adjective,73,37,36,0.00041126647844741344,0.0003998489459537508,0.5068493150684932
2921,답답/Noun,72,2,70,2.2230620456616944e-05,0.0007774840615767377,0.9722222222222222
2922,Good/Alpha,72,69,3,0.0007669564057532845,3.33207454961459e-05,0.9583333333333334
2923,어색/Noun,72,3,69,3.3345930684925414e-05,0.0007663771464113557,0.9583333333333334
2924,명불허전/Noun,72,64,8,0.0007113798546117422,8.885532132305573e-05,0.8888888888888888
2925,비록/Noun,72,64,8,0.0007113798546117422,8.885532132305573e-05,0.8888888888888888
2926,애틋하다/Adjective,72,61,11,0.0006780339239268168,0.00012217606681920164,0.8472222222222222
2927,광구/Noun,72,12,60,0.00013338372273970166,0.000666414909922918,0.8333333333333334
2928,쓴다/Verb,72,12,60,0.00013338372273970166,0.000666414909922918,0.8333333333333334
2929,짜릿하다/Adjective,72,59,13,0.0006558033034701999,0.00014438989714996557,0.8194444444444444
2930,땀/Noun,72,58,14,0.0006446879932418914,0.00015549681231534753,0.8055555555555556
2931,배꼽/Noun,72,58,14,0.0006446879932418914,0.00015549681231534753,0.8055555555555556
2932,뎅/Noun,72,57,15,0.0006335726830135829,0.0001666037274807295,0.7916666666666666
2933,누나/Suffix,72,56,16,0.0006224573727852744,0.00017771064264611146,0.7777777777777778
2934,아무나/Noun,72,17,55,0.00018896027388124403,0.0006108803340960082,0.7638888888888888
2935,기획/Noun,72,22,50,0.00024453682502278637,0.0005553457582690984,0.6944444444444444
2936,호흡/Noun,72,49,23,0.0005446502011871152,0.0002554590488037852,0.6805555555555556
2937,고전/Modifier,72,49,23,0.0005446502011871152,0.0002554590488037852,0.6805555555555556
2938,대부/Noun,72,46,26,0.0005113042705021897,0.00028877979429993113,0.6388888888888888
2939,일지/Noun,72,46,26,0.0005113042705021897,0.00028877979429993113,0.6388888888888888
2940,못자다/Verb,72,26,46,0.00028899806593602026,0.0005109180976075704,0.6388888888888888
2941,구분/Noun,72,27,45,0.00030011337616432876,0.0004998111824421885,0.625
2942,이지/Noun,72,27,45,0.00030011337616432876,0.0004998111824421885,0.625
2943,수록/Noun,72,44,28,0.0004890736500455727,0.00031099362463069506,0.6111111111111112
2944,풀/Noun,72,28,44,0.0003112286863926372,0.0004887042672768066,0.6111111111111112
2945,본질/Noun,72,44,28,0.0004890736500455727,0.00031099362463069506,0.6111111111111112
2946,찾아가다/Verb,72,42,30,0.00046684302958895584,0.000333207454961459,0.5833333333333334
2947,객관/Noun,72,30,42,0.00033345930684925416,0.0004664904369460426,0.5833333333333334
2948,혼란/Noun,72,33,39,0.0003668052375341796,0.0004331696914498967,0.5416666666666666
2949,말씀/Noun,72,38,34,0.00042238178867572195,0.00037763511562298685,0.5277777777777778
2950,하얗다/Adjective,72,38,34,0.00042238178867572195,0.00037763511562298685,0.5277777777777778
2951,비행기/Noun,72,37,35,0.00041126647844741344,0.00038874203078836884,0.5138888888888888
2952,부로/Noun,72,37,35,0.00041126647844741344,0.00038874203078836884,0.5138888888888888
2953,아마추어/Noun,71,5,66,5.557655114154236e-05,0.0007330564009152098,0.9295774647887324
2954,케미/Noun,71,66,5,0.0007336104750683592,5.5534575826909837e-05,0.9295774647887324
2955,오글오글/Adverb,71,6,65,6.669186136985083e-05,0.0007219494857498279,0.9154929577464789
2956,...^^/Punctuation,71,65,6,0.0007224951648400507,6.66414909922918e-05,0.9154929577464789
2957,쓸쓸하다/Adjective,71,63,8,0.0007002645443834338,8.885532132305573e-05,0.8873239436619719
2958,15년/Number,71,60,11,0.0006669186136985083,0.00012217606681920164,0.8450704225352113
2959,고인/Noun,71,60,11,0.0006669186136985083,0.00012217606681920164,0.8450704225352113
2960,데리다/Verb,71,12,59,0.00013338372273970166,0.000655307994757536,0.8309859154929577
2961,제작자/Noun,71,12,59,0.00013338372273970166,0.000655307994757536,0.8309859154929577
2962,정점/Noun,71,55,16,0.000611342062556966,0.00017771064264611146,0.7746478873239436
2963,상식/Noun,71,16,55,0.00017784496365293555,0.0006108803340960082,0.7746478873239436
2964,명장/Noun,71,52,19,0.0005779961318720405,0.00021103138814225738,0.7323943661971831
2965,ㅜㅠ/KoreanParticle,71,50,21,0.0005557655114154236,0.0002332452184730213,0.704225352112676
2966,고증/Noun,71,21,50,0.00023342151479447792,0.0005553457582690984,0.704225352112676
2967,괴롭다/Adjective,71,22,49,0.00024453682502278637,0.0005442388431037163,0.6901408450704225
2968,살이/Noun,71,45,26,0.0005001889602738813,0.00028877979429993113,0.6338028169014085
2969,회사/Noun,71,26,45,0.00028899806593602026,0.0004998111824421885,0.6338028169014085
2970,커버/Noun,71,44,27,0.0004890736500455727,0.0002998867094653131,0.6197183098591549
2971,별거/Noun,71,28,43,0.0003112286863926372,0.00047759735211142456,0.6056338028169014
2972,합/Noun,71,28,43,0.0003112286863926372,0.00047759735211142456,0.6056338028169014
2973,돌/Noun,71,29,42,0.0003223439966209457,0.0004664904369460426,0.5915492957746479
2974,안기다/Verb,71,42,29,0.00046684302958895584,0.00032210053979607705,0.5915492957746479
2975,공유/Noun,71,42,29,0.00046684302958895584,0.00032210053979607705,0.5915492957746479
2976,두운/Noun,71,42,29,0.00046684302958895584,0.00032210053979607705,0.5915492957746479
2977,님/Noun,71,40,31,0.0004446124091323389,0.000344314370126841,0.5633802816901409
2978,기괴하다/Adjective,71,40,31,0.0004446124091323389,0.000344314370126841,0.5633802816901409
2979,노인/Noun,71,31,40,0.00034457461707756266,0.0004442766066152787,0.5633802816901409
2980,받아들이다/Verb,71,38,33,0.00042238178867572195,0.0003665282004576049,0.5352112676056338
2981,스릴러물/Noun,71,38,33,0.00042238178867572195,0.0003665282004576049,0.5352112676056338
2982,잔인함/Noun,71,37,34,0.00041126647844741344,0.00037763511562298685,0.5211267605633803
2983,아오이/Noun,71,36,35,0.000400151168219105,0.00038874203078836884,0.5070422535211268
2984,진창/Noun,70,4,66,4.446124091323389e-05,0.0007330564009152098,0.9428571428571428
2985,돌려주다/Verb,70,6,64,6.669186136985083e-05,0.0007108425705844458,0.9142857142857143
2986,찬사/Noun,70,61,9,0.0006780339239268168,9.99622364884377e-05,0.8714285714285714
2987,you/Alpha,70,59,11,0.0006558033034701999,0.00012217606681920164,0.8428571428571429
2988,일반인/Noun,70,11,59,0.00012226841251139318,0.000655307994757536,0.8428571428571429
2989,의심스럽다/Adjective,70,11,59,0.00012226841251139318,0.000655307994757536,0.8428571428571429
2990,티나/Noun,70,14,56,0.0001556143431963186,0.0006219872492613901,0.8
2991,피아노/Noun,70,56,14,0.0006224573727852744,0.00015549681231534753,0.8
2992,이기도/Josa,70,55,15,0.000611342062556966,0.0001666037274807295,0.7857142857142857
2993,90분/Number,70,15,55,0.00016672965342462708,0.0006108803340960082,0.7857142857142857
2994,미스터리/Noun,70,17,53,0.00018896027388124403,0.0005886665037652442,0.7571428571428571
2995,믿음/Noun,70,52,18,0.0005779961318720405,0.0001999244729768754,0.7428571428571429
2996,디테일/Noun,70,50,20,0.0005557655114154236,0.00022213830330763935,0.7142857142857143
2997,닥치고/Noun,70,49,21,0.0005446502011871152,0.0002332452184730213,0.7
2998,위험하다/Adjective,70,22,48,0.00024453682502278637,0.0005331319279383344,0.6857142857142857
2999,멜로영화/Noun,70,46,24,0.0005113042705021897,0.0002665659639691672,0.6571428571428571
3000,오로지/Adverb,70,24,46,0.0002667674454794033,0.0005109180976075704,0.6571428571428571
3001,스필버그/Noun,70,46,24,0.0005113042705021897,0.0002665659639691672,0.6571428571428571
3002,놀란/Noun,70,46,24,0.0005113042705021897,0.0002665659639691672,0.6571428571428571
3003,업/Noun,70,26,44,0.00028899806593602026,0.0004887042672768066,0.6285714285714286
3004,남자배우/Noun,70,28,42,0.0003112286863926372,0.0004664904369460426,0.6
3005,본능/Noun,70,41,29,0.00045572771936064734,0.00032210053979607705,0.5857142857142857
3006,고등학생/Noun,70,40,30,0.0004446124091323389,0.000333207454961459,0.5714285714285714
3007,가르치다/Verb,70,39,31,0.0004334970989040304,0.000344314370126841,0.5571428571428572
3008,만큼이나/Josa,70,39,31,0.0004334970989040304,0.000344314370126841,0.5571428571428572
3009,아누/Noun,70,38,32,0.00042238178867572195,0.0003554212852922229,0.5428571428571428
3010,다해/Noun,70,32,38,0.0003556899273058711,0.00042206277628451476,0.5428571428571428
3011,권상우/Noun,70,38,32,0.00042238178867572195,0.0003554212852922229,0.5428571428571428
3012,그치다/Verb,70,37,33,0.00041126647844741344,0.0003665282004576049,0.5285714285714286
3013,가야/Noun,70,33,37,0.0003668052375341796,0.00041095586111913277,0.5285714285714286
3014,실/Noun,70,37,33,0.00041126647844741344,0.0003665282004576049,0.5285714285714286
3015,1등/Number,70,33,37,0.0003668052375341796,0.00041095586111913277,0.5285714285714286
3016,국산/Noun,70,34,36,0.00037792054776248805,0.0003998489459537508,0.5142857142857142
3017,정부/Noun,70,36,34,0.000400151168219105,0.00037763511562298685,0.5142857142857142
3018,수면제/Noun,69,3,66,3.3345930684925414e-05,0.0007330564009152098,0.9565217391304348
3019,짬뽕/Noun,69,4,65,4.446124091323389e-05,0.0007219494857498279,0.9420289855072463
3020,비호감/Noun,69,7,62,7.78071715981593e-05,0.000688628740253682,0.8985507246376812
3021,명연기/Noun,69,61,8,0.0006780339239268168,8.885532132305573e-05,0.8840579710144928
3022,꿀/Noun,69,61,8,0.0006780339239268168,8.885532132305573e-05,0.8840579710144928
3023,국어/Noun,69,9,60,0.00010003779205477625,0.000666414909922918,0.8695652173913043
3024,전문/Noun,69,13,56,0.00014449903296801013,0.0006219872492613901,0.8115942028985508
3025,많아지다/Verb,69,55,14,0.000611342062556966,0.00015549681231534753,0.7971014492753623
3026,순수/Noun,69,54,15,0.0006002267523286575,0.0001666037274807295,0.782608695652174
3027,초월/Noun,69,53,16,0.000589111442100349,0.00017771064264611146,0.7681159420289855
3028,연관/Noun,69,16,53,0.00017784496365293555,0.0005886665037652442,0.7681159420289855
3029,출연자/Noun,69,17,52,0.00018896027388124403,0.0005775595885998623,0.7536231884057971
3030,저지르다/Verb,69,18,51,0.0002000755841095525,0.0005664526734344803,0.7391304347826086
3031,혁명/Noun,69,50,19,0.0005557655114154236,0.00021103138814225738,0.7246376811594203
3032,하나님/Noun,69,48,21,0.0005335348909588066,0.0002332452184730213,0.6956521739130435
3033,마찬가지/Noun,69,21,48,0.00023342151479447792,0.0005331319279383344,0.6956521739130435
3034,스포츠/Noun,69,47,22,0.0005224195807304982,0.0002443521336384033,0.6811594202898551
3035,가까이/Noun,69,47,22,0.0005224195807304982,0.0002443521336384033,0.6811594202898551
3036,빌다/Verb,69,46,23,0.0005113042705021897,0.0002554590488037852,0.6666666666666666
3037,엽기/Noun,69,26,43,0.00028899806593602026,0.00047759735211142456,0.6231884057971014
3038,계/Noun,69,26,43,0.00028899806593602026,0.00047759735211142456,0.6231884057971014
3039,선수/Noun,69,42,27,0.00046684302958895584,0.0002998867094653131,0.6086956521739131
3040,홀로/Noun,69,42,27,0.00046684302958895584,0.0002998867094653131,0.6086956521739131
3041,애정/Noun,69,41,28,0.00045572771936064734,0.00031099362463069506,0.5942028985507246
3042,정리/Noun,69,28,41,0.0003112286863926372,0.00045538352178066063,0.5942028985507246
3043,민족/Noun,69,40,29,0.0004446124091323389,0.00032210053979607705,0.5797101449275363
3044,2000년/Number,69,29,40,0.0003223439966209457,0.0004442766066152787,0.5797101449275363
3045,뎀/Noun,69,38,31,0.00042238178867572195,0.000344314370126841,0.5507246376811594
3046,부터는/Josa,69,32,37,0.0003556899273058711,0.00041095586111913277,0.5362318840579711
3047,무어/Noun,69,32,37,0.0003556899273058711,0.00041095586111913277,0.5362318840579711
3048,밀/Noun,69,37,32,0.00041126647844741344,0.0003554212852922229,0.5362318840579711
3049,잃어버리다/Verb,69,32,37,0.0003556899273058711,0.00041095586111913277,0.5362318840579711
3050,교회/Noun,69,36,33,0.000400151168219105,0.0003665282004576049,0.5217391304347826
3051,가능성/Noun,69,36,33,0.000400151168219105,0.0003665282004576049,0.5217391304347826
3052,~~^^/Punctuation,68,65,3,0.0007224951648400507,3.33207454961459e-05,0.9558823529411765
3053,유아/Noun,68,8,60,8.892248182646778e-05,0.000666414909922918,0.8823529411764706
3054,게스트/Noun,68,10,58,0.00011115310228308472,0.0006442010795921541,0.8529411764705882
3055,대박나다/Verb,68,58,10,0.0006446879932418914,0.00011106915165381967,0.8529411764705882
3056,알파/Noun,68,56,12,0.0006224573727852744,0.0001332829819845836,0.8235294117647058
3057,세대/Noun,68,54,14,0.0006002267523286575,0.00015549681231534753,0.7941176470588235
3058,즐거움/Noun,68,53,15,0.000589111442100349,0.0001666037274807295,0.7794117647058824
3059,고문/Noun,68,15,53,0.00016672965342462708,0.0005886665037652442,0.7794117647058824
3060,연습/Noun,68,16,52,0.00017784496365293555,0.0005775595885998623,0.7647058823529411
3061,40분/Number,68,16,52,0.00017784496365293555,0.0005775595885998623,0.7647058823529411
3062,숨막히다/Adjective,68,52,16,0.0005779961318720405,0.00017771064264611146,0.7647058823529411
3063,무식하다/Adjective,68,17,51,0.00018896027388124403,0.0005664526734344803,0.75
3064,떡/Noun,68,19,49,0.00021119089433786097,0.0005442388431037163,0.7205882352941176
3065,농담/Noun,68,19,49,0.00021119089433786097,0.0005442388431037163,0.7205882352941176
3066,미스테리/Noun,68,19,49,0.00021119089433786097,0.0005442388431037163,0.7205882352941176
3067,로빈/Noun,68,48,20,0.0005335348909588066,0.00022213830330763935,0.7058823529411765
3068,미학/Noun,68,48,20,0.0005335348909588066,0.00022213830330763935,0.7058823529411765
3069,뺏다/Verb,68,20,48,0.00022230620456616945,0.0005331319279383344,0.7058823529411765
3070,쏟다/Verb,68,46,22,0.0005113042705021897,0.0002443521336384033,0.6764705882352942
3071,타란티노/Noun,68,45,23,0.0005001889602738813,0.0002554590488037852,0.6617647058823529
3072,반영/Noun,68,44,24,0.0004890736500455727,0.0002665659639691672,0.6470588235294118
3073,자세하다/Adjective,68,44,24,0.0004890736500455727,0.0002665659639691672,0.6470588235294118
3074,세트/Noun,68,25,43,0.0002778827557077118,0.00047759735211142456,0.6323529411764706
3075,위주/Noun,68,25,43,0.0002778827557077118,0.00047759735211142456,0.6323529411764706
3076,다른사람/Noun,68,25,43,0.0002778827557077118,0.00047759735211142456,0.6323529411764706
3077,쭉/Noun,68,43,25,0.0004779583398172643,0.0002776728791345492,0.6323529411764706
3078,스텝/Noun,68,28,40,0.0003112286863926372,0.0004442766066152787,0.5882352941176471
3079,상이/Noun,68,40,28,0.0004446124091323389,0.00031099362463069506,0.5882352941176471
3080,소개/Noun,68,30,38,0.00033345930684925416,0.00042206277628451476,0.5588235294117647
3081,?../Punctuation,68,30,38,0.00033345930684925416,0.00042206277628451476,0.5588235294117647
3082,춤추다/Verb,68,36,32,0.000400151168219105,0.0003554212852922229,0.5294117647058824
3083,기전/Noun,68,33,35,0.0003668052375341796,0.00038874203078836884,0.5147058823529411
3084,암울하다/Adjective,68,35,33,0.0003890358579907965,0.0003665282004576049,0.5147058823529411
3085,나무/Noun,68,34,34,0.00037792054776248805,0.00037763511562298685,0.5
3086,국/Noun,68,34,34,0.00037792054776248805,0.00037763511562298685,0.5
3087,굿굿굿/Noun,67,67,0,0.0007447257852966677,0.0,1.0
3088,부자연스럽다/Adjective,67,8,59,8.892248182646778e-05,0.000655307994757536,0.8805970149253731
3089,~~!!/Punctuation,67,55,12,0.000611342062556966,0.0001332829819845836,0.8208955223880597
3090,강간/Noun,67,12,55,0.00013338372273970166,0.0006108803340960082,0.8208955223880597
3091,뭣/Noun,67,15,52,0.00016672965342462708,0.0005775595885998623,0.7761194029850746
3092,한동안/Adverb,67,51,16,0.0005668808216437321,0.00017771064264611146,0.7611940298507462
3093,까지만/Josa,67,16,51,0.00017784496365293555,0.0005664526734344803,0.7611940298507462
3094,간지/Noun,67,50,17,0.0005557655114154236,0.00018881755781149343,0.746268656716418
3095,외국인/Noun,67,18,49,0.0002000755841095525,0.0005442388431037163,0.7313432835820896
3096,ㅈㄴ/KoreanParticle,67,18,49,0.0002000755841095525,0.0005442388431037163,0.7313432835820896
3097,s/Alpha,67,47,20,0.0005224195807304982,0.00022213830330763935,0.7014925373134329
3098,마저도/Josa,67,21,46,0.00023342151479447792,0.0005109180976075704,0.6865671641791045
3099,칭찬/Noun,67,22,45,0.00024453682502278637,0.0004998111824421885,0.6716417910447762
3100,리도/Noun,67,22,45,0.00024453682502278637,0.0004998111824421885,0.6716417910447762
3101,유치원/Noun,67,22,45,0.00024453682502278637,0.0004998111824421885,0.6716417910447762
3102,권력/Noun,67,44,23,0.0004890736500455727,0.0002554590488037852,0.6567164179104478
3103,데이빗/Noun,67,43,24,0.0004779583398172643,0.0002665659639691672,0.6417910447761194
3104,원/Suffix,67,25,42,0.0002778827557077118,0.0004664904369460426,0.6268656716417911
3105,능가/Noun,67,42,25,0.00046684302958895584,0.0002776728791345492,0.6268656716417911
3106,우린/Noun,67,42,25,0.00046684302958895584,0.0002776728791345492,0.6268656716417911
3107,데이/Noun,67,42,25,0.00046684302958895584,0.0002776728791345492,0.6268656716417911
3108,문/Noun,67,26,41,0.00028899806593602026,0.00045538352178066063,0.6119402985074627
3109,나로/Noun,67,26,41,0.00028899806593602026,0.00045538352178066063,0.6119402985074627
3110,지식/Noun,67,40,27,0.0004446124091323389,0.0002998867094653131,0.5970149253731343
3111,베일/Noun,67,38,29,0.00042238178867572195,0.00032210053979607705,0.5671641791044776
3112,박보영/Noun,67,36,31,0.000400151168219105,0.000344314370126841,0.5373134328358209
3113,쯤/Noun,67,35,32,0.0003890358579907965,0.0003554212852922229,0.5223880597014925
3114,성과/Noun,67,35,32,0.0003890358579907965,0.0003554212852922229,0.5223880597014925
3115,떨어뜨리다/Verb,66,4,62,4.446124091323389e-05,0.000688628740253682,0.9393939393939394
3116,칠하다/Adjective,66,8,58,8.892248182646778e-05,0.0006442010795921541,0.8787878787878788
3117,영구/Noun,66,10,56,0.00011115310228308472,0.0006219872492613901,0.8484848484848485
3118,디카프리오/Noun,66,56,10,0.0006224573727852744,0.00011106915165381967,0.8484848484848485
3119,콩/Noun,66,10,56,0.00011115310228308472,0.0006219872492613901,0.8484848484848485
3120,화중/Noun,66,54,12,0.0006002267523286575,0.0001332829819845836,0.8181818181818182
3121,한석규/Noun,66,54,12,0.0006002267523286575,0.0001332829819845836,0.8181818181818182
3122,외롭다/Adjective,66,49,17,0.0005446502011871152,0.00018881755781149343,0.7424242424242424
3123,머릿속/Noun,66,47,19,0.0005224195807304982,0.00021103138814225738,0.7121212121212122
3124,상징/Noun,66,45,21,0.0005001889602738813,0.0002332452184730213,0.6818181818181818
3125,커서/Noun,66,44,22,0.0004890736500455727,0.0002443521336384033,0.6666666666666666
3126,이따/Noun,66,23,43,0.00025565213525109487,0.00047759735211142456,0.6515151515151515
3127,억울하다/Adjective,66,23,43,0.00025565213525109487,0.00047759735211142456,0.6515151515151515
3128,견디다/Verb,66,24,42,0.0002667674454794033,0.0004664904369460426,0.6363636363636364
3129,포함/Noun,66,24,42,0.0002667674454794033,0.0004664904369460426,0.6363636363636364
3130,강아지/Noun,66,41,25,0.00045572771936064734,0.0002776728791345492,0.6212121212121212
3131,호불호/Noun,66,41,25,0.00045572771936064734,0.0002776728791345492,0.6212121212121212
3132,드네/Noun,66,39,27,0.0004334970989040304,0.0002998867094653131,0.5909090909090909
3133,장애인/Noun,66,38,28,0.00042238178867572195,0.00031099362463069506,0.5757575757575758
3134,반응/Noun,66,28,38,0.0003112286863926372,0.00042206277628451476,0.5757575757575758
3135,부산/Noun,66,38,28,0.00042238178867572195,0.00031099362463069506,0.5757575757575758
3136,너희/Noun,66,29,37,0.0003223439966209457,0.00041095586111913277,0.5606060606060606
3137,당장/Noun,66,36,30,0.000400151168219105,0.000333207454961459,0.5454545454545454
3138,옳다/Adjective,66,30,36,0.00033345930684925416,0.0003998489459537508,0.5454545454545454
3139,해봤다/Verb,66,35,31,0.0003890358579907965,0.000344314370126841,0.5303030303030303
3140,니콜라스/Noun,66,31,35,0.00034457461707756266,0.00038874203078836884,0.5303030303030303
3141,주인/Noun,66,33,33,0.0003668052375341796,0.0003665282004576049,0.5
3142,빠순이/Noun,65,5,60,5.557655114154236e-05,0.000666414909922918,0.9230769230769231
3143,적당/Noun,65,9,56,0.00010003779205477625,0.0006219872492613901,0.8615384615384616
3144,아우/Noun,65,10,55,0.00011115310228308472,0.0006108803340960082,0.8461538461538461
3145,다시금/Noun,65,54,11,0.0006002267523286575,0.00012217606681920164,0.8307692307692308
3146,마누라/Noun,65,12,53,0.00013338372273970166,0.0005886665037652442,0.8153846153846154
3147,미스캐스팅/Noun,65,12,53,0.00013338372273970166,0.0005886665037652442,0.8153846153846154
3148,올려주다/Verb,65,51,14,0.0005668808216437321,0.00015549681231534753,0.7846153846153846
3149,시체/Noun,65,16,49,0.00017784496365293555,0.0005442388431037163,0.7538461538461538
3150,죄송하다/Adjective,65,17,48,0.00018896027388124403,0.0005331319279383344,0.7384615384615385
3151,거임/Noun,65,18,47,0.0002000755841095525,0.0005220250127729525,0.7230769230769231
3152,마다/Noun,65,45,20,0.0005001889602738813,0.00022213830330763935,0.6923076923076923
3153,안쓰럽다/Adjective,65,22,43,0.00024453682502278637,0.00047759735211142456,0.6615384615384615
3154,차승원/Noun,65,43,22,0.0004779583398172643,0.0002443521336384033,0.6615384615384615
3155,백인/Noun,65,22,43,0.00024453682502278637,0.00047759735211142456,0.6615384615384615
3156,도와주다/Verb,65,23,42,0.00025565213525109487,0.0004664904369460426,0.6461538461538462
3157,구만/Noun,65,23,42,0.00025565213525109487,0.0004664904369460426,0.6461538461538462
3158,.........../Punctuation,65,24,41,0.0002667674454794033,0.00045538352178066063,0.6307692307692307
3159,인식/Noun,65,26,39,0.00028899806593602026,0.0004331696914498967,0.6
3160,어쨌든/Noun,65,38,27,0.00042238178867572195,0.0002998867094653131,0.5846153846153846
3161,동감/Noun,65,27,38,0.00030011337616432876,0.00042206277628451476,0.5846153846153846
3162,일부/Noun,65,29,36,0.0003223439966209457,0.0003998489459537508,0.5538461538461539
3163,어차피/Noun,65,29,36,0.0003223439966209457,0.0003998489459537508,0.5538461538461539
3164,공주/Noun,65,36,29,0.000400151168219105,0.00032210053979607705,0.5538461538461539
3165,이드/Noun,65,35,30,0.0003890358579907965,0.000333207454961459,0.5384615384615384
3166,연상/Noun,65,33,32,0.0003668052375341796,0.0003554212852922229,0.5076923076923077
3167,없애다/Verb,65,33,32,0.0003668052375341796,0.0003554212852922229,0.5076923076923077
3168,역작/Noun,64,59,5,0.0006558033034701999,5.5534575826909837e-05,0.921875
3169,싱겁다/Adjective,64,7,57,7.78071715981593e-05,0.0006330941644267721,0.890625
3170,치노/Noun,64,53,11,0.000589111442100349,0.00012217606681920164,0.828125
3171,잘나가다/Verb,64,11,53,0.00012226841251139318,0.0005886665037652442,0.828125
3172,뒤늦다/Adjective,64,52,12,0.0005779961318720405,0.0001332829819845836,0.8125
3173,납득/Noun,64,12,52,0.00013338372273970166,0.0005775595885998623,0.8125
3174,조차/Noun,64,13,51,0.00014449903296801013,0.0005664526734344803,0.796875
3175,사람과/Noun,64,51,13,0.0005668808216437321,0.00014438989714996557,0.796875
3176,클래식/Noun,64,50,14,0.0005557655114154236,0.00015549681231534753,0.78125
3177,...!/Punctuation,64,48,16,0.0005335348909588066,0.00017771064264611146,0.75
3178,재방/Noun,64,48,16,0.0005335348909588066,0.00017771064264611146,0.75
3179,우드/Noun,64,48,16,0.0005335348909588066,0.00017771064264611146,0.75
3180,두렵다/Adjective,64,48,16,0.0005335348909588066,0.00017771064264611146,0.75
3181,떨리다/Verb,64,47,17,0.0005224195807304982,0.00018881755781149343,0.734375
3182,차리다/Verb,64,17,47,0.00018896027388124403,0.0005220250127729525,0.734375
3183,!!!!!!/Punctuation,64,47,17,0.0005224195807304982,0.00018881755781149343,0.734375
3184,찍/Noun,64,18,46,0.0002000755841095525,0.0005109180976075704,0.71875
3185,신화/Noun,64,46,18,0.0005113042705021897,0.0001999244729768754,0.71875
3186,난후/Noun,64,44,20,0.0004890736500455727,0.00022213830330763935,0.6875
3187,발랄하다/Adjective,64,44,20,0.0004890736500455727,0.00022213830330763935,0.6875
3188,스펙/Noun,64,43,21,0.0004779583398172643,0.0002332452184730213,0.671875
3189,인걸/Josa,64,22,42,0.00024453682502278637,0.0004664904369460426,0.65625
3190,세계관/Noun,64,22,42,0.00024453682502278637,0.0004664904369460426,0.65625
3191,찌르다/Verb,64,22,42,0.00024453682502278637,0.0004664904369460426,0.65625
3192,화질/Noun,64,23,41,0.00025565213525109487,0.00045538352178066063,0.640625
3193,설/Noun,64,24,40,0.0002667674454794033,0.0004442766066152787,0.625
3194,화하다/Adjective,64,27,37,0.00030011337616432876,0.00041095586111913277,0.578125
3195,추격/Noun,64,36,28,0.000400151168219105,0.00031099362463069506,0.5625
3196,리암/Noun,64,36,28,0.000400151168219105,0.00031099362463069506,0.5625
3197,도르다/Verb,64,29,35,0.0003223439966209457,0.00038874203078836884,0.546875
3198,각/Noun,64,34,30,0.00037792054776248805,0.000333207454961459,0.53125
3199,구조/Noun,64,30,34,0.00033345930684925416,0.00037763511562298685,0.53125
3200,열다/Verb,64,34,30,0.00037792054776248805,0.000333207454961459,0.53125
3201,한지/Noun,64,30,34,0.00033345930684925416,0.00037763511562298685,0.53125
3202,보나/Noun,64,33,31,0.0003668052375341796,0.000344314370126841,0.515625
3203,로맨틱코미디/Noun,64,32,32,0.0003556899273058711,0.0003554212852922229,0.5
3204,4.44/Number,63,9,54,0.00010003779205477625,0.0005997734189306263,0.8571428571428571
3205,-_-;;/Punctuation,63,9,54,0.00010003779205477625,0.0005997734189306263,0.8571428571428571
3206,재앙/Noun,63,10,53,0.00011115310228308472,0.0005886665037652442,0.8412698412698413
3207,해지/Noun,63,51,12,0.0005668808216437321,0.0001332829819845836,0.8095238095238095
3208,다치다/Verb,63,16,47,0.00017784496365293555,0.0005220250127729525,0.746031746031746
3209,허무/Noun,63,16,47,0.00017784496365293555,0.0005220250127729525,0.746031746031746
3210,앙/Adverb,63,45,18,0.0005001889602738813,0.0001999244729768754,0.7142857142857143
3211,승부/Noun,63,18,45,0.0002000755841095525,0.0004998111824421885,0.7142857142857143
3212,김희선/Noun,63,20,43,0.00022230620456616945,0.00047759735211142456,0.6825396825396826
3213,벌어지다/Verb,63,42,21,0.00046684302958895584,0.0002332452184730213,0.6666666666666666
3214,첨으로/Adverb,63,22,41,0.00024453682502278637,0.00045538352178066063,0.6507936507936508
3215,만화가/Noun,63,22,41,0.00024453682502278637,0.00045538352178066063,0.6507936507936508
3216,작화/Noun,63,40,23,0.0004446124091323389,0.0002554590488037852,0.6349206349206349
3217,거듭/Noun,63,40,23,0.0004446124091323389,0.0002554590488037852,0.6349206349206349
3218,메이/Noun,63,40,23,0.0004446124091323389,0.0002554590488037852,0.6349206349206349
3219,오직/Noun,63,24,39,0.0002667674454794033,0.0004331696914498967,0.6190476190476191
3220,강동원/Noun,63,39,24,0.0004334970989040304,0.0002665659639691672,0.6190476190476191
3221,장진/Noun,63,26,37,0.00028899806593602026,0.00041095586111913277,0.5873015873015873
3222,비쥬/Noun,63,26,37,0.00028899806593602026,0.00041095586111913277,0.5873015873015873
3223,3시간/Number,63,36,27,0.000400151168219105,0.0002998867094653131,0.5714285714285714
3224,섬/Noun,63,36,27,0.000400151168219105,0.0002998867094653131,0.5714285714285714
3225,깜놀/Noun,63,36,27,0.000400151168219105,0.0002998867094653131,0.5714285714285714
3226,주가/Noun,63,28,35,0.0003112286863926372,0.00038874203078836884,0.5555555555555556
3227,슈퍼맨/Noun,63,28,35,0.0003112286863926372,0.00038874203078836884,0.5555555555555556
3228,열자/Noun,63,28,35,0.0003112286863926372,0.00038874203078836884,0.5555555555555556
3229,오해/Noun,63,34,29,0.00037792054776248805,0.00032210053979607705,0.5396825396825397
3230,산다/Noun,63,32,31,0.0003556899273058711,0.000344314370126841,0.5079365079365079
3231,bb/Alpha,62,59,3,0.0006558033034701999,3.33207454961459e-05,0.9516129032258065
3232,에로물/Noun,62,6,56,6.669186136985083e-05,0.0006219872492613901,0.9032258064516129
3233,살때/Noun,62,54,8,0.0006002267523286575,8.885532132305573e-05,0.8709677419354839
3234,알바생/Noun,62,8,54,8.892248182646778e-05,0.0005997734189306263,0.8709677419354839
3235,벅차다/Adjective,62,53,9,0.000589111442100349,9.99622364884377e-05,0.8548387096774194
3236,로운/Josa,62,51,11,0.0005668808216437321,0.00012217606681920164,0.8225806451612904
3237,^-^/Punctuation,62,50,12,0.0005557655114154236,0.0001332829819845836,0.8064516129032258
3238,꼽/Noun,62,49,13,0.0005446502011871152,0.00014438989714996557,0.7903225806451613
3239,관대하다/Adjective,62,14,48,0.0001556143431963186,0.0005331319279383344,0.7741935483870968
3240,뿌리다/Verb,62,14,48,0.0001556143431963186,0.0005331319279383344,0.7741935483870968
3241,페이크/Noun,62,14,48,0.0001556143431963186,0.0005331319279383344,0.7741935483870968
3242,망치/Noun,62,16,46,0.00017784496365293555,0.0005109180976075704,0.7419354838709677
3243,올레/Noun,62,16,46,0.00017784496365293555,0.0005109180976075704,0.7419354838709677
3244,강요/Noun,62,16,46,0.00017784496365293555,0.0005109180976075704,0.7419354838709677
3245,밀다/Verb,62,17,45,0.00018896027388124403,0.0004998111824421885,0.7258064516129032
3246,다섯/Determiner,62,45,17,0.0005001889602738813,0.00018881755781149343,0.7258064516129032
3247,짜내다/Verb,62,18,44,0.0002000755841095525,0.0004887042672768066,0.7096774193548387
3248,가짜/Noun,62,19,43,0.00021119089433786097,0.00047759735211142456,0.6935483870967742
3249,소품/Noun,62,20,42,0.00022230620456616945,0.0004664904369460426,0.6774193548387096
3250,아담/Noun,62,42,20,0.00046684302958895584,0.00022213830330763935,0.6774193548387096
3251,다녀오다/Verb,62,42,20,0.00046684302958895584,0.00022213830330763935,0.6774193548387096
3252,만난/Noun,62,41,21,0.00045572771936064734,0.0002332452184730213,0.6612903225806451
3253,원조/Noun,62,41,21,0.00045572771936064734,0.0002332452184730213,0.6612903225806451
3254,구석/Noun,62,21,41,0.00023342151479447792,0.00045538352178066063,0.6612903225806451
3255,드러내다/Verb,62,40,22,0.0004446124091323389,0.0002443521336384033,0.6451612903225806
3256,섬뜩하다/Adjective,62,39,23,0.0004334970989040304,0.0002554590488037852,0.6290322580645161
3257,흑백/Noun,62,38,24,0.00042238178867572195,0.0002665659639691672,0.6129032258064516
3258,가라/Noun,62,24,38,0.0002667674454794033,0.00042206277628451476,0.6129032258064516
3259,행/Noun,62,38,24,0.00042238178867572195,0.0002665659639691672,0.6129032258064516
3260,철저하다/Adjective,62,24,38,0.0002667674454794033,0.00042206277628451476,0.6129032258064516
3261,지지/Noun,62,24,38,0.0002667674454794033,0.00042206277628451476,0.6129032258064516
3262,곤/Noun,62,25,37,0.0002778827557077118,0.00041095586111913277,0.5967741935483871
3263,파워/Noun,62,26,36,0.00028899806593602026,0.0003998489459537508,0.5806451612903226
3264,대에/Foreign,62,26,36,0.00028899806593602026,0.0003998489459537508,0.5806451612903226
3265,옥/Noun,62,36,26,0.000400151168219105,0.00028877979429993113,0.5806451612903226
3266,외면/Noun,62,35,27,0.0003890358579907965,0.0002998867094653131,0.5645161290322581
3267,갓/Noun,62,28,34,0.0003112286863926372,0.00037763511562298685,0.5483870967741935
3268,최민수/Noun,62,33,29,0.0003668052375341796,0.00032210053979607705,0.532258064516129
3269,가게/Noun,62,30,32,0.00033345930684925416,0.0003554212852922229,0.5161290322580645
3270,쏘우/Noun,62,32,30,0.0003556899273058711,0.000333207454961459,0.5161290322580645
3271,장소/Noun,62,30,32,0.00033345930684925416,0.0003554212852922229,0.5161290322580645
3272,시험/Noun,62,31,31,0.00034457461707756266,0.000344314370126841,0.5
3273,두고두고/Noun,61,55,6,0.000611342062556966,6.66414909922918e-05,0.9016393442622951
3274,짱짱맨/Noun,61,52,9,0.0005779961318720405,9.99622364884377e-05,0.8524590163934426
3275,관리/Noun,61,11,50,0.00012226841251139318,0.0005553457582690984,0.819672131147541
3276,창피하다/Adjective,61,12,49,0.00013338372273970166,0.0005442388431037163,0.8032786885245902
3277,과도/Noun,61,15,46,0.00016672965342462708,0.0005109180976075704,0.7540983606557377
3278,싸하다/Adjective,61,15,46,0.00016672965342462708,0.0005109180976075704,0.7540983606557377
3279,남친/Noun,61,16,45,0.00017784496365293555,0.0004998111824421885,0.7377049180327869
3280,공연/Noun,61,45,16,0.0005001889602738813,0.00017771064264611146,0.7377049180327869
3281,떠들다/Verb,61,17,44,0.00018896027388124403,0.0004887042672768066,0.7213114754098361
3282,방황/Noun,61,43,18,0.0004779583398172643,0.0001999244729768754,0.7049180327868853
3283,덩어리/Noun,61,18,43,0.0002000755841095525,0.00047759735211142456,0.7049180327868853
3284,태국/Noun,61,18,43,0.0002000755841095525,0.00047759735211142456,0.7049180327868853
3285,밝혀지다/Verb,61,19,42,0.00021119089433786097,0.0004664904369460426,0.6885245901639344
3286,톤/Noun,61,20,41,0.00022230620456616945,0.00045538352178066063,0.6721311475409836
3287,타인/Noun,61,41,20,0.00045572771936064734,0.00022213830330763935,0.6721311475409836
3288,음향/Noun,61,20,41,0.00022230620456616945,0.00045538352178066063,0.6721311475409836
3289,볼라/Noun,61,21,40,0.00023342151479447792,0.0004442766066152787,0.6557377049180327
3290,지내다/Verb,61,40,21,0.0004446124091323389,0.0002332452184730213,0.6557377049180327
3291,택시/Noun,61,23,38,0.00025565213525109487,0.00042206277628451476,0.6229508196721312
3292,특집/Noun,61,23,38,0.00025565213525109487,0.00042206277628451476,0.6229508196721312
3293,여지/Noun,61,37,24,0.00041126647844741344,0.0002665659639691672,0.6065573770491803
3294,층/Noun,61,25,36,0.0002778827557077118,0.0003998489459537508,0.5901639344262295
3295,띄다/Verb,61,25,36,0.0002778827557077118,0.0003998489459537508,0.5901639344262295
3296,엄정화/Noun,61,36,25,0.000400151168219105,0.0002776728791345492,0.5901639344262295
3297,포드/Noun,61,35,26,0.0003890358579907965,0.00028877979429993113,0.5737704918032787
3298,밝히다/Verb,61,26,35,0.00028899806593602026,0.00038874203078836884,0.5737704918032787
3299,해오다/Verb,61,34,27,0.00037792054776248805,0.0002998867094653131,0.5573770491803278
3300,언어/Noun,61,34,27,0.00037792054776248805,0.0002998867094653131,0.5573770491803278
3301,킬러/Noun,61,27,34,0.00030011337616432876,0.00037763511562298685,0.5573770491803278
3302,정선/Noun,61,33,28,0.0003668052375341796,0.00031099362463069506,0.5409836065573771
3303,찬란하다/Adjective,61,29,32,0.0003223439966209457,0.0003554212852922229,0.5245901639344263
3304,복선/Noun,61,29,32,0.0003223439966209457,0.0003554212852922229,0.5245901639344263
3305,종/Noun,61,29,32,0.0003223439966209457,0.0003554212852922229,0.5245901639344263
3306,엉뚱하다/Adjective,61,30,31,0.00033345930684925416,0.000344314370126841,0.5081967213114754
3307,OOOO/Alpha,60,2,58,2.2230620456616944e-05,0.0006442010795921541,0.9666666666666667
3308,쯧쯧/Noun,60,3,57,3.3345930684925414e-05,0.0006330941644267721,0.95
3309,모욕/Noun,60,4,56,4.446124091323389e-05,0.0006219872492613901,0.9333333333333333
3310,홧팅/Noun,60,56,4,0.0006224573727852744,4.4427660661527865e-05,0.9333333333333333
3311,심사/Noun,60,5,55,5.557655114154236e-05,0.0006108803340960082,0.9166666666666666
3312,울림/Noun,60,55,5,0.000611342062556966,5.5534575826909837e-05,0.9166666666666666
3313,고독/Noun,60,51,9,0.0005668808216437321,9.99622364884377e-05,0.85
3314,깨달음/Noun,60,49,11,0.0005446502011871152,0.00012217606681920164,0.8166666666666667
3315,어째/Noun,60,12,48,0.00013338372273970166,0.0005331319279383344,0.8
3316,상큼/Noun,60,48,12,0.0005335348909588066,0.0001332829819845836,0.8
3317,..!!/Punctuation,60,47,13,0.0005224195807304982,0.00014438989714996557,0.7833333333333333
3318,젊은이/Noun,60,47,13,0.0005224195807304982,0.00014438989714996557,0.7833333333333333
3319,자랑/Noun,60,14,46,0.0001556143431963186,0.0005109180976075704,0.7666666666666667
3320,맙시/Noun,60,15,45,0.00016672965342462708,0.0004998111824421885,0.75
3321,짙다/Adjective,60,44,16,0.0004890736500455727,0.00017771064264611146,0.7333333333333333
3322,ㅂ/KoreanParticle,60,18,42,0.0002000755841095525,0.0004664904369460426,0.7
3323,사과/Noun,60,18,42,0.0002000755841095525,0.0004664904369460426,0.7
3324,떄/Noun,60,41,19,0.00045572771936064734,0.00021103138814225738,0.6833333333333333
3325,신비/Noun,60,41,19,0.00045572771936064734,0.00021103138814225738,0.6833333333333333
3326,백배/Noun,60,40,20,0.0004446124091323389,0.00022213830330763935,0.6666666666666666
3327,다이하드/Noun,60,21,39,0.00023342151479447792,0.0004331696914498967,0.65
3328,에바/Noun,60,22,38,0.00024453682502278637,0.00042206277628451476,0.6333333333333333
3329,유익하다/Adjective,60,37,23,0.00041126647844741344,0.0002554590488037852,0.6166666666666667
3330,애니매이션/Noun,60,37,23,0.00041126647844741344,0.0002554590488037852,0.6166666666666667
3331,김혜수/Noun,60,36,24,0.000400151168219105,0.0002665659639691672,0.6
3332,덮다/Verb,60,24,36,0.0002667674454794033,0.0003998489459537508,0.6
3333,슨/Noun,60,36,24,0.000400151168219105,0.0002665659639691672,0.6
3334,박하다/Adjective,60,35,25,0.0003890358579907965,0.0002776728791345492,0.5833333333333334
3335,넹/Noun,60,25,35,0.0002778827557077118,0.00038874203078836884,0.5833333333333334
3336,무간도/Noun,60,25,35,0.0002778827557077118,0.00038874203078836884,0.5833333333333334
3337,조선/Noun,60,25,35,0.0002778827557077118,0.00038874203078836884,0.5833333333333334
3338,주위/Noun,60,34,26,0.00037792054776248805,0.00028877979429993113,0.5666666666666667
3339,인권/Noun,60,34,26,0.00037792054776248805,0.00028877979429993113,0.5666666666666667
3340,집다/Verb,60,26,34,0.00028899806593602026,0.00037763511562298685,0.5666666666666667
3341,도둑/Noun,60,27,33,0.00030011337616432876,0.0003665282004576049,0.55
3342,자본/Noun,60,28,32,0.0003112286863926372,0.0003554212852922229,0.5333333333333333
3343,혹/Noun,60,28,32,0.0003112286863926372,0.0003554212852922229,0.5333333333333333
3344,차별/Noun,60,32,28,0.0003556899273058711,0.00031099362463069506,0.5333333333333333
3345,침/Noun,60,28,32,0.0003112286863926372,0.0003554212852922229,0.5333333333333333
3346,참여/Noun,60,29,31,0.0003223439966209457,0.000344314370126841,0.5166666666666667
3347,광/Noun,60,29,31,0.0003223439966209457,0.000344314370126841,0.5166666666666667
3348,소/Noun,60,29,31,0.0003223439966209457,0.000344314370126841,0.5166666666666667
3349,걷다/Verb,60,31,29,0.00034457461707756266,0.00032210053979607705,0.5166666666666667
3350,볼일/Noun,59,3,56,3.3345930684925414e-05,0.0006219872492613901,0.9491525423728814
3351,미달/Noun,59,4,55,4.446124091323389e-05,0.0006108803340960082,0.9322033898305084
3352,거북하다/Adjective,59,5,54,5.557655114154236e-05,0.0005997734189306263,0.9152542372881356
3353,군더더기/Noun,59,54,5,0.0006002267523286575,5.5534575826909837e-05,0.9152542372881356
3354,bad/Alpha,59,5,54,5.557655114154236e-05,0.0005997734189306263,0.9152542372881356
3355,모독/Noun,59,7,52,7.78071715981593e-05,0.0005775595885998623,0.8813559322033898
3356,폼/Noun,59,11,48,0.00012226841251139318,0.0005331319279383344,0.8135593220338984
3357,먹기/Noun,59,11,48,0.00012226841251139318,0.0005331319279383344,0.8135593220338984
3358,천사/Noun,59,48,11,0.0005335348909588066,0.00012217606681920164,0.8135593220338984
3359,부담/Noun,59,46,13,0.0005113042705021897,0.00014438989714996557,0.7796610169491526
3360,엔딩크레딧/Noun,59,46,13,0.0005113042705021897,0.00014438989714996557,0.7796610169491526
3361,누님/Noun,59,45,14,0.0005001889602738813,0.00015549681231534753,0.7627118644067796
3362,칠/Noun,59,14,45,0.0001556143431963186,0.0004998111824421885,0.7627118644067796
3363,짓/VerbPrefix,59,15,44,0.00016672965342462708,0.0004887042672768066,0.7457627118644068
3364,반감/Noun,59,15,44,0.00016672965342462708,0.0004887042672768066,0.7457627118644068
3365,성형/Noun,59,16,43,0.00017784496365293555,0.00047759735211142456,0.7288135593220338
3366,뉴스/Noun,59,17,42,0.00018896027388124403,0.0004664904369460426,0.711864406779661
3367,떡밥/Noun,59,18,41,0.0002000755841095525,0.00045538352178066063,0.6949152542372882
3368,인연/Noun,59,40,19,0.0004446124091323389,0.00021103138814225738,0.6779661016949152
3369,고작/Noun,59,19,40,0.00021119089433786097,0.0004442766066152787,0.6779661016949152
3370,눈치/Noun,59,19,40,0.00021119089433786097,0.0004442766066152787,0.6779661016949152
3371,찾아오다/Verb,59,38,21,0.00042238178867572195,0.0002332452184730213,0.6440677966101694
3372,토니/Noun,59,37,22,0.00041126647844741344,0.0002443521336384033,0.6271186440677966
3373,스콧/Noun,59,37,22,0.00041126647844741344,0.0002443521336384033,0.6271186440677966
3374,테이큰/Noun,59,36,23,0.000400151168219105,0.0002554590488037852,0.6101694915254238
3375,리기/Noun,59,36,23,0.000400151168219105,0.0002554590488037852,0.6101694915254238
3376,밖에는/Josa,59,24,35,0.0002667674454794033,0.00038874203078836884,0.5932203389830508
3377,스파이더맨/Noun,59,35,24,0.0003890358579907965,0.0002665659639691672,0.5932203389830508
3378,나루토/Noun,59,35,24,0.0003890358579907965,0.0002665659639691672,0.5932203389830508
3379,그려지다/Verb,59,35,24,0.0003890358579907965,0.0002665659639691672,0.5932203389830508
3380,아이유/Noun,59,34,25,0.00037792054776248805,0.0002776728791345492,0.576271186440678
3381,뒤지다/Verb,59,25,34,0.0002778827557077118,0.00037763511562298685,0.576271186440678
3382,박평/Noun,59,34,25,0.00037792054776248805,0.0002776728791345492,0.576271186440678
3383,기사/Noun,59,25,34,0.0002778827557077118,0.00037763511562298685,0.576271186440678
3384,버스/Noun,59,33,26,0.0003668052375341796,0.00028877979429993113,0.559322033898305
3385,흔들리다/Verb,59,26,33,0.00028899806593602026,0.0003665282004576049,0.559322033898305
3386,불가능하다/Adjective,59,26,33,0.00028899806593602026,0.0003665282004576049,0.559322033898305
3387,쓰이다/Verb,59,27,32,0.00030011337616432876,0.0003554212852922229,0.5423728813559322
3388,징/Noun,59,27,32,0.00030011337616432876,0.0003554212852922229,0.5423728813559322
3389,클라스/Noun,59,32,27,0.0003556899273058711,0.0002998867094653131,0.5423728813559322
3390,던/Noun,59,27,32,0.00030011337616432876,0.0003554212852922229,0.5423728813559322
3391,가하다/Verb,59,28,31,0.0003112286863926372,0.000344314370126841,0.5254237288135594
3392,하고도/Josa,59,29,30,0.0003223439966209457,0.000333207454961459,0.5084745762711864
3393,킹/Noun,59,29,30,0.0003223439966209457,0.000333207454961459,0.5084745762711864
3394,로드/Noun,59,30,29,0.00033345930684925416,0.00032210053979607705,0.5084745762711864
3395,새록새록/Noun,58,57,1,0.0006335726830135829,1.1106915165381966e-05,0.9827586206896551
3396,우롱/Noun,58,3,55,3.3345930684925414e-05,0.0006108803340960082,0.9482758620689655
3397,개똥/Noun,58,4,54,4.446124091323389e-05,0.0005997734189306263,0.9310344827586207
3398,진영화/Noun,58,53,5,0.000589111442100349,5.5534575826909837e-05,0.9137931034482759
3399,아기자기하다/Adjective,58,51,7,0.0005668808216437321,7.774840615767377e-05,0.8793103448275862
3400,렉/Noun,58,8,50,8.892248182646778e-05,0.0005553457582690984,0.8620689655172413
3401,기쁘다/Adjective,58,49,9,0.0005446502011871152,9.99622364884377e-05,0.8448275862068966
3402,남고/Noun,58,48,10,0.0005335348909588066,0.00011106915165381967,0.8275862068965517
3403,문득/Noun,58,47,11,0.0005224195807304982,0.00012217606681920164,0.8103448275862069
3404,성장하다/Adjective,58,44,14,0.0004890736500455727,0.00015549681231534753,0.7586206896551724
3405,향기/Noun,58,44,14,0.0004890736500455727,0.00015549681231534753,0.7586206896551724
3406,왕조현/Noun,58,43,15,0.0004779583398172643,0.0001666037274807295,0.7413793103448276
3407,타이틀/Noun,58,15,43,0.00016672965342462708,0.00047759735211142456,0.7413793103448276
3408,사이코/Noun,58,15,43,0.00016672965342462708,0.00047759735211142456,0.7413793103448276
3409,벌/Noun,58,16,42,0.00017784496365293555,0.0004664904369460426,0.7241379310344828
3410,기승/Noun,58,16,42,0.00017784496365293555,0.0004664904369460426,0.7241379310344828
3411,습/Noun,58,41,17,0.00045572771936064734,0.00018881755781149343,0.7068965517241379
3412,레이첼/Noun,58,40,18,0.0004446124091323389,0.0001999244729768754,0.6896551724137931
3413,영활/Noun,58,18,40,0.0002000755841095525,0.0004442766066152787,0.6896551724137931
3414,".""/Punctuation",58,40,18,0.0004446124091323389,0.0001999244729768754,0.6896551724137931
3415,디테/Noun,58,39,19,0.0004334970989040304,0.00021103138814225738,0.6724137931034483
3416,썩/Noun,58,19,39,0.00021119089433786097,0.0004331696914498967,0.6724137931034483
3417,피곤하다/Adjective,58,20,38,0.00022230620456616945,0.00042206277628451476,0.6551724137931034
3418,어떠하다/Adjective,58,38,20,0.00042238178867572195,0.00022213830330763935,0.6551724137931034
3419,양/Suffix,58,37,21,0.00041126647844741344,0.0002332452184730213,0.6379310344827587
3420,...(/Punctuation,58,21,37,0.00023342151479447792,0.00041095586111913277,0.6379310344827587
3421,지켜보다/Verb,58,37,21,0.00041126647844741344,0.0002332452184730213,0.6379310344827587
3422,평화/Noun,58,36,22,0.000400151168219105,0.0002443521336384033,0.6206896551724138
3423,합치다/Verb,58,23,35,0.00025565213525109487,0.00038874203078836884,0.603448275862069
3424,황정민/Noun,58,35,23,0.0003890358579907965,0.0002554590488037852,0.603448275862069
3425,시골/Noun,58,34,24,0.00037792054776248805,0.0002665659639691672,0.5862068965517241
3426,해외/Noun,58,25,33,0.0002778827557077118,0.0003665282004576049,0.5689655172413793
3427,김수현/Noun,58,32,26,0.0003556899273058711,0.00028877979429993113,0.5517241379310345
3428,까맣다/Adjective,58,32,26,0.0003556899273058711,0.00028877979429993113,0.5517241379310345
3429,손예진/Noun,58,27,31,0.00030011337616432876,0.000344314370126841,0.5344827586206896
3430,한효주/Noun,58,27,31,0.00030011337616432876,0.000344314370126841,0.5344827586206896
3431,제시카/Noun,58,27,31,0.00030011337616432876,0.000344314370126841,0.5344827586206896
3432,맺다/Verb,58,31,27,0.00034457461707756266,0.0002998867094653131,0.5344827586206896
3433,제왕/Noun,58,28,30,0.0003112286863926372,0.000333207454961459,0.5172413793103449
3434,동양/Noun,58,30,28,0.00033345930684925416,0.00031099362463069506,0.5172413793103449
3435,멀리/Noun,58,29,29,0.0003223439966209457,0.00032210053979607705,0.5
3436,반도/Noun,57,2,55,2.2230620456616944e-05,0.0006108803340960082,0.9649122807017544
3437,커녕/Noun,57,3,54,3.3345930684925414e-05,0.0005997734189306263,0.9473684210526315
3438,헛웃음/Noun,57,4,53,4.446124091323389e-05,0.0005886665037652442,0.9298245614035088
3439,차분하다/Adjective,57,48,9,0.0005335348909588066,9.99622364884377e-05,0.8421052631578947
3440,어지간하다/Adjective,57,11,46,0.00012226841251139318,0.0005109180976075704,0.8070175438596491
3441,압/Noun,57,46,11,0.0005113042705021897,0.00012217606681920164,0.8070175438596491
3442,학창시절/Noun,57,44,13,0.0004890736500455727,0.00014438989714996557,0.7719298245614035
3443,더욱더/Noun,57,44,13,0.0004890736500455727,0.00014438989714996557,0.7719298245614035
3444,주온/Noun,57,14,43,0.0001556143431963186,0.00047759735211142456,0.7543859649122807
3445,적극/Noun,57,42,15,0.00046684302958895584,0.0001666037274807295,0.7368421052631579
3446,새삼/Noun,57,41,16,0.00045572771936064734,0.00017771064264611146,0.7192982456140351
3447,환자/Noun,57,18,39,0.0002000755841095525,0.0004331696914498967,0.6842105263157895
3448,쎄다/Adjective,57,18,39,0.0002000755841095525,0.0004331696914498967,0.6842105263157895
3449,미장센/Noun,57,38,19,0.00042238178867572195,0.00021103138814225738,0.6666666666666666
3450,각각/Noun,57,38,19,0.00042238178867572195,0.00021103138814225738,0.6666666666666666
3451,대학생/Noun,57,20,37,0.00022230620456616945,0.00041095586111913277,0.6491228070175439
3452,겨울왕국/Noun,57,37,20,0.00041126647844741344,0.00022213830330763935,0.6491228070175439
3453,내려가다/Verb,57,20,37,0.00022230620456616945,0.00041095586111913277,0.6491228070175439
3454,청년/Noun,57,37,20,0.00041126647844741344,0.00022213830330763935,0.6491228070175439
3455,5년/Number,57,36,21,0.000400151168219105,0.0002332452184730213,0.631578947368421
3456,T/Alpha,57,36,21,0.000400151168219105,0.0002332452184730213,0.631578947368421
3457,스파이/Noun,57,36,21,0.000400151168219105,0.0002332452184730213,0.631578947368421
3458,오지/Noun,57,22,35,0.00024453682502278637,0.00038874203078836884,0.6140350877192983
3459,신세계/Noun,57,35,22,0.0003890358579907965,0.0002443521336384033,0.6140350877192983
3460,송승헌/Noun,57,23,34,0.00025565213525109487,0.00037763511562298685,0.5964912280701754
3461,쿨하다/Adjective,57,34,23,0.00037792054776248805,0.0002554590488037852,0.5964912280701754
3462,색깔/Noun,57,34,23,0.00037792054776248805,0.0002554590488037852,0.5964912280701754
3463,질문/Noun,57,33,24,0.0003668052375341796,0.0002665659639691672,0.5789473684210527
3464,대학/Noun,57,24,33,0.0002667674454794033,0.0003665282004576049,0.5789473684210527
3465,이정재/Noun,57,33,24,0.0003668052375341796,0.0002665659639691672,0.5789473684210527
3466,이나/Foreign,57,25,32,0.0002778827557077118,0.0003554212852922229,0.5614035087719298
3467,장애/Noun,57,25,32,0.0002778827557077118,0.0003554212852922229,0.5614035087719298
3468,무리다/Adjective,57,25,32,0.0002778827557077118,0.0003554212852922229,0.5614035087719298
3469,60년/Number,57,26,31,0.00028899806593602026,0.000344314370126841,0.543859649122807
3470,롱/Noun,57,31,26,0.00034457461707756266,0.00028877979429993113,0.543859649122807
3471,재현/Noun,57,31,26,0.00034457461707756266,0.00028877979429993113,0.543859649122807
3472,자라다/Verb,57,31,26,0.00034457461707756266,0.00028877979429993113,0.543859649122807
3473,래야/Noun,57,26,31,0.00028899806593602026,0.000344314370126841,0.543859649122807
3474,설경구/Noun,57,30,27,0.00033345930684925416,0.0002998867094653131,0.5263157894736842
3475,완젼/Noun,57,30,27,0.00033345930684925416,0.0002998867094653131,0.5263157894736842
3476,찌/Noun,57,28,29,0.0003112286863926372,0.00032210053979607705,0.5087719298245614
3477,시장/Noun,57,29,28,0.0003223439966209457,0.00031099362463069506,0.5087719298245614
3478,원주율/Noun,56,2,54,2.2230620456616944e-05,0.0005997734189306263,0.9642857142857143
3479,난국/Noun,56,2,54,2.2230620456616944e-05,0.0005997734189306263,0.9642857142857143
3480,묵직하다/Adjective,56,49,7,0.0005446502011871152,7.774840615767377e-05,0.875
3481,오랫동안/Adverb,56,49,7,0.0005446502011871152,7.774840615767377e-05,0.875
3482,손꼽다/Verb,56,45,11,0.0005001889602738813,0.00012217606681920164,0.8035714285714286
3483,절반/Noun,56,11,45,0.00012226841251139318,0.0004998111824421885,0.8035714285714286
3484,비싸다/Adjective,56,11,45,0.00012226841251139318,0.0004998111824421885,0.8035714285714286
3485,아이고/Exclamation,56,12,44,0.00013338372273970166,0.0004887042672768066,0.7857142857142857
3486,에드/Noun,56,44,12,0.0004890736500455727,0.0001332829819845836,0.7857142857142857
3487,!~/Punctuation,56,43,13,0.0004779583398172643,0.00014438989714996557,0.7678571428571429
3488,의견/Noun,56,15,41,0.00016672965342462708,0.00045538352178066063,0.7321428571428571
3489,덤/Noun,56,40,16,0.0004446124091323389,0.00017771064264611146,0.7142857142857143
3490,싸이코패스/Noun,56,16,40,0.00017784496365293555,0.0004442766066152787,0.7142857142857143
3491,집안/Noun,56,16,40,0.00017784496365293555,0.0004442766066152787,0.7142857142857143
3492,귀찮다/Adjective,56,17,39,0.00018896027388124403,0.0004331696914498967,0.6964285714285714
3493,유행/Noun,56,17,39,0.00018896027388124403,0.0004331696914498967,0.6964285714285714
3494,공식/Noun,56,17,39,0.00018896027388124403,0.0004331696914498967,0.6964285714285714
3495,사장/Noun,56,18,38,0.0002000755841095525,0.00042206277628451476,0.6785714285714286
3496,빼놓다/Verb,56,38,18,0.00042238178867572195,0.0001999244729768754,0.6785714285714286
3497,방향/Noun,56,18,38,0.0002000755841095525,0.00042206277628451476,0.6785714285714286
3498,영웅본색/Noun,56,19,37,0.00021119089433786097,0.00041095586111913277,0.6607142857142857
3499,대하/Noun,56,37,19,0.00041126647844741344,0.00021103138814225738,0.6607142857142857
3500,크레딧/Noun,56,37,19,0.00041126647844741344,0.00021103138814225738,0.6607142857142857
3501,펼치다/Verb,56,37,19,0.00041126647844741344,0.00021103138814225738,0.6607142857142857
3502,추악하다/Adjective,56,36,20,0.000400151168219105,0.00022213830330763935,0.6428571428571429
3503,사무라이/Noun,56,20,36,0.00022230620456616945,0.0003998489459537508,0.6428571428571429
3504,잘나다/Adjective,56,20,36,0.00022230620456616945,0.0003998489459537508,0.6428571428571429
3505,주관/Noun,56,20,36,0.00022230620456616945,0.0003998489459537508,0.6428571428571429
3506,고해/Noun,56,20,36,0.00022230620456616945,0.0003998489459537508,0.6428571428571429
3507,유혹/Noun,56,20,36,0.00022230620456616945,0.0003998489459537508,0.6428571428571429
3508,적나라하다/Adjective,56,35,21,0.0003890358579907965,0.0002332452184730213,0.625
3509,장혁/Noun,56,35,21,0.0003890358579907965,0.0002332452184730213,0.625
3510,콜린/Noun,56,35,21,0.0003890358579907965,0.0002332452184730213,0.625
3511,옮기다/Verb,56,22,34,0.00024453682502278637,0.00037763511562298685,0.6071428571428571
3512,전지현/Noun,56,22,34,0.00024453682502278637,0.00037763511562298685,0.6071428571428571
3513,눕다/Verb,56,22,34,0.00024453682502278637,0.00037763511562298685,0.6071428571428571
3514,박찬욱/Noun,56,22,34,0.00024453682502278637,0.00037763511562298685,0.6071428571428571
3515,따지다/Verb,56,33,23,0.0003668052375341796,0.0002554590488037852,0.5892857142857143
3516,훔치다/Verb,56,23,33,0.00025565213525109487,0.0003665282004576049,0.5892857142857143
3517,지대/Noun,56,23,33,0.00025565213525109487,0.0003665282004576049,0.5892857142857143
3518,걸이/Noun,56,23,33,0.00025565213525109487,0.0003665282004576049,0.5892857142857143
3519,명/Suffix,56,24,32,0.0002667674454794033,0.0003554212852922229,0.5714285714285714
3520,아바타/Noun,56,32,24,0.0003556899273058711,0.0002665659639691672,0.5714285714285714
3521,회상/Noun,56,31,25,0.00034457461707756266,0.0002776728791345492,0.5535714285714286
3522,공허하다/Adjective,56,31,25,0.00034457461707756266,0.0002776728791345492,0.5535714285714286
3523,애인/Noun,56,26,30,0.00028899806593602026,0.000333207454961459,0.5357142857142857
3524,엑스맨/Noun,56,30,26,0.00033345930684925416,0.00028877979429993113,0.5357142857142857
3525,왕자/Noun,56,30,26,0.00033345930684925416,0.00028877979429993113,0.5357142857142857
3526,섹시/Noun,56,30,26,0.00033345930684925416,0.00028877979429993113,0.5357142857142857
3527,부다/Adjective,56,27,29,0.00030011337616432876,0.00032210053979607705,0.5178571428571429
3528,당당하다/Adjective,56,29,27,0.0003223439966209457,0.0002998867094653131,0.5178571428571429
3529,유령/Noun,56,27,29,0.00030011337616432876,0.00032210053979607705,0.5178571428571429
3530,열리다/Verb,56,29,27,0.0003223439966209457,0.0002998867094653131,0.5178571428571429
3531,트랜스포머/Noun,56,28,28,0.0003112286863926372,0.00031099362463069506,0.5
3532,따스하다/Adjective,55,54,1,0.0006002267523286575,1.1106915165381966e-05,0.9818181818181818
3533,만족스럽다/Adjective,55,50,5,0.0005557655114154236,5.5534575826909837e-05,0.9090909090909091
3534,흠잡다/Adjective,55,50,5,0.0005557655114154236,5.5534575826909837e-05,0.9090909090909091
3535,투성이/Noun,55,6,49,6.669186136985083e-05,0.0005442388431037163,0.8909090909090909
3536,어정쩡하다/Adjective,55,6,49,6.669186136985083e-05,0.0005442388431037163,0.8909090909090909
3537,정화/Noun,55,47,8,0.0005224195807304982,8.885532132305573e-05,0.8545454545454545
3538,도망가다/Verb,55,9,46,0.00010003779205477625,0.0005109180976075704,0.8363636363636363
3539,멀쩡하다/Adjective,55,11,44,0.00012226841251139318,0.0004887042672768066,0.8
3540,출현/Noun,55,13,42,0.00014449903296801013,0.0004664904369460426,0.7636363636363637
3541,덜하다/Adjective,55,41,14,0.00045572771936064734,0.00015549681231534753,0.7454545454545455
3542,꼬이다/Adjective,55,15,40,0.00016672965342462708,0.0004442766066152787,0.7272727272727273
3543,촌/Noun,55,38,17,0.00042238178867572195,0.00018881755781149343,0.6909090909090909
3544,러셀/Noun,55,38,17,0.00042238178867572195,0.00018881755781149343,0.6909090909090909
3545,..;/Punctuation,55,17,38,0.00018896027388124403,0.00042206277628451476,0.6909090909090909
3546,하고프다/Verb,55,37,18,0.00041126647844741344,0.0001999244729768754,0.6727272727272727
3547,지독하다/Adjective,55,37,18,0.00041126647844741344,0.0001999244729768754,0.6727272727272727
3548,is/Alpha,55,37,18,0.00041126647844741344,0.0001999244729768754,0.6727272727272727
3549,가식/Noun,55,20,35,0.00022230620456616945,0.00038874203078836884,0.6363636363636364
3550,재방송/Noun,55,35,20,0.0003890358579907965,0.00022213830330763935,0.6363636363636364
3551,다크나이트/Noun,55,35,20,0.0003890358579907965,0.00022213830330763935,0.6363636363636364
3552,끝판/Noun,55,20,35,0.00022230620456616945,0.00038874203078836884,0.6363636363636364
3553,신부/Noun,55,35,20,0.0003890358579907965,0.00022213830330763935,0.6363636363636364
3554,번역/Noun,55,20,35,0.00022230620456616945,0.00038874203078836884,0.6363636363636364
3555,작년/Noun,55,35,20,0.0003890358579907965,0.00022213830330763935,0.6363636363636364
3556,스피드/Noun,55,23,32,0.00025565213525109487,0.0003554212852922229,0.5818181818181818
3557,조지/Noun,55,31,24,0.00034457461707756266,0.0002665659639691672,0.5636363636363636
3558,어딘가/Noun,55,31,24,0.00034457461707756266,0.0002665659639691672,0.5636363636363636
3559,기타/Noun,55,30,25,0.00033345930684925416,0.0002776728791345492,0.5454545454545454
3560,폰/Noun,55,25,30,0.0002778827557077118,0.000333207454961459,0.5454545454545454
3561,대상/Noun,55,25,30,0.0002778827557077118,0.000333207454961459,0.5454545454545454
3562,마디/Noun,55,25,30,0.0002778827557077118,0.000333207454961459,0.5454545454545454
3563,픽션/Noun,55,25,30,0.0002778827557077118,0.000333207454961459,0.5454545454545454
3564,람보/Noun,55,30,25,0.00033345930684925416,0.0002776728791345492,0.5454545454545454
3565,지극히/Adverb,55,29,26,0.0003223439966209457,0.00028877979429993113,0.5272727272727272
3566,완죤/Noun,55,28,27,0.0003112286863926372,0.0002998867094653131,0.509090909090909
3567,준영/Noun,55,27,28,0.00030011337616432876,0.00031099362463069506,0.509090909090909
3568,외로움/Noun,54,52,2,0.0005779961318720405,2.2213830330763933e-05,0.9629629629629629
3569,흑역사/Noun,54,2,52,2.2230620456616944e-05,0.0005775595885998623,0.9629629629629629
3570,개꿀잼/Noun,54,51,3,0.0005668808216437321,3.33207454961459e-05,0.9444444444444444
3571,쪽팔리다/Verb,54,6,48,6.669186136985083e-05,0.0005331319279383344,0.8888888888888888
3572,3분/Number,54,8,46,8.892248182646778e-05,0.0005109180976075704,0.8518518518518519
3573,주행/Noun,54,46,8,0.0005113042705021897,8.885532132305573e-05,0.8518518518518519
3574,온갖/Noun,54,9,45,0.00010003779205477625,0.0004998111824421885,0.8333333333333334
3575,대역/Noun,54,10,44,0.00011115310228308472,0.0004887042672768066,0.8148148148148148
3576,색채/Noun,54,43,11,0.0004779583398172643,0.00012217606681920164,0.7962962962962963
3577,개발/Noun,54,12,42,0.00013338372273970166,0.0004664904369460426,0.7777777777777778
3578,전라도/Noun,54,12,42,0.00013338372273970166,0.0004664904369460426,0.7777777777777778
3579,차마/Noun,54,13,41,0.00014449903296801013,0.00045538352178066063,0.7592592592592593
3580,구경/Noun,54,13,41,0.00014449903296801013,0.00045538352178066063,0.7592592592592593
3581,관람객/Noun,54,14,40,0.0001556143431963186,0.0004442766066152787,0.7407407407407407
3582,혀/Noun,54,14,40,0.0001556143431963186,0.0004442766066152787,0.7407407407407407
3583,일찍/Noun,54,39,15,0.0004334970989040304,0.0001666037274807295,0.7222222222222222
3584,피디/Noun,54,15,39,0.00016672965342462708,0.0004331696914498967,0.7222222222222222
3585,본성/Noun,54,38,16,0.00042238178867572195,0.00017771064264611146,0.7037037037037037
3586,말리다/Verb,54,16,38,0.00017784496365293555,0.00042206277628451476,0.7037037037037037
3587,절절/Noun,54,38,16,0.00042238178867572195,0.00017771064264611146,0.7037037037037037
3588,기용/Noun,54,16,38,0.00017784496365293555,0.00042206277628451476,0.7037037037037037
3589,살기/Noun,54,38,16,0.00042238178867572195,0.00017771064264611146,0.7037037037037037
3590,크리스/Noun,54,38,16,0.00042238178867572195,0.00017771064264611146,0.7037037037037037
3591,팍팍/Adverb,54,17,37,0.00018896027388124403,0.00041095586111913277,0.6851851851851852
3592,거야/Eomi,54,17,37,0.00018896027388124403,0.00041095586111913277,0.6851851851851852
3593,차태현/Noun,54,37,17,0.00041126647844741344,0.00018881755781149343,0.6851851851851852
3594,그나저나/Adverb,54,35,19,0.0003890358579907965,0.00021103138814225738,0.6481481481481481
3595,권/Noun,54,35,19,0.0003890358579907965,0.00021103138814225738,0.6481481481481481
3596,가기/Noun,54,20,34,0.00022230620456616945,0.00037763511562298685,0.6296296296296297
3597,잭슨/Noun,54,34,20,0.00037792054776248805,0.00022213830330763935,0.6296296296296297
3598,거대하다/Adjective,54,34,20,0.00037792054776248805,0.00022213830330763935,0.6296296296296297
3599,버그/Noun,54,34,20,0.00037792054776248805,0.00022213830330763935,0.6296296296296297
3600,밟다/Verb,54,21,33,0.00023342151479447792,0.0003665282004576049,0.6111111111111112
3601,상관/Noun,54,21,33,0.00023342151479447792,0.0003665282004576049,0.6111111111111112
3602,격/Noun,54,21,33,0.00023342151479447792,0.0003665282004576049,0.6111111111111112
3603,다운로드/Noun,54,21,33,0.00023342151479447792,0.0003665282004576049,0.6111111111111112
3604,밀리다/Verb,54,22,32,0.00024453682502278637,0.0003554212852922229,0.5925925925925926
3605,가안/Noun,54,22,32,0.00024453682502278637,0.0003554212852922229,0.5925925925925926
3606,호감/Noun,54,32,22,0.0003556899273058711,0.0002443521336384033,0.5925925925925926
3607,마블/Noun,54,31,23,0.00034457461707756266,0.0002554590488037852,0.5740740740740741
3608,막상/Noun,54,24,30,0.0002667674454794033,0.000333207454961459,0.5555555555555556
3609,픽사/Noun,54,25,29,0.0002778827557077118,0.00032210053979607705,0.5370370370370371
3610,만큼의/Josa,54,29,25,0.0003223439966209457,0.0002776728791345492,0.5370370370370371
3611,디젤/Noun,54,28,26,0.0003112286863926372,0.00028877979429993113,0.5185185185185185
3612,ㅓ/KoreanParticle,54,26,28,0.00028899806593602026,0.00031099362463069506,0.5185185185185185
3613,치료/Noun,54,26,28,0.00028899806593602026,0.00031099362463069506,0.5185185185185185
3614,유지태/Noun,54,28,26,0.0003112286863926372,0.00028877979429993113,0.5185185185185185
3615,냉정하다/Adjective,54,26,28,0.00028899806593602026,0.00031099362463069506,0.5185185185185185
3616,중후/Noun,54,27,27,0.00030011337616432876,0.0002998867094653131,0.5
3617,헛/Noun,53,5,48,5.557655114154236e-05,0.0005331319279383344,0.9056603773584906
3618,팝콘/Noun,53,6,47,6.669186136985083e-05,0.0005220250127729525,0.8867924528301887
3619,흐지부지/Noun,53,6,47,6.669186136985083e-05,0.0005220250127729525,0.8867924528301887
3620,납치/Noun,53,7,46,7.78071715981593e-05,0.0005109180976075704,0.8679245283018868
3621,오유/Noun,53,7,46,7.78071715981593e-05,0.0005109180976075704,0.8679245283018868
3622,서정/Noun,53,45,8,0.0005001889602738813,8.885532132305573e-05,0.8490566037735849
3623,c/Alpha,53,8,45,8.892248182646778e-05,0.0004998111824421885,0.8490566037735849
3624,^^*/Punctuation,53,45,8,0.0005001889602738813,8.885532132305573e-05,0.8490566037735849
3625,클라라/Noun,53,9,44,0.00010003779205477625,0.0004887042672768066,0.8301886792452831
3626,최민식/Noun,53,42,11,0.00046684302958895584,0.00012217606681920164,0.7924528301886793
3627,벌리다/Verb,53,11,42,0.00012226841251139318,0.0004664904369460426,0.7924528301886793
3628,살인자/Noun,53,11,42,0.00012226841251139318,0.0004664904369460426,0.7924528301886793
3629,옛/Modifier,53,41,12,0.00045572771936064734,0.0001332829819845836,0.7735849056603774
3630,나머진/Noun,53,12,41,0.00013338372273970166,0.00045538352178066063,0.7735849056603774
3631,눈요기/Noun,53,12,41,0.00013338372273970166,0.00045538352178066063,0.7735849056603774
3632,깨끗하다/Adjective,53,40,13,0.0004446124091323389,0.00014438989714996557,0.7547169811320755
3633,재치/Noun,53,39,14,0.0004334970989040304,0.00015549681231534753,0.7358490566037735
3634,한국어/Noun,53,14,39,0.0001556143431963186,0.0004331696914498967,0.7358490566037735
3635,께서/Josa,53,38,15,0.00042238178867572195,0.0001666037274807295,0.7169811320754716
3636,이외/Noun,53,15,38,0.00016672965342462708,0.00042206277628451476,0.7169811320754716
3637,조차도/Josa,53,15,38,0.00016672965342462708,0.00042206277628451476,0.7169811320754716
3638,정석/Noun,53,37,16,0.00041126647844741344,0.00017771064264611146,0.6981132075471698
3639,movie/Alpha,53,37,16,0.00041126647844741344,0.00017771064264611146,0.6981132075471698
3640,틀림없다/Adjective,53,37,16,0.00041126647844741344,0.00017771064264611146,0.6981132075471698
3641,네/Modifier,53,16,37,0.00017784496365293555,0.00041095586111913277,0.6981132075471698
3642,예고/Noun,53,16,37,0.00017784496365293555,0.00041095586111913277,0.6981132075471698
3643,저렇다/Adjective,53,16,37,0.00017784496365293555,0.00041095586111913277,0.6981132075471698
3644,멘탈/Noun,53,16,37,0.00017784496365293555,0.00041095586111913277,0.6981132075471698
3645,1분/Number,53,17,36,0.00018896027388124403,0.0003998489459537508,0.6792452830188679
3646,무의미하다/Adjective,53,17,36,0.00018896027388124403,0.0003998489459537508,0.6792452830188679
3647,★/Foreign,53,35,18,0.0003890358579907965,0.0001999244729768754,0.660377358490566
3648,잘알다/Verb,53,35,18,0.0003890358579907965,0.0001999244729768754,0.660377358490566
3649,부터/Foreign,53,35,18,0.0003890358579907965,0.0001999244729768754,0.660377358490566
3650,레옹/Noun,53,18,35,0.0002000755841095525,0.00038874203078836884,0.660377358490566
3651,신도/Noun,53,18,35,0.0002000755841095525,0.00038874203078836884,0.660377358490566
3652,볼걸/Noun,53,18,35,0.0002000755841095525,0.00038874203078836884,0.660377358490566
3653,일리/Noun,53,34,19,0.00037792054776248805,0.00021103138814225738,0.6415094339622641
3654,긴박/Noun,53,19,34,0.00021119089433786097,0.00037763511562298685,0.6415094339622641
3655,이의/Noun,53,33,20,0.0003668052375341796,0.00022213830330763935,0.6226415094339622
3656,꼽히다/Verb,53,33,20,0.0003668052375341796,0.00022213830330763935,0.6226415094339622
3657,태도/Noun,53,20,33,0.00022230620456616945,0.0003665282004576049,0.6226415094339622
3658,감옥/Noun,53,21,32,0.00023342151479447792,0.0003554212852922229,0.6037735849056604
3659,할배/Noun,53,21,32,0.00023342151479447792,0.0003554212852922229,0.6037735849056604
3660,사귀다/Verb,53,21,32,0.00023342151479447792,0.0003554212852922229,0.6037735849056604
3661,신데렐라/Noun,53,22,31,0.00024453682502278637,0.000344314370126841,0.5849056603773585
3662,꺼내다/Verb,53,31,22,0.00034457461707756266,0.0002443521336384033,0.5849056603773585
3663,작전/Noun,53,22,31,0.00024453682502278637,0.000344314370126841,0.5849056603773585
3664,공원/Noun,53,22,31,0.00024453682502278637,0.000344314370126841,0.5849056603773585
3665,어서/Noun,53,31,22,0.00034457461707756266,0.0002443521336384033,0.5849056603773585
3666,프리/Noun,53,31,22,0.00034457461707756266,0.0002443521336384033,0.5849056603773585
3667,당/Noun,53,30,23,0.00033345930684925416,0.0002554590488037852,0.5660377358490566
3668,꾸미다/Verb,53,30,23,0.00033345930684925416,0.0002554590488037852,0.5660377358490566
3669,늑대/Noun,53,24,29,0.0002667674454794033,0.00032210053979607705,0.5471698113207547
3670,마법/Noun,53,29,24,0.0003223439966209457,0.0002665659639691672,0.5471698113207547
3671,반지/Noun,53,29,24,0.0003223439966209457,0.0002665659639691672,0.5471698113207547
3672,함부로/Noun,53,25,28,0.0002778827557077118,0.00031099362463069506,0.5283018867924528
3673,외치다/Verb,53,25,28,0.0002778827557077118,0.00031099362463069506,0.5283018867924528
3674,러브스토리/Noun,53,28,25,0.0003112286863926372,0.0002776728791345492,0.5283018867924528
3675,마을/Noun,53,26,27,0.00028899806593602026,0.0002998867094653131,0.5094339622641509
3676,기록/Noun,53,26,27,0.00028899806593602026,0.0002998867094653131,0.5094339622641509
3677,크리스찬/Noun,53,27,26,0.00030011337616432876,0.00028877979429993113,0.5094339622641509
3678,집단/Noun,53,27,26,0.00030011337616432876,0.00028877979429993113,0.5094339622641509
3679,...;;/Punctuation,52,4,48,4.446124091323389e-05,0.0005331319279383344,0.9230769230769231
3680,ㅗ/KoreanParticle,52,7,45,7.78071715981593e-05,0.0004998111824421885,0.8653846153846154
3681,엉터리/Noun,52,7,45,7.78071715981593e-05,0.0004998111824421885,0.8653846153846154
3682,성찰/Noun,52,43,9,0.0004779583398172643,9.99622364884377e-05,0.8269230769230769
3683,모방/Noun,52,10,42,0.00011115310228308472,0.0004664904369460426,0.8076923076923077
3684,매주/Adverb,52,42,10,0.00046684302958895584,0.00011106915165381967,0.8076923076923077
3685,파라/Noun,52,11,41,0.00012226841251139318,0.00045538352178066063,0.7884615384615384
3686,더니/Noun,52,11,41,0.00012226841251139318,0.00045538352178066063,0.7884615384615384
3687,안남/Noun,52,13,39,0.00014449903296801013,0.0004331696914498967,0.75
3688,어쩌다/Adverb,52,13,39,0.00014449903296801013,0.0004331696914498967,0.75
3689,노튼/Noun,52,38,14,0.00042238178867572195,0.00015549681231534753,0.7307692307692307
3690,베이/Noun,52,38,14,0.00042238178867572195,0.00015549681231534753,0.7307692307692307
3691,!?/Punctuation,52,15,37,0.00016672965342462708,0.00041095586111913277,0.7115384615384616
3692,펼쳐지다/Verb,52,37,15,0.00041126647844741344,0.0001666037274807295,0.7115384615384616
3693,고어/Noun,52,16,36,0.00017784496365293555,0.0003998489459537508,0.6923076923076923
3694,어딜/Adverb,52,17,35,0.00018896027388124403,0.00038874203078836884,0.6730769230769231
3695,빨갛다/Adjective,52,35,17,0.0003890358579907965,0.00018881755781149343,0.6730769230769231
3696,수없이/Adverb,52,17,35,0.00018896027388124403,0.00038874203078836884,0.6730769230769231
3697,몇개/Noun,52,18,34,0.0002000755841095525,0.00037763511562298685,0.6538461538461539
3698,조명/Noun,52,34,18,0.00037792054776248805,0.0001999244729768754,0.6538461538461539
3699,주네/Noun,52,34,18,0.00037792054776248805,0.0001999244729768754,0.6538461538461539
3700,금지/Noun,52,19,33,0.00021119089433786097,0.0003665282004576049,0.6346153846153846
3701,예수/Noun,52,19,33,0.00021119089433786097,0.0003665282004576049,0.6346153846153846
3702,커피/Noun,52,33,19,0.0003668052375341796,0.00021103138814225738,0.6346153846153846
3703,불만/Noun,52,20,32,0.00022230620456616945,0.0003554212852922229,0.6153846153846154
3704,장이/Suffix,52,20,32,0.00022230620456616945,0.0003554212852922229,0.6153846153846154
3705,헉/Adverb,52,20,32,0.00022230620456616945,0.0003554212852922229,0.6153846153846154
3706,MBC/Alpha,52,20,32,0.00022230620456616945,0.0003554212852922229,0.6153846153846154
3707,성유리/Noun,52,32,20,0.0003556899273058711,0.00022213830330763935,0.6153846153846154
3708,일수/Noun,52,31,21,0.00034457461707756266,0.0002332452184730213,0.5961538461538461
3709,님들/Noun,52,21,31,0.00023342151479447792,0.000344314370126841,0.5961538461538461
3710,여유/Noun,52,31,21,0.00034457461707756266,0.0002332452184730213,0.5961538461538461
3711,국제/Noun,52,30,22,0.00033345930684925416,0.0002443521336384033,0.5769230769230769
3712,인도영화/Noun,52,30,22,0.00033345930684925416,0.0002443521336384033,0.5769230769230769
3713,라스/Noun,52,29,23,0.0003223439966209457,0.0002554590488037852,0.5576923076923077
3714,경악/Noun,52,23,29,0.00025565213525109487,0.00032210053979607705,0.5576923076923077
3715,극본/Noun,52,23,29,0.00025565213525109487,0.00032210053979607705,0.5576923076923077
3716,또는/Adverb,52,24,28,0.0002667674454794033,0.00031099362463069506,0.5384615384615384
3717,실상/Noun,52,24,28,0.0002667674454794033,0.00031099362463069506,0.5384615384615384
3718,비참하다/Adjective,52,28,24,0.0003112286863926372,0.0002665659639691672,0.5384615384615384
3719,지네/Noun,52,26,26,0.00028899806593602026,0.00028877979429993113,0.5
3720,끈/Noun,52,26,26,0.00028899806593602026,0.00028877979429993113,0.5
3721,어수선하다/Adjective,51,3,48,3.3345930684925414e-05,0.0005331319279383344,0.9411764705882353
3722,저급하다/Adjective,51,5,46,5.557655114154236e-05,0.0005109180976075704,0.9019607843137255
3723,씨발/Noun,51,5,46,5.557655114154236e-05,0.0005109180976075704,0.9019607843137255
3724,가관/Noun,51,6,45,6.669186136985083e-05,0.0004998111824421885,0.8823529411764706
3725,불필요하다/Adjective,51,7,44,7.78071715981593e-05,0.0004887042672768066,0.8627450980392157
3726,.!/Punctuation,51,44,7,0.0004890736500455727,7.774840615767377e-05,0.8627450980392157
3727,양반/Noun,51,8,43,8.892248182646778e-05,0.00047759735211142456,0.8431372549019608
3728,파이팅/Noun,51,42,9,0.00046684302958895584,9.99622364884377e-05,0.8235294117647058
3729,뚝뚝/Noun,51,9,42,0.00010003779205477625,0.0004664904369460426,0.8235294117647058
3730,땡/Noun,51,9,42,0.00010003779205477625,0.0004664904369460426,0.8235294117647058
3731,모두/Modifier,51,40,11,0.0004446124091323389,0.00012217606681920164,0.7843137254901961
3732,잠자다/Verb,51,11,40,0.00012226841251139318,0.0004442766066152787,0.7843137254901961
3733,덜덜/Noun,51,40,11,0.0004446124091323389,0.00012217606681920164,0.7843137254901961
3734,먼지/Noun,51,12,39,0.00013338372273970166,0.0004331696914498967,0.7647058823529411
3735,임청하/Noun,51,39,12,0.0004334970989040304,0.0001332829819845836,0.7647058823529411
3736,다니엘/Noun,51,39,12,0.0004334970989040304,0.0001332829819845836,0.7647058823529411
3737,불과하다/Adjective,51,14,37,0.0001556143431963186,0.00041095586111913277,0.7254901960784313
3738,피식/Adverb,51,15,36,0.00016672965342462708,0.0003998489459537508,0.7058823529411765
3739,텐데/Eomi,51,16,35,0.00017784496365293555,0.00038874203078836884,0.6862745098039216
3740,마틴/Noun,51,35,16,0.0003890358579907965,0.00017771064264611146,0.6862745098039216
3741,첩보/Noun,51,35,16,0.0003890358579907965,0.00017771064264611146,0.6862745098039216
3742,취급/Noun,51,17,34,0.00018896027388124403,0.00037763511562298685,0.6666666666666666
3743,허구/Noun,51,18,33,0.0002000755841095525,0.0003665282004576049,0.6470588235294118
3744,vs/Alpha,51,18,33,0.0002000755841095525,0.0003665282004576049,0.6470588235294118
3745,흔적/Noun,51,18,33,0.0002000755841095525,0.0003665282004576049,0.6470588235294118
3746,7.5/Number,51,33,18,0.0003668052375341796,0.0001999244729768754,0.6470588235294118
3747,리스/Noun,51,32,19,0.0003556899273058711,0.00021103138814225738,0.6274509803921569
3748,이은주/Noun,51,32,19,0.0003556899273058711,0.00021103138814225738,0.6274509803921569
3749,7년/Number,51,31,20,0.00034457461707756266,0.00022213830330763935,0.6078431372549019
3750,생기/Noun,51,20,31,0.00022230620456616945,0.000344314370126841,0.6078431372549019
3751,와중/Noun,51,20,31,0.00022230620456616945,0.000344314370126841,0.6078431372549019
3752,장치/Noun,51,30,21,0.00033345930684925416,0.0002332452184730213,0.5882352941176471
3753,밖엔/Josa,51,21,30,0.00023342151479447792,0.000333207454961459,0.5882352941176471
3754,후기/Noun,51,21,30,0.00023342151479447792,0.000333207454961459,0.5882352941176471
3755,체험/Noun,51,21,30,0.00023342151479447792,0.000333207454961459,0.5882352941176471
3756,파악/Noun,51,21,30,0.00023342151479447792,0.000333207454961459,0.5882352941176471
3757,간/Foreign,51,22,29,0.00024453682502278637,0.00032210053979607705,0.5686274509803921
3758,특/Noun,51,29,22,0.0003223439966209457,0.0002443521336384033,0.5686274509803921
3759,누/Noun,51,22,29,0.00024453682502278637,0.00032210053979607705,0.5686274509803921
3760,장동건/Noun,51,22,29,0.00024453682502278637,0.00032210053979607705,0.5686274509803921
3761,활동/Noun,51,22,29,0.00024453682502278637,0.00032210053979607705,0.5686274509803921
3762,답지/Noun,51,24,27,0.0002667674454794033,0.0002998867094653131,0.5294117647058824
3763,전투씬/Noun,51,25,26,0.0002778827557077118,0.00028877979429993113,0.5098039215686274
3764,지인/Noun,51,26,25,0.00028899806593602026,0.0002776728791345492,0.5098039215686274
3765,이/Modifier,51,26,25,0.00028899806593602026,0.0002776728791345492,0.5098039215686274
3766,어중간하다/Adjective,50,2,48,2.2230620456616944e-05,0.0005331319279383344,0.96
3767,어쩌라고/Adverb,50,3,47,3.3345930684925414e-05,0.0005220250127729525,0.94
3768,극혐/Noun,50,5,45,5.557655114154236e-05,0.0004998111824421885,0.9
3769,전해지다/Verb,50,43,7,0.0004779583398172643,7.774840615767377e-05,0.86
3770,재수없다/Adjective,50,8,42,8.892248182646778e-05,0.0004664904369460426,0.84
3771,위원회/Noun,50,8,42,8.892248182646778e-05,0.0004664904369460426,0.84
3772,어의/Noun,50,9,41,0.00010003779205477625,0.00045538352178066063,0.82
3773,절묘하다/Adjective,50,39,11,0.0004334970989040304,0.00012217606681920164,0.78
3774,먹히다/Verb,50,12,38,0.00013338372273970166,0.00042206277628451476,0.76
3775,연주/Noun,50,38,12,0.00042238178867572195,0.0001332829819845836,0.76
3776,이연희/Noun,50,37,13,0.00041126647844741344,0.00014438989714996557,0.74
3777,생존/Noun,50,36,14,0.000400151168219105,0.00015549681231534753,0.72
3778,망설이다/Verb,50,36,14,0.000400151168219105,0.00015549681231534753,0.72
3779,원피스/Noun,50,36,14,0.000400151168219105,0.00015549681231534753,0.72
3780,역다/Adjective,50,14,36,0.0001556143431963186,0.0003998489459537508,0.72
3781,여기저기/Noun,50,14,36,0.0001556143431963186,0.0003998489459537508,0.72
3782,에드워드/Noun,50,35,15,0.0003890358579907965,0.0001666037274807295,0.7
3783,고스/Noun,50,35,15,0.0003890358579907965,0.0001666037274807295,0.7
3784,강력하다/Adjective,50,34,16,0.00037792054776248805,0.00017771064264611146,0.68
3785,오우삼/Noun,50,17,33,0.00018896027388124403,0.0003665282004576049,0.66
3786,안성기/Noun,50,33,17,0.0003668052375341796,0.00018881755781149343,0.66
3787,까지/Foreign,50,17,33,0.00018896027388124403,0.0003665282004576049,0.66
3788,전도연/Noun,50,33,17,0.0003668052375341796,0.00018881755781149343,0.66
3789,엿보다/Verb,50,33,17,0.0003668052375341796,0.00018881755781149343,0.66
3790,영광/Noun,50,33,17,0.0003668052375341796,0.00018881755781149343,0.66
3791,바쁘다/Adjective,50,17,33,0.00018896027388124403,0.0003665282004576049,0.66
3792,전화/Noun,50,17,33,0.00018896027388124403,0.0003665282004576049,0.66
3793,닷/Noun,50,33,17,0.0003668052375341796,0.00018881755781149343,0.66
3794,증명/Noun,50,18,32,0.0002000755841095525,0.0003554212852922229,0.64
3795,구도/Noun,50,18,32,0.0002000755841095525,0.0003554212852922229,0.64
3796,종합/Noun,50,18,32,0.0002000755841095525,0.0003554212852922229,0.64
3797,검사/Noun,50,19,31,0.00021119089433786097,0.000344314370126841,0.62
3798,소지섭/Noun,50,31,19,0.00034457461707756266,0.00021103138814225738,0.62
3799,추구/Noun,50,31,19,0.00034457461707756266,0.00021103138814225738,0.62
3800,로버츠/Noun,50,30,20,0.00033345930684925416,0.00022213830330763935,0.6
3801,카메론/Noun,50,30,20,0.00033345930684925416,0.00022213830330763935,0.6
3802,장근석/Noun,50,20,30,0.00022230620456616945,0.000333207454961459,0.6
3803,언론/Noun,50,30,20,0.00033345930684925416,0.00022213830330763935,0.6
3804,구혜선/Noun,50,20,30,0.00022230620456616945,0.000333207454961459,0.6
3805,나니/Noun,50,29,21,0.0003223439966209457,0.0002332452184730213,0.58
3806,유의/Noun,50,29,21,0.0003223439966209457,0.0002332452184730213,0.58
3807,역활/Noun,50,22,28,0.00024453682502278637,0.00031099362463069506,0.56
3808,죽지/Noun,50,28,22,0.0003112286863926372,0.0002443521336384033,0.56
3809,심정/Noun,50,22,28,0.00024453682502278637,0.00031099362463069506,0.56
3810,멤버/Noun,50,28,22,0.0003112286863926372,0.0002443521336384033,0.56
3811,댄스/Noun,50,22,28,0.00024453682502278637,0.00031099362463069506,0.56
3812,지적/Noun,50,28,22,0.0003112286863926372,0.0002443521336384033,0.56
3813,출발/Noun,50,23,27,0.00025565213525109487,0.0002998867094653131,0.54
3814,단역/Noun,50,24,26,0.0002667674454794033,0.00028877979429993113,0.52
3815,스페인/Noun,50,26,24,0.00028899806593602026,0.0002665659639691672,0.52
3816,서양/Noun,50,24,26,0.0002667674454794033,0.00028877979429993113,0.52
3817,곰/Noun,50,26,24,0.00028899806593602026,0.0002665659639691672,0.52
3818,자격/Noun,50,25,25,0.0002778827557077118,0.0002776728791345492,0.5
3819,2.22/Number,49,0,49,0.0,0.0005442388431037163,1.0
3820,선율/Noun,49,47,2,0.0005224195807304982,2.2213830330763933e-05,0.9591836734693877
3821,접함/Noun,49,3,46,3.3345930684925414e-05,0.0005109180976075704,0.9387755102040817
3822,김구라/Noun,49,3,46,3.3345930684925414e-05,0.0005109180976075704,0.9387755102040817
3823,지저분하다/Adjective,49,3,46,3.3345930684925414e-05,0.0005109180976075704,0.9387755102040817
3824,배속/Noun,49,4,45,4.446124091323389e-05,0.0004998111824421885,0.9183673469387755
3825,유쾌/Noun,49,45,4,0.0005001889602738813,4.4427660661527865e-05,0.9183673469387755
3826,전락/Noun,49,5,44,5.557655114154236e-05,0.0004887042672768066,0.8979591836734694
3827,뽕짝/Noun,49,5,44,5.557655114154236e-05,0.0004887042672768066,0.8979591836734694
3828,부드럽다/Adjective,49,43,6,0.0004779583398172643,6.66414909922918e-05,0.8775510204081632
3829,사기꾼/Noun,49,6,43,6.669186136985083e-05,0.00047759735211142456,0.8775510204081632
3830,스킵/Noun,49,6,43,6.669186136985083e-05,0.00047759735211142456,0.8775510204081632
3831,무리수/Noun,49,6,43,6.669186136985083e-05,0.00047759735211142456,0.8775510204081632
3832,두려움/Noun,49,43,6,0.0004779583398172643,6.66414909922918e-05,0.8775510204081632
3833,재주/Noun,49,8,41,8.892248182646778e-05,0.00045538352178066063,0.8367346938775511
3834,감기/Noun,49,9,40,0.00010003779205477625,0.0004442766066152787,0.8163265306122449
3835,애로/Noun,49,9,40,0.00010003779205477625,0.0004442766066152787,0.8163265306122449
3836,시스/Noun,49,40,9,0.0004446124091323389,9.99622364884377e-05,0.8163265306122449
3837,록키/Noun,49,39,10,0.0004334970989040304,0.00011106915165381967,0.7959183673469388
3838,The/Alpha,49,39,10,0.0004334970989040304,0.00011106915165381967,0.7959183673469388
3839,스키/Noun,49,38,11,0.00042238178867572195,0.00012217606681920164,0.7755102040816326
3840,한두/Modifier,49,11,38,0.00012226841251139318,0.00042206277628451476,0.7755102040816326
3841,흉내내/Noun,49,12,37,0.00013338372273970166,0.00041095586111913277,0.7551020408163265
3842,뜯다/Verb,49,12,37,0.00013338372273970166,0.00041095586111913277,0.7551020408163265
3843,튀어나오다/Verb,49,12,37,0.00013338372273970166,0.00041095586111913277,0.7551020408163265
3844,경의/Noun,49,36,13,0.000400151168219105,0.00014438989714996557,0.7346938775510204
3845,간직/Noun,49,36,13,0.000400151168219105,0.00014438989714996557,0.7346938775510204
3846,무색/Noun,49,15,34,0.00016672965342462708,0.00037763511562298685,0.6938775510204082
3847,이탈리아/Noun,49,33,16,0.0003668052375341796,0.00017771064264611146,0.673469387755102
3848,고치다/Verb,49,16,33,0.00017784496365293555,0.0003665282004576049,0.673469387755102
3849,충/Noun,49,16,33,0.00017784496365293555,0.0003665282004576049,0.673469387755102
3850,목사/Noun,49,32,17,0.0003556899273058711,0.00018881755781149343,0.6530612244897959
3851,이웃/Noun,49,17,32,0.00018896027388124403,0.0003554212852922229,0.6530612244897959
3852,셋/Noun,49,17,32,0.00018896027388124403,0.0003554212852922229,0.6530612244897959
3853,일생/Noun,49,32,17,0.0003556899273058711,0.00018881755781149343,0.6530612244897959
3854,홍/Noun,49,18,31,0.0002000755841095525,0.000344314370126841,0.6326530612244898
3855,학살/Noun,49,18,31,0.0002000755841095525,0.000344314370126841,0.6326530612244898
3856,저절로/Noun,49,30,19,0.00033345930684925416,0.00021103138814225738,0.6122448979591837
3857,로망/Noun,49,30,19,0.00033345930684925416,0.00021103138814225738,0.6122448979591837
3858,품/Noun,49,29,20,0.0003223439966209457,0.00022213830330763935,0.5918367346938775
3859,왕가위/Noun,49,29,20,0.0003223439966209457,0.00022213830330763935,0.5918367346938775
3860,아시/Noun,49,29,20,0.0003223439966209457,0.00022213830330763935,0.5918367346938775
3861,락/Noun,49,20,29,0.00022230620456616945,0.00032210053979607705,0.5918367346938775
3862,도로/Noun,49,20,29,0.00022230620456616945,0.00032210053979607705,0.5918367346938775
3863,예술가/Noun,49,29,20,0.0003223439966209457,0.00022213830330763935,0.5918367346938775
3864,초기/Noun,49,20,29,0.00022230620456616945,0.00032210053979607705,0.5918367346938775
3865,직/Noun,49,20,29,0.00022230620456616945,0.00032210053979607705,0.5918367346938775
3866,비슷/Noun,49,21,28,0.00023342151479447792,0.00031099362463069506,0.5714285714285714
3867,말르다/Adjective,49,21,28,0.00023342151479447792,0.00031099362463069506,0.5714285714285714
3868,양조위/Noun,49,28,21,0.0003112286863926372,0.0002332452184730213,0.5714285714285714
3869,월/Noun,49,28,21,0.0003112286863926372,0.0002332452184730213,0.5714285714285714
3870,.(/Punctuation,49,22,27,0.00024453682502278637,0.0002998867094653131,0.5510204081632653
3871,채다/Verb,49,22,27,0.00024453682502278637,0.0002998867094653131,0.5510204081632653
3872,모순/Noun,49,27,22,0.00030011337616432876,0.0002443521336384033,0.5510204081632653
3873,ㅇㅇㅇ/KoreanParticle,49,26,23,0.00028899806593602026,0.0002554590488037852,0.5306122448979592
3874,올라오다/Verb,49,26,23,0.00028899806593602026,0.0002554590488037852,0.5306122448979592
3875,자아/Noun,49,23,26,0.00025565213525109487,0.00028877979429993113,0.5306122448979592
3876,테/Noun,49,26,23,0.00028899806593602026,0.0002554590488037852,0.5306122448979592
3877,양/Noun,49,23,26,0.00025565213525109487,0.00028877979429993113,0.5306122448979592
3878,지배/Noun,49,25,24,0.0002778827557077118,0.0002665659639691672,0.5102040816326531
3879,미야자키/Noun,49,25,24,0.0002778827557077118,0.0002665659639691672,0.5102040816326531
3880,내보내다/Verb,48,1,47,1.1115310228308472e-05,0.0005220250127729525,0.9791666666666666
3881,주옥/Noun,48,47,1,0.0005224195807304982,1.1106915165381966e-05,0.9791666666666666
3882,파워레인저/Noun,48,5,43,5.557655114154236e-05,0.00047759735211142456,0.8958333333333334
3883,엉엉/Noun,48,41,7,0.00045572771936064734,7.774840615767377e-05,0.8541666666666666
3884,이예/Noun,48,40,8,0.0004446124091323389,8.885532132305573e-05,0.8333333333333334
3885,그땐/Noun,48,40,8,0.0004446124091323389,8.885532132305573e-05,0.8333333333333334
3886,이혼/Noun,48,8,40,8.892248182646778e-05,0.0004442766066152787,0.8333333333333334
3887,나빠지다/Verb,48,9,39,0.00010003779205477625,0.0004331696914498967,0.8125
3888,과잉/Noun,48,9,39,0.00010003779205477625,0.0004331696914498967,0.8125
3889,카피/Noun,48,9,39,0.00010003779205477625,0.0004331696914498967,0.8125
3890,노골/Noun,48,11,37,0.00012226841251139318,0.00041095586111913277,0.7708333333333334
3891,젖다/Verb,48,36,12,0.000400151168219105,0.0001332829819845836,0.75
3892,8.5/Number,48,36,12,0.000400151168219105,0.0001332829819845836,0.75
3893,미국인/Noun,48,13,35,0.00014449903296801013,0.00038874203078836884,0.7291666666666666
3894,품다/Verb,48,35,13,0.0003890358579907965,0.00014438989714996557,0.7291666666666666
3895,려/Noun,48,13,35,0.00014449903296801013,0.00038874203078836884,0.7291666666666666
3896,대고/Noun,48,14,34,0.0001556143431963186,0.00037763511562298685,0.7083333333333334
3897,화판/Noun,48,14,34,0.0001556143431963186,0.00037763511562298685,0.7083333333333334
3898,대감/Noun,48,14,34,0.0001556143431963186,0.00037763511562298685,0.7083333333333334
3899,흥분/Noun,48,34,14,0.00037792054776248805,0.00015549681231534753,0.7083333333333334
3900,마케팅/Noun,48,15,33,0.00016672965342462708,0.0003665282004576049,0.6875
3901,한정/Noun,48,32,16,0.0003556899273058711,0.00017771064264611146,0.6666666666666666
3902,아이러니/Noun,48,31,17,0.00034457461707756266,0.00018881755781149343,0.6458333333333334
3903,따라오다/Verb,48,31,17,0.00034457461707756266,0.00018881755781149343,0.6458333333333334
3904,송혜교/Noun,48,17,31,0.00018896027388124403,0.000344314370126841,0.6458333333333334
3905,신세경/Noun,48,17,31,0.00018896027388124403,0.000344314370126841,0.6458333333333334
3906,위기/Noun,48,17,31,0.00018896027388124403,0.000344314370126841,0.6458333333333334
3907,침묵/Noun,48,30,18,0.00033345930684925416,0.0001999244729768754,0.625
3908,송지효/Noun,48,30,18,0.00033345930684925416,0.0001999244729768754,0.625
3909,일요일/Noun,48,30,18,0.00033345930684925416,0.0001999244729768754,0.625
3910,주원/Noun,48,30,18,0.00033345930684925416,0.0001999244729768754,0.625
3911,저주/Noun,48,18,30,0.0002000755841095525,0.000333207454961459,0.625
3912,마르/Noun,48,29,19,0.0003223439966209457,0.00021103138814225738,0.6041666666666666
3913,지고/Noun,48,29,19,0.0003223439966209457,0.00021103138814225738,0.6041666666666666
3914,고자/Noun,48,19,29,0.00021119089433786097,0.00032210053979607705,0.6041666666666666
3915,이구/Noun,48,28,20,0.0003112286863926372,0.00022213830330763935,0.5833333333333334
3916,후속/Noun,48,28,20,0.0003112286863926372,0.00022213830330763935,0.5833333333333334
3917,쏟아지다/Verb,48,28,20,0.0003112286863926372,0.00022213830330763935,0.5833333333333334
3918,째다/Verb,48,20,28,0.00022230620456616945,0.00031099362463069506,0.5833333333333334
3919,물건/Noun,48,20,28,0.00022230620456616945,0.00031099362463069506,0.5833333333333334
3920,유우/Noun,48,20,28,0.00022230620456616945,0.00031099362463069506,0.5833333333333334
3921,로다/Josa,48,21,27,0.00023342151479447792,0.0002998867094653131,0.5625
3922,불안하다/Adjective,48,27,21,0.00030011337616432876,0.0002332452184730213,0.5625
3923,증거/Noun,48,21,27,0.00023342151479447792,0.0002998867094653131,0.5625
3924,줄리아/Noun,48,22,26,0.00024453682502278637,0.00028877979429993113,0.5416666666666666
3925,극/Noun,48,22,26,0.00024453682502278637,0.00028877979429993113,0.5416666666666666
3926,들보/Noun,48,22,26,0.00024453682502278637,0.00028877979429993113,0.5416666666666666
3927,알리다/Verb,48,25,23,0.0002778827557077118,0.0002554590488037852,0.5208333333333334
3928,시간대/Noun,48,23,25,0.00025565213525109487,0.0002776728791345492,0.5208333333333334
3929,긍정/Noun,48,25,23,0.0002778827557077118,0.0002554590488037852,0.5208333333333334
3930,토끼/Noun,48,24,24,0.0002667674454794033,0.0002665659639691672,0.5
3931,고도/Noun,48,24,24,0.0002667674454794033,0.0002665659639691672,0.5
3932,조악하다/Adjective,47,1,46,1.1115310228308472e-05,0.0005109180976075704,0.9787234042553191
3933,낚였/Noun,47,1,46,1.1115310228308472e-05,0.0005109180976075704,0.9787234042553191
3934,졸잼/Noun,47,43,4,0.0004779583398172643,4.4427660661527865e-05,0.9148936170212766
3935,클리셰/Noun,47,5,42,5.557655114154236e-05,0.0004664904369460426,0.8936170212765957
3936,이스트/Noun,47,41,6,0.00045572771936064734,6.66414909922918e-05,0.8723404255319149
3937,구역/Noun,47,8,39,8.892248182646778e-05,0.0004331696914498967,0.8297872340425532
3938,구려/Noun,47,8,39,8.892248182646778e-05,0.0004331696914498967,0.8297872340425532
3939,만날/Noun,47,38,9,0.00042238178867572195,9.99622364884377e-05,0.8085106382978723
3940,대가리/Noun,47,9,38,0.00010003779205477625,0.00042206277628451476,0.8085106382978723
3941,인척/Noun,47,10,37,0.00011115310228308472,0.00041095586111913277,0.7872340425531915
3942,환장하다/Adjective,47,10,37,0.00011115310228308472,0.00041095586111913277,0.7872340425531915
3943,-_-;/Punctuation,47,12,35,0.00013338372273970166,0.00038874203078836884,0.7446808510638298
3944,타령/Noun,47,12,35,0.00013338372273970166,0.00038874203078836884,0.7446808510638298
3945,하드/Noun,47,13,34,0.00014449903296801013,0.00037763511562298685,0.723404255319149
3946,면도/Noun,47,33,14,0.0003668052375341796,0.00015549681231534753,0.7021276595744681
3947,붉다/Adjective,47,33,14,0.0003668052375341796,0.00015549681231534753,0.7021276595744681
3948,조승우/Noun,47,33,14,0.0003668052375341796,0.00015549681231534753,0.7021276595744681
3949,별다르다/Adjective,47,14,33,0.0001556143431963186,0.0003665282004576049,0.7021276595744681
3950,시사/Noun,47,33,14,0.0003668052375341796,0.00015549681231534753,0.7021276595744681
3951,도라에몽/Noun,47,33,14,0.0003668052375341796,0.00015549681231534753,0.7021276595744681
3952,오페라/Noun,47,33,14,0.0003668052375341796,0.00015549681231534753,0.7021276595744681
3953,신념/Noun,47,32,15,0.0003556899273058711,0.0001666037274807295,0.6808510638297872
3954,아이언맨/Noun,47,32,15,0.0003556899273058711,0.0001666037274807295,0.6808510638297872
3955,애국심/Noun,47,15,32,0.00016672965342462708,0.0003554212852922229,0.6808510638297872
3956,작/Foreign,47,15,32,0.00016672965342462708,0.0003554212852922229,0.6808510638297872
3957,미이라/Noun,47,15,32,0.00016672965342462708,0.0003554212852922229,0.6808510638297872
3958,드래곤볼/Noun,47,15,32,0.00016672965342462708,0.0003554212852922229,0.6808510638297872
3959,전이/Noun,47,31,16,0.00034457461707756266,0.00017771064264611146,0.6595744680851063
3960,크루즈/Noun,47,31,16,0.00034457461707756266,0.00017771064264611146,0.6595744680851063
3961,김명민/Noun,47,30,17,0.00033345930684925416,0.00018881755781149343,0.6382978723404256
3962,웅장/Noun,47,30,17,0.00033345930684925416,0.00018881755781149343,0.6382978723404256
3963,지브리/Noun,47,30,17,0.00033345930684925416,0.00018881755781149343,0.6382978723404256
3964,홍금보/Noun,47,30,17,0.00033345930684925416,0.00018881755781149343,0.6382978723404256
3965,쩜/Noun,47,29,18,0.0003223439966209457,0.0001999244729768754,0.6170212765957447
3966,2015년/Number,47,29,18,0.0003223439966209457,0.0001999244729768754,0.6170212765957447
3967,부여/Noun,47,18,29,0.0002000755841095525,0.00032210053979607705,0.6170212765957447
3968,뻥/Noun,47,18,29,0.0002000755841095525,0.00032210053979607705,0.6170212765957447
3969,국적/Noun,47,29,18,0.0003223439966209457,0.0001999244729768754,0.6170212765957447
3970,독립/Noun,47,29,18,0.0003223439966209457,0.0001999244729768754,0.6170212765957447
3971,메인/Noun,47,18,29,0.0002000755841095525,0.00032210053979607705,0.6170212765957447
3972,밧다/Verb,47,29,18,0.0003223439966209457,0.0001999244729768754,0.6170212765957447
3973,보고서/Noun,47,29,18,0.0003223439966209457,0.0001999244729768754,0.6170212765957447
3974,자의/Noun,47,29,18,0.0003223439966209457,0.0001999244729768754,0.6170212765957447
3975,겹/Noun,47,28,19,0.0003112286863926372,0.00021103138814225738,0.5957446808510638
3976,한글/Noun,47,28,19,0.0003112286863926372,0.00021103138814225738,0.5957446808510638
3977,간단하다/Adjective,47,19,28,0.00021119089433786097,0.00031099362463069506,0.5957446808510638
3978,초점/Noun,47,20,27,0.00022230620456616945,0.0002998867094653131,0.574468085106383
3979,봉/Noun,47,20,27,0.00022230620456616945,0.0002998867094653131,0.574468085106383
3980,인종차별/Noun,47,20,27,0.00022230620456616945,0.0002998867094653131,0.574468085106383
3981,다크/Noun,47,26,21,0.00028899806593602026,0.0002332452184730213,0.5531914893617021
3982,미리/Noun,47,21,26,0.00023342151479447792,0.00028877979429993113,0.5531914893617021
3983,ㅐ/KoreanParticle,47,21,26,0.00023342151479447792,0.00028877979429993113,0.5531914893617021
3984,꼬맹이/Noun,47,26,21,0.00028899806593602026,0.0002332452184730213,0.5531914893617021
3985,쥬라기/Noun,47,21,26,0.00023342151479447792,0.00028877979429993113,0.5531914893617021
3986,고수/Noun,47,21,26,0.00023342151479447792,0.00028877979429993113,0.5531914893617021
3987,커지다/Verb,47,22,25,0.00024453682502278637,0.0002776728791345492,0.5319148936170213
3988,스탈/Noun,47,22,25,0.00024453682502278637,0.0002776728791345492,0.5319148936170213
3989,무지하다/Adjective,47,25,22,0.0002778827557077118,0.0002443521336384033,0.5319148936170213
3990,비치/Noun,47,22,25,0.00024453682502278637,0.0002776728791345492,0.5319148936170213
3991,불쌍/Noun,47,22,25,0.00024453682502278637,0.0002776728791345492,0.5319148936170213
3992,배려/Noun,47,25,22,0.0002778827557077118,0.0002443521336384033,0.5319148936170213
3993,열광하다/Adjective,47,22,25,0.00024453682502278637,0.0002776728791345492,0.5319148936170213
3994,감추다/Verb,47,24,23,0.0002667674454794033,0.0002554590488037852,0.5106382978723404
3995,갓/Modifier,47,23,24,0.00025565213525109487,0.0002665659639691672,0.5106382978723404
3996,~~~~~/Punctuation,47,23,24,0.00025565213525109487,0.0002665659639691672,0.5106382978723404
3997,운동/Noun,47,23,24,0.00025565213525109487,0.0002665659639691672,0.5106382978723404
3998,남발/Noun,46,2,44,2.2230620456616944e-05,0.0004887042672768066,0.9565217391304348
3999,용가리/Noun,46,5,41,5.557655114154236e-05,0.00045538352178066063,0.8913043478260869
4000,배드/Noun,46,6,40,6.669186136985083e-05,0.0004442766066152787,0.8695652173913043
4001,재탕/Noun,46,6,40,6.669186136985083e-05,0.0004442766066152787,0.8695652173913043
4002,증말/Noun,46,7,39,7.78071715981593e-05,0.0004331696914498967,0.8478260869565217
4003,우왕/Noun,46,39,7,0.0004334970989040304,7.774840615767377e-05,0.8478260869565217
4004,재료/Noun,46,7,39,7.78071715981593e-05,0.0004331696914498967,0.8478260869565217
4005,즐/Noun,46,7,39,7.78071715981593e-05,0.0004331696914498967,0.8478260869565217
4006,덴젤/Noun,46,38,8,0.00042238178867572195,8.885532132305573e-05,0.8260869565217391
4007,풍부하다/Adjective,46,37,9,0.00041126647844741344,9.99622364884377e-05,0.8043478260869565
4008,벗기다/Verb,46,9,37,0.00010003779205477625,0.00041095586111913277,0.8043478260869565
4009,정당화/Noun,46,9,37,0.00010003779205477625,0.00041095586111913277,0.8043478260869565
4010,저희/Noun,46,34,12,0.00037792054776248805,0.0001332829819845836,0.7391304347826086
4011,땜시/Noun,46,12,34,0.00013338372273970166,0.00037763511562298685,0.7391304347826086
4012,줄이다/Verb,46,13,33,0.00014449903296801013,0.0003665282004576049,0.717391304347826
4013,특징/Noun,46,13,33,0.00014449903296801013,0.0003665282004576049,0.717391304347826
4014,태양/Noun,46,33,13,0.0003668052375341796,0.00014438989714996557,0.717391304347826
4015,조정/Noun,46,13,33,0.00014449903296801013,0.0003665282004576049,0.717391304347826
4016,정통/Noun,46,32,14,0.0003556899273058711,0.00015549681231534753,0.6956521739130435
4017,역쉬/Noun,46,31,15,0.00034457461707756266,0.0001666037274807295,0.6739130434782609
4018,나와라/Noun,46,31,15,0.00034457461707756266,0.0001666037274807295,0.6739130434782609
4019,6년/Number,46,31,15,0.00034457461707756266,0.0001666037274807295,0.6739130434782609
4020,지원/Noun,46,16,30,0.00017784496365293555,0.000333207454961459,0.6521739130434783
4021,KBS/Alpha,46,30,16,0.00033345930684925416,0.00017771064264611146,0.6521739130434783
4022,저기/Noun,46,16,30,0.00017784496365293555,0.000333207454961459,0.6521739130434783
4023,최선/Noun,46,30,16,0.00033345930684925416,0.00017771064264611146,0.6521739130434783
4024,부자/Noun,46,17,29,0.00018896027388124403,0.00032210053979607705,0.6304347826086957
4025,하나요/Noun,46,17,29,0.00018896027388124403,0.00032210053979607705,0.6304347826086957
4026,만듬/Noun,46,17,29,0.00018896027388124403,0.00032210053979607705,0.6304347826086957
4027,줄리/Noun,46,29,17,0.0003223439966209457,0.00018881755781149343,0.6304347826086957
4028,헷갈리다/Adjective,46,18,28,0.0002000755841095525,0.00031099362463069506,0.6086956521739131
4029,주먹/Noun,46,18,28,0.0002000755841095525,0.00031099362463069506,0.6086956521739131
4030,환타지/Noun,46,18,28,0.0002000755841095525,0.00031099362463069506,0.6086956521739131
4031,격투/Noun,46,27,19,0.00030011337616432876,0.00021103138814225738,0.5869565217391305
4032,ㄹㅇ/KoreanParticle,46,19,27,0.00021119089433786097,0.0002998867094653131,0.5869565217391305
4033,칸/Noun,46,20,26,0.00022230620456616945,0.00028877979429993113,0.5652173913043478
4034,호화/Noun,46,20,26,0.00022230620456616945,0.00028877979429993113,0.5652173913043478
4035,패션/Noun,46,26,20,0.00028899806593602026,0.00022213830330763935,0.5652173913043478
4036,짱구/Noun,46,20,26,0.00022230620456616945,0.00028877979429993113,0.5652173913043478
4037,장난감/Noun,46,21,25,0.00023342151479447792,0.0002776728791345492,0.5434782608695652
4038,대비/Noun,46,25,21,0.0002778827557077118,0.0002332452184730213,0.5434782608695652
4039,하디/Noun,46,21,25,0.00023342151479447792,0.0002776728791345492,0.5434782608695652
4040,서스펜스/Noun,46,25,21,0.0002778827557077118,0.0002332452184730213,0.5434782608695652
4041,`/Punctuation,46,21,25,0.00023342151479447792,0.0002776728791345492,0.5434782608695652
4042,검다/Adjective,46,21,25,0.00023342151479447792,0.0002776728791345492,0.5434782608695652
4043,으로가/Josa,46,21,25,0.00023342151479447792,0.0002776728791345492,0.5434782608695652
4044,여왕/Noun,46,21,25,0.00023342151479447792,0.0002776728791345492,0.5434782608695652
4045,이형/Noun,46,24,22,0.0002667674454794033,0.0002443521336384033,0.5217391304347826
4046,한텐/Noun,46,22,24,0.00024453682502278637,0.0002665659639691672,0.5217391304347826
4047,이던/Josa,46,22,24,0.00024453682502278637,0.0002665659639691672,0.5217391304347826
4048,안함/Noun,46,23,23,0.00025565213525109487,0.0002554590488037852,0.5
4049,전환/Noun,46,23,23,0.00025565213525109487,0.0002554590488037852,0.5
4050,치면/Noun,46,23,23,0.00025565213525109487,0.0002554590488037852,0.5
4051,최하/Noun,45,3,42,3.3345930684925414e-05,0.0004664904369460426,0.9333333333333333
4052,어처구니없다/Adjective,45,3,42,3.3345930684925414e-05,0.0004664904369460426,0.9333333333333333
4053,글쎄요/Noun,45,3,42,3.3345930684925414e-05,0.0004664904369460426,0.9333333333333333
4054,흐뭇하다/Adjective,45,42,3,0.00046684302958895584,3.33207454961459e-05,0.9333333333333333
4055,대략/Noun,45,5,40,5.557655114154236e-05,0.0004442766066152787,0.8888888888888888
4056,곁/Noun,45,40,5,0.0004446124091323389,5.5534575826909837e-05,0.8888888888888888
4057,성함/Noun,45,6,39,6.669186136985083e-05,0.0004331696914498967,0.8666666666666667
4058,팔다/Verb,45,7,38,7.78071715981593e-05,0.00042206277628451476,0.8444444444444444
4059,간첩/Noun,45,10,35,0.00011115310228308472,0.00038874203078836884,0.7777777777777778
4060,구성은/Noun,45,10,35,0.00011115310228308472,0.00038874203078836884,0.7777777777777778
4061,온몸/Noun,45,34,11,0.00037792054776248805,0.00012217606681920164,0.7555555555555555
4062,수치/Noun,45,11,34,0.00012226841251139318,0.00037763511562298685,0.7555555555555555
4063,행크스/Noun,45,34,11,0.00037792054776248805,0.00012217606681920164,0.7555555555555555
4064,12년/Number,45,33,12,0.0003668052375341796,0.0001332829819845836,0.7333333333333333
4065,직원/Noun,45,12,33,0.00013338372273970166,0.0003665282004576049,0.7333333333333333
4066,도입/Noun,45,12,33,0.00013338372273970166,0.0003665282004576049,0.7333333333333333
4067,모호하다/Adjective,45,13,32,0.00014449903296801013,0.0003554212852922229,0.7111111111111111
4068,감수성/Noun,45,31,14,0.00034457461707756266,0.00015549681231534753,0.6888888888888889
4069,게리/Noun,45,31,14,0.00034457461707756266,0.00015549681231534753,0.6888888888888889
4070,박사/Noun,45,30,15,0.00033345930684925416,0.0001666037274807295,0.6666666666666666
4071,김태희/Noun,45,16,29,0.00017784496365293555,0.00032210053979607705,0.6444444444444445
4072,활용/Noun,45,16,29,0.00017784496365293555,0.00032210053979607705,0.6444444444444445
4073,민/Noun,45,29,16,0.0003223439966209457,0.00017771064264611146,0.6444444444444445
4074,고백/Noun,45,28,17,0.0003112286863926372,0.00018881755781149343,0.6222222222222222
4075,남매/Noun,45,28,17,0.0003112286863926372,0.00018881755781149343,0.6222222222222222
4076,그로/Noun,45,28,17,0.0003112286863926372,0.00018881755781149343,0.6222222222222222
4077,총알/Noun,45,17,28,0.00018896027388124403,0.00031099362463069506,0.6222222222222222
4078,부탁드리다/Adjective,45,28,17,0.0003112286863926372,0.00018881755781149343,0.6222222222222222
4079,수위/Noun,45,17,28,0.00018896027388124403,0.00031099362463069506,0.6222222222222222
4080,삐/Noun,45,17,28,0.00018896027388124403,0.00031099362463069506,0.6222222222222222
4081,시민/Noun,45,17,28,0.00018896027388124403,0.00031099362463069506,0.6222222222222222
4082,긋다/Verb,45,18,27,0.0002000755841095525,0.0002998867094653131,0.6
4083,존내/Noun,45,18,27,0.0002000755841095525,0.0002998867094653131,0.6
4084,노동자/Noun,45,26,19,0.00028899806593602026,0.00021103138814225738,0.5777777777777777
4085,영감/Noun,45,26,19,0.00028899806593602026,0.00021103138814225738,0.5777777777777777
4086,닫다/Verb,45,19,26,0.00021119089433786097,0.00028877979429993113,0.5777777777777777
4087,법정/Noun,45,26,19,0.00028899806593602026,0.00021103138814225738,0.5777777777777777
4088,똑똑하다/Adjective,45,26,19,0.00028899806593602026,0.00021103138814225738,0.5777777777777777
4089,부디/Noun,45,25,20,0.0002778827557077118,0.00022213830330763935,0.5555555555555556
4090,모성애/Noun,45,25,20,0.0002778827557077118,0.00022213830330763935,0.5555555555555556
4091,이나영/Noun,45,21,24,0.00023342151479447792,0.0002665659639691672,0.5333333333333333
4092,마녀/Noun,45,24,21,0.0002667674454794033,0.0002332452184730213,0.5333333333333333
4093,간간히/Adverb,45,21,24,0.00023342151479447792,0.0002665659639691672,0.5333333333333333
4094,극찬/Noun,45,21,24,0.00023342151479447792,0.0002665659639691672,0.5333333333333333
4095,리브/Noun,45,24,21,0.0002667674454794033,0.0002332452184730213,0.5333333333333333
4096,가미/Noun,45,21,24,0.00023342151479447792,0.0002665659639691672,0.5333333333333333
4097,복/Noun,45,24,21,0.0002667674454794033,0.0002332452184730213,0.5333333333333333
4098,어째서/Noun,45,24,21,0.0002667674454794033,0.0002332452184730213,0.5333333333333333
4099,퍼스/Noun,45,22,23,0.00024453682502278637,0.0002554590488037852,0.5111111111111111
4100,월드/Noun,45,22,23,0.00024453682502278637,0.0002554590488037852,0.5111111111111111
4101,먹음/Noun,45,22,23,0.00024453682502278637,0.0002554590488037852,0.5111111111111111
4102,♥♥♥♥/Foreign,44,44,0,0.0004890736500455727,0.0,1.0
4103,자위/Noun,44,2,42,2.2230620456616944e-05,0.0004664904369460426,0.9545454545454546
4104,용두사미/Noun,44,2,42,2.2230620456616944e-05,0.0004664904369460426,0.9545454545454546
4105,모야/Noun,44,3,41,3.3345930684925414e-05,0.00045538352178066063,0.9318181818181818
4106,앞서/Noun,44,41,3,0.00045572771936064734,3.33207454961459e-05,0.9318181818181818
4107,구역질/Noun,44,3,41,3.3345930684925414e-05,0.00045538352178066063,0.9318181818181818
4108,삼가다/Verb,44,39,5,0.0004334970989040304,5.5534575826909837e-05,0.8863636363636364
4109,뽕/Noun,44,6,38,6.669186136985083e-05,0.00042206277628451476,0.8636363636363636
4110,느슨하다/Adjective,44,7,37,7.78071715981593e-05,0.00041095586111913277,0.8409090909090909
4111,코스프레/Noun,44,7,37,7.78071715981593e-05,0.00041095586111913277,0.8409090909090909
4112,노리다/Verb,44,7,37,7.78071715981593e-05,0.00041095586111913277,0.8409090909090909
4113,등급/Noun,44,8,36,8.892248182646778e-05,0.0003998489459537508,0.8181818181818182
4114,가을/Noun,44,36,8,0.000400151168219105,8.885532132305573e-05,0.8181818181818182
4115,노말/Noun,44,8,36,8.892248182646778e-05,0.0003998489459537508,0.8181818181818182
4116,ㅂㅅ/KoreanParticle,44,8,36,8.892248182646778e-05,0.0003998489459537508,0.8181818181818182
4117,펭귄/Noun,44,36,8,0.000400151168219105,8.885532132305573e-05,0.8181818181818182
4118,에러/Noun,44,9,35,0.00010003779205477625,0.00038874203078836884,0.7954545454545454
4119,드립/Noun,44,9,35,0.00010003779205477625,0.00038874203078836884,0.7954545454545454
4120,구리다/Adjective,44,9,35,0.00010003779205477625,0.00038874203078836884,0.7954545454545454
4121,읍/Noun,44,9,35,0.00010003779205477625,0.00038874203078836884,0.7954545454545454
4122,섭외/Noun,44,9,35,0.00010003779205477625,0.00038874203078836884,0.7954545454545454
4123,15분/Number,44,10,34,0.00011115310228308472,0.00037763511562298685,0.7727272727272727
4124,중국인/Noun,44,10,34,0.00011115310228308472,0.00037763511562298685,0.7727272727272727
4125,에여/Josa,44,34,10,0.00037792054776248805,0.00011106915165381967,0.7727272727272727
4126,병원/Noun,44,11,33,0.00012226841251139318,0.0003665282004576049,0.75
4127,불후/Noun,44,32,12,0.0003556899273058711,0.0001332829819845836,0.7272727272727273
4128,성숙하다/Adjective,44,32,12,0.0003556899273058711,0.0001332829819845836,0.7272727272727273
4129,해안가/Noun,44,12,32,0.00013338372273970166,0.0003554212852922229,0.7272727272727273
4130,똑바로/Noun,44,13,31,0.00014449903296801013,0.000344314370126841,0.7045454545454546
4131,구멍/Noun,44,13,31,0.00014449903296801013,0.000344314370126841,0.7045454545454546
4132,워커/Noun,44,31,13,0.00034457461707756266,0.00014438989714996557,0.7045454545454546
4133,낙/Noun,44,31,13,0.00034457461707756266,0.00014438989714996557,0.7045454545454546
4134,레오/Noun,44,31,13,0.00034457461707756266,0.00014438989714996557,0.7045454545454546
4135,부재/Noun,44,13,31,0.00014449903296801013,0.000344314370126841,0.7045454545454546
4136,인터뷰/Noun,44,13,31,0.00014449903296801013,0.000344314370126841,0.7045454545454546
4137,가져오다/Verb,44,14,30,0.0001556143431963186,0.000333207454961459,0.6818181818181818
4138,아무래도/Adverb,44,14,30,0.0001556143431963186,0.000333207454961459,0.6818181818181818
4139,북/Noun,44,14,30,0.0001556143431963186,0.000333207454961459,0.6818181818181818
4140,절실/Noun,44,30,14,0.00033345930684925416,0.00015549681231534753,0.6818181818181818
4141,비롯/Noun,44,29,15,0.0003223439966209457,0.0001666037274807295,0.6590909090909091
4142,지존/Noun,44,29,15,0.0003223439966209457,0.0001666037274807295,0.6590909090909091
4143,슬래셔/Noun,44,15,29,0.00016672965342462708,0.00032210053979607705,0.6590909090909091
4144,걸치다/Verb,44,15,29,0.00016672965342462708,0.00032210053979607705,0.6590909090909091
4145,무적/Noun,44,16,28,0.00017784496365293555,0.00031099362463069506,0.6363636363636364
4146,지금껏/Noun,44,28,16,0.0003112286863926372,0.00017771064264611146,0.6363636363636364
4147,숲/Noun,44,27,17,0.00030011337616432876,0.00018881755781149343,0.6136363636363636
4148,신민아/Noun,44,27,17,0.00030011337616432876,0.00018881755781149343,0.6136363636363636
4149,양동근/Noun,44,17,27,0.00018896027388124403,0.0002998867094653131,0.6136363636363636
4150,괜/Noun,44,26,18,0.00028899806593602026,0.0001999244729768754,0.5909090909090909
4151,뼈/Noun,44,26,18,0.00028899806593602026,0.0001999244729768754,0.5909090909090909
4152,천만/Noun,44,18,26,0.0002000755841095525,0.00028877979429993113,0.5909090909090909
4153,구원/Noun,44,26,18,0.00028899806593602026,0.0001999244729768754,0.5909090909090909
4154,고요/Noun,44,26,18,0.00028899806593602026,0.0001999244729768754,0.5909090909090909
4155,세우다/Verb,44,18,26,0.0002000755841095525,0.00028877979429993113,0.5909090909090909
4156,정사/Noun,44,19,25,0.00021119089433786097,0.0002776728791345492,0.5681818181818182
4157,다기/Noun,44,19,25,0.00021119089433786097,0.0002776728791345492,0.5681818181818182
4158,임권택/Noun,44,19,25,0.00021119089433786097,0.0002776728791345492,0.5681818181818182
4159,대전/Noun,44,19,25,0.00021119089433786097,0.0002776728791345492,0.5681818181818182
4160,16/Number,44,25,19,0.0002778827557077118,0.00021103138814225738,0.5681818181818182
4161,광팬/Noun,44,25,19,0.0002778827557077118,0.00021103138814225738,0.5681818181818182
4162,진보/Noun,44,24,20,0.0002667674454794033,0.00022213830330763935,0.5454545454545454
4163,드림웍스/Noun,44,20,24,0.00022230620456616945,0.0002665659639691672,0.5454545454545454
4164,유리/Noun,44,20,24,0.00022230620456616945,0.0002665659639691672,0.5454545454545454
4165,실사/Noun,44,20,24,0.00022230620456616945,0.0002665659639691672,0.5454545454545454
4166,스텝업/Noun,44,20,24,0.00022230620456616945,0.0002665659639691672,0.5454545454545454
4167,긴박하다/Adjective,44,21,23,0.00023342151479447792,0.0002554590488037852,0.5227272727272727
4168,임수정/Noun,44,23,21,0.00025565213525109487,0.0002332452184730213,0.5227272727272727
4169,장군/Noun,44,21,23,0.00023342151479447792,0.0002554590488037852,0.5227272727272727
4170,존중/Noun,44,22,22,0.00024453682502278637,0.0002443521336384033,0.5
4171,곱씹다/Verb,43,42,1,0.00046684302958895584,1.1106915165381966e-05,0.9767441860465116
4172,very/Alpha,43,42,1,0.00046684302958895584,1.1106915165381966e-05,0.9767441860465116
4173,실종/Noun,43,1,42,1.1115310228308472e-05,0.0004664904369460426,0.9767441860465116
4174,나발/Noun,43,2,41,2.2230620456616944e-05,0.00045538352178066063,0.9534883720930233
4175,리즈시절/Noun,43,40,3,0.0004446124091323389,3.33207454961459e-05,0.9302325581395349
4176,미묘하다/Adjective,43,39,4,0.0004334970989040304,4.4427660661527865e-05,0.9069767441860465
4177,허무맹랑/Noun,43,6,37,6.669186136985083e-05,0.00041095586111913277,0.8604651162790697
4178,실소/Noun,43,7,36,7.78071715981593e-05,0.0003998489459537508,0.8372093023255814
4179,요약/Noun,43,8,35,8.892248182646778e-05,0.00038874203078836884,0.813953488372093
4180,8년/Number,43,35,8,0.0003890358579907965,8.885532132305573e-05,0.813953488372093
4181,비명/Noun,43,8,35,8.892248182646778e-05,0.00038874203078836884,0.813953488372093
4182,PD/Alpha,43,8,35,8.892248182646778e-05,0.00038874203078836884,0.813953488372093
4183,말기/Noun,43,9,34,0.00010003779205477625,0.00037763511562298685,0.7906976744186046
4184,훈남/Noun,43,34,9,0.00037792054776248805,9.99622364884377e-05,0.7906976744186046
4185,콤비/Noun,43,33,10,0.0003668052375341796,0.00011106915165381967,0.7674418604651163
4186,박해일/Noun,43,32,11,0.0003556899273058711,0.00012217606681920164,0.7441860465116279
4187,정도/Foreign,43,11,32,0.00012226841251139318,0.0003554212852922229,0.7441860465116279
4188,자랑스럽다/Adjective,43,32,11,0.0003556899273058711,0.00012217606681920164,0.7441860465116279
4189,이념/Noun,43,31,12,0.00034457461707756266,0.0001332829819845836,0.7209302325581395
4190,낯/Noun,43,12,31,0.00013338372273970166,0.000344314370126841,0.7209302325581395
4191,명도/Noun,43,12,31,0.00013338372273970166,0.000344314370126841,0.7209302325581395
4192,크리스토퍼/Noun,43,31,12,0.00034457461707756266,0.0001332829819845836,0.7209302325581395
4193,일도/Noun,43,13,30,0.00014449903296801013,0.000333207454961459,0.6976744186046512
4194,거만/Noun,43,13,30,0.00014449903296801013,0.000333207454961459,0.6976744186046512
4195,에게서/Josa,43,30,13,0.00033345930684925416,0.00014438989714996557,0.6976744186046512
4196,미국영화/Noun,43,13,30,0.00014449903296801013,0.000333207454961459,0.6976744186046512
4197,뮤직비디오/Noun,43,13,30,0.00014449903296801013,0.000333207454961459,0.6976744186046512
4198,모티브/Noun,43,13,30,0.00014449903296801013,0.000333207454961459,0.6976744186046512
4199,요구/Noun,43,13,30,0.00014449903296801013,0.000333207454961459,0.6976744186046512
4200,만/Foreign,43,14,29,0.0001556143431963186,0.00032210053979607705,0.6744186046511628
4201,깨지다/Verb,43,14,29,0.0001556143431963186,0.00032210053979607705,0.6744186046511628
4202,호강/Noun,43,29,14,0.0003223439966209457,0.00015549681231534753,0.6744186046511628
4203,뉴욕/Noun,43,29,14,0.0003223439966209457,0.00015549681231534753,0.6744186046511628
4204,끊임없다/Adjective,43,29,14,0.0003223439966209457,0.00015549681231534753,0.6744186046511628
4205,남지/Noun,43,15,28,0.00016672965342462708,0.00031099362463069506,0.6511627906976745
4206,옹/Noun,43,28,15,0.0003112286863926372,0.0001666037274807295,0.6511627906976745
4207,교수/Noun,43,15,28,0.00016672965342462708,0.00031099362463069506,0.6511627906976745
4208,학원/Noun,43,15,28,0.00016672965342462708,0.00031099362463069506,0.6511627906976745
4209,2003년/Number,43,28,15,0.0003112286863926372,0.0001666037274807295,0.6511627906976745
4210,혹평/Noun,43,28,15,0.0003112286863926372,0.0001666037274807295,0.6511627906976745
4211,쫓다/Verb,43,15,28,0.00016672965342462708,0.00031099362463069506,0.6511627906976745
4212,지니다/Verb,43,27,16,0.00030011337616432876,0.00017771064264611146,0.627906976744186
4213,꺼리다/Verb,43,16,27,0.00017784496365293555,0.0002998867094653131,0.627906976744186
4214,그/Modifier,43,16,27,0.00017784496365293555,0.0002998867094653131,0.627906976744186
4215,라마/Noun,43,16,27,0.00017784496365293555,0.0002998867094653131,0.627906976744186
4216,저번/Noun,43,17,26,0.00018896027388124403,0.00028877979429993113,0.6046511627906976
4217,쓰러지다/Verb,43,17,26,0.00018896027388124403,0.00028877979429993113,0.6046511627906976
4218,은퇴/Noun,43,17,26,0.00018896027388124403,0.00028877979429993113,0.6046511627906976
4219,주목/Noun,43,26,17,0.00028899806593602026,0.00018881755781149343,0.6046511627906976
4220,종류/Noun,43,26,17,0.00028899806593602026,0.00018881755781149343,0.6046511627906976
4221,벽/Noun,43,26,17,0.00028899806593602026,0.00018881755781149343,0.6046511627906976
4222,물의/Noun,43,25,18,0.0002778827557077118,0.0001999244729768754,0.5813953488372093
4223,계획/Noun,43,25,18,0.0002778827557077118,0.0001999244729768754,0.5813953488372093
4224,아역배우/Noun,43,25,18,0.0002778827557077118,0.0001999244729768754,0.5813953488372093
4225,미술/Noun,43,25,18,0.0002778827557077118,0.0001999244729768754,0.5813953488372093
4226,해적/Noun,43,25,18,0.0002778827557077118,0.0001999244729768754,0.5813953488372093
4227,엽문/Noun,43,19,24,0.00021119089433786097,0.0002665659639691672,0.5581395348837209
4228,밴드/Noun,43,24,19,0.0002667674454794033,0.00021103138814225738,0.5581395348837209
4229,몫/Noun,43,19,24,0.00021119089433786097,0.0002665659639691672,0.5581395348837209
4230,노랗다/Adjective,43,20,23,0.00022230620456616945,0.0002554590488037852,0.5348837209302325
4231,공중파/Noun,43,23,20,0.00025565213525109487,0.00022213830330763935,0.5348837209302325
4232,기어/Noun,43,20,23,0.00022230620456616945,0.0002554590488037852,0.5348837209302325
4233,가해자/Noun,43,20,23,0.00022230620456616945,0.0002554590488037852,0.5348837209302325
4234,와이프/Noun,43,23,20,0.00025565213525109487,0.00022213830330763935,0.5348837209302325
4235,명확하다/Adjective,43,23,20,0.00025565213525109487,0.00022213830330763935,0.5348837209302325
4236,이민기/Noun,43,21,22,0.00023342151479447792,0.0002443521336384033,0.5116279069767442
4237,ocn/Alpha,43,21,22,0.00023342151479447792,0.0002443521336384033,0.5116279069767442
4238,실컷/Noun,43,22,21,0.00024453682502278637,0.0002332452184730213,0.5116279069767442
4239,장편/Noun,43,22,21,0.00024453682502278637,0.0002332452184730213,0.5116279069767442
4240,접근/Noun,43,22,21,0.00024453682502278637,0.0002332452184730213,0.5116279069767442
4241,욕구/Noun,43,22,21,0.00024453682502278637,0.0002332452184730213,0.5116279069767442
4242,도통/Noun,42,1,41,1.1115310228308472e-05,0.00045538352178066063,0.9761904761904762
4243,남아돌다/Verb,42,1,41,1.1115310228308472e-05,0.00045538352178066063,0.9761904761904762
4244,저급/Noun,42,2,40,2.2230620456616944e-05,0.0004442766066152787,0.9523809523809523
4245,귀요미/Noun,42,38,4,0.00042238178867572195,4.4427660661527865e-05,0.9047619047619048
4246,화만/Noun,42,4,38,4.446124091323389e-05,0.00042206277628451476,0.9047619047619048
4247,에든/Josa,42,37,5,0.00041126647844741344,5.5534575826909837e-05,0.8809523809523809
4248,집어넣다/Verb,42,5,37,5.557655114154236e-05,0.00041095586111913277,0.8809523809523809
4249,미안/Noun,42,6,36,6.669186136985083e-05,0.0003998489459537508,0.8571428571428571
4250,이준기/Noun,42,35,7,0.0003890358579907965,7.774840615767377e-05,0.8333333333333334
4251,망상/Noun,42,8,34,8.892248182646778e-05,0.00037763511562298685,0.8095238095238095
4252,눈뜨다/Verb,42,8,34,8.892248182646778e-05,0.00037763511562298685,0.8095238095238095
4253,찜찜하다/Adjective,42,8,34,8.892248182646778e-05,0.00037763511562298685,0.8095238095238095
4254,매혹/Noun,42,33,9,0.0003668052375341796,9.99622364884377e-05,0.7857142857142857
4255,경계/Noun,42,33,9,0.0003668052375341796,9.99622364884377e-05,0.7857142857142857
4256,상치/Noun,42,33,9,0.0003668052375341796,9.99622364884377e-05,0.7857142857142857
4257,진짜진짜/Noun,42,33,9,0.0003668052375341796,9.99622364884377e-05,0.7857142857142857
4258,자유롭다/Adjective,42,33,9,0.0003668052375341796,9.99622364884377e-05,0.7857142857142857
4259,사춘기/Noun,42,32,10,0.0003556899273058711,0.00011106915165381967,0.7619047619047619
4260,앵글/Noun,42,10,32,0.00011115310228308472,0.0003554212852922229,0.7619047619047619
4261,내기/Noun,42,11,31,0.00012226841251139318,0.000344314370126841,0.7380952380952381
4262,원인/Noun,42,11,31,0.00012226841251139318,0.000344314370126841,0.7380952380952381
4263,..??/Punctuation,42,11,31,0.00012226841251139318,0.000344314370126841,0.7380952380952381
4264,박신양/Noun,42,30,12,0.00033345930684925416,0.0001332829819845836,0.7142857142857143
4265,덕후/Noun,42,12,30,0.00013338372273970166,0.000333207454961459,0.7142857142857143
4266,4년/Number,42,29,13,0.0003223439966209457,0.00014438989714996557,0.6904761904761905
4267,주상욱/Noun,42,13,29,0.00014449903296801013,0.00032210053979607705,0.6904761904761905
4268,강제/Noun,42,13,29,0.00014449903296801013,0.00032210053979607705,0.6904761904761905
4269,유아인/Noun,42,28,14,0.0003112286863926372,0.00015549681231534753,0.6666666666666666
4270,............/Punctuation,42,14,28,0.0001556143431963186,0.00031099362463069506,0.6666666666666666
4271,원표/Noun,42,28,14,0.0003112286863926372,0.00015549681231534753,0.6666666666666666
4272,가르다/Verb,42,28,14,0.0003112286863926372,0.00015549681231534753,0.6666666666666666
4273,도하/Noun,42,27,15,0.00030011337616432876,0.0001666037274807295,0.6428571428571429
4274,3년/Number,42,27,15,0.00030011337616432876,0.0001666037274807295,0.6428571428571429
4275,그딴/Modifier,42,15,27,0.00016672965342462708,0.0002998867094653131,0.6428571428571429
4276,권하다/Verb,42,15,27,0.00016672965342462708,0.0002998867094653131,0.6428571428571429
4277,아프리카/Noun,42,26,16,0.00028899806593602026,0.00017771064264611146,0.6190476190476191
4278,강지환/Noun,42,26,16,0.00028899806593602026,0.00017771064264611146,0.6190476190476191
4279,포켓몬/Noun,42,17,25,0.00018896027388124403,0.0002776728791345492,0.5952380952380952
4280,ㄱㄱ/KoreanParticle,42,17,25,0.00018896027388124403,0.0002776728791345492,0.5952380952380952
4281,CGV/Alpha,42,17,25,0.00018896027388124403,0.0002776728791345492,0.5952380952380952
4282,고로/Noun,42,18,24,0.0002000755841095525,0.0002665659639691672,0.5714285714285714
4283,휴먼/Noun,42,24,18,0.0002667674454794033,0.0001999244729768754,0.5714285714285714
4284,구르다/Verb,42,18,24,0.0002000755841095525,0.0002665659639691672,0.5714285714285714
4285,여동생/Noun,42,18,24,0.0002000755841095525,0.0002665659639691672,0.5714285714285714
4286,조금씩/Adverb,42,23,19,0.00025565213525109487,0.00021103138814225738,0.5476190476190477
4287,아가/Noun,42,23,19,0.00025565213525109487,0.00021103138814225738,0.5476190476190477
4288,3일/Number,42,23,19,0.00025565213525109487,0.00021103138814225738,0.5476190476190477
4289,고발/Noun,42,19,23,0.00021119089433786097,0.0002554590488037852,0.5476190476190477
4290,랩/Noun,42,19,23,0.00021119089433786097,0.0002554590488037852,0.5476190476190477
4291,닉/Noun,42,23,19,0.00025565213525109487,0.00021103138814225738,0.5476190476190477
4292,*/Punctuation,42,19,23,0.00021119089433786097,0.0002554590488037852,0.5476190476190477
4293,땡기다/Verb,42,23,19,0.00025565213525109487,0.00021103138814225738,0.5476190476190477
4294,석/Modifier,42,20,22,0.00022230620456616945,0.0002443521336384033,0.5238095238095238
4295,일드/Noun,42,20,22,0.00022230620456616945,0.0002443521336384033,0.5238095238095238
4296,나나/Noun,42,20,22,0.00022230620456616945,0.0002443521336384033,0.5238095238095238
4297,히스/Noun,42,22,20,0.00024453682502278637,0.00022213830330763935,0.5238095238095238
4298,이를/Josa,42,22,20,0.00024453682502278637,0.00022213830330763935,0.5238095238095238
4299,2005년/Number,42,20,22,0.00022230620456616945,0.0002443521336384033,0.5238095238095238
4300,슈렉/Noun,42,22,20,0.00024453682502278637,0.00022213830330763935,0.5238095238095238
4301,게왜/Noun,42,22,20,0.00024453682502278637,0.00022213830330763935,0.5238095238095238
4302,오랜만/Adverb,42,22,20,0.00024453682502278637,0.00022213830330763935,0.5238095238095238
4303,김선아/Noun,42,22,20,0.00024453682502278637,0.00022213830330763935,0.5238095238095238
4304,르/Noun,42,22,20,0.00024453682502278637,0.00022213830330763935,0.5238095238095238
4305,갇히다/Verb,42,21,21,0.00023342151479447792,0.0002332452184730213,0.5
4306,서프라이즈/Noun,41,2,39,2.2230620456616944e-05,0.0004331696914498967,0.9512195121951219
4307,존잼/Noun,41,39,2,0.0004334970989040304,2.2213830330763933e-05,0.9512195121951219
4308,가슴속/Noun,41,39,2,0.0004334970989040304,2.2213830330763933e-05,0.9512195121951219
4309,우리네/Noun,41,39,2,0.0004334970989040304,2.2213830330763933e-05,0.9512195121951219
4310,소박하다/Adjective,41,38,3,0.00042238178867572195,3.33207454961459e-05,0.926829268292683
4311,짓거리/Noun,41,4,37,4.446124091323389e-05,0.00041095586111913277,0.9024390243902439
4312,희망이/Noun,41,36,5,0.000400151168219105,5.5534575826909837e-05,0.8780487804878049
4313,예수님/Noun,41,35,6,0.0003890358579907965,6.66414909922918e-05,0.8536585365853658
4314,충무로/Noun,41,8,33,8.892248182646778e-05,0.0003665282004576049,0.8048780487804879
4315,기쁨/Noun,41,33,8,0.0003668052375341796,8.885532132305573e-05,0.8048780487804879
4316,두근거리다/Adjective,41,33,8,0.0003668052375341796,8.885532132305573e-05,0.8048780487804879
4317,시보/Noun,41,33,8,0.0003668052375341796,8.885532132305573e-05,0.8048780487804879
4318,쏙/Noun,41,32,9,0.0003556899273058711,9.99622364884377e-05,0.7804878048780488
4319,쌈/Noun,41,9,32,0.00010003779205477625,0.0003554212852922229,0.7804878048780488
4320,멘붕/Noun,41,9,32,0.00010003779205477625,0.0003554212852922229,0.7804878048780488
4321,선하다/Adjective,41,32,9,0.0003556899273058711,9.99622364884377e-05,0.7804878048780488
4322,조조/Noun,41,10,31,0.00011115310228308472,0.000344314370126841,0.7560975609756098
4323,꼴리다/Verb,41,10,31,0.00011115310228308472,0.000344314370126841,0.7560975609756098
4324,행위/Noun,41,11,30,0.00012226841251139318,0.000333207454961459,0.7317073170731707
4325,유오성/Noun,41,12,29,0.00013338372273970166,0.00032210053979607705,0.7073170731707317
4326,미흡하다/Adjective,41,12,29,0.00013338372273970166,0.00032210053979607705,0.7073170731707317
4327,^^;/Punctuation,41,29,12,0.0003223439966209457,0.0001332829819845836,0.7073170731707317
4328,오타쿠/Noun,41,12,29,0.00013338372273970166,0.00032210053979607705,0.7073170731707317
4329,어우/Noun,41,12,29,0.00013338372273970166,0.00032210053979607705,0.7073170731707317
4330,피터/Noun,41,29,12,0.0003223439966209457,0.0001332829819845836,0.7073170731707317
4331,쓰기/Noun,41,12,29,0.00013338372273970166,0.00032210053979607705,0.7073170731707317
4332,파고들다/Verb,41,29,12,0.0003223439966209457,0.0001332829819845836,0.7073170731707317
4333,웹툰/Noun,41,12,29,0.00013338372273970166,0.00032210053979607705,0.7073170731707317
4334,이러하다/Adjective,41,29,12,0.0003223439966209457,0.0001332829819845836,0.7073170731707317
4335,->/Punctuation,41,13,28,0.00014449903296801013,0.00031099362463069506,0.6829268292682927
4336,임신/Noun,41,13,28,0.00014449903296801013,0.00031099362463069506,0.6829268292682927
4337,맷/Noun,41,28,13,0.0003112286863926372,0.00014438989714996557,0.6829268292682927
4338,50년/Number,41,28,13,0.0003112286863926372,0.00014438989714996557,0.6829268292682927
4339,디지다/Verb,41,13,28,0.00014449903296801013,0.00031099362463069506,0.6829268292682927
4340,수십/Modifier,41,28,13,0.0003112286863926372,0.00014438989714996557,0.6829268292682927
4341,차이다/Verb,41,13,28,0.00014449903296801013,0.00031099362463069506,0.6829268292682927
4342,2012년/Number,41,14,27,0.0001556143431963186,0.0002998867094653131,0.6585365853658537
4343,언급/Noun,41,14,27,0.0001556143431963186,0.0002998867094653131,0.6585365853658537
4344,통수/Noun,41,14,27,0.0001556143431963186,0.0002998867094653131,0.6585365853658537
4345,대로/Noun,41,14,27,0.0001556143431963186,0.0002998867094653131,0.6585365853658537
4346,부턴/Josa,41,14,27,0.0001556143431963186,0.0002998867094653131,0.6585365853658537
4347,it/Alpha,41,27,14,0.00030011337616432876,0.00015549681231534753,0.6585365853658537
4348,황비홍/Noun,41,26,15,0.00028899806593602026,0.0001666037274807295,0.6341463414634146
4349,해피/Noun,41,26,15,0.00028899806593602026,0.0001666037274807295,0.6341463414634146
4350,지역/Noun,41,15,26,0.00016672965342462708,0.00028877979429993113,0.6341463414634146
4351,궁/Noun,41,15,26,0.00016672965342462708,0.00028877979429993113,0.6341463414634146
4352,날아가다/Verb,41,16,25,0.00017784496365293555,0.0002776728791345492,0.6097560975609756
4353,@/Punctuation,41,16,25,0.00017784496365293555,0.0002776728791345492,0.6097560975609756
4354,레드/Noun,41,25,16,0.0002778827557077118,0.00017771064264611146,0.6097560975609756
4355,압박/Noun,41,16,25,0.00017784496365293555,0.0002776728791345492,0.6097560975609756
4356,자매/Noun,41,17,24,0.00018896027388124403,0.0002665659639691672,0.5853658536585366
4357,일베충/Noun,41,24,17,0.0002667674454794033,0.00018881755781149343,0.5853658536585366
4358,독/Noun,41,17,24,0.00018896027388124403,0.0002665659639691672,0.5853658536585366
4359,디자인/Noun,41,17,24,0.00018896027388124403,0.0002665659639691672,0.5853658536585366
4360,재기/Noun,41,24,17,0.0002667674454794033,0.00018881755781149343,0.5853658536585366
4361,작렬/Noun,41,17,24,0.00018896027388124403,0.0002665659639691672,0.5853658536585366
4362,죽여주다/Verb,41,23,18,0.00025565213525109487,0.0001999244729768754,0.5609756097560976
4363,어르다/Verb,41,18,23,0.0002000755841095525,0.0002554590488037852,0.5609756097560976
4364,책임/Noun,41,18,23,0.0002000755841095525,0.0002554590488037852,0.5609756097560976
4365,가능/Noun,41,23,18,0.00025565213525109487,0.0001999244729768754,0.5609756097560976
4366,장나라/Noun,41,23,18,0.00025565213525109487,0.0001999244729768754,0.5609756097560976
4367,휴가/Noun,41,23,18,0.00025565213525109487,0.0001999244729768754,0.5609756097560976
4368,2013년/Number,41,18,23,0.0002000755841095525,0.0002554590488037852,0.5609756097560976
4369,진작/Noun,41,23,18,0.00025565213525109487,0.0001999244729768754,0.5609756097560976
4370,현/Noun,41,19,22,0.00021119089433786097,0.0002443521336384033,0.5365853658536586
4371,빚/Noun,41,19,22,0.00021119089433786097,0.0002443521336384033,0.5365853658536586
4372,식스센스/Noun,41,19,22,0.00021119089433786097,0.0002443521336384033,0.5365853658536586
4373,윤아/Noun,41,21,20,0.00023342151479447792,0.00022213830330763935,0.5121951219512195
4374,봣다/Noun,41,20,21,0.00022230620456616945,0.0002332452184730213,0.5121951219512195
4375,컨저링/Noun,41,21,20,0.00023342151479447792,0.00022213830330763935,0.5121951219512195
4376,위원/Noun,40,2,38,2.2230620456616944e-05,0.00042206277628451476,0.95
4377,찡/Adverb,40,37,3,0.00041126647844741344,3.33207454961459e-05,0.925
4378,!^^/Punctuation,40,36,4,0.000400151168219105,4.4427660661527865e-05,0.9
4379,상투/Noun,40,4,36,4.446124091323389e-05,0.0003998489459537508,0.9
4380,마인드/Noun,40,5,35,5.557655114154236e-05,0.00038874203078836884,0.875
4381,오인혜/Noun,40,5,35,5.557655114154236e-05,0.00038874203078836884,0.875
4382,시리다/Adjective,40,35,5,0.0003890358579907965,5.5534575826909837e-05,0.875
4383,신파극/Noun,40,7,33,7.78071715981593e-05,0.0003665282004576049,0.825
4384,추락/Noun,40,7,33,7.78071715981593e-05,0.0003665282004576049,0.825
4385,이라곤/Josa,40,7,33,7.78071715981593e-05,0.0003665282004576049,0.825
4386,여정/Noun,40,32,8,0.0003556899273058711,8.885532132305573e-05,0.8
4387,귀가/Noun,40,32,8,0.0003556899273058711,8.885532132305573e-05,0.8
4388,증/Noun,40,8,32,8.892248182646778e-05,0.0003554212852922229,0.8
4389,어느새다/Adjective,40,32,8,0.0003556899273058711,8.885532132305573e-05,0.8
4390,이러니/Conjunction,40,8,32,8.892248182646778e-05,0.0003554212852922229,0.8
4391,강조/Noun,40,8,32,8.892248182646778e-05,0.0003554212852922229,0.8
4392,남자라면/Noun,40,32,8,0.0003556899273058711,8.885532132305573e-05,0.8
4393,ebs/Alpha,40,31,9,0.00034457461707756266,9.99622364884377e-05,0.775
4394,불법/Noun,40,9,31,0.00010003779205477625,0.000344314370126841,0.775
4395,저렴하다/Adjective,40,9,31,0.00010003779205477625,0.000344314370126841,0.775
4396,방이/Noun,40,30,10,0.00033345930684925416,0.00011106915165381967,0.75
4397,곳곳/Noun,40,30,10,0.00033345930684925416,0.00011106915165381967,0.75
4398,경이/Noun,40,30,10,0.00033345930684925416,0.00011106915165381967,0.75
4399,옹박/Noun,40,10,30,0.00011115310228308472,0.000333207454961459,0.75
4400,자제/Noun,40,10,30,0.00011115310228308472,0.000333207454961459,0.75
4401,빼/Noun,40,11,29,0.00012226841251139318,0.00032210053979607705,0.725
4402,우월/Noun,40,11,29,0.00012226841251139318,0.00032210053979607705,0.725
4403,~~!/Punctuation,40,29,11,0.0003223439966209457,0.00012217606681920164,0.725
4404,획/Noun,40,29,11,0.0003223439966209457,0.00012217606681920164,0.725
4405,수업/Noun,40,29,11,0.0003223439966209457,0.00012217606681920164,0.725
4406,호러물/Noun,40,11,29,0.00012226841251139318,0.00032210053979607705,0.725
4407,유명/Noun,40,11,29,0.00012226841251139318,0.00032210053979607705,0.725
4408,우디/Noun,40,28,12,0.0003112286863926372,0.0001332829819845836,0.7
4409,승화/Noun,40,28,12,0.0003112286863926372,0.0001332829819845836,0.7
4410,교감/Noun,40,28,12,0.0003112286863926372,0.0001332829819845836,0.7
4411,외우다/Verb,40,28,12,0.0003112286863926372,0.0001332829819845836,0.7
4412,퀴어/Noun,40,28,12,0.0003112286863926372,0.0001332829819845836,0.7
4413,쫒다/Verb,40,13,27,0.00014449903296801013,0.0002998867094653131,0.675
4414,수정/Noun,40,13,27,0.00014449903296801013,0.0002998867094653131,0.675
4415,저녁/Noun,40,13,27,0.00014449903296801013,0.0002998867094653131,0.675
4416,전의/Noun,40,26,14,0.00028899806593602026,0.00015549681231534753,0.65
4417,상의/Noun,40,26,14,0.00028899806593602026,0.00015549681231534753,0.65
4418,독창/Noun,40,14,26,0.0001556143431963186,0.00028877979429993113,0.65
4419,매트릭스/Noun,40,26,14,0.00028899806593602026,0.00015549681231534753,0.65
4420,버젼/Noun,40,15,25,0.00016672965342462708,0.0002776728791345492,0.625
4421,김강우/Noun,40,24,16,0.0002667674454794033,0.00017771064264611146,0.6
4422,런닝맨/Noun,40,16,24,0.00017784496365293555,0.0002665659639691672,0.6
4423,리오/Noun,40,24,16,0.0002667674454794033,0.00017771064264611146,0.6
4424,금방/Noun,40,24,16,0.0002667674454794033,0.00017771064264611146,0.6
4425,정재영/Noun,40,24,16,0.0002667674454794033,0.00017771064264611146,0.6
4426,건드리다/Verb,40,16,24,0.00017784496365293555,0.0002665659639691672,0.6
4427,턱/Noun,40,17,23,0.00018896027388124403,0.0002554590488037852,0.575
4428,감당/Noun,40,17,23,0.00018896027388124403,0.0002554590488037852,0.575
4429,산드라/Noun,40,23,17,0.00025565213525109487,0.00018881755781149343,0.575
4430,왓/Noun,40,23,17,0.00025565213525109487,0.00018881755781149343,0.575
4431,애도/Noun,40,17,23,0.00018896027388124403,0.0002554590488037852,0.575
4432,ㄹ/KoreanParticle,40,17,23,0.00018896027388124403,0.0002554590488037852,0.575
4433,2004년/Number,40,23,17,0.00025565213525109487,0.00018881755781149343,0.575
4434,한없이/Adverb,40,22,18,0.00024453682502278637,0.0001999244729768754,0.55
4435,높이/Noun,40,18,22,0.0002000755841095525,0.0002443521336384033,0.55
4436,아자/Exclamation,40,22,18,0.00024453682502278637,0.0001999244729768754,0.55
4437,막스/Noun,40,22,18,0.00024453682502278637,0.0001999244729768754,0.55
4438,김민종/Noun,40,18,22,0.0002000755841095525,0.0002443521336384033,0.55
4439,활/Noun,40,18,22,0.0002000755841095525,0.0002443521336384033,0.55
4440,실존/Noun,40,21,19,0.00023342151479447792,0.00021103138814225738,0.525
4441,물씬/Noun,40,19,21,0.00021119089433786097,0.0002332452184730213,0.525
4442,전사/Noun,40,19,21,0.00021119089433786097,0.0002332452184730213,0.525
4443,로보캅/Noun,40,19,21,0.00021119089433786097,0.0002332452184730213,0.525
4444,글구/Noun,40,20,20,0.00022230620456616945,0.00022213830330763935,0.5
4445,격전/Noun,40,20,20,0.00022230620456616945,0.00022213830330763935,0.5
4446,한예슬/Noun,40,20,20,0.00022230620456616945,0.00022213830330763935,0.5
4447,진자/Noun,40,20,20,0.00022230620456616945,0.00022213830330763935,0.5
4448,분석/Noun,40,20,20,0.00022230620456616945,0.00022213830330763935,0.5
4449,투자자/Noun,39,0,39,0.0,0.0004331696914498967,1.0
4450,졸음/Noun,39,1,38,1.1115310228308472e-05,0.00042206277628451476,0.9743589743589743
4451,쓰레기통/Noun,39,1,38,1.1115310228308472e-05,0.00042206277628451476,0.9743589743589743
4452,문성우/Noun,39,2,37,2.2230620456616944e-05,0.00041095586111913277,0.9487179487179487
4453,환불/Noun,39,3,36,3.3345930684925414e-05,0.0003998489459537508,0.9230769230769231
4454,황홀하다/Adjective,39,36,3,0.000400151168219105,3.33207454961459e-05,0.9230769230769231
4455,뭡/Noun,39,4,35,4.446124091323389e-05,0.00038874203078836884,0.8974358974358975
4456,은은하다/Adjective,39,35,4,0.0003890358579907965,4.4427660661527865e-05,0.8974358974358975
4457,에서야/Josa,39,35,4,0.0003890358579907965,4.4427660661527865e-05,0.8974358974358975
4458,후지/Noun,39,4,35,4.446124091323389e-05,0.00038874203078836884,0.8974358974358975
4459,우익/Noun,39,5,34,5.557655114154236e-05,0.00037763511562298685,0.8717948717948718
4460,엉덩이/Noun,39,6,33,6.669186136985083e-05,0.0003665282004576049,0.8461538461538461
4461,에릭/Noun,39,33,6,0.0003668052375341796,6.66414909922918e-05,0.8461538461538461
4462,불면증/Noun,39,7,32,7.78071715981593e-05,0.0003554212852922229,0.8205128205128205
4463,찌푸리다/Verb,39,7,32,7.78071715981593e-05,0.0003554212852922229,0.8205128205128205
4464,구라/Noun,39,7,32,7.78071715981593e-05,0.0003554212852922229,0.8205128205128205
4465,젊음/Noun,39,31,8,0.00034457461707756266,8.885532132305573e-05,0.7948717948717948
4466,놀이/Suffix,39,8,31,8.892248182646778e-05,0.000344314370126841,0.7948717948717948
4467,파이다/Verb,39,31,8,0.00034457461707756266,8.885532132305573e-05,0.7948717948717948
4468,울음/Noun,39,31,8,0.00034457461707756266,8.885532132305573e-05,0.7948717948717948
4469,헤어/Noun,39,30,9,0.00033345930684925416,9.99622364884377e-05,0.7692307692307693
4470,mbc/Alpha,39,9,30,0.00010003779205477625,0.000333207454961459,0.7692307692307693
4471,루이스/Noun,39,29,10,0.0003223439966209457,0.00011106915165381967,0.7435897435897436
4472,에일리언/Noun,39,11,28,0.00012226841251139318,0.00031099362463069506,0.717948717948718
4473,전기/Noun,39,11,28,0.00012226841251139318,0.00031099362463069506,0.717948717948718
4474,극한/Noun,39,28,11,0.0003112286863926372,0.00012217606681920164,0.717948717948718
4475,우아하다/Adjective,39,28,11,0.0003112286863926372,0.00012217606681920164,0.717948717948718
4476,묘미/Noun,39,28,11,0.0003112286863926372,0.00012217606681920164,0.717948717948718
4477,관계자/Noun,39,11,28,0.00012226841251139318,0.00031099362463069506,0.717948717948718
4478,로그/Noun,39,11,28,0.00012226841251139318,0.00031099362463069506,0.717948717948718
4479,사나이/Noun,39,27,12,0.00030011337616432876,0.0001332829819845836,0.6923076923076923
4480,오류/Noun,39,12,27,0.00013338372273970166,0.0002998867094653131,0.6923076923076923
4481,이민정/Noun,39,27,12,0.00030011337616432876,0.0001332829819845836,0.6923076923076923
4482,완/Noun,39,27,12,0.00030011337616432876,0.0001332829819845836,0.6923076923076923
4483,한쪽/Noun,39,12,27,0.00013338372273970166,0.0002998867094653131,0.6923076923076923
4484,활약/Noun,39,27,12,0.00030011337616432876,0.0001332829819845836,0.6923076923076923
4485,필수/Noun,39,27,12,0.00030011337616432876,0.0001332829819845836,0.6923076923076923
4486,제시/Noun,39,27,12,0.00030011337616432876,0.0001332829819845836,0.6923076923076923
4487,찢다/Verb,39,13,26,0.00014449903296801013,0.00028877979429993113,0.6666666666666666
4488,때메/Noun,39,13,26,0.00014449903296801013,0.00028877979429993113,0.6666666666666666
4489,가사/Noun,39,26,13,0.00028899806593602026,0.00014438989714996557,0.6666666666666666
4490,기간/Noun,39,26,13,0.00028899806593602026,0.00014438989714996557,0.6666666666666666
4491,in/Alpha,39,26,13,0.00028899806593602026,0.00014438989714996557,0.6666666666666666
4492,핸드폰/Noun,39,13,26,0.00014449903296801013,0.00028877979429993113,0.6666666666666666
4493,멍청이/Noun,39,13,26,0.00014449903296801013,0.00028877979429993113,0.6666666666666666
4494,사라/Noun,39,26,13,0.00028899806593602026,0.00014438989714996557,0.6666666666666666
4495,쿠/Noun,39,26,13,0.00028899806593602026,0.00014438989714996557,0.6666666666666666
4496,수다/Noun,39,14,25,0.0001556143431963186,0.0002776728791345492,0.6410256410256411
4497,에의/Josa,39,25,14,0.0002778827557077118,0.00015549681231534753,0.6410256410256411
4498,불러일으키다/Verb,39,25,14,0.0002778827557077118,0.00015549681231534753,0.6410256410256411
4499,내겐/Noun,39,25,14,0.0002778827557077118,0.00015549681231534753,0.6410256410256411
4500,크로우/Noun,39,25,14,0.0002778827557077118,0.00015549681231534753,0.6410256410256411
4501,로렌스/Noun,39,25,14,0.0002778827557077118,0.00015549681231534753,0.6410256410256411
4502,다음주/Noun,39,25,14,0.0002778827557077118,0.00015549681231534753,0.6410256410256411
4503,불리다/Verb,39,24,15,0.0002667674454794033,0.0001666037274807295,0.6153846153846154
4504,예매/Noun,39,15,24,0.00016672965342462708,0.0002665659639691672,0.6153846153846154
4505,폭/Noun,39,24,15,0.0002667674454794033,0.0001666037274807295,0.6153846153846154
4506,연장/Noun,39,15,24,0.00016672965342462708,0.0002665659639691672,0.6153846153846154
4507,시르다/Adjective,39,15,24,0.00016672965342462708,0.0002665659639691672,0.6153846153846154
4508,임용/Noun,39,16,23,0.00017784496365293555,0.0002554590488037852,0.5897435897435898
4509,to/Alpha,39,23,16,0.00025565213525109487,0.00017771064264611146,0.5897435897435898
4510,단편영화/Noun,39,16,23,0.00017784496365293555,0.0002554590488037852,0.5897435897435898
4511,맥스/Noun,39,23,16,0.00025565213525109487,0.00017771064264611146,0.5897435897435898
4512,전적/Noun,39,16,23,0.00017784496365293555,0.0002554590488037852,0.5897435897435898
4513,그러면/Adverb,39,16,23,0.00017784496365293555,0.0002554590488037852,0.5897435897435898
4514,창작/Noun,39,16,23,0.00017784496365293555,0.0002554590488037852,0.5897435897435898
4515,볼땐/Noun,39,22,17,0.00024453682502278637,0.00018881755781149343,0.5641025641025641
4516,발생/Noun,39,22,17,0.00024453682502278637,0.00018881755781149343,0.5641025641025641
4517,사망/Noun,39,17,22,0.00018896027388124403,0.0002443521336384033,0.5641025641025641
4518,다문화/Noun,39,17,22,0.00018896027388124403,0.0002443521336384033,0.5641025641025641
4519,악평/Noun,39,22,17,0.00024453682502278637,0.00018881755781149343,0.5641025641025641
4520,호텔/Noun,39,21,18,0.00023342151479447792,0.0001999244729768754,0.5384615384615384
4521,비난/Noun,39,21,18,0.00023342151479447792,0.0001999244729768754,0.5384615384615384
4522,치명/Noun,39,21,18,0.00023342151479447792,0.0001999244729768754,0.5384615384615384
4523,컬트/Noun,39,21,18,0.00023342151479447792,0.0001999244729768754,0.5384615384615384
4524,샤를/Noun,39,21,18,0.00023342151479447792,0.0001999244729768754,0.5384615384615384
4525,종일/Noun,39,18,21,0.0002000755841095525,0.0002332452184730213,0.5384615384615384
4526,조직/Noun,39,21,18,0.00023342151479447792,0.0001999244729768754,0.5384615384615384
4527,즉/Noun,39,20,19,0.00022230620456616945,0.00021103138814225738,0.5128205128205128
4528,노예/Noun,39,19,20,0.00021119089433786097,0.00022213830330763935,0.5128205128205128
4529,이성재/Noun,39,20,19,0.00022230620456616945,0.00021103138814225738,0.5128205128205128
4530,충만/Noun,39,20,19,0.00022230620456616945,0.00021103138814225738,0.5128205128205128
4531,그러하다/Adjective,39,20,19,0.00022230620456616945,0.00021103138814225738,0.5128205128205128
4532,아마도/Adverb,39,19,20,0.00021119089433786097,0.00022213830330763935,0.5128205128205128
4533,지상/Noun,39,20,19,0.00022230620456616945,0.00021103138814225738,0.5128205128205128
4534,안질리다/Verb,38,37,1,0.00041126647844741344,1.1106915165381966e-05,0.9736842105263158
4535,아리다/Adjective,38,36,2,0.000400151168219105,2.2213830330763933e-05,0.9473684210526315
4536,자빠지다/Verb,38,3,35,3.3345930684925414e-05,0.00038874203078836884,0.9210526315789473
4537,무니/Noun,38,5,33,5.557655114154236e-05,0.0003665282004576049,0.868421052631579
4538,불친절하다/Adjective,38,5,33,5.557655114154236e-05,0.0003665282004576049,0.868421052631579
4539,은지/Noun,38,5,33,5.557655114154236e-05,0.0003665282004576049,0.868421052631579
4540,거창하다/Adjective,38,5,33,5.557655114154236e-05,0.0003665282004576049,0.868421052631579
4541,깝/Noun,38,6,32,6.669186136985083e-05,0.0003554212852922229,0.8421052631578947
4542,0.5/Number,38,6,32,6.669186136985083e-05,0.0003554212852922229,0.8421052631578947
4543,허탈하다/Adjective,38,7,31,7.78071715981593e-05,0.000344314370126841,0.8157894736842105
4544,!!!!!!!/Punctuation,38,31,7,0.00034457461707756266,7.774840615767377e-05,0.8157894736842105
4545,현대인/Noun,38,31,7,0.00034457461707756266,7.774840615767377e-05,0.8157894736842105
4546,화평/Noun,38,9,29,0.00010003779205477625,0.00032210053979607705,0.7631578947368421
4547,살아오다/Verb,38,29,9,0.0003223439966209457,9.99622364884377e-05,0.7631578947368421
4548,까먹다/Verb,38,9,29,0.00010003779205477625,0.00032210053979607705,0.7631578947368421
4549,치열하다/Adjective,38,28,10,0.0003112286863926372,0.00011106915165381967,0.7368421052631579
4550,제작사/Noun,38,10,28,0.00011115310228308472,0.00031099362463069506,0.7368421052631579
4551,경쾌하다/Adjective,38,28,10,0.0003112286863926372,0.00011106915165381967,0.7368421052631579
4552,연령/Noun,38,10,28,0.00011115310228308472,0.00031099362463069506,0.7368421052631579
4553,F/Alpha,38,11,27,0.00012226841251139318,0.0002998867094653131,0.7105263157894737
4554,간의/Noun,38,27,11,0.00030011337616432876,0.00012217606681920164,0.7105263157894737
4555,생략/Noun,38,11,27,0.00012226841251139318,0.0002998867094653131,0.7105263157894737
4556,14년/Number,38,27,11,0.00030011337616432876,0.00012217606681920164,0.7105263157894737
4557,가버리다/Verb,38,12,26,0.00013338372273970166,0.00028877979429993113,0.6842105263157895
4558,미만/Noun,38,12,26,0.00013338372273970166,0.00028877979429993113,0.6842105263157895
4559,전세계/Noun,38,26,12,0.00028899806593602026,0.0001332829819845836,0.6842105263157895
4560,질주/Noun,38,25,13,0.0002778827557077118,0.00014438989714996557,0.6578947368421053
4561,아카데미/Noun,38,25,13,0.0002778827557077118,0.00014438989714996557,0.6578947368421053
4562,부수/Noun,38,13,25,0.00014449903296801013,0.0002776728791345492,0.6578947368421053
4563,동의/Noun,38,13,25,0.00014449903296801013,0.0002776728791345492,0.6578947368421053
4564,청/Noun,38,13,25,0.00014449903296801013,0.0002776728791345492,0.6578947368421053
4565,멍하다/Adjective,38,25,13,0.0002778827557077118,0.00014438989714996557,0.6578947368421053
4566,물어보다/Verb,38,13,25,0.00014449903296801013,0.0002776728791345492,0.6578947368421053
4567,빅뱅/Noun,38,24,14,0.0002667674454794033,0.00015549681231534753,0.631578947368421
4568,레인/Noun,38,14,24,0.0001556143431963186,0.0002665659639691672,0.631578947368421
4569,훈련/Noun,38,14,24,0.0001556143431963186,0.0002665659639691672,0.631578947368421
4570,"..,/Punctuation",38,14,24,0.0001556143431963186,0.0002665659639691672,0.631578947368421
4571,법칙/Noun,38,14,24,0.0001556143431963186,0.0002665659639691672,0.631578947368421
4572,삼다/Verb,38,14,24,0.0001556143431963186,0.0002665659639691672,0.631578947368421
4573,보장/Noun,38,24,14,0.0002667674454794033,0.00015549681231534753,0.631578947368421
4574,마마/Noun,38,14,24,0.0001556143431963186,0.0002665659639691672,0.631578947368421
4575,케이트/Noun,38,23,15,0.00025565213525109487,0.0001666037274807295,0.6052631578947368
4576,얽히다/Verb,38,23,15,0.00025565213525109487,0.0001666037274807295,0.6052631578947368
4577,직장/Noun,38,23,15,0.00025565213525109487,0.0001666037274807295,0.6052631578947368
4578,로마/Noun,38,15,23,0.00016672965342462708,0.0002554590488037852,0.6052631578947368
4579,트릭/Noun,38,23,15,0.00025565213525109487,0.0001666037274807295,0.6052631578947368
4580,현빈/Noun,38,23,15,0.00025565213525109487,0.0001666037274807295,0.6052631578947368
4581,허영/Noun,38,15,23,0.00016672965342462708,0.0002554590488037852,0.6052631578947368
4582,에이리언/Noun,38,22,16,0.00024453682502278637,0.00017771064264611146,0.5789473684210527
4583,꾼/Suffix,38,16,22,0.00017784496365293555,0.0002443521336384033,0.5789473684210527
4584,코스트/Noun,38,22,16,0.00024453682502278637,0.00017771064264611146,0.5789473684210527
4585,가운데/Noun,38,22,16,0.00024453682502278637,0.00017771064264611146,0.5789473684210527
4586,무려/Noun,38,22,16,0.00024453682502278637,0.00017771064264611146,0.5789473684210527
4587,동료/Noun,38,21,17,0.00023342151479447792,0.00018881755781149343,0.5526315789473685
4588,높아지다/Verb,38,17,21,0.00018896027388124403,0.0002332452184730213,0.5526315789473685
4589,외화/Noun,38,17,21,0.00018896027388124403,0.0002332452184730213,0.5526315789473685
4590,가만히/Adverb,38,17,21,0.00018896027388124403,0.0002332452184730213,0.5526315789473685
4591,자세/Noun,38,17,21,0.00018896027388124403,0.0002332452184730213,0.5526315789473685
4592,나약하다/Adjective,38,21,17,0.00023342151479447792,0.00018881755781149343,0.5526315789473685
4593,엄/Noun,38,18,20,0.0002000755841095525,0.00022213830330763935,0.5263157894736842
4594,kbs/Alpha,38,20,18,0.00022230620456616945,0.0001999244729768754,0.5263157894736842
4595,화해/Noun,38,20,18,0.00022230620456616945,0.0001999244729768754,0.5263157894736842
4596,전국/Noun,38,20,18,0.00022230620456616945,0.0001999244729768754,0.5263157894736842
4597,물리다/Verb,38,20,18,0.00022230620456616945,0.0001999244729768754,0.5263157894736842
4598,머피/Noun,38,20,18,0.00022230620456616945,0.0001999244729768754,0.5263157894736842
4599,평론/Noun,38,19,19,0.00021119089433786097,0.00021103138814225738,0.5
4600,데스/Noun,38,19,19,0.00021119089433786097,0.00021103138814225738,0.5
4601,관객수/Noun,38,19,19,0.00021119089433786097,0.00021103138814225738,0.5
4602,찬란/Noun,37,0,37,0.0,0.00041095586111913277,1.0
4603,채플린/Noun,37,34,3,0.00037792054776248805,3.33207454961459e-05,0.918918918918919
4604,대책/Noun,37,3,34,3.3345930684925414e-05,0.00037763511562298685,0.918918918918919
4605,날로/Noun,37,3,34,3.3345930684925414e-05,0.00037763511562298685,0.918918918918919
4606,개잼/Noun,37,33,4,0.0003668052375341796,4.4427660661527865e-05,0.8918918918918919
4607,워싱턴/Noun,37,33,4,0.0003668052375341796,4.4427660661527865e-05,0.8918918918918919
4608,꾹/Noun,37,4,33,4.446124091323389e-05,0.0003665282004576049,0.8918918918918919
4609,거뭐/Noun,37,5,32,5.557655114154236e-05,0.0003554212852922229,0.8648648648648649
4610,설레임/Noun,37,32,5,0.0003556899273058711,5.5534575826909837e-05,0.8648648648648649
4611,습작/Noun,37,5,32,5.557655114154236e-05,0.0003554212852922229,0.8648648648648649
4612,신들리다/Adjective,37,32,5,0.0003556899273058711,5.5534575826909837e-05,0.8648648648648649
4613,두근두근/Adverb,37,31,6,0.00034457461707756266,6.66414909922918e-05,0.8378378378378378
4614,뇌리/Noun,37,31,6,0.00034457461707756266,6.66414909922918e-05,0.8378378378378378
4615,패턴/Noun,37,6,31,6.669186136985083e-05,0.000344314370126841,0.8378378378378378
4616,공개/Noun,37,6,31,6.669186136985083e-05,0.000344314370126841,0.8378378378378378
4617,동아리/Noun,37,6,31,6.669186136985083e-05,0.000344314370126841,0.8378378378378378
4618,몰락/Noun,37,7,30,7.78071715981593e-05,0.000333207454961459,0.8108108108108109
4619,옹호/Noun,37,7,30,7.78071715981593e-05,0.000333207454961459,0.8108108108108109
4620,껄/Noun,37,7,30,7.78071715981593e-05,0.000333207454961459,0.8108108108108109
4621,오로라/Noun,37,7,30,7.78071715981593e-05,0.000333207454961459,0.8108108108108109
4622,신비롭다/Adjective,37,30,7,0.00033345930684925416,7.774840615767377e-05,0.8108108108108109
4623,이라고는/Josa,37,8,29,8.892248182646778e-05,0.00032210053979607705,0.7837837837837838
4624,넋/Noun,37,29,8,0.0003223439966209457,8.885532132305573e-05,0.7837837837837838
4625,눈부시다/Adjective,37,29,8,0.0003223439966209457,8.885532132305573e-05,0.7837837837837838
4626,서우/Noun,37,8,29,8.892248182646778e-05,0.00032210053979607705,0.7837837837837838
4627,라곤/Josa,37,8,29,8.892248182646778e-05,0.00032210053979607705,0.7837837837837838
4628,닦다/Verb,37,8,29,8.892248182646778e-05,0.00032210053979607705,0.7837837837837838
4629,강호동/Noun,37,9,28,0.00010003779205477625,0.00031099362463069506,0.7567567567567568
4630,탕웨이/Noun,37,28,9,0.0003112286863926372,9.99622364884377e-05,0.7567567567567568
4631,유도/Noun,37,9,28,0.00010003779205477625,0.00031099362463069506,0.7567567567567568
4632,고질라/Noun,37,9,28,0.00010003779205477625,0.00031099362463069506,0.7567567567567568
4633,엠마/Noun,37,28,9,0.0003112286863926372,9.99622364884377e-05,0.7567567567567568
4634,이남/Noun,37,28,9,0.0003112286863926372,9.99622364884377e-05,0.7567567567567568
4635,켄/Noun,37,28,9,0.0003112286863926372,9.99622364884377e-05,0.7567567567567568
4636,오랜/Adverb,37,27,10,0.00030011337616432876,0.00011106915165381967,0.7297297297297297
4637,.!!/Punctuation,37,27,10,0.00030011337616432876,0.00011106915165381967,0.7297297297297297
4638,근거/Noun,37,10,27,0.00011115310228308472,0.0002998867094653131,0.7297297297297297
4639,브래드피트/Noun,37,27,10,0.00030011337616432876,0.00011106915165381967,0.7297297297297297
4640,엑소시스트/Noun,37,10,27,0.00011115310228308472,0.0002998867094653131,0.7297297297297297
4641,예의/Noun,37,11,26,0.00012226841251139318,0.00028877979429993113,0.7027027027027027
4642,수술/Noun,37,11,26,0.00012226841251139318,0.00028877979429993113,0.7027027027027027
4643,힙합/Noun,37,11,26,0.00012226841251139318,0.00028877979429993113,0.7027027027027027
4644,............./Punctuation,37,11,26,0.00012226841251139318,0.00028877979429993113,0.7027027027027027
4645,마초/Noun,37,11,26,0.00012226841251139318,0.00028877979429993113,0.7027027027027027
4646,부담스럽다/Adjective,37,11,26,0.00012226841251139318,0.00028877979429993113,0.7027027027027027
4647,소문/Noun,37,11,26,0.00012226841251139318,0.00028877979429993113,0.7027027027027027
4648,사서/Noun,37,26,11,0.00028899806593602026,0.00012217606681920164,0.7027027027027027
4649,변호사/Noun,37,26,11,0.00028899806593602026,0.00012217606681920164,0.7027027027027027
4650,신선/Noun,37,25,12,0.0002778827557077118,0.0001332829819845836,0.6756756756756757
4651,성향/Noun,37,12,25,0.00013338372273970166,0.0002776728791345492,0.6756756756756757
4652,육체/Noun,37,13,24,0.00014449903296801013,0.0002665659639691672,0.6486486486486487
4653,신현준/Noun,37,14,23,0.0001556143431963186,0.0002554590488037852,0.6216216216216216
4654,진의/Noun,37,14,23,0.0001556143431963186,0.0002554590488037852,0.6216216216216216
4655,유작/Noun,37,14,23,0.0001556143431963186,0.0002554590488037852,0.6216216216216216
4656,간절하다/Adjective,37,23,14,0.00025565213525109487,0.00015549681231534753,0.6216216216216216
4657,안경/Noun,37,14,23,0.0001556143431963186,0.0002554590488037852,0.6216216216216216
4658,라지/Josa,37,14,23,0.0001556143431963186,0.0002554590488037852,0.6216216216216216
4659,히트/Noun,37,23,14,0.00025565213525109487,0.00015549681231534753,0.6216216216216216
4660,거울/Noun,37,23,14,0.00025565213525109487,0.00015549681231534753,0.6216216216216216
4661,까지의/Josa,37,23,14,0.00025565213525109487,0.00015549681231534753,0.6216216216216216
4662,용감하다/Adjective,37,22,15,0.00024453682502278637,0.0001666037274807295,0.5945945945945946
4663,나라/Suffix,37,15,22,0.00016672965342462708,0.0002443521336384033,0.5945945945945946
4664,버금/Noun,37,22,15,0.00024453682502278637,0.0001666037274807295,0.5945945945945946
4665,믄/Modifier,37,15,22,0.00016672965342462708,0.0002443521336384033,0.5945945945945946
4666,싹/Noun,37,15,22,0.00016672965342462708,0.0002443521336384033,0.5945945945945946
4667,이순신/Noun,37,15,22,0.00016672965342462708,0.0002443521336384033,0.5945945945945946
4668,주체/Noun,37,22,15,0.00024453682502278637,0.0001666037274807295,0.5945945945945946
4669,한장/Noun,37,22,15,0.00024453682502278637,0.0001666037274807295,0.5945945945945946
4670,나아지다/Verb,37,15,22,0.00016672965342462708,0.0002443521336384033,0.5945945945945946
4671,마크/Noun,37,22,15,0.00024453682502278637,0.0001666037274807295,0.5945945945945946
4672,앞서다/Verb,37,21,16,0.00023342151479447792,0.00017771064264611146,0.5675675675675675
4673,까메오/Noun,37,16,21,0.00017784496365293555,0.0002332452184730213,0.5675675675675675
4674,홍진호/Noun,37,16,21,0.00017784496365293555,0.0002332452184730213,0.5675675675675675
4675,300/Number,37,16,21,0.00017784496365293555,0.0002332452184730213,0.5675675675675675
4676,제법/Noun,37,21,16,0.00023342151479447792,0.00017771064264611146,0.5675675675675675
4677,더보/Noun,37,16,21,0.00017784496365293555,0.0002332452184730213,0.5675675675675675
4678,페이/Noun,37,21,16,0.00023342151479447792,0.00017771064264611146,0.5675675675675675
4679,이범수/Noun,37,21,16,0.00023342151479447792,0.00017771064264611146,0.5675675675675675
4680,그러니까/Adverb,37,16,21,0.00017784496365293555,0.0002332452184730213,0.5675675675675675
4681,금요일/Noun,37,21,16,0.00023342151479447792,0.00017771064264611146,0.5675675675675675
4682,짐승/Noun,37,16,21,0.00017784496365293555,0.0002332452184730213,0.5675675675675675
4683,부의/Noun,37,21,16,0.00023342151479447792,0.00017771064264611146,0.5675675675675675
4684,지하철/Noun,37,16,21,0.00017784496365293555,0.0002332452184730213,0.5675675675675675
4685,루크/Noun,37,21,16,0.00023342151479447792,0.00017771064264611146,0.5675675675675675
4686,넓다/Adjective,37,17,20,0.00018896027388124403,0.00022213830330763935,0.5405405405405406
4687,율/Noun,37,20,17,0.00022230620456616945,0.00018881755781149343,0.5405405405405406
4688,황금/Noun,37,20,17,0.00022230620456616945,0.00018881755781149343,0.5405405405405406
4689,부가/Noun,37,20,17,0.00022230620456616945,0.00018881755781149343,0.5405405405405406
4690,스톤/Noun,37,17,20,0.00018896027388124403,0.00022213830330763935,0.5405405405405406
4691,인디아나/Noun,37,19,18,0.00021119089433786097,0.0001999244729768754,0.5135135135135135
4692,허전하다/Adjective,37,18,19,0.0002000755841095525,0.00021103138814225738,0.5135135135135135
4693,플/Exclamation,37,18,19,0.0002000755841095525,0.00021103138814225738,0.5135135135135135
4694,낚임/Noun,36,0,36,0.0,0.0003998489459537508,1.0
4695,되돌아보다/Verb,36,35,1,0.0003890358579907965,1.1106915165381966e-05,0.9722222222222222
4696,보고/Foreign,36,3,33,3.3345930684925414e-05,0.0003665282004576049,0.9166666666666666
4697,치기/Noun,36,3,33,3.3345930684925414e-05,0.0003665282004576049,0.9166666666666666
4698,큐브/Noun,36,4,32,4.446124091323389e-05,0.0003554212852922229,0.8888888888888888
4699,욤/Noun,36,31,5,0.00034457461707756266,5.5534575826909837e-05,0.8611111111111112
4700,허니/Noun,36,31,5,0.00034457461707756266,5.5534575826909837e-05,0.8611111111111112
4701,100분/Number,36,5,31,5.557655114154236e-05,0.000344314370126841,0.8611111111111112
4702,발암/Noun,36,5,31,5.557655114154236e-05,0.000344314370126841,0.8611111111111112
4703,엑스트라/Noun,36,6,30,6.669186136985083e-05,0.000333207454961459,0.8333333333333334
4704,서극/Noun,36,7,29,7.78071715981593e-05,0.00032210053979607705,0.8055555555555556
4705,멋대로/Noun,36,7,29,7.78071715981593e-05,0.00032210053979607705,0.8055555555555556
4706,평이하다/Adjective,36,7,29,7.78071715981593e-05,0.00032210053979607705,0.8055555555555556
4707,내러티브/Noun,36,8,28,8.892248182646778e-05,0.00031099362463069506,0.7777777777777778
4708,볼껄/Noun,36,8,28,8.892248182646778e-05,0.00031099362463069506,0.7777777777777778
4709,t/Alpha,36,28,8,0.0003112286863926372,8.885532132305573e-05,0.7777777777777778
4710,하차/Noun,36,8,28,8.892248182646778e-05,0.00031099362463069506,0.7777777777777778
4711,!!!!!!!!/Punctuation,36,28,8,0.0003112286863926372,8.885532132305573e-05,0.7777777777777778
4712,꽉/Noun,36,28,8,0.0003112286863926372,8.885532132305573e-05,0.7777777777777778
4713,역사왜곡/Noun,36,9,27,0.00010003779205477625,0.0002998867094653131,0.75
4714,자신감/Noun,36,9,27,0.00010003779205477625,0.0002998867094653131,0.75
4715,진화/Noun,36,26,10,0.00028899806593602026,0.00011106915165381967,0.7222222222222222
4716,자본주의/Noun,36,26,10,0.00028899806593602026,0.00011106915165381967,0.7222222222222222
4717,줄리엣/Noun,36,26,10,0.00028899806593602026,0.00011106915165381967,0.7222222222222222
4718,다가가다/Verb,36,26,10,0.00028899806593602026,0.00011106915165381967,0.7222222222222222
4719,지진희/Noun,36,10,26,0.00011115310228308472,0.00028877979429993113,0.7222222222222222
4720,수애/Noun,36,25,11,0.0002778827557077118,0.00012217606681920164,0.6944444444444444
4721,정신차리다/Adjective,36,11,25,0.00012226841251139318,0.0002776728791345492,0.6944444444444444
4722,먹이다/Verb,36,12,24,0.00013338372273970166,0.0002665659639691672,0.6666666666666666
4723,어찌나/Adverb,36,24,12,0.0002667674454794033,0.0001332829819845836,0.6666666666666666
4724,문근영/Noun,36,24,12,0.0002667674454794033,0.0001332829819845836,0.6666666666666666
4725,호평/Noun,36,12,24,0.00013338372273970166,0.0002665659639691672,0.6666666666666666
4726,호소/Noun,36,13,23,0.00014449903296801013,0.0002554590488037852,0.6388888888888888
4727,신은경/Noun,36,13,23,0.00014449903296801013,0.0002554590488037852,0.6388888888888888
4728,일대기/Noun,36,23,13,0.00025565213525109487,0.00014438989714996557,0.6388888888888888
4729,투표/Noun,36,13,23,0.00014449903296801013,0.0002554590488037852,0.6388888888888888
4730,판치다/Verb,36,13,23,0.00014449903296801013,0.0002554590488037852,0.6388888888888888
4731,휘/Noun,36,13,23,0.00014449903296801013,0.0002554590488037852,0.6388888888888888
4732,놀람/Noun,36,22,14,0.00024453682502278637,0.00015549681231534753,0.6111111111111112
4733,런닝/Noun,36,14,22,0.0001556143431963186,0.0002443521336384033,0.6111111111111112
4734,오리/Noun,36,14,22,0.0001556143431963186,0.0002443521336384033,0.6111111111111112
4735,김하늘/Noun,36,22,14,0.00024453682502278637,0.00015549681231534753,0.6111111111111112
4736,"?""/Punctuation",36,14,22,0.0001556143431963186,0.0002443521336384033,0.6111111111111112
4737,프레디/Noun,36,15,21,0.00016672965342462708,0.0002332452184730213,0.5833333333333334
4738,사르다/Verb,36,21,15,0.00023342151479447792,0.0001666037274807295,0.5833333333333334
4739,표본/Noun,36,15,21,0.00016672965342462708,0.0002332452184730213,0.5833333333333334
4740,풍기다/Verb,36,15,21,0.00016672965342462708,0.0002332452184730213,0.5833333333333334
4741,판타스틱/Noun,36,21,15,0.00023342151479447792,0.0001666037274807295,0.5833333333333334
4742,미키/Noun,36,21,15,0.00023342151479447792,0.0001666037274807295,0.5833333333333334
4743,퍼즐/Noun,36,15,21,0.00016672965342462708,0.0002332452184730213,0.5833333333333334
4744,비정상/Noun,36,15,21,0.00016672965342462708,0.0002332452184730213,0.5833333333333334
4745,바이러스/Noun,36,15,21,0.00016672965342462708,0.0002332452184730213,0.5833333333333334
4746,받치다/Verb,36,16,20,0.00017784496365293555,0.00022213830330763935,0.5555555555555556
4747,화답/Noun,36,16,20,0.00017784496365293555,0.00022213830330763935,0.5555555555555556
4748,보삼/Noun,36,20,16,0.00022230620456616945,0.00017771064264611146,0.5555555555555556
4749,호러영화/Noun,36,20,16,0.00022230620456616945,0.00017771064264611146,0.5555555555555556
4750,2002년/Number,36,20,16,0.00022230620456616945,0.00017771064264611146,0.5555555555555556
4751,며/Noun,36,20,16,0.00022230620456616945,0.00017771064264611146,0.5555555555555556
4752,으로나/Josa,36,16,20,0.00017784496365293555,0.00022213830330763935,0.5555555555555556
4753,발휘/Noun,36,17,19,0.00018896027388124403,0.00021103138814225738,0.5277777777777778
4754,테론/Noun,36,19,17,0.00021119089433786097,0.00018881755781149343,0.5277777777777778
4755,가난하다/Adjective,36,19,17,0.00021119089433786097,0.00018881755781149343,0.5277777777777778
4756,종이/Noun,36,19,17,0.00021119089433786097,0.00018881755781149343,0.5277777777777778
4757,현장/Noun,36,19,17,0.00021119089433786097,0.00018881755781149343,0.5277777777777778
4758,기묘하다/Adjective,36,19,17,0.00021119089433786097,0.00018881755781149343,0.5277777777777778
4759,인종/Noun,36,19,17,0.00021119089433786097,0.00018881755781149343,0.5277777777777778
4760,런닝타임/Noun,36,18,18,0.0002000755841095525,0.0001999244729768754,0.5
4761,내공/Noun,36,18,18,0.0002000755841095525,0.0001999244729768754,0.5
4762,벨/Noun,36,18,18,0.0002000755841095525,0.0001999244729768754,0.5
4763,함정/Noun,36,18,18,0.0002000755841095525,0.0001999244729768754,0.5
4764,비유/Noun,36,18,18,0.0002000755841095525,0.0001999244729768754,0.5
4765,OCN/Alpha,36,18,18,0.0002000755841095525,0.0001999244729768754,0.5
4766,♡♡/Foreign,35,35,0,0.0003890358579907965,0.0,1.0
4767,최저/Noun,35,1,34,1.1115310228308472e-05,0.00037763511562298685,0.9714285714285714
4768,나열/Noun,35,2,33,2.2230620456616944e-05,0.0003665282004576049,0.9428571428571428
4769,알맹이/Noun,35,2,33,2.2230620456616944e-05,0.0003665282004576049,0.9428571428571428
4770,정신건강/Noun,35,3,32,3.3345930684925414e-05,0.0003554212852922229,0.9142857142857143
4771,도아/Noun,35,3,32,3.3345930684925414e-05,0.0003554212852922229,0.9142857142857143
4772,건강하다/Adjective,35,31,4,0.00034457461707756266,4.4427660661527865e-05,0.8857142857142857
4773,^_^/Punctuation,35,30,5,0.00033345930684925416,5.5534575826909837e-05,0.8571428571428571
4774,선전/Noun,35,5,30,5.557655114154236e-05,0.000333207454961459,0.8571428571428571
4775,구매/Noun,35,29,6,0.0003223439966209457,6.66414909922918e-05,0.8285714285714286
4776,진솔하다/Adjective,35,29,6,0.0003223439966209457,6.66414909922918e-05,0.8285714285714286
4777,이나마/Josa,35,29,6,0.0003223439966209457,6.66414909922918e-05,0.8285714285714286
4778,어물/Noun,35,6,29,6.669186136985083e-05,0.00032210053979607705,0.8285714285714286
4779,찰리/Noun,35,28,7,0.0003112286863926372,7.774840615767377e-05,0.8
4780,합리화/Noun,35,7,28,7.78071715981593e-05,0.00031099362463069506,0.8
4781,작정/Noun,35,8,27,8.892248182646778e-05,0.0002998867094653131,0.7714285714285715
4782,데이먼/Noun,35,27,8,0.00030011337616432876,8.885532132305573e-05,0.7714285714285715
4783,잡지/Noun,35,8,27,8.892248182646778e-05,0.0002998867094653131,0.7714285714285715
4784,갑갑하다/Adjective,35,8,27,8.892248182646778e-05,0.0002998867094653131,0.7714285714285715
4785,인내/Noun,35,9,26,0.00010003779205477625,0.00028877979429993113,0.7428571428571429
4786,미군/Noun,35,9,26,0.00010003779205477625,0.00028877979429993113,0.7428571428571429
4787,발톱/Noun,35,9,26,0.00010003779205477625,0.00028877979429993113,0.7428571428571429
4788,괴롭히다/Verb,35,9,26,0.00010003779205477625,0.00028877979429993113,0.7428571428571429
4789,과도/Josa,35,26,9,0.00028899806593602026,9.99622364884377e-05,0.7428571428571429
4790,악몽/Noun,35,9,26,0.00010003779205477625,0.00028877979429993113,0.7428571428571429
4791,ㄴㄴ/KoreanParticle,35,9,26,0.00010003779205477625,0.00028877979429993113,0.7428571428571429
4792,보스/Noun,35,9,26,0.00010003779205477625,0.00028877979429993113,0.7428571428571429
4793,띄우다/Verb,35,9,26,0.00010003779205477625,0.00028877979429993113,0.7428571428571429
4794,치밀다/Verb,35,9,26,0.00010003779205477625,0.00028877979429993113,0.7428571428571429
4795,광주/Noun,35,9,26,0.00010003779205477625,0.00028877979429993113,0.7428571428571429
4796,혼나다/Verb,35,10,25,0.00011115310228308472,0.0002776728791345492,0.7142857142857143
4797,태우다/Verb,35,10,25,0.00011115310228308472,0.0002776728791345492,0.7142857142857143
4798,엘/Noun,35,25,10,0.0002778827557077118,0.00011106915165381967,0.7142857142857143
4799,잣/Noun,35,10,25,0.00011115310228308472,0.0002776728791345492,0.7142857142857143
4800,마구/Noun,35,10,25,0.00011115310228308472,0.0002776728791345492,0.7142857142857143
4801,설치다/Adjective,35,10,25,0.00011115310228308472,0.0002776728791345492,0.7142857142857143
4802,스포일러/Noun,35,24,11,0.0002667674454794033,0.00012217606681920164,0.6857142857142857
4803,여자도/Noun,35,11,24,0.00012226841251139318,0.0002665659639691672,0.6857142857142857
4804,쌓이다/Verb,35,11,24,0.00012226841251139318,0.0002665659639691672,0.6857142857142857
4805,흘러나오다/Verb,35,23,12,0.00025565213525109487,0.0001332829819845836,0.6571428571428571
4806,스티브/Noun,35,23,12,0.00025565213525109487,0.0001332829819845836,0.6571428571428571
4807,이분/Noun,35,23,12,0.00025565213525109487,0.0001332829819845836,0.6571428571428571
4808,한국말/Noun,35,12,23,0.00013338372273970166,0.0002554590488037852,0.6571428571428571
4809,로우/Noun,35,23,12,0.00025565213525109487,0.0001332829819845836,0.6571428571428571
4810,족/Noun,35,12,23,0.00013338372273970166,0.0002554590488037852,0.6571428571428571
4811,듯이/Noun,35,12,23,0.00013338372273970166,0.0002554590488037852,0.6571428571428571
4812,캐서린/Noun,35,12,23,0.00013338372273970166,0.0002554590488037852,0.6571428571428571
4813,이완/Noun,35,22,13,0.00024453682502278637,0.00014438989714996557,0.6285714285714286
4814,주의자/Noun,35,13,22,0.00014449903296801013,0.0002443521336384033,0.6285714285714286
4815,리들리/Noun,35,21,14,0.00023342151479447792,0.00015549681231534753,0.6
4816,직전/Noun,35,14,21,0.0001556143431963186,0.0002332452184730213,0.6
4817,엇음/Noun,35,14,21,0.0001556143431963186,0.0002332452184730213,0.6
4818,낭/Noun,35,14,21,0.0001556143431963186,0.0002332452184730213,0.6
4819,사이/Modifier,35,21,14,0.00023342151479447792,0.00015549681231534753,0.6
4820,기독교인/Noun,35,14,21,0.0001556143431963186,0.0002332452184730213,0.6
4821,프로젝트/Noun,35,14,21,0.0001556143431963186,0.0002332452184730213,0.6
4822,~~~~~~/Punctuation,35,14,21,0.0001556143431963186,0.0002332452184730213,0.6
4823,한지민/Noun,35,21,14,0.00023342151479447792,0.00015549681231534753,0.6
4824,꾸준하다/Adjective,35,15,20,0.00016672965342462708,0.00022213830330763935,0.5714285714285714
4825,cgv/Alpha,35,20,15,0.00022230620456616945,0.0001666037274807295,0.5714285714285714
4826,위안/Noun,35,15,20,0.00016672965342462708,0.00022213830330763935,0.5714285714285714
4827,안주/Noun,35,20,15,0.00022230620456616945,0.0001666037274807295,0.5714285714285714
4828,음모/Noun,35,15,20,0.00016672965342462708,0.00022213830330763935,0.5714285714285714
4829,의아/Noun,35,15,20,0.00016672965342462708,0.00022213830330763935,0.5714285714285714
4830,사연/Noun,35,19,16,0.00021119089433786097,0.00017771064264611146,0.5428571428571428
4831,샤론스톤/Noun,35,19,16,0.00021119089433786097,0.00017771064264611146,0.5428571428571428
4832,2001년/Number,35,19,16,0.00021119089433786097,0.00017771064264611146,0.5428571428571428
4833,확신/Noun,35,16,19,0.00017784496365293555,0.00021103138814225738,0.5428571428571428
4834,잘살다/Verb,35,16,19,0.00017784496365293555,0.00021103138814225738,0.5428571428571428
4835,우마/Noun,35,19,16,0.00021119089433786097,0.00017771064264611146,0.5428571428571428
4836,의학/Noun,35,16,19,0.00017784496365293555,0.00021103138814225738,0.5428571428571428
4837,순진하다/Adjective,35,16,19,0.00017784496365293555,0.00021103138814225738,0.5428571428571428
4838,위치/Noun,35,16,19,0.00017784496365293555,0.00021103138814225738,0.5428571428571428
4839,옴니버스/Noun,35,17,18,0.00018896027388124403,0.0001999244729768754,0.5142857142857142
4840,아시아/Noun,35,17,18,0.00018896027388124403,0.0001999244729768754,0.5142857142857142
4841,정권/Noun,35,18,17,0.0002000755841095525,0.00018881755781149343,0.5142857142857142
4842,몬스터/Noun,35,18,17,0.0002000755841095525,0.00018881755781149343,0.5142857142857142
4843,따라서/Noun,35,17,18,0.00018896027388124403,0.0001999244729768754,0.5142857142857142
4844,에리/Noun,35,18,17,0.0002000755841095525,0.00018881755781149343,0.5142857142857142
4845,어려움/Noun,35,18,17,0.0002000755841095525,0.00018881755781149343,0.5142857142857142
4846,독백/Noun,35,17,18,0.00018896027388124403,0.0001999244729768754,0.5142857142857142
4847,퉤/Noun,34,2,32,2.2230620456616944e-05,0.0003554212852922229,0.9411764705882353
4848,만큼도/Josa,34,2,32,2.2230620456616944e-05,0.0003554212852922229,0.9411764705882353
4849,박신혜/Noun,34,31,3,0.00034457461707756266,3.33207454961459e-05,0.9117647058823529
4850,자질/Noun,34,3,31,3.3345930684925414e-05,0.000344314370126841,0.9117647058823529
4851,...;;;/Punctuation,34,3,31,3.3345930684925414e-05,0.000344314370126841,0.9117647058823529
4852,공효진/Noun,34,30,4,0.00033345930684925416,4.4427660661527865e-05,0.8823529411764706
4853,톰크루즈/Noun,34,29,5,0.0003223439966209457,5.5534575826909837e-05,0.8529411764705882
4854,맑은/Noun,34,29,5,0.0003223439966209457,5.5534575826909837e-05,0.8529411764705882
4855,칠이/Noun,34,5,29,5.557655114154236e-05,0.00032210053979607705,0.8529411764705882
4856,동호/Noun,34,5,29,5.557655114154236e-05,0.00032210053979607705,0.8529411764705882
4857,이동욱/Noun,34,29,5,0.0003223439966209457,5.5534575826909837e-05,0.8529411764705882
4858,동기/Noun,34,6,28,6.669186136985083e-05,0.00031099362463069506,0.8235294117647058
4859,~!!!!/Punctuation,34,27,7,0.00030011337616432876,7.774840615767377e-05,0.7941176470588235
4860,가시/Noun,34,27,7,0.00030011337616432876,7.774840615767377e-05,0.7941176470588235
4861,급전/Noun,34,7,27,7.78071715981593e-05,0.0002998867094653131,0.7941176470588235
4862,또한/Modifier,34,27,7,0.00030011337616432876,7.774840615767377e-05,0.7941176470588235
4863,고려/Noun,34,7,27,7.78071715981593e-05,0.0002998867094653131,0.7941176470588235
4864,지다/Noun,34,27,7,0.00030011337616432876,7.774840615767377e-05,0.7941176470588235
4865,카타르/Noun,34,27,7,0.00030011337616432876,7.774840615767377e-05,0.7941176470588235
4866,숭고하다/Adjective,34,27,7,0.00030011337616432876,7.774840615767377e-05,0.7941176470588235
4867,화이/Noun,34,27,7,0.00030011337616432876,7.774840615767377e-05,0.7941176470588235
4868,뺨/Noun,34,8,26,8.892248182646778e-05,0.00028877979429993113,0.7647058823529411
4869,아웃/Noun,34,8,26,8.892248182646778e-05,0.00028877979429993113,0.7647058823529411
4870,출연료/Noun,34,8,26,8.892248182646778e-05,0.00028877979429993113,0.7647058823529411
4871,흥겹다/Adjective,34,26,8,0.00028899806593602026,8.885532132305573e-05,0.7647058823529411
4872,비급/Noun,34,8,26,8.892248182646778e-05,0.00028877979429993113,0.7647058823529411
4873,통한/Noun,34,26,8,0.00028899806593602026,8.885532132305573e-05,0.7647058823529411
4874,저예산영화/Noun,34,8,26,8.892248182646778e-05,0.00028877979429993113,0.7647058823529411
4875,멜깁슨/Noun,34,26,8,0.00028899806593602026,8.885532132305573e-05,0.7647058823529411
4876,어딨다/Verb,34,8,26,8.892248182646778e-05,0.00028877979429993113,0.7647058823529411
4877,행운/Noun,34,25,9,0.0002778827557077118,9.99622364884377e-05,0.7352941176470589
4878,도망/Noun,34,9,25,0.00010003779205477625,0.0002776728791345492,0.7352941176470589
4879,린치/Noun,34,25,9,0.0002778827557077118,9.99622364884377e-05,0.7352941176470589
4880,잘쓰다/Verb,34,9,25,0.00010003779205477625,0.0002776728791345492,0.7352941176470589
4881,또다시/Adverb,34,25,9,0.0002778827557077118,9.99622364884377e-05,0.7352941176470589
4882,처참하다/Adjective,34,9,25,0.00010003779205477625,0.0002776728791345492,0.7352941176470589
4883,두/Modifier,34,9,25,0.00010003779205477625,0.0002776728791345492,0.7352941176470589
4884,흐/Noun,34,25,9,0.0002778827557077118,9.99622364884377e-05,0.7352941176470589
4885,속도/Noun,34,10,24,0.00011115310228308472,0.0002665659639691672,0.7058823529411765
4886,일본어/Noun,34,10,24,0.00011115310228308472,0.0002665659639691672,0.7058823529411765
4887,털리다/Verb,34,10,24,0.00011115310228308472,0.0002665659639691672,0.7058823529411765
4888,나아가다/Verb,34,24,10,0.0002667674454794033,0.00011106915165381967,0.7058823529411765
4889,질투/Noun,34,24,10,0.0002667674454794033,0.00011106915165381967,0.7058823529411765
4890,사이코패스/Noun,34,10,24,0.00011115310228308472,0.0002665659639691672,0.7058823529411765
4891,2010년/Number,34,10,24,0.00011115310228308472,0.0002665659639691672,0.7058823529411765
4892,김남길/Noun,34,24,10,0.0002667674454794033,0.00011106915165381967,0.7058823529411765
4893,스치다/Verb,34,24,10,0.0002667674454794033,0.00011106915165381967,0.7058823529411765
4894,파일/Noun,34,23,11,0.00025565213525109487,0.00012217606681920164,0.6764705882352942
4895,S/Alpha,34,23,11,0.00025565213525109487,0.00012217606681920164,0.6764705882352942
4896,떼/Noun,34,11,23,0.00012226841251139318,0.0002554590488037852,0.6764705882352942
4897,토미/Noun,34,23,11,0.00025565213525109487,0.00012217606681920164,0.6764705882352942
4898,?'/Punctuation,34,12,22,0.00013338372273970166,0.0002443521336384033,0.6470588235294118
4899,페이지/Noun,34,22,12,0.00024453682502278637,0.0001332829819845836,0.6470588235294118
4900,중이/Noun,34,22,12,0.00024453682502278637,0.0001332829819845836,0.6470588235294118
4901,좌절/Noun,34,22,12,0.00024453682502278637,0.0001332829819845836,0.6470588235294118
4902,...!!/Punctuation,34,22,12,0.00024453682502278637,0.0001332829819845836,0.6470588235294118
4903,아르/Noun,34,22,12,0.00024453682502278637,0.0001332829819845836,0.6470588235294118
4904,프레데터/Noun,34,12,22,0.00013338372273970166,0.0002443521336384033,0.6470588235294118
4905,고찰/Noun,34,22,12,0.00024453682502278637,0.0001332829819845836,0.6470588235294118
4906,고개/Noun,34,12,22,0.00013338372273970166,0.0002443521336384033,0.6470588235294118
4907,고소영/Noun,34,12,22,0.00013338372273970166,0.0002443521336384033,0.6470588235294118
4908,여우/Noun,34,22,12,0.00024453682502278637,0.0001332829819845836,0.6470588235294118
4909,안목/Noun,34,12,22,0.00013338372273970166,0.0002443521336384033,0.6470588235294118
4910,이슈/Noun,34,13,21,0.00014449903296801013,0.0002332452184730213,0.6176470588235294
4911,브리/Noun,34,21,13,0.00023342151479447792,0.00014438989714996557,0.6176470588235294
4912,거대/Noun,34,13,21,0.00014449903296801013,0.0002332452184730213,0.6176470588235294
4913,개독/Noun,34,13,21,0.00014449903296801013,0.0002332452184730213,0.6176470588235294
4914,남자친구/Noun,34,21,13,0.00023342151479447792,0.00014438989714996557,0.6176470588235294
4915,라며/Noun,34,13,21,0.00014449903296801013,0.0002332452184730213,0.6176470588235294
4916,플레이/Noun,34,13,21,0.00014449903296801013,0.0002332452184730213,0.6176470588235294
4917,몸부림/Noun,34,14,20,0.0001556143431963186,0.00022213830330763935,0.5882352941176471
4918,이내/Noun,34,14,20,0.0001556143431963186,0.00022213830330763935,0.5882352941176471
4919,하이킥/Noun,34,20,14,0.00022230620456616945,0.00015549681231534753,0.5882352941176471
4920,스캔들/Noun,34,14,20,0.0001556143431963186,0.00022213830330763935,0.5882352941176471
4921,블루/Noun,34,14,20,0.0001556143431963186,0.00022213830330763935,0.5882352941176471
4922,성경/Noun,34,14,20,0.0001556143431963186,0.00022213830330763935,0.5882352941176471
4923,제인/Noun,34,20,14,0.00022230620456616945,0.00015549681231534753,0.5882352941176471
4924,차지/Noun,34,14,20,0.0001556143431963186,0.00022213830330763935,0.5882352941176471
4925,하여금/Adverb,34,20,14,0.00022230620456616945,0.00015549681231534753,0.5882352941176471
4926,대형/Noun,34,14,20,0.0001556143431963186,0.00022213830330763935,0.5882352941176471
4927,조인성/Noun,34,20,14,0.00022230620456616945,0.00015549681231534753,0.5882352941176471
4928,형성/Noun,34,20,14,0.00022230620456616945,0.00015549681231534753,0.5882352941176471
4929,목표/Noun,34,20,14,0.00022230620456616945,0.00015549681231534753,0.5882352941176471
4930,오토바이/Noun,34,14,20,0.0001556143431963186,0.00022213830330763935,0.5882352941176471
4931,근본/Noun,34,14,20,0.0001556143431963186,0.00022213830330763935,0.5882352941176471
4932,충분/Noun,34,20,14,0.00022230620456616945,0.00015549681231534753,0.5882352941176471
4933,측면/Noun,34,14,20,0.0001556143431963186,0.00022213830330763935,0.5882352941176471
4934,뿌리/Noun,34,19,15,0.00021119089433786097,0.0001666037274807295,0.5588235294117647
4935,2008년/Number,34,19,15,0.00021119089433786097,0.0001666037274807295,0.5588235294117647
4936,따윈/Noun,34,15,19,0.00016672965342462708,0.00021103138814225738,0.5588235294117647
4937,.?/Punctuation,34,19,15,0.00021119089433786097,0.0001666037274807295,0.5588235294117647
4938,완결/Noun,34,19,15,0.00021119089433786097,0.0001666037274807295,0.5588235294117647
4939,딱좋다/Adjective,34,19,15,0.00021119089433786097,0.0001666037274807295,0.5588235294117647
4940,김수로/Noun,34,19,15,0.00021119089433786097,0.0001666037274807295,0.5588235294117647
4941,2012/Number,34,15,19,0.00016672965342462708,0.00021103138814225738,0.5588235294117647
4942,마땅하다/Adjective,34,19,15,0.00021119089433786097,0.0001666037274807295,0.5588235294117647
4943,뒤통수/Noun,34,15,19,0.00016672965342462708,0.00021103138814225738,0.5588235294117647
4944,태/Noun,34,18,16,0.0002000755841095525,0.00017771064264611146,0.5294117647058824
4945,룩/Suffix,34,18,16,0.0002000755841095525,0.00017771064264611146,0.5294117647058824
4946,서기/Noun,34,18,16,0.0002000755841095525,0.00017771064264611146,0.5294117647058824
4947,특성/Noun,34,16,18,0.00017784496365293555,0.0001999244729768754,0.5294117647058824
4948,끝장/Noun,34,18,16,0.0002000755841095525,0.00017771064264611146,0.5294117647058824
4949,익다/Verb,34,16,18,0.00017784496365293555,0.0001999244729768754,0.5294117647058824
4950,대리/Noun,34,18,16,0.0002000755841095525,0.00017771064264611146,0.5294117647058824
4951,개미/Noun,34,17,17,0.00018896027388124403,0.00018881755781149343,0.5
4952,강시/Noun,34,17,17,0.00018896027388124403,0.00018881755781149343,0.5
4953,암살/Noun,34,17,17,0.00018896027388124403,0.00018881755781149343,0.5
4954,다수/Noun,34,17,17,0.00018896027388124403,0.00018881755781149343,0.5
4955,기계/Noun,34,17,17,0.00018896027388124403,0.00018881755781149343,0.5
4956,!!^^/Punctuation,33,33,0,0.0003668052375341796,0.0,1.0
4957,앓이/Noun,33,33,0,0.0003668052375341796,0.0,1.0
4958,서세원/Noun,33,1,32,1.1115310228308472e-05,0.0003554212852922229,0.9696969696969697
4959,모처럼/Noun,33,32,1,0.0003556899273058711,1.1106915165381966e-05,0.9696969696969697
4960,알차다/Adjective,33,31,2,0.00034457461707756266,2.2213830330763933e-05,0.9393939393939394
4961,조아/Adverb,33,31,2,0.00034457461707756266,2.2213830330763933e-05,0.9393939393939394
4962,국뽕/Noun,33,3,30,3.3345930684925414e-05,0.000333207454961459,0.9090909090909091
4963,듣보잡/Noun,33,3,30,3.3345930684925414e-05,0.000333207454961459,0.9090909090909091
4964,best/Alpha,33,30,3,0.00033345930684925416,3.33207454961459e-05,0.9090909090909091
4965,혹성탈출/Noun,33,6,27,6.669186136985083e-05,0.0002998867094653131,0.8181818181818182
4966,어줍다/Adjective,33,6,27,6.669186136985083e-05,0.0002998867094653131,0.8181818181818182
4967,매회/Adverb,33,27,6,0.00030011337616432876,6.66414909922918e-05,0.8181818181818182
4968,놀이/Noun,33,7,26,7.78071715981593e-05,0.00028877979429993113,0.7878787878787878
4969,각인/Noun,33,26,7,0.00028899806593602026,7.774840615767377e-05,0.7878787878787878
4970,공격/Noun,33,7,26,7.78071715981593e-05,0.00028877979429993113,0.7878787878787878
4971,사랑과전쟁/Noun,33,8,25,8.892248182646778e-05,0.0002776728791345492,0.7575757575757576
4972,마련/Noun,33,25,8,0.0002778827557077118,8.885532132305573e-05,0.7575757575757576
4973,발레/Noun,33,25,8,0.0002778827557077118,8.885532132305573e-05,0.7575757575757576
4974,해대/Noun,33,8,25,8.892248182646778e-05,0.0002776728791345492,0.7575757575757576
4975,전결/Noun,33,8,25,8.892248182646778e-05,0.0002776728791345492,0.7575757575757576
4976,진구/Noun,33,24,9,0.0002667674454794033,9.99622364884377e-05,0.7272727272727273
4977,서서히/Noun,33,24,9,0.0002667674454794033,9.99622364884377e-05,0.7272727272727273
4978,갑작스럽다/Adjective,33,9,24,0.00010003779205477625,0.0002665659639691672,0.7272727272727273
4979,자아내다/Verb,33,24,9,0.0002667674454794033,9.99622364884377e-05,0.7272727272727273
4980,대의/Foreign,33,24,9,0.0002667674454794033,9.99622364884377e-05,0.7272727272727273
4981,대도/Noun,33,9,24,0.00010003779205477625,0.0002665659639691672,0.7272727272727273
4982,나이트/Noun,33,10,23,0.00011115310228308472,0.0002554590488037852,0.696969696969697
4983,얼른/Noun,33,23,10,0.00025565213525109487,0.00011106915165381967,0.696969696969697
4984,재회/Noun,33,23,10,0.00025565213525109487,0.00011106915165381967,0.696969696969697
4985,좌파/Noun,33,10,23,0.00011115310228308472,0.0002554590488037852,0.696969696969697
4986,회장/Noun,33,10,23,0.00011115310228308472,0.0002554590488037852,0.696969696969697
4987,돌아다니다/Verb,33,10,23,0.00011115310228308472,0.0002554590488037852,0.696969696969697
4988,부러/Noun,33,23,10,0.00025565213525109487,0.00011106915165381967,0.696969696969697
4989,승/Noun,33,11,22,0.00012226841251139318,0.0002443521336384033,0.6666666666666666
4990,…/Punctuation,33,11,22,0.00012226841251139318,0.0002443521336384033,0.6666666666666666
4991,후유증/Noun,33,22,11,0.00024453682502278637,0.00012217606681920164,0.6666666666666666
4992,안녕/Noun,33,22,11,0.00024453682502278637,0.00012217606681920164,0.6666666666666666
4993,에게나/Josa,33,22,11,0.00024453682502278637,0.00012217606681920164,0.6666666666666666
4994,효민/Noun,33,11,22,0.00012226841251139318,0.0002443521336384033,0.6666666666666666
4995,피우다/Verb,33,11,22,0.00012226841251139318,0.0002443521336384033,0.6666666666666666
4996,까지가/Josa,33,11,22,0.00012226841251139318,0.0002443521336384033,0.6666666666666666
4997,케이스/Noun,33,11,22,0.00012226841251139318,0.0002443521336384033,0.6666666666666666
4998,낯선/Noun,33,22,11,0.00024453682502278637,0.00012217606681920164,0.6666666666666666
4999,과제/Noun,33,12,21,0.00013338372273970166,0.0002332452184730213,0.6363636363636364
5000,괴수/Noun,33,12,21,0.00013338372273970166,0.0002332452184730213,0.6363636363636364
5001,장인/Noun,33,21,12,0.00023342151479447792,0.0001332829819845836,0.6363636363636364
5002,미로/Noun,33,12,21,0.00013338372273970166,0.0002332452184730213,0.6363636363636364
5003,시청율/Noun,33,12,21,0.00013338372273970166,0.0002332452184730213,0.6363636363636364
5004,탕/Noun,33,12,21,0.00013338372273970166,0.0002332452184730213,0.6363636363636364
5005,지성/Noun,33,21,12,0.00023342151479447792,0.0001332829819845836,0.6363636363636364
5006,↓/Foreign,33,12,21,0.00013338372273970166,0.0002332452184730213,0.6363636363636364
5007,만으로는/Josa,33,13,20,0.00014449903296801013,0.00022213830330763935,0.6060606060606061
5008,대만/Noun,33,13,20,0.00014449903296801013,0.00022213830330763935,0.6060606060606061
5009,신뢰/Noun,33,13,20,0.00014449903296801013,0.00022213830330763935,0.6060606060606061
5010,人/Foreign,33,13,20,0.00014449903296801013,0.00022213830330763935,0.6060606060606061
5011,고정/Noun,33,20,13,0.00022230620456616945,0.00014438989714996557,0.6060606060606061
5012,서방/Noun,33,13,20,0.00014449903296801013,0.00022213830330763935,0.6060606060606061
5013,2회/Number,33,20,13,0.00022230620456616945,0.00014438989714996557,0.6060606060606061
5014,어둠/Noun,33,19,14,0.00021119089433786097,0.00015549681231534753,0.5757575757575758
5015,결합/Noun,33,19,14,0.00021119089433786097,0.00015549681231534753,0.5757575757575758
5016,뚜렷하다/Adjective,33,19,14,0.00021119089433786097,0.00015549681231534753,0.5757575757575758
5017,뵈다/Verb,33,19,14,0.00021119089433786097,0.00015549681231534753,0.5757575757575758
5018,이신/Josa,33,19,14,0.00021119089433786097,0.00015549681231534753,0.5757575757575758
5019,소수/Noun,33,14,19,0.0001556143431963186,0.00021103138814225738,0.5757575757575758
5020,명량/Noun,33,19,14,0.00021119089433786097,0.00015549681231534753,0.5757575757575758
5021,검/Noun,33,14,19,0.0001556143431963186,0.00021103138814225738,0.5757575757575758
5022,자하/Noun,33,14,19,0.0001556143431963186,0.00021103138814225738,0.5757575757575758
5023,도덕/Noun,33,15,18,0.00016672965342462708,0.0001999244729768754,0.5454545454545454
5024,고통스럽다/Adjective,33,18,15,0.0002000755841095525,0.0001666037274807295,0.5454545454545454
5025,패닝/Noun,33,18,15,0.0002000755841095525,0.0001666037274807295,0.5454545454545454
5026,어보/Noun,33,18,15,0.0002000755841095525,0.0001666037274807295,0.5454545454545454
5027,2009년/Number,33,18,15,0.0002000755841095525,0.0001666037274807295,0.5454545454545454
5028,가치관/Noun,33,18,15,0.0002000755841095525,0.0001666037274807295,0.5454545454545454
5029,조각/Noun,33,18,15,0.0002000755841095525,0.0001666037274807295,0.5454545454545454
5030,핵심/Noun,33,15,18,0.00016672965342462708,0.0001999244729768754,0.5454545454545454
5031,해리슨/Noun,33,15,18,0.00016672965342462708,0.0001999244729768754,0.5454545454545454
5032,조심하다/Verb,33,15,18,0.00016672965342462708,0.0001999244729768754,0.5454545454545454
5033,물질/Noun,33,18,15,0.0002000755841095525,0.0001666037274807295,0.5454545454545454
5034,하여튼/Noun,33,15,18,0.00016672965342462708,0.0001999244729768754,0.5454545454545454
5035,수단/Noun,33,18,15,0.0002000755841095525,0.0001666037274807295,0.5454545454545454
5036,영화배우/Noun,33,18,15,0.0002000755841095525,0.0001666037274807295,0.5454545454545454
5037,서민/Noun,33,18,15,0.0002000755841095525,0.0001666037274807295,0.5454545454545454
5038,으아/Exclamation,33,18,15,0.0002000755841095525,0.0001666037274807295,0.5454545454545454
5039,제공/Noun,33,18,15,0.0002000755841095525,0.0001666037274807295,0.5454545454545454
5040,박자/Noun,33,17,16,0.00018896027388124403,0.00017771064264611146,0.5151515151515151
5041,타입/Noun,33,16,17,0.00017784496365293555,0.00018881755781149343,0.5151515151515151
5042,몰래/Noun,33,17,16,0.00018896027388124403,0.00017771064264611146,0.5151515151515151
5043,스타뎀/Noun,33,17,16,0.00018896027388124403,0.00017771064264611146,0.5151515151515151
5044,균형/Noun,33,17,16,0.00018896027388124403,0.00017771064264611146,0.5151515151515151
5045,민주주의/Noun,33,17,16,0.00018896027388124403,0.00017771064264611146,0.5151515151515151
5046,떄문/Noun,33,17,16,0.00018896027388124403,0.00017771064264611146,0.5151515151515151
5047,테이크/Noun,33,17,16,0.00018896027388124403,0.00017771064264611146,0.5151515151515151
5048,평정/Noun,33,16,17,0.00017784496365293555,0.00018881755781149343,0.5151515151515151
5049,인터스텔라/Noun,33,17,16,0.00018896027388124403,0.00017771064264611146,0.5151515151515151
5050,빅/Noun,33,17,16,0.00018896027388124403,0.00017771064264611146,0.5151515151515151
5051,보석같다/Adjective,32,31,1,0.00034457461707756266,1.1106915165381966e-05,0.96875
5052,명곡/Noun,32,30,2,0.00033345930684925416,2.2213830330763933e-05,0.9375
5053,유행어/Noun,32,2,30,2.2230620456616944e-05,0.000333207454961459,0.9375
5054,AV/Alpha,32,2,30,2.2230620456616944e-05,0.000333207454961459,0.9375
5055,얄팍하다/Adjective,32,2,30,2.2230620456616944e-05,0.000333207454961459,0.9375
5056,></Punctuation,32,30,2,0.00033345930684925416,2.2213830330763933e-05,0.9375
5057,썰렁하다/Adjective,32,3,29,3.3345930684925414e-05,0.00032210053979607705,0.90625
5058,Very/Alpha,32,29,3,0.0003223439966209457,3.33207454961459e-05,0.90625
5059,테스트/Noun,32,3,29,3.3345930684925414e-05,0.00032210053979607705,0.90625
5060,love/Alpha,32,28,4,0.0003112286863926372,4.4427660661527865e-05,0.875
5061,괴작/Noun,32,4,28,4.446124091323389e-05,0.00031099362463069506,0.875
5062,보석/Noun,32,28,4,0.0003112286863926372,4.4427660661527865e-05,0.875
5063,되새기다/Verb,32,28,4,0.0003112286863926372,4.4427660661527865e-05,0.875
5064,참혹하다/Adjective,32,27,5,0.00030011337616432876,5.5534575826909837e-05,0.84375
5065,어필/Noun,32,5,27,5.557655114154236e-05,0.0002998867094653131,0.84375
5066,슈스케/Noun,32,5,27,5.557655114154236e-05,0.0002998867094653131,0.84375
5067,마주/Noun,32,27,5,0.00030011337616432876,5.5534575826909837e-05,0.84375
5068,변명/Noun,32,6,26,6.669186136985083e-05,0.00028877979429993113,0.8125
5069,감독판/Noun,32,26,6,0.00028899806593602026,6.66414909922918e-05,0.8125
5070,아리/Noun,32,26,6,0.00028899806593602026,6.66414909922918e-05,0.8125
5071,침몰/Noun,32,6,26,6.669186136985083e-05,0.00028877979429993113,0.8125
5072,뽀로로/Noun,32,7,25,7.78071715981593e-05,0.0002776728791345492,0.78125
5073,맛깔나다/Adjective,32,25,7,0.0002778827557077118,7.774840615767377e-05,0.78125
5074,토요명화/Noun,32,25,7,0.0002778827557077118,7.774840615767377e-05,0.78125
5075,사소하다/Adjective,32,25,7,0.0002778827557077118,7.774840615767377e-05,0.78125
5076,된장/Noun,32,8,24,8.892248182646778e-05,0.0002665659639691672,0.75
5077,쌍욕/Noun,32,8,24,8.892248182646778e-05,0.0002665659639691672,0.75
5078,어쨋/Noun,32,24,8,0.0002667674454794033,8.885532132305573e-05,0.75
5079,안달/Noun,32,8,24,8.892248182646778e-05,0.0002665659639691672,0.75
5080,취미/Noun,32,8,24,8.892248182646778e-05,0.0002665659639691672,0.75
5081,튀기다/Verb,32,8,24,8.892248182646778e-05,0.0002665659639691672,0.75
5082,my/Alpha,32,23,9,0.00025565213525109487,9.99622364884377e-05,0.71875
5083,콘서트/Noun,32,23,9,0.00025565213525109487,9.99622364884377e-05,0.71875
5084,토마스/Noun,32,23,9,0.00025565213525109487,9.99622364884377e-05,0.71875
5085,희극/Noun,32,22,10,0.00024453682502278637,0.00011106915165381967,0.6875
5086,싸/VerbPrefix,32,10,22,0.00011115310228308472,0.0002443521336384033,0.6875
5087,압축/Noun,32,10,22,0.00011115310228308472,0.0002443521336384033,0.6875
5088,아랫/Modifier,32,22,10,0.00024453682502278637,0.00011106915165381967,0.6875
5089,통일/Noun,32,22,10,0.00024453682502278637,0.00011106915165381967,0.6875
5090,me/Alpha,32,22,10,0.00024453682502278637,0.00011106915165381967,0.6875
5091,일베/Noun,32,10,22,0.00011115310228308472,0.0002443521336384033,0.6875
5092,원빈/Noun,32,22,10,0.00024453682502278637,0.00011106915165381967,0.6875
5093,다한/Noun,32,10,22,0.00011115310228308472,0.0002443521336384033,0.6875
5094,녹화/Noun,32,21,11,0.00023342151479447792,0.00012217606681920164,0.65625
5095,기차/Noun,32,21,11,0.00023342151479447792,0.00012217606681920164,0.65625
5096,주지훈/Noun,32,21,11,0.00023342151479447792,0.00012217606681920164,0.65625
5097,공리/Noun,32,21,11,0.00023342151479447792,0.00012217606681920164,0.65625
5098,정답/Noun,32,21,11,0.00023342151479447792,0.00012217606681920164,0.65625
5099,최지우/Noun,32,21,11,0.00023342151479447792,0.00012217606681920164,0.65625
5100,즘/Noun,32,11,21,0.00012226841251139318,0.0002332452184730213,0.65625
5101,치르다/Verb,32,11,21,0.00012226841251139318,0.0002332452184730213,0.65625
5102,벌이다/Verb,32,11,21,0.00012226841251139318,0.0002332452184730213,0.65625
5103,치가/Noun,32,11,21,0.00012226841251139318,0.0002332452184730213,0.65625
5104,무작정/Noun,32,11,21,0.00012226841251139318,0.0002332452184730213,0.65625
5105,뱉다/Verb,32,11,21,0.00012226841251139318,0.0002332452184730213,0.65625
5106,학/Noun,32,12,20,0.00013338372273970166,0.00022213830330763935,0.625
5107,~~~~~~~/Punctuation,32,12,20,0.00013338372273970166,0.00022213830330763935,0.625
5108,휴머니즘/Noun,32,20,12,0.00022230620456616945,0.0001332829819845836,0.625
5109,트와일라잇/Noun,32,12,20,0.00013338372273970166,0.00022213830330763935,0.625
5110,과감/Noun,32,12,20,0.00013338372273970166,0.00022213830330763935,0.625
5111,크리/Noun,32,20,12,0.00022230620456616945,0.0001332829819845836,0.625
5112,디스/Noun,32,12,20,0.00013338372273970166,0.00022213830330763935,0.625
5113,동원/Noun,32,12,20,0.00013338372273970166,0.00022213830330763935,0.625
5114,어벤져스/Noun,32,20,12,0.00022230620456616945,0.0001332829819845836,0.625
5115,줄알/Noun,32,12,20,0.00013338372273970166,0.00022213830330763935,0.625
5116,송중기/Noun,32,20,12,0.00022230620456616945,0.0001332829819845836,0.625
5117,강혜정/Noun,32,13,19,0.00014449903296801013,0.00021103138814225738,0.59375
5118,므/Noun,32,19,13,0.00021119089433786097,0.00014438989714996557,0.59375
5119,하우스/Noun,32,14,18,0.0001556143431963186,0.0001999244729768754,0.5625
5120,여야/Noun,32,14,18,0.0001556143431963186,0.0001999244729768754,0.5625
5121,주신/Noun,32,18,14,0.0002000755841095525,0.00015549681231534753,0.5625
5122,쳐다보다/Verb,32,14,18,0.0001556143431963186,0.0001999244729768754,0.5625
5123,2011년/Number,32,14,18,0.0001556143431963186,0.0001999244729768754,0.5625
5124,가도/Noun,32,18,14,0.0002000755841095525,0.00015549681231534753,0.5625
5125,쓰리다/Adjective,32,14,18,0.0001556143431963186,0.0001999244729768754,0.5625
5126,자가/Noun,32,14,18,0.0001556143431963186,0.0001999244729768754,0.5625
5127,적응/Noun,32,14,18,0.0001556143431963186,0.0001999244729768754,0.5625
5128,에야/Josa,32,18,14,0.0002000755841095525,0.00015549681231534753,0.5625
5129,작살/Noun,32,18,14,0.0002000755841095525,0.00015549681231534753,0.5625
5130,뉴/Noun,32,15,17,0.00016672965342462708,0.00018881755781149343,0.53125
5131,농구/Noun,32,17,15,0.00018896027388124403,0.0001666037274807295,0.53125
5132,레이싱/Noun,32,17,15,0.00018896027388124403,0.0001666037274807295,0.53125
5133,이선균/Noun,32,17,15,0.00018896027388124403,0.0001666037274807295,0.53125
5134,갈수/Noun,32,15,17,0.00016672965342462708,0.00018881755781149343,0.53125
5135,2일/Number,32,15,17,0.00016672965342462708,0.00018881755781149343,0.53125
5136,피트/Noun,32,17,15,0.00018896027388124403,0.0001666037274807295,0.53125
5137,여명/Noun,32,17,15,0.00018896027388124403,0.0001666037274807295,0.53125
5138,어마어마하다/Adjective,32,16,16,0.00017784496365293555,0.00017771064264611146,0.5
5139,친절하다/Adjective,32,16,16,0.00017784496365293555,0.00017771064264611146,0.5
5140,잔혹/Noun,32,16,16,0.00017784496365293555,0.00017771064264611146,0.5
5141,안듬/Noun,31,1,30,1.1115310228308472e-05,0.000333207454961459,0.967741935483871
5142,참내/Noun,31,1,30,1.1115310228308472e-05,0.000333207454961459,0.967741935483871
5143,이상형/Noun,31,28,3,0.0003112286863926372,3.33207454961459e-05,0.9032258064516129
5144,못지않다/Adjective,31,28,3,0.0003112286863926372,3.33207454961459e-05,0.9032258064516129
5145,그만두다/Verb,31,3,28,3.3345930684925414e-05,0.00031099362463069506,0.9032258064516129
5146,잘맞다/Adjective,31,27,4,0.00030011337616432876,4.4427660661527865e-05,0.8709677419354839
5147,수습/Noun,31,4,27,4.446124091323389e-05,0.0002998867094653131,0.8709677419354839
5148,발악/Noun,31,4,27,4.446124091323389e-05,0.0002998867094653131,0.8709677419354839
5149,랍시고/Noun,31,4,27,4.446124091323389e-05,0.0002998867094653131,0.8709677419354839
5150,자마자/Noun,31,5,26,5.557655114154236e-05,0.00028877979429993113,0.8387096774193549
5151,공존/Noun,31,26,5,0.00028899806593602026,5.5534575826909837e-05,0.8387096774193549
5152,팬심/Noun,31,5,26,5.557655114154236e-05,0.00028877979429993113,0.8387096774193549
5153,제이/Noun,31,26,5,0.00028899806593602026,5.5534575826909837e-05,0.8387096774193549
5154,봣던/Noun,31,25,6,0.0002778827557077118,6.66414909922918e-05,0.8064516129032258
5155,통틀어/Noun,31,25,6,0.0002778827557077118,6.66414909922918e-05,0.8064516129032258
5156,메리/Noun,31,25,6,0.0002778827557077118,6.66414909922918e-05,0.8064516129032258
5157,쪽바리/Noun,31,6,25,6.669186136985083e-05,0.0002776728791345492,0.8064516129032258
5158,결제/Noun,31,6,25,6.669186136985083e-05,0.0002776728791345492,0.8064516129032258
5159,서인국/Noun,31,25,6,0.0002778827557077118,6.66414909922918e-05,0.8064516129032258
5160,으로/Foreign,31,7,24,7.78071715981593e-05,0.0002665659639691672,0.7741935483870968
5161,히치콕/Noun,31,24,7,0.0002667674454794033,7.774840615767377e-05,0.7741935483870968
5162,클린트/Noun,31,24,7,0.0002667674454794033,7.774840615767377e-05,0.7741935483870968
5163,윌리엄스/Noun,31,24,7,0.0002667674454794033,7.774840615767377e-05,0.7741935483870968
5164,혼/Noun,31,24,7,0.0002667674454794033,7.774840615767377e-05,0.7741935483870968
5165,때론/Noun,31,24,7,0.0002667674454794033,7.774840615767377e-05,0.7741935483870968
5166,기막히다/Adjective,31,23,8,0.00025565213525109487,8.885532132305573e-05,0.7419354838709677
5167,크리스틴/Noun,31,23,8,0.00025565213525109487,8.885532132305573e-05,0.7419354838709677
5168,부대/Noun,31,8,23,8.892248182646778e-05,0.0002554590488037852,0.7419354838709677
5169,이틀/Noun,31,23,8,0.00025565213525109487,8.885532132305573e-05,0.7419354838709677
5170,봣음/Noun,31,23,8,0.00025565213525109487,8.885532132305573e-05,0.7419354838709677
5171,욕설/Noun,31,8,23,8.892248182646778e-05,0.0002554590488037852,0.7419354838709677
5172,하필/Noun,31,9,22,0.00010003779205477625,0.0002443521336384033,0.7096774193548387
5173,희한하다/Adjective,31,9,22,0.00010003779205477625,0.0002443521336384033,0.7096774193548387
5174,윤계상/Noun,31,22,9,0.00024453682502278637,9.99622364884377e-05,0.7096774193548387
5175,미니/Noun,31,22,9,0.00024453682502278637,9.99622364884377e-05,0.7096774193548387
5176,대면/Noun,31,9,22,0.00010003779205477625,0.0002443521336384033,0.7096774193548387
5177,약자/Noun,31,22,9,0.00024453682502278637,9.99622364884377e-05,0.7096774193548387
5178,1억/Number,31,9,22,0.00010003779205477625,0.0002443521336384033,0.7096774193548387
5179,사다코/Noun,31,9,22,0.00010003779205477625,0.0002443521336384033,0.7096774193548387
5180,공상/Noun,31,9,22,0.00010003779205477625,0.0002443521336384033,0.7096774193548387
5181,엑/Exclamation,31,9,22,0.00010003779205477625,0.0002443521336384033,0.7096774193548387
5182,미개하다/Adjective,31,9,22,0.00010003779205477625,0.0002443521336384033,0.7096774193548387
5183,....?/Punctuation,31,10,21,0.00011115310228308472,0.0002332452184730213,0.6774193548387096
5184,츠/Noun,31,21,10,0.00023342151479447792,0.00011106915165381967,0.6774193548387096
5185,인셉션/Noun,31,21,10,0.00023342151479447792,0.00011106915165381967,0.6774193548387096
5186,스트립/Noun,31,21,10,0.00023342151479447792,0.00011106915165381967,0.6774193548387096
5187,큰일/Noun,31,10,21,0.00011115310228308472,0.0002332452184730213,0.6774193548387096
5188,오우/Noun,31,21,10,0.00023342151479447792,0.00011106915165381967,0.6774193548387096
5189,무장/Noun,31,10,21,0.00011115310228308472,0.0002332452184730213,0.6774193548387096
5190,끊어지다/Verb,31,10,21,0.00011115310228308472,0.0002332452184730213,0.6774193548387096
5191,미남/Noun,31,21,10,0.00023342151479447792,0.00011106915165381967,0.6774193548387096
5192,부류/Noun,31,10,21,0.00011115310228308472,0.0002332452184730213,0.6774193548387096
5193,내주다/Verb,31,21,10,0.00023342151479447792,0.00011106915165381967,0.6774193548387096
5194,마저/Noun,31,11,20,0.00012226841251139318,0.00022213830330763935,0.6451612903225806
5195,라고는/Josa,31,11,20,0.00012226841251139318,0.00022213830330763935,0.6451612903225806
5196,인증/Noun,31,11,20,0.00012226841251139318,0.00022213830330763935,0.6451612903225806
5197,나인/Noun,31,20,11,0.00022230620456616945,0.00012217606681920164,0.6451612903225806
5198,그런대로/Adverb,31,11,20,0.00012226841251139318,0.00022213830330763935,0.6451612903225806
5199,",../Punctuation",31,11,20,0.00012226841251139318,0.00022213830330763935,0.6451612903225806
5200,필립/Noun,31,20,11,0.00022230620456616945,0.00012217606681920164,0.6451612903225806
5201,뎁/Noun,31,20,11,0.00022230620456616945,0.00012217606681920164,0.6451612903225806
5202,써주다/Verb,31,11,20,0.00012226841251139318,0.00022213830330763935,0.6451612903225806
5203,난이/Noun,31,20,11,0.00022230620456616945,0.00012217606681920164,0.6451612903225806
5204,7~8/Number,31,20,11,0.00022230620456616945,0.00012217606681920164,0.6451612903225806
5205,맞먹다/Verb,31,12,19,0.00013338372273970166,0.00021103138814225738,0.6129032258064516
5206,불꽃/Noun,31,19,12,0.00021119089433786097,0.0001332829819845836,0.6129032258064516
5207,악의/Noun,31,19,12,0.00021119089433786097,0.0001332829819845836,0.6129032258064516
5208,미스터/Noun,31,19,12,0.00021119089433786097,0.0001332829819845836,0.6129032258064516
5209,진출/Noun,31,13,18,0.00014449903296801013,0.0001999244729768754,0.5806451612903226
5210,기리/Noun,31,18,13,0.0002000755841095525,0.00014438989714996557,0.5806451612903226
5211,주장/Noun,31,13,18,0.00014449903296801013,0.0001999244729768754,0.5806451612903226
5212,불가능/Noun,31,18,13,0.0002000755841095525,0.00014438989714996557,0.5806451612903226
5213,매튜/Noun,31,18,13,0.0002000755841095525,0.00014438989714996557,0.5806451612903226
5214,보더/Noun,31,13,18,0.00014449903296801013,0.0001999244729768754,0.5806451612903226
5215,리스트/Noun,31,18,13,0.0002000755841095525,0.00014438989714996557,0.5806451612903226
5216,달려가다/Verb,31,18,13,0.0002000755841095525,0.00014438989714996557,0.5806451612903226
5217,도박/Noun,31,18,13,0.0002000755841095525,0.00014438989714996557,0.5806451612903226
5218,전투기/Noun,31,13,18,0.00014449903296801013,0.0001999244729768754,0.5806451612903226
5219,창조/Noun,31,18,13,0.0002000755841095525,0.00014438989714996557,0.5806451612903226
5220,정성/Noun,31,13,18,0.00014449903296801013,0.0001999244729768754,0.5806451612903226
5221,미션/Noun,31,13,18,0.00014449903296801013,0.0001999244729768754,0.5806451612903226
5222,큐/Noun,31,13,18,0.00014449903296801013,0.0001999244729768754,0.5806451612903226
5223,좁다/Adjective,31,13,18,0.00014449903296801013,0.0001999244729768754,0.5806451612903226
5224,앤딩/Noun,31,13,18,0.00014449903296801013,0.0001999244729768754,0.5806451612903226
5225,장용/Noun,31,13,18,0.00014449903296801013,0.0001999244729768754,0.5806451612903226
5226,사오다/Verb,31,18,13,0.0002000755841095525,0.00014438989714996557,0.5806451612903226
5227,기반/Noun,31,13,18,0.00014449903296801013,0.0001999244729768754,0.5806451612903226
5228,뜸/Noun,31,18,13,0.0002000755841095525,0.00014438989714996557,0.5806451612903226
5229,궁금증/Noun,31,14,17,0.0001556143431963186,0.00018881755781149343,0.5483870967741935
5230,문제점/Noun,31,14,17,0.0001556143431963186,0.00018881755781149343,0.5483870967741935
5231,천녀유혼/Noun,31,14,17,0.0001556143431963186,0.00018881755781149343,0.5483870967741935
5232,헤/Noun,31,14,17,0.0001556143431963186,0.00018881755781149343,0.5483870967741935
5233,롯데/Noun,31,17,14,0.00018896027388124403,0.00015549681231534753,0.5483870967741935
5234,미우다/Verb,31,17,14,0.00018896027388124403,0.00015549681231534753,0.5483870967741935
5235,며칠/Noun,31,17,14,0.00018896027388124403,0.00015549681231534753,0.5483870967741935
5236,발차기/Noun,31,14,17,0.0001556143431963186,0.00018881755781149343,0.5483870967741935
5237,이겠다/Verb,31,17,14,0.00018896027388124403,0.00015549681231534753,0.5483870967741935
5238,자녀/Noun,31,16,15,0.00017784496365293555,0.0001666037274807295,0.5161290322580645
5239,마니아/Noun,31,16,15,0.00017784496365293555,0.0001666037274807295,0.5161290322580645
5240,주시/Noun,31,16,15,0.00017784496365293555,0.0001666037274807295,0.5161290322580645
5241,고현정/Noun,31,15,16,0.00016672965342462708,0.00017771064264611146,0.5161290322580645
5242,K/Alpha,31,15,16,0.00016672965342462708,0.00017771064264611146,0.5161290322580645
5243,을/Noun,31,15,16,0.00016672965342462708,0.00017771064264611146,0.5161290322580645
5244,대학교/Noun,31,16,15,0.00017784496365293555,0.0001666037274807295,0.5161290322580645
5245,천하/Noun,31,16,15,0.00017784496365293555,0.0001666037274807295,0.5161290322580645
5246,O/Alpha,31,15,16,0.00016672965342462708,0.00017771064264611146,0.5161290322580645
5247,난감하다/Adjective,30,1,29,1.1115310228308472e-05,0.00032210053979607705,0.9666666666666667
5248,흠뻑/Noun,30,29,1,0.0003223439966209457,1.1106915165381966e-05,0.9666666666666667
5249,난방/Noun,30,1,29,1.1115310228308472e-05,0.00032210053979607705,0.9666666666666667
5250,한물가다/Verb,30,2,28,2.2230620456616944e-05,0.00031099362463069506,0.9333333333333333
5251,중구/Noun,30,2,28,2.2230620456616944e-05,0.00031099362463069506,0.9333333333333333
5252,더러워지다/Verb,30,2,28,2.2230620456616944e-05,0.00031099362463069506,0.9333333333333333
5253,유승준/Noun,30,3,27,3.3345930684925414e-05,0.0002998867094653131,0.9
5254,망신/Noun,30,3,27,3.3345930684925414e-05,0.0002998867094653131,0.9
5255,인간미/Noun,30,26,4,0.00028899806593602026,4.4427660661527865e-05,0.8666666666666667
5256,무책임하다/Adjective,30,4,26,4.446124091323389e-05,0.00028877979429993113,0.8666666666666667
5257,안남다/Adjective,30,4,26,4.446124091323389e-05,0.00028877979429993113,0.8666666666666667
5258,진실되다/Adjective,30,26,4,0.00028899806593602026,4.4427660661527865e-05,0.8666666666666667
5259,괴/Noun,30,4,26,4.446124091323389e-05,0.00028877979429993113,0.8666666666666667
5260,무표정/Noun,30,5,25,5.557655114154236e-05,0.0002776728791345492,0.8333333333333334
5261,거도/Noun,30,6,24,6.669186136985083e-05,0.0002665659639691672,0.8
5262,영화음악/Noun,30,24,6,0.0002667674454794033,6.66414909922918e-05,0.8
5263,걸레/Noun,30,6,24,6.669186136985083e-05,0.0002665659639691672,0.8
5264,ㅁㅊ/KoreanParticle,30,6,24,6.669186136985083e-05,0.0002665659639691672,0.8
5265,쬐다/Verb,30,6,24,6.669186136985083e-05,0.0002665659639691672,0.8
5266,잠수함/Noun,30,24,6,0.0002667674454794033,6.66414909922918e-05,0.8
5267,관성/Noun,30,6,24,6.669186136985083e-05,0.0002665659639691672,0.8
5268,으으/Exclamation,30,6,24,6.669186136985083e-05,0.0002665659639691672,0.8
5269,패기/Noun,30,6,24,6.669186136985083e-05,0.0002665659639691672,0.8
5270,진주/Noun,30,24,6,0.0002667674454794033,6.66414909922918e-05,0.8
5271,은희/Noun,30,7,23,7.78071715981593e-05,0.0002554590488037852,0.7666666666666667
5272,미루다/Verb,30,23,7,0.00025565213525109487,7.774840615767377e-05,0.7666666666666667
5273,피하/Noun,30,7,23,7.78071715981593e-05,0.0002554590488037852,0.7666666666666667
5274,여고괴담/Noun,30,7,23,7.78071715981593e-05,0.0002554590488037852,0.7666666666666667
5275,콧물/Noun,30,23,7,0.00025565213525109487,7.774840615767377e-05,0.7666666666666667
5276,오점/Noun,30,8,22,8.892248182646778e-05,0.0002443521336384033,0.7333333333333333
5277,기념/Noun,30,8,22,8.892248182646778e-05,0.0002443521336384033,0.7333333333333333
5278,and/Alpha,30,22,8,0.00024453682502278637,8.885532132305573e-05,0.7333333333333333
5279,토이스토리/Noun,30,22,8,0.00024453682502278637,8.885532132305573e-05,0.7333333333333333
5280,교차/Noun,30,22,8,0.00024453682502278637,8.885532132305573e-05,0.7333333333333333
5281,나마/Josa,30,22,8,0.00024453682502278637,8.885532132305573e-05,0.7333333333333333
5282,평범/Noun,30,8,22,8.892248182646778e-05,0.0002443521336384033,0.7333333333333333
5283,무능하다/Adjective,30,9,21,0.00010003779205477625,0.0002332452184730213,0.7
5284,아야/Noun,30,9,21,0.00010003779205477625,0.0002332452184730213,0.7
5285,작업/Noun,30,9,21,0.00010003779205477625,0.0002332452184730213,0.7
5286,처벌/Noun,30,9,21,0.00010003779205477625,0.0002332452184730213,0.7
5287,구해/Noun,30,21,9,0.00023342151479447792,9.99622364884377e-05,0.7
5288,의존/Noun,30,9,21,0.00010003779205477625,0.0002332452184730213,0.7
5289,에너지/Noun,30,20,10,0.00022230620456616945,0.00011106915165381967,0.6666666666666666
5290,sbs/Alpha,30,10,20,0.00011115310228308472,0.00022213830330763935,0.6666666666666666
5291,안정/Noun,30,20,10,0.00022230620456616945,0.00011106915165381967,0.6666666666666666
5292,지능/Noun,30,10,20,0.00011115310228308472,0.00022213830330763935,0.6666666666666666
5293,조재현/Noun,30,20,10,0.00022230620456616945,0.00011106915165381967,0.6666666666666666
5294,축/Noun,30,10,20,0.00011115310228308472,0.00022213830330763935,0.6666666666666666
5295,간접/Noun,30,20,10,0.00022230620456616945,0.00011106915165381967,0.6666666666666666
5296,정적/Noun,30,20,10,0.00022230620456616945,0.00011106915165381967,0.6666666666666666
5297,로드무비/Noun,30,20,10,0.00022230620456616945,0.00011106915165381967,0.6666666666666666
5298,이종석/Noun,30,19,11,0.00021119089433786097,0.00012217606681920164,0.6333333333333333
5299,갱/Noun,30,11,19,0.00012226841251139318,0.00021103138814225738,0.6333333333333333
5300,도감/Noun,30,19,11,0.00021119089433786097,0.00012217606681920164,0.6333333333333333
5301,모델/Noun,30,11,19,0.00012226841251139318,0.00021103138814225738,0.6333333333333333
5302,웨슬리/Noun,30,11,19,0.00012226841251139318,0.00021103138814225738,0.6333333333333333
5303,모자/Noun,30,19,11,0.00021119089433786097,0.00012217606681920164,0.6333333333333333
5304,쾌감/Noun,30,19,11,0.00021119089433786097,0.00012217606681920164,0.6333333333333333
5305,안티/Noun,30,11,19,0.00012226841251139318,0.00021103138814225738,0.6333333333333333
5306,데이트/Noun,30,11,19,0.00012226841251139318,0.00021103138814225738,0.6333333333333333
5307,최진실/Noun,30,19,11,0.00021119089433786097,0.00012217606681920164,0.6333333333333333
5308,속상하다/Adjective,30,19,11,0.00021119089433786097,0.00012217606681920164,0.6333333333333333
5309,나비효과/Noun,30,12,18,0.00013338372273970166,0.0001999244729768754,0.6
5310,무심하다/Adjective,30,12,18,0.00013338372273970166,0.0001999244729768754,0.6
5311,두뇌/Noun,30,18,12,0.0002000755841095525,0.0001332829819845836,0.6
5312,스토리텔링/Noun,30,12,18,0.00013338372273970166,0.0001999244729768754,0.6
5313,평작/Noun,30,12,18,0.00013338372273970166,0.0001999244729768754,0.6
5314,묶다/Verb,30,12,18,0.00013338372273970166,0.0001999244729768754,0.6
5315,헛소리/Noun,30,12,18,0.00013338372273970166,0.0001999244729768754,0.6
5316,일본애니/Noun,30,18,12,0.0002000755841095525,0.0001332829819845836,0.6
5317,대니/Noun,30,18,12,0.0002000755841095525,0.0001332829819845836,0.6
5318,출동/Noun,30,12,18,0.00013338372273970166,0.0001999244729768754,0.6
5319,하여간/Adverb,30,12,18,0.00013338372273970166,0.0001999244729768754,0.6
5320,시스템/Noun,30,18,12,0.0002000755841095525,0.0001332829819845836,0.6
5321,유해진/Noun,30,18,12,0.0002000755841095525,0.0001332829819845836,0.6
5322,가문/Noun,30,12,18,0.00013338372273970166,0.0001999244729768754,0.6
5323,초능력/Noun,30,12,18,0.00013338372273970166,0.0001999244729768754,0.6
5324,그룹/Noun,30,12,18,0.00013338372273970166,0.0001999244729768754,0.6
5325,이승기/Noun,30,18,12,0.0002000755841095525,0.0001332829819845836,0.6
5326,각성/Noun,30,13,17,0.00014449903296801013,0.00018881755781149343,0.5666666666666667
5327,로사/Noun,30,17,13,0.00018896027388124403,0.00014438989714996557,0.5666666666666667
5328,자존심/Noun,30,17,13,0.00018896027388124403,0.00014438989714996557,0.5666666666666667
5329,번만/Noun,30,17,13,0.00018896027388124403,0.00014438989714996557,0.5666666666666667
5330,고향/Noun,30,13,17,0.00014449903296801013,0.00018881755781149343,0.5666666666666667
5331,뚫다/Verb,30,13,17,0.00014449903296801013,0.00018881755781149343,0.5666666666666667
5332,해안/Noun,30,13,17,0.00014449903296801013,0.00018881755781149343,0.5666666666666667
5333,퀄/Noun,30,17,13,0.00018896027388124403,0.00014438989714996557,0.5666666666666667
5334,이입/Noun,30,13,17,0.00014449903296801013,0.00018881755781149343,0.5666666666666667
5335,리언/Noun,30,17,13,0.00018896027388124403,0.00014438989714996557,0.5666666666666667
5336,에서부터/Josa,30,13,17,0.00014449903296801013,0.00018881755781149343,0.5666666666666667
5337,아트/Noun,30,17,13,0.00018896027388124403,0.00014438989714996557,0.5666666666666667
5338,안고/Noun,30,17,13,0.00018896027388124403,0.00014438989714996557,0.5666666666666667
5339,찍히다/Verb,30,14,16,0.0001556143431963186,0.00017771064264611146,0.5333333333333333
5340,식당/Noun,30,14,16,0.0001556143431963186,0.00017771064264611146,0.5333333333333333
5341,1%/Number,30,16,14,0.00017784496365293555,0.00015549681231534753,0.5333333333333333
5342,헐크/Noun,30,16,14,0.00017784496365293555,0.00015549681231534753,0.5333333333333333
5343,대판/Noun,30,16,14,0.00017784496365293555,0.00015549681231534753,0.5333333333333333
5344,봉태규/Noun,30,14,16,0.0001556143431963186,0.00017771064264611146,0.5333333333333333
5345,림/Noun,30,16,14,0.00017784496365293555,0.00015549681231534753,0.5333333333333333
5346,경제/Noun,30,14,16,0.0001556143431963186,0.00017771064264611146,0.5333333333333333
5347,악플/Noun,30,14,16,0.0001556143431963186,0.00017771064264611146,0.5333333333333333
5348,장쯔이/Noun,30,16,14,0.00017784496365293555,0.00015549681231534753,0.5333333333333333
5349,사의/Noun,30,16,14,0.00017784496365293555,0.00015549681231534753,0.5333333333333333
5350,아날로그/Noun,30,16,14,0.00017784496365293555,0.00015549681231534753,0.5333333333333333
5351,신동엽/Noun,30,15,15,0.00016672965342462708,0.0001666037274807295,0.5
5352,모건/Noun,30,15,15,0.00016672965342462708,0.0001666037274807295,0.5
5353,실체/Noun,30,15,15,0.00016672965342462708,0.0001666037274807295,0.5
5354,지속/Noun,30,15,15,0.00016672965342462708,0.0001666037274807295,0.5
5355,감싸다/Verb,30,15,15,0.00016672965342462708,0.0001666037274807295,0.5
5356,200/Number,30,15,15,0.00016672965342462708,0.0001666037274807295,0.5
5357,판타지영화/Noun,30,15,15,0.00016672965342462708,0.0001666037274807295,0.5
5358,주고/Foreign,29,1,28,1.1115310228308472e-05,0.00031099362463069506,0.9655172413793104
5359,맑다/Adjective,29,28,1,0.0003112286863926372,1.1106915165381966e-05,0.9655172413793104
5360,남아도/Noun,29,2,27,2.2230620456616944e-05,0.0002998867094653131,0.9310344827586207
5361,간신히/Adverb,29,2,27,2.2230620456616944e-05,0.0002998867094653131,0.9310344827586207
5362,거중/Noun,29,2,27,2.2230620456616944e-05,0.0002998867094653131,0.9310344827586207
5363,성질/Noun,29,2,27,2.2230620456616944e-05,0.0002998867094653131,0.9310344827586207
5364,MC/Alpha,29,3,26,3.3345930684925414e-05,0.00028877979429993113,0.896551724137931
5365,입가/Noun,29,26,3,0.00028899806593602026,3.33207454961459e-05,0.896551724137931
5366,취지/Noun,29,3,26,3.3345930684925414e-05,0.00028877979429993113,0.896551724137931
5367,말장난/Noun,29,3,26,3.3345930684925414e-05,0.00028877979429993113,0.896551724137931
5368,나소/Noun,29,4,25,4.446124091323389e-05,0.0002776728791345492,0.8620689655172413
5369,두서/Noun,29,4,25,4.446124091323389e-05,0.0002776728791345492,0.8620689655172413
5370,"..,,/Punctuation",29,4,25,4.446124091323389e-05,0.0002776728791345492,0.8620689655172413
5371,백미/Noun,29,25,4,0.0002778827557077118,4.4427660661527865e-05,0.8620689655172413
5372,미성년/Noun,29,4,25,4.446124091323389e-05,0.0002776728791345492,0.8620689655172413
5373,잡아먹다/Verb,29,4,25,4.446124091323389e-05,0.0002776728791345492,0.8620689655172413
5374,성냥/Noun,29,4,25,4.446124091323389e-05,0.0002776728791345492,0.8620689655172413
5375,전파/Noun,29,4,25,4.446124091323389e-05,0.0002776728791345492,0.8620689655172413
5376,틀어놓다/Verb,29,5,24,5.557655114154236e-05,0.0002665659639691672,0.8275862068965517
5377,김규리/Noun,29,5,24,5.557655114154236e-05,0.0002665659639691672,0.8275862068965517
5378,돌이키다/Verb,29,24,5,0.0002667674454794033,5.5534575826909837e-05,0.8275862068965517
5379,눈알/Noun,29,5,24,5.557655114154236e-05,0.0002665659639691672,0.8275862068965517
5380,좆/Noun,29,5,24,5.557655114154236e-05,0.0002665659639691672,0.8275862068965517
5381,으로의/Josa,29,24,5,0.0002667674454794033,5.5534575826909837e-05,0.8275862068965517
5382,똥폼/Noun,29,5,24,5.557655114154236e-05,0.0002665659639691672,0.8275862068965517
5383,통쾌/Noun,29,23,6,0.00025565213525109487,6.66414909922918e-05,0.7931034482758621
5384,퍼펙트/Noun,29,23,6,0.00025565213525109487,6.66414909922918e-05,0.7931034482758621
5385,’/Punctuation,29,6,23,6.669186136985083e-05,0.0002554590488037852,0.7931034482758621
5386,오늘날/Noun,29,23,6,0.00025565213525109487,6.66414909922918e-05,0.7931034482758621
5387,깜찍하다/Adjective,29,23,6,0.00025565213525109487,6.66414909922918e-05,0.7931034482758621
5388,사납다/Adjective,29,6,23,6.669186136985083e-05,0.0002554590488037852,0.7931034482758621
5389,대치/Noun,29,7,22,7.78071715981593e-05,0.0002443521336384033,0.7586206896551724
5390,엇어/Noun,29,22,7,0.00024453682502278637,7.774840615767377e-05,0.7586206896551724
5391,별반/Noun,29,7,22,7.78071715981593e-05,0.0002443521336384033,0.7586206896551724
5392,단막극/Noun,29,7,22,7.78071715981593e-05,0.0002443521336384033,0.7586206896551724
5393,조롱/Noun,29,7,22,7.78071715981593e-05,0.0002443521336384033,0.7586206896551724
5394,",.../Punctuation",29,7,22,7.78071715981593e-05,0.0002443521336384033,0.7586206896551724
5395,운전/Noun,29,7,22,7.78071715981593e-05,0.0002443521336384033,0.7586206896551724
5396,가왜/Noun,29,7,22,7.78071715981593e-05,0.0002443521336384033,0.7586206896551724
5397,사전/Noun,29,22,7,0.00024453682502278637,7.774840615767377e-05,0.7586206896551724
5398,몬/Noun,29,7,22,7.78071715981593e-05,0.0002443521336384033,0.7586206896551724
5399,찌들다/Verb,29,22,7,0.00024453682502278637,7.774840615767377e-05,0.7586206896551724
5400,인공/Noun,29,8,21,8.892248182646778e-05,0.0002332452184730213,0.7241379310344828
5401,뮤직/Noun,29,21,8,0.00023342151479447792,8.885532132305573e-05,0.7241379310344828
5402,사례/Noun,29,8,21,8.892248182646778e-05,0.0002332452184730213,0.7241379310344828
5403,신기/Noun,29,8,21,8.892248182646778e-05,0.0002332452184730213,0.7241379310344828
5404,-.-/Punctuation,29,8,21,8.892248182646778e-05,0.0002332452184730213,0.7241379310344828
5405,영화니/Noun,29,8,21,8.892248182646778e-05,0.0002332452184730213,0.7241379310344828
5406,☆/Foreign,29,21,8,0.00023342151479447792,8.885532132305573e-05,0.7241379310344828
5407,당한/Noun,29,8,21,8.892248182646778e-05,0.0002332452184730213,0.7241379310344828
5408,사로자다/Verb,29,21,8,0.00023342151479447792,8.885532132305573e-05,0.7241379310344828
5409,길들이다/Verb,29,21,8,0.00023342151479447792,8.885532132305573e-05,0.7241379310344828
5410,연민/Noun,29,20,9,0.00022230620456616945,9.99622364884377e-05,0.6896551724137931
5411,금발/Noun,29,9,20,0.00010003779205477625,0.00022213830330763935,0.6896551724137931
5412,치중/Noun,29,9,20,0.00010003779205477625,0.00022213830330763935,0.6896551724137931
5413,가위/Noun,29,9,20,0.00010003779205477625,0.00022213830330763935,0.6896551724137931
5414,짝사랑/Noun,29,20,9,0.00022230620456616945,9.99622364884377e-05,0.6896551724137931
5415,거들다/Verb,29,9,20,0.00010003779205477625,0.00022213830330763935,0.6896551724137931
5416,보물/Noun,29,20,9,0.00022230620456616945,9.99622364884377e-05,0.6896551724137931
5417,17/Number,29,19,10,0.00021119089433786097,0.00011106915165381967,0.6551724137931034
5418,여실히/Noun,29,10,19,0.00011115310228308472,0.00021103138814225738,0.6551724137931034
5419,타잔/Noun,29,10,19,0.00011115310228308472,0.00021103138814225738,0.6551724137931034
5420,토르/Noun,29,19,10,0.00021119089433786097,0.00011106915165381967,0.6551724137931034
5421,무도/Noun,29,10,19,0.00011115310228308472,0.00021103138814225738,0.6551724137931034
5422,이성/Noun,29,19,10,0.00021119089433786097,0.00011106915165381967,0.6551724137931034
5423,시원/Noun,29,19,10,0.00021119089433786097,0.00011106915165381967,0.6551724137931034
5424,보호/Noun,29,19,10,0.00021119089433786097,0.00011106915165381967,0.6551724137931034
5425,오기/Noun,29,10,19,0.00011115310228308472,0.00021103138814225738,0.6551724137931034
5426,시킴/Noun,29,10,19,0.00011115310228308472,0.00021103138814225738,0.6551724137931034
5427,해달라다/Verb,29,10,19,0.00011115310228308472,0.00021103138814225738,0.6551724137931034
5428,폭탄/Noun,29,10,19,0.00011115310228308472,0.00021103138814225738,0.6551724137931034
5429,파트너/Noun,29,11,18,0.00012226841251139318,0.0001999244729768754,0.6206896551724138
5430,우울증/Noun,29,11,18,0.00012226841251139318,0.0001999244729768754,0.6206896551724138
5431,어깨/Noun,29,18,11,0.0002000755841095525,0.00012217606681920164,0.6206896551724138
5432,어울림/Noun,29,18,11,0.0002000755841095525,0.00012217606681920164,0.6206896551724138
5433,힐/Noun,29,11,18,0.00012226841251139318,0.0001999244729768754,0.6206896551724138
5434,홈/Noun,29,11,18,0.00012226841251139318,0.0001999244729768754,0.6206896551724138
5435,병사/Noun,29,11,18,0.00012226841251139318,0.0001999244729768754,0.6206896551724138
5436,라이브/Noun,29,18,11,0.0002000755841095525,0.00012217606681920164,0.6206896551724138
5437,클루니/Noun,29,18,11,0.0002000755841095525,0.00012217606681920164,0.6206896551724138
5438,어긋나다/Verb,29,11,18,0.00012226841251139318,0.0001999244729768754,0.6206896551724138
5439,한몫/Noun,29,18,11,0.0002000755841095525,0.00012217606681920164,0.6206896551724138
5440,영호/Noun,29,18,11,0.0002000755841095525,0.00012217606681920164,0.6206896551724138
5441,이라기/Josa,29,11,18,0.00012226841251139318,0.0001999244729768754,0.6206896551724138
5442,벨/Modifier,29,11,18,0.00012226841251139318,0.0001999244729768754,0.6206896551724138
5443,수사/Noun,29,12,17,0.00013338372273970166,0.00018881755781149343,0.5862068965517241
5444,경쟁/Noun,29,17,12,0.00018896027388124403,0.0001332829819845836,0.5862068965517241
5445,백/Noun,29,12,17,0.00013338372273970166,0.00018881755781149343,0.5862068965517241
5446,한때/Adverb,29,17,12,0.00018896027388124403,0.0001332829819845836,0.5862068965517241
5447,‥/Foreign,29,17,12,0.00018896027388124403,0.0001332829819845836,0.5862068965517241
5448,퍼/Noun,29,12,17,0.00013338372273970166,0.00018881755781149343,0.5862068965517241
5449,원제/Noun,29,12,17,0.00013338372273970166,0.00018881755781149343,0.5862068965517241
5450,초심/Noun,29,12,17,0.00013338372273970166,0.00018881755781149343,0.5862068965517241
5451,삽입/Noun,29,12,17,0.00013338372273970166,0.00018881755781149343,0.5862068965517241
5452,건물/Noun,29,12,17,0.00013338372273970166,0.00018881755781149343,0.5862068965517241
5453,핫/Noun,29,17,12,0.00018896027388124403,0.0001332829819845836,0.5862068965517241
5454,로라/Noun,29,12,17,0.00013338372273970166,0.00018881755781149343,0.5862068965517241
5455,황/Noun,29,12,17,0.00013338372273970166,0.00018881755781149343,0.5862068965517241
5456,아메리칸/Noun,29,16,13,0.00017784496365293555,0.00014438989714996557,0.5517241379310345
5457,점임/Noun,29,13,16,0.00014449903296801013,0.00017771064264611146,0.5517241379310345
5458,주민/Noun,29,13,16,0.00014449903296801013,0.00017771064264611146,0.5517241379310345
5459,그림자/Noun,29,13,16,0.00014449903296801013,0.00017771064264611146,0.5517241379310345
5460,피로/Noun,29,13,16,0.00014449903296801013,0.00017771064264611146,0.5517241379310345
5461,선배/Noun,29,13,16,0.00014449903296801013,0.00017771064264611146,0.5517241379310345
5462,헤헤/Noun,29,13,16,0.00014449903296801013,0.00017771064264611146,0.5517241379310345
5463,세지/Noun,29,16,13,0.00017784496365293555,0.00014438989714996557,0.5517241379310345
5464,헬기/Noun,29,13,16,0.00014449903296801013,0.00017771064264611146,0.5517241379310345
5465,정글/Noun,29,14,15,0.0001556143431963186,0.0001666037274807295,0.5172413793103449
5466,전통/Noun,29,15,14,0.00016672965342462708,0.00015549681231534753,0.5172413793103449
5467,극도/Noun,29,14,15,0.0001556143431963186,0.0001666037274807295,0.5172413793103449
5468,대처/Noun,29,15,14,0.00016672965342462708,0.00015549681231534753,0.5172413793103449
5469,늘어나다/Verb,29,15,14,0.00016672965342462708,0.00015549681231534753,0.5172413793103449
5470,세라/Noun,29,14,15,0.0001556143431963186,0.0001666037274807295,0.5172413793103449
5471,디비디/Noun,29,15,14,0.00016672965342462708,0.00015549681231534753,0.5172413793103449
5472,ㅆ/KoreanParticle,29,14,15,0.0001556143431963186,0.0001666037274807295,0.5172413793103449
5473,이서/Noun,29,14,15,0.0001556143431963186,0.0001666037274807295,0.5172413793103449
5474,.'/Punctuation,29,15,14,0.00016672965342462708,0.00015549681231534753,0.5172413793103449
5475,대변/Noun,29,14,15,0.0001556143431963186,0.0001666037274807295,0.5172413793103449
5476,악인/Noun,29,14,15,0.0001556143431963186,0.0001666037274807295,0.5172413793103449
5477,블/Noun,29,14,15,0.0001556143431963186,0.0001666037274807295,0.5172413793103449
5478,단계/Noun,29,15,14,0.00016672965342462708,0.00015549681231534753,0.5172413793103449
5479,책임감/Noun,29,14,15,0.0001556143431963186,0.0001666037274807295,0.5172413793103449
5480,구림/Noun,28,0,28,0.0,0.00031099362463069506,1.0
5481,당췌/Noun,28,1,27,1.1115310228308472e-05,0.0002998867094653131,0.9642857142857143
5482,물결/Noun,28,26,2,0.00028899806593602026,2.2213830330763933e-05,0.9285714285714286
5483,날림/Noun,28,3,25,3.3345930684925414e-05,0.0002776728791345492,0.8928571428571429
5484,배슬기/Noun,28,3,25,3.3345930684925414e-05,0.0002776728791345492,0.8928571428571429
5485,통찰/Noun,28,24,4,0.0002667674454794033,4.4427660661527865e-05,0.8571428571428571
5486,천박하다/Adjective,28,4,24,4.446124091323389e-05,0.0002665659639691672,0.8571428571428571
5487,이면/Foreign,28,4,24,4.446124091323389e-05,0.0002665659639691672,0.8571428571428571
5488,추잡하다/Adjective,28,4,24,4.446124091323389e-05,0.0002665659639691672,0.8571428571428571
5489,결과물/Noun,28,4,24,4.446124091323389e-05,0.0002665659639691672,0.8571428571428571
5490,로맨스영화/Noun,28,24,4,0.0002667674454794033,4.4427660661527865e-05,0.8571428571428571
5491,늘어놓다/Verb,28,4,24,4.446124091323389e-05,0.0002665659639691672,0.8571428571428571
5492,봣습니/Noun,28,24,4,0.0002667674454794033,4.4427660661527865e-05,0.8571428571428571
5493,진부/Noun,28,5,23,5.557655114154236e-05,0.0002554590488037852,0.8214285714285714
5494,심은하/Noun,28,23,5,0.00025565213525109487,5.5534575826909837e-05,0.8214285714285714
5495,농락/Noun,28,5,23,5.557655114154236e-05,0.0002554590488037852,0.8214285714285714
5496,오열/Noun,28,23,5,0.00025565213525109487,5.5534575826909837e-05,0.8214285714285714
5497,주어지다/Verb,28,23,5,0.00025565213525109487,5.5534575826909837e-05,0.8214285714285714
5498,지못미/Noun,28,5,23,5.557655114154236e-05,0.0002554590488037852,0.8214285714285714
5499,i/Alpha,28,22,6,0.00024453682502278637,6.66414909922918e-05,0.7857142857142857
5500,해설/Noun,28,6,22,6.669186136985083e-05,0.0002443521336384033,0.7857142857142857
5501,좌좀/Noun,28,6,22,6.669186136985083e-05,0.0002443521336384033,0.7857142857142857
5502,남겨지다/Verb,28,22,6,0.00024453682502278637,6.66414909922918e-05,0.7857142857142857
5503,‘/Foreign,28,6,22,6.669186136985083e-05,0.0002443521336384033,0.7857142857142857
5504,아키라/Noun,28,21,7,0.00023342151479447792,7.774840615767377e-05,0.75
5505,폭파/Noun,28,7,21,7.78071715981593e-05,0.0002332452184730213,0.75
5506,빠져나오다/Verb,28,21,7,0.00023342151479447792,7.774840615767377e-05,0.75
5507,소유/Noun,28,21,7,0.00023342151479447792,7.774840615767377e-05,0.75
5508,파멸/Noun,28,21,7,0.00023342151479447792,7.774840615767377e-05,0.75
5509,보상/Noun,28,7,21,7.78071715981593e-05,0.0002332452184730213,0.75
5510,짐작/Noun,28,7,21,7.78071715981593e-05,0.0002332452184730213,0.75
5511,감우성/Noun,28,21,7,0.00023342151479447792,7.774840615767377e-05,0.75
5512,후의/Noun,28,21,7,0.00023342151479447792,7.774840615767377e-05,0.75
5513,거여/Noun,28,7,21,7.78071715981593e-05,0.0002332452184730213,0.75
5514,오묘하다/Adjective,28,21,7,0.00023342151479447792,7.774840615767377e-05,0.75
5515,조커/Noun,28,21,7,0.00023342151479447792,7.774840615767377e-05,0.75
5516,타이밍/Noun,28,7,21,7.78071715981593e-05,0.0002332452184730213,0.75
5517,스탤론/Noun,28,20,8,0.00022230620456616945,8.885532132305573e-05,0.7142857142857143
5518,느끼하다/Adjective,28,8,20,8.892248182646778e-05,0.00022213830330763935,0.7142857142857143
5519,시바/Noun,28,8,20,8.892248182646778e-05,0.00022213830330763935,0.7142857142857143
5520,고집/Noun,28,8,20,8.892248182646778e-05,0.00022213830330763935,0.7142857142857143
5521,이민호/Noun,28,20,8,0.00022230620456616945,8.885532132305573e-05,0.7142857142857143
5522,동참/Noun,28,8,20,8.892248182646778e-05,0.00022213830330763935,0.7142857142857143
5523,이모/Noun,28,20,8,0.00022230620456616945,8.885532132305573e-05,0.7142857142857143
5524,반면/Noun,28,8,20,8.892248182646778e-05,0.00022213830330763935,0.7142857142857143
5525,장만옥/Noun,28,20,8,0.00022230620456616945,8.885532132305573e-05,0.7142857142857143
5526,늑대인간/Noun,28,8,20,8.892248182646778e-05,0.00022213830330763935,0.7142857142857143
5527,이리저리/Adverb,28,8,20,8.892248182646778e-05,0.00022213830330763935,0.7142857142857143
5528,말리/Noun,28,8,20,8.892248182646778e-05,0.00022213830330763935,0.7142857142857143
5529,어메이징/Noun,28,19,9,0.00021119089433786097,9.99622364884377e-05,0.6785714285714286
5530,24/Number,28,19,9,0.00021119089433786097,9.99622364884377e-05,0.6785714285714286
5531,퀸/Noun,28,19,9,0.00021119089433786097,9.99622364884377e-05,0.6785714285714286
5532,예정/Noun,28,19,9,0.00021119089433786097,9.99622364884377e-05,0.6785714285714286
5533,노무/Noun,28,9,19,0.00010003779205477625,0.00021103138814225738,0.6785714285714286
5534,자료/Noun,28,19,9,0.00021119089433786097,9.99622364884377e-05,0.6785714285714286
5535,덤덤하다/Adjective,28,19,9,0.00021119089433786097,9.99622364884377e-05,0.6785714285714286
5536,권리/Noun,28,19,9,0.00021119089433786097,9.99622364884377e-05,0.6785714285714286
5537,스콜/Noun,28,19,9,0.00021119089433786097,9.99622364884377e-05,0.6785714285714286
5538,눈감다/Verb,28,9,19,0.00010003779205477625,0.00021103138814225738,0.6785714285714286
5539,o/Alpha,28,19,9,0.00021119089433786097,9.99622364884377e-05,0.6785714285714286
5540,화장/Noun,28,9,19,0.00010003779205477625,0.00021103138814225738,0.6785714285714286
5541,부리/Noun,28,10,18,0.00011115310228308472,0.0001999244729768754,0.6428571428571429
5542,장담/Noun,28,18,10,0.0002000755841095525,0.00011106915165381967,0.6428571428571429
5543,왕따/Noun,28,10,18,0.00011115310228308472,0.0001999244729768754,0.6428571428571429
5544,이야말로/Josa,28,18,10,0.0002000755841095525,0.00011106915165381967,0.6428571428571429
5545,서사시/Noun,28,18,10,0.0002000755841095525,0.00011106915165381967,0.6428571428571429
5546,오디션/Noun,28,10,18,0.00011115310228308472,0.0001999244729768754,0.6428571428571429
5547,아이리스/Noun,28,10,18,0.00011115310228308472,0.0001999244729768754,0.6428571428571429
5548,군데/Noun,28,10,18,0.00011115310228308472,0.0001999244729768754,0.6428571428571429
5549,지은/Noun,28,10,18,0.00011115310228308472,0.0001999244729768754,0.6428571428571429
5550,타이타닉/Noun,28,18,10,0.0002000755841095525,0.00011106915165381967,0.6428571428571429
5551,지난/Modifier,28,18,10,0.0002000755841095525,0.00011106915165381967,0.6428571428571429
5552,우베/Noun,28,10,18,0.00011115310228308472,0.0001999244729768754,0.6428571428571429
5553,인사/Noun,28,18,10,0.0002000755841095525,0.00011106915165381967,0.6428571428571429
5554,붙잡다/Verb,28,17,11,0.00018896027388124403,0.00012217606681920164,0.6071428571428571
5555,끓다/Verb,28,17,11,0.00018896027388124403,0.00012217606681920164,0.6071428571428571
5556,고급/Noun,28,17,11,0.00018896027388124403,0.00012217606681920164,0.6071428571428571
5557,털다/Verb,28,11,17,0.00012226841251139318,0.00018881755781149343,0.6071428571428571
5558,물들다/Verb,28,17,11,0.00018896027388124403,0.00012217606681920164,0.6071428571428571
5559,제레미/Noun,28,17,11,0.00018896027388124403,0.00012217606681920164,0.6071428571428571
5560,수년/Noun,28,17,11,0.00018896027388124403,0.00012217606681920164,0.6071428571428571
5561,엄태웅/Noun,28,11,17,0.00012226841251139318,0.00018881755781149343,0.6071428571428571
5562,다나/Noun,28,11,17,0.00012226841251139318,0.00018881755781149343,0.6071428571428571
5563,나오니/Noun,28,11,17,0.00012226841251139318,0.00018881755781149343,0.6071428571428571
5564,모니카/Noun,28,11,17,0.00012226841251139318,0.00018881755781149343,0.6071428571428571
5565,결투/Noun,28,17,11,0.00018896027388124403,0.00012217606681920164,0.6071428571428571
5566,미련/Noun,28,11,17,0.00012226841251139318,0.00018881755781149343,0.6071428571428571
5567,시네마/Noun,28,16,12,0.00017784496365293555,0.0001332829819845836,0.5714285714285714
5568,묵다/Verb,28,12,16,0.00013338372273970166,0.00017771064264611146,0.5714285714285714
5569,경기/Noun,28,16,12,0.00017784496365293555,0.0001332829819845836,0.5714285714285714
5570,풀이/Noun,28,12,16,0.00013338372273970166,0.00017771064264611146,0.5714285714285714
5571,이프/Noun,28,12,16,0.00013338372273970166,0.00017771064264611146,0.5714285714285714
5572,빠다/Noun,28,12,16,0.00013338372273970166,0.00017771064264611146,0.5714285714285714
5573,오름/Noun,28,16,12,0.00017784496365293555,0.0001332829819845836,0.5714285714285714
5574,눈높이/Noun,28,12,16,0.00013338372273970166,0.00017771064264611146,0.5714285714285714
5575,공기/Noun,28,16,12,0.00017784496365293555,0.0001332829819845836,0.5714285714285714
5576,일인/Noun,28,16,12,0.00017784496365293555,0.0001332829819845836,0.5714285714285714
5577,휴잭맨/Noun,28,12,16,0.00013338372273970166,0.00017771064264611146,0.5714285714285714
5578,참신/Noun,28,16,12,0.00017784496365293555,0.0001332829819845836,0.5714285714285714
5579,개방/Noun,28,12,16,0.00013338372273970166,0.00017771064264611146,0.5714285714285714
5580,깨어나다/Verb,28,12,16,0.00013338372273970166,0.00017771064264611146,0.5714285714285714
5581,안젤리나/Noun,28,13,15,0.00014449903296801013,0.0001666037274807295,0.5357142857142857
5582,저만/Modifier,28,13,15,0.00014449903296801013,0.0001666037274807295,0.5357142857142857
5583,문학/Noun,28,15,13,0.00016672965342462708,0.00014438989714996557,0.5357142857142857
5584,?)/Punctuation,28,15,13,0.00016672965342462708,0.00014438989714996557,0.5357142857142857
5585,비리/Noun,28,13,15,0.00014449903296801013,0.0001666037274807295,0.5357142857142857
5586,찢어지다/Verb,28,13,15,0.00014449903296801013,0.0001666037274807295,0.5357142857142857
5587,흡사하다/Adjective,28,15,13,0.00016672965342462708,0.00014438989714996557,0.5357142857142857
5588,결혼식/Noun,28,13,15,0.00014449903296801013,0.0001666037274807295,0.5357142857142857
5589,채민서/Noun,28,15,13,0.00016672965342462708,0.00014438989714996557,0.5357142857142857
5590,상승/Noun,28,13,15,0.00014449903296801013,0.0001666037274807295,0.5357142857142857
5591,2006년/Number,28,13,15,0.00014449903296801013,0.0001666037274807295,0.5357142857142857
5592,약속/Noun,28,15,13,0.00016672965342462708,0.00014438989714996557,0.5357142857142857
5593,톱/Noun,28,15,13,0.00016672965342462708,0.00014438989714996557,0.5357142857142857
5594,롭/Noun,28,15,13,0.00016672965342462708,0.00014438989714996557,0.5357142857142857
5595,세명/Noun,28,13,15,0.00014449903296801013,0.0001666037274807295,0.5357142857142857
5596,무방/Noun,28,13,15,0.00014449903296801013,0.0001666037274807295,0.5357142857142857
5597,다그/Noun,28,15,13,0.00016672965342462708,0.00014438989714996557,0.5357142857142857
5598,윌스미스/Noun,28,15,13,0.00016672965342462708,0.00014438989714996557,0.5357142857142857
5599,소원/Noun,28,13,15,0.00014449903296801013,0.0001666037274807295,0.5357142857142857
5600,but/Alpha,28,13,15,0.00014449903296801013,0.0001666037274807295,0.5357142857142857
5601,권선/Noun,28,13,15,0.00014449903296801013,0.0001666037274807295,0.5357142857142857
5602,사형/Noun,28,13,15,0.00014449903296801013,0.0001666037274807295,0.5357142857142857
5603,정신없이/Adverb,28,14,14,0.0001556143431963186,0.00015549681231534753,0.5
5604,"),/Punctuation",28,14,14,0.0001556143431963186,0.00015549681231534753,0.5
5605,자라/Noun,28,14,14,0.0001556143431963186,0.00015549681231534753,0.5
5606,남한/Noun,28,14,14,0.0001556143431963186,0.00015549681231534753,0.5
5607,공각기동대/Noun,28,14,14,0.0001556143431963186,0.00015549681231534753,0.5
5608,닥터/Noun,28,14,14,0.0001556143431963186,0.00015549681231534753,0.5
5609,미션임파서블/Noun,28,14,14,0.0001556143431963186,0.00015549681231534753,0.5
5610,에혀/Noun,27,1,26,1.1115310228308472e-05,0.00028877979429993113,0.9629629629629629
5611,술함/Noun,27,3,24,3.3345930684925414e-05,0.0002665659639691672,0.8888888888888888
5612,댓글알바/Noun,27,3,24,3.3345930684925414e-05,0.0002665659639691672,0.8888888888888888
5613,초보/Noun,27,3,24,3.3345930684925414e-05,0.0002665659639691672,0.8888888888888888
5614,쉣/Noun,27,3,24,3.3345930684925414e-05,0.0002665659639691672,0.8888888888888888
5615,맡기다/Verb,27,3,24,3.3345930684925414e-05,0.0002665659639691672,0.8888888888888888
5616,허망/Noun,27,4,23,4.446124091323389e-05,0.0002554590488037852,0.8518518518518519
5617,오오/Exclamation,27,23,4,0.00025565213525109487,4.4427660661527865e-05,0.8518518518518519
5618,맥락/Noun,27,4,23,4.446124091323389e-05,0.0002554590488037852,0.8518518518518519
5619,그리움/Noun,27,23,4,0.00025565213525109487,4.4427660661527865e-05,0.8518518518518519
5620,경지/Noun,27,23,4,0.00025565213525109487,4.4427660661527865e-05,0.8518518518518519
5621,제한/Noun,27,4,23,4.446124091323389e-05,0.0002554590488037852,0.8518518518518519
5622,사하나/Noun,27,23,4,0.00025565213525109487,4.4427660661527865e-05,0.8518518518518519
5623,푸른/Noun,27,23,4,0.00025565213525109487,4.4427660661527865e-05,0.8518518518518519
5624,알아주다/Verb,27,22,5,0.00024453682502278637,5.5534575826909837e-05,0.8148148148148148
5625,이정현/Noun,27,22,5,0.00024453682502278637,5.5534575826909837e-05,0.8148148148148148
5626,전용/Noun,27,5,22,5.557655114154236e-05,0.0002443521336384033,0.8148148148148148
5627,가상하다/Adjective,27,5,22,5.557655114154236e-05,0.0002443521336384033,0.8148148148148148
5628,맙소사/Exclamation,27,5,22,5.557655114154236e-05,0.0002443521336384033,0.8148148148148148
5629,훼손/Noun,27,5,22,5.557655114154236e-05,0.0002443521336384033,0.8148148148148148
5630,av/Alpha,27,5,22,5.557655114154236e-05,0.0002443521336384033,0.8148148148148148
5631,자칫/Noun,27,22,5,0.00024453682502278637,5.5534575826909837e-05,0.8148148148148148
5632,궁금/Noun,27,5,22,5.557655114154236e-05,0.0002443521336384033,0.8148148148148148
5633,--;/Punctuation,27,5,22,5.557655114154236e-05,0.0002443521336384033,0.8148148148148148
5634,자비/Noun,27,21,6,0.00023342151479447792,6.66414909922918e-05,0.7777777777777778
5635,본받다/Verb,27,21,6,0.00023342151479447792,6.66414909922918e-05,0.7777777777777778
5636,웨스턴/Noun,27,21,6,0.00023342151479447792,6.66414909922918e-05,0.7777777777777778
5637,피라냐/Noun,27,6,21,6.669186136985083e-05,0.0002332452184730213,0.7777777777777778
5638,비노/Noun,27,21,6,0.00023342151479447792,6.66414909922918e-05,0.7777777777777778
5639,헌신/Noun,27,21,6,0.00023342151479447792,6.66414909922918e-05,0.7777777777777778
5640,탐욕/Noun,27,21,6,0.00023342151479447792,6.66414909922918e-05,0.7777777777777778
5641,슬슬/Noun,27,6,21,6.669186136985083e-05,0.0002332452184730213,0.7777777777777778
5642,평화롭다/Adjective,27,21,6,0.00023342151479447792,6.66414909922918e-05,0.7777777777777778
5643,숨쉬다/Verb,27,21,6,0.00023342151479447792,6.66414909922918e-05,0.7777777777777778
5644,박유천/Noun,27,21,6,0.00023342151479447792,6.66414909922918e-05,0.7777777777777778
5645,삘/Noun,27,6,21,6.669186136985083e-05,0.0002332452184730213,0.7777777777777778
5646,과언/Noun,27,21,6,0.00023342151479447792,6.66414909922918e-05,0.7777777777777778
5647,지껄이다/Verb,27,7,20,7.78071715981593e-05,0.00022213830330763935,0.7407407407407407
5648,좌/Noun,27,20,7,0.00022230620456616945,7.774840615767377e-05,0.7407407407407407
5649,용하다/Adjective,27,7,20,7.78071715981593e-05,0.00022213830330763935,0.7407407407407407
5650,컬/Noun,27,20,7,0.00022230620456616945,7.774840615767377e-05,0.7407407407407407
5651,침대/Noun,27,7,20,7.78071715981593e-05,0.00022213830330763935,0.7407407407407407
5652,조선족/Noun,27,7,20,7.78071715981593e-05,0.00022213830330763935,0.7407407407407407
5653,성장기/Noun,27,20,7,0.00022230620456616945,7.774840615767377e-05,0.7407407407407407
5654,브로디/Noun,27,7,20,7.78071715981593e-05,0.00022213830330763935,0.7407407407407407
5655,치부/Noun,27,20,7,0.00022230620456616945,7.774840615767377e-05,0.7407407407407407
5656,치우다/Verb,27,7,20,7.78071715981593e-05,0.00022213830330763935,0.7407407407407407
5657,사이트/Noun,27,7,20,7.78071715981593e-05,0.00022213830330763935,0.7407407407407407
5658,구입/Noun,27,20,7,0.00022230620456616945,7.774840615767377e-05,0.7407407407407407
5659,자리/Suffix,27,7,20,7.78071715981593e-05,0.00022213830330763935,0.7407407407407407
5660,평타/Noun,27,7,20,7.78071715981593e-05,0.00022213830330763935,0.7407407407407407
5661,모니터/Noun,27,7,20,7.78071715981593e-05,0.00022213830330763935,0.7407407407407407
5662,일방/Noun,27,7,20,7.78071715981593e-05,0.00022213830330763935,0.7407407407407407
5663,가나다/Noun,27,7,20,7.78071715981593e-05,0.00022213830330763935,0.7407407407407407
5664,허준/Noun,27,20,7,0.00022230620456616945,7.774840615767377e-05,0.7407407407407407
5665,레저/Noun,27,19,8,0.00021119089433786097,8.885532132305573e-05,0.7037037037037037
5666,패스/Noun,27,8,19,8.892248182646778e-05,0.00021103138814225738,0.7037037037037037
5667,오싹하다/Adjective,27,19,8,0.00021119089433786097,8.885532132305573e-05,0.7037037037037037
5668,석/Noun,27,8,19,8.892248182646778e-05,0.00021103138814225738,0.7037037037037037
5669,종종/Noun,27,19,8,0.00021119089433786097,8.885532132305573e-05,0.7037037037037037
5670,쌓다/Verb,27,8,19,8.892248182646778e-05,0.00021103138814225738,0.7037037037037037
5671,모자라/Noun,27,8,19,8.892248182646778e-05,0.00021103138814225738,0.7037037037037037
5672,기절/Noun,27,8,19,8.892248182646778e-05,0.00021103138814225738,0.7037037037037037
5673,깔깔/Noun,27,18,9,0.0002000755841095525,9.99622364884377e-05,0.6666666666666666
5674,질린다/Verb,27,9,18,0.00010003779205477625,0.0001999244729768754,0.6666666666666666
5675,팬티/Noun,27,9,18,0.00010003779205477625,0.0001999244729768754,0.6666666666666666
5676,솜씨/Noun,27,18,9,0.0002000755841095525,9.99622364884377e-05,0.6666666666666666
5677,치닫다/Verb,27,9,18,0.00010003779205477625,0.0001999244729768754,0.6666666666666666
5678,이브/Noun,27,18,9,0.0002000755841095525,9.99622364884377e-05,0.6666666666666666
5679,최강희/Noun,27,18,9,0.0002000755841095525,9.99622364884377e-05,0.6666666666666666
5680,고릴라/Noun,27,9,18,0.00010003779205477625,0.0001999244729768754,0.6666666666666666
5681,꺄/Noun,27,18,9,0.0002000755841095525,9.99622364884377e-05,0.6666666666666666
5682,리치/Noun,27,18,9,0.0002000755841095525,9.99622364884377e-05,0.6666666666666666
5683,괜찬/Noun,27,18,9,0.0002000755841095525,9.99622364884377e-05,0.6666666666666666
5684,난생/Noun,27,9,18,0.00010003779205477625,0.0001999244729768754,0.6666666666666666
5685,삼촌/Noun,27,9,18,0.00010003779205477625,0.0001999244729768754,0.6666666666666666
5686,투쟁/Noun,27,18,9,0.0002000755841095525,9.99622364884377e-05,0.6666666666666666
5687,피어/Noun,27,18,9,0.0002000755841095525,9.99622364884377e-05,0.6666666666666666
5688,모드/Noun,27,10,17,0.00011115310228308472,0.00018881755781149343,0.6296296296296297
5689,사가/Noun,27,17,10,0.00018896027388124403,0.00011106915165381967,0.6296296296296297
5690,............../Punctuation,27,10,17,0.00011115310228308472,0.00018881755781149343,0.6296296296296297
5691,아일랜드/Noun,27,17,10,0.00018896027388124403,0.00011106915165381967,0.6296296296296297
5692,피어스/Noun,27,17,10,0.00018896027388124403,0.00011106915165381967,0.6296296296296297
5693,자시다/Verb,27,10,17,0.00011115310228308472,0.00018881755781149343,0.6296296296296297
5694,어쩐지/Noun,27,10,17,0.00011115310228308472,0.00018881755781149343,0.6296296296296297
5695,차인표/Noun,27,10,17,0.00011115310228308472,0.00018881755781149343,0.6296296296296297
5696,근육/Noun,27,17,10,0.00018896027388124403,0.00011106915165381967,0.6296296296296297
5697,명절/Noun,27,16,11,0.00017784496365293555,0.00012217606681920164,0.5925925925925926
5698,하나경/Noun,27,11,16,0.00012226841251139318,0.00017771064264611146,0.5925925925925926
5699,미인/Noun,27,16,11,0.00017784496365293555,0.00012217606681920164,0.5925925925925926
5700,준수/Noun,27,16,11,0.00017784496365293555,0.00012217606681920164,0.5925925925925926
5701,머물다/Verb,27,16,11,0.00017784496365293555,0.00012217606681920164,0.5925925925925926
5702,정유미/Noun,27,16,11,0.00017784496365293555,0.00012217606681920164,0.5925925925925926
5703,투입/Noun,27,11,16,0.00012226841251139318,0.00017771064264611146,0.5925925925925926
5704,지리/Noun,27,11,16,0.00012226841251139318,0.00017771064264611146,0.5925925925925926
5705,킴/Noun,27,16,11,0.00017784496365293555,0.00012217606681920164,0.5925925925925926
5706,유진/Noun,27,16,11,0.00017784496365293555,0.00012217606681920164,0.5925925925925926
5707,해드리다/Verb,27,16,11,0.00017784496365293555,0.00012217606681920164,0.5925925925925926
5708,오줌/Noun,27,11,16,0.00012226841251139318,0.00017771064264611146,0.5925925925925926
5709,만행/Noun,27,16,11,0.00017784496365293555,0.00012217606681920164,0.5925925925925926
5710,멘스/Noun,27,11,16,0.00012226841251139318,0.00017771064264611146,0.5925925925925926
5711,블록/Noun,27,16,11,0.00017784496365293555,0.00012217606681920164,0.5925925925925926
5712,만인/Noun,27,16,11,0.00017784496365293555,0.00012217606681920164,0.5925925925925926
5713,그날/Noun,27,16,11,0.00017784496365293555,0.00012217606681920164,0.5925925925925926
5714,초적/Noun,27,16,11,0.00017784496365293555,0.00012217606681920164,0.5925925925925926
5715,25/Number,27,16,11,0.00017784496365293555,0.00012217606681920164,0.5925925925925926
5716,기운/Noun,27,11,16,0.00012226841251139318,0.00017771064264611146,0.5925925925925926
5717,고기/Noun,27,16,11,0.00017784496365293555,0.00012217606681920164,0.5925925925925926
5718,윤리/Noun,27,15,12,0.00016672965342462708,0.0001332829819845836,0.5555555555555556
5719,보수/Noun,27,12,15,0.00013338372273970166,0.0001666037274807295,0.5555555555555556
5720,클래스/Noun,27,15,12,0.00016672965342462708,0.0001332829819845836,0.5555555555555556
5721,이제껏/Noun,27,12,15,0.00013338372273970166,0.0001666037274807295,0.5555555555555556
5722,조기/Noun,27,12,15,0.00013338372273970166,0.0001666037274807295,0.5555555555555556
5723,이중/Noun,27,12,15,0.00013338372273970166,0.0001666037274807295,0.5555555555555556
5724,쓰나미/Noun,27,15,12,0.00016672965342462708,0.0001332829819845836,0.5555555555555556
5725,여진구/Noun,27,15,12,0.00016672965342462708,0.0001332829819845836,0.5555555555555556
5726,최대한/Noun,27,12,15,0.00013338372273970166,0.0001666037274807295,0.5555555555555556
5727,도나/Noun,27,15,12,0.00016672965342462708,0.0001332829819845836,0.5555555555555556
5728,유역비/Noun,27,12,15,0.00013338372273970166,0.0001666037274807295,0.5555555555555556
5729,나비/Noun,27,12,15,0.00013338372273970166,0.0001666037274807295,0.5555555555555556
5730,마피아/Noun,27,12,15,0.00013338372273970166,0.0001666037274807295,0.5555555555555556
5731,알리/Noun,27,12,15,0.00013338372273970166,0.0001666037274807295,0.5555555555555556
5732,딱딱하다/Adjective,27,12,15,0.00013338372273970166,0.0001666037274807295,0.5555555555555556
5733,추석/Noun,27,15,12,0.00016672965342462708,0.0001332829819845836,0.5555555555555556
5734,로나/Noun,27,12,15,0.00013338372273970166,0.0001666037274807295,0.5555555555555556
5735,황제/Noun,27,13,14,0.00014449903296801013,0.00015549681231534753,0.5185185185185185
5736,이치/Noun,27,14,13,0.0001556143431963186,0.00014438989714996557,0.5185185185185185
5737,안소니/Noun,27,14,13,0.0001556143431963186,0.00014438989714996557,0.5185185185185185
5738,죠스/Noun,27,14,13,0.0001556143431963186,0.00014438989714996557,0.5185185185185185
5739,1000/Number,27,14,13,0.0001556143431963186,0.00014438989714996557,0.5185185185185185
5740,^^;;/Punctuation,27,14,13,0.0001556143431963186,0.00014438989714996557,0.5185185185185185
5741,대기업/Noun,27,13,14,0.00014449903296801013,0.00015549681231534753,0.5185185185185185
5742,적도/Noun,27,13,14,0.00014449903296801013,0.00015549681231534753,0.5185185185185185
5743,비행/Noun,27,14,13,0.0001556143431963186,0.00014438989714996557,0.5185185185185185
5744,카드/Noun,27,14,13,0.0001556143431963186,0.00014438989714996557,0.5185185185185185
5745,모름/Noun,27,14,13,0.0001556143431963186,0.00014438989714996557,0.5185185185185185
5746,하리/Noun,27,13,14,0.00014449903296801013,0.00015549681231534753,0.5185185185185185
5747,재판/Noun,27,14,13,0.0001556143431963186,0.00014438989714996557,0.5185185185185185
5748,드래곤/Noun,27,13,14,0.00014449903296801013,0.00015549681231534753,0.5185185185185185
5749,제도/Noun,27,13,14,0.00014449903296801013,0.00015549681231534753,0.5185185185185185
5750,이스라엘/Noun,27,13,14,0.00014449903296801013,0.00015549681231534753,0.5185185185185185
5751,14/Number,27,14,13,0.0001556143431963186,0.00014438989714996557,0.5185185185185185
5752,세력/Noun,27,13,14,0.00014449903296801013,0.00015549681231534753,0.5185185185185185
5753,안드로메다/Noun,26,0,26,0.0,0.00028877979429993113,1.0
5754,돌림/Noun,26,1,25,1.1115310228308472e-05,0.0002776728791345492,0.9615384615384616
5755,불우/Noun,26,1,25,1.1115310228308472e-05,0.0002776728791345492,0.9615384615384616
5756,녹이다/Verb,26,25,1,0.0002778827557077118,1.1106915165381966e-05,0.9615384615384616
5757,한시/Noun,26,25,1,0.0002778827557077118,1.1106915165381966e-05,0.9615384615384616
5758,무리하다/Adjective,26,1,25,1.1115310228308472e-05,0.0002776728791345492,0.9615384615384616
5759,맘대로/Adverb,26,2,24,2.2230620456616944e-05,0.0002665659639691672,0.9230769230769231
5760,싸가지/Noun,26,2,24,2.2230620456616944e-05,0.0002665659639691672,0.9230769230769231
5761,니미/Noun,26,2,24,2.2230620456616944e-05,0.0002665659639691672,0.9230769230769231
5762,!!!!!!!!!/Punctuation,26,23,3,0.00025565213525109487,3.33207454961459e-05,0.8846153846153846
5763,해학/Noun,26,23,3,0.00025565213525109487,3.33207454961459e-05,0.8846153846153846
5764,정신병원/Noun,26,3,23,3.3345930684925414e-05,0.0002554590488037852,0.8846153846153846
5765,괴상하다/Adjective,26,4,22,4.446124091323389e-05,0.0002443521336384033,0.8461538461538461
5766,。/Foreign,26,22,4,0.00024453682502278637,4.4427660661527865e-05,0.8461538461538461
5767,저건/Noun,26,4,22,4.446124091323389e-05,0.0002443521336384033,0.8461538461538461
5768,사랑받다/Verb,26,22,4,0.00024453682502278637,4.4427660661527865e-05,0.8461538461538461
5769,비용/Noun,26,4,22,4.446124091323389e-05,0.0002443521336384033,0.8461538461538461
5770,침략/Noun,26,4,22,4.446124091323389e-05,0.0002443521336384033,0.8461538461538461
5771,매년/Noun,26,22,4,0.00024453682502278637,4.4427660661527865e-05,0.8461538461538461
5772,하루하루/Noun,26,22,4,0.00024453682502278637,4.4427660661527865e-05,0.8461538461538461
5773,걸왜/Noun,26,4,22,4.446124091323389e-05,0.0002443521336384033,0.8461538461538461
5774,절용/Noun,26,4,22,4.446124091323389e-05,0.0002443521336384033,0.8461538461538461
5775,9년/Number,26,22,4,0.00024453682502278637,4.4427660661527865e-05,0.8461538461538461
5776,장진영/Noun,26,21,5,0.00023342151479447792,5.5534575826909837e-05,0.8076923076923077
5777,드라마틱하다/Adjective,26,21,5,0.00023342151479447792,5.5534575826909837e-05,0.8076923076923077
5778,쯧/Adverb,26,5,21,5.557655114154236e-05,0.0002332452184730213,0.8076923076923077
5779,류덕환/Noun,26,21,5,0.00023342151479447792,5.5534575826909837e-05,0.8076923076923077
5780,징징대다/Adjective,26,5,21,5.557655114154236e-05,0.0002332452184730213,0.8076923076923077
5781,만원/Noun,26,5,21,5.557655114154236e-05,0.0002332452184730213,0.8076923076923077
5782,나열하다/Adjective,26,5,21,5.557655114154236e-05,0.0002332452184730213,0.8076923076923077
5783,피터팬/Noun,26,21,5,0.00023342151479447792,5.5534575826909837e-05,0.8076923076923077
5784,답습/Noun,26,5,21,5.557655114154236e-05,0.0002332452184730213,0.8076923076923077
5785,싸이/Noun,26,6,20,6.669186136985083e-05,0.00022213830330763935,0.7692307692307693
5786,코너/Noun,26,6,20,6.669186136985083e-05,0.00022213830330763935,0.7692307692307693
5787,50분/Number,26,6,20,6.669186136985083e-05,0.00022213830330763935,0.7692307692307693
5788,편지/Noun,26,20,6,0.00022230620456616945,6.66414909922918e-05,0.7692307692307693
5789,봉준호/Noun,26,20,6,0.00022230620456616945,6.66414909922918e-05,0.7692307692307693
5790,퇴보하다/Adjective,26,6,20,6.669186136985083e-05,0.00022213830330763935,0.7692307692307693
5791,z/Alpha,26,6,20,6.669186136985083e-05,0.00022213830330763935,0.7692307692307693
5792,한잔/Noun,26,20,6,0.00022230620456616945,6.66414909922918e-05,0.7692307692307693
5793,쌤/Noun,26,20,6,0.00022230620456616945,6.66414909922918e-05,0.7692307692307693
5794,살해/Noun,26,6,20,6.669186136985083e-05,0.00022213830330763935,0.7692307692307693
5795,하든/Noun,26,6,20,6.669186136985083e-05,0.00022213830330763935,0.7692307692307693
5796,주어/Noun,26,20,6,0.00022230620456616945,6.66414909922918e-05,0.7692307692307693
5797,흐흐/Noun,26,19,7,0.00021119089433786097,7.774840615767377e-05,0.7307692307692307
5798,진도/Noun,26,7,19,7.78071715981593e-05,0.00021103138814225738,0.7307692307692307
5799,ㅈㄹ/KoreanParticle,26,7,19,7.78071715981593e-05,0.00021103138814225738,0.7307692307692307
5800,메릴/Noun,26,19,7,0.00021119089433786097,7.774840615767377e-05,0.7307692307692307
5801,주제곡/Noun,26,19,7,0.00021119089433786097,7.774840615767377e-05,0.7307692307692307
5802,심심/Noun,26,7,19,7.78071715981593e-05,0.00021103138814225738,0.7307692307692307
5803,선입견/Noun,26,19,7,0.00021119089433786097,7.774840615767377e-05,0.7307692307692307
5804,형태/Noun,26,19,7,0.00021119089433786097,7.774840615767377e-05,0.7307692307692307
5805,한수/Noun,26,19,7,0.00021119089433786097,7.774840615767377e-05,0.7307692307692307
5806,재벌/Noun,26,7,19,7.78071715981593e-05,0.00021103138814225738,0.7307692307692307
5807,부영/Noun,26,18,8,0.0002000755841095525,8.885532132305573e-05,0.6923076923076923
5808,.............../Punctuation,26,8,18,8.892248182646778e-05,0.0001999244729768754,0.6923076923076923
5809,닌자/Noun,26,8,18,8.892248182646778e-05,0.0001999244729768754,0.6923076923076923
5810,얕다/Adjective,26,8,18,8.892248182646778e-05,0.0001999244729768754,0.6923076923076923
5811,1.2/Number,26,18,8,0.0002000755841095525,8.885532132305573e-05,0.6923076923076923
5812,잘리다/Verb,26,8,18,8.892248182646778e-05,0.0001999244729768754,0.6923076923076923
5813,기네/Noun,26,8,18,8.892248182646778e-05,0.0001999244729768754,0.6923076923076923
5814,맞서다/Verb,26,18,8,0.0002000755841095525,8.885532132305573e-05,0.6923076923076923
5815,나뉘다/Verb,26,17,9,0.00018896027388124403,9.99622364884377e-05,0.6538461538461539
5816,키스신/Noun,26,17,9,0.00018896027388124403,9.99622364884377e-05,0.6538461538461539
5817,반지의제왕/Noun,26,17,9,0.00018896027388124403,9.99622364884377e-05,0.6538461538461539
5818,올인/Noun,26,17,9,0.00018896027388124403,9.99622364884377e-05,0.6538461538461539
5819,so/Alpha,26,17,9,0.00018896027388124403,9.99622364884377e-05,0.6538461538461539
5820,회의/Noun,26,9,17,0.00010003779205477625,0.00018881755781149343,0.6538461538461539
5821,어요/Noun,26,17,9,0.00018896027388124403,9.99622364884377e-05,0.6538461538461539
5822,시간여행/Noun,26,17,9,0.00018896027388124403,9.99622364884377e-05,0.6538461538461539
5823,김래원/Noun,26,17,9,0.00018896027388124403,9.99622364884377e-05,0.6538461538461539
5824,원한/Noun,26,9,17,0.00010003779205477625,0.00018881755781149343,0.6538461538461539
5825,해리/Noun,26,17,9,0.00018896027388124403,9.99622364884377e-05,0.6538461538461539
5826,수지/Noun,26,17,9,0.00018896027388124403,9.99622364884377e-05,0.6538461538461539
5827,여고생/Noun,26,10,16,0.00011115310228308472,0.00017771064264611146,0.6153846153846154
5828,디아즈/Noun,26,10,16,0.00011115310228308472,0.00017771064264611146,0.6153846153846154
5829,순정/Noun,26,16,10,0.00017784496365293555,0.00011106915165381967,0.6153846153846154
5830,위선/Noun,26,10,16,0.00011115310228308472,0.00017771064264611146,0.6153846153846154
5831,no/Alpha,26,10,16,0.00011115310228308472,0.00017771064264611146,0.6153846153846154
5832,98년/Number,26,16,10,0.00017784496365293555,0.00011106915165381967,0.6153846153846154
5833,맛보다/Verb,26,16,10,0.00017784496365293555,0.00011106915165381967,0.6153846153846154
5834,유이/Noun,26,16,10,0.00017784496365293555,0.00011106915165381967,0.6153846153846154
5835,앨리스/Noun,26,16,10,0.00017784496365293555,0.00011106915165381967,0.6153846153846154
5836,씻다/Verb,26,10,16,0.00011115310228308472,0.00017771064264611146,0.6153846153846154
5837,이뿌다/Adjective,26,16,10,0.00017784496365293555,0.00011106915165381967,0.6153846153846154
5838,질감/Noun,26,10,16,0.00011115310228308472,0.00017771064264611146,0.6153846153846154
5839,잉여/Noun,26,10,16,0.00011115310228308472,0.00017771064264611146,0.6153846153846154
5840,돕다/Verb,26,10,16,0.00011115310228308472,0.00017771064264611146,0.6153846153846154
5841,알고싶다/Noun,26,10,16,0.00011115310228308472,0.00017771064264611146,0.6153846153846154
5842,추적/Noun,26,10,16,0.00011115310228308472,0.00017771064264611146,0.6153846153846154
5843,블루레이/Noun,26,16,10,0.00017784496365293555,0.00011106915165381967,0.6153846153846154
5844,부각/Noun,26,10,16,0.00011115310228308472,0.00017771064264611146,0.6153846153846154
5845,이요원/Noun,26,10,16,0.00011115310228308472,0.00017771064264611146,0.6153846153846154
5846,서사/Noun,26,11,15,0.00012226841251139318,0.0001666037274807295,0.5769230769230769
5847,일일/Noun,26,11,15,0.00012226841251139318,0.0001666037274807295,0.5769230769230769
5848,닥치다/Verb,26,11,15,0.00012226841251139318,0.0001666037274807295,0.5769230769230769
5849,도도/Noun,26,11,15,0.00012226841251139318,0.0001666037274807295,0.5769230769230769
5850,스칼렛/Noun,26,15,11,0.00016672965342462708,0.00012217606681920164,0.5769230769230769
5851,변/Noun,26,15,11,0.00016672965342462708,0.00012217606681920164,0.5769230769230769
5852,와이어/Noun,26,11,15,0.00012226841251139318,0.0001666037274807295,0.5769230769230769
5853,2007년/Number,26,15,11,0.00016672965342462708,0.00012217606681920164,0.5769230769230769
5854,왤다/Verb,26,11,15,0.00012226841251139318,0.0001666037274807295,0.5769230769230769
5855,증오/Noun,26,15,11,0.00016672965342462708,0.00012217606681920164,0.5769230769230769
5856,스틱/Noun,26,11,15,0.00012226841251139318,0.0001666037274807295,0.5769230769230769
5857,신지/Noun,26,11,15,0.00012226841251139318,0.0001666037274807295,0.5769230769230769
5858,미사일/Noun,26,11,15,0.00012226841251139318,0.0001666037274807295,0.5769230769230769
5859,상업성/Noun,26,11,15,0.00012226841251139318,0.0001666037274807295,0.5769230769230769
5860,암시/Noun,26,11,15,0.00012226841251139318,0.0001666037274807295,0.5769230769230769
5861,웨이/Noun,26,15,11,0.00016672965342462708,0.00012217606681920164,0.5769230769230769
5862,다듬다/Verb,26,11,15,0.00012226841251139318,0.0001666037274807295,0.5769230769230769
5863,에디/Noun,26,11,15,0.00012226841251139318,0.0001666037274807295,0.5769230769230769
5864,클럽/Noun,26,15,11,0.00016672965342462708,0.00012217606681920164,0.5769230769230769
5865,기원/Noun,26,14,12,0.0001556143431963186,0.0001332829819845836,0.5384615384615384
5866,2014/Number,26,14,12,0.0001556143431963186,0.0001332829819845836,0.5384615384615384
5867,블레이드/Noun,26,12,14,0.00013338372273970166,0.00015549681231534753,0.5384615384615384
5868,데스노트/Noun,26,12,14,0.00013338372273970166,0.00015549681231534753,0.5384615384615384
5869,정돈/Noun,26,14,12,0.0001556143431963186,0.0001332829819845836,0.5384615384615384
5870,대세/Noun,26,14,12,0.0001556143431963186,0.0001332829819845836,0.5384615384615384
5871,개봉관/Noun,26,12,14,0.00013338372273970166,0.00015549681231534753,0.5384615384615384
5872,안녕하다/Adjective,26,14,12,0.0001556143431963186,0.0001332829819845836,0.5384615384615384
5873,인성/Noun,26,12,14,0.00013338372273970166,0.00015549681231534753,0.5384615384615384
5874,터뜨리다/Verb,26,14,12,0.0001556143431963186,0.0001332829819845836,0.5384615384615384
5875,고래/Noun,26,12,14,0.00013338372273970166,0.00015549681231534753,0.5384615384615384
5876,비꼬다/Verb,26,14,12,0.0001556143431963186,0.0001332829819845836,0.5384615384615384
5877,힘겹다/Adjective,26,12,14,0.00013338372273970166,0.00015549681231534753,0.5384615384615384
5878,깃/Noun,26,14,12,0.0001556143431963186,0.0001332829819845836,0.5384615384615384
5879,엥/Exclamation,26,12,14,0.00013338372273970166,0.00015549681231534753,0.5384615384615384
5880,피부/Noun,26,13,13,0.00014449903296801013,0.00014438989714996557,0.5
5881,생일/Noun,26,13,13,0.00014449903296801013,0.00014438989714996557,0.5
5882,명예/Noun,26,13,13,0.00014449903296801013,0.00014438989714996557,0.5
5883,사막/Noun,26,13,13,0.00014449903296801013,0.00014438989714996557,0.5
5884,고고/Noun,26,13,13,0.00014449903296801013,0.00014438989714996557,0.5
5885,굿바이/Noun,26,13,13,0.00014449903296801013,0.00014438989714996557,0.5
5886,성동일/Noun,26,13,13,0.00014449903296801013,0.00014438989714996557,0.5
5887,것임/Noun,26,13,13,0.00014449903296801013,0.00014438989714996557,0.5
5888,죄책감/Noun,26,13,13,0.00014449903296801013,0.00014438989714996557,0.5
5889,엮/Noun,26,13,13,0.00014449903296801013,0.00014438989714996557,0.5
5890,Bad/Alpha,25,1,24,1.1115310228308472e-05,0.0002665659639691672,0.96
5891,꾸밈/Noun,25,24,1,0.0002667674454794033,1.1106915165381966e-05,0.96
5892,쏠쏠하다/Adjective,25,24,1,0.0002667674454794033,1.1106915165381966e-05,0.96
5893,기부/Noun,25,1,24,1.1115310228308472e-05,0.0002665659639691672,0.96
5894,ㅅㄱ/KoreanParticle,25,2,23,2.2230620456616944e-05,0.0002554590488037852,0.92
5895,인피니트/Noun,25,23,2,0.00025565213525109487,2.2213830330763933e-05,0.92
5896,부실/Noun,25,2,23,2.2230620456616944e-05,0.0002554590488037852,0.92
5897,오래오래/Noun,25,23,2,0.00025565213525109487,2.2213830330763933e-05,0.92
5898,탄탄/Noun,25,23,2,0.00025565213525109487,2.2213830330763933e-05,0.92
5899,조잡/Noun,25,2,23,2.2230620456616944e-05,0.0002554590488037852,0.92
5900,지망/Noun,25,3,22,3.3345930684925414e-05,0.0002443521336384033,0.88
5901,예상외/Noun,25,22,3,0.00024453682502278637,3.33207454961459e-05,0.88
5902,클릭/Noun,25,3,22,3.3345930684925414e-05,0.0002443521336384033,0.88
5903,?./Punctuation,25,3,22,3.3345930684925414e-05,0.0002443521336384033,0.88
5904,같잖다/Adjective,25,3,22,3.3345930684925414e-05,0.0002443521336384033,0.88
5905,ㅡㅡㅋ/KoreanParticle,25,4,21,4.446124091323389e-05,0.0002332452184730213,0.84
5906,윽/Noun,25,4,21,4.446124091323389e-05,0.0002332452184730213,0.84
5907,훌륭/Noun,25,21,4,0.00023342151479447792,4.4427660661527865e-05,0.84
5908,엠씨/Noun,25,4,21,4.446124091323389e-05,0.0002332452184730213,0.84
5909,쿠바/Noun,25,21,4,0.00023342151479447792,4.4427660661527865e-05,0.84
5910,축복/Noun,25,21,4,0.00023342151479447792,4.4427660661527865e-05,0.84
5911,온건/Noun,25,4,21,4.446124091323389e-05,0.0002332452184730213,0.84
5912,4000원/Number,25,4,21,4.446124091323389e-05,0.0002332452184730213,0.84
5913,붕/Noun,25,4,21,4.446124091323389e-05,0.0002332452184730213,0.84
5914,...-_-/Punctuation,25,5,20,5.557655114154236e-05,0.00022213830330763935,0.8
5915,양산/Noun,25,5,20,5.557655114154236e-05,0.00022213830330763935,0.8
5916,슬로우/Noun,25,5,20,5.557655114154236e-05,0.00022213830330763935,0.8
5917,바램/Noun,25,20,5,0.00022230620456616945,5.5534575826909837e-05,0.8
5918,쩔어요/Noun,25,20,5,0.00022230620456616945,5.5534575826909837e-05,0.8
5919,썅/Noun,25,5,20,5.557655114154236e-05,0.00022213830330763935,0.8
5920,-_/Punctuation,25,5,20,5.557655114154236e-05,0.00022213830330763935,0.8
5921,아이디/Noun,25,5,20,5.557655114154236e-05,0.00022213830330763935,0.8
5922,따오다/Verb,25,5,20,5.557655114154236e-05,0.00022213830330763935,0.8
5923,97년/Number,25,20,5,0.00022230620456616945,5.5534575826909837e-05,0.8
5924,소방관/Noun,25,20,5,0.00022230620456616945,5.5534575826909837e-05,0.8
5925,붕괴/Noun,25,5,20,5.557655114154236e-05,0.00022213830330763935,0.8
5926,멸망/Noun,25,6,19,6.669186136985083e-05,0.00021103138814225738,0.76
5927,된장녀/Noun,25,6,19,6.669186136985083e-05,0.00021103138814225738,0.76
5928,진가/Noun,25,19,6,0.00021119089433786097,6.66414909922918e-05,0.76
5929,고갈/Noun,25,6,19,6.669186136985083e-05,0.00021103138814225738,0.76
5930,브금/Noun,25,19,6,0.00021119089433786097,6.66414909922918e-05,0.76
5931,서양인/Noun,25,6,19,6.669186136985083e-05,0.00021103138814225738,0.76
5932,요란하다/Adjective,25,6,19,6.669186136985083e-05,0.00021103138814225738,0.76
5933,억압/Noun,25,19,6,0.00021119089433786097,6.66414909922918e-05,0.76
5934,김승우/Noun,25,6,19,6.669186136985083e-05,0.00021103138814225738,0.76
5935,1980년/Number,25,6,19,6.669186136985083e-05,0.00021103138814225738,0.76
5936,자전거/Noun,25,19,6,0.00021119089433786097,6.66414909922918e-05,0.76
5937,껍데기/Noun,25,7,18,7.78071715981593e-05,0.0001999244729768754,0.72
5938,정상인/Noun,25,7,18,7.78071715981593e-05,0.0001999244729768754,0.72
5939,멘트/Noun,25,7,18,7.78071715981593e-05,0.0001999244729768754,0.72
5940,k/Alpha,25,7,18,7.78071715981593e-05,0.0001999244729768754,0.72
5941,분투/Noun,25,7,18,7.78071715981593e-05,0.0001999244729768754,0.72
5942,첩보물/Noun,25,18,7,0.0002000755841095525,7.774840615767377e-05,0.72
5943,건달/Noun,25,7,18,7.78071715981593e-05,0.0001999244729768754,0.72
5944,윤발/Noun,25,7,18,7.78071715981593e-05,0.0001999244729768754,0.72
5945,제국주의/Noun,25,7,18,7.78071715981593e-05,0.0001999244729768754,0.72
5946,바사/Noun,25,7,18,7.78071715981593e-05,0.0001999244729768754,0.72
5947,애국/Noun,25,7,18,7.78071715981593e-05,0.0001999244729768754,0.72
5948,집합/Noun,25,8,17,8.892248182646778e-05,0.00018881755781149343,0.68
5949,삼국지/Noun,25,8,17,8.892248182646778e-05,0.00018881755781149343,0.68
5950,별개/Noun,25,8,17,8.892248182646778e-05,0.00018881755781149343,0.68
5951,분류/Noun,25,8,17,8.892248182646778e-05,0.00018881755781149343,0.68
5952,마셈/Noun,25,8,17,8.892248182646778e-05,0.00018881755781149343,0.68
5953,단말/Noun,25,8,17,8.892248182646778e-05,0.00018881755781149343,0.68
5954,러브레터/Noun,25,17,8,0.00018896027388124403,8.885532132305573e-05,0.68
5955,헌/Modifier,25,17,8,0.00018896027388124403,8.885532132305573e-05,0.68
5956,중견/Noun,25,8,17,8.892248182646778e-05,0.00018881755781149343,0.68
5957,박스/Noun,25,8,17,8.892248182646778e-05,0.00018881755781149343,0.68
5958,구지/Noun,25,8,17,8.892248182646778e-05,0.00018881755781149343,0.68
5959,No/Alpha,25,8,17,8.892248182646778e-05,0.00018881755781149343,0.68
5960,프리드/Noun,25,17,8,0.00018896027388124403,8.885532132305573e-05,0.68
5961,베를린/Noun,25,17,8,0.00018896027388124403,8.885532132305573e-05,0.68
5962,내지/Noun,25,8,17,8.892248182646778e-05,0.00018881755781149343,0.68
5963,제적/Noun,25,8,17,8.892248182646778e-05,0.00018881755781149343,0.68
5964,본드/Noun,25,17,8,0.00018896027388124403,8.885532132305573e-05,0.68
5965,알렉스/Noun,25,17,8,0.00018896027388124403,8.885532132305573e-05,0.68
5966,친일/Noun,25,8,17,8.892248182646778e-05,0.00018881755781149343,0.68
5967,귀하다/Adjective,25,17,8,0.00018896027388124403,8.885532132305573e-05,0.68
5968,고루/Noun,25,8,17,8.892248182646778e-05,0.00018881755781149343,0.68
5969,회복/Noun,25,17,8,0.00018896027388124403,8.885532132305573e-05,0.68
5970,좌빨/Noun,25,9,16,0.00010003779205477625,0.00017771064264611146,0.64
5971,인위/Noun,25,9,16,0.00010003779205477625,0.00017771064264611146,0.64
5972,스토/Noun,25,9,16,0.00010003779205477625,0.00017771064264611146,0.64
5973,건조하다/Adjective,25,16,9,0.00017784496365293555,9.99622364884377e-05,0.64
5974,벌레/Noun,25,9,16,0.00010003779205477625,0.00017771064264611146,0.64
5975,중요성/Noun,25,16,9,0.00017784496365293555,9.99622364884377e-05,0.64
5976,...!!!/Punctuation,25,16,9,0.00017784496365293555,9.99622364884377e-05,0.64
5977,에게만/Josa,25,9,16,0.00010003779205477625,0.00017771064264611146,0.64
5978,당대/Noun,25,16,9,0.00017784496365293555,9.99622364884377e-05,0.64
5979,인칭/Noun,25,9,16,0.00010003779205477625,0.00017771064264611146,0.64
5980,내버리다/Verb,25,9,16,0.00010003779205477625,0.00017771064264611146,0.64
5981,폭소/Noun,25,9,16,0.00010003779205477625,0.00017771064264611146,0.64
5982,대구/Noun,25,16,9,0.00017784496365293555,9.99622364884377e-05,0.64
5983,괴기/Noun,25,9,16,0.00010003779205477625,0.00017771064264611146,0.64
5984,이어서/Adverb,25,16,9,0.00017784496365293555,9.99622364884377e-05,0.64
5985,사나/Noun,25,16,9,0.00017784496365293555,9.99622364884377e-05,0.64
5986,마력/Noun,25,16,9,0.00017784496365293555,9.99622364884377e-05,0.64
5987,인정받다/Verb,25,9,16,0.00010003779205477625,0.00017771064264611146,0.64
5988,퍼지다/Verb,25,16,9,0.00017784496365293555,9.99622364884377e-05,0.64
5989,2%/Number,25,16,9,0.00017784496365293555,9.99622364884377e-05,0.64
5990,방사/Noun,25,9,16,0.00010003779205477625,0.00017771064264611146,0.64
5991,세월호/Noun,25,16,9,0.00017784496365293555,9.99622364884377e-05,0.64
5992,타락하다/Adjective,25,15,10,0.00016672965342462708,0.00011106915165381967,0.6
5993,토비/Noun,25,15,10,0.00016672965342462708,0.00011106915165381967,0.6
5994,통속/Noun,25,10,15,0.00011115310228308472,0.0001666037274807295,0.6
5995,펜/Noun,25,10,15,0.00011115310228308472,0.0001666037274807295,0.6
5996,이정진/Noun,25,10,15,0.00011115310228308472,0.0001666037274807295,0.6
5997,요원/Noun,25,15,10,0.00016672965342462708,0.00011106915165381967,0.6
5998,장백지/Noun,25,10,15,0.00011115310228308472,0.0001666037274807295,0.6
5999,스틸/Noun,25,10,15,0.00011115310228308472,0.0001666037274807295,0.6
6000,덧/Noun,25,15,10,0.00016672965342462708,0.00011106915165381967,0.6
6001,마동석/Noun,25,10,15,0.00011115310228308472,0.0001666037274807295,0.6
6002,해주/Noun,25,15,10,0.00016672965342462708,0.00011106915165381967,0.6
6003,조건/Noun,25,15,10,0.00016672965342462708,0.00011106915165381967,0.6
6004,얹다/Verb,25,10,15,0.00011115310228308472,0.0001666037274807295,0.6
6005,오가다/Verb,25,15,10,0.00016672965342462708,0.00011106915165381967,0.6
6006,가가/Noun,25,15,10,0.00016672965342462708,0.00011106915165381967,0.6
6007,이준/Noun,25,15,10,0.00016672965342462708,0.00011106915165381967,0.6
6008,파이/Noun,25,11,14,0.00012226841251139318,0.00015549681231534753,0.56
6009,찔리다/Verb,25,11,14,0.00012226841251139318,0.00015549681231534753,0.56
6010,유튜브/Noun,25,11,14,0.00012226841251139318,0.00015549681231534753,0.56
6011,여태껏/Noun,25,14,11,0.0001556143431963186,0.00012217606681920164,0.56
6012,일기/Noun,25,11,14,0.00012226841251139318,0.00015549681231534753,0.56
6013,탁/Noun,25,14,11,0.0001556143431963186,0.00012217606681920164,0.56
6014,사정/Noun,25,11,14,0.00012226841251139318,0.00015549681231534753,0.56
6015,띠/Noun,25,11,14,0.00012226841251139318,0.00015549681231534753,0.56
6016,불교/Noun,25,14,11,0.0001556143431963186,0.00012217606681920164,0.56
6017,타짜/Noun,25,14,11,0.0001556143431963186,0.00012217606681920164,0.56
6018,위안부/Noun,25,11,14,0.00012226841251139318,0.00015549681231534753,0.56
6019,종말/Noun,25,11,14,0.00012226841251139318,0.00015549681231534753,0.56
6020,소가/Noun,25,11,14,0.00012226841251139318,0.00015549681231534753,0.56
6021,톱스타/Noun,25,14,11,0.0001556143431963186,0.00012217606681920164,0.56
6022,베트남/Noun,25,11,14,0.00012226841251139318,0.00015549681231534753,0.56
6023,내/Modifier,25,11,14,0.00012226841251139318,0.00015549681231534753,0.56
6024,놀/Noun,25,11,14,0.00012226841251139318,0.00015549681231534753,0.56
6025,주변인/Noun,25,11,14,0.00012226841251139318,0.00015549681231534753,0.56
6026,권총/Noun,25,11,14,0.00012226841251139318,0.00015549681231534753,0.56
6027,에어/Noun,25,14,11,0.0001556143431963186,0.00012217606681920164,0.56
6028,스무/Modifier,25,14,11,0.0001556143431963186,0.00012217606681920164,0.56
6029,영화평론가/Noun,25,14,11,0.0001556143431963186,0.00012217606681920164,0.56
6030,종북/Noun,25,11,14,0.00012226841251139318,0.00015549681231534753,0.56
6031,브래드/Noun,25,14,11,0.0001556143431963186,0.00012217606681920164,0.56
6032,동성애자/Noun,25,11,14,0.00012226841251139318,0.00015549681231534753,0.56
6033,징악/Noun,25,11,14,0.00012226841251139318,0.00015549681231534753,0.56
6034,신랑/Noun,25,12,13,0.00013338372273970166,0.00014438989714996557,0.52
6035,까지나/Josa,25,12,13,0.00013338372273970166,0.00014438989714996557,0.52
6036,진지/Noun,25,12,13,0.00013338372273970166,0.00014438989714996557,0.52
6037,어리석다/Adjective,25,12,13,0.00013338372273970166,0.00014438989714996557,0.52
6038,댐/Noun,25,12,13,0.00013338372273970166,0.00014438989714996557,0.52
6039,컨데/Noun,25,12,13,0.00013338372273970166,0.00014438989714996557,0.52
6040,1990년/Number,25,13,12,0.00014449903296801013,0.0001332829819845836,0.52
6041,특급/Noun,25,13,12,0.00014449903296801013,0.0001332829819845836,0.52
6042,마이크/Noun,25,12,13,0.00013338372273970166,0.00014438989714996557,0.52
6043,슈/Noun,25,13,12,0.00014449903296801013,0.0001332829819845836,0.52
6044,손잡다/Verb,25,13,12,0.00014449903296801013,0.0001332829819845836,0.52
6045,제자/Noun,25,13,12,0.00014449903296801013,0.0001332829819845836,0.52
6046,마술/Noun,25,12,13,0.00013338372273970166,0.00014438989714996557,0.52
6047,일어나서/Noun,25,12,13,0.00013338372273970166,0.00014438989714996557,0.52
6048,물고기/Noun,25,12,13,0.00013338372273970166,0.00014438989714996557,0.52
6049,♡♡♡/Foreign,24,24,0,0.0002667674454794033,0.0,1.0
6050,乃/Foreign,24,24,0,0.0002667674454794033,0.0,1.0
6051,낚였어/Noun,24,0,24,0.0,0.0002665659639691672,1.0
6052,관광/Noun,24,0,24,0.0,0.0002665659639691672,1.0
6053,조치/Noun,24,1,23,1.1115310228308472e-05,0.0002554590488037852,0.9583333333333334
6054,맥빠지다/Adjective,24,1,23,1.1115310228308472e-05,0.0002554590488037852,0.9583333333333334
6055,빠르기/Noun,24,1,23,1.1115310228308472e-05,0.0002554590488037852,0.9583333333333334
6056,학예회/Noun,24,1,23,1.1115310228308472e-05,0.0002554590488037852,0.9583333333333334
6057,오그/Noun,24,1,23,1.1115310228308472e-05,0.0002554590488037852,0.9583333333333334
6058,반점/Noun,24,2,22,2.2230620456616944e-05,0.0002443521336384033,0.9166666666666666
6059,심금/Noun,24,22,2,0.00024453682502278637,2.2213830330763933e-05,0.9166666666666666
6060,닭살/Noun,24,2,22,2.2230620456616944e-05,0.0002443521336384033,0.9166666666666666
6061,전범/Noun,24,2,22,2.2230620456616944e-05,0.0002443521336384033,0.9166666666666666
6062,상쾌하다/Adjective,24,22,2,0.00024453682502278637,2.2213830330763933e-05,0.9166666666666666
6063,날카롭다/Adjective,24,22,2,0.00024453682502278637,2.2213830330763933e-05,0.9166666666666666
6064,소외/Noun,24,22,2,0.00024453682502278637,2.2213830330763933e-05,0.9166666666666666
6065,수면/Noun,24,2,22,2.2230620456616944e-05,0.0002443521336384033,0.9166666666666666
6066,방어율/Noun,24,2,22,2.2230620456616944e-05,0.0002443521336384033,0.9166666666666666
6067,구지성/Noun,24,2,22,2.2230620456616944e-05,0.0002443521336384033,0.9166666666666666
6068,뿐더러/Noun,24,3,21,3.3345930684925414e-05,0.0002332452184730213,0.875
6069,거참/Noun,24,3,21,3.3345930684925414e-05,0.0002332452184730213,0.875
6070,오래도록/Adverb,24,21,3,0.00023342151479447792,3.33207454961459e-05,0.875
6071,캡틴/Noun,24,21,3,0.00023342151479447792,3.33207454961459e-05,0.875
6072,어렷을때/Noun,24,21,3,0.00023342151479447792,3.33207454961459e-05,0.875
6073,와나/Noun,24,4,20,4.446124091323389e-05,0.00022213830330763935,0.8333333333333334
6074,대륙/Noun,24,4,20,4.446124091323389e-05,0.00022213830330763935,0.8333333333333334
6075,브라질/Noun,24,20,4,0.00022230620456616945,4.4427660661527865e-05,0.8333333333333334
6076,실적/Noun,24,20,4,0.00022230620456616945,4.4427660661527865e-05,0.8333333333333334
6077,죽겠네/Noun,24,4,20,4.446124091323389e-05,0.00022213830330763935,0.8333333333333334
6078,문명/Noun,24,20,4,0.00022230620456616945,4.4427660661527865e-05,0.8333333333333334
6079,장창/Noun,24,4,20,4.446124091323389e-05,0.00022213830330763935,0.8333333333333334
6080,13년/Number,24,20,4,0.00022230620456616945,4.4427660661527865e-05,0.8333333333333334
6081,올려놓다/Verb,24,5,19,5.557655114154236e-05,0.00021103138814225738,0.7916666666666666
6082,흐리다/Verb,24,5,19,5.557655114154236e-05,0.00021103138814225738,0.7916666666666666
6083,렌트/Noun,24,5,19,5.557655114154236e-05,0.00021103138814225738,0.7916666666666666
6084,반의/Noun,24,5,19,5.557655114154236e-05,0.00021103138814225738,0.7916666666666666
6085,스무살/Noun,24,19,5,0.00021119089433786097,5.5534575826909837e-05,0.7916666666666666
6086,저능/Noun,24,5,19,5.557655114154236e-05,0.00021103138814225738,0.7916666666666666
6087,으악/Adverb,24,5,19,5.557655114154236e-05,0.00021103138814225738,0.7916666666666666
6088,박정희/Noun,24,5,19,5.557655114154236e-05,0.00021103138814225738,0.7916666666666666
6089,놔두다/Verb,24,5,19,5.557655114154236e-05,0.00021103138814225738,0.7916666666666666
6090,아따/Noun,24,5,19,5.557655114154236e-05,0.00021103138814225738,0.7916666666666666
6091,상속/Noun,24,19,5,0.00021119089433786097,5.5534575826909837e-05,0.7916666666666666
6092,진상/Noun,24,5,19,5.557655114154236e-05,0.00021103138814225738,0.7916666666666666
6093,적합하다/Adjective,24,5,19,5.557655114154236e-05,0.00021103138814225738,0.7916666666666666
6094,조디/Noun,24,19,5,0.00021119089433786097,5.5534575826909837e-05,0.7916666666666666
6095,액/Noun,24,5,19,5.557655114154236e-05,0.00021103138814225738,0.7916666666666666
6096,피고/Noun,24,6,18,6.669186136985083e-05,0.0001999244729768754,0.75
6097,앵/Adverb,24,6,18,6.669186136985083e-05,0.0001999244729768754,0.75
6098,가두다/Verb,24,6,18,6.669186136985083e-05,0.0001999244729768754,0.75
6099,엠비씨/Noun,24,6,18,6.669186136985083e-05,0.0001999244729768754,0.75
6100,하찮다/Adjective,24,6,18,6.669186136985083e-05,0.0001999244729768754,0.75
6101,진국/Noun,24,18,6,0.0002000755841095525,6.66414909922918e-05,0.75
6102,소비/Noun,24,6,18,6.669186136985083e-05,0.0001999244729768754,0.75
6103,아주아주/Adverb,24,18,6,0.0002000755841095525,6.66414909922918e-05,0.75
6104,ㅅㅅ/KoreanParticle,24,6,18,6.669186136985083e-05,0.0001999244729768754,0.75
6105,축하/Noun,24,18,6,0.0002000755841095525,6.66414909922918e-05,0.75
6106,게다/Noun,24,6,18,6.669186136985083e-05,0.0001999244729768754,0.75
6107,이경영/Noun,24,6,18,6.669186136985083e-05,0.0001999244729768754,0.75
6108,도배/Noun,24,7,17,7.78071715981593e-05,0.00018881755781149343,0.7083333333333334
6109,녹음/Noun,24,7,17,7.78071715981593e-05,0.00018881755781149343,0.7083333333333334
6110,존예/Noun,24,17,7,0.00018896027388124403,7.774840615767377e-05,0.7083333333333334
6111,박살/Noun,24,7,17,7.78071715981593e-05,0.00018881755781149343,0.7083333333333334
6112,기기/Noun,24,7,17,7.78071715981593e-05,0.00018881755781149343,0.7083333333333334
6113,계단/Noun,24,17,7,0.00018896027388124403,7.774840615767377e-05,0.7083333333333334
6114,명언/Noun,24,17,7,0.00018896027388124403,7.774840615767377e-05,0.7083333333333334
6115,..!!!/Punctuation,24,17,7,0.00018896027388124403,7.774840615767377e-05,0.7083333333333334
6116,브라이언/Noun,24,17,7,0.00018896027388124403,7.774840615767377e-05,0.7083333333333334
6117,퀴/Noun,24,7,17,7.78071715981593e-05,0.00018881755781149343,0.7083333333333334
6118,90/Number,24,7,17,7.78071715981593e-05,0.00018881755781149343,0.7083333333333334
6119,완존/Noun,24,17,7,0.00018896027388124403,7.774840615767377e-05,0.7083333333333334
6120,".,./Punctuation",24,7,17,7.78071715981593e-05,0.00018881755781149343,0.7083333333333334
6121,눈물샘/Noun,24,17,7,0.00018896027388124403,7.774840615767377e-05,0.7083333333333334
6122,민호/Noun,24,17,7,0.00018896027388124403,7.774840615767377e-05,0.7083333333333334
6123,장선우/Noun,24,7,17,7.78071715981593e-05,0.00018881755781149343,0.7083333333333334
6124,창문/Noun,24,7,17,7.78071715981593e-05,0.00018881755781149343,0.7083333333333334
6125,이빨/Noun,24,7,17,7.78071715981593e-05,0.00018881755781149343,0.7083333333333334
6126,파치노/Noun,24,17,7,0.00018896027388124403,7.774840615767377e-05,0.7083333333333334
6127,낡다/Adjective,24,7,17,7.78071715981593e-05,0.00018881755781149343,0.7083333333333334
6128,초라하다/Adjective,24,7,17,7.78071715981593e-05,0.00018881755781149343,0.7083333333333334
6129,해소/Noun,24,17,7,0.00018896027388124403,7.774840615767377e-05,0.7083333333333334
6130,이문식/Noun,24,7,17,7.78071715981593e-05,0.00018881755781149343,0.7083333333333334
6131,이뤄지다/Verb,24,17,7,0.00018896027388124403,7.774840615767377e-05,0.7083333333333334
6132,스티븐시걸/Noun,24,8,16,8.892248182646778e-05,0.00017771064264611146,0.6666666666666666
6133,비우다/Verb,24,8,16,8.892248182646778e-05,0.00017771064264611146,0.6666666666666666
6134,부조리/Noun,24,16,8,0.00017784496365293555,8.885532132305573e-05,0.6666666666666666
6135,대립/Noun,24,16,8,0.00017784496365293555,8.885532132305573e-05,0.6666666666666666
6136,스님/Noun,24,16,8,0.00017784496365293555,8.885532132305573e-05,0.6666666666666666
6137,장영/Noun,24,16,8,0.00017784496365293555,8.885532132305573e-05,0.6666666666666666
6138,분노하다/Adjective,24,8,16,8.892248182646778e-05,0.00017771064264611146,0.6666666666666666
6139,월드컵/Noun,24,16,8,0.00017784496365293555,8.885532132305573e-05,0.6666666666666666
6140,?????/Punctuation,24,8,16,8.892248182646778e-05,0.00017771064264611146,0.6666666666666666
6141,쇼킹/Noun,24,16,8,0.00017784496365293555,8.885532132305573e-05,0.6666666666666666
6142,문구/Noun,24,8,16,8.892248182646778e-05,0.00017771064264611146,0.6666666666666666
6143,야쿠자/Noun,24,8,16,8.892248182646778e-05,0.00017771064264611146,0.6666666666666666
6144,택/Noun,24,8,16,8.892248182646778e-05,0.00017771064264611146,0.6666666666666666
6145,호랑이/Noun,24,16,8,0.00017784496365293555,8.885532132305573e-05,0.6666666666666666
6146,빈틈/Noun,24,16,8,0.00017784496365293555,8.885532132305573e-05,0.6666666666666666
6147,리차드/Noun,24,16,8,0.00017784496365293555,8.885532132305573e-05,0.6666666666666666
6148,움직임/Noun,24,16,8,0.00017784496365293555,8.885532132305573e-05,0.6666666666666666
6149,유준상/Noun,24,8,16,8.892248182646778e-05,0.00017771064264611146,0.6666666666666666
6150,류승룡/Noun,24,16,8,0.00017784496365293555,8.885532132305573e-05,0.6666666666666666
6151,캐다/Verb,24,9,15,0.00010003779205477625,0.0001666037274807295,0.625
6152,안개/Noun,24,15,9,0.00016672965342462708,9.99622364884377e-05,0.625
6153,햇던/Noun,24,9,15,0.00010003779205477625,0.0001666037274807295,0.625
6154,유승호/Noun,24,9,15,0.00010003779205477625,0.0001666037274807295,0.625
6155,그리스/Noun,24,9,15,0.00010003779205477625,0.0001666037274807295,0.625
6156,숀펜/Noun,24,15,9,0.00016672965342462708,9.99622364884377e-05,0.625
6157,지워지다/Verb,24,15,9,0.00016672965342462708,9.99622364884377e-05,0.625
6158,독도/Noun,24,15,9,0.00016672965342462708,9.99622364884377e-05,0.625
6159,외다/Verb,24,9,15,0.00010003779205477625,0.0001666037274807295,0.625
6160,닳다/Verb,24,9,15,0.00010003779205477625,0.0001666037274807295,0.625
6161,재일/Noun,24,15,9,0.00016672965342462708,9.99622364884377e-05,0.625
6162,김윤석/Noun,24,15,9,0.00016672965342462708,9.99622364884377e-05,0.625
6163,장미/Noun,24,15,9,0.00016672965342462708,9.99622364884377e-05,0.625
6164,교사/Noun,24,9,15,0.00010003779205477625,0.0001666037274807295,0.625
6165,멕/Noun,24,10,14,0.00011115310228308472,0.00015549681231534753,0.5833333333333334
6166,배두나/Noun,24,14,10,0.0001556143431963186,0.00011106915165381967,0.5833333333333334
6167,취하/Noun,24,10,14,0.00011115310228308472,0.00015549681231534753,0.5833333333333334
6168,김정은/Noun,24,10,14,0.00011115310228308472,0.00015549681231534753,0.5833333333333334
6169,범죄영화/Noun,24,10,14,0.00011115310228308472,0.00015549681231534753,0.5833333333333334
6170,영하/Noun,24,14,10,0.0001556143431963186,0.00011106915165381967,0.5833333333333334
6171,날개/Noun,24,10,14,0.00011115310228308472,0.00015549681231534753,0.5833333333333334
6172,연결고리/Noun,24,10,14,0.00011115310228308472,0.00015549681231534753,0.5833333333333334
6173,굴/Noun,24,14,10,0.0001556143431963186,0.00011106915165381967,0.5833333333333334
6174,디게/Adverb,24,14,10,0.0001556143431963186,0.00011106915165381967,0.5833333333333334
6175,~?/Punctuation,24,10,14,0.00011115310228308472,0.00015549681231534753,0.5833333333333334
6176,갱스터/Noun,24,14,10,0.0001556143431963186,0.00011106915165381967,0.5833333333333334
6177,개척/Noun,24,14,10,0.0001556143431963186,0.00011106915165381967,0.5833333333333334
6178,누리다/Verb,24,14,10,0.0001556143431963186,0.00011106915165381967,0.5833333333333334
6179,제국/Noun,24,14,10,0.0001556143431963186,0.00011106915165381967,0.5833333333333334
6180,초등/Noun,24,10,14,0.00011115310228308472,0.00015549681231534753,0.5833333333333334
6181,우울/Noun,24,10,14,0.00011115310228308472,0.00015549681231534753,0.5833333333333334
6182,ㅡㅜ/KoreanParticle,24,10,14,0.00011115310228308472,0.00015549681231534753,0.5833333333333334
6183,스마트폰/Noun,24,10,14,0.00011115310228308472,0.00015549681231534753,0.5833333333333334
6184,데려가다/Verb,24,11,13,0.00012226841251139318,0.00014438989714996557,0.5416666666666666
6185,하/Noun,24,13,11,0.00014449903296801013,0.00012217606681920164,0.5416666666666666
6186,조여정/Noun,24,13,11,0.00014449903296801013,0.00012217606681920164,0.5416666666666666
6187,됫/Noun,24,13,11,0.00014449903296801013,0.00012217606681920164,0.5416666666666666
6188,외치/Noun,24,11,13,0.00012226841251139318,0.00014438989714996557,0.5416666666666666
6189,러/Noun,24,13,11,0.00014449903296801013,0.00012217606681920164,0.5416666666666666
6190,비운/Noun,24,13,11,0.00014449903296801013,0.00012217606681920164,0.5416666666666666
6191,나선/Noun,24,13,11,0.00014449903296801013,0.00012217606681920164,0.5416666666666666
6192,손오공/Noun,24,11,13,0.00012226841251139318,0.00014438989714996557,0.5416666666666666
6193,예지원/Noun,24,11,13,0.00012226841251139318,0.00014438989714996557,0.5416666666666666
6194,이해력/Noun,24,11,13,0.00012226841251139318,0.00014438989714996557,0.5416666666666666
6195,어유/Noun,24,13,11,0.00014449903296801013,0.00012217606681920164,0.5416666666666666
6196,리부트/Noun,24,13,11,0.00014449903296801013,0.00012217606681920164,0.5416666666666666
6197,닭/Noun,24,11,13,0.00012226841251139318,0.00014438989714996557,0.5416666666666666
6198,노무현/Noun,24,11,13,0.00012226841251139318,0.00014438989714996557,0.5416666666666666
6199,대지/Noun,24,11,13,0.00012226841251139318,0.00014438989714996557,0.5416666666666666
6200,편성/Noun,24,11,13,0.00012226841251139318,0.00014438989714996557,0.5416666666666666
6201,획기/Noun,24,13,11,0.00014449903296801013,0.00012217606681920164,0.5416666666666666
6202,용의/Noun,24,13,11,0.00014449903296801013,0.00012217606681920164,0.5416666666666666
6203,쌍둥이/Noun,24,11,13,0.00012226841251139318,0.00014438989714996557,0.5416666666666666
6204,매치/Noun,24,11,13,0.00012226841251139318,0.00014438989714996557,0.5416666666666666
6205,얼음/Noun,24,13,11,0.00014449903296801013,0.00012217606681920164,0.5416666666666666
6206,바람둥이/Noun,24,11,13,0.00012226841251139318,0.00014438989714996557,0.5416666666666666
6207,그토록/Adverb,24,11,13,0.00012226841251139318,0.00014438989714996557,0.5416666666666666
6208,사자/Noun,24,11,13,0.00012226841251139318,0.00014438989714996557,0.5416666666666666
6209,올드보이/Noun,24,11,13,0.00012226841251139318,0.00014438989714996557,0.5416666666666666
6210,흑형/Noun,24,13,11,0.00014449903296801013,0.00012217606681920164,0.5416666666666666
6211,빙의/Noun,24,13,11,0.00014449903296801013,0.00012217606681920164,0.5416666666666666
6212,일텐데/Josa,24,13,11,0.00014449903296801013,0.00012217606681920164,0.5416666666666666
6213,돌이/Noun,24,12,12,0.00013338372273970166,0.0001332829819845836,0.5
6214,팔마/Noun,24,12,12,0.00013338372273970166,0.0001332829819845836,0.5
6215,논란/Noun,24,12,12,0.00013338372273970166,0.0001332829819845836,0.5
6216,환영/Noun,24,12,12,0.00013338372273970166,0.0001332829819845836,0.5
6217,화제/Noun,24,12,12,0.00013338372273970166,0.0001332829819845836,0.5
6218,환/Noun,24,12,12,0.00013338372273970166,0.0001332829819845836,0.5
6219,라이즈/Noun,24,12,12,0.00013338372273970166,0.0001332829819845836,0.5
6220,로안/Noun,24,12,12,0.00013338372273970166,0.0001332829819845836,0.5
6221,한자/Noun,24,12,12,0.00013338372273970166,0.0001332829819845836,0.5
6222,특색/Noun,24,12,12,0.00013338372273970166,0.0001332829819845836,0.5
6223,가보/Noun,24,12,12,0.00013338372273970166,0.0001332829819845836,0.5
6224,빼앗기다/Verb,24,12,12,0.00013338372273970166,0.0001332829819845836,0.5
6225,포근하다/Adjective,23,23,0,0.00025565213525109487,0.0,1.0
6226,물체/Noun,23,0,23,0.0,0.0002554590488037852,1.0
6227,긴급/Noun,23,1,22,1.1115310228308472e-05,0.0002443521336384033,0.9565217391304348
6228,난감/Noun,23,1,22,1.1115310228308472e-05,0.0002443521336384033,0.9565217391304348
6229,추강/Noun,23,22,1,0.00024453682502278637,1.1106915165381966e-05,0.9565217391304348
6230,잡탕/Noun,23,1,22,1.1115310228308472e-05,0.0002443521336384033,0.9565217391304348
6231,꼽는/Noun,23,22,1,0.00024453682502278637,1.1106915165381966e-05,0.9565217391304348
6232,못만드/Noun,23,2,21,2.2230620456616944e-05,0.0002332452184730213,0.9130434782608695
6233,박영화/Noun,23,21,2,0.00023342151479447792,2.2213830330763933e-05,0.9130434782608695
6234,바람나다/Verb,23,2,21,2.2230620456616944e-05,0.0002332452184730213,0.9130434782608695
6235,존잘/Noun,23,20,3,0.00022230620456616945,3.33207454961459e-05,0.8695652173913043
6236,경력/Noun,23,3,20,3.3345930684925414e-05,0.00022213830330763935,0.8695652173913043
6237,11년/Number,23,20,3,0.00022230620456616945,3.33207454961459e-05,0.8695652173913043
6238,나대다/Verb,23,3,20,3.3345930684925414e-05,0.00022213830330763935,0.8695652173913043
6239,-;/Punctuation,23,3,20,3.3345930684925414e-05,0.00022213830330763935,0.8695652173913043
6240,^.^/Punctuation,23,20,3,0.00022230620456616945,3.33207454961459e-05,0.8695652173913043
6241,노아/Noun,23,3,20,3.3345930684925414e-05,0.00022213830330763935,0.8695652173913043
6242,욧/Noun,23,20,3,0.00022230620456616945,3.33207454961459e-05,0.8695652173913043
6243,스며들다/Verb,23,20,3,0.00022230620456616945,3.33207454961459e-05,0.8695652173913043
6244,호프/Noun,23,20,3,0.00022230620456616945,3.33207454961459e-05,0.8695652173913043
6245,직장인/Noun,23,20,3,0.00022230620456616945,3.33207454961459e-05,0.8695652173913043
6246,볼바/Noun,23,3,20,3.3345930684925414e-05,0.00022213830330763935,0.8695652173913043
6247,반쪽/Noun,23,3,20,3.3345930684925414e-05,0.00022213830330763935,0.8695652173913043
6248,꾸역꾸역/Adverb,23,3,20,3.3345930684925414e-05,0.00022213830330763935,0.8695652173913043
6249,데드/Noun,23,4,19,4.446124091323389e-05,0.00021103138814225738,0.8260869565217391
6250,파탄/Noun,23,4,19,4.446124091323389e-05,0.00021103138814225738,0.8260869565217391
6251,사골/Noun,23,4,19,4.446124091323389e-05,0.00021103138814225738,0.8260869565217391
6252,동양인/Noun,23,4,19,4.446124091323389e-05,0.00021103138814225738,0.8260869565217391
6253,요가/Noun,23,4,19,4.446124091323389e-05,0.00021103138814225738,0.8260869565217391
6254,잼남/Noun,23,19,4,0.00021119089433786097,4.4427660661527865e-05,0.8260869565217391
6255,후진/Noun,23,4,19,4.446124091323389e-05,0.00021103138814225738,0.8260869565217391
6256,킹왕짱/Noun,23,19,4,0.00021119089433786097,4.4427660661527865e-05,0.8260869565217391
6257,갈망/Noun,23,19,4,0.00021119089433786097,4.4427660661527865e-05,0.8260869565217391
6258,구식/Noun,23,4,19,4.446124091323389e-05,0.00021103138814225738,0.8260869565217391
6259,세심/Noun,23,19,4,0.00021119089433786097,4.4427660661527865e-05,0.8260869565217391
6260,추상/Noun,23,4,19,4.446124091323389e-05,0.00021103138814225738,0.8260869565217391
6261,남우/Noun,23,19,4,0.00021119089433786097,4.4427660661527865e-05,0.8260869565217391
6262,밍밍/Noun,23,4,19,4.446124091323389e-05,0.00021103138814225738,0.8260869565217391
6263,?;;/Punctuation,23,4,19,4.446124091323389e-05,0.00021103138814225738,0.8260869565217391
6264,보너스/Noun,23,18,5,0.0002000755841095525,5.5534575826909837e-05,0.782608695652174
6265,수호/Noun,23,18,5,0.0002000755841095525,5.5534575826909837e-05,0.782608695652174
6266,토요일/Noun,23,18,5,0.0002000755841095525,5.5534575826909837e-05,0.782608695652174
6267,람/Noun,23,5,18,5.557655114154236e-05,0.0001999244729768754,0.782608695652174
6268,화신/Noun,23,5,18,5.557655114154236e-05,0.0001999244729768754,0.782608695652174
6269,저학년/Noun,23,5,18,5.557655114154236e-05,0.0001999244729768754,0.782608695652174
6270,유부녀/Noun,23,5,18,5.557655114154236e-05,0.0001999244729768754,0.782608695652174
6271,기다림/Noun,23,18,5,0.0002000755841095525,5.5534575826909837e-05,0.782608695652174
6272,왕국/Noun,23,5,18,5.557655114154236e-05,0.0001999244729768754,0.782608695652174
6273,불신/Noun,23,5,18,5.557655114154236e-05,0.0001999244729768754,0.782608695652174
6274,에반게리온/Noun,23,17,6,0.00018896027388124403,6.66414909922918e-05,0.7391304347826086
6275,나탈리/Noun,23,17,6,0.00018896027388124403,6.66414909922918e-05,0.7391304347826086
6276,온통/Noun,23,6,17,6.669186136985083e-05,0.00018881755781149343,0.7391304347826086
6277,현상/Noun,23,6,17,6.669186136985083e-05,0.00018881755781149343,0.7391304347826086
6278,25년/Number,23,17,6,0.00018896027388124403,6.66414909922918e-05,0.7391304347826086
6279,뵙다/Verb,23,17,6,0.00018896027388124403,6.66414909922918e-05,0.7391304347826086
6280,단조롭다/Adjective,23,6,17,6.669186136985083e-05,0.00018881755781149343,0.7391304347826086
6281,나른하다/Adjective,23,17,6,0.00018896027388124403,6.66414909922918e-05,0.7391304347826086
6282,후배/Noun,23,6,17,6.669186136985083e-05,0.00018881755781149343,0.7391304347826086
6283,탱/Adverb,23,6,17,6.669186136985083e-05,0.00018881755781149343,0.7391304347826086
6284,긁다/Verb,23,6,17,6.669186136985083e-05,0.00018881755781149343,0.7391304347826086
6285,이기심/Noun,23,17,6,0.00018896027388124403,6.66414909922918e-05,0.7391304347826086
6286,레고/Noun,23,17,6,0.00018896027388124403,6.66414909922918e-05,0.7391304347826086
6287,?..../Punctuation,23,6,17,6.669186136985083e-05,0.00018881755781149343,0.7391304347826086
6288,함축/Noun,23,17,6,0.00018896027388124403,6.66414909922918e-05,0.7391304347826086
6289,쭈욱/Noun,23,17,6,0.00018896027388124403,6.66414909922918e-05,0.7391304347826086
6290,먹고살다/Verb,23,7,16,7.78071715981593e-05,0.00017771064264611146,0.6956521739130435
6291,길거리/Noun,23,7,16,7.78071715981593e-05,0.00017771064264611146,0.6956521739130435
6292,오덕/Noun,23,7,16,7.78071715981593e-05,0.00017771064264611146,0.6956521739130435
6293,태권도/Noun,23,7,16,7.78071715981593e-05,0.00017771064264611146,0.6956521739130435
6294,lt/Alpha,23,16,7,0.00017784496365293555,7.774840615767377e-05,0.6956521739130435
6295,송윤아/Noun,23,16,7,0.00017784496365293555,7.774840615767377e-05,0.6956521739130435
6296,사신/Noun,23,7,16,7.78071715981593e-05,0.00017771064264611146,0.6956521739130435
6297,영화광/Noun,23,7,16,7.78071715981593e-05,0.00017771064264611146,0.6956521739130435
6298,고아라/Noun,23,16,7,0.00017784496365293555,7.774840615767377e-05,0.6956521739130435
6299,건너/Noun,23,7,16,7.78071715981593e-05,0.00017771064264611146,0.6956521739130435
6300,반미/Noun,23,7,16,7.78071715981593e-05,0.00017771064264611146,0.6956521739130435
6301,인격/Noun,23,7,16,7.78071715981593e-05,0.00017771064264611146,0.6956521739130435
6302,에잇/Exclamation,23,7,16,7.78071715981593e-05,0.00017771064264611146,0.6956521739130435
6303,동정/Noun,23,7,16,7.78071715981593e-05,0.00017771064264611146,0.6956521739130435
6304,지하/Noun,23,7,16,7.78071715981593e-05,0.00017771064264611146,0.6956521739130435
6305,시위/Noun,23,7,16,7.78071715981593e-05,0.00017771064264611146,0.6956521739130435
6306,싱크로/Noun,23,15,8,0.00016672965342462708,8.885532132305573e-05,0.6521739130434783
6307,심판/Noun,23,8,15,8.892248182646778e-05,0.0001666037274807295,0.6521739130434783
6308,잘나오다/Verb,23,8,15,8.892248182646778e-05,0.0001666037274807295,0.6521739130434783
6309,리그/Noun,23,8,15,8.892248182646778e-05,0.0001666037274807295,0.6521739130434783
6310,꽃미남/Noun,23,15,8,0.00016672965342462708,8.885532132305573e-05,0.6521739130434783
6311,김수미/Noun,23,8,15,8.892248182646778e-05,0.0001666037274807295,0.6521739130434783
6312,치킨/Noun,23,8,15,8.892248182646778e-05,0.0001666037274807295,0.6521739130434783
6313,윤시윤/Noun,23,15,8,0.00016672965342462708,8.885532132305573e-05,0.6521739130434783
6314,gt/Alpha,23,15,8,0.00016672965342462708,8.885532132305573e-05,0.6521739130434783
6315,광해/Noun,23,15,8,0.00016672965342462708,8.885532132305573e-05,0.6521739130434783
6316,기선/Noun,23,8,15,8.892248182646778e-05,0.0001666037274807295,0.6521739130434783
6317,여서/Noun,23,15,8,0.00016672965342462708,8.885532132305573e-05,0.6521739130434783
6318,경/Noun,23,15,8,0.00016672965342462708,8.885532132305573e-05,0.6521739130434783
6319,에밀리/Noun,23,15,8,0.00016672965342462708,8.885532132305573e-05,0.6521739130434783
6320,페/Noun,23,15,8,0.00016672965342462708,8.885532132305573e-05,0.6521739130434783
6321,연락/Noun,23,15,8,0.00016672965342462708,8.885532132305573e-05,0.6521739130434783
6322,XX/Alpha,23,8,15,8.892248182646778e-05,0.0001666037274807295,0.6521739130434783
6323,밑바닥/Noun,23,8,15,8.892248182646778e-05,0.0001666037274807295,0.6521739130434783
6324,이자벨/Noun,23,15,8,0.00016672965342462708,8.885532132305573e-05,0.6521739130434783
6325,설리/Noun,23,15,8,0.00016672965342462708,8.885532132305573e-05,0.6521739130434783
6326,도망치다/Verb,23,8,15,8.892248182646778e-05,0.0001666037274807295,0.6521739130434783
6327,꼬집다/Verb,23,15,8,0.00016672965342462708,8.885532132305573e-05,0.6521739130434783
6328,라이더/Noun,23,15,8,0.00016672965342462708,8.885532132305573e-05,0.6521739130434783
6329,신앙/Noun,23,15,8,0.00016672965342462708,8.885532132305573e-05,0.6521739130434783
6330,들려주다/Verb,23,15,8,0.00016672965342462708,8.885532132305573e-05,0.6521739130434783
6331,6.5/Number,23,8,15,8.892248182646778e-05,0.0001666037274807295,0.6521739130434783
6332,뛰어다니다/Verb,23,8,15,8.892248182646778e-05,0.0001666037274807295,0.6521739130434783
6333,성폭행/Noun,23,8,15,8.892248182646778e-05,0.0001666037274807295,0.6521739130434783
6334,제주도/Noun,23,14,9,0.0001556143431963186,9.99622364884377e-05,0.6086956521739131
6335,둘리/Noun,23,14,9,0.0001556143431963186,9.99622364884377e-05,0.6086956521739131
6336,해운대/Noun,23,14,9,0.0001556143431963186,9.99622364884377e-05,0.6086956521739131
6337,그로테스크/Noun,23,14,9,0.0001556143431963186,9.99622364884377e-05,0.6086956521739131
6338,다케시/Noun,23,14,9,0.0001556143431963186,9.99622364884377e-05,0.6086956521739131
6339,상자/Noun,23,9,14,0.00010003779205477625,0.00015549681231534753,0.6086956521739131
6340,내려오다/Verb,23,14,9,0.0001556143431963186,9.99622364884377e-05,0.6086956521739131
6341,햇음/Noun,23,9,14,0.00010003779205477625,0.00015549681231534753,0.6086956521739131
6342,성기/Noun,23,9,14,0.00010003779205477625,0.00015549681231534753,0.6086956521739131
6343,야수/Noun,23,14,9,0.0001556143431963186,9.99622364884377e-05,0.6086956521739131
6344,재생/Noun,23,9,14,0.00010003779205477625,0.00015549681231534753,0.6086956521739131
6345,슬레/Noun,23,9,14,0.00010003779205477625,0.00015549681231534753,0.6086956521739131
6346,테러리스트/Noun,23,9,14,0.00010003779205477625,0.00015549681231534753,0.6086956521739131
6347,이불/Noun,23,14,9,0.0001556143431963186,9.99622364884377e-05,0.6086956521739131
6348,앗/Noun,23,14,9,0.0001556143431963186,9.99622364884377e-05,0.6086956521739131
6349,아유/Noun,23,9,14,0.00010003779205477625,0.00015549681231534753,0.6086956521739131
6350,강소라/Noun,23,9,14,0.00010003779205477625,0.00015549681231534753,0.6086956521739131
6351,하이라이트/Noun,23,13,10,0.00014449903296801013,0.00011106915165381967,0.5652173913043478
6352,보드/Noun,23,10,13,0.00011115310228308472,0.00014438989714996557,0.5652173913043478
6353,떤다/Verb,23,13,10,0.00014449903296801013,0.00011106915165381967,0.5652173913043478
6354,바라지/Noun,23,10,13,0.00011115310228308472,0.00014438989714996557,0.5652173913043478
6355,트라우마/Noun,23,13,10,0.00014449903296801013,0.00011106915165381967,0.5652173913043478
6356,시한/Noun,23,13,10,0.00014449903296801013,0.00011106915165381967,0.5652173913043478
6357,일만/Noun,23,10,13,0.00011115310228308472,0.00014438989714996557,0.5652173913043478
6358,후편/Noun,23,13,10,0.00014449903296801013,0.00011106915165381967,0.5652173913043478
6359,입히다/Verb,23,10,13,0.00011115310228308472,0.00014438989714996557,0.5652173913043478
6360,끝없다/Adjective,23,13,10,0.00014449903296801013,0.00011106915165381967,0.5652173913043478
6361,정책/Noun,23,10,13,0.00011115310228308472,0.00014438989714996557,0.5652173913043478
6362,순이/Noun,23,10,13,0.00011115310228308472,0.00014438989714996557,0.5652173913043478
6363,산업/Noun,23,13,10,0.00014449903296801013,0.00011106915165381967,0.5652173913043478
6364,무죄/Noun,23,13,10,0.00014449903296801013,0.00011106915165381967,0.5652173913043478
6365,화이트/Noun,23,10,13,0.00011115310228308472,0.00014438989714996557,0.5652173913043478
6366,파헤치다/Verb,23,13,10,0.00014449903296801013,0.00011106915165381967,0.5652173913043478
6367,잔인/Noun,23,13,10,0.00014449903296801013,0.00011106915165381967,0.5652173913043478
6368,찰지다/Adjective,23,10,13,0.00011115310228308472,0.00014438989714996557,0.5652173913043478
6369,아담샌들러/Noun,23,13,10,0.00014449903296801013,0.00011106915165381967,0.5652173913043478
6370,"!""/Punctuation",23,10,13,0.00011115310228308472,0.00014438989714996557,0.5652173913043478
6371,충족/Noun,23,13,10,0.00014449903296801013,0.00011106915165381967,0.5652173913043478
6372,건담/Noun,23,13,10,0.00014449903296801013,0.00011106915165381967,0.5652173913043478
6373,실속/Noun,23,10,13,0.00011115310228308472,0.00014438989714996557,0.5652173913043478
6374,bgm/Alpha,23,13,10,0.00014449903296801013,0.00011106915165381967,0.5652173913043478
6375,소련/Noun,23,10,13,0.00011115310228308472,0.00014438989714996557,0.5652173913043478
6376,중세/Noun,23,11,12,0.00012226841251139318,0.0001332829819845836,0.5217391304347826
6377,한일/Noun,23,11,12,0.00012226841251139318,0.0001332829819845836,0.5217391304347826
6378,!'/Punctuation,23,12,11,0.00013338372273970166,0.00012217606681920164,0.5217391304347826
6379,사악하다/Adjective,23,12,11,0.00013338372273970166,0.00012217606681920164,0.5217391304347826
6380,꽂히다/Verb,23,12,11,0.00013338372273970166,0.00012217606681920164,0.5217391304347826
6381,여자아이/Noun,23,11,12,0.00012226841251139318,0.0001332829819845836,0.5217391304347826
6382,문자/Noun,23,11,12,0.00012226841251139318,0.0001332829819845836,0.5217391304347826
6383,도가니/Noun,23,11,12,0.00012226841251139318,0.0001332829819845836,0.5217391304347826
6384,L/Alpha,23,12,11,0.00013338372273970166,0.00012217606681920164,0.5217391304347826
6385,킬/Noun,23,12,11,0.00013338372273970166,0.00012217606681920164,0.5217391304347826
6386,교양/Noun,23,11,12,0.00012226841251139318,0.0001332829819845836,0.5217391304347826
6387,라이트/Noun,23,12,11,0.00013338372273970166,0.00012217606681920164,0.5217391304347826
6388,보편/Noun,23,11,12,0.00012226841251139318,0.0001332829819845836,0.5217391304347826
6389,현란하다/Adjective,23,11,12,0.00012226841251139318,0.0001332829819845836,0.5217391304347826
6390,감점/Noun,23,11,12,0.00012226841251139318,0.0001332829819845836,0.5217391304347826
6391,피노키오/Noun,23,12,11,0.00013338372273970166,0.00012217606681920164,0.5217391304347826
6392,대장/Noun,23,11,12,0.00012226841251139318,0.0001332829819845836,0.5217391304347826
6393,폐해/Noun,23,11,12,0.00012226841251139318,0.0001332829819845836,0.5217391304347826
6394,서태지/Noun,23,11,12,0.00012226841251139318,0.0001332829819845836,0.5217391304347826
6395,규/Noun,23,12,11,0.00013338372273970166,0.00012217606681920164,0.5217391304347826
6396,방울/Noun,23,12,11,0.00013338372273970166,0.00012217606681920164,0.5217391304347826
6397,유사하다/Adjective,23,12,11,0.00013338372273970166,0.00012217606681920164,0.5217391304347826
6398,대요/Noun,23,11,12,0.00012226841251139318,0.0001332829819845836,0.5217391304347826
6399,다섯/Noun,23,12,11,0.00013338372273970166,0.00012217606681920164,0.5217391304347826
6400,짖다/Verb,23,11,12,0.00012226841251139318,0.0001332829819845836,0.5217391304347826
6401,휴지/Noun,23,11,12,0.00012226841251139318,0.0001332829819845836,0.5217391304347826
6402,뭘말/Noun,22,0,22,0.0,0.0002443521336384033,1.0
6403,어장/Noun,22,0,22,0.0,0.0002443521336384033,1.0
6404,엇/Noun,22,21,1,0.00023342151479447792,1.1106915165381966e-05,0.9545454545454546
6405,멀미/Noun,22,1,21,1.1115310228308472e-05,0.0002332452184730213,0.9545454545454546
6406,비약/Noun,22,1,21,1.1115310228308472e-05,0.0002332452184730213,0.9545454545454546
6407,뭉클/Noun,22,21,1,0.00023342151479447792,1.1106915165381966e-05,0.9545454545454546
6408,그이/Noun,22,1,21,1.1115310228308472e-05,0.0002332452184730213,0.9545454545454546
6409,면상/Noun,22,2,20,2.2230620456616944e-05,0.00022213830330763935,0.9090909090909091
6410,시시/Noun,22,2,20,2.2230620456616944e-05,0.00022213830330763935,0.9090909090909091
6411,레즈비언/Noun,22,2,20,2.2230620456616944e-05,0.00022213830330763935,0.9090909090909091
6412,주님/Noun,22,20,2,0.00022230620456616945,2.2213830330763933e-05,0.9090909090909091
6413,막무가내/Noun,22,2,20,2.2230620456616944e-05,0.00022213830330763935,0.9090909090909091
6414,연출자/Noun,22,2,20,2.2230620456616944e-05,0.00022213830330763935,0.9090909090909091
6415,장사/Noun,22,2,20,2.2230620456616944e-05,0.00022213830330763935,0.9090909090909091
6416,..;;;/Punctuation,22,2,20,2.2230620456616944e-05,0.00022213830330763935,0.9090909090909091
6417,에/Noun,22,3,19,3.3345930684925414e-05,0.00021103138814225738,0.8636363636363636
6418,쟤/Noun,22,3,19,3.3345930684925414e-05,0.00021103138814225738,0.8636363636363636
6419,공익/Noun,22,3,19,3.3345930684925414e-05,0.00021103138814225738,0.8636363636363636
6420,쯤/Foreign,22,3,19,3.3345930684925414e-05,0.00021103138814225738,0.8636363636363636
6421,저그/Noun,22,3,19,3.3345930684925414e-05,0.00021103138814225738,0.8636363636363636
6422,고사/Noun,22,3,19,3.3345930684925414e-05,0.00021103138814225738,0.8636363636363636
6423,바하/Noun,22,4,18,4.446124091323389e-05,0.0001999244729768754,0.8181818181818182
6424,악행/Noun,22,4,18,4.446124091323389e-05,0.0001999244729768754,0.8181818181818182
6425,쫙/Noun,22,18,4,0.0002000755841095525,4.4427660661527865e-05,0.8181818181818182
6426,윤진서/Noun,22,4,18,4.446124091323389e-05,0.0001999244729768754,0.8181818181818182
6427,연설/Noun,22,18,4,0.0002000755841095525,4.4427660661527865e-05,0.8181818181818182
6428,가시다/Verb,22,18,4,0.0002000755841095525,4.4427660661527865e-05,0.8181818181818182
6429,",,,,,/Punctuation",22,4,18,4.446124091323389e-05,0.0001999244729768754,0.8181818181818182
6430,꼴다/Verb,22,4,18,4.446124091323389e-05,0.0001999244729768754,0.8181818181818182
6431,최수종/Noun,22,18,4,0.0002000755841095525,4.4427660661527865e-05,0.8181818181818182
6432,베드씬/Noun,22,4,18,4.446124091323389e-05,0.0001999244729768754,0.8181818181818182
6433,대인/Noun,22,18,4,0.0002000755841095525,4.4427660661527865e-05,0.8181818181818182
6434,쿵푸팬더/Noun,22,4,18,4.446124091323389e-05,0.0001999244729768754,0.8181818181818182
6435,민주화/Noun,22,4,18,4.446124091323389e-05,0.0001999244729768754,0.8181818181818182
6436,미숙/Noun,22,4,18,4.446124091323389e-05,0.0001999244729768754,0.8181818181818182
6437,소유진/Noun,22,4,18,4.446124091323389e-05,0.0001999244729768754,0.8181818181818182
6438,일관/Noun,22,4,18,4.446124091323389e-05,0.0001999244729768754,0.8181818181818182
6439,월화/Noun,22,17,5,0.00018896027388124403,5.5534575826909837e-05,0.7727272727272727
6440,위성/Noun,22,5,17,5.557655114154236e-05,0.00018881755781149343,0.7727272727272727
6441,외로/Noun,22,17,5,0.00018896027388124403,5.5534575826909837e-05,0.7727272727272727
6442,초콜릿/Noun,22,17,5,0.00018896027388124403,5.5534575826909837e-05,0.7727272727272727
6443,김민희/Noun,22,17,5,0.00018896027388124403,5.5534575826909837e-05,0.7727272727272727
6444,나잇/Noun,22,5,17,5.557655114154236e-05,0.00018881755781149343,0.7727272727272727
6445,낯설다/Adjective,22,17,5,0.00018896027388124403,5.5534575826909837e-05,0.7727272727272727
6446,라기보단/Josa,22,5,17,5.557655114154236e-05,0.00018881755781149343,0.7727272727272727
6447,치우치다/Verb,22,5,17,5.557655114154236e-05,0.00018881755781149343,0.7727272727272727
6448,냉소/Noun,22,17,5,0.00018896027388124403,5.5534575826909837e-05,0.7727272727272727
6449,하하/Exclamation,22,5,17,5.557655114154236e-05,0.00018881755781149343,0.7727272727272727
6450,40년/Number,22,17,5,0.00018896027388124403,5.5534575826909837e-05,0.7727272727272727
6451,변질/Noun,22,5,17,5.557655114154236e-05,0.00018881755781149343,0.7727272727272727
6452,마녀사냥/Noun,22,17,5,0.00018896027388124403,5.5534575826909837e-05,0.7727272727272727
6453,쨩/Suffix,22,17,5,0.00018896027388124403,5.5534575826909837e-05,0.7727272727272727
6454,연구/Noun,22,5,17,5.557655114154236e-05,0.00018881755781149343,0.7727272727272727
6455,종교영화/Noun,22,6,16,6.669186136985083e-05,0.00017771064264611146,0.7272727272727273
6456,조선시대/Noun,22,6,16,6.669186136985083e-05,0.00017771064264611146,0.7272727272727273
6457,비틀즈/Noun,22,16,6,0.00017784496365293555,6.66414909922918e-05,0.7272727272727273
6458,배달/Noun,22,6,16,6.669186136985083e-05,0.00017771064264611146,0.7272727272727273
6459,입맛/Noun,22,6,16,6.669186136985083e-05,0.00017771064264611146,0.7272727272727273
6460,사태/Noun,22,6,16,6.669186136985083e-05,0.00017771064264611146,0.7272727272727273
6461,울버린/Noun,22,6,16,6.669186136985083e-05,0.00017771064264611146,0.7272727272727273
6462,바이올린/Noun,22,16,6,0.00017784496365293555,6.66414909922918e-05,0.7272727272727273
6463,ㅇㅅㅇ/KoreanParticle,22,16,6,0.00017784496365293555,6.66414909922918e-05,0.7272727272727273
6464,마시다/Verb,22,6,16,6.669186136985083e-05,0.00017771064264611146,0.7272727272727273
6465,간지나다/Verb,22,16,6,0.00017784496365293555,6.66414909922918e-05,0.7272727272727273
6466,이지나/Noun,22,16,6,0.00017784496365293555,6.66414909922918e-05,0.7272727272727273
6467,올바르다/Adjective,22,16,6,0.00017784496365293555,6.66414909922918e-05,0.7272727272727273
6468,95년/Number,22,15,7,0.00016672965342462708,7.774840615767377e-05,0.6818181818181818
6469,털/Noun,22,7,15,7.78071715981593e-05,0.0001666037274807295,0.6818181818181818
6470,서바이벌/Noun,22,7,15,7.78071715981593e-05,0.0001666037274807295,0.6818181818181818
6471,김윤진/Noun,22,7,15,7.78071715981593e-05,0.0001666037274807295,0.6818181818181818
6472,E/Alpha,22,7,15,7.78071715981593e-05,0.0001666037274807295,0.6818181818181818
6473,청춘영화/Noun,22,15,7,0.00016672965342462708,7.774840615767377e-05,0.6818181818181818
6474,무덤/Noun,22,7,15,7.78071715981593e-05,0.0001666037274807295,0.6818181818181818
6475,심해/Noun,22,7,15,7.78071715981593e-05,0.0001666037274807295,0.6818181818181818
6476,덜다/Verb,22,7,15,7.78071715981593e-05,0.0001666037274807295,0.6818181818181818
6477,무고/Noun,22,7,15,7.78071715981593e-05,0.0001666037274807295,0.6818181818181818
6478,지라/Noun,22,15,7,0.00016672965342462708,7.774840615767377e-05,0.6818181818181818
6479,보영/Noun,22,15,7,0.00016672965342462708,7.774840615767377e-05,0.6818181818181818
6480,그따위/Noun,22,7,15,7.78071715981593e-05,0.0001666037274807295,0.6818181818181818
6481,헌터/Noun,22,7,15,7.78071715981593e-05,0.0001666037274807295,0.6818181818181818
6482,지상파/Noun,22,15,7,0.00016672965342462708,7.774840615767377e-05,0.6818181818181818
6483,동화책/Noun,22,15,7,0.00016672965342462708,7.774840615767377e-05,0.6818181818181818
6484,엑소/Noun,22,15,7,0.00016672965342462708,7.774840615767377e-05,0.6818181818181818
6485,시어머니/Noun,22,7,15,7.78071715981593e-05,0.0001666037274807295,0.6818181818181818
6486,개월/Noun,22,15,7,0.00016672965342462708,7.774840615767377e-05,0.6818181818181818
6487,조니/Noun,22,7,15,7.78071715981593e-05,0.0001666037274807295,0.6818181818181818
6488,싸지르다/Verb,22,7,15,7.78071715981593e-05,0.0001666037274807295,0.6818181818181818
6489,뱀/Noun,22,7,15,7.78071715981593e-05,0.0001666037274807295,0.6818181818181818
6490,저격/Noun,22,15,7,0.00016672965342462708,7.774840615767377e-05,0.6818181818181818
6491,~~!!!/Punctuation,22,15,7,0.00016672965342462708,7.774840615767377e-05,0.6818181818181818
6492,번방/Noun,22,15,7,0.00016672965342462708,7.774840615767377e-05,0.6818181818181818
6493,박한별/Noun,22,8,14,8.892248182646778e-05,0.00015549681231534753,0.6363636363636364
6494,이진/Noun,22,8,14,8.892248182646778e-05,0.00015549681231534753,0.6363636363636364
6495,제시카알바/Noun,22,8,14,8.892248182646778e-05,0.00015549681231534753,0.6363636363636364
6496,환희/Noun,22,14,8,0.0001556143431963186,8.885532132305573e-05,0.6363636363636364
6497,인간성/Noun,22,14,8,0.0001556143431963186,8.885532132305573e-05,0.6363636363636364
6498,십대/Noun,22,8,14,8.892248182646778e-05,0.00015549681231534753,0.6363636363636364
6499,이슬람/Noun,22,14,8,0.0001556143431963186,8.885532132305573e-05,0.6363636363636364
6500,병자/Noun,22,8,14,8.892248182646778e-05,0.00015549681231534753,0.6363636363636364
6501,개쩌/Noun,22,14,8,0.0001556143431963186,8.885532132305573e-05,0.6363636363636364
6502,결/Noun,22,8,14,8.892248182646778e-05,0.00015549681231534753,0.6363636363636364
6503,마는/Noun,22,8,14,8.892248182646778e-05,0.00015549681231534753,0.6363636363636364
6504,산타/Noun,22,14,8,0.0001556143431963186,8.885532132305573e-05,0.6363636363636364
6505,달인/Noun,22,8,14,8.892248182646778e-05,0.00015549681231534753,0.6363636363636364
6506,금은/Noun,22,14,8,0.0001556143431963186,8.885532132305573e-05,0.6363636363636364
6507,조르다/Verb,22,8,14,8.892248182646778e-05,0.00015549681231534753,0.6363636363636364
6508,this/Alpha,22,14,8,0.0001556143431963186,8.885532132305573e-05,0.6363636363636364
6509,이상우/Noun,22,14,8,0.0001556143431963186,8.885532132305573e-05,0.6363636363636364
6510,숀/Noun,22,14,8,0.0001556143431963186,8.885532132305573e-05,0.6363636363636364
6511,무명/Noun,22,8,14,8.892248182646778e-05,0.00015549681231534753,0.6363636363636364
6512,불안/Noun,22,14,8,0.0001556143431963186,8.885532132305573e-05,0.6363636363636364
6513,유명배우/Noun,22,8,14,8.892248182646778e-05,0.00015549681231534753,0.6363636363636364
6514,모리/Noun,22,14,8,0.0001556143431963186,8.885532132305573e-05,0.6363636363636364
6515,배제/Noun,22,8,14,8.892248182646778e-05,0.00015549681231534753,0.6363636363636364
6516,어게인/Noun,22,14,8,0.0001556143431963186,8.885532132305573e-05,0.6363636363636364
6517,대답/Noun,22,14,8,0.0001556143431963186,8.885532132305573e-05,0.6363636363636364
6518,몸짓/Noun,22,14,8,0.0001556143431963186,8.885532132305573e-05,0.6363636363636364
6519,카페/Noun,22,14,8,0.0001556143431963186,8.885532132305573e-05,0.6363636363636364
6520,스미스/Noun,22,8,14,8.892248182646778e-05,0.00015549681231534753,0.6363636363636364
6521,물리/Noun,22,8,14,8.892248182646778e-05,0.00015549681231534753,0.6363636363636364
6522,타워/Noun,22,13,9,0.00014449903296801013,9.99622364884377e-05,0.5909090909090909
6523,김보성/Noun,22,9,13,0.00010003779205477625,0.00014438989714996557,0.5909090909090909
6524,핀/Noun,22,9,13,0.00010003779205477625,0.00014438989714996557,0.5909090909090909
6525,배고프다/Adjective,22,13,9,0.00014449903296801013,9.99622364884377e-05,0.5909090909090909
6526,세븐/Noun,22,9,13,0.00010003779205477625,0.00014438989714996557,0.5909090909090909
6527,프리퀄/Noun,22,13,9,0.00014449903296801013,9.99622364884377e-05,0.5909090909090909
6528,맥그리거/Noun,22,13,9,0.00014449903296801013,9.99622364884377e-05,0.5909090909090909
6529,리더/Noun,22,13,9,0.00014449903296801013,9.99622364884377e-05,0.5909090909090909
6530,이롭다/Adjective,22,13,9,0.00014449903296801013,9.99622364884377e-05,0.5909090909090909
6531,지연/Noun,22,13,9,0.00014449903296801013,9.99622364884377e-05,0.5909090909090909
6532,성인영화/Noun,22,9,13,0.00010003779205477625,0.00014438989714996557,0.5909090909090909
6533,먹이/Noun,22,9,13,0.00010003779205477625,0.00014438989714996557,0.5909090909090909
6534,1~2/Number,22,9,13,0.00010003779205477625,0.00014438989714996557,0.5909090909090909
6535,관념/Noun,22,9,13,0.00010003779205477625,0.00014438989714996557,0.5909090909090909
6536,총격/Noun,22,13,9,0.00014449903296801013,9.99622364884377e-05,0.5909090909090909
6537,데미무어/Noun,22,9,13,0.00010003779205477625,0.00014438989714996557,0.5909090909090909
6538,복귀/Noun,22,9,13,0.00010003779205477625,0.00014438989714996557,0.5909090909090909
6539,재희/Noun,22,9,13,0.00010003779205477625,0.00014438989714996557,0.5909090909090909
6540,윤은혜/Noun,22,9,13,0.00010003779205477625,0.00014438989714996557,0.5909090909090909
6541,건강/Noun,22,13,9,0.00014449903296801013,9.99622364884377e-05,0.5909090909090909
6542,후/Foreign,22,9,13,0.00010003779205477625,0.00014438989714996557,0.5909090909090909
6543,비웃다/Verb,22,9,13,0.00010003779205477625,0.00014438989714996557,0.5909090909090909
6544,이즈/Noun,22,12,10,0.00013338372273970166,0.00011106915165381967,0.5454545454545454
6545,애교/Noun,22,12,10,0.00013338372273970166,0.00011106915165381967,0.5454545454545454
6546,비트/Noun,22,12,10,0.00013338372273970166,0.00011106915165381967,0.5454545454545454
6547,껀/Noun,22,10,12,0.00011115310228308472,0.0001332829819845836,0.5454545454545454
6548,박물관/Noun,22,12,10,0.00013338372273970166,0.00011106915165381967,0.5454545454545454
6549,스포츠영화/Noun,22,12,10,0.00013338372273970166,0.00011106915165381967,0.5454545454545454
6550,수녀/Noun,22,12,10,0.00013338372273970166,0.00011106915165381967,0.5454545454545454
6551,개봉일/Noun,22,10,12,0.00011115310228308472,0.0001332829819845836,0.5454545454545454
6552,취권/Noun,22,10,12,0.00011115310228308472,0.0001332829819845836,0.5454545454545454
6553,~~~~~~~~/Punctuation,22,10,12,0.00011115310228308472,0.0001332829819845836,0.5454545454545454
6554,만지다/Verb,22,12,10,0.00013338372273970166,0.00011106915165381967,0.5454545454545454
6555,재탕하다/Adjective,22,12,10,0.00013338372273970166,0.00011106915165381967,0.5454545454545454
6556,나치/Noun,22,10,12,0.00011115310228308472,0.0001332829819845836,0.5454545454545454
6557,m/Alpha,22,10,12,0.00011115310228308472,0.0001332829819845836,0.5454545454545454
6558,이익/Noun,22,12,10,0.00013338372273970166,0.00011106915165381967,0.5454545454545454
6559,불어/Noun,22,12,10,0.00013338372273970166,0.00011106915165381967,0.5454545454545454
6560,솔로/Noun,22,10,12,0.00011115310228308472,0.0001332829819845836,0.5454545454545454
6561,취해/Noun,22,12,10,0.00013338372273970166,0.00011106915165381967,0.5454545454545454
6562,스크림/Noun,22,12,10,0.00013338372273970166,0.00011106915165381967,0.5454545454545454
6563,인디언/Noun,22,12,10,0.00013338372273970166,0.00011106915165381967,0.5454545454545454
6564,책임지다/Verb,22,10,12,0.00011115310228308472,0.0001332829819845836,0.5454545454545454
6565,직하다/Adjective,22,12,10,0.00013338372273970166,0.00011106915165381967,0.5454545454545454
6566,이라는/Foreign,22,12,10,0.00013338372273970166,0.00011106915165381967,0.5454545454545454
6567,훨낫다/Adjective,22,12,10,0.00013338372273970166,0.00011106915165381967,0.5454545454545454
6568,서커스/Noun,22,10,12,0.00011115310228308472,0.0001332829819845836,0.5454545454545454
6569,한적/Noun,22,10,12,0.00011115310228308472,0.0001332829819845836,0.5454545454545454
6570,1초/Number,22,12,10,0.00013338372273970166,0.00011106915165381967,0.5454545454545454
6571,습격/Noun,22,10,12,0.00011115310228308472,0.0001332829819845836,0.5454545454545454
6572,주리/Noun,22,11,11,0.00012226841251139318,0.00012217606681920164,0.5
6573,파티/Noun,22,11,11,0.00012226841251139318,0.00012217606681920164,0.5
6574,살림/Noun,22,11,11,0.00012226841251139318,0.00012217606681920164,0.5
6575,마스크/Noun,22,11,11,0.00012226841251139318,0.00012217606681920164,0.5
6576,스토커/Noun,22,11,11,0.00012226841251139318,0.00012217606681920164,0.5
6577,줄줄/Noun,22,11,11,0.00012226841251139318,0.00012217606681920164,0.5
6578,유산/Noun,22,11,11,0.00012226841251139318,0.00012217606681920164,0.5
6579,오마쥬/Noun,22,11,11,0.00012226841251139318,0.00012217606681920164,0.5
6580,박현지/Noun,21,0,21,0.0,0.0002332452184730213,1.0
6581,유머러스하다/Adjective,21,21,0,0.00023342151479447792,0.0,1.0
6582,똥망/Noun,21,0,21,0.0,0.0002332452184730213,1.0
6583,이수근/Noun,21,0,21,0.0,0.0002332452184730213,1.0
6584,재즈/Noun,21,20,1,0.00022230620456616945,1.1106915165381966e-05,0.9523809523809523
6585,인내력/Noun,21,1,20,1.1115310228308472e-05,0.00022213830330763935,0.9523809523809523
6586,입력/Noun,21,1,20,1.1115310228308472e-05,0.00022213830330763935,0.9523809523809523
6587,조장/Noun,21,1,20,1.1115310228308472e-05,0.00022213830330763935,0.9523809523809523
6588,봣어/Noun,21,20,1,0.00022230620456616945,1.1106915165381966e-05,0.9523809523809523
6589,김현주/Noun,21,20,1,0.00022230620456616945,1.1106915165381966e-05,0.9523809523809523
6590,후레쉬맨/Noun,21,1,20,1.1115310228308472e-05,0.00022213830330763935,0.9523809523809523
6591,접영/Noun,21,1,20,1.1115310228308472e-05,0.00022213830330763935,0.9523809523809523
6592,멎다/Verb,21,20,1,0.00022230620456616945,1.1106915165381966e-05,0.9523809523809523
6593,개망작/Noun,21,1,20,1.1115310228308472e-05,0.00022213830330763935,0.9523809523809523
6594,긴지/Noun,21,1,20,1.1115310228308472e-05,0.00022213830330763935,0.9523809523809523
6595,퇴보/Noun,21,2,19,2.2230620456616944e-05,0.00021103138814225738,0.9047619047619048
6596,우스꽝스럽다/Adjective,21,2,19,2.2230620456616944e-05,0.00021103138814225738,0.9047619047619048
6597,귓가/Noun,21,19,2,0.00021119089433786097,2.2213830330763933e-05,0.9047619047619048
6598,협박/Noun,21,2,19,2.2230620456616944e-05,0.00021103138814225738,0.9047619047619048
6599,과분/Noun,21,2,19,2.2230620456616944e-05,0.00021103138814225738,0.9047619047619048
6600,훌쩍/Noun,21,19,2,0.00021119089433786097,2.2213830330763933e-05,0.9047619047619048
6601,탱고/Noun,21,19,2,0.00021119089433786097,2.2213830330763933e-05,0.9047619047619048
6602,핑계/Noun,21,2,19,2.2230620456616944e-05,0.00021103138814225738,0.9047619047619048
6603,개떡같다/Adjective,21,2,19,2.2230620456616944e-05,0.00021103138814225738,0.9047619047619048
6604,이래도/Josa,21,2,19,2.2230620456616944e-05,0.00021103138814225738,0.9047619047619048
6605,..-_-/Punctuation,21,3,18,3.3345930684925414e-05,0.0001999244729768754,0.8571428571428571
6606,99년/Number,21,18,3,0.0002000755841095525,3.33207454961459e-05,0.8571428571428571
6607,참패/Noun,21,3,18,3.3345930684925414e-05,0.0001999244729768754,0.8571428571428571
6608,성지순례/Noun,21,3,18,3.3345930684925414e-05,0.0001999244729768754,0.8571428571428571
6609,문채원/Noun,21,18,3,0.0002000755841095525,3.33207454961459e-05,0.8571428571428571
6610,저따위/Noun,21,3,18,3.3345930684925414e-05,0.0001999244729768754,0.8571428571428571
6611,매료/Noun,21,18,3,0.0002000755841095525,3.33207454961459e-05,0.8571428571428571
6612,조국/Noun,21,18,3,0.0002000755841095525,3.33207454961459e-05,0.8571428571428571
6613,장동민/Noun,21,18,3,0.0002000755841095525,3.33207454961459e-05,0.8571428571428571
6614,하모니/Noun,21,18,3,0.0002000755841095525,3.33207454961459e-05,0.8571428571428571
6615,장황하다/Adjective,21,3,18,3.3345930684925414e-05,0.0001999244729768754,0.8571428571428571
6616,진실하다/Adjective,21,18,3,0.0002000755841095525,3.33207454961459e-05,0.8571428571428571
6617,하트/Noun,21,18,3,0.0002000755841095525,3.33207454961459e-05,0.8571428571428571
6618,둔갑/Noun,21,3,18,3.3345930684925414e-05,0.0001999244729768754,0.8571428571428571
6619,꾀/Noun,21,18,3,0.0002000755841095525,3.33207454961459e-05,0.8571428571428571
6620,끼들/Adverb,21,3,18,3.3345930684925414e-05,0.0001999244729768754,0.8571428571428571
6621,으로부터/Josa,21,18,3,0.0002000755841095525,3.33207454961459e-05,0.8571428571428571
6622,강원도/Noun,21,3,18,3.3345930684925414e-05,0.0001999244729768754,0.8571428571428571
6623,한층/Noun,21,18,3,0.0002000755841095525,3.33207454961459e-05,0.8571428571428571
6624,마스터피스/Noun,21,18,3,0.0002000755841095525,3.33207454961459e-05,0.8571428571428571
6625,굵다/Adjective,21,17,4,0.00018896027388124403,4.4427660661527865e-05,0.8095238095238095
6626,하다못해/Adverb,21,4,17,4.446124091323389e-05,0.00018881755781149343,0.8095238095238095
6627,방지/Noun,21,4,17,4.446124091323389e-05,0.00018881755781149343,0.8095238095238095
6628,가다가/Noun,21,4,17,4.446124091323389e-05,0.00018881755781149343,0.8095238095238095
6629,범작/Noun,21,4,17,4.446124091323389e-05,0.00018881755781149343,0.8095238095238095
6630,시원시원하다/Adjective,21,17,4,0.00018896027388124403,4.4427660661527865e-05,0.8095238095238095
6631,어쩌구/Noun,21,4,17,4.446124091323389e-05,0.00018881755781149343,0.8095238095238095
6632,오오오/Noun,21,17,4,0.00018896027388124403,4.4427660661527865e-05,0.8095238095238095
6633,눈살/Noun,21,4,17,4.446124091323389e-05,0.00018881755781149343,0.8095238095238095
6634,미셸/Noun,21,17,4,0.00018896027388124403,4.4427660661527865e-05,0.8095238095238095
6635,줄라/Noun,21,4,17,4.446124091323389e-05,0.00018881755781149343,0.8095238095238095
6636,편향/Noun,21,4,17,4.446124091323389e-05,0.00018881755781149343,0.8095238095238095
6637,긴장도/Noun,21,4,17,4.446124091323389e-05,0.00018881755781149343,0.8095238095238095
6638,동떨어지다/Adjective,21,4,17,4.446124091323389e-05,0.00018881755781149343,0.8095238095238095
6639,뚝/Noun,21,5,16,5.557655114154236e-05,0.00017771064264611146,0.7619047619047619
6640,트루/Noun,21,5,16,5.557655114154236e-05,0.00017771064264611146,0.7619047619047619
6641,재림/Noun,21,5,16,5.557655114154236e-05,0.00017771064264611146,0.7619047619047619
6642,레즈/Noun,21,5,16,5.557655114154236e-05,0.00017771064264611146,0.7619047619047619
6643,오죽하다/Adjective,21,5,16,5.557655114154236e-05,0.00017771064264611146,0.7619047619047619
6644,파도/Noun,21,16,5,0.00017784496365293555,5.5534575826909837e-05,0.7619047619047619
6645,젖/Noun,21,5,16,5.557655114154236e-05,0.00017771064264611146,0.7619047619047619
6646,결여/Noun,21,5,16,5.557655114154236e-05,0.00017771064264611146,0.7619047619047619
6647,절때/Noun,21,5,16,5.557655114154236e-05,0.00017771064264611146,0.7619047619047619
6648,“/Foreign,21,5,16,5.557655114154236e-05,0.00017771064264611146,0.7619047619047619
6649,콩가루/Noun,21,5,16,5.557655114154236e-05,0.00017771064264611146,0.7619047619047619
6650,쌩뚱맞/Noun,21,5,16,5.557655114154236e-05,0.00017771064264611146,0.7619047619047619
6651,댄서/Noun,21,5,16,5.557655114154236e-05,0.00017771064264611146,0.7619047619047619
6652,느님/Noun,21,16,5,0.00017784496365293555,5.5534575826909837e-05,0.7619047619047619
6653,짚다/Verb,21,15,6,0.00016672965342462708,6.66414909922918e-05,0.7142857142857143
6654,인용/Noun,21,6,15,6.669186136985083e-05,0.0001666037274807295,0.7142857142857143
6655,음모론/Noun,21,6,15,6.669186136985083e-05,0.0001666037274807295,0.7142857142857143
6656,!!!!!!!!!!!/Punctuation,21,15,6,0.00016672965342462708,6.66414909922918e-05,0.7142857142857143
6657,재연/Noun,21,6,15,6.669186136985083e-05,0.0001666037274807295,0.7142857142857143
6658,작고/Noun,21,6,15,6.669186136985083e-05,0.0001666037274807295,0.7142857142857143
6659,대서/Noun,21,6,15,6.669186136985083e-05,0.0001666037274807295,0.7142857142857143
6660,걸음/Noun,21,15,6,0.00016672965342462708,6.66414909922918e-05,0.7142857142857143
6661,지향/Noun,21,6,15,6.669186136985083e-05,0.0001666037274807295,0.7142857142857143
6662,보람/Noun,21,15,6,0.00016672965342462708,6.66414909922918e-05,0.7142857142857143
6663,강우석/Noun,21,6,15,6.669186136985083e-05,0.0001666037274807295,0.7142857142857143
6664,일진/Noun,21,6,15,6.669186136985083e-05,0.0001666037274807295,0.7142857142857143
6665,금도/Noun,21,15,6,0.00016672965342462708,6.66414909922918e-05,0.7142857142857143
6666,다짐/Noun,21,15,6,0.00016672965342462708,6.66414909922918e-05,0.7142857142857143
6667,화재/Noun,21,6,15,6.669186136985083e-05,0.0001666037274807295,0.7142857142857143
6668,ㅇㅋ/KoreanParticle,21,6,15,6.669186136985083e-05,0.0001666037274807295,0.7142857142857143
6669,명분/Noun,21,6,15,6.669186136985083e-05,0.0001666037274807295,0.7142857142857143
6670,영애/Noun,21,15,6,0.00016672965342462708,6.66414909922918e-05,0.7142857142857143
6671,무었/Noun,21,15,6,0.00016672965342462708,6.66414909922918e-05,0.7142857142857143
6672,에이미/Noun,21,14,7,0.0001556143431963186,7.774840615767377e-05,0.6666666666666666
6673,악녀/Noun,21,7,14,7.78071715981593e-05,0.00015549681231534753,0.6666666666666666
6674,싱어/Noun,21,14,7,0.0001556143431963186,7.774840615767377e-05,0.6666666666666666
6675,수능/Noun,21,14,7,0.0001556143431963186,7.774840615767377e-05,0.6666666666666666
6676,시가/Noun,21,14,7,0.0001556143431963186,7.774840615767377e-05,0.6666666666666666
6677,괴담/Noun,21,7,14,7.78071715981593e-05,0.00015549681231534753,0.6666666666666666
6678,일제/Noun,21,7,14,7.78071715981593e-05,0.00015549681231534753,0.6666666666666666
6679,****/Punctuation,21,14,7,0.0001556143431963186,7.774840615767377e-05,0.6666666666666666
6680,푸하하하/Noun,21,7,14,7.78071715981593e-05,0.00015549681231534753,0.6666666666666666
6681,재수/Noun,21,7,14,7.78071715981593e-05,0.00015549681231534753,0.6666666666666666
6682,김민준/Noun,21,7,14,7.78071715981593e-05,0.00015549681231534753,0.6666666666666666
6683,둘이서/Noun,21,7,14,7.78071715981593e-05,0.00015549681231534753,0.6666666666666666
6684,핸드/Noun,21,7,14,7.78071715981593e-05,0.00015549681231534753,0.6666666666666666
6685,제격/Noun,21,14,7,0.0001556143431963186,7.774840615767377e-05,0.6666666666666666
6686,정녕/Noun,21,7,14,7.78071715981593e-05,0.00015549681231534753,0.6666666666666666
6687,을해/Noun,21,7,14,7.78071715981593e-05,0.00015549681231534753,0.6666666666666666
6688,근대/Noun,21,14,7,0.0001556143431963186,7.774840615767377e-05,0.6666666666666666
6689,쑤다/Verb,21,7,14,7.78071715981593e-05,0.00015549681231534753,0.6666666666666666
6690,동경/Noun,21,14,7,0.0001556143431963186,7.774840615767377e-05,0.6666666666666666
6691,사업/Noun,21,7,14,7.78071715981593e-05,0.00015549681231534753,0.6666666666666666
6692,베토벤/Noun,21,14,7,0.0001556143431963186,7.774840615767377e-05,0.6666666666666666
6693,런/Noun,21,14,7,0.0001556143431963186,7.774840615767377e-05,0.6666666666666666
6694,넘버/Noun,21,14,7,0.0001556143431963186,7.774840615767377e-05,0.6666666666666666
6695,댓글달다/Verb,21,7,14,7.78071715981593e-05,0.00015549681231534753,0.6666666666666666
6696,차기작/Noun,21,14,7,0.0001556143431963186,7.774840615767377e-05,0.6666666666666666
6697,훅/Noun,21,7,14,7.78071715981593e-05,0.00015549681231534753,0.6666666666666666
6698,주요/Modifier,21,7,14,7.78071715981593e-05,0.00015549681231534753,0.6666666666666666
6699,나래/Noun,21,7,14,7.78071715981593e-05,0.00015549681231534753,0.6666666666666666
6700,한결같다/Adjective,21,7,14,7.78071715981593e-05,0.00015549681231534753,0.6666666666666666
6701,연평해전/Noun,21,7,14,7.78071715981593e-05,0.00015549681231534753,0.6666666666666666
6702,잊어버리다/Verb,21,14,7,0.0001556143431963186,7.774840615767377e-05,0.6666666666666666
6703,어이없이/Adverb,21,7,14,7.78071715981593e-05,0.00015549681231534753,0.6666666666666666
6704,쿠엔틴/Noun,21,13,8,0.00014449903296801013,8.885532132305573e-05,0.6190476190476191
6705,염정아/Noun,21,13,8,0.00014449903296801013,8.885532132305573e-05,0.6190476190476191
6706,오드리/Noun,21,13,8,0.00014449903296801013,8.885532132305573e-05,0.6190476190476191
6707,빨르다/Adjective,21,8,13,8.892248182646778e-05,0.00014438989714996557,0.6190476190476191
6708,테마/Noun,21,8,13,8.892248182646778e-05,0.00014438989714996557,0.6190476190476191
6709,문소리/Noun,21,13,8,0.00014449903296801013,8.885532132305573e-05,0.6190476190476191
6710,소녀시대/Noun,21,8,13,8.892248182646778e-05,0.00014438989714996557,0.6190476190476191
6711,상도/Noun,21,13,8,0.00014449903296801013,8.885532132305573e-05,0.6190476190476191
6712,똥꼬/Noun,21,8,13,8.892248182646778e-05,0.00014438989714996557,0.6190476190476191
6713,백프로/Noun,21,8,13,8.892248182646778e-05,0.00014438989714996557,0.6190476190476191
6714,................./Punctuation,21,8,13,8.892248182646778e-05,0.00014438989714996557,0.6190476190476191
6715,not/Alpha,21,13,8,0.00014449903296801013,8.885532132305573e-05,0.6190476190476191
6716,리프/Noun,21,8,13,8.892248182646778e-05,0.00014438989714996557,0.6190476190476191
6717,식구/Noun,21,8,13,8.892248182646778e-05,0.00014438989714996557,0.6190476190476191
6718,대들다/Verb,21,8,13,8.892248182646778e-05,0.00014438989714996557,0.6190476190476191
6719,이제훈/Noun,21,13,8,0.00014449903296801013,8.885532132305573e-05,0.6190476190476191
6720,냥/Noun,21,8,13,8.892248182646778e-05,0.00014438989714996557,0.6190476190476191
6721,벨루치/Noun,21,8,13,8.892248182646778e-05,0.00014438989714996557,0.6190476190476191
6722,호주/Noun,21,8,13,8.892248182646778e-05,0.00014438989714996557,0.6190476190476191
6723,여군/Noun,21,8,13,8.892248182646778e-05,0.00014438989714996557,0.6190476190476191
6724,눈앞/Noun,21,13,8,0.00014449903296801013,8.885532132305573e-05,0.6190476190476191
6725,교도소/Noun,21,8,13,8.892248182646778e-05,0.00014438989714996557,0.6190476190476191
6726,힘없다/Adjective,21,12,9,0.00013338372273970166,9.99622364884377e-05,0.5714285714285714
6727,거구/Noun,21,12,9,0.00013338372273970166,9.99622364884377e-05,0.5714285714285714
6728,삼박자/Noun,21,12,9,0.00013338372273970166,9.99622364884377e-05,0.5714285714285714
6729,러시/Noun,21,12,9,0.00013338372273970166,9.99622364884377e-05,0.5714285714285714
6730,마모루/Noun,21,9,12,0.00010003779205477625,0.0001332829819845836,0.5714285714285714
6731,박스오피스/Noun,21,9,12,0.00010003779205477625,0.0001332829819845836,0.5714285714285714
6732,찍기/Noun,21,9,12,0.00010003779205477625,0.0001332829819845836,0.5714285714285714
6733,마스터/Noun,21,12,9,0.00013338372273970166,9.99622364884377e-05,0.5714285714285714
6734,백/Suffix,21,12,9,0.00013338372273970166,9.99622364884377e-05,0.5714285714285714
6735,만이라도/Josa,21,12,9,0.00013338372273970166,9.99622364884377e-05,0.5714285714285714
6736,범벅/Noun,21,12,9,0.00013338372273970166,9.99622364884377e-05,0.5714285714285714
6737,룰/Noun,21,9,12,0.00010003779205477625,0.0001332829819845836,0.5714285714285714
6738,발칙하다/Adjective,21,12,9,0.00013338372273970166,9.99622364884377e-05,0.5714285714285714
6739,억/Noun,21,9,12,0.00010003779205477625,0.0001332829819845836,0.5714285714285714
6740,깜짝깜짝/Adverb,21,9,12,0.00010003779205477625,0.0001332829819845836,0.5714285714285714
6741,카메오/Noun,21,9,12,0.00010003779205477625,0.0001332829819845836,0.5714285714285714
6742,매체/Noun,21,12,9,0.00013338372273970166,9.99622364884377e-05,0.5714285714285714
6743,시퀀스/Noun,21,12,9,0.00013338372273970166,9.99622364884377e-05,0.5714285714285714
6744,스케/Noun,21,12,9,0.00013338372273970166,9.99622364884377e-05,0.5714285714285714
6745,쌍벽/Noun,21,9,12,0.00010003779205477625,0.0001332829819845836,0.5714285714285714
6746,바비/Noun,21,12,9,0.00013338372273970166,9.99622364884377e-05,0.5714285714285714
6747,뭉치다/Verb,21,9,12,0.00010003779205477625,0.0001332829819845836,0.5714285714285714
6748,오씨/Noun,21,9,12,0.00010003779205477625,0.0001332829819845836,0.5714285714285714
6749,BGM/Alpha,21,12,9,0.00013338372273970166,9.99622364884377e-05,0.5714285714285714
6750,히틀러/Noun,21,12,9,0.00013338372273970166,9.99622364884377e-05,0.5714285714285714
6751,패배/Noun,21,12,9,0.00013338372273970166,9.99622364884377e-05,0.5714285714285714
6752,각심/Noun,21,12,9,0.00013338372273970166,9.99622364884377e-05,0.5714285714285714
6753,친척/Noun,21,9,12,0.00010003779205477625,0.0001332829819845836,0.5714285714285714
6754,2분/Number,21,9,12,0.00010003779205477625,0.0001332829819845836,0.5714285714285714
6755,유대인/Noun,21,12,9,0.00013338372273970166,9.99622364884377e-05,0.5714285714285714
6756,남상미/Noun,21,9,12,0.00010003779205477625,0.0001332829819845836,0.5714285714285714
6757,모자이크/Noun,21,9,12,0.00010003779205477625,0.0001332829819845836,0.5714285714285714
6758,메카/Noun,21,11,10,0.00012226841251139318,0.00011106915165381967,0.5238095238095238
6759,조안/Noun,21,11,10,0.00012226841251139318,0.00011106915165381967,0.5238095238095238
6760,정준호/Noun,21,10,11,0.00011115310228308472,0.00012217606681920164,0.5238095238095238
6761,퍼센트/Noun,21,11,10,0.00012226841251139318,0.00011106915165381967,0.5238095238095238
6762,워쇼스키/Noun,21,11,10,0.00012226841251139318,0.00011106915165381967,0.5238095238095238
6763,전두환/Noun,21,10,11,0.00011115310228308472,0.00012217606681920164,0.5238095238095238
6764,따라잡다/Verb,21,10,11,0.00011115310228308472,0.00012217606681920164,0.5238095238095238
6765,타임머신/Noun,21,11,10,0.00012226841251139318,0.00011106915165381967,0.5238095238095238
6766,그레이/Noun,21,11,10,0.00012226841251139318,0.00011106915165381967,0.5238095238095238
6767,루시/Noun,21,10,11,0.00011115310228308472,0.00012217606681920164,0.5238095238095238
6768,안내/Noun,21,10,11,0.00011115310228308472,0.00012217606681920164,0.5238095238095238
6769,정치인/Noun,21,11,10,0.00012226841251139318,0.00011106915165381967,0.5238095238095238
6770,욱/Noun,21,10,11,0.00011115310228308472,0.00012217606681920164,0.5238095238095238
6771,중점/Noun,21,10,11,0.00011115310228308472,0.00012217606681920164,0.5238095238095238
6772,그다음/Noun,21,11,10,0.00012226841251139318,0.00011106915165381967,0.5238095238095238
6773,배틀/Noun,21,11,10,0.00012226841251139318,0.00011106915165381967,0.5238095238095238
6774,팍/Noun,21,11,10,0.00012226841251139318,0.00011106915165381967,0.5238095238095238
6775,...)/Punctuation,21,11,10,0.00012226841251139318,0.00011106915165381967,0.5238095238095238
6776,연발/Noun,21,11,10,0.00012226841251139318,0.00011106915165381967,0.5238095238095238
6777,기업/Noun,21,11,10,0.00012226841251139318,0.00011106915165381967,0.5238095238095238
6778,으로서의/Josa,21,11,10,0.00012226841251139318,0.00011106915165381967,0.5238095238095238
6779,극영화/Noun,21,10,11,0.00011115310228308472,0.00012217606681920164,0.5238095238095238
6780,강남/Noun,21,10,11,0.00011115310228308472,0.00012217606681920164,0.5238095238095238
6781,뮤지컬영화/Noun,21,11,10,0.00012226841251139318,0.00011106915165381967,0.5238095238095238
6782,아파트/Noun,21,10,11,0.00011115310228308472,0.00012217606681920164,0.5238095238095238
6783,..)/Punctuation,21,11,10,0.00012226841251139318,0.00011106915165381967,0.5238095238095238
6784,로부터/Noun,21,10,11,0.00011115310228308472,0.00012217606681920164,0.5238095238095238
6785,팩트/Noun,21,11,10,0.00012226841251139318,0.00011106915165381967,0.5238095238095238
6786,우승/Noun,21,10,11,0.00011115310228308472,0.00012217606681920164,0.5238095238095238
6787,낭패/Noun,20,0,20,0.0,0.00022213830330763935,1.0
6788,낚시질/Noun,20,0,20,0.0,0.00022213830330763935,1.0
6789,GOOD/Alpha,20,19,1,0.00021119089433786097,1.1106915165381966e-05,0.95
6790,맛없다/Adjective,20,1,19,1.1115310228308472e-05,0.00021103138814225738,0.95
6791,자연스레/Adverb,20,19,1,0.00021119089433786097,1.1106915165381966e-05,0.95
6792,^^~/Punctuation,20,19,1,0.00021119089433786097,1.1106915165381966e-05,0.95
6793,우기다/Verb,20,1,19,1.1115310228308472e-05,0.00021103138814225738,0.95
6794,어따/Exclamation,20,1,19,1.1115310228308472e-05,0.00021103138814225738,0.95
6795,잔치/Noun,20,1,19,1.1115310228308472e-05,0.00021103138814225738,0.95
6796,무미건조하다/Adjective,20,1,19,1.1115310228308472e-05,0.00021103138814225738,0.95
6797,꽉차다/Verb,20,18,2,0.0002000755841095525,2.2213830330763933e-05,0.9
6798,기한/Noun,20,2,18,2.2230620456616944e-05,0.0001999244729768754,0.9
6799,뷁/Noun,20,2,18,2.2230620456616944e-05,0.0001999244729768754,0.9
6800,보다/Foreign,20,2,18,2.2230620456616944e-05,0.0001999244729768754,0.9
6801,노소/Noun,20,18,2,0.0002000755841095525,2.2213830330763933e-05,0.9
6802,한구석/Noun,20,18,2,0.0002000755841095525,2.2213830330763933e-05,0.9
6803,유년/Noun,20,18,2,0.0002000755841095525,2.2213830330763933e-05,0.9
6804,mc/Alpha,20,2,18,2.2230620456616944e-05,0.0001999244729768754,0.9
6805,양키/Noun,20,2,18,2.2230620456616944e-05,0.0001999244729768754,0.9
6806,미워하다/Adjective,20,17,3,0.00018896027388124403,3.33207454961459e-05,0.85
6807,고추/Noun,20,3,17,3.3345930684925414e-05,0.00018881755781149343,0.85
6808,박진영/Noun,20,3,17,3.3345930684925414e-05,0.00018881755781149343,0.85
6809,>_</Punctuation,20,17,3,0.00018896027388124403,3.33207454961459e-05,0.85
6810,자국/Noun,20,3,17,3.3345930684925414e-05,0.00018881755781149343,0.85
6811,쫄깃/Noun,20,17,3,0.00018896027388124403,3.33207454961459e-05,0.85
6812,테일러/Noun,20,17,3,0.00018896027388124403,3.33207454961459e-05,0.85
6813,명백하다/Adjective,20,3,17,3.3345930684925414e-05,0.00018881755781149343,0.85
6814,드릅/Noun,20,3,17,3.3345930684925414e-05,0.00018881755781149343,0.85
6815,탈락/Noun,20,3,17,3.3345930684925414e-05,0.00018881755781149343,0.85
6816,나위/Noun,20,17,3,0.00018896027388124403,3.33207454961459e-05,0.85
6817,삼천포/Noun,20,3,17,3.3345930684925414e-05,0.00018881755781149343,0.85
6818,섹/Noun,20,3,17,3.3345930684925414e-05,0.00018881755781149343,0.85
6819,...;/Punctuation,20,3,17,3.3345930684925414e-05,0.00018881755781149343,0.85
6820,떨구다/Verb,20,3,17,3.3345930684925414e-05,0.00018881755781149343,0.85
6821,마더/Noun,20,17,3,0.00018896027388124403,3.33207454961459e-05,0.85
6822,It/Alpha,20,17,3,0.00018896027388124403,3.33207454961459e-05,0.85
6823,생동감/Noun,20,16,4,0.00017784496365293555,4.4427660661527865e-05,0.8
6824,CF/Alpha,20,4,16,4.446124091323389e-05,0.00017771064264611146,0.8
6825,더러/Noun,20,4,16,4.446124091323389e-05,0.00017771064264611146,0.8
6826,친일파/Noun,20,4,16,4.446124091323389e-05,0.00017771064264611146,0.8
6827,쫓기다/Verb,20,4,16,4.446124091323389e-05,0.00017771064264611146,0.8
6828,부진하다/Adjective,20,4,16,4.446124091323389e-05,0.00017771064264611146,0.8
6829,교묘하다/Adjective,20,4,16,4.446124091323389e-05,0.00017771064264611146,0.8
6830,우물/Noun,20,4,16,4.446124091323389e-05,0.00017771064264611146,0.8
6831,읍니/Noun,20,16,4,0.00017784496365293555,4.4427660661527865e-05,0.8
6832,허비하다/Adjective,20,4,16,4.446124091323389e-05,0.00017771064264611146,0.8
6833,수식어/Noun,20,16,4,0.00017784496365293555,4.4427660661527865e-05,0.8
6834,기름/Noun,20,4,16,4.446124091323389e-05,0.00017771064264611146,0.8
6835,박용우/Noun,20,16,4,0.00017784496365293555,4.4427660661527865e-05,0.8
6836,나하/Noun,20,4,16,4.446124091323389e-05,0.00017771064264611146,0.8
6837,람사/Noun,20,16,4,0.00017784496365293555,4.4427660661527865e-05,0.8
6838,앞두다/Verb,20,16,4,0.00017784496365293555,4.4427660661527865e-05,0.8
6839,서글프다/Adjective,20,16,4,0.00017784496365293555,4.4427660661527865e-05,0.8
6840,학적/Noun,20,4,16,4.446124091323389e-05,0.00017771064264611146,0.8
6841,월요일/Noun,20,16,4,0.00017784496365293555,4.4427660661527865e-05,0.8
6842,프랭크/Noun,20,16,4,0.00017784496365293555,4.4427660661527865e-05,0.8
6843,총기/Noun,20,15,5,0.00016672965342462708,5.5534575826909837e-05,0.75
6844,시계/Noun,20,5,15,5.557655114154236e-05,0.0001666037274807295,0.75
6845,소리내다/Verb,20,15,5,0.00016672965342462708,5.5534575826909837e-05,0.75
6846,머리카락/Noun,20,5,15,5.557655114154236e-05,0.0001666037274807295,0.75
6847,가르침/Noun,20,15,5,0.00016672965342462708,5.5534575826909837e-05,0.75
6848,짜장면/Noun,20,5,15,5.557655114154236e-05,0.0001666037274807295,0.75
6849,여사/Noun,20,15,5,0.00016672965342462708,5.5534575826909837e-05,0.75
6850,합작/Noun,20,5,15,5.557655114154236e-05,0.0001666037274807295,0.75
6851,무심코/Noun,20,15,5,0.00016672965342462708,5.5534575826909837e-05,0.75
6852,전무후무/Noun,20,15,5,0.00016672965342462708,5.5534575826909837e-05,0.75
6853,시달리다/Verb,20,5,15,5.557655114154236e-05,0.0001666037274807295,0.75
6854,관해/Noun,20,15,5,0.00016672965342462708,5.5534575826909837e-05,0.75
6855,ever/Alpha,20,15,5,0.00016672965342462708,5.5534575826909837e-05,0.75
6856,얄밉다/Adjective,20,15,5,0.00016672965342462708,5.5534575826909837e-05,0.75
6857,오만하다/Adjective,20,5,15,5.557655114154236e-05,0.0001666037274807295,0.75
6858,노릇/Noun,20,5,15,5.557655114154236e-05,0.0001666037274807295,0.75
6859,경상도/Noun,20,5,15,5.557655114154236e-05,0.0001666037274807295,0.75
6860,학대/Noun,20,5,15,5.557655114154236e-05,0.0001666037274807295,0.75
6861,.~/Punctuation,20,15,5,0.00016672965342462708,5.5534575826909837e-05,0.75
6862,연예/Noun,20,5,15,5.557655114154236e-05,0.0001666037274807295,0.75
6863,세금/Noun,20,5,15,5.557655114154236e-05,0.0001666037274807295,0.75
6864,순정만화/Noun,20,5,15,5.557655114154236e-05,0.0001666037274807295,0.75
6865,이로/Noun,20,14,6,0.0001556143431963186,6.66414909922918e-05,0.7
6866,몰려오다/Verb,20,6,14,6.669186136985083e-05,0.00015549681231534753,0.7
6867,벨라/Noun,20,6,14,6.669186136985083e-05,0.00015549681231534753,0.7
6868,번하다/Adjective,20,6,14,6.669186136985083e-05,0.00015549681231534753,0.7
6869,폰부스/Noun,20,6,14,6.669186136985083e-05,0.00015549681231534753,0.7
6870,유희/Noun,20,14,6,0.0001556143431963186,6.66414909922918e-05,0.7
6871,잡스/Noun,20,6,14,6.669186136985083e-05,0.00015549681231534753,0.7
6872,쿵푸/Noun,20,6,14,6.669186136985083e-05,0.00015549681231534753,0.7
6873,사토시/Noun,20,14,6,0.0001556143431963186,6.66414909922918e-05,0.7
6874,무성영화/Noun,20,14,6,0.0001556143431963186,6.66414909922918e-05,0.7
6875,인데/Foreign,20,6,14,6.669186136985083e-05,0.00015549681231534753,0.7
6876,안에/Foreign,20,6,14,6.669186136985083e-05,0.00015549681231534753,0.7
6877,리플/Noun,20,6,14,6.669186136985083e-05,0.00015549681231534753,0.7
6878,신비하다/Adjective,20,14,6,0.0001556143431963186,6.66414909922918e-05,0.7
6879,켈리/Noun,20,14,6,0.0001556143431963186,6.66414909922918e-05,0.7
6880,페미니즘/Noun,20,6,14,6.669186136985083e-05,0.00015549681231534753,0.7
6881,몰아치다/Verb,20,14,6,0.0001556143431963186,6.66414909922918e-05,0.7
6882,티라노/Noun,20,6,14,6.669186136985083e-05,0.00015549681231534753,0.7
6883,다섯손가락/Noun,20,14,6,0.0001556143431963186,6.66414909922918e-05,0.7
6884,SM/Alpha,20,6,14,6.669186136985083e-05,0.00015549681231534753,0.7
6885,서툴다/Adjective,20,14,6,0.0001556143431963186,6.66414909922918e-05,0.7
6886,불멸/Noun,20,14,6,0.0001556143431963186,6.66414909922918e-05,0.7
6887,은애/Noun,20,6,14,6.669186136985083e-05,0.00015549681231534753,0.7
6888,허각/Noun,20,14,6,0.0001556143431963186,6.66414909922918e-05,0.7
6889,원망/Noun,20,6,14,6.669186136985083e-05,0.00015549681231534753,0.7
6890,송새벽/Noun,20,6,14,6.669186136985083e-05,0.00015549681231534753,0.7
6891,울부짖다/Verb,20,14,6,0.0001556143431963186,6.66414909922918e-05,0.7
6892,꽁/Adverb,20,6,14,6.669186136985083e-05,0.00015549681231534753,0.7
6893,한치/Noun,20,6,14,6.669186136985083e-05,0.00015549681231534753,0.7
6894,즈음/Noun,20,14,6,0.0001556143431963186,6.66414909922918e-05,0.7
6895,pd/Alpha,20,6,14,6.669186136985083e-05,0.00015549681231534753,0.7
6896,마돈나/Noun,20,6,14,6.669186136985083e-05,0.00015549681231534753,0.7
6897,스티/Noun,20,7,13,7.78071715981593e-05,0.00014438989714996557,0.65
6898,김주혁/Noun,20,13,7,0.00014449903296801013,7.774840615767377e-05,0.65
6899,고함/Noun,20,7,13,7.78071715981593e-05,0.00014438989714996557,0.65
6900,밸런스/Noun,20,7,13,7.78071715981593e-05,0.00014438989714996557,0.65
6901,판도/Noun,20,13,7,0.00014449903296801013,7.774840615767377e-05,0.65
6902,연대기/Noun,20,13,7,0.00014449903296801013,7.774840615767377e-05,0.65
6903,신들/Noun,20,7,13,7.78071715981593e-05,0.00014438989714996557,0.65
6904,소라/Noun,20,7,13,7.78071715981593e-05,0.00014438989714996557,0.65
6905,어스/Noun,20,13,7,0.00014449903296801013,7.774840615767377e-05,0.65
6906,모범/Noun,20,13,7,0.00014449903296801013,7.774840615767377e-05,0.65
6907,부각시키다/Verb,20,7,13,7.78071715981593e-05,0.00014438989714996557,0.65
6908,다우니/Noun,20,13,7,0.00014449903296801013,7.774840615767377e-05,0.65
6909,탐험/Noun,20,7,13,7.78071715981593e-05,0.00014438989714996557,0.65
6910,대다수/Noun,20,7,13,7.78071715981593e-05,0.00014438989714996557,0.65
6911,이크/Noun,20,7,13,7.78071715981593e-05,0.00014438989714996557,0.65
6912,대중성/Noun,20,7,13,7.78071715981593e-05,0.00014438989714996557,0.65
6913,부천/Noun,20,13,7,0.00014449903296801013,7.774840615767377e-05,0.65
6914,13일/Number,20,7,13,7.78071715981593e-05,0.00014438989714996557,0.65
6915,김창완/Noun,20,7,13,7.78071715981593e-05,0.00014438989714996557,0.65
6916,미지/Noun,20,13,7,0.00014449903296801013,7.774840615767377e-05,0.65
6917,탐정/Noun,20,7,13,7.78071715981593e-05,0.00014438989714996557,0.65
6918,아이템/Noun,20,7,13,7.78071715981593e-05,0.00014438989714996557,0.65
6919,존트라볼타/Noun,20,13,7,0.00014449903296801013,7.774840615767377e-05,0.65
6920,류승완/Noun,20,8,12,8.892248182646778e-05,0.0001332829819845836,0.6
6921,甲/Foreign,20,12,8,0.00013338372273970166,8.885532132305573e-05,0.6
6922,사람인/Noun,20,8,12,8.892248182646778e-05,0.0001332829819845836,0.6
6923,헤매다/Verb,20,8,12,8.892248182646778e-05,0.0001332829819845836,0.6
6924,주문/Noun,20,8,12,8.892248182646778e-05,0.0001332829819845836,0.6
6925,스웨덴/Noun,20,12,8,0.00013338372273970166,8.885532132305573e-05,0.6
6926,겄/Noun,20,8,12,8.892248182646778e-05,0.0001332829819845836,0.6
6927,존쿠삭/Noun,20,12,8,0.00013338372273970166,8.885532132305573e-05,0.6
6928,top/Alpha,20,12,8,0.00013338372273970166,8.885532132305573e-05,0.6
6929,고난/Noun,20,12,8,0.00013338372273970166,8.885532132305573e-05,0.6
6930,숫자/Noun,20,12,8,0.00013338372273970166,8.885532132305573e-05,0.6
6931,원스/Noun,20,12,8,0.00013338372273970166,8.885532132305573e-05,0.6
6932,록/Noun,20,12,8,0.00013338372273970166,8.885532132305573e-05,0.6
6933,비둘기/Noun,20,8,12,8.892248182646778e-05,0.0001332829819845836,0.6
6934,김옥빈/Noun,20,12,8,0.00013338372273970166,8.885532132305573e-05,0.6
6935,리처드/Noun,20,12,8,0.00013338372273970166,8.885532132305573e-05,0.6
6936,천년/Noun,20,12,8,0.00013338372273970166,8.885532132305573e-05,0.6
6937,김청기/Noun,20,8,12,8.892248182646778e-05,0.0001332829819845836,0.6
6938,아씨/Noun,20,8,12,8.892248182646778e-05,0.0001332829819845836,0.6
6939,고본/Noun,20,8,12,8.892248182646778e-05,0.0001332829819845836,0.6
6940,강예원/Noun,20,8,12,8.892248182646778e-05,0.0001332829819845836,0.6
6941,개운하다/Adjective,20,8,12,8.892248182646778e-05,0.0001332829819845836,0.6
6942,구속/Noun,20,8,12,8.892248182646778e-05,0.0001332829819845836,0.6
6943,네요/Eomi,20,12,8,0.00013338372273970166,8.885532132305573e-05,0.6
6944,up/Alpha,20,12,8,0.00013338372273970166,8.885532132305573e-05,0.6
6945,위협/Noun,20,8,12,8.892248182646778e-05,0.0001332829819845836,0.6
6946,담당/Noun,20,8,12,8.892248182646778e-05,0.0001332829819845836,0.6
6947,전체관람가/Noun,20,8,12,8.892248182646778e-05,0.0001332829819845836,0.6
6948,익숙해지다/Verb,20,12,8,0.00013338372273970166,8.885532132305573e-05,0.6
6949,똘끼/Noun,20,9,11,0.00010003779205477625,0.00012217606681920164,0.55
6950,고스트/Noun,20,9,11,0.00010003779205477625,0.00012217606681920164,0.55
6951,살수/Noun,20,11,9,0.00012226841251139318,9.99622364884377e-05,0.55
6952,유코/Noun,20,11,9,0.00012226841251139318,9.99622364884377e-05,0.55
6953,낄낄/Noun,20,9,11,0.00010003779205477625,0.00012217606681920164,0.55
6954,뮤비/Noun,20,9,11,0.00010003779205477625,0.00012217606681920164,0.55
6955,장수/Noun,20,11,9,0.00012226841251139318,9.99622364884377e-05,0.55
6956,조진웅/Noun,20,11,9,0.00012226841251139318,9.99622364884377e-05,0.55
6957,1만/Number,20,11,9,0.00012226841251139318,9.99622364884377e-05,0.55
6958,라서/Noun,20,9,11,0.00010003779205477625,0.00012217606681920164,0.55
6959,반항/Noun,20,9,11,0.00010003779205477625,0.00012217606681920164,0.55
6960,강도/Noun,20,9,11,0.00010003779205477625,0.00012217606681920164,0.55
6961,최종/Noun,20,9,11,0.00010003779205477625,0.00012217606681920164,0.55
6962,낮아지다/Verb,20,11,9,0.00012226841251139318,9.99622364884377e-05,0.55
6963,생전/Noun,20,11,9,0.00012226841251139318,9.99622364884377e-05,0.55
6964,폴라/Noun,20,9,11,0.00010003779205477625,0.00012217606681920164,0.55
6965,다양성/Noun,20,11,9,0.00012226841251139318,9.99622364884377e-05,0.55
6966,그중/Adverb,20,9,11,0.00010003779205477625,0.00012217606681920164,0.55
6967,경고/Noun,20,11,9,0.00012226841251139318,9.99622364884377e-05,0.55
6968,믿어지다/Verb,20,11,9,0.00012226841251139318,9.99622364884377e-05,0.55
6969,오정세/Noun,20,11,9,0.00012226841251139318,9.99622364884377e-05,0.55
6970,다코타/Noun,20,11,9,0.00012226841251139318,9.99622364884377e-05,0.55
6971,비평/Noun,20,11,9,0.00012226841251139318,9.99622364884377e-05,0.55
6972,불행/Noun,20,11,9,0.00012226841251139318,9.99622364884377e-05,0.55
6973,플러스/Noun,20,9,11,0.00010003779205477625,0.00012217606681920164,0.55
6974,은유/Noun,20,11,9,0.00012226841251139318,9.99622364884377e-05,0.55
6975,레벨/Noun,20,11,9,0.00012226841251139318,9.99622364884377e-05,0.55
6976,맥주/Noun,20,9,11,0.00010003779205477625,0.00012217606681920164,0.55
6977,슌/Noun,20,11,9,0.00012226841251139318,9.99622364884377e-05,0.55
6978,괴수영화/Noun,20,11,9,0.00012226841251139318,9.99622364884377e-05,0.55
6979,수학/Noun,20,11,9,0.00012226841251139318,9.99622364884377e-05,0.55
6980,지방/Noun,20,11,9,0.00012226841251139318,9.99622364884377e-05,0.55
6981,느/Noun,20,11,9,0.00012226841251139318,9.99622364884377e-05,0.55
6982,비치다/Verb,20,9,11,0.00010003779205477625,0.00012217606681920164,0.55
6983,일치/Noun,20,11,9,0.00012226841251139318,9.99622364884377e-05,0.55
6984,삼성/Noun,20,10,10,0.00011115310228308472,0.00011106915165381967,0.5
6985,궁극/Noun,20,10,10,0.00011115310228308472,0.00011106915165381967,0.5
6986,알맞다/Adjective,20,10,10,0.00011115310228308472,0.00011106915165381967,0.5
6987,은행/Noun,20,10,10,0.00011115310228308472,0.00011106915165381967,0.5
6988,양념/Noun,20,10,10,0.00011115310228308472,0.00011106915165381967,0.5
6989,잠도/Noun,20,10,10,0.00011115310228308472,0.00011106915165381967,0.5
6990,코넬/Noun,20,10,10,0.00011115310228308472,0.00011106915165381967,0.5
6991,곽부성/Noun,20,10,10,0.00011115310228308472,0.00011106915165381967,0.5
6992,동물농장/Noun,20,10,10,0.00011115310228308472,0.00011106915165381967,0.5
6993,전후/Noun,20,10,10,0.00011115310228308472,0.00011106915165381967,0.5
6994,퇴폐/Noun,20,10,10,0.00011115310228308472,0.00011106915165381967,0.5
6995,백퍼/Noun,20,10,10,0.00011115310228308472,0.00011106915165381967,0.5
6996,우승하다/Adjective,20,10,10,0.00011115310228308472,0.00011106915165381967,0.5
6997,유재석/Noun,20,10,10,0.00011115310228308472,0.00011106915165381967,0.5
6998,영점/Noun,19,0,19,0.0,0.00021103138814225738,1.0
6999,해롭다/Adjective,19,0,19,0.0,0.00021103138814225738,1.0
7000,맘에듬/Noun,19,19,0,0.00021119089433786097,0.0,1.0
7001,쒸레기/Noun,19,0,19,0.0,0.00021103138814225738,1.0
7002,빼어나다/Adjective,19,18,1,0.0002000755841095525,1.1106915165381966e-05,0.9473684210526315
7003,발정/Noun,19,1,18,1.1115310228308472e-05,0.0001999244729768754,0.9473684210526315
7004,~~~^^/Punctuation,19,18,1,0.0002000755841095525,1.1106915165381966e-05,0.9473684210526315
7005,ㅆㄹㄱ/KoreanParticle,19,1,18,1.1115310228308472e-05,0.0001999244729768754,0.9473684210526315
7006,빈약/Noun,19,1,18,1.1115310228308472e-05,0.0001999244729768754,0.9473684210526315
7007,상쾌/Noun,19,18,1,0.0002000755841095525,1.1106915165381966e-05,0.9473684210526315
7008,짜증스럽다/Adjective,19,1,18,1.1115310228308472e-05,0.0001999244729768754,0.9473684210526315
7009,냉혹하다/Adjective,19,18,1,0.0002000755841095525,1.1106915165381966e-05,0.9473684210526315
7010,짜깁다/Verb,19,1,18,1.1115310228308472e-05,0.0001999244729768754,0.9473684210526315
7011,Ost/Alpha,19,18,1,0.0002000755841095525,1.1106915165381966e-05,0.9473684210526315
7012,재밌엇음/Noun,19,18,1,0.0002000755841095525,1.1106915165381966e-05,0.9473684210526315
7013,진전/Noun,19,1,18,1.1115310228308472e-05,0.0001999244729768754,0.9473684210526315
7014,발성/Noun,19,1,18,1.1115310228308472e-05,0.0001999244729768754,0.9473684210526315
7015,우웩/Noun,19,1,18,1.1115310228308472e-05,0.0001999244729768754,0.9473684210526315
7016,남다르다/Adjective,19,17,2,0.00018896027388124403,2.2213830330763933e-05,0.8947368421052632
7017,최상/Noun,19,17,2,0.00018896027388124403,2.2213830330763933e-05,0.8947368421052632
7018,80%/Number,19,2,17,2.2230620456616944e-05,0.00018881755781149343,0.8947368421052632
7019,9~10/Number,19,2,17,2.2230620456616944e-05,0.00018881755781149343,0.8947368421052632
7020,완소/Noun,19,17,2,0.00018896027388124403,2.2213830330763933e-05,0.8947368421052632
7021,다인/Noun,19,2,17,2.2230620456616944e-05,0.00018881755781149343,0.8947368421052632
7022,생뚱맞/Noun,19,2,17,2.2230620456616944e-05,0.00018881755781149343,0.8947368421052632
7023,이글/Noun,19,2,17,2.2230620456616944e-05,0.00018881755781149343,0.8947368421052632
7024,툭툭/Noun,19,3,16,3.3345930684925414e-05,0.00017771064264611146,0.8421052631578947
7025,실천/Noun,19,16,3,0.00017784496365293555,3.33207454961459e-05,0.8421052631578947
7026,관우/Noun,19,3,16,3.3345930684925414e-05,0.00017771064264611146,0.8421052631578947
7027,망정/Noun,19,3,16,3.3345930684925414e-05,0.00017771064264611146,0.8421052631578947
7028,고질/Noun,19,3,16,3.3345930684925414e-05,0.00017771064264611146,0.8421052631578947
7029,김혜선/Noun,19,3,16,3.3345930684925414e-05,0.00017771064264611146,0.8421052631578947
7030,때로는/Noun,19,16,3,0.00017784496365293555,3.33207454961459e-05,0.8421052631578947
7031,안중근/Noun,19,3,16,3.3345930684925414e-05,0.00017771064264611146,0.8421052631578947
7032,호연/Noun,19,16,3,0.00017784496365293555,3.33207454961459e-05,0.8421052631578947
7033,박시후/Noun,19,16,3,0.00017784496365293555,3.33207454961459e-05,0.8421052631578947
7034,이쯤/Noun,19,3,16,3.3345930684925414e-05,0.00017771064264611146,0.8421052631578947
7035,천천히/Adverb,19,16,3,0.00017784496365293555,3.33207454961459e-05,0.8421052631578947
7036,애비/Noun,19,3,16,3.3345930684925414e-05,0.00017771064264611146,0.8421052631578947
7037,알아듣다/Verb,19,3,16,3.3345930684925414e-05,0.00017771064264611146,0.8421052631578947
7038,멜로디/Noun,19,15,4,0.00016672965342462708,4.4427660661527865e-05,0.7894736842105263
7039,지게/Noun,19,15,4,0.00016672965342462708,4.4427660661527865e-05,0.7894736842105263
7040,오래간만/Adverb,19,15,4,0.00016672965342462708,4.4427660661527865e-05,0.7894736842105263
7041,맴도/Noun,19,15,4,0.00016672965342462708,4.4427660661527865e-05,0.7894736842105263
7042,소스/Noun,19,4,15,4.446124091323389e-05,0.0001666037274807295,0.7894736842105263
7043,................/Punctuation,19,4,15,4.446124091323389e-05,0.0001666037274807295,0.7894736842105263
7044,수영/Noun,19,15,4,0.00016672965342462708,4.4427660661527865e-05,0.7894736842105263
7045,짝짝/Noun,19,15,4,0.00016672965342462708,4.4427660661527865e-05,0.7894736842105263
7046,”/Foreign,19,4,15,4.446124091323389e-05,0.0001666037274807295,0.7894736842105263
7047,창의/Noun,19,15,4,0.00016672965342462708,4.4427660661527865e-05,0.7894736842105263
7048,액션연기/Noun,19,15,4,0.00016672965342462708,4.4427660661527865e-05,0.7894736842105263
7049,천/Noun,19,14,5,0.0001556143431963186,5.5534575826909837e-05,0.7368421052631579
7050,도의/Noun,19,14,5,0.0001556143431963186,5.5534575826909837e-05,0.7368421052631579
7051,추모/Noun,19,14,5,0.0001556143431963186,5.5534575826909837e-05,0.7368421052631579
7052,육/Modifier,19,5,14,5.557655114154236e-05,0.00015549681231534753,0.7368421052631579
7053,제라드/Noun,19,14,5,0.0001556143431963186,5.5534575826909837e-05,0.7368421052631579
7054,자도/Noun,19,5,14,5.557655114154236e-05,0.00015549681231534753,0.7368421052631579
7055,덩/Noun,19,5,14,5.557655114154236e-05,0.00015549681231534753,0.7368421052631579
7056,슴가/Noun,19,5,14,5.557655114154236e-05,0.00015549681231534753,0.7368421052631579
7057,90%/Number,19,5,14,5.557655114154236e-05,0.00015549681231534753,0.7368421052631579
7058,샹/Noun,19,5,14,5.557655114154236e-05,0.00015549681231534753,0.7368421052631579
7059,쾌락/Noun,19,14,5,0.0001556143431963186,5.5534575826909837e-05,0.7368421052631579
7060,김고은/Noun,19,5,14,5.557655114154236e-05,0.00015549681231534753,0.7368421052631579
7061,흑백영화/Noun,19,14,5,0.0001556143431963186,5.5534575826909837e-05,0.7368421052631579
7062,퓨전/Noun,19,5,14,5.557655114154236e-05,0.00015549681231534753,0.7368421052631579
7063,박진희/Noun,19,14,5,0.0001556143431963186,5.5534575826909837e-05,0.7368421052631579
7064,한판/Noun,19,5,14,5.557655114154236e-05,0.00015549681231534753,0.7368421052631579
7065,새기다/Verb,19,14,5,0.0001556143431963186,5.5534575826909837e-05,0.7368421052631579
7066,난생처음/Noun,19,5,14,5.557655114154236e-05,0.00015549681231534753,0.7368421052631579
7067,금성무/Noun,19,14,5,0.0001556143431963186,5.5534575826909837e-05,0.7368421052631579
7068,세련/Noun,19,14,5,0.0001556143431963186,5.5534575826909837e-05,0.7368421052631579
7069,재활용/Noun,19,5,14,5.557655114154236e-05,0.00015549681231534753,0.7368421052631579
7070,진호/Noun,19,5,14,5.557655114154236e-05,0.00015549681231534753,0.7368421052631579
7071,스승/Noun,19,14,5,0.0001556143431963186,5.5534575826909837e-05,0.7368421052631579
7072,~./Punctuation,19,14,5,0.0001556143431963186,5.5534575826909837e-05,0.7368421052631579
7073,인질/Noun,19,5,14,5.557655114154236e-05,0.00015549681231534753,0.7368421052631579
7074,별것/Noun,19,5,14,5.557655114154236e-05,0.00015549681231534753,0.7368421052631579
7075,휼륭하다/Adjective,19,14,5,0.0001556143431963186,5.5534575826909837e-05,0.7368421052631579
7076,민간인/Noun,19,5,14,5.557655114154236e-05,0.00015549681231534753,0.7368421052631579
7077,샤말란/Noun,19,5,14,5.557655114154236e-05,0.00015549681231534753,0.7368421052631579
7078,다분하다/Adjective,19,5,14,5.557655114154236e-05,0.00015549681231534753,0.7368421052631579
7079,Z/Alpha,19,5,14,5.557655114154236e-05,0.00015549681231534753,0.7368421052631579
7080,바가지/Noun,19,6,13,6.669186136985083e-05,0.00014438989714996557,0.6842105263157895
7081,이처럼/Noun,19,13,6,0.00014449903296801013,6.66414909922918e-05,0.6842105263157895
7082,가필드/Noun,19,13,6,0.00014449903296801013,6.66414909922918e-05,0.6842105263157895
7083,for/Alpha,19,13,6,0.00014449903296801013,6.66414909922918e-05,0.6842105263157895
7084,사고방식/Noun,19,6,13,6.669186136985083e-05,0.00014438989714996557,0.6842105263157895
7085,허락/Noun,19,6,13,6.669186136985083e-05,0.00014438989714996557,0.6842105263157895
7086,조한선/Noun,19,6,13,6.669186136985083e-05,0.00014438989714996557,0.6842105263157895
7087,톡톡/Noun,19,13,6,0.00014449903296801013,6.66414909922918e-05,0.6842105263157895
7088,넨/Noun,19,13,6,0.00014449903296801013,6.66414909922918e-05,0.6842105263157895
7089,포스트/Noun,19,6,13,6.669186136985083e-05,0.00014438989714996557,0.6842105263157895
7090,특정/Noun,19,6,13,6.669186136985083e-05,0.00014438989714996557,0.6842105263157895
7091,후보/Noun,19,6,13,6.669186136985083e-05,0.00014438989714996557,0.6842105263157895
7092,애환/Noun,19,13,6,0.00014449903296801013,6.66414909922918e-05,0.6842105263157895
7093,순식간/Noun,19,6,13,6.669186136985083e-05,0.00014438989714996557,0.6842105263157895
7094,싸인/Noun,19,13,6,0.00014449903296801013,6.66414909922918e-05,0.6842105263157895
7095,영역/Noun,19,13,6,0.00014449903296801013,6.66414909922918e-05,0.6842105263157895
7096,구로/Noun,19,13,6,0.00014449903296801013,6.66414909922918e-05,0.6842105263157895
7097,생방송/Noun,19,6,13,6.669186136985083e-05,0.00014438989714996557,0.6842105263157895
7098,며느리/Noun,19,6,13,6.669186136985083e-05,0.00014438989714996557,0.6842105263157895
7099,업그레이드/Noun,19,13,6,0.00014449903296801013,6.66414909922918e-05,0.6842105263157895
7100,곽지민/Noun,19,6,13,6.669186136985083e-05,0.00014438989714996557,0.6842105263157895
7101,영리하다/Adjective,19,13,6,0.00014449903296801013,6.66414909922918e-05,0.6842105263157895
7102,킹콩/Noun,19,6,13,6.669186136985083e-05,0.00014438989714996557,0.6842105263157895
7103,해치다/Verb,19,6,13,6.669186136985083e-05,0.00014438989714996557,0.6842105263157895
7104,별그대/Noun,19,13,6,0.00014449903296801013,6.66414909922918e-05,0.6842105263157895
7105,스페셜/Noun,19,6,13,6.669186136985083e-05,0.00014438989714996557,0.6842105263157895
7106,자꾸만/Noun,19,13,6,0.00014449903296801013,6.66414909922918e-05,0.6842105263157895
7107,올리비아/Noun,19,12,7,0.00013338372273970166,7.774840615767377e-05,0.631578947368421
7108,성욕/Noun,19,7,12,7.78071715981593e-05,0.0001332829819845836,0.631578947368421
7109,승자/Noun,19,12,7,0.00013338372273970166,7.774840615767377e-05,0.631578947368421
7110,예나/Noun,19,12,7,0.00013338372273970166,7.774840615767377e-05,0.631578947368421
7111,와이/Modifier,19,12,7,0.00013338372273970166,7.774840615767377e-05,0.631578947368421
7112,100년/Number,19,12,7,0.00013338372273970166,7.774840615767377e-05,0.631578947368421
7113,바디/Noun,19,7,12,7.78071715981593e-05,0.0001332829819845836,0.631578947368421
7114,대강/Noun,19,7,12,7.78071715981593e-05,0.0001332829819845836,0.631578947368421
7115,썸/Noun,19,7,12,7.78071715981593e-05,0.0001332829819845836,0.631578947368421
7116,여럿/Noun,19,7,12,7.78071715981593e-05,0.0001332829819845836,0.631578947368421
7117,만치/Josa,19,12,7,0.00013338372273970166,7.774840615767377e-05,0.631578947368421
7118,주식/Noun,19,12,7,0.00013338372273970166,7.774840615767377e-05,0.631578947368421
7119,뒤집어지다/Verb,19,12,7,0.00013338372273970166,7.774840615767377e-05,0.631578947368421
7120,당기다/Verb,19,7,12,7.78071715981593e-05,0.0001332829819845836,0.631578947368421
7121,딸아이/Noun,19,12,7,0.00013338372273970166,7.774840615767377e-05,0.631578947368421
7122,개구리/Noun,19,7,12,7.78071715981593e-05,0.0001332829819845836,0.631578947368421
7123,몰리다/Verb,19,7,12,7.78071715981593e-05,0.0001332829819845836,0.631578947368421
7124,스나입스/Noun,19,7,12,7.78071715981593e-05,0.0001332829819845836,0.631578947368421
7125,일류/Noun,19,7,12,7.78071715981593e-05,0.0001332829819845836,0.631578947368421
7126,이미숙/Noun,19,12,7,0.00013338372273970166,7.774840615767377e-05,0.631578947368421
7127,거북/Noun,19,7,12,7.78071715981593e-05,0.0001332829819845836,0.631578947368421
7128,원본/Noun,19,12,7,0.00013338372273970166,7.774840615767377e-05,0.631578947368421
7129,돌고래/Noun,19,12,7,0.00013338372273970166,7.774840615767377e-05,0.631578947368421
7130,작성/Noun,19,7,12,7.78071715981593e-05,0.0001332829819845836,0.631578947368421
7131,케로로/Noun,19,12,7,0.00013338372273970166,7.774840615767377e-05,0.631578947368421
7132,외계/Noun,19,7,12,7.78071715981593e-05,0.0001332829819845836,0.631578947368421
7133,우주선/Noun,19,7,12,7.78071715981593e-05,0.0001332829819845836,0.631578947368421
7134,달린다/Noun,19,7,12,7.78071715981593e-05,0.0001332829819845836,0.631578947368421
7135,상대로/Noun,19,7,12,7.78071715981593e-05,0.0001332829819845836,0.631578947368421
7136,꺾다/Verb,19,7,12,7.78071715981593e-05,0.0001332829819845836,0.631578947368421
7137,4회/Number,19,7,12,7.78071715981593e-05,0.0001332829819845836,0.631578947368421
7138,넘어지다/Verb,19,7,12,7.78071715981593e-05,0.0001332829819845836,0.631578947368421
7139,터널/Noun,19,12,7,0.00013338372273970166,7.774840615767377e-05,0.631578947368421
7140,다물다/Verb,19,12,7,0.00013338372273970166,7.774840615767377e-05,0.631578947368421
7141,28/Number,19,12,7,0.00013338372273970166,7.774840615767377e-05,0.631578947368421
7142,건전하다/Adjective,19,11,8,0.00012226841251139318,8.885532132305573e-05,0.5789473684210527
7143,유기/Noun,19,8,11,8.892248182646778e-05,0.00012217606681920164,0.5789473684210527
7144,확실/Noun,19,8,11,8.892248182646778e-05,0.00012217606681920164,0.5789473684210527
7145,10%/Number,19,8,11,8.892248182646778e-05,0.00012217606681920164,0.5789473684210527
7146,////Punctuation,19,8,11,8.892248182646778e-05,0.00012217606681920164,0.5789473684210527
7147,와인/Noun,19,11,8,0.00012226841251139318,8.885532132305573e-05,0.5789473684210527
7148,갚다/Verb,19,8,11,8.892248182646778e-05,0.00012217606681920164,0.5789473684210527
7149,스카이/Noun,19,8,11,8.892248182646778e-05,0.00012217606681920164,0.5789473684210527
7150,파이터/Noun,19,8,11,8.892248182646778e-05,0.00012217606681920164,0.5789473684210527
7151,한창/Noun,19,8,11,8.892248182646778e-05,0.00012217606681920164,0.5789473684210527
7152,되돌리다/Verb,19,8,11,8.892248182646778e-05,0.00012217606681920164,0.5789473684210527
7153,박하선/Noun,19,11,8,0.00012226841251139318,8.885532132305573e-05,0.5789473684210527
7154,한반도/Noun,19,8,11,8.892248182646778e-05,0.00012217606681920164,0.5789473684210527
7155,관능/Noun,19,8,11,8.892248182646778e-05,0.00012217606681920164,0.5789473684210527
7156,운영/Noun,19,11,8,0.00012226841251139318,8.885532132305573e-05,0.5789473684210527
7157,장예모/Noun,19,11,8,0.00012226841251139318,8.885532132305573e-05,0.5789473684210527
7158,씬들/Noun,19,8,11,8.892248182646778e-05,0.00012217606681920164,0.5789473684210527
7159,취한/Noun,19,8,11,8.892248182646778e-05,0.00012217606681920164,0.5789473684210527
7160,이해해/Noun,19,8,11,8.892248182646778e-05,0.00012217606681920164,0.5789473684210527
7161,이대로/Adverb,19,11,8,0.00012226841251139318,8.885532132305573e-05,0.5789473684210527
7162,비비다/Verb,19,11,8,0.00012226841251139318,8.885532132305573e-05,0.5789473684210527
7163,먹방/Noun,19,8,11,8.892248182646778e-05,0.00012217606681920164,0.5789473684210527
7164,우수하다/Adjective,19,11,8,0.00012226841251139318,8.885532132305573e-05,0.5789473684210527
7165,사냥/Noun,19,8,11,8.892248182646778e-05,0.00012217606681920164,0.5789473684210527
7166,서서/Noun,19,11,8,0.00012226841251139318,8.885532132305573e-05,0.5789473684210527
7167,토토/Noun,19,11,8,0.00012226841251139318,8.885532132305573e-05,0.5789473684210527
7168,기념비/Noun,19,11,8,0.00012226841251139318,8.885532132305573e-05,0.5789473684210527
7169,단호/Noun,19,11,8,0.00012226841251139318,8.885532132305573e-05,0.5789473684210527
7170,윌/Noun,19,8,11,8.892248182646778e-05,0.00012217606681920164,0.5789473684210527
7171,판사/Noun,19,11,8,0.00012226841251139318,8.885532132305573e-05,0.5789473684210527
7172,투척/Noun,19,11,8,0.00012226841251139318,8.885532132305573e-05,0.5789473684210527
7173,이세/Noun,19,9,10,0.00010003779205477625,0.00011106915165381967,0.5263157894736842
7174,불타다/Adjective,19,10,9,0.00011115310228308472,9.99622364884377e-05,0.5263157894736842
7175,방송국/Noun,19,9,10,0.00010003779205477625,0.00011106915165381967,0.5263157894736842
7176,80/Number,19,10,9,0.00011115310228308472,9.99622364884377e-05,0.5263157894736842
7177,박력/Noun,19,9,10,0.00010003779205477625,0.00011106915165381967,0.5263157894736842
7178,패밀리/Noun,19,9,10,0.00010003779205477625,0.00011106915165381967,0.5263157894736842
7179,음산하다/Adjective,19,9,10,0.00010003779205477625,0.00011106915165381967,0.5263157894736842
7180,장식/Noun,19,10,9,0.00011115310228308472,9.99622364884377e-05,0.5263157894736842
7181,야말로/Josa,19,10,9,0.00011115310228308472,9.99622364884377e-05,0.5263157894736842
7182,흥분하다/Adjective,19,10,9,0.00011115310228308472,9.99622364884377e-05,0.5263157894736842
7183,유료/Noun,19,10,9,0.00011115310228308472,9.99622364884377e-05,0.5263157894736842
7184,업적/Noun,19,9,10,0.00010003779205477625,0.00011106915165381967,0.5263157894736842
7185,쇼크/Noun,19,9,10,0.00010003779205477625,0.00011106915165381967,0.5263157894736842
7186,입양/Noun,19,10,9,0.00011115310228308472,9.99622364884377e-05,0.5263157894736842
7187,스팅/Noun,19,9,10,0.00010003779205477625,0.00011106915165381967,0.5263157894736842
7188,연하다/Adjective,19,10,9,0.00011115310228308472,9.99622364884377e-05,0.5263157894736842
7189,동일하다/Adjective,19,10,9,0.00011115310228308472,9.99622364884377e-05,0.5263157894736842
7190,조심/Noun,19,10,9,0.00011115310228308472,9.99622364884377e-05,0.5263157894736842
7191,인즈/Noun,19,10,9,0.00011115310228308472,9.99622364884377e-05,0.5263157894736842
7192,V/Alpha,19,9,10,0.00010003779205477625,0.00011106915165381967,0.5263157894736842
7193,법도/Noun,19,9,10,0.00010003779205477625,0.00011106915165381967,0.5263157894736842
7194,불행하다/Adjective,19,10,9,0.00011115310228308472,9.99622364884377e-05,0.5263157894736842
7195,청자/Noun,19,9,10,0.00010003779205477625,0.00011106915165381967,0.5263157894736842
7196,복싱/Noun,19,10,9,0.00011115310228308472,9.99622364884377e-05,0.5263157894736842
7197,노고/Noun,19,10,9,0.00011115310228308472,9.99622364884377e-05,0.5263157894736842
7198,세이/Noun,19,9,10,0.00010003779205477625,0.00011106915165381967,0.5263157894736842
7199,한니발/Noun,19,10,9,0.00011115310228308472,9.99622364884377e-05,0.5263157894736842
7200,늦추다/Verb,18,18,0,0.0002000755841095525,0.0,1.0
7201,다려지다/Verb,18,18,0,0.0002000755841095525,0.0,1.0
7202,보고또보고/Noun,18,18,0,0.0002000755841095525,0.0,1.0
7203,김준호/Noun,18,0,18,0.0,0.0001999244729768754,1.0
7204,오광록/Noun,18,0,18,0.0,0.0001999244729768754,1.0
7205,놨/Noun,18,0,18,0.0,0.0001999244729768754,1.0
7206,굿잡/Noun,18,17,1,0.00018896027388124403,1.1106915165381966e-05,0.9444444444444444
7207,여비/Noun,18,1,17,1.1115310228308472e-05,0.00018881755781149343,0.9444444444444444
7208,여균동/Noun,18,1,17,1.1115310228308472e-05,0.00018881755781149343,0.9444444444444444
7209,혈압/Noun,18,1,17,1.1115310228308472e-05,0.00018881755781149343,0.9444444444444444
7210,평온하다/Adjective,18,17,1,0.00018896027388124403,1.1106915165381966e-05,0.9444444444444444
7211,불법체류자/Noun,18,1,17,1.1115310228308472e-05,0.00018881755781149343,0.9444444444444444
7212,출품/Noun,18,1,17,1.1115310228308472e-05,0.00018881755781149343,0.9444444444444444
7213,발가락/Noun,18,1,17,1.1115310228308472e-05,0.00018881755781149343,0.9444444444444444
7214,좀해/Noun,18,2,16,2.2230620456616944e-05,0.00017771064264611146,0.8888888888888888
7215,성해/Noun,18,2,16,2.2230620456616944e-05,0.00017771064264611146,0.8888888888888888
7216,충돌/Noun,18,16,2,0.00017784496365293555,2.2213830330763933e-05,0.8888888888888888
7217,+_+/Punctuation,18,16,2,0.00017784496365293555,2.2213830330763933e-05,0.8888888888888888
7218,신랄하다/Adjective,18,16,2,0.00017784496365293555,2.2213830330763933e-05,0.8888888888888888
7219,졸귀/Noun,18,16,2,0.00017784496365293555,2.2213830330763933e-05,0.8888888888888888
7220,만만하다/Adjective,18,2,16,2.2230620456616944e-05,0.00017771064264611146,0.8888888888888888
7221,엘렌/Noun,18,16,2,0.00017784496365293555,2.2213830330763933e-05,0.8888888888888888
7222,테잎/Noun,18,16,2,0.00017784496365293555,2.2213830330763933e-05,0.8888888888888888
7223,가차/Noun,18,2,16,2.2230620456616944e-05,0.00017771064264611146,0.8888888888888888
7224,테이프/Noun,18,16,2,0.00017784496365293555,2.2213830330763933e-05,0.8888888888888888
7225,갈팡질팡/Noun,18,2,16,2.2230620456616944e-05,0.00017771064264611146,0.8888888888888888
7226,신발/Noun,18,2,16,2.2230620456616944e-05,0.00017771064264611146,0.8888888888888888
7227,용인/Noun,18,2,16,2.2230620456616944e-05,0.00017771064264611146,0.8888888888888888
7228,....;;/Punctuation,18,2,16,2.2230620456616944e-05,0.00017771064264611146,0.8888888888888888
7229,불과/Noun,18,2,16,2.2230620456616944e-05,0.00017771064264611146,0.8888888888888888
7230,전설의고향/Noun,18,2,16,2.2230620456616944e-05,0.00017771064264611146,0.8888888888888888
7231,혁신/Noun,18,16,2,0.00017784496365293555,2.2213830330763933e-05,0.8888888888888888
7232,444/Number,18,2,16,2.2230620456616944e-05,0.00017771064264611146,0.8888888888888888
7233,비로소/Noun,18,16,2,0.00017784496365293555,2.2213830330763933e-05,0.8888888888888888
7234,윗/Modifier,18,3,15,3.3345930684925414e-05,0.0001666037274807295,0.8333333333333334
7235,장비/Noun,18,3,15,3.3345930684925414e-05,0.0001666037274807295,0.8333333333333334
7236,니콜슨/Noun,18,15,3,0.00016672965342462708,3.33207454961459e-05,0.8333333333333334
7237,부풀리다/Verb,18,3,15,3.3345930684925414e-05,0.0001666037274807295,0.8333333333333334
7238,5~6/Number,18,3,15,3.3345930684925414e-05,0.0001666037274807295,0.8333333333333334
7239,산뜻하다/Adjective,18,15,3,0.00016672965342462708,3.33207454961459e-05,0.8333333333333334
7240,칙칙하다/Adjective,18,3,15,3.3345930684925414e-05,0.0001666037274807295,0.8333333333333334
7241,더군다나/Noun,18,3,15,3.3345930684925414e-05,0.0001666037274807295,0.8333333333333334
7242,교통사고/Noun,18,3,15,3.3345930684925414e-05,0.0001666037274807295,0.8333333333333334
7243,레기/Noun,18,3,15,3.3345930684925414e-05,0.0001666037274807295,0.8333333333333334
7244,통제/Noun,18,14,4,0.0001556143431963186,4.4427660661527865e-05,0.7777777777777778
7245,기능/Noun,18,4,14,4.446124091323389e-05,0.00015549681231534753,0.7777777777777778
7246,주걸륜/Noun,18,4,14,4.446124091323389e-05,0.00015549681231534753,0.7777777777777778
7247,천지/Noun,18,4,14,4.446124091323389e-05,0.00015549681231534753,0.7777777777777778
7248,매기/Noun,18,4,14,4.446124091323389e-05,0.00015549681231534753,0.7777777777777778
7249,폭동/Noun,18,4,14,4.446124091323389e-05,0.00015549681231534753,0.7777777777777778
7250,엇갈리다/Verb,18,14,4,0.0001556143431963186,4.4427660661527865e-05,0.7777777777777778
7251,김소연/Noun,18,14,4,0.0001556143431963186,4.4427660661527865e-05,0.7777777777777778
7252,17년/Number,18,14,4,0.0001556143431963186,4.4427660661527865e-05,0.7777777777777778
7253,권장/Noun,18,4,14,4.446124091323389e-05,0.00015549681231534753,0.7777777777777778
7254,나무라다/Verb,18,14,4,0.0001556143431963186,4.4427660661527865e-05,0.7777777777777778
7255,SBS/Alpha,18,4,14,4.446124091323389e-05,0.00015549681231534753,0.7777777777777778
7256,전화하다/Adjective,18,4,14,4.446124091323389e-05,0.00015549681231534753,0.7777777777777778
7257,김동욱/Noun,18,14,4,0.0001556143431963186,4.4427660661527865e-05,0.7777777777777778
7258,무관심/Noun,18,14,4,0.0001556143431963186,4.4427660661527865e-05,0.7777777777777778
7259,사운드트랙/Noun,18,14,4,0.0001556143431963186,4.4427660661527865e-05,0.7777777777777778
7260,황우슬혜/Noun,18,4,14,4.446124091323389e-05,0.00015549681231534753,0.7777777777777778
7261,무한도전/Noun,18,4,14,4.446124091323389e-05,0.00015549681231534753,0.7777777777777778
7262,리얼리즘/Noun,18,14,4,0.0001556143431963186,4.4427660661527865e-05,0.7777777777777778
7263,천정명/Noun,18,4,14,4.446124091323389e-05,0.00015549681231534753,0.7777777777777778
7264,상한/Noun,18,5,13,5.557655114154236e-05,0.00014438989714996557,0.7222222222222222
7265,식겁하다/Adjective,18,5,13,5.557655114154236e-05,0.00014438989714996557,0.7222222222222222
7266,해품달/Noun,18,13,5,0.00014449903296801013,5.5534575826909837e-05,0.7222222222222222
7267,쥬/Noun,18,13,5,0.00014449903296801013,5.5534575826909837e-05,0.7222222222222222
7268,....!/Punctuation,18,13,5,0.00014449903296801013,5.5534575826909837e-05,0.7222222222222222
7269,능청/Noun,18,13,5,0.00014449903296801013,5.5534575826909837e-05,0.7222222222222222
7270,자화상/Noun,18,13,5,0.00014449903296801013,5.5534575826909837e-05,0.7222222222222222
7271,화살/Noun,18,5,13,5.557655114154236e-05,0.00014438989714996557,0.7222222222222222
7272,강수연/Noun,18,5,13,5.557655114154236e-05,0.00014438989714996557,0.7222222222222222
7273,국회의원/Noun,18,5,13,5.557655114154236e-05,0.00014438989714996557,0.7222222222222222
7274,드라큐라/Noun,18,13,5,0.00014449903296801013,5.5534575826909837e-05,0.7222222222222222
7275,페넬로페/Noun,18,13,5,0.00014449903296801013,5.5534575826909837e-05,0.7222222222222222
7276,막말/Noun,18,5,13,5.557655114154236e-05,0.00014438989714996557,0.7222222222222222
7277,누굴/Noun,18,5,13,5.557655114154236e-05,0.00014438989714996557,0.7222222222222222
7278,훗날/Noun,18,13,5,0.00014449903296801013,5.5534575826909837e-05,0.7222222222222222
7279,풋/Noun,18,5,13,5.557655114154236e-05,0.00014438989714996557,0.7222222222222222
7280,우주전쟁/Noun,18,5,13,5.557655114154236e-05,0.00014438989714996557,0.7222222222222222
7281,키이라/Noun,18,13,5,0.00014449903296801013,5.5534575826909837e-05,0.7222222222222222
7282,곤란하다/Adjective,18,5,13,5.557655114154236e-05,0.00014438989714996557,0.7222222222222222
7283,절규/Noun,18,13,5,0.00014449903296801013,5.5534575826909837e-05,0.7222222222222222
7284,정우/Noun,18,13,5,0.00014449903296801013,5.5534575826909837e-05,0.7222222222222222
7285,경향/Noun,18,5,13,5.557655114154236e-05,0.00014438989714996557,0.7222222222222222
7286,가든/Noun,18,5,13,5.557655114154236e-05,0.00014438989714996557,0.7222222222222222
7287,싸대기/Noun,18,5,13,5.557655114154236e-05,0.00014438989714996557,0.7222222222222222
7288,복잡/Noun,18,13,5,0.00014449903296801013,5.5534575826909837e-05,0.7222222222222222
7289,이필/Noun,18,13,5,0.00014449903296801013,5.5534575826909837e-05,0.7222222222222222
7290,공자/Noun,18,13,5,0.00014449903296801013,5.5534575826909837e-05,0.7222222222222222
7291,치매/Noun,18,5,13,5.557655114154236e-05,0.00014438989714996557,0.7222222222222222
7292,친근하다/Adjective,18,13,5,0.00014449903296801013,5.5534575826909837e-05,0.7222222222222222
7293,정교하다/Adjective,18,13,5,0.00014449903296801013,5.5534575826909837e-05,0.7222222222222222
7294,고서/Noun,18,5,13,5.557655114154236e-05,0.00014438989714996557,0.7222222222222222
7295,주저/Noun,18,13,5,0.00014449903296801013,5.5534575826909837e-05,0.7222222222222222
7296,.;;/Punctuation,18,5,13,5.557655114154236e-05,0.00014438989714996557,0.7222222222222222
7297,열차/Noun,18,5,13,5.557655114154236e-05,0.00014438989714996557,0.7222222222222222
7298,이득/Noun,18,5,13,5.557655114154236e-05,0.00014438989714996557,0.7222222222222222
7299,라네/Josa,18,6,12,6.669186136985083e-05,0.0001332829819845836,0.6666666666666666
7300,내부/Noun,18,12,6,0.00013338372273970166,6.66414909922918e-05,0.6666666666666666
7301,천원/Noun,18,6,12,6.669186136985083e-05,0.0001332829819845836,0.6666666666666666
7302,악령/Noun,18,6,12,6.669186136985083e-05,0.0001332829819845836,0.6666666666666666
7303,가오/Noun,18,6,12,6.669186136985083e-05,0.0001332829819845836,0.6666666666666666
7304,투모로우/Noun,18,6,12,6.669186136985083e-05,0.0001332829819845836,0.6666666666666666
7305,딱지/Noun,18,6,12,6.669186136985083e-05,0.0001332829819845836,0.6666666666666666
7306,짤/Noun,18,6,12,6.669186136985083e-05,0.0001332829819845836,0.6666666666666666
7307,강의/Noun,18,12,6,0.00013338372273970166,6.66414909922918e-05,0.6666666666666666
7308,대우/Noun,18,12,6,0.00013338372273970166,6.66414909922918e-05,0.6666666666666666
7309,고마/Noun,18,6,12,6.669186136985083e-05,0.0001332829819845836,0.6666666666666666
7310,종편/Noun,18,12,6,0.00013338372273970166,6.66414909922918e-05,0.6666666666666666
7311,미지근하다/Adjective,18,6,12,6.669186136985083e-05,0.0001332829819845836,0.6666666666666666
7312,자부/Noun,18,12,6,0.00013338372273970166,6.66414909922918e-05,0.6666666666666666
7313,세뇌/Noun,18,6,12,6.669186136985083e-05,0.0001332829819845836,0.6666666666666666
7314,정사씬/Noun,18,6,12,6.669186136985083e-05,0.0001332829819845836,0.6666666666666666
7315,오만/Noun,18,6,12,6.669186136985083e-05,0.0001332829819845836,0.6666666666666666
7316,더더/Noun,18,12,6,0.00013338372273970166,6.66414909922918e-05,0.6666666666666666
7317,김사랑/Noun,18,6,12,6.669186136985083e-05,0.0001332829819845836,0.6666666666666666
7318,가져가다/Verb,18,6,12,6.669186136985083e-05,0.0001332829819845836,0.6666666666666666
7319,140/Number,18,12,6,0.00013338372273970166,6.66414909922918e-05,0.6666666666666666
7320,베니/Noun,18,12,6,0.00013338372273970166,6.66414909922918e-05,0.6666666666666666
7321,"~""/Punctuation",18,12,6,0.00013338372273970166,6.66414909922918e-05,0.6666666666666666
7322,추격자/Noun,18,6,12,6.669186136985083e-05,0.0001332829819845836,0.6666666666666666
7323,건데/Noun,18,6,12,6.669186136985083e-05,0.0001332829819845836,0.6666666666666666
7324,주니어/Noun,18,12,6,0.00013338372273970166,6.66414909922918e-05,0.6666666666666666
7325,날수/Noun,18,12,6,0.00013338372273970166,6.66414909922918e-05,0.6666666666666666
7326,핀처/Noun,18,12,6,0.00013338372273970166,6.66414909922918e-05,0.6666666666666666
7327,김대중/Noun,18,6,12,6.669186136985083e-05,0.0001332829819845836,0.6666666666666666
7328,삽질/Noun,18,6,12,6.669186136985083e-05,0.0001332829819845836,0.6666666666666666
7329,위험/Noun,18,6,12,6.669186136985083e-05,0.0001332829819845836,0.6666666666666666
7330,기해/Noun,18,6,12,6.669186136985083e-05,0.0001332829819845836,0.6666666666666666
7331,정당하다/Adjective,18,6,12,6.669186136985083e-05,0.0001332829819845836,0.6666666666666666
7332,정준/Noun,18,12,6,0.00013338372273970166,6.66414909922918e-05,0.6666666666666666
7333,심각/Noun,18,12,6,0.00013338372273970166,6.66414909922918e-05,0.6666666666666666
7334,2등/Number,18,7,11,7.78071715981593e-05,0.00012217606681920164,0.6111111111111112
7335,이나라/Noun,18,11,7,0.00012226841251139318,7.774840615767377e-05,0.6111111111111112
7336,웬/Modifier,18,7,11,7.78071715981593e-05,0.00012217606681920164,0.6111111111111112
7337,80분/Number,18,7,11,7.78071715981593e-05,0.00012217606681920164,0.6111111111111112
7338,특선/Noun,18,11,7,0.00012226841251139318,7.774840615767377e-05,0.6111111111111112
7339,비됴/Noun,18,7,11,7.78071715981593e-05,0.00012217606681920164,0.6111111111111112
7340,돌프/Noun,18,7,11,7.78071715981593e-05,0.00012217606681920164,0.6111111111111112
7341,노다메/Noun,18,11,7,0.00012226841251139318,7.774840615767377e-05,0.6111111111111112
7342,장기/Noun,18,7,11,7.78071715981593e-05,0.00012217606681920164,0.6111111111111112
7343,오후/Noun,18,11,7,0.00012226841251139318,7.774840615767377e-05,0.6111111111111112
7344,힐러리/Noun,18,11,7,0.00012226841251139318,7.774840615767377e-05,0.6111111111111112
7345,선교/Noun,18,7,11,7.78071715981593e-05,0.00012217606681920164,0.6111111111111112
7346,바지/Noun,18,11,7,0.00012226841251139318,7.774840615767377e-05,0.6111111111111112
7347,나오미/Noun,18,11,7,0.00012226841251139318,7.774840615767377e-05,0.6111111111111112
7348,6~7/Number,18,11,7,0.00012226841251139318,7.774840615767377e-05,0.6111111111111112
7349,바이블/Noun,18,11,7,0.00012226841251139318,7.774840615767377e-05,0.6111111111111112
7350,비긴/Noun,18,11,7,0.00012226841251139318,7.774840615767377e-05,0.6111111111111112
7351,익/Noun,18,7,11,7.78071715981593e-05,0.00012217606681920164,0.6111111111111112
7352,할리/Noun,18,11,7,0.00012226841251139318,7.774840615767377e-05,0.6111111111111112
7353,여백/Noun,18,11,7,0.00012226841251139318,7.774840615767377e-05,0.6111111111111112
7354,매드/Noun,18,11,7,0.00012226841251139318,7.774840615767377e-05,0.6111111111111112
7355,쟁쟁/Noun,18,7,11,7.78071715981593e-05,0.00012217606681920164,0.6111111111111112
7356,왜캐/Noun,18,7,11,7.78071715981593e-05,0.00012217606681920164,0.6111111111111112
7357,제리/Noun,18,11,7,0.00012226841251139318,7.774840615767377e-05,0.6111111111111112
7358,샷/Noun,18,7,11,7.78071715981593e-05,0.00012217606681920164,0.6111111111111112
7359,홍경인/Noun,18,7,11,7.78071715981593e-05,0.00012217606681920164,0.6111111111111112
7360,라기보다는/Josa,18,7,11,7.78071715981593e-05,0.00012217606681920164,0.6111111111111112
7361,현우/Noun,18,11,7,0.00012226841251139318,7.774840615767377e-05,0.6111111111111112
7362,왈/Noun,18,7,11,7.78071715981593e-05,0.00012217606681920164,0.6111111111111112
7363,죄악/Noun,18,7,11,7.78071715981593e-05,0.00012217606681920164,0.6111111111111112
7364,곱/Noun,18,7,11,7.78071715981593e-05,0.00012217606681920164,0.6111111111111112
7365,닮음/Noun,18,11,7,0.00012226841251139318,7.774840615767377e-05,0.6111111111111112
7366,오컬트/Noun,18,7,11,7.78071715981593e-05,0.00012217606681920164,0.6111111111111112
7367,상사/Noun,18,7,11,7.78071715981593e-05,0.00012217606681920164,0.6111111111111112
7368,날아다니다/Verb,18,7,11,7.78071715981593e-05,0.00012217606681920164,0.6111111111111112
7369,달래다/Verb,18,11,7,0.00012226841251139318,7.774840615767377e-05,0.6111111111111112
7370,갈아타다/Verb,18,7,11,7.78071715981593e-05,0.00012217606681920164,0.6111111111111112
7371,유감/Noun,18,7,11,7.78071715981593e-05,0.00012217606681920164,0.6111111111111112
7372,남여/Noun,18,11,7,0.00012226841251139318,7.774840615767377e-05,0.6111111111111112
7373,초대/Noun,18,11,7,0.00012226841251139318,7.774840615767377e-05,0.6111111111111112
7374,달러/Noun,18,7,11,7.78071715981593e-05,0.00012217606681920164,0.6111111111111112
7375,날때/Noun,18,11,7,0.00012226841251139318,7.774840615767377e-05,0.6111111111111112
7376,차카/Noun,18,7,11,7.78071715981593e-05,0.00012217606681920164,0.6111111111111112
7377,불가하다/Adjective,18,7,11,7.78071715981593e-05,0.00012217606681920164,0.6111111111111112
7378,무모하다/Adjective,18,11,7,0.00012226841251139318,7.774840615767377e-05,0.6111111111111112
7379,씩/Adverb,18,7,11,7.78071715981593e-05,0.00012217606681920164,0.6111111111111112
7380,기초/Noun,18,8,10,8.892248182646778e-05,0.00011106915165381967,0.5555555555555556
7381,예외/Noun,18,8,10,8.892248182646778e-05,0.00011106915165381967,0.5555555555555556
7382,소식/Noun,18,10,8,0.00011115310228308472,8.885532132305573e-05,0.5555555555555556
7383,홉킨스/Noun,18,10,8,0.00011115310228308472,8.885532132305573e-05,0.5555555555555556
7384,에나/Noun,18,10,8,0.00011115310228308472,8.885532132305573e-05,0.5555555555555556
7385,그랬는데/Conjunction,18,8,10,8.892248182646778e-05,0.00011106915165381967,0.5555555555555556
7386,메이저/Noun,18,8,10,8.892248182646778e-05,0.00011106915165381967,0.5555555555555556
7387,주진모/Noun,18,10,8,0.00011115310228308472,8.885532132305573e-05,0.5555555555555556
7388,애쉬/Noun,18,10,8,0.00011115310228308472,8.885532132305573e-05,0.5555555555555556
7389,단단하다/Adjective,18,8,10,8.892248182646778e-05,0.00011106915165381967,0.5555555555555556
7390,서유기/Noun,18,10,8,0.00011115310228308472,8.885532132305573e-05,0.5555555555555556
7391,그릇/Noun,18,8,10,8.892248182646778e-05,0.00011106915165381967,0.5555555555555556
7392,..'/Punctuation,18,8,10,8.892248182646778e-05,0.00011106915165381967,0.5555555555555556
7393,어간/Noun,18,10,8,0.00011115310228308472,8.885532132305573e-05,0.5555555555555556
7394,망각/Noun,18,8,10,8.892248182646778e-05,0.00011106915165381967,0.5555555555555556
7395,스페이스/Noun,18,8,10,8.892248182646778e-05,0.00011106915165381967,0.5555555555555556
7396,이소연/Noun,18,8,10,8.892248182646778e-05,0.00011106915165381967,0.5555555555555556
7397,여부/Noun,18,8,10,8.892248182646778e-05,0.00011106915165381967,0.5555555555555556
7398,핳/Exclamation,18,8,10,8.892248182646778e-05,0.00011106915165381967,0.5555555555555556
7399,모세/Noun,18,10,8,0.00011115310228308472,8.885532132305573e-05,0.5555555555555556
7400,지기/Noun,18,8,10,8.892248182646778e-05,0.00011106915165381967,0.5555555555555556
7401,겸/Noun,18,10,8,0.00011115310228308472,8.885532132305573e-05,0.5555555555555556
7402,크기/Noun,18,8,10,8.892248182646778e-05,0.00011106915165381967,0.5555555555555556
7403,입체/Noun,18,8,10,8.892248182646778e-05,0.00011106915165381967,0.5555555555555556
7404,레이스/Noun,18,10,8,0.00011115310228308472,8.885532132305573e-05,0.5555555555555556
7405,이아/Noun,18,8,10,8.892248182646778e-05,0.00011106915165381967,0.5555555555555556
7406,유투브/Noun,18,10,8,0.00011115310228308472,8.885532132305573e-05,0.5555555555555556
7407,구현/Noun,18,10,8,0.00011115310228308472,8.885532132305573e-05,0.5555555555555556
7408,주로/Noun,18,8,10,8.892248182646778e-05,0.00011106915165381967,0.5555555555555556
7409,부시/Noun,18,8,10,8.892248182646778e-05,0.00011106915165381967,0.5555555555555556
7410,유선/Noun,18,10,8,0.00011115310228308472,8.885532132305573e-05,0.5555555555555556
7411,듬뿍/Noun,18,8,10,8.892248182646778e-05,0.00011106915165381967,0.5555555555555556
7412,드릴/Noun,18,8,10,8.892248182646778e-05,0.00011106915165381967,0.5555555555555556
7413,탱크/Noun,18,10,8,0.00011115310228308472,8.885532132305573e-05,0.5555555555555556
7414,정식/Noun,18,8,10,8.892248182646778e-05,0.00011106915165381967,0.5555555555555556
7415,중국어/Noun,18,8,10,8.892248182646778e-05,0.00011106915165381967,0.5555555555555556
7416,독재/Noun,18,8,10,8.892248182646778e-05,0.00011106915165381967,0.5555555555555556
7417,가스/Noun,18,8,10,8.892248182646778e-05,0.00011106915165381967,0.5555555555555556
7418,페이스/Noun,18,8,10,8.892248182646778e-05,0.00011106915165381967,0.5555555555555556
7419,요정/Noun,18,8,10,8.892248182646778e-05,0.00011106915165381967,0.5555555555555556
7420,포커스/Noun,18,8,10,8.892248182646778e-05,0.00011106915165381967,0.5555555555555556
7421,이미연/Noun,18,10,8,0.00011115310228308472,8.885532132305573e-05,0.5555555555555556
7422,알포인트/Noun,18,10,8,0.00011115310228308472,8.885532132305573e-05,0.5555555555555556
7423,크크/Exclamation,18,10,8,0.00011115310228308472,8.885532132305573e-05,0.5555555555555556
7424,지현우/Noun,18,8,10,8.892248182646778e-05,0.00011106915165381967,0.5555555555555556
7425,처지/Noun,18,10,8,0.00011115310228308472,8.885532132305573e-05,0.5555555555555556
7426,두루/Noun,18,9,9,0.00010003779205477625,9.99622364884377e-05,0.5
7427,무시무시하다/Adjective,18,9,9,0.00010003779205477625,9.99622364884377e-05,0.5
7428,갑툭튀/Noun,18,9,9,0.00010003779205477625,9.99622364884377e-05,0.5
7429,놀리다/Verb,18,9,9,0.00010003779205477625,9.99622364884377e-05,0.5
7430,..(/Punctuation,18,9,9,0.00010003779205477625,9.99622364884377e-05,0.5
7431,파이널/Noun,18,9,9,0.00010003779205477625,9.99622364884377e-05,0.5
7432,재임/Noun,18,9,9,0.00010003779205477625,9.99622364884377e-05,0.5
7433,이서진/Noun,18,9,9,0.00010003779205477625,9.99622364884377e-05,0.5
7434,돌아서다/Verb,18,9,9,0.00010003779205477625,9.99622364884377e-05,0.5
7435,식다/Verb,18,9,9,0.00010003779205477625,9.99622364884377e-05,0.5
7436,합격/Noun,18,9,9,0.00010003779205477625,9.99622364884377e-05,0.5
7437,이란/Foreign,18,9,9,0.00010003779205477625,9.99622364884377e-05,0.5
7438,윌리엄/Noun,18,9,9,0.00010003779205477625,9.99622364884377e-05,0.5
7439,스물/Noun,18,9,9,0.00010003779205477625,9.99622364884377e-05,0.5
7440,사도/Noun,18,9,9,0.00010003779205477625,9.99622364884377e-05,0.5
7441,료코/Noun,18,9,9,0.00010003779205477625,9.99622364884377e-05,0.5
7442,인시디어스/Noun,18,9,9,0.00010003779205477625,9.99622364884377e-05,0.5
7443,유방/Noun,18,9,9,0.00010003779205477625,9.99622364884377e-05,0.5
7444,질적/Noun,18,9,9,0.00010003779205477625,9.99622364884377e-05,0.5
7445,중요/Noun,18,9,9,0.00010003779205477625,9.99622364884377e-05,0.5
7446,나기/Noun,18,9,9,0.00010003779205477625,9.99622364884377e-05,0.5
7447,아싸/Exclamation,18,9,9,0.00010003779205477625,9.99622364884377e-05,0.5
7448,횽/Noun,18,9,9,0.00010003779205477625,9.99622364884377e-05,0.5
7449,독하다/Adjective,18,9,9,0.00010003779205477625,9.99622364884377e-05,0.5
7450,최신/Noun,18,9,9,0.00010003779205477625,9.99622364884377e-05,0.5
7451,요청/Noun,18,9,9,0.00010003779205477625,9.99622364884377e-05,0.5
7452,패륜/Noun,17,0,17,0.0,0.00018881755781149343,1.0
7453,김대희/Noun,17,0,17,0.0,0.00018881755781149343,1.0
7454,이러니까/Conjunction,17,0,17,0.0,0.00018881755781149343,1.0
7455,*^^*/Punctuation,17,17,0,0.00018896027388124403,0.0,1.0
7456,숙면/Noun,17,0,17,0.0,0.00018881755781149343,1.0
7457,클레이/Noun,17,17,0,0.00018896027388124403,0.0,1.0
7458,조음/Noun,17,17,0,0.00018896027388124403,0.0,1.0
7459,8~10/Number,17,0,17,0.0,0.00018881755781149343,1.0
7460,0.1/Number,17,1,16,1.1115310228308472e-05,0.00017771064264611146,0.9411764705882353
7461,하락/Noun,17,1,16,1.1115310228308472e-05,0.00017771064264611146,0.9411764705882353
7462,죄송/Noun,17,1,16,1.1115310228308472e-05,0.00017771064264611146,0.9411764705882353
7463,ㅡㅡㅡ/KoreanParticle,17,1,16,1.1115310228308472e-05,0.00017771064264611146,0.9411764705882353
7464,임성한/Noun,17,1,16,1.1115310228308472e-05,0.00017771064264611146,0.9411764705882353
7465,데려오다/Verb,17,1,16,1.1115310228308472e-05,0.00017771064264611146,0.9411764705882353
7466,눈시울/Noun,17,16,1,0.00017784496365293555,1.1106915165381966e-05,0.9411764705882353
7467,끓이다/Verb,17,1,16,1.1115310228308472e-05,0.00017771064264611146,0.9411764705882353
7468,원주고/Noun,17,1,16,1.1115310228308472e-05,0.00017771064264611146,0.9411764705882353
7469,고리타분하다/Adjective,17,2,15,2.2230620456616944e-05,0.0001666037274807295,0.8823529411764706
7470,훈녀/Noun,17,15,2,0.00016672965342462708,2.2213830330763933e-05,0.8823529411764706
7471,궁합/Noun,17,15,2,0.00016672965342462708,2.2213830330763933e-05,0.8823529411764706
7472,작자/Noun,17,2,15,2.2230620456616944e-05,0.0001666037274807295,0.8823529411764706
7473,암만/Noun,17,2,15,2.2230620456616944e-05,0.0001666037274807295,0.8823529411764706
7474,폐/Noun,17,2,15,2.2230620456616944e-05,0.0001666037274807295,0.8823529411764706
7475,신음/Noun,17,2,15,2.2230620456616944e-05,0.0001666037274807295,0.8823529411764706
7476,랄프/Noun,17,15,2,0.00016672965342462708,2.2213830330763933e-05,0.8823529411764706
7477,쨋/Noun,17,15,2,0.00016672965342462708,2.2213830330763933e-05,0.8823529411764706
7478,로더/Noun,17,2,15,2.2230620456616944e-05,0.0001666037274807295,0.8823529411764706
7479,bbb/Alpha,17,15,2,0.00016672965342462708,2.2213830330763933e-05,0.8823529411764706
7480,야망/Noun,17,15,2,0.00016672965342462708,2.2213830330763933e-05,0.8823529411764706
7481,파란만장하다/Adjective,17,15,2,0.00016672965342462708,2.2213830330763933e-05,0.8823529411764706
7482,or/Alpha,17,2,15,2.2230620456616944e-05,0.0001666037274807295,0.8823529411764706
7483,서른/Noun,17,15,2,0.00016672965342462708,2.2213830330763933e-05,0.8823529411764706
7484,앞세우다/Verb,17,2,15,2.2230620456616944e-05,0.0001666037274807295,0.8823529411764706
7485,심플/Noun,17,14,3,0.0001556143431963186,3.33207454961459e-05,0.8235294117647058
7486,단면/Noun,17,14,3,0.0001556143431963186,3.33207454961459e-05,0.8235294117647058
7487,사지/Noun,17,3,14,3.3345930684925414e-05,0.00015549681231534753,0.8235294117647058
7488,딘/Noun,17,14,3,0.0001556143431963186,3.33207454961459e-05,0.8235294117647058
7489,심보/Noun,17,3,14,3.3345930684925414e-05,0.00015549681231534753,0.8235294117647058
7490,악어/Noun,17,3,14,3.3345930684925414e-05,0.00015549681231534753,0.8235294117647058
7491,거저/Noun,17,3,14,3.3345930684925414e-05,0.00015549681231534753,0.8235294117647058
7492,상위/Noun,17,14,3,0.0001556143431963186,3.33207454961459e-05,0.8235294117647058
7493,생생/Noun,17,14,3,0.0001556143431963186,3.33207454961459e-05,0.8235294117647058
7494,앤드류/Noun,17,14,3,0.0001556143431963186,3.33207454961459e-05,0.8235294117647058
7495,폐인/Noun,17,14,3,0.0001556143431963186,3.33207454961459e-05,0.8235294117647058
7496,ok/Alpha,17,3,14,3.3345930684925414e-05,0.00015549681231534753,0.8235294117647058
7497,시리/Noun,17,14,3,0.0001556143431963186,3.33207454961459e-05,0.8235294117647058
7498,제멋대로/Noun,17,3,14,3.3345930684925414e-05,0.00015549681231534753,0.8235294117647058
7499,서비스/Noun,17,3,14,3.3345930684925414e-05,0.00015549681231534753,0.8235294117647058
7500,쏠리다/Verb,17,3,14,3.3345930684925414e-05,0.00015549681231534753,0.8235294117647058
7501,꽥꽥/Adverb,17,3,14,3.3345930684925414e-05,0.00015549681231534753,0.8235294117647058
7502,빙빙/Noun,17,3,14,3.3345930684925414e-05,0.00015549681231534753,0.8235294117647058
7503,뮤/Noun,17,14,3,0.0001556143431963186,3.33207454961459e-05,0.8235294117647058
7504,쑤시다/Verb,17,3,14,3.3345930684925414e-05,0.00015549681231534753,0.8235294117647058
7505,저희/Modifier,17,14,3,0.0001556143431963186,3.33207454961459e-05,0.8235294117647058
7506,일색/Noun,17,3,14,3.3345930684925414e-05,0.00015549681231534753,0.8235294117647058
7507,진진/Noun,17,14,3,0.0001556143431963186,3.33207454961459e-05,0.8235294117647058
7508,배급/Noun,17,3,14,3.3345930684925414e-05,0.00015549681231534753,0.8235294117647058
7509,운지/Noun,17,3,14,3.3345930684925414e-05,0.00015549681231534753,0.8235294117647058
7510,토크/Noun,17,4,13,4.446124091323389e-05,0.00014438989714996557,0.7647058823529411
7511,교/Noun,17,4,13,4.446124091323389e-05,0.00014438989714996557,0.7647058823529411
7512,커트/Noun,17,13,4,0.00014449903296801013,4.4427660661527865e-05,0.7647058823529411
7513,우상/Noun,17,13,4,0.00014449903296801013,4.4427660661527865e-05,0.7647058823529411
7514,웠/Noun,17,13,4,0.00014449903296801013,4.4427660661527865e-05,0.7647058823529411
7515,미생/Noun,17,13,4,0.00014449903296801013,4.4427660661527865e-05,0.7647058823529411
7516,1998년/Number,17,13,4,0.00014449903296801013,4.4427660661527865e-05,0.7647058823529411
7517,내사/Noun,17,13,4,0.00014449903296801013,4.4427660661527865e-05,0.7647058823529411
7518,토시/Noun,17,4,13,4.446124091323389e-05,0.00014438989714996557,0.7647058823529411
7519,아비/Noun,17,4,13,4.446124091323389e-05,0.00014438989714996557,0.7647058823529411
7520,웨스/Noun,17,13,4,0.00014449903296801013,4.4427660661527865e-05,0.7647058823529411
7521,붙이/Noun,17,4,13,4.446124091323389e-05,0.00014438989714996557,0.7647058823529411
7522,넘사벽/Noun,17,13,4,0.00014449903296801013,4.4427660661527865e-05,0.7647058823529411
7523,--;;/Punctuation,17,4,13,4.446124091323389e-05,0.00014438989714996557,0.7647058823529411
7524,맘마미아/Noun,17,4,13,4.446124091323389e-05,0.00014438989714996557,0.7647058823529411
7525,처지다/Verb,17,4,13,4.446124091323389e-05,0.00014438989714996557,0.7647058823529411
7526,쉰/Noun,17,13,4,0.00014449903296801013,4.4427660661527865e-05,0.7647058823529411
7527,뽑히다/Verb,17,4,13,4.446124091323389e-05,0.00014438989714996557,0.7647058823529411
7528,거려/Noun,17,4,13,4.446124091323389e-05,0.00014438989714996557,0.7647058823529411
7529,..~/Punctuation,17,13,4,0.00014449903296801013,4.4427660661527865e-05,0.7647058823529411
7530,기립박수/Noun,17,13,4,0.00014449903296801013,4.4427660661527865e-05,0.7647058823529411
7531,래서/Noun,17,4,13,4.446124091323389e-05,0.00014438989714996557,0.7647058823529411
7532,만능/Noun,17,13,4,0.00014449903296801013,4.4427660661527865e-05,0.7647058823529411
7533,마당/Noun,17,4,13,4.446124091323389e-05,0.00014438989714996557,0.7647058823529411
7534,시궁창/Noun,17,4,13,4.446124091323389e-05,0.00014438989714996557,0.7647058823529411
7535,발랄/Noun,17,13,4,0.00014449903296801013,4.4427660661527865e-05,0.7647058823529411
7536,항/Noun,17,4,13,4.446124091323389e-05,0.00014438989714996557,0.7647058823529411
7537,시원찮다/Adjective,17,4,13,4.446124091323389e-05,0.00014438989714996557,0.7647058823529411
7538,릴/Noun,17,5,12,5.557655114154236e-05,0.0001332829819845836,0.7058823529411765
7539,연쇄/Noun,17,5,12,5.557655114154236e-05,0.0001332829819845836,0.7058823529411765
7540,회수/Noun,17,5,12,5.557655114154236e-05,0.0001332829819845836,0.7058823529411765
7541,소금/Noun,17,5,12,5.557655114154236e-05,0.0001332829819845836,0.7058823529411765
7542,아가씨/Noun,17,5,12,5.557655114154236e-05,0.0001332829819845836,0.7058823529411765
7543,머임/Noun,17,5,12,5.557655114154236e-05,0.0001332829819845836,0.7058823529411765
7544,위엄/Noun,17,5,12,5.557655114154236e-05,0.0001332829819845836,0.7058823529411765
7545,스탭/Noun,17,12,5,0.00013338372273970166,5.5534575826909837e-05,0.7058823529411765
7546,다행하다/Adjective,17,12,5,0.00013338372273970166,5.5534575826909837e-05,0.7058823529411765
7547,비위/Noun,17,5,12,5.557655114154236e-05,0.0001332829819845836,0.7058823529411765
7548,특수부대/Noun,17,5,12,5.557655114154236e-05,0.0001332829819845836,0.7058823529411765
7549,신영화/Noun,17,5,12,5.557655114154236e-05,0.0001332829819845836,0.7058823529411765
7550,더럽히다/Verb,17,5,12,5.557655114154236e-05,0.0001332829819845836,0.7058823529411765
7551,은밀/Noun,17,5,12,5.557655114154236e-05,0.0001332829819845836,0.7058823529411765
7552,요한/Noun,17,12,5,0.00013338372273970166,5.5534575826909837e-05,0.7058823529411765
7553,p/Alpha,17,5,12,5.557655114154236e-05,0.0001332829819845836,0.7058823529411765
7554,어쩌다가/Noun,17,5,12,5.557655114154236e-05,0.0001332829819845836,0.7058823529411765
7555,아버/Noun,17,5,12,5.557655114154236e-05,0.0001332829819845836,0.7058823529411765
7556,뒷모습/Noun,17,12,5,0.00013338372273970166,5.5534575826909837e-05,0.7058823529411765
7557,우습다/Adjective,17,5,12,5.557655114154236e-05,0.0001332829819845836,0.7058823529411765
7558,................../Punctuation,17,5,12,5.557655114154236e-05,0.0001332829819845836,0.7058823529411765
7559,당첨/Noun,17,5,12,5.557655114154236e-05,0.0001332829819845836,0.7058823529411765
7560,물어/Noun,17,5,12,5.557655114154236e-05,0.0001332829819845836,0.7058823529411765
7561,9.5/Number,17,12,5,0.00013338372273970166,5.5534575826909837e-05,0.7058823529411765
7562,종결/Noun,17,5,12,5.557655114154236e-05,0.0001332829819845836,0.7058823529411765
7563,드럼/Noun,17,12,5,0.00013338372273970166,5.5534575826909837e-05,0.7058823529411765
7564,영화제작/Noun,17,5,12,5.557655114154236e-05,0.0001332829819845836,0.7058823529411765
7565,입술/Noun,17,5,12,5.557655114154236e-05,0.0001332829819845836,0.7058823529411765
7566,졋/Noun,17,5,12,5.557655114154236e-05,0.0001332829819845836,0.7058823529411765
7567,맴/Noun,17,12,5,0.00013338372273970166,5.5534575826909837e-05,0.7058823529411765
7568,아부/Noun,17,5,12,5.557655114154236e-05,0.0001332829819845836,0.7058823529411765
7569,전기영/Noun,17,12,5,0.00013338372273970166,5.5534575826909837e-05,0.7058823529411765
7570,윤제문/Noun,17,12,5,0.00013338372273970166,5.5534575826909837e-05,0.7058823529411765
7571,라가/Noun,17,5,12,5.557655114154236e-05,0.0001332829819845836,0.7058823529411765
7572,해바라기/Noun,17,5,12,5.557655114154236e-05,0.0001332829819845836,0.7058823529411765
7573,이보영/Noun,17,12,5,0.00013338372273970166,5.5534575826909837e-05,0.7058823529411765
7574,클로즈업/Noun,17,5,12,5.557655114154236e-05,0.0001332829819845836,0.7058823529411765
7575,!!!!!!!!!!!!!!/Punctuation,17,11,6,0.00012226841251139318,6.66414909922918e-05,0.6470588235294118
7576,92년/Number,17,11,6,0.00012226841251139318,6.66414909922918e-05,0.6470588235294118
7577,판빙빙/Noun,17,6,11,6.669186136985083e-05,0.00012217606681920164,0.6470588235294118
7578,끝없이/Adverb,17,11,6,0.00012226841251139318,6.66414909922918e-05,0.6470588235294118
7579,영향력/Noun,17,11,6,0.00012226841251139318,6.66414909922918e-05,0.6470588235294118
7580,한류/Noun,17,6,11,6.669186136985083e-05,0.00012217606681920164,0.6470588235294118
7581,몇몇/Modifier,17,6,11,6.669186136985083e-05,0.00012217606681920164,0.6470588235294118
7582,내심/Noun,17,6,11,6.669186136985083e-05,0.00012217606681920164,0.6470588235294118
7583,도발/Noun,17,6,11,6.669186136985083e-05,0.00012217606681920164,0.6470588235294118
7584,어나/Modifier,17,6,11,6.669186136985083e-05,0.00012217606681920164,0.6470588235294118
7585,서영희/Noun,17,11,6,0.00012226841251139318,6.66414909922918e-05,0.6470588235294118
7586,세계대전/Noun,17,6,11,6.669186136985083e-05,0.00012217606681920164,0.6470588235294118
7587,투신/Noun,17,11,6,0.00012226841251139318,6.66414909922918e-05,0.6470588235294118
7588,VOD/Alpha,17,6,11,6.669186136985083e-05,0.00012217606681920164,0.6470588235294118
7589,민감하다/Adjective,17,6,11,6.669186136985083e-05,0.00012217606681920164,0.6470588235294118
7590,정경호/Noun,17,11,6,0.00012226841251139318,6.66414909922918e-05,0.6470588235294118
7591,You/Alpha,17,11,6,0.00012226841251139318,6.66414909922918e-05,0.6470588235294118
7592,휴대폰/Noun,17,6,11,6.669186136985083e-05,0.00012217606681920164,0.6470588235294118
7593,인디영화/Noun,17,6,11,6.669186136985083e-05,0.00012217606681920164,0.6470588235294118
7594,94년/Number,17,11,6,0.00012226841251139318,6.66414909922918e-05,0.6470588235294118
7595,가격/Noun,17,6,11,6.669186136985083e-05,0.00012217606681920164,0.6470588235294118
7596,사투/Noun,17,11,6,0.00012226841251139318,6.66414909922918e-05,0.6470588235294118
7597,초한지/Noun,17,11,6,0.00012226841251139318,6.66414909922918e-05,0.6470588235294118
7598,십/Noun,17,6,11,6.669186136985083e-05,0.00012217606681920164,0.6470588235294118
7599,훨신/Noun,17,6,11,6.669186136985083e-05,0.00012217606681920164,0.6470588235294118
7600,장안/Noun,17,6,11,6.669186136985083e-05,0.00012217606681920164,0.6470588235294118
7601,자동/Noun,17,6,11,6.669186136985083e-05,0.00012217606681920164,0.6470588235294118
7602,대명사/Noun,17,11,6,0.00012226841251139318,6.66414909922918e-05,0.6470588235294118
7603,이명박/Noun,17,6,11,6.669186136985083e-05,0.00012217606681920164,0.6470588235294118
7604,은영/Noun,17,6,11,6.669186136985083e-05,0.00012217606681920164,0.6470588235294118
7605,사색/Noun,17,11,6,0.00012226841251139318,6.66414909922918e-05,0.6470588235294118
7606,요괴/Noun,17,11,6,0.00012226841251139318,6.66414909922918e-05,0.6470588235294118
7607,발킬머/Noun,17,11,6,0.00012226841251139318,6.66414909922918e-05,0.6470588235294118
7608,하녀/Noun,17,6,11,6.669186136985083e-05,0.00012217606681920164,0.6470588235294118
7609,디지털/Noun,17,6,11,6.669186136985083e-05,0.00012217606681920164,0.6470588235294118
7610,옆집/Noun,17,6,11,6.669186136985083e-05,0.00012217606681920164,0.6470588235294118
7611,후후/Exclamation,17,11,6,0.00012226841251139318,6.66414909922918e-05,0.6470588235294118
7612,차이나다/Verb,17,6,11,6.669186136985083e-05,0.00012217606681920164,0.6470588235294118
7613,뒷이야기/Noun,17,11,6,0.00012226841251139318,6.66414909922918e-05,0.6470588235294118
7614,김지수/Noun,17,11,6,0.00012226841251139318,6.66414909922918e-05,0.6470588235294118
7615,올드/Noun,17,6,11,6.669186136985083e-05,0.00012217606681920164,0.6470588235294118
7616,툭/Noun,17,6,11,6.669186136985083e-05,0.00012217606681920164,0.6470588235294118
7617,일로/Noun,17,6,11,6.669186136985083e-05,0.00012217606681920164,0.6470588235294118
7618,사이먼/Noun,17,11,6,0.00012226841251139318,6.66414909922918e-05,0.6470588235294118
7619,카이/Noun,17,11,6,0.00012226841251139318,6.66414909922918e-05,0.6470588235294118
7620,유일/Noun,17,10,7,0.00011115310228308472,7.774840615767377e-05,0.5882352941176471
7621,올리버/Noun,17,7,10,7.78071715981593e-05,0.00011106915165381967,0.5882352941176471
7622,60/Number,17,7,10,7.78071715981593e-05,0.00011106915165381967,0.5882352941176471
7623,공중/Noun,17,10,7,0.00011115310228308472,7.774840615767377e-05,0.5882352941176471
7624,)./Punctuation,17,7,10,7.78071715981593e-05,0.00011106915165381967,0.5882352941176471
7625,박시연/Noun,17,10,7,0.00011115310228308472,7.774840615767377e-05,0.5882352941176471
7626,실버/Noun,17,10,7,0.00011115310228308472,7.774840615767377e-05,0.5882352941176471
7627,봣으/Noun,17,10,7,0.00011115310228308472,7.774840615767377e-05,0.5882352941176471
7628,후려/Noun,17,7,10,7.78071715981593e-05,0.00011106915165381967,0.5882352941176471
7629,70/Number,17,10,7,0.00011115310228308472,7.774840615767377e-05,0.5882352941176471
7630,보리/Noun,17,10,7,0.00011115310228308472,7.774840615767377e-05,0.5882352941176471
7631,한가인/Noun,17,7,10,7.78071715981593e-05,0.00011106915165381967,0.5882352941176471
7632,인의/Noun,17,7,10,7.78071715981593e-05,0.00011106915165381967,0.5882352941176471
7633,볼타/Noun,17,10,7,0.00011115310228308472,7.774840615767377e-05,0.5882352941176471
7634,금물/Noun,17,7,10,7.78071715981593e-05,0.00011106915165381967,0.5882352941176471
7635,1970년/Number,17,7,10,7.78071715981593e-05,0.00011106915165381967,0.5882352941176471
7636,배우진/Noun,17,7,10,7.78071715981593e-05,0.00011106915165381967,0.5882352941176471
7637,헨리/Noun,17,10,7,0.00011115310228308472,7.774840615767377e-05,0.5882352941176471
7638,의의/Noun,17,10,7,0.00011115310228308472,7.774840615767377e-05,0.5882352941176471
7639,마사/Noun,17,10,7,0.00011115310228308472,7.774840615767377e-05,0.5882352941176471
7640,킬빌/Noun,17,7,10,7.78071715981593e-05,0.00011106915165381967,0.5882352941176471
7641,유태인/Noun,17,10,7,0.00011115310228308472,7.774840615767377e-05,0.5882352941176471
7642,이런저런/Modifier,17,7,10,7.78071715981593e-05,0.00011106915165381967,0.5882352941176471
7643,는가/Noun,17,10,7,0.00011115310228308472,7.774840615767377e-05,0.5882352941176471
7644,동방불패/Noun,17,10,7,0.00011115310228308472,7.774840615767377e-05,0.5882352941176471
7645,NO/Alpha,17,7,10,7.78071715981593e-05,0.00011106915165381967,0.5882352941176471
7646,마루/Noun,17,10,7,0.00011115310228308472,7.774840615767377e-05,0.5882352941176471
7647,브로스/Noun,17,10,7,0.00011115310228308472,7.774840615767377e-05,0.5882352941176471
7648,베테/Noun,17,10,7,0.00011115310228308472,7.774840615767377e-05,0.5882352941176471
7649,싱크/Noun,17,7,10,7.78071715981593e-05,0.00011106915165381967,0.5882352941176471
7650,일병/Noun,17,10,7,0.00011115310228308472,7.774840615767377e-05,0.5882352941176471
7651,존슨/Noun,17,7,10,7.78071715981593e-05,0.00011106915165381967,0.5882352941176471
7652,배경음/Noun,17,10,7,0.00011115310228308472,7.774840615767377e-05,0.5882352941176471
7653,10000/Number,17,10,7,0.00011115310228308472,7.774840615767377e-05,0.5882352941176471
7654,백년/Noun,17,10,7,0.00011115310228308472,7.774840615767377e-05,0.5882352941176471
7655,이이/Noun,17,10,7,0.00011115310228308472,7.774840615767377e-05,0.5882352941176471
7656,잡기/Noun,17,7,10,7.78071715981593e-05,0.00011106915165381967,0.5882352941176471
7657,라라/Noun,17,8,9,8.892248182646778e-05,9.99622364884377e-05,0.5294117647058824
7658,도록/Noun,17,9,8,0.00010003779205477625,8.885532132305573e-05,0.5294117647058824
7659,라나/Noun,17,9,8,0.00010003779205477625,8.885532132305573e-05,0.5294117647058824
7660,본분/Noun,17,9,8,0.00010003779205477625,8.885532132305573e-05,0.5294117647058824
7661,예감/Noun,17,9,8,0.00010003779205477625,8.885532132305573e-05,0.5294117647058824
7662,제대/Noun,17,9,8,0.00010003779205477625,8.885532132305573e-05,0.5294117647058824
7663,안도/Noun,17,8,9,8.892248182646778e-05,9.99622364884377e-05,0.5294117647058824
7664,더글라스/Noun,17,8,9,8.892248182646778e-05,9.99622364884377e-05,0.5294117647058824
7665,인천/Noun,17,9,8,0.00010003779205477625,8.885532132305573e-05,0.5294117647058824
7666,무릎/Noun,17,9,8,0.00010003779205477625,8.885532132305573e-05,0.5294117647058824
7667,홀딱/Noun,17,8,9,8.892248182646778e-05,9.99622364884377e-05,0.5294117647058824
7668,?(/Punctuation,17,8,9,8.892248182646778e-05,9.99622364884377e-05,0.5294117647058824
7669,다람쥐/Noun,17,9,8,0.00010003779205477625,8.885532132305573e-05,0.5294117647058824
7670,햄버거/Noun,17,9,8,0.00010003779205477625,8.885532132305573e-05,0.5294117647058824
7671,움직/Noun,17,9,8,0.00010003779205477625,8.885532132305573e-05,0.5294117647058824
7672,퍼포먼스/Noun,17,9,8,0.00010003779205477625,8.885532132305573e-05,0.5294117647058824
7673,다잡다/Verb,17,8,9,8.892248182646778e-05,9.99622364884377e-05,0.5294117647058824
7674,굿닥터/Noun,17,8,9,8.892248182646778e-05,9.99622364884377e-05,0.5294117647058824
7675,지니어스/Noun,17,9,8,0.00010003779205477625,8.885532132305573e-05,0.5294117647058824
7676,티스/Noun,17,9,8,0.00010003779205477625,8.885532132305573e-05,0.5294117647058824
7677,디자이너/Noun,17,9,8,0.00010003779205477625,8.885532132305573e-05,0.5294117647058824
7678,주자/Noun,17,9,8,0.00010003779205477625,8.885532132305573e-05,0.5294117647058824
7679,G/Alpha,17,8,9,8.892248182646778e-05,9.99622364884377e-05,0.5294117647058824
7680,어드벤쳐/Noun,17,9,8,0.00010003779205477625,8.885532132305573e-05,0.5294117647058824
7681,어어/Noun,17,8,9,8.892248182646778e-05,9.99622364884377e-05,0.5294117647058824
7682,더블/Noun,17,8,9,8.892248182646778e-05,9.99622364884377e-05,0.5294117647058824
7683,디다/Noun,17,8,9,8.892248182646778e-05,9.99622364884377e-05,0.5294117647058824
7684,치아/Noun,17,9,8,0.00010003779205477625,8.885532132305573e-05,0.5294117647058824
7685,드류/Noun,17,9,8,0.00010003779205477625,8.885532132305573e-05,0.5294117647058824
7686,공산당/Noun,17,9,8,0.00010003779205477625,8.885532132305573e-05,0.5294117647058824
7687,주년/Noun,17,8,9,8.892248182646778e-05,9.99622364884377e-05,0.5294117647058824
7688,쿨/Noun,17,9,8,0.00010003779205477625,8.885532132305573e-05,0.5294117647058824
7689,옜날/Noun,17,9,8,0.00010003779205477625,8.885532132305573e-05,0.5294117647058824
7690,내미다/Verb,17,9,8,0.00010003779205477625,8.885532132305573e-05,0.5294117647058824
7691,니슨/Noun,17,8,9,8.892248182646778e-05,9.99622364884377e-05,0.5294117647058824
7692,100만/Number,17,9,8,0.00010003779205477625,8.885532132305573e-05,0.5294117647058824
7693,참담하다/Adjective,17,8,9,8.892248182646778e-05,9.99622364884377e-05,0.5294117647058824
7694,조화롭다/Adjective,17,9,8,0.00010003779205477625,8.885532132305573e-05,0.5294117647058824
7695,위인/Noun,17,8,9,8.892248182646778e-05,9.99622364884377e-05,0.5294117647058824
7696,이동진/Noun,17,9,8,0.00010003779205477625,8.885532132305573e-05,0.5294117647058824
7697,정준영/Noun,17,9,8,0.00010003779205477625,8.885532132305573e-05,0.5294117647058824
7698,빼먹다/Verb,17,9,8,0.00010003779205477625,8.885532132305573e-05,0.5294117647058824
7699,타파/Noun,17,9,8,0.00010003779205477625,8.885532132305573e-05,0.5294117647058824
7700,ㅁㅈㅎ/KoreanParticle,16,0,16,0.0,0.00017771064264611146,1.0
7701,이뭐병/Noun,16,0,16,0.0,0.00017771064264611146,1.0
7702,코끝/Noun,16,16,0,0.00017784496365293555,0.0,1.0
7703,루고/Noun,16,0,16,0.0,0.00017771064264611146,1.0
7704,감격/Noun,16,16,0,0.00017784496365293555,0.0,1.0
7705,bbbb/Alpha,16,16,0,0.00017784496365293555,0.0,1.0
7706,박하/Noun,16,16,0,0.00017784496365293555,0.0,1.0
7707,좆망/Noun,16,1,15,1.1115310228308472e-05,0.0001666037274807295,0.9375
7708,찰스/Noun,16,15,1,0.00016672965342462708,1.1106915165381966e-05,0.9375
7709,상술/Noun,16,1,15,1.1115310228308472e-05,0.0001666037274807295,0.9375
7710,넘침/Noun,16,15,1,0.00016672965342462708,1.1106915165381966e-05,0.9375
7711,공군/Noun,16,1,15,1.1115310228308472e-05,0.0001666037274807295,0.9375
7712,모도/Noun,16,15,1,0.00016672965342462708,1.1106915165381966e-05,0.9375
7713,짱깨/Noun,16,1,15,1.1115310228308472e-05,0.0001666037274807295,0.9375
7714,씌우다/Verb,16,1,15,1.1115310228308472e-05,0.0001666037274807295,0.9375
7715,am/Alpha,16,15,1,0.00016672965342462708,1.1106915165381966e-05,0.9375
7716,빙자/Noun,16,1,15,1.1115310228308472e-05,0.0001666037274807295,0.9375
7717,윤재/Noun,16,1,15,1.1115310228308472e-05,0.0001666037274807295,0.9375
7718,얼렁뚱땅/Noun,16,1,15,1.1115310228308472e-05,0.0001666037274807295,0.9375
7719,하비에르/Noun,16,15,1,0.00016672965342462708,1.1106915165381966e-05,0.9375
7720,표지/Noun,16,2,14,2.2230620456616944e-05,0.00015549681231534753,0.875
7721,부추기다/Verb,16,2,14,2.2230620456616944e-05,0.00015549681231534753,0.875
7722,전과/Noun,16,14,2,0.0001556143431963186,2.2213830330763933e-05,0.875
7723,우수/Noun,16,14,2,0.0001556143431963186,2.2213830330763933e-05,0.875
7724,샤크/Noun,16,2,14,2.2230620456616944e-05,0.00015549681231534753,0.875
7725,과소/Noun,16,14,2,0.0001556143431963186,2.2213830330763933e-05,0.875
7726,신중하다/Adjective,16,2,14,2.2230620456616944e-05,0.00015549681231534753,0.875
7727,유부/Noun,16,2,14,2.2230620456616944e-05,0.00015549681231534753,0.875
7728,돌아이/Noun,16,2,14,2.2230620456616944e-05,0.00015549681231534753,0.875
7729,!!!!!!!!!!/Punctuation,16,14,2,0.0001556143431963186,2.2213830330763933e-05,0.875
7730,프렌즈/Noun,16,14,2,0.0001556143431963186,2.2213830330763933e-05,0.875
7731,사죄/Noun,16,2,14,2.2230620456616944e-05,0.00015549681231534753,0.875
7732,어렴풋이/Adverb,16,14,2,0.0001556143431963186,2.2213830330763933e-05,0.875
7733,막연하다/Adjective,16,14,2,0.0001556143431963186,2.2213830330763933e-05,0.875
7734,값지다/Adjective,16,14,2,0.0001556143431963186,2.2213830330763933e-05,0.875
7735,수박/Noun,16,2,14,2.2230620456616944e-05,0.00015549681231534753,0.875
7736,찌꺼기/Noun,16,2,14,2.2230620456616944e-05,0.00015549681231534753,0.875
7737,사먹다/Verb,16,2,14,2.2230620456616944e-05,0.00015549681231534753,0.875
7738,벗/Noun,16,2,14,2.2230620456616944e-05,0.00015549681231534753,0.875
7739,타겟/Noun,16,2,14,2.2230620456616944e-05,0.00015549681231534753,0.875
7740,직설/Noun,16,14,2,0.0001556143431963186,2.2213830330763933e-05,0.875
7741,볼품/Noun,16,2,14,2.2230620456616944e-05,0.00015549681231534753,0.875
7742,sm/Alpha,16,2,14,2.2230620456616944e-05,0.00015549681231534753,0.875
7743,쓰시/Noun,16,3,13,3.3345930684925414e-05,0.00014438989714996557,0.8125
7744,야마카시/Noun,16,3,13,3.3345930684925414e-05,0.00014438989714996557,0.8125
7745,훈훈/Noun,16,13,3,0.00014449903296801013,3.33207454961459e-05,0.8125
7746,지리하다/Adjective,16,3,13,3.3345930684925414e-05,0.00014438989714996557,0.8125
7747,김아중/Noun,16,13,3,0.00014449903296801013,3.33207454961459e-05,0.8125
7748,연성/Noun,16,3,13,3.3345930684925414e-05,0.00014438989714996557,0.8125
7749,여학생/Noun,16,3,13,3.3345930684925414e-05,0.00014438989714996557,0.8125
7750,찔끔/Adverb,16,13,3,0.00014449903296801013,3.33207454961459e-05,0.8125
7751,개무시/Noun,16,3,13,3.3345930684925414e-05,0.00014438989714996557,0.8125
7752,하트넷/Noun,16,13,3,0.00014449903296801013,3.33207454961459e-05,0.8125
7753,;;;;;;/Punctuation,16,3,13,3.3345930684925414e-05,0.00014438989714996557,0.8125
7754,입사/Noun,16,3,13,3.3345930684925414e-05,0.00014438989714996557,0.8125
7755,지혜/Noun,16,13,3,0.00014449903296801013,3.33207454961459e-05,0.8125
7756,살의/Noun,16,13,3,0.00014449903296801013,3.33207454961459e-05,0.8125
7757,리나/Noun,16,3,13,3.3345930684925414e-05,0.00014438989714996557,0.8125
7758,황정음/Noun,16,13,3,0.00014449903296801013,3.33207454961459e-05,0.8125
7759,강정/Noun,16,3,13,3.3345930684925414e-05,0.00014438989714996557,0.8125
7760,방화/Noun,16,3,13,3.3345930684925414e-05,0.00014438989714996557,0.8125
7761,색기/Noun,16,3,13,3.3345930684925414e-05,0.00014438989714996557,0.8125
7762,현기증/Noun,16,13,3,0.00014449903296801013,3.33207454961459e-05,0.8125
7763,갈피/Noun,16,3,13,3.3345930684925414e-05,0.00014438989714996557,0.8125
7764,차려/Noun,16,3,13,3.3345930684925414e-05,0.00014438989714996557,0.8125
7765,이시영/Noun,16,13,3,0.00014449903296801013,3.33207454961459e-05,0.8125
7766,퇴/Noun,16,3,13,3.3345930684925414e-05,0.00014438989714996557,0.8125
7767,불허/Noun,16,13,3,0.00014449903296801013,3.33207454961459e-05,0.8125
7768,배틀로얄/Noun,16,3,13,3.3345930684925414e-05,0.00014438989714996557,0.8125
7769,국민학교/Noun,16,13,3,0.00014449903296801013,3.33207454961459e-05,0.8125
7770,무당/Noun,16,3,13,3.3345930684925414e-05,0.00014438989714996557,0.8125
7771,유동근/Noun,16,13,3,0.00014449903296801013,3.33207454961459e-05,0.8125
7772,매염방/Noun,16,12,4,0.00013338372273970166,4.4427660661527865e-05,0.75
7773,꼬박꼬박/Noun,16,12,4,0.00013338372273970166,4.4427660661527865e-05,0.75
7774,넘버원/Noun,16,12,4,0.00013338372273970166,4.4427660661527865e-05,0.75
7775,쥑/Noun,16,12,4,0.00013338372273970166,4.4427660661527865e-05,0.75
7776,사무엘/Noun,16,12,4,0.00013338372273970166,4.4427660661527865e-05,0.75
7777,be/Alpha,16,12,4,0.00013338372273970166,4.4427660661527865e-05,0.75
7778,자폐/Noun,16,4,12,4.446124091323389e-05,0.0001332829819845836,0.75
7779,빠돌이/Noun,16,4,12,4.446124091323389e-05,0.0001332829819845836,0.75
7780,세기말/Noun,16,12,4,0.00013338372273970166,4.4427660661527865e-05,0.75
7781,김지운/Noun,16,12,4,0.00013338372273970166,4.4427660661527865e-05,0.75
7782,럼/Noun,16,4,12,4.446124091323389e-05,0.0001332829819845836,0.75
7783,_-/Punctuation,16,4,12,4.446124091323389e-05,0.0001332829819845836,0.75
7784,화구/Noun,16,4,12,4.446124091323389e-05,0.0001332829819845836,0.75
7785,가물가물/Adverb,16,12,4,0.00013338372273970166,4.4427660661527865e-05,0.75
7786,1995년/Number,16,12,4,0.00013338372273970166,4.4427660661527865e-05,0.75
7787,-_-;;;/Punctuation,16,4,12,4.446124091323389e-05,0.0001332829819845836,0.75
7788,한채영/Noun,16,4,12,4.446124091323389e-05,0.0001332829819845836,0.75
7789,연속극/Noun,16,4,12,4.446124091323389e-05,0.0001332829819845836,0.75
7790,뜻밖/Noun,16,12,4,0.00013338372273970166,4.4427660661527865e-05,0.75
7791,손녀/Noun,16,4,12,4.446124091323389e-05,0.0001332829819845836,0.75
7792,상품/Noun,16,4,12,4.446124091323389e-05,0.0001332829819845836,0.75
7793,장엄하다/Adjective,16,12,4,0.00013338372273970166,4.4427660661527865e-05,0.75
7794,꼽으라/Noun,16,12,4,0.00013338372273970166,4.4427660661527865e-05,0.75
7795,앙상블/Noun,16,12,4,0.00013338372273970166,4.4427660661527865e-05,0.75
7796,피닉스/Noun,16,12,4,0.00013338372273970166,4.4427660661527865e-05,0.75
7797,건축/Noun,16,12,4,0.00013338372273970166,4.4427660661527865e-05,0.75
7798,알콩달콩/Noun,16,12,4,0.00013338372273970166,4.4427660661527865e-05,0.75
7799,개쩜/Noun,16,12,4,0.00013338372273970166,4.4427660661527865e-05,0.75
7800,두기/Noun,16,12,4,0.00013338372273970166,4.4427660661527865e-05,0.75
7801,...??/Punctuation,16,4,12,4.446124091323389e-05,0.0001332829819845836,0.75
7802,시내/Noun,16,4,12,4.446124091323389e-05,0.0001332829819845836,0.75
7803,김상경/Noun,16,12,4,0.00013338372273970166,4.4427660661527865e-05,0.75
7804,우기/Noun,16,4,12,4.446124091323389e-05,0.0001332829819845836,0.75
7805,숙제/Noun,16,12,4,0.00013338372273970166,4.4427660661527865e-05,0.75
7806,"...""/Punctuation",16,4,12,4.446124091323389e-05,0.0001332829819845836,0.75
7807,설계/Noun,16,4,12,4.446124091323389e-05,0.0001332829819845836,0.75
7808,베댓/Noun,16,4,12,4.446124091323389e-05,0.0001332829819845836,0.75
7809,불편/Noun,16,4,12,4.446124091323389e-05,0.0001332829819845836,0.75
7810,코메/Noun,16,4,12,4.446124091323389e-05,0.0001332829819845836,0.75
7811,바리/Noun,16,4,12,4.446124091323389e-05,0.0001332829819845836,0.75
7812,파커/Noun,16,12,4,0.00013338372273970166,4.4427660661527865e-05,0.75
7813,십분/Noun,16,4,12,4.446124091323389e-05,0.0001332829819845836,0.75
7814,바둑/Noun,16,4,12,4.446124091323389e-05,0.0001332829819845836,0.75
7815,제압/Noun,16,4,12,4.446124091323389e-05,0.0001332829819845836,0.75
7816,집어치우다/Verb,16,4,12,4.446124091323389e-05,0.0001332829819845836,0.75
7817,치의/Noun,16,12,4,0.00013338372273970166,4.4427660661527865e-05,0.75
7818,간혹/Noun,16,5,11,5.557655114154236e-05,0.00012217606681920164,0.6875
7819,힘차다/Adjective,16,5,11,5.557655114154236e-05,0.00012217606681920164,0.6875
7820,맥과이어/Noun,16,11,5,0.00012226841251139318,5.5534575826909837e-05,0.6875
7821,쉐프/Noun,16,5,11,5.557655114154236e-05,0.00012217606681920164,0.6875
7822,민영화/Noun,16,11,5,0.00012226841251139318,5.5534575826909837e-05,0.6875
7823,외설/Noun,16,5,11,5.557655114154236e-05,0.00012217606681920164,0.6875
7824,도서관/Noun,16,11,5,0.00012226841251139318,5.5534575826909837e-05,0.6875
7825,나마/Noun,16,11,5,0.00012226841251139318,5.5534575826909837e-05,0.6875
7826,후딱/Adverb,16,11,5,0.00012226841251139318,5.5534575826909837e-05,0.6875
7827,도둑질/Noun,16,5,11,5.557655114154236e-05,0.00012217606681920164,0.6875
7828,일과/Noun,16,11,5,0.00012226841251139318,5.5534575826909837e-05,0.6875
7829,다다/Noun,16,5,11,5.557655114154236e-05,0.00012217606681920164,0.6875
7830,혼합/Noun,16,5,11,5.557655114154236e-05,0.00012217606681920164,0.6875
7831,끈끈/Noun,16,11,5,0.00012226841251139318,5.5534575826909837e-05,0.6875
7832,사위/Noun,16,5,11,5.557655114154236e-05,0.00012217606681920164,0.6875
7833,타고나다/Verb,16,11,5,0.00012226841251139318,5.5534575826909837e-05,0.6875
7834,TOP/Alpha,16,11,5,0.00012226841251139318,5.5534575826909837e-05,0.6875
7835,괴리감/Noun,16,5,11,5.557655114154236e-05,0.00012217606681920164,0.6875
7836,지로/Noun,16,5,11,5.557655114154236e-05,0.00012217606681920164,0.6875
7837,확장/Noun,16,11,5,0.00012226841251139318,5.5534575826909837e-05,0.6875
7838,김민정/Noun,16,11,5,0.00012226841251139318,5.5534575826909837e-05,0.6875
7839,세포/Noun,16,11,5,0.00012226841251139318,5.5534575826909837e-05,0.6875
7840,시티/Noun,16,11,5,0.00012226841251139318,5.5534575826909837e-05,0.6875
7841,이영애/Noun,16,11,5,0.00012226841251139318,5.5534575826909837e-05,0.6875
7842,줄어들다/Verb,16,11,5,0.00012226841251139318,5.5534575826909837e-05,0.6875
7843,대회/Noun,16,5,11,5.557655114154236e-05,0.00012217606681920164,0.6875
7844,똥파리/Noun,16,5,11,5.557655114154236e-05,0.00012217606681920164,0.6875
7845,극우/Noun,16,5,11,5.557655114154236e-05,0.00012217606681920164,0.6875
7846,곽경택/Noun,16,5,11,5.557655114154236e-05,0.00012217606681920164,0.6875
7847,세로/Noun,16,5,11,5.557655114154236e-05,0.00012217606681920164,0.6875
7848,수출/Noun,16,5,11,5.557655114154236e-05,0.00012217606681920164,0.6875
7849,쌀/Noun,16,11,5,0.00012226841251139318,5.5534575826909837e-05,0.6875
7850,겜/Noun,16,11,5,0.00012226841251139318,5.5534575826909837e-05,0.6875
7851,고정관념/Noun,16,11,5,0.00012226841251139318,5.5534575826909837e-05,0.6875
7852,치도/Noun,16,11,5,0.00012226841251139318,5.5534575826909837e-05,0.6875
7853,민중/Noun,16,11,5,0.00012226841251139318,5.5534575826909837e-05,0.6875
7854,고하/Noun,16,5,11,5.557655114154236e-05,0.00012217606681920164,0.6875
7855,23/Number,16,11,5,0.00012226841251139318,5.5534575826909837e-05,0.6875
7856,으아아/Exclamation,16,5,11,5.557655114154236e-05,0.00012217606681920164,0.6875
7857,오마이갓/Noun,16,5,11,5.557655114154236e-05,0.00012217606681920164,0.6875
7858,효과음/Noun,16,5,11,5.557655114154236e-05,0.00012217606681920164,0.6875
7859,모조리/Noun,16,5,11,5.557655114154236e-05,0.00012217606681920164,0.6875
7860,쇼생크탈출/Noun,16,11,5,0.00012226841251139318,5.5534575826909837e-05,0.6875
7861,닐/Noun,16,10,6,0.00011115310228308472,6.66414909922918e-05,0.625
7862,여느/Noun,16,10,6,0.00011115310228308472,6.66414909922918e-05,0.625
7863,깨우치다/Verb,16,10,6,0.00011115310228308472,6.66414909922918e-05,0.625
7864,밭/Noun,16,10,6,0.00011115310228308472,6.66414909922918e-05,0.625
7865,안전/Noun,16,6,10,6.669186136985083e-05,0.00011106915165381967,0.625
7866,라디오스타/Noun,16,6,10,6.669186136985083e-05,0.00011106915165381967,0.625
7867,억/Suffix,16,10,6,0.00011115310228308472,6.66414909922918e-05,0.625
7868,정무문/Noun,16,10,6,0.00011115310228308472,6.66414909922918e-05,0.625
7869,오시/Noun,16,6,10,6.669186136985083e-05,0.00011106915165381967,0.625
7870,였음/Eomi,16,6,10,6.669186136985083e-05,0.00011106915165381967,0.625
7871,차용/Noun,16,6,10,6.669186136985083e-05,0.00011106915165381967,0.625
7872,라디오/Noun,16,10,6,0.00011115310228308472,6.66414909922918e-05,0.625
7873,내포/Noun,16,10,6,0.00011115310228308472,6.66414909922918e-05,0.625
7874,병들다/Verb,16,6,10,6.669186136985083e-05,0.00011106915165381967,0.625
7875,마법사/Noun,16,10,6,0.00011115310228308472,6.66414909922918e-05,0.625
7876,소지/Noun,16,6,10,6.669186136985083e-05,0.00011106915165381967,0.625
7877,포켓몬스터/Noun,16,10,6,0.00011115310228308472,6.66414909922918e-05,0.625
7878,어르신/Noun,16,10,6,0.00011115310228308472,6.66414909922918e-05,0.625
7879,가방/Noun,16,6,10,6.669186136985083e-05,0.00011106915165381967,0.625
7880,미사/Noun,16,10,6,0.00011115310228308472,6.66414909922918e-05,0.625
7881,샤론/Noun,16,6,10,6.669186136985083e-05,0.00011106915165381967,0.625
7882,메이킹/Noun,16,6,10,6.669186136985083e-05,0.00011106915165381967,0.625
7883,복습/Noun,16,10,6,0.00011115310228308472,6.66414909922918e-05,0.625
7884,죄인/Noun,16,6,10,6.669186136985083e-05,0.00011106915165381967,0.625
7885,점줄/Noun,16,6,10,6.669186136985083e-05,0.00011106915165381967,0.625
7886,소심하다/Adjective,16,6,10,6.669186136985083e-05,0.00011106915165381967,0.625
7887,v/Alpha,16,6,10,6.669186136985083e-05,0.00011106915165381967,0.625
7888,뮬란/Noun,16,10,6,0.00011115310228308472,6.66414909922918e-05,0.625
7889,찍어내다/Verb,16,6,10,6.669186136985083e-05,0.00011106915165381967,0.625
7890,저스틴/Noun,16,6,10,6.669186136985083e-05,0.00011106915165381967,0.625
7891,요시/Noun,16,6,10,6.669186136985083e-05,0.00011106915165381967,0.625
7892,도리/Noun,16,10,6,0.00011115310228308472,6.66414909922918e-05,0.625
7893,각종/Noun,16,10,6,0.00011115310228308472,6.66414909922918e-05,0.625
7894,도달/Noun,16,6,10,6.669186136985083e-05,0.00011106915165381967,0.625
7895,거꾸로/Noun,16,6,10,6.669186136985083e-05,0.00011106915165381967,0.625
7896,슬/Noun,16,10,6,0.00011115310228308472,6.66414909922918e-05,0.625
7897,알라/Noun,16,10,6,0.00011115310228308472,6.66414909922918e-05,0.625
7898,라던가/Josa,16,6,10,6.669186136985083e-05,0.00011106915165381967,0.625
7899,폭스/Noun,16,10,6,0.00011115310228308472,6.66414909922918e-05,0.625
7900,사탄/Noun,16,6,10,6.669186136985083e-05,0.00011106915165381967,0.625
7901,약해지다/Verb,16,6,10,6.669186136985083e-05,0.00011106915165381967,0.625
7902,저걸/Noun,16,6,10,6.669186136985083e-05,0.00011106915165381967,0.625
7903,엘/Josa,16,10,6,0.00011115310228308472,6.66414909922918e-05,0.625
7904,자임/Noun,16,6,10,6.669186136985083e-05,0.00011106915165381967,0.625
7905,앨런/Noun,16,10,6,0.00011115310228308472,6.66414909922918e-05,0.625
7906,랫/Noun,16,6,10,6.669186136985083e-05,0.00011106915165381967,0.625
7907,딸도/Noun,16,6,10,6.669186136985083e-05,0.00011106915165381967,0.625
7908,외도/Noun,16,6,10,6.669186136985083e-05,0.00011106915165381967,0.625
7909,후련하다/Adjective,16,10,6,0.00011115310228308472,6.66414909922918e-05,0.625
7910,출생/Noun,16,6,10,6.669186136985083e-05,0.00011106915165381967,0.625
7911,차고/Noun,16,6,10,6.669186136985083e-05,0.00011106915165381967,0.625
7912,ㅛ/KoreanParticle,16,9,7,0.00010003779205477625,7.774840615767377e-05,0.5625
7913,김우빈/Noun,16,9,7,0.00010003779205477625,7.774840615767377e-05,0.5625
7914,꼬리/Noun,16,9,7,0.00010003779205477625,7.774840615767377e-05,0.5625
7915,송일국/Noun,16,9,7,0.00010003779205477625,7.774840615767377e-05,0.5625
7916,샤/Noun,16,7,9,7.78071715981593e-05,9.99622364884377e-05,0.5625
7917,취/Noun,16,7,9,7.78071715981593e-05,9.99622364884377e-05,0.5625
7918,증언/Noun,16,7,9,7.78071715981593e-05,9.99622364884377e-05,0.5625
7919,안구/Noun,16,9,7,0.00010003779205477625,7.774840615767377e-05,0.5625
7920,엘리베이터/Noun,16,9,7,0.00010003779205477625,7.774840615767377e-05,0.5625
7921,설날/Noun,16,9,7,0.00010003779205477625,7.774840615767377e-05,0.5625
7922,부치다/Verb,16,7,9,7.78071715981593e-05,9.99622364884377e-05,0.5625
7923,하느님/Noun,16,9,7,0.00010003779205477625,7.774840615767377e-05,0.5625
7924,청순하다/Adjective,16,9,7,0.00010003779205477625,7.774840615767377e-05,0.5625
7925,소위/Noun,16,9,7,0.00010003779205477625,7.774840615767377e-05,0.5625
7926,트렌드/Noun,16,7,9,7.78071715981593e-05,9.99622364884377e-05,0.5625
7927,실질/Noun,16,9,7,0.00010003779205477625,7.774840615767377e-05,0.5625
7928,기교/Noun,16,7,9,7.78071715981593e-05,9.99622364884377e-05,0.5625
7929,결심/Noun,16,7,9,7.78071715981593e-05,9.99622364884377e-05,0.5625
7930,무언/Noun,16,7,9,7.78071715981593e-05,9.99622364884377e-05,0.5625
7931,96년/Number,16,7,9,7.78071715981593e-05,9.99622364884377e-05,0.5625
7932,모래/Noun,16,7,9,7.78071715981593e-05,9.99622364884377e-05,0.5625
7933,초창/Noun,16,9,7,0.00010003779205477625,7.774840615767377e-05,0.5625
7934,용면/Noun,16,7,9,7.78071715981593e-05,9.99622364884377e-05,0.5625
7935,들어맞다/Verb,16,7,9,7.78071715981593e-05,9.99622364884377e-05,0.5625
7936,태희/Noun,16,9,7,0.00010003779205477625,7.774840615767377e-05,0.5625
7937,P/Alpha,16,9,7,0.00010003779205477625,7.774840615767377e-05,0.5625
7938,강철/Noun,16,9,7,0.00010003779205477625,7.774840615767377e-05,0.5625
7939,생물/Noun,16,7,9,7.78071715981593e-05,9.99622364884377e-05,0.5625
7940,후손/Noun,16,7,9,7.78071715981593e-05,9.99622364884377e-05,0.5625
7941,마키/Noun,16,7,9,7.78071715981593e-05,9.99622364884377e-05,0.5625
7942,닌/Noun,16,7,9,7.78071715981593e-05,9.99622364884377e-05,0.5625
7943,2만/Number,16,9,7,0.00010003779205477625,7.774840615767377e-05,0.5625
7944,은하/Noun,16,9,7,0.00010003779205477625,7.774840615767377e-05,0.5625
7945,선보이다/Verb,16,7,9,7.78071715981593e-05,9.99622364884377e-05,0.5625
7946,악한/Noun,16,9,7,0.00010003779205477625,7.774840615767377e-05,0.5625
7947,갠차다/Adjective,16,7,9,7.78071715981593e-05,9.99622364884377e-05,0.5625
7948,강용석/Noun,16,7,9,7.78071715981593e-05,9.99622364884377e-05,0.5625
7949,아메리카/Noun,16,7,9,7.78071715981593e-05,9.99622364884377e-05,0.5625
7950,생산/Noun,16,7,9,7.78071715981593e-05,9.99622364884377e-05,0.5625
7951,절친/Noun,16,7,9,7.78071715981593e-05,9.99622364884377e-05,0.5625
7952,다투다/Verb,16,9,7,0.00010003779205477625,7.774840615767377e-05,0.5625
7953,어쩌나/Adverb,16,9,7,0.00010003779205477625,7.774840615767377e-05,0.5625
7954,태극기/Noun,16,7,9,7.78071715981593e-05,9.99622364884377e-05,0.5625
7955,니모/Noun,16,7,9,7.78071715981593e-05,9.99622364884377e-05,0.5625
7956,정복/Noun,16,9,7,0.00010003779205477625,7.774840615767377e-05,0.5625
7957,써니/Noun,16,7,9,7.78071715981593e-05,9.99622364884377e-05,0.5625
7958,앤더슨/Noun,16,9,7,0.00010003779205477625,7.774840615767377e-05,0.5625
7959,태민/Noun,16,7,9,7.78071715981593e-05,9.99622364884377e-05,0.5625
7960,공정하다/Adjective,16,7,9,7.78071715981593e-05,9.99622364884377e-05,0.5625
7961,ㅔ/KoreanParticle,16,9,7,0.00010003779205477625,7.774840615767377e-05,0.5625
7962,오픈/Noun,16,8,8,8.892248182646778e-05,8.885532132305573e-05,0.5
7963,문성근/Noun,16,8,8,8.892248182646778e-05,8.885532132305573e-05,0.5
7964,5월/Number,16,8,8,8.892248182646778e-05,8.885532132305573e-05,0.5
7965,노트북/Noun,16,8,8,8.892248182646778e-05,8.885532132305573e-05,0.5
7966,1999년/Number,16,8,8,8.892248182646778e-05,8.885532132305573e-05,0.5
7967,산이/Noun,16,8,8,8.892248182646778e-05,8.885532132305573e-05,0.5
7968,수사물/Noun,16,8,8,8.892248182646778e-05,8.885532132305573e-05,0.5
7969,신자/Noun,16,8,8,8.892248182646778e-05,8.885532132305573e-05,0.5
7970,백설공주/Noun,16,8,8,8.892248182646778e-05,8.885532132305573e-05,0.5
7971,첫날/Noun,16,8,8,8.892248182646778e-05,8.885532132305573e-05,0.5
7972,.)/Punctuation,16,8,8,8.892248182646778e-05,8.885532132305573e-05,0.5
7973,들/Noun,16,8,8,8.892248182646778e-05,8.885532132305573e-05,0.5
7974,번의/Noun,16,8,8,8.892248182646778e-05,8.885532132305573e-05,0.5
7975,6.25/Number,16,8,8,8.892248182646778e-05,8.885532132305573e-05,0.5
7976,쪼금/Noun,16,8,8,8.892248182646778e-05,8.885532132305573e-05,0.5
7977,오오/Noun,16,8,8,8.892248182646778e-05,8.885532132305573e-05,0.5
7978,검색어/Noun,16,8,8,8.892248182646778e-05,8.885532132305573e-05,0.5
7979,출시/Noun,16,8,8,8.892248182646778e-05,8.885532132305573e-05,0.5
7980,성시경/Noun,16,8,8,8.892248182646778e-05,8.885532132305573e-05,0.5
7981,그간/Noun,16,8,8,8.892248182646778e-05,8.885532132305573e-05,0.5
7982,공장/Noun,16,8,8,8.892248182646778e-05,8.885532132305573e-05,0.5
7983,제이콥/Noun,16,8,8,8.892248182646778e-05,8.885532132305573e-05,0.5
7984,바위/Noun,16,8,8,8.892248182646778e-05,8.885532132305573e-05,0.5
7985,다임/Noun,15,0,15,0.0,0.0001666037274807295,1.0
7986,감회/Noun,15,15,0,0.00016672965342462708,0.0,1.0
7987,리좀/Noun,15,0,15,0.0,0.0001666037274807295,1.0
7988,이상자/Noun,15,0,15,0.0,0.0001666037274807295,1.0
7989,이수정/Noun,15,0,15,0.0,0.0001666037274807295,1.0
7990,어루만지다/Verb,15,15,0,0.00016672965342462708,0.0,1.0
7991,보다가/Foreign,15,0,15,0.0,0.0001666037274807295,1.0
7992,왕정/Noun,15,0,15,0.0,0.0001666037274807295,1.0
7993,폭풍눈물/Noun,15,15,0,0.00016672965342462708,0.0,1.0
7994,착오/Noun,15,0,15,0.0,0.0001666037274807295,1.0
7995,밋/Noun,15,15,0,0.00016672965342462708,0.0,1.0
7996,대자연/Noun,15,15,0,0.00016672965342462708,0.0,1.0
7997,중국산/Noun,15,0,15,0.0,0.0001666037274807295,1.0
7998,잼슴/Noun,15,14,1,0.0001556143431963186,1.1106915165381966e-05,0.9333333333333333
7999,설마설마/Adverb,15,1,14,1.1115310228308472e-05,0.00015549681231534753,0.9333333333333333
8000,핫세/Noun,15,14,1,0.0001556143431963186,1.1106915165381966e-05,0.9333333333333333
8001,넣기/Noun,15,1,14,1.1115310228308472e-05,0.00015549681231534753,0.9333333333333333
8002,음미/Noun,15,14,1,0.0001556143431963186,1.1106915165381966e-05,0.9333333333333333
8003,boring/Alpha,15,1,14,1.1115310228308472e-05,0.00015549681231534753,0.9333333333333333
8004,아포칼립토/Noun,15,1,14,1.1115310228308472e-05,0.00015549681231534753,0.9333333333333333
8005,잘봣어/Noun,15,14,1,0.0001556143431963186,1.1106915165381966e-05,0.9333333333333333
8006,신소율/Noun,15,1,14,1.1115310228308472e-05,0.00015549681231534753,0.9333333333333333
8007,더티/Noun,15,1,14,1.1115310228308472e-05,0.00015549681231534753,0.9333333333333333
8008,무능력하다/Adjective,15,1,14,1.1115310228308472e-05,0.00015549681231534753,0.9333333333333333
8009,대소/Noun,15,14,1,0.0001556143431963186,1.1106915165381966e-05,0.9333333333333333
8010,성관계/Noun,15,1,14,1.1115310228308472e-05,0.00015549681231534753,0.9333333333333333
8011,핥다/Verb,15,1,14,1.1115310228308472e-05,0.00015549681231534753,0.9333333333333333
8012,보듬다/Verb,15,14,1,0.0001556143431963186,1.1106915165381966e-05,0.9333333333333333
8013,Best/Alpha,15,14,1,0.0001556143431963186,1.1106915165381966e-05,0.9333333333333333
8014,반했어/Noun,15,14,1,0.0001556143431963186,1.1106915165381966e-05,0.9333333333333333
8015,호모/Noun,15,1,14,1.1115310228308472e-05,0.00015549681231534753,0.9333333333333333
8016,로치/Noun,15,14,1,0.0001556143431963186,1.1106915165381966e-05,0.9333333333333333
8017,아른거리다/Verb,15,14,1,0.0001556143431963186,1.1106915165381966e-05,0.9333333333333333
8018,리슨/Noun,15,13,2,0.00014449903296801013,2.2213830330763933e-05,0.8666666666666667
8019,참되다/Adjective,15,13,2,0.00014449903296801013,2.2213830330763933e-05,0.8666666666666667
8020,아청법/Noun,15,2,13,2.2230620456616944e-05,0.00014438989714996557,0.8666666666666667
8021,편승/Noun,15,2,13,2.2230620456616944e-05,0.00014438989714996557,0.8666666666666667
8022,도현/Noun,15,2,13,2.2230620456616944e-05,0.00014438989714996557,0.8666666666666667
8023,버겁다/Adjective,15,2,13,2.2230620456616944e-05,0.00014438989714996557,0.8666666666666667
8024,잡다하다/Adjective,15,2,13,2.2230620456616944e-05,0.00014438989714996557,0.8666666666666667
8025,귀여니/Noun,15,2,13,2.2230620456616944e-05,0.00014438989714996557,0.8666666666666667
8026,오지랖/Noun,15,2,13,2.2230620456616944e-05,0.00014438989714996557,0.8666666666666667
8027,노년/Noun,15,13,2,0.00014449903296801013,2.2213830330763933e-05,0.8666666666666667
8028,헬/Noun,15,2,13,2.2230620456616944e-05,0.00014438989714996557,0.8666666666666667
8029,조사/Noun,15,2,13,2.2230620456616944e-05,0.00014438989714996557,0.8666666666666667
8030,나니아/Noun,15,13,2,0.00014449903296801013,2.2213830330763933e-05,0.8666666666666667
8031,위력/Noun,15,13,2,0.00014449903296801013,2.2213830330763933e-05,0.8666666666666667
8032,우어/Noun,15,13,2,0.00014449903296801013,2.2213830330763933e-05,0.8666666666666667
8033,쒯/Noun,15,2,13,2.2230620456616944e-05,0.00014438989714996557,0.8666666666666667
8034,투영/Noun,15,13,2,0.00014449903296801013,2.2213830330763933e-05,0.8666666666666667
8035,임상수/Noun,15,2,13,2.2230620456616944e-05,0.00014438989714996557,0.8666666666666667
8036,워스트/Noun,15,2,13,2.2230620456616944e-05,0.00014438989714996557,0.8666666666666667
8037,히로/Noun,15,13,2,0.00014449903296801013,2.2213830330763933e-05,0.8666666666666667
8038,박아/Noun,15,2,13,2.2230620456616944e-05,0.00014438989714996557,0.8666666666666667
8039,도신/Noun,15,2,13,2.2230620456616944e-05,0.00014438989714996557,0.8666666666666667
8040,사족/Noun,15,2,13,2.2230620456616944e-05,0.00014438989714996557,0.8666666666666667
8041,챔피언/Noun,15,13,2,0.00014449903296801013,2.2213830330763933e-05,0.8666666666666667
8042,무차별/Noun,15,2,13,2.2230620456616944e-05,0.00014438989714996557,0.8666666666666667
8043,;;;;;/Punctuation,15,2,13,2.2230620456616944e-05,0.00014438989714996557,0.8666666666666667
8044,발매/Noun,15,13,2,0.00014449903296801013,2.2213830330763933e-05,0.8666666666666667
8045,독수리/Noun,15,2,13,2.2230620456616944e-05,0.00014438989714996557,0.8666666666666667
8046,무관/Noun,15,2,13,2.2230620456616944e-05,0.00014438989714996557,0.8666666666666667
8047,연예계/Noun,15,2,13,2.2230620456616944e-05,0.00014438989714996557,0.8666666666666667
8048,소망/Noun,15,13,2,0.00014449903296801013,2.2213830330763933e-05,0.8666666666666667
8049,차예련/Noun,15,2,13,2.2230620456616944e-05,0.00014438989714996557,0.8666666666666667
8050,안무/Noun,15,2,13,2.2230620456616944e-05,0.00014438989714996557,0.8666666666666667
8051,장학우/Noun,15,12,3,0.00013338372273970166,3.33207454961459e-05,0.8
8052,분만/Noun,15,3,12,3.3345930684925414e-05,0.0001332829819845836,0.8
8053,누드/Noun,15,3,12,3.3345930684925414e-05,0.0001332829819845836,0.8
8054,다지/Noun,15,3,12,3.3345930684925414e-05,0.0001332829819845836,0.8
8055,자칭/Noun,15,3,12,3.3345930684925414e-05,0.0001332829819845836,0.8
8056,R/Alpha,15,12,3,0.00013338372273970166,3.33207454961459e-05,0.8
8057,능력자/Noun,15,3,12,3.3345930684925414e-05,0.0001332829819845836,0.8
8058,꿀잼임/Noun,15,12,3,0.00013338372273970166,3.33207454961459e-05,0.8
8059,잠기다/Verb,15,12,3,0.00013338372273970166,3.33207454961459e-05,0.8
8060,인양/Noun,15,3,12,3.3345930684925414e-05,0.0001332829819845836,0.8
8061,지수/Noun,15,3,12,3.3345930684925414e-05,0.0001332829819845836,0.8
8062,눈가/Noun,15,12,3,0.00013338372273970166,3.33207454961459e-05,0.8
8063,카펜터/Noun,15,3,12,3.3345930684925414e-05,0.0001332829819845836,0.8
8064,오버액션/Noun,15,3,12,3.3345930684925414e-05,0.0001332829819845836,0.8
8065,가려진/Noun,15,12,3,0.00013338372273970166,3.33207454961459e-05,0.8
8066,that/Alpha,15,12,3,0.00013338372273970166,3.33207454961459e-05,0.8
8067,맴돈다/Verb,15,12,3,0.00013338372273970166,3.33207454961459e-05,0.8
8068,노부/Noun,15,12,3,0.00013338372273970166,3.33207454961459e-05,0.8
8069,정준하/Noun,15,3,12,3.3345930684925414e-05,0.0001332829819845836,0.8
8070,사치/Noun,15,3,12,3.3345930684925414e-05,0.0001332829819845836,0.8
8071,갈구다/Verb,15,12,3,0.00013338372273970166,3.33207454961459e-05,0.8
8072,폭행/Noun,15,3,12,3.3345930684925414e-05,0.0001332829819845836,0.8
8073,선명하다/Adjective,15,12,3,0.00013338372273970166,3.33207454961459e-05,0.8
8074,황진이/Noun,15,12,3,0.00013338372273970166,3.33207454961459e-05,0.8
8075,장하다/Adjective,15,3,12,3.3345930684925414e-05,0.0001332829819845836,0.8
8076,티켓/Noun,15,3,12,3.3345930684925414e-05,0.0001332829819845836,0.8
8077,장님/Noun,15,12,3,0.00013338372273970166,3.33207454961459e-05,0.8
8078,세밀/Noun,15,12,3,0.00013338372273970166,3.33207454961459e-05,0.8
8079,각본가/Noun,15,3,12,3.3345930684925414e-05,0.0001332829819845836,0.8
8080,뿅/Adverb,15,12,3,0.00013338372273970166,3.33207454961459e-05,0.8
8081,깊숙하다/Adjective,15,12,3,0.00013338372273970166,3.33207454961459e-05,0.8
8082,버릇/Noun,15,4,11,4.446124091323389e-05,0.00012217606681920164,0.7333333333333333
8083,혼신/Noun,15,11,4,0.00012226841251139318,4.4427660661527865e-05,0.7333333333333333
8084,토리/Noun,15,4,11,4.446124091323389e-05,0.00012217606681920164,0.7333333333333333
8085,웅/Noun,15,11,4,0.00012226841251139318,4.4427660661527865e-05,0.7333333333333333
8086,로멘틱/Noun,15,11,4,0.00012226841251139318,4.4427660661527865e-05,0.7333333333333333
8087,격정/Noun,15,11,4,0.00012226841251139318,4.4427660661527865e-05,0.7333333333333333
8088,커다랗다/Adjective,15,11,4,0.00012226841251139318,4.4427660661527865e-05,0.7333333333333333
8089,불문/Noun,15,4,11,4.446124091323389e-05,0.00012217606681920164,0.7333333333333333
8090,료/Noun,15,4,11,4.446124091323389e-05,0.00012217606681920164,0.7333333333333333
8091,가발/Noun,15,4,11,4.446124091323389e-05,0.00012217606681920164,0.7333333333333333
8092,걸어가다/Verb,15,11,4,0.00012226841251139318,4.4427660661527865e-05,0.7333333333333333
8093,고조/Noun,15,11,4,0.00012226841251139318,4.4427660661527865e-05,0.7333333333333333
8094,단언컨대/Noun,15,11,4,0.00012226841251139318,4.4427660661527865e-05,0.7333333333333333
8095,바람직하다/Adjective,15,11,4,0.00012226841251139318,4.4427660661527865e-05,0.7333333333333333
8096,꿈속/Noun,15,11,4,0.00012226841251139318,4.4427660661527865e-05,0.7333333333333333
8097,매달리다/Verb,15,4,11,4.446124091323389e-05,0.00012217606681920164,0.7333333333333333
8098,모음/Noun,15,4,11,4.446124091323389e-05,0.00012217606681920164,0.7333333333333333
8099,88년/Number,15,11,4,0.00012226841251139318,4.4427660661527865e-05,0.7333333333333333
8100,발끝/Noun,15,4,11,4.446124091323389e-05,0.00012217606681920164,0.7333333333333333
8101,데스티네이션/Noun,15,4,11,4.446124091323389e-05,0.00012217606681920164,0.7333333333333333
8102,편협/Noun,15,4,11,4.446124091323389e-05,0.00012217606681920164,0.7333333333333333
8103,이하나/Noun,15,11,4,0.00012226841251139318,4.4427660661527865e-05,0.7333333333333333
8104,우애/Noun,15,11,4,0.00012226841251139318,4.4427660661527865e-05,0.7333333333333333
8105,썰전/Noun,15,4,11,4.446124091323389e-05,0.00012217606681920164,0.7333333333333333
8106,비스트/Noun,15,11,4,0.00012226841251139318,4.4427660661527865e-05,0.7333333333333333
8107,are/Alpha,15,11,4,0.00012226841251139318,4.4427660661527865e-05,0.7333333333333333
8108,멘타리/Noun,15,4,11,4.446124091323389e-05,0.00012217606681920164,0.7333333333333333
8109,깨달/Noun,15,11,4,0.00012226841251139318,4.4427660661527865e-05,0.7333333333333333
8110,쓸모없다/Adjective,15,4,11,4.446124091323389e-05,0.00012217606681920164,0.7333333333333333
8111,루나/Noun,15,4,11,4.446124091323389e-05,0.00012217606681920164,0.7333333333333333
8112,체감/Noun,15,11,4,0.00012226841251139318,4.4427660661527865e-05,0.7333333333333333
8113,생명력/Noun,15,11,4,0.00012226841251139318,4.4427660661527865e-05,0.7333333333333333
8114,|/Punctuation,15,4,11,4.446124091323389e-05,0.00012217606681920164,0.7333333333333333
8115,켜/Noun,15,4,11,4.446124091323389e-05,0.00012217606681920164,0.7333333333333333
8116,갈아/Adverb,15,4,11,4.446124091323389e-05,0.00012217606681920164,0.7333333333333333
8117,뇨/Noun,15,4,11,4.446124091323389e-05,0.00012217606681920164,0.7333333333333333
8118,샤이니/Noun,15,11,4,0.00012226841251139318,4.4427660661527865e-05,0.7333333333333333
8119,....;;;/Punctuation,15,4,11,4.446124091323389e-05,0.00012217606681920164,0.7333333333333333
8120,부처/Noun,15,4,11,4.446124091323389e-05,0.00012217606681920164,0.7333333333333333
8121,유전자/Noun,15,4,11,4.446124091323389e-05,0.00012217606681920164,0.7333333333333333
8122,이기주의/Noun,15,4,11,4.446124091323389e-05,0.00012217606681920164,0.7333333333333333
8123,를/Foreign,15,11,4,0.00012226841251139318,4.4427660661527865e-05,0.7333333333333333
8124,포맷/Noun,15,4,11,4.446124091323389e-05,0.00012217606681920164,0.7333333333333333
8125,3시/Number,15,11,4,0.00012226841251139318,4.4427660661527865e-05,0.7333333333333333
8126,간결하다/Adjective,15,11,4,0.00012226841251139318,4.4427660661527865e-05,0.7333333333333333
8127,해체/Noun,15,4,11,4.446124091323389e-05,0.00012217606681920164,0.7333333333333333
8128,모녀/Noun,15,5,10,5.557655114154236e-05,0.00011106915165381967,0.6666666666666666
8129,책보/Noun,15,10,5,0.00011115310228308472,5.5534575826909837e-05,0.6666666666666666
8130,소림사/Noun,15,5,10,5.557655114154236e-05,0.00011106915165381967,0.6666666666666666
8131,미스터빈/Noun,15,10,5,0.00011115310228308472,5.5534575826909837e-05,0.6666666666666666
8132,팝/Noun,15,5,10,5.557655114154236e-05,0.00011106915165381967,0.6666666666666666
8133,출근/Noun,15,10,5,0.00011115310228308472,5.5534575826909837e-05,0.6666666666666666
8134,독특/Noun,15,10,5,0.00011115310228308472,5.5534575826909837e-05,0.6666666666666666
8135,스턴트맨/Noun,15,5,10,5.557655114154236e-05,0.00011106915165381967,0.6666666666666666
8136,갈기/Noun,15,5,10,5.557655114154236e-05,0.00011106915165381967,0.6666666666666666
8137,분야/Noun,15,5,10,5.557655114154236e-05,0.00011106915165381967,0.6666666666666666
8138,아야세/Noun,15,10,5,0.00011115310228308472,5.5534575826909837e-05,0.6666666666666666
8139,프로도/Noun,15,5,10,5.557655114154236e-05,0.00011106915165381967,0.6666666666666666
8140,타임슬립/Noun,15,5,10,5.557655114154236e-05,0.00011106915165381967,0.6666666666666666
8141,은주/Noun,15,10,5,0.00011115310228308472,5.5534575826909837e-05,0.6666666666666666
8142,세운/Noun,15,5,10,5.557655114154236e-05,0.00011106915165381967,0.6666666666666666
8143,일상생활/Noun,15,10,5,0.00011115310228308472,5.5534575826909837e-05,0.6666666666666666
8144,29/Number,15,5,10,5.557655114154236e-05,0.00011106915165381967,0.6666666666666666
8145,박상민/Noun,15,5,10,5.557655114154236e-05,0.00011106915165381967,0.6666666666666666
8146,무참/Noun,15,5,10,5.557655114154236e-05,0.00011106915165381967,0.6666666666666666
8147,상류층/Noun,15,5,10,5.557655114154236e-05,0.00011106915165381967,0.6666666666666666
8148,투니버스/Noun,15,5,10,5.557655114154236e-05,0.00011106915165381967,0.6666666666666666
8149,심은경/Noun,15,10,5,0.00011115310228308472,5.5534575826909837e-05,0.6666666666666666
8150,천하다/Adjective,15,5,10,5.557655114154236e-05,0.00011106915165381967,0.6666666666666666
8151,시오/Noun,15,10,5,0.00011115310228308472,5.5534575826909837e-05,0.6666666666666666
8152,동일/Noun,15,5,10,5.557655114154236e-05,0.00011106915165381967,0.6666666666666666
8153,슬랩/Noun,15,5,10,5.557655114154236e-05,0.00011106915165381967,0.6666666666666666
8154,손님/Noun,15,5,10,5.557655114154236e-05,0.00011106915165381967,0.6666666666666666
8155,니야/Noun,15,5,10,5.557655114154236e-05,0.00011106915165381967,0.6666666666666666
8156,설치/Noun,15,5,10,5.557655114154236e-05,0.00011106915165381967,0.6666666666666666
8157,고든/Noun,15,10,5,0.00011115310228308472,5.5534575826909837e-05,0.6666666666666666
8158,뚫리다/Verb,15,5,10,5.557655114154236e-05,0.00011106915165381967,0.6666666666666666
8159,철철/Noun,15,10,5,0.00011115310228308472,5.5534575826909837e-05,0.6666666666666666
8160,고리/Noun,15,10,5,0.00011115310228308472,5.5534575826909837e-05,0.6666666666666666
8161,93년/Number,15,10,5,0.00011115310228308472,5.5534575826909837e-05,0.6666666666666666
8162,잘해야/Noun,15,10,5,0.00011115310228308472,5.5534575826909837e-05,0.6666666666666666
8163,ㅕ/KoreanParticle,15,5,10,5.557655114154236e-05,0.00011106915165381967,0.6666666666666666
8164,로랑/Noun,15,10,5,0.00011115310228308472,5.5534575826909837e-05,0.6666666666666666
8165,캐리비안/Noun,15,10,5,0.00011115310228308472,5.5534575826909837e-05,0.6666666666666666
8166,모토/Noun,15,10,5,0.00011115310228308472,5.5534575826909837e-05,0.6666666666666666
8167,돌파/Noun,15,10,5,0.00011115310228308472,5.5534575826909837e-05,0.6666666666666666
8168,거미/Noun,15,5,10,5.557655114154236e-05,0.00011106915165381967,0.6666666666666666
8169,명치/Noun,15,5,10,5.557655114154236e-05,0.00011106915165381967,0.6666666666666666
8170,진중하다/Adjective,15,10,5,0.00011115310228308472,5.5534575826909837e-05,0.6666666666666666
8171,89년/Number,15,10,5,0.00011115310228308472,5.5534575826909837e-05,0.6666666666666666
8172,매국노/Noun,15,5,10,5.557655114154236e-05,0.00011106915165381967,0.6666666666666666
8173,컨텐츠/Noun,15,5,10,5.557655114154236e-05,0.00011106915165381967,0.6666666666666666
8174,시나/Noun,15,5,10,5.557655114154236e-05,0.00011106915165381967,0.6666666666666666
8175,비열하다/Adjective,15,10,5,0.00011115310228308472,5.5534575826909837e-05,0.6666666666666666
8176,what/Alpha,15,5,10,5.557655114154236e-05,0.00011106915165381967,0.6666666666666666
8177,거두다/Verb,15,10,5,0.00011115310228308472,5.5534575826909837e-05,0.6666666666666666
8178,노리/Noun,15,5,10,5.557655114154236e-05,0.00011106915165381967,0.6666666666666666
8179,지아/Noun,15,6,9,6.669186136985083e-05,9.99622364884377e-05,0.6
8180,멍하니/Noun,15,6,9,6.669186136985083e-05,9.99622364884377e-05,0.6
8181,말론/Noun,15,9,6,0.00010003779205477625,6.66414909922918e-05,0.6
8182,베이비/Noun,15,6,9,6.669186136985083e-05,9.99622364884377e-05,0.6
8183,군요/Eomi,15,9,6,0.00010003779205477625,6.66414909922918e-05,0.6
8184,...'/Punctuation,15,6,9,6.669186136985083e-05,9.99622364884377e-05,0.6
8185,놈놈놈/Noun,15,6,9,6.669186136985083e-05,9.99622364884377e-05,0.6
8186,쓸리다/Verb,15,6,9,6.669186136985083e-05,9.99622364884377e-05,0.6
8187,서리/Noun,15,9,6,0.00010003779205477625,6.66414909922918e-05,0.6
8188,어드벤처/Noun,15,9,6,0.00010003779205477625,6.66414909922918e-05,0.6
8189,충성/Noun,15,9,6,0.00010003779205477625,6.66414909922918e-05,0.6
8190,맹목/Noun,15,9,6,0.00010003779205477625,6.66414909922918e-05,0.6
8191,루카스/Noun,15,6,9,6.669186136985083e-05,9.99622364884377e-05,0.6
8192,어도/Noun,15,9,6,0.00010003779205477625,6.66414909922918e-05,0.6
8193,기울이다/Verb,15,9,6,0.00010003779205477625,6.66414909922918e-05,0.6
8194,코끼리/Noun,15,6,9,6.669186136985083e-05,9.99622364884377e-05,0.6
8195,여성부/Noun,15,6,9,6.669186136985083e-05,9.99622364884377e-05,0.6
8196,제보/Noun,15,9,6,0.00010003779205477625,6.66414909922918e-05,0.6
8197,포로/Noun,15,6,9,6.669186136985083e-05,9.99622364884377e-05,0.6
8198,믹스/Noun,15,9,6,0.00010003779205477625,6.66414909922918e-05,0.6
8199,복고/Noun,15,6,9,6.669186136985083e-05,9.99622364884377e-05,0.6
8200,우에노/Noun,15,6,9,6.669186136985083e-05,9.99622364884377e-05,0.6
8201,우울함/Noun,15,6,9,6.669186136985083e-05,9.99622364884377e-05,0.6
8202,맴돌다/Verb,15,9,6,0.00010003779205477625,6.66414909922918e-05,0.6
8203,화법/Noun,15,6,9,6.669186136985083e-05,9.99622364884377e-05,0.6
8204,국가대표/Noun,15,6,9,6.669186136985083e-05,9.99622364884377e-05,0.6
8205,ㅑ/KoreanParticle,15,9,6,0.00010003779205477625,6.66414909922918e-05,0.6
8206,권위/Noun,15,9,6,0.00010003779205477625,6.66414909922918e-05,0.6
8207,트럭/Noun,15,6,9,6.669186136985083e-05,9.99622364884377e-05,0.6
8208,♬/Foreign,15,9,6,0.00010003779205477625,6.66414909922918e-05,0.6
8209,로티/Noun,15,9,6,0.00010003779205477625,6.66414909922918e-05,0.6
8210,빌어먹을/Noun,15,6,9,6.669186136985083e-05,9.99622364884377e-05,0.6
8211,소림축구/Noun,15,6,9,6.669186136985083e-05,9.99622364884377e-05,0.6
8212,무사/Noun,15,9,6,0.00010003779205477625,6.66414909922918e-05,0.6
8213,보도/Noun,15,9,6,0.00010003779205477625,6.66414909922918e-05,0.6
8214,자만/Noun,15,6,9,6.669186136985083e-05,9.99622364884377e-05,0.6
8215,키키/Noun,15,9,6,0.00010003779205477625,6.66414909922918e-05,0.6
8216,20%/Number,15,6,9,6.669186136985083e-05,9.99622364884377e-05,0.6
8217,무용/Noun,15,9,6,0.00010003779205477625,6.66414909922918e-05,0.6
8218,모임/Noun,15,6,9,6.669186136985083e-05,9.99622364884377e-05,0.6
8219,멜라/Noun,15,9,6,0.00010003779205477625,6.66414909922918e-05,0.6
8220,몹시/Noun,15,9,6,0.00010003779205477625,6.66414909922918e-05,0.6
8221,똑/Noun,15,9,6,0.00010003779205477625,6.66414909922918e-05,0.6
8222,몰이/Noun,15,6,9,6.669186136985083e-05,9.99622364884377e-05,0.6
8223,일본만화/Noun,15,9,6,0.00010003779205477625,6.66414909922918e-05,0.6
8224,레미제라블/Noun,15,9,6,0.00010003779205477625,6.66414909922918e-05,0.6
8225,백만/Noun,15,6,9,6.669186136985083e-05,9.99622364884377e-05,0.6
8226,라울/Noun,15,6,9,6.669186136985083e-05,9.99622364884377e-05,0.6
8227,삼키다/Verb,15,9,6,0.00010003779205477625,6.66414909922918e-05,0.6
8228,이유리/Noun,15,9,6,0.00010003779205477625,6.66414909922918e-05,0.6
8229,라운드/Noun,15,6,9,6.669186136985083e-05,9.99622364884377e-05,0.6
8230,로드리게즈/Noun,15,9,6,0.00010003779205477625,6.66414909922918e-05,0.6
8231,랜드/Noun,15,6,9,6.669186136985083e-05,9.99622364884377e-05,0.6
8232,금시/Noun,15,7,8,7.78071715981593e-05,8.885532132305573e-05,0.5333333333333333
8233,2시/Number,15,7,8,7.78071715981593e-05,8.885532132305573e-05,0.5333333333333333
8234,채시라/Noun,15,8,7,8.892248182646778e-05,7.774840615767377e-05,0.5333333333333333
8235,"..""/Punctuation",15,8,7,8.892248182646778e-05,7.774840615767377e-05,0.5333333333333333
8236,정신과/Noun,15,7,8,7.78071715981593e-05,8.885532132305573e-05,0.5333333333333333
8237,이루/Noun,15,7,8,7.78071715981593e-05,8.885532132305573e-05,0.5333333333333333
8238,껀데/Noun,15,7,8,7.78071715981593e-05,8.885532132305573e-05,0.5333333333333333
8239,time/Alpha,15,8,7,8.892248182646778e-05,7.774840615767377e-05,0.5333333333333333
8240,겐/Noun,15,7,8,7.78071715981593e-05,8.885532132305573e-05,0.5333333333333333
8241,화성/Noun,15,8,7,8.892248182646778e-05,7.774840615767377e-05,0.5333333333333333
8242,대여/Noun,15,8,7,8.892248182646778e-05,7.774840615767377e-05,0.5333333333333333
8243,H/Alpha,15,8,7,8.892248182646778e-05,7.774840615767377e-05,0.5333333333333333
8244,앨범/Noun,15,8,7,8.892248182646778e-05,7.774840615767377e-05,0.5333333333333333
8245,부딪히다/Verb,15,7,8,7.78071715981593e-05,8.885532132305573e-05,0.5333333333333333
8246,g/Alpha,15,7,8,7.78071715981593e-05,8.885532132305573e-05,0.5333333333333333
8247,꼬꼬/Noun,15,7,8,7.78071715981593e-05,8.885532132305573e-05,0.5333333333333333
8248,현명하다/Adjective,15,8,7,8.892248182646778e-05,7.774840615767377e-05,0.5333333333333333
8249,짜임/Noun,15,8,7,8.892248182646778e-05,7.774840615767377e-05,0.5333333333333333
8250,팔리다/Verb,15,7,8,7.78071715981593e-05,8.885532132305573e-05,0.5333333333333333
8251,로리/Noun,15,7,8,7.78071715981593e-05,8.885532132305573e-05,0.5333333333333333
8252,시놉시스/Noun,15,7,8,7.78071715981593e-05,8.885532132305573e-05,0.5333333333333333
8253,설다/Verb,15,8,7,8.892248182646778e-05,7.774840615767377e-05,0.5333333333333333
8254,동성/Noun,15,7,8,7.78071715981593e-05,8.885532132305573e-05,0.5333333333333333
8255,미덕/Noun,15,8,7,8.892248182646778e-05,7.774840615767377e-05,0.5333333333333333
8256,백윤식/Noun,15,7,8,7.78071715981593e-05,8.885532132305573e-05,0.5333333333333333
8257,파트/Noun,15,7,8,7.78071715981593e-05,8.885532132305573e-05,0.5333333333333333
8258,마징/Noun,15,8,7,8.892248182646778e-05,7.774840615767377e-05,0.5333333333333333
8259,기보/Noun,15,7,8,7.78071715981593e-05,8.885532132305573e-05,0.5333333333333333
8260,삼총사/Noun,15,8,7,8.892248182646778e-05,7.774840615767377e-05,0.5333333333333333
8261,분하다/Adjective,15,7,8,7.78071715981593e-05,8.885532132305573e-05,0.5333333333333333
8262,속물/Noun,15,8,7,8.892248182646778e-05,7.774840615767377e-05,0.5333333333333333
8263,8월/Number,15,8,7,8.892248182646778e-05,7.774840615767377e-05,0.5333333333333333
8264,아빠어디가/Noun,15,7,8,7.78071715981593e-05,8.885532132305573e-05,0.5333333333333333
8265,사하다/Verb,15,7,8,7.78071715981593e-05,8.885532132305573e-05,0.5333333333333333
8266,장교/Noun,15,7,8,7.78071715981593e-05,8.885532132305573e-05,0.5333333333333333
8267,퀴즈/Noun,15,8,7,8.892248182646778e-05,7.774840615767377e-05,0.5333333333333333
8268,But/Alpha,15,7,8,7.78071715981593e-05,8.885532132305573e-05,0.5333333333333333
8269,덩달아/Noun,15,7,8,7.78071715981593e-05,8.885532132305573e-05,0.5333333333333333
8270,권투/Noun,15,8,7,8.892248182646778e-05,7.774840615767377e-05,0.5333333333333333
8271,요한슨/Noun,15,7,8,7.78071715981593e-05,8.885532132305573e-05,0.5333333333333333
8272,널리/Noun,15,7,8,7.78071715981593e-05,8.885532132305573e-05,0.5333333333333333
8273,다카/Noun,15,7,8,7.78071715981593e-05,8.885532132305573e-05,0.5333333333333333
8274,클레/Noun,15,8,7,8.892248182646778e-05,7.774840615767377e-05,0.5333333333333333
8275,김정화/Noun,15,8,7,8.892248182646778e-05,7.774840615767377e-05,0.5333333333333333
8276,한낱/Adverb,15,7,8,7.78071715981593e-05,8.885532132305573e-05,0.5333333333333333
8277,모어/Noun,15,8,7,8.892248182646778e-05,7.774840615767377e-05,0.5333333333333333
8278,남동생/Noun,15,7,8,7.78071715981593e-05,8.885532132305573e-05,0.5333333333333333
8279,컬러/Noun,15,7,8,7.78071715981593e-05,8.885532132305573e-05,0.5333333333333333
8280,가난/Noun,15,8,7,8.892248182646778e-05,7.774840615767377e-05,0.5333333333333333
8281,달성/Noun,15,8,7,8.892248182646778e-05,7.774840615767377e-05,0.5333333333333333
8282,슈퍼스타/Noun,15,7,8,7.78071715981593e-05,8.885532132305573e-05,0.5333333333333333
8283,진과/Noun,15,8,7,8.892248182646778e-05,7.774840615767377e-05,0.5333333333333333
8284,그레이스/Noun,15,8,7,8.892248182646778e-05,7.774840615767377e-05,0.5333333333333333
8285,측은하다/Adjective,15,7,8,7.78071715981593e-05,8.885532132305573e-05,0.5333333333333333
8286,신성일/Noun,15,7,8,7.78071715981593e-05,8.885532132305573e-05,0.5333333333333333
8287,경치/Noun,15,7,8,7.78071715981593e-05,8.885532132305573e-05,0.5333333333333333
8288,레이미/Noun,15,8,7,8.892248182646778e-05,7.774840615767377e-05,0.5333333333333333
8289,방안/Noun,15,7,8,7.78071715981593e-05,8.885532132305573e-05,0.5333333333333333
8290,만족감/Noun,15,7,8,7.78071715981593e-05,8.885532132305573e-05,0.5333333333333333
8291,공백/Noun,15,7,8,7.78071715981593e-05,8.885532132305573e-05,0.5333333333333333
8292,과자/Noun,15,8,7,8.892248182646778e-05,7.774840615767377e-05,0.5333333333333333
8293,렌/Noun,15,8,7,8.892248182646778e-05,7.774840615767377e-05,0.5333333333333333
8294,87년/Number,15,7,8,7.78071715981593e-05,8.885532132305573e-05,0.5333333333333333
8295,동이/Noun,15,7,8,7.78071715981593e-05,8.885532132305573e-05,0.5333333333333333
8296,조이다/Verb,14,14,0,0.0001556143431963186,0.0,1.0
8297,밥맛/Noun,14,0,14,0.0,0.00015549681231534753,1.0
8298,분신사바/Noun,14,0,14,0.0,0.00015549681231534753,1.0
8299,혐/Noun,14,0,14,0.0,0.00015549681231534753,1.0
8300,짱개/Noun,14,0,14,0.0,0.00015549681231534753,1.0
8301,잘봣습니/Noun,14,14,0,0.0001556143431963186,0.0,1.0
8302,햇살/Noun,14,14,0,0.0001556143431963186,0.0,1.0
8303,영아/Noun,14,0,14,0.0,0.00015549681231534753,1.0
8304,..-/Punctuation,14,0,14,0.0,0.00015549681231534753,1.0
8305,졸림/Noun,14,0,14,0.0,0.00015549681231534753,1.0
8306,..-_-;;/Punctuation,14,0,14,0.0,0.00015549681231534753,1.0
8307,심슨/Noun,14,14,0,0.0001556143431963186,0.0,1.0
8308,빠져듬/Noun,14,14,0,0.0001556143431963186,0.0,1.0
8309,최선정/Noun,14,0,14,0.0,0.00015549681231534753,1.0
8310,홍석천/Noun,14,0,14,0.0,0.00015549681231534753,1.0
8311,어쩌자/Noun,14,0,14,0.0,0.00015549681231534753,1.0
8312,성준/Noun,14,13,1,0.00014449903296801013,1.1106915165381966e-05,0.9285714285714286
8313,으뜸/Noun,14,13,1,0.00014449903296801013,1.1106915165381966e-05,0.9285714285714286
8314,독보/Noun,14,13,1,0.00014449903296801013,1.1106915165381966e-05,0.9285714285714286
8315,옷벗다/Verb,14,1,13,1.1115310228308472e-05,0.00014438989714996557,0.9285714285714286
8316,소송/Noun,14,1,13,1.1115310228308472e-05,0.00014438989714996557,0.9285714285714286
8317,인간관계/Noun,14,13,1,0.00014449903296801013,1.1106915165381966e-05,0.9285714285714286
8318,탁재훈/Noun,14,1,13,1.1115310228308472e-05,0.00014438989714996557,0.9285714285714286
8319,케이온/Noun,14,13,1,0.00014449903296801013,1.1106915165381966e-05,0.9285714285714286
8320,인간극장/Noun,14,1,13,1.1115310228308472e-05,0.00014438989714996557,0.9285714285714286
8321,무조/Noun,14,13,1,0.00014449903296801013,1.1106915165381966e-05,0.9285714285714286
8322,박예진/Noun,14,1,13,1.1115310228308472e-05,0.00014438989714996557,0.9285714285714286
8323,강츄/Noun,14,13,1,0.00014449903296801013,1.1106915165381966e-05,0.9285714285714286
8324,표방/Noun,14,1,13,1.1115310228308472e-05,0.00014438989714996557,0.9285714285714286
8325,더스틴/Noun,14,13,1,0.00014449903296801013,1.1106915165381966e-05,0.9285714285714286
8326,현저/Noun,14,1,13,1.1115310228308472e-05,0.00014438989714996557,0.9285714285714286
8327,주몽/Noun,14,13,1,0.00014449903296801013,1.1106915165381966e-05,0.9285714285714286
8328,강인하다/Adjective,14,13,1,0.00014449903296801013,1.1106915165381966e-05,0.9285714285714286
8329,호프만/Noun,14,13,1,0.00014449903296801013,1.1106915165381966e-05,0.9285714285714286
8330,불명/Noun,14,1,13,1.1115310228308472e-05,0.00014438989714996557,0.9285714285714286
8331,16년/Number,14,13,1,0.00014449903296801013,1.1106915165381966e-05,0.9285714285714286
8332,민주/Noun,14,1,13,1.1115310228308472e-05,0.00014438989714996557,0.9285714285714286
8333,산만/Noun,14,1,13,1.1115310228308472e-05,0.00014438989714996557,0.9285714285714286
8334,모시다/Verb,14,1,13,1.1115310228308472e-05,0.00014438989714996557,0.9285714285714286
8335,노민우/Noun,14,13,1,0.00014449903296801013,1.1106915165381966e-05,0.9285714285714286
8336,삽입곡/Noun,14,13,1,0.00014449903296801013,1.1106915165381966e-05,0.9285714285714286
8337,외전/Noun,14,1,13,1.1115310228308472e-05,0.00014438989714996557,0.9285714285714286
8338,반말/Noun,14,1,13,1.1115310228308472e-05,0.00014438989714996557,0.9285714285714286
8339,유사라/Noun,14,1,13,1.1115310228308472e-05,0.00014438989714996557,0.9285714285714286
8340,능욕/Noun,14,1,13,1.1115310228308472e-05,0.00014438989714996557,0.9285714285714286
8341,마담/Noun,14,2,12,2.2230620456616944e-05,0.0001332829819845836,0.8571428571428571
8342,주입/Noun,14,2,12,2.2230620456616944e-05,0.0001332829819845836,0.8571428571428571
8343,탄도/Noun,14,12,2,0.00013338372273970166,2.2213830330763933e-05,0.8571428571428571
8344,오로라공주/Noun,14,2,12,2.2230620456616944e-05,0.0001332829819845836,0.8571428571428571
8345,소란/Noun,14,2,12,2.2230620456616944e-05,0.0001332829819845836,0.8571428571428571
8346,무렵/Noun,14,12,2,0.00013338372273970166,2.2213830330763933e-05,0.8571428571428571
8347,연말/Noun,14,12,2,0.00013338372273970166,2.2213830330763933e-05,0.8571428571428571
8348,주룩주룩/Noun,14,12,2,0.00013338372273970166,2.2213830330763933e-05,0.8571428571428571
8349,폴리스스토리/Noun,14,12,2,0.00013338372273970166,2.2213830330763933e-05,0.8571428571428571
8350,8천원/Number,14,2,12,2.2230620456616944e-05,0.0001332829819845836,0.8571428571428571
8351,스탭들/Noun,14,2,12,2.2230620456616944e-05,0.0001332829819845836,0.8571428571428571
8352,로다주/Noun,14,12,2,0.00013338372273970166,2.2213830330763933e-05,0.8571428571428571
8353,힛걸/Noun,14,12,2,0.00013338372273970166,2.2213830330763933e-05,0.8571428571428571
8354,늙은이/Noun,14,2,12,2.2230620456616944e-05,0.0001332829819845836,0.8571428571428571
8355,작작하다/Adjective,14,2,12,2.2230620456616944e-05,0.0001332829819845836,0.8571428571428571
8356,끼어들다/Verb,14,2,12,2.2230620456616944e-05,0.0001332829819845836,0.8571428571428571
8357,화이자/Noun,14,12,2,0.00013338372273970166,2.2213830330763933e-05,0.8571428571428571
8358,로군/Josa,14,2,12,2.2230620456616944e-05,0.0001332829819845836,0.8571428571428571
8359,포트/Noun,14,12,2,0.00013338372273970166,2.2213830330763933e-05,0.8571428571428571
8360,엑소시즘/Noun,14,2,12,2.2230620456616944e-05,0.0001332829819845836,0.8571428571428571
8361,감탄사/Noun,14,12,2,0.00013338372273970166,2.2213830330763933e-05,0.8571428571428571
8362,노출하다/Adjective,14,2,12,2.2230620456616944e-05,0.0001332829819845836,0.8571428571428571
8363,왜봄/Noun,14,2,12,2.2230620456616944e-05,0.0001332829819845836,0.8571428571428571
8364,ㅗㅗ/KoreanParticle,14,2,12,2.2230620456616944e-05,0.0001332829819845836,0.8571428571428571
8365,겨냥/Noun,14,2,12,2.2230620456616944e-05,0.0001332829819845836,0.8571428571428571
8366,내리막/Noun,14,2,12,2.2230620456616944e-05,0.0001332829819845836,0.8571428571428571
8367,따먹다/Verb,14,2,12,2.2230620456616944e-05,0.0001332829819845836,0.8571428571428571
8368,뻘/Noun,14,2,12,2.2230620456616944e-05,0.0001332829819845836,0.8571428571428571
8369,메우다/Verb,14,2,12,2.2230620456616944e-05,0.0001332829819845836,0.8571428571428571
8370,부제/Noun,14,2,12,2.2230620456616944e-05,0.0001332829819845836,0.8571428571428571
8371,휘두르다/Verb,14,2,12,2.2230620456616944e-05,0.0001332829819845836,0.8571428571428571
8372,일어서다/Verb,14,12,2,0.00013338372273970166,2.2213830330763933e-05,0.8571428571428571
8373,핵꿀잼/Noun,14,12,2,0.00013338372273970166,2.2213830330763933e-05,0.8571428571428571
8374,회한/Noun,14,12,2,0.00013338372273970166,2.2213830330763933e-05,0.8571428571428571
8375,벌이/Noun,14,2,12,2.2230620456616944e-05,0.0001332829819845836,0.8571428571428571
8376,치장/Noun,14,2,12,2.2230620456616944e-05,0.0001332829819845836,0.8571428571428571
8377,야호/Noun,14,12,2,0.00013338372273970166,2.2213830330763933e-05,0.8571428571428571
8378,우왕좌왕/Noun,14,2,12,2.2230620456616944e-05,0.0001332829819845836,0.8571428571428571
8379,교체/Noun,14,2,12,2.2230620456616944e-05,0.0001332829819845836,0.8571428571428571
8380,지도자/Noun,14,12,2,0.00013338372273970166,2.2213830330763933e-05,0.8571428571428571
8381,서늘하다/Adjective,14,12,2,0.00013338372273970166,2.2213830330763933e-05,0.8571428571428571
8382,막심/Noun,14,3,11,3.3345930684925414e-05,0.00012217606681920164,0.7857142857142857
8383,붐/Noun,14,3,11,3.3345930684925414e-05,0.00012217606681920164,0.7857142857142857
8384,오늘이/Noun,14,11,3,0.00012226841251139318,3.33207454961459e-05,0.7857142857142857
8385,복장/Noun,14,3,11,3.3345930684925414e-05,0.00012217606681920164,0.7857142857142857
8386,>.</Punctuation,14,11,3,0.00012226841251139318,3.33207454961459e-05,0.7857142857142857
8387,상기/Noun,14,11,3,0.00012226841251139318,3.33207454961459e-05,0.7857142857142857
8388,조형기/Noun,14,3,11,3.3345930684925414e-05,0.00012217606681920164,0.7857142857142857
8389,불량/Noun,14,3,11,3.3345930684925414e-05,0.00012217606681920164,0.7857142857142857
8390,가만있다/Verb,14,3,11,3.3345930684925414e-05,0.00012217606681920164,0.7857142857142857
8391,수목/Noun,14,11,3,0.00012226841251139318,3.33207454961459e-05,0.7857142857142857
8392,번개/Noun,14,11,3,0.00012226841251139318,3.33207454961459e-05,0.7857142857142857
8393,미술관/Noun,14,11,3,0.00012226841251139318,3.33207454961459e-05,0.7857142857142857
8394,정려원/Noun,14,11,3,0.00012226841251139318,3.33207454961459e-05,0.7857142857142857
8395,오마주/Noun,14,3,11,3.3345930684925414e-05,0.00012217606681920164,0.7857142857142857
8396,뽀뽀/Noun,14,3,11,3.3345930684925414e-05,0.00012217606681920164,0.7857142857142857
8397,닷/Modifier,14,11,3,0.00012226841251139318,3.33207454961459e-05,0.7857142857142857
8398,느릿느릿/Noun,14,3,11,3.3345930684925414e-05,0.00012217606681920164,0.7857142857142857
8399,오즈/Noun,14,11,3,0.00012226841251139318,3.33207454961459e-05,0.7857142857142857
8400,푼/Noun,14,3,11,3.3345930684925414e-05,0.00012217606681920164,0.7857142857142857
8401,지니/Noun,14,11,3,0.00012226841251139318,3.33207454961459e-05,0.7857142857142857
8402,개밥/Noun,14,3,11,3.3345930684925414e-05,0.00012217606681920164,0.7857142857142857
8403,이색/Noun,14,11,3,0.00012226841251139318,3.33207454961459e-05,0.7857142857142857
8404,오리엔탈리즘/Noun,14,3,11,3.3345930684925414e-05,0.00012217606681920164,0.7857142857142857
8405,젬/Noun,14,11,3,0.00012226841251139318,3.33207454961459e-05,0.7857142857142857
8406,브라보/Noun,14,11,3,0.00012226841251139318,3.33207454961459e-05,0.7857142857142857
8407,작작/Noun,14,3,11,3.3345930684925414e-05,0.00012217606681920164,0.7857142857142857
8408,이듬/Noun,14,3,11,3.3345930684925414e-05,0.00012217606681920164,0.7857142857142857
8409,지긋지긋하다/Adjective,14,3,11,3.3345930684925414e-05,0.00012217606681920164,0.7857142857142857
8410,시초/Noun,14,11,3,0.00012226841251139318,3.33207454961459e-05,0.7857142857142857
8411,청순/Noun,14,11,3,0.00012226841251139318,3.33207454961459e-05,0.7857142857142857
8412,.................../Punctuation,14,3,11,3.3345930684925414e-05,0.00012217606681920164,0.7857142857142857
8413,맹/Noun,14,3,11,3.3345930684925414e-05,0.00012217606681920164,0.7857142857142857
8414,비상/Noun,14,3,11,3.3345930684925414e-05,0.00012217606681920164,0.7857142857142857
8415,리버/Noun,14,11,3,0.00012226841251139318,3.33207454961459e-05,0.7857142857142857
8416,불평/Noun,14,11,3,0.00012226841251139318,3.33207454961459e-05,0.7857142857142857
8417,머레이/Noun,14,11,3,0.00012226841251139318,3.33207454961459e-05,0.7857142857142857
8418,주름/Noun,14,3,11,3.3345930684925414e-05,0.00012217606681920164,0.7857142857142857
8419,대머리/Noun,14,3,11,3.3345930684925414e-05,0.00012217606681920164,0.7857142857142857
8420,저조하다/Adjective,14,11,3,0.00012226841251139318,3.33207454961459e-05,0.7857142857142857
8421,노숙자/Noun,14,3,11,3.3345930684925414e-05,0.00012217606681920164,0.7857142857142857
8422,점차/Noun,14,11,3,0.00012226841251139318,3.33207454961459e-05,0.7857142857142857
8423,적용/Noun,14,3,11,3.3345930684925414e-05,0.00012217606681920164,0.7857142857142857
8424,몽골/Noun,14,3,11,3.3345930684925414e-05,0.00012217606681920164,0.7857142857142857
8425,난장판/Noun,14,3,11,3.3345930684925414e-05,0.00012217606681920164,0.7857142857142857
8426,시인/Noun,14,11,3,0.00012226841251139318,3.33207454961459e-05,0.7857142857142857
8427,몰락하다/Adjective,14,3,11,3.3345930684925414e-05,0.00012217606681920164,0.7857142857142857
8428,할인/Noun,14,3,11,3.3345930684925414e-05,0.00012217606681920164,0.7857142857142857
8429,결승전/Noun,14,3,11,3.3345930684925414e-05,0.00012217606681920164,0.7857142857142857
8430,헬렌/Noun,14,11,3,0.00012226841251139318,3.33207454961459e-05,0.7857142857142857
8431,밨/Noun,14,11,3,0.00012226841251139318,3.33207454961459e-05,0.7857142857142857
8432,무례하다/Adjective,14,3,11,3.3345930684925414e-05,0.00012217606681920164,0.7857142857142857
8433,호호/Noun,14,11,3,0.00012226841251139318,3.33207454961459e-05,0.7857142857142857
8434,연쇄살인/Noun,14,3,11,3.3345930684925414e-05,0.00012217606681920164,0.7857142857142857
8435,찌라시/Noun,14,3,11,3.3345930684925414e-05,0.00012217606681920164,0.7857142857142857
8436,~~!!!!/Punctuation,14,11,3,0.00012226841251139318,3.33207454961459e-05,0.7857142857142857
8437,갈증/Noun,14,10,4,0.00011115310228308472,4.4427660661527865e-05,0.7142857142857143
8438,무식/Noun,14,4,10,4.446124091323389e-05,0.00011106915165381967,0.7142857142857143
8439,역경/Noun,14,10,4,0.00011115310228308472,4.4427660661527865e-05,0.7142857142857143
8440,태권브이/Noun,14,4,10,4.446124091323389e-05,0.00011106915165381967,0.7142857142857143
8441,발달/Noun,14,10,4,0.00011115310228308472,4.4427660661527865e-05,0.7142857142857143
8442,센세이션/Noun,14,10,4,0.00011115310228308472,4.4427660661527865e-05,0.7142857142857143
8443,개입/Noun,14,4,10,4.446124091323389e-05,0.00011106915165381967,0.7142857142857143
8444,의무/Noun,14,10,4,0.00011115310228308472,4.4427660661527865e-05,0.7142857142857143
8445,퍽/Noun,14,4,10,4.446124091323389e-05,0.00011106915165381967,0.7142857142857143
8446,줄기/Noun,14,10,4,0.00011115310228308472,4.4427660661527865e-05,0.7142857142857143
8447,다섯/Modifier,14,10,4,0.00011115310228308472,4.4427660661527865e-05,0.7142857142857143
8448,애니스톤/Noun,14,4,10,4.446124091323389e-05,0.00011106915165381967,0.7142857142857143
8449,?!!/Punctuation,14,4,10,4.446124091323389e-05,0.00011106915165381967,0.7142857142857143
8450,김재원/Noun,14,10,4,0.00011115310228308472,4.4427660661527865e-05,0.7142857142857143
8451,조미료/Noun,14,4,10,4.446124091323389e-05,0.00011106915165381967,0.7142857142857143
8452,수상한/Noun,14,10,4,0.00011115310228308472,4.4427660661527865e-05,0.7142857142857143
8453,흠/Exclamation,14,4,10,4.446124091323389e-05,0.00011106915165381967,0.7142857142857143
8454,타의/Noun,14,10,4,0.00011115310228308472,4.4427660661527865e-05,0.7142857142857143
8455,이만/Modifier,14,10,4,0.00011115310228308472,4.4427660661527865e-05,0.7142857142857143
8456,리듬/Noun,14,10,4,0.00011115310228308472,4.4427660661527865e-05,0.7142857142857143
8457,르노/Noun,14,4,10,4.446124091323389e-05,0.00011106915165381967,0.7142857142857143
8458,정규/Noun,14,10,4,0.00011115310228308472,4.4427660661527865e-05,0.7142857142857143
8459,레디/Noun,14,4,10,4.446124091323389e-05,0.00011106915165381967,0.7142857142857143
8460,덕화/Noun,14,10,4,0.00011115310228308472,4.4427660661527865e-05,0.7142857142857143
8461,혼돈/Noun,14,10,4,0.00011115310228308472,4.4427660661527865e-05,0.7142857142857143
8462,박철수/Noun,14,4,10,4.446124091323389e-05,0.00011106915165381967,0.7142857142857143
8463,드라큘라/Noun,14,4,10,4.446124091323389e-05,0.00011106915165381967,0.7142857142857143
8464,흡혈귀/Noun,14,4,10,4.446124091323389e-05,0.00011106915165381967,0.7142857142857143
8465,가중/Noun,14,4,10,4.446124091323389e-05,0.00011106915165381967,0.7142857142857143
8466,메가박스/Noun,14,10,4,0.00011115310228308472,4.4427660661527865e-05,0.7142857142857143
8467,학원물/Noun,14,4,10,4.446124091323389e-05,0.00011106915165381967,0.7142857142857143
8468,앗다/Verb,14,4,10,4.446124091323389e-05,0.00011106915165381967,0.7142857142857143
8469,상실하다/Adjective,14,4,10,4.446124091323389e-05,0.00011106915165381967,0.7142857142857143
8470,치자/Noun,14,4,10,4.446124091323389e-05,0.00011106915165381967,0.7142857142857143
8471,셜록홈즈/Noun,14,10,4,0.00011115310228308472,4.4427660661527865e-05,0.7142857142857143
8472,에고/Noun,14,4,10,4.446124091323389e-05,0.00011106915165381967,0.7142857142857143
8473,이벤트/Noun,14,4,10,4.446124091323389e-05,0.00011106915165381967,0.7142857142857143
8474,굴욕/Noun,14,4,10,4.446124091323389e-05,0.00011106915165381967,0.7142857142857143
8475,사이비/Noun,14,4,10,4.446124091323389e-05,0.00011106915165381967,0.7142857142857143
8476,시련/Noun,14,10,4,0.00011115310228308472,4.4427660661527865e-05,0.7142857142857143
8477,면모/Noun,14,10,4,0.00011115310228308472,4.4427660661527865e-05,0.7142857142857143
8478,대적/Noun,14,4,10,4.446124091323389e-05,0.00011106915165381967,0.7142857142857143
8479,아우르다/Verb,14,10,4,0.00011115310228308472,4.4427660661527865e-05,0.7142857142857143
8480,우디앨런/Noun,14,10,4,0.00011115310228308472,4.4427660661527865e-05,0.7142857142857143
8481,미쉘/Noun,14,10,4,0.00011115310228308472,4.4427660661527865e-05,0.7142857142857143
8482,이수경/Noun,14,10,4,0.00011115310228308472,4.4427660661527865e-05,0.7142857142857143
8483,랬/Noun,14,4,10,4.446124091323389e-05,0.00011106915165381967,0.7142857142857143
8484,1시/Number,14,4,10,4.446124091323389e-05,0.00011106915165381967,0.7142857142857143
8485,사채/Noun,14,4,10,4.446124091323389e-05,0.00011106915165381967,0.7142857142857143
8486,유학/Noun,14,9,5,0.00010003779205477625,5.5534575826909837e-05,0.6428571428571429
8487,허탈/Noun,14,5,9,5.557655114154236e-05,9.99622364884377e-05,0.6428571428571429
8488,리턴즈/Noun,14,9,5,0.00010003779205477625,5.5534575826909837e-05,0.6428571428571429
8489,간수/Noun,14,5,9,5.557655114154236e-05,9.99622364884377e-05,0.6428571428571429
8490,사만/Noun,14,9,5,0.00010003779205477625,5.5534575826909837e-05,0.6428571428571429
8491,아앙/Noun,14,5,9,5.557655114154236e-05,9.99622364884377e-05,0.6428571428571429
8492,엑스/Noun,14,5,9,5.557655114154236e-05,9.99622364884377e-05,0.6428571428571429
8493,부들/Noun,14,5,9,5.557655114154236e-05,9.99622364884377e-05,0.6428571428571429
8494,.;/Punctuation,14,5,9,5.557655114154236e-05,9.99622364884377e-05,0.6428571428571429
8495,락스/Noun,14,9,5,0.00010003779205477625,5.5534575826909837e-05,0.6428571428571429
8496,돈좀/Noun,14,5,9,5.557655114154236e-05,9.99622364884377e-05,0.6428571428571429
8497,할리웃/Noun,14,5,9,5.557655114154236e-05,9.99622364884377e-05,0.6428571428571429
8498,매장/Noun,14,5,9,5.557655114154236e-05,9.99622364884377e-05,0.6428571428571429
8499,극히/Noun,14,5,9,5.557655114154236e-05,9.99622364884377e-05,0.6428571428571429
8500,이참/Noun,14,5,9,5.557655114154236e-05,9.99622364884377e-05,0.6428571428571429
8501,시대극/Noun,14,5,9,5.557655114154236e-05,9.99622364884377e-05,0.6428571428571429
8502,실로/Noun,14,9,5,0.00010003779205477625,5.5534575826909837e-05,0.6428571428571429
8503,본영/Noun,14,9,5,0.00010003779205477625,5.5534575826909837e-05,0.6428571428571429
8504,뺴/Noun,14,5,9,5.557655114154236e-05,9.99622364884377e-05,0.6428571428571429
8505,소동/Noun,14,5,9,5.557655114154236e-05,9.99622364884377e-05,0.6428571428571429
8506,구심/Noun,14,5,9,5.557655114154236e-05,9.99622364884377e-05,0.6428571428571429
8507,기지/Noun,14,9,5,0.00010003779205477625,5.5534575826909837e-05,0.6428571428571429
8508,요리사/Noun,14,5,9,5.557655114154236e-05,9.99622364884377e-05,0.6428571428571429
8509,아이언/Noun,14,9,5,0.00010003779205477625,5.5534575826909837e-05,0.6428571428571429
8510,배부르다/Adjective,14,9,5,0.00010003779205477625,5.5534575826909837e-05,0.6428571428571429
8511,!!!!!!!!!!!!/Punctuation,14,9,5,0.00010003779205477625,5.5534575826909837e-05,0.6428571428571429
8512,감초/Noun,14,9,5,0.00010003779205477625,5.5534575826909837e-05,0.6428571428571429
8513,품격/Noun,14,9,5,0.00010003779205477625,5.5534575826909837e-05,0.6428571428571429
8514,하치/Noun,14,9,5,0.00010003779205477625,5.5534575826909837e-05,0.6428571428571429
8515,몽/Noun,14,5,9,5.557655114154236e-05,9.99622364884377e-05,0.6428571428571429
8516,안이/Noun,14,9,5,0.00010003779205477625,5.5534575826909837e-05,0.6428571428571429
8517,볼맛/Noun,14,5,9,5.557655114154236e-05,9.99622364884377e-05,0.6428571428571429
8518,련/Noun,14,9,5,0.00010003779205477625,5.5534575826909837e-05,0.6428571428571429
8519,북괴/Noun,14,5,9,5.557655114154236e-05,9.99622364884377e-05,0.6428571428571429
8520,안타/Noun,14,5,9,5.557655114154236e-05,9.99622364884377e-05,0.6428571428571429
8521,오감/Noun,14,9,5,0.00010003779205477625,5.5534575826909837e-05,0.6428571428571429
8522,임산부/Noun,14,5,9,5.557655114154236e-05,9.99622364884377e-05,0.6428571428571429
8523,..................../Punctuation,14,5,9,5.557655114154236e-05,9.99622364884377e-05,0.6428571428571429
8524,달이/Noun,14,9,5,0.00010003779205477625,5.5534575826909837e-05,0.6428571428571429
8525,댓/Noun,14,5,9,5.557655114154236e-05,9.99622364884377e-05,0.6428571428571429
8526,친하다/Adjective,14,5,9,5.557655114154236e-05,9.99622364884377e-05,0.6428571428571429
8527,부유하다/Adjective,14,9,5,0.00010003779205477625,5.5534575826909837e-05,0.6428571428571429
8528,비서/Noun,14,5,9,5.557655114154236e-05,9.99622364884377e-05,0.6428571428571429
8529,거물/Noun,14,9,5,0.00010003779205477625,5.5534575826909837e-05,0.6428571428571429
8530,편의점/Noun,14,5,9,5.557655114154236e-05,9.99622364884377e-05,0.6428571428571429
8531,셀/Noun,14,9,5,0.00010003779205477625,5.5534575826909837e-05,0.6428571428571429
8532,CSI/Alpha,14,9,5,0.00010003779205477625,5.5534575826909837e-05,0.6428571428571429
8533,아베/Noun,14,5,9,5.557655114154236e-05,9.99622364884377e-05,0.6428571428571429
8534,절도/Noun,14,5,9,5.557655114154236e-05,9.99622364884377e-05,0.6428571428571429
8535,파고/Noun,14,5,9,5.557655114154236e-05,9.99622364884377e-05,0.6428571428571429
8536,후진국/Noun,14,5,9,5.557655114154236e-05,9.99622364884377e-05,0.6428571428571429
8537,도구/Noun,14,5,9,5.557655114154236e-05,9.99622364884377e-05,0.6428571428571429
8538,낙태/Noun,14,5,9,5.557655114154236e-05,9.99622364884377e-05,0.6428571428571429
8539,유키/Noun,14,9,5,0.00010003779205477625,5.5534575826909837e-05,0.6428571428571429
8540,에피/Noun,14,9,5,0.00010003779205477625,5.5534575826909837e-05,0.6428571428571429
8541,보성/Noun,14,9,5,0.00010003779205477625,5.5534575826909837e-05,0.6428571428571429
8542,수두/Noun,14,5,9,5.557655114154236e-05,9.99622364884377e-05,0.6428571428571429
8543,친숙하다/Adjective,14,9,5,0.00010003779205477625,5.5534575826909837e-05,0.6428571428571429
8544,애국가/Noun,14,5,9,5.557655114154236e-05,9.99622364884377e-05,0.6428571428571429
8545,테러범/Noun,14,5,9,5.557655114154236e-05,9.99622364884377e-05,0.6428571428571429
8546,무진장/Noun,14,5,9,5.557655114154236e-05,9.99622364884377e-05,0.6428571428571429
8547,난리치다/Verb,14,5,9,5.557655114154236e-05,9.99622364884377e-05,0.6428571428571429
8548,송/Noun,14,9,5,0.00010003779205477625,5.5534575826909837e-05,0.6428571428571429
8549,잘해주다/Verb,14,9,5,0.00010003779205477625,5.5534575826909837e-05,0.6428571428571429
8550,본연/Noun,14,9,5,0.00010003779205477625,5.5534575826909837e-05,0.6428571428571429
8551,탐구/Noun,14,9,5,0.00010003779205477625,5.5534575826909837e-05,0.6428571428571429
8552,일어나지/Noun,14,9,5,0.00010003779205477625,5.5534575826909837e-05,0.6428571428571429
8553,골든/Noun,14,9,5,0.00010003779205477625,5.5534575826909837e-05,0.6428571428571429
8554,로이/Noun,14,5,9,5.557655114154236e-05,9.99622364884377e-05,0.6428571428571429
8555,중복/Noun,14,8,6,8.892248182646778e-05,6.66414909922918e-05,0.5714285714285714
8556,은혜/Noun,14,8,6,8.892248182646778e-05,6.66414909922918e-05,0.5714285714285714
8557,밤새다/Verb,14,8,6,8.892248182646778e-05,6.66414909922918e-05,0.5714285714285714
8558,무인도/Noun,14,8,6,8.892248182646778e-05,6.66414909922918e-05,0.5714285714285714
8559,커리어/Noun,14,6,8,6.669186136985083e-05,8.885532132305573e-05,0.5714285714285714
8560,밀리/Noun,14,8,6,8.892248182646778e-05,6.66414909922918e-05,0.5714285714285714
8561,10월/Number,14,8,6,8.892248182646778e-05,6.66414909922918e-05,0.5714285714285714
8562,다름없다/Adjective,14,6,8,6.669186136985083e-05,8.885532132305573e-05,0.5714285714285714
8563,장례식/Noun,14,8,6,8.892248182646778e-05,6.66414909922918e-05,0.5714285714285714
8564,유괴/Noun,14,6,8,6.669186136985083e-05,8.885532132305573e-05,0.5714285714285714
8565,육아/Noun,14,8,6,8.892248182646778e-05,6.66414909922918e-05,0.5714285714285714
8566,고준희/Noun,14,6,8,6.669186136985083e-05,8.885532132305573e-05,0.5714285714285714
8567,배기/Noun,14,6,8,6.669186136985083e-05,8.885532132305573e-05,0.5714285714285714
8568,2월/Number,14,6,8,6.669186136985083e-05,8.885532132305573e-05,0.5714285714285714
8569,유죄/Noun,14,8,6,8.892248182646778e-05,6.66414909922918e-05,0.5714285714285714
8570,블러드/Noun,14,6,8,6.669186136985083e-05,8.885532132305573e-05,0.5714285714285714
8571,복제/Noun,14,6,8,6.669186136985083e-05,8.885532132305573e-05,0.5714285714285714
8572,사주다/Verb,14,6,8,6.669186136985083e-05,8.885532132305573e-05,0.5714285714285714
8573,심야/Noun,14,6,8,6.669186136985083e-05,8.885532132305573e-05,0.5714285714285714
8574,결방/Noun,14,6,8,6.669186136985083e-05,8.885532132305573e-05,0.5714285714285714
8575,녹/Noun,14,8,6,8.892248182646778e-05,6.66414909922918e-05,0.5714285714285714
8576,펀치/Noun,14,6,8,6.669186136985083e-05,8.885532132305573e-05,0.5714285714285714
8577,무자비하다/Adjective,14,8,6,8.892248182646778e-05,6.66414909922918e-05,0.5714285714285714
8578,판매/Noun,14,6,8,6.669186136985083e-05,8.885532132305573e-05,0.5714285714285714
8579,컴백/Noun,14,6,8,6.669186136985083e-05,8.885532132305573e-05,0.5714285714285714
8580,대입/Noun,14,8,6,8.892248182646778e-05,6.66414909922918e-05,0.5714285714285714
8581,서구/Noun,14,6,8,6.669186136985083e-05,8.885532132305573e-05,0.5714285714285714
8582,광대/Noun,14,8,6,8.892248182646778e-05,6.66414909922918e-05,0.5714285714285714
8583,과극/Noun,14,8,6,8.892248182646778e-05,6.66414909922918e-05,0.5714285714285714
8584,허황/Noun,14,6,8,6.669186136985083e-05,8.885532132305573e-05,0.5714285714285714
8585,도피/Noun,14,8,6,8.892248182646778e-05,6.66414909922918e-05,0.5714285714285714
8586,오션스/Noun,14,6,8,6.669186136985083e-05,8.885532132305573e-05,0.5714285714285714
8587,종족/Noun,14,6,8,6.669186136985083e-05,8.885532132305573e-05,0.5714285714285714
8588,f/Alpha,14,6,8,6.669186136985083e-05,8.885532132305573e-05,0.5714285714285714
8589,괴짜/Noun,14,8,6,8.892248182646778e-05,6.66414909922918e-05,0.5714285714285714
8590,가져다주다/Verb,14,8,6,8.892248182646778e-05,6.66414909922918e-05,0.5714285714285714
8591,비보이/Noun,14,6,8,6.669186136985083e-05,8.885532132305573e-05,0.5714285714285714
8592,내려놓다/Verb,14,8,6,8.892248182646778e-05,6.66414909922918e-05,0.5714285714285714
8593,스턴/Noun,14,8,6,8.892248182646778e-05,6.66414909922918e-05,0.5714285714285714
8594,!.../Punctuation,14,8,6,8.892248182646778e-05,6.66414909922918e-05,0.5714285714285714
8595,이현우/Noun,14,8,6,8.892248182646778e-05,6.66414909922918e-05,0.5714285714285714
8596,드하/Noun,14,6,8,6.669186136985083e-05,8.885532132305573e-05,0.5714285714285714
8597,아티스트/Noun,14,6,8,6.669186136985083e-05,8.885532132305573e-05,0.5714285714285714
8598,마다가스카/Noun,14,8,6,8.892248182646778e-05,6.66414909922918e-05,0.5714285714285714
8599,사생활/Noun,14,6,8,6.669186136985083e-05,8.885532132305573e-05,0.5714285714285714
8600,눈길/Noun,14,6,8,6.669186136985083e-05,8.885532132305573e-05,0.5714285714285714
8601,주류/Noun,14,6,8,6.669186136985083e-05,8.885532132305573e-05,0.5714285714285714
8602,의적/Noun,14,6,8,6.669186136985083e-05,8.885532132305573e-05,0.5714285714285714
8603,최고급/Noun,14,6,8,6.669186136985083e-05,8.885532132305573e-05,0.5714285714285714
8604,둥이/Noun,14,8,6,8.892248182646778e-05,6.66414909922918e-05,0.5714285714285714
8605,으로라도/Josa,14,6,8,6.669186136985083e-05,8.885532132305573e-05,0.5714285714285714
8606,구름/Noun,14,8,6,8.892248182646778e-05,6.66414909922918e-05,0.5714285714285714
8607,홀/Noun,14,8,6,8.892248182646778e-05,6.66414909922918e-05,0.5714285714285714
8608,아이덴티티/Noun,14,6,8,6.669186136985083e-05,8.885532132305573e-05,0.5714285714285714
8609,카스/Noun,14,6,8,6.669186136985083e-05,8.885532132305573e-05,0.5714285714285714
8610,데인/Noun,14,6,8,6.669186136985083e-05,8.885532132305573e-05,0.5714285714285714
8611,냉철하다/Adjective,14,8,6,8.892248182646778e-05,6.66414909922918e-05,0.5714285714285714
8612,검술/Noun,14,8,6,8.892248182646778e-05,6.66414909922918e-05,0.5714285714285714
8613,프레임/Noun,14,8,6,8.892248182646778e-05,6.66414909922918e-05,0.5714285714285714
8614,저항/Noun,14,6,8,6.669186136985083e-05,8.885532132305573e-05,0.5714285714285714
8615,분다/Noun,14,8,6,8.892248182646778e-05,6.66414909922918e-05,0.5714285714285714
8616,쟈/Noun,14,8,6,8.892248182646778e-05,6.66414909922918e-05,0.5714285714285714
8617,강풀/Noun,14,6,8,6.669186136985083e-05,8.885532132305573e-05,0.5714285714285714
8618,해변/Noun,14,6,8,6.669186136985083e-05,8.885532132305573e-05,0.5714285714285714
8619,암흑/Noun,14,6,8,6.669186136985083e-05,8.885532132305573e-05,0.5714285714285714
8620,911/Number,14,8,6,8.892248182646778e-05,6.66414909922918e-05,0.5714285714285714
8621,터키/Noun,14,8,6,8.892248182646778e-05,6.66414909922918e-05,0.5714285714285714
8622,이다/Foreign,14,8,6,8.892248182646778e-05,6.66414909922918e-05,0.5714285714285714
8623,는바/Noun,14,8,6,8.892248182646778e-05,6.66414909922918e-05,0.5714285714285714
8624,발표/Noun,14,6,8,6.669186136985083e-05,8.885532132305573e-05,0.5714285714285714
8625,이집트/Noun,14,8,6,8.892248182646778e-05,6.66414909922918e-05,0.5714285714285714
8626,링컨/Noun,14,6,8,6.669186136985083e-05,8.885532132305573e-05,0.5714285714285714
8627,차안/Noun,14,6,8,6.669186136985083e-05,8.885532132305573e-05,0.5714285714285714
8628,분노의질주/Noun,14,8,6,8.892248182646778e-05,6.66414909922918e-05,0.5714285714285714
8629,위버/Noun,14,8,6,8.892248182646778e-05,6.66414909922918e-05,0.5714285714285714
8630,프레/Noun,14,8,6,8.892248182646778e-05,6.66414909922918e-05,0.5714285714285714
8631,고의/Noun,14,6,8,6.669186136985083e-05,8.885532132305573e-05,0.5714285714285714
8632,재산/Noun,14,6,8,6.669186136985083e-05,8.885532132305573e-05,0.5714285714285714
8633,2013/Number,14,6,8,6.669186136985083e-05,8.885532132305573e-05,0.5714285714285714
8634,갈릴/Noun,14,8,6,8.892248182646778e-05,6.66414909922918e-05,0.5714285714285714
8635,이지아/Noun,14,6,8,6.669186136985083e-05,8.885532132305573e-05,0.5714285714285714
8636,응징/Noun,14,6,8,6.669186136985083e-05,8.885532132305573e-05,0.5714285714285714
8637,데니스/Noun,14,6,8,6.669186136985083e-05,8.885532132305573e-05,0.5714285714285714
8638,횡포/Noun,14,6,8,6.669186136985083e-05,8.885532132305573e-05,0.5714285714285714
8639,페인/Noun,14,6,8,6.669186136985083e-05,8.885532132305573e-05,0.5714285714285714
8640,독일군/Noun,14,8,6,8.892248182646778e-05,6.66414909922918e-05,0.5714285714285714
8641,뽀/Noun,14,6,8,6.669186136985083e-05,8.885532132305573e-05,0.5714285714285714
8642,빌어/Noun,14,8,6,8.892248182646778e-05,6.66414909922918e-05,0.5714285714285714
8643,최성국/Noun,14,6,8,6.669186136985083e-05,8.885532132305573e-05,0.5714285714285714
8644,헝거게임/Noun,14,8,6,8.892248182646778e-05,6.66414909922918e-05,0.5714285714285714
8645,리딕/Noun,14,8,6,8.892248182646778e-05,6.66414909922918e-05,0.5714285714285714
8646,형사물/Noun,14,6,8,6.669186136985083e-05,8.885532132305573e-05,0.5714285714285714
8647,두르다/Verb,14,7,7,7.78071715981593e-05,7.774840615767377e-05,0.5
8648,숲속/Noun,14,7,7,7.78071715981593e-05,7.774840615767377e-05,0.5
8649,랏/Noun,14,7,7,7.78071715981593e-05,7.774840615767377e-05,0.5
8650,화기/Noun,14,7,7,7.78071715981593e-05,7.774840615767377e-05,0.5
8651,김두한/Noun,14,7,7,7.78071715981593e-05,7.774840615767377e-05,0.5
8652,풍선/Noun,14,7,7,7.78071715981593e-05,7.774840615767377e-05,0.5
8653,의자/Noun,14,7,7,7.78071715981593e-05,7.774840615767377e-05,0.5
8654,토모/Noun,14,7,7,7.78071715981593e-05,7.774840615767377e-05,0.5
8655,수행/Noun,14,7,7,7.78071715981593e-05,7.774840615767377e-05,0.5
8656,서나/Noun,14,7,7,7.78071715981593e-05,7.774840615767377e-05,0.5
8657,텅/Noun,14,7,7,7.78071715981593e-05,7.774840615767377e-05,0.5
8658,선언/Noun,14,7,7,7.78071715981593e-05,7.774840615767377e-05,0.5
8659,탄압/Noun,14,7,7,7.78071715981593e-05,7.774840615767377e-05,0.5
8660,맞춤/Noun,14,7,7,7.78071715981593e-05,7.774840615767377e-05,0.5
8661,계시/Noun,14,7,7,7.78071715981593e-05,7.774840615767377e-05,0.5
8662,파렐/Noun,14,7,7,7.78071715981593e-05,7.774840615767377e-05,0.5
8663,일편/Noun,14,7,7,7.78071715981593e-05,7.774840615767377e-05,0.5
8664,수긍/Noun,14,7,7,7.78071715981593e-05,7.774840615767377e-05,0.5
8665,콜/Noun,14,7,7,7.78071715981593e-05,7.774840615767377e-05,0.5
8666,발사/Noun,14,7,7,7.78071715981593e-05,7.774840615767377e-05,0.5
8667,이청아/Noun,14,7,7,7.78071715981593e-05,7.774840615767377e-05,0.5
8668,방도/Noun,14,7,7,7.78071715981593e-05,7.774840615767377e-05,0.5
8669,체인지/Noun,14,7,7,7.78071715981593e-05,7.774840615767377e-05,0.5
8670,계급/Noun,14,7,7,7.78071715981593e-05,7.774840615767377e-05,0.5
8671,여하튼/Noun,14,7,7,7.78071715981593e-05,7.774840615767377e-05,0.5
8672,바랬는데/Noun,14,7,7,7.78071715981593e-05,7.774840615767377e-05,0.5
8673,브/Noun,14,7,7,7.78071715981593e-05,7.774840615767377e-05,0.5
8674,릴리/Noun,14,7,7,7.78071715981593e-05,7.774840615767377e-05,0.5
8675,이오/Noun,14,7,7,7.78071715981593e-05,7.774840615767377e-05,0.5
8676,말년/Noun,14,7,7,7.78071715981593e-05,7.774840615767377e-05,0.5
8677,서인/Noun,14,7,7,7.78071715981593e-05,7.774840615767377e-05,0.5
8678,홍길동/Noun,14,7,7,7.78071715981593e-05,7.774840615767377e-05,0.5
8679,현주소/Noun,14,7,7,7.78071715981593e-05,7.774840615767377e-05,0.5
8680,일어나고/Noun,14,7,7,7.78071715981593e-05,7.774840615767377e-05,0.5
8681,봉인/Noun,14,7,7,7.78071715981593e-05,7.774840615767377e-05,0.5
8682,해주시/Noun,14,7,7,7.78071715981593e-05,7.774840615767377e-05,0.5
8683,깔리다/Verb,14,7,7,7.78071715981593e-05,7.774840615767377e-05,0.5
8684,딜레마/Noun,14,7,7,7.78071715981593e-05,7.774840615767377e-05,0.5
8685,단독/Noun,14,7,7,7.78071715981593e-05,7.774840615767377e-05,0.5
8686,막막하다/Adjective,14,7,7,7.78071715981593e-05,7.774840615767377e-05,0.5
8687,남자에게/Noun,14,7,7,7.78071715981593e-05,7.774840615767377e-05,0.5
8688,은별/Noun,14,7,7,7.78071715981593e-05,7.774840615767377e-05,0.5
8689,금치/Noun,14,7,7,7.78071715981593e-05,7.774840615767377e-05,0.5
8690,휴지통/Noun,13,0,13,0.0,0.00014438989714996557,1.0
8691,동남아/Noun,13,0,13,0.0,0.00014438989714996557,1.0
8692,we/Alpha,13,13,0,0.00014449903296801013,0.0,1.0
8693,저리다/Adjective,13,13,0,0.00014449903296801013,0.0,1.0
8694,졷/Noun,13,0,13,0.0,0.00014438989714996557,1.0
8695,이화영/Noun,13,0,13,0.0,0.00014438989714996557,1.0
8696,라그/Noun,13,0,13,0.0,0.00014438989714996557,1.0
8697,정윤희/Noun,13,13,0,0.00014449903296801013,0.0,1.0
8698,정도껏해/Noun,13,0,13,0.0,0.00014438989714996557,1.0
8699,나사/Noun,13,0,13,0.0,0.00014438989714996557,1.0
8700,이상준/Noun,13,0,13,0.0,0.00014438989714996557,1.0
8701,죽도/Noun,13,0,13,0.0,0.00014438989714996557,1.0
8702,아려/Noun,13,13,0,0.00014449903296801013,0.0,1.0
8703,댕기/Noun,13,0,13,0.0,0.00014438989714996557,1.0
8704,지스토리/Noun,13,0,13,0.0,0.00014438989714996557,1.0
8705,씩씩하다/Adjective,13,13,0,0.00014449903296801013,0.0,1.0
8706,모욕감/Noun,13,0,13,0.0,0.00014438989714996557,1.0
8707,질색/Noun,13,0,13,0.0,0.00014438989714996557,1.0
8708,최우식/Noun,13,13,0,0.00014449903296801013,0.0,1.0
8709,오호/Exclamation,13,12,1,0.00013338372273970166,1.1106915165381966e-05,0.9230769230769231
8710,무뇌/Noun,13,1,12,1.1115310228308472e-05,0.0001332829819845836,0.9230769230769231
8711,전날/Noun,13,12,1,0.00013338372273970166,1.1106915165381966e-05,0.9230769230769231
8712,잠듬/Noun,13,1,12,1.1115310228308472e-05,0.0001332829819845836,0.9230769230769231
8713,사뭇/Noun,13,12,1,0.00013338372273970166,1.1106915165381966e-05,0.9230769230769231
8714,ㅅㄲ/KoreanParticle,13,1,12,1.1115310228308472e-05,0.0001332829819845836,0.9230769230769231
8715,life/Alpha,13,12,1,0.00013338372273970166,1.1106915165381966e-05,0.9230769230769231
8716,상남자/Noun,13,12,1,0.00013338372273970166,1.1106915165381966e-05,0.9230769230769231
8717,툭하면/Noun,13,1,12,1.1115310228308472e-05,0.0001332829819845836,0.9230769230769231
8718,Cg/Alpha,13,1,12,1.1115310228308472e-05,0.0001332829819845836,0.9230769230769231
8719,이창동/Noun,13,12,1,0.00013338372273970166,1.1106915165381966e-05,0.9230769230769231
8720,노망/Noun,13,1,12,1.1115310228308472e-05,0.0001332829819845836,0.9230769230769231
8721,로빈윌리엄스/Noun,13,12,1,0.00013338372273970166,1.1106915165381966e-05,0.9230769230769231
8722,박기웅/Noun,13,12,1,0.00013338372273970166,1.1106915165381966e-05,0.9230769230769231
8723,한스/Noun,13,12,1,0.00013338372273970166,1.1106915165381966e-05,0.9230769230769231
8724,괜춘/Noun,13,12,1,0.00013338372273970166,1.1106915165381966e-05,0.9230769230769231
8725,아낌없이/Adverb,13,12,1,0.00013338372273970166,1.1106915165381966e-05,0.9230769230769231
8726,잘껄/Noun,13,1,12,1.1115310228308472e-05,0.0001332829819845836,0.9230769230769231
8727,미끼/Noun,13,1,12,1.1115310228308472e-05,0.0001332829819845836,0.9230769230769231
8728,밋밋/Noun,13,1,12,1.1115310228308472e-05,0.0001332829819845836,0.9230769230769231
8729,휴그랜트/Noun,13,12,1,0.00013338372273970166,1.1106915165381966e-05,0.9230769230769231
8730,분단/Noun,13,12,1,0.00013338372273970166,1.1106915165381966e-05,0.9230769230769231
8731,on/Alpha,13,12,1,0.00013338372273970166,1.1106915165381966e-05,0.9230769230769231
8732,타오르다/Verb,13,12,1,0.00013338372273970166,1.1106915165381966e-05,0.9230769230769231
8733,퉷/Noun,13,1,12,1.1115310228308472e-05,0.0001332829819845836,0.9230769230769231
8734,삭막하다/Adjective,13,12,1,0.00013338372273970166,1.1106915165381966e-05,0.9230769230769231
8735,쯔쯔/Noun,13,1,12,1.1115310228308472e-05,0.0001332829819845836,0.9230769230769231
8736,로건/Noun,13,12,1,0.00013338372273970166,1.1106915165381966e-05,0.9230769230769231
8737,따분함/Noun,13,1,12,1.1115310228308472e-05,0.0001332829819845836,0.9230769230769231
8738,바르뎀/Noun,13,12,1,0.00013338372273970166,1.1106915165381966e-05,0.9230769230769231
8739,쯧/Exclamation,13,2,11,2.2230620456616944e-05,0.00012217606681920164,0.8461538461538461
8740,쯧쯧/Exclamation,13,2,11,2.2230620456616944e-05,0.00012217606681920164,0.8461538461538461
8741,기껏/Noun,13,2,11,2.2230620456616944e-05,0.00012217606681920164,0.8461538461538461
8742,하기는/Adverb,13,2,11,2.2230620456616944e-05,0.00012217606681920164,0.8461538461538461
8743,.!!!/Punctuation,13,11,2,0.00012226841251139318,2.2213830330763933e-05,0.8461538461538461
8744,별도/Noun,13,2,11,2.2230620456616944e-05,0.00012217606681920164,0.8461538461538461
8745,캠코더/Noun,13,2,11,2.2230620456616944e-05,0.00012217606681920164,0.8461538461538461
8746,방구/Noun,13,2,11,2.2230620456616944e-05,0.00012217606681920164,0.8461538461538461
8747,요런/Noun,13,11,2,0.00012226841251139318,2.2213830330763933e-05,0.8461538461538461
8748,분전/Noun,13,2,11,2.2230620456616944e-05,0.00012217606681920164,0.8461538461538461
8749,부당하다/Adjective,13,11,2,0.00012226841251139318,2.2213830330763933e-05,0.8461538461538461
8750,당근/Noun,13,11,2,0.00012226841251139318,2.2213830330763933e-05,0.8461538461538461
8751,독립영화관/Noun,13,11,2,0.00012226841251139318,2.2213830330763933e-05,0.8461538461538461
8752,농촌/Noun,13,11,2,0.00012226841251139318,2.2213830330763933e-05,0.8461538461538461
8753,델피/Noun,13,11,2,0.00012226841251139318,2.2213830330763933e-05,0.8461538461538461
8754,은정/Noun,13,2,11,2.2230620456616944e-05,0.00012217606681920164,0.8461538461538461
8755,지모/Noun,13,11,2,0.00012226841251139318,2.2213830330763933e-05,0.8461538461538461
8756,캠/Noun,13,2,11,2.2230620456616944e-05,0.00012217606681920164,0.8461538461538461
8757,반한/Noun,13,11,2,0.00012226841251139318,2.2213830330763933e-05,0.8461538461538461
8758,빽/Noun,13,2,11,2.2230620456616944e-05,0.00012217606681920164,0.8461538461538461
8759,래미/Noun,13,2,11,2.2230620456616944e-05,0.00012217606681920164,0.8461538461538461
8760,브랜든/Noun,13,11,2,0.00012226841251139318,2.2213830330763933e-05,0.8461538461538461
8761,깍/Noun,13,2,11,2.2230620456616944e-05,0.00012217606681920164,0.8461538461538461
8762,애착/Noun,13,11,2,0.00012226841251139318,2.2213830330763933e-05,0.8461538461538461
8763,재밌슴/Noun,13,11,2,0.00012226841251139318,2.2213830330763933e-05,0.8461538461538461
8764,핑/Noun,13,11,2,0.00012226841251139318,2.2213830330763933e-05,0.8461538461538461
8765,극악/Noun,13,2,11,2.2230620456616944e-05,0.00012217606681920164,0.8461538461538461
8766,해피앤딩/Noun,13,11,2,0.00012226841251139318,2.2213830330763933e-05,0.8461538461538461
8767,기인/Noun,13,2,11,2.2230620456616944e-05,0.00012217606681920164,0.8461538461538461
8768,돈벌이/Noun,13,2,11,2.2230620456616944e-05,0.00012217606681920164,0.8461538461538461
8769,정감/Noun,13,11,2,0.00012226841251139318,2.2213830330763933e-05,0.8461538461538461
8770,흡인/Noun,13,11,2,0.00012226841251139318,2.2213830330763933e-05,0.8461538461538461
8771,삼각관계/Noun,13,2,11,2.2230620456616944e-05,0.00012217606681920164,0.8461538461538461
8772,특촬물/Noun,13,2,11,2.2230620456616944e-05,0.00012217606681920164,0.8461538461538461
8773,디도/Noun,13,2,11,2.2230620456616944e-05,0.00012217606681920164,0.8461538461538461
8774,야심/Noun,13,2,11,2.2230620456616944e-05,0.00012217606681920164,0.8461538461538461
8775,블레어/Noun,13,2,11,2.2230620456616944e-05,0.00012217606681920164,0.8461538461538461
8776,부리고/Noun,13,2,11,2.2230620456616944e-05,0.00012217606681920164,0.8461538461538461
8777,반대편/Noun,13,11,2,0.00012226841251139318,2.2213830330763933e-05,0.8461538461538461
8778,습니/Noun,13,11,2,0.00012226841251139318,2.2213830330763933e-05,0.8461538461538461
8779,무스/Noun,13,11,2,0.00012226841251139318,2.2213830330763933e-05,0.8461538461538461
8780,REC/Alpha,13,2,11,2.2230620456616944e-05,0.00012217606681920164,0.8461538461538461
8781,꼽는다/Noun,13,11,2,0.00012226841251139318,2.2213830330763933e-05,0.8461538461538461
8782,정은지/Noun,13,11,2,0.00012226841251139318,2.2213830330763933e-05,0.8461538461538461
8783,분발/Noun,13,2,11,2.2230620456616944e-05,0.00012217606681920164,0.8461538461538461
8784,4~5/Number,13,2,11,2.2230620456616944e-05,0.00012217606681920164,0.8461538461538461
8785,애매모호하다/Adjective,13,2,11,2.2230620456616944e-05,0.00012217606681920164,0.8461538461538461
8786,업자/Noun,13,2,11,2.2230620456616944e-05,0.00012217606681920164,0.8461538461538461
8787,버프/Noun,13,2,11,2.2230620456616944e-05,0.00012217606681920164,0.8461538461538461
8788,코비/Noun,13,11,2,0.00012226841251139318,2.2213830330763933e-05,0.8461538461538461
8789,썸띵/Noun,13,2,11,2.2230620456616944e-05,0.00012217606681920164,0.8461538461538461
8790,김정훈/Noun,13,3,10,3.3345930684925414e-05,0.00011106915165381967,0.7692307692307693
8791,소감/Noun,13,3,10,3.3345930684925414e-05,0.00011106915165381967,0.7692307692307693
8792,외로워/Noun,13,10,3,0.00011115310228308472,3.33207454961459e-05,0.7692307692307693
8793,imdb/Alpha,13,3,10,3.3345930684925414e-05,0.00011106915165381967,0.7692307692307693
8794,!!!!!!!!!!!!!/Punctuation,13,10,3,0.00011115310228308472,3.33207454961459e-05,0.7692307692307693
8795,점령/Noun,13,3,10,3.3345930684925414e-05,0.00011106915165381967,0.7692307692307693
8796,캠프/Noun,13,3,10,3.3345930684925414e-05,0.00011106915165381967,0.7692307692307693
8797,숨소리/Noun,13,10,3,0.00011115310228308472,3.33207454961459e-05,0.7692307692307693
8798,거림/Noun,13,10,3,0.00011115310228308472,3.33207454961459e-05,0.7692307692307693
8799,도쿄/Noun,13,10,3,0.00011115310228308472,3.33207454961459e-05,0.7692307692307693
8800,....^^/Punctuation,13,10,3,0.00011115310228308472,3.33207454961459e-05,0.7692307692307693
8801,욥/Noun,13,10,3,0.00011115310228308472,3.33207454961459e-05,0.7692307692307693
8802,인주/Noun,13,3,10,3.3345930684925414e-05,0.00011106915165381967,0.7692307692307693
8803,평가절하/Noun,13,10,3,0.00011115310228308472,3.33207454961459e-05,0.7692307692307693
8804,노홍철/Noun,13,10,3,0.00011115310228308472,3.33207454961459e-05,0.7692307692307693
8805,굴곡/Noun,13,3,10,3.3345930684925414e-05,0.00011106915165381967,0.7692307692307693
8806,소문나다/Verb,13,3,10,3.3345930684925414e-05,0.00011106915165381967,0.7692307692307693
8807,십자/Noun,13,3,10,3.3345930684925414e-05,0.00011106915165381967,0.7692307692307693
8808,쩔/Noun,13,10,3,0.00011115310228308472,3.33207454961459e-05,0.7692307692307693
8809,맛깔/Noun,13,10,3,0.00011115310228308472,3.33207454961459e-05,0.7692307692307693
8810,서유리/Noun,13,3,10,3.3345930684925414e-05,0.00011106915165381967,0.7692307692307693
8811,햐/Noun,13,3,10,3.3345930684925414e-05,0.00011106915165381967,0.7692307692307693
8812,끝임/Noun,13,3,10,3.3345930684925414e-05,0.00011106915165381967,0.7692307692307693
8813,복사/Noun,13,3,10,3.3345930684925414e-05,0.00011106915165381967,0.7692307692307693
8814,조미/Noun,13,10,3,0.00011115310228308472,3.33207454961459e-05,0.7692307692307693
8815,수염/Noun,13,3,10,3.3345930684925414e-05,0.00011106915165381967,0.7692307692307693
8816,빡/Noun,13,3,10,3.3345930684925414e-05,0.00011106915165381967,0.7692307692307693
8817,카렐/Noun,13,10,3,0.00011115310228308472,3.33207454961459e-05,0.7692307692307693
8818,간의/Foreign,13,10,3,0.00011115310228308472,3.33207454961459e-05,0.7692307692307693
8819,이재은/Noun,13,3,10,3.3345930684925414e-05,0.00011106915165381967,0.7692307692307693
8820,배출/Noun,13,10,3,0.00011115310228308472,3.33207454961459e-05,0.7692307692307693
8821,누리/Noun,13,10,3,0.00011115310228308472,3.33207454961459e-05,0.7692307692307693
8822,비겁하다/Adjective,13,3,10,3.3345930684925414e-05,0.00011106915165381967,0.7692307692307693
8823,부들부들/Noun,13,3,10,3.3345930684925414e-05,0.00011106915165381967,0.7692307692307693
8824,수트/Noun,13,10,3,0.00011115310228308472,3.33207454961459e-05,0.7692307692307693
8825,뻑/Noun,13,3,10,3.3345930684925414e-05,0.00011106915165381967,0.7692307692307693
8826,기수/Noun,13,3,10,3.3345930684925414e-05,0.00011106915165381967,0.7692307692307693
8827,스럽지도/Josa,13,3,10,3.3345930684925414e-05,0.00011106915165381967,0.7692307692307693
8828,예언/Noun,13,10,3,0.00011115310228308472,3.33207454961459e-05,0.7692307692307693
8829,120/Number,13,3,10,3.3345930684925414e-05,0.00011106915165381967,0.7692307692307693
8830,넘어오다/Verb,13,3,10,3.3345930684925414e-05,0.00011106915165381967,0.7692307692307693
8831,히트치다/Verb,13,3,10,3.3345930684925414e-05,0.00011106915165381967,0.7692307692307693
8832,고창석/Noun,13,3,10,3.3345930684925414e-05,0.00011106915165381967,0.7692307692307693
8833,조로/Noun,13,3,10,3.3345930684925414e-05,0.00011106915165381967,0.7692307692307693
8834,안대/Noun,13,3,10,3.3345930684925414e-05,0.00011106915165381967,0.7692307692307693
8835,선장/Noun,13,10,3,0.00011115310228308472,3.33207454961459e-05,0.7692307692307693
8836,시적/Noun,13,10,3,0.00011115310228308472,3.33207454961459e-05,0.7692307692307693
8837,방송사/Noun,13,3,10,3.3345930684925414e-05,0.00011106915165381967,0.7692307692307693
8838,국경/Noun,13,10,3,0.00011115310228308472,3.33207454961459e-05,0.7692307692307693
8839,버디/Noun,13,10,3,0.00011115310228308472,3.33207454961459e-05,0.7692307692307693
8840,신체/Noun,13,3,10,3.3345930684925414e-05,0.00011106915165381967,0.7692307692307693
8841,마리옹/Noun,13,10,3,0.00011115310228308472,3.33207454961459e-05,0.7692307692307693
8842,만끽/Noun,13,10,3,0.00011115310228308472,3.33207454961459e-05,0.7692307692307693
8843,봉하/Noun,13,10,3,0.00011115310228308472,3.33207454961459e-05,0.7692307692307693
8844,재개/Noun,13,10,3,0.00011115310228308472,3.33207454961459e-05,0.7692307692307693
8845,살찌다/Adjective,13,3,10,3.3345930684925414e-05,0.00011106915165381967,0.7692307692307693
8846,무의식/Noun,13,10,3,0.00011115310228308472,3.33207454961459e-05,0.7692307692307693
8847,워킹/Noun,13,3,10,3.3345930684925414e-05,0.00011106915165381967,0.7692307692307693
8848,우산/Noun,13,10,3,0.00011115310228308472,3.33207454961459e-05,0.7692307692307693
8849,1960년/Number,13,3,10,3.3345930684925414e-05,0.00011106915165381967,0.7692307692307693
8850,영원/Noun,13,10,3,0.00011115310228308472,3.33207454961459e-05,0.7692307692307693
8851,마리아/Noun,13,10,3,0.00011115310228308472,3.33207454961459e-05,0.7692307692307693
8852,계절/Noun,13,10,3,0.00011115310228308472,3.33207454961459e-05,0.7692307692307693
8853,최루성/Noun,13,4,9,4.446124091323389e-05,9.99622364884377e-05,0.6923076923076923
8854,손길/Noun,13,9,4,0.00010003779205477625,4.4427660661527865e-05,0.6923076923076923
8855,한고은/Noun,13,4,9,4.446124091323389e-05,9.99622364884377e-05,0.6923076923076923
8856,문란하다/Adjective,13,4,9,4.446124091323389e-05,9.99622364884377e-05,0.6923076923076923
8857,꺅/Adverb,13,9,4,0.00010003779205477625,4.4427660661527865e-05,0.6923076923076923
8858,이영환/Noun,13,4,9,4.446124091323389e-05,9.99622364884377e-05,0.6923076923076923
8859,미취/Noun,13,4,9,4.446124091323389e-05,9.99622364884377e-05,0.6923076923076923
8860,갑옷/Noun,13,4,9,4.446124091323389e-05,9.99622364884377e-05,0.6923076923076923
8861,가르시아/Noun,13,9,4,0.00010003779205477625,4.4427660661527865e-05,0.6923076923076923
8862,이어도/Noun,13,9,4,0.00010003779205477625,4.4427660661527865e-05,0.6923076923076923
8863,천안함/Noun,13,4,9,4.446124091323389e-05,9.99622364884377e-05,0.6923076923076923
8864,하류/Noun,13,4,9,4.446124091323389e-05,9.99622364884377e-05,0.6923076923076923
8865,나미/Noun,13,4,9,4.446124091323389e-05,9.99622364884377e-05,0.6923076923076923
8866,엿/Noun,13,4,9,4.446124091323389e-05,9.99622364884377e-05,0.6923076923076923
8867,아찔하다/Adjective,13,9,4,0.00010003779205477625,4.4427660661527865e-05,0.6923076923076923
8868,소신/Noun,13,9,4,0.00010003779205477625,4.4427660661527865e-05,0.6923076923076923
8869,엘리/Noun,13,9,4,0.00010003779205477625,4.4427660661527865e-05,0.6923076923076923
8870,로미오/Noun,13,9,4,0.00010003779205477625,4.4427660661527865e-05,0.6923076923076923
8871,이씨/Noun,13,4,9,4.446124091323389e-05,9.99622364884377e-05,0.6923076923076923
8872,모모/Noun,13,4,9,4.446124091323389e-05,9.99622364884377e-05,0.6923076923076923
8873,비율/Noun,13,4,9,4.446124091323389e-05,9.99622364884377e-05,0.6923076923076923
8874,게이트/Noun,13,9,4,0.00010003779205477625,4.4427660661527865e-05,0.6923076923076923
8875,5.5/Number,13,4,9,4.446124091323389e-05,9.99622364884377e-05,0.6923076923076923
8876,고대/Noun,13,9,4,0.00010003779205477625,4.4427660661527865e-05,0.6923076923076923
8877,인가/Foreign,13,9,4,0.00010003779205477625,4.4427660661527865e-05,0.6923076923076923
8878,첩혈쌍웅/Noun,13,9,4,0.00010003779205477625,4.4427660661527865e-05,0.6923076923076923
8879,무쟈/Noun,13,4,9,4.446124091323389e-05,9.99622364884377e-05,0.6923076923076923
8880,왕가네/Noun,13,4,9,4.446124091323389e-05,9.99622364884377e-05,0.6923076923076923
8881,gg/Alpha,13,4,9,4.446124091323389e-05,9.99622364884377e-05,0.6923076923076923
8882,가출/Noun,13,4,9,4.446124091323389e-05,9.99622364884377e-05,0.6923076923076923
8883,캔디/Noun,13,9,4,0.00010003779205477625,4.4427660661527865e-05,0.6923076923076923
8884,취업/Noun,13,9,4,0.00010003779205477625,4.4427660661527865e-05,0.6923076923076923
8885,장통/Noun,13,9,4,0.00010003779205477625,4.4427660661527865e-05,0.6923076923076923
8886,조온나/Noun,13,4,9,4.446124091323389e-05,9.99622364884377e-05,0.6923076923076923
8887,설교/Noun,13,4,9,4.446124091323389e-05,9.99622364884377e-05,0.6923076923076923
8888,애증/Noun,13,9,4,0.00010003779205477625,4.4427660661527865e-05,0.6923076923076923
8889,빼앗다/Verb,13,4,9,4.446124091323389e-05,9.99622364884377e-05,0.6923076923076923
8890,강인/Noun,13,4,9,4.446124091323389e-05,9.99622364884377e-05,0.6923076923076923
8891,약점/Noun,13,4,9,4.446124091323389e-05,9.99622364884377e-05,0.6923076923076923
8892,올라서다/Verb,13,9,4,0.00010003779205477625,4.4427660661527865e-05,0.6923076923076923
8893,BEST/Alpha,13,9,4,0.00010003779205477625,4.4427660661527865e-05,0.6923076923076923
8894,왜냐하면/Adverb,13,9,4,0.00010003779205477625,4.4427660661527865e-05,0.6923076923076923
8895,훑다/Verb,13,4,9,4.446124091323389e-05,9.99622364884377e-05,0.6923076923076923
8896,동해/Noun,13,4,9,4.446124091323389e-05,9.99622364884377e-05,0.6923076923076923
8897,휴일/Noun,13,9,4,0.00010003779205477625,4.4427660661527865e-05,0.6923076923076923
8898,주된/Modifier,13,4,9,4.446124091323389e-05,9.99622364884377e-05,0.6923076923076923
8899,불사신/Noun,13,4,9,4.446124091323389e-05,9.99622364884377e-05,0.6923076923076923
8900,선악/Noun,13,9,4,0.00010003779205477625,4.4427660661527865e-05,0.6923076923076923
8901,공평하다/Adjective,13,9,4,0.00010003779205477625,4.4427660661527865e-05,0.6923076923076923
8902,신경안/Noun,13,4,9,4.446124091323389e-05,9.99622364884377e-05,0.6923076923076923
8903,성취/Noun,13,9,4,0.00010003779205477625,4.4427660661527865e-05,0.6923076923076923
8904,근원/Noun,13,9,4,0.00010003779205477625,4.4427660661527865e-05,0.6923076923076923
8905,민아/Noun,13,9,4,0.00010003779205477625,4.4427660661527865e-05,0.6923076923076923
8906,알렌/Noun,13,9,4,0.00010003779205477625,4.4427660661527865e-05,0.6923076923076923
8907,광수/Noun,13,4,9,4.446124091323389e-05,9.99622364884377e-05,0.6923076923076923
8908,시급하다/Adjective,13,4,9,4.446124091323389e-05,9.99622364884377e-05,0.6923076923076923
8909,남극/Noun,13,9,4,0.00010003779205477625,4.4427660661527865e-05,0.6923076923076923
8910,절벽/Noun,13,4,9,4.446124091323389e-05,9.99622364884377e-05,0.6923076923076923
8911,브레드/Noun,13,4,9,4.446124091323389e-05,9.99622364884377e-05,0.6923076923076923
8912,실현/Noun,13,9,4,0.00010003779205477625,4.4427660661527865e-05,0.6923076923076923
8913,아부지/Noun,13,9,4,0.00010003779205477625,4.4427660661527865e-05,0.6923076923076923
8914,27/Number,13,9,4,0.00010003779205477625,4.4427660661527865e-05,0.6923076923076923
8915,노출씬/Noun,13,4,9,4.446124091323389e-05,9.99622364884377e-05,0.6923076923076923
8916,달려들다/Verb,13,4,9,4.446124091323389e-05,9.99622364884377e-05,0.6923076923076923
8917,문어/Noun,13,4,9,4.446124091323389e-05,9.99622364884377e-05,0.6923076923076923
8918,동반/Noun,13,9,4,0.00010003779205477625,4.4427660661527865e-05,0.6923076923076923
8919,♪/Foreign,13,9,4,0.00010003779205477625,4.4427660661527865e-05,0.6923076923076923
8920,최다니엘/Noun,13,9,4,0.00010003779205477625,4.4427660661527865e-05,0.6923076923076923
8921,차량/Noun,13,4,9,4.446124091323389e-05,9.99622364884377e-05,0.6923076923076923
8922,주도/Noun,13,4,9,4.446124091323389e-05,9.99622364884377e-05,0.6923076923076923
8923,히든싱어/Noun,13,9,4,0.00010003779205477625,4.4427660661527865e-05,0.6923076923076923
8924,마자/Noun,13,4,9,4.446124091323389e-05,9.99622364884377e-05,0.6923076923076923
8925,시공간/Noun,13,9,4,0.00010003779205477625,4.4427660661527865e-05,0.6923076923076923
8926,신작/Noun,13,4,9,4.446124091323389e-05,9.99622364884377e-05,0.6923076923076923
8927,기여/Noun,13,9,4,0.00010003779205477625,4.4427660661527865e-05,0.6923076923076923
8928,른/Noun,13,9,4,0.00010003779205477625,4.4427660661527865e-05,0.6923076923076923
8929,수백/Modifier,13,4,9,4.446124091323389e-05,9.99622364884377e-05,0.6923076923076923
8930,무덥다/Adjective,13,9,4,0.00010003779205477625,4.4427660661527865e-05,0.6923076923076923
8931,김인권/Noun,13,4,9,4.446124091323389e-05,9.99622364884377e-05,0.6923076923076923
8932,성별/Noun,13,4,9,4.446124091323389e-05,9.99622364884377e-05,0.6923076923076923
8933,오징어/Noun,13,4,9,4.446124091323389e-05,9.99622364884377e-05,0.6923076923076923
8934,허드/Noun,13,4,9,4.446124091323389e-05,9.99622364884377e-05,0.6923076923076923
8935,치정/Noun,13,4,9,4.446124091323389e-05,9.99622364884377e-05,0.6923076923076923
8936,회도/Noun,13,9,4,0.00010003779205477625,4.4427660661527865e-05,0.6923076923076923
8937,구가/Noun,13,4,9,4.446124091323389e-05,9.99622364884377e-05,0.6923076923076923
8938,에어컨/Noun,13,5,8,5.557655114154236e-05,8.885532132305573e-05,0.6153846153846154
8939,최면/Noun,13,5,8,5.557655114154236e-05,8.885532132305573e-05,0.6153846153846154
8940,더락/Noun,13,8,5,8.892248182646778e-05,5.5534575826909837e-05,0.6153846153846154
8941,찾아내다/Verb,13,8,5,8.892248182646778e-05,5.5534575826909837e-05,0.6153846153846154
8942,자리다/Adjective,13,8,5,8.892248182646778e-05,5.5534575826909837e-05,0.6153846153846154
8943,힝/Noun,13,8,5,8.892248182646778e-05,5.5534575826909837e-05,0.6153846153846154
8944,으이/Adverb,13,5,8,5.557655114154236e-05,8.885532132305573e-05,0.6153846153846154
8945,스시/Noun,13,8,5,8.892248182646778e-05,5.5534575826909837e-05,0.6153846153846154
8946,비도/Noun,13,8,5,8.892248182646778e-05,5.5534575826909837e-05,0.6153846153846154
8947,특공대/Noun,13,5,8,5.557655114154236e-05,8.885532132305573e-05,0.6153846153846154
8948,고다르/Noun,13,8,5,8.892248182646778e-05,5.5534575826909837e-05,0.6153846153846154
8949,아나운서/Noun,13,5,8,5.557655114154236e-05,8.885532132305573e-05,0.6153846153846154
8950,저주받다/Verb,13,5,8,5.557655114154236e-05,8.885532132305573e-05,0.6153846153846154
8951,정면/Noun,13,8,5,8.892248182646778e-05,5.5534575826909837e-05,0.6153846153846154
8952,썸머/Noun,13,8,5,8.892248182646778e-05,5.5534575826909837e-05,0.6153846153846154
8953,조성/Noun,13,5,8,5.557655114154236e-05,8.885532132305573e-05,0.6153846153846154
8954,모에/Noun,13,5,8,5.557655114154236e-05,8.885532132305573e-05,0.6153846153846154
8955,범죄물/Noun,13,5,8,5.557655114154236e-05,8.885532132305573e-05,0.6153846153846154
8956,엇을/Noun,13,5,8,5.557655114154236e-05,8.885532132305573e-05,0.6153846153846154
8957,해군/Noun,13,8,5,8.892248182646778e-05,5.5534575826909837e-05,0.6153846153846154
8958,아우라/Noun,13,5,8,5.557655114154236e-05,8.885532132305573e-05,0.6153846153846154
8959,마나/Noun,13,5,8,5.557655114154236e-05,8.885532132305573e-05,0.6153846153846154
8960,구별/Noun,13,5,8,5.557655114154236e-05,8.885532132305573e-05,0.6153846153846154
8961,>./Punctuation,13,8,5,8.892248182646778e-05,5.5534575826909837e-05,0.6153846153846154
8962,중립/Noun,13,5,8,5.557655114154236e-05,8.885532132305573e-05,0.6153846153846154
8963,멕시코/Noun,13,5,8,5.557655114154236e-05,8.885532132305573e-05,0.6153846153846154
8964,솔직/Noun,13,8,5,8.892248182646778e-05,5.5534575826909837e-05,0.6153846153846154
8965,언덕/Noun,13,8,5,8.892248182646778e-05,5.5534575826909837e-05,0.6153846153846154
8966,오케스트라/Noun,13,8,5,8.892248182646778e-05,5.5534575826909837e-05,0.6153846153846154
8967,해병대/Noun,13,5,8,5.557655114154236e-05,8.885532132305573e-05,0.6153846153846154
8968,아악/Noun,13,5,8,5.557655114154236e-05,8.885532132305573e-05,0.6153846153846154
8969,필드/Noun,13,5,8,5.557655114154236e-05,8.885532132305573e-05,0.6153846153846154
8970,머랄/Noun,13,5,8,5.557655114154236e-05,8.885532132305573e-05,0.6153846153846154
8971,프로포즈/Noun,13,8,5,8.892248182646778e-05,5.5534575826909837e-05,0.6153846153846154
8972,드레스/Noun,13,5,8,5.557655114154236e-05,8.885532132305573e-05,0.6153846153846154
8973,골고루/Adverb,13,8,5,8.892248182646778e-05,5.5534575826909837e-05,0.6153846153846154
8974,건아/Noun,13,5,8,5.557655114154236e-05,8.885532132305573e-05,0.6153846153846154
8975,재목/Noun,13,5,8,5.557655114154236e-05,8.885532132305573e-05,0.6153846153846154
8976,난도질/Noun,13,5,8,5.557655114154236e-05,8.885532132305573e-05,0.6153846153846154
8977,km/Alpha,13,5,8,5.557655114154236e-05,8.885532132305573e-05,0.6153846153846154
8978,에이즈/Noun,13,5,8,5.557655114154236e-05,8.885532132305573e-05,0.6153846153846154
8979,소속/Noun,13,5,8,5.557655114154236e-05,8.885532132305573e-05,0.6153846153846154
8980,관찰/Noun,13,8,5,8.892248182646778e-05,5.5534575826909837e-05,0.6153846153846154
8981,벨소리/Noun,13,5,8,5.557655114154236e-05,8.885532132305573e-05,0.6153846153846154
8982,전우치/Noun,13,8,5,8.892248182646778e-05,5.5534575826909837e-05,0.6153846153846154
8983,FBI/Alpha,13,5,8,5.557655114154236e-05,8.885532132305573e-05,0.6153846153846154
8984,라이벌/Noun,13,8,5,8.892248182646778e-05,5.5534575826909837e-05,0.6153846153846154
8985,방문/Noun,13,5,8,5.557655114154236e-05,8.885532132305573e-05,0.6153846153846154
8986,떳떳하다/Adjective,13,8,5,8.892248182646778e-05,5.5534575826909837e-05,0.6153846153846154
8987,어느덧다/Adjective,13,8,5,8.892248182646778e-05,5.5534575826909837e-05,0.6153846153846154
8988,브리트니/Noun,13,8,5,8.892248182646778e-05,5.5534575826909837e-05,0.6153846153846154
8989,로망스/Noun,13,8,5,8.892248182646778e-05,5.5534575826909837e-05,0.6153846153846154
8990,돌보다/Verb,13,8,5,8.892248182646778e-05,5.5534575826909837e-05,0.6153846153846154
8991,아지/Noun,13,5,8,5.557655114154236e-05,8.885532132305573e-05,0.6153846153846154
8992,타카/Noun,13,8,5,8.892248182646778e-05,5.5534575826909837e-05,0.6153846153846154
8993,바이/Noun,13,8,5,8.892248182646778e-05,5.5534575826909837e-05,0.6153846153846154
8994,몇십/Modifier,13,5,8,5.557655114154236e-05,8.885532132305573e-05,0.6153846153846154
8995,사탕/Noun,13,5,8,5.557655114154236e-05,8.885532132305573e-05,0.6153846153846154
8996,무너/Noun,13,5,8,5.557655114154236e-05,8.885532132305573e-05,0.6153846153846154
8997,??????/Punctuation,13,5,8,5.557655114154236e-05,8.885532132305573e-05,0.6153846153846154
8998,참가자/Noun,13,5,8,5.557655114154236e-05,8.885532132305573e-05,0.6153846153846154
8999,창의력/Noun,13,5,8,5.557655114154236e-05,8.885532132305573e-05,0.6153846153846154
9000,산악/Noun,13,8,5,8.892248182646778e-05,5.5534575826909837e-05,0.6153846153846154
9001,하진/Noun,13,8,5,8.892248182646778e-05,5.5534575826909837e-05,0.6153846153846154
9002,밨는데/Noun,13,8,5,8.892248182646778e-05,5.5534575826909837e-05,0.6153846153846154
9003,양자경/Noun,13,8,5,8.892248182646778e-05,5.5534575826909837e-05,0.6153846153846154
9004,가만/Adverb,13,5,8,5.557655114154236e-05,8.885532132305573e-05,0.6153846153846154
9005,맨몸/Noun,13,8,5,8.892248182646778e-05,5.5534575826909837e-05,0.6153846153846154
9006,오전/Noun,13,5,8,5.557655114154236e-05,8.885532132305573e-05,0.6153846153846154
9007,해당/Noun,13,5,8,5.557655114154236e-05,8.885532132305573e-05,0.6153846153846154
9008,수의/Noun,13,5,8,5.557655114154236e-05,8.885532132305573e-05,0.6153846153846154
9009,타이/Noun,13,8,5,8.892248182646778e-05,5.5534575826909837e-05,0.6153846153846154
9010,박지성/Noun,13,8,5,8.892248182646778e-05,5.5534575826909837e-05,0.6153846153846154
9011,대체로/Noun,13,5,8,5.557655114154236e-05,8.885532132305573e-05,0.6153846153846154
9012,ㅊ/KoreanParticle,13,8,5,8.892248182646778e-05,5.5534575826909837e-05,0.6153846153846154
9013,차례/Noun,13,5,8,5.557655114154236e-05,8.885532132305573e-05,0.6153846153846154
9014,동굴/Noun,13,5,8,5.557655114154236e-05,8.885532132305573e-05,0.6153846153846154
9015,눈썹/Noun,13,5,8,5.557655114154236e-05,8.885532132305573e-05,0.6153846153846154
9016,코미/Noun,13,8,5,8.892248182646778e-05,5.5534575826909837e-05,0.6153846153846154
9017,원주민/Noun,13,5,8,5.557655114154236e-05,8.885532132305573e-05,0.6153846153846154
9018,이론/Noun,13,6,7,6.669186136985083e-05,7.774840615767377e-05,0.5384615384615384
9019,테니스/Noun,13,6,7,6.669186136985083e-05,7.774840615767377e-05,0.5384615384615384
9020,123/Number,13,6,7,6.669186136985083e-05,7.774840615767377e-05,0.5384615384615384
9021,전직/Noun,13,6,7,6.669186136985083e-05,7.774840615767377e-05,0.5384615384615384
9022,박영규/Noun,13,7,6,7.78071715981593e-05,6.66414909922918e-05,0.5384615384615384
9023,생명체/Noun,13,6,7,6.669186136985083e-05,7.774840615767377e-05,0.5384615384615384
9024,신드롬/Noun,13,6,7,6.669186136985083e-05,7.774840615767377e-05,0.5384615384615384
9025,10만/Number,13,6,7,6.669186136985083e-05,7.774840615767377e-05,0.5384615384615384
9026,달려오다/Verb,13,7,6,7.78071715981593e-05,6.66414909922918e-05,0.5384615384615384
9027,마주치다/Verb,13,6,7,6.669186136985083e-05,7.774840615767377e-05,0.5384615384615384
9028,화로/Noun,13,7,6,7.78071715981593e-05,6.66414909922918e-05,0.5384615384615384
9029,백진희/Noun,13,7,6,7.78071715981593e-05,6.66414909922918e-05,0.5384615384615384
9030,단절/Noun,13,6,7,6.669186136985083e-05,7.774840615767377e-05,0.5384615384615384
9031,둘러싸다/Verb,13,7,6,7.78071715981593e-05,6.66414909922918e-05,0.5384615384615384
9032,적히다/Verb,13,6,7,6.669186136985083e-05,7.774840615767377e-05,0.5384615384615384
9033,에서/Foreign,13,6,7,6.669186136985083e-05,7.774840615767377e-05,0.5384615384615384
9034,착/Noun,13,6,7,6.669186136985083e-05,7.774840615767377e-05,0.5384615384615384
9035,6회/Number,13,6,7,6.669186136985083e-05,7.774840615767377e-05,0.5384615384615384
9036,아하/Noun,13,7,6,7.78071715981593e-05,6.66414909922918e-05,0.5384615384615384
9037,복원/Noun,13,7,6,7.78071715981593e-05,6.66414909922918e-05,0.5384615384615384
9038,역설/Noun,13,6,7,6.669186136985083e-05,7.774840615767377e-05,0.5384615384615384
9039,엑스파일/Noun,13,6,7,6.669186136985083e-05,7.774840615767377e-05,0.5384615384615384
9040,어가/Noun,13,7,6,7.78071715981593e-05,6.66414909922918e-05,0.5384615384615384
9041,핏줄/Noun,13,6,7,6.669186136985083e-05,7.774840615767377e-05,0.5384615384615384
9042,행오버/Noun,13,6,7,6.669186136985083e-05,7.774840615767377e-05,0.5384615384615384
9043,쭉쭉/Noun,13,7,6,7.78071715981593e-05,6.66414909922918e-05,0.5384615384615384
9044,헤드/Noun,13,6,7,6.669186136985083e-05,7.774840615767377e-05,0.5384615384615384
9045,섭/Noun,13,7,6,7.78071715981593e-05,6.66414909922918e-05,0.5384615384615384
9046,야마/Noun,13,7,6,7.78071715981593e-05,6.66414909922918e-05,0.5384615384615384
9047,사리/Noun,13,7,6,7.78071715981593e-05,6.66414909922918e-05,0.5384615384615384
9048,연결하다/Adjective,13,6,7,6.669186136985083e-05,7.774840615767377e-05,0.5384615384615384
9049,답안/Noun,13,6,7,6.669186136985083e-05,7.774840615767377e-05,0.5384615384615384
9050,기네스/Noun,13,6,7,6.669186136985083e-05,7.774840615767377e-05,0.5384615384615384
9051,마이너/Noun,13,6,7,6.669186136985083e-05,7.774840615767377e-05,0.5384615384615384
9052,쩌리/Noun,13,6,7,6.669186136985083e-05,7.774840615767377e-05,0.5384615384615384
9053,이랑은/Josa,13,7,6,7.78071715981593e-05,6.66414909922918e-05,0.5384615384615384
9054,피나/Noun,13,7,6,7.78071715981593e-05,6.66414909922918e-05,0.5384615384615384
9055,미디어/Noun,13,7,6,7.78071715981593e-05,6.66414909922918e-05,0.5384615384615384
9056,김병만/Noun,13,7,6,7.78071715981593e-05,6.66414909922918e-05,0.5384615384615384
9057,우디알렌/Noun,13,7,6,7.78071715981593e-05,6.66414909922918e-05,0.5384615384615384
9058,잔잔/Noun,13,7,6,7.78071715981593e-05,6.66414909922918e-05,0.5384615384615384
9059,시기하다/Adjective,13,6,7,6.669186136985083e-05,7.774840615767377e-05,0.5384615384615384
9060,스튜어트/Noun,13,7,6,7.78071715981593e-05,6.66414909922918e-05,0.5384615384615384
9061,도시락/Noun,13,7,6,7.78071715981593e-05,6.66414909922918e-05,0.5384615384615384
9062,자락/Noun,13,6,7,6.669186136985083e-05,7.774840615767377e-05,0.5384615384615384
9063,방대하다/Adjective,13,7,6,7.78071715981593e-05,6.66414909922918e-05,0.5384615384615384
9064,의원/Noun,13,7,6,7.78071715981593e-05,6.66414909922918e-05,0.5384615384615384
9065,블럭버스터/Noun,13,6,7,6.669186136985083e-05,7.774840615767377e-05,0.5384615384615384
9066,공무원/Noun,13,6,7,6.669186136985083e-05,7.774840615767377e-05,0.5384615384615384
9067,한눈/Noun,13,6,7,6.669186136985083e-05,7.774840615767377e-05,0.5384615384615384
9068,찬성/Noun,13,7,6,7.78071715981593e-05,6.66414909922918e-05,0.5384615384615384
9069,에라도/Josa,13,6,7,6.669186136985083e-05,7.774840615767377e-05,0.5384615384615384
9070,실사판/Noun,13,6,7,6.669186136985083e-05,7.774840615767377e-05,0.5384615384615384
9071,티브이/Noun,13,6,7,6.669186136985083e-05,7.774840615767377e-05,0.5384615384615384
9072,김효진/Noun,13,6,7,6.669186136985083e-05,7.774840615767377e-05,0.5384615384615384
9073,날뛰다/Verb,13,6,7,6.669186136985083e-05,7.774840615767377e-05,0.5384615384615384
9074,·/Punctuation,13,7,6,7.78071715981593e-05,6.66414909922918e-05,0.5384615384615384
9075,수천/Modifier,13,7,6,7.78071715981593e-05,6.66414909922918e-05,0.5384615384615384
9076,프/Noun,13,6,7,6.669186136985083e-05,7.774840615767377e-05,0.5384615384615384
9077,탄식/Noun,13,6,7,6.669186136985083e-05,7.774840615767377e-05,0.5384615384615384
9078,미나/Noun,13,7,6,7.78071715981593e-05,6.66414909922918e-05,0.5384615384615384
9079,비애/Noun,13,7,6,7.78071715981593e-05,6.66414909922918e-05,0.5384615384615384
9080,철수/Noun,13,7,6,7.78071715981593e-05,6.66414909922918e-05,0.5384615384615384
9081,올림픽/Noun,13,6,7,6.669186136985083e-05,7.774840615767377e-05,0.5384615384615384
9082,~~~!!/Punctuation,13,7,6,7.78071715981593e-05,6.66414909922918e-05,0.5384615384615384
9083,조문탁/Noun,13,7,6,7.78071715981593e-05,6.66414909922918e-05,0.5384615384615384
9084,노래방/Noun,13,6,7,6.669186136985083e-05,7.774840615767377e-05,0.5384615384615384
9085,치이다/Verb,13,6,7,6.669186136985083e-05,7.774840615767377e-05,0.5384615384615384
9086,두사부일체/Noun,13,7,6,7.78071715981593e-05,6.66414909922918e-05,0.5384615384615384
9087,천상/Noun,13,6,7,6.669186136985083e-05,7.774840615767377e-05,0.5384615384615384
9088,엄연하다/Adjective,13,7,6,7.78071715981593e-05,6.66414909922918e-05,0.5384615384615384
9089,형아/Noun,13,6,7,6.669186136985083e-05,7.774840615767377e-05,0.5384615384615384
9090,견/Noun,13,7,6,7.78071715981593e-05,6.66414909922918e-05,0.5384615384615384
9091,뤽/Noun,13,6,7,6.669186136985083e-05,7.774840615767377e-05,0.5384615384615384
9092,슈나이더/Noun,13,6,7,6.669186136985083e-05,7.774840615767377e-05,0.5384615384615384
9093,라이온킹/Noun,13,7,6,7.78071715981593e-05,6.66414909922918e-05,0.5384615384615384
9094,자극시키다/Verb,13,7,6,7.78071715981593e-05,6.66414909922918e-05,0.5384615384615384
9095,장보리/Noun,13,6,7,6.669186136985083e-05,7.774840615767377e-05,0.5384615384615384
9096,중앙/Noun,13,7,6,7.78071715981593e-05,6.66414909922918e-05,0.5384615384615384
9097,담임/Noun,13,7,6,7.78071715981593e-05,6.66414909922918e-05,0.5384615384615384
9098,둥/Noun,13,6,7,6.669186136985083e-05,7.774840615767377e-05,0.5384615384615384
9099,한나/Noun,13,7,6,7.78071715981593e-05,6.66414909922918e-05,0.5384615384615384
9100,동갑/Noun,13,6,7,6.669186136985083e-05,7.774840615767377e-05,0.5384615384615384
9101,일등/Noun,13,7,6,7.78071715981593e-05,6.66414909922918e-05,0.5384615384615384
9102,이광수/Noun,13,7,6,7.78071715981593e-05,6.66414909922918e-05,0.5384615384615384
9103,강철중/Noun,13,7,6,7.78071715981593e-05,6.66414909922918e-05,0.5384615384615384
9104,이거슨/Noun,13,6,7,6.669186136985083e-05,7.774840615767377e-05,0.5384615384615384
9105,보태/Noun,13,6,7,6.669186136985083e-05,7.774840615767377e-05,0.5384615384615384
9106,에플렉/Noun,13,6,7,6.669186136985083e-05,7.774840615767377e-05,0.5384615384615384
9107,음성/Noun,13,7,6,7.78071715981593e-05,6.66414909922918e-05,0.5384615384615384
9108,막내/Noun,13,7,6,7.78071715981593e-05,6.66414909922918e-05,0.5384615384615384
9109,심리전/Noun,13,6,7,6.669186136985083e-05,7.774840615767377e-05,0.5384615384615384
9110,표면/Noun,13,6,7,6.669186136985083e-05,7.774840615767377e-05,0.5384615384615384
9111,첨가/Noun,13,7,6,7.78071715981593e-05,6.66414909922918e-05,0.5384615384615384
9112,주유소/Noun,13,6,7,6.669186136985083e-05,7.774840615767377e-05,0.5384615384615384
9113,체제/Noun,13,6,7,6.669186136985083e-05,7.774840615767377e-05,0.5384615384615384
9114,달콤/Noun,12,12,0,0.00013338372273970166,0.0,1.0
9115,아동학대/Noun,12,0,12,0.0,0.0001332829819845836,1.0
9116,함량/Noun,12,0,12,0.0,0.0001332829819845836,1.0
9117,언플/Noun,12,0,12,0.0,0.0001332829819845836,1.0
9118,알몸/Noun,12,0,12,0.0,0.0001332829819845836,1.0
9119,뭐/Exclamation,12,0,12,0.0,0.0001332829819845836,1.0
9120,박시환/Noun,12,0,12,0.0,0.0001332829819845836,1.0
9121,넘겨보다/Verb,12,0,12,0.0,0.0001332829819845836,1.0
9122,예스/Noun,12,12,0,0.00013338372273970166,0.0,1.0
9123,허접스럽다/Adjective,12,0,12,0.0,0.0001332829819845836,1.0
9124,붙여넣기/Noun,12,0,12,0.0,0.0001332829819845836,1.0
9125,횡설수설/Noun,12,0,12,0.0,0.0001332829819845836,1.0
9126,故/Foreign,12,12,0,0.00013338372273970166,0.0,1.0
9127,아이폰/Noun,12,0,12,0.0,0.0001332829819845836,1.0
9128,게머/Noun,12,0,12,0.0,0.0001332829819845836,1.0
9129,요점/Noun,12,0,12,0.0,0.0001332829819845836,1.0
9130,쵝/Noun,12,12,0,0.00013338372273970166,0.0,1.0
9131,정색/Noun,12,0,12,0.0,0.0001332829819845836,1.0
9132,가지가지/Noun,12,0,12,0.0,0.0001332829819845836,1.0
9133,화남/Noun,12,0,12,0.0,0.0001332829819845836,1.0
9134,다망/Noun,12,0,12,0.0,0.0001332829819845836,1.0
9135,서동요/Noun,12,11,1,0.00012226841251139318,1.1106915165381966e-05,0.9166666666666666
9136,에구/Exclamation,12,1,11,1.1115310228308472e-05,0.00012217606681920164,0.9166666666666666
9137,샬롯/Noun,12,11,1,0.00012226841251139318,1.1106915165381966e-05,0.9166666666666666
9138,화표/Noun,12,1,11,1.1115310228308472e-05,0.00012217606681920164,0.9166666666666666
9139,국물/Noun,12,1,11,1.1115310228308472e-05,0.00012217606681920164,0.9166666666666666
9140,겉도/Noun,12,1,11,1.1115310228308472e-05,0.00012217606681920164,0.9166666666666666
9141,온갖/Modifier,12,1,11,1.1115310228308472e-05,0.00012217606681920164,0.9166666666666666
9142,참상/Noun,12,11,1,0.00012226841251139318,1.1106915165381966e-05,0.9166666666666666
9143,챙/Noun,12,1,11,1.1115310228308472e-05,0.00012217606681920164,0.9166666666666666
9144,쉴드/Noun,12,1,11,1.1115310228308472e-05,0.00012217606681920164,0.9166666666666666
9145,비범하다/Adjective,12,11,1,0.00012226841251139318,1.1106915165381966e-05,0.9166666666666666
9146,갈비/Noun,12,1,11,1.1115310228308472e-05,0.00012217606681920164,0.9166666666666666
9147,~^/Punctuation,12,11,1,0.00012226841251139318,1.1106915165381966e-05,0.9166666666666666
9148,콩콩/Adverb,12,1,11,1.1115310228308472e-05,0.00012217606681920164,0.9166666666666666
9149,퇴마록/Noun,12,1,11,1.1115310228308472e-05,0.00012217606681920164,0.9166666666666666
9150,색안경/Noun,12,11,1,0.00012226841251139318,1.1106915165381966e-05,0.9166666666666666
9151,똥칠/Noun,12,1,11,1.1115310228308472e-05,0.00012217606681920164,0.9166666666666666
9152,장대/Noun,12,11,1,0.00012226841251139318,1.1106915165381966e-05,0.9166666666666666
9153,~*/Punctuation,12,11,1,0.00012226841251139318,1.1106915165381966e-05,0.9166666666666666
9154,My/Alpha,12,11,1,0.00012226841251139318,1.1106915165381966e-05,0.9166666666666666
9155,가까워지다/Verb,12,11,1,0.00012226841251139318,1.1106915165381966e-05,0.9166666666666666
9156,취재/Noun,12,1,11,1.1115310228308472e-05,0.00012217606681920164,0.9166666666666666
9157,시망/Noun,12,1,11,1.1115310228308472e-05,0.00012217606681920164,0.9166666666666666
9158,퉤퉤/Noun,12,1,11,1.1115310228308472e-05,0.00012217606681920164,0.9166666666666666
9159,유식/Noun,12,1,11,1.1115310228308472e-05,0.00012217606681920164,0.9166666666666666
9160,글썽/Noun,12,11,1,0.00012226841251139318,1.1106915165381966e-05,0.9166666666666666
9161,뻘짓/Noun,12,1,11,1.1115310228308472e-05,0.00012217606681920164,0.9166666666666666
9162,세도/Noun,12,1,11,1.1115310228308472e-05,0.00012217606681920164,0.9166666666666666
9163,초강추/Noun,12,11,1,0.00012226841251139318,1.1106915165381966e-05,0.9166666666666666
9164,친자/Noun,12,1,11,1.1115310228308472e-05,0.00012217606681920164,0.9166666666666666
9165,아이큐/Noun,12,1,11,1.1115310228308472e-05,0.00012217606681920164,0.9166666666666666
9166,마구잡이/Noun,12,1,11,1.1115310228308472e-05,0.00012217606681920164,0.9166666666666666
9167,위노나/Noun,12,11,1,0.00012226841251139318,1.1106915165381966e-05,0.9166666666666666
9168,개떡/Noun,12,1,11,1.1115310228308472e-05,0.00012217606681920164,0.9166666666666666
9169,당혹스럽다/Adjective,12,1,11,1.1115310228308472e-05,0.00012217606681920164,0.9166666666666666
9170,10억/Number,12,1,11,1.1115310228308472e-05,0.00012217606681920164,0.9166666666666666
9171,삼생이/Noun,12,1,11,1.1115310228308472e-05,0.00012217606681920164,0.9166666666666666
9172,뿌듯하다/Adjective,12,11,1,0.00012226841251139318,1.1106915165381966e-05,0.9166666666666666
9173,얼척/Noun,12,1,11,1.1115310228308472e-05,0.00012217606681920164,0.9166666666666666
9174,어정쩡/Adverb,12,1,11,1.1115310228308472e-05,0.00012217606681920164,0.9166666666666666
9175,미녀삼총사/Noun,12,1,11,1.1115310228308472e-05,0.00012217606681920164,0.9166666666666666
9176,봣네/Noun,12,11,1,0.00012226841251139318,1.1106915165381966e-05,0.9166666666666666
9177,11시/Number,12,11,1,0.00012226841251139318,1.1106915165381966e-05,0.9166666666666666
9178,눈꼽/Noun,12,1,11,1.1115310228308472e-05,0.00012217606681920164,0.9166666666666666
9179,화병/Noun,12,2,10,2.2230620456616944e-05,0.00011106915165381967,0.8333333333333334
9180,법적/Noun,12,2,10,2.2230620456616944e-05,0.00011106915165381967,0.8333333333333334
9181,캡/Noun,12,10,2,0.00011115310228308472,2.2213830330763933e-05,0.8333333333333334
9182,",,,,,,/Punctuation",12,2,10,2.2230620456616944e-05,0.00011106915165381967,0.8333333333333334
9183,재일교포/Noun,12,10,2,0.00011115310228308472,2.2213830330763933e-05,0.8333333333333334
9184,소속사/Noun,12,2,10,2.2230620456616944e-05,0.00011106915165381967,0.8333333333333334
9185,중단/Noun,12,2,10,2.2230620456616944e-05,0.00011106915165381967,0.8333333333333334
9186,손목/Noun,12,2,10,2.2230620456616944e-05,0.00011106915165381967,0.8333333333333334
9187,무인/Noun,12,10,2,0.00011115310228308472,2.2213830330763933e-05,0.8333333333333334
9188,불사조/Noun,12,2,10,2.2230620456616944e-05,0.00011106915165381967,0.8333333333333334
9189,고소하다/Adjective,12,2,10,2.2230620456616944e-05,0.00011106915165381967,0.8333333333333334
9190,비긴즈/Noun,12,10,2,0.00011115310228308472,2.2213830330763933e-05,0.8333333333333334
9191,직시/Noun,12,10,2,0.00011115310228308472,2.2213830330763933e-05,0.8333333333333334
9192,84년/Number,12,10,2,0.00011115310228308472,2.2213830330763933e-05,0.8333333333333334
9193,메르스/Noun,12,10,2,0.00011115310228308472,2.2213830330763933e-05,0.8333333333333334
9194,르네젤위거/Noun,12,10,2,0.00011115310228308472,2.2213830330763933e-05,0.8333333333333334
9195,후벼파다/Verb,12,10,2,0.00011115310228308472,2.2213830330763933e-05,0.8333333333333334
9196,징기스칸/Noun,12,2,10,2.2230620456616944e-05,0.00011106915165381967,0.8333333333333334
9197,급작/Noun,12,2,10,2.2230620456616944e-05,0.00011106915165381967,0.8333333333333334
9198,김동완/Noun,12,10,2,0.00011115310228308472,2.2213830330763933e-05,0.8333333333333334
9199,린지/Noun,12,2,10,2.2230620456616944e-05,0.00011106915165381967,0.8333333333333334
9200,애뜻/Noun,12,10,2,0.00011115310228308472,2.2213830330763933e-05,0.8333333333333334
9201,라푼젤/Noun,12,10,2,0.00011115310228308472,2.2213830330763933e-05,0.8333333333333334
9202,내적/Noun,12,10,2,0.00011115310228308472,2.2213830330763933e-05,0.8333333333333334
9203,어후/Noun,12,2,10,2.2230620456616944e-05,0.00011106915165381967,0.8333333333333334
9204,아키/Noun,12,10,2,0.00011115310228308472,2.2213830330763933e-05,0.8333333333333334
9205,마부/Noun,12,10,2,0.00011115310228308472,2.2213830330763933e-05,0.8333333333333334
9206,스푼/Noun,12,2,10,2.2230620456616944e-05,0.00011106915165381967,0.8333333333333334
9207,정치가/Noun,12,10,2,0.00011115310228308472,2.2213830330763933e-05,0.8333333333333334
9208,음슴다/Verb,12,2,10,2.2230620456616944e-05,0.00011106915165381967,0.8333333333333334
9209,훗/Noun,12,10,2,0.00011115310228308472,2.2213830330763933e-05,0.8333333333333334
9210,더러/Josa,12,2,10,2.2230620456616944e-05,0.00011106915165381967,0.8333333333333334
9211,골빈/Noun,12,2,10,2.2230620456616944e-05,0.00011106915165381967,0.8333333333333334
9212,~~~!/Punctuation,12,10,2,0.00011115310228308472,2.2213830330763933e-05,0.8333333333333334
9213,기질/Noun,12,2,10,2.2230620456616944e-05,0.00011106915165381967,0.8333333333333334
9214,들뜨다/Adjective,12,10,2,0.00011115310228308472,2.2213830330763933e-05,0.8333333333333334
9215,최시원/Noun,12,2,10,2.2230620456616944e-05,0.00011106915165381967,0.8333333333333334
9216,부하/Noun,12,2,10,2.2230620456616944e-05,0.00011106915165381967,0.8333333333333334
9217,허리/Noun,12,2,10,2.2230620456616944e-05,0.00011106915165381967,0.8333333333333334
9218,인과/Noun,12,2,10,2.2230620456616944e-05,0.00011106915165381967,0.8333333333333334
9219,수채화/Noun,12,10,2,0.00011115310228308472,2.2213830330763933e-05,0.8333333333333334
9220,팬더/Noun,12,2,10,2.2230620456616944e-05,0.00011106915165381967,0.8333333333333334
9221,본래/Noun,12,2,10,2.2230620456616944e-05,0.00011106915165381967,0.8333333333333334
9222,해답/Noun,12,10,2,0.00011115310228308472,2.2213830330763933e-05,0.8333333333333334
9223,제자리/Noun,12,2,10,2.2230620456616944e-05,0.00011106915165381967,0.8333333333333334
9224,테드/Noun,12,10,2,0.00011115310228308472,2.2213830330763933e-05,0.8333333333333334
9225,신물/Noun,12,2,10,2.2230620456616944e-05,0.00011106915165381967,0.8333333333333334
9226,볼빠/Noun,12,2,10,2.2230620456616944e-05,0.00011106915165381967,0.8333333333333334
9227,역행/Noun,12,2,10,2.2230620456616944e-05,0.00011106915165381967,0.8333333333333334
9228,당초/Noun,12,2,10,2.2230620456616944e-05,0.00011106915165381967,0.8333333333333334
9229,고요하다/Adjective,12,10,2,0.00011115310228308472,2.2213830330763933e-05,0.8333333333333334
9230,킥/Noun,12,2,10,2.2230620456616944e-05,0.00011106915165381967,0.8333333333333334
9231,제이크/Noun,12,10,2,0.00011115310228308472,2.2213830330763933e-05,0.8333333333333334
9232,연달/Noun,12,10,2,0.00011115310228308472,2.2213830330763933e-05,0.8333333333333334
9233,강박증/Noun,12,9,3,0.00010003779205477625,3.33207454961459e-05,0.75
9234,연재/Noun,12,9,3,0.00010003779205477625,3.33207454961459e-05,0.75
9235,대로의/Josa,12,9,3,0.00010003779205477625,3.33207454961459e-05,0.75
9236,암담하다/Adjective,12,3,9,3.3345930684925414e-05,9.99622364884377e-05,0.75
9237,왓으/Noun,12,9,3,0.00010003779205477625,3.33207454961459e-05,0.75
9238,가상/Noun,12,9,3,0.00010003779205477625,3.33207454961459e-05,0.75
9239,So/Alpha,12,9,3,0.00010003779205477625,3.33207454961459e-05,0.75
9240,이래저래/Adverb,12,3,9,3.3345930684925414e-05,9.99622364884377e-05,0.75
9241,순전하다/Adjective,12,3,9,3.3345930684925414e-05,9.99622364884377e-05,0.75
9242,라이어/Noun,12,3,9,3.3345930684925414e-05,9.99622364884377e-05,0.75
9243,배치/Noun,12,9,3,0.00010003779205477625,3.33207454961459e-05,0.75
9244,축소/Noun,12,9,3,0.00010003779205477625,3.33207454961459e-05,0.75
9245,다듬어지다/Verb,12,9,3,0.00010003779205477625,3.33207454961459e-05,0.75
9246,내년/Noun,12,9,3,0.00010003779205477625,3.33207454961459e-05,0.75
9247,윌리암스/Noun,12,9,3,0.00010003779205477625,3.33207454961459e-05,0.75
9248,해명/Noun,12,3,9,3.3345930684925414e-05,9.99622364884377e-05,0.75
9249,연연하다/Adjective,12,9,3,0.00010003779205477625,3.33207454961459e-05,0.75
9250,정심/Noun,12,3,9,3.3345930684925414e-05,9.99622364884377e-05,0.75
9251,엘리자베스/Noun,12,9,3,0.00010003779205477625,3.33207454961459e-05,0.75
9252,홍어/Noun,12,3,9,3.3345930684925414e-05,9.99622364884377e-05,0.75
9253,무법자/Noun,12,9,3,0.00010003779205477625,3.33207454961459e-05,0.75
9254,여름방학/Noun,12,9,3,0.00010003779205477625,3.33207454961459e-05,0.75
9255,사냥꾼/Noun,12,3,9,3.3345930684925414e-05,9.99622364884377e-05,0.75
9256,쇼핑/Noun,12,3,9,3.3345930684925414e-05,9.99622364884377e-05,0.75
9257,사무/Noun,12,3,9,3.3345930684925414e-05,9.99622364884377e-05,0.75
9258,깽/Noun,12,3,9,3.3345930684925414e-05,9.99622364884377e-05,0.75
9259,애물/Noun,12,3,9,3.3345930684925414e-05,9.99622364884377e-05,0.75
9260,헬드/Noun,12,3,9,3.3345930684925414e-05,9.99622364884377e-05,0.75
9261,쩌네/Noun,12,9,3,0.00010003779205477625,3.33207454961459e-05,0.75
9262,고대로/Noun,12,3,9,3.3345930684925414e-05,9.99622364884377e-05,0.75
9263,덤앤더머/Noun,12,9,3,0.00010003779205477625,3.33207454961459e-05,0.75
9264,호들갑/Noun,12,3,9,3.3345930684925414e-05,9.99622364884377e-05,0.75
9265,포토/Noun,12,3,9,3.3345930684925414e-05,9.99622364884377e-05,0.75
9266,격투기/Noun,12,3,9,3.3345930684925414e-05,9.99622364884377e-05,0.75
9267,서편제/Noun,12,9,3,0.00010003779205477625,3.33207454961459e-05,0.75
9268,부질없다/Adjective,12,3,9,3.3345930684925414e-05,9.99622364884377e-05,0.75
9269,100회/Number,12,3,9,3.3345930684925414e-05,9.99622364884377e-05,0.75
9270,야경/Noun,12,3,9,3.3345930684925414e-05,9.99622364884377e-05,0.75
9271,고만/Modifier,12,3,9,3.3345930684925414e-05,9.99622364884377e-05,0.75
9272,",..../Punctuation",12,3,9,3.3345930684925414e-05,9.99622364884377e-05,0.75
9273,전역/Noun,12,9,3,0.00010003779205477625,3.33207454961459e-05,0.75
9274,분도/Noun,12,9,3,0.00010003779205477625,3.33207454961459e-05,0.75
9275,아대/Noun,12,3,9,3.3345930684925414e-05,9.99622364884377e-05,0.75
9276,즐감/Noun,12,9,3,0.00010003779205477625,3.33207454961459e-05,0.75
9277,김소현/Noun,12,9,3,0.00010003779205477625,3.33207454961459e-05,0.75
9278,아따맘마/Noun,12,9,3,0.00010003779205477625,3.33207454961459e-05,0.75
9279,고장/Noun,12,3,9,3.3345930684925414e-05,9.99622364884377e-05,0.75
9280,차기/Noun,12,9,3,0.00010003779205477625,3.33207454961459e-05,0.75
9281,김범/Noun,12,3,9,3.3345930684925414e-05,9.99622364884377e-05,0.75
9282,찰나/Noun,12,9,3,0.00010003779205477625,3.33207454961459e-05,0.75
9283,부러지다/Verb,12,3,9,3.3345930684925414e-05,9.99622364884377e-05,0.75
9284,찰리채플린/Noun,12,9,3,0.00010003779205477625,3.33207454961459e-05,0.75
9285,나락/Noun,12,3,9,3.3345930684925414e-05,9.99622364884377e-05,0.75
9286,로스/Noun,12,9,3,0.00010003779205477625,3.33207454961459e-05,0.75
9287,풍운/Noun,12,3,9,3.3345930684925414e-05,9.99622364884377e-05,0.75
9288,일종/Noun,12,3,9,3.3345930684925414e-05,9.99622364884377e-05,0.75
9289,저딴/Modifier,12,3,9,3.3345930684925414e-05,9.99622364884377e-05,0.75
9290,생기지/Noun,12,3,9,3.3345930684925414e-05,9.99622364884377e-05,0.75
9291,~~~!!!/Punctuation,12,9,3,0.00010003779205477625,3.33207454961459e-05,0.75
9292,크리스천/Noun,12,9,3,0.00010003779205477625,3.33207454961459e-05,0.75
9293,10초/Number,12,3,9,3.3345930684925414e-05,9.99622364884377e-05,0.75
9294,스킬/Noun,12,3,9,3.3345930684925414e-05,9.99622364884377e-05,0.75
9295,노노/Noun,12,3,9,3.3345930684925414e-05,9.99622364884377e-05,0.75
9296,에프/Noun,12,9,3,0.00010003779205477625,3.33207454961459e-05,0.75
9297,조보아/Noun,12,9,3,0.00010003779205477625,3.33207454961459e-05,0.75
9298,교실/Noun,12,9,3,0.00010003779205477625,3.33207454961459e-05,0.75
9299,만회/Noun,12,3,9,3.3345930684925414e-05,9.99622364884377e-05,0.75
9300,구먼/Noun,12,3,9,3.3345930684925414e-05,9.99622364884377e-05,0.75
9301,서막/Noun,12,9,3,0.00010003779205477625,3.33207454961459e-05,0.75
9302,선진국/Noun,12,9,3,0.00010003779205477625,3.33207454961459e-05,0.75
9303,전의/Foreign,12,9,3,0.00010003779205477625,3.33207454961459e-05,0.75
9304,올린다/Noun,12,9,3,0.00010003779205477625,3.33207454961459e-05,0.75
9305,천만다행/Noun,12,3,9,3.3345930684925414e-05,9.99622364884377e-05,0.75
9306,오연서/Noun,12,9,3,0.00010003779205477625,3.33207454961459e-05,0.75
9307,입문/Noun,12,9,3,0.00010003779205477625,3.33207454961459e-05,0.75
9308,가죽/Noun,12,3,9,3.3345930684925414e-05,9.99622364884377e-05,0.75
9309,인제/Noun,12,3,9,3.3345930684925414e-05,9.99622364884377e-05,0.75
9310,류현경/Noun,12,9,3,0.00010003779205477625,3.33207454961459e-05,0.75
9311,4시간/Number,12,9,3,0.00010003779205477625,3.33207454961459e-05,0.75
9312,논스톱/Noun,12,9,3,0.00010003779205477625,3.33207454961459e-05,0.75
9313,작일/Noun,12,3,9,3.3345930684925414e-05,9.99622364884377e-05,0.75
9314,007시/Number,12,9,3,0.00010003779205477625,3.33207454961459e-05,0.75
9315,전태일/Noun,12,9,3,0.00010003779205477625,3.33207454961459e-05,0.75
9316,원수/Noun,12,3,9,3.3345930684925414e-05,9.99622364884377e-05,0.75
9317,눈동자/Noun,12,9,3,0.00010003779205477625,3.33207454961459e-05,0.75
9318,심취/Noun,12,8,4,8.892248182646778e-05,4.4427660661527865e-05,0.6666666666666666
9319,리플리/Noun,12,8,4,8.892248182646778e-05,4.4427660661527865e-05,0.6666666666666666
9320,안내상/Noun,12,4,8,4.446124091323389e-05,8.885532132305573e-05,0.6666666666666666
9321,글로리아/Noun,12,8,4,8.892248182646778e-05,4.4427660661527865e-05,0.6666666666666666
9322,만으론/Josa,12,4,8,4.446124091323389e-05,8.885532132305573e-05,0.6666666666666666
9323,사적/Noun,12,8,4,8.892248182646778e-05,4.4427660661527865e-05,0.6666666666666666
9324,격인/Noun,12,4,8,4.446124091323389e-05,8.885532132305573e-05,0.6666666666666666
9325,입증/Noun,12,4,8,4.446124091323389e-05,8.885532132305573e-05,0.6666666666666666
9326,케인/Noun,12,8,4,8.892248182646778e-05,4.4427660661527865e-05,0.6666666666666666
9327,시크릿/Noun,12,8,4,8.892248182646778e-05,4.4427660661527865e-05,0.6666666666666666
9328,미라/Noun,12,4,8,4.446124091323389e-05,8.885532132305573e-05,0.6666666666666666
9329,퍼레이드/Noun,12,4,8,4.446124091323389e-05,8.885532132305573e-05,0.6666666666666666
9330,아이콘/Noun,12,4,8,4.446124091323389e-05,8.885532132305573e-05,0.6666666666666666
9331,처럼/Foreign,12,4,8,4.446124091323389e-05,8.885532132305573e-05,0.6666666666666666
9332,필자/Noun,12,4,8,4.446124091323389e-05,8.885532132305573e-05,0.6666666666666666
9333,우결/Noun,12,4,8,4.446124091323389e-05,8.885532132305573e-05,0.6666666666666666
9334,어떨/Modifier,12,8,4,8.892248182646778e-05,4.4427660661527865e-05,0.6666666666666666
9335,아마존/Noun,12,8,4,8.892248182646778e-05,4.4427660661527865e-05,0.6666666666666666
9336,다다르다/Verb,12,8,4,8.892248182646778e-05,4.4427660661527865e-05,0.6666666666666666
9337,갖은/Noun,12,4,8,4.446124091323389e-05,8.885532132305573e-05,0.6666666666666666
9338,전생/Noun,12,8,4,8.892248182646778e-05,4.4427660661527865e-05,0.6666666666666666
9339,모차르트/Noun,12,8,4,8.892248182646778e-05,4.4427660661527865e-05,0.6666666666666666
9340,밀러/Noun,12,8,4,8.892248182646778e-05,4.4427660661527865e-05,0.6666666666666666
9341,병헌/Noun,12,8,4,8.892248182646778e-05,4.4427660661527865e-05,0.6666666666666666
9342,미란다/Noun,12,8,4,8.892248182646778e-05,4.4427660661527865e-05,0.6666666666666666
9343,무지개/Noun,12,8,4,8.892248182646778e-05,4.4427660661527865e-05,0.6666666666666666
9344,곤충/Noun,12,8,4,8.892248182646778e-05,4.4427660661527865e-05,0.6666666666666666
9345,부패/Noun,12,8,4,8.892248182646778e-05,4.4427660661527865e-05,0.6666666666666666
9346,대를/Foreign,12,8,4,8.892248182646778e-05,4.4427660661527865e-05,0.6666666666666666
9347,진영/Noun,12,8,4,8.892248182646778e-05,4.4427660661527865e-05,0.6666666666666666
9348,못난이/Noun,12,8,4,8.892248182646778e-05,4.4427660661527865e-05,0.6666666666666666
9349,앤디/Noun,12,8,4,8.892248182646778e-05,4.4427660661527865e-05,0.6666666666666666
9350,설원/Noun,12,8,4,8.892248182646778e-05,4.4427660661527865e-05,0.6666666666666666
9351,뒷맛/Noun,12,4,8,4.446124091323389e-05,8.885532132305573e-05,0.6666666666666666
9352,맘껏/Noun,12,8,4,8.892248182646778e-05,4.4427660661527865e-05,0.6666666666666666
9353,리틀/Noun,12,8,4,8.892248182646778e-05,4.4427660661527865e-05,0.6666666666666666
9354,할로윈/Noun,12,4,8,4.446124091323389e-05,8.885532132305573e-05,0.6666666666666666
9355,여장/Noun,12,4,8,4.446124091323389e-05,8.885532132305573e-05,0.6666666666666666
9356,너머/Noun,12,8,4,8.892248182646778e-05,4.4427660661527865e-05,0.6666666666666666
9357,되다/Adjective,12,4,8,4.446124091323389e-05,8.885532132305573e-05,0.6666666666666666
9358,우리엄마/Noun,12,8,4,8.892248182646778e-05,4.4427660661527865e-05,0.6666666666666666
9359,임원희/Noun,12,4,8,4.446124091323389e-05,8.885532132305573e-05,0.6666666666666666
9360,흥얼거리다/Verb,12,8,4,8.892248182646778e-05,4.4427660661527865e-05,0.6666666666666666
9361,자이언트/Noun,12,8,4,8.892248182646778e-05,4.4427660661527865e-05,0.6666666666666666
9362,ㄱㄱㄱ/KoreanParticle,12,4,8,4.446124091323389e-05,8.885532132305573e-05,0.6666666666666666
9363,박근혜/Noun,12,8,4,8.892248182646778e-05,4.4427660661527865e-05,0.6666666666666666
9364,버러지/Noun,12,4,8,4.446124091323389e-05,8.885532132305573e-05,0.6666666666666666
9365,특이/Noun,12,8,4,8.892248182646778e-05,4.4427660661527865e-05,0.6666666666666666
9366,부서지다/Verb,12,4,8,4.446124091323389e-05,8.885532132305573e-05,0.6666666666666666
9367,우스/Noun,12,4,8,4.446124091323389e-05,8.885532132305573e-05,0.6666666666666666
9368,컬트영화/Noun,12,8,4,8.892248182646778e-05,4.4427660661527865e-05,0.6666666666666666
9369,대견하다/Adjective,12,4,8,4.446124091323389e-05,8.885532132305573e-05,0.6666666666666666
9370,조의/Noun,12,8,4,8.892248182646778e-05,4.4427660661527865e-05,0.6666666666666666
9371,파란/Noun,12,8,4,8.892248182646778e-05,4.4427660661527865e-05,0.6666666666666666
9372,닐슨/Noun,12,8,4,8.892248182646778e-05,4.4427660661527865e-05,0.6666666666666666
9373,인조/Noun,12,4,8,4.446124091323389e-05,8.885532132305573e-05,0.6666666666666666
9374,렌스/Noun,12,8,4,8.892248182646778e-05,4.4427660661527865e-05,0.6666666666666666
9375,넬/Noun,12,8,4,8.892248182646778e-05,4.4427660661527865e-05,0.6666666666666666
9376,모하/Noun,12,4,8,4.446124091323389e-05,8.885532132305573e-05,0.6666666666666666
9377,과장하다/Adjective,12,4,8,4.446124091323389e-05,8.885532132305573e-05,0.6666666666666666
9378,재결합/Noun,12,4,8,4.446124091323389e-05,8.885532132305573e-05,0.6666666666666666
9379,셜록/Noun,12,8,4,8.892248182646778e-05,4.4427660661527865e-05,0.6666666666666666
9380,잡혀가다/Verb,12,4,8,4.446124091323389e-05,8.885532132305573e-05,0.6666666666666666
9381,각도/Noun,12,4,8,4.446124091323389e-05,8.885532132305573e-05,0.6666666666666666
9382,티아라/Noun,12,4,8,4.446124091323389e-05,8.885532132305573e-05,0.6666666666666666
9383,행성/Noun,12,4,8,4.446124091323389e-05,8.885532132305573e-05,0.6666666666666666
9384,런던/Noun,12,8,4,8.892248182646778e-05,4.4427660661527865e-05,0.6666666666666666
9385,미노/Noun,12,4,8,4.446124091323389e-05,8.885532132305573e-05,0.6666666666666666
9386,미켈슨/Noun,12,8,4,8.892248182646778e-05,4.4427660661527865e-05,0.6666666666666666
9387,사로잡히다/Verb,12,4,8,4.446124091323389e-05,8.885532132305573e-05,0.6666666666666666
9388,도자기/Noun,12,4,8,4.446124091323389e-05,8.885532132305573e-05,0.6666666666666666
9389,기와/Noun,12,8,4,8.892248182646778e-05,4.4427660661527865e-05,0.6666666666666666
9390,홀리/Noun,12,4,8,4.446124091323389e-05,8.885532132305573e-05,0.6666666666666666
9391,솟다/Verb,12,8,4,8.892248182646778e-05,4.4427660661527865e-05,0.6666666666666666
9392,일말/Noun,12,4,8,4.446124091323389e-05,8.885532132305573e-05,0.6666666666666666
9393,일부분/Noun,12,8,4,8.892248182646778e-05,4.4427660661527865e-05,0.6666666666666666
9394,간호사/Noun,12,8,4,8.892248182646778e-05,4.4427660661527865e-05,0.6666666666666666
9395,사촌동생/Noun,12,4,8,4.446124091323389e-05,8.885532132305573e-05,0.6666666666666666
9396,히히히/Noun,12,4,8,4.446124091323389e-05,8.885532132305573e-05,0.6666666666666666
9397,드뎌/Noun,12,8,4,8.892248182646778e-05,4.4427660661527865e-05,0.6666666666666666
9398,문장/Noun,12,4,8,4.446124091323389e-05,8.885532132305573e-05,0.6666666666666666
9399,한껏/Adverb,12,8,4,8.892248182646778e-05,4.4427660661527865e-05,0.6666666666666666
9400,33/Number,12,4,8,4.446124091323389e-05,8.885532132305573e-05,0.6666666666666666
9401,이주승/Noun,12,8,4,8.892248182646778e-05,4.4427660661527865e-05,0.6666666666666666
9402,전병/Noun,12,4,8,4.446124091323389e-05,8.885532132305573e-05,0.6666666666666666
9403,스텔론/Noun,12,8,4,8.892248182646778e-05,4.4427660661527865e-05,0.6666666666666666
9404,나리/Noun,12,4,8,4.446124091323389e-05,8.885532132305573e-05,0.6666666666666666
9405,종료/Noun,12,4,8,4.446124091323389e-05,8.885532132305573e-05,0.6666666666666666
9406,소나기/Noun,12,8,4,8.892248182646778e-05,4.4427660661527865e-05,0.6666666666666666
9407,명과/Noun,12,8,4,8.892248182646778e-05,4.4427660661527865e-05,0.6666666666666666
9408,기함/Noun,12,4,8,4.446124091323389e-05,8.885532132305573e-05,0.6666666666666666
9409,가세/Noun,12,4,8,4.446124091323389e-05,8.885532132305573e-05,0.6666666666666666
9410,다이아몬드/Noun,12,8,4,8.892248182646778e-05,4.4427660661527865e-05,0.6666666666666666
9411,양쪽/Noun,12,4,8,4.446124091323389e-05,8.885532132305573e-05,0.6666666666666666
9412,히데/Noun,12,4,8,4.446124091323389e-05,8.885532132305573e-05,0.6666666666666666
9413,남궁민/Noun,12,8,4,8.892248182646778e-05,4.4427660661527865e-05,0.6666666666666666
9414,김지영/Noun,12,4,8,4.446124091323389e-05,8.885532132305573e-05,0.6666666666666666
9415,주더/Noun,12,4,8,4.446124091323389e-05,8.885532132305573e-05,0.6666666666666666
9416,팔레스타인/Noun,12,8,4,8.892248182646778e-05,4.4427660661527865e-05,0.6666666666666666
9417,필연/Noun,12,8,4,8.892248182646778e-05,4.4427660661527865e-05,0.6666666666666666
9418,순풍/Noun,12,8,4,8.892248182646778e-05,4.4427660661527865e-05,0.6666666666666666
9419,이중성/Noun,12,4,8,4.446124091323389e-05,8.885532132305573e-05,0.6666666666666666
9420,강박/Noun,12,4,8,4.446124091323389e-05,8.885532132305573e-05,0.6666666666666666
9421,트리오/Noun,12,8,4,8.892248182646778e-05,4.4427660661527865e-05,0.6666666666666666
9422,엠버/Noun,12,4,8,4.446124091323389e-05,8.885532132305573e-05,0.6666666666666666
9423,유독/Noun,12,4,8,4.446124091323389e-05,8.885532132305573e-05,0.6666666666666666
9424,색즉시공/Noun,12,4,8,4.446124091323389e-05,8.885532132305573e-05,0.6666666666666666
9425,보트/Noun,12,7,5,7.78071715981593e-05,5.5534575826909837e-05,0.5833333333333334
9426,하고만/Josa,12,7,5,7.78071715981593e-05,5.5534575826909837e-05,0.5833333333333334
9427,즌/Noun,12,5,7,5.557655114154236e-05,7.774840615767377e-05,0.5833333333333334
9428,출산/Noun,12,5,7,5.557655114154236e-05,7.774840615767377e-05,0.5833333333333334
9429,영화상/Noun,12,5,7,5.557655114154236e-05,7.774840615767377e-05,0.5833333333333334
9430,애슐리/Noun,12,5,7,5.557655114154236e-05,7.774840615767377e-05,0.5833333333333334
9431,격투씬/Noun,12,5,7,5.557655114154236e-05,7.774840615767377e-05,0.5833333333333334
9432,7시/Number,12,5,7,5.557655114154236e-05,7.774840615767377e-05,0.5833333333333334
9433,미니시리즈/Noun,12,7,5,7.78071715981593e-05,5.5534575826909837e-05,0.5833333333333334
9434,꽂다/Verb,12,5,7,5.557655114154236e-05,7.774840615767377e-05,0.5833333333333334
9435,VS/Alpha,12,7,5,7.78071715981593e-05,5.5534575826909837e-05,0.5833333333333334
9436,박지윤/Noun,12,5,7,5.557655114154236e-05,7.774840615767377e-05,0.5833333333333334
9437,현지/Noun,12,5,7,5.557655114154236e-05,7.774840615767377e-05,0.5833333333333334
9438,매너/Noun,12,7,5,7.78071715981593e-05,5.5534575826909837e-05,0.5833333333333334
9439,do/Alpha,12,7,5,7.78071715981593e-05,5.5534575826909837e-05,0.5833333333333334
9440,뷰티/Noun,12,7,5,7.78071715981593e-05,5.5534575826909837e-05,0.5833333333333334
9441,토대/Noun,12,7,5,7.78071715981593e-05,5.5534575826909837e-05,0.5833333333333334
9442,쇼생/Noun,12,7,5,7.78071715981593e-05,5.5534575826909837e-05,0.5833333333333334
9443,어리숙하다/Adjective,12,5,7,5.557655114154236e-05,7.774840615767377e-05,0.5833333333333334
9444,손자/Noun,12,7,5,7.78071715981593e-05,5.5534575826909837e-05,0.5833333333333334
9445,이편/Noun,12,7,5,7.78071715981593e-05,5.5534575826909837e-05,0.5833333333333334
9446,살벌하다/Adjective,12,7,5,7.78071715981593e-05,5.5534575826909837e-05,0.5833333333333334
9447,박선영/Noun,12,7,5,7.78071715981593e-05,5.5534575826909837e-05,0.5833333333333334
9448,몰두하다/Adjective,12,7,5,7.78071715981593e-05,5.5534575826909837e-05,0.5833333333333334
9449,난왜/Noun,12,5,7,5.557655114154236e-05,7.774840615767377e-05,0.5833333333333334
9450,잭블랙/Noun,12,7,5,7.78071715981593e-05,5.5534575826909837e-05,0.5833333333333334
9451,목욕/Noun,12,5,7,5.557655114154236e-05,7.774840615767377e-05,0.5833333333333334
9452,환호/Noun,12,7,5,7.78071715981593e-05,5.5534575826909837e-05,0.5833333333333334
9453,타협/Noun,12,7,5,7.78071715981593e-05,5.5534575826909837e-05,0.5833333333333334
9454,막바지/Noun,12,5,7,5.557655114154236e-05,7.774840615767377e-05,0.5833333333333334
9455,지우/Noun,12,5,7,5.557655114154236e-05,7.774840615767377e-05,0.5833333333333334
9456,넓히다/Verb,12,7,5,7.78071715981593e-05,5.5534575826909837e-05,0.5833333333333334
9457,정자/Noun,12,5,7,5.557655114154236e-05,7.774840615767377e-05,0.5833333333333334
9458,무상/Noun,12,7,5,7.78071715981593e-05,5.5534575826909837e-05,0.5833333333333334
9459,이레/Noun,12,7,5,7.78071715981593e-05,5.5534575826909837e-05,0.5833333333333334
9460,빠뜨리다/Verb,12,5,7,5.557655114154236e-05,7.774840615767377e-05,0.5833333333333334
9461,삐뚤어지다/Verb,12,5,7,5.557655114154236e-05,7.774840615767377e-05,0.5833333333333334
9462,술집/Noun,12,5,7,5.557655114154236e-05,7.774840615767377e-05,0.5833333333333334
9463,한가득/Adverb,12,7,5,7.78071715981593e-05,5.5534575826909837e-05,0.5833333333333334
9464,얌/Noun,12,5,7,5.557655114154236e-05,7.774840615767377e-05,0.5833333333333334
9465,아이스/Noun,12,5,7,5.557655114154236e-05,7.774840615767377e-05,0.5833333333333334
9466,개정/Noun,12,5,7,5.557655114154236e-05,7.774840615767377e-05,0.5833333333333334
9467,기이하다/Adjective,12,5,7,5.557655114154236e-05,7.774840615767377e-05,0.5833333333333334
9468,구출/Noun,12,7,5,7.78071715981593e-05,5.5534575826909837e-05,0.5833333333333334
9469,구상/Noun,12,5,7,5.557655114154236e-05,7.774840615767377e-05,0.5833333333333334
9470,돌연변이/Noun,12,5,7,5.557655114154236e-05,7.774840615767377e-05,0.5833333333333334
9471,제프/Noun,12,7,5,7.78071715981593e-05,5.5534575826909837e-05,0.5833333333333334
9472,소드/Noun,12,5,7,5.557655114154236e-05,7.774840615767377e-05,0.5833333333333334
9473,일보/Noun,12,5,7,5.557655114154236e-05,7.774840615767377e-05,0.5833333333333334
9474,휩쓸다/Adjective,12,7,5,7.78071715981593e-05,5.5534575826909837e-05,0.5833333333333334
9475,공공/Modifier,12,7,5,7.78071715981593e-05,5.5534575826909837e-05,0.5833333333333334
9476,어그/Noun,12,5,7,5.557655114154236e-05,7.774840615767377e-05,0.5833333333333334
9477,왈츠/Noun,12,7,5,7.78071715981593e-05,5.5534575826909837e-05,0.5833333333333334
9478,롤/Noun,12,5,7,5.557655114154236e-05,7.774840615767377e-05,0.5833333333333334
9479,렷/Noun,12,5,7,5.557655114154236e-05,7.774840615767377e-05,0.5833333333333334
9480,글래디에이터/Noun,12,5,7,5.557655114154236e-05,7.774840615767377e-05,0.5833333333333334
9481,30%/Number,12,5,7,5.557655114154236e-05,7.774840615767377e-05,0.5833333333333334
9482,→/Foreign,12,5,7,5.557655114154236e-05,7.774840615767377e-05,0.5833333333333334
9483,딴사람/Noun,12,5,7,5.557655114154236e-05,7.774840615767377e-05,0.5833333333333334
9484,날씨/Noun,12,7,5,7.78071715981593e-05,5.5534575826909837e-05,0.5833333333333334
9485,생/Foreign,12,7,5,7.78071715981593e-05,5.5534575826909837e-05,0.5833333333333334
9486,like/Alpha,12,7,5,7.78071715981593e-05,5.5534575826909837e-05,0.5833333333333334
9487,치히로/Noun,12,7,5,7.78071715981593e-05,5.5534575826909837e-05,0.5833333333333334
9488,경찰서/Noun,12,5,7,5.557655114154236e-05,7.774840615767377e-05,0.5833333333333334
9489,정보석/Noun,12,7,5,7.78071715981593e-05,5.5534575826909837e-05,0.5833333333333334
9490,인크레더블/Noun,12,7,5,7.78071715981593e-05,5.5534575826909837e-05,0.5833333333333334
9491,수로/Noun,12,5,7,5.557655114154236e-05,7.774840615767377e-05,0.5833333333333334
9492,텅빈/Noun,12,5,7,5.557655114154236e-05,7.774840615767377e-05,0.5833333333333334
9493,그남자/Noun,12,7,5,7.78071715981593e-05,5.5534575826909837e-05,0.5833333333333334
9494,서든/Noun,12,7,5,7.78071715981593e-05,5.5534575826909837e-05,0.5833333333333334
9495,화려/Noun,12,7,5,7.78071715981593e-05,5.5534575826909837e-05,0.5833333333333334
9496,좌충우돌/Noun,12,7,5,7.78071715981593e-05,5.5534575826909837e-05,0.5833333333333334
9497,수십/Noun,12,7,5,7.78071715981593e-05,5.5534575826909837e-05,0.5833333333333334
9498,3회/Number,12,5,7,5.557655114154236e-05,7.774840615767377e-05,0.5833333333333334
9499,쿠퍼/Noun,12,7,5,7.78071715981593e-05,5.5534575826909837e-05,0.5833333333333334
9500,그러므로/Conjunction,12,7,5,7.78071715981593e-05,5.5534575826909837e-05,0.5833333333333334
9501,도구로/Noun,12,5,7,5.557655114154236e-05,7.774840615767377e-05,0.5833333333333334
9502,바랬/Noun,12,5,7,5.557655114154236e-05,7.774840615767377e-05,0.5833333333333334
9503,멸망하다/Adjective,12,5,7,5.557655114154236e-05,7.774840615767377e-05,0.5833333333333334
9504,마왕/Noun,12,7,5,7.78071715981593e-05,5.5534575826909837e-05,0.5833333333333334
9505,군국/Noun,12,5,7,5.557655114154236e-05,7.774840615767377e-05,0.5833333333333334
9506,용의자/Noun,12,5,7,5.557655114154236e-05,7.774840615767377e-05,0.5833333333333334
9507,고가/Noun,12,7,5,7.78071715981593e-05,5.5534575826909837e-05,0.5833333333333334
9508,1~3/Number,12,7,5,7.78071715981593e-05,5.5534575826909837e-05,0.5833333333333334
9509,엘리트/Noun,12,7,5,7.78071715981593e-05,5.5534575826909837e-05,0.5833333333333334
9510,소시민/Noun,12,7,5,7.78071715981593e-05,5.5534575826909837e-05,0.5833333333333334
9511,홍성/Noun,12,5,7,5.557655114154236e-05,7.774840615767377e-05,0.5833333333333334
9512,맥클레인/Noun,12,7,5,7.78071715981593e-05,5.5534575826909837e-05,0.5833333333333334
9513,고모/Noun,12,7,5,7.78071715981593e-05,5.5534575826909837e-05,0.5833333333333334
9514,정직하다/Adjective,12,5,7,5.557655114154236e-05,7.774840615767377e-05,0.5833333333333334
9515,김영철/Noun,12,7,5,7.78071715981593e-05,5.5534575826909837e-05,0.5833333333333334
9516,이요/Noun,12,7,5,7.78071715981593e-05,5.5534575826909837e-05,0.5833333333333334
9517,10시/Number,12,7,5,7.78071715981593e-05,5.5534575826909837e-05,0.5833333333333334
9518,일정/Noun,12,7,5,7.78071715981593e-05,5.5534575826909837e-05,0.5833333333333334
9519,나부랭이/Noun,12,5,7,5.557655114154236e-05,7.774840615767377e-05,0.5833333333333334
9520,잘추다/Verb,12,7,5,7.78071715981593e-05,5.5534575826909837e-05,0.5833333333333334
9521,대원/Noun,12,5,7,5.557655114154236e-05,7.774840615767377e-05,0.5833333333333334
9522,스머프/Noun,12,7,5,7.78071715981593e-05,5.5534575826909837e-05,0.5833333333333334
9523,니스/Noun,12,7,5,7.78071715981593e-05,5.5534575826909837e-05,0.5833333333333334
9524,몸소/Noun,12,7,5,7.78071715981593e-05,5.5534575826909837e-05,0.5833333333333334
9525,랴/Noun,12,5,7,5.557655114154236e-05,7.774840615767377e-05,0.5833333333333334
9526,괴로움/Noun,12,7,5,7.78071715981593e-05,5.5534575826909837e-05,0.5833333333333334
9527,유니크/Noun,12,7,5,7.78071715981593e-05,5.5534575826909837e-05,0.5833333333333334
9528,오산/Noun,12,5,7,5.557655114154236e-05,7.774840615767377e-05,0.5833333333333334
9529,거절/Noun,12,7,5,7.78071715981593e-05,5.5534575826909837e-05,0.5833333333333334
9530,유연석/Noun,12,5,7,5.557655114154236e-05,7.774840615767377e-05,0.5833333333333334
9531,미개/Noun,12,6,6,6.669186136985083e-05,6.66414909922918e-05,0.5
9532,습관/Noun,12,6,6,6.669186136985083e-05,6.66414909922918e-05,0.5
9533,태극권/Noun,12,6,6,6.669186136985083e-05,6.66414909922918e-05,0.5
9534,귀환/Noun,12,6,6,6.669186136985083e-05,6.66414909922918e-05,0.5
9535,한혜진/Noun,12,6,6,6.669186136985083e-05,6.66414909922918e-05,0.5
9536,차로/Noun,12,6,6,6.669186136985083e-05,6.66414909922918e-05,0.5
9537,22/Number,12,6,6,6.669186136985083e-05,6.66414909922918e-05,0.5
9538,억양/Noun,12,6,6,6.669186136985083e-05,6.66414909922918e-05,0.5
9539,베티/Noun,12,6,6,6.669186136985083e-05,6.66414909922918e-05,0.5
9540,찜/Noun,12,6,6,6.669186136985083e-05,6.66414909922918e-05,0.5
9541,널다/Verb,12,6,6,6.669186136985083e-05,6.66414909922918e-05,0.5
9542,영화롭다/Adjective,12,6,6,6.669186136985083e-05,6.66414909922918e-05,0.5
9543,템포/Noun,12,6,6,6.669186136985083e-05,6.66414909922918e-05,0.5
9544,4.5/Number,12,6,6,6.669186136985083e-05,6.66414909922918e-05,0.5
9545,상담/Noun,12,6,6,6.669186136985083e-05,6.66414909922918e-05,0.5
9546,온주완/Noun,12,6,6,6.669186136985083e-05,6.66414909922918e-05,0.5
9547,김재중/Noun,12,6,6,6.669186136985083e-05,6.66414909922918e-05,0.5
9548,기황후/Noun,12,6,6,6.669186136985083e-05,6.66414909922918e-05,0.5
9549,여전/Noun,12,6,6,6.669186136985083e-05,6.66414909922918e-05,0.5
9550,소수자/Noun,12,6,6,6.669186136985083e-05,6.66414909922918e-05,0.5
9551,해먹/Noun,12,6,6,6.669186136985083e-05,6.66414909922918e-05,0.5
9552,네트/Noun,12,6,6,6.669186136985083e-05,6.66414909922918e-05,0.5
9553,50%/Number,12,6,6,6.669186136985083e-05,6.66414909922918e-05,0.5
9554,생소하다/Adjective,12,6,6,6.669186136985083e-05,6.66414909922918e-05,0.5
9555,소주/Noun,12,6,6,6.669186136985083e-05,6.66414909922918e-05,0.5
9556,엔딩씬/Noun,12,6,6,6.669186136985083e-05,6.66414909922918e-05,0.5
9557,이거지/Adverb,12,6,6,6.669186136985083e-05,6.66414909922918e-05,0.5
9558,예체능/Noun,12,6,6,6.669186136985083e-05,6.66414909922918e-05,0.5
9559,고급스럽다/Adjective,12,6,6,6.669186136985083e-05,6.66414909922918e-05,0.5
9560,왜색/Noun,12,6,6,6.669186136985083e-05,6.66414909922918e-05,0.5
9561,스마트/Noun,12,6,6,6.669186136985083e-05,6.66414909922918e-05,0.5
9562,편중/Noun,12,6,6,6.669186136985083e-05,6.66414909922918e-05,0.5
9563,초능력자/Noun,12,6,6,6.669186136985083e-05,6.66414909922918e-05,0.5
9564,흐미/Noun,12,6,6,6.669186136985083e-05,6.66414909922918e-05,0.5
9565,안치/Noun,12,6,6,6.669186136985083e-05,6.66414909922918e-05,0.5
9566,모션/Noun,12,6,6,6.669186136985083e-05,6.66414909922918e-05,0.5
9567,배용준/Noun,12,6,6,6.669186136985083e-05,6.66414909922918e-05,0.5
9568,째/Foreign,12,6,6,6.669186136985083e-05,6.66414909922918e-05,0.5
9569,인대/Noun,12,6,6,6.669186136985083e-05,6.66414909922918e-05,0.5
9570,샤워/Noun,12,6,6,6.669186136985083e-05,6.66414909922918e-05,0.5
9571,액숀/Noun,12,6,6,6.669186136985083e-05,6.66414909922918e-05,0.5
9572,리안/Noun,12,6,6,6.669186136985083e-05,6.66414909922918e-05,0.5
9573,포심/Noun,12,6,6,6.669186136985083e-05,6.66414909922918e-05,0.5
9574,도주/Noun,12,6,6,6.669186136985083e-05,6.66414909922918e-05,0.5
9575,아론/Noun,12,6,6,6.669186136985083e-05,6.66414909922918e-05,0.5
9576,점프/Noun,12,6,6,6.669186136985083e-05,6.66414909922918e-05,0.5
9577,xx/Alpha,12,6,6,6.669186136985083e-05,6.66414909922918e-05,0.5
9578,거란/Noun,12,6,6,6.669186136985083e-05,6.66414909922918e-05,0.5
9579,살라/Noun,12,6,6,6.669186136985083e-05,6.66414909922918e-05,0.5
9580,얻어맞다/Verb,12,6,6,6.669186136985083e-05,6.66414909922918e-05,0.5
9581,뿜/Noun,12,6,6,6.669186136985083e-05,6.66414909922918e-05,0.5
9582,두목/Noun,12,6,6,6.669186136985083e-05,6.66414909922918e-05,0.5
9583,넷/Noun,12,6,6,6.669186136985083e-05,6.66414909922918e-05,0.5
9584,컴/Noun,12,6,6,6.669186136985083e-05,6.66414909922918e-05,0.5
9585,방치/Noun,12,6,6,6.669186136985083e-05,6.66414909922918e-05,0.5
9586,간과/Noun,12,6,6,6.669186136985083e-05,6.66414909922918e-05,0.5
9587,지미/Noun,12,6,6,6.669186136985083e-05,6.66414909922918e-05,0.5
9588,베이커/Noun,12,6,6,6.669186136985083e-05,6.66414909922918e-05,0.5
9589,다지다/Verb,12,6,6,6.669186136985083e-05,6.66414909922918e-05,0.5
9590,진미/Noun,12,6,6,6.669186136985083e-05,6.66414909922918e-05,0.5
9591,왜인/Noun,12,6,6,6.669186136985083e-05,6.66414909922918e-05,0.5
9592,찾아다니다/Verb,12,6,6,6.669186136985083e-05,6.66414909922918e-05,0.5
9593,심의/Noun,12,6,6,6.669186136985083e-05,6.66414909922918e-05,0.5
9594,쨔응/Noun,11,11,0,0.00012226841251139318,0.0,1.0
9595,깝깝/Noun,11,0,11,0.0,0.00012217606681920164,1.0
9596,고은아/Noun,11,0,11,0.0,0.00012217606681920164,1.0
9597,애하/Noun,11,0,11,0.0,0.00012217606681920164,1.0
9598,폭도/Noun,11,0,11,0.0,0.00012217606681920164,1.0
9599,티남/Noun,11,0,11,0.0,0.00012217606681920164,1.0
9600,찍지마라/Noun,11,0,11,0.0,0.00012217606681920164,1.0
9601,아하/Exclamation,11,0,11,0.0,0.00012217606681920164,1.0
9602,500/Number,11,0,11,0.0,0.00012217606681920164,1.0
9603,청소년기/Noun,11,11,0,0.00012226841251139318,0.0,1.0
9604,손은서/Noun,11,0,11,0.0,0.00012217606681920164,1.0
9605,유사/Noun,11,0,11,0.0,0.00012217606681920164,1.0
9606,울화통/Noun,11,0,11,0.0,0.00012217606681920164,1.0
9607,부릉부릉/Adverb,11,0,11,0.0,0.00012217606681920164,1.0
9608,편파/Noun,11,0,11,0.0,0.00012217606681920164,1.0
9609,과욕/Noun,11,0,11,0.0,0.00012217606681920164,1.0
9610,싱그럽다/Adjective,11,11,0,0.00012226841251139318,0.0,1.0
9611,탈세/Noun,11,0,11,0.0,0.00012217606681920164,1.0
9612,까비/Noun,11,0,11,0.0,0.00012217606681920164,1.0
9613,추기경/Noun,11,11,0,0.00012226841251139318,0.0,1.0
9614,휴식/Noun,11,11,0,0.00012226841251139318,0.0,1.0
9615,배종옥/Noun,11,11,0,0.00012226841251139318,0.0,1.0
9616,노랑/Noun,11,0,11,0.0,0.00012217606681920164,1.0
9617,말좀/Noun,11,0,11,0.0,0.00012217606681920164,1.0
9618,후광/Noun,11,0,11,0.0,0.00012217606681920164,1.0
9619,복수초/Noun,11,0,11,0.0,0.00012217606681920164,1.0
9620,ㅠㅠㅜ/KoreanParticle,11,11,0,0.00012226841251139318,0.0,1.0
9621,아나킨/Noun,11,11,0,0.00012226841251139318,0.0,1.0
9622,윌슨/Noun,11,11,0,0.00012226841251139318,0.0,1.0
9623,별루임/Noun,11,0,11,0.0,0.00012217606681920164,1.0
9624,짱짱걸/Noun,11,10,1,0.00011115310228308472,1.1106915165381966e-05,0.9090909090909091
9625,벤허/Noun,11,10,1,0.00011115310228308472,1.1106915165381966e-05,0.9090909090909091
9626,애매/Noun,11,1,10,1.1115310228308472e-05,0.00011106915165381967,0.9090909090909091
9627,울트라/Noun,11,1,10,1.1115310228308472e-05,0.00011106915165381967,0.9090909090909091
9628,오바이트/Noun,11,1,10,1.1115310228308472e-05,0.00011106915165381967,0.9090909090909091
9629,구토/Noun,11,1,10,1.1115310228308472e-05,0.00011106915165381967,0.9090909090909091
9630,갓파더/Noun,11,1,10,1.1115310228308472e-05,0.00011106915165381967,0.9090909090909091
9631,덱스터/Noun,11,10,1,0.00011115310228308472,1.1106915165381966e-05,0.9090909090909091
9632,페미/Noun,11,1,10,1.1115310228308472e-05,0.00011106915165381967,0.9090909090909091
9633,4천원/Number,11,1,10,1.1115310228308472e-05,0.00011106915165381967,0.9090909090909091
9634,입담/Noun,11,10,1,0.00011115310228308472,1.1106915165381966e-05,0.9090909090909091
9635,알라딘/Noun,11,10,1,0.00011115310228308472,1.1106915165381966e-05,0.9090909090909091
9636,감금/Noun,11,1,10,1.1115310228308472e-05,0.00011106915165381967,0.9090909090909091
9637,수신료/Noun,11,1,10,1.1115310228308472e-05,0.00011106915165381967,0.9090909090909091
9638,소모/Noun,11,1,10,1.1115310228308472e-05,0.00011106915165381967,0.9090909090909091
9639,없슴/Noun,11,1,10,1.1115310228308472e-05,0.00011106915165381967,0.9090909090909091
9640,프로파간다/Noun,11,1,10,1.1115310228308472e-05,0.00011106915165381967,0.9090909090909091
9641,다이빙/Noun,11,1,10,1.1115310228308472e-05,0.00011106915165381967,0.9090909090909091
9642,유물/Noun,11,1,10,1.1115310228308472e-05,0.00011106915165381967,0.9090909090909091
9643,、/Foreign,11,10,1,0.00011115310228308472,1.1106915165381966e-05,0.9090909090909091
9644,먹듯/Noun,11,1,10,1.1115310228308472e-05,0.00011106915165381967,0.9090909090909091
9645,고역/Noun,11,1,10,1.1115310228308472e-05,0.00011106915165381967,0.9090909090909091
9646,개폼/Noun,11,1,10,1.1115310228308472e-05,0.00011106915165381967,0.9090909090909091
9647,골다/Verb,11,1,10,1.1115310228308472e-05,0.00011106915165381967,0.9090909090909091
9648,워터/Noun,11,1,10,1.1115310228308472e-05,0.00011106915165381967,0.9090909090909091
9649,world/Alpha,11,10,1,0.00011115310228308472,1.1106915165381966e-05,0.9090909090909091
9650,석양/Noun,11,10,1,0.00011115310228308472,1.1106915165381966e-05,0.9090909090909091
9651,이지현/Noun,11,1,10,1.1115310228308472e-05,0.00011106915165381967,0.9090909090909091
9652,징징거리다/Adjective,11,1,10,1.1115310228308472e-05,0.00011106915165381967,0.9090909090909091
9653,비키니/Noun,11,1,10,1.1115310228308472e-05,0.00011106915165381967,0.9090909090909091
9654,답시고/Noun,11,1,10,1.1115310228308472e-05,0.00011106915165381967,0.9090909090909091
9655,(-/Punctuation,11,1,10,1.1115310228308472e-05,0.00011106915165381967,0.9090909090909091
9656,압니/Noun,11,10,1,0.00011115310228308472,1.1106915165381966e-05,0.9090909090909091
9657,OTL/Alpha,11,1,10,1.1115310228308472e-05,0.00011106915165381967,0.9090909090909091
9658,퉁/Noun,11,1,10,1.1115310228308472e-05,0.00011106915165381967,0.9090909090909091
9659,오지호/Noun,11,1,10,1.1115310228308472e-05,0.00011106915165381967,0.9090909090909091
9660,KTX/Alpha,11,1,10,1.1115310228308472e-05,0.00011106915165381967,0.9090909090909091
9661,동행/Noun,11,10,1,0.00011115310228308472,1.1106915165381966e-05,0.9090909090909091
9662,8~9/Number,11,10,1,0.00011115310228308472,1.1106915165381966e-05,0.9090909090909091
9663,게이물/Noun,11,1,10,1.1115310228308472e-05,0.00011106915165381967,0.9090909090909091
9664,오분/Noun,11,1,10,1.1115310228308472e-05,0.00011106915165381967,0.9090909090909091
9665,개망/Noun,11,1,10,1.1115310228308472e-05,0.00011106915165381967,0.9090909090909091
9666,극화/Noun,11,1,10,1.1115310228308472e-05,0.00011106915165381967,0.9090909090909091
9667,킬러조/Noun,11,1,10,1.1115310228308472e-05,0.00011106915165381967,0.9090909090909091
9668,마음껏/Noun,11,10,1,0.00011115310228308472,1.1106915165381966e-05,0.9090909090909091
9669,팔고/Noun,11,1,10,1.1115310228308472e-05,0.00011106915165381967,0.9090909090909091
9670,OUT/Alpha,11,1,10,1.1115310228308472e-05,0.00011106915165381967,0.9090909090909091
9671,제안/Noun,11,1,10,1.1115310228308472e-05,0.00011106915165381967,0.9090909090909091
9672,착신아리/Noun,11,1,10,1.1115310228308472e-05,0.00011106915165381967,0.9090909090909091
9673,다스베이더/Noun,11,10,1,0.00011115310228308472,1.1106915165381966e-05,0.9090909090909091
9674,!!!^^/Punctuation,11,10,1,0.00011115310228308472,1.1106915165381966e-05,0.9090909090909091
9675,반함/Noun,11,10,1,0.00011115310228308472,1.1106915165381966e-05,0.9090909090909091
9676,엇습/Noun,11,10,1,0.00011115310228308472,1.1106915165381966e-05,0.9090909090909091
9677,궈/Noun,11,1,10,1.1115310228308472e-05,0.00011106915165381967,0.9090909090909091
9678,어릴떄/Noun,11,10,1,0.00011115310228308472,1.1106915165381966e-05,0.9090909090909091
9679,퀼리티/Noun,11,1,10,1.1115310228308472e-05,0.00011106915165381967,0.9090909090909091
9680,판정/Noun,11,2,9,2.2230620456616944e-05,9.99622364884377e-05,0.8181818181818182
9681,구사/Noun,11,2,9,2.2230620456616944e-05,9.99622364884377e-05,0.8181818181818182
9682,가려지다/Verb,11,9,2,0.00010003779205477625,2.2213830330763933e-05,0.8181818181818182
9683,메리다/Noun,11,2,9,2.2230620456616944e-05,9.99622364884377e-05,0.8181818181818182
9684,비디오테잎/Noun,11,9,2,0.00010003779205477625,2.2213830330763933e-05,0.8181818181818182
9685,관통/Noun,11,9,2,0.00010003779205477625,2.2213830330763933e-05,0.8181818181818182
9686,간지럽다/Adjective,11,2,9,2.2230620456616944e-05,9.99622364884377e-05,0.8181818181818182
9687,광신도/Noun,11,2,9,2.2230620456616944e-05,9.99622364884377e-05,0.8181818181818182
9688,34/Number,11,9,2,0.00010003779205477625,2.2213830330763933e-05,0.8181818181818182
9689,윤/Noun,11,9,2,0.00010003779205477625,2.2213830330763933e-05,0.8181818181818182
9690,깡통/Noun,11,2,9,2.2230620456616944e-05,9.99622364884377e-05,0.8181818181818182
9691,70분/Number,11,2,9,2.2230620456616944e-05,9.99622364884377e-05,0.8181818181818182
9692,계약/Noun,11,2,9,2.2230620456616944e-05,9.99622364884377e-05,0.8181818181818182
9693,타락/Noun,11,2,9,2.2230620456616944e-05,9.99622364884377e-05,0.8181818181818182
9694,분간/Noun,11,2,9,2.2230620456616944e-05,9.99622364884377e-05,0.8181818181818182
9695,죤나/Noun,11,2,9,2.2230620456616944e-05,9.99622364884377e-05,0.8181818181818182
9696,민망/Noun,11,2,9,2.2230620456616944e-05,9.99622364884377e-05,0.8181818181818182
9697,축제/Noun,11,9,2,0.00010003779205477625,2.2213830330763933e-05,0.8181818181818182
9698,방학/Noun,11,9,2,0.00010003779205477625,2.2213830330763933e-05,0.8181818181818182
9699,되찾다/Verb,11,9,2,0.00010003779205477625,2.2213830330763933e-05,0.8181818181818182
9700,음울하다/Adjective,11,9,2,0.00010003779205477625,2.2213830330763933e-05,0.8181818181818182
9701,한주/Noun,11,9,2,0.00010003779205477625,2.2213830330763933e-05,0.8181818181818182
9702,...................../Punctuation,11,2,9,2.2230620456616944e-05,9.99622364884377e-05,0.8181818181818182
9703,들려오다/Verb,11,9,2,0.00010003779205477625,2.2213830330763933e-05,0.8181818181818182
9704,취소/Noun,11,2,9,2.2230620456616944e-05,9.99622364884377e-05,0.8181818181818182
9705,린즈링/Noun,11,2,9,2.2230620456616944e-05,9.99622364884377e-05,0.8181818181818182
9706,동거/Noun,11,2,9,2.2230620456616944e-05,9.99622364884377e-05,0.8181818181818182
9707,버틀러/Noun,11,9,2,0.00010003779205477625,2.2213830330763933e-05,0.8181818181818182
9708,염병/Noun,11,2,9,2.2230620456616944e-05,9.99622364884377e-05,0.8181818181818182
9709,80~90년/Number,11,2,9,2.2230620456616944e-05,9.99622364884377e-05,0.8181818181818182
9710,센터/Noun,11,2,9,2.2230620456616944e-05,9.99622364884377e-05,0.8181818181818182
9711,관계도/Noun,11,2,9,2.2230620456616944e-05,9.99622364884377e-05,0.8181818181818182
9712,스탠리/Noun,11,9,2,0.00010003779205477625,2.2213830330763933e-05,0.8181818181818182
9713,선교사/Noun,11,9,2,0.00010003779205477625,2.2213830330763933e-05,0.8181818181818182
9714,양익준/Noun,11,9,2,0.00010003779205477625,2.2213830330763933e-05,0.8181818181818182
9715,무민/Noun,11,9,2,0.00010003779205477625,2.2213830330763933e-05,0.8181818181818182
9716,자지/Noun,11,2,9,2.2230620456616944e-05,9.99622364884377e-05,0.8181818181818182
9717,go/Alpha,11,9,2,0.00010003779205477625,2.2213830330763933e-05,0.8181818181818182
9718,랑께/Josa,11,2,9,2.2230620456616944e-05,9.99622364884377e-05,0.8181818181818182
9719,서론/Noun,11,2,9,2.2230620456616944e-05,9.99622364884377e-05,0.8181818181818182
9720,환각/Noun,11,2,9,2.2230620456616944e-05,9.99622364884377e-05,0.8181818181818182
9721,미미하다/Adjective,11,2,9,2.2230620456616944e-05,9.99622364884377e-05,0.8181818181818182
9722,고립/Noun,11,9,2,0.00010003779205477625,2.2213830330763933e-05,0.8181818181818182
9723,저딴/Noun,11,2,9,2.2230620456616944e-05,9.99622364884377e-05,0.8181818181818182
9724,사발/Noun,11,2,9,2.2230620456616944e-05,9.99622364884377e-05,0.8181818181818182
9725,바스코/Noun,11,2,9,2.2230620456616944e-05,9.99622364884377e-05,0.8181818181818182
9726,셰익스피어/Noun,11,9,2,0.00010003779205477625,2.2213830330763933e-05,0.8181818181818182
9727,쿵후/Noun,11,2,9,2.2230620456616944e-05,9.99622364884377e-05,0.8181818181818182
9728,난해/Noun,11,2,9,2.2230620456616944e-05,9.99622364884377e-05,0.8181818181818182
9729,바퀴벌레/Noun,11,2,9,2.2230620456616944e-05,9.99622364884377e-05,0.8181818181818182
9730,know/Alpha,11,9,2,0.00010003779205477625,2.2213830330763933e-05,0.8181818181818182
9731,질렌할/Noun,11,9,2,0.00010003779205477625,2.2213830330763933e-05,0.8181818181818182
9732,리다/Noun,11,2,9,2.2230620456616944e-05,9.99622364884377e-05,0.8181818181818182
9733,연출가/Noun,11,2,9,2.2230620456616944e-05,9.99622364884377e-05,0.8181818181818182
9734,호빗/Noun,11,9,2,0.00010003779205477625,2.2213830330763933e-05,0.8181818181818182
9735,의욕/Noun,11,2,9,2.2230620456616944e-05,9.99622364884377e-05,0.8181818181818182
9736,was/Alpha,11,9,2,0.00010003779205477625,2.2213830330763933e-05,0.8181818181818182
9737,기무라/Noun,11,9,2,0.00010003779205477625,2.2213830330763933e-05,0.8181818181818182
9738,안봣/Noun,11,9,2,0.00010003779205477625,2.2213830330763933e-05,0.8181818181818182
9739,브랜드/Noun,11,9,2,0.00010003779205477625,2.2213830330763933e-05,0.8181818181818182
9740,버킷리스트/Noun,11,9,2,0.00010003779205477625,2.2213830330763933e-05,0.8181818181818182
9741,요인/Noun,11,2,9,2.2230620456616944e-05,9.99622364884377e-05,0.8181818181818182
9742,"...,/Punctuation",11,2,9,2.2230620456616944e-05,9.99622364884377e-05,0.8181818181818182
9743,무신론자/Noun,11,2,9,2.2230620456616944e-05,9.99622364884377e-05,0.8181818181818182
9744,레슬링/Noun,11,2,9,2.2230620456616944e-05,9.99622364884377e-05,0.8181818181818182
9745,노처녀/Noun,11,2,9,2.2230620456616944e-05,9.99622364884377e-05,0.8181818181818182
9746,조엘/Noun,11,2,9,2.2230620456616944e-05,9.99622364884377e-05,0.8181818181818182
9747,無/Foreign,11,2,9,2.2230620456616944e-05,9.99622364884377e-05,0.8181818181818182
9748,쪽지/Noun,11,9,2,0.00010003779205477625,2.2213830330763933e-05,0.8181818181818182
9749,형용/Noun,11,9,2,0.00010003779205477625,2.2213830330763933e-05,0.8181818181818182
9750,zzz/Alpha,11,2,9,2.2230620456616944e-05,9.99622364884377e-05,0.8181818181818182
9751,남북/Noun,11,9,2,0.00010003779205477625,2.2213830330763933e-05,0.8181818181818182
9752,왕년/Noun,11,2,9,2.2230620456616944e-05,9.99622364884377e-05,0.8181818181818182
9753,4월/Number,11,9,2,0.00010003779205477625,2.2213830330763933e-05,0.8181818181818182
9754,댕/Noun,11,2,9,2.2230620456616944e-05,9.99622364884377e-05,0.8181818181818182
9755,번지르르하다/Adjective,11,2,9,2.2230620456616944e-05,9.99622364884377e-05,0.8181818181818182
9756,평보/Noun,11,2,9,2.2230620456616944e-05,9.99622364884377e-05,0.8181818181818182
9757,김원효/Noun,11,2,9,2.2230620456616944e-05,9.99622364884377e-05,0.8181818181818182
9758,사유/Noun,11,9,2,0.00010003779205477625,2.2213830330763933e-05,0.8181818181818182
9759,행각/Noun,11,2,9,2.2230620456616944e-05,9.99622364884377e-05,0.8181818181818182
9760,수치심/Noun,11,2,9,2.2230620456616944e-05,9.99622364884377e-05,0.8181818181818182
9761,욜라/Noun,11,2,9,2.2230620456616944e-05,9.99622364884377e-05,0.8181818181818182
9762,승희/Noun,11,2,9,2.2230620456616944e-05,9.99622364884377e-05,0.8181818181818182
9763,오케이/Noun,11,2,9,2.2230620456616944e-05,9.99622364884377e-05,0.8181818181818182
9764,팬텀/Noun,11,9,2,0.00010003779205477625,2.2213830330763933e-05,0.8181818181818182
9765,하비/Noun,11,9,2,0.00010003779205477625,2.2213830330763933e-05,0.8181818181818182
9766,김성수/Noun,11,2,9,2.2230620456616944e-05,9.99622364884377e-05,0.8181818181818182
9767,달튼/Noun,11,9,2,0.00010003779205477625,2.2213830330763933e-05,0.8181818181818182
9768,발라/Noun,11,2,9,2.2230620456616944e-05,9.99622364884377e-05,0.8181818181818182
9769,박준형/Noun,11,2,9,2.2230620456616944e-05,9.99622364884377e-05,0.8181818181818182
9770,불급/Noun,11,2,9,2.2230620456616944e-05,9.99622364884377e-05,0.8181818181818182
9771,진지희/Noun,11,2,9,2.2230620456616944e-05,9.99622364884377e-05,0.8181818181818182
9772,횟수/Noun,11,2,9,2.2230620456616944e-05,9.99622364884377e-05,0.8181818181818182
9773,악플달다/Verb,11,9,2,0.00010003779205477625,2.2213830330763933e-05,0.8181818181818182
9774,2.2/Number,11,2,9,2.2230620456616944e-05,9.99622364884377e-05,0.8181818181818182
9775,레젼드/Noun,11,9,2,0.00010003779205477625,2.2213830330763933e-05,0.8181818181818182
9776,김꽃비/Noun,11,2,9,2.2230620456616944e-05,9.99622364884377e-05,0.8181818181818182
9777,무성의/Noun,11,2,9,2.2230620456616944e-05,9.99622364884377e-05,0.8181818181818182
9778,일본사람/Noun,11,2,9,2.2230620456616944e-05,9.99622364884377e-05,0.8181818181818182
9779,r/Alpha,11,3,8,3.3345930684925414e-05,8.885532132305573e-05,0.7272727272727273
9780,독고/Noun,11,8,3,8.892248182646778e-05,3.33207454961459e-05,0.7272727272727273
9781,나왓으/Noun,11,8,3,8.892248182646778e-05,3.33207454961459e-05,0.7272727272727273
9782,바티칸/Noun,11,3,8,3.3345930684925414e-05,8.885532132305573e-05,0.7272727272727273
9783,후퇴/Noun,11,3,8,3.3345930684925414e-05,8.885532132305573e-05,0.7272727272727273
9784,CD/Alpha,11,8,3,8.892248182646778e-05,3.33207454961459e-05,0.7272727272727273
9785,NG/Alpha,11,8,3,8.892248182646778e-05,3.33207454961459e-05,0.7272727272727273
9786,".,../Punctuation",11,3,8,3.3345930684925414e-05,8.885532132305573e-05,0.7272727272727273
9787,팝핀현준/Noun,11,3,8,3.3345930684925414e-05,8.885532132305573e-05,0.7272727272727273
9788,불협화음/Noun,11,3,8,3.3345930684925414e-05,8.885532132305573e-05,0.7272727272727273
9789,카터/Noun,11,8,3,8.892248182646778e-05,3.33207454961459e-05,0.7272727272727273
9790,뚜껑/Noun,11,3,8,3.3345930684925414e-05,8.885532132305573e-05,0.7272727272727273
9791,당사자/Noun,11,8,3,8.892248182646778e-05,3.33207454961459e-05,0.7272727272727273
9792,브란도/Noun,11,8,3,8.892248182646778e-05,3.33207454961459e-05,0.7272727272727273
9793,에르/Noun,11,8,3,8.892248182646778e-05,3.33207454961459e-05,0.7272727272727273
9794,참가/Noun,11,3,8,3.3345930684925414e-05,8.885532132305573e-05,0.7272727272727273
9795,승승장구/Noun,11,8,3,8.892248182646778e-05,3.33207454961459e-05,0.7272727272727273
9796,딥블루씨/Noun,11,3,8,3.3345930684925414e-05,8.885532132305573e-05,0.7272727272727273
9797,변경/Noun,11,3,8,3.3345930684925414e-05,8.885532132305573e-05,0.7272727272727273
9798,유효하다/Adjective,11,8,3,8.892248182646778e-05,3.33207454961459e-05,0.7272727272727273
9799,고달프다/Adjective,11,8,3,8.892248182646778e-05,3.33207454961459e-05,0.7272727272727273
9800,대조/Noun,11,8,3,8.892248182646778e-05,3.33207454961459e-05,0.7272727272727273
9801,근친상간/Noun,11,3,8,3.3345930684925414e-05,8.885532132305573e-05,0.7272727272727273
9802,충전/Noun,11,3,8,3.3345930684925414e-05,8.885532132305573e-05,0.7272727272727273
9803,추리물/Noun,11,3,8,3.3345930684925414e-05,8.885532132305573e-05,0.7272727272727273
9804,지오/Noun,11,8,3,8.892248182646778e-05,3.33207454961459e-05,0.7272727272727273
9805,들것/Noun,11,3,8,3.3345930684925414e-05,8.885532132305573e-05,0.7272727272727273
9806,근처/Noun,11,8,3,8.892248182646778e-05,3.33207454961459e-05,0.7272727272727273
9807,쉬리/Noun,11,3,8,3.3345930684925414e-05,8.885532132305573e-05,0.7272727272727273
9808,건너다/Verb,11,3,8,3.3345930684925414e-05,8.885532132305573e-05,0.7272727272727273
9809,로리타/Noun,11,3,8,3.3345930684925414e-05,8.885532132305573e-05,0.7272727272727273
9810,감방/Noun,11,3,8,3.3345930684925414e-05,8.885532132305573e-05,0.7272727272727273
9811,쑈/Noun,11,3,8,3.3345930684925414e-05,8.885532132305573e-05,0.7272727272727273
9812,피라미드/Noun,11,3,8,3.3345930684925414e-05,8.885532132305573e-05,0.7272727272727273
9813,마사미/Noun,11,8,3,8.892248182646778e-05,3.33207454961459e-05,0.7272727272727273
9814,개차반/Noun,11,3,8,3.3345930684925414e-05,8.885532132305573e-05,0.7272727272727273
9815,하드코어/Noun,11,3,8,3.3345930684925414e-05,8.885532132305573e-05,0.7272727272727273
9816,계몽/Noun,11,8,3,8.892248182646778e-05,3.33207454961459e-05,0.7272727272727273
9817,고구마/Noun,11,8,3,8.892248182646778e-05,3.33207454961459e-05,0.7272727272727273
9818,뭐길/Noun,11,3,8,3.3345930684925414e-05,8.885532132305573e-05,0.7272727272727273
9819,왓츠/Noun,11,8,3,8.892248182646778e-05,3.33207454961459e-05,0.7272727272727273
9820,꿀잠/Noun,11,3,8,3.3345930684925414e-05,8.885532132305573e-05,0.7272727272727273
9821,경기도/Noun,11,8,3,8.892248182646778e-05,3.33207454961459e-05,0.7272727272727273
9822,여분/Noun,11,3,8,3.3345930684925414e-05,8.885532132305573e-05,0.7272727272727273
9823,연작/Noun,11,8,3,8.892248182646778e-05,3.33207454961459e-05,0.7272727272727273
9824,전인/Noun,11,8,3,8.892248182646778e-05,3.33207454961459e-05,0.7272727272727273
9825,수첩/Noun,11,3,8,3.3345930684925414e-05,8.885532132305573e-05,0.7272727272727273
9826,려원/Noun,11,8,3,8.892248182646778e-05,3.33207454961459e-05,0.7272727272727273
9827,나이틀리/Noun,11,8,3,8.892248182646778e-05,3.33207454961459e-05,0.7272727272727273
9828,외침/Noun,11,8,3,8.892248182646778e-05,3.33207454961459e-05,0.7272727272727273
9829,시력/Noun,11,3,8,3.3345930684925414e-05,8.885532132305573e-05,0.7272727272727273
9830,밀고/Noun,11,3,8,3.3345930684925414e-05,8.885532132305573e-05,0.7272727272727273
9831,졸지/Noun,11,3,8,3.3345930684925414e-05,8.885532132305573e-05,0.7272727272727273
9832,패틴슨/Noun,11,3,8,3.3345930684925414e-05,8.885532132305573e-05,0.7272727272727273
9833,영국영화/Noun,11,8,3,8.892248182646778e-05,3.33207454961459e-05,0.7272727272727273
9834,이자스민/Noun,11,3,8,3.3345930684925414e-05,8.885532132305573e-05,0.7272727272727273
9835,합성/Noun,11,3,8,3.3345930684925414e-05,8.885532132305573e-05,0.7272727272727273
9836,대루/Noun,11,3,8,3.3345930684925414e-05,8.885532132305573e-05,0.7272727272727273
9837,뿜었다/Noun,11,3,8,3.3345930684925414e-05,8.885532132305573e-05,0.7272727272727273
9838,뻣뻣하다/Adjective,11,3,8,3.3345930684925414e-05,8.885532132305573e-05,0.7272727272727273
9839,각시탈/Noun,11,8,3,8.892248182646778e-05,3.33207454961459e-05,0.7272727272727273
9840,500원/Number,11,3,8,3.3345930684925414e-05,8.885532132305573e-05,0.7272727272727273
9841,하염없이/Adverb,11,8,3,8.892248182646778e-05,3.33207454961459e-05,0.7272727272727273
9842,이태임/Noun,11,3,8,3.3345930684925414e-05,8.885532132305573e-05,0.7272727272727273
9843,엽/Noun,11,8,3,8.892248182646778e-05,3.33207454961459e-05,0.7272727272727273
9844,박은혜/Noun,11,3,8,3.3345930684925414e-05,8.885532132305573e-05,0.7272727272727273
9845,상하/Noun,11,3,8,3.3345930684925414e-05,8.885532132305573e-05,0.7272727272727273
9846,This/Alpha,11,8,3,8.892248182646778e-05,3.33207454961459e-05,0.7272727272727273
9847,히로스에/Noun,11,3,8,3.3345930684925414e-05,8.885532132305573e-05,0.7272727272727273
9848,양은/Noun,11,3,8,3.3345930684925414e-05,8.885532132305573e-05,0.7272727272727273
9849,자서전/Noun,11,3,8,3.3345930684925414e-05,8.885532132305573e-05,0.7272727272727273
9850,고이/Noun,11,3,8,3.3345930684925414e-05,8.885532132305573e-05,0.7272727272727273
9851,콱/Noun,11,3,8,3.3345930684925414e-05,8.885532132305573e-05,0.7272727272727273
9852,이중인격/Noun,11,3,8,3.3345930684925414e-05,8.885532132305573e-05,0.7272727272727273
9853,허공/Noun,11,3,8,3.3345930684925414e-05,8.885532132305573e-05,0.7272727272727273
9854,임요환/Noun,11,3,8,3.3345930684925414e-05,8.885532132305573e-05,0.7272727272727273
9855,스리/Noun,11,8,3,8.892248182646778e-05,3.33207454961459e-05,0.7272727272727273
9856,가레스/Noun,11,3,8,3.3345930684925414e-05,8.885532132305573e-05,0.7272727272727273
9857,트렁크/Noun,11,3,8,3.3345930684925414e-05,8.885532132305573e-05,0.7272727272727273
9858,골든타임/Noun,11,3,8,3.3345930684925414e-05,8.885532132305573e-05,0.7272727272727273
9859,얼간이/Noun,11,3,8,3.3345930684925414e-05,8.885532132305573e-05,0.7272727272727273
9860,씩/Foreign,11,3,8,3.3345930684925414e-05,8.885532132305573e-05,0.7272727272727273
9861,섭섭하다/Adjective,11,8,3,8.892248182646778e-05,3.33207454961459e-05,0.7272727272727273
9862,여타/Noun,11,8,3,8.892248182646778e-05,3.33207454961459e-05,0.7272727272727273
9863,효율/Noun,11,3,8,3.3345930684925414e-05,8.885532132305573e-05,0.7272727272727273
9864,미처/Noun,11,8,3,8.892248182646778e-05,3.33207454961459e-05,0.7272727272727273
9865,하울/Noun,11,8,3,8.892248182646778e-05,3.33207454961459e-05,0.7272727272727273
9866,애처롭다/Adjective,11,8,3,8.892248182646778e-05,3.33207454961459e-05,0.7272727272727273
9867,꼬띠/Noun,11,8,3,8.892248182646778e-05,3.33207454961459e-05,0.7272727272727273
9868,숭배/Noun,11,3,8,3.3345930684925414e-05,8.885532132305573e-05,0.7272727272727273
9869,비키/Noun,11,3,8,3.3345930684925414e-05,8.885532132305573e-05,0.7272727272727273
9870,꾼/Noun,11,8,3,8.892248182646778e-05,3.33207454961459e-05,0.7272727272727273
9871,열망/Noun,11,8,3,8.892248182646778e-05,3.33207454961459e-05,0.7272727272727273
9872,추적자/Noun,11,8,3,8.892248182646778e-05,3.33207454961459e-05,0.7272727272727273
9873,또래/Noun,11,8,3,8.892248182646778e-05,3.33207454961459e-05,0.7272727272727273
9874,원장/Noun,11,3,8,3.3345930684925414e-05,8.885532132305573e-05,0.7272727272727273
9875,빙/Noun,11,3,8,3.3345930684925414e-05,8.885532132305573e-05,0.7272727272727273
9876,지식인/Noun,11,8,3,8.892248182646778e-05,3.33207454961459e-05,0.7272727272727273
9877,정수/Noun,11,8,3,8.892248182646778e-05,3.33207454961459e-05,0.7272727272727273
9878,미치광이/Noun,11,3,8,3.3345930684925414e-05,8.885532132305573e-05,0.7272727272727273
9879,쵸/VerbPrefix,11,8,3,8.892248182646778e-05,3.33207454961459e-05,0.7272727272727273
9880,화끈/Noun,11,8,3,8.892248182646778e-05,3.33207454961459e-05,0.7272727272727273
9881,증인/Noun,11,3,8,3.3345930684925414e-05,8.885532132305573e-05,0.7272727272727273
9882,악순환/Noun,11,8,3,8.892248182646778e-05,3.33207454961459e-05,0.7272727272727273
9883,최상급/Noun,11,8,3,8.892248182646778e-05,3.33207454961459e-05,0.7272727272727273
9884,유주/Noun,11,8,3,8.892248182646778e-05,3.33207454961459e-05,0.7272727272727273
9885,이제일/Noun,11,8,3,8.892248182646778e-05,3.33207454961459e-05,0.7272727272727273
9886,안심/Noun,11,8,3,8.892248182646778e-05,3.33207454961459e-05,0.7272727272727273
9887,쿵/Noun,11,8,3,8.892248182646778e-05,3.33207454961459e-05,0.7272727272727273
9888,고간/Noun,11,3,8,3.3345930684925414e-05,8.885532132305573e-05,0.7272727272727273
9889,김태우/Noun,11,8,3,8.892248182646778e-05,3.33207454961459e-05,0.7272727272727273
9890,이종혁/Noun,11,8,3,8.892248182646778e-05,3.33207454961459e-05,0.7272727272727273
9891,서른/Modifier,11,8,3,8.892248182646778e-05,3.33207454961459e-05,0.7272727272727273
9892,아이거/Noun,11,7,4,7.78071715981593e-05,4.4427660661527865e-05,0.6363636363636364
9893,골드버그/Noun,11,7,4,7.78071715981593e-05,4.4427660661527865e-05,0.6363636363636364
9894,명함/Noun,11,7,4,7.78071715981593e-05,4.4427660661527865e-05,0.6363636363636364
9895,껌/Noun,11,7,4,7.78071715981593e-05,4.4427660661527865e-05,0.6363636363636364
9896,쪼개다/Verb,11,4,7,4.446124091323389e-05,7.774840615767377e-05,0.6363636363636364
9897,1997년/Number,11,7,4,7.78071715981593e-05,4.4427660661527865e-05,0.6363636363636364
9898,차오르다/Verb,11,7,4,7.78071715981593e-05,4.4427660661527865e-05,0.6363636363636364
9899,겟/Noun,11,4,7,4.446124091323389e-05,7.774840615767377e-05,0.6363636363636364
9900,감수/Noun,11,4,7,4.446124091323389e-05,7.774840615767377e-05,0.6363636363636364
9901,득/Noun,11,4,7,4.446124091323389e-05,7.774840615767377e-05,0.6363636363636364
9902,이지훈/Noun,11,4,7,4.446124091323389e-05,7.774840615767377e-05,0.6363636363636364
9903,었/Noun,11,7,4,7.78071715981593e-05,4.4427660661527865e-05,0.6363636363636364
9904,출중하다/Adjective,11,7,4,7.78071715981593e-05,4.4427660661527865e-05,0.6363636363636364
9905,견줄만/Noun,11,7,4,7.78071715981593e-05,4.4427660661527865e-05,0.6363636363636364
9906,비감/Noun,11,4,7,4.446124091323389e-05,7.774840615767377e-05,0.6363636363636364
9907,건네다/Verb,11,7,4,7.78071715981593e-05,4.4427660661527865e-05,0.6363636363636364
9908,정지/Noun,11,7,4,7.78071715981593e-05,4.4427660661527865e-05,0.6363636363636364
9909,임무/Noun,11,4,7,4.446124091323389e-05,7.774840615767377e-05,0.6363636363636364
9910,산트/Noun,11,7,4,7.78071715981593e-05,4.4427660661527865e-05,0.6363636363636364
9911,열등감/Noun,11,4,7,4.446124091323389e-05,7.774840615767377e-05,0.6363636363636364
9912,헛점/Noun,11,4,7,4.446124091323389e-05,7.774840615767377e-05,0.6363636363636364
9913,솔솔/Noun,11,4,7,4.446124091323389e-05,7.774840615767377e-05,0.6363636363636364
9914,천장/Noun,11,7,4,7.78071715981593e-05,4.4427660661527865e-05,0.6363636363636364
9915,우치/Noun,11,7,4,7.78071715981593e-05,4.4427660661527865e-05,0.6363636363636364
9916,화비/Noun,11,4,7,4.446124091323389e-05,7.774840615767377e-05,0.6363636363636364
9917,뚱뚱하다/Adjective,11,4,7,4.446124091323389e-05,7.774840615767377e-05,0.6363636363636364
9918,본드걸/Noun,11,7,4,7.78071715981593e-05,4.4427660661527865e-05,0.6363636363636364
9919,집시/Noun,11,7,4,7.78071715981593e-05,4.4427660661527865e-05,0.6363636363636364
9920,퀄러티/Noun,11,7,4,7.78071715981593e-05,4.4427660661527865e-05,0.6363636363636364
9921,분열/Noun,11,4,7,4.446124091323389e-05,7.774840615767377e-05,0.6363636363636364
9922,후우/Exclamation,11,4,7,4.446124091323389e-05,7.774840615767377e-05,0.6363636363636364
9923,배창호/Noun,11,7,4,7.78071715981593e-05,4.4427660661527865e-05,0.6363636363636364
9924,팝송/Noun,11,4,7,4.446124091323389e-05,7.774840615767377e-05,0.6363636363636364
9925,열악하다/Adjective,11,4,7,4.446124091323389e-05,7.774840615767377e-05,0.6363636363636364
9926,악랄하다/Adjective,11,7,4,7.78071715981593e-05,4.4427660661527865e-05,0.6363636363636364
9927,오멘/Noun,11,7,4,7.78071715981593e-05,4.4427660661527865e-05,0.6363636363636364
9928,머시/Noun,11,7,4,7.78071715981593e-05,4.4427660661527865e-05,0.6363636363636364
9929,열광/Noun,11,7,4,7.78071715981593e-05,4.4427660661527865e-05,0.6363636363636364
9930,아보/Noun,11,4,7,4.446124091323389e-05,7.774840615767377e-05,0.6363636363636364
9931,숨기/Noun,11,4,7,4.446124091323389e-05,7.774840615767377e-05,0.6363636363636364
9932,퍼/PreEomi,11,4,7,4.446124091323389e-05,7.774840615767377e-05,0.6363636363636364
9933,러쉬/Noun,11,7,4,7.78071715981593e-05,4.4427660661527865e-05,0.6363636363636364
9934,반올림/Noun,11,4,7,4.446124091323389e-05,7.774840615767377e-05,0.6363636363636364
9935,이하고/Josa,11,4,7,4.446124091323389e-05,7.774840615767377e-05,0.6363636363636364
9936,종자/Noun,11,4,7,4.446124091323389e-05,7.774840615767377e-05,0.6363636363636364
9937,더구나/Noun,11,4,7,4.446124091323389e-05,7.774840615767377e-05,0.6363636363636364
9938,톰슨/Noun,11,7,4,7.78071715981593e-05,4.4427660661527865e-05,0.6363636363636364
9939,사이드/Noun,11,7,4,7.78071715981593e-05,4.4427660661527865e-05,0.6363636363636364
9940,가트/Noun,11,7,4,7.78071715981593e-05,4.4427660661527865e-05,0.6363636363636364
9941,일제시대/Noun,11,7,4,7.78071715981593e-05,4.4427660661527865e-05,0.6363636363636364
9942,씨부리다/Verb,11,4,7,4.446124091323389e-05,7.774840615767377e-05,0.6363636363636364
9943,다리다/Verb,11,4,7,4.446124091323389e-05,7.774840615767377e-05,0.6363636363636364
9944,총각/Noun,11,4,7,4.446124091323389e-05,7.774840615767377e-05,0.6363636363636364
9945,자서/Noun,11,4,7,4.446124091323389e-05,7.774840615767377e-05,0.6363636363636364
9946,쿄코/Noun,11,4,7,4.446124091323389e-05,7.774840615767377e-05,0.6363636363636364
9947,롤러코스터/Noun,11,7,4,7.78071715981593e-05,4.4427660661527865e-05,0.6363636363636364
9948,세영/Noun,11,4,7,4.446124091323389e-05,7.774840615767377e-05,0.6363636363636364
9949,호수/Noun,11,7,4,7.78071715981593e-05,4.4427660661527865e-05,0.6363636363636364
9950,장고/Noun,11,7,4,7.78071715981593e-05,4.4427660661527865e-05,0.6363636363636364
9951,간장/Noun,11,4,7,4.446124091323389e-05,7.774840615767377e-05,0.6363636363636364
9952,으로서는/Josa,11,4,7,4.446124091323389e-05,7.774840615767377e-05,0.6363636363636364
9953,수상작/Noun,11,7,4,7.78071715981593e-05,4.4427660661527865e-05,0.6363636363636364
9954,거북이/Noun,11,7,4,7.78071715981593e-05,4.4427660661527865e-05,0.6363636363636364
9955,맨오브스틸/Noun,11,4,7,4.446124091323389e-05,7.774840615767377e-05,0.6363636363636364
9956,매니저/Noun,11,4,7,4.446124091323389e-05,7.774840615767377e-05,0.6363636363636364
9957,김일성/Noun,11,4,7,4.446124091323389e-05,7.774840615767377e-05,0.6363636363636364
9958,ㄲ/KoreanParticle,11,4,7,4.446124091323389e-05,7.774840615767377e-05,0.6363636363636364
9959,앓다/Verb,11,7,4,7.78071715981593e-05,4.4427660661527865e-05,0.6363636363636364
9960,퍼시픽림/Noun,11,4,7,4.446124091323389e-05,7.774840615767377e-05,0.6363636363636364
9961,전원/Noun,11,4,7,4.446124091323389e-05,7.774840615767377e-05,0.6363636363636364
9962,샤넬/Noun,11,4,7,4.446124091323389e-05,7.774840615767377e-05,0.6363636363636364
9963,60분/Number,11,4,7,4.446124091323389e-05,7.774840615767377e-05,0.6363636363636364
9964,심혜진/Noun,11,4,7,4.446124091323389e-05,7.774840615767377e-05,0.6363636363636364
9965,제기/Noun,11,4,7,4.446124091323389e-05,7.774840615767377e-05,0.6363636363636364
9966,도우/Noun,11,7,4,7.78071715981593e-05,4.4427660661527865e-05,0.6363636363636364
9967,에두/Noun,11,4,7,4.446124091323389e-05,7.774840615767377e-05,0.6363636363636364
9968,스트/Noun,11,4,7,4.446124091323389e-05,7.774840615767377e-05,0.6363636363636364
9969,창고/Noun,11,4,7,4.446124091323389e-05,7.774840615767377e-05,0.6363636363636364
9970,도심/Noun,11,7,4,7.78071715981593e-05,4.4427660661527865e-05,0.6363636363636364
9971,메가폰/Noun,11,4,7,4.446124091323389e-05,7.774840615767377e-05,0.6363636363636364
9972,카밀라/Noun,11,4,7,4.446124091323389e-05,7.774840615767377e-05,0.6363636363636364
9973,계승/Noun,11,7,4,7.78071715981593e-05,4.4427660661527865e-05,0.6363636363636364
9974,김새론/Noun,11,7,4,7.78071715981593e-05,4.4427660661527865e-05,0.6363636363636364
9975,한지혜/Noun,11,7,4,7.78071715981593e-05,4.4427660661527865e-05,0.6363636363636364
9976,부도/Noun,11,7,4,7.78071715981593e-05,4.4427660661527865e-05,0.6363636363636364
9977,아아/Exclamation,11,4,7,4.446124091323389e-05,7.774840615767377e-05,0.6363636363636364
9978,민정/Noun,11,4,7,4.446124091323389e-05,7.774840615767377e-05,0.6363636363636364
9979,만발/Noun,11,4,7,4.446124091323389e-05,7.774840615767377e-05,0.6363636363636364
9980,82년/Number,11,7,4,7.78071715981593e-05,4.4427660661527865e-05,0.6363636363636364
9981,모가지/Noun,11,4,7,4.446124091323389e-05,7.774840615767377e-05,0.6363636363636364
9982,왼쪽/Noun,11,4,7,4.446124091323389e-05,7.774840615767377e-05,0.6363636363636364
9983,트랩/Noun,11,4,7,4.446124091323389e-05,7.774840615767377e-05,0.6363636363636364
9984,맹인/Noun,11,7,4,7.78071715981593e-05,4.4427660661527865e-05,0.6363636363636364
9985,보완/Noun,11,4,7,4.446124091323389e-05,7.774840615767377e-05,0.6363636363636364
9986,거인/Noun,11,4,7,4.446124091323389e-05,7.774840615767377e-05,0.6363636363636364
9987,포세이돈/Noun,11,7,4,7.78071715981593e-05,4.4427660661527865e-05,0.6363636363636364
9988,마감/Noun,11,4,7,4.446124091323389e-05,7.774840615767377e-05,0.6363636363636364
9989,캐나다/Noun,11,4,7,4.446124091323389e-05,7.774840615767377e-05,0.6363636363636364
9990,코멘트/Noun,11,7,4,7.78071715981593e-05,4.4427660661527865e-05,0.6363636363636364
9991,오라/Noun,11,4,7,4.446124091323389e-05,7.774840615767377e-05,0.6363636363636364
9992,현혹/Noun,11,4,7,4.446124091323389e-05,7.774840615767377e-05,0.6363636363636364
9993,부시다/Verb,11,4,7,4.446124091323389e-05,7.774840615767377e-05,0.6363636363636364
9994,고니/Noun,11,7,4,7.78071715981593e-05,4.4427660661527865e-05,0.6363636363636364
9995,설사/Noun,11,4,7,4.446124091323389e-05,7.774840615767377e-05,0.6363636363636364
9996,토로/Noun,11,7,4,7.78071715981593e-05,4.4427660661527865e-05,0.6363636363636364
9997,****)/Punctuation,11,7,4,7.78071715981593e-05,4.4427660661527865e-05,0.6363636363636364
9998,일그러지다/Verb,11,7,4,7.78071715981593e-05,4.4427660661527865e-05,0.6363636363636364
9999,성실하다/Adjective,11,4,7,4.446124091323389e-05,7.774840615767377e-05,0.6363636363636364
10000,튼튼하다/Adjective,11,7,4,7.78071715981593e-05,4.4427660661527865e-05,0.6363636363636364
10001,룬드/Noun,11,7,4,7.78071715981593e-05,4.4427660661527865e-05,0.6363636363636364
10002,저하/Noun,11,4,7,4.446124091323389e-05,7.774840615767377e-05,0.6363636363636364
10003,주소/Noun,11,7,4,7.78071715981593e-05,4.4427660661527865e-05,0.6363636363636364
10004,괴물영화/Noun,11,7,4,7.78071715981593e-05,4.4427660661527865e-05,0.6363636363636364
10005,빈자리/Noun,11,7,4,7.78071715981593e-05,4.4427660661527865e-05,0.6363636363636364
10006,오도/Noun,11,7,4,7.78071715981593e-05,4.4427660661527865e-05,0.6363636363636364
10007,마린/Noun,11,4,7,4.446124091323389e-05,7.774840615767377e-05,0.6363636363636364
10008,뉘/Noun,11,4,7,4.446124091323389e-05,7.774840615767377e-05,0.6363636363636364
10009,cctv/Alpha,11,4,7,4.446124091323389e-05,7.774840615767377e-05,0.6363636363636364
10010,딸내미/Noun,11,4,7,4.446124091323389e-05,7.774840615767377e-05,0.6363636363636364
10011,비견/Noun,11,7,4,7.78071715981593e-05,4.4427660661527865e-05,0.6363636363636364
10012,우유/Noun,11,6,5,6.669186136985083e-05,5.5534575826909837e-05,0.5454545454545454
10013,4일/Number,11,6,5,6.669186136985083e-05,5.5534575826909837e-05,0.5454545454545454
10014,청불/Noun,11,5,6,5.557655114154236e-05,6.66414909922918e-05,0.5454545454545454
10015,중사/Noun,11,5,6,5.557655114154236e-05,6.66414909922918e-05,0.5454545454545454
10016,힐러/Noun,11,5,6,5.557655114154236e-05,6.66414909922918e-05,0.5454545454545454
10017,윈/Noun,11,6,5,6.669186136985083e-05,5.5534575826909837e-05,0.5454545454545454
10018,비아/Noun,11,5,6,5.557655114154236e-05,6.66414909922918e-05,0.5454545454545454
10019,컴플렉스/Noun,11,6,5,6.669186136985083e-05,5.5534575826909837e-05,0.5454545454545454
10020,적지/Noun,11,6,5,6.669186136985083e-05,5.5534575826909837e-05,0.5454545454545454
10021,투캅스/Noun,11,5,6,5.557655114154236e-05,6.66414909922918e-05,0.5454545454545454
10022,데이비스/Noun,11,6,5,6.669186136985083e-05,5.5534575826909837e-05,0.5454545454545454
10023,어짜피/Adverb,11,5,6,5.557655114154236e-05,6.66414909922918e-05,0.5454545454545454
10024,동작/Noun,11,6,5,6.669186136985083e-05,5.5534575826909837e-05,0.5454545454545454
10025,이재용/Noun,11,5,6,5.557655114154236e-05,6.66414909922918e-05,0.5454545454545454
10026,코피/Noun,11,6,5,6.669186136985083e-05,5.5534575826909837e-05,0.5454545454545454
10027,우릴/Noun,11,6,5,6.669186136985083e-05,5.5534575826909837e-05,0.5454545454545454
10028,면적/Noun,11,5,6,5.557655114154236e-05,6.66414909922918e-05,0.5454545454545454
10029,세얼간이/Noun,11,5,6,5.557655114154236e-05,6.66414909922918e-05,0.5454545454545454
10030,흙/Noun,11,6,5,6.669186136985083e-05,5.5534575826909837e-05,0.5454545454545454
10031,..???/Punctuation,11,5,6,5.557655114154236e-05,6.66414909922918e-05,0.5454545454545454
10032,차서/Noun,11,5,6,5.557655114154236e-05,6.66414909922918e-05,0.5454545454545454
10033,에스/Noun,11,5,6,5.557655114154236e-05,6.66414909922918e-05,0.5454545454545454
10034,룸메이트/Noun,11,5,6,5.557655114154236e-05,6.66414909922918e-05,0.5454545454545454
10035,점안/Noun,11,6,5,6.669186136985083e-05,5.5534575826909837e-05,0.5454545454545454
10036,이하늬/Noun,11,6,5,6.669186136985083e-05,5.5534575826909837e-05,0.5454545454545454
10037,\/Punctuation,11,6,5,6.669186136985083e-05,5.5534575826909837e-05,0.5454545454545454
10038,이랬는데/Conjunction,11,5,6,5.557655114154236e-05,6.66414909922918e-05,0.5454545454545454
10039,라붐/Noun,11,6,5,6.669186136985083e-05,5.5534575826909837e-05,0.5454545454545454
10040,확률/Noun,11,6,5,6.669186136985083e-05,5.5534575826909837e-05,0.5454545454545454
10041,아멘/Noun,11,5,6,5.557655114154236e-05,6.66414909922918e-05,0.5454545454545454
10042,cf/Alpha,11,5,6,5.557655114154236e-05,6.66414909922918e-05,0.5454545454545454
10043,간디/Noun,11,6,5,6.669186136985083e-05,5.5534575826909837e-05,0.5454545454545454
10044,각오/Noun,11,6,5,6.669186136985083e-05,5.5534575826909837e-05,0.5454545454545454
10045,누적/Noun,11,5,6,5.557655114154236e-05,6.66414909922918e-05,0.5454545454545454
10046,허드슨/Noun,11,5,6,5.557655114154236e-05,6.66414909922918e-05,0.5454545454545454
10047,!../Punctuation,11,5,6,5.557655114154236e-05,6.66414909922918e-05,0.5454545454545454
10048,승천/Noun,11,6,5,6.669186136985083e-05,5.5534575826909837e-05,0.5454545454545454
10049,세인/Noun,11,5,6,5.557655114154236e-05,6.66414909922918e-05,0.5454545454545454
10050,여행가/Noun,11,6,5,6.669186136985083e-05,5.5534575826909837e-05,0.5454545454545454
10051,큐브릭/Noun,11,6,5,6.669186136985083e-05,5.5534575826909837e-05,0.5454545454545454
10052,계륜미/Noun,11,5,6,5.557655114154236e-05,6.66414909922918e-05,0.5454545454545454
10053,구한/Noun,11,6,5,6.669186136985083e-05,5.5534575826909837e-05,0.5454545454545454
10054,음침하다/Adjective,11,6,5,6.669186136985083e-05,5.5534575826909837e-05,0.5454545454545454
10055,7월/Number,11,5,6,5.557655114154236e-05,6.66414909922918e-05,0.5454545454545454
10056,화류/Noun,11,5,6,5.557655114154236e-05,6.66414909922918e-05,0.5454545454545454
10057,늑대소년/Noun,11,5,6,5.557655114154236e-05,6.66414909922918e-05,0.5454545454545454
10058,특별출연/Noun,11,6,5,6.669186136985083e-05,5.5534575826909837e-05,0.5454545454545454
10059,중경삼림/Noun,11,6,5,6.669186136985083e-05,5.5534575826909837e-05,0.5454545454545454
10060,처키/Noun,11,6,5,6.669186136985083e-05,5.5534575826909837e-05,0.5454545454545454
10061,솔까말/Noun,11,5,6,5.557655114154236e-05,6.66414909922918e-05,0.5454545454545454
10062,빗나가다/Verb,11,5,6,5.557655114154236e-05,6.66414909922918e-05,0.5454545454545454
10063,부잣집/Noun,11,5,6,5.557655114154236e-05,6.66414909922918e-05,0.5454545454545454
10064,제트/Noun,11,5,6,5.557655114154236e-05,6.66414909922918e-05,0.5454545454545454
10065,야마다/Noun,11,6,5,6.669186136985083e-05,5.5534575826909837e-05,0.5454545454545454
10066,셧/Noun,11,5,6,5.557655114154236e-05,6.66414909922918e-05,0.5454545454545454
10067,사토미/Noun,11,6,5,6.669186136985083e-05,5.5534575826909837e-05,0.5454545454545454
10068,학도/Noun,11,6,5,6.669186136985083e-05,5.5534575826909837e-05,0.5454545454545454
10069,에볼루션/Noun,11,6,5,6.669186136985083e-05,5.5534575826909837e-05,0.5454545454545454
10070,.~~/Punctuation,11,5,6,5.557655114154236e-05,6.66414909922918e-05,0.5454545454545454
10071,러너/Noun,11,5,6,5.557655114154236e-05,6.66414909922918e-05,0.5454545454545454
10072,로맨틱영화/Noun,11,6,5,6.669186136985083e-05,5.5534575826909837e-05,0.5454545454545454
10073,난뒤/Noun,11,6,5,6.669186136985083e-05,5.5534575826909837e-05,0.5454545454545454
10074,스완/Noun,11,6,5,6.669186136985083e-05,5.5534575826909837e-05,0.5454545454545454
10075,가/Foreign,11,6,5,6.669186136985083e-05,5.5534575826909837e-05,0.5454545454545454
10076,브라/Noun,11,6,5,6.669186136985083e-05,5.5534575826909837e-05,0.5454545454545454
10077,클로이/Noun,11,6,5,6.669186136985083e-05,5.5534575826909837e-05,0.5454545454545454
10078,빌딩/Noun,11,5,6,5.557655114154236e-05,6.66414909922918e-05,0.5454545454545454
10079,공산주의/Noun,11,5,6,5.557655114154236e-05,6.66414909922918e-05,0.5454545454545454
10080,깁슨/Noun,11,6,5,6.669186136985083e-05,5.5534575826909837e-05,0.5454545454545454
10081,럭/Noun,11,6,5,6.669186136985083e-05,5.5534575826909837e-05,0.5454545454545454
10082,보복/Noun,11,5,6,5.557655114154236e-05,6.66414909922918e-05,0.5454545454545454
10083,아랍/Noun,11,6,5,6.669186136985083e-05,5.5534575826909837e-05,0.5454545454545454
10084,반란/Noun,11,6,5,6.669186136985083e-05,5.5534575826909837e-05,0.5454545454545454
10085,발버둥치다/Verb,11,6,5,6.669186136985083e-05,5.5534575826909837e-05,0.5454545454545454
10086,연우진/Noun,11,6,5,6.669186136985083e-05,5.5534575826909837e-05,0.5454545454545454
10087,엄지/Noun,11,6,5,6.669186136985083e-05,5.5534575826909837e-05,0.5454545454545454
10088,접속/Noun,11,5,6,5.557655114154236e-05,6.66414909922918e-05,0.5454545454545454
10089,상세/Noun,11,5,6,5.557655114154236e-05,6.66414909922918e-05,0.5454545454545454
10090,선조/Noun,11,5,6,5.557655114154236e-05,6.66414909922918e-05,0.5454545454545454
10091,".,,/Punctuation",11,6,5,6.669186136985083e-05,5.5534575826909837e-05,0.5454545454545454
10092,소의/Noun,11,6,5,6.669186136985083e-05,5.5534575826909837e-05,0.5454545454545454
10093,조윤희/Noun,11,5,6,5.557655114154236e-05,6.66414909922918e-05,0.5454545454545454
10094,어진/Noun,11,6,5,6.669186136985083e-05,5.5534575826909837e-05,0.5454545454545454
10095,플래툰/Noun,11,6,5,6.669186136985083e-05,5.5534575826909837e-05,0.5454545454545454
10096,슬링/Noun,11,6,5,6.669186136985083e-05,5.5534575826909837e-05,0.5454545454545454
10097,역습/Noun,11,5,6,5.557655114154236e-05,6.66414909922918e-05,0.5454545454545454
10098,윤하/Noun,11,5,6,5.557655114154236e-05,6.66414909922918e-05,0.5454545454545454
10099,모레/Noun,11,6,5,6.669186136985083e-05,5.5534575826909837e-05,0.5454545454545454
10100,열쇠/Noun,11,6,5,6.669186136985083e-05,5.5534575826909837e-05,0.5454545454545454
10101,조정석/Noun,11,6,5,6.669186136985083e-05,5.5534575826909837e-05,0.5454545454545454
10102,틀림/Noun,11,5,6,5.557655114154236e-05,6.66414909922918e-05,0.5454545454545454
10103,군상/Noun,11,5,6,5.557655114154236e-05,6.66414909922918e-05,0.5454545454545454
10104,vod/Alpha,11,5,6,5.557655114154236e-05,6.66414909922918e-05,0.5454545454545454
10105,제타/Noun,11,6,5,6.669186136985083e-05,5.5534575826909837e-05,0.5454545454545454
10106,김민선/Noun,11,5,6,5.557655114154236e-05,6.66414909922918e-05,0.5454545454545454
10107,와일드/Noun,11,5,6,5.557655114154236e-05,6.66414909922918e-05,0.5454545454545454
10108,소유자/Noun,11,5,6,5.557655114154236e-05,6.66414909922918e-05,0.5454545454545454
10109,송은채/Noun,11,5,6,5.557655114154236e-05,6.66414909922918e-05,0.5454545454545454
10110,역전/Noun,11,6,5,6.669186136985083e-05,5.5534575826909837e-05,0.5454545454545454
10111,코스/Noun,11,6,5,6.669186136985083e-05,5.5534575826909837e-05,0.5454545454545454
10112,결단/Noun,11,5,6,5.557655114154236e-05,6.66414909922918e-05,0.5454545454545454
10113,오른/Noun,11,6,5,6.669186136985083e-05,5.5534575826909837e-05,0.5454545454545454
10114,배타/Noun,11,6,5,6.669186136985083e-05,5.5534575826909837e-05,0.5454545454545454
10115,통통/Noun,11,6,5,6.669186136985083e-05,5.5534575826909837e-05,0.5454545454545454
10116,베스타/Noun,11,6,5,6.669186136985083e-05,5.5534575826909837e-05,0.5454545454545454
10117,난건/Noun,11,6,5,6.669186136985083e-05,5.5534575826909837e-05,0.5454545454545454
10118,빗대다/Verb,11,6,5,6.669186136985083e-05,5.5534575826909837e-05,0.5454545454545454
10119,지점/Noun,11,6,5,6.669186136985083e-05,5.5534575826909837e-05,0.5454545454545454
10120,유심/Noun,11,5,6,5.557655114154236e-05,6.66414909922918e-05,0.5454545454545454
10121,델/Noun,11,6,5,6.669186136985083e-05,5.5534575826909837e-05,0.5454545454545454
10122,브라운관/Noun,11,5,6,5.557655114154236e-05,6.66414909922918e-05,0.5454545454545454
10123,로스트/Noun,11,5,6,5.557655114154236e-05,6.66414909922918e-05,0.5454545454545454
10124,다이나믹/Noun,11,6,5,6.669186136985083e-05,5.5534575826909837e-05,0.5454545454545454
10125,화학/Noun,11,5,6,5.557655114154236e-05,6.66414909922918e-05,0.5454545454545454
10126,목록/Noun,11,6,5,6.669186136985083e-05,5.5534575826909837e-05,0.5454545454545454
10127,카메론디아즈/Noun,11,5,6,5.557655114154236e-05,6.66414909922918e-05,0.5454545454545454
10128,추격씬/Noun,11,5,6,5.557655114154236e-05,6.66414909922918e-05,0.5454545454545454
10129,결핍/Noun,11,6,5,6.669186136985083e-05,5.5534575826909837e-05,0.5454545454545454
10130,폴리스/Noun,11,6,5,6.669186136985083e-05,5.5534575826909837e-05,0.5454545454545454
10131,야기/Noun,11,6,5,6.669186136985083e-05,5.5534575826909837e-05,0.5454545454545454
10132,해방/Noun,11,6,5,6.669186136985083e-05,5.5534575826909837e-05,0.5454545454545454
10133,테스/Noun,11,5,6,5.557655114154236e-05,6.66414909922918e-05,0.5454545454545454
10134,엄지원/Noun,11,6,5,6.669186136985083e-05,5.5534575826909837e-05,0.5454545454545454
10135,목격/Noun,11,6,5,6.669186136985083e-05,5.5534575826909837e-05,0.5454545454545454
10136,맴버/Noun,11,6,5,6.669186136985083e-05,5.5534575826909837e-05,0.5454545454545454
10137,떨치다/Verb,11,5,6,5.557655114154236e-05,6.66414909922918e-05,0.5454545454545454
10138,연제욱/Noun,11,6,5,6.669186136985083e-05,5.5534575826909837e-05,0.5454545454545454
10139,불치/Noun,11,6,5,6.669186136985083e-05,5.5534575826909837e-05,0.5454545454545454
10140,손현주/Noun,11,6,5,6.669186136985083e-05,5.5534575826909837e-05,0.5454545454545454
10141,따갑다/Adjective,11,5,6,5.557655114154236e-05,6.66414909922918e-05,0.5454545454545454
10142,떠다니다/Verb,11,6,5,6.669186136985083e-05,5.5534575826909837e-05,0.5454545454545454
10143,령/Noun,11,5,6,5.557655114154236e-05,6.66414909922918e-05,0.5454545454545454
10144,들키다/Verb,11,6,5,6.669186136985083e-05,5.5534575826909837e-05,0.5454545454545454
10145,규모/Noun,11,5,6,5.557655114154236e-05,6.66414909922918e-05,0.5454545454545454
10146,의젖/Noun,10,0,10,0.0,0.00011106915165381967,1.0
10147,본전/Noun,10,0,10,0.0,0.00011106915165381967,1.0
10148,forever/Alpha,10,10,0,0.00011115310228308472,0.0,1.0
10149,로고/Noun,10,0,10,0.0,0.00011106915165381967,1.0
10150,정겨운/Noun,10,10,0,0.00011115310228308472,0.0,1.0
10151,검증/Noun,10,0,10,0.0,0.00011106915165381967,1.0
10152,마틸다/Noun,10,10,0,0.00011115310228308472,0.0,1.0
10153,주르륵/Noun,10,10,0,0.00011115310228308472,0.0,1.0
10154,쟈니/Noun,10,10,0,0.00011115310228308472,0.0,1.0
10155,소나/Noun,10,0,10,0.0,0.00011106915165381967,1.0
10156,에스티/Noun,10,10,0,0.00011115310228308472,0.0,1.0
10157,trash/Alpha,10,0,10,0.0,0.00011106915165381967,1.0
10158,벅차오르다/Adjective,10,10,0,0.00011115310228308472,0.0,1.0
10159,증발/Noun,10,0,10,0.0,0.00011106915165381967,1.0
10160,제데로/Adverb,10,0,10,0.0,0.00011106915165381967,1.0
10161,비디오영화/Noun,10,0,10,0.0,0.00011106915165381967,1.0
10162,욱일승천기/Noun,10,0,10,0.0,0.00011106915165381967,1.0
10163,베르세르크/Noun,10,10,0,0.00011115310228308472,0.0,1.0
10164,미자/Noun,10,10,0,0.00011115310228308472,0.0,1.0
10165,숨죽/Noun,10,10,0,0.00011115310228308472,0.0,1.0
10166,안재욱/Noun,10,10,0,0.00011115310228308472,0.0,1.0
10167,8.0/Number,10,10,0,0.00011115310228308472,0.0,1.0
10168,아낌없다/Adjective,10,10,0,0.00011115310228308472,0.0,1.0
10169,떡칠/Noun,10,0,10,0.0,0.00011106915165381967,1.0
10170,부조화/Noun,10,0,10,0.0,0.00011106915165381967,1.0
10171,great/Alpha,10,10,0,0.00011115310228308472,0.0,1.0
10172,베끼기/Noun,10,0,10,0.0,0.00011106915165381967,1.0
10173,마음씨/Noun,10,10,0,0.00011115310228308472,0.0,1.0
10174,송희진/Noun,10,0,10,0.0,0.00011106915165381967,1.0
10175,정선희/Noun,10,0,10,0.0,0.00011106915165381967,1.0
10176,:-)/Punctuation,10,10,0,0.00011115310228308472,0.0,1.0
10177,불체/Noun,10,0,10,0.0,0.00011106915165381967,1.0
10178,집기/Noun,10,0,10,0.0,0.00011106915165381967,1.0
10179,존멋/Noun,10,10,0,0.00011115310228308472,0.0,1.0
10180,♥♥♥♥♥/Foreign,10,10,0,0.00011115310228308472,0.0,1.0
10181,~!^^/Punctuation,10,10,0,0.00011115310228308472,0.0,1.0
10182,생쇼/Noun,10,0,10,0.0,0.00011106915165381967,1.0
10183,이지마/Noun,10,0,10,0.0,0.00011106915165381967,1.0
10184,영문/Noun,10,0,10,0.0,0.00011106915165381967,1.0
10185,차만/Noun,10,0,10,0.0,0.00011106915165381967,1.0
10186,벡터맨/Noun,10,0,10,0.0,0.00011106915165381967,1.0
10187,ㅗㅗㅗ/KoreanParticle,10,0,10,0.0,0.00011106915165381967,1.0
10188,ㅠㅜㅠ/KoreanParticle,10,10,0,0.00011115310228308472,0.0,1.0
10189,윤제균/Noun,10,0,10,0.0,0.00011106915165381967,1.0
10190,우연찮/Noun,10,10,0,0.00011115310228308472,0.0,1.0
10191,루비/Noun,10,1,9,1.1115310228308472e-05,9.99622364884377e-05,0.9
10192,안면/Noun,10,1,9,1.1115310228308472e-05,9.99622364884377e-05,0.9
10193,공사/Noun,10,1,9,1.1115310228308472e-05,9.99622364884377e-05,0.9
10194,이기만/Noun,10,1,9,1.1115310228308472e-05,9.99622364884377e-05,0.9
10195,하희라/Noun,10,1,9,1.1115310228308472e-05,9.99622364884377e-05,0.9
10196,사살/Noun,10,1,9,1.1115310228308472e-05,9.99622364884377e-05,0.9
10197,차도/Noun,10,1,9,1.1115310228308472e-05,9.99622364884377e-05,0.9
10198,맘속/Noun,10,9,1,0.00010003779205477625,1.1106915165381966e-05,0.9
10199,고삐/Noun,10,1,9,1.1115310228308472e-05,9.99622364884377e-05,0.9
10200,도용/Noun,10,1,9,1.1115310228308472e-05,9.99622364884377e-05,0.9
10201,쉴드치다/Verb,10,1,9,1.1115310228308472e-05,9.99622364884377e-05,0.9
10202,몰살/Noun,10,1,9,1.1115310228308472e-05,9.99622364884377e-05,0.9
10203,모시/Noun,10,9,1,0.00010003779205477625,1.1106915165381966e-05,0.9
10204,이데올로기/Noun,10,9,1,0.00010003779205477625,1.1106915165381966e-05,0.9
10205,왈칵/Noun,10,9,1,0.00010003779205477625,1.1106915165381966e-05,0.9
10206,박서준/Noun,10,9,1,0.00010003779205477625,1.1106915165381966e-05,0.9
10207,익살스럽다/Adjective,10,9,1,0.00010003779205477625,1.1106915165381966e-05,0.9
10208,지민/Noun,10,9,1,0.00010003779205477625,1.1106915165381966e-05,0.9
10209,기획사/Noun,10,1,9,1.1115310228308472e-05,9.99622364884377e-05,0.9
10210,대게/Noun,10,9,1,0.00010003779205477625,1.1106915165381966e-05,0.9
10211,하향/Noun,10,1,9,1.1115310228308472e-05,9.99622364884377e-05,0.9
10212,0%/Number,10,1,9,1.1115310228308472e-05,9.99622364884377e-05,0.9
10213,ㅜㅠㅠ/KoreanParticle,10,9,1,0.00010003779205477625,1.1106915165381966e-05,0.9
10214,엠/Noun,10,1,9,1.1115310228308472e-05,9.99622364884377e-05,0.9
10215,...-_-;/Punctuation,10,1,9,1.1115310228308472e-05,9.99622364884377e-05,0.9
10216,발단/Noun,10,1,9,1.1115310228308472e-05,9.99622364884377e-05,0.9
10217,줏대/Noun,10,1,9,1.1115310228308472e-05,9.99622364884377e-05,0.9
10218,비밥/Noun,10,9,1,0.00010003779205477625,1.1106915165381966e-05,0.9
10219,처분/Noun,10,1,9,1.1115310228308472e-05,9.99622364884377e-05,0.9
10220,통렬/Noun,10,9,1,0.00010003779205477625,1.1106915165381966e-05,0.9
10221,지리멸렬하다/Adjective,10,1,9,1.1115310228308472e-05,9.99622364884377e-05,0.9
10222,^^!/Punctuation,10,9,1,0.00010003779205477625,1.1106915165381966e-05,0.9
10223,2~3/Number,10,1,9,1.1115310228308472e-05,9.99622364884377e-05,0.9
10224,그루지/Noun,10,1,9,1.1115310228308472e-05,9.99622364884377e-05,0.9
10225,타지/Noun,10,9,1,0.00010003779205477625,1.1106915165381966e-05,0.9
10226,추잡/Noun,10,1,9,1.1115310228308472e-05,9.99622364884377e-05,0.9
10227,사회생활/Noun,10,9,1,0.00010003779205477625,1.1106915165381966e-05,0.9
10228,120분/Number,10,1,9,1.1115310228308472e-05,9.99622364884377e-05,0.9
10229,단서/Noun,10,1,9,1.1115310228308472e-05,9.99622364884377e-05,0.9
10230,전주/Noun,10,9,1,0.00010003779205477625,1.1106915165381966e-05,0.9
10231,캐스퍼/Noun,10,9,1,0.00010003779205477625,1.1106915165381966e-05,0.9
10232,구제/Noun,10,1,9,1.1115310228308472e-05,9.99622364884377e-05,0.9
10233,70%/Number,10,1,9,1.1115310228308472e-05,9.99622364884377e-05,0.9
10234,처녀/Noun,10,1,9,1.1115310228308472e-05,9.99622364884377e-05,0.9
10235,조만간/Noun,10,9,1,0.00010003779205477625,1.1106915165381966e-05,0.9
10236,장구/Noun,10,1,9,1.1115310228308472e-05,9.99622364884377e-05,0.9
10237,육성/Noun,10,1,9,1.1115310228308472e-05,9.99622364884377e-05,0.9
10238,개꿀/Noun,10,9,1,0.00010003779205477625,1.1106915165381966e-05,0.9
10239,스톰/Noun,10,1,9,1.1115310228308472e-05,9.99622364884377e-05,0.9
10240,봣더/Noun,10,1,9,1.1115310228308472e-05,9.99622364884377e-05,0.9
10241,공략/Noun,10,1,9,1.1115310228308472e-05,9.99622364884377e-05,0.9
10242,개간/Noun,10,9,1,0.00010003779205477625,1.1106915165381966e-05,0.9
10243,딸년/Noun,10,1,9,1.1115310228308472e-05,9.99622364884377e-05,0.9
10244,러블리/Noun,10,9,1,0.00010003779205477625,1.1106915165381966e-05,0.9
10245,구숙정/Noun,10,9,1,0.00010003779205477625,1.1106915165381966e-05,0.9
10246,레나/Noun,10,9,1,0.00010003779205477625,1.1106915165381966e-05,0.9
10247,자금/Noun,10,1,9,1.1115310228308472e-05,9.99622364884377e-05,0.9
10248,！/Foreign,10,9,1,0.00010003779205477625,1.1106915165381966e-05,0.9
10249,단조/Noun,10,1,9,1.1115310228308472e-05,9.99622364884377e-05,0.9
10250,결재/Noun,10,1,9,1.1115310228308472e-05,9.99622364884377e-05,0.9
10251,다작/Noun,10,1,9,1.1115310228308472e-05,9.99622364884377e-05,0.9
10252,하위/Noun,10,1,9,1.1115310228308472e-05,9.99622364884377e-05,0.9
10253,메이퀸/Noun,10,9,1,0.00010003779205477625,1.1106915165381966e-05,0.9
10254,꿈틀/Noun,10,9,1,0.00010003779205477625,1.1106915165381966e-05,0.9
10255,백조/Noun,10,9,1,0.00010003779205477625,1.1106915165381966e-05,0.9
10256,존엄/Noun,10,9,1,0.00010003779205477625,1.1106915165381966e-05,0.9
10257,은지원/Noun,10,2,8,2.2230620456616944e-05,8.885532132305573e-05,0.8
10258,대응/Noun,10,2,8,2.2230620456616944e-05,8.885532132305573e-05,0.8
10259,성숙/Noun,10,8,2,8.892248182646778e-05,2.2213830330763933e-05,0.8
10260,키도/Noun,10,2,8,2.2230620456616944e-05,8.885532132305573e-05,0.8
10261,일지매/Noun,10,8,2,8.892248182646778e-05,2.2213830330763933e-05,0.8
10262,위반/Noun,10,2,8,2.2230620456616944e-05,8.885532132305573e-05,0.8
10263,전투력/Noun,10,2,8,2.2230620456616944e-05,8.885532132305573e-05,0.8
10264,정해/Noun,10,2,8,2.2230620456616944e-05,8.885532132305573e-05,0.8
10265,위장/Noun,10,2,8,2.2230620456616944e-05,8.885532132305573e-05,0.8
10266,다모/Noun,10,8,2,8.892248182646778e-05,2.2213830330763933e-05,0.8
10267,J/Alpha,10,2,8,2.2230620456616944e-05,8.885532132305573e-05,0.8
10268,자시/Noun,10,2,8,2.2230620456616944e-05,8.885532132305573e-05,0.8
10269,매춘부/Noun,10,2,8,2.2230620456616944e-05,8.885532132305573e-05,0.8
10270,ㅠㅜㅜ/KoreanParticle,10,8,2,8.892248182646778e-05,2.2213830330763933e-05,0.8
10271,!!~~/Punctuation,10,8,2,8.892248182646778e-05,2.2213830330763933e-05,0.8
10272,죄값/Noun,10,2,8,2.2230620456616944e-05,8.885532132305573e-05,0.8
10273,사형수/Noun,10,2,8,2.2230620456616944e-05,8.885532132305573e-05,0.8
10274,줄평/Noun,10,2,8,2.2230620456616944e-05,8.885532132305573e-05,0.8
10275,퇴색/Noun,10,2,8,2.2230620456616944e-05,8.885532132305573e-05,0.8
10276,카톡/Noun,10,2,8,2.2230620456616944e-05,8.885532132305573e-05,0.8
10277,신경질/Noun,10,2,8,2.2230620456616944e-05,8.885532132305573e-05,0.8
10278,조던/Noun,10,8,2,8.892248182646778e-05,2.2213830330763933e-05,0.8
10279,객/Noun,10,2,8,2.2230620456616944e-05,8.885532132305573e-05,0.8
10280,홍은희/Noun,10,2,8,2.2230620456616944e-05,8.885532132305573e-05,0.8
10281,한다해/Noun,10,2,8,2.2230620456616944e-05,8.885532132305573e-05,0.8
10282,개그콘서트/Noun,10,2,8,2.2230620456616944e-05,8.885532132305573e-05,0.8
10283,구태의연하다/Adjective,10,2,8,2.2230620456616944e-05,8.885532132305573e-05,0.8
10284,구두/Noun,10,8,2,8.892248182646778e-05,2.2213830330763933e-05,0.8
10285,박희순/Noun,10,8,2,8.892248182646778e-05,2.2213830330763933e-05,0.8
10286,무분별/Noun,10,2,8,2.2230620456616944e-05,8.885532132305573e-05,0.8
10287,리즈중/Noun,10,8,2,8.892248182646778e-05,2.2213830330763933e-05,0.8
10288,유전/Noun,10,8,2,8.892248182646778e-05,2.2213830330763933e-05,0.8
10289,송재림/Noun,10,8,2,8.892248182646778e-05,2.2213830330763933e-05,0.8
10290,명탐정코난/Noun,10,8,2,8.892248182646778e-05,2.2213830330763933e-05,0.8
10291,집합소/Noun,10,2,8,2.2230620456616944e-05,8.885532132305573e-05,0.8
10292,평면/Noun,10,2,8,2.2230620456616944e-05,8.885532132305573e-05,0.8
10293,느닷없다/Adjective,10,2,8,2.2230620456616944e-05,8.885532132305573e-05,0.8
10294,빠리/Noun,10,2,8,2.2230620456616944e-05,8.885532132305573e-05,0.8
10295,과격하다/Adjective,10,2,8,2.2230620456616944e-05,8.885532132305573e-05,0.8
10296,희생양/Noun,10,2,8,2.2230620456616944e-05,8.885532132305573e-05,0.8
10297,짤/Suffix,10,2,8,2.2230620456616944e-05,8.885532132305573e-05,0.8
10298,맞짱/Noun,10,2,8,2.2230620456616944e-05,8.885532132305573e-05,0.8
10299,고시/Noun,10,2,8,2.2230620456616944e-05,8.885532132305573e-05,0.8
10300,구시대/Noun,10,2,8,2.2230620456616944e-05,8.885532132305573e-05,0.8
10301,코스모스/Noun,10,8,2,8.892248182646778e-05,2.2213830330763933e-05,0.8
10302,낌/Noun,10,8,2,8.892248182646778e-05,2.2213830330763933e-05,0.8
10303,가해/Noun,10,2,8,2.2230620456616944e-05,8.885532132305573e-05,0.8
10304,찐빵/Noun,10,2,8,2.2230620456616944e-05,8.885532132305573e-05,0.8
10305,뮤지션/Noun,10,8,2,8.892248182646778e-05,2.2213830330763933e-05,0.8
10306,이덕화/Noun,10,8,2,8.892248182646778e-05,2.2213830330763933e-05,0.8
10307,달기/Noun,10,2,8,2.2230620456616944e-05,8.885532132305573e-05,0.8
10308,뚱땡이/Noun,10,2,8,2.2230620456616944e-05,8.885532132305573e-05,0.8
10309,날짜/Noun,10,2,8,2.2230620456616944e-05,8.885532132305573e-05,0.8
10310,with/Alpha,10,8,2,8.892248182646778e-05,2.2213830330763933e-05,0.8
10311,왜그러지/Noun,10,8,2,8.892248182646778e-05,2.2213830330763933e-05,0.8
10312,지휘/Noun,10,8,2,8.892248182646778e-05,2.2213830330763933e-05,0.8
10313,공이/Noun,10,2,8,2.2230620456616944e-05,8.885532132305573e-05,0.8
10314,구만/Eomi,10,2,8,2.2230620456616944e-05,8.885532132305573e-05,0.8
10315,계보/Noun,10,2,8,2.2230620456616944e-05,8.885532132305573e-05,0.8
10316,퇴화/Noun,10,2,8,2.2230620456616944e-05,8.885532132305573e-05,0.8
10317,김갑수/Noun,10,8,2,8.892248182646778e-05,2.2213830330763933e-05,0.8
10318,족하/Noun,10,2,8,2.2230620456616944e-05,8.885532132305573e-05,0.8
10319,현수/Noun,10,2,8,2.2230620456616944e-05,8.885532132305573e-05,0.8
10320,Top/Alpha,10,8,2,8.892248182646778e-05,2.2213830330763933e-05,0.8
10321,우파/Noun,10,8,2,8.892248182646778e-05,2.2213830330763933e-05,0.8
10322,ktx/Alpha,10,2,8,2.2230620456616944e-05,8.885532132305573e-05,0.8
10323,거론/Noun,10,2,8,2.2230620456616944e-05,8.885532132305573e-05,0.8
10324,IMDB/Alpha,10,2,8,2.2230620456616944e-05,8.885532132305573e-05,0.8
10325,골로/Noun,10,2,8,2.2230620456616944e-05,8.885532132305573e-05,0.8
10326,1000만/Number,10,2,8,2.2230620456616944e-05,8.885532132305573e-05,0.8
10327,치욕/Noun,10,2,8,2.2230620456616944e-05,8.885532132305573e-05,0.8
10328,개개인/Noun,10,8,2,8.892248182646778e-05,2.2213830330763933e-05,0.8
10329,에코/Noun,10,2,8,2.2230620456616944e-05,8.885532132305573e-05,0.8
10330,재연배우/Noun,10,2,8,2.2230620456616944e-05,8.885532132305573e-05,0.8
10331,8회/Number,10,8,2,8.892248182646778e-05,2.2213830330763933e-05,0.8
10332,개신교/Noun,10,2,8,2.2230620456616944e-05,8.885532132305573e-05,0.8
10333,미아/Noun,10,8,2,8.892248182646778e-05,2.2213830330763933e-05,0.8
10334,낙하산/Noun,10,2,8,2.2230620456616944e-05,8.885532132305573e-05,0.8
10335,중국사람/Noun,10,2,8,2.2230620456616944e-05,8.885532132305573e-05,0.8
10336,로보트/Noun,10,2,8,2.2230620456616944e-05,8.885532132305573e-05,0.8
10337,장관/Noun,10,8,2,8.892248182646778e-05,2.2213830330763933e-05,0.8
10338,썻/Noun,10,2,8,2.2230620456616944e-05,8.885532132305573e-05,0.8
10339,대식/Foreign,10,2,8,2.2230620456616944e-05,8.885532132305573e-05,0.8
10340,끈질기다/Adjective,10,8,2,8.892248182646778e-05,2.2213830330763933e-05,0.8
10341,방귀/Noun,10,2,8,2.2230620456616944e-05,8.885532132305573e-05,0.8
10342,치즈/Noun,10,8,2,8.892248182646778e-05,2.2213830330763933e-05,0.8
10343,피에르/Noun,10,8,2,8.892248182646778e-05,2.2213830330763933e-05,0.8
10344,왕창/Noun,10,2,8,2.2230620456616944e-05,8.885532132305573e-05,0.8
10345,클리/Noun,10,2,8,2.2230620456616944e-05,8.885532132305573e-05,0.8
10346,개멋/Noun,10,8,2,8.892248182646778e-05,2.2213830330763933e-05,0.8
10347,쭈쭈/Noun,10,2,8,2.2230620456616944e-05,8.885532132305573e-05,0.8
10348,26/Number,10,8,2,8.892248182646778e-05,2.2213830330763933e-05,0.8
10349,드라마스페셜/Noun,10,2,8,2.2230620456616944e-05,8.885532132305573e-05,0.8
10350,추측/Noun,10,8,2,8.892248182646778e-05,2.2213830330763933e-05,0.8
10351,폭팔/Noun,10,8,2,8.892248182646778e-05,2.2213830330763933e-05,0.8
10352,쥐뿔/Noun,10,2,8,2.2230620456616944e-05,8.885532132305573e-05,0.8
10353,데미/Noun,10,2,8,2.2230620456616944e-05,8.885532132305573e-05,0.8
10354,테두리/Noun,10,2,8,2.2230620456616944e-05,8.885532132305573e-05,0.8
10355,건방지다/Adjective,10,2,8,2.2230620456616944e-05,8.885532132305573e-05,0.8
10356,♡♡♡♡/Foreign,10,8,2,8.892248182646778e-05,2.2213830330763933e-05,0.8
10357,부다/Noun,10,2,8,2.2230620456616944e-05,8.885532132305573e-05,0.8
10358,질풍/Noun,10,8,2,8.892248182646778e-05,2.2213830330763933e-05,0.8
10359,동포/Noun,10,8,2,8.892248182646778e-05,2.2213830330763933e-05,0.8
10360,따라다니다/Verb,10,2,8,2.2230620456616944e-05,8.885532132305573e-05,0.8
10361,전무하다/Adjective,10,2,8,2.2230620456616944e-05,8.885532132305573e-05,0.8
10362,과유/Noun,10,2,8,2.2230620456616944e-05,8.885532132305573e-05,0.8
10363,자의식/Noun,10,2,8,2.2230620456616944e-05,8.885532132305573e-05,0.8
10364,합창/Noun,10,8,2,8.892248182646778e-05,2.2213830330763933e-05,0.8
10365,위태/Noun,10,8,2,8.892248182646778e-05,2.2213830330763933e-05,0.8
10366,이슬/Noun,10,8,2,8.892248182646778e-05,2.2213830330763933e-05,0.8
10367,튀어/Noun,10,2,8,2.2230620456616944e-05,8.885532132305573e-05,0.8
10368,순박하다/Adjective,10,8,2,8.892248182646778e-05,2.2213830330763933e-05,0.8
10369,쩍/Noun,10,2,8,2.2230620456616944e-05,8.885532132305573e-05,0.8
10370,슈트/Noun,10,3,7,3.3345930684925414e-05,7.774840615767377e-05,0.7
10371,정선경/Noun,10,3,7,3.3345930684925414e-05,7.774840615767377e-05,0.7
10372,통과/Noun,10,7,3,7.78071715981593e-05,3.33207454961459e-05,0.7
10373,웃음소리/Noun,10,3,7,3.3345930684925414e-05,7.774840615767377e-05,0.7
10374,댜/Noun,10,7,3,7.78071715981593e-05,3.33207454961459e-05,0.7
10375,고귀하다/Adjective,10,7,3,7.78071715981593e-05,3.33207454961459e-05,0.7
10376,촌티/Noun,10,3,7,3.3345930684925414e-05,7.774840615767377e-05,0.7
10377,파이어/Noun,10,7,3,7.78071715981593e-05,3.33207454961459e-05,0.7
10378,김정태/Noun,10,7,3,7.78071715981593e-05,3.33207454961459e-05,0.7
10379,파업/Noun,10,3,7,3.3345930684925414e-05,7.774840615767377e-05,0.7
10380,월터/Noun,10,7,3,7.78071715981593e-05,3.33207454961459e-05,0.7
10381,가드/Noun,10,3,7,3.3345930684925414e-05,7.774840615767377e-05,0.7
10382,패션왕/Noun,10,3,7,3.3345930684925414e-05,7.774840615767377e-05,0.7
10383,킨/Noun,10,7,3,7.78071715981593e-05,3.33207454961459e-05,0.7
10384,니드/Noun,10,7,3,7.78071715981593e-05,3.33207454961459e-05,0.7
10385,미신/Noun,10,3,7,3.3345930684925414e-05,7.774840615767377e-05,0.7
10386,김석훈/Noun,10,3,7,3.3345930684925414e-05,7.774840615767377e-05,0.7
10387,실재/Noun,10,7,3,7.78071715981593e-05,3.33207454961459e-05,0.7
10388,부작용/Noun,10,3,7,3.3345930684925414e-05,7.774840615767377e-05,0.7
10389,베닝/Noun,10,7,3,7.78071715981593e-05,3.33207454961459e-05,0.7
10390,백수/Noun,10,3,7,3.3345930684925414e-05,7.774840615767377e-05,0.7
10391,네러티브/Noun,10,3,7,3.3345930684925414e-05,7.774840615767377e-05,0.7
10392,정신분열증/Noun,10,3,7,3.3345930684925414e-05,7.774840615767377e-05,0.7
10393,신의한수/Noun,10,7,3,7.78071715981593e-05,3.33207454961459e-05,0.7
10394,옥상/Noun,10,7,3,7.78071715981593e-05,3.33207454961459e-05,0.7
10395,노조미/Noun,10,7,3,7.78071715981593e-05,3.33207454961459e-05,0.7
10396,day/Alpha,10,7,3,7.78071715981593e-05,3.33207454961459e-05,0.7
10397,헤치다/Verb,10,7,3,7.78071715981593e-05,3.33207454961459e-05,0.7
10398,모양새/Noun,10,3,7,3.3345930684925414e-05,7.774840615767377e-05,0.7
10399,자평/Noun,10,3,7,3.3345930684925414e-05,7.774840615767377e-05,0.7
10400,잦다/Verb,10,3,7,3.3345930684925414e-05,7.774840615767377e-05,0.7
10401,딧/Noun,10,7,3,7.78071715981593e-05,3.33207454961459e-05,0.7
10402,??../Punctuation,10,3,7,3.3345930684925414e-05,7.774840615767377e-05,0.7
10403,롯/Noun,10,7,3,7.78071715981593e-05,3.33207454961459e-05,0.7
10404,이성민/Noun,10,7,3,7.78071715981593e-05,3.33207454961459e-05,0.7
10405,1.5/Number,10,3,7,3.3345930684925414e-05,7.774840615767377e-05,0.7
10406,마우스/Noun,10,3,7,3.3345930684925414e-05,7.774840615767377e-05,0.7
10407,닥터후/Noun,10,7,3,7.78071715981593e-05,3.33207454961459e-05,0.7
10408,갈리/Noun,10,7,3,7.78071715981593e-05,3.33207454961459e-05,0.7
10409,시온/Noun,10,7,3,7.78071715981593e-05,3.33207454961459e-05,0.7
10410,점퍼/Noun,10,3,7,3.3345930684925414e-05,7.774840615767377e-05,0.7
10411,연정훈/Noun,10,7,3,7.78071715981593e-05,3.33207454961459e-05,0.7
10412,명목/Noun,10,3,7,3.3345930684925414e-05,7.774840615767377e-05,0.7
10413,하의/Noun,10,3,7,3.3345930684925414e-05,7.774840615767377e-05,0.7
10414,듯해/Noun,10,7,3,7.78071715981593e-05,3.33207454961459e-05,0.7
10415,군단/Noun,10,3,7,3.3345930684925414e-05,7.774840615767377e-05,0.7
10416,조성하/Noun,10,3,7,3.3345930684925414e-05,7.774840615767377e-05,0.7
10417,과학자/Noun,10,3,7,3.3345930684925414e-05,7.774840615767377e-05,0.7
10418,all/Alpha,10,7,3,7.78071715981593e-05,3.33207454961459e-05,0.7
10419,행세/Noun,10,3,7,3.3345930684925414e-05,7.774840615767377e-05,0.7
10420,실어/Noun,10,7,3,7.78071715981593e-05,3.33207454961459e-05,0.7
10421,말세/Noun,10,3,7,3.3345930684925414e-05,7.774840615767377e-05,0.7
10422,이산/Noun,10,3,7,3.3345930684925414e-05,7.774840615767377e-05,0.7
10423,.-/Punctuation,10,3,7,3.3345930684925414e-05,7.774840615767377e-05,0.7
10424,북극/Noun,10,7,3,7.78071715981593e-05,3.33207454961459e-05,0.7
10425,불상/Noun,10,3,7,3.3345930684925414e-05,7.774840615767377e-05,0.7
10426,달랑/Noun,10,3,7,3.3345930684925414e-05,7.774840615767377e-05,0.7
10427,은교/Noun,10,3,7,3.3345930684925414e-05,7.774840615767377e-05,0.7
10428,헤어스타일/Noun,10,3,7,3.3345930684925414e-05,7.774840615767377e-05,0.7
10429,램버트/Noun,10,7,3,7.78071715981593e-05,3.33207454961459e-05,0.7
10430,쌩/Noun,10,3,7,3.3345930684925414e-05,7.774840615767377e-05,0.7
10431,투혼/Noun,10,3,7,3.3345930684925414e-05,7.774840615767377e-05,0.7
10432,로고/Josa,10,3,7,3.3345930684925414e-05,7.774840615767377e-05,0.7
10433,그래비티/Noun,10,7,3,7.78071715981593e-05,3.33207454961459e-05,0.7
10434,격추/Noun,10,3,7,3.3345930684925414e-05,7.774840615767377e-05,0.7
10435,불쌍타/Noun,10,3,7,3.3345930684925414e-05,7.774840615767377e-05,0.7
10436,률/Noun,10,3,7,3.3345930684925414e-05,7.774840615767377e-05,0.7
10437,비장하다/Adjective,10,7,3,7.78071715981593e-05,3.33207454961459e-05,0.7
10438,임마/Noun,10,3,7,3.3345930684925414e-05,7.774840615767377e-05,0.7
10439,12월/Number,10,7,3,7.78071715981593e-05,3.33207454961459e-05,0.7
10440,징징/Noun,10,3,7,3.3345930684925414e-05,7.774840615767377e-05,0.7
10441,공권력/Noun,10,7,3,7.78071715981593e-05,3.33207454961459e-05,0.7
10442,쪼/Noun,10,7,3,7.78071715981593e-05,3.33207454961459e-05,0.7
10443,죵/Noun,10,3,7,3.3345930684925414e-05,7.774840615767377e-05,0.7
10444,일수록/Josa,10,3,7,3.3345930684925414e-05,7.774840615767377e-05,0.7
10445,모텔/Noun,10,3,7,3.3345930684925414e-05,7.774840615767377e-05,0.7
10446,잠재우다/Verb,10,3,7,3.3345930684925414e-05,7.774840615767377e-05,0.7
10447,분신/Noun,10,3,7,3.3345930684925414e-05,7.774840615767377e-05,0.7
10448,기생/Noun,10,3,7,3.3345930684925414e-05,7.774840615767377e-05,0.7
10449,인가가/Josa,10,7,3,7.78071715981593e-05,3.33207454961459e-05,0.7
10450,볼륨/Noun,10,3,7,3.3345930684925414e-05,7.774840615767377e-05,0.7
10451,로구나/Josa,10,3,7,3.3345930684925414e-05,7.774840615767377e-05,0.7
10452,해서웨이/Noun,10,7,3,7.78071715981593e-05,3.33207454961459e-05,0.7
10453,초원/Noun,10,7,3,7.78071715981593e-05,3.33207454961459e-05,0.7
10454,자괴/Noun,10,3,7,3.3345930684925414e-05,7.774840615767377e-05,0.7
10455,매진/Noun,10,7,3,7.78071715981593e-05,3.33207454961459e-05,0.7
10456,상호/Noun,10,7,3,7.78071715981593e-05,3.33207454961459e-05,0.7
10457,스타크래프트/Noun,10,7,3,7.78071715981593e-05,3.33207454961459e-05,0.7
10458,시각장애인/Noun,10,7,3,7.78071715981593e-05,3.33207454961459e-05,0.7
10459,인원/Noun,10,3,7,3.3345930684925414e-05,7.774840615767377e-05,0.7
10460,격렬하다/Adjective,10,7,3,7.78071715981593e-05,3.33207454961459e-05,0.7
10461,허수아비/Noun,10,3,7,3.3345930684925414e-05,7.774840615767377e-05,0.7
10462,스칼렛요한슨/Noun,10,7,3,7.78071715981593e-05,3.33207454961459e-05,0.7
10463,연도/Noun,10,7,3,7.78071715981593e-05,3.33207454961459e-05,0.7
10464,급격하다/Adjective,10,3,7,3.3345930684925414e-05,7.774840615767377e-05,0.7
10465,물든/Noun,10,7,3,7.78071715981593e-05,3.33207454961459e-05,0.7
10466,리모컨/Noun,10,3,7,3.3345930684925414e-05,7.774840615767377e-05,0.7
10467,비고/Noun,10,7,3,7.78071715981593e-05,3.33207454961459e-05,0.7
10468,one/Alpha,10,7,3,7.78071715981593e-05,3.33207454961459e-05,0.7
10469,서너/Modifier,10,7,3,7.78071715981593e-05,3.33207454961459e-05,0.7
10470,레아/Noun,10,7,3,7.78071715981593e-05,3.33207454961459e-05,0.7
10471,필리핀/Noun,10,3,7,3.3345930684925414e-05,7.774840615767377e-05,0.7
10472,ET/Alpha,10,7,3,7.78071715981593e-05,3.33207454961459e-05,0.7
10473,비포/Noun,10,7,3,7.78071715981593e-05,3.33207454961459e-05,0.7
10474,오맹달/Noun,10,7,3,7.78071715981593e-05,3.33207454961459e-05,0.7
10475,좌익/Noun,10,3,7,3.3345930684925414e-05,7.774840615767377e-05,0.7
10476,리브스/Noun,10,7,3,7.78071715981593e-05,3.33207454961459e-05,0.7
10477,덧글/Noun,10,3,7,3.3345930684925414e-05,7.774840615767377e-05,0.7
10478,150/Number,10,3,7,3.3345930684925414e-05,7.774840615767377e-05,0.7
10479,선호/Noun,10,7,3,7.78071715981593e-05,3.33207454961459e-05,0.7
10480,맞이/Noun,10,7,3,7.78071715981593e-05,3.33207454961459e-05,0.7
10481,방한/Noun,10,3,7,3.3345930684925414e-05,7.774840615767377e-05,0.7
10482,크레이븐/Noun,10,7,3,7.78071715981593e-05,3.33207454961459e-05,0.7
10483,이효리/Noun,10,3,7,3.3345930684925414e-05,7.774840615767377e-05,0.7
10484,자잘하다/Adjective,10,7,3,7.78071715981593e-05,3.33207454961459e-05,0.7
10485,방향성/Noun,10,3,7,3.3345930684925414e-05,7.774840615767377e-05,0.7
10486,피스/Noun,10,7,3,7.78071715981593e-05,3.33207454961459e-05,0.7
10487,돌대가리/Noun,10,3,7,3.3345930684925414e-05,7.774840615767377e-05,0.7
10488,의료/Noun,10,7,3,7.78071715981593e-05,3.33207454961459e-05,0.7
10489,실비/Noun,10,7,3,7.78071715981593e-05,3.33207454961459e-05,0.7
10490,코트/Noun,10,7,3,7.78071715981593e-05,3.33207454961459e-05,0.7
10491,지평/Noun,10,7,3,7.78071715981593e-05,3.33207454961459e-05,0.7
10492,ㆍ/Foreign,10,7,3,7.78071715981593e-05,3.33207454961459e-05,0.7
10493,로지/Noun,10,3,7,3.3345930684925414e-05,7.774840615767377e-05,0.7
10494,열매/Noun,10,7,3,7.78071715981593e-05,3.33207454961459e-05,0.7
10495,안재모/Noun,10,7,3,7.78071715981593e-05,3.33207454961459e-05,0.7
10496,마츠코/Noun,10,3,7,3.3345930684925414e-05,7.774840615767377e-05,0.7
10497,로페즈/Noun,10,3,7,3.3345930684925414e-05,7.774840615767377e-05,0.7
10498,일일이/Noun,10,3,7,3.3345930684925414e-05,7.774840615767377e-05,0.7
10499,배신자/Noun,10,3,7,3.3345930684925414e-05,7.774840615767377e-05,0.7
10500,이주/Noun,10,7,3,7.78071715981593e-05,3.33207454961459e-05,0.7
10501,간판/Noun,10,3,7,3.3345930684925414e-05,7.774840615767377e-05,0.7
10502,연애시대/Noun,10,7,3,7.78071715981593e-05,3.33207454961459e-05,0.7
10503,러브액츄얼리/Noun,10,7,3,7.78071715981593e-05,3.33207454961459e-05,0.7
10504,로비/Noun,10,3,7,3.3345930684925414e-05,7.774840615767377e-05,0.7
10505,주드로/Noun,10,7,3,7.78071715981593e-05,3.33207454961459e-05,0.7
10506,히로인/Noun,10,3,7,3.3345930684925414e-05,7.774840615767377e-05,0.7
10507,What/Alpha,10,3,7,3.3345930684925414e-05,7.774840615767377e-05,0.7
10508,LA/Alpha,10,7,3,7.78071715981593e-05,3.33207454961459e-05,0.7
10509,박재정/Noun,10,3,7,3.3345930684925414e-05,7.774840615767377e-05,0.7
10510,눈망울/Noun,10,7,3,7.78071715981593e-05,3.33207454961459e-05,0.7
10511,중국무협/Noun,10,3,7,3.3345930684925414e-05,7.774840615767377e-05,0.7
10512,이용철/Noun,10,7,3,7.78071715981593e-05,3.33207454961459e-05,0.7
10513,포레스트검프/Noun,10,7,3,7.78071715981593e-05,3.33207454961459e-05,0.7
10514,정당성/Noun,10,3,7,3.3345930684925414e-05,7.774840615767377e-05,0.7
10515,김신/Noun,10,3,7,3.3345930684925414e-05,7.774840615767377e-05,0.7
10516,걔/Noun,10,3,7,3.3345930684925414e-05,7.774840615767377e-05,0.7
10517,똥개/Noun,10,3,7,3.3345930684925414e-05,7.774840615767377e-05,0.7
10518,아름/Noun,10,7,3,7.78071715981593e-05,3.33207454961459e-05,0.7
10519,개지/Noun,10,3,7,3.3345930684925414e-05,7.774840615767377e-05,0.7
10520,'./Punctuation,10,7,3,7.78071715981593e-05,3.33207454961459e-05,0.7
10521,거고/Eomi,10,3,7,3.3345930684925414e-05,7.774840615767377e-05,0.7
10522,떠나가다/Verb,10,7,3,7.78071715981593e-05,3.33207454961459e-05,0.7
10523,라오스/Noun,10,7,3,7.78071715981593e-05,3.33207454961459e-05,0.7
10524,공항/Noun,10,7,3,7.78071715981593e-05,3.33207454961459e-05,0.7
10525,아이엠/Noun,10,7,3,7.78071715981593e-05,3.33207454961459e-05,0.7
10526,더듬다/Verb,10,7,3,7.78071715981593e-05,3.33207454961459e-05,0.7
10527,깜빡/Noun,10,4,6,4.446124091323389e-05,6.66414909922918e-05,0.6
10528,풍/Noun,10,4,6,4.446124091323389e-05,6.66414909922918e-05,0.6
10529,김씨/Noun,10,4,6,4.446124091323389e-05,6.66414909922918e-05,0.6
10530,좌석/Noun,10,4,6,4.446124091323389e-05,6.66414909922918e-05,0.6
10531,바다로/Noun,10,4,6,4.446124091323389e-05,6.66414909922918e-05,0.6
10532,가의/Noun,10,6,4,6.669186136985083e-05,4.4427660661527865e-05,0.6
10533,익스트림/Noun,10,4,6,4.446124091323389e-05,6.66414909922918e-05,0.6
10534,익숙/Noun,10,6,4,6.669186136985083e-05,4.4427660661527865e-05,0.6
10535,멀어지다/Verb,10,4,6,4.446124091323389e-05,6.66414909922918e-05,0.6
10536,막걸리/Noun,10,6,4,6.669186136985083e-05,4.4427660661527865e-05,0.6
10537,두산/Noun,10,6,4,6.669186136985083e-05,4.4427660661527865e-05,0.6
10538,소시오패스/Noun,10,4,6,4.446124091323389e-05,6.66414909922918e-05,0.6
10539,김현중/Noun,10,4,6,4.446124091323389e-05,6.66414909922918e-05,0.6
10540,베스트셀러/Noun,10,4,6,4.446124091323389e-05,6.66414909922918e-05,0.6
10541,헛된/Noun,10,4,6,4.446124091323389e-05,6.66414909922918e-05,0.6
10542,서두/Noun,10,4,6,4.446124091323389e-05,6.66414909922918e-05,0.6
10543,세미/Noun,10,6,4,6.669186136985083e-05,4.4427660661527865e-05,0.6
10544,개구/Noun,10,4,6,4.446124091323389e-05,6.66414909922918e-05,0.6
10545,자단/Noun,10,6,4,6.669186136985083e-05,4.4427660661527865e-05,0.6
10546,수퍼맨/Noun,10,6,4,6.669186136985083e-05,4.4427660661527865e-05,0.6
10547,1:1/Number,10,4,6,4.446124091323389e-05,6.66414909922918e-05,0.6
10548,묵묵하다/Adjective,10,6,4,6.669186136985083e-05,4.4427660661527865e-05,0.6
10549,붓다/Verb,10,6,4,6.669186136985083e-05,4.4427660661527865e-05,0.6
10550,로또/Noun,10,4,6,4.446124091323389e-05,6.66414909922918e-05,0.6
10551,코치/Noun,10,4,6,4.446124091323389e-05,6.66414909922918e-05,0.6
10552,보험/Noun,10,6,4,6.669186136985083e-05,4.4427660661527865e-05,0.6
10553,블런트/Noun,10,6,4,6.669186136985083e-05,4.4427660661527865e-05,0.6
10554,메멘토/Noun,10,6,4,6.669186136985083e-05,4.4427660661527865e-05,0.6
10555,ㅏㅇ/KoreanParticle,10,6,4,6.669186136985083e-05,4.4427660661527865e-05,0.6
10556,번영/Noun,10,6,4,6.669186136985083e-05,4.4427660661527865e-05,0.6
10557,헐리우드영화/Noun,10,6,4,6.669186136985083e-05,4.4427660661527865e-05,0.6
10558,천배/Noun,10,6,4,6.669186136985083e-05,4.4427660661527865e-05,0.6
10559,제품/Noun,10,4,6,4.446124091323389e-05,6.66414909922918e-05,0.6
10560,김소은/Noun,10,6,4,6.669186136985083e-05,4.4427660661527865e-05,0.6
10561,총잡이/Noun,10,4,6,4.446124091323389e-05,6.66414909922918e-05,0.6
10562,침착하다/Adjective,10,6,4,6.669186136985083e-05,4.4427660661527865e-05,0.6
10563,마트/Noun,10,4,6,4.446124091323389e-05,6.66414909922918e-05,0.6
10564,snl/Alpha,10,4,6,4.446124091323389e-05,6.66414909922918e-05,0.6
10565,공통점/Noun,10,4,6,4.446124091323389e-05,6.66414909922918e-05,0.6
10566,육감/Noun,10,4,6,4.446124091323389e-05,6.66414909922918e-05,0.6
10567,칸타빌레/Noun,10,6,4,6.669186136985083e-05,4.4427660661527865e-05,0.6
10568,터치/Noun,10,6,4,6.669186136985083e-05,4.4427660661527865e-05,0.6
10569,블랙홀/Noun,10,6,4,6.669186136985083e-05,4.4427660661527865e-05,0.6
10570,해골/Noun,10,4,6,4.446124091323389e-05,6.66414909922918e-05,0.6
10571,복제인간/Noun,10,6,4,6.669186136985083e-05,4.4427660661527865e-05,0.6
10572,30초/Number,10,4,6,4.446124091323389e-05,6.66414909922918e-05,0.6
10573,매직/Noun,10,4,6,4.446124091323389e-05,6.66414909922918e-05,0.6
10574,상일/Noun,10,4,6,4.446124091323389e-05,6.66414909922918e-05,0.6
10575,3.14/Number,10,4,6,4.446124091323389e-05,6.66414909922918e-05,0.6
10576,**/Punctuation,10,6,4,6.669186136985083e-05,4.4427660661527865e-05,0.6
10577,백야/Noun,10,4,6,4.446124091323389e-05,6.66414909922918e-05,0.6
10578,단비/Noun,10,6,4,6.669186136985083e-05,4.4427660661527865e-05,0.6
10579,배리/Noun,10,4,6,4.446124091323389e-05,6.66414909922918e-05,0.6
10580,패널/Noun,10,4,6,4.446124091323389e-05,6.66414909922918e-05,0.6
10581,올리버스톤/Noun,10,6,4,6.669186136985083e-05,4.4427660661527865e-05,0.6
10582,한경직/Noun,10,4,6,4.446124091323389e-05,6.66414909922918e-05,0.6
10583,신사/Noun,10,4,6,4.446124091323389e-05,6.66414909922918e-05,0.6
10584,부끄러움/Noun,10,4,6,4.446124091323389e-05,6.66414909922918e-05,0.6
10585,격감/Noun,10,6,4,6.669186136985083e-05,4.4427660661527865e-05,0.6
10586,자장가/Noun,10,4,6,4.446124091323389e-05,6.66414909922918e-05,0.6
10587,...???/Punctuation,10,6,4,6.669186136985083e-05,4.4427660661527865e-05,0.6
10588,핵폭탄/Noun,10,4,6,4.446124091323389e-05,6.66414909922918e-05,0.6
10589,진입/Noun,10,4,6,4.446124091323389e-05,6.66414909922918e-05,0.6
10590,투명인간/Noun,10,4,6,4.446124091323389e-05,6.66414909922918e-05,0.6
10591,기만/Modifier,10,4,6,4.446124091323389e-05,6.66414909922918e-05,0.6
10592,1월/Number,10,6,4,6.669186136985083e-05,4.4427660661527865e-05,0.6
10593,유희왕/Noun,10,4,6,4.446124091323389e-05,6.66414909922918e-05,0.6
10594,예견/Noun,10,6,4,6.669186136985083e-05,4.4427660661527865e-05,0.6
10595,프라임/Noun,10,6,4,6.669186136985083e-05,4.4427660661527865e-05,0.6
10596,부숴/Noun,10,4,6,4.446124091323389e-05,6.66414909922918e-05,0.6
10597,실시간/Noun,10,6,4,6.669186136985083e-05,4.4427660661527865e-05,0.6
10598,딴다/Adjective,10,6,4,6.669186136985083e-05,4.4427660661527865e-05,0.6
10599,트롤/Noun,10,6,4,6.669186136985083e-05,4.4427660661527865e-05,0.6
10600,참사/Noun,10,4,6,4.446124091323389e-05,6.66414909922918e-05,0.6
10601,허상/Noun,10,4,6,4.446124091323389e-05,6.66414909922918e-05,0.6
10602,이민자/Noun,10,6,4,6.669186136985083e-05,4.4427660661527865e-05,0.6
10603,프로필/Noun,10,4,6,4.446124091323389e-05,6.66414909922918e-05,0.6
10604,도어/Noun,10,6,4,6.669186136985083e-05,4.4427660661527865e-05,0.6
10605,피자/Noun,10,4,6,4.446124091323389e-05,6.66414909922918e-05,0.6
10606,이두/Noun,10,4,6,4.446124091323389e-05,6.66414909922918e-05,0.6
10607,이자나/Josa,10,4,6,4.446124091323389e-05,6.66414909922918e-05,0.6
10608,여리다/Adjective,10,4,6,4.446124091323389e-05,6.66414909922918e-05,0.6
10609,??!!/Punctuation,10,4,6,4.446124091323389e-05,6.66414909922918e-05,0.6
10610,언더월드/Noun,10,4,6,4.446124091323389e-05,6.66414909922918e-05,0.6
10611,쿵푸허슬/Noun,10,6,4,6.669186136985083e-05,4.4427660661527865e-05,0.6
10612,비정하다/Adjective,10,6,4,6.669186136985083e-05,4.4427660661527865e-05,0.6
10613,순애보/Noun,10,6,4,6.669186136985083e-05,4.4427660661527865e-05,0.6
10614,관용/Noun,10,4,6,4.446124091323389e-05,6.66414909922918e-05,0.6
10615,교복/Noun,10,6,4,6.669186136985083e-05,4.4427660661527865e-05,0.6
10616,텔/Noun,10,4,6,4.446124091323389e-05,6.66414909922918e-05,0.6
10617,나단/Noun,10,6,4,6.669186136985083e-05,4.4427660661527865e-05,0.6
10618,전남편/Noun,10,4,6,4.446124091323389e-05,6.66414909922918e-05,0.6
10619,김유정/Noun,10,4,6,4.446124091323389e-05,6.66414909922918e-05,0.6
10620,ㅜㅡ/KoreanParticle,10,4,6,4.446124091323389e-05,6.66414909922918e-05,0.6
10621,인구/Noun,10,4,6,4.446124091323389e-05,6.66414909922918e-05,0.6
10622,날아오다/Verb,10,4,6,4.446124091323389e-05,6.66414909922918e-05,0.6
10623,5위안/Number,10,6,4,6.669186136985083e-05,4.4427660661527865e-05,0.6
10624,척도/Noun,10,4,6,4.446124091323389e-05,6.66414909922918e-05,0.6
10625,자수/Noun,10,6,4,6.669186136985083e-05,4.4427660661527865e-05,0.6
10626,임펙트/Noun,10,6,4,6.669186136985083e-05,4.4427660661527865e-05,0.6
10627,기점/Noun,10,6,4,6.669186136985083e-05,4.4427660661527865e-05,0.6
10628,수리/Noun,10,4,6,4.446124091323389e-05,6.66414909922918e-05,0.6
10629,복지/Noun,10,6,4,6.669186136985083e-05,4.4427660661527865e-05,0.6
10630,장도/Noun,10,4,6,4.446124091323389e-05,6.66414909922918e-05,0.6
10631,탈옥/Noun,10,6,4,6.669186136985083e-05,4.4427660661527865e-05,0.6
10632,장병/Noun,10,4,6,4.446124091323389e-05,6.66414909922918e-05,0.6
10633,카사노바/Noun,10,6,4,6.669186136985083e-05,4.4427660661527865e-05,0.6
10634,홈즈/Noun,10,6,4,6.669186136985083e-05,4.4427660661527865e-05,0.6
10635,내뱉다/Verb,10,4,6,4.446124091323389e-05,6.66414909922918e-05,0.6
10636,도그빌/Noun,10,6,4,6.669186136985083e-05,4.4427660661527865e-05,0.6
10637,제타존스/Noun,10,4,6,4.446124091323389e-05,6.66414909922918e-05,0.6
10638,이다해/Noun,10,6,4,6.669186136985083e-05,4.4427660661527865e-05,0.6
10639,몽롱/Noun,10,6,4,6.669186136985083e-05,4.4427660661527865e-05,0.6
10640,끈기/Noun,10,4,6,4.446124091323389e-05,6.66414909922918e-05,0.6
10641,느긋하다/Adjective,10,4,6,4.446124091323389e-05,6.66414909922918e-05,0.6
10642,박해진/Noun,10,6,4,6.669186136985083e-05,4.4427660661527865e-05,0.6
10643,카톨릭/Noun,10,4,6,4.446124091323389e-05,6.66414909922918e-05,0.6
10644,여섯/Determiner,10,6,4,6.669186136985083e-05,4.4427660661527865e-05,0.6
10645,꽃님/Noun,10,4,6,4.446124091323389e-05,6.66414909922918e-05,0.6
10646,은색/Noun,10,6,4,6.669186136985083e-05,4.4427660661527865e-05,0.6
10647,숟가락/Noun,10,4,6,4.446124091323389e-05,6.66414909922918e-05,0.6
10648,5일/Number,10,6,4,6.669186136985083e-05,4.4427660661527865e-05,0.6
10649,도보/Noun,10,6,4,6.669186136985083e-05,4.4427660661527865e-05,0.6
10650,피아니스트/Noun,10,4,6,4.446124091323389e-05,6.66414909922918e-05,0.6
10651,아영/Noun,10,6,4,6.669186136985083e-05,4.4427660661527865e-05,0.6
10652,MB/Alpha,10,6,4,6.669186136985083e-05,4.4427660661527865e-05,0.6
10653,탈북자/Noun,10,4,6,4.446124091323389e-05,6.66414909922918e-05,0.6
10654,다중인격/Noun,10,4,6,4.446124091323389e-05,6.66414909922918e-05,0.6
10655,이방인/Noun,10,6,4,6.669186136985083e-05,4.4427660661527865e-05,0.6
10656,실리다/Verb,10,6,4,6.669186136985083e-05,4.4427660661527865e-05,0.6
10657,김영애/Noun,10,6,4,6.669186136985083e-05,4.4427660661527865e-05,0.6
10658,풀풀/Adverb,10,4,6,4.446124091323389e-05,6.66414909922918e-05,0.6
10659,하늘나라/Noun,10,6,4,6.669186136985083e-05,4.4427660661527865e-05,0.6
10660,슈퍼주니어/Noun,10,6,4,6.669186136985083e-05,4.4427660661527865e-05,0.6
10661,유세윤/Noun,10,4,6,4.446124091323389e-05,6.66414909922918e-05,0.6
10662,내레이션/Noun,10,4,6,4.446124091323389e-05,6.66414909922918e-05,0.6
10663,드라이브/Noun,10,4,6,4.446124091323389e-05,6.66414909922918e-05,0.6
10664,하므다/Verb,10,4,6,4.446124091323389e-05,6.66414909922918e-05,0.6
10665,챔프/Noun,10,4,6,4.446124091323389e-05,6.66414909922918e-05,0.6
10666,백성/Noun,10,4,6,4.446124091323389e-05,6.66414909922918e-05,0.6
10667,어바웃타임/Noun,10,6,4,6.669186136985083e-05,4.4427660661527865e-05,0.6
10668,하워드/Noun,10,6,4,6.669186136985083e-05,4.4427660661527865e-05,0.6
10669,3~4/Number,10,6,4,6.669186136985083e-05,4.4427660661527865e-05,0.6
10670,일본군/Noun,10,4,6,4.446124091323389e-05,6.66414909922918e-05,0.6
10671,감칠맛/Noun,10,6,4,6.669186136985083e-05,4.4427660661527865e-05,0.6
10672,종교인/Noun,10,6,4,6.669186136985083e-05,4.4427660661527865e-05,0.6
10673,뻗다/Verb,10,6,4,6.669186136985083e-05,4.4427660661527865e-05,0.6
10674,원판/Noun,10,6,4,6.669186136985083e-05,4.4427660661527865e-05,0.6
10675,일침/Noun,10,6,4,6.669186136985083e-05,4.4427660661527865e-05,0.6
10676,UFO/Alpha,10,4,6,4.446124091323389e-05,6.66414909922918e-05,0.6
10677,악하다/Adjective,10,4,6,4.446124091323389e-05,6.66414909922918e-05,0.6
10678,소용/Noun,10,4,6,4.446124091323389e-05,6.66414909922918e-05,0.6
10679,추종/Noun,10,6,4,6.669186136985083e-05,4.4427660661527865e-05,0.6
10680,사가다/Verb,10,4,6,4.446124091323389e-05,6.66414909922918e-05,0.6
10681,야만/Noun,10,4,6,4.446124091323389e-05,6.66414909922918e-05,0.6
10682,코리아/Noun,10,4,6,4.446124091323389e-05,6.66414909922918e-05,0.6
10683,십자가/Noun,10,4,6,4.446124091323389e-05,6.66414909922918e-05,0.6
10684,네네/Noun,10,4,6,4.446124091323389e-05,6.66414909922918e-05,0.6
10685,룸/Noun,10,6,4,6.669186136985083e-05,4.4427660661527865e-05,0.6
10686,작용/Noun,10,6,4,6.669186136985083e-05,4.4427660661527865e-05,0.6
10687,대담하다/Adjective,10,6,4,6.669186136985083e-05,4.4427660661527865e-05,0.6
10688,두껍다/Adjective,10,4,6,4.446124091323389e-05,6.66414909922918e-05,0.6
10689,지하실/Noun,10,6,4,6.669186136985083e-05,4.4427660661527865e-05,0.6
10690,정해진/Noun,10,6,4,6.669186136985083e-05,4.4427660661527865e-05,0.6
10691,랍니/Noun,10,6,4,6.669186136985083e-05,4.4427660661527865e-05,0.6
10692,찰/Noun,10,4,6,4.446124091323389e-05,6.66414909922918e-05,0.6
10693,아이맥스/Noun,10,6,4,6.669186136985083e-05,4.4427660661527865e-05,0.6
10694,립/Noun,10,6,4,6.669186136985083e-05,4.4427660661527865e-05,0.6
10695,정지훈/Noun,10,6,4,6.669186136985083e-05,4.4427660661527865e-05,0.6
10696,내내/Foreign,10,6,4,6.669186136985083e-05,4.4427660661527865e-05,0.6
10697,숨바꼭질/Noun,10,4,6,4.446124091323389e-05,6.66414909922918e-05,0.6
10698,",,./Punctuation",10,4,6,4.446124091323389e-05,6.66414909922918e-05,0.6
10699,파이트/Noun,10,4,6,4.446124091323389e-05,6.66414909922918e-05,0.6
10700,멍멍/Adverb,10,4,6,4.446124091323389e-05,6.66414909922918e-05,0.6
10701,거늘/Noun,10,4,6,4.446124091323389e-05,6.66414909922918e-05,0.6
10702,서투르다/Adjective,10,6,4,6.669186136985083e-05,4.4427660661527865e-05,0.6
10703,버무린/Noun,10,4,6,4.446124091323389e-05,6.66414909922918e-05,0.6
10704,원더풀/Noun,10,6,4,6.669186136985083e-05,4.4427660661527865e-05,0.6
10705,아사/Noun,10,6,4,6.669186136985083e-05,4.4427660661527865e-05,0.6
10706,제거/Noun,10,6,4,6.669186136985083e-05,4.4427660661527865e-05,0.6
10707,명탐정/Noun,10,4,6,4.446124091323389e-05,6.66414909922918e-05,0.6
10708,장끌/Noun,10,4,6,4.446124091323389e-05,6.66414909922918e-05,0.6
10709,장화홍련/Noun,10,6,4,6.669186136985083e-05,4.4427660661527865e-05,0.6
10710,9.11/Number,10,6,4,6.669186136985083e-05,4.4427660661527865e-05,0.6
10711,순서/Noun,10,4,6,4.446124091323389e-05,6.66414909922918e-05,0.6
10712,밀폐/Noun,10,6,4,6.669186136985083e-05,4.4427660661527865e-05,0.6
10713,일본드라마/Noun,10,6,4,6.669186136985083e-05,4.4427660661527865e-05,0.6
10714,엠마왓슨/Noun,10,4,6,4.446124091323389e-05,6.66414909922918e-05,0.6
10715,관상/Noun,10,5,5,5.557655114154236e-05,5.5534575826909837e-05,0.5
10716,화두/Noun,10,5,5,5.557655114154236e-05,5.5534575826909837e-05,0.5
10717,김정일/Noun,10,5,5,5.557655114154236e-05,5.5534575826909837e-05,0.5
10718,슈퍼히어로/Noun,10,5,5,5.557655114154236e-05,5.5534575826909837e-05,0.5
10719,로/Foreign,10,5,5,5.557655114154236e-05,5.5534575826909837e-05,0.5
10720,김해숙/Noun,10,5,5,5.557655114154236e-05,5.5534575826909837e-05,0.5
10721,cm/Alpha,10,5,5,5.557655114154236e-05,5.5534575826909837e-05,0.5
10722,국영/Noun,10,5,5,5.557655114154236e-05,5.5534575826909837e-05,0.5
10723,35/Number,10,5,5,5.557655114154236e-05,5.5534575826909837e-05,0.5
10724,장서희/Noun,10,5,5,5.557655114154236e-05,5.5534575826909837e-05,0.5
10725,관도/Noun,10,5,5,5.557655114154236e-05,5.5534575826909837e-05,0.5
10726,울고불고/Adverb,10,5,5,5.557655114154236e-05,5.5534575826909837e-05,0.5
10727,브로/Noun,10,5,5,5.557655114154236e-05,5.5534575826909837e-05,0.5
10728,명중/Noun,10,5,5,5.557655114154236e-05,5.5534575826909837e-05,0.5
10729,사무실/Noun,10,5,5,5.557655114154236e-05,5.5534575826909837e-05,0.5
10730,범위/Noun,10,5,5,5.557655114154236e-05,5.5534575826909837e-05,0.5
10731,엔진/Noun,10,5,5,5.557655114154236e-05,5.5534575826909837e-05,0.5
10732,물량/Noun,10,5,5,5.557655114154236e-05,5.5534575826909837e-05,0.5
10733,혈/Noun,10,5,5,5.557655114154236e-05,5.5534575826909837e-05,0.5
10734,실전/Noun,10,5,5,5.557655114154236e-05,5.5534575826909837e-05,0.5
10735,첨단/Noun,10,5,5,5.557655114154236e-05,5.5534575826909837e-05,0.5
10736,음향효과/Noun,10,5,5,5.557655114154236e-05,5.5534575826909837e-05,0.5
10737,리하/Noun,10,5,5,5.557655114154236e-05,5.5534575826909837e-05,0.5
10738,!./Punctuation,10,5,5,5.557655114154236e-05,5.5534575826909837e-05,0.5
10739,오달수/Noun,10,5,5,5.557655114154236e-05,5.5534575826909837e-05,0.5
10740,읽히다/Verb,10,5,5,5.557655114154236e-05,5.5534575826909837e-05,0.5
10741,크루/Noun,10,5,5,5.557655114154236e-05,5.5534575826909837e-05,0.5
10742,진찌/Noun,10,5,5,5.557655114154236e-05,5.5534575826909837e-05,0.5
10743,옥택연/Noun,10,5,5,5.557655114154236e-05,5.5534575826909837e-05,0.5
10744,안톤/Noun,10,5,5,5.557655114154236e-05,5.5534575826909837e-05,0.5
10745,워낭소리/Noun,10,5,5,5.557655114154236e-05,5.5534575826909837e-05,0.5
10746,박민영/Noun,10,5,5,5.557655114154236e-05,5.5534575826909837e-05,0.5
10747,라이프/Noun,10,5,5,5.557655114154236e-05,5.5534575826909837e-05,0.5
10748,멀더/Noun,10,5,5,5.557655114154236e-05,5.5534575826909837e-05,0.5
10749,평행이론/Noun,10,5,5,5.557655114154236e-05,5.5534575826909837e-05,0.5
10750,대성/Noun,10,5,5,5.557655114154236e-05,5.5534575826909837e-05,0.5
10751,프라/Noun,10,5,5,5.557655114154236e-05,5.5534575826909837e-05,0.5
10752,백발/Noun,10,5,5,5.557655114154236e-05,5.5534575826909837e-05,0.5
10753,만큼만/Josa,10,5,5,5.557655114154236e-05,5.5534575826909837e-05,0.5
10754,합법/Noun,10,5,5,5.557655114154236e-05,5.5534575826909837e-05,0.5
10755,닝/Noun,10,5,5,5.557655114154236e-05,5.5534575826909837e-05,0.5
10756,상임/Noun,10,5,5,5.557655114154236e-05,5.5534575826909837e-05,0.5
10757,비비/Noun,10,5,5,5.557655114154236e-05,5.5534575826909837e-05,0.5
10758,조센징/Noun,10,5,5,5.557655114154236e-05,5.5534575826909837e-05,0.5
10759,전도/Noun,10,5,5,5.557655114154236e-05,5.5534575826909837e-05,0.5
10760,훼/Noun,10,5,5,5.557655114154236e-05,5.5534575826909837e-05,0.5
10761,4분/Number,10,5,5,5.557655114154236e-05,5.5534575826909837e-05,0.5
10762,자취/Noun,10,5,5,5.557655114154236e-05,5.5534575826909837e-05,0.5
10763,라이토/Noun,10,5,5,5.557655114154236e-05,5.5534575826909837e-05,0.5
10764,무전/Noun,10,5,5,5.557655114154236e-05,5.5534575826909837e-05,0.5
10765,주부/Noun,10,5,5,5.557655114154236e-05,5.5534575826909837e-05,0.5
10766,경비/Noun,10,5,5,5.557655114154236e-05,5.5534575826909837e-05,0.5
10767,지스/Noun,10,5,5,5.557655114154236e-05,5.5534575826909837e-05,0.5
10768,1996년/Number,10,5,5,5.557655114154236e-05,5.5534575826909837e-05,0.5
10769,대항/Noun,10,5,5,5.557655114154236e-05,5.5534575826909837e-05,0.5
10770,우연이/Noun,10,5,5,5.557655114154236e-05,5.5534575826909837e-05,0.5
10771,느그/Modifier,10,5,5,5.557655114154236e-05,5.5534575826909837e-05,0.5
10772,좔좔/Noun,10,5,5,5.557655114154236e-05,5.5534575826909837e-05,0.5
10773,합당/Noun,10,5,5,5.557655114154236e-05,5.5534575826909837e-05,0.5
10774,권유/Noun,10,5,5,5.557655114154236e-05,5.5534575826909837e-05,0.5
10775,확대/Noun,10,5,5,5.557655114154236e-05,5.5534575826909837e-05,0.5
10776,백성현/Noun,10,5,5,5.557655114154236e-05,5.5534575826909837e-05,0.5
10777,칼부림/Noun,10,5,5,5.557655114154236e-05,5.5534575826909837e-05,0.5
10778,부녀/Noun,10,5,5,5.557655114154236e-05,5.5534575826909837e-05,0.5
10779,마귀/Noun,10,5,5,5.557655114154236e-05,5.5534575826909837e-05,0.5
10780,습하다/Adjective,10,5,5,5.557655114154236e-05,5.5534575826909837e-05,0.5
10781,실물/Noun,10,5,5,5.557655114154236e-05,5.5534575826909837e-05,0.5
10782,~'/Punctuation,10,5,5,5.557655114154236e-05,5.5534575826909837e-05,0.5
10783,겁내/Noun,10,5,5,5.557655114154236e-05,5.5534575826909837e-05,0.5
10784,당분간/Noun,10,5,5,5.557655114154236e-05,5.5534575826909837e-05,0.5
10785,제때/Noun,10,5,5,5.557655114154236e-05,5.5534575826909837e-05,0.5
10786,정전/Noun,10,5,5,5.557655114154236e-05,5.5534575826909837e-05,0.5
10787,ㅠㅡㅠ/KoreanParticle,10,5,5,5.557655114154236e-05,5.5534575826909837e-05,0.5
10788,사시/Noun,10,5,5,5.557655114154236e-05,5.5534575826909837e-05,0.5
10789,썩을/Modifier,10,5,5,5.557655114154236e-05,5.5534575826909837e-05,0.5
10790,브레이크/Noun,10,5,5,5.557655114154236e-05,5.5534575826909837e-05,0.5
10791,소이현/Noun,10,5,5,5.557655114154236e-05,5.5534575826909837e-05,0.5
10792,3만/Number,10,5,5,5.557655114154236e-05,5.5534575826909837e-05,0.5
10793,독자/Noun,10,5,5,5.557655114154236e-05,5.5534575826909837e-05,0.5
10794,덧붙이다/Verb,10,5,5,5.557655114154236e-05,5.5534575826909837e-05,0.5
10795,상감/Noun,10,5,5,5.557655114154236e-05,5.5534575826909837e-05,0.5
10796,정일우/Noun,10,5,5,5.557655114154236e-05,5.5534575826909837e-05,0.5
10797,도성/Noun,10,5,5,5.557655114154236e-05,5.5534575826909837e-05,0.5
10798,후세/Noun,10,5,5,5.557655114154236e-05,5.5534575826909837e-05,0.5
10799,방가/Noun,10,5,5,5.557655114154236e-05,5.5534575826909837e-05,0.5
10800,집도/Noun,10,5,5,5.557655114154236e-05,5.5534575826909837e-05,0.5
10801,약물/Noun,10,5,5,5.557655114154236e-05,5.5534575826909837e-05,0.5
10802,연기면/Noun,10,5,5,5.557655114154236e-05,5.5534575826909837e-05,0.5
10803,정신차려라/Noun,9,0,9,0.0,9.99622364884377e-05,1.0
10804,망인/Noun,9,0,9,0.0,9.99622364884377e-05,1.0
10805,천조국/Noun,9,9,0,0.00010003779205477625,0.0,1.0
10806,바니/Noun,9,9,0,0.00010003779205477625,0.0,1.0
10807,거볼/Noun,9,0,9,0.0,9.99622364884377e-05,1.0
10808,장난없다/Adjective,9,9,0,0.00010003779205477625,0.0,1.0
10809,땔/Noun,9,9,0,0.00010003779205477625,0.0,1.0
10810,민경/Noun,9,0,9,0.0,9.99622364884377e-05,1.0
10811,분리수거/Noun,9,0,9,0.0,9.99622364884377e-05,1.0
10812,겸비/Noun,9,9,0,0.00010003779205477625,0.0,1.0
10813,낙제/Noun,9,0,9,0.0,9.99622364884377e-05,1.0
10814,겸손하다/Adjective,9,9,0,0.00010003779205477625,0.0,1.0
10815,직면/Noun,9,9,0,0.00010003779205477625,0.0,1.0
10816,THE/Alpha,9,9,0,0.00010003779205477625,0.0,1.0
10817,최진혁/Noun,9,9,0,0.00010003779205477625,0.0,1.0
10818,용납/Noun,9,0,9,0.0,9.99622364884377e-05,1.0
10819,윤찬/Noun,9,0,9,0.0,9.99622364884377e-05,1.0
10820,할껄/Noun,9,0,9,0.0,9.99622364884377e-05,1.0
10821,잡담/Noun,9,0,9,0.0,9.99622364884377e-05,1.0
10822,강윤/Noun,9,0,9,0.0,9.99622364884377e-05,1.0
10823,벙어리/Noun,9,0,9,0.0,9.99622364884377e-05,1.0
10824,웹하드/Noun,9,0,9,0.0,9.99622364884377e-05,1.0
10825,낚였음/Noun,9,0,9,0.0,9.99622364884377e-05,1.0
10826,폐기/Noun,9,0,9,0.0,9.99622364884377e-05,1.0
10827,전라/Noun,9,0,9,0.0,9.99622364884377e-05,1.0
10828,오락가락/Noun,9,0,9,0.0,9.99622364884377e-05,1.0
10829,승질/Noun,9,0,9,0.0,9.99622364884377e-05,1.0
10830,맹물/Noun,9,0,9,0.0,9.99622364884377e-05,1.0
10831,배짱/Noun,9,0,9,0.0,9.99622364884377e-05,1.0
10832,괘씸하다/Adjective,9,0,9,0.0,9.99622364884377e-05,1.0
10833,귀염/Noun,9,9,0,0.00010003779205477625,0.0,1.0
10834,멘마/Noun,9,9,0,0.00010003779205477625,0.0,1.0
10835,썰렁/Noun,9,0,9,0.0,9.99622364884377e-05,1.0
10836,3500원/Number,9,0,9,0.0,9.99622364884377e-05,1.0
10837,하물며/Noun,9,0,9,0.0,9.99622364884377e-05,1.0
10838,좃/Noun,9,0,9,0.0,9.99622364884377e-05,1.0
10839,스크린쿼터제/Noun,9,0,9,0.0,9.99622364884377e-05,1.0
10840,시티헌터/Noun,9,9,0,0.00010003779205477625,0.0,1.0
10841,잼잼/Noun,9,9,0,0.00010003779205477625,0.0,1.0
10842,보다만/Josa,9,0,9,0.0,9.99622364884377e-05,1.0
10843,안이하다/Adjective,9,0,9,0.0,9.99622364884377e-05,1.0
10844,우좀/Noun,9,0,9,0.0,9.99622364884377e-05,1.0
10845,악/Exclamation,9,0,9,0.0,9.99622364884377e-05,1.0
10846,지창욱/Noun,9,9,0,0.00010003779205477625,0.0,1.0
10847,Love/Alpha,9,9,0,0.00010003779205477625,0.0,1.0
10848,ㄲㅈ/KoreanParticle,9,0,9,0.0,9.99622364884377e-05,1.0
10849,수화/Noun,9,9,0,0.00010003779205477625,0.0,1.0
10850,남일/Noun,9,9,0,0.00010003779205477625,0.0,1.0
10851,고흐/Noun,9,9,0,0.00010003779205477625,0.0,1.0
10852,민비/Noun,9,0,9,0.0,9.99622364884377e-05,1.0
10853,핵폐기물/Noun,9,0,9,0.0,9.99622364884377e-05,1.0
10854,버젓이/Adverb,9,0,9,0.0,9.99622364884377e-05,1.0
10855,낚이/Noun,9,0,9,0.0,9.99622364884377e-05,1.0
10856,탁하다/Adjective,9,1,8,1.1115310228308472e-05,8.885532132305573e-05,0.8888888888888888
10857,".,.,/Punctuation",9,1,8,1.1115310228308472e-05,8.885532132305573e-05,0.8888888888888888
10858,다정하다/Adjective,9,8,1,8.892248182646778e-05,1.1106915165381966e-05,0.8888888888888888
10859,인과관계/Noun,9,1,8,1.1115310228308472e-05,8.885532132305573e-05,0.8888888888888888
10860,끌어내리다/Verb,9,1,8,1.1115310228308472e-05,8.885532132305573e-05,0.8888888888888888
10861,씩/Noun,9,1,8,1.1115310228308472e-05,8.885532132305573e-05,0.8888888888888888
10862,비장/Noun,9,8,1,8.892248182646778e-05,1.1106915165381966e-05,0.8888888888888888
10863,시세/Noun,9,8,1,8.892248182646778e-05,1.1106915165381966e-05,0.8888888888888888
10864,95분/Number,9,1,8,1.1115310228308472e-05,8.885532132305573e-05,0.8888888888888888
10865,고소/Noun,9,1,8,1.1115310228308472e-05,8.885532132305573e-05,0.8888888888888888
10866,청초하다/Adjective,9,8,1,8.892248182646778e-05,1.1106915165381966e-05,0.8888888888888888
10867,드림하이/Noun,9,1,8,1.1115310228308472e-05,8.885532132305573e-05,0.8888888888888888
10868,윤두준/Noun,9,8,1,8.892248182646778e-05,1.1106915165381966e-05,0.8888888888888888
10869,브로드웨이/Noun,9,8,1,8.892248182646778e-05,1.1106915165381966e-05,0.8888888888888888
10870,약탈/Noun,9,1,8,1.1115310228308472e-05,8.885532132305573e-05,0.8888888888888888
10871,캐롤/Noun,9,8,1,8.892248182646778e-05,1.1106915165381966e-05,0.8888888888888888
10872,너리/Noun,9,1,8,1.1115310228308472e-05,8.885532132305573e-05,0.8888888888888888
10873,봉작/Noun,9,1,8,1.1115310228308472e-05,8.885532132305573e-05,0.8888888888888888
10874,bomb/Alpha,9,1,8,1.1115310228308472e-05,8.885532132305573e-05,0.8888888888888888
10875,위조/Noun,9,1,8,1.1115310228308472e-05,8.885532132305573e-05,0.8888888888888888
10876,강연/Noun,9,8,1,8.892248182646778e-05,1.1106915165381966e-05,0.8888888888888888
10877,사이보그/Noun,9,1,8,1.1115310228308472e-05,8.885532132305573e-05,0.8888888888888888
10878,소오강호/Noun,9,8,1,8.892248182646778e-05,1.1106915165381966e-05,0.8888888888888888
10879,나요/Eomi,9,8,1,8.892248182646778e-05,1.1106915165381966e-05,0.8888888888888888
10880,선셋/Noun,9,8,1,8.892248182646778e-05,1.1106915165381966e-05,0.8888888888888888
10881,딴판/Noun,9,1,8,1.1115310228308472e-05,8.885532132305573e-05,0.8888888888888888
10882,읎/Noun,9,1,8,1.1115310228308472e-05,8.885532132305573e-05,0.8888888888888888
10883,블로그/Noun,9,1,8,1.1115310228308472e-05,8.885532132305573e-05,0.8888888888888888
10884,가원/Noun,9,8,1,8.892248182646778e-05,1.1106915165381966e-05,0.8888888888888888
10885,본보기/Noun,9,1,8,1.1115310228308472e-05,8.885532132305573e-05,0.8888888888888888
10886,비웃음/Noun,9,1,8,1.1115310228308472e-05,8.885532132305573e-05,0.8888888888888888
10887,모기/Noun,9,1,8,1.1115310228308472e-05,8.885532132305573e-05,0.8888888888888888
10888,앵앵거리다/Verb,9,1,8,1.1115310228308472e-05,8.885532132305573e-05,0.8888888888888888
10889,파국/Noun,9,8,1,8.892248182646778e-05,1.1106915165381966e-05,0.8888888888888888
10890,이수혁/Noun,9,8,1,8.892248182646778e-05,1.1106915165381966e-05,0.8888888888888888
10891,쪼가리/Noun,9,1,8,1.1115310228308472e-05,8.885532132305573e-05,0.8888888888888888
10892,돕기/Noun,9,1,8,1.1115310228308472e-05,8.885532132305573e-05,0.8888888888888888
10893,ucc/Alpha,9,1,8,1.1115310228308472e-05,8.885532132305573e-05,0.8888888888888888
10894,수백향/Noun,9,8,1,8.892248182646778e-05,1.1106915165381966e-05,0.8888888888888888
10895,성범죄/Noun,9,1,8,1.1115310228308472e-05,8.885532132305573e-05,0.8888888888888888
10896,불안감/Noun,9,8,1,8.892248182646778e-05,1.1106915165381966e-05,0.8888888888888888
10897,난잡/Noun,9,1,8,1.1115310228308472e-05,8.885532132305573e-05,0.8888888888888888
10898,폐가/Noun,9,1,8,1.1115310228308472e-05,8.885532132305573e-05,0.8888888888888888
10899,설국열차/Noun,9,8,1,8.892248182646778e-05,1.1106915165381966e-05,0.8888888888888888
10900,수선/Noun,9,1,8,1.1115310228308472e-05,8.885532132305573e-05,0.8888888888888888
10901,우피/Noun,9,8,1,8.892248182646778e-05,1.1106915165381966e-05,0.8888888888888888
10902,....................../Punctuation,9,1,8,1.1115310228308472e-05,8.885532132305573e-05,0.8888888888888888
10903,그늘/Noun,9,8,1,8.892248182646778e-05,1.1106915165381966e-05,0.8888888888888888
10904,퇴물/Noun,9,1,8,1.1115310228308472e-05,8.885532132305573e-05,0.8888888888888888
10905,들통/Noun,9,1,8,1.1115310228308472e-05,8.885532132305573e-05,0.8888888888888888
10906,해전/Noun,9,8,1,8.892248182646778e-05,1.1106915165381966e-05,0.8888888888888888
10907,어미/Noun,9,8,1,8.892248182646778e-05,1.1106915165381966e-05,0.8888888888888888
10908,뒈지다/Verb,9,1,8,1.1115310228308472e-05,8.885532132305573e-05,0.8888888888888888
10909,유통/Noun,9,1,8,1.1115310228308472e-05,8.885532132305573e-05,0.8888888888888888
10910,복합/Noun,9,8,1,8.892248182646778e-05,1.1106915165381966e-05,0.8888888888888888
10911,진행형/Noun,9,8,1,8.892248182646778e-05,1.1106915165381966e-05,0.8888888888888888
10912,만도/Noun,9,1,8,1.1115310228308472e-05,8.885532132305573e-05,0.8888888888888888
10913,스폰서/Noun,9,1,8,1.1115310228308472e-05,8.885532132305573e-05,0.8888888888888888
10914,머싯/Noun,9,8,1,8.892248182646778e-05,1.1106915165381966e-05,0.8888888888888888
10915,불쾌감/Noun,9,1,8,1.1115310228308472e-05,8.885532132305573e-05,0.8888888888888888
10916,조상/Noun,9,8,1,8.892248182646778e-05,1.1106915165381966e-05,0.8888888888888888
10917,쪽박/Noun,9,1,8,1.1115310228308472e-05,8.885532132305573e-05,0.8888888888888888
10918,중화사상/Noun,9,1,8,1.1115310228308472e-05,8.885532132305573e-05,0.8888888888888888
10919,뺑소니/Noun,9,1,8,1.1115310228308472e-05,8.885532132305573e-05,0.8888888888888888
10920,덴/Noun,9,1,8,1.1115310228308472e-05,8.885532132305573e-05,0.8888888888888888
10921,전략/Noun,9,1,8,1.1115310228308472e-05,8.885532132305573e-05,0.8888888888888888
10922,아이즈/Noun,9,8,1,8.892248182646778e-05,1.1106915165381966e-05,0.8888888888888888
10923,4.4/Number,9,1,8,1.1115310228308472e-05,8.885532132305573e-05,0.8888888888888888
10924,후려치다/Verb,9,1,8,1.1115310228308472e-05,8.885532132305573e-05,0.8888888888888888
10925,꽃뱀/Noun,9,1,8,1.1115310228308472e-05,8.885532132305573e-05,0.8888888888888888
10926,로프/Noun,9,8,1,8.892248182646778e-05,1.1106915165381966e-05,0.8888888888888888
10927,매즈/Noun,9,8,1,8.892248182646778e-05,1.1106915165381966e-05,0.8888888888888888
10928,가증/Noun,9,1,8,1.1115310228308472e-05,8.885532132305573e-05,0.8888888888888888
10929,마음대로/Noun,9,1,8,1.1115310228308472e-05,8.885532132305573e-05,0.8888888888888888
10930,들러리/Noun,9,1,8,1.1115310228308472e-05,8.885532132305573e-05,0.8888888888888888
10931,인심/Noun,9,1,8,1.1115310228308472e-05,8.885532132305573e-05,0.8888888888888888
10932,졸이다/Verb,9,8,1,8.892248182646778e-05,1.1106915165381966e-05,0.8888888888888888
10933,생방/Noun,9,1,8,1.1115310228308472e-05,8.885532132305573e-05,0.8888888888888888
10934,원조교제/Noun,9,1,8,1.1115310228308472e-05,8.885532132305573e-05,0.8888888888888888
10935,꼭꼭/Noun,9,8,1,8.892248182646778e-05,1.1106915165381966e-05,0.8888888888888888
10936,더없이/Noun,9,8,1,8.892248182646778e-05,1.1106915165381966e-05,0.8888888888888888
10937,라스베가스/Noun,9,8,1,8.892248182646778e-05,1.1106915165381966e-05,0.8888888888888888
10938,민세/Noun,9,1,8,1.1115310228308472e-05,8.885532132305573e-05,0.8888888888888888
10939,감미롭다/Adjective,9,8,1,8.892248182646778e-05,1.1106915165381966e-05,0.8888888888888888
10940,이명세/Noun,9,8,1,8.892248182646778e-05,1.1106915165381966e-05,0.8888888888888888
10941,정열/Noun,9,8,1,8.892248182646778e-05,1.1106915165381966e-05,0.8888888888888888
10942,시로/Noun,9,8,1,8.892248182646778e-05,1.1106915165381966e-05,0.8888888888888888
10943,수수하다/Adjective,9,8,1,8.892248182646778e-05,1.1106915165381966e-05,0.8888888888888888
10944,질의/Noun,9,1,8,1.1115310228308472e-05,8.885532132305573e-05,0.8888888888888888
10945,리더십/Noun,9,8,1,8.892248182646778e-05,1.1106915165381966e-05,0.8888888888888888
10946,8000원/Number,9,1,8,1.1115310228308472e-05,8.885532132305573e-05,0.8888888888888888
10947,캬악/Noun,9,1,8,1.1115310228308472e-05,8.885532132305573e-05,0.8888888888888888
10948,알렉산더/Noun,9,8,1,8.892248182646778e-05,1.1106915165381966e-05,0.8888888888888888
10949,도희/Noun,9,1,8,1.1115310228308472e-05,8.885532132305573e-05,0.8888888888888888
10950,삶속/Noun,9,8,1,8.892248182646778e-05,1.1106915165381966e-05,0.8888888888888888
10951,구체/Noun,9,8,1,8.892248182646778e-05,1.1106915165381966e-05,0.8888888888888888
10952,이상/Foreign,9,1,8,1.1115310228308472e-05,8.885532132305573e-05,0.8888888888888888
10953,돌변/Noun,9,1,8,1.1115310228308472e-05,8.885532132305573e-05,0.8888888888888888
10954,게으르다/Adjective,9,1,8,1.1115310228308472e-05,8.885532132305573e-05,0.8888888888888888
10955,목요일/Noun,9,8,1,8.892248182646778e-05,1.1106915165381966e-05,0.8888888888888888
10956,크림슨/Noun,9,1,8,1.1115310228308472e-05,8.885532132305573e-05,0.8888888888888888
10957,우유부단하다/Adjective,9,2,7,2.2230620456616944e-05,7.774840615767377e-05,0.7777777777777778
10958,필히/Noun,9,7,2,7.78071715981593e-05,2.2213830330763933e-05,0.7777777777777778
10959,선도/Noun,9,2,7,2.2230620456616944e-05,7.774840615767377e-05,0.7777777777777778
10960,그루/Noun,9,7,2,7.78071715981593e-05,2.2213830330763933e-05,0.7777777777777778
10961,살펴보다/Verb,9,2,7,2.2230620456616944e-05,7.774840615767377e-05,0.7777777777777778
10962,리자/Noun,9,2,7,2.2230620456616944e-05,7.774840615767377e-05,0.7777777777777778
10963,꿇다/Verb,9,7,2,7.78071715981593e-05,2.2213830330763933e-05,0.7777777777777778
10964,사토/Noun,9,7,2,7.78071715981593e-05,2.2213830330763933e-05,0.7777777777777778
10965,존박/Noun,9,7,2,7.78071715981593e-05,2.2213830330763933e-05,0.7777777777777778
10966,물속/Noun,9,2,7,2.2230620456616944e-05,7.774840615767377e-05,0.7777777777777778
10967,수나/Noun,9,2,7,2.2230620456616944e-05,7.774840615767377e-05,0.7777777777777778
10968,볼트/Noun,9,7,2,7.78071715981593e-05,2.2213830330763933e-05,0.7777777777777778
10969,해프닝/Noun,9,2,7,2.2230620456616944e-05,7.774840615767377e-05,0.7777777777777778
10970,지체/Noun,9,2,7,2.2230620456616944e-05,7.774840615767377e-05,0.7777777777777778
10971,토막/Noun,9,2,7,2.2230620456616944e-05,7.774840615767377e-05,0.7777777777777778
10972,잠입/Noun,9,2,7,2.2230620456616944e-05,7.774840615767377e-05,0.7777777777777778
10973,스폰/Noun,9,2,7,2.2230620456616944e-05,7.774840615767377e-05,0.7777777777777778
10974,롤모델/Noun,9,7,2,7.78071715981593e-05,2.2213830330763933e-05,0.7777777777777778
10975,배드씬/Noun,9,2,7,2.2230620456616944e-05,7.774840615767377e-05,0.7777777777777778
10976,울프/Noun,9,7,2,7.78071715981593e-05,2.2213830330763933e-05,0.7777777777777778
10977,만듭시/Noun,9,2,7,2.2230620456616944e-05,7.774840615767377e-05,0.7777777777777778
10978,하룻밤/Noun,9,2,7,2.2230620456616944e-05,7.774840615767377e-05,0.7777777777777778
10979,잠재/Noun,9,7,2,7.78071715981593e-05,2.2213830330763933e-05,0.7777777777777778
10980,띄엄띄엄/Noun,9,2,7,2.2230620456616944e-05,7.774840615767377e-05,0.7777777777777778
10981,게시판/Noun,9,2,7,2.2230620456616944e-05,7.774840615767377e-05,0.7777777777777778
10982,가늠/Noun,9,7,2,7.78071715981593e-05,2.2213830330763933e-05,0.7777777777777778
10983,선라이즈/Noun,9,7,2,7.78071715981593e-05,2.2213830330763933e-05,0.7777777777777778
10984,무수/Noun,9,7,2,7.78071715981593e-05,2.2213830330763933e-05,0.7777777777777778
10985,중세시대/Noun,9,7,2,7.78071715981593e-05,2.2213830330763933e-05,0.7777777777777778
10986,데모/Noun,9,2,7,2.2230620456616944e-05,7.774840615767377e-05,0.7777777777777778
10987,창정/Noun,9,7,2,7.78071715981593e-05,2.2213830330763933e-05,0.7777777777777778
10988,그랜트/Noun,9,7,2,7.78071715981593e-05,2.2213830330763933e-05,0.7777777777777778
10989,빠져나가다/Verb,9,7,2,7.78071715981593e-05,2.2213830330763933e-05,0.7777777777777778
10990,맨발/Noun,9,7,2,7.78071715981593e-05,2.2213830330763933e-05,0.7777777777777778
10991,미약/Noun,9,2,7,2.2230620456616944e-05,7.774840615767377e-05,0.7777777777777778
10992,79년/Number,9,7,2,7.78071715981593e-05,2.2213830330763933e-05,0.7777777777777778
10993,광장/Noun,9,7,2,7.78071715981593e-05,2.2213830330763933e-05,0.7777777777777778
10994,찬가/Noun,9,7,2,7.78071715981593e-05,2.2213830330763933e-05,0.7777777777777778
10995,always/Alpha,9,7,2,7.78071715981593e-05,2.2213830330763933e-05,0.7777777777777778
10996,무신/Noun,9,2,7,2.2230620456616944e-05,7.774840615767377e-05,0.7777777777777778
10997,비단/Noun,9,7,2,7.78071715981593e-05,2.2213830330763933e-05,0.7777777777777778
10998,뻥튀기/Noun,9,2,7,2.2230620456616944e-05,7.774840615767377e-05,0.7777777777777778
10999,발언/Noun,9,2,7,2.2230620456616944e-05,7.774840615767377e-05,0.7777777777777778
11000,가감/Noun,9,7,2,7.78071715981593e-05,2.2213830330763933e-05,0.7777777777777778
11001,씽/Adverb,9,2,7,2.2230620456616944e-05,7.774840615767377e-05,0.7777777777777778
11002,라든가/Josa,9,2,7,2.2230620456616944e-05,7.774840615767377e-05,0.7777777777777778
11003,스파이크/Noun,9,2,7,2.2230620456616944e-05,7.774840615767377e-05,0.7777777777777778
11004,페킨파/Noun,9,7,2,7.78071715981593e-05,2.2213830330763933e-05,0.7777777777777778
11005,잠자리/Noun,9,2,7,2.2230620456616944e-05,7.774840615767377e-05,0.7777777777777778
11006,어눌하다/Adjective,9,2,7,2.2230620456616944e-05,7.774840615767377e-05,0.7777777777777778
11007,윤여정/Noun,9,7,2,7.78071715981593e-05,2.2213830330763933e-05,0.7777777777777778
11008,가루/Noun,9,2,7,2.2230620456616944e-05,7.774840615767377e-05,0.7777777777777778
11009,후자/Noun,9,2,7,2.2230620456616944e-05,7.774840615767377e-05,0.7777777777777778
11010,장물/Noun,9,2,7,2.2230620456616944e-05,7.774840615767377e-05,0.7777777777777778
11011,식민지/Noun,9,2,7,2.2230620456616944e-05,7.774840615767377e-05,0.7777777777777778
11012,에미/Noun,9,7,2,7.78071715981593e-05,2.2213830330763933e-05,0.7777777777777778
11013,격하/Noun,9,7,2,7.78071715981593e-05,2.2213830330763933e-05,0.7777777777777778
11014,재우다/Verb,9,2,7,2.2230620456616944e-05,7.774840615767377e-05,0.7777777777777778
11015,존엄성/Noun,9,7,2,7.78071715981593e-05,2.2213830330763933e-05,0.7777777777777778
11016,반짝/Noun,9,2,7,2.2230620456616944e-05,7.774840615767377e-05,0.7777777777777778
11017,가엾다/Adjective,9,2,7,2.2230620456616944e-05,7.774840615767377e-05,0.7777777777777778
11018,껄렁하다/Adjective,9,2,7,2.2230620456616944e-05,7.774840615767377e-05,0.7777777777777778
11019,뒷북/Noun,9,7,2,7.78071715981593e-05,2.2213830330763933e-05,0.7777777777777778
11020,위더/Noun,9,2,7,2.2230620456616944e-05,7.774840615767377e-05,0.7777777777777778
11021,우아/Exclamation,9,7,2,7.78071715981593e-05,2.2213830330763933e-05,0.7777777777777778
11022,급박하다/Adjective,9,2,7,2.2230620456616944e-05,7.774840615767377e-05,0.7777777777777778
11023,발리다/Verb,9,2,7,2.2230620456616944e-05,7.774840615767377e-05,0.7777777777777778
11024,레이저/Noun,9,2,7,2.2230620456616944e-05,7.774840615767377e-05,0.7777777777777778
11025,전복/Noun,9,2,7,2.2230620456616944e-05,7.774840615767377e-05,0.7777777777777778
11026,적벽대전/Noun,9,2,7,2.2230620456616944e-05,7.774840615767377e-05,0.7777777777777778
11027,깨물다/Verb,9,7,2,7.78071715981593e-05,2.2213830330763933e-05,0.7777777777777778
11028,포효/Noun,9,7,2,7.78071715981593e-05,2.2213830330763933e-05,0.7777777777777778
11029,타쿠야/Noun,9,7,2,7.78071715981593e-05,2.2213830330763933e-05,0.7777777777777778
11030,마술사/Noun,9,7,2,7.78071715981593e-05,2.2213830330763933e-05,0.7777777777777778
11031,치졸하다/Adjective,9,2,7,2.2230620456616944e-05,7.774840615767377e-05,0.7777777777777778
11032,년놈/Noun,9,2,7,2.2230620456616944e-05,7.774840615767377e-05,0.7777777777777778
11033,가인/Noun,9,7,2,7.78071715981593e-05,2.2213830330763933e-05,0.7777777777777778
11034,몽정기/Noun,9,2,7,2.2230620456616944e-05,7.774840615767377e-05,0.7777777777777778
11035,유모/Noun,9,7,2,7.78071715981593e-05,2.2213830330763933e-05,0.7777777777777778
11036,엘프/Noun,9,7,2,7.78071715981593e-05,2.2213830330763933e-05,0.7777777777777778
11037,흐믓/Noun,9,7,2,7.78071715981593e-05,2.2213830330763933e-05,0.7777777777777778
11038,자라나다/Verb,9,7,2,7.78071715981593e-05,2.2213830330763933e-05,0.7777777777777778
11039,일어/Noun,9,2,7,2.2230620456616944e-05,7.774840615767377e-05,0.7777777777777778
11040,단순화/Noun,9,2,7,2.2230620456616944e-05,7.774840615767377e-05,0.7777777777777778
11041,학과/Noun,9,2,7,2.2230620456616944e-05,7.774840615767377e-05,0.7777777777777778
11042,기타등등/Noun,9,2,7,2.2230620456616944e-05,7.774840615767377e-05,0.7777777777777778
11043,말초신경/Noun,9,2,7,2.2230620456616944e-05,7.774840615767377e-05,0.7777777777777778
11044,미카/Noun,9,7,2,7.78071715981593e-05,2.2213830330763933e-05,0.7777777777777778
11045,유기견/Noun,9,7,2,7.78071715981593e-05,2.2213830330763933e-05,0.7777777777777778
11046,IPTV/Alpha,9,2,7,2.2230620456616944e-05,7.774840615767377e-05,0.7777777777777778
11047,깡/Noun,9,2,7,2.2230620456616944e-05,7.774840615767377e-05,0.7777777777777778
11048,폭망/Noun,9,2,7,2.2230620456616944e-05,7.774840615767377e-05,0.7777777777777778
11049,소고기/Noun,9,2,7,2.2230620456616944e-05,7.774840615767377e-05,0.7777777777777778
11050,마미/Noun,9,7,2,7.78071715981593e-05,2.2213830330763933e-05,0.7777777777777778
11051,고유/Noun,9,7,2,7.78071715981593e-05,2.2213830330763933e-05,0.7777777777777778
11052,빅맨/Noun,9,7,2,7.78071715981593e-05,2.2213830330763933e-05,0.7777777777777778
11053,성나다/Verb,9,2,7,2.2230620456616944e-05,7.774840615767377e-05,0.7777777777777778
11054,발란스/Noun,9,2,7,2.2230620456616944e-05,7.774840615767377e-05,0.7777777777777778
11055,스모/Noun,9,2,7,2.2230620456616944e-05,7.774840615767377e-05,0.7777777777777778
11056,황폐/Noun,9,7,2,7.78071715981593e-05,2.2213830330763933e-05,0.7777777777777778
11057,바란/Noun,9,2,7,2.2230620456616944e-05,7.774840615767377e-05,0.7777777777777778
11058,빈센트/Noun,9,7,2,7.78071715981593e-05,2.2213830330763933e-05,0.7777777777777778
11059,원츄/Noun,9,7,2,7.78071715981593e-05,2.2213830330763933e-05,0.7777777777777778
11060,예기/Noun,9,2,7,2.2230620456616944e-05,7.774840615767377e-05,0.7777777777777778
11061,자폭/Noun,9,2,7,2.2230620456616944e-05,7.774840615767377e-05,0.7777777777777778
11062,주일/Noun,9,7,2,7.78071715981593e-05,2.2213830330763933e-05,0.7777777777777778
11063,지갑/Noun,9,2,7,2.2230620456616944e-05,7.774840615767377e-05,0.7777777777777778
11064,.!!!!/Punctuation,9,7,2,7.78071715981593e-05,2.2213830330763933e-05,0.7777777777777778
11065,따귀/Noun,9,2,7,2.2230620456616944e-05,7.774840615767377e-05,0.7777777777777778
11066,존시나/Noun,9,2,7,2.2230620456616944e-05,7.774840615767377e-05,0.7777777777777778
11067,헤라클레스/Noun,9,2,7,2.2230620456616944e-05,7.774840615767377e-05,0.7777777777777778
11068,최정윤/Noun,9,2,7,2.2230620456616944e-05,7.774840615767377e-05,0.7777777777777778
11069,정신연령/Noun,9,2,7,2.2230620456616944e-05,7.774840615767377e-05,0.7777777777777778
11070,선덕여왕/Noun,9,7,2,7.78071715981593e-05,2.2213830330763933e-05,0.7777777777777778
11071,실태/Noun,9,7,2,7.78071715981593e-05,2.2213830330763933e-05,0.7777777777777778
11072,낙원/Noun,9,7,2,7.78071715981593e-05,2.2213830330763933e-05,0.7777777777777778
11073,~^^*/Punctuation,9,7,2,7.78071715981593e-05,2.2213830330763933e-05,0.7777777777777778
11074,ㅎㄷㄷㄷ/KoreanParticle,9,7,2,7.78071715981593e-05,2.2213830330763933e-05,0.7777777777777778
11075,간츠/Noun,9,2,7,2.2230620456616944e-05,7.774840615767377e-05,0.7777777777777778
11076,이송희일/Noun,9,2,7,2.2230620456616944e-05,7.774840615767377e-05,0.7777777777777778
11077,스카/Noun,9,7,2,7.78071715981593e-05,2.2213830330763933e-05,0.7777777777777778
11078,이따금/Adverb,9,7,2,7.78071715981593e-05,2.2213830330763933e-05,0.7777777777777778
11079,처제/Noun,9,2,7,2.2230620456616944e-05,7.774840615767377e-05,0.7777777777777778
11080,주무시다/Verb,9,2,7,2.2230620456616944e-05,7.774840615767377e-05,0.7777777777777778
11081,뤽베송/Noun,9,7,2,7.78071715981593e-05,2.2213830330763933e-05,0.7777777777777778
11082,이적/Noun,9,7,2,7.78071715981593e-05,2.2213830330763933e-05,0.7777777777777778
11083,레슬리/Noun,9,7,2,7.78071715981593e-05,2.2213830330763933e-05,0.7777777777777778
11084,무릎팍/Noun,9,3,6,3.3345930684925414e-05,6.66414909922918e-05,0.6666666666666666
11085,조그만/Noun,9,6,3,6.669186136985083e-05,3.33207454961459e-05,0.6666666666666666
11086,얼룩지다/Verb,9,6,3,6.669186136985083e-05,3.33207454961459e-05,0.6666666666666666
11087,사단/Noun,9,6,3,6.669186136985083e-05,3.33207454961459e-05,0.6666666666666666
11088,외부/Noun,9,6,3,6.669186136985083e-05,3.33207454961459e-05,0.6666666666666666
11089,윤성호/Noun,9,6,3,6.669186136985083e-05,3.33207454961459e-05,0.6666666666666666
11090,학교폭력/Noun,9,3,6,3.3345930684925414e-05,6.66414909922918e-05,0.6666666666666666
11091,케리/Noun,9,6,3,6.669186136985083e-05,3.33207454961459e-05,0.6666666666666666
11092,럭키/Noun,9,3,6,3.3345930684925414e-05,6.66414909922918e-05,0.6666666666666666
11093,힘주다/Verb,9,3,6,3.3345930684925414e-05,6.66414909922918e-05,0.6666666666666666
11094,디아/Noun,9,3,6,3.3345930684925414e-05,6.66414909922918e-05,0.6666666666666666
11095,조종사/Noun,9,3,6,3.3345930684925414e-05,6.66414909922918e-05,0.6666666666666666
11096,샤이닝/Noun,9,3,6,3.3345930684925414e-05,6.66414909922918e-05,0.6666666666666666
11097,파장/Noun,9,6,3,6.669186136985083e-05,3.33207454961459e-05,0.6666666666666666
11098,남장/Noun,9,6,3,6.669186136985083e-05,3.33207454961459e-05,0.6666666666666666
11099,상대방/Noun,9,6,3,6.669186136985083e-05,3.33207454961459e-05,0.6666666666666666
11100,",.,/Punctuation",9,3,6,3.3345930684925414e-05,6.66414909922918e-05,0.6666666666666666
11101,안햇/Noun,9,3,6,3.3345930684925414e-05,6.66414909922918e-05,0.6666666666666666
11102,장가휘/Noun,9,6,3,6.669186136985083e-05,3.33207454961459e-05,0.6666666666666666
11103,꼼꼼하다/Adjective,9,6,3,6.669186136985083e-05,3.33207454961459e-05,0.6666666666666666
11104,지난주/Noun,9,3,6,3.3345930684925414e-05,6.66414909922918e-05,0.6666666666666666
11105,사정봉/Noun,9,3,6,3.3345930684925414e-05,6.66414909922918e-05,0.6666666666666666
11106,럽/Noun,9,6,3,6.669186136985083e-05,3.33207454961459e-05,0.6666666666666666
11107,마가렛/Noun,9,6,3,6.669186136985083e-05,3.33207454961459e-05,0.6666666666666666
11108,관음증/Noun,9,6,3,6.669186136985083e-05,3.33207454961459e-05,0.6666666666666666
11109,동상/Noun,9,3,6,3.3345930684925414e-05,6.66414909922918e-05,0.6666666666666666
11110,대갈/Noun,9,3,6,3.3345930684925414e-05,6.66414909922918e-05,0.6666666666666666
11111,예민하다/Adjective,9,6,3,6.669186136985083e-05,3.33207454961459e-05,0.6666666666666666
11112,4.3/Number,9,3,6,3.3345930684925414e-05,6.66414909922918e-05,0.6666666666666666
11113,비리다/Adjective,9,3,6,3.3345930684925414e-05,6.66414909922918e-05,0.6666666666666666
11114,스크린쿼터/Noun,9,3,6,3.3345930684925414e-05,6.66414909922918e-05,0.6666666666666666
11115,아버님/Noun,9,6,3,6.669186136985083e-05,3.33207454961459e-05,0.6666666666666666
11116,대장금/Noun,9,6,3,6.669186136985083e-05,3.33207454961459e-05,0.6666666666666666
11117,7.8/Number,9,6,3,6.669186136985083e-05,3.33207454961459e-05,0.6666666666666666
11118,린데/Noun,9,3,6,3.3345930684925414e-05,6.66414909922918e-05,0.6666666666666666
11119,뿜어내다/Verb,9,6,3,6.669186136985083e-05,3.33207454961459e-05,0.6666666666666666
11120,사망유희/Noun,9,6,3,6.669186136985083e-05,3.33207454961459e-05,0.6666666666666666
11121,조율/Noun,9,6,3,6.669186136985083e-05,3.33207454961459e-05,0.6666666666666666
11122,온라인/Noun,9,6,3,6.669186136985083e-05,3.33207454961459e-05,0.6666666666666666
11123,스멜/Noun,9,3,6,3.3345930684925414e-05,6.66414909922918e-05,0.6666666666666666
11124,만빵/Noun,9,6,3,6.669186136985083e-05,3.33207454961459e-05,0.6666666666666666
11125,재발/Noun,9,3,6,3.3345930684925414e-05,6.66414909922918e-05,0.6666666666666666
11126,어떡하다/Adjective,9,6,3,6.669186136985083e-05,3.33207454961459e-05,0.6666666666666666
11127,뭉/Noun,9,3,6,3.3345930684925414e-05,6.66414909922918e-05,0.6666666666666666
11128,응사/Noun,9,3,6,3.3345930684925414e-05,6.66414909922918e-05,0.6666666666666666
11129,찌그러지다/Verb,9,3,6,3.3345930684925414e-05,6.66414909922918e-05,0.6666666666666666
11130,엘리샤/Noun,9,3,6,3.3345930684925414e-05,6.66414909922918e-05,0.6666666666666666
11131,하야/Noun,9,3,6,3.3345930684925414e-05,6.66414909922918e-05,0.6666666666666666
11132,넉/Modifier,9,3,6,3.3345930684925414e-05,6.66414909922918e-05,0.6666666666666666
11133,봉사/Noun,9,6,3,6.669186136985083e-05,3.33207454961459e-05,0.6666666666666666
11134,코빅/Noun,9,6,3,6.669186136985083e-05,3.33207454961459e-05,0.6666666666666666
11135,can/Alpha,9,6,3,6.669186136985083e-05,3.33207454961459e-05,0.6666666666666666
11136,게속/Noun,9,3,6,3.3345930684925414e-05,6.66414909922918e-05,0.6666666666666666
11137,워리어/Noun,9,3,6,3.3345930684925414e-05,6.66414909922918e-05,0.6666666666666666
11138,꾹꾹/Noun,9,3,6,3.3345930684925414e-05,6.66414909922918e-05,0.6666666666666666
11139,여고/Noun,9,3,6,3.3345930684925414e-05,6.66414909922918e-05,0.6666666666666666
11140,필모/Noun,9,3,6,3.3345930684925414e-05,6.66414909922918e-05,0.6666666666666666
11141,싱/Noun,9,3,6,3.3345930684925414e-05,6.66414909922918e-05,0.6666666666666666
11142,우우/Adverb,9,3,6,3.3345930684925414e-05,6.66414909922918e-05,0.6666666666666666
11143,적응하다/Adjective,9,6,3,6.669186136985083e-05,3.33207454961459e-05,0.6666666666666666
11144,희미하다/Adjective,9,3,6,3.3345930684925414e-05,6.66414909922918e-05,0.6666666666666666
11145,숱/Noun,9,3,6,3.3345930684925414e-05,6.66414909922918e-05,0.6666666666666666
11146,보이스/Noun,9,6,3,6.669186136985083e-05,3.33207454961459e-05,0.6666666666666666
11147,표기/Noun,9,3,6,3.3345930684925414e-05,6.66414909922918e-05,0.6666666666666666
11148,배움/Noun,9,6,3,6.669186136985083e-05,3.33207454961459e-05,0.6666666666666666
11149,농/Noun,9,6,3,6.669186136985083e-05,3.33207454961459e-05,0.6666666666666666
11150,전쟁씬/Noun,9,6,3,6.669186136985083e-05,3.33207454961459e-05,0.6666666666666666
11151,유민/Noun,9,6,3,6.669186136985083e-05,3.33207454961459e-05,0.6666666666666666
11152,계층/Noun,9,6,3,6.669186136985083e-05,3.33207454961459e-05,0.6666666666666666
11153,소린/Noun,9,3,6,3.3345930684925414e-05,6.66414909922918e-05,0.6666666666666666
11154,타르/Noun,9,6,3,6.669186136985083e-05,3.33207454961459e-05,0.6666666666666666
11155,거가/Noun,9,6,3,6.669186136985083e-05,3.33207454961459e-05,0.6666666666666666
11156,?;/Punctuation,9,3,6,3.3345930684925414e-05,6.66414909922918e-05,0.6666666666666666
11157,비키다/Verb,9,3,6,3.3345930684925414e-05,6.66414909922918e-05,0.6666666666666666
11158,타격/Noun,9,3,6,3.3345930684925414e-05,6.66414909922918e-05,0.6666666666666666
11159,호크/Noun,9,3,6,3.3345930684925414e-05,6.66414909922918e-05,0.6666666666666666
11160,나문희/Noun,9,3,6,3.3345930684925414e-05,6.66414909922918e-05,0.6666666666666666
11161,쥬드/Noun,9,6,3,6.669186136985083e-05,3.33207454961459e-05,0.6666666666666666
11162,얼빵/Noun,9,3,6,3.3345930684925414e-05,6.66414909922918e-05,0.6666666666666666
11163,핀란드/Noun,9,6,3,6.669186136985083e-05,3.33207454961459e-05,0.6666666666666666
11164,별명/Noun,9,6,3,6.669186136985083e-05,3.33207454961459e-05,0.6666666666666666
11165,일본침몰/Noun,9,3,6,3.3345930684925414e-05,6.66414909922918e-05,0.6666666666666666
11166,호응/Noun,9,3,6,3.3345930684925414e-05,6.66414909922918e-05,0.6666666666666666
11167,값어치/Noun,9,3,6,3.3345930684925414e-05,6.66414909922918e-05,0.6666666666666666
11168,영화장르/Noun,9,3,6,3.3345930684925414e-05,6.66414909922918e-05,0.6666666666666666
11169,아메리칸파이/Noun,9,6,3,6.669186136985083e-05,3.33207454961459e-05,0.6666666666666666
11170,조우/Noun,9,6,3,6.669186136985083e-05,3.33207454961459e-05,0.6666666666666666
11171,거만하다/Adjective,9,3,6,3.3345930684925414e-05,6.66414909922918e-05,0.6666666666666666
11172,영화포스터/Noun,9,3,6,3.3345930684925414e-05,6.66414909922918e-05,0.6666666666666666
11173,진짜사나이/Noun,9,3,6,3.3345930684925414e-05,6.66414909922918e-05,0.6666666666666666
11174,전미선/Noun,9,6,3,6.669186136985083e-05,3.33207454961459e-05,0.6666666666666666
11175,이기우/Noun,9,6,3,6.669186136985083e-05,3.33207454961459e-05,0.6666666666666666
11176,일체/Noun,9,6,3,6.669186136985083e-05,3.33207454961459e-05,0.6666666666666666
11177,흠집/Noun,9,3,6,3.3345930684925414e-05,6.66414909922918e-05,0.6666666666666666
11178,수영장/Noun,9,3,6,3.3345930684925414e-05,6.66414909922918e-05,0.6666666666666666
11179,스노우/Noun,9,3,6,3.3345930684925414e-05,6.66414909922918e-05,0.6666666666666666
11180,>_/Punctuation,9,6,3,6.669186136985083e-05,3.33207454961459e-05,0.6666666666666666
11181,미저리/Noun,9,3,6,3.3345930684925414e-05,6.66414909922918e-05,0.6666666666666666
11182,이태리/Noun,9,6,3,6.669186136985083e-05,3.33207454961459e-05,0.6666666666666666
11183,얼핏/Noun,9,6,3,6.669186136985083e-05,3.33207454961459e-05,0.6666666666666666
11184,몽땅/Noun,9,6,3,6.669186136985083e-05,3.33207454961459e-05,0.6666666666666666
11185,글렌/Noun,9,6,3,6.669186136985083e-05,3.33207454961459e-05,0.6666666666666666
11186,봉만대/Noun,9,3,6,3.3345930684925414e-05,6.66414909922918e-05,0.6666666666666666
11187,실사영화/Noun,9,6,3,6.669186136985083e-05,3.33207454961459e-05,0.6666666666666666
11188,전기톱/Noun,9,3,6,3.3345930684925414e-05,6.66414909922918e-05,0.6666666666666666
11189,뻣/Noun,9,6,3,6.669186136985083e-05,3.33207454961459e-05,0.6666666666666666
11190,생사/Noun,9,6,3,6.669186136985083e-05,3.33207454961459e-05,0.6666666666666666
11191,오예/Noun,9,6,3,6.669186136985083e-05,3.33207454961459e-05,0.6666666666666666
11192,영채/Noun,9,3,6,3.3345930684925414e-05,6.66414909922918e-05,0.6666666666666666
11193,꼴통/Noun,9,3,6,3.3345930684925414e-05,6.66414909922918e-05,0.6666666666666666
11194,Oh/Alpha,9,3,6,3.3345930684925414e-05,6.66414909922918e-05,0.6666666666666666
11195,조선인/Noun,9,3,6,3.3345930684925414e-05,6.66414909922918e-05,0.6666666666666666
11196,이애/Noun,9,6,3,6.669186136985083e-05,3.33207454961459e-05,0.6666666666666666
11197,홍수현/Noun,9,3,6,3.3345930684925414e-05,6.66414909922918e-05,0.6666666666666666
11198,악덕/Noun,9,6,3,6.669186136985083e-05,3.33207454961459e-05,0.6666666666666666
11199,홍수/Noun,9,6,3,6.669186136985083e-05,3.33207454961459e-05,0.6666666666666666
11200,루미/Noun,9,6,3,6.669186136985083e-05,3.33207454961459e-05,0.6666666666666666
11201,동전/Noun,9,6,3,6.669186136985083e-05,3.33207454961459e-05,0.6666666666666666
11202,그램/Noun,9,6,3,6.669186136985083e-05,3.33207454961459e-05,0.6666666666666666
11203,by/Alpha,9,6,3,6.669186136985083e-05,3.33207454961459e-05,0.6666666666666666
11204,펑크/Noun,9,6,3,6.669186136985083e-05,3.33207454961459e-05,0.6666666666666666
11205,극명하다/Adjective,9,3,6,3.3345930684925414e-05,6.66414909922918e-05,0.6666666666666666
11206,쏠때/Noun,9,3,6,3.3345930684925414e-05,6.66414909922918e-05,0.6666666666666666
11207,하인/Noun,9,3,6,3.3345930684925414e-05,6.66414909922918e-05,0.6666666666666666
11208,내다보다/Verb,9,6,3,6.669186136985083e-05,3.33207454961459e-05,0.6666666666666666
11209,보정/Noun,9,3,6,3.3345930684925414e-05,6.66414909922918e-05,0.6666666666666666
11210,알아내다/Verb,9,3,6,3.3345930684925414e-05,6.66414909922918e-05,0.6666666666666666
11211,왕건/Noun,9,3,6,3.3345930684925414e-05,6.66414909922918e-05,0.6666666666666666
11212,더록/Noun,9,3,6,3.3345930684925414e-05,6.66414909922918e-05,0.6666666666666666
11213,턴/Noun,9,6,3,6.669186136985083e-05,3.33207454961459e-05,0.6666666666666666
11214,장모님/Noun,9,6,3,6.669186136985083e-05,3.33207454961459e-05,0.6666666666666666
11215,성추행/Noun,9,3,6,3.3345930684925414e-05,6.66414909922918e-05,0.6666666666666666
11216,십계/Noun,9,6,3,6.669186136985083e-05,3.33207454961459e-05,0.6666666666666666
11217,''/Punctuation,9,3,6,3.3345930684925414e-05,6.66414909922918e-05,0.6666666666666666
11218,요하/Noun,9,3,6,3.3345930684925414e-05,6.66414909922918e-05,0.6666666666666666
11219,콜린스/Noun,9,3,6,3.3345930684925414e-05,6.66414909922918e-05,0.6666666666666666
11220,솟구치다/Verb,9,3,6,3.3345930684925414e-05,6.66414909922918e-05,0.6666666666666666
11221,병기/Noun,9,6,3,6.669186136985083e-05,3.33207454961459e-05,0.6666666666666666
11222,ㅂㄷㅂㄷ/KoreanParticle,9,3,6,3.3345930684925414e-05,6.66414909922918e-05,0.6666666666666666
11223,패러다임/Noun,9,6,3,6.669186136985083e-05,3.33207454961459e-05,0.6666666666666666
11224,들먹이다/Verb,9,3,6,3.3345930684925414e-05,6.66414909922918e-05,0.6666666666666666
11225,과시/Noun,9,3,6,3.3345930684925414e-05,6.66414909922918e-05,0.6666666666666666
11226,금고/Noun,9,6,3,6.669186136985083e-05,3.33207454961459e-05,0.6666666666666666
11227,꼴랑/Adverb,9,3,6,3.3345930684925414e-05,6.66414909922918e-05,0.6666666666666666
11228,여중생/Noun,9,3,6,3.3345930684925414e-05,6.66414909922918e-05,0.6666666666666666
11229,9월/Number,9,3,6,3.3345930684925414e-05,6.66414909922918e-05,0.6666666666666666
11230,태권/Noun,9,3,6,3.3345930684925414e-05,6.66414909922918e-05,0.6666666666666666
11231,휘날리다/Verb,9,3,6,3.3345930684925414e-05,6.66414909922918e-05,0.6666666666666666
11232,맥아더/Noun,9,3,6,3.3345930684925414e-05,6.66414909922918e-05,0.6666666666666666
11233,확보/Noun,9,3,6,3.3345930684925414e-05,6.66414909922918e-05,0.6666666666666666
11234,스킨/Noun,9,3,6,3.3345930684925414e-05,6.66414909922918e-05,0.6666666666666666
11235,날뻔/Noun,9,6,3,6.669186136985083e-05,3.33207454961459e-05,0.6666666666666666
11236,스파르타쿠스/Noun,9,3,6,3.3345930684925414e-05,6.66414909922918e-05,0.6666666666666666
11237,보디가드/Noun,9,3,6,3.3345930684925414e-05,6.66414909922918e-05,0.6666666666666666
11238,가누다/Verb,9,3,6,3.3345930684925414e-05,6.66414909922918e-05,0.6666666666666666
11239,에까지/Josa,9,6,3,6.669186136985083e-05,3.33207454961459e-05,0.6666666666666666
11240,이마/Noun,9,3,6,3.3345930684925414e-05,6.66414909922918e-05,0.6666666666666666
11241,내전/Noun,9,6,3,6.669186136985083e-05,3.33207454961459e-05,0.6666666666666666
11242,물르다/Verb,9,3,6,3.3345930684925414e-05,6.66414909922918e-05,0.6666666666666666
11243,32년/Number,9,6,3,6.669186136985083e-05,3.33207454961459e-05,0.6666666666666666
11244,임은경/Noun,9,3,6,3.3345930684925414e-05,6.66414909922918e-05,0.6666666666666666
11245,난쟁이/Noun,9,3,6,3.3345930684925414e-05,6.66414909922918e-05,0.6666666666666666
11246,밀도/Noun,9,3,6,3.3345930684925414e-05,6.66414909922918e-05,0.6666666666666666
11247,임순례/Noun,9,3,6,3.3345930684925414e-05,6.66414909922918e-05,0.6666666666666666
11248,마네킹/Noun,9,3,6,3.3345930684925414e-05,6.66414909922918e-05,0.6666666666666666
11249,좀처럼/Noun,9,3,6,3.3345930684925414e-05,6.66414909922918e-05,0.6666666666666666
11250,허지웅/Noun,9,3,6,3.3345930684925414e-05,6.66414909922918e-05,0.6666666666666666
11251,마스/Noun,9,6,3,6.669186136985083e-05,3.33207454961459e-05,0.6666666666666666
11252,쩌는데/Noun,9,3,6,3.3345930684925414e-05,6.66414909922918e-05,0.6666666666666666
11253,슬쩍/Adverb,9,3,6,3.3345930684925414e-05,6.66414909922918e-05,0.6666666666666666
11254,선비/Noun,9,3,6,3.3345930684925414e-05,6.66414909922918e-05,0.6666666666666666
11255,굽다/Verb,9,3,6,3.3345930684925414e-05,6.66414909922918e-05,0.6666666666666666
11256,음란/Noun,9,3,6,3.3345930684925414e-05,6.66414909922918e-05,0.6666666666666666
11257,뷰/Noun,9,6,3,6.669186136985083e-05,3.33207454961459e-05,0.6666666666666666
11258,산부인과/Noun,9,3,6,3.3345930684925414e-05,6.66414909922918e-05,0.6666666666666666
11259,Tv/Alpha,9,6,3,6.669186136985083e-05,3.33207454961459e-05,0.6666666666666666
11260,침공/Noun,9,3,6,3.3345930684925414e-05,6.66414909922918e-05,0.6666666666666666
11261,쿠키/Noun,9,3,6,3.3345930684925414e-05,6.66414909922918e-05,0.6666666666666666
11262,로드리게스/Noun,9,6,3,6.669186136985083e-05,3.33207454961459e-05,0.6666666666666666
11263,후리다/Verb,9,3,6,3.3345930684925414e-05,6.66414909922918e-05,0.6666666666666666
11264,성범죄자/Noun,9,3,6,3.3345930684925414e-05,6.66414909922918e-05,0.6666666666666666
11265,인재/Noun,9,6,3,6.669186136985083e-05,3.33207454961459e-05,0.6666666666666666
11266,쏟아내다/Verb,9,6,3,6.669186136985083e-05,3.33207454961459e-05,0.6666666666666666
11267,범람/Noun,9,3,6,3.3345930684925414e-05,6.66414909922918e-05,0.6666666666666666
11268,프랑/Noun,9,6,3,6.669186136985083e-05,3.33207454961459e-05,0.6666666666666666
11269,칭송/Noun,9,3,6,3.3345930684925414e-05,6.66414909922918e-05,0.6666666666666666
11270,2.5/Number,9,3,6,3.3345930684925414e-05,6.66414909922918e-05,0.6666666666666666
11271,에이스/Noun,9,6,3,6.669186136985083e-05,3.33207454961459e-05,0.6666666666666666
11272,루피/Noun,9,3,6,3.3345930684925414e-05,6.66414909922918e-05,0.6666666666666666
11273,대런/Noun,9,6,3,6.669186136985083e-05,3.33207454961459e-05,0.6666666666666666
11274,~~~~~~~~~/Punctuation,9,3,6,3.3345930684925414e-05,6.66414909922918e-05,0.6666666666666666
11275,케네디/Noun,9,6,3,6.669186136985083e-05,3.33207454961459e-05,0.6666666666666666
11276,잡음/Noun,9,3,6,3.3345930684925414e-05,6.66414909922918e-05,0.6666666666666666
11277,리키/Noun,9,6,3,6.669186136985083e-05,3.33207454961459e-05,0.6666666666666666
11278,나물/Noun,9,3,6,3.3345930684925414e-05,6.66414909922918e-05,0.6666666666666666
11279,자네/Noun,9,3,6,3.3345930684925414e-05,6.66414909922918e-05,0.6666666666666666
11280,팽이/Noun,9,3,6,3.3345930684925414e-05,6.66414909922918e-05,0.6666666666666666
11281,포레스트/Noun,9,6,3,6.669186136985083e-05,3.33207454961459e-05,0.6666666666666666
11282,티모시/Noun,9,6,3,6.669186136985083e-05,3.33207454961459e-05,0.6666666666666666
11283,부조리하다/Adjective,9,6,3,6.669186136985083e-05,3.33207454961459e-05,0.6666666666666666
11284,놀이터/Noun,9,3,6,3.3345930684925414e-05,6.66414909922918e-05,0.6666666666666666
11285,승호/Noun,9,6,3,6.669186136985083e-05,3.33207454961459e-05,0.6666666666666666
11286,개조/Noun,9,6,3,6.669186136985083e-05,3.33207454961459e-05,0.6666666666666666
11287,건만/Noun,9,3,6,3.3345930684925414e-05,6.66414909922918e-05,0.6666666666666666
11288,주심/Noun,9,6,3,6.669186136985083e-05,3.33207454961459e-05,0.6666666666666666
11289,오스카/Noun,9,6,3,6.669186136985083e-05,3.33207454961459e-05,0.6666666666666666
11290,자기만족/Noun,9,3,6,3.3345930684925414e-05,6.66414909922918e-05,0.6666666666666666
11291,손톱/Noun,9,3,6,3.3345930684925414e-05,6.66414909922918e-05,0.6666666666666666
11292,손바닥/Noun,9,3,6,3.3345930684925414e-05,6.66414909922918e-05,0.6666666666666666
11293,판결/Noun,9,3,6,3.3345930684925414e-05,6.66414909922918e-05,0.6666666666666666
11294,이병훈/Noun,9,4,5,4.446124091323389e-05,5.5534575826909837e-05,0.5555555555555556
11295,구축/Noun,9,5,4,5.557655114154236e-05,4.4427660661527865e-05,0.5555555555555556
11296,응답/Noun,9,5,4,5.557655114154236e-05,4.4427660661527865e-05,0.5555555555555556
11297,선고/Noun,9,5,4,5.557655114154236e-05,4.4427660661527865e-05,0.5555555555555556
11298,보컬/Noun,9,5,4,5.557655114154236e-05,4.4427660661527865e-05,0.5555555555555556
11299,죄수/Noun,9,4,5,4.446124091323389e-05,5.5534575826909837e-05,0.5555555555555556
11300,이분법/Noun,9,5,4,5.557655114154236e-05,4.4427660661527865e-05,0.5555555555555556
11301,거래/Noun,9,5,4,5.557655114154236e-05,4.4427660661527865e-05,0.5555555555555556
11302,애국자/Noun,9,5,4,5.557655114154236e-05,4.4427660661527865e-05,0.5555555555555556
11303,광희/Noun,9,4,5,4.446124091323389e-05,5.5534575826909837e-05,0.5555555555555556
11304,괴리/Noun,9,4,5,4.446124091323389e-05,5.5534575826909837e-05,0.5555555555555556
11305,골목/Noun,9,5,4,5.557655114154236e-05,4.4427660661527865e-05,0.5555555555555556
11306,울트라맨/Noun,9,4,5,4.446124091323389e-05,5.5534575826909837e-05,0.5555555555555556
11307,앵무새/Noun,9,4,5,4.446124091323389e-05,5.5534575826909837e-05,0.5555555555555556
11308,무공/Noun,9,4,5,4.446124091323389e-05,5.5534575826909837e-05,0.5555555555555556
11309,귀족/Noun,9,5,4,5.557655114154236e-05,4.4427660661527865e-05,0.5555555555555556
11310,댁/Noun,9,5,4,5.557655114154236e-05,4.4427660661527865e-05,0.5555555555555556
11311,뛰어들다/Verb,9,4,5,4.446124091323389e-05,5.5534575826909837e-05,0.5555555555555556
11312,둘러보다/Verb,9,5,4,5.557655114154236e-05,4.4427660661527865e-05,0.5555555555555556
11313,솜/Noun,9,5,4,5.557655114154236e-05,4.4427660661527865e-05,0.5555555555555556
11314,회피/Noun,9,4,5,4.446124091323389e-05,5.5534575826909837e-05,0.5555555555555556
11315,---/Punctuation,9,4,5,4.446124091323389e-05,5.5534575826909837e-05,0.5555555555555556
11316,상해/Noun,9,4,5,4.446124091323389e-05,5.5534575826909837e-05,0.5555555555555556
11317,읭/Noun,9,5,4,5.557655114154236e-05,4.4427660661527865e-05,0.5555555555555556
11318,개취/Noun,9,4,5,4.446124091323389e-05,5.5534575826909837e-05,0.5555555555555556
11319,이역/Noun,9,4,5,4.446124091323389e-05,5.5534575826909837e-05,0.5555555555555556
11320,28일/Number,9,4,5,4.446124091323389e-05,5.5534575826909837e-05,0.5555555555555556
11321,Not/Alpha,9,4,5,4.446124091323389e-05,5.5534575826909837e-05,0.5555555555555556
11322,마다/Foreign,9,4,5,4.446124091323389e-05,5.5534575826909837e-05,0.5555555555555556
11323,동방신기/Noun,9,4,5,4.446124091323389e-05,5.5534575826909837e-05,0.5555555555555556
11324,염두/Noun,9,5,4,5.557655114154236e-05,4.4427660661527865e-05,0.5555555555555556
11325,나이트메어/Noun,9,5,4,5.557655114154236e-05,4.4427660661527865e-05,0.5555555555555556
11326,유다/Noun,9,4,5,4.446124091323389e-05,5.5534575826909837e-05,0.5555555555555556
11327,이홍기/Noun,9,5,4,5.557655114154236e-05,4.4427660661527865e-05,0.5555555555555556
11328,일케/Noun,9,5,4,5.557655114154236e-05,4.4427660661527865e-05,0.5555555555555556
11329,크리스탈/Noun,9,5,4,5.557655114154236e-05,4.4427660661527865e-05,0.5555555555555556
11330,김희애/Noun,9,5,4,5.557655114154236e-05,4.4427660661527865e-05,0.5555555555555556
11331,절박/Noun,9,5,4,5.557655114154236e-05,4.4427660661527865e-05,0.5555555555555556
11332,브이/Noun,9,5,4,5.557655114154236e-05,4.4427660661527865e-05,0.5555555555555556
11333,미진/Noun,9,4,5,4.446124091323389e-05,5.5534575826909837e-05,0.5555555555555556
11334,무감각/Noun,9,5,4,5.557655114154236e-05,4.4427660661527865e-05,0.5555555555555556
11335,도망자/Noun,9,4,5,4.446124091323389e-05,5.5534575826909837e-05,0.5555555555555556
11336,답변/Noun,9,4,5,4.446124091323389e-05,5.5534575826909837e-05,0.5555555555555556
11337,보관/Noun,9,5,4,5.557655114154236e-05,4.4427660661527865e-05,0.5555555555555556
11338,것좀/Noun,9,4,5,4.446124091323389e-05,5.5534575826909837e-05,0.5555555555555556
11339,김예림/Noun,9,5,4,5.557655114154236e-05,4.4427660661527865e-05,0.5555555555555556
11340,프랑스인/Noun,9,4,5,4.446124091323389e-05,5.5534575826909837e-05,0.5555555555555556
11341,해양/Noun,9,5,4,5.557655114154236e-05,4.4427660661527865e-05,0.5555555555555556
11342,대접/Noun,9,4,5,4.446124091323389e-05,5.5534575826909837e-05,0.5555555555555556
11343,스펀지/Noun,9,5,4,5.557655114154236e-05,4.4427660661527865e-05,0.5555555555555556
11344,인육/Noun,9,5,4,5.557655114154236e-05,4.4427660661527865e-05,0.5555555555555556
11345,구세주/Noun,9,4,5,4.446124091323389e-05,5.5534575826909837e-05,0.5555555555555556
11346,화합/Noun,9,5,4,5.557655114154236e-05,4.4427660661527865e-05,0.5555555555555556
11347,산책/Noun,9,5,4,5.557655114154236e-05,4.4427660661527865e-05,0.5555555555555556
11348,시집/Noun,9,5,4,5.557655114154236e-05,4.4427660661527865e-05,0.5555555555555556
11349,푸른거탑/Noun,9,5,4,5.557655114154236e-05,4.4427660661527865e-05,0.5555555555555556
11350,가라앉다/Verb,9,4,5,4.446124091323389e-05,5.5534575826909837e-05,0.5555555555555556
11351,편임/Noun,9,5,4,5.557655114154236e-05,4.4427660661527865e-05,0.5555555555555556
11352,시구/Noun,9,4,5,4.446124091323389e-05,5.5534575826909837e-05,0.5555555555555556
11353,하등/Noun,9,5,4,5.557655114154236e-05,4.4427660661527865e-05,0.5555555555555556
11354,소리치다/Verb,9,4,5,4.446124091323389e-05,5.5534575826909837e-05,0.5555555555555556
11355,피비/Noun,9,4,5,4.446124091323389e-05,5.5534575826909837e-05,0.5555555555555556
11356,장땡/Noun,9,4,5,4.446124091323389e-05,5.5534575826909837e-05,0.5555555555555556
11357,쫄/Noun,9,5,4,5.557655114154236e-05,4.4427660661527865e-05,0.5555555555555556
11358,서린/Noun,9,4,5,4.446124091323389e-05,5.5534575826909837e-05,0.5555555555555556
11359,셔/Noun,9,4,5,4.446124091323389e-05,5.5534575826909837e-05,0.5555555555555556
11360,톰하디/Noun,9,5,4,5.557655114154236e-05,4.4427660661527865e-05,0.5555555555555556
11361,스트레이트/Noun,9,5,4,5.557655114154236e-05,4.4427660661527865e-05,0.5555555555555556
11362,조폭마누라/Noun,9,4,5,4.446124091323389e-05,5.5534575826909837e-05,0.5555555555555556
11363,지침/Noun,9,5,4,5.557655114154236e-05,4.4427660661527865e-05,0.5555555555555556
11364,오르가즘/Noun,9,4,5,4.446124091323389e-05,5.5534575826909837e-05,0.5555555555555556
11365,가정부/Noun,9,5,4,5.557655114154236e-05,4.4427660661527865e-05,0.5555555555555556
11366,북미/Noun,9,5,4,5.557655114154236e-05,4.4427660661527865e-05,0.5555555555555556
11367,포도/Noun,9,5,4,5.557655114154236e-05,4.4427660661527865e-05,0.5555555555555556
11368,26년/Number,9,4,5,4.446124091323389e-05,5.5534575826909837e-05,0.5555555555555556
11369,어마/Noun,9,4,5,4.446124091323389e-05,5.5534575826909837e-05,0.5555555555555556
11370,god/Alpha,9,4,5,4.446124091323389e-05,5.5534575826909837e-05,0.5555555555555556
11371,번쩍/Noun,9,5,4,5.557655114154236e-05,4.4427660661527865e-05,0.5555555555555556
11372,시종/Noun,9,4,5,4.446124091323389e-05,5.5534575826909837e-05,0.5555555555555556
11373,젠토/Noun,9,4,5,4.446124091323389e-05,5.5534575826909837e-05,0.5555555555555556
11374,부상/Noun,9,4,5,4.446124091323389e-05,5.5534575826909837e-05,0.5555555555555556
11375,더욱이/Noun,9,4,5,4.446124091323389e-05,5.5534575826909837e-05,0.5555555555555556
11376,....(/Punctuation,9,5,4,5.557655114154236e-05,4.4427660661527865e-05,0.5555555555555556
11377,시야/Noun,9,4,5,4.446124091323389e-05,5.5534575826909837e-05,0.5555555555555556
11378,강하/Noun,9,5,4,5.557655114154236e-05,4.4427660661527865e-05,0.5555555555555556
11379,태평양/Noun,9,4,5,4.446124091323389e-05,5.5534575826909837e-05,0.5555555555555556
11380,서지/Noun,9,5,4,5.557655114154236e-05,4.4427660661527865e-05,0.5555555555555556
11381,연희/Noun,9,5,4,5.557655114154236e-05,4.4427660661527865e-05,0.5555555555555556
11382,쾅/Noun,9,4,5,4.446124091323389e-05,5.5534575826909837e-05,0.5555555555555556
11383,셔터/Noun,9,4,5,4.446124091323389e-05,5.5534575826909837e-05,0.5555555555555556
11384,펠트/Noun,9,4,5,4.446124091323389e-05,5.5534575826909837e-05,0.5555555555555556
11385,!!!!!!!!!!!!!!!!!!!/Punctuation,9,5,4,5.557655114154236e-05,4.4427660661527865e-05,0.5555555555555556
11386,표시/Noun,9,4,5,4.446124091323389e-05,5.5534575826909837e-05,0.5555555555555556
11387,원망하다/Adjective,9,4,5,4.446124091323389e-05,5.5534575826909837e-05,0.5555555555555556
11388,블럭/Noun,9,5,4,5.557655114154236e-05,4.4427660661527865e-05,0.5555555555555556
11389,아드레날린/Noun,9,5,4,5.557655114154236e-05,4.4427660661527865e-05,0.5555555555555556
11390,여대생/Noun,9,4,5,4.446124091323389e-05,5.5534575826909837e-05,0.5555555555555556
11391,작곡/Noun,9,5,4,5.557655114154236e-05,4.4427660661527865e-05,0.5555555555555556
11392,특선영화/Noun,9,4,5,4.446124091323389e-05,5.5534575826909837e-05,0.5555555555555556
11393,히로시/Noun,9,4,5,4.446124091323389e-05,5.5534575826909837e-05,0.5555555555555556
11394,덕이/Noun,9,4,5,4.446124091323389e-05,5.5534575826909837e-05,0.5555555555555556
11395,비평가/Noun,9,4,5,4.446124091323389e-05,5.5534575826909837e-05,0.5555555555555556
11396,디센트/Noun,9,4,5,4.446124091323389e-05,5.5534575826909837e-05,0.5555555555555556
11397,도착/Noun,9,5,4,5.557655114154236e-05,4.4427660661527865e-05,0.5555555555555556
11398,여호와/Noun,9,4,5,4.446124091323389e-05,5.5534575826909837e-05,0.5555555555555556
11399,금전/Noun,9,5,4,5.557655114154236e-05,4.4427660661527865e-05,0.5555555555555556
11400,참전/Noun,9,5,4,5.557655114154236e-05,4.4427660661527865e-05,0.5555555555555556
11401,꾸리/Noun,9,5,4,5.557655114154236e-05,4.4427660661527865e-05,0.5555555555555556
11402,로멘/Noun,9,5,4,5.557655114154236e-05,4.4427660661527865e-05,0.5555555555555556
11403,무뇌충/Noun,9,5,4,5.557655114154236e-05,4.4427660661527865e-05,0.5555555555555556
11404,지역감정/Noun,9,5,4,5.557655114154236e-05,4.4427660661527865e-05,0.5555555555555556
11405,전제/Noun,9,4,5,4.446124091323389e-05,5.5534575826909837e-05,0.5555555555555556
11406,나야/Noun,9,4,5,4.446124091323389e-05,5.5534575826909837e-05,0.5555555555555556
11407,장악/Noun,9,5,4,5.557655114154236e-05,4.4427660661527865e-05,0.5555555555555556
11408,도장/Noun,9,5,4,5.557655114154236e-05,4.4427660661527865e-05,0.5555555555555556
11409,익히다/Verb,9,5,4,5.557655114154236e-05,4.4427660661527865e-05,0.5555555555555556
11410,퓨리/Noun,9,4,5,4.446124091323389e-05,5.5534575826909837e-05,0.5555555555555556
11411,구야/Noun,9,4,5,4.446124091323389e-05,5.5534575826909837e-05,0.5555555555555556
11412,난민/Noun,9,5,4,5.557655114154236e-05,4.4427660661527865e-05,0.5555555555555556
11413,버려지다/Verb,9,5,4,5.557655114154236e-05,4.4427660661527865e-05,0.5555555555555556
11414,분통/Noun,9,5,4,5.557655114154236e-05,4.4427660661527865e-05,0.5555555555555556
11415,조종/Noun,9,4,5,4.446124091323389e-05,5.5534575826909837e-05,0.5555555555555556
11416,정기/Noun,9,5,4,5.557655114154236e-05,4.4427660661527865e-05,0.5555555555555556
11417,창피해/Noun,9,4,5,4.446124091323389e-05,5.5534575826909837e-05,0.5555555555555556
11418,공범/Noun,9,4,5,4.446124091323389e-05,5.5534575826909837e-05,0.5555555555555556
11419,목걸이/Noun,9,4,5,4.446124091323389e-05,5.5534575826909837e-05,0.5555555555555556
11420,불호/Noun,9,4,5,4.446124091323389e-05,5.5534575826909837e-05,0.5555555555555556
11421,뒤틀리다/Verb,9,5,4,5.557655114154236e-05,4.4427660661527865e-05,0.5555555555555556
11422,줄줄이/Noun,9,4,5,4.446124091323389e-05,5.5534575826909837e-05,0.5555555555555556
11423,기꺼이/Adverb,9,4,5,4.446124091323389e-05,5.5534575826909837e-05,0.5555555555555556
11424,신청/Noun,9,5,4,5.557655114154236e-05,4.4427660661527865e-05,0.5555555555555556
11425,2000/Number,9,4,5,4.446124091323389e-05,5.5534575826909837e-05,0.5555555555555556
11426,문법/Noun,9,4,5,4.446124091323389e-05,5.5534575826909837e-05,0.5555555555555556
11427,협상/Noun,9,4,5,4.446124091323389e-05,5.5534575826909837e-05,0.5555555555555556
11428,엑기스/Noun,9,5,4,5.557655114154236e-05,4.4427660661527865e-05,0.5555555555555556
11429,이순재/Noun,9,5,4,5.557655114154236e-05,4.4427660661527865e-05,0.5555555555555556
11430,상가/Noun,9,4,5,4.446124091323389e-05,5.5534575826909837e-05,0.5555555555555556
11431,고풍/Noun,9,4,5,4.446124091323389e-05,5.5534575826909837e-05,0.5555555555555556
11432,에필로그/Noun,9,4,5,4.446124091323389e-05,5.5534575826909837e-05,0.5555555555555556
11433,자게/Noun,9,4,5,4.446124091323389e-05,5.5534575826909837e-05,0.5555555555555556
11434,이라크/Noun,9,4,5,4.446124091323389e-05,5.5534575826909837e-05,0.5555555555555556
11435,미적/Noun,9,5,4,5.557655114154236e-05,4.4427660661527865e-05,0.5555555555555556
11436,회개/Noun,9,4,5,4.446124091323389e-05,5.5534575826909837e-05,0.5555555555555556
11437,팜므파탈/Noun,9,4,5,4.446124091323389e-05,5.5534575826909837e-05,0.5555555555555556
11438,가닥/Noun,9,4,5,4.446124091323389e-05,5.5534575826909837e-05,0.5555555555555556
11439,낭자/Noun,9,4,5,4.446124091323389e-05,5.5534575826909837e-05,0.5555555555555556
11440,이장우/Noun,9,4,5,4.446124091323389e-05,5.5534575826909837e-05,0.5555555555555556
11441,줌마/Noun,9,4,5,4.446124091323389e-05,5.5534575826909837e-05,0.5555555555555556
11442,만찬/Noun,9,4,5,4.446124091323389e-05,5.5534575826909837e-05,0.5555555555555556
11443,얍/Noun,9,5,4,5.557655114154236e-05,4.4427660661527865e-05,0.5555555555555556
11444,쪼끔/Noun,9,4,5,4.446124091323389e-05,5.5534575826909837e-05,0.5555555555555556
11445,다라/Noun,9,4,5,4.446124091323389e-05,5.5534575826909837e-05,0.5555555555555556
11446,진흙/Noun,9,5,4,5.557655114154236e-05,4.4427660661527865e-05,0.5555555555555556
11447,이해관계/Noun,9,5,4,5.557655114154236e-05,4.4427660661527865e-05,0.5555555555555556
11448,배우자/Noun,9,5,4,5.557655114154236e-05,4.4427660661527865e-05,0.5555555555555556
11449,준놈/Noun,9,4,5,4.446124091323389e-05,5.5534575826909837e-05,0.5555555555555556
11450,부와/Noun,9,4,5,4.446124091323389e-05,5.5534575826909837e-05,0.5555555555555556
11451,군생활/Noun,9,4,5,4.446124091323389e-05,5.5534575826909837e-05,0.5555555555555556
11452,무림/Noun,9,5,4,5.557655114154236e-05,4.4427660661527865e-05,0.5555555555555556
11453,앙/Exclamation,9,5,4,5.557655114154236e-05,4.4427660661527865e-05,0.5555555555555556
11454,밀양/Noun,9,5,4,5.557655114154236e-05,4.4427660661527865e-05,0.5555555555555556
11455,지급/Noun,9,4,5,4.446124091323389e-05,5.5534575826909837e-05,0.5555555555555556
11456,처단/Noun,9,5,4,5.557655114154236e-05,4.4427660661527865e-05,0.5555555555555556
11457,기둥/Noun,9,4,5,4.446124091323389e-05,5.5534575826909837e-05,0.5555555555555556
11458,열폭/Noun,9,4,5,4.446124091323389e-05,5.5534575826909837e-05,0.5555555555555556
11459,올슨/Noun,9,4,5,4.446124091323389e-05,5.5534575826909837e-05,0.5555555555555556
11460,마샬/Noun,9,5,4,5.557655114154236e-05,4.4427660661527865e-05,0.5555555555555556
11461,그해/Adverb,9,5,4,5.557655114154236e-05,4.4427660661527865e-05,0.5555555555555556
11462,멋쟁이/Noun,9,5,4,5.557655114154236e-05,4.4427660661527865e-05,0.5555555555555556
11463,보심/Noun,9,4,5,4.446124091323389e-05,5.5534575826909837e-05,0.5555555555555556
11464,호퍼/Noun,9,4,5,4.446124091323389e-05,5.5534575826909837e-05,0.5555555555555556
11465,연신/Adverb,9,4,5,4.446124091323389e-05,5.5534575826909837e-05,0.5555555555555556
11466,한국사/Noun,9,5,4,5.557655114154236e-05,4.4427660661527865e-05,0.5555555555555556
11467,정해지다/Verb,9,5,4,5.557655114154236e-05,4.4427660661527865e-05,0.5555555555555556
11468,바랬다/Noun,9,5,4,5.557655114154236e-05,4.4427660661527865e-05,0.5555555555555556
11469,박철민/Noun,9,4,5,4.446124091323389e-05,5.5534575826909837e-05,0.5555555555555556
11470,탈피/Noun,9,4,5,4.446124091323389e-05,5.5534575826909837e-05,0.5555555555555556
11471,전광렬/Noun,9,4,5,4.446124091323389e-05,5.5534575826909837e-05,0.5555555555555556
11472,것은/Noun,9,4,5,4.446124091323389e-05,5.5534575826909837e-05,0.5555555555555556
11473,오현경/Noun,9,5,4,5.557655114154236e-05,4.4427660661527865e-05,0.5555555555555556
11474,베트남전/Noun,9,4,5,4.446124091323389e-05,5.5534575826909837e-05,0.5555555555555556
11475,클로즈/Noun,9,5,4,5.557655114154236e-05,4.4427660661527865e-05,0.5555555555555556
11476,광태/Noun,9,4,5,4.446124091323389e-05,5.5534575826909837e-05,0.5555555555555556
11477,고향이/Noun,9,5,4,5.557655114154236e-05,4.4427660661527865e-05,0.5555555555555556
11478,선의/Noun,9,4,5,4.446124091323389e-05,5.5534575826909837e-05,0.5555555555555556
11479,이영/Noun,9,4,5,4.446124091323389e-05,5.5534575826909837e-05,0.5555555555555556
11480,착취/Noun,9,5,4,5.557655114154236e-05,4.4427660661527865e-05,0.5555555555555556
11481,준애/Noun,9,4,5,4.446124091323389e-05,5.5534575826909837e-05,0.5555555555555556
11482,유유/Noun,9,4,5,4.446124091323389e-05,5.5534575826909837e-05,0.5555555555555556
11483,왜냐면/Noun,9,4,5,4.446124091323389e-05,5.5534575826909837e-05,0.5555555555555556
11484,자각/Noun,9,5,4,5.557655114154236e-05,4.4427660661527865e-05,0.5555555555555556
11485,못내/Noun,9,4,5,4.446124091323389e-05,5.5534575826909837e-05,0.5555555555555556
11486,3월/Number,9,5,4,5.557655114154236e-05,4.4427660661527865e-05,0.5555555555555556
11487,진득/Noun,9,4,5,4.446124091323389e-05,5.5534575826909837e-05,0.5555555555555556
11488,까발리다/Verb,9,4,5,4.446124091323389e-05,5.5534575826909837e-05,0.5555555555555556
11489,끗/Noun,9,4,5,4.446124091323389e-05,5.5534575826909837e-05,0.5555555555555556
11490,첩/Noun,9,4,5,4.446124091323389e-05,5.5534575826909837e-05,0.5555555555555556
11491,듯함/Noun,9,4,5,4.446124091323389e-05,5.5534575826909837e-05,0.5555555555555556
11492,개선/Noun,9,4,5,4.446124091323389e-05,5.5534575826909837e-05,0.5555555555555556
11493,가혹하다/Adjective,9,5,4,5.557655114154236e-05,4.4427660661527865e-05,0.5555555555555556
11494,병장/Noun,9,5,4,5.557655114154236e-05,4.4427660661527865e-05,0.5555555555555556
11495,체리/Noun,9,5,4,5.557655114154236e-05,4.4427660661527865e-05,0.5555555555555556
11496,뛰어가다/Verb,9,4,5,4.446124091323389e-05,5.5534575826909837e-05,0.5555555555555556
11497,충고/Noun,9,4,5,4.446124091323389e-05,5.5534575826909837e-05,0.5555555555555556
11498,버들/Noun,9,5,4,5.557655114154236e-05,4.4427660661527865e-05,0.5555555555555556
11499,었다/Noun,9,4,5,4.446124091323389e-05,5.5534575826909837e-05,0.5555555555555556
11500,불운/Noun,9,5,4,5.557655114154236e-05,4.4427660661527865e-05,0.5555555555555556
11501,영자/Noun,9,4,5,4.446124091323389e-05,5.5534575826909837e-05,0.5555555555555556
11502,빔/Noun,9,5,4,5.557655114154236e-05,4.4427660661527865e-05,0.5555555555555556
11503,댄싱/Noun,9,4,5,4.446124091323389e-05,5.5534575826909837e-05,0.5555555555555556
11504,훨배/Noun,9,4,5,4.446124091323389e-05,5.5534575826909837e-05,0.5555555555555556
11505,헤더/Noun,9,4,5,4.446124091323389e-05,5.5534575826909837e-05,0.5555555555555556
11506,쿠스/Noun,9,5,4,5.557655114154236e-05,4.4427660661527865e-05,0.5555555555555556
11507,용어/Noun,9,4,5,4.446124091323389e-05,5.5534575826909837e-05,0.5555555555555556
11508,트로트/Noun,9,5,4,5.557655114154236e-05,4.4427660661527865e-05,0.5555555555555556
11509,악수/Noun,9,5,4,5.557655114154236e-05,4.4427660661527865e-05,0.5555555555555556
11510,고교/Noun,9,4,5,4.446124091323389e-05,5.5534575826909837e-05,0.5555555555555556
11511,들여다보다/Verb,9,5,4,5.557655114154236e-05,4.4427660661527865e-05,0.5555555555555556
11512,회전/Noun,9,5,4,5.557655114154236e-05,4.4427660661527865e-05,0.5555555555555556
11513,호쾌/Noun,9,5,4,5.557655114154236e-05,4.4427660661527865e-05,0.5555555555555556
11514,그레고리/Noun,8,8,0,8.892248182646778e-05,0.0,1.0
11515,기광/Noun,8,8,0,8.892248182646778e-05,0.0,1.0
11516,이기광/Noun,8,8,0,8.892248182646778e-05,0.0,1.0
11517,슬펏다/Noun,8,8,0,8.892248182646778e-05,0.0,1.0
11518,사드/Noun,8,8,0,8.892248182646778e-05,0.0,1.0
11519,박정민/Noun,8,8,0,8.892248182646778e-05,0.0,1.0
11520,자뻑/Noun,8,0,8,0.0,8.885532132305573e-05,1.0
11521,UCC/Alpha,8,0,8,0.0,8.885532132305573e-05,1.0
11522,두근/Adverb,8,8,0,8.892248182646778e-05,0.0,1.0
11523,페티쉬/Noun,8,0,8,0.0,8.885532132305573e-05,1.0
11524,19년/Number,8,8,0,8.892248182646778e-05,0.0,1.0
11525,야설/Noun,8,0,8,0.0,8.885532132305573e-05,1.0
11526,제임스딘/Noun,8,8,0,8.892248182646778e-05,0.0,1.0
11527,동조/Noun,8,0,8,0.0,8.885532132305573e-05,1.0
11528,아델/Noun,8,8,0,8.892248182646778e-05,0.0,1.0
11529,카메라맨/Noun,8,0,8,0.0,8.885532132305573e-05,1.0
11530,임밸류/Noun,8,0,8,0.0,8.885532132305573e-05,1.0
11531,흐접/Noun,8,0,8,0.0,8.885532132305573e-05,1.0
11532,하반기/Noun,8,8,0,8.892248182646778e-05,0.0,1.0
11533,전효성/Noun,8,0,8,0.0,8.885532132305573e-05,1.0
11534,땡큐/Noun,8,8,0,8.892248182646778e-05,0.0,1.0
11535,넘김/Noun,8,0,8,0.0,8.885532132305573e-05,1.0
11536,성괴/Noun,8,0,8,0.0,8.885532132305573e-05,1.0
11537,지불/Noun,8,0,8,0.0,8.885532132305573e-05,1.0
11538,도마/Noun,8,0,8,0.0,8.885532132305573e-05,1.0
11539,에보니/Noun,8,8,0,8.892248182646778e-05,0.0,1.0
11540,계집/Noun,8,0,8,0.0,8.885532132305573e-05,1.0
11541,십여/Modifier,8,8,0,8.892248182646778e-05,0.0,1.0
11542,쓰라리다/Adjective,8,8,0,8.892248182646778e-05,0.0,1.0
11543,Mbc/Alpha,8,0,8,0.0,8.885532132305573e-05,1.0
11544,레빗/Noun,8,8,0,8.892248182646778e-05,0.0,1.0
11545,박용하/Noun,8,8,0,8.892248182646778e-05,0.0,1.0
11546,게뭐임/Noun,8,0,8,0.0,8.885532132305573e-05,1.0
11547,개극혐/Noun,8,0,8,0.0,8.885532132305573e-05,1.0
11548,냉무/Noun,8,0,8,0.0,8.885532132305573e-05,1.0
11549,샤룩/Noun,8,8,0,8.892248182646778e-05,0.0,1.0
11550,빠들/Noun,8,0,8,0.0,8.885532132305573e-05,1.0
11551,배설/Noun,8,0,8,0.0,8.885532132305573e-05,1.0
11552,토크쇼/Noun,8,0,8,0.0,8.885532132305573e-05,1.0
11553,할머님/Noun,8,8,0,8.892248182646778e-05,0.0,1.0
11554,월광보합/Noun,8,8,0,8.892248182646778e-05,0.0,1.0
11555,치사하다/Adjective,8,0,8,0.0,8.885532132305573e-05,1.0
11556,꾸르잼/Noun,8,8,0,8.892248182646778e-05,0.0,1.0
11557,부라/Noun,8,0,8,0.0,8.885532132305573e-05,1.0
11558,균신/Noun,8,8,0,8.892248182646778e-05,0.0,1.0
11559,GG/Alpha,8,0,8,0.0,8.885532132305573e-05,1.0
11560,머꼬/Noun,8,0,8,0.0,8.885532132305573e-05,1.0
11561,맥아담스/Noun,8,8,0,8.892248182646778e-05,0.0,1.0
11562,박재범/Noun,8,0,8,0.0,8.885532132305573e-05,1.0
11563,속옷/Noun,8,0,8,0.0,8.885532132305573e-05,1.0
11564,칼질/Noun,8,0,8,0.0,8.885532132305573e-05,1.0
11565,희롱/Noun,8,0,8,0.0,8.885532132305573e-05,1.0
11566,멋진날/Noun,8,8,0,8.892248182646778e-05,0.0,1.0
11567,사인/Noun,8,0,8,0.0,8.885532132305573e-05,1.0
11568,심쿵/Noun,8,8,0,8.892248182646778e-05,0.0,1.0
11569,유년기/Noun,8,8,0,8.892248182646778e-05,0.0,1.0
11570,번봄/Noun,8,8,0,8.892248182646778e-05,0.0,1.0
11571,잡아내다/Verb,8,8,0,8.892248182646778e-05,0.0,1.0
11572,박차다/Verb,8,0,8,0.0,8.885532132305573e-05,1.0
11573,강성재/Noun,8,0,8,0.0,8.885532132305573e-05,1.0
11574,손수건/Noun,8,8,0,8.892248182646778e-05,0.0,1.0
11575,은커녕/Josa,8,0,8,0.0,8.885532132305573e-05,1.0
11576,조마조마하다/Adjective,8,8,0,8.892248182646778e-05,0.0,1.0
11577,똘/Noun,8,0,8,0.0,8.885532132305573e-05,1.0
11578,환하다/Adjective,8,8,0,8.892248182646778e-05,0.0,1.0
11579,웩/Noun,8,0,8,0.0,8.885532132305573e-05,1.0
11580,오그리다/Verb,8,0,8,0.0,8.885532132305573e-05,1.0
11581,난데없다/Adjective,8,0,8,0.0,8.885532132305573e-05,1.0
11582,씨엔블루/Noun,8,8,0,8.892248182646778e-05,0.0,1.0
11583,종특/Noun,8,0,8,0.0,8.885532132305573e-05,1.0
11584,정소동/Noun,8,0,8,0.0,8.885532132305573e-05,1.0
11585,끙/Adverb,8,0,8,0.0,8.885532132305573e-05,1.0
11586,한여운/Noun,8,8,0,8.892248182646778e-05,0.0,1.0
11587,518/Number,8,0,8,0.0,8.885532132305573e-05,1.0
11588,로키/Noun,8,8,0,8.892248182646778e-05,0.0,1.0
11589,One/Alpha,8,8,0,8.892248182646778e-05,0.0,1.0
11590,방콕/Noun,8,0,8,0.0,8.885532132305573e-05,1.0
11591,느릿하다/Adjective,8,0,8,0.0,8.885532132305573e-05,1.0
11592,무미/Noun,8,0,8,0.0,8.885532132305573e-05,1.0
11593,thumbs/Alpha,8,8,0,8.892248182646778e-05,0.0,1.0
11594,청승/Noun,8,0,8,0.0,8.885532132305573e-05,1.0
11595,일자리/Noun,8,1,7,1.1115310228308472e-05,7.774840615767377e-05,0.875
11596,벼/Noun,8,1,7,1.1115310228308472e-05,7.774840615767377e-05,0.875
11597,염치/Noun,8,1,7,1.1115310228308472e-05,7.774840615767377e-05,0.875
11598,6월/Number,8,7,1,7.78071715981593e-05,1.1106915165381966e-05,0.875
11599,wow/Alpha,8,7,1,7.78071715981593e-05,1.1106915165381966e-05,0.875
11600,병풍/Noun,8,1,7,1.1115310228308472e-05,7.774840615767377e-05,0.875
11601,꿰뚫다/Verb,8,7,1,7.78071715981593e-05,1.1106915165381966e-05,0.875
11602,안전하다/Adjective,8,7,1,7.78071715981593e-05,1.1106915165381966e-05,0.875
11603,펙/Noun,8,7,1,7.78071715981593e-05,1.1106915165381966e-05,0.875
11604,니키/Noun,8,7,1,7.78071715981593e-05,1.1106915165381966e-05,0.875
11605,트랙/Noun,8,7,1,7.78071715981593e-05,1.1106915165381966e-05,0.875
11606,김흥수/Noun,8,1,7,1.1115310228308472e-05,7.774840615767377e-05,0.875
11607,타임캡슐/Noun,8,1,7,1.1115310228308472e-05,7.774840615767377e-05,0.875
11608,!!(/Punctuation,8,7,1,7.78071715981593e-05,1.1106915165381966e-05,0.875
11609,무협지/Noun,8,1,7,1.1115310228308472e-05,7.774840615767377e-05,0.875
11610,기상/Noun,8,7,1,7.78071715981593e-05,1.1106915165381966e-05,0.875
11611,드리프트/Noun,8,1,7,1.1115310228308472e-05,7.774840615767377e-05,0.875
11612,로맨스코미디/Noun,8,7,1,7.78071715981593e-05,1.1106915165381966e-05,0.875
11613,ps/Alpha,8,7,1,7.78071715981593e-05,1.1106915165381966e-05,0.875
11614,1992년/Number,8,7,1,7.78071715981593e-05,1.1106915165381966e-05,0.875
11615,찮아다/Verb,8,7,1,7.78071715981593e-05,1.1106915165381966e-05,0.875
11616,까운/Noun,8,1,7,1.1115310228308472e-05,7.774840615767377e-05,0.875
11617,어쩌란/Noun,8,1,7,1.1115310228308472e-05,7.774840615767377e-05,0.875
11618,난동/Noun,8,1,7,1.1115310228308472e-05,7.774840615767377e-05,0.875
11619,스피디/Noun,8,7,1,7.78071715981593e-05,1.1106915165381966e-05,0.875
11620,사이다/Noun,8,7,1,7.78071715981593e-05,1.1106915165381966e-05,0.875
11621,국비/Noun,8,1,7,1.1115310228308472e-05,7.774840615767377e-05,0.875
11622,마일/Noun,8,7,1,7.78071715981593e-05,1.1106915165381966e-05,0.875
11623,오른쪽/Noun,8,1,7,1.1115310228308472e-05,7.774840615767377e-05,0.875
11624,근접하다/Adjective,8,7,1,7.78071715981593e-05,1.1106915165381966e-05,0.875
11625,스타킹/Noun,8,1,7,1.1115310228308472e-05,7.774840615767377e-05,0.875
11626,정도전/Noun,8,7,1,7.78071715981593e-05,1.1106915165381966e-05,0.875
11627,ㅍ/KoreanParticle,8,7,1,7.78071715981593e-05,1.1106915165381966e-05,0.875
11628,변종/Noun,8,1,7,1.1115310228308472e-05,7.774840615767377e-05,0.875
11629,시너지/Noun,8,7,1,7.78071715981593e-05,1.1106915165381966e-05,0.875
11630,맥시/Noun,8,7,1,7.78071715981593e-05,1.1106915165381966e-05,0.875
11631,짱꼴라/Noun,8,1,7,1.1115310228308472e-05,7.774840615767377e-05,0.875
11632,-_-../Punctuation,8,1,7,1.1115310228308472e-05,7.774840615767377e-05,0.875
11633,술해/Noun,8,1,7,1.1115310228308472e-05,7.774840615767377e-05,0.875
11634,코인/Noun,8,1,7,1.1115310228308472e-05,7.774840615767377e-05,0.875
11635,허풍/Noun,8,1,7,1.1115310228308472e-05,7.774840615767377e-05,0.875
11636,게말/Noun,8,1,7,1.1115310228308472e-05,7.774840615767377e-05,0.875
11637,shit/Alpha,8,1,7,1.1115310228308472e-05,7.774840615767377e-05,0.875
11638,오디오/Noun,8,1,7,1.1115310228308472e-05,7.774840615767377e-05,0.875
11639,퉁퉁/Noun,8,7,1,7.78071715981593e-05,1.1106915165381966e-05,0.875
11640,효도/Noun,8,7,1,7.78071715981593e-05,1.1106915165381966e-05,0.875
11641,예비군/Noun,8,1,7,1.1115310228308472e-05,7.774840615767377e-05,0.875
11642,티아/Noun,8,7,1,7.78071715981593e-05,1.1106915165381966e-05,0.875
11643,처자/Noun,8,1,7,1.1115310228308472e-05,7.774840615767377e-05,0.875
11644,~!!!!!/Punctuation,8,7,1,7.78071715981593e-05,1.1106915165381966e-05,0.875
11645,우뢰/Noun,8,1,7,1.1115310228308472e-05,7.774840615767377e-05,0.875
11646,빤스/Noun,8,1,7,1.1115310228308472e-05,7.774840615767377e-05,0.875
11647,숭숭/Noun,8,1,7,1.1115310228308472e-05,7.774840615767377e-05,0.875
11648,런스/Noun,8,1,7,1.1115310228308472e-05,7.774840615767377e-05,0.875
11649,콕/Noun,8,7,1,7.78071715981593e-05,1.1106915165381966e-05,0.875
11650,부자연/Noun,8,1,7,1.1115310228308472e-05,7.774840615767377e-05,0.875
11651,풍요/Noun,8,7,1,7.78071715981593e-05,1.1106915165381966e-05,0.875
11652,추리소설/Noun,8,7,1,7.78071715981593e-05,1.1106915165381966e-05,0.875
11653,유딩/Noun,8,1,7,1.1115310228308472e-05,7.774840615767377e-05,0.875
11654,盧/Foreign,8,1,7,1.1115310228308472e-05,7.774840615767377e-05,0.875
11655,뜬구름/Noun,8,1,7,1.1115310228308472e-05,7.774840615767377e-05,0.875
11656,후짐/Noun,8,1,7,1.1115310228308472e-05,7.774840615767377e-05,0.875
11657,개이득/Noun,8,1,7,1.1115310228308472e-05,7.774840615767377e-05,0.875
11658,쫄딱/Noun,8,1,7,1.1115310228308472e-05,7.774840615767377e-05,0.875
11659,프랑켄슈타인/Noun,8,7,1,7.78071715981593e-05,1.1106915165381966e-05,0.875
11660,수법/Noun,8,1,7,1.1115310228308472e-05,7.774840615767377e-05,0.875
11661,혼혈/Noun,8,1,7,1.1115310228308472e-05,7.774840615767377e-05,0.875
11662,화요일/Noun,8,7,1,7.78071715981593e-05,1.1106915165381966e-05,0.875
11663,35분/Number,8,1,7,1.1115310228308472e-05,7.774840615767377e-05,0.875
11664,나이스/Noun,8,7,1,7.78071715981593e-05,1.1106915165381966e-05,0.875
11665,로필/Noun,8,7,1,7.78071715981593e-05,1.1106915165381966e-05,0.875
11666,천둥/Noun,8,7,1,7.78071715981593e-05,1.1106915165381966e-05,0.875
11667,품질/Noun,8,1,7,1.1115310228308472e-05,7.774840615767377e-05,0.875
11668,젓/Noun,8,1,7,1.1115310228308472e-05,7.774840615767377e-05,0.875
11669,야자/Noun,8,7,1,7.78071715981593e-05,1.1106915165381966e-05,0.875
11670,이신가/Josa,8,1,7,1.1115310228308472e-05,7.774840615767377e-05,0.875
11671,홍수아/Noun,8,1,7,1.1115310228308472e-05,7.774840615767377e-05,0.875
11672,사명/Noun,8,7,1,7.78071715981593e-05,1.1106915165381966e-05,0.875
11673,몰상식하다/Adjective,8,1,7,1.1115310228308472e-05,7.774840615767377e-05,0.875
11674,슈마허/Noun,8,1,7,1.1115310228308472e-05,7.774840615767377e-05,0.875
11675,찬물/Noun,8,1,7,1.1115310228308472e-05,7.774840615767377e-05,0.875
11676,자초/Noun,8,1,7,1.1115310228308472e-05,7.774840615767377e-05,0.875
11677,스트리트/Noun,8,1,7,1.1115310228308472e-05,7.774840615767377e-05,0.875
11678,휘성/Noun,8,7,1,7.78071715981593e-05,1.1106915165381966e-05,0.875
11679,놓이다/Verb,8,7,1,7.78071715981593e-05,1.1106915165381966e-05,0.875
11680,beautiful/Alpha,8,7,1,7.78071715981593e-05,1.1106915165381966e-05,0.875
11681,숙연/Noun,8,7,1,7.78071715981593e-05,1.1106915165381966e-05,0.875
11682,쌩뚱/Noun,8,1,7,1.1115310228308472e-05,7.774840615767377e-05,0.875
11683,해몽/Noun,8,1,7,1.1115310228308472e-05,7.774840615767377e-05,0.875
11684,개비/Noun,8,1,7,1.1115310228308472e-05,7.774840615767377e-05,0.875
11685,헌법/Noun,8,7,1,7.78071715981593e-05,1.1106915165381966e-05,0.875
11686,희노애락/Noun,8,7,1,7.78071715981593e-05,1.1106915165381966e-05,0.875
11687,웰케/Noun,8,7,1,7.78071715981593e-05,1.1106915165381966e-05,0.875
11688,가입/Noun,8,7,1,7.78071715981593e-05,1.1106915165381966e-05,0.875
11689,티격태격/Noun,8,7,1,7.78071715981593e-05,1.1106915165381966e-05,0.875
11690,100원/Number,8,1,7,1.1115310228308472e-05,7.774840615767377e-05,0.875
11691,쓰리데이즈/Noun,8,7,1,7.78071715981593e-05,1.1106915165381966e-05,0.875
11692,꼭두각시/Noun,8,1,7,1.1115310228308472e-05,7.774840615767377e-05,0.875
11693,고지식하다/Adjective,8,1,7,1.1115310228308472e-05,7.774840615767377e-05,0.875
11694,포트만/Noun,8,7,1,7.78071715981593e-05,1.1106915165381966e-05,0.875
11695,100억/Number,8,1,7,1.1115310228308472e-05,7.774840615767377e-05,0.875
11696,뭍/Noun,8,7,1,7.78071715981593e-05,1.1106915165381966e-05,0.875
11697,조류/Noun,8,1,7,1.1115310228308472e-05,7.774840615767377e-05,0.875
11698,perfect/Alpha,8,7,1,7.78071715981593e-05,1.1106915165381966e-05,0.875
11699,고용/Noun,8,1,7,1.1115310228308472e-05,7.774840615767377e-05,0.875
11700,1/3/Number,8,1,7,1.1115310228308472e-05,7.774840615767377e-05,0.875
11701,틴토/Noun,8,1,7,1.1115310228308472e-05,7.774840615767377e-05,0.875
11702,거왜/Noun,8,1,7,1.1115310228308472e-05,7.774840615767377e-05,0.875
11703,도식/Noun,8,1,7,1.1115310228308472e-05,7.774840615767377e-05,0.875
11704,슬하/Noun,8,7,1,7.78071715981593e-05,1.1106915165381966e-05,0.875
11705,밀리터리/Noun,8,1,7,1.1115310228308472e-05,7.774840615767377e-05,0.875
11706,우직하다/Adjective,8,7,1,7.78071715981593e-05,1.1106915165381966e-05,0.875
11707,카이지/Noun,8,1,7,1.1115310228308472e-05,7.774840615767377e-05,0.875
11708,만만/Noun,8,1,7,1.1115310228308472e-05,7.774840615767377e-05,0.875
11709,이경실/Noun,8,1,7,1.1115310228308472e-05,7.774840615767377e-05,0.875
11710,이사/Noun,8,1,7,1.1115310228308472e-05,7.774840615767377e-05,0.875
11711,개살구/Noun,8,1,7,1.1115310228308472e-05,7.774840615767377e-05,0.875
11712,가구/Noun,8,7,1,7.78071715981593e-05,1.1106915165381966e-05,0.875
11713,휘파람/Noun,8,7,1,7.78071715981593e-05,1.1106915165381966e-05,0.875
11714,뉘앙스/Noun,8,1,7,1.1115310228308472e-05,7.774840615767377e-05,0.875
11715,푸근하다/Adjective,8,7,1,7.78071715981593e-05,1.1106915165381966e-05,0.875
11716,멱살/Noun,8,1,7,1.1115310228308472e-05,7.774840615767377e-05,0.875
11717,라이언킹/Noun,8,7,1,7.78071715981593e-05,1.1106915165381966e-05,0.875
11718,공급/Noun,8,1,7,1.1115310228308472e-05,7.774840615767377e-05,0.875
11719,김태훈/Noun,8,7,1,7.78071715981593e-05,1.1106915165381966e-05,0.875
11720,유치뽕/Noun,8,1,7,1.1115310228308472e-05,7.774840615767377e-05,0.875
11721,중이병/Noun,8,1,7,1.1115310228308472e-05,7.774840615767377e-05,0.875
11722,똥덩어리/Noun,8,1,7,1.1115310228308472e-05,7.774840615767377e-05,0.875
11723,바론/Noun,8,7,1,7.78071715981593e-05,1.1106915165381966e-05,0.875
11724,초토화/Noun,8,1,7,1.1115310228308472e-05,7.774840615767377e-05,0.875
11725,담론/Noun,8,1,7,1.1115310228308472e-05,7.774840615767377e-05,0.875
11726,천황/Noun,8,1,7,1.1115310228308472e-05,7.774840615767377e-05,0.875
11727,1987년/Number,8,7,1,7.78071715981593e-05,1.1106915165381966e-05,0.875
11728,고마움/Noun,8,7,1,7.78071715981593e-05,1.1106915165381966e-05,0.875
11729,무턱/Noun,8,1,7,1.1115310228308472e-05,7.774840615767377e-05,0.875
11730,완득이/Noun,8,1,7,1.1115310228308472e-05,7.774840615767377e-05,0.875
11731,상수/Noun,8,1,7,1.1115310228308472e-05,7.774840615767377e-05,0.875
11732,라만/Noun,8,1,7,1.1115310228308472e-05,7.774840615767377e-05,0.875
11733,수려/Noun,8,7,1,7.78071715981593e-05,1.1106915165381966e-05,0.875
11734,데넘/Noun,8,7,1,7.78071715981593e-05,1.1106915165381966e-05,0.875
11735,멸종/Noun,8,1,7,1.1115310228308472e-05,7.774840615767377e-05,0.875
11736,하급/Noun,8,1,7,1.1115310228308472e-05,7.774840615767377e-05,0.875
11737,반정부/Noun,8,1,7,1.1115310228308472e-05,7.774840615767377e-05,0.875
11738,슨상님/Noun,8,1,7,1.1115310228308472e-05,7.774840615767377e-05,0.875
11739,굴레/Noun,8,7,1,7.78071715981593e-05,1.1106915165381966e-05,0.875
11740,your/Alpha,8,7,1,7.78071715981593e-05,1.1106915165381966e-05,0.875
11741,부진/Noun,8,1,7,1.1115310228308472e-05,7.774840615767377e-05,0.875
11742,난정/Noun,8,7,1,7.78071715981593e-05,1.1106915165381966e-05,0.875
11743,.-_-/Punctuation,8,1,7,1.1115310228308472e-05,7.774840615767377e-05,0.875
11744,평등하다/Adjective,8,7,1,7.78071715981593e-05,1.1106915165381966e-05,0.875
11745,진짜루/Noun,8,7,1,7.78071715981593e-05,1.1106915165381966e-05,0.875
11746,충동/Noun,8,1,7,1.1115310228308472e-05,7.774840615767377e-05,0.875
11747,베네딕트/Noun,8,7,1,7.78071715981593e-05,1.1106915165381966e-05,0.875
11748,굶다/Verb,8,1,7,1.1115310228308472e-05,7.774840615767377e-05,0.875
11749,고만/Eomi,8,1,7,1.1115310228308472e-05,7.774840615767377e-05,0.875
11750,문답/Noun,8,1,7,1.1115310228308472e-05,7.774840615767377e-05,0.875
11751,마이클잭슨/Noun,8,7,1,7.78071715981593e-05,1.1106915165381966e-05,0.875
11752,일전/Noun,8,7,1,7.78071715981593e-05,1.1106915165381966e-05,0.875
11753,늦/Noun,8,7,1,7.78071715981593e-05,1.1106915165381966e-05,0.875
11754,귀여웡/Noun,8,7,1,7.78071715981593e-05,1.1106915165381966e-05,0.875
11755,경종/Noun,8,7,1,7.78071715981593e-05,1.1106915165381966e-05,0.875
11756,미흡/Noun,8,1,7,1.1115310228308472e-05,7.774840615767377e-05,0.875
11757,등골/Noun,8,7,1,7.78071715981593e-05,1.1106915165381966e-05,0.875
11758,김지호/Noun,8,1,7,1.1115310228308472e-05,7.774840615767377e-05,0.875
11759,식탁/Noun,8,2,6,2.2230620456616944e-05,6.66414909922918e-05,0.75
11760,엎/Noun,8,2,6,2.2230620456616944e-05,6.66414909922918e-05,0.75
11761,바티스타/Noun,8,2,6,2.2230620456616944e-05,6.66414909922918e-05,0.75
11762,성당/Noun,8,6,2,6.669186136985083e-05,2.2213830330763933e-05,0.75
11763,랍/Noun,8,2,6,2.2230620456616944e-05,6.66414909922918e-05,0.75
11764,클라이맥스/Noun,8,2,6,2.2230620456616944e-05,6.66414909922918e-05,0.75
11765,관중/Noun,8,2,6,2.2230620456616944e-05,6.66414909922918e-05,0.75
11766,전우/Noun,8,6,2,6.669186136985083e-05,2.2213830330763933e-05,0.75
11767,퀼/Noun,8,6,2,6.669186136985083e-05,2.2213830330763933e-05,0.75
11768,지훈/Noun,8,2,6,2.2230620456616944e-05,6.66414909922918e-05,0.75
11769,n/Alpha,8,6,2,6.669186136985083e-05,2.2213830330763933e-05,0.75
11770,막론/Noun,8,6,2,6.669186136985083e-05,2.2213830330763933e-05,0.75
11771,어부/Noun,8,2,6,2.2230620456616944e-05,6.66414909922918e-05,0.75
11772,(+/Punctuation,8,2,6,2.2230620456616944e-05,6.66414909922918e-05,0.75
11773,슬램덩크/Noun,8,2,6,2.2230620456616944e-05,6.66414909922918e-05,0.75
11774,태상/Noun,8,2,6,2.2230620456616944e-05,6.66414909922918e-05,0.75
11775,암세포/Noun,8,2,6,2.2230620456616944e-05,6.66414909922918e-05,0.75
11776,해부/Noun,8,2,6,2.2230620456616944e-05,6.66414909922918e-05,0.75
11777,토의/Noun,8,6,2,6.669186136985083e-05,2.2213830330763933e-05,0.75
11778,76년/Number,8,2,6,2.2230620456616944e-05,6.66414909922918e-05,0.75
11779,나들이/Noun,8,6,2,6.669186136985083e-05,2.2213830330763933e-05,0.75
11780,갈아입다/Verb,8,2,6,2.2230620456616944e-05,6.66414909922918e-05,0.75
11781,기복/Noun,8,2,6,2.2230620456616944e-05,6.66414909922918e-05,0.75
11782,오/Exclamation,8,6,2,6.669186136985083e-05,2.2213830330763933e-05,0.75
11783,자지러지다/Verb,8,6,2,6.669186136985083e-05,2.2213830330763933e-05,0.75
11784,연쇄살인범/Noun,8,2,6,2.2230620456616944e-05,6.66414909922918e-05,0.75
11785,아이스크림/Noun,8,6,2,6.669186136985083e-05,2.2213830330763933e-05,0.75
11786,좌우/Noun,8,6,2,6.669186136985083e-05,2.2213830330763933e-05,0.75
11787,개과천선/Noun,8,2,6,2.2230620456616944e-05,6.66414909922918e-05,0.75
11788,토론/Noun,8,6,2,6.669186136985083e-05,2.2213830330763933e-05,0.75
11789,77년/Number,8,6,2,6.669186136985083e-05,2.2213830330763933e-05,0.75
11790,헐겁다/Adjective,8,2,6,2.2230620456616944e-05,6.66414909922918e-05,0.75
11791,미세하다/Adjective,8,6,2,6.669186136985083e-05,2.2213830330763933e-05,0.75
11792,-;;/Punctuation,8,2,6,2.2230620456616944e-05,6.66414909922918e-05,0.75
11793,이어폰/Noun,8,6,2,6.669186136985083e-05,2.2213830330763933e-05,0.75
11794,모험영화/Noun,8,6,2,6.669186136985083e-05,2.2213830330763933e-05,0.75
11795,케스팅/Noun,8,2,6,2.2230620456616944e-05,6.66414909922918e-05,0.75
11796,질서/Noun,8,2,6,2.2230620456616944e-05,6.66414909922918e-05,0.75
11797,차이점/Noun,8,2,6,2.2230620456616944e-05,6.66414909922918e-05,0.75
11798,틸/Noun,8,6,2,6.669186136985083e-05,2.2213830330763933e-05,0.75
11799,장선/Noun,8,6,2,6.669186136985083e-05,2.2213830330763933e-05,0.75
11800,사사키/Noun,8,6,2,6.669186136985083e-05,2.2213830330763933e-05,0.75
11801,체계/Noun,8,6,2,6.669186136985083e-05,2.2213830330763933e-05,0.75
11802,헬로/Noun,8,2,6,2.2230620456616944e-05,6.66414909922918e-05,0.75
11803,강간범/Noun,8,2,6,2.2230620456616944e-05,6.66414909922918e-05,0.75
11804,가장이/Noun,8,6,2,6.669186136985083e-05,2.2213830330763933e-05,0.75
11805,빅토리아/Noun,8,6,2,6.669186136985083e-05,2.2213830330763933e-05,0.75
11806,츤데레/Noun,8,6,2,6.669186136985083e-05,2.2213830330763933e-05,0.75
11807,생가/Noun,8,2,6,2.2230620456616944e-05,6.66414909922918e-05,0.75
11808,무지막지/Noun,8,6,2,6.669186136985083e-05,2.2213830330763933e-05,0.75
11809,머리스타일/Noun,8,2,6,2.2230620456616944e-05,6.66414909922918e-05,0.75
11810,앉히다/Verb,8,2,6,2.2230620456616944e-05,6.66414909922918e-05,0.75
11811,음주/Noun,8,2,6,2.2230620456616944e-05,6.66414909922918e-05,0.75
11812,종결자/Noun,8,6,2,6.669186136985083e-05,2.2213830330763933e-05,0.75
11813,가톨릭/Noun,8,6,2,6.669186136985083e-05,2.2213830330763933e-05,0.75
11814,이영아/Noun,8,2,6,2.2230620456616944e-05,6.66414909922918e-05,0.75
11815,다이빙벨/Noun,8,2,6,2.2230620456616944e-05,6.66414909922918e-05,0.75
11816,면목/Noun,8,6,2,6.669186136985083e-05,2.2213830330763933e-05,0.75
11817,고스트라이더/Noun,8,2,6,2.2230620456616944e-05,6.66414909922918e-05,0.75
11818,구애/Noun,8,6,2,6.669186136985083e-05,2.2213830330763933e-05,0.75
11819,....!!/Punctuation,8,2,6,2.2230620456616944e-05,6.66414909922918e-05,0.75
11820,와이어액션/Noun,8,2,6,2.2230620456616944e-05,6.66414909922918e-05,0.75
11821,화산/Noun,8,6,2,6.669186136985083e-05,2.2213830330763933e-05,0.75
11822,피셔/Noun,8,6,2,6.669186136985083e-05,2.2213830330763933e-05,0.75
11823,콜라보/Noun,8,6,2,6.669186136985083e-05,2.2213830330763933e-05,0.75
11824,미적지근하다/Adjective,8,2,6,2.2230620456616944e-05,6.66414909922918e-05,0.75
11825,기득권/Noun,8,6,2,6.669186136985083e-05,2.2213830330763933e-05,0.75
11826,안전벨트/Noun,8,2,6,2.2230620456616944e-05,6.66414909922918e-05,0.75
11827,한단/Noun,8,2,6,2.2230620456616944e-05,6.66414909922918e-05,0.75
11828,ㄱㅊ/KoreanParticle,8,6,2,6.669186136985083e-05,2.2213830330763933e-05,0.75
11829,~(/Punctuation,8,2,6,2.2230620456616944e-05,6.66414909922918e-05,0.75
11830,타블로/Noun,8,2,6,2.2230620456616944e-05,6.66414909922918e-05,0.75
11831,베이컨/Noun,8,6,2,6.669186136985083e-05,2.2213830330763933e-05,0.75
11832,질병/Noun,8,2,6,2.2230620456616944e-05,6.66414909922918e-05,0.75
11833,만년/Noun,8,6,2,6.669186136985083e-05,2.2213830330763933e-05,0.75
11834,위함/Noun,8,2,6,2.2230620456616944e-05,6.66414909922918e-05,0.75
11835,투사/Noun,8,6,2,6.669186136985083e-05,2.2213830330763933e-05,0.75
11836,파랑/Noun,8,2,6,2.2230620456616944e-05,6.66414909922918e-05,0.75
11837,에덴/Noun,8,6,2,6.669186136985083e-05,2.2213830330763933e-05,0.75
11838,루비반지/Noun,8,2,6,2.2230620456616944e-05,6.66414909922918e-05,0.75
11839,자연재해/Noun,8,6,2,6.669186136985083e-05,2.2213830330763933e-05,0.75
11840,종로/Noun,8,6,2,6.669186136985083e-05,2.2213830330763933e-05,0.75
11841,황신혜/Noun,8,2,6,2.2230620456616944e-05,6.66414909922918e-05,0.75
11842,복판/Noun,8,2,6,2.2230620456616944e-05,6.66414909922918e-05,0.75
11843,것일/Noun,8,2,6,2.2230620456616944e-05,6.66414909922918e-05,0.75
11844,주드/Noun,8,6,2,6.669186136985083e-05,2.2213830330763933e-05,0.75
11845,철도/Noun,8,6,2,6.669186136985083e-05,2.2213830330763933e-05,0.75
11846,잭니콜슨/Noun,8,6,2,6.669186136985083e-05,2.2213830330763933e-05,0.75
11847,반짝반짝/Adverb,8,6,2,6.669186136985083e-05,2.2213830330763933e-05,0.75
11848,한예리/Noun,8,6,2,6.669186136985083e-05,2.2213830330763933e-05,0.75
11849,글씨/Noun,8,2,6,2.2230620456616944e-05,6.66414909922918e-05,0.75
11850,더미/Noun,8,2,6,2.2230620456616944e-05,6.66414909922918e-05,0.75
11851,이상인/Noun,8,6,2,6.669186136985083e-05,2.2213830330763933e-05,0.75
11852,번지/Noun,8,6,2,6.669186136985083e-05,2.2213830330763933e-05,0.75
11853,``/Punctuation,8,6,2,6.669186136985083e-05,2.2213830330763933e-05,0.75
11854,돈버/Noun,8,2,6,2.2230620456616944e-05,6.66414909922918e-05,0.75
11855,99%/Number,8,6,2,6.669186136985083e-05,2.2213830330763933e-05,0.75
11856,임금/Noun,8,2,6,2.2230620456616944e-05,6.66414909922918e-05,0.75
11857,직행/Noun,8,2,6,2.2230620456616944e-05,6.66414909922918e-05,0.75
11858,스와핑/Noun,8,2,6,2.2230620456616944e-05,6.66414909922918e-05,0.75
11859,문도/Noun,8,2,6,2.2230620456616944e-05,6.66414909922918e-05,0.75
11860,칠레/Noun,8,6,2,6.669186136985083e-05,2.2213830330763933e-05,0.75
11861,무력하다/Adjective,8,2,6,2.2230620456616944e-05,6.66414909922918e-05,0.75
11862,머나멀다/Adjective,8,6,2,6.669186136985083e-05,2.2213830330763933e-05,0.75
11863,탁탁/Noun,8,2,6,2.2230620456616944e-05,6.66414909922918e-05,0.75
11864,학력/Noun,8,2,6,2.2230620456616944e-05,6.66414909922918e-05,0.75
11865,카우보이/Noun,8,6,2,6.669186136985083e-05,2.2213830330763933e-05,0.75
11866,신애/Noun,8,2,6,2.2230620456616944e-05,6.66414909922918e-05,0.75
11867,번호/Noun,8,2,6,2.2230620456616944e-05,6.66414909922918e-05,0.75
11868,저음/Noun,8,6,2,6.669186136985083e-05,2.2213830330763933e-05,0.75
11869,바바라/Noun,8,6,2,6.669186136985083e-05,2.2213830330763933e-05,0.75
11870,서요/Noun,8,2,6,2.2230620456616944e-05,6.66414909922918e-05,0.75
11871,본업/Noun,8,2,6,2.2230620456616944e-05,6.66414909922918e-05,0.75
11872,오닐/Noun,8,6,2,6.669186136985083e-05,2.2213830330763933e-05,0.75
11873,개드립/Noun,8,2,6,2.2230620456616944e-05,6.66414909922918e-05,0.75
11874,메기/Noun,8,2,6,2.2230620456616944e-05,6.66414909922918e-05,0.75
11875,양다리/Noun,8,2,6,2.2230620456616944e-05,6.66414909922918e-05,0.75
11876,굵직하다/Adjective,8,6,2,6.669186136985083e-05,2.2213830330763933e-05,0.75
11877,입원/Noun,8,2,6,2.2230620456616944e-05,6.66414909922918e-05,0.75
11878,파이란/Noun,8,6,2,6.669186136985083e-05,2.2213830330763933e-05,0.75
11879,애플렉/Noun,8,6,2,6.669186136985083e-05,2.2213830330763933e-05,0.75
11880,성우진/Noun,8,6,2,6.669186136985083e-05,2.2213830330763933e-05,0.75
11881,불의/Noun,8,6,2,6.669186136985083e-05,2.2213830330763933e-05,0.75
11882,27년/Number,8,6,2,6.669186136985083e-05,2.2213830330763933e-05,0.75
11883,감시/Noun,8,6,2,6.669186136985083e-05,2.2213830330763933e-05,0.75
11884,실리/Noun,8,6,2,6.669186136985083e-05,2.2213830330763933e-05,0.75
11885,나부/Noun,8,2,6,2.2230620456616944e-05,6.66414909922918e-05,0.75
11886,발리우드/Noun,8,6,2,6.669186136985083e-05,2.2213830330763933e-05,0.75
11887,대성통곡/Noun,8,6,2,6.669186136985083e-05,2.2213830330763933e-05,0.75
11888,로완/Noun,8,6,2,6.669186136985083e-05,2.2213830330763933e-05,0.75
11889,농부/Noun,8,6,2,6.669186136985083e-05,2.2213830330763933e-05,0.75
11890,out/Alpha,8,2,6,2.2230620456616944e-05,6.66414909922918e-05,0.75
11891,부다페스트/Noun,8,2,6,2.2230620456616944e-05,6.66414909922918e-05,0.75
11892,어쩐/Modifier,8,2,6,2.2230620456616944e-05,6.66414909922918e-05,0.75
11893,;;;;;;;/Punctuation,8,2,6,2.2230620456616944e-05,6.66414909922918e-05,0.75
11894,대목/Noun,8,2,6,2.2230620456616944e-05,6.66414909922918e-05,0.75
11895,수식/Noun,8,6,2,6.669186136985083e-05,2.2213830330763933e-05,0.75
11896,닉쿤/Noun,8,2,6,2.2230620456616944e-05,6.66414909922918e-05,0.75
11897,과대망상/Noun,8,2,6,2.2230620456616944e-05,6.66414909922918e-05,0.75
11898,개독교/Noun,8,2,6,2.2230620456616944e-05,6.66414909922918e-05,0.75
11899,전향/Noun,8,2,6,2.2230620456616944e-05,6.66414909922918e-05,0.75
11900,리해/Noun,8,2,6,2.2230620456616944e-05,6.66414909922918e-05,0.75
11901,나쁜사람/Noun,8,2,6,2.2230620456616944e-05,6.66414909922918e-05,0.75
11902,지진/Noun,8,2,6,2.2230620456616944e-05,6.66414909922918e-05,0.75
11903,번뜩이다/Verb,8,6,2,6.669186136985083e-05,2.2213830330763933e-05,0.75
11904,우승자/Noun,8,2,6,2.2230620456616944e-05,6.66414909922918e-05,0.75
11905,콘/Noun,8,6,2,6.669186136985083e-05,2.2213830330763933e-05,0.75
11906,소음/Noun,8,2,6,2.2230620456616944e-05,6.66414909922918e-05,0.75
11907,페드로/Noun,8,6,2,6.669186136985083e-05,2.2213830330763933e-05,0.75
11908,손대다/Verb,8,2,6,2.2230620456616944e-05,6.66414909922918e-05,0.75
11909,엔젤/Noun,8,6,2,6.669186136985083e-05,2.2213830330763933e-05,0.75
11910,감자별/Noun,8,6,2,6.669186136985083e-05,2.2213830330763933e-05,0.75
11911,ㅊㅊ/KoreanParticle,8,6,2,6.669186136985083e-05,2.2213830330763933e-05,0.75
11912,신가/Noun,8,2,6,2.2230620456616944e-05,6.66414909922918e-05,0.75
11913,마크로스/Noun,8,2,6,2.2230620456616944e-05,6.66414909922918e-05,0.75
11914,고스톱/Noun,8,2,6,2.2230620456616944e-05,6.66414909922918e-05,0.75
11915,닌자거북이/Noun,8,2,6,2.2230620456616944e-05,6.66414909922918e-05,0.75
11916,그나/Noun,8,2,6,2.2230620456616944e-05,6.66414909922918e-05,0.75
11917,구미/Noun,8,6,2,6.669186136985083e-05,2.2213830330763933e-05,0.75
11918,그니까/Conjunction,8,2,6,2.2230620456616944e-05,6.66414909922918e-05,0.75
11919,고어영화/Noun,8,2,6,2.2230620456616944e-05,6.66414909922918e-05,0.75
11920,균/Noun,8,6,2,6.669186136985083e-05,2.2213830330763933e-05,0.75
11921,이간/Noun,8,2,6,2.2230620456616944e-05,6.66414909922918e-05,0.75
11922,해병/Noun,8,6,2,6.669186136985083e-05,2.2213830330763933e-05,0.75
11923,초이스/Noun,8,6,2,6.669186136985083e-05,2.2213830330763933e-05,0.75
11924,장미인애/Noun,8,2,6,2.2230620456616944e-05,6.66414909922918e-05,0.75
11925,열사/Noun,8,6,2,6.669186136985083e-05,2.2213830330763933e-05,0.75
11926,활짝/Noun,8,6,2,6.669186136985083e-05,2.2213830330763933e-05,0.75
11927,소울/Noun,8,6,2,6.669186136985083e-05,2.2213830330763933e-05,0.75
11928,when/Alpha,8,6,2,6.669186136985083e-05,2.2213830330763933e-05,0.75
11929,see/Alpha,8,6,2,6.669186136985083e-05,2.2213830330763933e-05,0.75
11930,무크/Noun,8,2,6,2.2230620456616944e-05,6.66414909922918e-05,0.75
11931,호박/Noun,8,2,6,2.2230620456616944e-05,6.66414909922918e-05,0.75
11932,링크/Noun,8,2,6,2.2230620456616944e-05,6.66414909922918e-05,0.75
11933,비만/Noun,8,6,2,6.669186136985083e-05,2.2213830330763933e-05,0.75
11934,택연/Noun,8,6,2,6.669186136985083e-05,2.2213830330763933e-05,0.75
11935,관전/Noun,8,2,6,2.2230620456616944e-05,6.66414909922918e-05,0.75
11936,팝스타/Noun,8,2,6,2.2230620456616944e-05,6.66414909922918e-05,0.75
11937,이상아/Noun,8,2,6,2.2230620456616944e-05,6.66414909922918e-05,0.75
11938,젤위거/Noun,8,6,2,6.669186136985083e-05,2.2213830330763933e-05,0.75
11939,시츄에이션/Noun,8,2,6,2.2230620456616944e-05,6.66414909922918e-05,0.75
11940,씨쥐/Noun,8,2,6,2.2230620456616944e-05,6.66414909922918e-05,0.75
11941,...-/Punctuation,8,2,6,2.2230620456616944e-05,6.66414909922918e-05,0.75
11942,중생/Noun,8,2,6,2.2230620456616944e-05,6.66414909922918e-05,0.75
11943,굴복/Noun,8,6,2,6.669186136985083e-05,2.2213830330763933e-05,0.75
11944,부어/Noun,8,2,6,2.2230620456616944e-05,6.66414909922918e-05,0.75
11945,천명/Noun,8,6,2,6.669186136985083e-05,2.2213830330763933e-05,0.75
11946,데일/Noun,8,2,6,2.2230620456616944e-05,6.66414909922918e-05,0.75
11947,윤도현/Noun,8,2,6,2.2230620456616944e-05,6.66414909922918e-05,0.75
11948,나아/Adverb,8,2,6,2.2230620456616944e-05,6.66414909922918e-05,0.75
11949,99/Number,8,6,2,6.669186136985083e-05,2.2213830330763933e-05,0.75
11950,파쿠르/Noun,8,2,6,2.2230620456616944e-05,6.66414909922918e-05,0.75
11951,형상/Noun,8,6,2,6.669186136985083e-05,2.2213830330763933e-05,0.75
11952,간간이/Noun,8,6,2,6.669186136985083e-05,2.2213830330763933e-05,0.75
11953,애나벨/Noun,8,6,2,6.669186136985083e-05,2.2213830330763933e-05,0.75
11954,만일/Noun,8,2,6,2.2230620456616944e-05,6.66414909922918e-05,0.75
11955,흐려지다/Verb,8,6,2,6.669186136985083e-05,2.2213830330763933e-05,0.75
11956,!!../Punctuation,8,6,2,6.669186136985083e-05,2.2213830330763933e-05,0.75
11957,트리스탄/Noun,8,6,2,6.669186136985083e-05,2.2213830330763933e-05,0.75
11958,얘길/Noun,8,2,6,2.2230620456616944e-05,6.66414909922918e-05,0.75
11959,볼떄/Noun,8,6,2,6.669186136985083e-05,2.2213830330763933e-05,0.75
11960,무지무지/Adverb,8,6,2,6.669186136985083e-05,2.2213830330763933e-05,0.75
11961,셀프/Noun,8,2,6,2.2230620456616944e-05,6.66414909922918e-05,0.75
11962,저장/Noun,8,6,2,6.669186136985083e-05,2.2213830330763933e-05,0.75
11963,비토/Noun,8,6,2,6.669186136985083e-05,2.2213830330763933e-05,0.75
11964,기구/Noun,8,2,6,2.2230620456616944e-05,6.66414909922918e-05,0.75
11965,매너리즘/Noun,8,2,6,2.2230620456616944e-05,6.66414909922918e-05,0.75
11966,코네/Noun,8,6,2,6.669186136985083e-05,2.2213830330763933e-05,0.75
11967,마이애미/Noun,8,6,2,6.669186136985083e-05,2.2213830330763933e-05,0.75
11968,콧수염/Noun,8,2,6,2.2230620456616944e-05,6.66414909922918e-05,0.75
11969,전시/Noun,8,2,6,2.2230620456616944e-05,6.66414909922918e-05,0.75
11970,서남/Noun,8,2,6,2.2230620456616944e-05,6.66414909922918e-05,0.75
11971,스태프/Noun,8,2,6,2.2230620456616944e-05,6.66414909922918e-05,0.75
11972,콘택트/Noun,8,6,2,6.669186136985083e-05,2.2213830330763933e-05,0.75
11973,아홉/Determiner,8,6,2,6.669186136985083e-05,2.2213830330763933e-05,0.75
11974,탁구/Noun,8,6,2,6.669186136985083e-05,2.2213830330763933e-05,0.75
11975,개싸움/Noun,8,2,6,2.2230620456616944e-05,6.66414909922918e-05,0.75
11976,전수/Noun,8,2,6,2.2230620456616944e-05,6.66414909922918e-05,0.75
11977,주책/Noun,8,2,6,2.2230620456616944e-05,6.66414909922918e-05,0.75
11978,혜택/Noun,8,2,6,2.2230620456616944e-05,6.66414909922918e-05,0.75
11979,간극/Noun,8,6,2,6.669186136985083e-05,2.2213830330763933e-05,0.75
11980,응급남녀/Noun,8,6,2,6.669186136985083e-05,2.2213830330763933e-05,0.75
11981,초인/Noun,8,2,6,2.2230620456616944e-05,6.66414909922918e-05,0.75
11982,관록/Noun,8,6,2,6.669186136985083e-05,2.2213830330763933e-05,0.75
11983,오니/Noun,8,2,6,2.2230620456616944e-05,6.66414909922918e-05,0.75
11984,크레이지/Noun,8,2,6,2.2230620456616944e-05,6.66414909922918e-05,0.75
11985,군사/Noun,8,2,6,2.2230620456616944e-05,6.66414909922918e-05,0.75
11986,애드립/Noun,8,2,6,2.2230620456616944e-05,6.66414909922918e-05,0.75
11987,근성/Noun,8,5,3,5.557655114154236e-05,3.33207454961459e-05,0.625
11988,열풍/Noun,8,5,3,5.557655114154236e-05,3.33207454961459e-05,0.625
11989,생계/Noun,8,5,3,5.557655114154236e-05,3.33207454961459e-05,0.625
11990,중하/Noun,8,3,5,3.3345930684925414e-05,5.5534575826909837e-05,0.625
11991,롹/Noun,8,3,5,3.3345930684925414e-05,5.5534575826909837e-05,0.625
11992,춥다/Adjective,8,3,5,3.3345930684925414e-05,5.5534575826909837e-05,0.625
11993,대보다/Verb,8,3,5,3.3345930684925414e-05,5.5534575826909837e-05,0.625
11994,5회/Number,8,5,3,5.557655114154236e-05,3.33207454961459e-05,0.625
11995,과오/Noun,8,5,3,5.557655114154236e-05,3.33207454961459e-05,0.625
11996,자문/Noun,8,5,3,5.557655114154236e-05,3.33207454961459e-05,0.625
11997,불사/Noun,8,5,3,5.557655114154236e-05,3.33207454961459e-05,0.625
11998,초상/Noun,8,3,5,3.3345930684925414e-05,5.5534575826909837e-05,0.625
11999,나볼/Noun,8,5,3,5.557655114154236e-05,3.33207454961459e-05,0.625
12000,지뢰/Noun,8,3,5,3.3345930684925414e-05,5.5534575826909837e-05,0.625
12001,사스/Noun,8,3,5,3.3345930684925414e-05,5.5534575826909837e-05,0.625
12002,생선/Noun,8,3,5,3.3345930684925414e-05,5.5534575826909837e-05,0.625
12003,she/Alpha,8,5,3,5.557655114154236e-05,3.33207454961459e-05,0.625
12004,예진/Noun,8,5,3,5.557655114154236e-05,3.33207454961459e-05,0.625
12005,요요/Noun,8,5,3,5.557655114154236e-05,3.33207454961459e-05,0.625
12006,??.../Punctuation,8,3,5,3.3345930684925414e-05,5.5534575826909837e-05,0.625
12007,문정희/Noun,8,3,5,3.3345930684925414e-05,5.5534575826909837e-05,0.625
12008,구석구석/Noun,8,5,3,5.557655114154236e-05,3.33207454961459e-05,0.625
12009,브라더스/Noun,8,5,3,5.557655114154236e-05,3.33207454961459e-05,0.625
12010,도끼/Noun,8,3,5,3.3345930684925414e-05,5.5534575826909837e-05,0.625
12011,수용/Noun,8,5,3,5.557655114154236e-05,3.33207454961459e-05,0.625
12012,무라카미/Noun,8,3,5,3.3345930684925414e-05,5.5534575826909837e-05,0.625
12013,태풍/Noun,8,3,5,3.3345930684925414e-05,5.5534575826909837e-05,0.625
12014,콜라/Noun,8,5,3,5.557655114154236e-05,3.33207454961459e-05,0.625
12015,마고/Noun,8,5,3,5.557655114154236e-05,3.33207454961459e-05,0.625
12016,탑건/Noun,8,3,5,3.3345930684925414e-05,5.5534575826909837e-05,0.625
12017,오스틴/Noun,8,5,3,5.557655114154236e-05,3.33207454961459e-05,0.625
12018,동심파괴/Noun,8,3,5,3.3345930684925414e-05,5.5534575826909837e-05,0.625
12019,친해지다/Verb,8,5,3,5.557655114154236e-05,3.33207454961459e-05,0.625
12020,게이고/Noun,8,5,3,5.557655114154236e-05,3.33207454961459e-05,0.625
12021,최신영/Noun,8,3,5,3.3345930684925414e-05,5.5534575826909837e-05,0.625
12022,케이크/Noun,8,5,3,5.557655114154236e-05,3.33207454961459e-05,0.625
12023,도약/Noun,8,3,5,3.3345930684925414e-05,5.5534575826909837e-05,0.625
12024,딩/Noun,8,3,5,3.3345930684925414e-05,5.5534575826909837e-05,0.625
12025,하소/Noun,8,3,5,3.3345930684925414e-05,5.5534575826909837e-05,0.625
12026,허당/Noun,8,5,3,5.557655114154236e-05,3.33207454961459e-05,0.625
12027,도일/Noun,8,3,5,3.3345930684925414e-05,5.5534575826909837e-05,0.625
12028,야인시대/Noun,8,3,5,3.3345930684925414e-05,5.5534575826909837e-05,0.625
12029,이대/Modifier,8,3,5,3.3345930684925414e-05,5.5534575826909837e-05,0.625
12030,............................/Punctuation,8,3,5,3.3345930684925414e-05,5.5534575826909837e-05,0.625
12031,냉정/Noun,8,5,3,5.557655114154236e-05,3.33207454961459e-05,0.625
12032,청각/Noun,8,5,3,5.557655114154236e-05,3.33207454961459e-05,0.625
12033,행보/Noun,8,5,3,5.557655114154236e-05,3.33207454961459e-05,0.625
12034,고위/Noun,8,5,3,5.557655114154236e-05,3.33207454961459e-05,0.625
12035,깜/Noun,8,5,3,5.557655114154236e-05,3.33207454961459e-05,0.625
12036,소제/Noun,8,5,3,5.557655114154236e-05,3.33207454961459e-05,0.625
12037,라임/Noun,8,5,3,5.557655114154236e-05,3.33207454961459e-05,0.625
12038,구스/Noun,8,5,3,5.557655114154236e-05,3.33207454961459e-05,0.625
12039,일라이/Noun,8,5,3,5.557655114154236e-05,3.33207454961459e-05,0.625
12040,정웅인/Noun,8,3,5,3.3345930684925414e-05,5.5534575826909837e-05,0.625
12041,서영이/Noun,8,5,3,5.557655114154236e-05,3.33207454961459e-05,0.625
12042,가선/Noun,8,5,3,5.557655114154236e-05,3.33207454961459e-05,0.625
12043,자유분방하다/Adjective,8,5,3,5.557655114154236e-05,3.33207454961459e-05,0.625
12044,식객/Noun,8,3,5,3.3345930684925414e-05,5.5534575826909837e-05,0.625
12045,XXX/Alpha,8,3,5,3.3345930684925414e-05,5.5534575826909837e-05,0.625
12046,컨트롤/Noun,8,5,3,5.557655114154236e-05,3.33207454961459e-05,0.625
12047,이상윤/Noun,8,5,3,5.557655114154236e-05,3.33207454961459e-05,0.625
12048,노장/Noun,8,5,3,5.557655114154236e-05,3.33207454961459e-05,0.625
12049,벅스라이프/Noun,8,3,5,3.3345930684925414e-05,5.5534575826909837e-05,0.625
12050,필사/Noun,8,5,3,5.557655114154236e-05,3.33207454961459e-05,0.625
12051,거룩하다/Adjective,8,3,5,3.3345930684925414e-05,5.5534575826909837e-05,0.625
12052,레포트/Noun,8,3,5,3.3345930684925414e-05,5.5534575826909837e-05,0.625
12053,브레이/Noun,8,3,5,3.3345930684925414e-05,5.5534575826909837e-05,0.625
12054,윤상현/Noun,8,5,3,5.557655114154236e-05,3.33207454961459e-05,0.625
12055,월등하다/Adjective,8,3,5,3.3345930684925414e-05,5.5534575826909837e-05,0.625
12056,뜰/Noun,8,3,5,3.3345930684925414e-05,5.5534575826909837e-05,0.625
12057,깨부수다/Verb,8,3,5,3.3345930684925414e-05,5.5534575826909837e-05,0.625
12058,저수지/Noun,8,3,5,3.3345930684925414e-05,5.5534575826909837e-05,0.625
12059,개보/Noun,8,3,5,3.3345930684925414e-05,5.5534575826909837e-05,0.625
12060,레이져/Noun,8,5,3,5.557655114154236e-05,3.33207454961459e-05,0.625
12061,토마토/Noun,8,3,5,3.3345930684925414e-05,5.5534575826909837e-05,0.625
12062,짐머/Noun,8,5,3,5.557655114154236e-05,3.33207454961459e-05,0.625
12063,랭/Noun,8,5,3,5.557655114154236e-05,3.33207454961459e-05,0.625
12064,착륙/Noun,8,5,3,5.557655114154236e-05,3.33207454961459e-05,0.625
12065,리드/Noun,8,3,5,3.3345930684925414e-05,5.5534575826909837e-05,0.625
12066,섭렵/Noun,8,5,3,5.557655114154236e-05,3.33207454961459e-05,0.625
12067,인신매매/Noun,8,3,5,3.3345930684925414e-05,5.5534575826909837e-05,0.625
12068,월급/Noun,8,3,5,3.3345930684925414e-05,5.5534575826909837e-05,0.625
12069,이준익/Noun,8,3,5,3.3345930684925414e-05,5.5534575826909837e-05,0.625
12070,숫/Noun,8,5,3,5.557655114154236e-05,3.33207454961459e-05,0.625
12071,레이드/Noun,8,5,3,5.557655114154236e-05,3.33207454961459e-05,0.625
12072,리즈/Foreign,8,5,3,5.557655114154236e-05,3.33207454961459e-05,0.625
12073,이어진/Noun,8,5,3,5.557655114154236e-05,3.33207454961459e-05,0.625
12074,블란쳇/Noun,8,5,3,5.557655114154236e-05,3.33207454961459e-05,0.625
12075,달리기/Noun,8,3,5,3.3345930684925414e-05,5.5534575826909837e-05,0.625
12076,우매/Noun,8,3,5,3.3345930684925414e-05,5.5534575826909837e-05,0.625
12077,된/Foreign,8,5,3,5.557655114154236e-05,3.33207454961459e-05,0.625
12078,쿠삭/Noun,8,3,5,3.3345930684925414e-05,5.5534575826909837e-05,0.625
12079,심문/Noun,8,3,5,3.3345930684925414e-05,5.5534575826909837e-05,0.625
12080,아귀/Noun,8,5,3,5.557655114154236e-05,3.33207454961459e-05,0.625
12081,이천희/Noun,8,5,3,5.557655114154236e-05,3.33207454961459e-05,0.625
12082,의대/Noun,8,5,3,5.557655114154236e-05,3.33207454961459e-05,0.625
12083,수확/Noun,8,3,5,3.3345930684925414e-05,5.5534575826909837e-05,0.625
12084,헵번/Noun,8,5,3,5.557655114154236e-05,3.33207454961459e-05,0.625
12085,!(/Punctuation,8,5,3,5.557655114154236e-05,3.33207454961459e-05,0.625
12086,really/Alpha,8,3,5,3.3345930684925414e-05,5.5534575826909837e-05,0.625
12087,GTA/Alpha,8,3,5,3.3345930684925414e-05,5.5534575826909837e-05,0.625
12088,단발/Noun,8,3,5,3.3345930684925414e-05,5.5534575826909837e-05,0.625
12089,우리말/Noun,8,3,5,3.3345930684925414e-05,5.5534575826909837e-05,0.625
12090,근무/Noun,8,3,5,3.3345930684925414e-05,5.5534575826909837e-05,0.625
12091,영국인/Noun,8,5,3,5.557655114154236e-05,3.33207454961459e-05,0.625
12092,약혼자/Noun,8,3,5,3.3345930684925414e-05,5.5534575826909837e-05,0.625
12093,안되겠니/Noun,8,3,5,3.3345930684925414e-05,5.5534575826909837e-05,0.625
12094,98분/Number,8,3,5,3.3345930684925414e-05,5.5534575826909837e-05,0.625
12095,철권/Noun,8,5,3,5.557655114154236e-05,3.33207454961459e-05,0.625
12096,토탈리콜/Noun,8,3,5,3.3345930684925414e-05,5.5534575826909837e-05,0.625
12097,곁들이다/Verb,8,5,3,5.557655114154236e-05,3.33207454961459e-05,0.625
12098,노르웨이/Noun,8,3,5,3.3345930684925414e-05,5.5534575826909837e-05,0.625
12099,박건형/Noun,8,3,5,3.3345930684925414e-05,5.5534575826909837e-05,0.625
12100,어벤저스/Noun,8,5,3,5.557655114154236e-05,3.33207454961459e-05,0.625
12101,수목드라마/Noun,8,5,3,5.557655114154236e-05,3.33207454961459e-05,0.625
12102,발광하다/Adjective,8,3,5,3.3345930684925414e-05,5.5534575826909837e-05,0.625
12103,이마/Modifier,8,5,3,5.557655114154236e-05,3.33207454961459e-05,0.625
12104,일해/Noun,8,3,5,3.3345930684925414e-05,5.5534575826909837e-05,0.625
12105,진흙탕/Noun,8,5,3,5.557655114154236e-05,3.33207454961459e-05,0.625
12106,』/Foreign,8,5,3,5.557655114154236e-05,3.33207454961459e-05,0.625
12107,팔자/Noun,8,3,5,3.3345930684925414e-05,5.5534575826909837e-05,0.625
12108,밍/Noun,8,5,3,5.557655114154236e-05,3.33207454961459e-05,0.625
12109,정두홍/Noun,8,3,5,3.3345930684925414e-05,5.5534575826909837e-05,0.625
12110,일제강점기/Noun,8,5,3,5.557655114154236e-05,3.33207454961459e-05,0.625
12111,공동/Noun,8,3,5,3.3345930684925414e-05,5.5534575826909837e-05,0.625
12112,유린/Noun,8,5,3,5.557655114154236e-05,3.33207454961459e-05,0.625
12113,강물/Noun,8,5,3,5.557655114154236e-05,3.33207454961459e-05,0.625
12114,숙이다/Verb,8,5,3,5.557655114154236e-05,3.33207454961459e-05,0.625
12115,그러다가/Conjunction,8,3,5,3.3345930684925414e-05,5.5534575826909837e-05,0.625
12116,용구성/Noun,8,3,5,3.3345930684925414e-05,5.5534575826909837e-05,0.625
12117,정반대/Noun,8,5,3,5.557655114154236e-05,3.33207454961459e-05,0.625
12118,냉전시대/Noun,8,5,3,5.557655114154236e-05,3.33207454961459e-05,0.625
12119,폭격/Noun,8,3,5,3.3345930684925414e-05,5.5534575826909837e-05,0.625
12120,군부/Noun,8,5,3,5.557655114154236e-05,3.33207454961459e-05,0.625
12121,왓음/Noun,8,3,5,3.3345930684925414e-05,5.5534575826909837e-05,0.625
12122,펑점/Noun,8,3,5,3.3345930684925414e-05,5.5534575826909837e-05,0.625
12123,~~~~~~~~~~~/Punctuation,8,5,3,5.557655114154236e-05,3.33207454961459e-05,0.625
12124,왕빛나/Noun,8,3,5,3.3345930684925414e-05,5.5534575826909837e-05,0.625
12125,씬나다/Adjective,8,3,5,3.3345930684925414e-05,5.5534575826909837e-05,0.625
12126,프로스트/Noun,8,3,5,3.3345930684925414e-05,5.5534575826909837e-05,0.625
12127,점때/Noun,8,3,5,3.3345930684925414e-05,5.5534575826909837e-05,0.625
12128,story/Alpha,8,5,3,5.557655114154236e-05,3.33207454961459e-05,0.625
12129,라퓨타/Noun,8,5,3,5.557655114154236e-05,3.33207454961459e-05,0.625
12130,리리/Noun,8,5,3,5.557655114154236e-05,3.33207454961459e-05,0.625
12131,헤븐/Noun,8,5,3,5.557655114154236e-05,3.33207454961459e-05,0.625
12132,식사/Noun,8,3,5,3.3345930684925414e-05,5.5534575826909837e-05,0.625
12133,뮤츠/Noun,8,5,3,5.557655114154236e-05,3.33207454961459e-05,0.625
12134,ㅇㄴ/KoreanParticle,8,3,5,3.3345930684925414e-05,5.5534575826909837e-05,0.625
12135,쏜다/Noun,8,3,5,3.3345930684925414e-05,5.5534575826909837e-05,0.625
12136,일기장/Noun,8,3,5,3.3345930684925414e-05,5.5534575826909837e-05,0.625
12137,초속/Noun,8,3,5,3.3345930684925414e-05,5.5534575826909837e-05,0.625
12138,젝키/Noun,8,5,3,5.557655114154236e-05,3.33207454961459e-05,0.625
12139,10일/Number,8,5,3,5.557655114154236e-05,3.33207454961459e-05,0.625
12140,점준놈/Noun,8,3,5,3.3345930684925414e-05,5.5534575826909837e-05,0.625
12141,셀마/Noun,8,5,3,5.557655114154236e-05,3.33207454961459e-05,0.625
12142,대개/Noun,8,3,5,3.3345930684925414e-05,5.5534575826909837e-05,0.625
12143,뛰어내리다/Verb,8,5,3,5.557655114154236e-05,3.33207454961459e-05,0.625
12144,시드/Noun,8,5,3,5.557655114154236e-05,3.33207454961459e-05,0.625
12145,베베/Noun,8,3,5,3.3345930684925414e-05,5.5534575826909837e-05,0.625
12146,야비하다/Adjective,8,3,5,3.3345930684925414e-05,5.5534575826909837e-05,0.625
12147,파이트클럽/Noun,8,5,3,5.557655114154236e-05,3.33207454961459e-05,0.625
12148,고잉홈/Noun,8,5,3,5.557655114154236e-05,3.33207454961459e-05,0.625
12149,소아/Noun,8,5,3,5.557655114154236e-05,3.33207454961459e-05,0.625
12150,테츠/Noun,8,5,3,5.557655114154236e-05,3.33207454961459e-05,0.625
12151,회복하다/Adjective,8,5,3,5.557655114154236e-05,3.33207454961459e-05,0.625
12152,바닷가/Noun,8,3,5,3.3345930684925414e-05,5.5534575826909837e-05,0.625
12153,촬영장/Noun,8,5,3,5.557655114154236e-05,3.33207454961459e-05,0.625
12154,웨딩/Noun,8,5,3,5.557655114154236e-05,3.33207454961459e-05,0.625
12155,입김/Noun,8,3,5,3.3345930684925414e-05,5.5534575826909837e-05,0.625
12156,공허/Noun,8,5,3,5.557655114154236e-05,3.33207454961459e-05,0.625
12157,9시/Number,8,5,3,5.557655114154236e-05,3.33207454961459e-05,0.625
12158,탈모/Noun,8,5,3,5.557655114154236e-05,3.33207454961459e-05,0.625
12159,원정/Noun,8,3,5,3.3345930684925414e-05,5.5534575826909837e-05,0.625
12160,"~,/Punctuation",8,5,3,5.557655114154236e-05,3.33207454961459e-05,0.625
12161,3등/Number,8,5,3,5.557655114154236e-05,3.33207454961459e-05,0.625
12162,진주만/Noun,8,3,5,3.3345930684925414e-05,5.5534575826909837e-05,0.625
12163,상반/Noun,8,5,3,5.557655114154236e-05,3.33207454961459e-05,0.625
12164,맨인블랙/Noun,8,5,3,5.557655114154236e-05,3.33207454961459e-05,0.625
12165,!!!!!!!!!!!!!!!!/Punctuation,8,5,3,5.557655114154236e-05,3.33207454961459e-05,0.625
12166,예술인/Noun,8,5,3,5.557655114154236e-05,3.33207454961459e-05,0.625
12167,하내/Noun,8,3,5,3.3345930684925414e-05,5.5534575826909837e-05,0.625
12168,h/Alpha,8,5,3,5.557655114154236e-05,3.33207454961459e-05,0.625
12169,폭로/Noun,8,5,3,5.557655114154236e-05,3.33207454961459e-05,0.625
12170,연합/Noun,8,3,5,3.3345930684925414e-05,5.5534575826909837e-05,0.625
12171,작도/Noun,8,3,5,3.3345930684925414e-05,5.5534575826909837e-05,0.625
12172,패닉/Noun,8,5,3,5.557655114154236e-05,3.33207454961459e-05,0.625
12173,시놉/Noun,8,3,5,3.3345930684925414e-05,5.5534575826909837e-05,0.625
12174,엘르/Noun,8,5,3,5.557655114154236e-05,3.33207454961459e-05,0.625
12175,검찰/Noun,8,5,3,5.557655114154236e-05,3.33207454961459e-05,0.625
12176,시라노/Noun,8,5,3,5.557655114154236e-05,3.33207454961459e-05,0.625
12177,소연/Noun,8,5,3,5.557655114154236e-05,3.33207454961459e-05,0.625
12178,김연아/Noun,8,3,5,3.3345930684925414e-05,5.5534575826909837e-05,0.625
12179,60초/Number,8,3,5,3.3345930684925414e-05,5.5534575826909837e-05,0.625
12180,그겨울/Noun,8,3,5,3.3345930684925414e-05,5.5534575826909837e-05,0.625
12181,밑에님/Noun,8,5,3,5.557655114154236e-05,3.33207454961459e-05,0.625
12182,하드보일드/Noun,8,5,3,5.557655114154236e-05,3.33207454961459e-05,0.625
12183,도마뱀/Noun,8,3,5,3.3345930684925414e-05,5.5534575826909837e-05,0.625
12184,우월하다/Adjective,8,5,3,5.557655114154236e-05,3.33207454961459e-05,0.625
12185,호의/Noun,8,3,5,3.3345930684925414e-05,5.5534575826909837e-05,0.625
12186,허물/Noun,8,3,5,3.3345930684925414e-05,5.5534575826909837e-05,0.625
12187,테레비/Noun,8,3,5,3.3345930684925414e-05,5.5534575826909837e-05,0.625
12188,탈주/Noun,8,5,3,5.557655114154236e-05,3.33207454961459e-05,0.625
12189,지끈/Noun,8,3,5,3.3345930684925414e-05,5.5534575826909837e-05,0.625
12190,오웬/Noun,8,5,3,5.557655114154236e-05,3.33207454961459e-05,0.625
12191,흐릿/Noun,8,5,3,5.557655114154236e-05,3.33207454961459e-05,0.625
12192,5원/Number,8,5,3,5.557655114154236e-05,3.33207454961459e-05,0.625
12193,업체/Noun,8,3,5,3.3345930684925414e-05,5.5534575826909837e-05,0.625
12194,레슬러/Noun,8,3,5,3.3345930684925414e-05,5.5534575826909837e-05,0.625
12195,중동/Noun,8,5,3,5.557655114154236e-05,3.33207454961459e-05,0.625
12196,티어/Noun,8,3,5,3.3345930684925414e-05,5.5534575826909837e-05,0.625
12197,긔/Noun,8,5,3,5.557655114154236e-05,3.33207454961459e-05,0.625
12198,카라/Noun,8,3,5,3.3345930684925414e-05,5.5534575826909837e-05,0.625
12199,섬기다/Verb,8,5,3,5.557655114154236e-05,3.33207454961459e-05,0.625
12200,다르덴/Noun,8,5,3,5.557655114154236e-05,3.33207454961459e-05,0.625
12201,채식/Noun,8,3,5,3.3345930684925414e-05,5.5534575826909837e-05,0.625
12202,톰과제리/Noun,8,5,3,5.557655114154236e-05,3.33207454961459e-05,0.625
12203,느꼇다/Noun,8,5,3,5.557655114154236e-05,3.33207454961459e-05,0.625
12204,단골/Noun,8,3,5,3.3345930684925414e-05,5.5534575826909837e-05,0.625
12205,램/Noun,8,3,5,3.3345930684925414e-05,5.5534575826909837e-05,0.625
12206,미소녀/Noun,8,5,3,5.557655114154236e-05,3.33207454961459e-05,0.625
12207,란걸/Noun,8,3,5,3.3345930684925414e-05,5.5534575826909837e-05,0.625
12208,@@/Punctuation,8,5,3,5.557655114154236e-05,3.33207454961459e-05,0.625
12209,스타덤/Noun,8,3,5,3.3345930684925414e-05,5.5534575826909837e-05,0.625
12210,부패하다/Adjective,8,3,5,3.3345930684925414e-05,5.5534575826909837e-05,0.625
12211,검열/Noun,8,3,5,3.3345930684925414e-05,5.5534575826909837e-05,0.625
12212,공중전/Noun,8,5,3,5.557655114154236e-05,3.33207454961459e-05,0.625
12213,우즈/Noun,8,5,3,5.557655114154236e-05,3.33207454961459e-05,0.625
12214,자로/Noun,8,3,5,3.3345930684925414e-05,5.5534575826909837e-05,0.625
12215,마비/Noun,8,5,3,5.557655114154236e-05,3.33207454961459e-05,0.625
12216,우리땅/Noun,8,3,5,3.3345930684925414e-05,5.5534575826909837e-05,0.625
12217,손해/Noun,8,3,5,3.3345930684925414e-05,5.5534575826909837e-05,0.625
12218,연길/Noun,8,5,3,5.557655114154236e-05,3.33207454961459e-05,0.625
12219,베송/Noun,8,3,5,3.3345930684925414e-05,5.5534575826909837e-05,0.625
12220,있슴/Noun,8,3,5,3.3345930684925414e-05,5.5534575826909837e-05,0.625
12221,특권/Noun,8,3,5,3.3345930684925414e-05,5.5534575826909837e-05,0.625
12222,대위/Noun,8,3,5,3.3345930684925414e-05,5.5534575826909837e-05,0.625
12223,미나토/Noun,8,5,3,5.557655114154236e-05,3.33207454961459e-05,0.625
12224,발작/Noun,8,5,3,5.557655114154236e-05,3.33207454961459e-05,0.625
12225,줄타기/Noun,8,3,5,3.3345930684925414e-05,5.5534575826909837e-05,0.625
12226,연화/Noun,8,3,5,3.3345930684925414e-05,5.5534575826909837e-05,0.625
12227,일어난다/Noun,8,5,3,5.557655114154236e-05,3.33207454961459e-05,0.625
12228,김지훈/Noun,8,5,3,5.557655114154236e-05,3.33207454961459e-05,0.625
12229,첨밀밀/Noun,8,3,5,3.3345930684925414e-05,5.5534575826909837e-05,0.625
12230,두드리다/Verb,8,3,5,3.3345930684925414e-05,5.5534575826909837e-05,0.625
12231,임달화/Noun,8,5,3,5.557655114154236e-05,3.33207454961459e-05,0.625
12232,분말/Noun,8,3,5,3.3345930684925414e-05,5.5534575826909837e-05,0.625
12233,~~~~~~~~~~/Punctuation,8,3,5,3.3345930684925414e-05,5.5534575826909837e-05,0.625
12234,짱짱하다/Adjective,8,5,3,5.557655114154236e-05,3.33207454961459e-05,0.625
12235,권력자/Noun,8,5,3,5.557655114154236e-05,3.33207454961459e-05,0.625
12236,아웅/Exclamation,8,3,5,3.3345930684925414e-05,5.5534575826909837e-05,0.625
12237,욕정/Noun,8,3,5,3.3345930684925414e-05,5.5534575826909837e-05,0.625
12238,시나리오작가/Noun,8,3,5,3.3345930684925414e-05,5.5534575826909837e-05,0.625
12239,랭킹/Noun,8,5,3,5.557655114154236e-05,3.33207454961459e-05,0.625
12240,베플/Noun,8,3,5,3.3345930684925414e-05,5.5534575826909837e-05,0.625
12241,먹여주다/Verb,8,3,5,3.3345930684925414e-05,5.5534575826909837e-05,0.625
12242,삼만리/Noun,8,3,5,3.3345930684925414e-05,5.5534575826909837e-05,0.625
12243,..-_-;/Punctuation,8,3,5,3.3345930684925414e-05,5.5534575826909837e-05,0.625
12244,말함/Noun,8,3,5,3.3345930684925414e-05,5.5534575826909837e-05,0.625
12245,미세/Noun,8,5,3,5.557655114154236e-05,3.33207454961459e-05,0.625
12246,프랑스어/Noun,8,3,5,3.3345930684925414e-05,5.5534575826909837e-05,0.625
12247,마인/Noun,8,3,5,3.3345930684925414e-05,5.5534575826909837e-05,0.625
12248,::/Punctuation,8,3,5,3.3345930684925414e-05,5.5534575826909837e-05,0.625
12249,브룩/Noun,8,5,3,5.557655114154236e-05,3.33207454961459e-05,0.625
12250,ㅜㅜㅠ/KoreanParticle,8,5,3,5.557655114154236e-05,3.33207454961459e-05,0.625
12251,#/Punctuation,8,3,5,3.3345930684925414e-05,5.5534575826909837e-05,0.625
12252,일장춘몽/Noun,8,5,3,5.557655114154236e-05,3.33207454961459e-05,0.625
12253,어감/Noun,8,5,3,5.557655114154236e-05,3.33207454961459e-05,0.625
12254,삭/Noun,8,3,5,3.3345930684925414e-05,5.5534575826909837e-05,0.625
12255,해고/Noun,8,3,5,3.3345930684925414e-05,5.5534575826909837e-05,0.625
12256,빛과/Noun,8,4,4,4.446124091323389e-05,4.4427660661527865e-05,0.5
12257,청소/Noun,8,4,4,4.446124091323389e-05,4.4427660661527865e-05,0.5
12258,심경/Noun,8,4,4,4.446124091323389e-05,4.4427660661527865e-05,0.5
12259,폭풍우/Noun,8,4,4,4.446124091323389e-05,4.4427660661527865e-05,0.5
12260,조세호/Noun,8,4,4,4.446124091323389e-05,4.4427660661527865e-05,0.5
12261,금기/Noun,8,4,4,4.446124091323389e-05,4.4427660661527865e-05,0.5
12262,햇빛/Noun,8,4,4,4.446124091323389e-05,4.4427660661527865e-05,0.5
12263,맛집/Noun,8,4,4,4.446124091323389e-05,4.4427660661527865e-05,0.5
12264,웰컴/Noun,8,4,4,4.446124091323389e-05,4.4427660661527865e-05,0.5
12265,징글징글/Noun,8,4,4,4.446124091323389e-05,4.4427660661527865e-05,0.5
12266,초난강/Noun,8,4,4,4.446124091323389e-05,4.4427660661527865e-05,0.5
12267,앜/Noun,8,4,4,4.446124091323389e-05,4.4427660661527865e-05,0.5
12268,까지와/Josa,8,4,4,4.446124091323389e-05,4.4427660661527865e-05,0.5
12269,여울/Noun,8,4,4,4.446124091323389e-05,4.4427660661527865e-05,0.5
12270,네버/Noun,8,4,4,4.446124091323389e-05,4.4427660661527865e-05,0.5
12271,속성/Noun,8,4,4,4.446124091323389e-05,4.4427660661527865e-05,0.5
12272,저력/Noun,8,4,4,4.446124091323389e-05,4.4427660661527865e-05,0.5
12273,촛불/Noun,8,4,4,4.446124091323389e-05,4.4427660661527865e-05,0.5
12274,동서/Noun,8,4,4,4.446124091323389e-05,4.4427660661527865e-05,0.5
12275,어린이날/Noun,8,4,4,4.446124091323389e-05,4.4427660661527865e-05,0.5
12276,전신/Noun,8,4,4,4.446124091323389e-05,4.4427660661527865e-05,0.5
12277,런타임/Noun,8,4,4,4.446124091323389e-05,4.4427660661527865e-05,0.5
12278,뿌/Noun,8,4,4,4.446124091323389e-05,4.4427660661527865e-05,0.5
12279,세아/Noun,8,4,4,4.446124091323389e-05,4.4427660661527865e-05,0.5
12280,필요성/Noun,8,4,4,4.446124091323389e-05,4.4427660661527865e-05,0.5
12281,집앞/Noun,8,4,4,4.446124091323389e-05,4.4427660661527865e-05,0.5
12282,드라이버/Noun,8,4,4,4.446124091323389e-05,4.4427660661527865e-05,0.5
12283,처형/Noun,8,4,4,4.446124091323389e-05,4.4427660661527865e-05,0.5
12284,박성웅/Noun,8,4,4,4.446124091323389e-05,4.4427660661527865e-05,0.5
12285,배포/Noun,8,4,4,4.446124091323389e-05,4.4427660661527865e-05,0.5
12286,꼭지/Noun,8,4,4,4.446124091323389e-05,4.4427660661527865e-05,0.5
12287,해진/Noun,8,4,4,4.446124091323389e-05,4.4427660661527865e-05,0.5
12288,못만듬/Noun,8,4,4,4.446124091323389e-05,4.4427660661527865e-05,0.5
12289,숙명/Noun,8,4,4,4.446124091323389e-05,4.4427660661527865e-05,0.5
12290,전원일기/Noun,8,4,4,4.446124091323389e-05,4.4427660661527865e-05,0.5
12291,고상하다/Adjective,8,4,4,4.446124091323389e-05,4.4427660661527865e-05,0.5
12292,속마음/Noun,8,4,4,4.446124091323389e-05,4.4427660661527865e-05,0.5
12293,뒤에/Foreign,8,4,4,4.446124091323389e-05,4.4427660661527865e-05,0.5
12294,스미다/Verb,8,4,4,4.446124091323389e-05,4.4427660661527865e-05,0.5
12295,경관/Noun,8,4,4,4.446124091323389e-05,4.4427660661527865e-05,0.5
12296,험담/Noun,8,4,4,4.446124091323389e-05,4.4427660661527865e-05,0.5
12297,HD/Alpha,8,4,4,4.446124091323389e-05,4.4427660661527865e-05,0.5
12298,규어/Noun,8,4,4,4.446124091323389e-05,4.4427660661527865e-05,0.5
12299,1~4/Number,8,4,4,4.446124091323389e-05,4.4427660661527865e-05,0.5
12300,>>/Punctuation,8,4,4,4.446124091323389e-05,4.4427660661527865e-05,0.5
12301,계란/Noun,8,4,4,4.446124091323389e-05,4.4427660661527865e-05,0.5
12302,장벽/Noun,8,4,4,4.446124091323389e-05,4.4427660661527865e-05,0.5
12303,영화매니아/Noun,8,4,4,4.446124091323389e-05,4.4427660661527865e-05,0.5
12304,발산/Noun,8,4,4,4.446124091323389e-05,4.4427660661527865e-05,0.5
12305,결점/Noun,8,4,4,4.446124091323389e-05,4.4427660661527865e-05,0.5
12306,진격/Noun,8,4,4,4.446124091323389e-05,4.4427660661527865e-05,0.5
12307,변호인/Noun,8,4,4,4.446124091323389e-05,4.4427660661527865e-05,0.5
12308,어쩜이리/Noun,8,4,4,4.446124091323389e-05,4.4427660661527865e-05,0.5
12309,와/Exclamation,8,4,4,4.446124091323389e-05,4.4427660661527865e-05,0.5
12310,신문/Noun,8,4,4,4.446124091323389e-05,4.4427660661527865e-05,0.5
12311,right/Alpha,8,4,4,4.446124091323389e-05,4.4427660661527865e-05,0.5
12312,9회/Number,8,4,4,4.446124091323389e-05,4.4427660661527865e-05,0.5
12313,파서/Noun,8,4,4,4.446124091323389e-05,4.4427660661527865e-05,0.5
12314,마네/Noun,8,4,4,4.446124091323389e-05,4.4427660661527865e-05,0.5
12315,투철/Noun,8,4,4,4.446124091323389e-05,4.4427660661527865e-05,0.5
12316,이상하/Noun,8,4,4,4.446124091323389e-05,4.4427660661527865e-05,0.5
12317,발현/Noun,8,4,4,4.446124091323389e-05,4.4427660661527865e-05,0.5
12318,제약/Noun,8,4,4,4.446124091323389e-05,4.4427660661527865e-05,0.5
12319,길어지다/Verb,8,4,4,4.446124091323389e-05,4.4427660661527865e-05,0.5
12320,판권/Noun,8,4,4,4.446124091323389e-05,4.4427660661527865e-05,0.5
12321,하리수/Noun,8,4,4,4.446124091323389e-05,4.4427660661527865e-05,0.5
12322,칼라/Noun,8,4,4,4.446124091323389e-05,4.4427660661527865e-05,0.5
12323,러시안/Noun,8,4,4,4.446124091323389e-05,4.4427660661527865e-05,0.5
12324,겨누/Noun,8,4,4,4.446124091323389e-05,4.4427660661527865e-05,0.5
12325,기일/Noun,8,4,4,4.446124091323389e-05,4.4427660661527865e-05,0.5
12326,금영/Noun,8,4,4,4.446124091323389e-05,4.4427660661527865e-05,0.5
12327,프렌치/Noun,8,4,4,4.446124091323389e-05,4.4427660661527865e-05,0.5
12328,썰다/Verb,8,4,4,4.446124091323389e-05,4.4427660661527865e-05,0.5
12329,여겨지다/Verb,8,4,4,4.446124091323389e-05,4.4427660661527865e-05,0.5
12330,made/Alpha,8,4,4,4.446124091323389e-05,4.4427660661527865e-05,0.5
12331,레베카/Noun,8,4,4,4.446124091323389e-05,4.4427660661527865e-05,0.5
12332,벤스틸러/Noun,8,4,4,4.446124091323389e-05,4.4427660661527865e-05,0.5
12333,옵티머스/Noun,8,4,4,4.446124091323389e-05,4.4427660661527865e-05,0.5
12334,복도/Noun,8,4,4,4.446124091323389e-05,4.4427660661527865e-05,0.5
12335,요즈음/Noun,8,4,4,4.446124091323389e-05,4.4427660661527865e-05,0.5
12336,바치/Noun,8,4,4,4.446124091323389e-05,4.4427660661527865e-05,0.5
12337,천공/Noun,8,4,4,4.446124091323389e-05,4.4427660661527865e-05,0.5
12338,냉장고/Noun,8,4,4,4.446124091323389e-05,4.4427660661527865e-05,0.5
12339,클레어/Noun,8,4,4,4.446124091323389e-05,4.4427660661527865e-05,0.5
12340,비인간/Noun,8,4,4,4.446124091323389e-05,4.4427660661527865e-05,0.5
12341,슈퍼카/Noun,8,4,4,4.446124091323389e-05,4.4427660661527865e-05,0.5
12342,배경인/Noun,8,4,4,4.446124091323389e-05,4.4427660661527865e-05,0.5
12343,욜/Noun,8,4,4,4.446124091323389e-05,4.4427660661527865e-05,0.5
12344,아슬아슬하다/Adjective,8,4,4,4.446124091323389e-05,4.4427660661527865e-05,0.5
12345,전현무/Noun,8,4,4,4.446124091323389e-05,4.4427660661527865e-05,0.5
12346,감상문/Noun,8,4,4,4.446124091323389e-05,4.4427660661527865e-05,0.5
12347,추노/Noun,8,4,4,4.446124091323389e-05,4.4427660661527865e-05,0.5
12348,계산/Noun,8,4,4,4.446124091323389e-05,4.4427660661527865e-05,0.5
12349,part/Alpha,8,4,4,4.446124091323389e-05,4.4427660661527865e-05,0.5
12350,트리플/Noun,8,4,4,4.446124091323389e-05,4.4427660661527865e-05,0.5
12351,스파게티/Noun,8,4,4,4.446124091323389e-05,4.4427660661527865e-05,0.5
12352,패자/Noun,8,4,4,4.446124091323389e-05,4.4427660661527865e-05,0.5
12353,헛되/Noun,8,4,4,4.446124091323389e-05,4.4427660661527865e-05,0.5
12354,레지던트이블/Noun,8,4,4,4.446124091323389e-05,4.4427660661527865e-05,0.5
12355,무교/Noun,8,4,4,4.446124091323389e-05,4.4427660661527865e-05,0.5
12356,매도/Noun,8,4,4,4.446124091323389e-05,4.4427660661527865e-05,0.5
12357,유인나/Noun,8,4,4,4.446124091323389e-05,4.4427660661527865e-05,0.5
12358,거보/Noun,8,4,4,4.446124091323389e-05,4.4427660661527865e-05,0.5
12359,펠레/Noun,8,4,4,4.446124091323389e-05,4.4427660661527865e-05,0.5
12360,루저/Noun,8,4,4,4.446124091323389e-05,4.4427660661527865e-05,0.5
12361,백치/Noun,8,4,4,4.446124091323389e-05,4.4427660661527865e-05,0.5
12362,20회/Number,8,4,4,4.446124091323389e-05,4.4427660661527865e-05,0.5
12363,관계없이/Adverb,8,4,4,4.446124091323389e-05,4.4427660661527865e-05,0.5
12364,초래/Noun,8,4,4,4.446124091323389e-05,4.4427660661527865e-05,0.5
12365,시월애/Noun,8,4,4,4.446124091323389e-05,4.4427660661527865e-05,0.5
12366,술술/Noun,8,4,4,4.446124091323389e-05,4.4427660661527865e-05,0.5
12367,단언/Noun,8,4,4,4.446124091323389e-05,4.4427660661527865e-05,0.5
12368,먹어주다/Verb,8,4,4,4.446124091323389e-05,4.4427660661527865e-05,0.5
12369,iptv/Alpha,8,4,4,4.446124091323389e-05,4.4427660661527865e-05,0.5
12370,퇴마/Noun,8,4,4,4.446124091323389e-05,4.4427660661527865e-05,0.5
12371,구인/Noun,8,4,4,4.446124091323389e-05,4.4427660661527865e-05,0.5
12372,리조/Noun,8,4,4,4.446124091323389e-05,4.4427660661527865e-05,0.5
12373,전함/Noun,8,4,4,4.446124091323389e-05,4.4427660661527865e-05,0.5
12374,요것/Noun,8,4,4,4.446124091323389e-05,4.4427660661527865e-05,0.5
12375,로케이션/Noun,8,4,4,4.446124091323389e-05,4.4427660661527865e-05,0.5
12376,아마겟돈/Noun,8,4,4,4.446124091323389e-05,4.4427660661527865e-05,0.5
12377,레이크/Noun,8,4,4,4.446124091323389e-05,4.4427660661527865e-05,0.5
12378,어머님/Noun,8,4,4,4.446124091323389e-05,4.4427660661527865e-05,0.5
12379,최첨단/Noun,8,4,4,4.446124091323389e-05,4.4427660661527865e-05,0.5
12380,선지/Noun,8,4,4,4.446124091323389e-05,4.4427660661527865e-05,0.5
12381,트루먼/Noun,8,4,4,4.446124091323389e-05,4.4427660661527865e-05,0.5
12382,트릴로지/Noun,8,4,4,4.446124091323389e-05,4.4427660661527865e-05,0.5
12383,양화/Noun,8,4,4,4.446124091323389e-05,4.4427660661527865e-05,0.5
12384,뉘우치다/Verb,8,4,4,4.446124091323389e-05,4.4427660661527865e-05,0.5
12385,타국/Noun,8,4,4,4.446124091323389e-05,4.4427660661527865e-05,0.5
12386,썬더/Noun,8,4,4,4.446124091323389e-05,4.4427660661527865e-05,0.5
12387,실행/Noun,8,4,4,4.446124091323389e-05,4.4427660661527865e-05,0.5
12388,수동/Noun,8,4,4,4.446124091323389e-05,4.4427660661527865e-05,0.5
12389,ㅋㅋㄱ/KoreanParticle,8,4,4,4.446124091323389e-05,4.4427660661527865e-05,0.5
12390,코코/Noun,8,4,4,4.446124091323389e-05,4.4427660661527865e-05,0.5
12391,자부심/Noun,8,4,4,4.446124091323389e-05,4.4427660661527865e-05,0.5
12392,하와이/Noun,8,4,4,4.446124091323389e-05,4.4427660661527865e-05,0.5
12393,멘토/Noun,8,4,4,4.446124091323389e-05,4.4427660661527865e-05,0.5
12394,환타/Noun,8,4,4,4.446124091323389e-05,4.4427660661527865e-05,0.5
12395,왈가/Noun,8,4,4,4.446124091323389e-05,4.4427660661527865e-05,0.5
12396,알기/Noun,8,4,4,4.446124091323389e-05,4.4427660661527865e-05,0.5
12397,밥상/Noun,8,4,4,4.446124091323389e-05,4.4427660661527865e-05,0.5
12398,시저/Noun,8,4,4,4.446124091323389e-05,4.4427660661527865e-05,0.5
12399,데이즈/Noun,8,4,4,4.446124091323389e-05,4.4427660661527865e-05,0.5
12400,누명/Noun,8,4,4,4.446124091323389e-05,4.4427660661527865e-05,0.5
12401,태생/Noun,8,4,4,4.446124091323389e-05,4.4427660661527865e-05,0.5
12402,길예르모/Noun,8,4,4,4.446124091323389e-05,4.4427660661527865e-05,0.5
12403,테레사/Noun,8,4,4,4.446124091323389e-05,4.4427660661527865e-05,0.5
12404,글귀/Noun,8,4,4,4.446124091323389e-05,4.4427660661527865e-05,0.5
12405,라즈베리/Noun,7,0,7,0.0,7.774840615767377e-05,1.0
12406,갑지/Noun,7,0,7,0.0,7.774840615767377e-05,1.0
12407,설익다/Verb,7,0,7,0.0,7.774840615767377e-05,1.0
12408,선리기연/Noun,7,7,0,7.78071715981593e-05,0.0,1.0
12409,1500원/Number,7,0,7,0.0,7.774840615767377e-05,1.0
12410,연아/Noun,7,7,0,7.78071715981593e-05,0.0,1.0
12411,음주운전/Noun,7,0,7,0.0,7.774840615767377e-05,1.0
12412,용쟁호투/Noun,7,7,0,7.78071715981593e-05,0.0,1.0
12413,애덜/Noun,7,0,7,0.0,7.774840615767377e-05,1.0
12414,주접/Noun,7,0,7,0.0,7.774840615767377e-05,1.0
12415,심영/Noun,7,7,0,7.78071715981593e-05,0.0,1.0
12416,고은정/Noun,7,0,7,0.0,7.774840615767377e-05,1.0
12417,범수/Noun,7,7,0,7.78071715981593e-05,0.0,1.0
12418,패트레이버/Noun,7,0,7,0.0,7.774840615767377e-05,1.0
12419,진실성/Noun,7,7,0,7.78071715981593e-05,0.0,1.0
12420,관객모독/Noun,7,0,7,0.0,7.774840615767377e-05,1.0
12421,책임자/Noun,7,0,7,0.0,7.774840615767377e-05,1.0
12422,인기투표/Noun,7,0,7,0.0,7.774840615767377e-05,1.0
12423,격동/Noun,7,7,0,7.78071715981593e-05,0.0,1.0
12424,스킨스/Noun,7,7,0,7.78071715981593e-05,0.0,1.0
12425,무늬/Noun,7,0,7,0.0,7.774840615767377e-05,1.0
12426,제야/Noun,7,7,0,7.78071715981593e-05,0.0,1.0
12427,낚였네/Noun,7,0,7,0.0,7.774840615767377e-05,1.0
12428,난또/Noun,7,0,7,0.0,7.774840615767377e-05,1.0
12429,쫄깃쫄깃/Noun,7,7,0,7.78071715981593e-05,0.0,1.0
12430,난데없이/Adverb,7,0,7,0.0,7.774840615767377e-05,1.0
12431,진범/Noun,7,0,7,0.0,7.774840615767377e-05,1.0
12432,해군기지/Noun,7,0,7,0.0,7.774840615767377e-05,1.0
12433,국정원/Noun,7,0,7,0.0,7.774840615767377e-05,1.0
12434,집요하다/Adjective,7,7,0,7.78071715981593e-05,0.0,1.0
12435,날라리/Noun,7,0,7,0.0,7.774840615767377e-05,1.0
12436,맹탕/Noun,7,0,7,0.0,7.774840615767377e-05,1.0
12437,개똥이/Noun,7,0,7,0.0,7.774840615767377e-05,1.0
12438,갈이/Noun,7,0,7,0.0,7.774840615767377e-05,1.0
12439,은수/Noun,7,7,0,7.78071715981593e-05,0.0,1.0
12440,울엇어/Noun,7,7,0,7.78071715981593e-05,0.0,1.0
12441,넌센스/Noun,7,0,7,0.0,7.774840615767377e-05,1.0
12442,입덕/Noun,7,7,0,7.78071715981593e-05,0.0,1.0
12443,회색/Noun,7,7,0,7.78071715981593e-05,0.0,1.0
12444,농구공/Noun,7,0,7,0.0,7.774840615767377e-05,1.0
12445,싸이다/Verb,7,0,7,0.0,7.774840615767377e-05,1.0
12446,판명/Noun,7,0,7,0.0,7.774840615767377e-05,1.0
12447,았음/Noun,7,0,7,0.0,7.774840615767377e-05,1.0
12448,200%/Number,7,7,0,7.78071715981593e-05,0.0,1.0
12449,썩소/Noun,7,0,7,0.0,7.774840615767377e-05,1.0
12450,고지라/Noun,7,0,7,0.0,7.774840615767377e-05,1.0
12451,촉촉하다/Adjective,7,7,0,7.78071715981593e-05,0.0,1.0
12452,모던/Noun,7,7,0,7.78071715981593e-05,0.0,1.0
12453,콩콩콩/Noun,7,0,7,0.0,7.774840615767377e-05,1.0
12454,뭣같/Noun,7,0,7,0.0,7.774840615767377e-05,1.0
12455,반짝이다/Verb,7,7,0,7.78071715981593e-05,0.0,1.0
12456,당나라/Noun,7,0,7,0.0,7.774840615767377e-05,1.0
12457,거세/Noun,7,0,7,0.0,7.774840615767377e-05,1.0
12458,10000원/Number,7,0,7,0.0,7.774840615767377e-05,1.0
12459,고객/Noun,7,0,7,0.0,7.774840615767377e-05,1.0
12460,생존자/Noun,7,0,7,0.0,7.774840615767377e-05,1.0
12461,하앍/Noun,7,7,0,7.78071715981593e-05,0.0,1.0
12462,감염/Noun,7,0,7,0.0,7.774840615767377e-05,1.0
12463,광활하다/Adjective,7,7,0,7.78071715981593e-05,0.0,1.0
12464,will/Alpha,7,7,0,7.78071715981593e-05,0.0,1.0
12465,블랙리스트/Noun,7,0,7,0.0,7.774840615767377e-05,1.0
12466,시름/Noun,7,0,7,0.0,7.774840615767377e-05,1.0
12467,서교/Noun,7,7,0,7.78071715981593e-05,0.0,1.0
12468,차분해지다/Verb,7,7,0,7.78071715981593e-05,0.0,1.0
12469,*_*/Punctuation,7,7,0,7.78071715981593e-05,0.0,1.0
12470,독선/Noun,7,0,7,0.0,7.774840615767377e-05,1.0
12471,정기용/Noun,7,7,0,7.78071715981593e-05,0.0,1.0
12472,엽기적인그녀/Noun,7,0,7,0.0,7.774840615767377e-05,1.0
12473,심쿵하다/Adjective,7,7,0,7.78071715981593e-05,0.0,1.0
12474,김영호/Noun,7,0,7,0.0,7.774840615767377e-05,1.0
12475,아까버/Noun,7,0,7,0.0,7.774840615767377e-05,1.0
12476,까다롭다/Adjective,7,7,0,7.78071715981593e-05,0.0,1.0
12477,정조/Noun,7,7,0,7.78071715981593e-05,0.0,1.0
12478,문학작품/Noun,7,7,0,7.78071715981593e-05,0.0,1.0
12479,우웨볼/Noun,7,0,7,0.0,7.774840615767377e-05,1.0
12480,맘에안듬/Noun,7,0,7,0.0,7.774840615767377e-05,1.0
12481,폐기물/Noun,7,0,7,0.0,7.774840615767377e-05,1.0
12482,돈벌/Noun,7,0,7,0.0,7.774840615767377e-05,1.0
12483,SNS/Alpha,7,7,0,7.78071715981593e-05,0.0,1.0
12484,뇌구조/Noun,7,0,7,0.0,7.774840615767377e-05,1.0
12485,캐빈/Noun,7,7,0,7.78071715981593e-05,0.0,1.0
12486,4-5/Number,7,0,7,0.0,7.774840615767377e-05,1.0
12487,마삼/Noun,7,0,7,0.0,7.774840615767377e-05,1.0
12488,실없다/Adjective,7,0,7,0.0,7.774840615767377e-05,1.0
12489,증폭/Noun,7,0,7,0.0,7.774840615767377e-05,1.0
12490,서브/Noun,7,0,7,0.0,7.774840615767377e-05,1.0
12491,삥/Noun,7,0,7,0.0,7.774840615767377e-05,1.0
12492,-_-..../Punctuation,7,0,7,0.0,7.774840615767377e-05,1.0
12493,희귀/Noun,7,0,7,0.0,7.774840615767377e-05,1.0
12494,신격화/Noun,7,0,7,0.0,7.774840615767377e-05,1.0
12495,담그다/Verb,7,0,7,0.0,7.774840615767377e-05,1.0
12496,껏음/Noun,7,0,7,0.0,7.774840615767377e-05,1.0
12497,절차/Noun,7,0,7,0.0,7.774840615767377e-05,1.0
12498,어우르다/Verb,7,7,0,7.78071715981593e-05,0.0,1.0
12499,재미나다/Noun,7,7,0,7.78071715981593e-05,0.0,1.0
12500,욕함/Noun,7,0,7,0.0,7.774840615767377e-05,1.0
12501,세이모어/Noun,7,7,0,7.78071715981593e-05,0.0,1.0
12502,스프/Noun,7,0,7,0.0,7.774840615767377e-05,1.0
12503,화난/Noun,7,0,7,0.0,7.774840615767377e-05,1.0
12504,내고/Foreign,7,0,7,0.0,7.774840615767377e-05,1.0
12505,한지훈/Noun,7,0,7,0.0,7.774840615767377e-05,1.0
12506,2/3/Number,7,0,7,0.0,7.774840615767377e-05,1.0
12507,나날이/Noun,7,7,0,7.78071715981593e-05,0.0,1.0
12508,Two/Alpha,7,7,0,7.78071715981593e-05,0.0,1.0
12509,만주/Noun,7,0,7,0.0,7.774840615767377e-05,1.0
12510,!~~/Punctuation,7,7,0,7.78071715981593e-05,0.0,1.0
12511,으이구/Exclamation,7,0,7,0.0,7.774840615767377e-05,1.0
12512,서운하다/Adjective,7,7,0,7.78071715981593e-05,0.0,1.0
12513,개별/Noun,7,0,7,0.0,7.774840615767377e-05,1.0
12514,글쎼/Noun,7,1,6,1.1115310228308472e-05,6.66414909922918e-05,0.8571428571428571
12515,강심장/Noun,7,6,1,6.669186136985083e-05,1.1106915165381966e-05,0.8571428571428571
12516,지난날/Noun,7,6,1,6.669186136985083e-05,1.1106915165381966e-05,0.8571428571428571
12517,되돌아가다/Verb,7,6,1,6.669186136985083e-05,1.1106915165381966e-05,0.8571428571428571
12518,걸그룹/Noun,7,1,6,1.1115310228308472e-05,6.66414909922918e-05,0.8571428571428571
12519,흰색/Noun,7,6,1,6.669186136985083e-05,1.1106915165381966e-05,0.8571428571428571
12520,'!/Punctuation,7,6,1,6.669186136985083e-05,1.1106915165381966e-05,0.8571428571428571
12521,노리개/Noun,7,1,6,1.1115310228308472e-05,6.66414909922918e-05,0.8571428571428571
12522,참극/Noun,7,1,6,1.1115310228308472e-05,6.66414909922918e-05,0.8571428571428571
12523,대기/Noun,7,1,6,1.1115310228308472e-05,6.66414909922918e-05,0.8571428571428571
12524,just/Alpha,7,6,1,6.669186136985083e-05,1.1106915165381966e-05,0.8571428571428571
12525,리허설/Noun,7,1,6,1.1115310228308472e-05,6.66414909922918e-05,0.8571428571428571
12526,맵다/Adjective,7,1,6,1.1115310228308472e-05,6.66414909922918e-05,0.8571428571428571
12527,시네마천국/Noun,7,6,1,6.669186136985083e-05,1.1106915165381966e-05,0.8571428571428571
12528,영양가/Noun,7,1,6,1.1115310228308472e-05,6.66414909922918e-05,0.8571428571428571
12529,몰카/Noun,7,1,6,1.1115310228308472e-05,6.66414909922918e-05,0.8571428571428571
12530,까닭/Noun,7,1,6,1.1115310228308472e-05,6.66414909922918e-05,0.8571428571428571
12531,이응경/Noun,7,1,6,1.1115310228308472e-05,6.66414909922918e-05,0.8571428571428571
12532,조소/Noun,7,6,1,6.669186136985083e-05,1.1106915165381966e-05,0.8571428571428571
12533,우먼/Noun,7,6,1,6.669186136985083e-05,1.1106915165381966e-05,0.8571428571428571
12534,떔/Noun,7,6,1,6.669186136985083e-05,1.1106915165381966e-05,0.8571428571428571
12535,For/Alpha,7,6,1,6.669186136985083e-05,1.1106915165381966e-05,0.8571428571428571
12536,릿카/Noun,7,6,1,6.669186136985083e-05,1.1106915165381966e-05,0.8571428571428571
12537,신사참배/Noun,7,1,6,1.1115310228308472e-05,6.66414909922918e-05,0.8571428571428571
12538,낮잠/Noun,7,1,6,1.1115310228308472e-05,6.66414909922918e-05,0.8571428571428571
12539,재탄생/Noun,7,6,1,6.669186136985083e-05,1.1106915165381966e-05,0.8571428571428571
12540,건축학개론/Noun,7,6,1,6.669186136985083e-05,1.1106915165381966e-05,0.8571428571428571
12541,칼날/Noun,7,1,6,1.1115310228308472e-05,6.66414909922918e-05,0.8571428571428571
12542,애마부인/Noun,7,1,6,1.1115310228308472e-05,6.66414909922918e-05,0.8571428571428571
12543,테리/Noun,7,6,1,6.669186136985083e-05,1.1106915165381966e-05,0.8571428571428571
12544,이산가족/Noun,7,6,1,6.669186136985083e-05,1.1106915165381966e-05,0.8571428571428571
12545,진절머리/Noun,7,1,6,1.1115310228308472e-05,6.66414909922918e-05,0.8571428571428571
12546,족보/Noun,7,1,6,1.1115310228308472e-05,6.66414909922918e-05,0.8571428571428571
12547,와장창/Adverb,7,1,6,1.1115310228308472e-05,6.66414909922918e-05,0.8571428571428571
12548,승려/Noun,7,1,6,1.1115310228308472e-05,6.66414909922918e-05,0.8571428571428571
12549,이함/Noun,7,6,1,6.669186136985083e-05,1.1106915165381966e-05,0.8571428571428571
12550,힐튼/Noun,7,1,6,1.1115310228308472e-05,6.66414909922918e-05,0.8571428571428571
12551,알란/Noun,7,6,1,6.669186136985083e-05,1.1106915165381966e-05,0.8571428571428571
12552,구질구질하다/Adjective,7,1,6,1.1115310228308472e-05,6.66414909922918e-05,0.8571428571428571
12553,잠기/Noun,7,6,1,6.669186136985083e-05,1.1106915165381966e-05,0.8571428571428571
12554,화양연화/Noun,7,6,1,6.669186136985083e-05,1.1106915165381966e-05,0.8571428571428571
12555,현자/Noun,7,1,6,1.1115310228308472e-05,6.66414909922918e-05,0.8571428571428571
12556,몽상가/Noun,7,6,1,6.669186136985083e-05,1.1106915165381966e-05,0.8571428571428571
12557,시크릿가든/Noun,7,6,1,6.669186136985083e-05,1.1106915165381966e-05,0.8571428571428571
12558,샴/Noun,7,1,6,1.1115310228308472e-05,6.66414909922918e-05,0.8571428571428571
12559,도수코/Noun,7,1,6,1.1115310228308472e-05,6.66414909922918e-05,0.8571428571428571
12560,버지니아/Noun,7,6,1,6.669186136985083e-05,1.1106915165381966e-05,0.8571428571428571
12561,게더/Noun,7,6,1,6.669186136985083e-05,1.1106915165381966e-05,0.8571428571428571
12562,운남/Noun,7,6,1,6.669186136985083e-05,1.1106915165381966e-05,0.8571428571428571
12563,멘탈붕괴/Noun,7,1,6,1.1115310228308472e-05,6.66414909922918e-05,0.8571428571428571
12564,승기/Noun,7,6,1,6.669186136985083e-05,1.1106915165381966e-05,0.8571428571428571
12565,전염/Noun,7,1,6,1.1115310228308472e-05,6.66414909922918e-05,0.8571428571428571
12566,쩌는듯/Noun,7,6,1,6.669186136985083e-05,1.1106915165381966e-05,0.8571428571428571
12567,붓다/Noun,7,1,6,1.1115310228308472e-05,6.66414909922918e-05,0.8571428571428571
12568,이목/Noun,7,1,6,1.1115310228308472e-05,6.66414909922918e-05,0.8571428571428571
12569,호날두/Noun,7,1,6,1.1115310228308472e-05,6.66414909922918e-05,0.8571428571428571
12570,부릅뜨다/Verb,7,1,6,1.1115310228308472e-05,6.66414909922918e-05,0.8571428571428571
12571,?????????/Punctuation,7,1,6,1.1115310228308472e-05,6.66414909922918e-05,0.8571428571428571
12572,묵시/Noun,7,6,1,6.669186136985083e-05,1.1106915165381966e-05,0.8571428571428571
12573,알아차리다/Verb,7,1,6,1.1115310228308472e-05,6.66414909922918e-05,0.8571428571428571
12574,혐한/Noun,7,1,6,1.1115310228308472e-05,6.66414909922918e-05,0.8571428571428571
12575,신혜/Noun,7,6,1,6.669186136985083e-05,1.1106915165381966e-05,0.8571428571428571
12576,유라/Noun,7,1,6,1.1115310228308472e-05,6.66414909922918e-05,0.8571428571428571
12577,휩싸이다/Verb,7,6,1,6.669186136985083e-05,1.1106915165381966e-05,0.8571428571428571
12578,박근형/Noun,7,6,1,6.669186136985083e-05,1.1106915165381966e-05,0.8571428571428571
12579,김준/Noun,7,6,1,6.669186136985083e-05,1.1106915165381966e-05,0.8571428571428571
12580,25분/Number,7,1,6,1.1115310228308472e-05,6.66414909922918e-05,0.8571428571428571
12581,찬찬하다/Adjective,7,6,1,6.669186136985083e-05,1.1106915165381966e-05,0.8571428571428571
12582,핑크/Noun,7,6,1,6.669186136985083e-05,1.1106915165381966e-05,0.8571428571428571
12583,ㄱㅐ/KoreanParticle,7,1,6,1.1115310228308472e-05,6.66414909922918e-05,0.8571428571428571
12584,비글/Noun,7,6,1,6.669186136985083e-05,1.1106915165381966e-05,0.8571428571428571
12585,으/Noun,7,1,6,1.1115310228308472e-05,6.66414909922918e-05,0.8571428571428571
12586,공인/Noun,7,1,6,1.1115310228308472e-05,6.66414909922918e-05,0.8571428571428571
12587,인력/Noun,7,1,6,1.1115310228308472e-05,6.66414909922918e-05,0.8571428571428571
12588,시설/Noun,7,1,6,1.1115310228308472e-05,6.66414909922918e-05,0.8571428571428571
12589,맹세/Noun,7,1,6,1.1115310228308472e-05,6.66414909922918e-05,0.8571428571428571
12590,밤새/Noun,7,6,1,6.669186136985083e-05,1.1106915165381966e-05,0.8571428571428571
12591,가업/Noun,7,1,6,1.1115310228308472e-05,6.66414909922918e-05,0.8571428571428571
12592,정장/Noun,7,6,1,6.669186136985083e-05,1.1106915165381966e-05,0.8571428571428571
12593,강호/Noun,7,6,1,6.669186136985083e-05,1.1106915165381966e-05,0.8571428571428571
12594,NC/Alpha,7,1,6,1.1115310228308472e-05,6.66414909922918e-05,0.8571428571428571
12595,빗/Noun,7,6,1,6.669186136985083e-05,1.1106915165381966e-05,0.8571428571428571
12596,주무/Noun,7,1,6,1.1115310228308472e-05,6.66414909922918e-05,0.8571428571428571
12597,주도하다/Adjective,7,6,1,6.669186136985083e-05,1.1106915165381966e-05,0.8571428571428571
12598,츄/Noun,7,1,6,1.1115310228308472e-05,6.66414909922918e-05,0.8571428571428571
12599,안드/Noun,7,1,6,1.1115310228308472e-05,6.66414909922918e-05,0.8571428571428571
12600,변형/Noun,7,1,6,1.1115310228308472e-05,6.66414909922918e-05,0.8571428571428571
12601,지장/Noun,7,1,6,1.1115310228308472e-05,6.66414909922918e-05,0.8571428571428571
12602,인생관/Noun,7,6,1,6.669186136985083e-05,1.1106915165381966e-05,0.8571428571428571
12603,꺼이꺼이/Adverb,7,6,1,6.669186136985083e-05,1.1106915165381966e-05,0.8571428571428571
12604,메타포/Noun,7,6,1,6.669186136985083e-05,1.1106915165381966e-05,0.8571428571428571
12605,^^./Punctuation,7,6,1,6.669186136985083e-05,1.1106915165381966e-05,0.8571428571428571
12606,크리처/Noun,7,1,6,1.1115310228308472e-05,6.66414909922918e-05,0.8571428571428571
12607,헨젤/Noun,7,1,6,1.1115310228308472e-05,6.66414909922918e-05,0.8571428571428571
12608,지지다/Verb,7,1,6,1.1115310228308472e-05,6.66414909922918e-05,0.8571428571428571
12609,패션쇼/Noun,7,1,6,1.1115310228308472e-05,6.66414909922918e-05,0.8571428571428571
12610,클린/Noun,7,6,1,6.669186136985083e-05,1.1106915165381966e-05,0.8571428571428571
12611,기고/Noun,7,1,6,1.1115310228308472e-05,6.66414909922918e-05,0.8571428571428571
12612,근사하다/Adjective,7,6,1,6.669186136985083e-05,1.1106915165381966e-05,0.8571428571428571
12613,힘쓰다/Verb,7,6,1,6.669186136985083e-05,1.1106915165381966e-05,0.8571428571428571
12614,벨트/Noun,7,1,6,1.1115310228308472e-05,6.66414909922918e-05,0.8571428571428571
12615,따분/Noun,7,1,6,1.1115310228308472e-05,6.66414909922918e-05,0.8571428571428571
12616,순환/Noun,7,6,1,6.669186136985083e-05,1.1106915165381966e-05,0.8571428571428571
12617,소스코드/Noun,7,1,6,1.1115310228308472e-05,6.66414909922918e-05,0.8571428571428571
12618,탁월/Noun,7,6,1,6.669186136985083e-05,1.1106915165381966e-05,0.8571428571428571
12619,오드리햅번/Noun,7,6,1,6.669186136985083e-05,1.1106915165381966e-05,0.8571428571428571
12620,음악가/Noun,7,6,1,6.669186136985083e-05,1.1106915165381966e-05,0.8571428571428571
12621,현영/Noun,7,1,6,1.1115310228308472e-05,6.66414909922918e-05,0.8571428571428571
12622,야박하다/Adjective,7,6,1,6.669186136985083e-05,1.1106915165381966e-05,0.8571428571428571
12623,더볼/Noun,7,6,1,6.669186136985083e-05,1.1106915165381966e-05,0.8571428571428571
12624,가족사/Noun,7,6,1,6.669186136985083e-05,1.1106915165381966e-05,0.8571428571428571
12625,터닝/Noun,7,6,1,6.669186136985083e-05,1.1106915165381966e-05,0.8571428571428571
12626,소령/Noun,7,6,1,6.669186136985083e-05,1.1106915165381966e-05,0.8571428571428571
12627,God/Alpha,7,6,1,6.669186136985083e-05,1.1106915165381966e-05,0.8571428571428571
12628,감자/Noun,7,6,1,6.669186136985083e-05,1.1106915165381966e-05,0.8571428571428571
12629,조루/Noun,7,1,6,1.1115310228308472e-05,6.66414909922918e-05,0.8571428571428571
12630,송해성/Noun,7,1,6,1.1115310228308472e-05,6.66414909922918e-05,0.8571428571428571
12631,어는/Modifier,7,1,6,1.1115310228308472e-05,6.66414909922918e-05,0.8571428571428571
12632,퇴장/Noun,7,1,6,1.1115310228308472e-05,6.66414909922918e-05,0.8571428571428571
12633,브랜든리/Noun,7,1,6,1.1115310228308472e-05,6.66414909922918e-05,0.8571428571428571
12634,으음/Exclamation,7,1,6,1.1115310228308472e-05,6.66414909922918e-05,0.8571428571428571
12635,통치/Noun,7,6,1,6.669186136985083e-05,1.1106915165381966e-05,0.8571428571428571
12636,아라하/Noun,7,6,1,6.669186136985083e-05,1.1106915165381966e-05,0.8571428571428571
12637,어우동/Noun,7,1,6,1.1115310228308472e-05,6.66414909922918e-05,0.8571428571428571
12638,27분/Number,7,1,6,1.1115310228308472e-05,6.66414909922918e-05,0.8571428571428571
12639,꽤볼/Noun,7,6,1,6.669186136985083e-05,1.1106915165381966e-05,0.8571428571428571
12640,서핑/Noun,7,6,1,6.669186136985083e-05,1.1106915165381966e-05,0.8571428571428571
12641,불쾌/Noun,7,1,6,1.1115310228308472e-05,6.66414909922918e-05,0.8571428571428571
12642,인투더/Noun,7,1,6,1.1115310228308472e-05,6.66414909922918e-05,0.8571428571428571
12643,주먹질/Noun,7,1,6,1.1115310228308472e-05,6.66414909922918e-05,0.8571428571428571
12644,편안/Noun,7,6,1,6.669186136985083e-05,1.1106915165381966e-05,0.8571428571428571
12645,사보다/Verb,7,6,1,6.669186136985083e-05,1.1106915165381966e-05,0.8571428571428571
12646,립싱크/Noun,7,1,6,1.1115310228308472e-05,6.66414909922918e-05,0.8571428571428571
12647,수장/Noun,7,1,6,1.1115310228308472e-05,6.66414909922918e-05,0.8571428571428571
12648,~`/Punctuation,7,6,1,6.669186136985083e-05,1.1106915165381966e-05,0.8571428571428571
12649,너므/Noun,7,6,1,6.669186136985083e-05,1.1106915165381966e-05,0.8571428571428571
12650,비슷비슷/Noun,7,1,6,1.1115310228308472e-05,6.66414909922918e-05,0.8571428571428571
12651,마침표/Noun,7,6,1,6.669186136985083e-05,1.1106915165381966e-05,0.8571428571428571
12652,......................./Punctuation,7,1,6,1.1115310228308472e-05,6.66414909922918e-05,0.8571428571428571
12653,므흣/Noun,7,6,1,6.669186136985083e-05,1.1106915165381966e-05,0.8571428571428571
12654,뭐함/Noun,7,1,6,1.1115310228308472e-05,6.66414909922918e-05,0.8571428571428571
12655,배트/Noun,7,1,6,1.1115310228308472e-05,6.66414909922918e-05,0.8571428571428571
12656,분과/Noun,7,6,1,6.669186136985083e-05,1.1106915165381966e-05,0.8571428571428571
12657,진동/Noun,7,1,6,1.1115310228308472e-05,6.66414909922918e-05,0.8571428571428571
12658,내기억/Noun,7,6,1,6.669186136985083e-05,1.1106915165381966e-05,0.8571428571428571
12659,크로노스/Noun,7,1,6,1.1115310228308472e-05,6.66414909922918e-05,0.8571428571428571
12660,더디다/Verb,7,1,6,1.1115310228308472e-05,6.66414909922918e-05,0.8571428571428571
12661,주근깨/Noun,7,6,1,6.669186136985083e-05,1.1106915165381966e-05,0.8571428571428571
12662,쩡/Noun,7,6,1,6.669186136985083e-05,1.1106915165381966e-05,0.8571428571428571
12663,ㅡㅅㅡ/KoreanParticle,7,1,6,1.1115310228308472e-05,6.66414909922918e-05,0.8571428571428571
12664,뻗치다/Verb,7,1,6,1.1115310228308472e-05,6.66414909922918e-05,0.8571428571428571
12665,애자/Noun,7,1,6,1.1115310228308472e-05,6.66414909922918e-05,0.8571428571428571
12666,2015/Number,7,6,1,6.669186136985083e-05,1.1106915165381966e-05,0.8571428571428571
12667,소용돌이/Noun,7,6,1,6.669186136985083e-05,1.1106915165381966e-05,0.8571428571428571
12668,근대사/Noun,7,6,1,6.669186136985083e-05,1.1106915165381966e-05,0.8571428571428571
12669,교향곡/Noun,7,6,1,6.669186136985083e-05,1.1106915165381966e-05,0.8571428571428571
12670,화차/Noun,7,1,6,1.1115310228308472e-05,6.66414909922918e-05,0.8571428571428571
12671,니나/Noun,7,1,6,1.1115310228308472e-05,6.66414909922918e-05,0.8571428571428571
12672,15일/Number,7,6,1,6.669186136985083e-05,1.1106915165381966e-05,0.8571428571428571
12673,객관성/Noun,7,1,6,1.1115310228308472e-05,6.66414909922918e-05,0.8571428571428571
12674,re/Alpha,7,6,1,6.669186136985083e-05,1.1106915165381966e-05,0.8571428571428571
12675,화원/Noun,7,6,1,6.669186136985083e-05,1.1106915165381966e-05,0.8571428571428571
12676,시상식/Noun,7,1,6,1.1115310228308472e-05,6.66414909922918e-05,0.8571428571428571
12677,되풀이/Noun,7,6,1,6.669186136985083e-05,1.1106915165381966e-05,0.8571428571428571
12678,신세/Noun,7,1,6,1.1115310228308472e-05,6.66414909922918e-05,0.8571428571428571
12679,시전/Noun,7,1,6,1.1115310228308472e-05,6.66414909922918e-05,0.8571428571428571
12680,훈/Noun,7,6,1,6.669186136985083e-05,1.1106915165381966e-05,0.8571428571428571
12681,대재앙/Noun,7,1,6,1.1115310228308472e-05,6.66414909922918e-05,0.8571428571428571
12682,성매매/Noun,7,1,6,1.1115310228308472e-05,6.66414909922918e-05,0.8571428571428571
12683,-_-?/Punctuation,7,1,6,1.1115310228308472e-05,6.66414909922918e-05,0.8571428571428571
12684,엊그제/Noun,7,6,1,6.669186136985083e-05,1.1106915165381966e-05,0.8571428571428571
12685,타이거/Noun,7,6,1,6.669186136985083e-05,1.1106915165381966e-05,0.8571428571428571
12686,Who/Alpha,7,6,1,6.669186136985083e-05,1.1106915165381966e-05,0.8571428571428571
12687,통증/Noun,7,1,6,1.1115310228308472e-05,6.66414909922918e-05,0.8571428571428571
12688,눈쌀/Noun,7,1,6,1.1115310228308472e-05,6.66414909922918e-05,0.8571428571428571
12689,얹히다/Verb,7,1,6,1.1115310228308472e-05,6.66414909922918e-05,0.8571428571428571
12690,난이도/Noun,7,1,6,1.1115310228308472e-05,6.66414909922918e-05,0.8571428571428571
12691,메일/Noun,7,6,1,6.669186136985083e-05,1.1106915165381966e-05,0.8571428571428571
12692,유리창/Noun,7,6,1,6.669186136985083e-05,1.1106915165381966e-05,0.8571428571428571
12693,컴퓨터그래픽/Noun,7,1,6,1.1115310228308472e-05,6.66414909922918e-05,0.8571428571428571
12694,jyj/Alpha,7,6,1,6.669186136985083e-05,1.1106915165381966e-05,0.8571428571428571
12695,사무치다/Verb,7,6,1,6.669186136985083e-05,1.1106915165381966e-05,0.8571428571428571
12696,예찬/Noun,7,1,6,1.1115310228308472e-05,6.66414909922918e-05,0.8571428571428571
12697,전장/Noun,7,6,1,6.669186136985083e-05,1.1106915165381966e-05,0.8571428571428571
12698,읎드다/Verb,7,1,6,1.1115310228308472e-05,6.66414909922918e-05,0.8571428571428571
12699,요강/Noun,7,6,1,6.669186136985083e-05,1.1106915165381966e-05,0.8571428571428571
12700,채림/Noun,7,6,1,6.669186136985083e-05,1.1106915165381966e-05,0.8571428571428571
12701,데이비드/Noun,7,6,1,6.669186136985083e-05,1.1106915165381966e-05,0.8571428571428571
12702,이십/Modifier,7,6,1,6.669186136985083e-05,1.1106915165381966e-05,0.8571428571428571
12703,옛사랑/Noun,7,6,1,6.669186136985083e-05,1.1106915165381966e-05,0.8571428571428571
12704,안야/Noun,7,1,6,1.1115310228308472e-05,6.66414909922918e-05,0.8571428571428571
12705,데이지/Noun,7,6,1,6.669186136985083e-05,1.1106915165381966e-05,0.8571428571428571
12706,주차/Noun,7,1,6,1.1115310228308472e-05,6.66414909922918e-05,0.8571428571428571
12707,집밥/Noun,7,1,6,1.1115310228308472e-05,6.66414909922918e-05,0.8571428571428571
12708,각기/Noun,7,6,1,6.669186136985083e-05,1.1106915165381966e-05,0.8571428571428571
12709,감미/Noun,7,6,1,6.669186136985083e-05,1.1106915165381966e-05,0.8571428571428571
12710,중시/Noun,7,6,1,6.669186136985083e-05,1.1106915165381966e-05,0.8571428571428571
12711,꿋꿋하다/Adjective,7,6,1,6.669186136985083e-05,1.1106915165381966e-05,0.8571428571428571
12712,푸르다/Adjective,7,6,1,6.669186136985083e-05,1.1106915165381966e-05,0.8571428571428571
12713,호스트/Noun,7,1,6,1.1115310228308472e-05,6.66414909922918e-05,0.8571428571428571
12714,수꼴/Noun,7,1,6,1.1115310228308472e-05,6.66414909922918e-05,0.8571428571428571
12715,공신/Noun,7,1,6,1.1115310228308472e-05,6.66414909922918e-05,0.8571428571428571
12716,상콤/Noun,7,6,1,6.669186136985083e-05,1.1106915165381966e-05,0.8571428571428571
12717,깜깜/Noun,7,1,6,1.1115310228308472e-05,6.66414909922918e-05,0.8571428571428571
12718,사격/Noun,7,1,6,1.1115310228308472e-05,6.66414909922918e-05,0.8571428571428571
12719,스타트렉/Noun,7,6,1,6.669186136985083e-05,1.1106915165381966e-05,0.8571428571428571
12720,김유미/Noun,7,6,1,6.669186136985083e-05,1.1106915165381966e-05,0.8571428571428571
12721,마코/Noun,7,6,1,6.669186136985083e-05,1.1106915165381966e-05,0.8571428571428571
12722,서지석/Noun,7,1,6,1.1115310228308472e-05,6.66414909922918e-05,0.8571428571428571
12723,진행중/Noun,7,6,1,6.669186136985083e-05,1.1106915165381966e-05,0.8571428571428571
12724,LOVE/Alpha,7,6,1,6.669186136985083e-05,1.1106915165381966e-05,0.8571428571428571
12725,후에/Foreign,7,6,1,6.669186136985083e-05,1.1106915165381966e-05,0.8571428571428571
12726,무정도시/Noun,7,6,1,6.669186136985083e-05,1.1106915165381966e-05,0.8571428571428571
12727,이토준지/Noun,7,1,6,1.1115310228308472e-05,6.66414909922918e-05,0.8571428571428571
12728,조이/Noun,7,6,1,6.669186136985083e-05,1.1106915165381966e-05,0.8571428571428571
12729,동물원/Noun,7,6,1,6.669186136985083e-05,1.1106915165381966e-05,0.8571428571428571
12730,쏠쏠/Noun,7,6,1,6.669186136985083e-05,1.1106915165381966e-05,0.8571428571428571
12731,인/Foreign,7,6,1,6.669186136985083e-05,1.1106915165381966e-05,0.8571428571428571
12732,백만배/Noun,7,1,6,1.1115310228308472e-05,6.66414909922918e-05,0.8571428571428571
12733,협찬/Noun,7,1,6,1.1115310228308472e-05,6.66414909922918e-05,0.8571428571428571
12734,상책/Noun,7,1,6,1.1115310228308472e-05,6.66414909922918e-05,0.8571428571428571
12735,PPL/Alpha,7,1,6,1.1115310228308472e-05,6.66414909922918e-05,0.8571428571428571
12736,주랑/Noun,7,6,1,6.669186136985083e-05,1.1106915165381966e-05,0.8571428571428571
12737,유두/Noun,7,1,6,1.1115310228308472e-05,6.66414909922918e-05,0.8571428571428571
12738,캐머런/Noun,7,6,1,6.669186136985083e-05,1.1106915165381966e-05,0.8571428571428571
12739,똥물/Noun,7,1,6,1.1115310228308472e-05,6.66414909922918e-05,0.8571428571428571
12740,삼고/Noun,7,6,1,6.669186136985083e-05,1.1106915165381966e-05,0.8571428571428571
12741,노도/Noun,7,6,1,6.669186136985083e-05,1.1106915165381966e-05,0.8571428571428571
12742,크리스챤/Noun,7,6,1,6.669186136985083e-05,1.1106915165381966e-05,0.8571428571428571
12743,9.1/Number,7,6,1,6.669186136985083e-05,1.1106915165381966e-05,0.8571428571428571
12744,이진욱/Noun,7,6,1,6.669186136985083e-05,1.1106915165381966e-05,0.8571428571428571
12745,김지현/Noun,7,1,6,1.1115310228308472e-05,6.66414909922918e-05,0.8571428571428571
12746,공연장/Noun,7,6,1,6.669186136985083e-05,1.1106915165381966e-05,0.8571428571428571
12747,모짜르트/Noun,7,6,1,6.669186136985083e-05,1.1106915165381966e-05,0.8571428571428571
12748,천군/Noun,7,1,6,1.1115310228308472e-05,6.66414909922918e-05,0.8571428571428571
12749,타가/Noun,7,6,1,6.669186136985083e-05,1.1106915165381966e-05,0.8571428571428571
12750,원내/Noun,7,1,6,1.1115310228308472e-05,6.66414909922918e-05,0.8571428571428571
12751,쟁취/Noun,7,6,1,6.669186136985083e-05,1.1106915165381966e-05,0.8571428571428571
12752,아하하/Adverb,7,1,6,1.1115310228308472e-05,6.66414909922918e-05,0.8571428571428571
12753,똥통/Noun,7,1,6,1.1115310228308472e-05,6.66414909922918e-05,0.8571428571428571
12754,모이/Noun,7,6,1,6.669186136985083e-05,1.1106915165381966e-05,0.8571428571428571
12755,정찬/Noun,7,1,6,1.1115310228308472e-05,6.66414909922918e-05,0.8571428571428571
12756,염소/Noun,7,6,1,6.669186136985083e-05,1.1106915165381966e-05,0.8571428571428571
12757,적막하다/Adjective,7,6,1,6.669186136985083e-05,1.1106915165381966e-05,0.8571428571428571
12758,비뚤어지다/Verb,7,1,6,1.1115310228308472e-05,6.66414909922918e-05,0.8571428571428571
12759,밍숭맹숭/Noun,7,1,6,1.1115310228308472e-05,6.66414909922918e-05,0.8571428571428571
12760,바고/Noun,7,6,1,6.669186136985083e-05,1.1106915165381966e-05,0.8571428571428571
12761,전쯤/Foreign,7,6,1,6.669186136985083e-05,1.1106915165381966e-05,0.8571428571428571
12762,왜구/Noun,7,1,6,1.1115310228308472e-05,6.66414909922918e-05,0.8571428571428571
12763,자멸/Noun,7,1,6,1.1115310228308472e-05,6.66414909922918e-05,0.8571428571428571
12764,말레나/Noun,7,5,2,5.557655114154236e-05,2.2213830330763933e-05,0.7142857142857143
12765,연약하다/Adjective,7,5,2,5.557655114154236e-05,2.2213830330763933e-05,0.7142857142857143
12766,운석/Noun,7,2,5,2.2230620456616944e-05,5.5534575826909837e-05,0.7142857142857143
12767,가제/Noun,7,5,2,5.557655114154236e-05,2.2213830330763933e-05,0.7142857142857143
12768,민국이/Noun,7,2,5,2.2230620456616944e-05,5.5534575826909837e-05,0.7142857142857143
12769,안드레이/Noun,7,5,2,5.557655114154236e-05,2.2213830330763933e-05,0.7142857142857143
12770,실마리/Noun,7,2,5,2.2230620456616944e-05,5.5534575826909837e-05,0.7142857142857143
12771,할렐루야/Noun,7,5,2,5.557655114154236e-05,2.2213830330763933e-05,0.7142857142857143
12772,리모콘/Noun,7,2,5,2.2230620456616944e-05,5.5534575826909837e-05,0.7142857142857143
12773,박형식/Noun,7,5,2,5.557655114154236e-05,2.2213830330763933e-05,0.7142857142857143
12774,허용/Noun,7,2,5,2.2230620456616944e-05,5.5534575826909837e-05,0.7142857142857143
12775,분출/Noun,7,5,2,5.557655114154236e-05,2.2213830330763933e-05,0.7142857142857143
12776,쥬리/Noun,7,2,5,2.2230620456616944e-05,5.5534575826909837e-05,0.7142857142857143
12777,뇌물/Noun,7,2,5,2.2230620456616944e-05,5.5534575826909837e-05,0.7142857142857143
12778,김남주/Noun,7,2,5,2.2230620456616944e-05,5.5534575826909837e-05,0.7142857142857143
12779,확확/Adverb,7,5,2,5.557655114154236e-05,2.2213830330763933e-05,0.7142857142857143
12780,진용/Noun,7,2,5,2.2230620456616944e-05,5.5534575826909837e-05,0.7142857142857143
12781,천식/Noun,7,2,5,2.2230620456616944e-05,5.5534575826909837e-05,0.7142857142857143
12782,동선/Noun,7,2,5,2.2230620456616944e-05,5.5534575826909837e-05,0.7142857142857143
12783,뒷골목/Noun,7,5,2,5.557655114154236e-05,2.2213830330763933e-05,0.7142857142857143
12784,점철/Noun,7,2,5,2.2230620456616944e-05,5.5534575826909837e-05,0.7142857142857143
12785,가젤/Noun,7,2,5,2.2230620456616944e-05,5.5534575826909837e-05,0.7142857142857143
12786,몸서리/Noun,7,5,2,5.557655114154236e-05,2.2213830330763933e-05,0.7142857142857143
12787,정도영/Noun,7,2,5,2.2230620456616944e-05,5.5534575826909837e-05,0.7142857142857143
12788,기겁/Noun,7,2,5,2.2230620456616944e-05,5.5534575826909837e-05,0.7142857142857143
12789,어어/Exclamation,7,5,2,5.557655114154236e-05,2.2213830330763933e-05,0.7142857142857143
12790,지영/Noun,7,5,2,5.557655114154236e-05,2.2213830330763933e-05,0.7142857142857143
12791,라우/Noun,7,5,2,5.557655114154236e-05,2.2213830330763933e-05,0.7142857142857143
12792,오현민/Noun,7,5,2,5.557655114154236e-05,2.2213830330763933e-05,0.7142857142857143
12793,언스/Noun,7,2,5,2.2230620456616944e-05,5.5534575826909837e-05,0.7142857142857143
12794,말미/Noun,7,5,2,5.557655114154236e-05,2.2213830330763933e-05,0.7142857142857143
12795,공작/Noun,7,2,5,2.2230620456616944e-05,5.5534575826909837e-05,0.7142857142857143
12796,김슬기/Noun,7,5,2,5.557655114154236e-05,2.2213830330763933e-05,0.7142857142857143
12797,일시/Noun,7,5,2,5.557655114154236e-05,2.2213830330763933e-05,0.7142857142857143
12798,학부모/Noun,7,5,2,5.557655114154236e-05,2.2213830330763933e-05,0.7142857142857143
12799,광복절/Noun,7,5,2,5.557655114154236e-05,2.2213830330763933e-05,0.7142857142857143
12800,물음표/Noun,7,2,5,2.2230620456616944e-05,5.5534575826909837e-05,0.7142857142857143
12801,치즈루/Noun,7,5,2,5.557655114154236e-05,2.2213830330763933e-05,0.7142857142857143
12802,제비/Noun,7,2,5,2.2230620456616944e-05,5.5534575826909837e-05,0.7142857142857143
12803,일본엔/Noun,7,2,5,2.2230620456616944e-05,5.5534575826909837e-05,0.7142857142857143
12804,자전/Noun,7,5,2,5.557655114154236e-05,2.2213830330763933e-05,0.7142857142857143
12805,28분/Number,7,2,5,2.2230620456616944e-05,5.5534575826909837e-05,0.7142857142857143
12806,병구/Noun,7,5,2,5.557655114154236e-05,2.2213830330763933e-05,0.7142857142857143
12807,탄성/Noun,7,5,2,5.557655114154236e-05,2.2213830330763933e-05,0.7142857142857143
12808,낄낄대다/Verb,7,2,5,2.2230620456616944e-05,5.5534575826909837e-05,0.7142857142857143
12809,근현대사/Noun,7,5,2,5.557655114154236e-05,2.2213830330763933e-05,0.7142857142857143
12810,흡사/Noun,7,5,2,5.557655114154236e-05,2.2213830330763933e-05,0.7142857142857143
12811,투하/Noun,7,2,5,2.2230620456616944e-05,5.5534575826909837e-05,0.7142857142857143
12812,김선영/Noun,7,2,5,2.2230620456616944e-05,5.5534575826909837e-05,0.7142857142857143
12813,러시아워/Noun,7,5,2,5.557655114154236e-05,2.2213830330763933e-05,0.7142857142857143
12814,전격/Noun,7,5,2,5.557655114154236e-05,2.2213830330763933e-05,0.7142857142857143
12815,내야/Noun,7,2,5,2.2230620456616944e-05,5.5534575826909837e-05,0.7142857142857143
12816,조권/Noun,7,5,2,5.557655114154236e-05,2.2213830330763933e-05,0.7142857142857143
12817,유다인/Noun,7,5,2,5.557655114154236e-05,2.2213830330763933e-05,0.7142857142857143
12818,쿠나/Noun,7,5,2,5.557655114154236e-05,2.2213830330763933e-05,0.7142857142857143
12819,의천도룡기/Noun,7,5,2,5.557655114154236e-05,2.2213830330763933e-05,0.7142857142857143
12820,마코토/Noun,7,5,2,5.557655114154236e-05,2.2213830330763933e-05,0.7142857142857143
12821,안일하다/Adjective,7,2,5,2.2230620456616944e-05,5.5534575826909837e-05,0.7142857142857143
12822,줄곧/Noun,7,2,5,2.2230620456616944e-05,5.5534575826909837e-05,0.7142857142857143
12823,키시/Noun,7,2,5,2.2230620456616944e-05,5.5534575826909837e-05,0.7142857142857143
12824,마츠야/Noun,7,5,2,5.557655114154236e-05,2.2213830330763933e-05,0.7142857142857143
12825,성용/Noun,7,2,5,2.2230620456616944e-05,5.5534575826909837e-05,0.7142857142857143
12826,작붕/Noun,7,2,5,2.2230620456616944e-05,5.5534575826909837e-05,0.7142857142857143
12827,파가니니/Noun,7,2,5,2.2230620456616944e-05,5.5534575826909837e-05,0.7142857142857143
12828,렵니/Noun,7,5,2,5.557655114154236e-05,2.2213830330763933e-05,0.7142857142857143
12829,오렌지/Noun,7,5,2,5.557655114154236e-05,2.2213830330763933e-05,0.7142857142857143
12830,지시/Noun,7,2,5,2.2230620456616944e-05,5.5534575826909837e-05,0.7142857142857143
12831,마이걸/Noun,7,5,2,5.557655114154236e-05,2.2213830330763933e-05,0.7142857142857143
12832,특수분장/Noun,7,2,5,2.2230620456616944e-05,5.5534575826909837e-05,0.7142857142857143
12833,무자식/Noun,7,2,5,2.2230620456616944e-05,5.5534575826909837e-05,0.7142857142857143
12834,김성은/Noun,7,2,5,2.2230620456616944e-05,5.5534575826909837e-05,0.7142857142857143
12835,수퍼액션/Noun,7,2,5,2.2230620456616944e-05,5.5534575826909837e-05,0.7142857142857143
12836,빙하/Noun,7,2,5,2.2230620456616944e-05,5.5534575826909837e-05,0.7142857142857143
12837,기진/Noun,7,2,5,2.2230620456616944e-05,5.5534575826909837e-05,0.7142857142857143
12838,조가/Noun,7,2,5,2.2230620456616944e-05,5.5534575826909837e-05,0.7142857142857143
12839,더위/Noun,7,5,2,5.557655114154236e-05,2.2213830330763933e-05,0.7142857142857143
12840,영춘권/Noun,7,2,5,2.2230620456616944e-05,5.5534575826909837e-05,0.7142857142857143
12841,심란하다/Adjective,7,2,5,2.2230620456616944e-05,5.5534575826909837e-05,0.7142857142857143
12842,독재자/Noun,7,5,2,5.557655114154236e-05,2.2213830330763933e-05,0.7142857142857143
12843,감고/Noun,7,5,2,5.557655114154236e-05,2.2213830330763933e-05,0.7142857142857143
12844,사회주의/Noun,7,5,2,5.557655114154236e-05,2.2213830330763933e-05,0.7142857142857143
12845,소명/Noun,7,5,2,5.557655114154236e-05,2.2213830330763933e-05,0.7142857142857143
12846,데미안/Noun,7,2,5,2.2230620456616944e-05,5.5534575826909837e-05,0.7142857142857143
12847,부적/Noun,7,5,2,5.557655114154236e-05,2.2213830330763933e-05,0.7142857142857143
12848,워킹데드/Noun,7,2,5,2.2230620456616944e-05,5.5534575826909837e-05,0.7142857142857143
12849,서지혜/Noun,7,5,2,5.557655114154236e-05,2.2213830330763933e-05,0.7142857142857143
12850,못함/Noun,7,2,5,2.2230620456616944e-05,5.5534575826909837e-05,0.7142857142857143
12851,청각장애/Noun,7,5,2,5.557655114154236e-05,2.2213830330763933e-05,0.7142857142857143
12852,폴리/Noun,7,5,2,5.557655114154236e-05,2.2213830330763933e-05,0.7142857142857143
12853,라는데/Eomi,7,2,5,2.2230620456616944e-05,5.5534575826909837e-05,0.7142857142857143
12854,배합/Noun,7,5,2,5.557655114154236e-05,2.2213830330763933e-05,0.7142857142857143
12855,앳킨슨/Noun,7,5,2,5.557655114154236e-05,2.2213830330763933e-05,0.7142857142857143
12856,dd/Alpha,7,5,2,5.557655114154236e-05,2.2213830330763933e-05,0.7142857142857143
12857,연가시/Noun,7,2,5,2.2230620456616944e-05,5.5534575826909837e-05,0.7142857142857143
12858,욱겨/Noun,7,5,2,5.557655114154236e-05,2.2213830330763933e-05,0.7142857142857143
12859,버마/Noun,7,5,2,5.557655114154236e-05,2.2213830330763933e-05,0.7142857142857143
12860,어질다/Adjective,7,5,2,5.557655114154236e-05,2.2213830330763933e-05,0.7142857142857143
12861,투어/Noun,7,5,2,5.557655114154236e-05,2.2213830330763933e-05,0.7142857142857143
12862,레지던트/Noun,7,2,5,2.2230620456616944e-05,5.5534575826909837e-05,0.7142857142857143
12863,배/Foreign,7,2,5,2.2230620456616944e-05,5.5534575826909837e-05,0.7142857142857143
12864,영업/Noun,7,5,2,5.557655114154236e-05,2.2213830330763933e-05,0.7142857142857143
12865,제기랄/Noun,7,2,5,2.2230620456616944e-05,5.5534575826909837e-05,0.7142857142857143
12866,압구정/Noun,7,2,5,2.2230620456616944e-05,5.5534575826909837e-05,0.7142857142857143
12867,예리하다/Adjective,7,5,2,5.557655114154236e-05,2.2213830330763933e-05,0.7142857142857143
12868,전문성/Noun,7,2,5,2.2230620456616944e-05,5.5534575826909837e-05,0.7142857142857143
12869,./Foreign,7,5,2,5.557655114154236e-05,2.2213830330763933e-05,0.7142857142857143
12870,워드/Noun,7,5,2,5.557655114154236e-05,2.2213830330763933e-05,0.7142857142857143
12871,원더우먼/Noun,7,2,5,2.2230620456616944e-05,5.5534575826909837e-05,0.7142857142857143
12872,일행/Noun,7,2,5,2.2230620456616944e-05,5.5534575826909837e-05,0.7142857142857143
12873,구마/Noun,7,2,5,2.2230620456616944e-05,5.5534575826909837e-05,0.7142857142857143
12874,얼어붙다/Verb,7,5,2,5.557655114154236e-05,2.2213830330763933e-05,0.7142857142857143
12875,애니메/Noun,7,5,2,5.557655114154236e-05,2.2213830330763933e-05,0.7142857142857143
12876,마시기/Noun,7,2,5,2.2230620456616944e-05,5.5534575826909837e-05,0.7142857142857143
12877,건축가/Noun,7,5,2,5.557655114154236e-05,2.2213830330763933e-05,0.7142857142857143
12878,동키/Noun,7,5,2,5.557655114154236e-05,2.2213830330763933e-05,0.7142857142857143
12879,도적/Noun,7,2,5,2.2230620456616944e-05,5.5534575826909837e-05,0.7142857142857143
12880,교정/Noun,7,2,5,2.2230620456616944e-05,5.5534575826909837e-05,0.7142857142857143
12881,할기다/Verb,7,5,2,5.557655114154236e-05,2.2213830330763933e-05,0.7142857142857143
12882,코만도/Noun,7,2,5,2.2230620456616944e-05,5.5534575826909837e-05,0.7142857142857143
12883,인스턴트/Noun,7,2,5,2.2230620456616944e-05,5.5534575826909837e-05,0.7142857142857143
12884,주식회사/Noun,7,5,2,5.557655114154236e-05,2.2213830330763933e-05,0.7142857142857143
12885,제아/Noun,7,5,2,5.557655114154236e-05,2.2213830330763933e-05,0.7142857142857143
12886,디카/Noun,7,2,5,2.2230620456616944e-05,5.5534575826909837e-05,0.7142857142857143
12887,벗겨지다/Verb,7,5,2,5.557655114154236e-05,2.2213830330763933e-05,0.7142857142857143
12888,튀김/Noun,7,2,5,2.2230620456616944e-05,5.5534575826909837e-05,0.7142857142857143
12889,드세다/Adjective,7,2,5,2.2230620456616944e-05,5.5534575826909837e-05,0.7142857142857143
12890,잔소리/Noun,7,5,2,5.557655114154236e-05,2.2213830330763933e-05,0.7142857142857143
12891,위상/Noun,7,5,2,5.557655114154236e-05,2.2213830330763933e-05,0.7142857142857143
12892,황혼/Noun,7,5,2,5.557655114154236e-05,2.2213830330763933e-05,0.7142857142857143
12893,퍼니셔/Noun,7,5,2,5.557655114154236e-05,2.2213830330763933e-05,0.7142857142857143
12894,완주/Noun,7,5,2,5.557655114154236e-05,2.2213830330763933e-05,0.7142857142857143
12895,관건/Noun,7,2,5,2.2230620456616944e-05,5.5534575826909837e-05,0.7142857142857143
12896,개체/Noun,7,5,2,5.557655114154236e-05,2.2213830330763933e-05,0.7142857142857143
12897,장철/Noun,7,5,2,5.557655114154236e-05,2.2213830330763933e-05,0.7142857142857143
12898,노스/Noun,7,5,2,5.557655114154236e-05,2.2213830330763933e-05,0.7142857142857143
12899,김혜자/Noun,7,5,2,5.557655114154236e-05,2.2213830330763933e-05,0.7142857142857143
12900,빌런/Noun,7,2,5,2.2230620456616944e-05,5.5534575826909837e-05,0.7142857142857143
12901,송이/Noun,7,5,2,5.557655114154236e-05,2.2213830330763933e-05,0.7142857142857143
12902,콤/Noun,7,5,2,5.557655114154236e-05,2.2213830330763933e-05,0.7142857142857143
12903,꿀꿀하다/Adjective,7,5,2,5.557655114154236e-05,2.2213830330763933e-05,0.7142857142857143
12904,삼십분/Noun,7,2,5,2.2230620456616944e-05,5.5534575826909837e-05,0.7142857142857143
12905,선희/Noun,7,5,2,5.557655114154236e-05,2.2213830330763933e-05,0.7142857142857143
12906,급무/Noun,7,2,5,2.2230620456616944e-05,5.5534575826909837e-05,0.7142857142857143
12907,평좀/Noun,7,2,5,2.2230620456616944e-05,5.5534575826909837e-05,0.7142857142857143
12908,모성/Noun,7,5,2,5.557655114154236e-05,2.2213830330763933e-05,0.7142857142857143
12909,경배/Noun,7,5,2,5.557655114154236e-05,2.2213830330763933e-05,0.7142857142857143
12910,피의자/Noun,7,2,5,2.2230620456616944e-05,5.5534575826909837e-05,0.7142857142857143
12911,연하/Noun,7,2,5,2.2230620456616944e-05,5.5534575826909837e-05,0.7142857142857143
12912,보나마나/Noun,7,2,5,2.2230620456616944e-05,5.5534575826909837e-05,0.7142857142857143
12913,라든지/Josa,7,5,2,5.557655114154236e-05,2.2213830330763933e-05,0.7142857142857143
12914,시합/Noun,7,2,5,2.2230620456616944e-05,5.5534575826909837e-05,0.7142857142857143
12915,오피스/Noun,7,2,5,2.2230620456616944e-05,5.5534575826909837e-05,0.7142857142857143
12916,프로덕션/Noun,7,2,5,2.2230620456616944e-05,5.5534575826909837e-05,0.7142857142857143
12917,겉모습/Noun,7,5,2,5.557655114154236e-05,2.2213830330763933e-05,0.7142857142857143
12918,픔/Noun,7,5,2,5.557655114154236e-05,2.2213830330763933e-05,0.7142857142857143
12919,85년/Number,7,5,2,5.557655114154236e-05,2.2213830330763933e-05,0.7142857142857143
12920,『/Foreign,7,5,2,5.557655114154236e-05,2.2213830330763933e-05,0.7142857142857143
12921,최동훈/Noun,7,5,2,5.557655114154236e-05,2.2213830330763933e-05,0.7142857142857143
12922,생체실험/Noun,7,2,5,2.2230620456616944e-05,5.5534575826909837e-05,0.7142857142857143
12923,어떻든/Adverb,7,2,5,2.2230620456616944e-05,5.5534575826909837e-05,0.7142857142857143
12924,!!!!!!!!!!!!!!!!!/Punctuation,7,5,2,5.557655114154236e-05,2.2213830330763933e-05,0.7142857142857143
12925,Sf/Alpha,7,5,2,5.557655114154236e-05,2.2213830330763933e-05,0.7142857142857143
12926,오신/Noun,7,2,5,2.2230620456616944e-05,5.5534575826909837e-05,0.7142857142857143
12927,겨털/Noun,7,2,5,2.2230620456616944e-05,5.5534575826909837e-05,0.7142857142857143
12928,대별/Noun,7,5,2,5.557655114154236e-05,2.2213830330763933e-05,0.7142857142857143
12929,도윤/Noun,7,2,5,2.2230620456616944e-05,5.5534575826909837e-05,0.7142857142857143
12930,일당백/Noun,7,5,2,5.557655114154236e-05,2.2213830330763933e-05,0.7142857142857143
12931,스파이키드/Noun,7,2,5,2.2230620456616944e-05,5.5534575826909837e-05,0.7142857142857143
12932,포에버/Noun,7,5,2,5.557655114154236e-05,2.2213830330763933e-05,0.7142857142857143
12933,친딸/Noun,7,2,5,2.2230620456616944e-05,5.5534575826909837e-05,0.7142857142857143
12934,아톰/Noun,7,5,2,5.557655114154236e-05,2.2213830330763933e-05,0.7142857142857143
12935,진세연/Noun,7,5,2,5.557655114154236e-05,2.2213830330763933e-05,0.7142857142857143
12936,벤자민/Noun,7,5,2,5.557655114154236e-05,2.2213830330763933e-05,0.7142857142857143
12937,열중/Noun,7,2,5,2.2230620456616944e-05,5.5534575826909837e-05,0.7142857142857143
12938,수류탄/Noun,7,2,5,2.2230620456616944e-05,5.5534575826909837e-05,0.7142857142857143
12939,정표/Noun,7,2,5,2.2230620456616944e-05,5.5534575826909837e-05,0.7142857142857143
12940,나스/Noun,7,5,2,5.557655114154236e-05,2.2213830330763933e-05,0.7142857142857143
12941,강림/Noun,7,5,2,5.557655114154236e-05,2.2213830330763933e-05,0.7142857142857143
12942,안양/Noun,7,5,2,5.557655114154236e-05,2.2213830330763933e-05,0.7142857142857143
12943,개강/Noun,7,5,2,5.557655114154236e-05,2.2213830330763933e-05,0.7142857142857143
12944,여행기/Noun,7,2,5,2.2230620456616944e-05,5.5534575826909837e-05,0.7142857142857143
12945,적군/Noun,7,5,2,5.557655114154236e-05,2.2213830330763933e-05,0.7142857142857143
12946,통곡/Noun,7,2,5,2.2230620456616944e-05,5.5534575826909837e-05,0.7142857142857143
12947,였슴/Noun,7,5,2,5.557655114154236e-05,2.2213830330763933e-05,0.7142857142857143
12948,파일럿/Noun,7,5,2,5.557655114154236e-05,2.2213830330763933e-05,0.7142857142857143
12949,히말라야/Noun,7,5,2,5.557655114154236e-05,2.2213830330763933e-05,0.7142857142857143
12950,그러기에/Conjunction,7,5,2,5.557655114154236e-05,2.2213830330763933e-05,0.7142857142857143
12951,슈타게/Noun,7,5,2,5.557655114154236e-05,2.2213830330763933e-05,0.7142857142857143
12952,조립/Noun,7,5,2,5.557655114154236e-05,2.2213830330763933e-05,0.7142857142857143
12953,미필/Noun,7,5,2,5.557655114154236e-05,2.2213830330763933e-05,0.7142857142857143
12954,한나라/Noun,7,2,5,2.2230620456616944e-05,5.5534575826909837e-05,0.7142857142857143
12955,불/Foreign,7,2,5,2.2230620456616944e-05,5.5534575826909837e-05,0.7142857142857143
12956,리우/Noun,7,2,5,2.2230620456616944e-05,5.5534575826909837e-05,0.7142857142857143
12957,간부/Noun,7,2,5,2.2230620456616944e-05,5.5534575826909837e-05,0.7142857142857143
12958,넝쿨당/Noun,7,5,2,5.557655114154236e-05,2.2213830330763933e-05,0.7142857142857143
12959,매수/Noun,7,2,5,2.2230620456616944e-05,5.5534575826909837e-05,0.7142857142857143
12960,1234567890/Number,7,5,2,5.557655114154236e-05,2.2213830330763933e-05,0.7142857142857143
12961,친북/Noun,7,2,5,2.2230620456616944e-05,5.5534575826909837e-05,0.7142857142857143
12962,강변/Noun,7,5,2,5.557655114154236e-05,2.2213830330763933e-05,0.7142857142857143
12963,히키코모리/Noun,7,2,5,2.2230620456616944e-05,5.5534575826909837e-05,0.7142857142857143
12964,여섯/Noun,7,2,5,2.2230620456616944e-05,5.5534575826909837e-05,0.7142857142857143
12965,평판/Noun,7,5,2,5.557655114154236e-05,2.2213830330763933e-05,0.7142857142857143
12966,한그루/Noun,7,5,2,5.557655114154236e-05,2.2213830330763933e-05,0.7142857142857143
12967,?;;;/Punctuation,7,2,5,2.2230620456616944e-05,5.5534575826909837e-05,0.7142857142857143
12968,보안관/Noun,7,2,5,2.2230620456616944e-05,5.5534575826909837e-05,0.7142857142857143
12969,어이구/Noun,7,2,5,2.2230620456616944e-05,5.5534575826909837e-05,0.7142857142857143
12970,too/Alpha,7,2,5,2.2230620456616944e-05,5.5534575826909837e-05,0.7142857142857143
12971,부딪치다/Verb,7,5,2,5.557655114154236e-05,2.2213830330763933e-05,0.7142857142857143
12972,앞머리/Noun,7,2,5,2.2230620456616944e-05,5.5534575826909837e-05,0.7142857142857143
12973,허울/Noun,7,2,5,2.2230620456616944e-05,5.5534575826909837e-05,0.7142857142857143
12974,성스럽다/Adjective,7,2,5,2.2230620456616944e-05,5.5534575826909837e-05,0.7142857142857143
12975,교장/Noun,7,5,2,5.557655114154236e-05,2.2213830330763933e-05,0.7142857142857143
12976,5.18/Number,7,2,5,2.2230620456616944e-05,5.5534575826909837e-05,0.7142857142857143
12977,기생충/Noun,7,2,5,2.2230620456616944e-05,5.5534575826909837e-05,0.7142857142857143
12978,소비자/Noun,7,2,5,2.2230620456616944e-05,5.5534575826909837e-05,0.7142857142857143
12979,?^^/Punctuation,7,5,2,5.557655114154236e-05,2.2213830330763933e-05,0.7142857142857143
12980,팽팽/Noun,7,5,2,5.557655114154236e-05,2.2213830330763933e-05,0.7142857142857143
12981,구걸/Noun,7,2,5,2.2230620456616944e-05,5.5534575826909837e-05,0.7142857142857143
12982,숭/Noun,7,5,2,5.557655114154236e-05,2.2213830330763933e-05,0.7142857142857143
12983,고약하다/Adjective,7,2,5,2.2230620456616944e-05,5.5534575826909837e-05,0.7142857142857143
12984,조여/Noun,7,5,2,5.557655114154236e-05,2.2213830330763933e-05,0.7142857142857143
12985,회원/Noun,7,5,2,5.557655114154236e-05,2.2213830330763933e-05,0.7142857142857143
12986,흡수/Noun,7,2,5,2.2230620456616944e-05,5.5534575826909837e-05,0.7142857142857143
12987,비디오테이프/Noun,7,5,2,5.557655114154236e-05,2.2213830330763933e-05,0.7142857142857143
12988,지드/Noun,7,5,2,5.557655114154236e-05,2.2213830330763933e-05,0.7142857142857143
12989,민들레/Noun,7,5,2,5.557655114154236e-05,2.2213830330763933e-05,0.7142857142857143
12990,심해지다/Verb,7,2,5,2.2230620456616944e-05,5.5534575826909837e-05,0.7142857142857143
12991,강대국/Noun,7,5,2,5.557655114154236e-05,2.2213830330763933e-05,0.7142857142857143
12992,덴마크/Noun,7,5,2,5.557655114154236e-05,2.2213830330763933e-05,0.7142857142857143
12993,춘향전/Noun,7,2,5,2.2230620456616944e-05,5.5534575826909837e-05,0.7142857142857143
12994,복불복/Noun,7,2,5,2.2230620456616944e-05,5.5534575826909837e-05,0.7142857142857143
12995,ㅋㄱㅋ/KoreanParticle,7,2,5,2.2230620456616944e-05,5.5534575826909837e-05,0.7142857142857143
12996,견해/Noun,7,2,5,2.2230620456616944e-05,5.5534575826909837e-05,0.7142857142857143
12997,식스/Noun,7,2,5,2.2230620456616944e-05,5.5534575826909837e-05,0.7142857142857143
12998,위험성/Noun,7,2,5,2.2230620456616944e-05,5.5534575826909837e-05,0.7142857142857143
12999,애원/Noun,7,2,5,2.2230620456616944e-05,5.5534575826909837e-05,0.7142857142857143
13000,조언/Noun,7,5,2,5.557655114154236e-05,2.2213830330763933e-05,0.7142857142857143
13001,나타/Noun,7,5,2,5.557655114154236e-05,2.2213830330763933e-05,0.7142857142857143
13002,기관/Noun,7,2,5,2.2230620456616944e-05,5.5534575826909837e-05,0.7142857142857143
13003,양면/Noun,7,5,2,5.557655114154236e-05,2.2213830330763933e-05,0.7142857142857143
13004,난사/Noun,7,2,5,2.2230620456616944e-05,5.5534575826909837e-05,0.7142857142857143
13005,반/Foreign,7,2,5,2.2230620456616944e-05,5.5534575826909837e-05,0.7142857142857143
13006,",@/Punctuation",7,2,5,2.2230620456616944e-05,5.5534575826909837e-05,0.7142857142857143
13007,꽃남/Noun,7,5,2,5.557655114154236e-05,2.2213830330763933e-05,0.7142857142857143
13008,봄날/Noun,7,5,2,5.557655114154236e-05,2.2213830330763933e-05,0.7142857142857143
13009,소멸/Noun,7,5,2,5.557655114154236e-05,2.2213830330763933e-05,0.7142857142857143
13010,어땟을까/Noun,7,2,5,2.2230620456616944e-05,5.5534575826909837e-05,0.7142857142857143
13011,완료/Noun,7,5,2,5.557655114154236e-05,2.2213830330763933e-05,0.7142857142857143
13012,브렌/Noun,7,5,2,5.557655114154236e-05,2.2213830330763933e-05,0.7142857142857143
13013,Do/Alpha,7,5,2,5.557655114154236e-05,2.2213830330763933e-05,0.7142857142857143
13014,사도세자/Noun,7,5,2,5.557655114154236e-05,2.2213830330763933e-05,0.7142857142857143
13015,거미줄/Noun,7,5,2,5.557655114154236e-05,2.2213830330763933e-05,0.7142857142857143
13016,제우스/Noun,7,2,5,2.2230620456616944e-05,5.5534575826909837e-05,0.7142857142857143
13017,래빗/Noun,7,5,2,5.557655114154236e-05,2.2213830330763933e-05,0.7142857142857143
13018,이대근/Noun,7,5,2,5.557655114154236e-05,2.2213830330763933e-05,0.7142857142857143
13019,루키/Noun,7,5,2,5.557655114154236e-05,2.2213830330763933e-05,0.7142857142857143
13020,자원/Noun,7,2,5,2.2230620456616944e-05,5.5534575826909837e-05,0.7142857142857143
13021,씬시티/Noun,7,2,5,2.2230620456616944e-05,5.5534575826909837e-05,0.7142857142857143
13022,바임/Noun,7,2,5,2.2230620456616944e-05,5.5534575826909837e-05,0.7142857142857143
13023,오만/Modifier,7,2,5,2.2230620456616944e-05,5.5534575826909837e-05,0.7142857142857143
13024,조강지처/Noun,7,2,5,2.2230620456616944e-05,5.5534575826909837e-05,0.7142857142857143
13025,분자/Noun,7,2,5,2.2230620456616944e-05,5.5534575826909837e-05,0.7142857142857143
13026,백원/Noun,7,2,5,2.2230620456616944e-05,5.5534575826909837e-05,0.7142857142857143
13027,황수정/Noun,7,5,2,5.557655114154236e-05,2.2213830330763933e-05,0.7142857142857143
13028,알리시아/Noun,7,5,2,5.557655114154236e-05,2.2213830330763933e-05,0.7142857142857143
13029,전력/Noun,7,2,5,2.2230620456616944e-05,5.5534575826909837e-05,0.7142857142857143
13030,정말루/Noun,7,5,2,5.557655114154236e-05,2.2213830330763933e-05,0.7142857142857143
13031,덩이/Noun,7,2,5,2.2230620456616944e-05,5.5534575826909837e-05,0.7142857142857143
13032,대선/Noun,7,2,5,2.2230620456616944e-05,5.5534575826909837e-05,0.7142857142857143
13033,have/Alpha,7,5,2,5.557655114154236e-05,2.2213830330763933e-05,0.7142857142857143
13034,better/Alpha,7,2,5,2.2230620456616944e-05,5.5534575826909837e-05,0.7142857142857143
13035,강제규/Noun,7,2,5,2.2230620456616944e-05,5.5534575826909837e-05,0.7142857142857143
13036,왕실/Noun,7,5,2,5.557655114154236e-05,2.2213830330763933e-05,0.7142857142857143
13037,리턴/Noun,7,5,2,5.557655114154236e-05,2.2213830330763933e-05,0.7142857142857143
13038,미제/Noun,7,2,5,2.2230620456616944e-05,5.5534575826909837e-05,0.7142857142857143
13039,그었다/Noun,7,5,2,5.557655114154236e-05,2.2213830330763933e-05,0.7142857142857143
13040,중력/Noun,7,5,2,5.557655114154236e-05,2.2213830330763933e-05,0.7142857142857143
13041,1982년/Number,7,5,2,5.557655114154236e-05,2.2213830330763933e-05,0.7142857142857143
13042,이심/Noun,7,5,2,5.557655114154236e-05,2.2213830330763933e-05,0.7142857142857143
13043,무녀/Noun,7,2,5,2.2230620456616944e-05,5.5534575826909837e-05,0.7142857142857143
13044,갈대/Noun,7,2,5,2.2230620456616944e-05,5.5534575826909837e-05,0.7142857142857143
13045,루스/Noun,7,2,5,2.2230620456616944e-05,5.5534575826909837e-05,0.7142857142857143
13046,jtbc/Alpha,7,5,2,5.557655114154236e-05,2.2213830330763933e-05,0.7142857142857143
13047,어림/Noun,7,2,5,2.2230620456616944e-05,5.5534575826909837e-05,0.7142857142857143
13048,출세작/Noun,7,5,2,5.557655114154236e-05,2.2213830330763933e-05,0.7142857142857143
13049,나카시마/Noun,7,5,2,5.557655114154236e-05,2.2213830330763933e-05,0.7142857142857143
13050,협력/Noun,7,5,2,5.557655114154236e-05,2.2213830330763933e-05,0.7142857142857143
13051,이수/Noun,7,5,2,5.557655114154236e-05,2.2213830330763933e-05,0.7142857142857143
13052,대량/Noun,7,2,5,2.2230620456616944e-05,5.5534575826909837e-05,0.7142857142857143
13053,감지덕지/Noun,7,2,5,2.2230620456616944e-05,5.5534575826909837e-05,0.7142857142857143
13054,111/Number,7,5,2,5.557655114154236e-05,2.2213830330763933e-05,0.7142857142857143
13055,측/Suffix,7,2,5,2.2230620456616944e-05,5.5534575826909837e-05,0.7142857142857143
13056,중도/Noun,7,2,5,2.2230620456616944e-05,5.5534575826909837e-05,0.7142857142857143
13057,왕족/Noun,7,2,5,2.2230620456616944e-05,5.5534575826909837e-05,0.7142857142857143
13058,가루지기/Noun,7,2,5,2.2230620456616944e-05,5.5534575826909837e-05,0.7142857142857143
13059,지자/Noun,7,2,5,2.2230620456616944e-05,5.5534575826909837e-05,0.7142857142857143
13060,로얄/Noun,7,2,5,2.2230620456616944e-05,5.5534575826909837e-05,0.7142857142857143
13061,타일러/Noun,7,2,5,2.2230620456616944e-05,5.5534575826909837e-05,0.7142857142857143
13062,오늘밤/Noun,7,5,2,5.557655114154236e-05,2.2213830330763933e-05,0.7142857142857143
13063,농사/Noun,7,2,5,2.2230620456616944e-05,5.5534575826909837e-05,0.7142857142857143
13064,무거/Noun,7,5,2,5.557655114154236e-05,2.2213830330763933e-05,0.7142857142857143
13065,컴터/Noun,7,2,5,2.2230620456616944e-05,5.5534575826909837e-05,0.7142857142857143
13066,일당/Noun,7,5,2,5.557655114154236e-05,2.2213830330763933e-05,0.7142857142857143
13067,/////Punctuation,7,2,5,2.2230620456616944e-05,5.5534575826909837e-05,0.7142857142857143
13068,캐치/Noun,7,5,2,5.557655114154236e-05,2.2213830330763933e-05,0.7142857142857143
13069,당선/Noun,7,2,5,2.2230620456616944e-05,5.5534575826909837e-05,0.7142857142857143
13070,행진/Noun,7,2,5,2.2230620456616944e-05,5.5534575826909837e-05,0.7142857142857143
13071,아수라/Noun,7,5,2,5.557655114154236e-05,2.2213830330763933e-05,0.7142857142857143
13072,86년/Number,7,5,2,5.557655114154236e-05,2.2213830330763933e-05,0.7142857142857143
13073,가물/Noun,7,5,2,5.557655114154236e-05,2.2213830330763933e-05,0.7142857142857143
13074,김용/Noun,7,5,2,5.557655114154236e-05,2.2213830330763933e-05,0.7142857142857143
13075,누굴까/Adverb,7,2,5,2.2230620456616944e-05,5.5534575826909837e-05,0.7142857142857143
13076,전계/Noun,7,2,5,2.2230620456616944e-05,5.5534575826909837e-05,0.7142857142857143
13077,지난번/Noun,7,5,2,5.557655114154236e-05,2.2213830330763933e-05,0.7142857142857143
13078,궂/Noun,7,2,5,2.2230620456616944e-05,5.5534575826909837e-05,0.7142857142857143
13079,악질/Noun,7,2,5,2.2230620456616944e-05,5.5534575826909837e-05,0.7142857142857143
13080,지탱/Noun,7,5,2,5.557655114154236e-05,2.2213830330763933e-05,0.7142857142857143
13081,경박하다/Adjective,7,2,5,2.2230620456616944e-05,5.5534575826909837e-05,0.7142857142857143
13082,수컷/Noun,7,5,2,5.557655114154236e-05,2.2213830330763933e-05,0.7142857142857143
13083,이개/Noun,7,2,5,2.2230620456616944e-05,5.5534575826909837e-05,0.7142857142857143
13084,호세/Noun,7,5,2,5.557655114154236e-05,2.2213830330763933e-05,0.7142857142857143
13085,의혹/Noun,7,2,5,2.2230620456616944e-05,5.5534575826909837e-05,0.7142857142857143
13086,악동/Noun,7,5,2,5.557655114154236e-05,2.2213830330763933e-05,0.7142857142857143
13087,풍기/Noun,7,2,5,2.2230620456616944e-05,5.5534575826909837e-05,0.7142857142857143
13088,토니쟈/Noun,7,2,5,2.2230620456616944e-05,5.5534575826909837e-05,0.7142857142857143
13089,번외편/Noun,7,5,2,5.557655114154236e-05,2.2213830330763933e-05,0.7142857142857143
13090,일개/Noun,7,2,5,2.2230620456616944e-05,5.5534575826909837e-05,0.7142857142857143
13091,ㅠㅡㅜ/KoreanParticle,7,5,2,5.557655114154236e-05,2.2213830330763933e-05,0.7142857142857143
13092,테오/Noun,7,5,2,5.557655114154236e-05,2.2213830330763933e-05,0.7142857142857143
13093,나불/Noun,7,5,2,5.557655114154236e-05,2.2213830330763933e-05,0.7142857142857143
13094,몹/Noun,7,5,2,5.557655114154236e-05,2.2213830330763933e-05,0.7142857142857143
13095,갸/Noun,7,5,2,5.557655114154236e-05,2.2213830330763933e-05,0.7142857142857143
13096,엮어/Noun,7,2,5,2.2230620456616944e-05,5.5534575826909837e-05,0.7142857142857143
13097,모라/Noun,7,2,5,2.2230620456616944e-05,5.5534575826909837e-05,0.7142857142857143
13098,소굴/Noun,7,2,5,2.2230620456616944e-05,5.5534575826909837e-05,0.7142857142857143
13099,did/Alpha,7,5,2,5.557655114154236e-05,2.2213830330763933e-05,0.7142857142857143
13100,내셔널/Noun,7,2,5,2.2230620456616944e-05,5.5534575826909837e-05,0.7142857142857143
13101,풍속/Noun,7,2,5,2.2230620456616944e-05,5.5534575826909837e-05,0.7142857142857143
13102,스팩/Noun,7,2,5,2.2230620456616944e-05,5.5534575826909837e-05,0.7142857142857143
13103,괜시리/Noun,7,5,2,5.557655114154236e-05,2.2213830330763933e-05,0.7142857142857143
13104,뒷받침/Noun,7,2,5,2.2230620456616944e-05,5.5534575826909837e-05,0.7142857142857143
13105,=_=/Punctuation,7,2,5,2.2230620456616944e-05,5.5534575826909837e-05,0.7142857142857143
13106,당하/Noun,7,2,5,2.2230620456616944e-05,5.5534575826909837e-05,0.7142857142857143
13107,문학관/Noun,7,2,5,2.2230620456616944e-05,5.5534575826909837e-05,0.7142857142857143
13108,말씀드리다/Verb,7,5,2,5.557655114154236e-05,2.2213830330763933e-05,0.7142857142857143
13109,나가요/Noun,7,2,5,2.2230620456616944e-05,5.5534575826909837e-05,0.7142857142857143
13110,똘똘/Noun,7,2,5,2.2230620456616944e-05,5.5534575826909837e-05,0.7142857142857143
13111,블룸/Noun,7,2,5,2.2230620456616944e-05,5.5534575826909837e-05,0.7142857142857143
13112,잔다르크/Noun,7,5,2,5.557655114154236e-05,2.2213830330763933e-05,0.7142857142857143
13113,남지현/Noun,7,4,3,4.446124091323389e-05,3.33207454961459e-05,0.5714285714285714
13114,버스터/Noun,7,3,4,3.3345930684925414e-05,4.4427660661527865e-05,0.5714285714285714
13115,시베리아/Noun,7,4,3,4.446124091323389e-05,3.33207454961459e-05,0.5714285714285714
13116,멜로드라마/Noun,7,4,3,4.446124091323389e-05,3.33207454961459e-05,0.5714285714285714
13117,에반스/Noun,7,4,3,4.446124091323389e-05,3.33207454961459e-05,0.5714285714285714
13118,캐스트/Noun,7,4,3,4.446124091323389e-05,3.33207454961459e-05,0.5714285714285714
13119,옥수수/Noun,7,3,4,3.3345930684925414e-05,4.4427660661527865e-05,0.5714285714285714
13120,루프/Noun,7,3,4,3.3345930684925414e-05,4.4427660661527865e-05,0.5714285714285714
13121,국수/Noun,7,3,4,3.3345930684925414e-05,4.4427660661527865e-05,0.5714285714285714
13122,김원희/Noun,7,4,3,4.446124091323389e-05,3.33207454961459e-05,0.5714285714285714
13123,호가/Noun,7,3,4,3.3345930684925414e-05,4.4427660661527865e-05,0.5714285714285714
13124,내장/Noun,7,3,4,3.3345930684925414e-05,4.4427660661527865e-05,0.5714285714285714
13125,부흥/Noun,7,4,3,4.446124091323389e-05,3.33207454961459e-05,0.5714285714285714
13126,구가의서/Noun,7,4,3,4.446124091323389e-05,3.33207454961459e-05,0.5714285714285714
13127,미혼모/Noun,7,3,4,3.3345930684925414e-05,4.4427660661527865e-05,0.5714285714285714
13128,암투/Noun,7,3,4,3.3345930684925414e-05,4.4427660661527865e-05,0.5714285714285714
13129,원동력/Noun,7,4,3,4.446124091323389e-05,3.33207454961459e-05,0.5714285714285714
13130,생김새/Noun,7,3,4,3.3345930684925414e-05,4.4427660661527865e-05,0.5714285714285714
13131,억눌리다/Verb,7,4,3,4.446124091323389e-05,3.33207454961459e-05,0.5714285714285714
13132,셰프/Noun,7,3,4,3.3345930684925414e-05,4.4427660661527865e-05,0.5714285714285714
13133,입안/Noun,7,3,4,3.3345930684925414e-05,4.4427660661527865e-05,0.5714285714285714
13134,평일/Noun,7,4,3,4.446124091323389e-05,3.33207454961459e-05,0.5714285714285714
13135,자알/Noun,7,3,4,3.3345930684925414e-05,4.4427660661527865e-05,0.5714285714285714
13136,카메라워크/Noun,7,3,4,3.3345930684925414e-05,4.4427660661527865e-05,0.5714285714285714
13137,콧/Noun,7,4,3,4.446124091323389e-05,3.33207454961459e-05,0.5714285714285714
13138,곰팡이/Noun,7,3,4,3.3345930684925414e-05,4.4427660661527865e-05,0.5714285714285714
13139,왕좌/Noun,7,4,3,4.446124091323389e-05,3.33207454961459e-05,0.5714285714285714
13140,저격수/Noun,7,4,3,4.446124091323389e-05,3.33207454961459e-05,0.5714285714285714
13141,부위/Noun,7,3,4,3.3345930684925414e-05,4.4427660661527865e-05,0.5714285714285714
13142,미셀/Noun,7,3,4,3.3345930684925414e-05,4.4427660661527865e-05,0.5714285714285714
13143,쌔/Noun,7,4,3,4.446124091323389e-05,3.33207454961459e-05,0.5714285714285714
13144,안토니오/Noun,7,4,3,4.446124091323389e-05,3.33207454961459e-05,0.5714285714285714
13145,팬임/Noun,7,3,4,3.3345930684925414e-05,4.4427660661527865e-05,0.5714285714285714
13146,혜리/Noun,7,3,4,3.3345930684925414e-05,4.4427660661527865e-05,0.5714285714285714
13147,바른/Modifier,7,4,3,4.446124091323389e-05,3.33207454961459e-05,0.5714285714285714
13148,무의미/Noun,7,3,4,3.3345930684925414e-05,4.4427660661527865e-05,0.5714285714285714
13149,부시맨/Noun,7,4,3,4.446124091323389e-05,3.33207454961459e-05,0.5714285714285714
13150,대물/Noun,7,3,4,3.3345930684925414e-05,4.4427660661527865e-05,0.5714285714285714
13151,뽑기/Noun,7,4,3,4.446124091323389e-05,3.33207454961459e-05,0.5714285714285714
13152,태현/Noun,7,3,4,3.3345930684925414e-05,4.4427660661527865e-05,0.5714285714285714
13153,풋볼/Noun,7,3,4,3.3345930684925414e-05,4.4427660661527865e-05,0.5714285714285714
13154,델마/Noun,7,3,4,3.3345930684925414e-05,4.4427660661527865e-05,0.5714285714285714
13155,최양일/Noun,7,3,4,3.3345930684925414e-05,4.4427660661527865e-05,0.5714285714285714
13156,편리하다/Adjective,7,3,4,3.3345930684925414e-05,4.4427660661527865e-05,0.5714285714285714
13157,가로/Noun,7,4,3,4.446124091323389e-05,3.33207454961459e-05,0.5714285714285714
13158,선댄스/Noun,7,3,4,3.3345930684925414e-05,4.4427660661527865e-05,0.5714285714285714
13159,황진/Noun,7,4,3,4.446124091323389e-05,3.33207454961459e-05,0.5714285714285714
13160,동명/Noun,7,3,4,3.3345930684925414e-05,4.4427660661527865e-05,0.5714285714285714
13161,4시/Number,7,4,3,4.446124091323389e-05,3.33207454961459e-05,0.5714285714285714
13162,인형극/Noun,7,4,3,4.446124091323389e-05,3.33207454961459e-05,0.5714285714285714
13163,전경/Noun,7,3,4,3.3345930684925414e-05,4.4427660661527865e-05,0.5714285714285714
13164,화피/Noun,7,4,3,4.446124091323389e-05,3.33207454961459e-05,0.5714285714285714
13165,정은/Noun,7,4,3,4.446124091323389e-05,3.33207454961459e-05,0.5714285714285714
13166,웅담/Noun,7,3,4,3.3345930684925414e-05,4.4427660661527865e-05,0.5714285714285714
13167,고경표/Noun,7,3,4,3.3345930684925414e-05,4.4427660661527865e-05,0.5714285714285714
13168,마릴/Noun,7,3,4,3.3345930684925414e-05,4.4427660661527865e-05,0.5714285714285714
13169,기술자/Noun,7,3,4,3.3345930684925414e-05,4.4427660661527865e-05,0.5714285714285714
13170,고온/Noun,7,4,3,4.446124091323389e-05,3.33207454961459e-05,0.5714285714285714
13171,순하다/Adjective,7,4,3,4.446124091323389e-05,3.33207454961459e-05,0.5714285714285714
13172,실실/Noun,7,3,4,3.3345930684925414e-05,4.4427660661527865e-05,0.5714285714285714
13173,프렌드/Noun,7,4,3,4.446124091323389e-05,3.33207454961459e-05,0.5714285714285714
13174,최재성/Noun,7,4,3,4.446124091323389e-05,3.33207454961459e-05,0.5714285714285714
13175,뒤끝/Noun,7,4,3,4.446124091323389e-05,3.33207454961459e-05,0.5714285714285714
13176,홀트/Noun,7,4,3,4.446124091323389e-05,3.33207454961459e-05,0.5714285714285714
13177,미드나잇/Noun,7,4,3,4.446124091323389e-05,3.33207454961459e-05,0.5714285714285714
13178,고종/Noun,7,4,3,4.446124091323389e-05,3.33207454961459e-05,0.5714285714285714
13179,가량/Noun,7,4,3,4.446124091323389e-05,3.33207454961459e-05,0.5714285714285714
13180,슈주/Noun,7,4,3,4.446124091323389e-05,3.33207454961459e-05,0.5714285714285714
13181,마스터링/Noun,7,4,3,4.446124091323389e-05,3.33207454961459e-05,0.5714285714285714
13182,신성록/Noun,7,3,4,3.3345930684925414e-05,4.4427660661527865e-05,0.5714285714285714
13183,봤슴/Noun,7,4,3,4.446124091323389e-05,3.33207454961459e-05,0.5714285714285714
13184,평민/Noun,7,3,4,3.3345930684925414e-05,4.4427660661527865e-05,0.5714285714285714
13185,태클/Noun,7,4,3,4.446124091323389e-05,3.33207454961459e-05,0.5714285714285714
13186,백이/Noun,7,3,4,3.3345930684925414e-05,4.4427660661527865e-05,0.5714285714285714
13187,말입/Noun,7,3,4,3.3345930684925414e-05,4.4427660661527865e-05,0.5714285714285714
13188,터너/Noun,7,3,4,3.3345930684925414e-05,4.4427660661527865e-05,0.5714285714285714
13189,뎌/Modifier,7,3,4,3.3345930684925414e-05,4.4427660661527865e-05,0.5714285714285714
13190,21년/Number,7,3,4,3.3345930684925414e-05,4.4427660661527865e-05,0.5714285714285714
13191,불만족/Noun,7,3,4,3.3345930684925414e-05,4.4427660661527865e-05,0.5714285714285714
13192,확고하다/Adjective,7,4,3,4.446124091323389e-05,3.33207454961459e-05,0.5714285714285714
13193,청담동/Noun,7,3,4,3.3345930684925414e-05,4.4427660661527865e-05,0.5714285714285714
13194,가주/Noun,7,4,3,4.446124091323389e-05,3.33207454961459e-05,0.5714285714285714
13195,평안/Noun,7,4,3,4.446124091323389e-05,3.33207454961459e-05,0.5714285714285714
13196,이단/Noun,7,3,4,3.3345930684925414e-05,4.4427660661527865e-05,0.5714285714285714
13197,호기/Noun,7,3,4,3.3345930684925414e-05,4.4427660661527865e-05,0.5714285714285714
13198,용소/Noun,7,3,4,3.3345930684925414e-05,4.4427660661527865e-05,0.5714285714285714
13199,얼릉/Noun,7,4,3,4.446124091323389e-05,3.33207454961459e-05,0.5714285714285714
13200,북유럽/Noun,7,4,3,4.446124091323389e-05,3.33207454961459e-05,0.5714285714285714
13201,SNL/Alpha,7,3,4,3.3345930684925414e-05,4.4427660661527865e-05,0.5714285714285714
13202,테라/Noun,7,4,3,4.446124091323389e-05,3.33207454961459e-05,0.5714285714285714
13203,악기/Noun,7,4,3,4.446124091323389e-05,3.33207454961459e-05,0.5714285714285714
13204,권법/Noun,7,3,4,3.3345930684925414e-05,4.4427660661527865e-05,0.5714285714285714
13205,방관/Noun,7,3,4,3.3345930684925414e-05,4.4427660661527865e-05,0.5714285714285714
13206,멋찌/Noun,7,4,3,4.446124091323389e-05,3.33207454961459e-05,0.5714285714285714
13207,알트/Noun,7,4,3,4.446124091323389e-05,3.33207454961459e-05,0.5714285714285714
13208,내용물/Noun,7,3,4,3.3345930684925414e-05,4.4427660661527865e-05,0.5714285714285714
13209,대미/Noun,7,3,4,3.3345930684925414e-05,4.4427660661527865e-05,0.5714285714285714
13210,ㅋㅎ/KoreanParticle,7,3,4,3.3345930684925414e-05,4.4427660661527865e-05,0.5714285714285714
13211,오노/Noun,7,4,3,4.446124091323389e-05,3.33207454961459e-05,0.5714285714285714
13212,되살리다/Verb,7,4,3,4.446124091323389e-05,3.33207454961459e-05,0.5714285714285714
13213,물음/Noun,7,4,3,4.446124091323389e-05,3.33207454961459e-05,0.5714285714285714
13214,오잉/Noun,7,3,4,3.3345930684925414e-05,4.4427660661527865e-05,0.5714285714285714
13215,이그/Noun,7,3,4,3.3345930684925414e-05,4.4427660661527865e-05,0.5714285714285714
13216,발동/Noun,7,4,3,4.446124091323389e-05,3.33207454961459e-05,0.5714285714285714
13217,뭉치/Noun,7,3,4,3.3345930684925414e-05,4.4427660661527865e-05,0.5714285714285714
13218,떳/Noun,7,3,4,3.3345930684925414e-05,4.4427660661527865e-05,0.5714285714285714
13219,로세/Josa,7,4,3,4.446124091323389e-05,3.33207454961459e-05,0.5714285714285714
13220,만배/Noun,7,3,4,3.3345930684925414e-05,4.4427660661527865e-05,0.5714285714285714
13221,고품격/Noun,7,4,3,4.446124091323389e-05,3.33207454961459e-05,0.5714285714285714
13222,시비/Noun,7,3,4,3.3345930684925414e-05,4.4427660661527865e-05,0.5714285714285714
13223,걱정스럽다/Adjective,7,3,4,3.3345930684925414e-05,4.4427660661527865e-05,0.5714285714285714
13224,보통사람/Noun,7,3,4,3.3345930684925414e-05,4.4427660661527865e-05,0.5714285714285714
13225,불리/Noun,7,3,4,3.3345930684925414e-05,4.4427660661527865e-05,0.5714285714285714
13226,불공평하다/Adjective,7,4,3,4.446124091323389e-05,3.33207454961459e-05,0.5714285714285714
13227,활발하다/Adjective,7,3,4,3.3345930684925414e-05,4.4427660661527865e-05,0.5714285714285714
13228,어택/Noun,7,3,4,3.3345930684925414e-05,4.4427660661527865e-05,0.5714285714285714
13229,선샤인/Noun,7,4,3,4.446124091323389e-05,3.33207454961459e-05,0.5714285714285714
13230,수요/Noun,7,3,4,3.3345930684925414e-05,4.4427660661527865e-05,0.5714285714285714
13231,단발머리/Noun,7,4,3,4.446124091323389e-05,3.33207454961459e-05,0.5714285714285714
13232,찮/Noun,7,4,3,4.446124091323389e-05,3.33207454961459e-05,0.5714285714285714
13233,으앙/Adverb,7,3,4,3.3345930684925414e-05,4.4427660661527865e-05,0.5714285714285714
13234,부업/Noun,7,3,4,3.3345930684925414e-05,4.4427660661527865e-05,0.5714285714285714
13235,카지노/Noun,7,3,4,3.3345930684925414e-05,4.4427660661527865e-05,0.5714285714285714
13236,박쥐/Noun,7,3,4,3.3345930684925414e-05,4.4427660661527865e-05,0.5714285714285714
13237,젠더/Noun,7,3,4,3.3345930684925414e-05,4.4427660661527865e-05,0.5714285714285714
13238,마가/Noun,7,3,4,3.3345930684925414e-05,4.4427660661527865e-05,0.5714285714285714
13239,All/Alpha,7,4,3,4.446124091323389e-05,3.33207454961459e-05,0.5714285714285714
13240,하듯/Eomi,7,4,3,4.446124091323389e-05,3.33207454961459e-05,0.5714285714285714
13241,타샤/Noun,7,4,3,4.446124091323389e-05,3.33207454961459e-05,0.5714285714285714
13242,사키/Noun,7,4,3,4.446124091323389e-05,3.33207454961459e-05,0.5714285714285714
13243,오카다/Noun,7,3,4,3.3345930684925414e-05,4.4427660661527865e-05,0.5714285714285714
13244,뽐내다/Verb,7,3,4,3.3345930684925414e-05,4.4427660661527865e-05,0.5714285714285714
13245,이티/Noun,7,4,3,4.446124091323389e-05,3.33207454961459e-05,0.5714285714285714
13246,엔터테인먼트/Noun,7,4,3,4.446124091323389e-05,3.33207454961459e-05,0.5714285714285714
13247,이라고도/Josa,7,4,3,4.446124091323389e-05,3.33207454961459e-05,0.5714285714285714
13248,피구/Noun,7,3,4,3.3345930684925414e-05,4.4427660661527865e-05,0.5714285714285714
13249,08년/Number,7,4,3,4.446124091323389e-05,3.33207454961459e-05,0.5714285714285714
13250,쳇/Exclamation,7,3,4,3.3345930684925414e-05,4.4427660661527865e-05,0.5714285714285714
13251,전멸/Noun,7,4,3,4.446124091323389e-05,3.33207454961459e-05,0.5714285714285714
13252,고화질/Noun,7,4,3,4.446124091323389e-05,3.33207454961459e-05,0.5714285714285714
13253,미완성/Noun,7,3,4,3.3345930684925414e-05,4.4427660661527865e-05,0.5714285714285714
13254,제주/Noun,7,4,3,4.446124091323389e-05,3.33207454961459e-05,0.5714285714285714
13255,불감증/Noun,7,3,4,3.3345930684925414e-05,4.4427660661527865e-05,0.5714285714285714
13256,한신/Noun,7,4,3,4.446124091323389e-05,3.33207454961459e-05,0.5714285714285714
13257,간나/Noun,7,3,4,3.3345930684925414e-05,4.4427660661527865e-05,0.5714285714285714
13258,프레이저/Noun,7,4,3,4.446124091323389e-05,3.33207454961459e-05,0.5714285714285714
13259,번더/Noun,7,3,4,3.3345930684925414e-05,4.4427660661527865e-05,0.5714285714285714
13260,수익/Noun,7,3,4,3.3345930684925414e-05,4.4427660661527865e-05,0.5714285714285714
13261,show/Alpha,7,3,4,3.3345930684925414e-05,4.4427660661527865e-05,0.5714285714285714
13262,IS/Alpha,7,4,3,4.446124091323389e-05,3.33207454961459e-05,0.5714285714285714
13263,현역/Noun,7,3,4,3.3345930684925414e-05,4.4427660661527865e-05,0.5714285714285714
13264,첸/Noun,7,4,3,4.446124091323389e-05,3.33207454961459e-05,0.5714285714285714
13265,판다/Noun,7,3,4,3.3345930684925414e-05,4.4427660661527865e-05,0.5714285714285714
13266,복수심/Noun,7,3,4,3.3345930684925414e-05,4.4427660661527865e-05,0.5714285714285714
13267,어마/Exclamation,7,4,3,4.446124091323389e-05,3.33207454961459e-05,0.5714285714285714
13268,.//Punctuation,7,3,4,3.3345930684925414e-05,4.4427660661527865e-05,0.5714285714285714
13269,철부지/Noun,7,3,4,3.3345930684925414e-05,4.4427660661527865e-05,0.5714285714285714
13270,더씽/Noun,7,3,4,3.3345930684925414e-05,4.4427660661527865e-05,0.5714285714285714
13271,눅눅하다/Adjective,7,4,3,4.446124091323389e-05,3.33207454961459e-05,0.5714285714285714
13272,당돌하다/Adjective,7,3,4,3.3345930684925414e-05,4.4427660661527865e-05,0.5714285714285714
13273,자칫하면/Noun,7,4,3,4.446124091323389e-05,3.33207454961459e-05,0.5714285714285714
13274,으스스하다/Adjective,7,4,3,4.446124091323389e-05,3.33207454961459e-05,0.5714285714285714
13275,동막골/Noun,7,4,3,4.446124091323389e-05,3.33207454961459e-05,0.5714285714285714
13276,허진호/Noun,7,4,3,4.446124091323389e-05,3.33207454961459e-05,0.5714285714285714
13277,전자/Noun,7,3,4,3.3345930684925414e-05,4.4427660661527865e-05,0.5714285714285714
13278,女/Foreign,7,3,4,3.3345930684925414e-05,4.4427660661527865e-05,0.5714285714285714
13279,하은/Noun,7,3,4,3.3345930684925414e-05,4.4427660661527865e-05,0.5714285714285714
13280,식인/Noun,7,3,4,3.3345930684925414e-05,4.4427660661527865e-05,0.5714285714285714
13281,팬서비스/Noun,7,4,3,4.446124091323389e-05,3.33207454961459e-05,0.5714285714285714
13282,이두용/Noun,7,3,4,3.3345930684925414e-05,4.4427660661527865e-05,0.5714285714285714
13283,발버둥/Noun,7,3,4,3.3345930684925414e-05,4.4427660661527865e-05,0.5714285714285714
13284,카야/Noun,7,4,3,4.446124091323389e-05,3.33207454961459e-05,0.5714285714285714
13285,이신/Noun,7,4,3,4.446124091323389e-05,3.33207454961459e-05,0.5714285714285714
13286,미혼/Noun,7,3,4,3.3345930684925414e-05,4.4427660661527865e-05,0.5714285714285714
13287,규칙/Noun,7,4,3,4.446124091323389e-05,3.33207454961459e-05,0.5714285714285714
13288,러/Eomi,7,3,4,3.3345930684925414e-05,4.4427660661527865e-05,0.5714285714285714
13289,얼씬/Noun,7,3,4,3.3345930684925414e-05,4.4427660661527865e-05,0.5714285714285714
13290,훠/Noun,7,3,4,3.3345930684925414e-05,4.4427660661527865e-05,0.5714285714285714
13291,헝/Noun,7,4,3,4.446124091323389e-05,3.33207454961459e-05,0.5714285714285714
13292,?~/Punctuation,7,3,4,3.3345930684925414e-05,4.4427660661527865e-05,0.5714285714285714
13293,밀당/Noun,7,3,4,3.3345930684925414e-05,4.4427660661527865e-05,0.5714285714285714
13294,노련하다/Adjective,7,4,3,4.446124091323389e-05,3.33207454961459e-05,0.5714285714285714
13295,더프/Noun,7,4,3,4.446124091323389e-05,3.33207454961459e-05,0.5714285714285714
13296,수백/Noun,7,3,4,3.3345930684925414e-05,4.4427660661527865e-05,0.5714285714285714
13297,oh/Alpha,7,4,3,4.446124091323389e-05,3.33207454961459e-05,0.5714285714285714
13298,수련/Noun,7,3,4,3.3345930684925414e-05,4.4427660661527865e-05,0.5714285714285714
13299,봣는대/Noun,7,4,3,4.446124091323389e-05,3.33207454961459e-05,0.5714285714285714
13300,돌려차기/Noun,7,3,4,3.3345930684925414e-05,4.4427660661527865e-05,0.5714285714285714
13301,반환/Noun,7,3,4,3.3345930684925414e-05,4.4427660661527865e-05,0.5714285714285714
13302,부문/Noun,7,4,3,4.446124091323389e-05,3.33207454961459e-05,0.5714285714285714
13303,모스/Noun,7,4,3,4.446124091323389e-05,3.33207454961459e-05,0.5714285714285714
13304,소도/Noun,7,3,4,3.3345930684925414e-05,4.4427660661527865e-05,0.5714285714285714
13305,개탄/Noun,7,4,3,4.446124091323389e-05,3.33207454961459e-05,0.5714285714285714
13306,순도/Noun,7,4,3,4.446124091323389e-05,3.33207454961459e-05,0.5714285714285714
13307,허위/Noun,7,3,4,3.3345930684925414e-05,4.4427660661527865e-05,0.5714285714285714
13308,방망이/Noun,7,3,4,3.3345930684925414e-05,4.4427660661527865e-05,0.5714285714285714
13309,비례/Noun,7,3,4,3.3345930684925414e-05,4.4427660661527865e-05,0.5714285714285714
13310,상우/Noun,7,4,3,4.446124091323389e-05,3.33207454961459e-05,0.5714285714285714
13311,젠틀맨/Noun,7,4,3,4.446124091323389e-05,3.33207454961459e-05,0.5714285714285714
13312,22년/Number,7,4,3,4.446124091323389e-05,3.33207454961459e-05,0.5714285714285714
13313,생도/Noun,7,4,3,4.446124091323389e-05,3.33207454961459e-05,0.5714285714285714
13314,티벳/Noun,7,4,3,4.446124091323389e-05,3.33207454961459e-05,0.5714285714285714
13315,철학자/Noun,7,3,4,3.3345930684925414e-05,4.4427660661527865e-05,0.5714285714285714
13316,무거워/Noun,7,4,3,4.446124091323389e-05,3.33207454961459e-05,0.5714285714285714
13317,사료/Noun,7,3,4,3.3345930684925414e-05,4.4427660661527865e-05,0.5714285714285714
13318,기량/Noun,7,4,3,4.446124091323389e-05,3.33207454961459e-05,0.5714285714285714
13319,야야/Noun,7,4,3,4.446124091323389e-05,3.33207454961459e-05,0.5714285714285714
13320,마침/Noun,7,3,4,3.3345930684925414e-05,4.4427660661527865e-05,0.5714285714285714
13321,마흔/Noun,7,4,3,4.446124091323389e-05,3.33207454961459e-05,0.5714285714285714
13322,레시피/Noun,7,4,3,4.446124091323389e-05,3.33207454961459e-05,0.5714285714285714
13323,바닐라/Noun,7,3,4,3.3345930684925414e-05,4.4427660661527865e-05,0.5714285714285714
13324,<</Punctuation,7,4,3,4.446124091323389e-05,3.33207454961459e-05,0.5714285714285714
13325,사리다/Verb,7,4,3,4.446124091323389e-05,3.33207454961459e-05,0.5714285714285714
13326,심령/Noun,7,4,3,4.446124091323389e-05,3.33207454961459e-05,0.5714285714285714
13327,얀/Noun,7,3,4,3.3345930684925414e-05,4.4427660661527865e-05,0.5714285714285714
13328,미스트/Noun,7,3,4,3.3345930684925414e-05,4.4427660661527865e-05,0.5714285714285714
13329,스컬리/Noun,7,4,3,4.446124091323389e-05,3.33207454961459e-05,0.5714285714285714
13330,교본/Noun,7,4,3,4.446124091323389e-05,3.33207454961459e-05,0.5714285714285714
13331,폴더/Noun,7,4,3,4.446124091323389e-05,3.33207454961459e-05,0.5714285714285714
13332,들추다/Verb,7,4,3,4.446124091323389e-05,3.33207454961459e-05,0.5714285714285714
13333,불안정하다/Adjective,7,3,4,3.3345930684925414e-05,4.4427660661527865e-05,0.5714285714285714
13334,나루/Noun,7,3,4,3.3345930684925414e-05,4.4427660661527865e-05,0.5714285714285714
13335,양지/Noun,7,3,4,3.3345930684925414e-05,4.4427660661527865e-05,0.5714285714285714
13336,의사소통/Noun,7,3,4,3.3345930684925414e-05,4.4427660661527865e-05,0.5714285714285714
13337,타츠야/Noun,7,4,3,4.446124091323389e-05,3.33207454961459e-05,0.5714285714285714
13338,낙오/Noun,7,4,3,4.446124091323389e-05,3.33207454961459e-05,0.5714285714285714
13339,기억상실증/Noun,7,4,3,4.446124091323389e-05,3.33207454961459e-05,0.5714285714285714
13340,원투/Noun,7,3,4,3.3345930684925414e-05,4.4427660661527865e-05,0.5714285714285714
13341,~~`/Punctuation,7,4,3,4.446124091323389e-05,3.33207454961459e-05,0.5714285714285714
13342,얼리다/Verb,7,3,4,3.3345930684925414e-05,4.4427660661527865e-05,0.5714285714285714
13343,당당/Adverb,7,4,3,4.446124091323389e-05,3.33207454961459e-05,0.5714285714285714
13344,킥애스/Noun,7,4,3,4.446124091323389e-05,3.33207454961459e-05,0.5714285714285714
13345,"!!""/Punctuation",7,3,4,3.3345930684925414e-05,4.4427660661527865e-05,0.5714285714285714
13346,태고/Noun,7,3,4,3.3345930684925414e-05,4.4427660661527865e-05,0.5714285714285714
13347,꺄악/Noun,7,4,3,4.446124091323389e-05,3.33207454961459e-05,0.5714285714285714
13348,리즈위더스푼/Noun,7,4,3,4.446124091323389e-05,3.33207454961459e-05,0.5714285714285714
13349,타로/Noun,7,4,3,4.446124091323389e-05,3.33207454961459e-05,0.5714285714285714
13350,애드리언/Noun,7,4,3,4.446124091323389e-05,3.33207454961459e-05,0.5714285714285714
13351,말코/Noun,7,4,3,4.446124091323389e-05,3.33207454961459e-05,0.5714285714285714
13352,레이디/Noun,7,3,4,3.3345930684925414e-05,4.4427660661527865e-05,0.5714285714285714
13353,생겨나다/Verb,7,3,4,3.3345930684925414e-05,4.4427660661527865e-05,0.5714285714285714
13354,폰트/Noun,7,4,3,4.446124091323389e-05,3.33207454961459e-05,0.5714285714285714
13355,추상미/Noun,7,4,3,4.446124091323389e-05,3.33207454961459e-05,0.5714285714285714
13356,파오/Noun,7,3,4,3.3345930684925414e-05,4.4427660661527865e-05,0.5714285714285714
13357,대왕/Noun,7,4,3,4.446124091323389e-05,3.33207454961459e-05,0.5714285714285714
13358,fuck/Alpha,7,3,4,3.3345930684925414e-05,4.4427660661527865e-05,0.5714285714285714
13359,후후후/Noun,7,3,4,3.3345930684925414e-05,4.4427660661527865e-05,0.5714285714285714
13360,'?/Punctuation,7,3,4,3.3345930684925414e-05,4.4427660661527865e-05,0.5714285714285714
13361,오토/Noun,7,3,4,3.3345930684925414e-05,4.4427660661527865e-05,0.5714285714285714
13362,체스/Noun,7,4,3,4.446124091323389e-05,3.33207454961459e-05,0.5714285714285714
13363,무성/Noun,7,3,4,3.3345930684925414e-05,4.4427660661527865e-05,0.5714285714285714
13364,씌/Noun,7,4,3,4.446124091323389e-05,3.33207454961459e-05,0.5714285714285714
13365,사물/Noun,7,4,3,4.446124091323389e-05,3.33207454961459e-05,0.5714285714285714
13366,폴란스키/Noun,7,3,4,3.3345930684925414e-05,4.4427660661527865e-05,0.5714285714285714
13367,한자리/Noun,7,3,4,3.3345930684925414e-05,4.4427660661527865e-05,0.5714285714285714
13368,이기전/Noun,7,4,3,4.446124091323389e-05,3.33207454961459e-05,0.5714285714285714
13369,디저트/Noun,7,4,3,4.446124091323389e-05,3.33207454961459e-05,0.5714285714285714
13370,인과응보/Noun,7,3,4,3.3345930684925414e-05,4.4427660661527865e-05,0.5714285714285714
13371,;../Punctuation,7,3,4,3.3345930684925414e-05,4.4427660661527865e-05,0.5714285714285714
13372,본의/Noun,7,3,4,3.3345930684925414e-05,4.4427660661527865e-05,0.5714285714285714
13373,신앙심/Noun,7,4,3,4.446124091323389e-05,3.33207454961459e-05,0.5714285714285714
13374,발굴/Noun,7,3,4,3.3345930684925414e-05,4.4427660661527865e-05,0.5714285714285714
13375,도제/Noun,7,3,4,3.3345930684925414e-05,4.4427660661527865e-05,0.5714285714285714
13376,유용하다/Adjective,7,3,4,3.3345930684925414e-05,4.4427660661527865e-05,0.5714285714285714
13377,패스트/Noun,7,4,3,4.446124091323389e-05,3.33207454961459e-05,0.5714285714285714
13378,투더/Noun,7,4,3,4.446124091323389e-05,3.33207454961459e-05,0.5714285714285714
13379,나가야/Noun,7,4,3,4.446124091323389e-05,3.33207454961459e-05,0.5714285714285714
13380,대규모/Noun,7,4,3,4.446124091323389e-05,3.33207454961459e-05,0.5714285714285714
13381,전진/Noun,7,4,3,4.446124091323389e-05,3.33207454961459e-05,0.5714285714285714
13382,장단/Noun,7,4,3,4.446124091323389e-05,3.33207454961459e-05,0.5714285714285714
13383,그랜드/Noun,7,3,4,3.3345930684925414e-05,4.4427660661527865e-05,0.5714285714285714
13384,회상씬/Noun,7,4,3,4.446124091323389e-05,3.33207454961459e-05,0.5714285714285714
13385,코디/Noun,7,3,4,3.3345930684925414e-05,4.4427660661527865e-05,0.5714285714285714
13386,민율/Noun,7,3,4,3.3345930684925414e-05,4.4427660661527865e-05,0.5714285714285714
13387,스너프/Noun,7,3,4,3.3345930684925414e-05,4.4427660661527865e-05,0.5714285714285714
13388,채운/Noun,7,4,3,4.446124091323389e-05,3.33207454961459e-05,0.5714285714285714
13389,성하/Noun,7,4,3,4.446124091323389e-05,3.33207454961459e-05,0.5714285714285714
13390,마차/Noun,7,4,3,4.446124091323389e-05,3.33207454961459e-05,0.5714285714285714
13391,박명수/Noun,7,3,4,3.3345930684925414e-05,4.4427660661527865e-05,0.5714285714285714
13392,고양/Noun,7,3,4,3.3345930684925414e-05,4.4427660661527865e-05,0.5714285714285714
13393,48/Number,7,4,3,4.446124091323389e-05,3.33207454961459e-05,0.5714285714285714
13394,만담/Noun,7,3,4,3.3345930684925414e-05,4.4427660661527865e-05,0.5714285714285714
13395,9.0/Number,7,4,3,4.446124091323389e-05,3.33207454961459e-05,0.5714285714285714
13396,놨다/Noun,7,4,3,4.446124091323389e-05,3.33207454961459e-05,0.5714285714285714
13397,스폰지밥/Noun,7,4,3,4.446124091323389e-05,3.33207454961459e-05,0.5714285714285714
13398,사촌/Noun,7,3,4,3.3345930684925414e-05,4.4427660661527865e-05,0.5714285714285714
13399,첫째/Noun,7,4,3,4.446124091323389e-05,3.33207454961459e-05,0.5714285714285714
13400,ㅇㅏ/KoreanParticle,7,4,3,4.446124091323389e-05,3.33207454961459e-05,0.5714285714285714
13401,총격씬/Noun,7,3,4,3.3345930684925414e-05,4.4427660661527865e-05,0.5714285714285714
13402,비엘/Noun,7,4,3,4.446124091323389e-05,3.33207454961459e-05,0.5714285714285714
13403,심리학/Noun,7,4,3,4.446124091323389e-05,3.33207454961459e-05,0.5714285714285714
13404,팬클럽/Noun,7,4,3,4.446124091323389e-05,3.33207454961459e-05,0.5714285714285714
13405,밀레니엄/Noun,7,4,3,4.446124091323389e-05,3.33207454961459e-05,0.5714285714285714
13406,남북전쟁/Noun,7,4,3,4.446124091323389e-05,3.33207454961459e-05,0.5714285714285714
13407,그네/Noun,7,4,3,4.446124091323389e-05,3.33207454961459e-05,0.5714285714285714
13408,명감/Noun,7,4,3,4.446124091323389e-05,3.33207454961459e-05,0.5714285714285714
13409,6시/Number,7,4,3,4.446124091323389e-05,3.33207454961459e-05,0.5714285714285714
13410,슥/Modifier,7,4,3,4.446124091323389e-05,3.33207454961459e-05,0.5714285714285714
13411,쇼타/Noun,7,4,3,4.446124091323389e-05,3.33207454961459e-05,0.5714285714285714
13412,전보/Noun,7,4,3,4.446124091323389e-05,3.33207454961459e-05,0.5714285714285714
13413,노래실력/Noun,7,4,3,4.446124091323389e-05,3.33207454961459e-05,0.5714285714285714
13414,파가/Noun,7,3,4,3.3345930684925414e-05,4.4427660661527865e-05,0.5714285714285714
13415,미카엘/Noun,7,3,4,3.3345930684925414e-05,4.4427660661527865e-05,0.5714285714285714
13416,부엉이/Noun,7,3,4,3.3345930684925414e-05,4.4427660661527865e-05,0.5714285714285714
13417,퓨티드/Noun,7,3,4,3.3345930684925414e-05,4.4427660661527865e-05,0.5714285714285714
13418,에게로/Josa,7,4,3,4.446124091323389e-05,3.33207454961459e-05,0.5714285714285714
13419,버드/Noun,7,3,4,3.3345930684925414e-05,4.4427660661527865e-05,0.5714285714285714
13420,내딸/Noun,7,3,4,3.3345930684925414e-05,4.4427660661527865e-05,0.5714285714285714
13421,보조/Noun,7,4,3,4.446124091323389e-05,3.33207454961459e-05,0.5714285714285714
13422,보로/Noun,7,4,3,4.446124091323389e-05,3.33207454961459e-05,0.5714285714285714
13423,합류/Noun,7,3,4,3.3345930684925414e-05,4.4427660661527865e-05,0.5714285714285714
13424,뭐시기/Noun,7,3,4,3.3345930684925414e-05,4.4427660661527865e-05,0.5714285714285714
13425,갈래/Noun,7,3,4,3.3345930684925414e-05,4.4427660661527865e-05,0.5714285714285714
13426,don/Alpha,7,4,3,4.446124091323389e-05,3.33207454961459e-05,0.5714285714285714
13427,머리털/Noun,7,3,4,3.3345930684925414e-05,4.4427660661527865e-05,0.5714285714285714
13428,책상/Noun,7,4,3,4.446124091323389e-05,3.33207454961459e-05,0.5714285714285714
13429,리라/Noun,7,3,4,3.3345930684925414e-05,4.4427660661527865e-05,0.5714285714285714
13430,호화롭다/Adjective,7,3,4,3.3345930684925414e-05,4.4427660661527865e-05,0.5714285714285714
13431,퍼스트/Noun,7,4,3,4.446124091323389e-05,3.33207454961459e-05,0.5714285714285714
13432,강국/Noun,7,3,4,3.3345930684925414e-05,4.4427660661527865e-05,0.5714285714285714
13433,안봣는데/Noun,7,3,4,3.3345930684925414e-05,4.4427660661527865e-05,0.5714285714285714
13434,CIA/Alpha,7,4,3,4.446124091323389e-05,3.33207454961459e-05,0.5714285714285714
13435,바랬던/Noun,7,4,3,4.446124091323389e-05,3.33207454961459e-05,0.5714285714285714
13436,구타/Noun,7,3,4,3.3345930684925414e-05,4.4427660661527865e-05,0.5714285714285714
13437,로간/Noun,7,4,3,4.446124091323389e-05,3.33207454961459e-05,0.5714285714285714
13438,요기/Noun,7,3,4,3.3345930684925414e-05,4.4427660661527865e-05,0.5714285714285714
13439,톡/Noun,7,4,3,4.446124091323389e-05,3.33207454961459e-05,0.5714285714285714
13440,가창력/Noun,7,4,3,4.446124091323389e-05,3.33207454961459e-05,0.5714285714285714
13441,집행/Noun,7,4,3,4.446124091323389e-05,3.33207454961459e-05,0.5714285714285714
13442,백제/Noun,7,4,3,4.446124091323389e-05,3.33207454961459e-05,0.5714285714285714
13443,끄적/Adverb,7,4,3,4.446124091323389e-05,3.33207454961459e-05,0.5714285714285714
13444,목욕탕/Noun,7,4,3,4.446124091323389e-05,3.33207454961459e-05,0.5714285714285714
13445,91년/Number,7,4,3,4.446124091323389e-05,3.33207454961459e-05,0.5714285714285714
13446,한결같이/Adverb,7,4,3,4.446124091323389e-05,3.33207454961459e-05,0.5714285714285714
13447,더라도/Noun,7,3,4,3.3345930684925414e-05,4.4427660661527865e-05,0.5714285714285714
13448,피조/Noun,7,3,4,3.3345930684925414e-05,4.4427660661527865e-05,0.5714285714285714
13449,설령/Noun,7,3,4,3.3345930684925414e-05,4.4427660661527865e-05,0.5714285714285714
13450,교육영화/Noun,7,3,4,3.3345930684925414e-05,4.4427660661527865e-05,0.5714285714285714
13451,헌트/Noun,7,4,3,4.446124091323389e-05,3.33207454961459e-05,0.5714285714285714
13452,대가/Foreign,7,3,4,3.3345930684925414e-05,4.4427660661527865e-05,0.5714285714285714
13453,예약/Noun,7,3,4,3.3345930684925414e-05,4.4427660661527865e-05,0.5714285714285714
13454,오스/Noun,7,4,3,4.446124091323389e-05,3.33207454961459e-05,0.5714285714285714
13455,우리동네/Noun,7,4,3,4.446124091323389e-05,3.33207454961459e-05,0.5714285714285714
13456,상당/Noun,7,4,3,4.446124091323389e-05,3.33207454961459e-05,0.5714285714285714
13457,브래들리/Noun,7,3,4,3.3345930684925414e-05,4.4427660661527865e-05,0.5714285714285714
13458,옅다/Adjective,7,4,3,4.446124091323389e-05,3.33207454961459e-05,0.5714285714285714
13459,매가/Noun,7,4,3,4.446124091323389e-05,3.33207454961459e-05,0.5714285714285714
13460,집념/Noun,7,4,3,4.446124091323389e-05,3.33207454961459e-05,0.5714285714285714
13461,글래머/Noun,7,4,3,4.446124091323389e-05,3.33207454961459e-05,0.5714285714285714
13462,중위/Noun,7,3,4,3.3345930684925414e-05,4.4427660661527865e-05,0.5714285714285714
13463,아스/Noun,7,3,4,3.3345930684925414e-05,4.4427660661527865e-05,0.5714285714285714
13464,횡재/Noun,7,4,3,4.446124091323389e-05,3.33207454961459e-05,0.5714285714285714
13465,김기영/Noun,7,4,3,4.446124091323389e-05,3.33207454961459e-05,0.5714285714285714
13466,카우프만/Noun,7,4,3,4.446124091323389e-05,3.33207454961459e-05,0.5714285714285714
13467,수만/Noun,7,3,4,3.3345930684925414e-05,4.4427660661527865e-05,0.5714285714285714
13468,무력/Noun,7,3,4,3.3345930684925414e-05,4.4427660661527865e-05,0.5714285714285714
13469,취약/Noun,7,4,3,4.446124091323389e-05,3.33207454961459e-05,0.5714285714285714
13470,니키타/Noun,7,3,4,3.3345930684925414e-05,4.4427660661527865e-05,0.5714285714285714
13471,라르/Noun,7,4,3,4.446124091323389e-05,3.33207454961459e-05,0.5714285714285714
13472,주마/Noun,7,4,3,4.446124091323389e-05,3.33207454961459e-05,0.5714285714285714
13473,복구/Noun,7,3,4,3.3345930684925414e-05,4.4427660661527865e-05,0.5714285714285714
13474,원죄/Noun,7,3,4,3.3345930684925414e-05,4.4427660661527865e-05,0.5714285714285714
13475,바흐/Noun,7,4,3,4.446124091323389e-05,3.33207454961459e-05,0.5714285714285714
13476,남자이야기/Noun,7,3,4,3.3345930684925414e-05,4.4427660661527865e-05,0.5714285714285714
13477,성급하다/Adjective,7,3,4,3.3345930684925414e-05,4.4427660661527865e-05,0.5714285714285714
13478,드팔마/Noun,7,3,4,3.3345930684925414e-05,4.4427660661527865e-05,0.5714285714285714
13479,순금/Noun,7,3,4,3.3345930684925414e-05,4.4427660661527865e-05,0.5714285714285714
13480,행사/Noun,7,3,4,3.3345930684925414e-05,4.4427660661527865e-05,0.5714285714285714
13481,나란하다/Adjective,7,4,3,4.446124091323389e-05,3.33207454961459e-05,0.5714285714285714
13482,임파/Noun,7,3,4,3.3345930684925414e-05,4.4427660661527865e-05,0.5714285714285714
13483,다미/Noun,7,4,3,4.446124091323389e-05,3.33207454961459e-05,0.5714285714285714
13484,식품/Noun,7,3,4,3.3345930684925414e-05,4.4427660661527865e-05,0.5714285714285714
13485,빨치산/Noun,7,4,3,4.446124091323389e-05,3.33207454961459e-05,0.5714285714285714
13486,트집/Noun,7,4,3,4.446124091323389e-05,3.33207454961459e-05,0.5714285714285714
13487,허리우드/Noun,7,4,3,4.446124091323389e-05,3.33207454961459e-05,0.5714285714285714
13488,썰매/Noun,7,4,3,4.446124091323389e-05,3.33207454961459e-05,0.5714285714285714
13489,선곡/Noun,7,4,3,4.446124091323389e-05,3.33207454961459e-05,0.5714285714285714
13490,카지노로얄/Noun,7,4,3,4.446124091323389e-05,3.33207454961459e-05,0.5714285714285714
13491,놀음/Noun,7,3,4,3.3345930684925414e-05,4.4427660661527865e-05,0.5714285714285714
13492,반찬/Noun,7,3,4,3.3345930684925414e-05,4.4427660661527865e-05,0.5714285714285714
13493,잔인성/Noun,7,3,4,3.3345930684925414e-05,4.4427660661527865e-05,0.5714285714285714
13494,브라운/Noun,7,4,3,4.446124091323389e-05,3.33207454961459e-05,0.5714285714285714
13495,이언/Noun,7,3,4,3.3345930684925414e-05,4.4427660661527865e-05,0.5714285714285714
13496,영관/Noun,7,3,4,3.3345930684925414e-05,4.4427660661527865e-05,0.5714285714285714
13497,에밀/Noun,7,4,3,4.446124091323389e-05,3.33207454961459e-05,0.5714285714285714
13498,둥둥/Noun,7,4,3,4.446124091323389e-05,3.33207454961459e-05,0.5714285714285714
13499,행태/Noun,7,3,4,3.3345930684925414e-05,4.4427660661527865e-05,0.5714285714285714
13500,괞/Noun,7,4,3,4.446124091323389e-05,3.33207454961459e-05,0.5714285714285714
13501,스티브잡스/Noun,7,4,3,4.446124091323389e-05,3.33207454961459e-05,0.5714285714285714
13502,투자가/Noun,7,3,4,3.3345930684925414e-05,4.4427660661527865e-05,0.5714285714285714
13503,신기전/Noun,7,4,3,4.446124091323389e-05,3.33207454961459e-05,0.5714285714285714
13504,모래시계/Noun,7,4,3,4.446124091323389e-05,3.33207454961459e-05,0.5714285714285714
13505,버티고/Noun,7,3,4,3.3345930684925414e-05,4.4427660661527865e-05,0.5714285714285714
13506,장본인/Noun,7,3,4,3.3345930684925414e-05,4.4427660661527865e-05,0.5714285714285714
13507,붕가붕가/Noun,6,0,6,0.0,6.66414909922918e-05,1.0
13508,모호/Noun,6,0,6,0.0,6.66414909922918e-05,1.0
13509,5초/Number,6,0,6,0.0,6.66414909922918e-05,1.0
13510,편애/Noun,6,0,6,0.0,6.66414909922918e-05,1.0
13511,각목/Noun,6,0,6,0.0,6.66414909922918e-05,1.0
13512,용량/Noun,6,0,6,0.0,6.66414909922918e-05,1.0
13513,2000원/Number,6,0,6,0.0,6.66414909922918e-05,1.0
13514,잘빠지다/Verb,6,6,0,6.669186136985083e-05,0.0,1.0
13515,마라도나/Noun,6,0,6,0.0,6.66414909922918e-05,1.0
13516,패킷/Noun,6,0,6,0.0,6.66414909922918e-05,1.0
13517,잠옴/Noun,6,0,6,0.0,6.66414909922918e-05,1.0
13518,기미가요/Noun,6,0,6,0.0,6.66414909922918e-05,1.0
13519,44/Number,6,0,6,0.0,6.66414909922918e-05,1.0
13520,대학가/Noun,6,0,6,0.0,6.66414909922918e-05,1.0
13521,노이즈/Noun,6,0,6,0.0,6.66414909922918e-05,1.0
13522,곽현화/Noun,6,0,6,0.0,6.66414909922918e-05,1.0
13523,창피/Noun,6,0,6,0.0,6.66414909922918e-05,1.0
13524,Ebs/Alpha,6,6,0,6.669186136985083e-05,0.0,1.0
13525,보급/Noun,6,0,6,0.0,6.66414909922918e-05,1.0
13526,촌철/Noun,6,6,0,6.669186136985083e-05,0.0,1.0
13527,역사관/Noun,6,0,6,0.0,6.66414909922918e-05,1.0
13528,세르게이/Noun,6,0,6,0.0,6.66414909922918e-05,1.0
13529,장하나/Noun,6,0,6,0.0,6.66414909922918e-05,1.0
13530,2.6/Number,6,0,6,0.0,6.66414909922918e-05,1.0
13531,생기다/Adjective,6,0,6,0.0,6.66414909922918e-05,1.0
13532,존레논/Noun,6,6,0,6.669186136985083e-05,0.0,1.0
13533,아작/Noun,6,0,6,0.0,6.66414909922918e-05,1.0
13534,남쪽/Noun,6,6,0,6.669186136985083e-05,0.0,1.0
13535,신예/Noun,6,0,6,0.0,6.66414909922918e-05,1.0
13536,그림판/Noun,6,0,6,0.0,6.66414909922918e-05,1.0
13537,개핵/Noun,6,0,6,0.0,6.66414909922918e-05,1.0
13538,기왕/Noun,6,0,6,0.0,6.66414909922918e-05,1.0
13539,장려/Noun,6,0,6,0.0,6.66414909922918e-05,1.0
13540,우현/Noun,6,6,0,6.669186136985083e-05,0.0,1.0
13541,시디/Noun,6,6,0,6.669186136985083e-05,0.0,1.0
13542,종범/Noun,6,0,6,0.0,6.66414909922918e-05,1.0
13543,정치사/Noun,6,6,0,6.669186136985083e-05,0.0,1.0
13544,엔드/Noun,6,0,6,0.0,6.66414909922918e-05,1.0
13545,허약하다/Adjective,6,0,6,0.0,6.66414909922918e-05,1.0
13546,연개소문/Noun,6,0,6,0.0,6.66414909922918e-05,1.0
13547,곤욕/Noun,6,0,6,0.0,6.66414909922918e-05,1.0
13548,방정/Noun,6,0,6,0.0,6.66414909922918e-05,1.0
13549,위쇼/Noun,6,6,0,6.669186136985083e-05,0.0,1.0
13550,자상하다/Adjective,6,6,0,6.669186136985083e-05,0.0,1.0
13551,라이오넬/Noun,6,6,0,6.669186136985083e-05,0.0,1.0
13552,^)//Punctuation,6,6,0,6.669186136985083e-05,0.0,1.0
13553,이케/Noun,6,0,6,0.0,6.66414909922918e-05,1.0
13554,전대물/Noun,6,0,6,0.0,6.66414909922918e-05,1.0
13555,동물학대/Noun,6,0,6,0.0,6.66414909922918e-05,1.0
13556,ll/Alpha,6,6,0,6.669186136985083e-05,0.0,1.0
13557,축축/Adverb,6,0,6,0.0,6.66414909922918e-05,1.0
13558,페니/Noun,6,6,0,6.669186136985083e-05,0.0,1.0
13559,...;;;;/Punctuation,6,0,6,0.0,6.66414909922918e-05,1.0
13560,이러다가/Adverb,6,0,6,0.0,6.66414909922918e-05,1.0
13561,간반/Noun,6,0,6,0.0,6.66414909922918e-05,1.0
13562,짬봉/Noun,6,0,6,0.0,6.66414909922918e-05,1.0
13563,허벅지/Noun,6,0,6,0.0,6.66414909922918e-05,1.0
13564,"..,,./Punctuation",6,0,6,0.0,6.66414909922918e-05,1.0
13565,정승/Noun,6,0,6,0.0,6.66414909922918e-05,1.0
13566,지지리/Noun,6,0,6,0.0,6.66414909922918e-05,1.0
13567,국군/Noun,6,0,6,0.0,6.66414909922918e-05,1.0
13568,쫘악/Noun,6,6,0,6.669186136985083e-05,0.0,1.0
13569,난로/Noun,6,6,0,6.669186136985083e-05,0.0,1.0
13570,사생아/Noun,6,0,6,0.0,6.66414909922918e-05,1.0
13571,31/Number,6,6,0,6.669186136985083e-05,0.0,1.0
13572,아낙/Noun,6,0,6,0.0,6.66414909922918e-05,1.0
13573,3.5/Number,6,0,6,0.0,6.66414909922918e-05,1.0
13574,진행자/Noun,6,0,6,0.0,6.66414909922918e-05,1.0
13575,맞춤법/Noun,6,0,6,0.0,6.66414909922918e-05,1.0
13576,경찰차/Noun,6,0,6,0.0,6.66414909922918e-05,1.0
13577,WWE/Alpha,6,0,6,0.0,6.66414909922918e-05,1.0
13578,맹꽁/Adverb,6,0,6,0.0,6.66414909922918e-05,1.0
13579,경비원/Noun,6,0,6,0.0,6.66414909922918e-05,1.0
13580,걔네/Noun,6,0,6,0.0,6.66414909922918e-05,1.0
13581,콕콕/Adverb,6,6,0,6.669186136985083e-05,0.0,1.0
13582,퇴갤/Noun,6,0,6,0.0,6.66414909922918e-05,1.0
13583,캠페인/Noun,6,0,6,0.0,6.66414909922918e-05,1.0
13584,플라스틱/Noun,6,0,6,0.0,6.66414909922918e-05,1.0
13585,다케/Noun,6,6,0,6.669186136985083e-05,0.0,1.0
13586,원폭/Noun,6,0,6,0.0,6.66414909922918e-05,1.0
13587,박영진/Noun,6,0,6,0.0,6.66414909922918e-05,1.0
13588,맨홀/Noun,6,0,6,0.0,6.66414909922918e-05,1.0
13589,쫄깃하/Noun,6,6,0,6.669186136985083e-05,0.0,1.0
13590,셋트/Noun,6,0,6,0.0,6.66414909922918e-05,1.0
13591,요란/Noun,6,0,6,0.0,6.66414909922918e-05,1.0
13592,최여진/Noun,6,0,6,0.0,6.66414909922918e-05,1.0
13593,본색/Noun,6,0,6,0.0,6.66414909922918e-05,1.0
13594,여건/Noun,6,0,6,0.0,6.66414909922918e-05,1.0
13595,낚인건/Noun,6,0,6,0.0,6.66414909922918e-05,1.0
13596,주루룩/Adverb,6,6,0,6.669186136985083e-05,0.0,1.0
13597,가스펠/Noun,6,6,0,6.669186136985083e-05,0.0,1.0
13598,바로잡다/Verb,6,6,0,6.669186136985083e-05,0.0,1.0
13599,혈액형/Noun,6,0,6,0.0,6.66414909922918e-05,1.0
13600,풍족하다/Adjective,6,6,0,6.669186136985083e-05,0.0,1.0
13601,킹스/Noun,6,6,0,6.669186136985083e-05,0.0,1.0
13602,신보라/Noun,6,0,6,0.0,6.66414909922918e-05,1.0
13603,돈크라이마미/Noun,6,0,6,0.0,6.66414909922918e-05,1.0
13604,명예훼손/Noun,6,0,6,0.0,6.66414909922918e-05,1.0
13605,나우/Noun,6,6,0,6.669186136985083e-05,0.0,1.0
13606,요술/Noun,6,0,6,0.0,6.66414909922918e-05,1.0
13607,김수환/Noun,6,6,0,6.669186136985083e-05,0.0,1.0
13608,징글/Noun,6,0,6,0.0,6.66414909922918e-05,1.0
13609,끝물/Noun,6,0,6,0.0,6.66414909922918e-05,1.0
13610,틸다/Noun,6,6,0,6.669186136985083e-05,0.0,1.0
13611,질도/Noun,6,0,6,0.0,6.66414909922918e-05,1.0
13612,(?).../Punctuation,6,0,6,0.0,6.66414909922918e-05,1.0
13613,빈곤하다/Adjective,6,0,6,0.0,6.66414909922918e-05,1.0
13614,순간이동/Noun,6,0,6,0.0,6.66414909922918e-05,1.0
13615,배틀쉽/Noun,6,0,6,0.0,6.66414909922918e-05,1.0
13616,완치/Noun,6,6,0,6.669186136985083e-05,0.0,1.0
13617,웨/Noun,6,0,6,0.0,6.66414909922918e-05,1.0
13618,대충대충/Adverb,6,0,6,0.0,6.66414909922918e-05,1.0
13619,올밴/Noun,6,0,6,0.0,6.66414909922918e-05,1.0
13620,땅크/Noun,6,0,6,0.0,6.66414909922918e-05,1.0
13621,손병호/Noun,6,0,6,0.0,6.66414909922918e-05,1.0
13622,노을/Noun,6,6,0,6.669186136985083e-05,0.0,1.0
13623,보살피다/Verb,6,6,0,6.669186136985083e-05,0.0,1.0
13624,시후/Noun,6,6,0,6.669186136985083e-05,0.0,1.0
13625,이지난/Foreign,6,6,0,6.669186136985083e-05,0.0,1.0
13626,패딩턴/Noun,6,6,0,6.669186136985083e-05,0.0,1.0
13627,재롱/Noun,6,0,6,0.0,6.66414909922918e-05,1.0
13628,버거운/Noun,6,0,6,0.0,6.66414909922918e-05,1.0
13629,일왕/Noun,6,0,6,0.0,6.66414909922918e-05,1.0
13630,재밌넹/Noun,6,6,0,6.669186136985083e-05,0.0,1.0
13631,^*^/Punctuation,6,6,0,6.669186136985083e-05,0.0,1.0
13632,소꿉놀이/Noun,6,0,6,0.0,6.66414909922918e-05,1.0
13633,레오네/Noun,6,6,0,6.669186136985083e-05,0.0,1.0
13634,부터의/Josa,6,6,0,6.669186136985083e-05,0.0,1.0
13635,희화/Noun,6,0,6,0.0,6.66414909922918e-05,1.0
13636,성지/Noun,6,0,6,0.0,6.66414909922918e-05,1.0
13637,사양/Noun,6,0,6,0.0,6.66414909922918e-05,1.0
13638,과일/Noun,6,0,6,0.0,6.66414909922918e-05,1.0
13639,승전/Noun,6,0,6,0.0,6.66414909922918e-05,1.0
13640,노희경/Noun,6,6,0,6.669186136985083e-05,0.0,1.0
13641,붕뜬/Noun,6,0,6,0.0,6.66414909922918e-05,1.0
13642,음식물/Noun,6,0,6,0.0,6.66414909922918e-05,1.0
13643,!!~/Punctuation,6,6,0,6.669186136985083e-05,0.0,1.0
13644,관습/Noun,6,6,0,6.669186136985083e-05,0.0,1.0
13645,적정/Noun,6,0,6,0.0,6.66414909922918e-05,1.0
13646,섬터/Noun,6,6,0,6.669186136985083e-05,0.0,1.0
13647,존경심/Noun,6,6,0,6.669186136985083e-05,0.0,1.0
13648,슈타인/Noun,6,6,0,6.669186136985083e-05,0.0,1.0
13649,역효과/Noun,6,0,6,0.0,6.66414909922918e-05,1.0
13650,루니/Noun,6,6,0,6.669186136985083e-05,0.0,1.0
13651,울먹이다/Verb,6,6,0,6.669186136985083e-05,0.0,1.0
13652,범주/Noun,6,0,6,0.0,6.66414909922918e-05,1.0
13653,쇼미더머니/Noun,6,0,6,0.0,6.66414909922918e-05,1.0
13654,불능/Noun,6,0,6,0.0,6.66414909922918e-05,1.0
13655,정정/Noun,6,0,6,0.0,6.66414909922918e-05,1.0
13656,겟썸/Noun,6,0,6,0.0,6.66414909922918e-05,1.0
13657,다욕/Noun,6,0,6,0.0,6.66414909922918e-05,1.0
13658,포옹/Noun,6,6,0,6.669186136985083e-05,0.0,1.0
13659,안중/Noun,6,0,6,0.0,6.66414909922918e-05,1.0
13660,몽상/Noun,6,0,6,0.0,6.66414909922918e-05,1.0
13661,아무런/Modifier,6,0,6,0.0,6.66414909922918e-05,1.0
13662,인스피릿/Noun,6,6,0,6.669186136985083e-05,0.0,1.0
13663,스탈린그라드/Noun,6,6,0,6.669186136985083e-05,0.0,1.0
13664,방청객/Noun,6,0,6,0.0,6.66414909922918e-05,1.0
13665,기관총/Noun,6,0,6,0.0,6.66414909922918e-05,1.0
13666,자아도취/Noun,6,0,6,0.0,6.66414909922918e-05,1.0
13667,험버트/Noun,6,6,0,6.669186136985083e-05,0.0,1.0
13668,러시아어/Noun,6,0,6,0.0,6.66414909922918e-05,1.0
13669,바닥나다/Verb,6,0,6,0.0,6.66414909922918e-05,1.0
13670,굿임/Noun,6,6,0,6.669186136985083e-05,0.0,1.0
13671,빠져듭니/Noun,6,6,0,6.669186136985083e-05,0.0,1.0
13672,뇬/Noun,6,0,6,0.0,6.66414909922918e-05,1.0
13673,곱등이/Noun,6,0,6,0.0,6.66414909922918e-05,1.0
13674,메이크업/Noun,6,6,0,6.669186136985083e-05,0.0,1.0
13675,버디무비/Noun,6,6,0,6.669186136985083e-05,0.0,1.0
13676,후아유/Noun,6,6,0,6.669186136985083e-05,0.0,1.0
13677,어사일럼/Noun,6,0,6,0.0,6.66414909922918e-05,1.0
13678,반죽/Noun,6,0,6,0.0,6.66414909922918e-05,1.0
13679,김은숙/Noun,6,6,0,6.669186136985083e-05,0.0,1.0
13680,더파이팅/Noun,6,6,0,6.669186136985083e-05,0.0,1.0
13681,중고생/Noun,6,0,6,0.0,6.66414909922918e-05,1.0
13682,그레이드/Noun,6,0,6,0.0,6.66414909922918e-05,1.0
13683,-_-.../Punctuation,6,0,6,0.0,6.66414909922918e-05,1.0
13684,문외한/Noun,6,6,0,6.669186136985083e-05,0.0,1.0
13685,어리둥절/Noun,6,0,6,0.0,6.66414909922918e-05,1.0
13686,윌리/Noun,6,6,0,6.669186136985083e-05,0.0,1.0
13687,글로버/Noun,6,6,0,6.669186136985083e-05,0.0,1.0
13688,고요한/Noun,6,6,0,6.669186136985083e-05,0.0,1.0
13689,60~70년/Number,6,0,6,0.0,6.66414909922918e-05,1.0
13690,단숨/Noun,6,6,0,6.669186136985083e-05,0.0,1.0
13691,백혈병/Noun,6,0,6,0.0,6.66414909922918e-05,1.0
13692,달팽이/Noun,6,6,0,6.669186136985083e-05,0.0,1.0
13693,도요타/Noun,6,0,6,0.0,6.66414909922918e-05,1.0
13694,강마/Noun,6,6,0,6.669186136985083e-05,0.0,1.0
13695,괜찬네/Noun,6,6,0,6.669186136985083e-05,0.0,1.0
13696,어쩌라구/Noun,6,0,6,0.0,6.66414909922918e-05,1.0
13697,도덕성/Noun,6,0,6,0.0,6.66414909922918e-05,1.0
13698,사절/Noun,6,0,6,0.0,6.66414909922918e-05,1.0
13699,달림/Noun,6,0,6,0.0,6.66414909922918e-05,1.0
13700,북받치다/Verb,6,6,0,6.669186136985083e-05,0.0,1.0
13701,지심/Noun,6,6,0,6.669186136985083e-05,0.0,1.0
13702,한술/Noun,6,0,6,0.0,6.66414909922918e-05,1.0
13703,빨강/Noun,6,6,0,6.669186136985083e-05,0.0,1.0
13704,리엘/Noun,6,6,0,6.669186136985083e-05,0.0,1.0
13705,치네다/Verb,6,0,6,0.0,6.66414909922918e-05,1.0
13706,애정결핍/Noun,6,0,6,0.0,6.66414909922918e-05,1.0
13707,흩어지다/Verb,6,0,6,0.0,6.66414909922918e-05,1.0
13708,마니마니/Adverb,6,6,0,6.669186136985083e-05,0.0,1.0
13709,덕지덕지/Noun,6,0,6,0.0,6.66414909922918e-05,1.0
13710,"?,/Punctuation",6,5,1,5.557655114154236e-05,1.1106915165381966e-05,0.8333333333333334
13711,큰소리/Noun,6,1,5,1.1115310228308472e-05,5.5534575826909837e-05,0.8333333333333334
13712,하곤/Eomi,6,1,5,1.1115310228308472e-05,5.5534575826909837e-05,0.8333333333333334
13713,의무감/Noun,6,1,5,1.1115310228308472e-05,5.5534575826909837e-05,0.8333333333333334
13714,cd/Alpha,6,1,5,1.1115310228308472e-05,5.5534575826909837e-05,0.8333333333333334
13715,섬뜩/Adverb,6,5,1,5.557655114154236e-05,1.1106915165381966e-05,0.8333333333333334
13716,정지영/Noun,6,1,5,1.1115310228308472e-05,5.5534575826909837e-05,0.8333333333333334
13717,포화/Noun,6,5,1,5.557655114154236e-05,1.1106915165381966e-05,0.8333333333333334
13718,창민/Noun,6,5,1,5.557655114154236e-05,1.1106915165381966e-05,0.8333333333333334
13719,개개/Noun,6,1,5,1.1115310228308472e-05,5.5534575826909837e-05,0.8333333333333334
13720,팡/Adverb,6,5,1,5.557655114154236e-05,1.1106915165381966e-05,0.8333333333333334
13721,GV/Alpha,6,5,1,5.557655114154236e-05,1.1106915165381966e-05,0.8333333333333334
13722,강시선생/Noun,6,5,1,5.557655114154236e-05,1.1106915165381966e-05,0.8333333333333334
13723,지사/Noun,6,5,1,5.557655114154236e-05,1.1106915165381966e-05,0.8333333333333334
13724,매춘/Noun,6,1,5,1.1115310228308472e-05,5.5534575826909837e-05,0.8333333333333334
13725,저작권/Noun,6,1,5,1.1115310228308472e-05,5.5534575826909837e-05,0.8333333333333334
13726,선남선녀/Noun,6,5,1,5.557655114154236e-05,1.1106915165381966e-05,0.8333333333333334
13727,벌겋다/Adjective,6,1,5,1.1115310228308472e-05,5.5534575826909837e-05,0.8333333333333334
13728,종반/Noun,6,1,5,1.1115310228308472e-05,5.5534575826909837e-05,0.8333333333333334
13729,오자룡/Noun,6,1,5,1.1115310228308472e-05,5.5534575826909837e-05,0.8333333333333334
13730,집사/Noun,6,5,1,5.557655114154236e-05,1.1106915165381966e-05,0.8333333333333334
13731,9천원/Number,6,1,5,1.1115310228308472e-05,5.5534575826909837e-05,0.8333333333333334
13732,페이소스/Noun,6,5,1,5.557655114154236e-05,1.1106915165381966e-05,0.8333333333333334
13733,난봉/Noun,6,1,5,1.1115310228308472e-05,5.5534575826909837e-05,0.8333333333333334
13734,활력소/Noun,6,5,1,5.557655114154236e-05,1.1106915165381966e-05,0.8333333333333334
13735,과외/Noun,6,1,5,1.1115310228308472e-05,5.5534575826909837e-05,0.8333333333333334
13736,참말/Noun,6,1,5,1.1115310228308472e-05,5.5534575826909837e-05,0.8333333333333334
13737,만화인/Noun,6,1,5,1.1115310228308472e-05,5.5534575826909837e-05,0.8333333333333334
13738,그라드/Noun,6,1,5,1.1115310228308472e-05,5.5534575826909837e-05,0.8333333333333334
13739,니시/Noun,6,5,1,5.557655114154236e-05,1.1106915165381966e-05,0.8333333333333334
13740,과함/Noun,6,1,5,1.1115310228308472e-05,5.5534575826909837e-05,0.8333333333333334
13741,1991년/Number,6,5,1,5.557655114154236e-05,1.1106915165381966e-05,0.8333333333333334
13742,붕붕/Noun,6,1,5,1.1115310228308472e-05,5.5534575826909837e-05,0.8333333333333334
13743,다니엘헤니/Noun,6,5,1,5.557655114154236e-05,1.1106915165381966e-05,0.8333333333333334
13744,조울증/Noun,6,1,5,1.1115310228308472e-05,5.5534575826909837e-05,0.8333333333333334
13745,척척/Noun,6,1,5,1.1115310228308472e-05,5.5534575826909837e-05,0.8333333333333334
13746,케시/Noun,6,5,1,5.557655114154236e-05,1.1106915165381966e-05,0.8333333333333334
13747,sns/Alpha,6,5,1,5.557655114154236e-05,1.1106915165381966e-05,0.8333333333333334
13748,발기/Noun,6,1,5,1.1115310228308472e-05,5.5534575826909837e-05,0.8333333333333334
13749,오차/Noun,6,1,5,1.1115310228308472e-05,5.5534575826909837e-05,0.8333333333333334
13750,중화/Noun,6,5,1,5.557655114154236e-05,1.1106915165381966e-05,0.8333333333333334
13751,베트남전쟁/Noun,6,5,1,5.557655114154236e-05,1.1106915165381966e-05,0.8333333333333334
13752,박시은/Noun,6,1,5,1.1115310228308472e-05,5.5534575826909837e-05,0.8333333333333334
13753,니노/Noun,6,5,1,5.557655114154236e-05,1.1106915165381966e-05,0.8333333333333334
13754,오슬로/Noun,6,5,1,5.557655114154236e-05,1.1106915165381966e-05,0.8333333333333334
13755,패리스/Noun,6,1,5,1.1115310228308472e-05,5.5534575826909837e-05,0.8333333333333334
13756,렉터/Noun,6,5,1,5.557655114154236e-05,1.1106915165381966e-05,0.8333333333333334
13757,좀바/Noun,6,1,5,1.1115310228308472e-05,5.5534575826909837e-05,0.8333333333333334
13758,고두심/Noun,6,5,1,5.557655114154236e-05,1.1106915165381966e-05,0.8333333333333334
13759,길가/Noun,6,1,5,1.1115310228308472e-05,5.5534575826909837e-05,0.8333333333333334
13760,토투/Noun,6,5,1,5.557655114154236e-05,1.1106915165381966e-05,0.8333333333333334
13761,헤엄/Noun,6,5,1,5.557655114154236e-05,1.1106915165381966e-05,0.8333333333333334
13762,여름밤/Noun,6,5,1,5.557655114154236e-05,1.1106915165381966e-05,0.8333333333333334
13763,순서대로/Noun,6,5,1,5.557655114154236e-05,1.1106915165381966e-05,0.8333333333333334
13764,구슬/Noun,6,1,5,1.1115310228308472e-05,5.5534575826909837e-05,0.8333333333333334
13765,오타/Noun,6,5,1,5.557655114154236e-05,1.1106915165381966e-05,0.8333333333333334
13766,돌란/Noun,6,5,1,5.557655114154236e-05,1.1106915165381966e-05,0.8333333333333334
13767,타자/Noun,6,5,1,5.557655114154236e-05,1.1106915165381966e-05,0.8333333333333334
13768,도서/Noun,6,5,1,5.557655114154236e-05,1.1106915165381966e-05,0.8333333333333334
13769,워메/Noun,6,1,5,1.1115310228308472e-05,5.5534575826909837e-05,0.8333333333333334
13770,버호벤/Noun,6,5,1,5.557655114154236e-05,1.1106915165381966e-05,0.8333333333333334
13771,박민우/Noun,6,1,5,1.1115310228308472e-05,5.5534575826909837e-05,0.8333333333333334
13772,유연하다/Adjective,6,5,1,5.557655114154236e-05,1.1106915165381966e-05,0.8333333333333334
13773,냉/Noun,6,1,5,1.1115310228308472e-05,5.5534575826909837e-05,0.8333333333333334
13774,그릇되다/Adjective,6,1,5,1.1115310228308472e-05,5.5534575826909837e-05,0.8333333333333334
13775,작이라니/Foreign,6,5,1,5.557655114154236e-05,1.1106915165381966e-05,0.8333333333333334
13776,유명인/Noun,6,1,5,1.1115310228308472e-05,5.5534575826909837e-05,0.8333333333333334
13777,실험영화/Noun,6,1,5,1.1115310228308472e-05,5.5534575826909837e-05,0.8333333333333334
13778,이가흔/Noun,6,5,1,5.557655114154236e-05,1.1106915165381966e-05,0.8333333333333334
13779,고연/Modifier,6,5,1,5.557655114154236e-05,1.1106915165381966e-05,0.8333333333333334
13780,미스코리아/Noun,6,1,5,1.1115310228308472e-05,5.5534575826909837e-05,0.8333333333333334
13781,레먼/Noun,6,5,1,5.557655114154236e-05,1.1106915165381966e-05,0.8333333333333334
13782,리더쉽/Noun,6,5,1,5.557655114154236e-05,1.1106915165381966e-05,0.8333333333333334
13783,춘희/Noun,6,5,1,5.557655114154236e-05,1.1106915165381966e-05,0.8333333333333334
13784,뻐기다/Verb,6,1,5,1.1115310228308472e-05,5.5534575826909837e-05,0.8333333333333334
13785,할갑다/Adjective,6,1,5,1.1115310228308472e-05,5.5534575826909837e-05,0.8333333333333334
13786,고천락/Noun,6,5,1,5.557655114154236e-05,1.1106915165381966e-05,0.8333333333333334
13787,칼리토/Noun,6,5,1,5.557655114154236e-05,1.1106915165381966e-05,0.8333333333333334
13788,프란체스카/Noun,6,1,5,1.1115310228308472e-05,5.5534575826909837e-05,0.8333333333333334
13789,꽥/Adverb,6,1,5,1.1115310228308472e-05,5.5534575826909837e-05,0.8333333333333334
13790,짤린/Noun,6,1,5,1.1115310228308472e-05,5.5534575826909837e-05,0.8333333333333334
13791,치마/Noun,6,5,1,5.557655114154236e-05,1.1106915165381966e-05,0.8333333333333334
13792,저속하다/Adjective,6,1,5,1.1115310228308472e-05,5.5534575826909837e-05,0.8333333333333334
13793,억수/Noun,6,5,1,5.557655114154236e-05,1.1106915165381966e-05,0.8333333333333334
13794,장남/Noun,6,5,1,5.557655114154236e-05,1.1106915165381966e-05,0.8333333333333334
13795,구글/Noun,6,1,5,1.1115310228308472e-05,5.5534575826909837e-05,0.8333333333333334
13796,디스코/Noun,6,1,5,1.1115310228308472e-05,5.5534575826909837e-05,0.8333333333333334
13797,의왕/Noun,6,1,5,1.1115310228308472e-05,5.5534575826909837e-05,0.8333333333333334
13798,무재/Noun,6,5,1,5.557655114154236e-05,1.1106915165381966e-05,0.8333333333333334
13799,조현재/Noun,6,5,1,5.557655114154236e-05,1.1106915165381966e-05,0.8333333333333334
13800,곰탕/Noun,6,1,5,1.1115310228308472e-05,5.5534575826909837e-05,0.8333333333333334
13801,욕실/Noun,6,5,1,5.557655114154236e-05,1.1106915165381966e-05,0.8333333333333334
13802,주륵주륵/Adverb,6,5,1,5.557655114154236e-05,1.1106915165381966e-05,0.8333333333333334
13803,반성은/Noun,6,1,5,1.1115310228308472e-05,5.5534575826909837e-05,0.8333333333333334
13804,걸돈/Noun,6,1,5,1.1115310228308472e-05,5.5534575826909837e-05,0.8333333333333334
13805,무관심하다/Adjective,6,5,1,5.557655114154236e-05,1.1106915165381966e-05,0.8333333333333334
13806,트로이/Noun,6,5,1,5.557655114154236e-05,1.1106915165381966e-05,0.8333333333333334
13807,인어공주/Noun,6,5,1,5.557655114154236e-05,1.1106915165381966e-05,0.8333333333333334
13808,병동/Noun,6,5,1,5.557655114154236e-05,1.1106915165381966e-05,0.8333333333333334
13809,케이티/Noun,6,1,5,1.1115310228308472e-05,5.5534575826909837e-05,0.8333333333333334
13810,나체/Noun,6,1,5,1.1115310228308472e-05,5.5534575826909837e-05,0.8333333333333334
13811,마리모/Noun,6,5,1,5.557655114154236e-05,1.1106915165381966e-05,0.8333333333333334
13812,아가리/Noun,6,1,5,1.1115310228308472e-05,5.5534575826909837e-05,0.8333333333333334
13813,^~/Punctuation,6,5,1,5.557655114154236e-05,1.1106915165381966e-05,0.8333333333333334
13814,다이애나/Noun,6,1,5,1.1115310228308472e-05,5.5534575826909837e-05,0.8333333333333334
13815,치켜세우다/Verb,6,1,5,1.1115310228308472e-05,5.5534575826909837e-05,0.8333333333333334
13816,중계/Noun,6,1,5,1.1115310228308472e-05,5.5534575826909837e-05,0.8333333333333334
13817,충실/Noun,6,1,5,1.1115310228308472e-05,5.5534575826909837e-05,0.8333333333333334
13818,베풀다/Verb,6,5,1,5.557655114154236e-05,1.1106915165381966e-05,0.8333333333333334
13819,구미호/Noun,6,1,5,1.1115310228308472e-05,5.5534575826909837e-05,0.8333333333333334
13820,디오/Noun,6,5,1,5.557655114154236e-05,1.1106915165381966e-05,0.8333333333333334
13821,채정안/Noun,6,5,1,5.557655114154236e-05,1.1106915165381966e-05,0.8333333333333334
13822,팁/Noun,6,5,1,5.557655114154236e-05,1.1106915165381966e-05,0.8333333333333334
13823,1979년/Number,6,5,1,5.557655114154236e-05,1.1106915165381966e-05,0.8333333333333334
13824,고쿠센/Noun,6,5,1,5.557655114154236e-05,1.1106915165381966e-05,0.8333333333333334
13825,부르짖다/Verb,6,1,5,1.1115310228308472e-05,5.5534575826909837e-05,0.8333333333333334
13826,추장/Noun,6,1,5,1.1115310228308472e-05,5.5534575826909837e-05,0.8333333333333334
13827,낳을/Noun,6,1,5,1.1115310228308472e-05,5.5534575826909837e-05,0.8333333333333334
13828,노자/Noun,6,1,5,1.1115310228308472e-05,5.5534575826909837e-05,0.8333333333333334
13829,바이오맨/Noun,6,1,5,1.1115310228308472e-05,5.5534575826909837e-05,0.8333333333333334
13830,초콜렛/Noun,6,5,1,5.557655114154236e-05,1.1106915165381966e-05,0.8333333333333334
13831,레너드/Noun,6,5,1,5.557655114154236e-05,1.1106915165381966e-05,0.8333333333333334
13832,하노/Noun,6,1,5,1.1115310228308472e-05,5.5534575826909837e-05,0.8333333333333334
13833,건설/Noun,6,1,5,1.1115310228308472e-05,5.5534575826909837e-05,0.8333333333333334
13834,계속계속/Adverb,6,5,1,5.557655114154236e-05,1.1106915165381966e-05,0.8333333333333334
13835,군데군데/Noun,6,1,5,1.1115310228308472e-05,5.5534575826909837e-05,0.8333333333333334
13836,위화/Noun,6,1,5,1.1115310228308472e-05,5.5534575826909837e-05,0.8333333333333334
13837,두리/Noun,6,1,5,1.1115310228308472e-05,5.5534575826909837e-05,0.8333333333333334
13838,로즈/Noun,6,5,1,5.557655114154236e-05,1.1106915165381966e-05,0.8333333333333334
13839,리포트/Noun,6,1,5,1.1115310228308472e-05,5.5534575826909837e-05,0.8333333333333334
13840,발리/Noun,6,1,5,1.1115310228308472e-05,5.5534575826909837e-05,0.8333333333333334
13841,어기다/Verb,6,1,5,1.1115310228308472e-05,5.5534575826909837e-05,0.8333333333333334
13842,늠/Noun,6,5,1,5.557655114154236e-05,1.1106915165381966e-05,0.8333333333333334
13843,1994년/Number,6,5,1,5.557655114154236e-05,1.1106915165381966e-05,0.8333333333333334
13844,~~~~!!!/Punctuation,6,5,1,5.557655114154236e-05,1.1106915165381966e-05,0.8333333333333334
13845,보실/Noun,6,1,5,1.1115310228308472e-05,5.5534575826909837e-05,0.8333333333333334
13846,영적/Noun,6,5,1,5.557655114154236e-05,1.1106915165381966e-05,0.8333333333333334
13847,채원/Noun,6,5,1,5.557655114154236e-05,1.1106915165381966e-05,0.8333333333333334
13848,커튼/Noun,6,5,1,5.557655114154236e-05,1.1106915165381966e-05,0.8333333333333334
13849,영창/Noun,6,1,5,1.1115310228308472e-05,5.5534575826909837e-05,0.8333333333333334
13850,분한/Noun,6,5,1,5.557655114154236e-05,1.1106915165381966e-05,0.8333333333333334
13851,우정은/Noun,6,5,1,5.557655114154236e-05,1.1106915165381966e-05,0.8333333333333334
13852,soso/Alpha,6,1,5,1.1115310228308472e-05,5.5534575826909837e-05,0.8333333333333334
13853,사담/Noun,6,1,5,1.1115310228308472e-05,5.5534575826909837e-05,0.8333333333333334
13854,수시로/Adverb,6,1,5,1.1115310228308472e-05,5.5534575826909837e-05,0.8333333333333334
13855,파시즘/Noun,6,1,5,1.1115310228308472e-05,5.5534575826909837e-05,0.8333333333333334
13856,^^^/Punctuation,6,5,1,5.557655114154236e-05,1.1106915165381966e-05,0.8333333333333334
13857,살살/Noun,6,5,1,5.557655114154236e-05,1.1106915165381966e-05,0.8333333333333334
13858,바르게/Noun,6,5,1,5.557655114154236e-05,1.1106915165381966e-05,0.8333333333333334
13859,커스버트/Noun,6,1,5,1.1115310228308472e-05,5.5534575826909837e-05,0.8333333333333334
13860,주군/Noun,6,5,1,5.557655114154236e-05,1.1106915165381966e-05,0.8333333333333334
13861,왜안/Noun,6,5,1,5.557655114154236e-05,1.1106915165381966e-05,0.8333333333333334
13862,울적하다/Adjective,6,5,1,5.557655114154236e-05,1.1106915165381966e-05,0.8333333333333334
13863,라티/Noun,6,1,5,1.1115310228308472e-05,5.5534575826909837e-05,0.8333333333333334
13864,xxx/Alpha,6,1,5,1.1115310228308472e-05,5.5534575826909837e-05,0.8333333333333334
13865,단정/Noun,6,5,1,5.557655114154236e-05,1.1106915165381966e-05,0.8333333333333334
13866,한공주/Noun,6,1,5,1.1115310228308472e-05,5.5534575826909837e-05,0.8333333333333334
13867,페어리테일/Noun,6,5,1,5.557655114154236e-05,1.1106915165381966e-05,0.8333333333333334
13868,대망/Noun,6,1,5,1.1115310228308472e-05,5.5534575826909837e-05,0.8333333333333334
13869,구수하다/Adjective,6,5,1,5.557655114154236e-05,1.1106915165381966e-05,0.8333333333333334
13870,개츠비/Noun,6,5,1,5.557655114154236e-05,1.1106915165381966e-05,0.8333333333333334
13871,덤벼/Noun,6,1,5,1.1115310228308472e-05,5.5534575826909837e-05,0.8333333333333334
13872,비어/Noun,6,1,5,1.1115310228308472e-05,5.5534575826909837e-05,0.8333333333333334
13873,친분/Noun,6,1,5,1.1115310228308472e-05,5.5534575826909837e-05,0.8333333333333334
13874,려면/Noun,6,1,5,1.1115310228308472e-05,5.5534575826909837e-05,0.8333333333333334
13875,다이스/Noun,6,5,1,5.557655114154236e-05,1.1106915165381966e-05,0.8333333333333334
13876,구조도/Noun,6,1,5,1.1115310228308472e-05,5.5534575826909837e-05,0.8333333333333334
13877,박정아/Noun,6,1,5,1.1115310228308472e-05,5.5534575826909837e-05,0.8333333333333334
13878,휙휙/Noun,6,1,5,1.1115310228308472e-05,5.5534575826909837e-05,0.8333333333333334
13879,내의/Noun,6,5,1,5.557655114154236e-05,1.1106915165381966e-05,0.8333333333333334
13880,클로버필드/Noun,6,1,5,1.1115310228308472e-05,5.5534575826909837e-05,0.8333333333333334
13881,은진/Noun,6,1,5,1.1115310228308472e-05,5.5534575826909837e-05,0.8333333333333334
13882,원혼/Noun,6,1,5,1.1115310228308472e-05,5.5534575826909837e-05,0.8333333333333334
13883,동안미녀/Noun,6,5,1,5.557655114154236e-05,1.1106915165381966e-05,0.8333333333333334
13884,잡수다/Verb,6,1,5,1.1115310228308472e-05,5.5534575826909837e-05,0.8333333333333334
13885,홀려/Noun,6,1,5,1.1115310228308472e-05,5.5534575826909837e-05,0.8333333333333334
13886,조은지/Noun,6,1,5,1.1115310228308472e-05,5.5534575826909837e-05,0.8333333333333334
13887,CCTV/Alpha,6,1,5,1.1115310228308472e-05,5.5534575826909837e-05,0.8333333333333334
13888,때깔/Noun,6,1,5,1.1115310228308472e-05,5.5534575826909837e-05,0.8333333333333334
13889,숨결/Noun,6,5,1,5.557655114154236e-05,1.1106915165381966e-05,0.8333333333333334
13890,협회/Noun,6,1,5,1.1115310228308472e-05,5.5534575826909837e-05,0.8333333333333334
13891,6분/Number,6,1,5,1.1115310228308472e-05,5.5534575826909837e-05,0.8333333333333334
13892,이식/Noun,6,1,5,1.1115310228308472e-05,5.5534575826909837e-05,0.8333333333333334
13893,오온/Noun,6,1,5,1.1115310228308472e-05,5.5534575826909837e-05,0.8333333333333334
13894,감소/Noun,6,1,5,1.1115310228308472e-05,5.5534575826909837e-05,0.8333333333333334
13895,girl/Alpha,6,5,1,5.557655114154236e-05,1.1106915165381966e-05,0.8333333333333334
13896,왓슨/Noun,6,5,1,5.557655114154236e-05,1.1106915165381966e-05,0.8333333333333334
13897,세르/Noun,6,5,1,5.557655114154236e-05,1.1106915165381966e-05,0.8333333333333334
13898,귀감/Noun,6,5,1,5.557655114154236e-05,1.1106915165381966e-05,0.8333333333333334
13899,용산/Noun,6,1,5,1.1115310228308472e-05,5.5534575826909837e-05,0.8333333333333334
13900,성행위/Noun,6,1,5,1.1115310228308472e-05,5.5534575826909837e-05,0.8333333333333334
13901,그레텔/Noun,6,1,5,1.1115310228308472e-05,5.5534575826909837e-05,0.8333333333333334
13902,용형/Noun,6,5,1,5.557655114154236e-05,1.1106915165381966e-05,0.8333333333333334
13903,이징/Noun,6,1,5,1.1115310228308472e-05,5.5534575826909837e-05,0.8333333333333334
13904,포즈/Noun,6,1,5,1.1115310228308472e-05,5.5534575826909837e-05,0.8333333333333334
13905,감격시대/Noun,6,5,1,5.557655114154236e-05,1.1106915165381966e-05,0.8333333333333334
13906,양성/Noun,6,1,5,1.1115310228308472e-05,5.5534575826909837e-05,0.8333333333333334
13907,피해망상/Noun,6,1,5,1.1115310228308472e-05,5.5534575826909837e-05,0.8333333333333334
13908,호갱/Noun,6,1,5,1.1115310228308472e-05,5.5534575826909837e-05,0.8333333333333334
13909,후루룩/Noun,6,1,5,1.1115310228308472e-05,5.5534575826909837e-05,0.8333333333333334
13910,유출/Noun,6,1,5,1.1115310228308472e-05,5.5534575826909837e-05,0.8333333333333334
13911,미스김/Noun,6,5,1,5.557655114154236e-05,1.1106915165381966e-05,0.8333333333333334
13912,이승철/Noun,6,1,5,1.1115310228308472e-05,5.5534575826909837e-05,0.8333333333333334
13913,는데/Noun,6,5,1,5.557655114154236e-05,1.1106915165381966e-05,0.8333333333333334
13914,룰렛/Noun,6,5,1,5.557655114154236e-05,1.1106915165381966e-05,0.8333333333333334
13915,",,,,,,,,/Punctuation",6,1,5,1.1115310228308472e-05,5.5534575826909837e-05,0.8333333333333334
13916,은행강도/Noun,6,1,5,1.1115310228308472e-05,5.5534575826909837e-05,0.8333333333333334
13917,ㅋㄷㅋㄷ/KoreanParticle,6,5,1,5.557655114154236e-05,1.1106915165381966e-05,0.8333333333333334
13918,느므/Noun,6,5,1,5.557655114154236e-05,1.1106915165381966e-05,0.8333333333333334
13919,전면/Noun,6,1,5,1.1115310228308472e-05,5.5534575826909837e-05,0.8333333333333334
13920,넬슨/Noun,6,5,1,5.557655114154236e-05,1.1106915165381966e-05,0.8333333333333334
13921,길동/Noun,6,5,1,5.557655114154236e-05,1.1106915165381966e-05,0.8333333333333334
13922,뉴하트/Noun,6,5,1,5.557655114154236e-05,1.1106915165381966e-05,0.8333333333333334
13923,도기/Noun,6,5,1,5.557655114154236e-05,1.1106915165381966e-05,0.8333333333333334
13924,월켄/Noun,6,5,1,5.557655114154236e-05,1.1106915165381966e-05,0.8333333333333334
13925,김서형/Noun,6,1,5,1.1115310228308472e-05,5.5534575826909837e-05,0.8333333333333334
13926,이준영/Noun,6,5,1,5.557655114154236e-05,1.1106915165381966e-05,0.8333333333333334
13927,해치/Noun,6,1,5,1.1115310228308472e-05,5.5534575826909837e-05,0.8333333333333334
13928,???????/Punctuation,6,1,5,1.1115310228308472e-05,5.5534575826909837e-05,0.8333333333333334
13929,IQ/Alpha,6,1,5,1.1115310228308472e-05,5.5534575826909837e-05,0.8333333333333334
13930,music/Alpha,6,5,1,5.557655114154236e-05,1.1106915165381966e-05,0.8333333333333334
13931,외계생명체/Noun,6,1,5,1.1115310228308472e-05,5.5534575826909837e-05,0.8333333333333334
13932,전영록/Noun,6,1,5,1.1115310228308472e-05,5.5534575826909837e-05,0.8333333333333334
13933,닼/Noun,6,5,1,5.557655114154236e-05,1.1106915165381966e-05,0.8333333333333334
13934,리포터/Noun,6,1,5,1.1115310228308472e-05,5.5534575826909837e-05,0.8333333333333334
13935,싱싱하다/Adjective,6,1,5,1.1115310228308472e-05,5.5534575826909837e-05,0.8333333333333334
13936,졸렬하다/Adjective,6,1,5,1.1115310228308472e-05,5.5534575826909837e-05,0.8333333333333334
13937,him/Alpha,6,5,1,5.557655114154236e-05,1.1106915165381966e-05,0.8333333333333334
13938,소서/Noun,6,5,1,5.557655114154236e-05,1.1106915165381966e-05,0.8333333333333334
13939,노후/Noun,6,1,5,1.1115310228308472e-05,5.5534575826909837e-05,0.8333333333333334
13940,의성/Noun,6,5,1,5.557655114154236e-05,1.1106915165381966e-05,0.8333333333333334
13941,고딕/Noun,6,5,1,5.557655114154236e-05,1.1106915165381966e-05,0.8333333333333334
13942,저해/Noun,6,1,5,1.1115310228308472e-05,5.5534575826909837e-05,0.8333333333333334
13943,립스틱/Noun,6,5,1,5.557655114154236e-05,1.1106915165381966e-05,0.8333333333333334
13944,하버드/Noun,6,1,5,1.1115310228308472e-05,5.5534575826909837e-05,0.8333333333333334
13945,젤로/Noun,6,5,1,5.557655114154236e-05,1.1106915165381966e-05,0.8333333333333334
13946,방언/Noun,6,1,5,1.1115310228308472e-05,5.5534575826909837e-05,0.8333333333333334
13947,녹슬다/Verb,6,5,1,5.557655114154236e-05,1.1106915165381966e-05,0.8333333333333334
13948,제겐/Noun,6,5,1,5.557655114154236e-05,1.1106915165381966e-05,0.8333333333333334
13949,개코/Noun,6,1,5,1.1115310228308472e-05,5.5534575826909837e-05,0.8333333333333334
13950,헿/Exclamation,6,5,1,5.557655114154236e-05,1.1106915165381966e-05,0.8333333333333334
13951,니코/Noun,6,5,1,5.557655114154236e-05,1.1106915165381966e-05,0.8333333333333334
13952,4.45/Number,6,1,5,1.1115310228308472e-05,5.5534575826909837e-05,0.8333333333333334
13953,협주곡/Noun,6,5,1,5.557655114154236e-05,1.1106915165381966e-05,0.8333333333333334
13954,도합/Modifier,6,5,1,5.557655114154236e-05,1.1106915165381966e-05,0.8333333333333334
13955,인공호흡/Noun,6,1,5,1.1115310228308472e-05,5.5534575826909837e-05,0.8333333333333334
13956,에서조차/Josa,6,1,5,1.1115310228308472e-05,5.5534575826909837e-05,0.8333333333333334
13957,메모리/Noun,6,1,5,1.1115310228308472e-05,5.5534575826909837e-05,0.8333333333333334
13958,공동체/Noun,6,5,1,5.557655114154236e-05,1.1106915165381966e-05,0.8333333333333334
13959,사이렌/Noun,6,5,1,5.557655114154236e-05,1.1106915165381966e-05,0.8333333333333334
13960,성애자/Noun,6,1,5,1.1115310228308472e-05,5.5534575826909837e-05,0.8333333333333334
13961,고사하고/Noun,6,1,5,1.1115310228308472e-05,5.5534575826909837e-05,0.8333333333333334
13962,찰떡/Noun,6,5,1,5.557655114154236e-05,1.1106915165381966e-05,0.8333333333333334
13963,바오/Noun,6,1,5,1.1115310228308472e-05,5.5534575826909837e-05,0.8333333333333334
13964,웅얼웅얼/Noun,6,1,5,1.1115310228308472e-05,5.5534575826909837e-05,0.8333333333333334
13965,32/Number,6,5,1,5.557655114154236e-05,1.1106915165381966e-05,0.8333333333333334
13966,다이아나/Noun,6,5,1,5.557655114154236e-05,1.1106915165381966e-05,0.8333333333333334
13967,기특하다/Adjective,6,5,1,5.557655114154236e-05,1.1106915165381966e-05,0.8333333333333334
13968,장민/Noun,6,5,1,5.557655114154236e-05,1.1106915165381966e-05,0.8333333333333334
13969,얼짱/Noun,6,5,1,5.557655114154236e-05,1.1106915165381966e-05,0.8333333333333334
13970,무쉬/Noun,6,5,1,5.557655114154236e-05,1.1106915165381966e-05,0.8333333333333334
13971,ㅋㄷ/KoreanParticle,6,5,1,5.557655114154236e-05,1.1106915165381966e-05,0.8333333333333334
13972,악취/Noun,6,1,5,1.1115310228308472e-05,5.5534575826909837e-05,0.8333333333333334
13973,쌩뚱맞다/Noun,6,1,5,1.1115310228308472e-05,5.5534575826909837e-05,0.8333333333333334
13974,규정/Noun,6,5,1,5.557655114154236e-05,1.1106915165381966e-05,0.8333333333333334
13975,둠스데이/Noun,6,1,5,1.1115310228308472e-05,5.5534575826909837e-05,0.8333333333333334
13976,유노윤호/Noun,6,1,5,1.1115310228308472e-05,5.5534575826909837e-05,0.8333333333333334
13977,본토/Noun,6,1,5,1.1115310228308472e-05,5.5534575826909837e-05,0.8333333333333334
13978,울렁거리다/Verb,6,1,5,1.1115310228308472e-05,5.5534575826909837e-05,0.8333333333333334
13979,성교육/Noun,6,1,5,1.1115310228308472e-05,5.5534575826909837e-05,0.8333333333333334
13980,증지위/Noun,6,5,1,5.557655114154236e-05,1.1106915165381966e-05,0.8333333333333334
13981,엎드리다/Verb,6,1,5,1.1115310228308472e-05,5.5534575826909837e-05,0.8333333333333334
13982,행여/Noun,6,1,5,1.1115310228308472e-05,5.5534575826909837e-05,0.8333333333333334
13983,서럽다/Adjective,6,5,1,5.557655114154236e-05,1.1106915165381966e-05,0.8333333333333334
13984,레오나르도/Noun,6,5,1,5.557655114154236e-05,1.1106915165381966e-05,0.8333333333333334
13985,한평생/Noun,6,1,5,1.1115310228308472e-05,5.5534575826909837e-05,0.8333333333333334
13986,자주자주/Adverb,6,5,1,5.557655114154236e-05,1.1106915165381966e-05,0.8333333333333334
13987,꺽/Noun,6,1,5,1.1115310228308472e-05,5.5534575826909837e-05,0.8333333333333334
13988,That/Alpha,6,5,1,5.557655114154236e-05,1.1106915165381966e-05,0.8333333333333334
13989,서준영/Noun,6,5,1,5.557655114154236e-05,1.1106915165381966e-05,0.8333333333333334
13990,갈갈/Adverb,6,1,5,1.1115310228308472e-05,5.5534575826909837e-05,0.8333333333333334
13991,^^!!/Punctuation,6,5,1,5.557655114154236e-05,1.1106915165381966e-05,0.8333333333333334
13992,호아킨/Noun,6,5,1,5.557655114154236e-05,1.1106915165381966e-05,0.8333333333333334
13993,쩝쩝/Adverb,6,1,5,1.1115310228308472e-05,5.5534575826909837e-05,0.8333333333333334
13994,쫓아오다/Verb,6,1,5,1.1115310228308472e-05,5.5534575826909837e-05,0.8333333333333334
13995,ㅈㅅ/KoreanParticle,6,1,5,1.1115310228308472e-05,5.5534575826909837e-05,0.8333333333333334
13996,노파/Noun,6,1,5,1.1115310228308472e-05,5.5534575826909837e-05,0.8333333333333334
13997,보안/Noun,6,1,5,1.1115310228308472e-05,5.5534575826909837e-05,0.8333333333333334
13998,7.2/Number,6,1,5,1.1115310228308472e-05,5.5534575826909837e-05,0.8333333333333334
13999,U/Alpha,6,5,1,5.557655114154236e-05,1.1106915165381966e-05,0.8333333333333334
14000,2천원/Number,6,1,5,1.1115310228308472e-05,5.5534575826909837e-05,0.8333333333333334
14001,떄리다/Verb,6,1,5,1.1115310228308472e-05,5.5534575826909837e-05,0.8333333333333334
14002,할껀/Noun,6,1,5,1.1115310228308472e-05,5.5534575826909837e-05,0.8333333333333334
14003,학교괴담/Noun,6,1,5,1.1115310228308472e-05,5.5534575826909837e-05,0.8333333333333334
14004,정의감/Noun,6,1,5,1.1115310228308472e-05,5.5534575826909837e-05,0.8333333333333334
14005,자재/Noun,6,1,5,1.1115310228308472e-05,5.5534575826909837e-05,0.8333333333333334
14006,대열/Noun,6,1,5,1.1115310228308472e-05,5.5534575826909837e-05,0.8333333333333334
14007,행방불명/Noun,6,5,1,5.557655114154236e-05,1.1106915165381966e-05,0.8333333333333334
14008,편안함/Noun,6,5,1,5.557655114154236e-05,1.1106915165381966e-05,0.8333333333333334
14009,앤해서웨이/Noun,6,5,1,5.557655114154236e-05,1.1106915165381966e-05,0.8333333333333334
14010,심기/Noun,6,1,5,1.1115310228308472e-05,5.5534575826909837e-05,0.8333333333333334
14011,변강쇠/Noun,6,1,5,1.1115310228308472e-05,5.5534575826909837e-05,0.8333333333333334
14012,쓰다/Adjective,6,1,5,1.1115310228308472e-05,5.5534575826909837e-05,0.8333333333333334
14013,권태/Noun,6,5,1,5.557655114154236e-05,1.1106915165381966e-05,0.8333333333333334
14014,포텐/Noun,6,5,1,5.557655114154236e-05,1.1106915165381966e-05,0.8333333333333334
14015,소릴/Noun,6,1,5,1.1115310228308472e-05,5.5534575826909837e-05,0.8333333333333334
14016,적중/Noun,6,1,5,1.1115310228308472e-05,5.5534575826909837e-05,0.8333333333333334
14017,장해/Noun,6,5,1,5.557655114154236e-05,1.1106915165381966e-05,0.8333333333333334
14018,...-_-;;/Punctuation,6,1,5,1.1115310228308472e-05,5.5534575826909837e-05,0.8333333333333334
14019,미란/Noun,6,5,1,5.557655114154236e-05,1.1106915165381966e-05,0.8333333333333334
14020,~~~~!!!!/Punctuation,6,5,1,5.557655114154236e-05,1.1106915165381966e-05,0.8333333333333334
14021,시카고/Noun,6,1,5,1.1115310228308472e-05,5.5534575826909837e-05,0.8333333333333334
14022,구더기/Noun,6,1,5,1.1115310228308472e-05,5.5534575826909837e-05,0.8333333333333334
14023,도가니탕/Noun,6,5,1,5.557655114154236e-05,1.1106915165381966e-05,0.8333333333333334
14024,훨훨/Noun,6,5,1,5.557655114154236e-05,1.1106915165381966e-05,0.8333333333333334
14025,떡볶이/Noun,6,1,5,1.1115310228308472e-05,5.5534575826909837e-05,0.8333333333333334
14026,작인데/Foreign,6,5,1,5.557655114154236e-05,1.1106915165381966e-05,0.8333333333333334
14027,베틀/Noun,6,1,5,1.1115310228308472e-05,5.5534575826909837e-05,0.8333333333333334
14028,진희/Noun,6,5,1,5.557655114154236e-05,1.1106915165381966e-05,0.8333333333333334
14029,떵/Noun,6,1,5,1.1115310228308472e-05,5.5534575826909837e-05,0.8333333333333334
14030,시가전/Noun,6,5,1,5.557655114154236e-05,1.1106915165381966e-05,0.8333333333333334
14031,공지/Noun,6,1,5,1.1115310228308472e-05,5.5534575826909837e-05,0.8333333333333334
14032,구관/Noun,6,5,1,5.557655114154236e-05,1.1106915165381966e-05,0.8333333333333334
14033,집애/Noun,6,1,5,1.1115310228308472e-05,5.5534575826909837e-05,0.8333333333333334
14034,9.3/Number,6,5,1,5.557655114154236e-05,1.1106915165381966e-05,0.8333333333333334
14035,빡빡이/Noun,6,1,5,1.1115310228308472e-05,5.5534575826909837e-05,0.8333333333333334
14036,힌트/Noun,6,5,1,5.557655114154236e-05,1.1106915165381966e-05,0.8333333333333334
14037,여덟/Noun,6,5,1,5.557655114154236e-05,1.1106915165381966e-05,0.8333333333333334
14038,반토막/Noun,6,1,5,1.1115310228308472e-05,5.5534575826909837e-05,0.8333333333333334
14039,스케이트보드/Noun,6,1,5,1.1115310228308472e-05,5.5534575826909837e-05,0.8333333333333334
14040,항우/Noun,6,5,1,5.557655114154236e-05,1.1106915165381966e-05,0.8333333333333334
14041,기면/Noun,6,1,5,1.1115310228308472e-05,5.5534575826909837e-05,0.8333333333333334
14042,현명/Noun,6,5,1,5.557655114154236e-05,1.1106915165381966e-05,0.8333333333333334
14043,임채무/Noun,6,1,5,1.1115310228308472e-05,5.5534575826909837e-05,0.8333333333333334
14044,Kbs/Alpha,6,1,5,1.1115310228308472e-05,5.5534575826909837e-05,0.8333333333333334
14045,소환/Noun,6,1,5,1.1115310228308472e-05,5.5534575826909837e-05,0.8333333333333334
14046,벌벌/Noun,6,5,1,5.557655114154236e-05,1.1106915165381966e-05,0.8333333333333334
14047,지문/Noun,6,5,1,5.557655114154236e-05,1.1106915165381966e-05,0.8333333333333334
14048,페인트/Noun,6,1,5,1.1115310228308472e-05,5.5534575826909837e-05,0.8333333333333334
14049,끄덕이다/Verb,6,5,1,5.557655114154236e-05,1.1106915165381966e-05,0.8333333333333334
14050,28년/Number,6,5,1,5.557655114154236e-05,1.1106915165381966e-05,0.8333333333333334
14051,가/Noun,6,5,1,5.557655114154236e-05,1.1106915165381966e-05,0.8333333333333334
14052,유느님/Noun,6,5,1,5.557655114154236e-05,1.1106915165381966e-05,0.8333333333333334
14053,지휘자/Noun,6,5,1,5.557655114154236e-05,1.1106915165381966e-05,0.8333333333333334
14054,텐/Noun,6,5,1,5.557655114154236e-05,1.1106915165381966e-05,0.8333333333333334
14055,불확실하다/Adjective,6,5,1,5.557655114154236e-05,1.1106915165381966e-05,0.8333333333333334
14056,백투더퓨처/Noun,6,5,1,5.557655114154236e-05,1.1106915165381966e-05,0.8333333333333334
14057,스카이폴/Noun,6,5,1,5.557655114154236e-05,1.1106915165381966e-05,0.8333333333333334
14058,추방/Noun,6,1,5,1.1115310228308472e-05,5.5534575826909837e-05,0.8333333333333334
14059,삼겹살/Noun,6,1,5,1.1115310228308472e-05,5.5534575826909837e-05,0.8333333333333334
14060,원영/Noun,6,5,1,5.557655114154236e-05,1.1106915165381966e-05,0.8333333333333334
14061,시신/Noun,6,5,1,5.557655114154236e-05,1.1106915165381966e-05,0.8333333333333334
14062,슬펏/Noun,6,5,1,5.557655114154236e-05,1.1106915165381966e-05,0.8333333333333334
14063,허준호/Noun,6,5,1,5.557655114154236e-05,1.1106915165381966e-05,0.8333333333333334
14064,관조/Noun,6,5,1,5.557655114154236e-05,1.1106915165381966e-05,0.8333333333333334
14065,프리미엄/Noun,6,1,5,1.1115310228308472e-05,5.5534575826909837e-05,0.8333333333333334
14066,프리즌브레이크/Noun,6,5,1,5.557655114154236e-05,1.1106915165381966e-05,0.8333333333333334
14067,상과/Noun,6,5,1,5.557655114154236e-05,1.1106915165381966e-05,0.8333333333333334
14068,귀척/Noun,6,1,5,1.1115310228308472e-05,5.5534575826909837e-05,0.8333333333333334
14069,공블리/Noun,6,5,1,5.557655114154236e-05,1.1106915165381966e-05,0.8333333333333334
14070,육식/Noun,6,5,1,5.557655114154236e-05,1.1106915165381966e-05,0.8333333333333334
14071,손쉽다/Adjective,6,1,5,1.1115310228308472e-05,5.5534575826909837e-05,0.8333333333333334
14072,다시없다/Adjective,6,4,2,4.446124091323389e-05,2.2213830330763933e-05,0.6666666666666666
14073,팅/Noun,6,2,4,2.2230620456616944e-05,4.4427660661527865e-05,0.6666666666666666
14074,키다/Noun,6,2,4,2.2230620456616944e-05,4.4427660661527865e-05,0.6666666666666666
14075,앨/Noun,6,2,4,2.2230620456616944e-05,4.4427660661527865e-05,0.6666666666666666
14076,메스/Noun,6,4,2,4.446124091323389e-05,2.2213830330763933e-05,0.6666666666666666
14077,팽배/Noun,6,4,2,4.446124091323389e-05,2.2213830330763933e-05,0.6666666666666666
14078,에로스/Noun,6,2,4,2.2230620456616944e-05,4.4427660661527865e-05,0.6666666666666666
14079,뷰티풀/Noun,6,2,4,2.2230620456616944e-05,4.4427660661527865e-05,0.6666666666666666
14080,다발/Noun,6,2,4,2.2230620456616944e-05,4.4427660661527865e-05,0.6666666666666666
14081,혓바닥/Noun,6,4,2,4.446124091323389e-05,2.2213830330763933e-05,0.6666666666666666
14082,노익/Noun,6,4,2,4.446124091323389e-05,2.2213830330763933e-05,0.6666666666666666
14083,컨디션/Noun,6,2,4,2.2230620456616944e-05,4.4427660661527865e-05,0.6666666666666666
14084,IT/Alpha,6,4,2,4.446124091323389e-05,2.2213830330763933e-05,0.6666666666666666
14085,혼동/Noun,6,2,4,2.2230620456616944e-05,4.4427660661527865e-05,0.6666666666666666
14086,진시황/Noun,6,4,2,4.446124091323389e-05,2.2213830330763933e-05,0.6666666666666666
14087,하수/Noun,6,2,4,2.2230620456616944e-05,4.4427660661527865e-05,0.6666666666666666
14088,꿋꿋/Noun,6,4,2,4.446124091323389e-05,2.2213830330763933e-05,0.6666666666666666
14089,바우어/Noun,6,4,2,4.446124091323389e-05,2.2213830330763933e-05,0.6666666666666666
14090,12시/Number,6,4,2,4.446124091323389e-05,2.2213830330763933e-05,0.6666666666666666
14091,....;/Punctuation,6,2,4,2.2230620456616944e-05,4.4427660661527865e-05,0.6666666666666666
14092,차수연/Noun,6,4,2,4.446124091323389e-05,2.2213830330763933e-05,0.6666666666666666
14093,눌/Noun,6,2,4,2.2230620456616944e-05,4.4427660661527865e-05,0.6666666666666666
14094,애완견/Noun,6,4,2,4.446124091323389e-05,2.2213830330763933e-05,0.6666666666666666
14095,아나콘다/Noun,6,2,4,2.2230620456616944e-05,4.4427660661527865e-05,0.6666666666666666
14096,아기자기/Noun,6,4,2,4.446124091323389e-05,2.2213830330763933e-05,0.6666666666666666
14097,수상/Noun,6,2,4,2.2230620456616944e-05,4.4427660661527865e-05,0.6666666666666666
14098,갱스부르/Noun,6,4,2,4.446124091323389e-05,2.2213830330763933e-05,0.6666666666666666
14099,중인/Noun,6,4,2,4.446124091323389e-05,2.2213830330763933e-05,0.6666666666666666
14100,조단/Noun,6,2,4,2.2230620456616944e-05,4.4427660661527865e-05,0.6666666666666666
14101,로빈훗/Noun,6,2,4,2.2230620456616944e-05,4.4427660661527865e-05,0.6666666666666666
14102,이라기보단/Josa,6,2,4,2.2230620456616944e-05,4.4427660661527865e-05,0.6666666666666666
14103,마치다/Verb,6,4,2,4.446124091323389e-05,2.2213830330763933e-05,0.6666666666666666
14104,금세/Noun,6,4,2,4.446124091323389e-05,2.2213830330763933e-05,0.6666666666666666
14105,드루/Noun,6,2,4,2.2230620456616944e-05,4.4427660661527865e-05,0.6666666666666666
14106,표준/Noun,6,4,2,4.446124091323389e-05,2.2213830330763933e-05,0.6666666666666666
14107,인자/Noun,6,4,2,4.446124091323389e-05,2.2213830330763933e-05,0.6666666666666666
14108,틈틈이/Noun,6,4,2,4.446124091323389e-05,2.2213830330763933e-05,0.6666666666666666
14109,ㅇㅂ/KoreanParticle,6,4,2,4.446124091323389e-05,2.2213830330763933e-05,0.6666666666666666
14110,상적/Noun,6,2,4,2.2230620456616944e-05,4.4427660661527865e-05,0.6666666666666666
14111,교황/Noun,6,4,2,4.446124091323389e-05,2.2213830330763933e-05,0.6666666666666666
14112,색도/Noun,6,4,2,4.446124091323389e-05,2.2213830330763933e-05,0.6666666666666666
14113,소세지/Noun,6,2,4,2.2230620456616944e-05,4.4427660661527865e-05,0.6666666666666666
14114,영동/Noun,6,4,2,4.446124091323389e-05,2.2213830330763933e-05,0.6666666666666666
14115,표류/Noun,6,2,4,2.2230620456616944e-05,4.4427660661527865e-05,0.6666666666666666
14116,순순하다/Adjective,6,4,2,4.446124091323389e-05,2.2213830330763933e-05,0.6666666666666666
14117,캔/Noun,6,4,2,4.446124091323389e-05,2.2213830330763933e-05,0.6666666666666666
14118,혼내다/Verb,6,2,4,2.2230620456616944e-05,4.4427660661527865e-05,0.6666666666666666
14119,단추/Noun,6,2,4,2.2230620456616944e-05,4.4427660661527865e-05,0.6666666666666666
14120,독일인/Noun,6,2,4,2.2230620456616944e-05,4.4427660661527865e-05,0.6666666666666666
14121,준호/Noun,6,4,2,4.446124091323389e-05,2.2213830330763933e-05,0.6666666666666666
14122,이다지/Noun,6,4,2,4.446124091323389e-05,2.2213830330763933e-05,0.6666666666666666
14123,음원/Noun,6,4,2,4.446124091323389e-05,2.2213830330763933e-05,0.6666666666666666
14124,Of/Alpha,6,4,2,4.446124091323389e-05,2.2213830330763933e-05,0.6666666666666666
14125,)(/Punctuation,6,4,2,4.446124091323389e-05,2.2213830330763933e-05,0.6666666666666666
14126,넉/Noun,6,2,4,2.2230620456616944e-05,4.4427660661527865e-05,0.6666666666666666
14127,서여/Noun,6,2,4,2.2230620456616944e-05,4.4427660661527865e-05,0.6666666666666666
14128,제크로무/Noun,6,4,2,4.446124091323389e-05,2.2213830330763933e-05,0.6666666666666666
14129,1988년/Number,6,4,2,4.446124091323389e-05,2.2213830330763933e-05,0.6666666666666666
14130,리사/Noun,6,2,4,2.2230620456616944e-05,4.4427660661527865e-05,0.6666666666666666
14131,장강/Noun,6,4,2,4.446124091323389e-05,2.2213830330763933e-05,0.6666666666666666
14132,그떄/Noun,6,4,2,4.446124091323389e-05,2.2213830330763933e-05,0.6666666666666666
14133,운동화/Noun,6,4,2,4.446124091323389e-05,2.2213830330763933e-05,0.6666666666666666
14134,~_~/Punctuation,6,2,4,2.2230620456616944e-05,4.4427660661527865e-05,0.6666666666666666
14135,분해/Noun,6,2,4,2.2230620456616944e-05,4.4427660661527865e-05,0.6666666666666666
14136,시댁/Noun,6,2,4,2.2230620456616944e-05,4.4427660661527865e-05,0.6666666666666666
14137,영드/Noun,6,4,2,4.446124091323389e-05,2.2213830330763933e-05,0.6666666666666666
14138,트라이앵글/Noun,6,2,4,2.2230620456616944e-05,4.4427660661527865e-05,0.6666666666666666
14139,박정철/Noun,6,2,4,2.2230620456616944e-05,4.4427660661527865e-05,0.6666666666666666
14140,풀기/Noun,6,2,4,2.2230620456616944e-05,4.4427660661527865e-05,0.6666666666666666
14141,쇼트/Noun,6,4,2,4.446124091323389e-05,2.2213830330763933e-05,0.6666666666666666
14142,메이커/Noun,6,4,2,4.446124091323389e-05,2.2213830330763933e-05,0.6666666666666666
14143,실하다/Adjective,6,2,4,2.2230620456616944e-05,4.4427660661527865e-05,0.6666666666666666
14144,첫걸음/Noun,6,4,2,4.446124091323389e-05,2.2213830330763933e-05,0.6666666666666666
14145,38/Number,6,2,4,2.2230620456616944e-05,4.4427660661527865e-05,0.6666666666666666
14146,스피릿/Noun,6,4,2,4.446124091323389e-05,2.2213830330763933e-05,0.6666666666666666
14147,스웨/Noun,6,4,2,4.446124091323389e-05,2.2213830330763933e-05,0.6666666666666666
14148,닥터진/Noun,6,2,4,2.2230620456616944e-05,4.4427660661527865e-05,0.6666666666666666
14149,먼로/Noun,6,4,2,4.446124091323389e-05,2.2213830330763933e-05,0.6666666666666666
14150,죠/Noun,6,2,4,2.2230620456616944e-05,4.4427660661527865e-05,0.6666666666666666
14151,8시/Number,6,2,4,2.2230620456616944e-05,4.4427660661527865e-05,0.6666666666666666
14152,웃겻다/Noun,6,4,2,4.446124091323389e-05,2.2213830330763933e-05,0.6666666666666666
14153,고구려/Noun,6,2,4,2.2230620456616944e-05,4.4427660661527865e-05,0.6666666666666666
14154,단번/Noun,6,4,2,4.446124091323389e-05,2.2213830330763933e-05,0.6666666666666666
14155,지름길/Noun,6,2,4,2.2230620456616944e-05,4.4427660661527865e-05,0.6666666666666666
14156,흐음/Exclamation,6,4,2,4.446124091323389e-05,2.2213830330763933e-05,0.6666666666666666
14157,아리랑/Noun,6,4,2,4.446124091323389e-05,2.2213830330763933e-05,0.6666666666666666
14158,신참/Noun,6,2,4,2.2230620456616944e-05,4.4427660661527865e-05,0.6666666666666666
14159,까불다/Verb,6,2,4,2.2230620456616944e-05,4.4427660661527865e-05,0.6666666666666666
14160,번가/Noun,6,4,2,4.446124091323389e-05,2.2213830330763933e-05,0.6666666666666666
14161,싹트다/Verb,6,4,2,4.446124091323389e-05,2.2213830330763933e-05,0.6666666666666666
14162,테크닉/Noun,6,2,4,2.2230620456616944e-05,4.4427660661527865e-05,0.6666666666666666
14163,예뻣다/Noun,6,4,2,4.446124091323389e-05,2.2213830330763933e-05,0.6666666666666666
14164,복수혈전/Noun,6,2,4,2.2230620456616944e-05,4.4427660661527865e-05,0.6666666666666666
14165,가두/Noun,6,4,2,4.446124091323389e-05,2.2213830330763933e-05,0.6666666666666666
14166,촛점/Noun,6,4,2,4.446124091323389e-05,2.2213830330763933e-05,0.6666666666666666
14167,83년/Number,6,2,4,2.2230620456616944e-05,4.4427660661527865e-05,0.6666666666666666
14168,오경/Noun,6,2,4,2.2230620456616944e-05,4.4427660661527865e-05,0.6666666666666666
14169,지노/Noun,6,2,4,2.2230620456616944e-05,4.4427660661527865e-05,0.6666666666666666
14170,도사/Noun,6,4,2,4.446124091323389e-05,2.2213830330763933e-05,0.6666666666666666
14171,엣지/Noun,6,4,2,4.446124091323389e-05,2.2213830330763933e-05,0.6666666666666666
14172,인방/Noun,6,2,4,2.2230620456616944e-05,4.4427660661527865e-05,0.6666666666666666
14173,은총/Noun,6,4,2,4.446124091323389e-05,2.2213830330763933e-05,0.6666666666666666
14174,중/Foreign,6,2,4,2.2230620456616944e-05,4.4427660661527865e-05,0.6666666666666666
14175,베니스/Noun,6,2,4,2.2230620456616944e-05,4.4427660661527865e-05,0.6666666666666666
14176,텍스트/Noun,6,2,4,2.2230620456616944e-05,4.4427660661527865e-05,0.6666666666666666
14177,스튜디오/Noun,6,2,4,2.2230620456616944e-05,4.4427660661527865e-05,0.6666666666666666
14178,소나타/Noun,6,4,2,4.446124091323389e-05,2.2213830330763933e-05,0.6666666666666666
14179,말살/Noun,6,4,2,4.446124091323389e-05,2.2213830330763933e-05,0.6666666666666666
14180,1999/Number,6,2,4,2.2230620456616944e-05,4.4427660661527865e-05,0.6666666666666666
14181,불완전하다/Adjective,6,4,2,4.446124091323389e-05,2.2213830330763933e-05,0.6666666666666666
14182,신밧드/Noun,6,2,4,2.2230620456616944e-05,4.4427660661527865e-05,0.6666666666666666
14183,심장마비/Noun,6,2,4,2.2230620456616944e-05,4.4427660661527865e-05,0.6666666666666666
14184,교인/Noun,6,4,2,4.446124091323389e-05,2.2213830330763933e-05,0.6666666666666666
14185,짜릿/Noun,6,4,2,4.446124091323389e-05,2.2213830330763933e-05,0.6666666666666666
14186,알바인/Noun,6,2,4,2.2230620456616944e-05,4.4427660661527865e-05,0.6666666666666666
14187,심지호/Noun,6,4,2,4.446124091323389e-05,2.2213830330763933e-05,0.6666666666666666
14188,솔져/Noun,6,2,4,2.2230620456616944e-05,4.4427660661527865e-05,0.6666666666666666
14189,외적/Noun,6,2,4,2.2230620456616944e-05,4.4427660661527865e-05,0.6666666666666666
14190,김상중/Noun,6,4,2,4.446124091323389e-05,2.2213830330763933e-05,0.6666666666666666
14191,영화에서처럼/Noun,6,2,4,2.2230620456616944e-05,4.4427660661527865e-05,0.6666666666666666
14192,절단/Noun,6,4,2,4.446124091323389e-05,2.2213830330763933e-05,0.6666666666666666
14193,전지전능하다/Adjective,6,2,4,2.2230620456616944e-05,4.4427660661527865e-05,0.6666666666666666
14194,헤아리다/Verb,6,4,2,4.446124091323389e-05,2.2213830330763933e-05,0.6666666666666666
14195,사후세계/Noun,6,4,2,4.446124091323389e-05,2.2213830330763933e-05,0.6666666666666666
14196,한바탕/Noun,6,4,2,4.446124091323389e-05,2.2213830330763933e-05,0.6666666666666666
14197,머신/Noun,6,2,4,2.2230620456616944e-05,4.4427660661527865e-05,0.6666666666666666
14198,이다희/Noun,6,4,2,4.446124091323389e-05,2.2213830330763933e-05,0.6666666666666666
14199,문의/Noun,6,2,4,2.2230620456616944e-05,4.4427660661527865e-05,0.6666666666666666
14200,마여/Noun,6,2,4,2.2230620456616944e-05,4.4427660661527865e-05,0.6666666666666666
14201,흡/Exclamation,6,4,2,4.446124091323389e-05,2.2213830330763933e-05,0.6666666666666666
14202,야간/Noun,6,4,2,4.446124091323389e-05,2.2213830330763933e-05,0.6666666666666666
14203,자폐증/Noun,6,4,2,4.446124091323389e-05,2.2213830330763933e-05,0.6666666666666666
14204,신년/Noun,6,2,4,2.2230620456616944e-05,4.4427660661527865e-05,0.6666666666666666
14205,시공/Noun,6,2,4,2.2230620456616944e-05,4.4427660661527865e-05,0.6666666666666666
14206,서술/Noun,6,2,4,2.2230620456616944e-05,4.4427660661527865e-05,0.6666666666666666
14207,막대/Noun,6,2,4,2.2230620456616944e-05,4.4427660661527865e-05,0.6666666666666666
14208,??;;/Punctuation,6,2,4,2.2230620456616944e-05,4.4427660661527865e-05,0.6666666666666666
14209,틀어지다/Verb,6,2,4,2.2230620456616944e-05,4.4427660661527865e-05,0.6666666666666666
14210,익스펜더블/Noun,6,4,2,4.446124091323389e-05,2.2213830330763933e-05,0.6666666666666666
14211,외출/Noun,6,4,2,4.446124091323389e-05,2.2213830330763933e-05,0.6666666666666666
14212,분쇄기/Noun,6,2,4,2.2230620456616944e-05,4.4427660661527865e-05,0.6666666666666666
14213,저가/Noun,6,2,4,2.2230620456616944e-05,4.4427660661527865e-05,0.6666666666666666
14214,토가시/Noun,6,2,4,2.2230620456616944e-05,4.4427660661527865e-05,0.6666666666666666
14215,라니까/Josa,6,2,4,2.2230620456616944e-05,4.4427660661527865e-05,0.6666666666666666
14216,"....,/Punctuation",6,2,4,2.2230620456616944e-05,4.4427660661527865e-05,0.6666666666666666
14217,한결/Noun,6,4,2,4.446124091323389e-05,2.2213830330763933e-05,0.6666666666666666
14218,야만인/Noun,6,4,2,4.446124091323389e-05,2.2213830330763933e-05,0.6666666666666666
14219,이블/Noun,6,2,4,2.2230620456616944e-05,4.4427660661527865e-05,0.6666666666666666
14220,ANG/Alpha,6,4,2,4.446124091323389e-05,2.2213830330763933e-05,0.6666666666666666
14221,티브/Noun,6,2,4,2.2230620456616944e-05,4.4427660661527865e-05,0.6666666666666666
14222,가모/Noun,6,4,2,4.446124091323389e-05,2.2213830330763933e-05,0.6666666666666666
14223,재정/Noun,6,2,4,2.2230620456616944e-05,4.4427660661527865e-05,0.6666666666666666
14224,웃찾사/Noun,6,2,4,2.2230620456616944e-05,4.4427660661527865e-05,0.6666666666666666
14225,변기/Noun,6,2,4,2.2230620456616944e-05,4.4427660661527865e-05,0.6666666666666666
14226,간략하다/Adjective,6,2,4,2.2230620456616944e-05,4.4427660661527865e-05,0.6666666666666666
14227,스티치/Noun,6,4,2,4.446124091323389e-05,2.2213830330763933e-05,0.6666666666666666
14228,직후/Noun,6,4,2,4.446124091323389e-05,2.2213830330763933e-05,0.6666666666666666
14229,우의/Noun,6,4,2,4.446124091323389e-05,2.2213830330763933e-05,0.6666666666666666
14230,버터/Noun,6,4,2,4.446124091323389e-05,2.2213830330763933e-05,0.6666666666666666
14231,영화개봉/Noun,6,4,2,4.446124091323389e-05,2.2213830330763933e-05,0.6666666666666666
14232,패쓰/Noun,6,2,4,2.2230620456616944e-05,4.4427660661527865e-05,0.6666666666666666
14233,)+/Punctuation,6,4,2,4.446124091323389e-05,2.2213830330763933e-05,0.6666666666666666
14234,...!!!!/Punctuation,6,4,2,4.446124091323389e-05,2.2213830330763933e-05,0.6666666666666666
14235,험하다/Adjective,6,4,2,4.446124091323389e-05,2.2213830330763933e-05,0.6666666666666666
14236,130/Number,6,2,4,2.2230620456616944e-05,4.4427660661527865e-05,0.6666666666666666
14237,알아채다/Verb,6,2,4,2.2230620456616944e-05,4.4427660661527865e-05,0.6666666666666666
14238,영영/Noun,6,2,4,2.2230620456616944e-05,4.4427660661527865e-05,0.6666666666666666
14239,캐시/Noun,6,4,2,4.446124091323389e-05,2.2213830330763933e-05,0.6666666666666666
14240,힌/Noun,6,4,2,4.446124091323389e-05,2.2213830330763933e-05,0.6666666666666666
14241,csi/Alpha,6,4,2,4.446124091323389e-05,2.2213830330763933e-05,0.6666666666666666
14242,이블데드/Noun,6,4,2,4.446124091323389e-05,2.2213830330763933e-05,0.6666666666666666
14243,잡것/Noun,6,2,4,2.2230620456616944e-05,4.4427660661527865e-05,0.6666666666666666
14244,이스/Noun,6,4,2,4.446124091323389e-05,2.2213830330763933e-05,0.6666666666666666
14245,여우주연상/Noun,6,4,2,4.446124091323389e-05,2.2213830330763933e-05,0.6666666666666666
14246,양대/Modifier,6,4,2,4.446124091323389e-05,2.2213830330763933e-05,0.6666666666666666
14247,란말/Noun,6,2,4,2.2230620456616944e-05,4.4427660661527865e-05,0.6666666666666666
14248,역도/Noun,6,4,2,4.446124091323389e-05,2.2213830330763933e-05,0.6666666666666666
14249,수임/Noun,6,2,4,2.2230620456616944e-05,4.4427660661527865e-05,0.6666666666666666
14250,피크닉/Noun,6,4,2,4.446124091323389e-05,2.2213830330763933e-05,0.6666666666666666
14251,텅텅/Noun,6,2,4,2.2230620456616944e-05,4.4427660661527865e-05,0.6666666666666666
14252,셧으/Noun,6,4,2,4.446124091323389e-05,2.2213830330763933e-05,0.6666666666666666
14253,핡/Noun,6,4,2,4.446124091323389e-05,2.2213830330763933e-05,0.6666666666666666
14254,도미/Noun,6,2,4,2.2230620456616944e-05,4.4427660661527865e-05,0.6666666666666666
14255,자크/Noun,6,4,2,4.446124091323389e-05,2.2213830330763933e-05,0.6666666666666666
14256,'../Punctuation,6,4,2,4.446124091323389e-05,2.2213830330763933e-05,0.6666666666666666
14257,칭/Noun,6,4,2,4.446124091323389e-05,2.2213830330763933e-05,0.6666666666666666
14258,자꾸자꾸/Adverb,6,4,2,4.446124091323389e-05,2.2213830330763933e-05,0.6666666666666666
14259,들썩이다/Verb,6,4,2,4.446124091323389e-05,2.2213830330763933e-05,0.6666666666666666
14260,유토피아/Noun,6,4,2,4.446124091323389e-05,2.2213830330763933e-05,0.6666666666666666
14261,후끈/Noun,6,4,2,4.446124091323389e-05,2.2213830330763933e-05,0.6666666666666666
14262,동호회/Noun,6,2,4,2.2230620456616944e-05,4.4427660661527865e-05,0.6666666666666666
14263,뻐꾸기/Noun,6,2,4,2.2230620456616944e-05,4.4427660661527865e-05,0.6666666666666666
14264,복사기/Noun,6,4,2,4.446124091323389e-05,2.2213830330763933e-05,0.6666666666666666
14265,거슬러/Noun,6,2,4,2.2230620456616944e-05,4.4427660661527865e-05,0.6666666666666666
14266,바네사/Noun,6,4,2,4.446124091323389e-05,2.2213830330763933e-05,0.6666666666666666
14267,박멸/Noun,6,2,4,2.2230620456616944e-05,4.4427660661527865e-05,0.6666666666666666
14268,시들다/Verb,6,4,2,4.446124091323389e-05,2.2213830330763933e-05,0.6666666666666666
14269,요건/Noun,6,2,4,2.2230620456616944e-05,4.4427660661527865e-05,0.6666666666666666
14270,덤블도어/Noun,6,4,2,4.446124091323389e-05,2.2213830330763933e-05,0.6666666666666666
14271,코믹스/Noun,6,2,4,2.2230620456616944e-05,4.4427660661527865e-05,0.6666666666666666
14272,남탓/Noun,6,2,4,2.2230620456616944e-05,4.4427660661527865e-05,0.6666666666666666
14273,글치/Noun,6,4,2,4.446124091323389e-05,2.2213830330763933e-05,0.6666666666666666
14274,그레이엄/Noun,6,2,4,2.2230620456616944e-05,4.4427660661527865e-05,0.6666666666666666
14275,67년/Number,6,4,2,4.446124091323389e-05,2.2213830330763933e-05,0.6666666666666666
14276,브레인/Noun,6,4,2,4.446124091323389e-05,2.2213830330763933e-05,0.6666666666666666
14277,ㅣㅇ/KoreanParticle,6,4,2,4.446124091323389e-05,2.2213830330763933e-05,0.6666666666666666
14278,병아리/Noun,6,4,2,4.446124091323389e-05,2.2213830330763933e-05,0.6666666666666666
14279,스테이/Noun,6,2,4,2.2230620456616944e-05,4.4427660661527865e-05,0.6666666666666666
14280,템/Noun,6,2,4,2.2230620456616944e-05,4.4427660661527865e-05,0.6666666666666666
14281,열렬하다/Adjective,6,4,2,4.446124091323389e-05,2.2213830330763933e-05,0.6666666666666666
14282,킬머/Noun,6,4,2,4.446124091323389e-05,2.2213830330763933e-05,0.6666666666666666
14283,볼순/Noun,6,4,2,4.446124091323389e-05,2.2213830330763933e-05,0.6666666666666666
14284,동질감/Noun,6,4,2,4.446124091323389e-05,2.2213830330763933e-05,0.6666666666666666
14285,유로트립/Noun,6,2,4,2.2230620456616944e-05,4.4427660661527865e-05,0.6666666666666666
14286,노모/Noun,6,2,4,2.2230620456616944e-05,4.4427660661527865e-05,0.6666666666666666
14287,주고받다/Verb,6,2,4,2.2230620456616944e-05,4.4427660661527865e-05,0.6666666666666666
14288,대종상/Noun,6,4,2,4.446124091323389e-05,2.2213830330763933e-05,0.6666666666666666
14289,후다닥/Noun,6,2,4,2.2230620456616944e-05,4.4427660661527865e-05,0.6666666666666666
14290,관장/Noun,6,4,2,4.446124091323389e-05,2.2213830330763933e-05,0.6666666666666666
14291,파쇼/Noun,6,2,4,2.2230620456616944e-05,4.4427660661527865e-05,0.6666666666666666
14292,中/Foreign,6,4,2,4.446124091323389e-05,2.2213830330763933e-05,0.6666666666666666
14293,김광석/Noun,6,4,2,4.446124091323389e-05,2.2213830330763933e-05,0.6666666666666666
14294,촘촘/Noun,6,4,2,4.446124091323389e-05,2.2213830330763933e-05,0.6666666666666666
14295,웁니/Noun,6,4,2,4.446124091323389e-05,2.2213830330763933e-05,0.6666666666666666
14296,코미디언/Noun,6,4,2,4.446124091323389e-05,2.2213830330763933e-05,0.6666666666666666
14297,난장/Noun,6,2,4,2.2230620456616944e-05,4.4427660661527865e-05,0.6666666666666666
14298,얼얼하다/Adjective,6,4,2,4.446124091323389e-05,2.2213830330763933e-05,0.6666666666666666
14299,여성성/Noun,6,2,4,2.2230620456616944e-05,4.4427660661527865e-05,0.6666666666666666
14300,85분/Number,6,2,4,2.2230620456616944e-05,4.4427660661527865e-05,0.6666666666666666
14301,가타/Noun,6,4,2,4.446124091323389e-05,2.2213830330763933e-05,0.6666666666666666
14302,시실리/Noun,6,2,4,2.2230620456616944e-05,4.4427660661527865e-05,0.6666666666666666
14303,비루하다/Adjective,6,2,4,2.2230620456616944e-05,4.4427660661527865e-05,0.6666666666666666
14304,명인/Noun,6,2,4,2.2230620456616944e-05,4.4427660661527865e-05,0.6666666666666666
14305,사이버/Noun,6,4,2,4.446124091323389e-05,2.2213830330763933e-05,0.6666666666666666
14306,태원/Noun,6,2,4,2.2230620456616944e-05,4.4427660661527865e-05,0.6666666666666666
14307,관세음보살/Noun,6,2,4,2.2230620456616944e-05,4.4427660661527865e-05,0.6666666666666666
14308,애란/Noun,6,2,4,2.2230620456616944e-05,4.4427660661527865e-05,0.6666666666666666
14309,프로메테우스/Noun,6,4,2,4.446124091323389e-05,2.2213830330763933e-05,0.6666666666666666
14310,음란하다/Adjective,6,2,4,2.2230620456616944e-05,4.4427660661527865e-05,0.6666666666666666
14311,뿜었음/Noun,6,2,4,2.2230620456616944e-05,4.4427660661527865e-05,0.6666666666666666
14312,저팔계/Noun,6,2,4,2.2230620456616944e-05,4.4427660661527865e-05,0.6666666666666666
14313,그리드/Noun,6,4,2,4.446124091323389e-05,2.2213830330763933e-05,0.6666666666666666
14314,작품하나/Noun,6,4,2,4.446124091323389e-05,2.2213830330763933e-05,0.6666666666666666
14315,남기남/Noun,6,2,4,2.2230620456616944e-05,4.4427660661527865e-05,0.6666666666666666
14316,파라다이스/Noun,6,4,2,4.446124091323389e-05,2.2213830330763933e-05,0.6666666666666666
14317,뱃속/Noun,6,2,4,2.2230620456616944e-05,4.4427660661527865e-05,0.6666666666666666
14318,전염병/Noun,6,4,2,4.446124091323389e-05,2.2213830330763933e-05,0.6666666666666666
14319,68년/Number,6,4,2,4.446124091323389e-05,2.2213830330763933e-05,0.6666666666666666
14320,타래/Noun,6,4,2,4.446124091323389e-05,2.2213830330763933e-05,0.6666666666666666
14321,단합/Noun,6,4,2,4.446124091323389e-05,2.2213830330763933e-05,0.6666666666666666
14322,정독/Noun,6,2,4,2.2230620456616944e-05,4.4427660661527865e-05,0.6666666666666666
14323,엠마뉴엘/Noun,6,4,2,4.446124091323389e-05,2.2213830330763933e-05,0.6666666666666666
14324,컬킨/Noun,6,4,2,4.446124091323389e-05,2.2213830330763933e-05,0.6666666666666666
14325,컬리/Noun,6,2,4,2.2230620456616944e-05,4.4427660661527865e-05,0.6666666666666666
14326,고단/Noun,6,4,2,4.446124091323389e-05,2.2213830330763933e-05,0.6666666666666666
14327,이이이/Noun,6,2,4,2.2230620456616944e-05,4.4427660661527865e-05,0.6666666666666666
14328,식욕/Noun,6,4,2,4.446124091323389e-05,2.2213830330763933e-05,0.6666666666666666
14329,도도하다/Adjective,6,4,2,4.446124091323389e-05,2.2213830330763933e-05,0.6666666666666666
14330,계백/Noun,6,2,4,2.2230620456616944e-05,4.4427660661527865e-05,0.6666666666666666
14331,올여름/Noun,6,4,2,4.446124091323389e-05,2.2213830330763933e-05,0.6666666666666666
14332,수난/Noun,6,2,4,2.2230620456616944e-05,4.4427660661527865e-05,0.6666666666666666
14333,2009/Number,6,4,2,4.446124091323389e-05,2.2213830330763933e-05,0.6666666666666666
14334,스탠바이/Noun,6,4,2,4.446124091323389e-05,2.2213830330763933e-05,0.6666666666666666
14335,차돌/Noun,6,4,2,4.446124091323389e-05,2.2213830330763933e-05,0.6666666666666666
14336,박세영/Noun,6,4,2,4.446124091323389e-05,2.2213830330763933e-05,0.6666666666666666
14337,재팬/Noun,6,2,4,2.2230620456616944e-05,4.4427660661527865e-05,0.6666666666666666
14338,만두/Noun,6,2,4,2.2230620456616944e-05,4.4427660661527865e-05,0.6666666666666666
14339,특기/Noun,6,2,4,2.2230620456616944e-05,4.4427660661527865e-05,0.6666666666666666
14340,먀/Noun,6,2,4,2.2230620456616944e-05,4.4427660661527865e-05,0.6666666666666666
14341,냠냠/Adverb,6,2,4,2.2230620456616944e-05,4.4427660661527865e-05,0.6666666666666666
14342,활기차다/Adjective,6,4,2,4.446124091323389e-05,2.2213830330763933e-05,0.6666666666666666
14343,tvn/Alpha,6,4,2,4.446124091323389e-05,2.2213830330763933e-05,0.6666666666666666
14344,입대/Noun,6,4,2,4.446124091323389e-05,2.2213830330763933e-05,0.6666666666666666
14345,백만불/Noun,6,2,4,2.2230620456616944e-05,4.4427660661527865e-05,0.6666666666666666
14346,망은/Noun,6,4,2,4.446124091323389e-05,2.2213830330763933e-05,0.6666666666666666
14347,사면/Noun,6,4,2,4.446124091323389e-05,2.2213830330763933e-05,0.6666666666666666
14348,78년/Number,6,4,2,4.446124091323389e-05,2.2213830330763933e-05,0.6666666666666666
14349,임주환/Noun,6,4,2,4.446124091323389e-05,2.2213830330763933e-05,0.6666666666666666
14350,알콜/Noun,6,4,2,4.446124091323389e-05,2.2213830330763933e-05,0.6666666666666666
14351,백화점/Noun,6,4,2,4.446124091323389e-05,2.2213830330763933e-05,0.6666666666666666
14352,시집가다/Verb,6,2,4,2.2230620456616944e-05,4.4427660661527865e-05,0.6666666666666666
14353,펑/Noun,6,4,2,4.446124091323389e-05,2.2213830330763933e-05,0.6666666666666666
14354,국방부/Noun,6,2,4,2.2230620456616944e-05,4.4427660661527865e-05,0.6666666666666666
14355,!!!!!!!!!!!!!!!/Punctuation,6,4,2,4.446124091323389e-05,2.2213830330763933e-05,0.6666666666666666
14356,종려시/Noun,6,2,4,2.2230620456616944e-05,4.4427660661527865e-05,0.6666666666666666
14357,할애/Noun,6,2,4,2.2230620456616944e-05,4.4427660661527865e-05,0.6666666666666666
14358,패러디영화/Noun,6,2,4,2.2230620456616944e-05,4.4427660661527865e-05,0.6666666666666666
14359,아성/Noun,6,4,2,4.446124091323389e-05,2.2213830330763933e-05,0.6666666666666666
14360,장률/Noun,6,4,2,4.446124091323389e-05,2.2213830330763933e-05,0.6666666666666666
14361,산전수전/Noun,6,2,4,2.2230620456616944e-05,4.4427660661527865e-05,0.6666666666666666
14362,분리/Noun,6,4,2,4.446124091323389e-05,2.2213830330763933e-05,0.6666666666666666
14363,Movie/Alpha,6,4,2,4.446124091323389e-05,2.2213830330763933e-05,0.6666666666666666
14364,사이사이/Noun,6,4,2,4.446124091323389e-05,2.2213830330763933e-05,0.6666666666666666
14365,",,,,,,,/Punctuation",6,2,4,2.2230620456616944e-05,4.4427660661527865e-05,0.6666666666666666
14366,스타일리시/Noun,6,4,2,4.446124091323389e-05,2.2213830330763933e-05,0.6666666666666666
14367,차림/Noun,6,2,4,2.2230620456616944e-05,4.4427660661527865e-05,0.6666666666666666
14368,달고나/Noun,6,2,4,2.2230620456616944e-05,4.4427660661527865e-05,0.6666666666666666
14369,부인과/Noun,6,2,4,2.2230620456616944e-05,4.4427660661527865e-05,0.6666666666666666
14370,하드캐리/Noun,6,4,2,4.446124091323389e-05,2.2213830330763933e-05,0.6666666666666666
14371,7회/Number,6,2,4,2.2230620456616944e-05,4.4427660661527865e-05,0.6666666666666666
14372,간통/Noun,6,2,4,2.2230620456616944e-05,4.4427660661527865e-05,0.6666666666666666
14373,야외/Noun,6,4,2,4.446124091323389e-05,2.2213830330763933e-05,0.6666666666666666
14374,식히다/Verb,6,4,2,4.446124091323389e-05,2.2213830330763933e-05,0.6666666666666666
14375,장장/Modifier,6,4,2,4.446124091323389e-05,2.2213830330763933e-05,0.6666666666666666
14376,서퍼/Noun,6,2,4,2.2230620456616944e-05,4.4427660661527865e-05,0.6666666666666666
14377,젤리/Noun,6,4,2,4.446124091323389e-05,2.2213830330763933e-05,0.6666666666666666
14378,궁굼하/Noun,6,2,4,2.2230620456616944e-05,4.4427660661527865e-05,0.6666666666666666
14379,녹색/Noun,6,4,2,4.446124091323389e-05,2.2213830330763933e-05,0.6666666666666666
14380,콘돔/Noun,6,2,4,2.2230620456616944e-05,4.4427660661527865e-05,0.6666666666666666
14381,도엔/Foreign,6,2,4,2.2230620456616944e-05,4.4427660661527865e-05,0.6666666666666666
14382,스토킹/Noun,6,2,4,2.2230620456616944e-05,4.4427660661527865e-05,0.6666666666666666
14383,녜/Noun,6,2,4,2.2230620456616944e-05,4.4427660661527865e-05,0.6666666666666666
14384,섹쉬/Noun,6,2,4,2.2230620456616944e-05,4.4427660661527865e-05,0.6666666666666666
14385,종방/Noun,6,4,2,4.446124091323389e-05,2.2213830330763933e-05,0.6666666666666666
14386,사항/Noun,6,4,2,4.446124091323389e-05,2.2213830330763933e-05,0.6666666666666666
14387,이임/Noun,6,4,2,4.446124091323389e-05,2.2213830330763933e-05,0.6666666666666666
14388,끌어당기다/Verb,6,2,4,2.2230620456616944e-05,4.4427660661527865e-05,0.6666666666666666
14389,훈련소/Noun,6,2,4,2.2230620456616944e-05,4.4427660661527865e-05,0.6666666666666666
14390,소희/Noun,6,4,2,4.446124091323389e-05,2.2213830330763933e-05,0.6666666666666666
14391,꽉꽉/Adverb,6,4,2,4.446124091323389e-05,2.2213830330763933e-05,0.6666666666666666
14392,미이케/Noun,6,2,4,2.2230620456616944e-05,4.4427660661527865e-05,0.6666666666666666
14393,연산군/Noun,6,2,4,2.2230620456616944e-05,4.4427660661527865e-05,0.6666666666666666
14394,마침내/Noun,6,4,2,4.446124091323389e-05,2.2213830330763933e-05,0.6666666666666666
14395,사부/Noun,6,2,4,2.2230620456616944e-05,4.4427660661527865e-05,0.6666666666666666
14396,유무/Noun,6,4,2,4.446124091323389e-05,2.2213830330763933e-05,0.6666666666666666
14397,국보/Noun,6,2,4,2.2230620456616944e-05,4.4427660661527865e-05,0.6666666666666666
14398,태연/Noun,6,2,4,2.2230620456616944e-05,4.4427660661527865e-05,0.6666666666666666
14399,스탠/Noun,6,4,2,4.446124091323389e-05,2.2213830330763933e-05,0.6666666666666666
14400,가련하다/Adjective,6,2,4,2.2230620456616944e-05,4.4427660661527865e-05,0.6666666666666666
14401,살다보면/Noun,6,4,2,4.446124091323389e-05,2.2213830330763933e-05,0.6666666666666666
14402,고저/Noun,6,2,4,2.2230620456616944e-05,4.4427660661527865e-05,0.6666666666666666
14403,계몽영화/Noun,6,2,4,2.2230620456616944e-05,4.4427660661527865e-05,0.6666666666666666
14404,리코/Noun,6,4,2,4.446124091323389e-05,2.2213830330763933e-05,0.6666666666666666
14405,라리/Noun,6,2,4,2.2230620456616944e-05,4.4427660661527865e-05,0.6666666666666666
14406,5억/Number,6,2,4,2.2230620456616944e-05,4.4427660661527865e-05,0.6666666666666666
14407,물감/Noun,6,4,2,4.446124091323389e-05,2.2213830330763933e-05,0.6666666666666666
14408,니요/Noun,6,4,2,4.446124091323389e-05,2.2213830330763933e-05,0.6666666666666666
14409,유신/Noun,6,4,2,4.446124091323389e-05,2.2213830330763933e-05,0.6666666666666666
14410,웨버/Noun,6,4,2,4.446124091323389e-05,2.2213830330763933e-05,0.6666666666666666
14411,입좀/Noun,6,2,4,2.2230620456616944e-05,4.4427660661527865e-05,0.6666666666666666
14412,이네/Foreign,6,4,2,4.446124091323389e-05,2.2213830330763933e-05,0.6666666666666666
14413,엄따/Noun,6,2,4,2.2230620456616944e-05,4.4427660661527865e-05,0.6666666666666666
14414,소피아/Noun,6,4,2,4.446124091323389e-05,2.2213830330763933e-05,0.6666666666666666
14415,판소리/Noun,6,4,2,4.446124091323389e-05,2.2213830330763933e-05,0.6666666666666666
14416,스웽크/Noun,6,4,2,4.446124091323389e-05,2.2213830330763933e-05,0.6666666666666666
14417,창의성/Noun,6,2,4,2.2230620456616944e-05,4.4427660661527865e-05,0.6666666666666666
14418,이나고/Noun,6,2,4,2.2230620456616944e-05,4.4427660661527865e-05,0.6666666666666666
14419,버니/Noun,6,4,2,4.446124091323389e-05,2.2213830330763933e-05,0.6666666666666666
14420,미녀와야수/Noun,6,4,2,4.446124091323389e-05,2.2213830330763933e-05,0.6666666666666666
14421,고무줄/Noun,6,2,4,2.2230620456616944e-05,4.4427660661527865e-05,0.6666666666666666
14422,에서까지/Josa,6,2,4,2.2230620456616944e-05,4.4427660661527865e-05,0.6666666666666666
14423,살육/Noun,6,2,4,2.2230620456616944e-05,4.4427660661527865e-05,0.6666666666666666
14424,화전/Noun,6,2,4,2.2230620456616944e-05,4.4427660661527865e-05,0.6666666666666666
14425,쉰들러리스트/Noun,6,4,2,4.446124091323389e-05,2.2213830330763933e-05,0.6666666666666666
14426,익살/Noun,6,4,2,4.446124091323389e-05,2.2213830330763933e-05,0.6666666666666666
14427,색체/Noun,6,4,2,4.446124091323389e-05,2.2213830330763933e-05,0.6666666666666666
14428,쥬만지/Noun,6,2,4,2.2230620456616944e-05,4.4427660661527865e-05,0.6666666666666666
14429,아카데미상/Noun,6,2,4,2.2230620456616944e-05,4.4427660661527865e-05,0.6666666666666666
14430,들개/Noun,6,4,2,4.446124091323389e-05,2.2213830330763933e-05,0.6666666666666666
14431,정인/Noun,6,2,4,2.2230620456616944e-05,4.4427660661527865e-05,0.6666666666666666
14432,성지루/Noun,6,2,4,2.2230620456616944e-05,4.4427660661527865e-05,0.6666666666666666
14433,포카혼타스/Noun,6,4,2,4.446124091323389e-05,2.2213830330763933e-05,0.6666666666666666
14434,녹차/Noun,6,4,2,4.446124091323389e-05,2.2213830330763933e-05,0.6666666666666666
14435,코앞/Noun,6,2,4,2.2230620456616944e-05,4.4427660661527865e-05,0.6666666666666666
14436,이수현/Noun,6,4,2,4.446124091323389e-05,2.2213830330763933e-05,0.6666666666666666
14437,다이어리/Noun,6,4,2,4.446124091323389e-05,2.2213830330763933e-05,0.6666666666666666
14438,정용화/Noun,6,4,2,4.446124091323389e-05,2.2213830330763933e-05,0.6666666666666666
14439,엑소더스/Noun,6,4,2,4.446124091323389e-05,2.2213830330763933e-05,0.6666666666666666
14440,성현아/Noun,6,2,4,2.2230620456616944e-05,4.4427660661527865e-05,0.6666666666666666
14441,유가/Noun,6,2,4,2.2230620456616944e-05,4.4427660661527865e-05,0.6666666666666666
14442,랜턴/Noun,6,2,4,2.2230620456616944e-05,4.4427660661527865e-05,0.6666666666666666
14443,명료하다/Adjective,6,4,2,4.446124091323389e-05,2.2213830330763933e-05,0.6666666666666666
14444,괄호/Noun,6,2,4,2.2230620456616944e-05,4.4427660661527865e-05,0.6666666666666666
14445,현시/Noun,6,4,2,4.446124091323389e-05,2.2213830330763933e-05,0.6666666666666666
14446,이본/Noun,6,2,4,2.2230620456616944e-05,4.4427660661527865e-05,0.6666666666666666
14447,개반/Noun,6,2,4,2.2230620456616944e-05,4.4427660661527865e-05,0.6666666666666666
14448,의인/Noun,6,2,4,2.2230620456616944e-05,4.4427660661527865e-05,0.6666666666666666
14449,키르/Noun,6,2,4,2.2230620456616944e-05,4.4427660661527865e-05,0.6666666666666666
14450,접합/Noun,6,2,4,2.2230620456616944e-05,4.4427660661527865e-05,0.6666666666666666
14451,광개토대왕/Noun,6,2,4,2.2230620456616944e-05,4.4427660661527865e-05,0.6666666666666666
14452,조심스럽다/Adjective,6,4,2,4.446124091323389e-05,2.2213830330763933e-05,0.6666666666666666
14453,땡땡/Noun,6,4,2,4.446124091323389e-05,2.2213830330763933e-05,0.6666666666666666
14454,읊는/Noun,6,4,2,4.446124091323389e-05,2.2213830330763933e-05,0.6666666666666666
14455,가정폭력/Noun,6,2,4,2.2230620456616944e-05,4.4427660661527865e-05,0.6666666666666666
14456,월레스/Noun,6,4,2,4.446124091323389e-05,2.2213830330763933e-05,0.6666666666666666
14457,깜작/Adverb,6,4,2,4.446124091323389e-05,2.2213830330763933e-05,0.6666666666666666
14458,테이/Noun,6,2,4,2.2230620456616944e-05,4.4427660661527865e-05,0.6666666666666666
14459,채팅/Noun,6,2,4,2.2230620456616944e-05,4.4427660661527865e-05,0.6666666666666666
14460,폴란드/Noun,6,4,2,4.446124091323389e-05,2.2213830330763933e-05,0.6666666666666666
14461,곡성/Noun,6,4,2,4.446124091323389e-05,2.2213830330763933e-05,0.6666666666666666
14462,에아/Noun,6,4,2,4.446124091323389e-05,2.2213830330763933e-05,0.6666666666666666
14463,보충/Noun,6,4,2,4.446124091323389e-05,2.2213830330763933e-05,0.6666666666666666
14464,1993년/Number,6,2,4,2.2230620456616944e-05,4.4427660661527865e-05,0.6666666666666666
14465,정직/Noun,6,4,2,4.446124091323389e-05,2.2213830330763933e-05,0.6666666666666666
14466,나쁜남자/Noun,6,2,4,2.2230620456616944e-05,4.4427660661527865e-05,0.6666666666666666
14467,광화문/Noun,6,4,2,4.446124091323389e-05,2.2213830330763933e-05,0.6666666666666666
14468,야무지다/Adjective,6,2,4,2.2230620456616944e-05,4.4427660661527865e-05,0.6666666666666666
14469,윤종신/Noun,6,2,4,2.2230620456616944e-05,4.4427660661527865e-05,0.6666666666666666
14470,천벌/Noun,6,4,2,4.446124091323389e-05,2.2213830330763933e-05,0.6666666666666666
14471,풀다/Noun,6,4,2,4.446124091323389e-05,2.2213830330763933e-05,0.6666666666666666
14472,김삼순/Noun,6,4,2,4.446124091323389e-05,2.2213830330763933e-05,0.6666666666666666
14473,처치/Noun,6,2,4,2.2230620456616944e-05,4.4427660661527865e-05,0.6666666666666666
14474,뒹굴/Adverb,6,2,4,2.2230620456616944e-05,4.4427660661527865e-05,0.6666666666666666
14475,여선생/Noun,6,2,4,2.2230620456616944e-05,4.4427660661527865e-05,0.6666666666666666
14476,^^../Punctuation,6,4,2,4.446124091323389e-05,2.2213830330763933e-05,0.6666666666666666
14477,크리스티나/Noun,6,4,2,4.446124091323389e-05,2.2213830330763933e-05,0.6666666666666666
14478,노동/Noun,6,4,2,4.446124091323389e-05,2.2213830330763933e-05,0.6666666666666666
14479,멍청/Noun,6,2,4,2.2230620456616944e-05,4.4427660661527865e-05,0.6666666666666666
14480,맞대다/Verb,6,4,2,4.446124091323389e-05,2.2213830330763933e-05,0.6666666666666666
14481,플래쉬/Noun,6,4,2,4.446124091323389e-05,2.2213830330763933e-05,0.6666666666666666
14482,어로/Noun,6,2,4,2.2230620456616944e-05,4.4427660661527865e-05,0.6666666666666666
14483,1200원/Number,6,2,4,2.2230620456616944e-05,4.4427660661527865e-05,0.6666666666666666
14484,연륜/Noun,6,4,2,4.446124091323389e-05,2.2213830330763933e-05,0.6666666666666666
14485,ㄹㄹ/KoreanParticle,6,4,2,4.446124091323389e-05,2.2213830330763933e-05,0.6666666666666666
14486,폭죽/Noun,6,4,2,4.446124091323389e-05,2.2213830330763933e-05,0.6666666666666666
14487,baby/Alpha,6,2,4,2.2230620456616944e-05,4.4427660661527865e-05,0.6666666666666666
14488,깜박/Noun,6,2,4,2.2230620456616944e-05,4.4427660661527865e-05,0.6666666666666666
14489,죠낸/Noun,6,2,4,2.2230620456616944e-05,4.4427660661527865e-05,0.6666666666666666
14490,테무진/Noun,6,2,4,2.2230620456616944e-05,4.4427660661527865e-05,0.6666666666666666
14491,칩/Noun,6,4,2,4.446124091323389e-05,2.2213830330763933e-05,0.6666666666666666
14492,쿵쿵/Adverb,6,4,2,4.446124091323389e-05,2.2213830330763933e-05,0.6666666666666666
14493,호빵맨/Noun,6,2,4,2.2230620456616944e-05,4.4427660661527865e-05,0.6666666666666666
14494,"..,,../Punctuation",6,4,2,4.446124091323389e-05,2.2213830330763933e-05,0.6666666666666666
14495,잔재미/Noun,6,4,2,4.446124091323389e-05,2.2213830330763933e-05,0.6666666666666666
14496,4.0/Number,6,2,4,2.2230620456616944e-05,4.4427660661527865e-05,0.6666666666666666
14497,여론/Noun,6,4,2,4.446124091323389e-05,2.2213830330763933e-05,0.6666666666666666
14498,정다빈/Noun,6,4,2,4.446124091323389e-05,2.2213830330763933e-05,0.6666666666666666
14499,류헤이/Noun,6,2,4,2.2230620456616944e-05,4.4427660661527865e-05,0.6666666666666666
14500,교관/Noun,6,4,2,4.446124091323389e-05,2.2213830330763933e-05,0.6666666666666666
14501,55/Number,6,2,4,2.2230620456616944e-05,4.4427660661527865e-05,0.6666666666666666
14502,체크/Noun,6,2,4,2.2230620456616944e-05,4.4427660661527865e-05,0.6666666666666666
14503,입학/Noun,6,4,2,4.446124091323389e-05,2.2213830330763933e-05,0.6666666666666666
14504,장일/Noun,6,4,2,4.446124091323389e-05,2.2213830330763933e-05,0.6666666666666666
14505,산물/Noun,6,2,4,2.2230620456616944e-05,4.4427660661527865e-05,0.6666666666666666
14506,해감/Noun,6,2,4,2.2230620456616944e-05,4.4427660661527865e-05,0.6666666666666666
14507,지조/Noun,6,2,4,2.2230620456616944e-05,4.4427660661527865e-05,0.6666666666666666
14508,왈부/Noun,6,2,4,2.2230620456616944e-05,4.4427660661527865e-05,0.6666666666666666
14509,여직원/Noun,6,4,2,4.446124091323389e-05,2.2213830330763933e-05,0.6666666666666666
14510,수학여행/Noun,6,2,4,2.2230620456616944e-05,4.4427660661527865e-05,0.6666666666666666
14511,발자국/Noun,6,2,4,2.2230620456616944e-05,4.4427660661527865e-05,0.6666666666666666
14512,넘게/Foreign,6,2,4,2.2230620456616944e-05,4.4427660661527865e-05,0.6666666666666666
14513,으로서도/Josa,6,2,4,2.2230620456616944e-05,4.4427660661527865e-05,0.6666666666666666
14514,크나크다/Adjective,6,2,4,2.2230620456616944e-05,4.4427660661527865e-05,0.6666666666666666
14515,끄덕/Noun,6,4,2,4.446124091323389e-05,2.2213830330763933e-05,0.6666666666666666
14516,옥토/Noun,6,4,2,4.446124091323389e-05,2.2213830330763933e-05,0.6666666666666666
14517,"""""/Punctuation",6,2,4,2.2230620456616944e-05,4.4427660661527865e-05,0.6666666666666666
14518,박상원/Noun,6,2,4,2.2230620456616944e-05,4.4427660661527865e-05,0.6666666666666666
14519,펄/Noun,6,2,4,2.2230620456616944e-05,4.4427660661527865e-05,0.6666666666666666
14520,빈번/Noun,6,4,2,4.446124091323389e-05,2.2213830330763933e-05,0.6666666666666666
14521,시큰둥하다/Adjective,6,4,2,4.446124091323389e-05,2.2213830330763933e-05,0.6666666666666666
14522,오복성/Noun,6,4,2,4.446124091323389e-05,2.2213830330763933e-05,0.6666666666666666
14523,피리/Noun,6,4,2,4.446124091323389e-05,2.2213830330763933e-05,0.6666666666666666
14524,네로/Noun,6,4,2,4.446124091323389e-05,2.2213830330763933e-05,0.6666666666666666
14525,설탕/Noun,6,2,4,2.2230620456616944e-05,4.4427660661527865e-05,0.6666666666666666
14526,영희/Noun,6,4,2,4.446124091323389e-05,2.2213830330763933e-05,0.6666666666666666
14527,헌/Noun,6,2,4,2.2230620456616944e-05,4.4427660661527865e-05,0.6666666666666666
14528,보증/Noun,6,4,2,4.446124091323389e-05,2.2213830330763933e-05,0.6666666666666666
14529,헤메/Noun,6,2,4,2.2230620456616944e-05,4.4427660661527865e-05,0.6666666666666666
14530,연우/Noun,6,2,4,2.2230620456616944e-05,4.4427660661527865e-05,0.6666666666666666
14531,손호준/Noun,6,4,2,4.446124091323389e-05,2.2213830330763933e-05,0.6666666666666666
14532,변덕/Noun,6,2,4,2.2230620456616944e-05,4.4427660661527865e-05,0.6666666666666666
14533,원시인/Noun,6,4,2,4.446124091323389e-05,2.2213830330763933e-05,0.6666666666666666
14534,고독감/Noun,6,4,2,4.446124091323389e-05,2.2213830330763933e-05,0.6666666666666666
14535,동족/Noun,6,2,4,2.2230620456616944e-05,4.4427660661527865e-05,0.6666666666666666
14536,초대형/Noun,6,3,3,3.3345930684925414e-05,3.33207454961459e-05,0.5
14537,식코/Noun,6,3,3,3.3345930684925414e-05,3.33207454961459e-05,0.5
14538,상반기/Noun,6,3,3,3.3345930684925414e-05,3.33207454961459e-05,0.5
14539,두더지/Noun,6,3,3,3.3345930684925414e-05,3.33207454961459e-05,0.5
14540,에너미/Noun,6,3,3,3.3345930684925414e-05,3.33207454961459e-05,0.5
14541,소매치기/Noun,6,3,3,3.3345930684925414e-05,3.33207454961459e-05,0.5
14542,원치않다/Adjective,6,3,3,3.3345930684925414e-05,3.33207454961459e-05,0.5
14543,메시/Noun,6,3,3,3.3345930684925414e-05,3.33207454961459e-05,0.5
14544,오인/Noun,6,3,3,3.3345930684925414e-05,3.33207454961459e-05,0.5
14545,통화/Noun,6,3,3,3.3345930684925414e-05,3.33207454961459e-05,0.5
14546,스틸컷/Noun,6,3,3,3.3345930684925414e-05,3.33207454961459e-05,0.5
14547,분별/Noun,6,3,3,3.3345930684925414e-05,3.33207454961459e-05,0.5
14548,결실/Noun,6,3,3,3.3345930684925414e-05,3.33207454961459e-05,0.5
14549,출구/Noun,6,3,3,3.3345930684925414e-05,3.33207454961459e-05,0.5
14550,보다야/Josa,6,3,3,3.3345930684925414e-05,3.33207454961459e-05,0.5
14551,대대/Noun,6,3,3,3.3345930684925414e-05,3.33207454961459e-05,0.5
14552,요호/Noun,6,3,3,3.3345930684925414e-05,3.33207454961459e-05,0.5
14553,맹승지/Noun,6,3,3,3.3345930684925414e-05,3.33207454961459e-05,0.5
14554,진중권/Noun,6,3,3,3.3345930684925414e-05,3.33207454961459e-05,0.5
14555,은줄/Noun,6,3,3,3.3345930684925414e-05,3.33207454961459e-05,0.5
14556,한겨울/Noun,6,3,3,3.3345930684925414e-05,3.33207454961459e-05,0.5
14557,속보/Noun,6,3,3,3.3345930684925414e-05,3.33207454961459e-05,0.5
14558,서두르다/Verb,6,3,3,3.3345930684925414e-05,3.33207454961459e-05,0.5
14559,오프/Noun,6,3,3,3.3345930684925414e-05,3.33207454961459e-05,0.5
14560,재고/Noun,6,3,3,3.3345930684925414e-05,3.33207454961459e-05,0.5
14561,")""/Punctuation",6,3,3,3.3345930684925414e-05,3.33207454961459e-05,0.5
14562,땅콩/Noun,6,3,3,3.3345930684925414e-05,3.33207454961459e-05,0.5
14563,홍자매/Noun,6,3,3,3.3345930684925414e-05,3.33207454961459e-05,0.5
14564,유추/Noun,6,3,3,3.3345930684925414e-05,3.33207454961459e-05,0.5
14565,재량/Noun,6,3,3,3.3345930684925414e-05,3.33207454961459e-05,0.5
14566,ㄳ/KoreanParticle,6,3,3,3.3345930684925414e-05,3.33207454961459e-05,0.5
14567,ㅇㅣ/KoreanParticle,6,3,3,3.3345930684925414e-05,3.33207454961459e-05,0.5
14568,페이스북/Noun,6,3,3,3.3345930684925414e-05,3.33207454961459e-05,0.5
14569,장미희/Noun,6,3,3,3.3345930684925414e-05,3.33207454961459e-05,0.5
14570,매니악/Noun,6,3,3,3.3345930684925414e-05,3.33207454961459e-05,0.5
14571,두세/Modifier,6,3,3,3.3345930684925414e-05,3.33207454961459e-05,0.5
14572,이점/Noun,6,3,3,3.3345930684925414e-05,3.33207454961459e-05,0.5
14573,텐데/Noun,6,3,3,3.3345930684925414e-05,3.33207454961459e-05,0.5
14574,가희/Noun,6,3,3,3.3345930684925414e-05,3.33207454961459e-05,0.5
14575,유비/Noun,6,3,3,3.3345930684925414e-05,3.33207454961459e-05,0.5
14576,연휴/Noun,6,3,3,3.3345930684925414e-05,3.33207454961459e-05,0.5
14577,승리자/Noun,6,3,3,3.3345930684925414e-05,3.33207454961459e-05,0.5
14578,언뜻/Noun,6,3,3,3.3345930684925414e-05,3.33207454961459e-05,0.5
14579,슬로우모션/Noun,6,3,3,3.3345930684925414e-05,3.33207454961459e-05,0.5
14580,가을동화/Noun,6,3,3,3.3345930684925414e-05,3.33207454961459e-05,0.5
14581,캣우먼/Noun,6,3,3,3.3345930684925414e-05,3.33207454961459e-05,0.5
14582,관음/Noun,6,3,3,3.3345930684925414e-05,3.33207454961459e-05,0.5
14583,협녀/Noun,6,3,3,3.3345930684925414e-05,3.33207454961459e-05,0.5
14584,국화/Noun,6,3,3,3.3345930684925414e-05,3.33207454961459e-05,0.5
14585,할망구/Noun,6,3,3,3.3345930684925414e-05,3.33207454961459e-05,0.5
14586,치밀/Noun,6,3,3,3.3345930684925414e-05,3.33207454961459e-05,0.5
14587,는/Foreign,6,3,3,3.3345930684925414e-05,3.33207454961459e-05,0.5
14588,여옥/Noun,6,3,3,3.3345930684925414e-05,3.33207454961459e-05,0.5
14589,으로써는/Josa,6,3,3,3.3345930684925414e-05,3.33207454961459e-05,0.5
14590,로켓/Noun,6,3,3,3.3345930684925414e-05,3.33207454961459e-05,0.5
14591,과/Foreign,6,3,3,3.3345930684925414e-05,3.33207454961459e-05,0.5
14592,황량/Noun,6,3,3,3.3345930684925414e-05,3.33207454961459e-05,0.5
14593,부부싸움/Noun,6,3,3,3.3345930684925414e-05,3.33207454961459e-05,0.5
14594,선행/Noun,6,3,3,3.3345930684925414e-05,3.33207454961459e-05,0.5
14595,폭격기/Noun,6,3,3,3.3345930684925414e-05,3.33207454961459e-05,0.5
14596,아이스에이지/Noun,6,3,3,3.3345930684925414e-05,3.33207454961459e-05,0.5
14597,옵니다/Eomi,6,3,3,3.3345930684925414e-05,3.33207454961459e-05,0.5
14598,던지기/Noun,6,3,3,3.3345930684925414e-05,3.33207454961459e-05,0.5
14599,친모/Noun,6,3,3,3.3345930684925414e-05,3.33207454961459e-05,0.5
14600,멈/Noun,6,3,3,3.3345930684925414e-05,3.33207454961459e-05,0.5
14601,루한/Noun,6,3,3,3.3345930684925414e-05,3.33207454961459e-05,0.5
14602,도참/Noun,6,3,3,3.3345930684925414e-05,3.33207454961459e-05,0.5
14603,데쓰/Noun,6,3,3,3.3345930684925414e-05,3.33207454961459e-05,0.5
14604,권태기/Noun,6,3,3,3.3345930684925414e-05,3.33207454961459e-05,0.5
14605,시프/Noun,6,3,3,3.3345930684925414e-05,3.33207454961459e-05,0.5
14606,5%/Number,6,3,3,3.3345930684925414e-05,3.33207454961459e-05,0.5
14607,두통/Noun,6,3,3,3.3345930684925414e-05,3.33207454961459e-05,0.5
14608,발목/Noun,6,3,3,3.3345930684925414e-05,3.33207454961459e-05,0.5
14609,골드/Noun,6,3,3,3.3345930684925414e-05,3.33207454961459e-05,0.5
14610,병실/Noun,6,3,3,3.3345930684925414e-05,3.33207454961459e-05,0.5
14611,갈라지다/Verb,6,3,3,3.3345930684925414e-05,3.33207454961459e-05,0.5
14612,말타/Noun,6,3,3,3.3345930684925414e-05,3.33207454961459e-05,0.5
14613,죨/Noun,6,3,3,3.3345930684925414e-05,3.33207454961459e-05,0.5
14614,박준규/Noun,6,3,3,3.3345930684925414e-05,3.33207454961459e-05,0.5
14615,zz/Alpha,6,3,3,3.3345930684925414e-05,3.33207454961459e-05,0.5
14616,여과/Noun,6,3,3,3.3345930684925414e-05,3.33207454961459e-05,0.5
14617,임의/Noun,6,3,3,3.3345930684925414e-05,3.33207454961459e-05,0.5
14618,지롱/Josa,6,3,3,3.3345930684925414e-05,3.33207454961459e-05,0.5
14619,더잼/Noun,6,3,3,3.3345930684925414e-05,3.33207454961459e-05,0.5
14620,장인정신/Noun,6,3,3,3.3345930684925414e-05,3.33207454961459e-05,0.5
14621,마리오/Noun,6,3,3,3.3345930684925414e-05,3.33207454961459e-05,0.5
14622,변주/Noun,6,3,3,3.3345930684925414e-05,3.33207454961459e-05,0.5
14623,우화/Noun,6,3,3,3.3345930684925414e-05,3.33207454961459e-05,0.5
14624,장화/Noun,6,3,3,3.3345930684925414e-05,3.33207454961459e-05,0.5
14625,엘지/Noun,6,3,3,3.3345930684925414e-05,3.33207454961459e-05,0.5
14626,포선/Noun,6,3,3,3.3345930684925414e-05,3.33207454961459e-05,0.5
14627,떠돌다/Verb,6,3,3,3.3345930684925414e-05,3.33207454961459e-05,0.5
14628,오락실/Noun,6,3,3,3.3345930684925414e-05,3.33207454961459e-05,0.5
14629,한선/Noun,6,3,3,3.3345930684925414e-05,3.33207454961459e-05,0.5
14630,회식/Noun,6,3,3,3.3345930684925414e-05,3.33207454961459e-05,0.5
14631,유능하다/Adjective,6,3,3,3.3345930684925414e-05,3.33207454961459e-05,0.5
14632,뜰때/Noun,6,3,3,3.3345930684925414e-05,3.33207454961459e-05,0.5
14633,삼위일체/Noun,6,3,3,3.3345930684925414e-05,3.33207454961459e-05,0.5
14634,이병/Noun,6,3,3,3.3345930684925414e-05,3.33207454961459e-05,0.5
14635,라빈/Noun,6,3,3,3.3345930684925414e-05,3.33207454961459e-05,0.5
14636,건의/Noun,6,3,3,3.3345930684925414e-05,3.33207454961459e-05,0.5
14637,비주류/Noun,6,3,3,3.3345930684925414e-05,3.33207454961459e-05,0.5
14638,빅풋/Noun,6,3,3,3.3345930684925414e-05,3.33207454961459e-05,0.5
14639,트이다/Verb,6,3,3,3.3345930684925414e-05,3.33207454961459e-05,0.5
14640,사슴/Noun,6,3,3,3.3345930684925414e-05,3.33207454961459e-05,0.5
14641,귀중하다/Adjective,6,3,3,3.3345930684925414e-05,3.33207454961459e-05,0.5
14642,처량하다/Adjective,6,3,3,3.3345930684925414e-05,3.33207454961459e-05,0.5
14643,팬덤/Noun,6,3,3,3.3345930684925414e-05,3.33207454961459e-05,0.5
14644,돗/Noun,6,3,3,3.3345930684925414e-05,3.33207454961459e-05,0.5
14645,선량하다/Adjective,6,3,3,3.3345930684925414e-05,3.33207454961459e-05,0.5
14646,라오/Josa,6,3,3,3.3345930684925414e-05,3.33207454961459e-05,0.5
14647,노조/Noun,6,3,3,3.3345930684925414e-05,3.33207454961459e-05,0.5
14648,개중/Noun,6,3,3,3.3345930684925414e-05,3.33207454961459e-05,0.5
14649,연수/Noun,6,3,3,3.3345930684925414e-05,3.33207454961459e-05,0.5
14650,가공/Noun,6,3,3,3.3345930684925414e-05,3.33207454961459e-05,0.5
14651,업무/Noun,6,3,3,3.3345930684925414e-05,3.33207454961459e-05,0.5
14652,하단/Noun,6,3,3,3.3345930684925414e-05,3.33207454961459e-05,0.5
14653,차/Foreign,6,3,3,3.3345930684925414e-05,3.33207454961459e-05,0.5
14654,재해/Noun,6,3,3,3.3345930684925414e-05,3.33207454961459e-05,0.5
14655,접목/Noun,6,3,3,3.3345930684925414e-05,3.33207454961459e-05,0.5
14656,붕대/Noun,6,3,3,3.3345930684925414e-05,3.33207454961459e-05,0.5
14657,시라/Noun,6,3,3,3.3345930684925414e-05,3.33207454961459e-05,0.5
14658,앨빈/Noun,6,3,3,3.3345930684925414e-05,3.33207454961459e-05,0.5
14659,택하/Noun,6,3,3,3.3345930684925414e-05,3.33207454961459e-05,0.5
14660,광해군/Noun,6,3,3,3.3345930684925414e-05,3.33207454961459e-05,0.5
14661,클론/Noun,6,3,3,3.3345930684925414e-05,3.33207454961459e-05,0.5
14662,점더/Noun,6,3,3,3.3345930684925414e-05,3.33207454961459e-05,0.5
14663,가뭄/Noun,6,3,3,3.3345930684925414e-05,3.33207454961459e-05,0.5
14664,퀘/Noun,6,3,3,3.3345930684925414e-05,3.33207454961459e-05,0.5
14665,변환/Noun,6,3,3,3.3345930684925414e-05,3.33207454961459e-05,0.5
14666,워터월드/Noun,6,3,3,3.3345930684925414e-05,3.33207454961459e-05,0.5
14667,갱신/Noun,6,3,3,3.3345930684925414e-05,3.33207454961459e-05,0.5
14668,먼치킨/Noun,6,3,3,3.3345930684925414e-05,3.33207454961459e-05,0.5
14669,찢기다/Verb,6,3,3,3.3345930684925414e-05,3.33207454961459e-05,0.5
14670,매그놀리아/Noun,6,3,3,3.3345930684925414e-05,3.33207454961459e-05,0.5
14671,게살/Noun,6,3,3,3.3345930684925414e-05,3.33207454961459e-05,0.5
14672,조마조마/Noun,6,3,3,3.3345930684925414e-05,3.33207454961459e-05,0.5
14673,순결하다/Adjective,6,3,3,3.3345930684925414e-05,3.33207454961459e-05,0.5
14674,거실/Noun,6,3,3,3.3345930684925414e-05,3.33207454961459e-05,0.5
14675,종말론/Noun,6,3,3,3.3345930684925414e-05,3.33207454961459e-05,0.5
14676,괴팍하다/Adjective,6,3,3,3.3345930684925414e-05,3.33207454961459e-05,0.5
14677,살길/Noun,6,3,3,3.3345930684925414e-05,3.33207454961459e-05,0.5
14678,조선왕조/Noun,6,3,3,3.3345930684925414e-05,3.33207454961459e-05,0.5
14679,엇네/Noun,6,3,3,3.3345930684925414e-05,3.33207454961459e-05,0.5
14680,첼로/Noun,6,3,3,3.3345930684925414e-05,3.33207454961459e-05,0.5
14681,발판/Noun,6,3,3,3.3345930684925414e-05,3.33207454961459e-05,0.5
14682,에를/Josa,6,3,3,3.3345930684925414e-05,3.33207454961459e-05,0.5
14683,고치/Noun,6,3,3,3.3345930684925414e-05,3.33207454961459e-05,0.5
14684,각선미/Noun,6,3,3,3.3345930684925414e-05,3.33207454961459e-05,0.5
14685,옵/Noun,6,3,3,3.3345930684925414e-05,3.33207454961459e-05,0.5
14686,소설가/Noun,6,3,3,3.3345930684925414e-05,3.33207454961459e-05,0.5
14687,다다다/Noun,6,3,3,3.3345930684925414e-05,3.33207454961459e-05,0.5
14688,막방/Noun,6,3,3,3.3345930684925414e-05,3.33207454961459e-05,0.5
14689,최배달/Noun,6,3,3,3.3345930684925414e-05,3.33207454961459e-05,0.5
14690,뜻대로/Adverb,6,3,3,3.3345930684925414e-05,3.33207454961459e-05,0.5
14691,지존파/Noun,6,3,3,3.3345930684925414e-05,3.33207454961459e-05,0.5
14692,김두영/Noun,6,3,3,3.3345930684925414e-05,3.33207454961459e-05,0.5
14693,보존/Noun,6,3,3,3.3345930684925414e-05,3.33207454961459e-05,0.5
14694,지드래곤/Noun,6,3,3,3.3345930684925414e-05,3.33207454961459e-05,0.5
14695,무사하다/Adjective,6,3,3,3.3345930684925414e-05,3.33207454961459e-05,0.5
14696,slow/Alpha,6,3,3,3.3345930684925414e-05,3.33207454961459e-05,0.5
14697,에헤/Exclamation,6,3,3,3.3345930684925414e-05,3.33207454961459e-05,0.5
14698,권해효/Noun,6,3,3,3.3345930684925414e-05,3.33207454961459e-05,0.5
14699,1000원/Number,6,3,3,3.3345930684925414e-05,3.33207454961459e-05,0.5
14700,좌지우지/Noun,6,3,3,3.3345930684925414e-05,3.33207454961459e-05,0.5
14701,계곡/Noun,6,3,3,3.3345930684925414e-05,3.33207454961459e-05,0.5
14702,상급/Noun,6,3,3,3.3345930684925414e-05,3.33207454961459e-05,0.5
14703,태평/Noun,6,3,3,3.3345930684925414e-05,3.33207454961459e-05,0.5
14704,만사/Noun,6,3,3,3.3345930684925414e-05,3.33207454961459e-05,0.5
14705,쇼파/Noun,6,3,3,3.3345930684925414e-05,3.33207454961459e-05,0.5
14706,10회/Number,6,3,3,3.3345930684925414e-05,3.33207454961459e-05,0.5
14707,조제/Noun,6,3,3,3.3345930684925414e-05,3.33207454961459e-05,0.5
14708,공통/Noun,6,3,3,3.3345930684925414e-05,3.33207454961459e-05,0.5
14709,서현진/Noun,6,3,3,3.3345930684925414e-05,3.33207454961459e-05,0.5
14710,하이바라/Noun,6,3,3,3.3345930684925414e-05,3.33207454961459e-05,0.5
14711,월스트리트/Noun,6,3,3,3.3345930684925414e-05,3.33207454961459e-05,0.5
14712,내려지다/Verb,6,3,3,3.3345930684925414e-05,3.33207454961459e-05,0.5
14713,니지/Noun,6,3,3,3.3345930684925414e-05,3.33207454961459e-05,0.5
14714,에도/Foreign,6,3,3,3.3345930684925414e-05,3.33207454961459e-05,0.5
14715,나영석/Noun,6,3,3,3.3345930684925414e-05,3.33207454961459e-05,0.5
14716,대풍수/Noun,6,3,3,3.3345930684925414e-05,3.33207454961459e-05,0.5
14717,베인/Noun,6,3,3,3.3345930684925414e-05,3.33207454961459e-05,0.5
14718,환가/Noun,6,3,3,3.3345930684925414e-05,3.33207454961459e-05,0.5
14719,피쉬/Noun,6,3,3,3.3345930684925414e-05,3.33207454961459e-05,0.5
14720,남규리/Noun,6,3,3,3.3345930684925414e-05,3.33207454961459e-05,0.5
14721,조은숙/Noun,6,3,3,3.3345930684925414e-05,3.33207454961459e-05,0.5
14722,마라톤/Noun,6,3,3,3.3345930684925414e-05,3.33207454961459e-05,0.5
14723,복음/Noun,6,3,3,3.3345930684925414e-05,3.33207454961459e-05,0.5
14724,미움/Noun,6,3,3,3.3345930684925414e-05,3.33207454961459e-05,0.5
14725,지위/Noun,6,3,3,3.3345930684925414e-05,3.33207454961459e-05,0.5
14726,지붕/Noun,6,3,3,3.3345930684925414e-05,3.33207454961459e-05,0.5
14727,주다해/Noun,6,3,3,3.3345930684925414e-05,3.33207454961459e-05,0.5
14728,덕의/Noun,6,3,3,3.3345930684925414e-05,3.33207454961459e-05,0.5
14729,토지/Noun,6,3,3,3.3345930684925414e-05,3.33207454961459e-05,0.5
14730,주방/Noun,6,3,3,3.3345930684925414e-05,3.33207454961459e-05,0.5
14731,스나이퍼/Noun,6,3,3,3.3345930684925414e-05,3.33207454961459e-05,0.5
14732,달래/Noun,6,3,3,3.3345930684925414e-05,3.33207454961459e-05,0.5
14733,허비/Noun,6,3,3,3.3345930684925414e-05,3.33207454961459e-05,0.5
14734,스레/Noun,6,3,3,3.3345930684925414e-05,3.33207454961459e-05,0.5
14735,신라/Noun,6,3,3,3.3345930684925414e-05,3.33207454961459e-05,0.5
14736,이세영/Noun,6,3,3,3.3345930684925414e-05,3.33207454961459e-05,0.5
14737,수명/Noun,6,3,3,3.3345930684925414e-05,3.33207454961459e-05,0.5
14738,알음/Noun,6,3,3,3.3345930684925414e-05,3.33207454961459e-05,0.5
14739,계열/Noun,6,3,3,3.3345930684925414e-05,3.33207454961459e-05,0.5
14740,팔뚝/Noun,6,3,3,3.3345930684925414e-05,3.33207454961459e-05,0.5
14741,왜놈/Noun,6,3,3,3.3345930684925414e-05,3.33207454961459e-05,0.5
14742,정신분열/Noun,6,3,3,3.3345930684925414e-05,3.33207454961459e-05,0.5
14743,전부터/Foreign,6,3,3,3.3345930684925414e-05,3.33207454961459e-05,0.5
14744,조난/Noun,6,3,3,3.3345930684925414e-05,3.33207454961459e-05,0.5
14745,탈의/Noun,6,3,3,3.3345930684925414e-05,3.33207454961459e-05,0.5
14746,리터/Noun,6,3,3,3.3345930684925414e-05,3.33207454961459e-05,0.5
14747,비행선/Noun,6,3,3,3.3345930684925414e-05,3.33207454961459e-05,0.5
14748,????????/Punctuation,6,3,3,3.3345930684925414e-05,3.33207454961459e-05,0.5
14749,후임/Noun,6,3,3,3.3345930684925414e-05,3.33207454961459e-05,0.5
14750,Me/Alpha,6,3,3,3.3345930684925414e-05,3.33207454961459e-05,0.5
14751,결전/Noun,6,3,3,3.3345930684925414e-05,3.33207454961459e-05,0.5
14752,웬걸/Noun,6,3,3,3.3345930684925414e-05,3.33207454961459e-05,0.5
14753,텍사스/Noun,6,3,3,3.3345930684925414e-05,3.33207454961459e-05,0.5
14754,멜리사/Noun,6,3,3,3.3345930684925414e-05,3.33207454961459e-05,0.5
14755,최고점/Noun,6,3,3,3.3345930684925414e-05,3.33207454961459e-05,0.5
14756,화소/Noun,6,3,3,3.3345930684925414e-05,3.33207454961459e-05,0.5
14757,합리/Noun,6,3,3,3.3345930684925414e-05,3.33207454961459e-05,0.5
14758,어번/Noun,6,3,3,3.3345930684925414e-05,3.33207454961459e-05,0.5
14759,만듭니/Noun,6,3,3,3.3345930684925414e-05,3.33207454961459e-05,0.5
14760,기태/Noun,6,3,3,3.3345930684925414e-05,3.33207454961459e-05,0.5
14761,쫙쫙/Noun,6,3,3,3.3345930684925414e-05,3.33207454961459e-05,0.5
14762,경규/Noun,6,3,3,3.3345930684925414e-05,3.33207454961459e-05,0.5
14763,장발장/Noun,6,3,3,3.3345930684925414e-05,3.33207454961459e-05,0.5
14764,ㅉㅏ/KoreanParticle,6,3,3,3.3345930684925414e-05,3.33207454961459e-05,0.5
14765,전임/Noun,6,3,3,3.3345930684925414e-05,3.33207454961459e-05,0.5
14766,전지/Noun,6,3,3,3.3345930684925414e-05,3.33207454961459e-05,0.5
14767,회귀/Noun,6,3,3,3.3345930684925414e-05,3.33207454961459e-05,0.5
14768,ㅋㄱ/KoreanParticle,6,3,3,3.3345930684925414e-05,3.33207454961459e-05,0.5
14769,사들이다/Verb,6,3,3,3.3345930684925414e-05,3.33207454961459e-05,0.5
14770,축구선수/Noun,6,3,3,3.3345930684925414e-05,3.33207454961459e-05,0.5
14771,네오/Noun,6,3,3,3.3345930684925414e-05,3.33207454961459e-05,0.5
14772,진경/Noun,6,3,3,3.3345930684925414e-05,3.33207454961459e-05,0.5
14773,가연/Noun,6,3,3,3.3345930684925414e-05,3.33207454961459e-05,0.5
14774,실황/Noun,6,3,3,3.3345930684925414e-05,3.33207454961459e-05,0.5
14775,유하/Noun,6,3,3,3.3345930684925414e-05,3.33207454961459e-05,0.5
14776,다큐맨/Noun,6,3,3,3.3345930684925414e-05,3.33207454961459e-05,0.5
14777,논픽션/Noun,6,3,3,3.3345930684925414e-05,3.33207454961459e-05,0.5
14778,즌/Foreign,6,3,3,3.3345930684925414e-05,3.33207454961459e-05,0.5
14779,재민/Noun,6,3,3,3.3345930684925414e-05,3.33207454961459e-05,0.5
14780,익스/Noun,6,3,3,3.3345930684925414e-05,3.33207454961459e-05,0.5
14781,베트맨/Noun,6,3,3,3.3345930684925414e-05,3.33207454961459e-05,0.5
14782,이듭/Noun,6,3,3,3.3345930684925414e-05,3.33207454961459e-05,0.5
14783,39/Number,6,3,3,3.3345930684925414e-05,3.33207454961459e-05,0.5
14784,톡톡하다/Adjective,6,3,3,3.3345930684925414e-05,3.33207454961459e-05,0.5
14785,타케시/Noun,6,3,3,3.3345930684925414e-05,3.33207454961459e-05,0.5
14786,송선미/Noun,6,3,3,3.3345930684925414e-05,3.33207454961459e-05,0.5
14787,족족/Noun,6,3,3,3.3345930684925414e-05,3.33207454961459e-05,0.5
14788,자처/Noun,6,3,3,3.3345930684925414e-05,3.33207454961459e-05,0.5
14789,컵/Noun,6,3,3,3.3345930684925414e-05,3.33207454961459e-05,0.5
14790,카호/Noun,6,3,3,3.3345930684925414e-05,3.33207454961459e-05,0.5
14791,로렌/Noun,5,5,0,5.557655114154236e-05,0.0,1.0
14792,온돌/Noun,5,0,5,0.0,5.5534575826909837e-05,1.0
14793,에헴/Exclamation,5,0,5,0.0,5.5534575826909837e-05,1.0
14794,옥보단/Noun,5,0,5,0.0,5.5534575826909837e-05,1.0
14795,케서방/Noun,5,0,5,0.0,5.5534575826909837e-05,1.0
14796,헤픈/Noun,5,0,5,0.0,5.5534575826909837e-05,1.0
14797,제리케이/Noun,5,5,0,5.557655114154236e-05,0.0,1.0
14798,플레이보이/Noun,5,0,5,0.0,5.5534575826909837e-05,1.0
14799,카비/Noun,5,5,0,5.557655114154236e-05,0.0,1.0
14800,임재범/Noun,5,5,0,5.557655114154236e-05,0.0,1.0
14801,몸뚱이/Noun,5,0,5,0.0,5.5534575826909837e-05,1.0
14802,애니메이션영화/Noun,5,5,0,5.557655114154236e-05,0.0,1.0
14803,아릅답/Noun,5,5,0,5.557655114154236e-05,0.0,1.0
14804,쇠/Noun,5,0,5,0.0,5.5534575826909837e-05,1.0
14805,주구/Noun,5,0,5,0.0,5.5534575826909837e-05,1.0
14806,모니터링/Noun,5,0,5,0.0,5.5534575826909837e-05,1.0
14807,지그/Noun,5,0,5,0.0,5.5534575826909837e-05,1.0
14808,그리스도인/Noun,5,5,0,5.557655114154236e-05,0.0,1.0
14809,정신승리/Noun,5,0,5,0.0,5.5534575826909837e-05,1.0
14810,아나스타샤/Noun,5,5,0,5.557655114154236e-05,0.0,1.0
14811,건들/Adverb,5,0,5,0.0,5.5534575826909837e-05,1.0
14812,싱싱/Noun,5,5,0,5.557655114154236e-05,0.0,1.0
14813,생인데/Foreign,5,5,0,5.557655114154236e-05,0.0,1.0
14814,흙속/Noun,5,5,0,5.557655114154236e-05,0.0,1.0
14815,양수빈/Noun,5,0,5,0.0,5.5534575826909837e-05,1.0
14816,생겻/Noun,5,0,5,0.0,5.5534575826909837e-05,1.0
14817,상팔자/Noun,5,0,5,0.0,5.5534575826909837e-05,1.0
14818,용임/Noun,5,0,5,0.0,5.5534575826909837e-05,1.0
14819,이승희/Noun,5,0,5,0.0,5.5534575826909837e-05,1.0
14820,싸나이/Noun,5,5,0,5.557655114154236e-05,0.0,1.0
14821,웬수/Noun,5,0,5,0.0,5.5534575826909837e-05,1.0
14822,창업/Noun,5,5,0,5.557655114154236e-05,0.0,1.0
14823,협동/Noun,5,5,0,5.557655114154236e-05,0.0,1.0
14824,캅/Noun,5,5,0,5.557655114154236e-05,0.0,1.0
14825,뒤치닥/Noun,5,0,5,0.0,5.5534575826909837e-05,1.0
14826,말걸/Noun,5,0,5,0.0,5.5534575826909837e-05,1.0
14827,~??/Punctuation,5,0,5,0.0,5.5534575826909837e-05,1.0
14828,밌/Noun,5,5,0,5.557655114154236e-05,0.0,1.0
14829,사기죄/Noun,5,0,5,0.0,5.5534575826909837e-05,1.0
14830,상당수/Noun,5,0,5,0.0,5.5534575826909837e-05,1.0
14831,황마/Noun,5,0,5,0.0,5.5534575826909837e-05,1.0
14832,없넹/Noun,5,0,5,0.0,5.5534575826909837e-05,1.0
14833,107분/Number,5,0,5,0.0,5.5534575826909837e-05,1.0
14834,남미/Noun,5,5,0,5.557655114154236e-05,0.0,1.0
14835,임자/Noun,5,5,0,5.557655114154236e-05,0.0,1.0
14836,육성재/Noun,5,5,0,5.557655114154236e-05,0.0,1.0
14837,꼴값/Noun,5,0,5,0.0,5.5534575826909837e-05,1.0
14838,심심함/Noun,5,0,5,0.0,5.5534575826909837e-05,1.0
14839,편모/Noun,5,5,0,5.557655114154236e-05,0.0,1.0
14840,아늑하다/Adjective,5,5,0,5.557655114154236e-05,0.0,1.0
14841,냉전/Noun,5,5,0,5.557655114154236e-05,0.0,1.0
14842,1/2/Number,5,0,5,0.0,5.5534575826909837e-05,1.0
14843,1234567/Number,5,5,0,5.557655114154236e-05,0.0,1.0
14844,접해/Noun,5,0,5,0.0,5.5534575826909837e-05,1.0
14845,불꽃놀이/Noun,5,5,0,5.557655114154236e-05,0.0,1.0
14846,코웃음/Noun,5,0,5,0.0,5.5534575826909837e-05,1.0
14847,전엔/Foreign,5,5,0,5.557655114154236e-05,0.0,1.0
14848,5000원/Number,5,0,5,0.0,5.5534575826909837e-05,1.0
14849,름/Noun,5,5,0,5.557655114154236e-05,0.0,1.0
14850,노친/Noun,5,0,5,0.0,5.5534575826909837e-05,1.0
14851,준거/Noun,5,0,5,0.0,5.5534575826909837e-05,1.0
14852,맹맹하다/Adjective,5,0,5,0.0,5.5534575826909837e-05,1.0
14853,배설물/Noun,5,0,5,0.0,5.5534575826909837e-05,1.0
14854,쪽쪽/Noun,5,0,5,0.0,5.5534575826909837e-05,1.0
14855,힘빠지다/Verb,5,0,5,0.0,5.5534575826909837e-05,1.0
14856,주둥이/Noun,5,0,5,0.0,5.5534575826909837e-05,1.0
14857,............................./Punctuation,5,0,5,0.0,5.5534575826909837e-05,1.0
14858,능글/Noun,5,5,0,5.557655114154236e-05,0.0,1.0
14859,성생활/Noun,5,0,5,0.0,5.5534575826909837e-05,1.0
14860,최영/Noun,5,5,0,5.557655114154236e-05,0.0,1.0
14861,헬리콥터/Noun,5,5,0,5.557655114154236e-05,0.0,1.0
14862,게모/Noun,5,0,5,0.0,5.5534575826909837e-05,1.0
14863,^&^/Punctuation,5,5,0,5.557655114154236e-05,0.0,1.0
14864,이동/Noun,5,0,5,0.0,5.5534575826909837e-05,1.0
14865,그름/Noun,5,5,0,5.557655114154236e-05,0.0,1.0
14866,맥퀸/Noun,5,5,0,5.557655114154236e-05,0.0,1.0
14867,다이쥬/Noun,5,0,5,0.0,5.5534575826909837e-05,1.0
14868,셀린느/Noun,5,5,0,5.557655114154236e-05,0.0,1.0
14869,물귀신/Noun,5,0,5,0.0,5.5534575826909837e-05,1.0
14870,멍충/Noun,5,0,5,0.0,5.5534575826909837e-05,1.0
14871,팔천원/Noun,5,0,5,0.0,5.5534575826909837e-05,1.0
14872,feel/Alpha,5,5,0,5.557655114154236e-05,0.0,1.0
14873,닭털/Noun,5,0,5,0.0,5.5534575826909837e-05,1.0
14874,유정/Noun,5,5,0,5.557655114154236e-05,0.0,1.0
14875,에이프릴/Noun,5,5,0,5.557655114154236e-05,0.0,1.0
14876,탑기어/Noun,5,0,5,0.0,5.5534575826909837e-05,1.0
14877,손태영/Noun,5,0,5,0.0,5.5534575826909837e-05,1.0
14878,Great/Alpha,5,5,0,5.557655114154236e-05,0.0,1.0
14879,짤려/Noun,5,0,5,0.0,5.5534575826909837e-05,1.0
14880,박하사탕/Noun,5,5,0,5.557655114154236e-05,0.0,1.0
14881,독설/Noun,5,5,0,5.557655114154236e-05,0.0,1.0
14882,성소수자/Noun,5,0,5,0.0,5.5534575826909837e-05,1.0
14883,언행/Noun,5,0,5,0.0,5.5534575826909837e-05,1.0
14884,자구/Noun,5,0,5,0.0,5.5534575826909837e-05,1.0
14885,김진표/Noun,5,0,5,0.0,5.5534575826909837e-05,1.0
14886,more/Alpha,5,5,0,5.557655114154236e-05,0.0,1.0
14887,정겹다/Adjective,5,5,0,5.557655114154236e-05,0.0,1.0
14888,일가견/Noun,5,0,5,0.0,5.5534575826909837e-05,1.0
14889,1만원/Number,5,0,5,0.0,5.5534575826909837e-05,1.0
14890,에서가/Josa,5,5,0,5.557655114154236e-05,0.0,1.0
14891,동등/Noun,5,5,0,5.557655114154236e-05,0.0,1.0
14892,냔/Noun,5,0,5,0.0,5.5534575826909837e-05,1.0
14893,220억/Number,5,0,5,0.0,5.5534575826909837e-05,1.0
14894,융/Noun,5,5,0,5.557655114154236e-05,0.0,1.0
14895,황보라/Noun,5,0,5,0.0,5.5534575826909837e-05,1.0
14896,참을성/Noun,5,0,5,0.0,5.5534575826909837e-05,1.0
14897,탈출기/Noun,5,5,0,5.557655114154236e-05,0.0,1.0
14898,아름다워지다/Verb,5,5,0,5.557655114154236e-05,0.0,1.0
14899,네스/Noun,5,5,0,5.557655114154236e-05,0.0,1.0
14900,상납/Noun,5,0,5,0.0,5.5534575826909837e-05,1.0
14901,연대/Noun,5,5,0,5.557655114154236e-05,0.0,1.0
14902,뭍혀/Noun,5,5,0,5.557655114154236e-05,0.0,1.0
14903,럴/Noun,5,0,5,0.0,5.5534575826909837e-05,1.0
14904,홍보물/Noun,5,0,5,0.0,5.5534575826909837e-05,1.0
14905,조자룡/Noun,5,0,5,0.0,5.5534575826909837e-05,1.0
14906,육탄/Noun,5,0,5,0.0,5.5534575826909837e-05,1.0
14907,세태/Noun,5,5,0,5.557655114154236e-05,0.0,1.0
14908,라면서/Eomi,5,0,5,0.0,5.5534575826909837e-05,1.0
14909,여파/Noun,5,5,0,5.557655114154236e-05,0.0,1.0
14910,초집/Noun,5,5,0,5.557655114154236e-05,0.0,1.0
14911,200억/Number,5,0,5,0.0,5.5534575826909837e-05,1.0
14912,(^/Punctuation,5,5,0,5.557655114154236e-05,0.0,1.0
14913,웬디/Noun,5,5,0,5.557655114154236e-05,0.0,1.0
14914,교리/Noun,5,0,5,0.0,5.5534575826909837e-05,1.0
14915,웃프/Noun,5,5,0,5.557655114154236e-05,0.0,1.0
14916,명색/Noun,5,0,5,0.0,5.5534575826909837e-05,1.0
14917,에어울프/Noun,5,5,0,5.557655114154236e-05,0.0,1.0
14918,벚꽃/Noun,5,5,0,5.557655114154236e-05,0.0,1.0
14919,방울방울/Noun,5,5,0,5.557655114154236e-05,0.0,1.0
14920,께선/Josa,5,5,0,5.557655114154236e-05,0.0,1.0
14921,정원/Noun,5,5,0,5.557655114154236e-05,0.0,1.0
14922,장모/Noun,5,0,5,0.0,5.5534575826909837e-05,1.0
14923,수목장/Noun,5,0,5,0.0,5.5534575826909837e-05,1.0
14924,구색/Noun,5,0,5,0.0,5.5534575826909837e-05,1.0
14925,가용/Noun,5,0,5,0.0,5.5534575826909837e-05,1.0
14926,유건/Noun,5,5,0,5.557655114154236e-05,0.0,1.0
14927,보샘/Noun,5,5,0,5.557655114154236e-05,0.0,1.0
14928,주현/Noun,5,0,5,0.0,5.5534575826909837e-05,1.0
14929,카오스/Noun,5,0,5,0.0,5.5534575826909837e-05,1.0
14930,다방면/Noun,5,5,0,5.557655114154236e-05,0.0,1.0
14931,무미건조/Noun,5,0,5,0.0,5.5534575826909837e-05,1.0
14932,쌉싸름하다/Adjective,5,5,0,5.557655114154236e-05,0.0,1.0
14933,대령/Noun,5,5,0,5.557655114154236e-05,0.0,1.0
14934,..................................../Punctuation,5,0,5,0.0,5.5534575826909837e-05,1.0
14935,가뜩이나/Noun,5,0,5,0.0,5.5534575826909837e-05,1.0
14936,분노조절/Noun,5,0,5,0.0,5.5534575826909837e-05,1.0
14937,그린랜턴/Noun,5,0,5,0.0,5.5534575826909837e-05,1.0
14938,오냐/Noun,5,0,5,0.0,5.5534575826909837e-05,1.0
14939,고만하다/Adjective,5,0,5,0.0,5.5534575826909837e-05,1.0
14940,반려견/Noun,5,5,0,5.557655114154236e-05,0.0,1.0
14941,43분/Number,5,0,5,0.0,5.5534575826909837e-05,1.0
14942,민주당/Noun,5,0,5,0.0,5.5534575826909837e-05,1.0
14943,88분/Number,5,0,5,0.0,5.5534575826909837e-05,1.0
14944,미져리/Noun,5,5,0,5.557655114154236e-05,0.0,1.0
14945,유망/Noun,5,0,5,0.0,5.5534575826909837e-05,1.0
14946,리액션/Noun,5,0,5,0.0,5.5534575826909837e-05,1.0
14947,수경/Noun,5,5,0,5.557655114154236e-05,0.0,1.0
14948,^*/Punctuation,5,5,0,5.557655114154236e-05,0.0,1.0
14949,주절주절/Adverb,5,0,5,0.0,5.5534575826909837e-05,1.0
14950,최송현/Noun,5,0,5,0.0,5.5534575826909837e-05,1.0
14951,적재적소/Noun,5,5,0,5.557655114154236e-05,0.0,1.0
14952,이경/Noun,5,0,5,0.0,5.5534575826909837e-05,1.0
14953,쌩쇼/Noun,5,0,5,0.0,5.5534575826909837e-05,1.0
14954,추기/Noun,5,0,5,0.0,5.5534575826909837e-05,1.0
14955,무취/Noun,5,0,5,0.0,5.5534575826909837e-05,1.0
14956,황인식/Noun,5,5,0,5.557655114154236e-05,0.0,1.0
14957,단가/Noun,5,0,5,0.0,5.5534575826909837e-05,1.0
14958,깐느/Noun,5,0,5,0.0,5.5534575826909837e-05,1.0
14959,정가/Noun,5,5,0,5.557655114154236e-05,0.0,1.0
14960,짜르/Noun,5,0,5,0.0,5.5534575826909837e-05,1.0
14961,진짜꿀/Noun,5,5,0,5.557655114154236e-05,0.0,1.0
14962,새옹지마/Noun,5,5,0,5.557655114154236e-05,0.0,1.0
14963,고안/Noun,5,0,5,0.0,5.5534575826909837e-05,1.0
14964,단성사/Noun,5,5,0,5.557655114154236e-05,0.0,1.0
14965,센빠이/Noun,5,5,0,5.557655114154236e-05,0.0,1.0
14966,5천/Number,5,0,5,0.0,5.5534575826909837e-05,1.0
14967,코타/Noun,5,5,0,5.557655114154236e-05,0.0,1.0
14968,에미넴/Noun,5,5,0,5.557655114154236e-05,0.0,1.0
14969,쥐똥/Noun,5,0,5,0.0,5.5534575826909837e-05,1.0
14970,스윈튼/Noun,5,5,0,5.557655114154236e-05,0.0,1.0
14971,갈기갈기/Noun,5,0,5,0.0,5.5534575826909837e-05,1.0
14972,두텁다/Adjective,5,5,0,5.557655114154236e-05,0.0,1.0
14973,꼼수/Noun,5,0,5,0.0,5.5534575826909837e-05,1.0
14974,첩보원/Noun,5,0,5,0.0,5.5534575826909837e-05,1.0
14975,gonna/Alpha,5,5,0,5.557655114154236e-05,0.0,1.0
14976,유딩들/Noun,5,0,5,0.0,5.5534575826909837e-05,1.0
14977,장신영/Noun,5,0,5,0.0,5.5534575826909837e-05,1.0
14978,이종수/Noun,5,0,5,0.0,5.5534575826909837e-05,1.0
14979,싸랑/Noun,5,5,0,5.557655114154236e-05,0.0,1.0
14980,황금기/Noun,5,5,0,5.557655114154236e-05,0.0,1.0
14981,강추임/Noun,5,5,0,5.557655114154236e-05,0.0,1.0
14982,알바로/Noun,5,0,5,0.0,5.5534575826909837e-05,1.0
14983,장수원/Noun,5,0,5,0.0,5.5534575826909837e-05,1.0
14984,끌기/Noun,5,0,5,0.0,5.5534575826909837e-05,1.0
14985,칼빵/Noun,5,0,5,0.0,5.5534575826909837e-05,1.0
14986,루임/Noun,5,0,5,0.0,5.5534575826909837e-05,1.0
14987,똥임/Noun,5,0,5,0.0,5.5534575826909837e-05,1.0
14988,땔수/Noun,5,5,0,5.557655114154236e-05,0.0,1.0
14989,감상주의/Noun,5,0,5,0.0,5.5534575826909837e-05,1.0
14990,핵잼/Noun,5,5,0,5.557655114154236e-05,0.0,1.0
14991,노선/Noun,5,0,5,0.0,5.5534575826909837e-05,1.0
14992,만델라/Noun,5,5,0,5.557655114154236e-05,0.0,1.0
14993,강유/Noun,5,0,5,0.0,5.5534575826909837e-05,1.0
14994,~~~~^^/Punctuation,5,5,0,5.557655114154236e-05,0.0,1.0
14995,신용카드/Noun,5,0,5,0.0,5.5534575826909837e-05,1.0
14996,은대구/Noun,5,5,0,5.557655114154236e-05,0.0,1.0
14997,팥/Noun,5,0,5,0.0,5.5534575826909837e-05,1.0
14998,블라인드/Noun,5,0,5,0.0,5.5534575826909837e-05,1.0
14999,핵무기/Noun,5,0,5,0.0,5.5534575826909837e-05,1.0
15000,조도/Noun,5,5,0,5.557655114154236e-05,0.0,1.0
15001,와사비/Noun,5,0,5,0.0,5.5534575826909837e-05,1.0
15002,해마다/Adverb,5,5,0,5.557655114154236e-05,0.0,1.0
15003,단편소설/Noun,5,5,0,5.557655114154236e-05,0.0,1.0
15004,일간/Noun,5,5,0,5.557655114154236e-05,0.0,1.0
15005,캡쳐/Noun,5,0,5,0.0,5.5534575826909837e-05,1.0
15006,고요함/Noun,5,5,0,5.557655114154236e-05,0.0,1.0
15007,급임/Noun,5,0,5,0.0,5.5534575826909837e-05,1.0
15008,중주/Noun,5,5,0,5.557655114154236e-05,0.0,1.0
15009,야릇하다/Adjective,5,5,0,5.557655114154236e-05,0.0,1.0
15010,재상/Noun,5,5,0,5.557655114154236e-05,0.0,1.0
15011,이무영/Noun,5,0,5,0.0,5.5534575826909837e-05,1.0
15012,140원/Number,5,0,5,0.0,5.5534575826909837e-05,1.0
15013,다드/Noun,5,0,5,0.0,5.5534575826909837e-05,1.0
15014,성찬/Noun,5,0,5,0.0,5.5534575826909837e-05,1.0
15015,★★★★★/Foreign,5,5,0,5.557655114154236e-05,0.0,1.0
15016,갱스/Noun,5,5,0,5.557655114154236e-05,0.0,1.0
15017,자유로/Noun,5,5,0,5.557655114154236e-05,0.0,1.0
15018,왜만듬/Noun,5,0,5,0.0,5.5534575826909837e-05,1.0
15019,야곱/Noun,5,5,0,5.557655114154236e-05,0.0,1.0
15020,어쨌다/Noun,5,0,5,0.0,5.5534575826909837e-05,1.0
15021,이상주/Noun,5,0,5,0.0,5.5534575826909837e-05,1.0
15022,르네상스/Noun,5,5,0,5.557655114154236e-05,0.0,1.0
15023,여담/Noun,5,5,0,5.557655114154236e-05,0.0,1.0
15024,악물다/Verb,5,0,5,0.0,5.5534575826909837e-05,1.0
15025,최효종/Noun,5,0,5,0.0,5.5534575826909837e-05,1.0
15026,마마마/Noun,5,5,0,5.557655114154236e-05,0.0,1.0
15027,통편집/Noun,5,0,5,0.0,5.5534575826909837e-05,1.0
15028,베가/Noun,5,5,0,5.557655114154236e-05,0.0,1.0
15029,짜리로/Foreign,5,0,5,0.0,5.5534575826909837e-05,1.0
15030,룻거/Noun,5,5,0,5.557655114154236e-05,0.0,1.0
15031,망조/Noun,5,0,5,0.0,5.5534575826909837e-05,1.0
15032,태산/Noun,5,0,5,0.0,5.5534575826909837e-05,1.0
15033,돌기/Noun,5,0,5,0.0,5.5534575826909837e-05,1.0
15034,꼬아/Noun,5,0,5,0.0,5.5534575826909837e-05,1.0
15035,정성일/Noun,5,0,5,0.0,5.5534575826909837e-05,1.0
15036,1976년/Number,5,5,0,5.557655114154236e-05,0.0,1.0
15037,업보/Noun,5,5,0,5.557655114154236e-05,0.0,1.0
15038,몽키/Noun,5,0,5,0.0,5.5534575826909837e-05,1.0
15039,난의/Noun,5,0,5,0.0,5.5534575826909837e-05,1.0
15040,형언/Noun,5,5,0,5.557655114154236e-05,0.0,1.0
15041,카이저/Noun,5,5,0,5.557655114154236e-05,0.0,1.0
15042,순결/Noun,5,0,5,0.0,5.5534575826909837e-05,1.0
15043,하네케/Noun,5,5,0,5.557655114154236e-05,0.0,1.0
15044,득템/Noun,5,5,0,5.557655114154236e-05,0.0,1.0
15045,쌩뚱맞고/Noun,5,0,5,0.0,5.5534575826909837e-05,1.0
15046,체널/Noun,5,0,5,0.0,5.5534575826909837e-05,1.0
15047,찜찜/Noun,5,0,5,0.0,5.5534575826909837e-05,1.0
15048,망처/Noun,5,0,5,0.0,5.5534575826909837e-05,1.0
15049,개수/Noun,5,0,5,0.0,5.5534575826909837e-05,1.0
15050,더글러스/Noun,5,0,5,0.0,5.5534575826909837e-05,1.0
15051,씨앗/Noun,5,5,0,5.557655114154236e-05,0.0,1.0
15052,묶이다/Verb,5,0,5,0.0,5.5534575826909837e-05,1.0
15053,속삭이다/Verb,5,5,0,5.557655114154236e-05,0.0,1.0
15054,개꿈/Noun,5,0,5,0.0,5.5534575826909837e-05,1.0
15055,욯/Noun,5,5,0,5.557655114154236e-05,0.0,1.0
15056,다짜고짜/Noun,5,0,5,0.0,5.5534575826909837e-05,1.0
15057,오죽/Noun,5,0,5,0.0,5.5534575826909837e-05,1.0
15058,허우적대다/Verb,5,0,5,0.0,5.5534575826909837e-05,1.0
15059,신저/Noun,5,5,0,5.557655114154236e-05,0.0,1.0
15060,경첨/Noun,5,0,5,0.0,5.5534575826909837e-05,1.0
15061,쉽사리/Noun,5,5,0,5.557655114154236e-05,0.0,1.0
15062,널린/Noun,5,0,5,0.0,5.5534575826909837e-05,1.0
15063,...^^*/Punctuation,5,5,0,5.557655114154236e-05,0.0,1.0
15064,테디/Noun,5,5,0,5.557655114154236e-05,0.0,1.0
15065,박희본/Noun,5,5,0,5.557655114154236e-05,0.0,1.0
15066,날조/Noun,5,0,5,0.0,5.5534575826909837e-05,1.0
15067,왜함/Noun,5,0,5,0.0,5.5534575826909837e-05,1.0
15068,이게뭡/Noun,5,0,5,0.0,5.5534575826909837e-05,1.0
15069,러브신/Noun,5,0,5,0.0,5.5534575826909837e-05,1.0
15070,깨뜨리다/Verb,5,0,5,0.0,5.5534575826909837e-05,1.0
15071,하데스/Noun,5,0,5,0.0,5.5534575826909837e-05,1.0
15072,먹잇감/Noun,5,0,5,0.0,5.5534575826909837e-05,1.0
15073,면죄부/Noun,5,0,5,0.0,5.5534575826909837e-05,1.0
15074,세스/Noun,5,5,0,5.557655114154236e-05,0.0,1.0
15075,잘봣음/Noun,5,5,0,5.557655114154236e-05,0.0,1.0
15076,마쇼/Noun,5,0,5,0.0,5.5534575826909837e-05,1.0
15077,훈계/Noun,5,0,5,0.0,5.5534575826909837e-05,1.0
15078,2222/Number,5,0,5,0.0,5.5534575826909837e-05,1.0
15079,>>>>/Punctuation,5,0,5,0.0,5.5534575826909837e-05,1.0
15080,이태란/Noun,5,0,5,0.0,5.5534575826909837e-05,1.0
15081,문화유산/Noun,5,5,0,5.557655114154236e-05,0.0,1.0
15082,호비다/Verb,5,5,0,5.557655114154236e-05,0.0,1.0
15083,어버버/Adverb,5,0,5,0.0,5.5534575826909837e-05,1.0
15084,개불/Noun,5,0,5,0.0,5.5534575826909837e-05,1.0
15085,자작/Noun,5,0,5,0.0,5.5534575826909837e-05,1.0
15086,합채/Noun,5,0,5,0.0,5.5534575826909837e-05,1.0
15087,지각/Noun,5,5,0,5.557655114154236e-05,0.0,1.0
15088,Don/Alpha,5,5,0,5.557655114154236e-05,0.0,1.0
15089,꼬셔/Noun,5,0,5,0.0,5.5534575826909837e-05,1.0
15090,빗속/Noun,5,5,0,5.557655114154236e-05,0.0,1.0
15091,면허/Noun,5,0,5,0.0,5.5534575826909837e-05,1.0
15092,명화극장/Noun,5,5,0,5.557655114154236e-05,0.0,1.0
15093,1984년/Number,5,5,0,5.557655114154236e-05,0.0,1.0
15094,;;;;;;;;;/Punctuation,5,0,5,0.0,5.5534575826909837e-05,1.0
15095,한마음/Noun,5,5,0,5.557655114154236e-05,0.0,1.0
15096,해괴망측/Noun,5,0,5,0.0,5.5534575826909837e-05,1.0
15097,송종국/Noun,5,0,5,0.0,5.5534575826909837e-05,1.0
15098,꿀잼꿀잼/Noun,5,5,0,5.557655114154236e-05,0.0,1.0
15099,뒤론/Noun,5,0,5,0.0,5.5534575826909837e-05,1.0
15100,명동/Noun,5,0,5,0.0,5.5534575826909837e-05,1.0
15101,고래고래/Noun,5,0,5,0.0,5.5534575826909837e-05,1.0
15102,우둔하다/Adjective,5,0,5,0.0,5.5534575826909837e-05,1.0
15103,분잡/Noun,5,0,5,0.0,5.5534575826909837e-05,1.0
15104,골수/Noun,5,0,5,0.0,5.5534575826909837e-05,1.0
15105,표값/Noun,5,0,5,0.0,5.5534575826909837e-05,1.0
15106,벌목/Noun,5,0,5,0.0,5.5534575826909837e-05,1.0
15107,킁/Noun,5,0,5,0.0,5.5534575826909837e-05,1.0
15108,낚시꾼/Noun,5,0,5,0.0,5.5534575826909837e-05,1.0
15109,재혼/Noun,5,0,5,0.0,5.5534575826909837e-05,1.0
15110,어언/Adverb,5,5,0,5.557655114154236e-05,0.0,1.0
15111,!~^^/Punctuation,5,5,0,5.557655114154236e-05,0.0,1.0
15112,fail/Alpha,5,0,5,0.0,5.5534575826909837e-05,1.0
15113,추접/Noun,5,0,5,0.0,5.5534575826909837e-05,1.0
15114,대학로/Noun,5,5,0,5.557655114154236e-05,0.0,1.0
15115,데니/Noun,5,5,0,5.557655114154236e-05,0.0,1.0
15116,텔러/Noun,5,5,0,5.557655114154236e-05,0.0,1.0
15117,로이킴/Noun,5,0,5,0.0,5.5534575826909837e-05,1.0
15118,!..../Punctuation,5,0,5,0.0,5.5534575826909837e-05,1.0
15119,기단/Noun,5,0,5,0.0,5.5534575826909837e-05,1.0
15120,깽깽/Adverb,5,0,5,0.0,5.5534575826909837e-05,1.0
15121,zero/Alpha,5,0,5,0.0,5.5534575826909837e-05,1.0
15122,저릿저릿하다/Adjective,5,5,0,5.557655114154236e-05,0.0,1.0
15123,목격자/Noun,5,0,5,0.0,5.5534575826909837e-05,1.0
15124,엣헴/Noun,5,0,5,0.0,5.5534575826909837e-05,1.0
15125,유나/Noun,5,5,0,5.557655114154236e-05,0.0,1.0
15126,애나/Noun,5,0,5,0.0,5.5534575826909837e-05,1.0
15127,특출나다/Adjective,5,0,5,0.0,5.5534575826909837e-05,1.0
15128,혈팬/Noun,5,5,0,5.557655114154236e-05,0.0,1.0
15129,^~^/Punctuation,5,5,0,5.557655114154236e-05,0.0,1.0
15130,이이해/Noun,5,0,5,0.0,5.5534575826909837e-05,1.0
15131,개시/Noun,5,0,5,0.0,5.5534575826909837e-05,1.0
15132,불결하다/Adjective,5,0,5,0.0,5.5534575826909837e-05,1.0
15133,가급적/Adverb,5,0,5,0.0,5.5534575826909837e-05,1.0
15134,마소/Noun,5,0,5,0.0,5.5534575826909837e-05,1.0
15135,학습/Noun,5,5,0,5.557655114154236e-05,0.0,1.0
15136,포뇨/Noun,5,5,0,5.557655114154236e-05,0.0,1.0
15137,조은영/Noun,5,5,0,5.557655114154236e-05,0.0,1.0
15138,판/Foreign,5,1,4,1.1115310228308472e-05,4.4427660661527865e-05,0.8
15139,몬스타/Noun,5,4,1,4.446124091323389e-05,1.1106915165381966e-05,0.8
15140,잭스/Noun,5,4,1,4.446124091323389e-05,1.1106915165381966e-05,0.8
15141,톨스토이/Noun,5,4,1,4.446124091323389e-05,1.1106915165381966e-05,0.8
15142,180/Number,5,1,4,1.1115310228308472e-05,4.4427660661527865e-05,0.8
15143,!!!!!!!!!!!!!!!!!!!!!!!/Punctuation,5,4,1,4.446124091323389e-05,1.1106915165381966e-05,0.8
15144,진실로/Adverb,5,4,1,4.446124091323389e-05,1.1106915165381966e-05,0.8
15145,연기대상/Noun,5,4,1,4.446124091323389e-05,1.1106915165381966e-05,0.8
15146,부사/Noun,5,1,4,1.1115310228308472e-05,4.4427660661527865e-05,0.8
15147,에이트/Noun,5,1,4,1.1115310228308472e-05,4.4427660661527865e-05,0.8
15148,분단국가/Noun,5,4,1,4.446124091323389e-05,1.1106915165381966e-05,0.8
15149,메리트/Noun,5,4,1,4.446124091323389e-05,1.1106915165381966e-05,0.8
15150,프로즌/Noun,5,4,1,4.446124091323389e-05,1.1106915165381966e-05,0.8
15151,스크립트/Noun,5,1,4,1.1115310228308472e-05,4.4427660661527865e-05,0.8
15152,왕팬/Noun,5,4,1,4.446124091323389e-05,1.1106915165381966e-05,0.8
15153,년대/Noun,5,1,4,1.1115310228308472e-05,4.4427660661527865e-05,0.8
15154,마나피/Noun,5,1,4,1.1115310228308472e-05,4.4427660661527865e-05,0.8
15155,젓다/Verb,5,4,1,4.446124091323389e-05,1.1106915165381966e-05,0.8
15156,딛다/Verb,5,4,1,4.446124091323389e-05,1.1106915165381966e-05,0.8
15157,페로/Noun,5,4,1,4.446124091323389e-05,1.1106915165381966e-05,0.8
15158,강남스타일/Noun,5,1,4,1.1115310228308472e-05,4.4427660661527865e-05,0.8
15159,세분/Noun,5,4,1,4.446124091323389e-05,1.1106915165381966e-05,0.8
15160,死/Foreign,5,1,4,1.1115310228308472e-05,4.4427660661527865e-05,0.8
15161,표상/Noun,5,1,4,1.1115310228308472e-05,4.4427660661527865e-05,0.8
15162,에다가/Noun,5,1,4,1.1115310228308472e-05,4.4427660661527865e-05,0.8
15163,간이/Noun,5,1,4,1.1115310228308472e-05,4.4427660661527865e-05,0.8
15164,!!'/Punctuation,5,1,4,1.1115310228308472e-05,4.4427660661527865e-05,0.8
15165,역사드라마/Noun,5,4,1,4.446124091323389e-05,1.1106915165381966e-05,0.8
15166,거때매/Noun,5,1,4,1.1115310228308472e-05,4.4427660661527865e-05,0.8
15167,?;;;;/Punctuation,5,1,4,1.1115310228308472e-05,4.4427660661527865e-05,0.8
15168,콤플렉스/Noun,5,1,4,1.1115310228308472e-05,4.4427660661527865e-05,0.8
15169,박현/Noun,5,1,4,1.1115310228308472e-05,4.4427660661527865e-05,0.8
15170,전차/Noun,5,1,4,1.1115310228308472e-05,4.4427660661527865e-05,0.8
15171,굉장/Noun,5,4,1,4.446124091323389e-05,1.1106915165381966e-05,0.8
15172,메이트/Noun,5,4,1,4.446124091323389e-05,1.1106915165381966e-05,0.8
15173,배터리/Noun,5,4,1,4.446124091323389e-05,1.1106915165381966e-05,0.8
15174,고지전/Noun,5,1,4,1.1115310228308472e-05,4.4427660661527865e-05,0.8
15175,농장/Noun,5,1,4,1.1115310228308472e-05,4.4427660661527865e-05,0.8
15176,담장/Noun,5,4,1,4.446124091323389e-05,1.1106915165381966e-05,0.8
15177,착란/Noun,5,1,4,1.1115310228308472e-05,4.4427660661527865e-05,0.8
15178,정치드라마/Noun,5,4,1,4.446124091323389e-05,1.1106915165381966e-05,0.8
15179,번천/Noun,5,1,4,1.1115310228308472e-05,4.4427660661527865e-05,0.8
15180,안통/Noun,5,1,4,1.1115310228308472e-05,4.4427660661527865e-05,0.8
15181,흰둥이/Noun,5,4,1,4.446124091323389e-05,1.1106915165381966e-05,0.8
15182,탭댄스/Noun,5,4,1,4.446124091323389e-05,1.1106915165381966e-05,0.8
15183,향상/Noun,5,4,1,4.446124091323389e-05,1.1106915165381966e-05,0.8
15184,쌍칼/Noun,5,1,4,1.1115310228308472e-05,4.4427660661527865e-05,0.8
15185,캠퍼스/Noun,5,4,1,4.446124091323389e-05,1.1106915165381966e-05,0.8
15186,서준이/Noun,5,4,1,4.446124091323389e-05,1.1106915165381966e-05,0.8
15187,한승연/Noun,5,1,4,1.1115310228308472e-05,4.4427660661527865e-05,0.8
15188,액스맨/Noun,5,1,4,1.1115310228308472e-05,4.4427660661527865e-05,0.8
15189,다툼/Noun,5,4,1,4.446124091323389e-05,1.1106915165381966e-05,0.8
15190,이인상/Noun,5,4,1,4.446124091323389e-05,1.1106915165381966e-05,0.8
15191,월남전/Noun,5,4,1,4.446124091323389e-05,1.1106915165381966e-05,0.8
15192,구성원/Noun,5,4,1,4.446124091323389e-05,1.1106915165381966e-05,0.8
15193,마음먹다/Verb,5,1,4,1.1115310228308472e-05,4.4427660661527865e-05,0.8
15194,저승/Noun,5,1,4,1.1115310228308472e-05,4.4427660661527865e-05,0.8
15195,봣을때/Noun,5,4,1,4.446124091323389e-05,1.1106915165381966e-05,0.8
15196,딴말/Noun,5,4,1,4.446124091323389e-05,1.1106915165381966e-05,0.8
15197,무책임/Noun,5,1,4,1.1115310228308472e-05,4.4427660661527865e-05,0.8
15198,자장면/Noun,5,4,1,4.446124091323389e-05,1.1106915165381966e-05,0.8
15199,인걸/Noun,5,1,4,1.1115310228308472e-05,4.4427660661527865e-05,0.8
15200,영웅재중/Noun,5,1,4,1.1115310228308472e-05,4.4427660661527865e-05,0.8
15201,풍만하다/Adjective,5,4,1,4.446124091323389e-05,1.1106915165381966e-05,0.8
15202,강타/Noun,5,4,1,4.446124091323389e-05,1.1106915165381966e-05,0.8
15203,금액/Noun,5,1,4,1.1115310228308472e-05,4.4427660661527865e-05,0.8
15204,순종/Noun,5,4,1,4.446124091323389e-05,1.1106915165381966e-05,0.8
15205,약혼/Noun,5,1,4,1.1115310228308472e-05,4.4427660661527865e-05,0.8
15206,개늑시/Noun,5,4,1,4.446124091323389e-05,1.1106915165381966e-05,0.8
15207,한겨레/Noun,5,4,1,4.446124091323389e-05,1.1106915165381966e-05,0.8
15208,백지/Noun,5,4,1,4.446124091323389e-05,1.1106915165381966e-05,0.8
15209,궁상맞다/Adjective,5,1,4,1.1115310228308472e-05,4.4427660661527865e-05,0.8
15210,로베르토/Noun,5,4,1,4.446124091323389e-05,1.1106915165381966e-05,0.8
15211,신입/Noun,5,1,4,1.1115310228308472e-05,4.4427660661527865e-05,0.8
15212,강산/Noun,5,4,1,4.446124091323389e-05,1.1106915165381966e-05,0.8
15213,딸바보/Noun,5,4,1,4.446124091323389e-05,1.1106915165381966e-05,0.8
15214,연줄/Noun,5,1,4,1.1115310228308472e-05,4.4427660661527865e-05,0.8
15215,관여/Noun,5,1,4,1.1115310228308472e-05,4.4427660661527865e-05,0.8
15216,라이터/Noun,5,1,4,1.1115310228308472e-05,4.4427660661527865e-05,0.8
15217,초록/Noun,5,4,1,4.446124091323389e-05,1.1106915165381966e-05,0.8
15218,골룸/Noun,5,1,4,1.1115310228308472e-05,4.4427660661527865e-05,0.8
15219,샵/Suffix,5,4,1,4.446124091323389e-05,1.1106915165381966e-05,0.8
15220,들판/Noun,5,4,1,4.446124091323389e-05,1.1106915165381966e-05,0.8
15221,뫼비우스/Noun,5,4,1,4.446124091323389e-05,1.1106915165381966e-05,0.8
15222,2500원/Number,5,1,4,1.1115310228308472e-05,4.4427660661527865e-05,0.8
15223,드림걸즈/Noun,5,1,4,1.1115310228308472e-05,4.4427660661527865e-05,0.8
15224,비아이/Noun,5,1,4,1.1115310228308472e-05,4.4427660661527865e-05,0.8
15225,3천/Number,5,1,4,1.1115310228308472e-05,4.4427660661527865e-05,0.8
15226,35년/Number,5,4,1,4.446124091323389e-05,1.1106915165381966e-05,0.8
15227,서영/Noun,5,1,4,1.1115310228308472e-05,4.4427660661527865e-05,0.8
15228,일터/Noun,5,1,4,1.1115310228308472e-05,4.4427660661527865e-05,0.8
15229,삼십/Noun,5,4,1,4.446124091323389e-05,1.1106915165381966e-05,0.8
15230,노가다/Noun,5,1,4,1.1115310228308472e-05,4.4427660661527865e-05,0.8
15231,신구/Noun,5,4,1,4.446124091323389e-05,1.1106915165381966e-05,0.8
15232,출생의비밀/Noun,5,1,4,1.1115310228308472e-05,4.4427660661527865e-05,0.8
15233,시아버지/Noun,5,1,4,1.1115310228308472e-05,4.4427660661527865e-05,0.8
15234,홍경민/Noun,5,1,4,1.1115310228308472e-05,4.4427660661527865e-05,0.8
15235,달라짐/Noun,5,1,4,1.1115310228308472e-05,4.4427660661527865e-05,0.8
15236,실미도/Noun,5,1,4,1.1115310228308472e-05,4.4427660661527865e-05,0.8
15237,네/Exclamation,5,4,1,4.446124091323389e-05,1.1106915165381966e-05,0.8
15238,법대/Noun,5,4,1,4.446124091323389e-05,1.1106915165381966e-05,0.8
15239,마등/Noun,5,4,1,4.446124091323389e-05,1.1106915165381966e-05,0.8
15240,1.4/Number,5,1,4,1.1115310228308472e-05,4.4427660661527865e-05,0.8
15241,back/Alpha,5,4,1,4.446124091323389e-05,1.1106915165381966e-05,0.8
15242,궤/Noun,5,4,1,4.446124091323389e-05,1.1106915165381966e-05,0.8
15243,경로/Noun,5,1,4,1.1115310228308472e-05,4.4427660661527865e-05,0.8
15244,애프터/Noun,5,4,1,4.446124091323389e-05,1.1106915165381966e-05,0.8
15245,199/Number,5,1,4,1.1115310228308472e-05,4.4427660661527865e-05,0.8
15246,☞/Foreign,5,1,4,1.1115310228308472e-05,4.4427660661527865e-05,0.8
15247,한해/Noun,5,4,1,4.446124091323389e-05,1.1106915165381966e-05,0.8
15248,성재/Noun,5,1,4,1.1115310228308472e-05,4.4427660661527865e-05,0.8
15249,묵/Noun,5,1,4,1.1115310228308472e-05,4.4427660661527865e-05,0.8
15250,적인걸/Noun,5,1,4,1.1115310228308472e-05,4.4427660661527865e-05,0.8
15251,대일/Noun,5,4,1,4.446124091323389e-05,1.1106915165381966e-05,0.8
15252,이왕/Adverb,5,1,4,1.1115310228308472e-05,4.4427660661527865e-05,0.8
15253,하강/Noun,5,1,4,1.1115310228308472e-05,4.4427660661527865e-05,0.8
15254,네일/Noun,5,4,1,4.446124091323389e-05,1.1106915165381966e-05,0.8
15255,들이밀다/Verb,5,1,4,1.1115310228308472e-05,4.4427660661527865e-05,0.8
15256,안부/Noun,5,1,4,1.1115310228308472e-05,4.4427660661527865e-05,0.8
15257,훈장/Noun,5,1,4,1.1115310228308472e-05,4.4427660661527865e-05,0.8
15258,레시라무/Noun,5,4,1,4.446124091323389e-05,1.1106915165381966e-05,0.8
15259,장판/Noun,5,1,4,1.1115310228308472e-05,4.4427660661527865e-05,0.8
15260,한드/Noun,5,4,1,4.446124091323389e-05,1.1106915165381966e-05,0.8
15261,전무/Noun,5,1,4,1.1115310228308472e-05,4.4427660661527865e-05,0.8
15262,베끼/Noun,5,1,4,1.1115310228308472e-05,4.4427660661527865e-05,0.8
15263,에지/Noun,5,4,1,4.446124091323389e-05,1.1106915165381966e-05,0.8
15264,청리/Noun,5,1,4,1.1115310228308472e-05,4.4427660661527865e-05,0.8
15265,콩트/Noun,5,1,4,1.1115310228308472e-05,4.4427660661527865e-05,0.8
15266,사설/Noun,5,1,4,1.1115310228308472e-05,4.4427660661527865e-05,0.8
15267,난대/Noun,5,1,4,1.1115310228308472e-05,4.4427660661527865e-05,0.8
15268,네드/Noun,5,4,1,4.446124091323389e-05,1.1106915165381966e-05,0.8
15269,무산/Noun,5,4,1,4.446124091323389e-05,1.1106915165381966e-05,0.8
15270,성자/Noun,5,4,1,4.446124091323389e-05,1.1106915165381966e-05,0.8
15271,유스케/Noun,5,1,4,1.1115310228308472e-05,4.4427660661527865e-05,0.8
15272,명쾌하다/Adjective,5,4,1,4.446124091323389e-05,1.1106915165381966e-05,0.8
15273,조수/Noun,5,1,4,1.1115310228308472e-05,4.4427660661527865e-05,0.8
15274,원샷/Noun,5,1,4,1.1115310228308472e-05,4.4427660661527865e-05,0.8
15275,연금술사/Noun,5,4,1,4.446124091323389e-05,1.1106915165381966e-05,0.8
15276,친구여/Noun,5,4,1,4.446124091323389e-05,1.1106915165381966e-05,0.8
15277,추앙/Noun,5,1,4,1.1115310228308472e-05,4.4427660661527865e-05,0.8
15278,백터/Noun,5,1,4,1.1115310228308472e-05,4.4427660661527865e-05,0.8
15279,스내치/Noun,5,4,1,4.446124091323389e-05,1.1106915165381966e-05,0.8
15280,원점/Noun,5,1,4,1.1115310228308472e-05,4.4427660661527865e-05,0.8
15281,지면/Noun,5,4,1,4.446124091323389e-05,1.1106915165381966e-05,0.8
15282,병폐/Noun,5,1,4,1.1115310228308472e-05,4.4427660661527865e-05,0.8
15283,ㄹㄹㄹ/KoreanParticle,5,4,1,4.446124091323389e-05,1.1106915165381966e-05,0.8
15284,",!/Punctuation",5,4,1,4.446124091323389e-05,1.1106915165381966e-05,0.8
15285,에픽/Noun,5,1,4,1.1115310228308472e-05,4.4427660661527865e-05,0.8
15286,대군/Noun,5,1,4,1.1115310228308472e-05,4.4427660661527865e-05,0.8
15287,대포/Noun,5,1,4,1.1115310228308472e-05,4.4427660661527865e-05,0.8
15288,한민족/Noun,5,4,1,4.446124091323389e-05,1.1106915165381966e-05,0.8
15289,주사위/Noun,5,1,4,1.1115310228308472e-05,4.4427660661527865e-05,0.8
15290,탑블레이드/Noun,5,1,4,1.1115310228308472e-05,4.4427660661527865e-05,0.8
15291,일박이일/Noun,5,1,4,1.1115310228308472e-05,4.4427660661527865e-05,0.8
15292,한강/Noun,5,4,1,4.446124091323389e-05,1.1106915165381966e-05,0.8
15293,반박/Noun,5,1,4,1.1115310228308472e-05,4.4427660661527865e-05,0.8
15294,뙇/Noun,5,4,1,4.446124091323389e-05,1.1106915165381966e-05,0.8
15295,개사/Noun,5,1,4,1.1115310228308472e-05,4.4427660661527865e-05,0.8
15296,찬열/Noun,5,4,1,4.446124091323389e-05,1.1106915165381966e-05,0.8
15297,오어/Noun,5,4,1,4.446124091323389e-05,1.1106915165381966e-05,0.8
15298,디시/Noun,5,4,1,4.446124091323389e-05,1.1106915165381966e-05,0.8
15299,말콤/Noun,5,4,1,4.446124091323389e-05,1.1106915165381966e-05,0.8
15300,수현/Noun,5,4,1,4.446124091323389e-05,1.1106915165381966e-05,0.8
15301,주적/Noun,5,1,4,1.1115310228308472e-05,4.4427660661527865e-05,0.8
15302,1981년/Number,5,4,1,4.446124091323389e-05,1.1106915165381966e-05,0.8
15303,따라쟁/Noun,5,1,4,1.1115310228308472e-05,4.4427660661527865e-05,0.8
15304,일빠/Noun,5,1,4,1.1115310228308472e-05,4.4427660661527865e-05,0.8
15305,살딸/Noun,5,4,1,4.446124091323389e-05,1.1106915165381966e-05,0.8
15306,속세/Noun,5,1,4,1.1115310228308472e-05,4.4427660661527865e-05,0.8
15307,유천/Noun,5,4,1,4.446124091323389e-05,1.1106915165381966e-05,0.8
15308,가타카/Noun,5,1,4,1.1115310228308472e-05,4.4427660661527865e-05,0.8
15309,년후/Noun,5,4,1,4.446124091323389e-05,1.1106915165381966e-05,0.8
15310,쩖/Noun,5,4,1,4.446124091323389e-05,1.1106915165381966e-05,0.8
15311,쌈빡하다/Adjective,5,1,4,1.1115310228308472e-05,4.4427660661527865e-05,0.8
15312,희수/Noun,5,1,4,1.1115310228308472e-05,4.4427660661527865e-05,0.8
15313,타당/Noun,5,1,4,1.1115310228308472e-05,4.4427660661527865e-05,0.8
15314,적절/Noun,5,1,4,1.1115310228308472e-05,4.4427660661527865e-05,0.8
15315,노병/Noun,5,4,1,4.446124091323389e-05,1.1106915165381966e-05,0.8
15316,신공/Noun,5,1,4,1.1115310228308472e-05,4.4427660661527865e-05,0.8
15317,민하/Noun,5,4,1,4.446124091323389e-05,1.1106915165381966e-05,0.8
15318,농민/Noun,5,4,1,4.446124091323389e-05,1.1106915165381966e-05,0.8
15319,로마시대/Noun,5,4,1,4.446124091323389e-05,1.1106915165381966e-05,0.8
15320,럭비/Noun,5,4,1,4.446124091323389e-05,1.1106915165381966e-05,0.8
15321,섹파/Noun,5,1,4,1.1115310228308472e-05,4.4427660661527865e-05,0.8
15322,한여름/Noun,5,4,1,4.446124091323389e-05,1.1106915165381966e-05,0.8
15323,연봉/Noun,5,1,4,1.1115310228308472e-05,4.4427660661527865e-05,0.8
15324,두기봉/Noun,5,4,1,4.446124091323389e-05,1.1106915165381966e-05,0.8
15325,불분명/Noun,5,1,4,1.1115310228308472e-05,4.4427660661527865e-05,0.8
15326,후뢰시맨/Noun,5,1,4,1.1115310228308472e-05,4.4427660661527865e-05,0.8
15327,그리스도/Noun,5,4,1,4.446124091323389e-05,1.1106915165381966e-05,0.8
15328,남용/Noun,5,1,4,1.1115310228308472e-05,4.4427660661527865e-05,0.8
15329,행복감/Noun,5,4,1,4.446124091323389e-05,1.1106915165381966e-05,0.8
15330,섹스씬/Noun,5,1,4,1.1115310228308472e-05,4.4427660661527865e-05,0.8
15331,ㅜㅡㅜ/KoreanParticle,5,4,1,4.446124091323389e-05,1.1106915165381966e-05,0.8
15332,우후죽순/Noun,5,1,4,1.1115310228308472e-05,4.4427660661527865e-05,0.8
15333,끼리끼리/Noun,5,1,4,1.1115310228308472e-05,4.4427660661527865e-05,0.8
15334,-->/Punctuation,5,1,4,1.1115310228308472e-05,4.4427660661527865e-05,0.8
15335,7일/Number,5,1,4,1.1115310228308472e-05,4.4427660661527865e-05,0.8
15336,잡아끌다/Verb,5,4,1,4.446124091323389e-05,1.1106915165381966e-05,0.8
15337,자건/Noun,5,4,1,4.446124091323389e-05,1.1106915165381966e-05,0.8
15338,기담/Noun,5,4,1,4.446124091323389e-05,1.1106915165381966e-05,0.8
15339,또렷하다/Adjective,5,4,1,4.446124091323389e-05,1.1106915165381966e-05,0.8
15340,바꿔치다/Verb,5,1,4,1.1115310228308472e-05,4.4427660661527865e-05,0.8
15341,엣날/Noun,5,4,1,4.446124091323389e-05,1.1106915165381966e-05,0.8
15342,앨리/Noun,5,4,1,4.446124091323389e-05,1.1106915165381966e-05,0.8
15343,",,../Punctuation",5,1,4,1.1115310228308472e-05,4.4427660661527865e-05,0.8
15344,민국/Noun,5,1,4,1.1115310228308472e-05,4.4427660661527865e-05,0.8
15345,eyes/Alpha,5,4,1,4.446124091323389e-05,1.1106915165381966e-05,0.8
15346,관심사/Noun,5,1,4,1.1115310228308472e-05,4.4427660661527865e-05,0.8
15347,DC/Alpha,5,1,4,1.1115310228308472e-05,4.4427660661527865e-05,0.8
15348,오뉴월/Noun,5,4,1,4.446124091323389e-05,1.1106915165381966e-05,0.8
15349,무능력/Noun,5,1,4,1.1115310228308472e-05,4.4427660661527865e-05,0.8
15350,무소유/Noun,5,4,1,4.446124091323389e-05,1.1106915165381966e-05,0.8
15351,김혜리/Noun,5,4,1,4.446124091323389e-05,1.1106915165381966e-05,0.8
15352,후지산/Noun,5,1,4,1.1115310228308472e-05,4.4427660661527865e-05,0.8
15353,대란/Noun,5,4,1,4.446124091323389e-05,1.1106915165381966e-05,0.8
15354,산자/Noun,5,4,1,4.446124091323389e-05,1.1106915165381966e-05,0.8
15355,성경책/Noun,5,1,4,1.1115310228308472e-05,4.4427660661527865e-05,0.8
15356,e/Alpha,5,4,1,4.446124091323389e-05,1.1106915165381966e-05,0.8
15357,촌빨/Noun,5,1,4,1.1115310228308472e-05,4.4427660661527865e-05,0.8
15358,And/Alpha,5,4,1,4.446124091323389e-05,1.1106915165381966e-05,0.8
15359,브라스/Noun,5,1,4,1.1115310228308472e-05,4.4427660661527865e-05,0.8
15360,대에는/Foreign,5,1,4,1.1115310228308472e-05,4.4427660661527865e-05,0.8
15361,새아빠/Noun,5,4,1,4.446124091323389e-05,1.1106915165381966e-05,0.8
15362,가벼워지다/Verb,5,4,1,4.446124091323389e-05,1.1106915165381966e-05,0.8
15363,윤수/Noun,5,4,1,4.446124091323389e-05,1.1106915165381966e-05,0.8
15364,마티/Noun,5,4,1,4.446124091323389e-05,1.1106915165381966e-05,0.8
15365,반격/Noun,5,4,1,4.446124091323389e-05,1.1106915165381966e-05,0.8
15366,낚일순/Noun,5,4,1,4.446124091323389e-05,1.1106915165381966e-05,0.8
15367,기마/Noun,5,1,4,1.1115310228308472e-05,4.4427660661527865e-05,0.8
15368,뒤/Foreign,5,4,1,4.446124091323389e-05,1.1106915165381966e-05,0.8
15369,박일/Noun,5,4,1,4.446124091323389e-05,1.1106915165381966e-05,0.8
15370,<-/Punctuation,5,1,4,1.1115310228308472e-05,4.4427660661527865e-05,0.8
15371,보건/Noun,5,1,4,1.1115310228308472e-05,4.4427660661527865e-05,0.8
15372,스트레칭/Noun,5,1,4,1.1115310228308472e-05,4.4427660661527865e-05,0.8
15373,무신/Modifier,5,1,4,1.1115310228308472e-05,4.4427660661527865e-05,0.8
15374,전선/Noun,5,1,4,1.1115310228308472e-05,4.4427660661527865e-05,0.8
15375,우루루/Adverb,5,1,4,1.1115310228308472e-05,4.4427660661527865e-05,0.8
15376,아킬레스/Noun,5,4,1,4.446124091323389e-05,1.1106915165381966e-05,0.8
15377,벅/Noun,5,1,4,1.1115310228308472e-05,4.4427660661527865e-05,0.8
15378,천진난만하다/Adjective,5,4,1,4.446124091323389e-05,1.1106915165381966e-05,0.8
15379,다스/Noun,5,1,4,1.1115310228308472e-05,4.4427660661527865e-05,0.8
15380,컨/Noun,5,4,1,4.446124091323389e-05,1.1106915165381966e-05,0.8
15381,히/Noun,5,1,4,1.1115310228308472e-05,4.4427660661527865e-05,0.8
15382,1/10/Number,5,1,4,1.1115310228308472e-05,4.4427660661527865e-05,0.8
15383,보오/Noun,5,1,4,1.1115310228308472e-05,4.4427660661527865e-05,0.8
15384,눈의여왕/Noun,5,1,4,1.1115310228308472e-05,4.4427660661527865e-05,0.8
15385,추녀/Noun,5,1,4,1.1115310228308472e-05,4.4427660661527865e-05,0.8
15386,ㅈㅐ/KoreanParticle,5,4,1,4.446124091323389e-05,1.1106915165381966e-05,0.8
15387,대하드라마/Noun,5,4,1,4.446124091323389e-05,1.1106915165381966e-05,0.8
15388,길냥이/Noun,5,4,1,4.446124091323389e-05,1.1106915165381966e-05,0.8
15389,파크/Noun,5,1,4,1.1115310228308472e-05,4.4427660661527865e-05,0.8
15390,경멸/Noun,5,1,4,1.1115310228308472e-05,4.4427660661527865e-05,0.8
15391,닦이다/Verb,5,1,4,1.1115310228308472e-05,4.4427660661527865e-05,0.8
15392,파랑새/Noun,5,4,1,4.446124091323389e-05,1.1106915165381966e-05,0.8
15393,에볼라/Noun,5,4,1,4.446124091323389e-05,1.1106915165381966e-05,0.8
15394,!!!~/Punctuation,5,4,1,4.446124091323389e-05,1.1106915165381966e-05,0.8
15395,저쩌/Noun,5,1,4,1.1115310228308472e-05,4.4427660661527865e-05,0.8
15396,!)/Punctuation,5,1,4,1.1115310228308472e-05,4.4427660661527865e-05,0.8
15397,마파도/Noun,5,1,4,1.1115310228308472e-05,4.4427660661527865e-05,0.8
15398,광대하다/Adjective,5,4,1,4.446124091323389e-05,1.1106915165381966e-05,0.8
15399,이뽀/Noun,5,4,1,4.446124091323389e-05,1.1106915165381966e-05,0.8
15400,상인/Noun,5,1,4,1.1115310228308472e-05,4.4427660661527865e-05,0.8
15401,빌붙다/Verb,5,1,4,1.1115310228308472e-05,4.4427660661527865e-05,0.8
15402,",,?/Punctuation",5,1,4,1.1115310228308472e-05,4.4427660661527865e-05,0.8
15403,유가령/Noun,5,4,1,4.446124091323389e-05,1.1106915165381966e-05,0.8
15404,험난하다/Adjective,5,4,1,4.446124091323389e-05,1.1106915165381966e-05,0.8
15405,끌어안다/Verb,5,4,1,4.446124091323389e-05,1.1106915165381966e-05,0.8
15406,기력/Noun,5,4,1,4.446124091323389e-05,1.1106915165381966e-05,0.8
15407,인조인간/Noun,5,1,4,1.1115310228308472e-05,4.4427660661527865e-05,0.8
15408,가일/Noun,5,1,4,1.1115310228308472e-05,4.4427660661527865e-05,0.8
15409,오백원/Noun,5,4,1,4.446124091323389e-05,1.1106915165381966e-05,0.8
15410,한프로/Noun,5,1,4,1.1115310228308472e-05,4.4427660661527865e-05,0.8
15411,종현/Noun,5,4,1,4.446124091323389e-05,1.1106915165381966e-05,0.8
15412,쉿/Noun,5,1,4,1.1115310228308472e-05,4.4427660661527865e-05,0.8
15413,윤소이/Noun,5,1,4,1.1115310228308472e-05,4.4427660661527865e-05,0.8
15414,황야/Noun,5,4,1,4.446124091323389e-05,1.1106915165381966e-05,0.8
15415,보살/Noun,5,1,4,1.1115310228308472e-05,4.4427660661527865e-05,0.8
15416,닌지/Noun,5,1,4,1.1115310228308472e-05,4.4427660661527865e-05,0.8
15417,Q/Alpha,5,4,1,4.446124091323389e-05,1.1106915165381966e-05,0.8
15418,2~3년/Number,5,4,1,4.446124091323389e-05,1.1106915165381966e-05,0.8
15419,일본도/Noun,5,1,4,1.1115310228308472e-05,4.4427660661527865e-05,0.8
15420,발광/Noun,5,1,4,1.1115310228308472e-05,4.4427660661527865e-05,0.8
15421,밀회/Noun,5,4,1,4.446124091323389e-05,1.1106915165381966e-05,0.8
15422,JYP/Alpha,5,1,4,1.1115310228308472e-05,4.4427660661527865e-05,0.8
15423,거금/Noun,5,1,4,1.1115310228308472e-05,4.4427660661527865e-05,0.8
15424,차이나/Noun,5,1,4,1.1115310228308472e-05,4.4427660661527865e-05,0.8
15425,어지러움/Noun,5,1,4,1.1115310228308472e-05,4.4427660661527865e-05,0.8
15426,칸나/Noun,5,1,4,1.1115310228308472e-05,4.4427660661527865e-05,0.8
15427,볼법/Noun,5,1,4,1.1115310228308472e-05,4.4427660661527865e-05,0.8
15428,추성훈/Noun,5,1,4,1.1115310228308472e-05,4.4427660661527865e-05,0.8
15429,잘만드/Noun,5,4,1,4.446124091323389e-05,1.1106915165381966e-05,0.8
15430,음반/Noun,5,4,1,4.446124091323389e-05,1.1106915165381966e-05,0.8
15431,꼭대기/Noun,5,4,1,4.446124091323389e-05,1.1106915165381966e-05,0.8
15432,ㅁㅇ/KoreanParticle,5,4,1,4.446124091323389e-05,1.1106915165381966e-05,0.8
15433,패자부활전/Noun,5,1,4,1.1115310228308472e-05,4.4427660661527865e-05,0.8
15434,두준/Noun,5,4,1,4.446124091323389e-05,1.1106915165381966e-05,0.8
15435,볼랬는데/Noun,5,1,4,1.1115310228308472e-05,4.4427660661527865e-05,0.8
15436,아스테릭스/Noun,5,1,4,1.1115310228308472e-05,4.4427660661527865e-05,0.8
15437,려니/Noun,5,1,4,1.1115310228308472e-05,4.4427660661527865e-05,0.8
15438,열기/Noun,5,4,1,4.446124091323389e-05,1.1106915165381966e-05,0.8
15439,----/Punctuation,5,1,4,1.1115310228308472e-05,4.4427660661527865e-05,0.8
15440,한밤중/Noun,5,4,1,4.446124091323389e-05,1.1106915165381966e-05,0.8
15441,Com/Alpha,5,4,1,4.446124091323389e-05,1.1106915165381966e-05,0.8
15442,황새/Noun,5,1,4,1.1115310228308472e-05,4.4427660661527865e-05,0.8
15443,자손/Noun,5,1,4,1.1115310228308472e-05,4.4427660661527865e-05,0.8
15444,난자/Noun,5,4,1,4.446124091323389e-05,1.1106915165381966e-05,0.8
15445,조혜련/Noun,5,1,4,1.1115310228308472e-05,4.4427660661527865e-05,0.8
15446,방송인/Noun,5,1,4,1.1115310228308472e-05,4.4427660661527865e-05,0.8
15447,너저분하다/Adjective,5,1,4,1.1115310228308472e-05,4.4427660661527865e-05,0.8
15448,병력/Noun,5,1,4,1.1115310228308472e-05,4.4427660661527865e-05,0.8
15449,ㅋㅋㅋㄱ/KoreanParticle,5,4,1,4.446124091323389e-05,1.1106915165381966e-05,0.8
15450,협소/Noun,5,1,4,1.1115310228308472e-05,4.4427660661527865e-05,0.8
15451,@/Foreign,5,4,1,4.446124091323389e-05,1.1106915165381966e-05,0.8
15452,예쁜남자/Noun,5,4,1,4.446124091323389e-05,1.1106915165381966e-05,0.8
15453,혁명가/Noun,5,4,1,4.446124091323389e-05,1.1106915165381966e-05,0.8
15454,최강창민/Noun,5,4,1,4.446124091323389e-05,1.1106915165381966e-05,0.8
15455,도화선/Noun,5,1,4,1.1115310228308472e-05,4.4427660661527865e-05,0.8
15456,이기선/Noun,5,4,1,4.446124091323389e-05,1.1106915165381966e-05,0.8
15457,깨끗해지다/Verb,5,4,1,4.446124091323389e-05,1.1106915165381966e-05,0.8
15458,멉/Noun,5,1,4,1.1115310228308472e-05,4.4427660661527865e-05,0.8
15459,데자뷰/Noun,5,1,4,1.1115310228308472e-05,4.4427660661527865e-05,0.8
15460,기역/Noun,5,4,1,4.446124091323389e-05,1.1106915165381966e-05,0.8
15461,자해/Noun,5,1,4,1.1115310228308472e-05,4.4427660661527865e-05,0.8
15462,강사/Noun,5,1,4,1.1115310228308472e-05,4.4427660661527865e-05,0.8
15463,빅터/Noun,5,4,1,4.446124091323389e-05,1.1106915165381966e-05,0.8
15464,육질/Noun,5,4,1,4.446124091323389e-05,1.1106915165381966e-05,0.8
15465,소총/Noun,5,1,4,1.1115310228308472e-05,4.4427660661527865e-05,0.8
15466,발걸음/Noun,5,4,1,4.446124091323389e-05,1.1106915165381966e-05,0.8
15467,큭/Noun,5,1,4,1.1115310228308472e-05,4.4427660661527865e-05,0.8
15468,까지는/Foreign,5,1,4,1.1115310228308472e-05,4.4427660661527865e-05,0.8
15469,반납/Noun,5,1,4,1.1115310228308472e-05,4.4427660661527865e-05,0.8
15470,레쉬/Noun,5,1,4,1.1115310228308472e-05,4.4427660661527865e-05,0.8
15471,film/Alpha,5,4,1,4.446124091323389e-05,1.1106915165381966e-05,0.8
15472,부임/Noun,5,1,4,1.1115310228308472e-05,4.4427660661527865e-05,0.8
15473,비비안/Noun,5,4,1,4.446124091323389e-05,1.1106915165381966e-05,0.8
15474,ㄸ/KoreanParticle,5,1,4,1.1115310228308472e-05,4.4427660661527865e-05,0.8
15475,~~~~~~~~~~~~~/Punctuation,5,4,1,4.446124091323389e-05,1.1106915165381966e-05,0.8
15476,재등장/Noun,5,1,4,1.1115310228308472e-05,4.4427660661527865e-05,0.8
15477,watch/Alpha,5,4,1,4.446124091323389e-05,1.1106915165381966e-05,0.8
15478,마츠다/Noun,5,4,1,4.446124091323389e-05,1.1106915165381966e-05,0.8
15479,먹거리/Noun,5,1,4,1.1115310228308472e-05,4.4427660661527865e-05,0.8
15480,성희롱/Noun,5,1,4,1.1115310228308472e-05,4.4427660661527865e-05,0.8
15481,선거/Noun,5,4,1,4.446124091323389e-05,1.1106915165381966e-05,0.8
15482,전봇대/Noun,5,1,4,1.1115310228308472e-05,4.4427660661527865e-05,0.8
15483,보우/Noun,5,1,4,1.1115310228308472e-05,4.4427660661527865e-05,0.8
15484,못난이주의보/Noun,5,4,1,4.446124091323389e-05,1.1106915165381966e-05,0.8
15485,쾌/Noun,5,4,1,4.446124091323389e-05,1.1106915165381966e-05,0.8
15486,훌룡/Noun,5,4,1,4.446124091323389e-05,1.1106915165381966e-05,0.8
15487,구니스/Noun,5,4,1,4.446124091323389e-05,1.1106915165381966e-05,0.8
15488,차례대로/Noun,5,1,4,1.1115310228308472e-05,4.4427660661527865e-05,0.8
15489,목회자/Noun,5,4,1,4.446124091323389e-05,1.1106915165381966e-05,0.8
15490,내보이다/Verb,5,1,4,1.1115310228308472e-05,4.4427660661527865e-05,0.8
15491,적반하장/Noun,5,1,4,1.1115310228308472e-05,4.4427660661527865e-05,0.8
15492,궤변/Noun,5,1,4,1.1115310228308472e-05,4.4427660661527865e-05,0.8
15493,파급/Noun,5,1,4,1.1115310228308472e-05,4.4427660661527865e-05,0.8
15494,아바/Noun,5,4,1,4.446124091323389e-05,1.1106915165381966e-05,0.8
15495,강해진/Noun,5,1,4,1.1115310228308472e-05,4.4427660661527865e-05,0.8
15496,제한상영가/Noun,5,1,4,1.1115310228308472e-05,4.4427660661527865e-05,0.8
15497,에슐리/Noun,5,4,1,4.446124091323389e-05,1.1106915165381966e-05,0.8
15498,찌개/Noun,5,1,4,1.1115310228308472e-05,4.4427660661527865e-05,0.8
15499,짊/Noun,5,4,1,4.446124091323389e-05,1.1106915165381966e-05,0.8
15500,real/Alpha,5,4,1,4.446124091323389e-05,1.1106915165381966e-05,0.8
15501,초초초/Noun,5,1,4,1.1115310228308472e-05,4.4427660661527865e-05,0.8
15502,호제/Noun,5,4,1,4.446124091323389e-05,1.1106915165381966e-05,0.8
15503,푸욱/Noun,5,4,1,4.446124091323389e-05,1.1106915165381966e-05,0.8
15504,상하이/Noun,5,4,1,4.446124091323389e-05,1.1106915165381966e-05,0.8
15505,시크/Noun,5,4,1,4.446124091323389e-05,1.1106915165381966e-05,0.8
15506,슛/Noun,5,4,1,4.446124091323389e-05,1.1106915165381966e-05,0.8
15507,부자간/Noun,5,4,1,4.446124091323389e-05,1.1106915165381966e-05,0.8
15508,자기애/Noun,5,1,4,1.1115310228308472e-05,4.4427660661527865e-05,0.8
15509,왜못/Noun,5,4,1,4.446124091323389e-05,1.1106915165381966e-05,0.8
15510,.....?/Punctuation,5,1,4,1.1115310228308472e-05,4.4427660661527865e-05,0.8
15511,"',/Punctuation",5,4,1,4.446124091323389e-05,1.1106915165381966e-05,0.8
15512,판박이/Noun,5,1,4,1.1115310228308472e-05,4.4427660661527865e-05,0.8
15513,ㄱㅅ/KoreanParticle,5,4,1,4.446124091323389e-05,1.1106915165381966e-05,0.8
15514,으잉/Noun,5,1,4,1.1115310228308472e-05,4.4427660661527865e-05,0.8
15515,건대/Noun,5,4,1,4.446124091323389e-05,1.1106915165381966e-05,0.8
15516,허큘리스/Noun,5,4,1,4.446124091323389e-05,1.1106915165381966e-05,0.8
15517,로케/Noun,5,1,4,1.1115310228308472e-05,4.4427660661527865e-05,0.8
15518,어여/Adverb,5,1,4,1.1115310228308472e-05,4.4427660661527865e-05,0.8
15519,성적소수자/Noun,5,4,1,4.446124091323389e-05,1.1106915165381966e-05,0.8
15520,뼈대/Noun,5,1,4,1.1115310228308472e-05,4.4427660661527865e-05,0.8
15521,양양/Noun,5,4,1,4.446124091323389e-05,1.1106915165381966e-05,0.8
15522,함장/Noun,5,4,1,4.446124091323389e-05,1.1106915165381966e-05,0.8
15523,커스틴/Noun,5,4,1,4.446124091323389e-05,1.1106915165381966e-05,0.8
15524,신상옥/Noun,5,1,4,1.1115310228308472e-05,4.4427660661527865e-05,0.8
15525,참치/Noun,5,1,4,1.1115310228308472e-05,4.4427660661527865e-05,0.8
15526,본기/Noun,5,1,4,1.1115310228308472e-05,4.4427660661527865e-05,0.8
15527,오싱/Noun,5,4,1,4.446124091323389e-05,1.1106915165381966e-05,0.8
15528,김한민/Noun,5,1,4,1.1115310228308472e-05,4.4427660661527865e-05,0.8
15529,어린왕자/Noun,5,4,1,4.446124091323389e-05,1.1106915165381966e-05,0.8
15530,캣/Noun,5,1,4,1.1115310228308472e-05,4.4427660661527865e-05,0.8
15531,각국/Noun,5,4,1,4.446124091323389e-05,1.1106915165381966e-05,0.8
15532,절권도/Noun,5,4,1,4.446124091323389e-05,1.1106915165381966e-05,0.8
15533,징역/Noun,5,1,4,1.1115310228308472e-05,4.4427660661527865e-05,0.8
15534,저서/Noun,5,1,4,1.1115310228308472e-05,4.4427660661527865e-05,0.8
15535,드롱/Noun,5,4,1,4.446124091323389e-05,1.1106915165381966e-05,0.8
15536,이종인/Noun,5,1,4,1.1115310228308472e-05,4.4427660661527865e-05,0.8
15537,발의/Noun,5,1,4,1.1115310228308472e-05,4.4427660661527865e-05,0.8
15538,코같다/Adjective,5,1,4,1.1115310228308472e-05,4.4427660661527865e-05,0.8
15539,상향/Noun,5,4,1,4.446124091323389e-05,1.1106915165381966e-05,0.8
15540,벤더스/Noun,5,4,1,4.446124091323389e-05,1.1106915165381966e-05,0.8
15541,외톨이/Noun,5,1,4,1.1115310228308472e-05,4.4427660661527865e-05,0.8
15542,야생/Noun,5,4,1,4.446124091323389e-05,1.1106915165381966e-05,0.8
15543,사다리/Noun,5,4,1,4.446124091323389e-05,1.1106915165381966e-05,0.8
15544,플랜맨/Noun,5,4,1,4.446124091323389e-05,1.1106915165381966e-05,0.8
15545,역류/Noun,5,1,4,1.1115310228308472e-05,4.4427660661527865e-05,0.8
15546,개병/Noun,5,1,4,1.1115310228308472e-05,4.4427660661527865e-05,0.8
15547,에서라도/Josa,5,4,1,4.446124091323389e-05,1.1106915165381966e-05,0.8
15548,타이어/Noun,5,1,4,1.1115310228308472e-05,4.4427660661527865e-05,0.8
15549,까지를/Josa,5,4,1,4.446124091323389e-05,1.1106915165381966e-05,0.8
15550,세자/Noun,5,4,1,4.446124091323389e-05,1.1106915165381966e-05,0.8
15551,와르르/Noun,5,1,4,1.1115310228308472e-05,4.4427660661527865e-05,0.8
15552,격려/Noun,5,4,1,4.446124091323389e-05,1.1106915165381966e-05,0.8
15553,양파/Noun,5,1,4,1.1115310228308472e-05,4.4427660661527865e-05,0.8
15554,오염/Noun,5,4,1,4.446124091323389e-05,1.1106915165381966e-05,0.8
15555,보라색/Noun,5,4,1,4.446124091323389e-05,1.1106915165381966e-05,0.8
15556,/../Punctuation,5,1,4,1.1115310228308472e-05,4.4427660661527865e-05,0.8
15557,메르/Noun,5,1,4,1.1115310228308472e-05,4.4427660661527865e-05,0.8
15558,촬영감독/Noun,5,1,4,1.1115310228308472e-05,4.4427660661527865e-05,0.8
15559,아랍인/Noun,5,4,1,4.446124091323389e-05,1.1106915165381966e-05,0.8
15560,스카이라인/Noun,5,1,4,1.1115310228308472e-05,4.4427660661527865e-05,0.8
15561,도모/Noun,5,4,1,4.446124091323389e-05,1.1106915165381966e-05,0.8
15562,여민정/Noun,5,1,4,1.1115310228308472e-05,4.4427660661527865e-05,0.8
15563,잔득/Noun,5,1,4,1.1115310228308472e-05,4.4427660661527865e-05,0.8
15564,적진/Noun,5,1,4,1.1115310228308472e-05,4.4427660661527865e-05,0.8
15565,퇴치/Noun,5,1,4,1.1115310228308472e-05,4.4427660661527865e-05,0.8
15566,명연/Noun,5,4,1,4.446124091323389e-05,1.1106915165381966e-05,0.8
15567,미용실/Noun,5,4,1,4.446124091323389e-05,1.1106915165381966e-05,0.8
15568,뒷목잡다/Verb,5,1,4,1.1115310228308472e-05,4.4427660661527865e-05,0.8
15569,후작/Noun,5,4,1,4.446124091323389e-05,1.1106915165381966e-05,0.8
15570,스펙트럼/Noun,5,4,1,4.446124091323389e-05,1.1106915165381966e-05,0.8
15571,파운드/Noun,5,1,4,1.1115310228308472e-05,4.4427660661527865e-05,0.8
15572,ㄴㄴㄴ/KoreanParticle,5,1,4,1.1115310228308472e-05,4.4427660661527865e-05,0.8
15573,댓/Modifier,5,1,4,1.1115310228308472e-05,4.4427660661527865e-05,0.8
15574,금성/Noun,5,4,1,4.446124091323389e-05,1.1106915165381966e-05,0.8
15575,레퀴엠/Noun,5,4,1,4.446124091323389e-05,1.1106915165381966e-05,0.8
15576,고충/Noun,5,4,1,4.446124091323389e-05,1.1106915165381966e-05,0.8
15577,루카/Noun,5,4,1,4.446124091323389e-05,1.1106915165381966e-05,0.8
15578,백년의유산/Noun,5,4,1,4.446124091323389e-05,1.1106915165381966e-05,0.8
15579,성비/Noun,5,1,4,1.1115310228308472e-05,4.4427660661527865e-05,0.8
15580,포이/Noun,5,4,1,4.446124091323389e-05,1.1106915165381966e-05,0.8
15581,하나라/Noun,5,4,1,4.446124091323389e-05,1.1106915165381966e-05,0.8
15582,분배/Noun,5,1,4,1.1115310228308472e-05,4.4427660661527865e-05,0.8
15583,뱁새/Noun,5,1,4,1.1115310228308472e-05,4.4427660661527865e-05,0.8
15584,족치다/Verb,5,1,4,1.1115310228308472e-05,4.4427660661527865e-05,0.8
15585,변치않다/Verb,5,4,1,4.446124091323389e-05,1.1106915165381966e-05,0.8
15586,건줄/Noun,5,1,4,1.1115310228308472e-05,4.4427660661527865e-05,0.8
15587,찌찌/Noun,5,1,4,1.1115310228308472e-05,4.4427660661527865e-05,0.8
15588,98%/Number,5,1,4,1.1115310228308472e-05,4.4427660661527865e-05,0.8
15589,침투/Noun,5,1,4,1.1115310228308472e-05,4.4427660661527865e-05,0.8
15590,아미/Noun,5,1,4,1.1115310228308472e-05,4.4427660661527865e-05,0.8
15591,후카/Noun,5,1,4,1.1115310228308472e-05,4.4427660661527865e-05,0.8
15592,무쌍/Noun,5,1,4,1.1115310228308472e-05,4.4427660661527865e-05,0.8
15593,번봣/Noun,5,4,1,4.446124091323389e-05,1.1106915165381966e-05,0.8
15594,자베르/Noun,5,1,4,1.1115310228308472e-05,4.4427660661527865e-05,0.8
15595,항문/Noun,5,1,4,1.1115310228308472e-05,4.4427660661527865e-05,0.8
15596,반공/Noun,5,1,4,1.1115310228308472e-05,4.4427660661527865e-05,0.8
15597,......................../Punctuation,5,1,4,1.1115310228308472e-05,4.4427660661527865e-05,0.8
15598,붕어빵/Noun,5,1,4,1.1115310228308472e-05,4.4427660661527865e-05,0.8
15599,비정상회담/Noun,5,4,1,4.446124091323389e-05,1.1106915165381966e-05,0.8
15600,무뚝뚝하다/Adjective,5,4,1,4.446124091323389e-05,1.1106915165381966e-05,0.8
15601,정예/Noun,5,1,4,1.1115310228308472e-05,4.4427660661527865e-05,0.8
15602,떨기/Noun,5,1,4,1.1115310228308472e-05,4.4427660661527865e-05,0.8
15603,놧/Noun,5,1,4,1.1115310228308472e-05,4.4427660661527865e-05,0.8
15604,알다/Noun,5,4,1,4.446124091323389e-05,1.1106915165381966e-05,0.8
15605,메탈리카/Noun,5,4,1,4.446124091323389e-05,1.1106915165381966e-05,0.8
15606,골수팬/Noun,5,1,4,1.1115310228308472e-05,4.4427660661527865e-05,0.8
15607,낚는/Noun,5,1,4,1.1115310228308472e-05,4.4427660661527865e-05,0.8
15608,커밍/Noun,5,4,1,4.446124091323389e-05,1.1106915165381966e-05,0.8
15609,에잉/Noun,5,1,4,1.1115310228308472e-05,4.4427660661527865e-05,0.8
15610,됫음/Noun,5,4,1,4.446124091323389e-05,1.1106915165381966e-05,0.8
15611,이승연/Noun,5,1,4,1.1115310228308472e-05,4.4427660661527865e-05,0.8
15612,제각각/Noun,5,1,4,1.1115310228308472e-05,4.4427660661527865e-05,0.8
15613,친한친구/Noun,5,4,1,4.446124091323389e-05,1.1106915165381966e-05,0.8
15614,단상/Noun,5,1,4,1.1115310228308472e-05,4.4427660661527865e-05,0.8
15615,퓨/Noun,5,1,4,1.1115310228308472e-05,4.4427660661527865e-05,0.8
15616,통합/Noun,5,1,4,1.1115310228308472e-05,4.4427660661527865e-05,0.8
15617,푹푹/Adverb,5,1,4,1.1115310228308472e-05,4.4427660661527865e-05,0.8
15618,쥰/Noun,5,1,4,1.1115310228308472e-05,4.4427660661527865e-05,0.8
15619,제정/Noun,5,1,4,1.1115310228308472e-05,4.4427660661527865e-05,0.8
15620,이대/Noun,5,1,4,1.1115310228308472e-05,4.4427660661527865e-05,0.8
15621,민족주의/Noun,5,1,4,1.1115310228308472e-05,4.4427660661527865e-05,0.8
15622,침울하다/Adjective,5,1,4,1.1115310228308472e-05,4.4427660661527865e-05,0.8
15623,피날레/Noun,5,4,1,4.446124091323389e-05,1.1106915165381966e-05,0.8
15624,비화/Noun,5,1,4,1.1115310228308472e-05,4.4427660661527865e-05,0.8
15625,대국민/Noun,5,1,4,1.1115310228308472e-05,4.4427660661527865e-05,0.8
15626,이력/Noun,5,1,4,1.1115310228308472e-05,4.4427660661527865e-05,0.8
15627,미사여구/Noun,5,1,4,1.1115310228308472e-05,4.4427660661527865e-05,0.8
15628,카레/Noun,5,1,4,1.1115310228308472e-05,4.4427660661527865e-05,0.8
15629,순응/Noun,5,4,1,4.446124091323389e-05,1.1106915165381966e-05,0.8
15630,한예린/Noun,5,1,4,1.1115310228308472e-05,4.4427660661527865e-05,0.8
15631,녘/Noun,5,4,1,4.446124091323389e-05,1.1106915165381966e-05,0.8
15632,거니/Eomi,5,1,4,1.1115310228308472e-05,4.4427660661527865e-05,0.8
15633,박지빈/Noun,5,4,1,4.446124091323389e-05,1.1106915165381966e-05,0.8
15634,어투/Noun,5,1,4,1.1115310228308472e-05,4.4427660661527865e-05,0.8
15635,라다/Noun,5,1,4,1.1115310228308472e-05,4.4427660661527865e-05,0.8
15636,달아나다/Verb,5,4,1,4.446124091323389e-05,1.1106915165381966e-05,0.8
15637,결승/Noun,5,1,4,1.1115310228308472e-05,4.4427660661527865e-05,0.8
15638,한탄/Noun,5,1,4,1.1115310228308472e-05,4.4427660661527865e-05,0.8
15639,네이션/Noun,5,4,1,4.446124091323389e-05,1.1106915165381966e-05,0.8
15640,후시/Noun,5,1,4,1.1115310228308472e-05,4.4427660661527865e-05,0.8
15641,통장/Noun,5,1,4,1.1115310228308472e-05,4.4427660661527865e-05,0.8
15642,윤한/Noun,5,1,4,1.1115310228308472e-05,4.4427660661527865e-05,0.8
15643,모태/Noun,5,4,1,4.446124091323389e-05,1.1106915165381966e-05,0.8
15644,가망/Noun,5,1,4,1.1115310228308472e-05,4.4427660661527865e-05,0.8
15645,다이아/Noun,5,1,4,1.1115310228308472e-05,4.4427660661527865e-05,0.8
15646,24년/Number,5,4,1,4.446124091323389e-05,1.1106915165381966e-05,0.8
15647,뒤엎/Noun,5,4,1,4.446124091323389e-05,1.1106915165381966e-05,0.8
15648,아랑사또전/Noun,5,4,1,4.446124091323389e-05,1.1106915165381966e-05,0.8
15649,코딱지/Noun,5,1,4,1.1115310228308472e-05,4.4427660661527865e-05,0.8
15650,파내다/Verb,5,1,4,1.1115310228308472e-05,4.4427660661527865e-05,0.8
15651,패인/Noun,5,1,4,1.1115310228308472e-05,4.4427660661527865e-05,0.8
15652,서럽다/Verb,5,4,1,4.446124091323389e-05,1.1106915165381966e-05,0.8
15653,플레이어/Noun,5,4,1,4.446124091323389e-05,1.1106915165381966e-05,0.8
15654,200원/Number,5,1,4,1.1115310228308472e-05,4.4427660661527865e-05,0.8
15655,대조영/Noun,5,1,4,1.1115310228308472e-05,4.4427660661527865e-05,0.8
15656,나주/Noun,5,1,4,1.1115310228308472e-05,4.4427660661527865e-05,0.8
15657,명관/Noun,5,4,1,4.446124091323389e-05,1.1106915165381966e-05,0.8
15658,패가/Noun,5,4,1,4.446124091323389e-05,1.1106915165381966e-05,0.8
15659,엄슴/Noun,5,1,4,1.1115310228308472e-05,4.4427660661527865e-05,0.8
15660,6-7/Number,5,1,4,1.1115310228308472e-05,4.4427660661527865e-05,0.8
15661,언터처블/Noun,5,4,1,4.446124091323389e-05,1.1106915165381966e-05,0.8
15662,마르지/Noun,5,4,1,4.446124091323389e-05,1.1106915165381966e-05,0.8
15663,우위/Noun,5,1,4,1.1115310228308472e-05,4.4427660661527865e-05,0.8
15664,축축하다/Adjective,5,4,1,4.446124091323389e-05,1.1106915165381966e-05,0.8
15665,전에는/Foreign,5,1,4,1.1115310228308472e-05,4.4427660661527865e-05,0.8
15666,정혜/Noun,5,4,1,4.446124091323389e-05,1.1106915165381966e-05,0.8
15667,81년/Number,5,4,1,4.446124091323389e-05,1.1106915165381966e-05,0.8
15668,참석/Noun,5,1,4,1.1115310228308472e-05,4.4427660661527865e-05,0.8
15669,작부/Noun,5,1,4,1.1115310228308472e-05,4.4427660661527865e-05,0.8
15670,언론플레이/Noun,5,1,4,1.1115310228308472e-05,4.4427660661527865e-05,0.8
15671,아우디/Noun,5,4,1,4.446124091323389e-05,1.1106915165381966e-05,0.8
15672,제휴/Noun,5,1,4,1.1115310228308472e-05,4.4427660661527865e-05,0.8
15673,은비/Noun,5,4,1,4.446124091323389e-05,1.1106915165381966e-05,0.8
15674,천주교/Noun,5,1,4,1.1115310228308472e-05,4.4427660661527865e-05,0.8
15675,그랴/Noun,5,1,4,1.1115310228308472e-05,4.4427660661527865e-05,0.8
15676,워킹맘/Noun,5,4,1,4.446124091323389e-05,1.1106915165381966e-05,0.8
15677,영홥니/Noun,5,4,1,4.446124091323389e-05,1.1106915165381966e-05,0.8
15678,갈겨/Adverb,5,1,4,1.1115310228308472e-05,4.4427660661527865e-05,0.8
15679,꺠/Noun,5,1,4,1.1115310228308472e-05,4.4427660661527865e-05,0.8
15680,닥쳐오다/Verb,5,4,1,4.446124091323389e-05,1.1106915165381966e-05,0.8
15681,하악/Exclamation,5,4,1,4.446124091323389e-05,1.1106915165381966e-05,0.8
15682,소/Foreign,5,4,1,4.446124091323389e-05,1.1106915165381966e-05,0.8
15683,브레이커/Noun,5,1,4,1.1115310228308472e-05,4.4427660661527865e-05,0.8
15684,7.4/Number,5,4,1,4.446124091323389e-05,1.1106915165381966e-05,0.8
15685,음양사/Noun,5,4,1,4.446124091323389e-05,1.1106915165381966e-05,0.8
15686,양가휘/Noun,5,4,1,4.446124091323389e-05,1.1106915165381966e-05,0.8
15687,이웃집/Noun,5,1,4,1.1115310228308472e-05,4.4427660661527865e-05,0.8
15688,리카/Noun,5,4,1,4.446124091323389e-05,1.1106915165381966e-05,0.8
15689,탈때/Noun,5,4,1,4.446124091323389e-05,1.1106915165381966e-05,0.8
15690,인어/Noun,5,4,1,4.446124091323389e-05,1.1106915165381966e-05,0.8
15691,12일/Number,5,1,4,1.1115310228308472e-05,4.4427660661527865e-05,0.8
15692,눈사태/Noun,5,4,1,4.446124091323389e-05,1.1106915165381966e-05,0.8
15693,냉혈/Noun,5,4,1,4.446124091323389e-05,1.1106915165381966e-05,0.8
15694,골탕/Noun,5,1,4,1.1115310228308472e-05,4.4427660661527865e-05,0.8
15695,게일/Noun,5,4,1,4.446124091323389e-05,1.1106915165381966e-05,0.8
15696,어렷을적/Noun,5,4,1,4.446124091323389e-05,1.1106915165381966e-05,0.8
15697,15초/Number,5,1,4,1.1115310228308472e-05,4.4427660661527865e-05,0.8
15698,무오/Noun,5,1,4,1.1115310228308472e-05,4.4427660661527865e-05,0.8
15699,사마/Noun,5,4,1,4.446124091323389e-05,1.1106915165381966e-05,0.8
15700,충남/Noun,5,1,4,1.1115310228308472e-05,4.4427660661527865e-05,0.8
15701,11월/Number,5,4,1,4.446124091323389e-05,1.1106915165381966e-05,0.8
15702,초록물고기/Noun,5,4,1,4.446124091323389e-05,1.1106915165381966e-05,0.8
15703,반동안/Foreign,5,1,4,1.1115310228308472e-05,4.4427660661527865e-05,0.8
15704,하래/Noun,5,1,4,1.1115310228308472e-05,4.4427660661527865e-05,0.8
15705,빙글빙글/Adverb,5,1,4,1.1115310228308472e-05,4.4427660661527865e-05,0.8
15706,무사백동수/Noun,5,4,1,4.446124091323389e-05,1.1106915165381966e-05,0.8
15707,김해/Noun,5,1,4,1.1115310228308472e-05,4.4427660661527865e-05,0.8
15708,어허/Exclamation,5,1,4,1.1115310228308472e-05,4.4427660661527865e-05,0.8
15709,와일드카드/Noun,5,1,4,1.1115310228308472e-05,4.4427660661527865e-05,0.8
15710,가브리엘/Noun,5,4,1,4.446124091323389e-05,1.1106915165381966e-05,0.8
15711,메뚜기/Noun,5,1,4,1.1115310228308472e-05,4.4427660661527865e-05,0.8
15712,유인원/Noun,5,4,1,4.446124091323389e-05,1.1106915165381966e-05,0.8
15713,창백하다/Adjective,5,4,1,4.446124091323389e-05,1.1106915165381966e-05,0.8
15714,때/Foreign,5,4,1,4.446124091323389e-05,1.1106915165381966e-05,0.8
15715,영민/Noun,5,4,1,4.446124091323389e-05,1.1106915165381966e-05,0.8
15716,알리샤/Noun,5,4,1,4.446124091323389e-05,1.1106915165381966e-05,0.8
15717,설키/Noun,5,1,4,1.1115310228308472e-05,4.4427660661527865e-05,0.8
15718,이영훈/Noun,5,4,1,4.446124091323389e-05,1.1106915165381966e-05,0.8
15719,주저리주저리/Adverb,5,1,4,1.1115310228308472e-05,4.4427660661527865e-05,0.8
15720,연주가/Noun,5,4,1,4.446124091323389e-05,1.1106915165381966e-05,0.8
15721,장희빈/Noun,5,1,4,1.1115310228308472e-05,4.4427660661527865e-05,0.8
15722,다크니스/Noun,5,4,1,4.446124091323389e-05,1.1106915165381966e-05,0.8
15723,드라이/Noun,5,4,1,4.446124091323389e-05,1.1106915165381966e-05,0.8
15724,-!/Punctuation,5,4,1,4.446124091323389e-05,1.1106915165381966e-05,0.8
15725,심신/Noun,5,1,4,1.1115310228308472e-05,4.4427660661527865e-05,0.8
15726,얌전하다/Adjective,5,1,4,1.1115310228308472e-05,4.4427660661527865e-05,0.8
15727,양육/Noun,5,1,4,1.1115310228308472e-05,4.4427660661527865e-05,0.8
15728,공중부양/Noun,5,1,4,1.1115310228308472e-05,4.4427660661527865e-05,0.8
15729,제네시스/Noun,5,1,4,1.1115310228308472e-05,4.4427660661527865e-05,0.8
15730,넴/Noun,5,4,1,4.446124091323389e-05,1.1106915165381966e-05,0.8
15731,ㅎㅎㅋㅋ/KoreanParticle,5,4,1,4.446124091323389e-05,1.1106915165381966e-05,0.8
15732,seen/Alpha,5,4,1,4.446124091323389e-05,1.1106915165381966e-05,0.8
15733,ve/Alpha,5,4,1,4.446124091323389e-05,1.1106915165381966e-05,0.8
15734,다크라이/Noun,5,1,4,1.1115310228308472e-05,4.4427660661527865e-05,0.8
15735,스나이더/Noun,5,4,1,4.446124091323389e-05,1.1106915165381966e-05,0.8
15736,미명/Noun,5,1,4,1.1115310228308472e-05,4.4427660661527865e-05,0.8
15737,종잡/Noun,5,1,4,1.1115310228308472e-05,4.4427660661527865e-05,0.8
15738,핏빛/Noun,5,4,1,4.446124091323389e-05,1.1106915165381966e-05,0.8
15739,리스크/Noun,5,1,4,1.1115310228308472e-05,4.4427660661527865e-05,0.8
15740,오크/Noun,5,1,4,1.1115310228308472e-05,4.4427660661527865e-05,0.8
15741,텔레비전/Noun,5,4,1,4.446124091323389e-05,1.1106915165381966e-05,0.8
15742,거원/Noun,5,1,4,1.1115310228308472e-05,4.4427660661527865e-05,0.8
15743,레닌/Noun,5,1,4,1.1115310228308472e-05,4.4427660661527865e-05,0.8
15744,이와이슌지/Noun,5,4,1,4.446124091323389e-05,1.1106915165381966e-05,0.8
15745,바늘/Noun,5,1,4,1.1115310228308472e-05,4.4427660661527865e-05,0.8
15746,진우/Noun,5,1,4,1.1115310228308472e-05,4.4427660661527865e-05,0.8
15747,섭리/Noun,5,4,1,4.446124091323389e-05,1.1106915165381966e-05,0.8
15748,주요/Noun,5,1,4,1.1115310228308472e-05,4.4427660661527865e-05,0.8
15749,팔씨름/Noun,5,4,1,4.446124091323389e-05,1.1106915165381966e-05,0.8
15750,껍/Noun,5,1,4,1.1115310228308472e-05,4.4427660661527865e-05,0.8
15751,라거/Noun,5,1,4,1.1115310228308472e-05,4.4427660661527865e-05,0.8
15752,반정/Noun,5,4,1,4.446124091323389e-05,1.1106915165381966e-05,0.8
15753,오언조/Noun,5,4,1,4.446124091323389e-05,1.1106915165381966e-05,0.8
15754,Ocn/Alpha,5,1,4,1.1115310228308472e-05,4.4427660661527865e-05,0.8
15755,코엑스/Noun,5,1,4,1.1115310228308472e-05,4.4427660661527865e-05,0.8
15756,슈퍼노바/Noun,5,4,1,4.446124091323389e-05,1.1106915165381966e-05,0.8
15757,웨인/Noun,5,4,1,4.446124091323389e-05,1.1106915165381966e-05,0.8
15758,배렸다/Noun,5,1,4,1.1115310228308472e-05,4.4427660661527865e-05,0.8
15759,슈발/Noun,5,4,1,4.446124091323389e-05,1.1106915165381966e-05,0.8
15760,특촬/Noun,5,1,4,1.1115310228308472e-05,4.4427660661527865e-05,0.8
15761,항변/Noun,5,1,4,1.1115310228308472e-05,4.4427660661527865e-05,0.8
15762,나르시즘/Noun,5,1,4,1.1115310228308472e-05,4.4427660661527865e-05,0.8
15763,살색/Noun,5,1,4,1.1115310228308472e-05,4.4427660661527865e-05,0.8
15764,푸핫/Exclamation,5,1,4,1.1115310228308472e-05,4.4427660661527865e-05,0.8
15765,곽/Noun,5,4,1,4.446124091323389e-05,1.1106915165381966e-05,0.8
15766,82분/Number,5,1,4,1.1115310228308472e-05,4.4427660661527865e-05,0.8
15767,^)/Punctuation,5,4,1,4.446124091323389e-05,1.1106915165381966e-05,0.8
15768,형부/Noun,5,1,4,1.1115310228308472e-05,4.4427660661527865e-05,0.8
15769,파르/Noun,5,4,1,4.446124091323389e-05,1.1106915165381966e-05,0.8
15770,해커/Noun,5,1,4,1.1115310228308472e-05,4.4427660661527865e-05,0.8
15771,성형수술/Noun,5,1,4,1.1115310228308472e-05,4.4427660661527865e-05,0.8
15772,소프트/Noun,5,1,4,1.1115310228308472e-05,4.4427660661527865e-05,0.8
15773,롤링/Noun,5,4,1,4.446124091323389e-05,1.1106915165381966e-05,0.8
15774,외딴/Noun,5,1,4,1.1115310228308472e-05,4.4427660661527865e-05,0.8
15775,국방/Noun,5,1,4,1.1115310228308472e-05,4.4427660661527865e-05,0.8
15776,everything/Alpha,5,4,1,4.446124091323389e-05,1.1106915165381966e-05,0.8
15777,캡틴아메리카/Noun,5,4,1,4.446124091323389e-05,1.1106915165381966e-05,0.8
15778,황산벌/Noun,5,1,4,1.1115310228308472e-05,4.4427660661527865e-05,0.8
15779,유구무언/Noun,5,1,4,1.1115310228308472e-05,4.4427660661527865e-05,0.8
15780,특별/Noun,5,1,4,1.1115310228308472e-05,4.4427660661527865e-05,0.8
15781,생태계/Noun,5,4,1,4.446124091323389e-05,1.1106915165381966e-05,0.8
15782,약육강식/Noun,5,4,1,4.446124091323389e-05,1.1106915165381966e-05,0.8
15783,GP/Alpha,5,1,4,1.1115310228308472e-05,4.4427660661527865e-05,0.8
15784,논리성/Noun,5,1,4,1.1115310228308472e-05,4.4427660661527865e-05,0.8
15785,수만/Modifier,5,3,2,3.3345930684925414e-05,2.2213830330763933e-05,0.6
15786,공산/Noun,5,3,2,3.3345930684925414e-05,2.2213830330763933e-05,0.6
15787,소니/Noun,5,2,3,2.2230620456616944e-05,3.33207454961459e-05,0.6
15788,향해/Noun,5,3,2,3.3345930684925414e-05,2.2213830330763933e-05,0.6
15789,상보/Noun,5,3,2,3.3345930684925414e-05,2.2213830330763933e-05,0.6
15790,멀티/Noun,5,2,3,2.2230620456616944e-05,3.33207454961459e-05,0.6
15791,여유롭다/Verb,5,2,3,2.2230620456616944e-05,3.33207454961459e-05,0.6
15792,내막/Noun,5,2,3,2.2230620456616944e-05,3.33207454961459e-05,0.6
15793,윈슬렛/Noun,5,2,3,2.2230620456616944e-05,3.33207454961459e-05,0.6
15794,미미/Noun,5,3,2,3.3345930684925414e-05,2.2213830330763933e-05,0.6
15795,펄롱/Noun,5,3,2,3.3345930684925414e-05,2.2213830330763933e-05,0.6
15796,~~~!!!!/Punctuation,5,2,3,2.2230620456616944e-05,3.33207454961459e-05,0.6
15797,뒤태/Noun,5,2,3,2.2230620456616944e-05,3.33207454961459e-05,0.6
15798,전전/Noun,5,3,2,3.3345930684925414e-05,2.2213830330763933e-05,0.6
15799,프라다/Noun,5,3,2,3.3345930684925414e-05,2.2213830330763933e-05,0.6
15800,다말/Noun,5,2,3,2.2230620456616944e-05,3.33207454961459e-05,0.6
15801,뚫어지다/Verb,5,3,2,3.3345930684925414e-05,2.2213830330763933e-05,0.6
15802,조총련/Noun,5,2,3,2.2230620456616944e-05,3.33207454961459e-05,0.6
15803,엇슴/Noun,5,2,3,2.2230620456616944e-05,3.33207454961459e-05,0.6
15804,일조/Noun,5,2,3,2.2230620456616944e-05,3.33207454961459e-05,0.6
15805,필터/Noun,5,2,3,2.2230620456616944e-05,3.33207454961459e-05,0.6
15806,대나무/Noun,5,2,3,2.2230620456616944e-05,3.33207454961459e-05,0.6
15807,영주/Noun,5,3,2,3.3345930684925414e-05,2.2213830330763933e-05,0.6
15808,멧돼지/Noun,5,2,3,2.2230620456616944e-05,3.33207454961459e-05,0.6
15809,스르/Noun,5,2,3,2.2230620456616944e-05,3.33207454961459e-05,0.6
15810,매몰/Noun,5,3,2,3.3345930684925414e-05,2.2213830330763933e-05,0.6
15811,디에고/Noun,5,3,2,3.3345930684925414e-05,2.2213830330763933e-05,0.6
15812,로저/Noun,5,3,2,3.3345930684925414e-05,2.2213830330763933e-05,0.6
15813,저금/Noun,5,2,3,2.2230620456616944e-05,3.33207454961459e-05,0.6
15814,그물/Noun,5,3,2,3.3345930684925414e-05,2.2213830330763933e-05,0.6
15815,프로야구/Noun,5,2,3,2.2230620456616944e-05,3.33207454961459e-05,0.6
15816,벙커/Noun,5,2,3,2.2230620456616944e-05,3.33207454961459e-05,0.6
15817,사촌형/Noun,5,3,2,3.3345930684925414e-05,2.2213830330763933e-05,0.6
15818,처사/Noun,5,2,3,2.2230620456616944e-05,3.33207454961459e-05,0.6
15819,죤/Noun,5,2,3,2.2230620456616944e-05,3.33207454961459e-05,0.6
15820,마눌/Noun,5,3,2,3.3345930684925414e-05,2.2213830330763933e-05,0.6
15821,쓸모/Noun,5,3,2,3.3345930684925414e-05,2.2213830330763933e-05,0.6
15822,명랑/Noun,5,2,3,2.2230620456616944e-05,3.33207454961459e-05,0.6
15823,진저/Noun,5,3,2,3.3345930684925414e-05,2.2213830330763933e-05,0.6
15824,매개/Noun,5,2,3,2.2230620456616944e-05,3.33207454961459e-05,0.6
15825,..^^;;/Punctuation,5,2,3,2.2230620456616944e-05,3.33207454961459e-05,0.6
15826,뉴문/Noun,5,3,2,3.3345930684925414e-05,2.2213830330763933e-05,0.6
15827,안락사/Noun,5,2,3,2.2230620456616944e-05,3.33207454961459e-05,0.6
15828,자객/Noun,5,2,3,2.2230620456616944e-05,3.33207454961459e-05,0.6
15829,재밌드/Noun,5,3,2,3.3345930684925414e-05,2.2213830330763933e-05,0.6
15830,고다/Noun,5,3,2,3.3345930684925414e-05,2.2213830330763933e-05,0.6
15831,여자라서/Noun,5,2,3,2.2230620456616944e-05,3.33207454961459e-05,0.6
15832,붙들다/Verb,5,3,2,3.3345930684925414e-05,2.2213830330763933e-05,0.6
15833,ㄲㄲㄲ/KoreanParticle,5,2,3,2.2230620456616944e-05,3.33207454961459e-05,0.6
15834,화산고/Noun,5,3,2,3.3345930684925414e-05,2.2213830330763933e-05,0.6
15835,콧대/Noun,5,2,3,2.2230620456616944e-05,3.33207454961459e-05,0.6
15836,욬/Noun,5,2,3,2.2230620456616944e-05,3.33207454961459e-05,0.6
15837,ㅡㅡㅋㅋ/KoreanParticle,5,2,3,2.2230620456616944e-05,3.33207454961459e-05,0.6
15838,방어/Noun,5,2,3,2.2230620456616944e-05,3.33207454961459e-05,0.6
15839,우회/Noun,5,3,2,3.3345930684925414e-05,2.2213830330763933e-05,0.6
15840,신카이/Noun,5,3,2,3.3345930684925414e-05,2.2213830330763933e-05,0.6
15841,브레이브/Noun,5,3,2,3.3345930684925414e-05,2.2213830330763933e-05,0.6
15842,달마/Noun,5,3,2,3.3345930684925414e-05,2.2213830330763933e-05,0.6
15843,브람스/Noun,5,2,3,2.2230620456616944e-05,3.33207454961459e-05,0.6
15844,음악감독/Noun,5,3,2,3.3345930684925414e-05,2.2213830330763933e-05,0.6
15845,관망/Noun,5,3,2,3.3345930684925414e-05,2.2213830330763933e-05,0.6
15846,꼬박/Noun,5,3,2,3.3345930684925414e-05,2.2213830330763933e-05,0.6
15847,가상현실/Noun,5,3,2,3.3345930684925414e-05,2.2213830330763933e-05,0.6
15848,버블/Noun,5,2,3,2.2230620456616944e-05,3.33207454961459e-05,0.6
15849,텐션/Noun,5,2,3,2.2230620456616944e-05,3.33207454961459e-05,0.6
15850,표적/Noun,5,3,2,3.3345930684925414e-05,2.2213830330763933e-05,0.6
15851,자태/Noun,5,2,3,2.2230620456616944e-05,3.33207454961459e-05,0.6
15852,베타/Noun,5,3,2,3.3345930684925414e-05,2.2213830330763933e-05,0.6
15853,리아/Noun,5,3,2,3.3345930684925414e-05,2.2213830330763933e-05,0.6
15854,이솜/Noun,5,3,2,3.3345930684925414e-05,2.2213830330763933e-05,0.6
15855,확연/Noun,5,2,3,2.2230620456616944e-05,3.33207454961459e-05,0.6
15856,의향/Noun,5,3,2,3.3345930684925414e-05,2.2213830330763933e-05,0.6
15857,파스텔/Noun,5,3,2,3.3345930684925414e-05,2.2213830330763933e-05,0.6
15858,재키/Noun,5,3,2,3.3345930684925414e-05,2.2213830330763933e-05,0.6
15859,16회/Number,5,3,2,3.3345930684925414e-05,2.2213830330763933e-05,0.6
15860,직무/Noun,5,3,2,3.3345930684925414e-05,2.2213830330763933e-05,0.6
15861,쫓아가다/Verb,5,2,3,2.2230620456616944e-05,3.33207454961459e-05,0.6
15862,400/Number,5,3,2,3.3345930684925414e-05,2.2213830330763933e-05,0.6
15863,세익스피어/Noun,5,3,2,3.3345930684925414e-05,2.2213830330763933e-05,0.6
15864,스몰빌/Noun,5,2,3,2.2230620456616944e-05,3.33207454961459e-05,0.6
15865,라피/Noun,5,2,3,2.2230620456616944e-05,3.33207454961459e-05,0.6
15866,생으로/Noun,5,2,3,2.2230620456616944e-05,3.33207454961459e-05,0.6
15867,실신/Noun,5,2,3,2.2230620456616944e-05,3.33207454961459e-05,0.6
15868,족속/Noun,5,3,2,3.3345930684925414e-05,2.2213830330763933e-05,0.6
15869,떡실신/Noun,5,2,3,2.2230620456616944e-05,3.33207454961459e-05,0.6
15870,듣보다/Verb,5,3,2,3.3345930684925414e-05,2.2213830330763933e-05,0.6
15871,라미/Noun,5,3,2,3.3345930684925414e-05,2.2213830330763933e-05,0.6
15872,허구성/Noun,5,2,3,2.2230620456616944e-05,3.33207454961459e-05,0.6
15873,성열/Noun,5,2,3,2.2230620456616944e-05,3.33207454961459e-05,0.6
15874,사심/Noun,5,3,2,3.3345930684925414e-05,2.2213830330763933e-05,0.6
15875,고심/Noun,5,3,2,3.3345930684925414e-05,2.2213830330763933e-05,0.6
15876,이웃사람/Noun,5,3,2,3.3345930684925414e-05,2.2213830330763933e-05,0.6
15877,퀵/Noun,5,2,3,2.2230620456616944e-05,3.33207454961459e-05,0.6
15878,자행/Noun,5,2,3,2.2230620456616944e-05,3.33207454961459e-05,0.6
15879,닌텐도/Noun,5,3,2,3.3345930684925414e-05,2.2213830330763933e-05,0.6
15880,유위/Noun,5,3,2,3.3345930684925414e-05,2.2213830330763933e-05,0.6
15881,국회/Noun,5,3,2,3.3345930684925414e-05,2.2213830330763933e-05,0.6
15882,마무/Noun,5,2,3,2.2230620456616944e-05,3.33207454961459e-05,0.6
15883,번쨰/Noun,5,2,3,2.2230620456616944e-05,3.33207454961459e-05,0.6
15884,애시/Noun,5,2,3,2.2230620456616944e-05,3.33207454961459e-05,0.6
15885,태연하다/Adjective,5,3,2,3.3345930684925414e-05,2.2213830330763933e-05,0.6
15886,112/Number,5,2,3,2.2230620456616944e-05,3.33207454961459e-05,0.6
15887,개재/Noun,5,2,3,2.2230620456616944e-05,3.33207454961459e-05,0.6
15888,총사/Noun,5,2,3,2.2230620456616944e-05,3.33207454961459e-05,0.6
15889,성미/Noun,5,3,2,3.3345930684925414e-05,2.2213830330763933e-05,0.6
15890,비버/Noun,5,2,3,2.2230620456616944e-05,3.33207454961459e-05,0.6
15891,JSA/Alpha,5,2,3,2.2230620456616944e-05,3.33207454961459e-05,0.6
15892,아즈미/Noun,5,2,3,2.2230620456616944e-05,3.33207454961459e-05,0.6
15893,포의/Noun,5,3,2,3.3345930684925414e-05,2.2213830330763933e-05,0.6
15894,크아/Noun,5,3,2,3.3345930684925414e-05,2.2213830330763933e-05,0.6
15895,몽둥이/Noun,5,3,2,3.3345930684925414e-05,2.2213830330763933e-05,0.6
15896,올가미/Noun,5,3,2,3.3345930684925414e-05,2.2213830330763933e-05,0.6
15897,대거/Noun,5,2,3,2.2230620456616944e-05,3.33207454961459e-05,0.6
15898,입도/Noun,5,2,3,2.2230620456616944e-05,3.33207454961459e-05,0.6
15899,침해/Noun,5,2,3,2.2230620456616944e-05,3.33207454961459e-05,0.6
15900,교전/Noun,5,3,2,3.3345930684925414e-05,2.2213830330763933e-05,0.6
15901,애송이/Noun,5,2,3,2.2230620456616944e-05,3.33207454961459e-05,0.6
15902,빌리버/Noun,5,3,2,3.3345930684925414e-05,2.2213830330763933e-05,0.6
15903,디스토피아/Noun,5,3,2,3.3345930684925414e-05,2.2213830330763933e-05,0.6
15904,말고도/Josa,5,3,2,3.3345930684925414e-05,2.2213830330763933e-05,0.6
15905,흉하다/Adjective,5,2,3,2.2230620456616944e-05,3.33207454961459e-05,0.6
15906,12회/Number,5,3,2,3.3345930684925414e-05,2.2213830330763933e-05,0.6
15907,껄끄럽/Noun,5,2,3,2.2230620456616944e-05,3.33207454961459e-05,0.6
15908,음음/Noun,5,3,2,3.3345930684925414e-05,2.2213830330763933e-05,0.6
15909,아서/Eomi,5,3,2,3.3345930684925414e-05,2.2213830330763933e-05,0.6
15910,브릿/Noun,5,3,2,3.3345930684925414e-05,2.2213830330763933e-05,0.6
15911,아웃사이더/Noun,5,3,2,3.3345930684925414e-05,2.2213830330763933e-05,0.6
15912,",.,,/Punctuation",5,3,2,3.3345930684925414e-05,2.2213830330763933e-05,0.6
15913,막막/Noun,5,2,3,2.2230620456616944e-05,3.33207454961459e-05,0.6
15914,풀어지다/Verb,5,3,2,3.3345930684925414e-05,2.2213830330763933e-05,0.6
15915,탈영/Noun,5,3,2,3.3345930684925414e-05,2.2213830330763933e-05,0.6
15916,발발/Noun,5,2,3,2.2230620456616944e-05,3.33207454961459e-05,0.6
15917,스페인어/Noun,5,3,2,3.3345930684925414e-05,2.2213830330763933e-05,0.6
15918,300만/Number,5,2,3,2.2230620456616944e-05,3.33207454961459e-05,0.6
15919,브로큰/Noun,5,3,2,3.3345930684925414e-05,2.2213830330763933e-05,0.6
15920,기아/Noun,5,2,3,2.2230620456616944e-05,3.33207454961459e-05,0.6
15921,소파/Noun,5,3,2,3.3345930684925414e-05,2.2213830330763933e-05,0.6
15922,볼케이노/Noun,5,2,3,2.2230620456616944e-05,3.33207454961459e-05,0.6
15923,나다니다/Verb,5,3,2,3.3345930684925414e-05,2.2213830330763933e-05,0.6
15924,패티/Noun,5,2,3,2.2230620456616944e-05,3.33207454961459e-05,0.6
15925,패왕별희/Noun,5,2,3,2.2230620456616944e-05,3.33207454961459e-05,0.6
15926,장의사/Noun,5,3,2,3.3345930684925414e-05,2.2213830330763933e-05,0.6
15927,홍대/Noun,5,2,3,2.2230620456616944e-05,3.33207454961459e-05,0.6
15928,수상하다/Adjective,5,2,3,2.2230620456616944e-05,3.33207454961459e-05,0.6
15929,중화권/Noun,5,3,2,3.3345930684925414e-05,2.2213830330763933e-05,0.6
15930,성립/Noun,5,2,3,2.2230620456616944e-05,3.33207454961459e-05,0.6
15931,더로드/Noun,5,3,2,3.3345930684925414e-05,2.2213830330763933e-05,0.6
15932,살포시/Noun,5,3,2,3.3345930684925414e-05,2.2213830330763933e-05,0.6
15933,동태/Noun,5,2,3,2.2230620456616944e-05,3.33207454961459e-05,0.6
15934,명랑하다/Adjective,5,3,2,3.3345930684925414e-05,2.2213830330763933e-05,0.6
15935,에게까지/Josa,5,2,3,2.2230620456616944e-05,3.33207454961459e-05,0.6
15936,시속/Noun,5,2,3,2.2230620456616944e-05,3.33207454961459e-05,0.6
15937,윤주/Noun,5,2,3,2.2230620456616944e-05,3.33207454961459e-05,0.6
15938,리메이크판/Noun,5,3,2,3.3345930684925414e-05,2.2213830330763933e-05,0.6
15939,진혜림/Noun,5,3,2,3.3345930684925414e-05,2.2213830330763933e-05,0.6
15940,가운/Noun,5,2,3,2.2230620456616944e-05,3.33207454961459e-05,0.6
15941,퍼트/Noun,5,2,3,2.2230620456616944e-05,3.33207454961459e-05,0.6
15942,키득거리다/Verb,5,3,2,3.3345930684925414e-05,2.2213830330763933e-05,0.6
15943,공모자/Noun,5,2,3,2.2230620456616944e-05,3.33207454961459e-05,0.6
15944,오지명/Noun,5,3,2,3.3345930684925414e-05,2.2213830330763933e-05,0.6
15945,29일/Number,5,2,3,2.2230620456616944e-05,3.33207454961459e-05,0.6
15946,소탕/Noun,5,3,2,3.3345930684925414e-05,2.2213830330763933e-05,0.6
15947,윤회/Noun,5,3,2,3.3345930684925414e-05,2.2213830330763933e-05,0.6
15948,AM/Alpha,5,3,2,3.3345930684925414e-05,2.2213830330763933e-05,0.6
15949,어떠케/Noun,5,2,3,2.2230620456616944e-05,3.33207454961459e-05,0.6
15950,순화/Noun,5,3,2,3.3345930684925414e-05,2.2213830330763933e-05,0.6
15951,징계/Noun,5,2,3,2.2230620456616944e-05,3.33207454961459e-05,0.6
15952,((/Punctuation,5,3,2,3.3345930684925414e-05,2.2213830330763933e-05,0.6
15953,항복/Noun,5,3,2,3.3345930684925414e-05,2.2213830330763933e-05,0.6
15954,바이크/Noun,5,2,3,2.2230620456616944e-05,3.33207454961459e-05,0.6
15955,명계남/Noun,5,2,3,2.2230620456616944e-05,3.33207454961459e-05,0.6
15956,필살기/Noun,5,3,2,3.3345930684925414e-05,2.2213830330763933e-05,0.6
15957,나혼자산다/Noun,5,3,2,3.3345930684925414e-05,2.2213830330763933e-05,0.6
15958,내쉬다/Verb,5,3,2,3.3345930684925414e-05,2.2213830330763933e-05,0.6
15959,워렌/Noun,5,2,3,2.2230620456616944e-05,3.33207454961459e-05,0.6
15960,볶다/Verb,5,2,3,2.2230620456616944e-05,3.33207454961459e-05,0.6
15961,이종격투기/Noun,5,2,3,2.2230620456616944e-05,3.33207454961459e-05,0.6
15962,친엄마/Noun,5,2,3,2.2230620456616944e-05,3.33207454961459e-05,0.6
15963,부터라도/Josa,5,3,2,3.3345930684925414e-05,2.2213830330763933e-05,0.6
15964,김풍/Noun,5,2,3,2.2230620456616944e-05,3.33207454961459e-05,0.6
15965,기시감/Noun,5,2,3,2.2230620456616944e-05,3.33207454961459e-05,0.6
15966,나본/Noun,5,3,2,3.3345930684925414e-05,2.2213830330763933e-05,0.6
15967,일맥상통/Noun,5,3,2,3.3345930684925414e-05,2.2213830330763933e-05,0.6
15968,06년/Number,5,3,2,3.3345930684925414e-05,2.2213830330763933e-05,0.6
15969,괸/Noun,5,3,2,3.3345930684925414e-05,2.2213830330763933e-05,0.6
15970,홍련/Noun,5,3,2,3.3345930684925414e-05,2.2213830330763933e-05,0.6
15971,사후/Noun,5,2,3,2.2230620456616944e-05,3.33207454961459e-05,0.6
15972,어쩃/Noun,5,2,3,2.2230620456616944e-05,3.33207454961459e-05,0.6
15973,글쓰기/Noun,5,2,3,2.2230620456616944e-05,3.33207454961459e-05,0.6
15974,몸짱/Noun,5,3,2,3.3345930684925414e-05,2.2213830330763933e-05,0.6
15975,은기/Noun,5,3,2,3.3345930684925414e-05,2.2213830330763933e-05,0.6
15976,곡괭이/Noun,5,2,3,2.2230620456616944e-05,3.33207454961459e-05,0.6
15977,트랜스포터/Noun,5,3,2,3.3345930684925414e-05,2.2213830330763933e-05,0.6
15978,반신반의/Noun,5,3,2,3.3345930684925414e-05,2.2213830330763933e-05,0.6
15979,기레기/Noun,5,2,3,2.2230620456616944e-05,3.33207454961459e-05,0.6
15980,people/Alpha,5,3,2,3.3345930684925414e-05,2.2213830330763933e-05,0.6
15981,곽도원/Noun,5,2,3,2.2230620456616944e-05,3.33207454961459e-05,0.6
15982,팩토리/Noun,5,2,3,2.2230620456616944e-05,3.33207454961459e-05,0.6
15983,바질/Noun,5,2,3,2.2230620456616944e-05,3.33207454961459e-05,0.6
15984,앞날/Noun,5,3,2,3.3345930684925414e-05,2.2213830330763933e-05,0.6
15985,차이나타운/Noun,5,2,3,2.2230620456616944e-05,3.33207454961459e-05,0.6
15986,as/Alpha,5,3,2,3.3345930684925414e-05,2.2213830330763933e-05,0.6
15987,람다/Noun,5,2,3,2.2230620456616944e-05,3.33207454961459e-05,0.6
15988,합체/Noun,5,2,3,2.2230620456616944e-05,3.33207454961459e-05,0.6
15989,귀로/Noun,5,3,2,3.3345930684925414e-05,2.2213830330763933e-05,0.6
15990,베로니카/Noun,5,3,2,3.3345930684925414e-05,2.2213830330763933e-05,0.6
15991,간질간질/Adverb,5,3,2,3.3345930684925414e-05,2.2213830330763933e-05,0.6
15992,서현/Noun,5,2,3,2.2230620456616944e-05,3.33207454961459e-05,0.6
15993,샤워씬/Noun,5,2,3,2.2230620456616944e-05,3.33207454961459e-05,0.6
15994,지우개/Noun,5,3,2,3.3345930684925414e-05,2.2213830330763933e-05,0.6
15995,뚜/Noun,5,3,2,3.3345930684925414e-05,2.2213830330763933e-05,0.6
15996,걸어오다/Verb,5,3,2,3.3345930684925414e-05,2.2213830330763933e-05,0.6
15997,해리스/Noun,5,3,2,3.3345930684925414e-05,2.2213830330763933e-05,0.6
15998,쿼터/Noun,5,2,3,2.2230620456616944e-05,3.33207454961459e-05,0.6
15999,사내/Noun,5,2,3,2.2230620456616944e-05,3.33207454961459e-05,0.6
16000,속임수/Noun,5,2,3,2.2230620456616944e-05,3.33207454961459e-05,0.6
16001,애플/Noun,5,3,2,3.3345930684925414e-05,2.2213830330763933e-05,0.6
16002,율동/Noun,5,2,3,2.2230620456616944e-05,3.33207454961459e-05,0.6
16003,로군요/Josa,5,3,2,3.3345930684925414e-05,2.2213830330763933e-05,0.6
16004,다이버전트/Noun,5,2,3,2.2230620456616944e-05,3.33207454961459e-05,0.6
16005,리신/Noun,5,2,3,2.2230620456616944e-05,3.33207454961459e-05,0.6
16006,하류인생/Noun,5,2,3,2.2230620456616944e-05,3.33207454961459e-05,0.6
16007,병적/Noun,5,2,3,2.2230620456616944e-05,3.33207454961459e-05,0.6
16008,석유/Noun,5,3,2,3.3345930684925414e-05,2.2213830330763933e-05,0.6
16009,벤츠/Noun,5,2,3,2.2230620456616944e-05,3.33207454961459e-05,0.6
16010,ㄷㅏ/KoreanParticle,5,2,3,2.2230620456616944e-05,3.33207454961459e-05,0.6
16011,분동/Noun,5,2,3,2.2230620456616944e-05,3.33207454961459e-05,0.6
16012,밀크/Noun,5,3,2,3.3345930684925414e-05,2.2213830330763933e-05,0.6
16013,김밥/Noun,5,2,3,2.2230620456616944e-05,3.33207454961459e-05,0.6
16014,또보/Noun,5,3,2,3.3345930684925414e-05,2.2213830330763933e-05,0.6
16015,휘트니/Noun,5,3,2,3.3345930684925414e-05,2.2213830330763933e-05,0.6
16016,살찐/Noun,5,2,3,2.2230620456616944e-05,3.33207454961459e-05,0.6
16017,진희경/Noun,5,2,3,2.2230620456616944e-05,3.33207454961459e-05,0.6
16018,저지/Noun,5,3,2,3.3345930684925414e-05,2.2213830330763933e-05,0.6
16019,베컴/Noun,5,2,3,2.2230620456616944e-05,3.33207454961459e-05,0.6
16020,터리/Noun,5,2,3,2.2230620456616944e-05,3.33207454961459e-05,0.6
16021,셀러/Noun,5,2,3,2.2230620456616944e-05,3.33207454961459e-05,0.6
16022,대출/Noun,5,2,3,2.2230620456616944e-05,3.33207454961459e-05,0.6
16023,렉스/Noun,5,2,3,2.2230620456616944e-05,3.33207454961459e-05,0.6
16024,중고/Noun,5,3,2,3.3345930684925414e-05,2.2213830330763933e-05,0.6
16025,호범/Noun,5,2,3,2.2230620456616944e-05,3.33207454961459e-05,0.6
16026,송두리째/Noun,5,3,2,3.3345930684925414e-05,2.2213830330763933e-05,0.6
16027,스마일리/Noun,5,3,2,3.3345930684925414e-05,2.2213830330763933e-05,0.6
16028,OMG/Alpha,5,2,3,2.2230620456616944e-05,3.33207454961459e-05,0.6
16029,햇으/Noun,5,2,3,2.2230620456616944e-05,3.33207454961459e-05,0.6
16030,만큼이라도/Josa,5,3,2,3.3345930684925414e-05,2.2213830330763933e-05,0.6
16031,혈투/Noun,5,2,3,2.2230620456616944e-05,3.33207454961459e-05,0.6
16032,곤란/Noun,5,2,3,2.2230620456616944e-05,3.33207454961459e-05,0.6
16033,호야/Noun,5,3,2,3.3345930684925414e-05,2.2213830330763933e-05,0.6
16034,로튼토마토/Noun,5,3,2,3.3345930684925414e-05,2.2213830330763933e-05,0.6
16035,관료/Noun,5,3,2,3.3345930684925414e-05,2.2213830330763933e-05,0.6
16036,스위스/Noun,5,3,2,3.3345930684925414e-05,2.2213830330763933e-05,0.6
16037,업계/Noun,5,2,3,2.2230620456616944e-05,3.33207454961459e-05,0.6
16038,요일/Noun,5,2,3,2.2230620456616944e-05,3.33207454961459e-05,0.6
16039,기미/Noun,5,3,2,3.3345930684925414e-05,2.2213830330763933e-05,0.6
16040,새엄마/Noun,5,3,2,3.3345930684925414e-05,2.2213830330763933e-05,0.6
16041,깃발/Noun,5,3,2,3.3345930684925414e-05,2.2213830330763933e-05,0.6
16042,기숙사/Noun,5,3,2,3.3345930684925414e-05,2.2213830330763933e-05,0.6
16043,닥치/Noun,5,3,2,3.3345930684925414e-05,2.2213830330763933e-05,0.6
16044,루머/Noun,5,3,2,3.3345930684925414e-05,2.2213830330763933e-05,0.6
16045,골격/Noun,5,2,3,2.2230620456616944e-05,3.33207454961459e-05,0.6
16046,주의보/Noun,5,3,2,3.3345930684925414e-05,2.2213830330763933e-05,0.6
16047,거제도/Noun,5,2,3,2.2230620456616944e-05,3.33207454961459e-05,0.6
16048,1977년/Number,5,3,2,3.3345930684925414e-05,2.2213830330763933e-05,0.6
16049,유실/Noun,5,2,3,2.2230620456616944e-05,3.33207454961459e-05,0.6
16050,어빠/Noun,5,3,2,3.3345930684925414e-05,2.2213830330763933e-05,0.6
16051,지안/Noun,5,3,2,3.3345930684925414e-05,2.2213830330763933e-05,0.6
16052,갑부/Noun,5,2,3,2.2230620456616944e-05,3.33207454961459e-05,0.6
16053,쉐/Noun,5,3,2,3.3345930684925414e-05,2.2213830330763933e-05,0.6
16054,유란/Noun,5,2,3,2.2230620456616944e-05,3.33207454961459e-05,0.6
16055,우도/Noun,5,3,2,3.3345930684925414e-05,2.2213830330763933e-05,0.6
16056,트론/Noun,5,2,3,2.2230620456616944e-05,3.33207454961459e-05,0.6
16057,질퍽/Noun,5,3,2,3.3345930684925414e-05,2.2213830330763933e-05,0.6
16058,2011/Number,5,2,3,2.2230620456616944e-05,3.33207454961459e-05,0.6
16059,함몰/Noun,5,2,3,2.2230620456616944e-05,3.33207454961459e-05,0.6
16060,플래시/Noun,5,3,2,3.3345930684925414e-05,2.2213830330763933e-05,0.6
16061,8.88/Number,5,3,2,3.3345930684925414e-05,2.2213830330763933e-05,0.6
16062,윤설희/Noun,5,3,2,3.3345930684925414e-05,2.2213830330763933e-05,0.6
16063,비수/Noun,5,2,3,2.2230620456616944e-05,3.33207454961459e-05,0.6
16064,사형제/Noun,5,3,2,3.3345930684925414e-05,2.2213830330763933e-05,0.6
16065,태조/Noun,5,3,2,3.3345930684925414e-05,2.2213830330763933e-05,0.6
16066,투명하다/Adjective,5,3,2,3.3345930684925414e-05,2.2213830330763933e-05,0.6
16067,캐치온/Noun,5,2,3,2.2230620456616944e-05,3.33207454961459e-05,0.6
16068,청소부/Noun,5,2,3,2.2230620456616944e-05,3.33207454961459e-05,0.6
16069,성병/Noun,5,2,3,2.2230620456616944e-05,3.33207454961459e-05,0.6
16070,주안/Noun,5,3,2,3.3345930684925414e-05,2.2213830330763933e-05,0.6
16071,순영/Noun,5,3,2,3.3345930684925414e-05,2.2213830330763933e-05,0.6
16072,바라냐/Noun,5,3,2,3.3345930684925414e-05,2.2213830330763933e-05,0.6
16073,그리기/Noun,5,3,2,3.3345930684925414e-05,2.2213830330763933e-05,0.6
16074,공해/Noun,5,2,3,2.2230620456616944e-05,3.33207454961459e-05,0.6
16075,2.3/Number,5,2,3,2.2230620456616944e-05,3.33207454961459e-05,0.6
16076,심정은/Noun,5,2,3,2.2230620456616944e-05,3.33207454961459e-05,0.6
16077,프로보/Noun,5,2,3,2.2230620456616944e-05,3.33207454961459e-05,0.6
16078,철인/Noun,5,2,3,2.2230620456616944e-05,3.33207454961459e-05,0.6
16079,연가/Noun,5,3,2,3.3345930684925414e-05,2.2213830330763933e-05,0.6
16080,요절/Noun,5,3,2,3.3345930684925414e-05,2.2213830330763933e-05,0.6
16081,간질/Noun,5,2,3,2.2230620456616944e-05,3.33207454961459e-05,0.6
16082,bbc/Alpha,5,2,3,2.2230620456616944e-05,3.33207454961459e-05,0.6
16083,회차/Noun,5,3,2,3.3345930684925414e-05,2.2213830330763933e-05,0.6
16084,머무르다/Verb,5,3,2,3.3345930684925414e-05,2.2213830330763933e-05,0.6
16085,자존감/Noun,5,3,2,3.3345930684925414e-05,2.2213830330763933e-05,0.6
16086,짬/Noun,5,3,2,3.3345930684925414e-05,2.2213830330763933e-05,0.6
16087,저승사자/Noun,5,3,2,3.3345930684925414e-05,2.2213830330763933e-05,0.6
16088,최정원/Noun,5,3,2,3.3345930684925414e-05,2.2213830330763933e-05,0.6
16089,신건/Noun,5,2,3,2.2230620456616944e-05,3.33207454961459e-05,0.6
16090,피에타/Noun,5,3,2,3.3345930684925414e-05,2.2213830330763933e-05,0.6
16091,빠따/Noun,5,2,3,2.2230620456616944e-05,3.33207454961459e-05,0.6
16092,다고/Eomi,5,2,3,2.2230620456616944e-05,3.33207454961459e-05,0.6
16093,작곡가/Noun,5,2,3,2.2230620456616944e-05,3.33207454961459e-05,0.6
16094,체력/Noun,5,2,3,2.2230620456616944e-05,3.33207454961459e-05,0.6
16095,괜춘함/Noun,5,3,2,3.3345930684925414e-05,2.2213830330763933e-05,0.6
16096,유형/Noun,5,2,3,2.2230620456616944e-05,3.33207454961459e-05,0.6
16097,후세인/Noun,5,3,2,3.3345930684925414e-05,2.2213830330763933e-05,0.6
16098,흉터/Noun,5,3,2,3.3345930684925414e-05,2.2213830330763933e-05,0.6
16099,셨/Noun,5,2,3,2.2230620456616944e-05,3.33207454961459e-05,0.6
16100,스포츠카/Noun,5,2,3,2.2230620456616944e-05,3.33207454961459e-05,0.6
16101,보이즈/Noun,5,3,2,3.3345930684925414e-05,2.2213830330763933e-05,0.6
16102,유니버셜/Noun,5,2,3,2.2230620456616944e-05,3.33207454961459e-05,0.6
16103,류담/Noun,5,3,2,3.3345930684925414e-05,2.2213830330763933e-05,0.6
16104,악의축/Noun,5,3,2,3.3345930684925414e-05,2.2213830330763933e-05,0.6
16105,커밍아웃/Noun,5,2,3,2.2230620456616944e-05,3.33207454961459e-05,0.6
16106,매듭/Noun,5,2,3,2.2230620456616944e-05,3.33207454961459e-05,0.6
16107,2억/Number,5,2,3,2.2230620456616944e-05,3.33207454961459e-05,0.6
16108,언터쳐블/Noun,5,3,2,3.3345930684925414e-05,2.2213830330763933e-05,0.6
16109,라인업/Noun,5,2,3,2.2230620456616944e-05,3.33207454961459e-05,0.6
16110,능글맞다/Adjective,5,2,3,2.2230620456616944e-05,3.33207454961459e-05,0.6
16111,평등/Noun,5,3,2,3.3345930684925414e-05,2.2213830330763933e-05,0.6
16112,알량하다/Adjective,5,2,3,2.2230620456616944e-05,3.33207454961459e-05,0.6
16113,원랜/Noun,5,3,2,3.3345930684925414e-05,2.2213830330763933e-05,0.6
16114,헤이글/Noun,5,2,3,2.2230620456616944e-05,3.33207454961459e-05,0.6
16115,~)/Punctuation,5,3,2,3.3345930684925414e-05,2.2213830330763933e-05,0.6
16116,쭈/Noun,5,3,2,3.3345930684925414e-05,2.2213830330763933e-05,0.6
16117,집주인/Noun,5,3,2,3.3345930684925414e-05,2.2213830330763933e-05,0.6
16118,....!!!/Punctuation,5,3,2,3.3345930684925414e-05,2.2213830330763933e-05,0.6
16119,떡하니/Adverb,5,2,3,2.2230620456616944e-05,3.33207454961459e-05,0.6
16120,주니/Noun,5,3,2,3.3345930684925414e-05,2.2213830330763933e-05,0.6
16121,너구리/Noun,5,3,2,3.3345930684925414e-05,2.2213830330763933e-05,0.6
16122,마운틴/Noun,5,3,2,3.3345930684925414e-05,2.2213830330763933e-05,0.6
16123,온도/Noun,5,2,3,2.2230620456616944e-05,3.33207454961459e-05,0.6
16124,강압/Noun,5,3,2,3.3345930684925414e-05,2.2213830330763933e-05,0.6
16125,피칠갑/Noun,5,3,2,3.3345930684925414e-05,2.2213830330763933e-05,0.6
16126,환생하다/Adjective,5,3,2,3.3345930684925414e-05,2.2213830330763933e-05,0.6
16127,환생/Noun,5,3,2,3.3345930684925414e-05,2.2213830330763933e-05,0.6
16128,자음/Noun,5,2,3,2.2230620456616944e-05,3.33207454961459e-05,0.6
16129,소행/Noun,5,2,3,2.2230620456616944e-05,3.33207454961459e-05,0.6
16130,정아/Noun,5,2,3,2.2230620456616944e-05,3.33207454961459e-05,0.6
16131,네덜란드/Noun,5,2,3,2.2230620456616944e-05,3.33207454961459e-05,0.6
16132,놀림/Noun,5,3,2,3.3345930684925414e-05,2.2213830330763933e-05,0.6
16133,자루/Noun,5,2,3,2.2230620456616944e-05,3.33207454961459e-05,0.6
16134,밑바탕/Noun,5,2,3,2.2230620456616944e-05,3.33207454961459e-05,0.6
16135,복종/Noun,5,3,2,3.3345930684925414e-05,2.2213830330763933e-05,0.6
16136,후잡/Noun,5,3,2,3.3345930684925414e-05,2.2213830330763933e-05,0.6
16137,친절/Noun,5,2,3,2.2230620456616944e-05,3.33207454961459e-05,0.6
16138,천/Suffix,5,2,3,2.2230620456616944e-05,3.33207454961459e-05,0.6
16139,낮술/Noun,5,2,3,2.2230620456616944e-05,3.33207454961459e-05,0.6
16140,백도빈/Noun,5,2,3,2.2230620456616944e-05,3.33207454961459e-05,0.6
16141,고아원/Noun,5,3,2,3.3345930684925414e-05,2.2213830330763933e-05,0.6
16142,파파/Noun,5,2,3,2.2230620456616944e-05,3.33207454961459e-05,0.6
16143,언능/Adverb,5,2,3,2.2230620456616944e-05,3.33207454961459e-05,0.6
16144,조리/Noun,5,3,2,3.3345930684925414e-05,2.2213830330763933e-05,0.6
16145,코마/Noun,5,3,2,3.3345930684925414e-05,2.2213830330763933e-05,0.6
16146,건전/Noun,5,3,2,3.3345930684925414e-05,2.2213830330763933e-05,0.6
16147,산맥/Noun,5,2,3,2.2230620456616944e-05,3.33207454961459e-05,0.6
16148,케르디오/Noun,5,2,3,2.2230620456616944e-05,3.33207454961459e-05,0.6
16149,이희준/Noun,5,3,2,3.3345930684925414e-05,2.2213830330763933e-05,0.6
16150,장갑/Noun,5,2,3,2.2230620456616944e-05,3.33207454961459e-05,0.6
16151,햄/Noun,5,3,2,3.3345930684925414e-05,2.2213830330763933e-05,0.6
16152,작아지다/Verb,5,2,3,2.2230620456616944e-05,3.33207454961459e-05,0.6
16153,심청전/Noun,5,2,3,2.2230620456616944e-05,3.33207454961459e-05,0.6
16154,막장인생/Noun,5,2,3,2.2230620456616944e-05,3.33207454961459e-05,0.6
16155,가위바위보/Noun,5,2,3,2.2230620456616944e-05,3.33207454961459e-05,0.6
16156,"!,/Punctuation",5,3,2,3.3345930684925414e-05,2.2213830330763933e-05,0.6
16157,주머니/Noun,5,2,3,2.2230620456616944e-05,3.33207454961459e-05,0.6
16158,어캐/Noun,5,2,3,2.2230620456616944e-05,3.33207454961459e-05,0.6
16159,~.../Punctuation,5,2,3,2.2230620456616944e-05,3.33207454961459e-05,0.6
16160,봉지/Noun,5,3,2,3.3345930684925414e-05,2.2213830330763933e-05,0.6
16161,막부/Noun,5,3,2,3.3345930684925414e-05,2.2213830330763933e-05,0.6
16162,불효자/Noun,5,2,3,2.2230620456616944e-05,3.33207454961459e-05,0.6
16163,양복/Noun,5,2,3,2.2230620456616944e-05,3.33207454961459e-05,0.6
16164,그랫/Noun,5,3,2,3.3345930684925414e-05,2.2213830330763933e-05,0.6
16165,농간/Noun,5,2,3,2.2230620456616944e-05,3.33207454961459e-05,0.6
16166,다봣는데/Noun,5,3,2,3.3345930684925414e-05,2.2213830330763933e-05,0.6
16167,레디에이터/Noun,5,2,3,2.2230620456616944e-05,3.33207454961459e-05,0.6
16168,미호/Noun,5,3,2,3.3345930684925414e-05,2.2213830330763933e-05,0.6
16169,대수/Noun,5,3,2,3.3345930684925414e-05,2.2213830330763933e-05,0.6
16170,자유의지/Noun,5,3,2,3.3345930684925414e-05,2.2213830330763933e-05,0.6
16171,케이츠/Noun,5,3,2,3.3345930684925414e-05,2.2213830330763933e-05,0.6
16172,한재석/Noun,5,3,2,3.3345930684925414e-05,2.2213830330763933e-05,0.6
16173,선방/Noun,5,3,2,3.3345930684925414e-05,2.2213830330763933e-05,0.6
16174,제의/Noun,5,3,2,3.3345930684925414e-05,2.2213830330763933e-05,0.6
16175,항의/Noun,5,2,3,2.2230620456616944e-05,3.33207454961459e-05,0.6
16176,)//Punctuation,5,2,3,2.2230620456616944e-05,3.33207454961459e-05,0.6
16177,면암/Noun,5,2,3,2.2230620456616944e-05,3.33207454961459e-05,0.6
16178,데어데블/Noun,5,2,3,2.2230620456616944e-05,3.33207454961459e-05,0.6
16179,........................./Punctuation,5,2,3,2.2230620456616944e-05,3.33207454961459e-05,0.6
16180,살피다/Verb,5,2,3,2.2230620456616944e-05,3.33207454961459e-05,0.6
16181,이주일/Noun,5,3,2,3.3345930684925414e-05,2.2213830330763933e-05,0.6
16182,미터/Noun,5,2,3,2.2230620456616944e-05,3.33207454961459e-05,0.6
16183,정복자/Noun,5,2,3,2.2230620456616944e-05,3.33207454961459e-05,0.6
16184,백악관/Noun,5,2,3,2.2230620456616944e-05,3.33207454961459e-05,0.6
16185,속사정/Noun,5,2,3,2.2230620456616944e-05,3.33207454961459e-05,0.6
16186,와아/Exclamation,5,3,2,3.3345930684925414e-05,2.2213830330763933e-05,0.6
16187,걷기/Noun,5,3,2,3.3345930684925414e-05,2.2213830330763933e-05,0.6
16188,보강/Noun,5,3,2,3.3345930684925414e-05,2.2213830330763933e-05,0.6
16189,순대/Noun,5,3,2,3.3345930684925414e-05,2.2213830330763933e-05,0.6
16190,아주머니/Noun,5,2,3,2.2230620456616944e-05,3.33207454961459e-05,0.6
16191,한화/Noun,5,3,2,3.3345930684925414e-05,2.2213830330763933e-05,0.6
16192,지아이조/Noun,5,2,3,2.2230620456616944e-05,3.33207454961459e-05,0.6
16193,닌자어쌔신/Noun,5,2,3,2.2230620456616944e-05,3.33207454961459e-05,0.6
16194,리썰웨폰/Noun,5,2,3,2.2230620456616944e-05,3.33207454961459e-05,0.6
16195,유학생/Noun,5,3,2,3.3345930684925414e-05,2.2213830330763933e-05,0.6
16196,여요/Noun,5,2,3,2.2230620456616944e-05,3.33207454961459e-05,0.6
16197,비상구/Noun,5,3,2,3.3345930684925414e-05,2.2213830330763933e-05,0.6
16198,호타루/Noun,5,2,3,2.2230620456616944e-05,3.33207454961459e-05,0.6
16199,데포/Noun,5,2,3,2.2230620456616944e-05,3.33207454961459e-05,0.6
16200,정크푸드/Noun,5,3,2,3.3345930684925414e-05,2.2213830330763933e-05,0.6
16201,PC/Alpha,5,2,3,2.2230620456616944e-05,3.33207454961459e-05,0.6
16202,알반/Noun,5,3,2,3.3345930684925414e-05,2.2213830330763933e-05,0.6
16203,열심/Noun,5,2,3,2.2230620456616944e-05,3.33207454961459e-05,0.6
16204,아구/Noun,5,3,2,3.3345930684925414e-05,2.2213830330763933e-05,0.6
16205,다방/Noun,5,2,3,2.2230620456616944e-05,3.33207454961459e-05,0.6
16206,보가/Noun,5,3,2,3.3345930684925414e-05,2.2213830330763933e-05,0.6
16207,주보/Noun,5,3,2,3.3345930684925414e-05,2.2213830330763933e-05,0.6
16208,학벌/Noun,5,2,3,2.2230620456616944e-05,3.33207454961459e-05,0.6
16209,해갈/Noun,5,3,2,3.3345930684925414e-05,2.2213830330763933e-05,0.6
16210,드림팀/Noun,5,2,3,2.2230620456616944e-05,3.33207454961459e-05,0.6
16211,갖/Noun,5,2,3,2.2230620456616944e-05,3.33207454961459e-05,0.6
16212,~../Punctuation,5,2,3,2.2230620456616944e-05,3.33207454961459e-05,0.6
16213,구실/Noun,5,3,2,3.3345930684925414e-05,2.2213830330763933e-05,0.6
16214,폭포/Noun,5,2,3,2.2230620456616944e-05,3.33207454961459e-05,0.6
16215,리베라/Noun,5,3,2,3.3345930684925414e-05,2.2213830330763933e-05,0.6
16216,sorry/Alpha,5,2,3,2.2230620456616944e-05,3.33207454961459e-05,0.6
16217,박탈/Noun,5,3,2,3.3345930684925414e-05,2.2213830330763933e-05,0.6
16218,랜덤/Noun,5,3,2,3.3345930684925414e-05,2.2213830330763933e-05,0.6
16219,".,.../Punctuation",5,2,3,2.2230620456616944e-05,3.33207454961459e-05,0.6
16220,스풀/Noun,5,3,2,3.3345930684925414e-05,2.2213830330763933e-05,0.6
16221,다사/Noun,5,2,3,2.2230620456616944e-05,3.33207454961459e-05,0.6
16222,다마/Noun,5,3,2,3.3345930684925414e-05,2.2213830330763933e-05,0.6
16223,에이브/Noun,5,2,3,2.2230620456616944e-05,3.33207454961459e-05,0.6
16224,새드/Noun,5,2,3,2.2230620456616944e-05,3.33207454961459e-05,0.6
16225,이지은/Noun,5,3,2,3.3345930684925414e-05,2.2213830330763933e-05,0.6
16226,1994/Number,5,3,2,3.3345930684925414e-05,2.2213830330763933e-05,0.6
16227,어젯밤/Noun,5,2,3,2.2230620456616944e-05,3.33207454961459e-05,0.6
16228,줄때/Noun,5,3,2,3.3345930684925414e-05,2.2213830330763933e-05,0.6
16229,시행/Noun,5,3,2,3.3345930684925414e-05,2.2213830330763933e-05,0.6
16230,우하하하/Noun,5,2,3,2.2230620456616944e-05,3.33207454961459e-05,0.6
16231,실생활/Noun,5,3,2,3.3345930684925414e-05,2.2213830330763933e-05,0.6
16232,검도/Noun,5,2,3,2.2230620456616944e-05,3.33207454961459e-05,0.6
16233,딸기/Noun,5,3,2,3.3345930684925414e-05,2.2213830330763933e-05,0.6
16234,딥/Noun,5,3,2,3.3345930684925414e-05,2.2213830330763933e-05,0.6
16235,페리/Noun,5,2,3,2.2230620456616944e-05,3.33207454961459e-05,0.6
16236,덩치/Noun,5,3,2,3.3345930684925414e-05,2.2213830330763933e-05,0.6
16237,부귀/Noun,5,3,2,3.3345930684925414e-05,2.2213830330763933e-05,0.6
16238,블랙스완/Noun,5,2,3,2.2230620456616944e-05,3.33207454961459e-05,0.6
16239,ㅇㅅ/KoreanParticle,5,2,3,2.2230620456616944e-05,3.33207454961459e-05,0.6
16240,인베이젼/Noun,5,2,3,2.2230620456616944e-05,3.33207454961459e-05,0.6
16241,비보잉/Noun,5,2,3,2.2230620456616944e-05,3.33207454961459e-05,0.6
16242,유쾌하/Noun,5,3,2,3.3345930684925414e-05,2.2213830330763933e-05,0.6
16243,1234/Number,5,2,3,2.2230620456616944e-05,3.33207454961459e-05,0.6
16244,라니깐/Josa,5,3,2,3.3345930684925414e-05,2.2213830330763933e-05,0.6
16245,살로/Noun,5,2,3,2.2230620456616944e-05,3.33207454961459e-05,0.6
16246,누비/Noun,5,3,2,3.3345930684925414e-05,2.2213830330763933e-05,0.6
16247,굴리/Noun,5,2,3,2.2230620456616944e-05,3.33207454961459e-05,0.6
16248,ㅤ/Foreign,5,2,3,2.2230620456616944e-05,3.33207454961459e-05,0.6
16249,사파리/Noun,5,2,3,2.2230620456616944e-05,3.33207454961459e-05,0.6
16250,36/Number,5,3,2,3.3345930684925414e-05,2.2213830330763933e-05,0.6
16251,한복/Noun,5,2,3,2.2230620456616944e-05,3.33207454961459e-05,0.6
16252,콤보/Noun,5,2,3,2.2230620456616944e-05,3.33207454961459e-05,0.6
16253,에라곤/Noun,5,3,2,3.3345930684925414e-05,2.2213830330763933e-05,0.6
16254,리노/Noun,5,3,2,3.3345930684925414e-05,2.2213830330763933e-05,0.6
16255,코프/Noun,5,3,2,3.3345930684925414e-05,2.2213830330763933e-05,0.6
16256,mother/Alpha,5,3,2,3.3345930684925414e-05,2.2213830330763933e-05,0.6
16257,눈꺼풀/Noun,5,2,3,2.2230620456616944e-05,3.33207454961459e-05,0.6
16258,젤위/Noun,5,3,2,3.3345930684925414e-05,2.2213830330763933e-05,0.6
16259,돔/Noun,5,3,2,3.3345930684925414e-05,2.2213830330763933e-05,0.6
16260,연습생/Noun,5,2,3,2.2230620456616944e-05,3.33207454961459e-05,0.6
16261,킬림/Noun,5,3,2,3.3345930684925414e-05,2.2213830330763933e-05,0.6
16262,고아성/Noun,5,2,3,2.2230620456616944e-05,3.33207454961459e-05,0.6
16263,Mr/Alpha,5,2,3,2.2230620456616944e-05,3.33207454961459e-05,0.6
16264,프라이/Noun,5,2,3,2.2230620456616944e-05,3.33207454961459e-05,0.6
16265,어쨌거/Noun,5,2,3,2.2230620456616944e-05,3.33207454961459e-05,0.6
16266,아폴로/Noun,5,3,2,3.3345930684925414e-05,2.2213830330763933e-05,0.6
16267,닫히다/Verb,5,2,3,2.2230620456616944e-05,3.33207454961459e-05,0.6
16268,이북/Noun,5,3,2,3.3345930684925414e-05,2.2213830330763933e-05,0.6
16269,변장/Noun,5,2,3,2.2230620456616944e-05,3.33207454961459e-05,0.6
16270,욘사마/Noun,5,2,3,2.2230620456616944e-05,3.33207454961459e-05,0.6
16271,서윤/Noun,5,2,3,2.2230620456616944e-05,3.33207454961459e-05,0.6
16272,까불지마/Noun,5,3,2,3.3345930684925414e-05,2.2213830330763933e-05,0.6
16273,21일/Number,5,3,2,3.3345930684925414e-05,2.2213830330763933e-05,0.6
16274,이노/Noun,5,2,3,2.2230620456616944e-05,3.33207454961459e-05,0.6
16275,발해/Noun,5,2,3,2.2230620456616944e-05,3.33207454961459e-05,0.6
16276,필립스/Noun,5,3,2,3.3345930684925414e-05,2.2213830330763933e-05,0.6
16277,어비스/Noun,5,2,3,2.2230620456616944e-05,3.33207454961459e-05,0.6
16278,동사서독/Noun,5,3,2,3.3345930684925414e-05,2.2213830330763933e-05,0.6
16279,usb/Alpha,5,2,3,2.2230620456616944e-05,3.33207454961459e-05,0.6
16280,아군/Noun,5,3,2,3.3345930684925414e-05,2.2213830330763933e-05,0.6
16281,독립운동/Noun,5,3,2,3.3345930684925414e-05,2.2213830330763933e-05,0.6
16282,꺅꺅/Adverb,5,2,3,2.2230620456616944e-05,3.33207454961459e-05,0.6
16283,무능/Noun,5,3,2,3.3345930684925414e-05,2.2213830330763933e-05,0.6
16284,남짓/Noun,5,3,2,3.3345930684925414e-05,2.2213830330763933e-05,0.6
16285,메탈/Noun,5,2,3,2.2230620456616944e-05,3.33207454961459e-05,0.6
16286,8.4/Number,5,2,3,2.2230620456616944e-05,3.33207454961459e-05,0.6
16287,대중화/Noun,5,3,2,3.3345930684925414e-05,2.2213830330763933e-05,0.6
16288,굴러가다/Verb,5,3,2,3.3345930684925414e-05,2.2213830330763933e-05,0.6
16289,상혁/Noun,5,2,3,2.2230620456616944e-05,3.33207454961459e-05,0.6
16290,둥지/Noun,5,2,3,2.2230620456616944e-05,3.33207454961459e-05,0.6
16291,폭주/Noun,5,2,3,2.2230620456616944e-05,3.33207454961459e-05,0.6
16292,타네/Noun,5,2,3,2.2230620456616944e-05,3.33207454961459e-05,0.6
16293,날줄/Noun,5,2,3,2.2230620456616944e-05,3.33207454961459e-05,0.6
16294,늬/Noun,5,3,2,3.3345930684925414e-05,2.2213830330763933e-05,0.6
16295,껄껄/Noun,5,2,3,2.2230620456616944e-05,3.33207454961459e-05,0.6
16296,내재/Noun,5,3,2,3.3345930684925414e-05,2.2213830330763933e-05,0.6
16297,문방구/Noun,5,3,2,3.3345930684925414e-05,2.2213830330763933e-05,0.6
16298,편곡/Noun,5,3,2,3.3345930684925414e-05,2.2213830330763933e-05,0.6
16299,더도/Noun,5,2,3,2.2230620456616944e-05,3.33207454961459e-05,0.6
16300,집대성/Noun,5,3,2,3.3345930684925414e-05,2.2213830330763933e-05,0.6
16301,못봣/Noun,5,3,2,3.3345930684925414e-05,2.2213830330763933e-05,0.6
16302,토이/Noun,5,2,3,2.2230620456616944e-05,3.33207454961459e-05,0.6
16303,살상/Noun,5,2,3,2.2230620456616944e-05,3.33207454961459e-05,0.6
16304,아우성/Noun,5,3,2,3.3345930684925414e-05,2.2213830330763933e-05,0.6
16305,시커멓다/Adjective,5,2,3,2.2230620456616944e-05,3.33207454961459e-05,0.6
16306,뱅/Noun,5,3,2,3.3345930684925414e-05,2.2213830330763933e-05,0.6
16307,순진/Noun,5,3,2,3.3345930684925414e-05,2.2213830330763933e-05,0.6
16308,렛/Noun,5,3,2,3.3345930684925414e-05,2.2213830330763933e-05,0.6
16309,소풍/Noun,5,2,3,2.2230620456616944e-05,3.33207454961459e-05,0.6
16310,해법/Noun,5,2,3,2.2230620456616944e-05,3.33207454961459e-05,0.6
16311,틱장애/Noun,5,3,2,3.3345930684925414e-05,2.2213830330763933e-05,0.6
16312,생물학/Noun,5,2,3,2.2230620456616944e-05,3.33207454961459e-05,0.6
16313,""",/Punctuation",5,3,2,3.3345930684925414e-05,2.2213830330763933e-05,0.6
16314,노킹/Noun,5,2,3,2.2230620456616944e-05,3.33207454961459e-05,0.6
16315,바로바로/Adverb,5,3,2,3.3345930684925414e-05,2.2213830330763933e-05,0.6
16316,총리/Noun,5,2,3,2.2230620456616944e-05,3.33207454961459e-05,0.6
16317,이지혜/Noun,5,2,3,2.2230620456616944e-05,3.33207454961459e-05,0.6
16318,블랙호크다운/Noun,5,3,2,3.3345930684925414e-05,2.2213830330763933e-05,0.6
16319,새미/Noun,5,2,3,2.2230620456616944e-05,3.33207454961459e-05,0.6
16320,나카마/Noun,5,3,2,3.3345930684925414e-05,2.2213830330763933e-05,0.6
16321,자씨/Noun,5,3,2,3.3345930684925414e-05,2.2213830330763933e-05,0.6
16322,태범/Noun,5,3,2,3.3345930684925414e-05,2.2213830330763933e-05,0.6
16323,동방/Noun,5,3,2,3.3345930684925414e-05,2.2213830330763933e-05,0.6
16324,연한/Noun,5,3,2,3.3345930684925414e-05,2.2213830330763933e-05,0.6
16325,아르세우스/Noun,5,3,2,3.3345930684925414e-05,2.2213830330763933e-05,0.6
16326,엌/Noun,5,3,2,3.3345930684925414e-05,2.2213830330763933e-05,0.6
16327,니아/Noun,5,3,2,3.3345930684925414e-05,2.2213830330763933e-05,0.6
16328,선인/Noun,5,3,2,3.3345930684925414e-05,2.2213830330763933e-05,0.6
16329,사쿠라/Noun,5,2,3,2.2230620456616944e-05,3.33207454961459e-05,0.6
16330,히나타/Noun,5,3,2,3.3345930684925414e-05,2.2213830330763933e-05,0.6
16331,ㅓㅇ/KoreanParticle,5,3,2,3.3345930684925414e-05,2.2213830330763933e-05,0.6
16332,카트/Noun,5,3,2,3.3345930684925414e-05,2.2213830330763933e-05,0.6
16333,경찰관/Noun,5,3,2,3.3345930684925414e-05,2.2213830330763933e-05,0.6
16334,장래희망/Noun,5,3,2,3.3345930684925414e-05,2.2213830330763933e-05,0.6
16335,군자/Noun,5,3,2,3.3345930684925414e-05,2.2213830330763933e-05,0.6
16336,소룡/Noun,5,2,3,2.2230620456616944e-05,3.33207454961459e-05,0.6
16337,단것/Noun,5,3,2,3.3345930684925414e-05,2.2213830330763933e-05,0.6
16338,아네트베닝/Noun,5,2,3,2.2230620456616944e-05,3.33207454961459e-05,0.6
16339,게으름/Noun,5,2,3,2.2230620456616944e-05,3.33207454961459e-05,0.6
16340,티파니/Noun,5,3,2,3.3345930684925414e-05,2.2213830330763933e-05,0.6
16341,정형/Noun,5,2,3,2.2230620456616944e-05,3.33207454961459e-05,0.6
16342,주역/Noun,5,2,3,2.2230620456616944e-05,3.33207454961459e-05,0.6
16343,배후/Noun,5,2,3,2.2230620456616944e-05,3.33207454961459e-05,0.6
16344,금융/Noun,5,3,2,3.3345930684925414e-05,2.2213830330763933e-05,0.6
16345,냅다/Adverb,5,2,3,2.2230620456616944e-05,3.33207454961459e-05,0.6
16346,수리검/Noun,5,3,2,3.3345930684925414e-05,2.2213830330763933e-05,0.6
16347,법인/Noun,5,2,3,2.2230620456616944e-05,3.33207454961459e-05,0.6
16348,말종/Noun,5,2,3,2.2230620456616944e-05,3.33207454961459e-05,0.6
16349,이연결/Noun,5,3,2,3.3345930684925414e-05,2.2213830330763933e-05,0.6
16350,키기/Noun,5,3,2,3.3345930684925414e-05,2.2213830330763933e-05,0.6
16351,껍질/Noun,5,3,2,3.3345930684925414e-05,2.2213830330763933e-05,0.6
16352,호스텔/Noun,5,2,3,2.2230620456616944e-05,3.33207454961459e-05,0.6
16353,달라붙다/Verb,5,2,3,2.2230620456616944e-05,3.33207454961459e-05,0.6
16354,낚일/Noun,5,2,3,2.2230620456616944e-05,3.33207454961459e-05,0.6
16355,가렛/Noun,5,2,3,2.2230620456616944e-05,3.33207454961459e-05,0.6
16356,칠흑/Noun,5,3,2,3.3345930684925414e-05,2.2213830330763933e-05,0.6
16357,-.-;;/Punctuation,5,2,3,2.2230620456616944e-05,3.33207454961459e-05,0.6
16358,일분/Noun,5,3,2,3.3345930684925414e-05,2.2213830330763933e-05,0.6
16359,이순신장군/Noun,5,2,3,2.2230620456616944e-05,3.33207454961459e-05,0.6
16360,휠씬/Noun,5,3,2,3.3345930684925414e-05,2.2213830330763933e-05,0.6
16361,손가락질/Noun,5,3,2,3.3345930684925414e-05,2.2213830330763933e-05,0.6
16362,에는/Foreign,5,2,3,2.2230620456616944e-05,3.33207454961459e-05,0.6
16363,진성/Noun,5,3,2,3.3345930684925414e-05,2.2213830330763933e-05,0.6
16364,힘껏/Noun,5,3,2,3.3345930684925414e-05,2.2213830330763933e-05,0.6
16365,페루/Noun,5,3,2,3.3345930684925414e-05,2.2213830330763933e-05,0.6
16366,해나/Noun,5,2,3,2.2230620456616944e-05,3.33207454961459e-05,0.6
16367,탄광/Noun,5,3,2,3.3345930684925414e-05,2.2213830330763933e-05,0.6
16368,쥐약/Noun,5,2,3,2.2230620456616944e-05,3.33207454961459e-05,0.6
16369,잠잠하다/Adjective,5,2,3,2.2230620456616944e-05,3.33207454961459e-05,0.6
16370,고막/Noun,5,2,3,2.2230620456616944e-05,3.33207454961459e-05,0.6
16371,시지/Noun,5,2,3,2.2230620456616944e-05,3.33207454961459e-05,0.6
16372,브레이브하트/Noun,5,3,2,3.3345930684925414e-05,2.2213830330763933e-05,0.6
16373,헤집다/Verb,5,3,2,3.3345930684925414e-05,2.2213830330763933e-05,0.6
16374,안길/Noun,5,3,2,3.3345930684925414e-05,2.2213830330763933e-05,0.6
16375,김조광수/Noun,5,2,3,2.2230620456616944e-05,3.33207454961459e-05,0.6
16376,경주/Noun,5,2,3,2.2230620456616944e-05,3.33207454961459e-05,0.6
16377,작이라고/Foreign,5,2,3,2.2230620456616944e-05,3.33207454961459e-05,0.6
16378,리야/Noun,5,3,2,3.3345930684925414e-05,2.2213830330763933e-05,0.6
16379,어머/Noun,5,3,2,3.3345930684925414e-05,2.2213830330763933e-05,0.6
16380,어두움/Noun,5,2,3,2.2230620456616944e-05,3.33207454961459e-05,0.6
16381,네타/Noun,5,2,3,2.2230620456616944e-05,3.33207454961459e-05,0.6
16382,팔면/Noun,5,3,2,3.3345930684925414e-05,2.2213830330763933e-05,0.6
16383,단시간/Noun,5,2,3,2.2230620456616944e-05,3.33207454961459e-05,0.6
16384,일삼/Noun,5,3,2,3.3345930684925414e-05,2.2213830330763933e-05,0.6
16385,트랜드/Noun,5,2,3,2.2230620456616944e-05,3.33207454961459e-05,0.6
16386,퇴근/Noun,5,2,3,2.2230620456616944e-05,3.33207454961459e-05,0.6
16387,온전/Noun,5,3,2,3.3345930684925414e-05,2.2213830330763933e-05,0.6
16388,야구장/Noun,5,2,3,2.2230620456616944e-05,3.33207454961459e-05,0.6
16389,산산조각/Noun,5,2,3,2.2230620456616944e-05,3.33207454961459e-05,0.6
16390,제임스본드/Noun,5,3,2,3.3345930684925414e-05,2.2213830330763933e-05,0.6
16391,전술/Noun,5,2,3,2.2230620456616944e-05,3.33207454961459e-05,0.6
16392,23년/Number,5,2,3,2.2230620456616944e-05,3.33207454961459e-05,0.6
16393,김무열/Noun,5,3,2,3.3345930684925414e-05,2.2213830330763933e-05,0.6
16394,베이스/Noun,5,3,2,3.3345930684925414e-05,2.2213830330763933e-05,0.6
16395,1986년/Number,5,3,2,3.3345930684925414e-05,2.2213830330763933e-05,0.6
16396,으어/Noun,5,2,3,2.2230620456616944e-05,3.33207454961459e-05,0.6
16397,노약/Noun,5,3,2,3.3345930684925414e-05,2.2213830330763933e-05,0.6
16398,아집/Noun,5,2,3,2.2230620456616944e-05,3.33207454961459e-05,0.6
16399,벌떡/Noun,5,3,2,3.3345930684925414e-05,2.2213830330763933e-05,0.6
16400,인색하다/Adjective,5,3,2,3.3345930684925414e-05,2.2213830330763933e-05,0.6
16401,대사관/Noun,5,3,2,3.3345930684925414e-05,2.2213830330763933e-05,0.6
16402,요코/Noun,5,2,3,2.2230620456616944e-05,3.33207454961459e-05,0.6
16403,십대/Modifier,5,3,2,3.3345930684925414e-05,2.2213830330763933e-05,0.6
16404,더라면/Noun,5,3,2,3.3345930684925414e-05,2.2213830330763933e-05,0.6
16405,환경오염/Noun,5,3,2,3.3345930684925414e-05,2.2213830330763933e-05,0.6
16406,조그마하다/Adjective,5,2,3,2.2230620456616944e-05,3.33207454961459e-05,0.6
16407,오하/Noun,5,2,3,2.2230620456616944e-05,3.33207454961459e-05,0.6
16408,침입/Noun,5,3,2,3.3345930684925414e-05,2.2213830330763933e-05,0.6
16409,무단/Noun,5,2,3,2.2230620456616944e-05,3.33207454961459e-05,0.6
16410,쪙/Noun,5,3,2,3.3345930684925414e-05,2.2213830330763933e-05,0.6
16411,낙천/Noun,5,2,3,2.2230620456616944e-05,3.33207454961459e-05,0.6
16412,7.0/Number,5,3,2,3.3345930684925414e-05,2.2213830330763933e-05,0.6
16413,속담/Noun,5,2,3,2.2230620456616944e-05,3.33207454961459e-05,0.6
16414,명/Foreign,5,3,2,3.3345930684925414e-05,2.2213830330763933e-05,0.6
16415,노트/Noun,5,3,2,3.3345930684925414e-05,2.2213830330763933e-05,0.6
16416,가산/Noun,5,2,3,2.2230620456616944e-05,3.33207454961459e-05,0.6
16417,사고뭉치/Noun,5,2,3,2.2230620456616944e-05,3.33207454961459e-05,0.6
16418,클락/Noun,5,3,2,3.3345930684925414e-05,2.2213830330763933e-05,0.6
16419,명수/Noun,5,2,3,2.2230620456616944e-05,3.33207454961459e-05,0.6
16420,펙트/Noun,5,2,3,2.2230620456616944e-05,3.33207454961459e-05,0.6
16421,과도기/Noun,5,3,2,3.3345930684925414e-05,2.2213830330763933e-05,0.6
16422,송해/Noun,5,3,2,3.3345930684925414e-05,2.2213830330763933e-05,0.6
16423,인강/Noun,5,3,2,3.3345930684925414e-05,2.2213830330763933e-05,0.6
16424,스핀오프/Noun,5,3,2,3.3345930684925414e-05,2.2213830330763933e-05,0.6
16425,이특/Noun,5,3,2,3.3345930684925414e-05,2.2213830330763933e-05,0.6
16426,숙청/Noun,5,2,3,2.2230620456616944e-05,3.33207454961459e-05,0.6
16427,꼬임/Noun,5,2,3,2.2230620456616944e-05,3.33207454961459e-05,0.6
16428,100일/Number,5,2,3,2.2230620456616944e-05,3.33207454961459e-05,0.6
16429,지라치/Noun,5,2,3,2.2230620456616944e-05,3.33207454961459e-05,0.6
16430,want/Alpha,5,3,2,3.3345930684925414e-05,2.2213830330763933e-05,0.6
16431,치고받다/Verb,5,3,2,3.3345930684925414e-05,2.2213830330763933e-05,0.6
16432,롤랜드/Noun,5,2,3,2.2230620456616944e-05,3.33207454961459e-05,0.6
16433,)../Punctuation,5,2,3,2.2230620456616944e-05,3.33207454961459e-05,0.6
16434,지팡이/Noun,5,2,3,2.2230620456616944e-05,3.33207454961459e-05,0.6
16435,개잡/Noun,5,2,3,2.2230620456616944e-05,3.33207454961459e-05,0.6
16436,곽재용/Noun,5,2,3,2.2230620456616944e-05,3.33207454961459e-05,0.6
16437,??!/Punctuation,5,2,3,2.2230620456616944e-05,3.33207454961459e-05,0.6
16438,클로드/Noun,5,3,2,3.3345930684925414e-05,2.2213830330763933e-05,0.6
16439,레스/Noun,5,3,2,3.3345930684925414e-05,2.2213830330763933e-05,0.6
16440,7분/Number,5,2,3,2.2230620456616944e-05,3.33207454961459e-05,0.6
16441,알리야/Noun,5,2,3,2.2230620456616944e-05,3.33207454961459e-05,0.6
16442,쇼타임/Noun,5,3,2,3.3345930684925414e-05,2.2213830330763933e-05,0.6
16443,왜왜왜/Noun,5,3,2,3.3345930684925414e-05,2.2213830330763933e-05,0.6
16444,이비/Noun,5,2,3,2.2230620456616944e-05,3.33207454961459e-05,0.6
16445,신기원/Noun,5,3,2,3.3345930684925414e-05,2.2213830330763933e-05,0.6
16446,상공/Noun,5,2,3,2.2230620456616944e-05,3.33207454961459e-05,0.6
16447,난관/Noun,5,3,2,3.3345930684925414e-05,2.2213830330763933e-05,0.6
16448,신임/Noun,5,3,2,3.3345930684925414e-05,2.2213830330763933e-05,0.6
16449,도해/Noun,5,3,2,3.3345930684925414e-05,2.2213830330763933e-05,0.6
16450,광개토태왕/Noun,5,2,3,2.2230620456616944e-05,3.33207454961459e-05,0.6
16451,1일/Number,5,3,2,3.3345930684925414e-05,2.2213830330763933e-05,0.6
16452,클랜/Noun,5,3,2,3.3345930684925414e-05,2.2213830330763933e-05,0.6
16453,다솜/Noun,5,3,2,3.3345930684925414e-05,2.2213830330763933e-05,0.6
16454,팽/Noun,5,2,3,2.2230620456616944e-05,3.33207454961459e-05,0.6
16455,가신/Noun,5,3,2,3.3345930684925414e-05,2.2213830330763933e-05,0.6
16456,걷어차다/Verb,5,2,3,2.2230620456616944e-05,3.33207454961459e-05,0.6
16457,텀/Noun,5,2,3,2.2230620456616944e-05,3.33207454961459e-05,0.6
16458,순회/Noun,5,2,3,2.2230620456616944e-05,3.33207454961459e-05,0.6
16459,필적/Noun,5,3,2,3.3345930684925414e-05,2.2213830330763933e-05,0.6
16460,거땜/Noun,5,2,3,2.2230620456616944e-05,3.33207454961459e-05,0.6
16461,45년/Number,5,3,2,3.3345930684925414e-05,2.2213830330763933e-05,0.6
16462,한글제목/Noun,5,2,3,2.2230620456616944e-05,3.33207454961459e-05,0.6
16463,으헝/Noun,5,3,2,3.3345930684925414e-05,2.2213830330763933e-05,0.6
16464,최불암/Noun,5,3,2,3.3345930684925414e-05,2.2213830330763933e-05,0.6
16465,토네이도/Noun,5,3,2,3.3345930684925414e-05,2.2213830330763933e-05,0.6
16466,에단/Noun,5,2,3,2.2230620456616944e-05,3.33207454961459e-05,0.6
16467,유종/Noun,5,3,2,3.3345930684925414e-05,2.2213830330763933e-05,0.6
16468,항해/Noun,5,3,2,3.3345930684925414e-05,2.2213830330763933e-05,0.6
16469,개구쟁이/Noun,5,2,3,2.2230620456616944e-05,3.33207454961459e-05,0.6
16470,상병/Noun,5,2,3,2.2230620456616944e-05,3.33207454961459e-05,0.6
16471,의형제/Noun,5,2,3,2.2230620456616944e-05,3.33207454961459e-05,0.6
16472,여름날/Noun,5,3,2,3.3345930684925414e-05,2.2213830330763933e-05,0.6
16473,이사장/Noun,5,2,3,2.2230620456616944e-05,3.33207454961459e-05,0.6
16474,부장/Noun,5,3,2,3.3345930684925414e-05,2.2213830330763933e-05,0.6
16475,세친구/Noun,5,3,2,3.3345930684925414e-05,2.2213830330763933e-05,0.6
16476,납/Noun,5,3,2,3.3345930684925414e-05,2.2213830330763933e-05,0.6
16477,찜질방/Noun,5,3,2,3.3345930684925414e-05,2.2213830330763933e-05,0.6
16478,쉴즈/Noun,5,3,2,3.3345930684925414e-05,2.2213830330763933e-05,0.6
16479,카운트/Noun,5,3,2,3.3345930684925414e-05,2.2213830330763933e-05,0.6
16480,꽃보다남자/Noun,5,3,2,3.3345930684925414e-05,2.2213830330763933e-05,0.6
16481,택배/Noun,5,2,3,2.2230620456616944e-05,3.33207454961459e-05,0.6
16482,삼일/Noun,5,2,3,2.2230620456616944e-05,3.33207454961459e-05,0.6
16483,갖가지/Noun,5,2,3,2.2230620456616944e-05,3.33207454961459e-05,0.6
16484,이성애자/Noun,5,3,2,3.3345930684925414e-05,2.2213830330763933e-05,0.6
16485,미우라/Noun,5,2,3,2.2230620456616944e-05,3.33207454961459e-05,0.6
16486,교류/Noun,5,2,3,2.2230620456616944e-05,3.33207454961459e-05,0.6
16487,파랗다/Adjective,5,3,2,3.3345930684925414e-05,2.2213830330763933e-05,0.6
16488,단둘/Noun,5,2,3,2.2230620456616944e-05,3.33207454961459e-05,0.6
16489,가부장/Noun,5,2,3,2.2230620456616944e-05,3.33207454961459e-05,0.6
16490,점/Foreign,5,2,3,2.2230620456616944e-05,3.33207454961459e-05,0.6
16491,움찔/Noun,5,3,2,3.3345930684925414e-05,2.2213830330763933e-05,0.6
16492,만물/Noun,5,3,2,3.3345930684925414e-05,2.2213830330763933e-05,0.6
16493,그릴/Noun,5,3,2,3.3345930684925414e-05,2.2213830330763933e-05,0.6
16494,빨래/Noun,5,3,2,3.3345930684925414e-05,2.2213830330763933e-05,0.6
16495,아물다/Verb,5,2,3,2.2230620456616944e-05,3.33207454961459e-05,0.6
16496,패럴/Noun,5,3,2,3.3345930684925414e-05,2.2213830330763933e-05,0.6
16497,닉슨/Noun,5,3,2,3.3345930684925414e-05,2.2213830330763933e-05,0.6
16498,래퍼/Noun,5,2,3,2.2230620456616944e-05,3.33207454961459e-05,0.6
16499,아스팔트/Noun,5,3,2,3.3345930684925414e-05,2.2213830330763933e-05,0.6
16500,벤틀리/Noun,5,3,2,3.3345930684925414e-05,2.2213830330763933e-05,0.6
16501,틸리/Noun,5,3,2,3.3345930684925414e-05,2.2213830330763933e-05,0.6
16502,용돈/Noun,5,2,3,2.2230620456616944e-05,3.33207454961459e-05,0.6
16503,화도/Noun,5,3,2,3.3345930684925414e-05,2.2213830330763933e-05,0.6
16504,흥이/Noun,5,2,3,2.2230620456616944e-05,3.33207454961459e-05,0.6
16505,소득/Noun,5,2,3,2.2230620456616944e-05,3.33207454961459e-05,0.6
16506,실명/Noun,5,2,3,2.2230620456616944e-05,3.33207454961459e-05,0.6
16507,자식새끼/Noun,5,3,2,3.3345930684925414e-05,2.2213830330763933e-05,0.6
16508,글리/Noun,5,2,3,2.2230620456616944e-05,3.33207454961459e-05,0.6
16509,비틀어지다/Verb,5,2,3,2.2230620456616944e-05,3.33207454961459e-05,0.6
16510,배정/Noun,5,3,2,3.3345930684925414e-05,2.2213830330763933e-05,0.6
16511,11분/Number,5,2,3,2.2230620456616944e-05,3.33207454961459e-05,0.6
16512,격조/Noun,5,3,2,3.3345930684925414e-05,2.2213830330763933e-05,0.6
16513,반칙/Noun,5,3,2,3.3345930684925414e-05,2.2213830330763933e-05,0.6
16514,지젤/Noun,5,2,3,2.2230620456616944e-05,3.33207454961459e-05,0.6
16515,타이탄/Noun,5,2,3,2.2230620456616944e-05,3.33207454961459e-05,0.6
16516,랄라/Adverb,5,3,2,3.3345930684925414e-05,2.2213830330763933e-05,0.6
16517,고아/Noun,5,3,2,3.3345930684925414e-05,2.2213830330763933e-05,0.6
16518,여가/Noun,5,2,3,2.2230620456616944e-05,3.33207454961459e-05,0.6
16519,용암/Noun,5,3,2,3.3345930684925414e-05,2.2213830330763933e-05,0.6
16520,긴머리/Noun,5,2,3,2.2230620456616944e-05,3.33207454961459e-05,0.6
16521,위드/Noun,5,2,3,2.2230620456616944e-05,3.33207454961459e-05,0.6
16522,반고흐/Noun,5,3,2,3.3345930684925414e-05,2.2213830330763933e-05,0.6
16523,이장호/Noun,5,3,2,3.3345930684925414e-05,2.2213830330763933e-05,0.6
16524,아이구/Exclamation,5,2,3,2.2230620456616944e-05,3.33207454961459e-05,0.6
16525,중요시/Noun,5,2,3,2.2230620456616944e-05,3.33207454961459e-05,0.6
16526,브룩쉴즈/Noun,5,2,3,2.2230620456616944e-05,3.33207454961459e-05,0.6
16527,점준애/Noun,5,2,3,2.2230620456616944e-05,3.33207454961459e-05,0.6
16528,이영은/Noun,5,2,3,2.2230620456616944e-05,3.33207454961459e-05,0.6
16529,…./Punctuation,5,2,3,2.2230620456616944e-05,3.33207454961459e-05,0.6
16530,종형/Noun,5,2,3,2.2230620456616944e-05,3.33207454961459e-05,0.6
16531,지적장애/Noun,5,2,3,2.2230620456616944e-05,3.33207454961459e-05,0.6
16532,뻐/Noun,5,3,2,3.3345930684925414e-05,2.2213830330763933e-05,0.6
16533,경례/Noun,5,2,3,2.2230620456616944e-05,3.33207454961459e-05,0.6
16534,훤히/Noun,5,3,2,3.3345930684925414e-05,2.2213830330763933e-05,0.6
16535,수호지/Noun,5,2,3,2.2230620456616944e-05,3.33207454961459e-05,0.6
16536,아담스/Noun,5,3,2,3.3345930684925414e-05,2.2213830330763933e-05,0.6
16537,터보/Noun,5,3,2,3.3345930684925414e-05,2.2213830330763933e-05,0.6
16538,비폭력/Noun,5,3,2,3.3345930684925414e-05,2.2213830330763933e-05,0.6
16539,너그럽다/Adjective,5,3,2,3.3345930684925414e-05,2.2213830330763933e-05,0.6
16540,산영/Noun,5,3,2,3.3345930684925414e-05,2.2213830330763933e-05,0.6
16541,획득/Noun,5,2,3,2.2230620456616944e-05,3.33207454961459e-05,0.6
16542,라미란/Noun,5,3,2,3.3345930684925414e-05,2.2213830330763933e-05,0.6
16543,류수영/Noun,5,3,2,3.3345930684925414e-05,2.2213830330763933e-05,0.6
16544,투지/Noun,5,3,2,3.3345930684925414e-05,2.2213830330763933e-05,0.6
16545,눈뎅/Noun,4,4,0,4.446124091323389e-05,0.0,1.0
16546,태주/Noun,4,4,0,4.446124091323389e-05,0.0,1.0
16547,쇼팽/Noun,4,4,0,4.446124091323389e-05,0.0,1.0
16548,꾸러기/Noun,4,4,0,4.446124091323389e-05,0.0,1.0
16549,방기/Noun,4,0,4,0.0,4.4427660661527865e-05,1.0
16550,개꿀잼임/Noun,4,4,0,4.446124091323389e-05,0.0,1.0
16551,봣었/Noun,4,4,0,4.446124091323389e-05,0.0,1.0
16552,나타남/Noun,4,0,4,0.0,4.4427660661527865e-05,1.0
16553,극혐임/Noun,4,0,4,0.0,4.4427660661527865e-05,1.0
16554,퍼킹/Noun,4,0,4,0.0,4.4427660661527865e-05,1.0
16555,ㅋㄲㅈㅁ/KoreanParticle,4,0,4,0.0,4.4427660661527865e-05,1.0
16556,49/Number,4,4,0,4.446124091323389e-05,0.0,1.0
16557,버거/Noun,4,0,4,0.0,4.4427660661527865e-05,1.0
16558,청바지/Noun,4,4,0,4.446124091323389e-05,0.0,1.0
16559,Man/Alpha,4,4,0,4.446124091323389e-05,0.0,1.0
16560,'.../Punctuation,4,4,0,4.446124091323389e-05,0.0,1.0
16561,거뭐임/Noun,4,0,4,0.0,4.4427660661527865e-05,1.0
16562,봣엇/Noun,4,4,0,4.446124091323389e-05,0.0,1.0
16563,여봐라/Noun,4,0,4,0.0,4.4427660661527865e-05,1.0
16564,바보엄마/Noun,4,4,0,4.446124091323389e-05,0.0,1.0
16565,낭만자객/Noun,4,0,4,0.0,4.4427660661527865e-05,1.0
16566,와이즈/Noun,4,4,0,4.446124091323389e-05,0.0,1.0
16567,서안/Noun,4,0,4,0.0,4.4427660661527865e-05,1.0
16568,series/Alpha,4,4,0,4.446124091323389e-05,0.0,1.0
16569,신입사원/Noun,4,0,4,0.0,4.4427660661527865e-05,1.0
16570,불혹/Noun,4,4,0,4.446124091323389e-05,0.0,1.0
16571,장기매매/Noun,4,0,4,0.0,4.4427660661527865e-05,1.0
16572,어떡/Noun,4,0,4,0.0,4.4427660661527865e-05,1.0
16573,말임/Noun,4,4,0,4.446124091323389e-05,0.0,1.0
16574,복희/Noun,4,0,4,0.0,4.4427660661527865e-05,1.0
16575,?>/Punctuation,4,0,4,0.0,4.4427660661527865e-05,1.0
16576,음조/Noun,4,4,0,4.446124091323389e-05,0.0,1.0
16577,시청료/Noun,4,0,4,0.0,4.4427660661527865e-05,1.0
16578,김태연/Noun,4,0,4,0.0,4.4427660661527865e-05,1.0
16579,롱런/Noun,4,4,0,4.446124091323389e-05,0.0,1.0
16580,이비에스/Noun,4,4,0,4.446124091323389e-05,0.0,1.0
16581,파이프/Noun,4,0,4,0.0,4.4427660661527865e-05,1.0
16582,！！/Foreign,4,4,0,4.446124091323389e-05,0.0,1.0
16583,레토/Noun,4,4,0,4.446124091323389e-05,0.0,1.0
16584,왜리/Noun,4,4,0,4.446124091323389e-05,0.0,1.0
16585,get/Alpha,4,4,0,4.446124091323389e-05,0.0,1.0
16586,.;;;;/Punctuation,4,0,4,0.0,4.4427660661527865e-05,1.0
16587,임/Foreign,4,0,4,0.0,4.4427660661527865e-05,1.0
16588,현직/Noun,4,4,0,4.446124091323389e-05,0.0,1.0
16589,제나/Noun,4,4,0,4.446124091323389e-05,0.0,1.0
16590,셰퍼드/Noun,4,4,0,4.446124091323389e-05,0.0,1.0
16591,떼거지/Noun,4,0,4,0.0,4.4427660661527865e-05,1.0
16592,잡수시다/Verb,4,0,4,0.0,4.4427660661527865e-05,1.0
16593,변태성욕/Noun,4,0,4,0.0,4.4427660661527865e-05,1.0
16594,까미유/Noun,4,4,0,4.446124091323389e-05,0.0,1.0
16595,가속/Noun,4,4,0,4.446124091323389e-05,0.0,1.0
16596,이스터섬/Noun,4,4,0,4.446124091323389e-05,0.0,1.0
16597,109분/Number,4,0,4,0.0,4.4427660661527865e-05,1.0
16598,...................................../Punctuation,4,0,4,0.0,4.4427660661527865e-05,1.0
16599,어이쿠/Noun,4,0,4,0.0,4.4427660661527865e-05,1.0
16600,노노노/Noun,4,0,4,0.0,4.4427660661527865e-05,1.0
16601,김성균/Noun,4,4,0,4.446124091323389e-05,0.0,1.0
16602,후대/Noun,4,4,0,4.446124091323389e-05,0.0,1.0
16603,ㅈㅈ/KoreanParticle,4,0,4,0.0,4.4427660661527865e-05,1.0
16604,레파/Noun,4,0,4,0.0,4.4427660661527865e-05,1.0
16605,가비/Noun,4,4,0,4.446124091323389e-05,0.0,1.0
16606,이로써/Adverb,4,0,4,0.0,4.4427660661527865e-05,1.0
16607,혹독하다/Adjective,4,4,0,4.446124091323389e-05,0.0,1.0
16608,;.../Punctuation,4,0,4,0.0,4.4427660661527865e-05,1.0
16609,뭐꼬/Noun,4,0,4,0.0,4.4427660661527865e-05,1.0
16610,공세/Noun,4,0,4,0.0,4.4427660661527865e-05,1.0
16611,불현듯/Noun,4,4,0,4.446124091323389e-05,0.0,1.0
16612,원칙/Noun,4,0,4,0.0,4.4427660661527865e-05,1.0
16613,박미선/Noun,4,0,4,0.0,4.4427660661527865e-05,1.0
16614,골디/Noun,4,4,0,4.446124091323389e-05,0.0,1.0
16615,가소롭다/Adjective,4,0,4,0.0,4.4427660661527865e-05,1.0
16616,챙피/Noun,4,0,4,0.0,4.4427660661527865e-05,1.0
16617,3.1/Number,4,0,4,0.0,4.4427660661527865e-05,1.0
16618,첫등장/Noun,4,0,4,0.0,4.4427660661527865e-05,1.0
16619,지아장커/Noun,4,4,0,4.446124091323389e-05,0.0,1.0
16620,안드로이드/Noun,4,4,0,4.446124091323389e-05,0.0,1.0
16621,ㅂㅂ/KoreanParticle,4,0,4,0.0,4.4427660661527865e-05,1.0
16622,인간지네/Noun,4,0,4,0.0,4.4427660661527865e-05,1.0
16623,순리/Noun,4,4,0,4.446124091323389e-05,0.0,1.0
16624,뮈/Noun,4,0,4,0.0,4.4427660661527865e-05,1.0
16625,다물어지다/Verb,4,4,0,4.446124091323389e-05,0.0,1.0
16626,하루히/Noun,4,4,0,4.446124091323389e-05,0.0,1.0
16627,여심/Noun,4,4,0,4.446124091323389e-05,0.0,1.0
16628,저열/Noun,4,0,4,0.0,4.4427660661527865e-05,1.0
16629,엘라/Noun,4,4,0,4.446124091323389e-05,0.0,1.0
16630,보빨/Noun,4,0,4,0.0,4.4427660661527865e-05,1.0
16631,집의/Noun,4,0,4,0.0,4.4427660661527865e-05,1.0
16632,파멸하다/Adjective,4,4,0,4.446124091323389e-05,0.0,1.0
16633,트래쉬/Noun,4,0,4,0.0,4.4427660661527865e-05,1.0
16634,간닷/Noun,4,0,4,0.0,4.4427660661527865e-05,1.0
16635,시럽/Noun,4,0,4,0.0,4.4427660661527865e-05,1.0
16636,♥♥♥♥♥♥♥/Foreign,4,4,0,4.446124091323389e-05,0.0,1.0
16637,……./Punctuation,4,0,4,0.0,4.4427660661527865e-05,1.0
16638,아웅산수치/Noun,4,4,0,4.446124091323389e-05,0.0,1.0
16639,꿀꿀/Noun,4,4,0,4.446124091323389e-05,0.0,1.0
16640,금옥/Noun,4,0,4,0.0,4.4427660661527865e-05,1.0
16641,again/Alpha,4,4,0,4.446124091323389e-05,0.0,1.0
16642,뭇/Modifier,4,4,0,4.446124091323389e-05,0.0,1.0
16643,잼잼잼/Noun,4,4,0,4.446124091323389e-05,0.0,1.0
16644,유분수/Noun,4,0,4,0.0,4.4427660661527865e-05,1.0
16645,기생수/Noun,4,4,0,4.446124091323389e-05,0.0,1.0
16646,건성건성/Noun,4,0,4,0.0,4.4427660661527865e-05,1.0
16647,!!!!!!!!!!!!!!!!!!!!!!!!!!!/Punctuation,4,4,0,4.446124091323389e-05,0.0,1.0
16648,크라운제이/Noun,4,0,4,0.0,4.4427660661527865e-05,1.0
16649,똥례/Noun,4,0,4,0.0,4.4427660661527865e-05,1.0
16650,정소민/Noun,4,4,0,4.446124091323389e-05,0.0,1.0
16651,똥망작/Noun,4,0,4,0.0,4.4427660661527865e-05,1.0
16652,피카/Noun,4,4,0,4.446124091323389e-05,0.0,1.0
16653,We/Alpha,4,4,0,4.446124091323389e-05,0.0,1.0
16654,울적/Noun,4,0,4,0.0,4.4427660661527865e-05,1.0
16655,쓰르라미/Noun,4,0,4,0.0,4.4427660661527865e-05,1.0
16656,부린다/Noun,4,0,4,0.0,4.4427660661527865e-05,1.0
16657,착잡하다/Adjective,4,4,0,4.446124091323389e-05,0.0,1.0
16658,스반/Noun,4,4,0,4.446124091323389e-05,0.0,1.0
16659,벙/Noun,4,0,4,0.0,4.4427660661527865e-05,1.0
16660,1010101010/Number,4,4,0,4.446124091323389e-05,0.0,1.0
16661,1998/Number,4,4,0,4.446124091323389e-05,0.0,1.0
16662,게이샤/Noun,4,0,4,0.0,4.4427660661527865e-05,1.0
16663,뱅뱅/Noun,4,0,4,0.0,4.4427660661527865e-05,1.0
16664,꼴깝/Noun,4,0,4,0.0,4.4427660661527865e-05,1.0
16665,뭘더바/Noun,4,4,0,4.446124091323389e-05,0.0,1.0
16666,1~6/Number,4,4,0,4.446124091323389e-05,0.0,1.0
16667,망고/Noun,4,0,4,0.0,4.4427660661527865e-05,1.0
16668,수레/Noun,4,0,4,0.0,4.4427660661527865e-05,1.0
16669,무안/Noun,4,0,4,0.0,4.4427660661527865e-05,1.0
16670,월령/Noun,4,4,0,4.446124091323389e-05,0.0,1.0
16671,픈/Noun,4,4,0,4.446124091323389e-05,0.0,1.0
16672,민속/Noun,4,4,0,4.446124091323389e-05,0.0,1.0
16673,콜린파렐/Noun,4,4,0,4.446124091323389e-05,0.0,1.0
16674,알레고리/Noun,4,0,4,0.0,4.4427660661527865e-05,1.0
16675,섯다/Noun,4,4,0,4.446124091323389e-05,0.0,1.0
16676,8일/Number,4,4,0,4.446124091323389e-05,0.0,1.0
16677,볼프강/Noun,4,4,0,4.446124091323389e-05,0.0,1.0
16678,두부/Noun,4,0,4,0.0,4.4427660661527865e-05,1.0
16679,국군포로/Noun,4,0,4,0.0,4.4427660661527865e-05,1.0
16680,7.3/Number,4,0,4,0.0,4.4427660661527865e-05,1.0
16681,야왕/Noun,4,0,4,0.0,4.4427660661527865e-05,1.0
16682,깅코/Noun,4,0,4,0.0,4.4427660661527865e-05,1.0
16683,심장이뛴다/Noun,4,4,0,4.446124091323389e-05,0.0,1.0
16684,".,.,./Punctuation",4,0,4,0.0,4.4427660661527865e-05,1.0
16685,요따위/Modifier,4,0,4,0.0,4.4427660661527865e-05,1.0
16686,메타/Noun,4,4,0,4.446124091323389e-05,0.0,1.0
16687,랑드/Noun,4,4,0,4.446124091323389e-05,0.0,1.0
16688,세탁/Noun,4,0,4,0.0,4.4427660661527865e-05,1.0
16689,맥가이버/Noun,4,4,0,4.446124091323389e-05,0.0,1.0
16690,종군기자/Noun,4,4,0,4.446124091323389e-05,0.0,1.0
16691,~!~!/Punctuation,4,4,0,4.446124091323389e-05,0.0,1.0
16692,중지/Noun,4,0,4,0.0,4.4427660661527865e-05,1.0
16693,지구과학/Noun,4,4,0,4.446124091323389e-05,0.0,1.0
16694,소개팅/Noun,4,0,4,0.0,4.4427660661527865e-05,1.0
16695,단보/Noun,4,4,0,4.446124091323389e-05,0.0,1.0
16696,꿰어/Noun,4,0,4,0.0,4.4427660661527865e-05,1.0
16697,퓨처라마/Noun,4,4,0,4.446124091323389e-05,0.0,1.0
16698,천외/Noun,4,4,0,4.446124091323389e-05,0.0,1.0
16699,지표/Noun,4,4,0,4.446124091323389e-05,0.0,1.0
16700,찡찡거리다/Verb,4,0,4,0.0,4.4427660661527865e-05,1.0
16701,흉/Noun,4,4,0,4.446124091323389e-05,0.0,1.0
16702,이돈/Noun,4,0,4,0.0,4.4427660661527865e-05,1.0
16703,이발사/Noun,4,0,4,0.0,4.4427660661527865e-05,1.0
16704,넋두리/Noun,4,0,4,0.0,4.4427660661527865e-05,1.0
16705,구면/Noun,4,0,4,0.0,4.4427660661527865e-05,1.0
16706,김공/Noun,4,0,4,0.0,4.4427660661527865e-05,1.0
16707,이경규/Noun,4,0,4,0.0,4.4427660661527865e-05,1.0
16708,카자흐스탄/Noun,4,0,4,0.0,4.4427660661527865e-05,1.0
16709,정하은/Noun,4,0,4,0.0,4.4427660661527865e-05,1.0
16710,환대/Noun,4,4,0,4.446124091323389e-05,0.0,1.0
16711,학도병/Noun,4,4,0,4.446124091323389e-05,0.0,1.0
16712,창가/Noun,4,4,0,4.446124091323389e-05,0.0,1.0
16713,류현진/Noun,4,0,4,0.0,4.4427660661527865e-05,1.0
16714,엮어낸/Noun,4,4,0,4.446124091323389e-05,0.0,1.0
16715,푸념/Noun,4,0,4,0.0,4.4427660661527865e-05,1.0
16716,작이/Foreign,4,0,4,0.0,4.4427660661527865e-05,1.0
16717,창작물/Noun,4,0,4,0.0,4.4427660661527865e-05,1.0
16718,only/Alpha,4,4,0,4.446124091323389e-05,0.0,1.0
16719,앳된/Noun,4,4,0,4.446124091323389e-05,0.0,1.0
16720,담표/Noun,4,0,4,0.0,4.4427660661527865e-05,1.0
16721,소대장/Noun,4,0,4,0.0,4.4427660661527865e-05,1.0
16722,송하윤/Noun,4,4,0,4.446124091323389e-05,0.0,1.0
16723,부지/Noun,4,0,4,0.0,4.4427660661527865e-05,1.0
16724,아득하다/Adjective,4,4,0,4.446124091323389e-05,0.0,1.0
16725,드와이트/Noun,4,4,0,4.446124091323389e-05,0.0,1.0
16726,신선도/Noun,4,0,4,0.0,4.4427660661527865e-05,1.0
16727,로미/Noun,4,4,0,4.446124091323389e-05,0.0,1.0
16728,심혈/Noun,4,4,0,4.446124091323389e-05,0.0,1.0
16729,맘에듭니/Noun,4,4,0,4.446124091323389e-05,0.0,1.0
16730,두만강/Noun,4,4,0,4.446124091323389e-05,0.0,1.0
16731,소녀시절/Noun,4,4,0,4.446124091323389e-05,0.0,1.0
16732,공영/Noun,4,0,4,0.0,4.4427660661527865e-05,1.0
16733,아르헨티나/Noun,4,4,0,4.446124091323389e-05,0.0,1.0
16734,일곱/Noun,4,0,4,0.0,4.4427660661527865e-05,1.0
16735,유한/Noun,4,4,0,4.446124091323389e-05,0.0,1.0
16736,다이노/Noun,4,0,4,0.0,4.4427660661527865e-05,1.0
16737,수니/Noun,4,4,0,4.446124091323389e-05,0.0,1.0
16738,루이/Noun,4,4,0,4.446124091323389e-05,0.0,1.0
16739,ㅆㅅㅌㅊ/KoreanParticle,4,4,0,4.446124091323389e-05,0.0,1.0
16740,옥소리/Noun,4,4,0,4.446124091323389e-05,0.0,1.0
16741,뺴곤/Noun,4,0,4,0.0,4.4427660661527865e-05,1.0
16742,엿같/Noun,4,0,4,0.0,4.4427660661527865e-05,1.0
16743,디어/Noun,4,4,0,4.446124091323389e-05,0.0,1.0
16744,소간/Noun,4,4,0,4.446124091323389e-05,0.0,1.0
16745,아호/Noun,4,0,4,0.0,4.4427660661527865e-05,1.0
16746,스타트랙/Noun,4,4,0,4.446124091323389e-05,0.0,1.0
16747,금욜/Noun,4,4,0,4.446124091323389e-05,0.0,1.0
16748,노팅힐/Noun,4,4,0,4.446124091323389e-05,0.0,1.0
16749,품위/Noun,4,4,0,4.446124091323389e-05,0.0,1.0
16750,).../Punctuation,4,0,4,0.0,4.4427660661527865e-05,1.0
16751,노코멘트/Noun,4,0,4,0.0,4.4427660661527865e-05,1.0
16752,척노리스/Noun,4,4,0,4.446124091323389e-05,0.0,1.0
16753,임진강/Noun,4,4,0,4.446124091323389e-05,0.0,1.0
16754,혼잡하다/Adjective,4,0,4,0.0,4.4427660661527865e-05,1.0
16755,복녀/Noun,4,4,0,4.446124091323389e-05,0.0,1.0
16756,성대현/Noun,4,0,4,0.0,4.4427660661527865e-05,1.0
16757,정설/Noun,4,0,4,0.0,4.4427660661527865e-05,1.0
16758,어흑/Noun,4,4,0,4.446124091323389e-05,0.0,1.0
16759,60%/Number,4,0,4,0.0,4.4427660661527865e-05,1.0
16760,....!!!!/Punctuation,4,4,0,4.446124091323389e-05,0.0,1.0
16761,주홍글씨/Noun,4,0,4,0.0,4.4427660661527865e-05,1.0
16762,흘러내리다/Verb,4,4,0,4.446124091323389e-05,0.0,1.0
16763,일견/Noun,4,4,0,4.446124091323389e-05,0.0,1.0
16764,몇대/Modifier,4,0,4,0.0,4.4427660661527865e-05,1.0
16765,덫/Noun,4,0,4,0.0,4.4427660661527865e-05,1.0
16766,북극곰/Noun,4,4,0,4.446124091323389e-05,0.0,1.0
16767,죽대/Noun,4,0,4,0.0,4.4427660661527865e-05,1.0
16768,치하/Noun,4,4,0,4.446124091323389e-05,0.0,1.0
16769,가족사진/Noun,4,4,0,4.446124091323389e-05,0.0,1.0
16770,탈선/Noun,4,0,4,0.0,4.4427660661527865e-05,1.0
16771,반타작/Noun,4,0,4,0.0,4.4427660661527865e-05,1.0
16772,에네스/Noun,4,0,4,0.0,4.4427660661527865e-05,1.0
16773,탈락자/Noun,4,0,4,0.0,4.4427660661527865e-05,1.0
16774,아마데우스/Noun,4,4,0,4.446124091323389e-05,0.0,1.0
16775,조웅/Noun,4,0,4,0.0,4.4427660661527865e-05,1.0
16776,경호원/Noun,4,0,4,0.0,4.4427660661527865e-05,1.0
16777,아이젠/Noun,4,4,0,4.446124091323389e-05,0.0,1.0
16778,라시오/Noun,4,4,0,4.446124091323389e-05,0.0,1.0
16779,렌즈/Noun,4,0,4,0.0,4.4427660661527865e-05,1.0
16780,차라/Noun,4,0,4,0.0,4.4427660661527865e-05,1.0
16781,새누리당/Noun,4,0,4,0.0,4.4427660661527865e-05,1.0
16782,중도하차/Noun,4,0,4,0.0,4.4427660661527865e-05,1.0
16783,홀리랜드/Noun,4,0,4,0.0,4.4427660661527865e-05,1.0
16784,법석/Noun,4,0,4,0.0,4.4427660661527865e-05,1.0
16785,마르코/Noun,4,4,0,4.446124091323389e-05,0.0,1.0
16786,꼬아놓/Noun,4,0,4,0.0,4.4427660661527865e-05,1.0
16787,양쿠미/Noun,4,4,0,4.446124091323389e-05,0.0,1.0
16788,외제차/Noun,4,0,4,0.0,4.4427660661527865e-05,1.0
16789,테넌트/Noun,4,4,0,4.446124091323389e-05,0.0,1.0
16790,여진/Noun,4,4,0,4.446124091323389e-05,0.0,1.0
16791,구경만/Noun,4,0,4,0.0,4.4427660661527865e-05,1.0
16792,화팅/Noun,4,4,0,4.446124091323389e-05,0.0,1.0
16793,사공/Noun,4,0,4,0.0,4.4427660661527865e-05,1.0
16794,눈꼽만치/Noun,4,0,4,0.0,4.4427660661527865e-05,1.0
16795,...*_*/Punctuation,4,4,0,4.446124091323389e-05,0.0,1.0
16796,초장/Noun,4,0,4,0.0,4.4427660661527865e-05,1.0
16797,얼토당토않다/Adjective,4,0,4,0.0,4.4427660661527865e-05,1.0
16798,음란물/Noun,4,0,4,0.0,4.4427660661527865e-05,1.0
16799,나토/Noun,4,4,0,4.446124091323389e-05,0.0,1.0
16800,섬짓/Noun,4,4,0,4.446124091323389e-05,0.0,1.0
16801,청산가리/Noun,4,0,4,0.0,4.4427660661527865e-05,1.0
16802,햅번/Noun,4,4,0,4.446124091323389e-05,0.0,1.0
16803,수건/Noun,4,0,4,0.0,4.4427660661527865e-05,1.0
16804,액트/Noun,4,0,4,0.0,4.4427660661527865e-05,1.0
16805,반절/Noun,4,0,4,0.0,4.4427660661527865e-05,1.0
16806,LG/Alpha,4,0,4,0.0,4.4427660661527865e-05,1.0
16807,이퀄리브리엄/Noun,4,0,4,0.0,4.4427660661527865e-05,1.0
16808,비디오게임/Noun,4,4,0,4.446124091323389e-05,0.0,1.0
16809,쿵쾅거리다/Verb,4,4,0,4.446124091323389e-05,0.0,1.0
16810,16분/Number,4,0,4,0.0,4.4427660661527865e-05,1.0
16811,첫째/Modifier,4,4,0,4.446124091323389e-05,0.0,1.0
16812,if/Alpha,4,4,0,4.446124091323389e-05,0.0,1.0
16813,시진핑/Noun,4,0,4,0.0,4.4427660661527865e-05,1.0
16814,뚝딱/Noun,4,0,4,0.0,4.4427660661527865e-05,1.0
16815,하휘동/Noun,4,0,4,0.0,4.4427660661527865e-05,1.0
16816,랄것/Noun,4,0,4,0.0,4.4427660661527865e-05,1.0
16817,할로우/Noun,4,0,4,0.0,4.4427660661527865e-05,1.0
16818,노크/Noun,4,0,4,0.0,4.4427660661527865e-05,1.0
16819,착착/Noun,4,4,0,4.446124091323389e-05,0.0,1.0
16820,태국인/Noun,4,0,4,0.0,4.4427660661527865e-05,1.0
16821,호준/Noun,4,4,0,4.446124091323389e-05,0.0,1.0
16822,연석/Noun,4,4,0,4.446124091323389e-05,0.0,1.0
16823,창시자/Noun,4,0,4,0.0,4.4427660661527865e-05,1.0
16824,가라데/Noun,4,0,4,0.0,4.4427660661527865e-05,1.0
16825,이지스함/Noun,4,0,4,0.0,4.4427660661527865e-05,1.0
16826,픽업/Noun,4,0,4,0.0,4.4427660661527865e-05,1.0
16827,분풀이/Noun,4,0,4,0.0,4.4427660661527865e-05,1.0
16828,욘/Noun,4,4,0,4.446124091323389e-05,0.0,1.0
16829,에린/Noun,4,4,0,4.446124091323389e-05,0.0,1.0
16830,kt/Alpha,4,0,4,0.0,4.4427660661527865e-05,1.0
16831,가면라이더/Noun,4,0,4,0.0,4.4427660661527865e-05,1.0
16832,명드/Noun,4,4,0,4.446124091323389e-05,0.0,1.0
16833,달라이라마/Noun,4,4,0,4.446124091323389e-05,0.0,1.0
16834,오비완/Noun,4,4,0,4.446124091323389e-05,0.0,1.0
16835,이든지/Josa,4,0,4,0.0,4.4427660661527865e-05,1.0
16836,몬드/Noun,4,4,0,4.446124091323389e-05,0.0,1.0
16837,돌풍/Noun,4,4,0,4.446124091323389e-05,0.0,1.0
16838,홀린/Noun,4,4,0,4.446124091323389e-05,0.0,1.0
16839,오취/Noun,4,0,4,0.0,4.4427660661527865e-05,1.0
16840,카다/Noun,4,0,4,0.0,4.4427660661527865e-05,1.0
16841,엔돌핀/Noun,4,4,0,4.446124091323389e-05,0.0,1.0
16842,이소재/Noun,4,0,4,0.0,4.4427660661527865e-05,1.0
16843,잠수/Noun,4,0,4,0.0,4.4427660661527865e-05,1.0
16844,잡아가다/Verb,4,0,4,0.0,4.4427660661527865e-05,1.0
16845,-_-^/Punctuation,4,0,4,0.0,4.4427660661527865e-05,1.0
16846,열두/Modifier,4,0,4,0.0,4.4427660661527865e-05,1.0
16847,슬펏음/Noun,4,4,0,4.446124091323389e-05,0.0,1.0
16848,pm/Alpha,4,4,0,4.446124091323389e-05,0.0,1.0
16849,맹룡과강/Noun,4,4,0,4.446124091323389e-05,0.0,1.0
16850,설설/Noun,4,0,4,0.0,4.4427660661527865e-05,1.0
16851,궁지/Noun,4,4,0,4.446124091323389e-05,0.0,1.0
16852,코로/Noun,4,0,4,0.0,4.4427660661527865e-05,1.0
16853,마르셀/Noun,4,4,0,4.446124091323389e-05,0.0,1.0
16854,순진무구/Noun,4,4,0,4.446124091323389e-05,0.0,1.0
16855,유카/Noun,4,4,0,4.446124091323389e-05,0.0,1.0
16856,손익/Noun,4,0,4,0.0,4.4427660661527865e-05,1.0
16857,핍박하다/Adjective,4,0,4,0.0,4.4427660661527865e-05,1.0
16858,아모레/Noun,4,4,0,4.446124091323389e-05,0.0,1.0
16859,round/Alpha,4,0,4,0.0,4.4427660661527865e-05,1.0
16860,갈매기/Noun,4,4,0,4.446124091323389e-05,0.0,1.0
16861,남구/Noun,4,4,0,4.446124091323389e-05,0.0,1.0
16862,버닝/Noun,4,4,0,4.446124091323389e-05,0.0,1.0
16863,삼은/Noun,4,0,4,0.0,4.4427660661527865e-05,1.0
16864,1997/Number,4,4,0,4.446124091323389e-05,0.0,1.0
16865,정경/Noun,4,4,0,4.446124091323389e-05,0.0,1.0
16866,덤비다/Verb,4,0,4,0.0,4.4427660661527865e-05,1.0
16867,출세/Noun,4,0,4,0.0,4.4427660661527865e-05,1.0
16868,뻔뻔스럽다/Adjective,4,0,4,0.0,4.4427660661527865e-05,1.0
16869,명성황후/Noun,4,0,4,0.0,4.4427660661527865e-05,1.0
16870,최원영/Noun,4,4,0,4.446124091323389e-05,0.0,1.0
16871,^^;;;/Punctuation,4,0,4,0.0,4.4427660661527865e-05,1.0
16872,정운택/Noun,4,0,4,0.0,4.4427660661527865e-05,1.0
16873,부스러기/Noun,4,0,4,0.0,4.4427660661527865e-05,1.0
16874,해죽/Noun,4,0,4,0.0,4.4427660661527865e-05,1.0
16875,20일/Number,4,4,0,4.446124091323389e-05,0.0,1.0
16876,떫/Noun,4,0,4,0.0,4.4427660661527865e-05,1.0
16877,증상/Noun,4,0,4,0.0,4.4427660661527865e-05,1.0
16878,혜수/Noun,4,4,0,4.446124091323389e-05,0.0,1.0
16879,대도/Foreign,4,0,4,0.0,4.4427660661527865e-05,1.0
16880,57/Number,4,0,4,0.0,4.4427660661527865e-05,1.0
16881,성대모사/Noun,4,0,4,0.0,4.4427660661527865e-05,1.0
16882,설렁설렁/Adverb,4,0,4,0.0,4.4427660661527865e-05,1.0
16883,황금시간대/Noun,4,0,4,0.0,4.4427660661527865e-05,1.0
16884,썽/Noun,4,4,0,4.446124091323389e-05,0.0,1.0
16885,충무공/Noun,4,0,4,0.0,4.4427660661527865e-05,1.0
16886,디디/Noun,4,4,0,4.446124091323389e-05,0.0,1.0
16887,이라든지/Josa,4,0,4,0.0,4.4427660661527865e-05,1.0
16888,two/Alpha,4,4,0,4.446124091323389e-05,0.0,1.0
16889,나이라/Noun,4,4,0,4.446124091323389e-05,0.0,1.0
16890,집약/Noun,4,4,0,4.446124091323389e-05,0.0,1.0
16891,콩가/Noun,4,0,4,0.0,4.4427660661527865e-05,1.0
16892,말빨/Noun,4,4,0,4.446124091323389e-05,0.0,1.0
16893,;;?/Punctuation,4,0,4,0.0,4.4427660661527865e-05,1.0
16894,고이즈미/Noun,4,0,4,0.0,4.4427660661527865e-05,1.0
16895,르네/Noun,4,4,0,4.446124091323389e-05,0.0,1.0
16896,랜디/Noun,4,4,0,4.446124091323389e-05,0.0,1.0
16897,로튼/Noun,4,0,4,0.0,4.4427660661527865e-05,1.0
16898,뒤로/Noun,4,4,0,4.446124091323389e-05,0.0,1.0
16899,사계절/Noun,4,4,0,4.446124091323389e-05,0.0,1.0
16900,없드/Noun,4,0,4,0.0,4.4427660661527865e-05,1.0
16901,팻/Noun,4,4,0,4.446124091323389e-05,0.0,1.0
16902,악도/Noun,4,4,0,4.446124091323389e-05,0.0,1.0
16903,이집/Noun,4,0,4,0.0,4.4427660661527865e-05,1.0
16904,최공/Noun,4,4,0,4.446124091323389e-05,0.0,1.0
16905,샷건/Noun,4,0,4,0.0,4.4427660661527865e-05,1.0
16906,촌극/Noun,4,0,4,0.0,4.4427660661527865e-05,1.0
16907,억측/Noun,4,0,4,0.0,4.4427660661527865e-05,1.0
16908,팬픽/Noun,4,0,4,0.0,4.4427660661527865e-05,1.0
16909,0.3/Number,4,0,4,0.0,4.4427660661527865e-05,1.0
16910,신나요/Noun,4,4,0,4.446124091323389e-05,0.0,1.0
16911,깝치/Noun,4,0,4,0.0,4.4427660661527865e-05,1.0
16912,레골라스/Noun,4,4,0,4.446124091323389e-05,0.0,1.0
16913,이글아이/Noun,4,0,4,0.0,4.4427660661527865e-05,1.0
16914,걸표/Noun,4,0,4,0.0,4.4427660661527865e-05,1.0
16915,가축/Noun,4,4,0,4.446124091323389e-05,0.0,1.0
16916,패착/Noun,4,0,4,0.0,4.4427660661527865e-05,1.0
16917,목말/Noun,4,4,0,4.446124091323389e-05,0.0,1.0
16918,스티브유/Noun,4,0,4,0.0,4.4427660661527865e-05,1.0
16919,유야/Noun,4,4,0,4.446124091323389e-05,0.0,1.0
16920,쫄아/Noun,4,0,4,0.0,4.4427660661527865e-05,1.0
16921,국한/Noun,4,4,0,4.446124091323389e-05,0.0,1.0
16922,반동/Noun,4,0,4,0.0,4.4427660661527865e-05,1.0
16923,껄렁/Adverb,4,0,4,0.0,4.4427660661527865e-05,1.0
16924,알프/Noun,4,4,0,4.446124091323389e-05,0.0,1.0
16925,카프/Noun,4,4,0,4.446124091323389e-05,0.0,1.0
16926,~~~~~~~~~~~~/Punctuation,4,4,0,4.446124091323389e-05,0.0,1.0
16927,톱니바퀴/Noun,4,4,0,4.446124091323389e-05,0.0,1.0
16928,테닥/Noun,4,4,0,4.446124091323389e-05,0.0,1.0
16929,33년/Number,4,0,4,0.0,4.4427660661527865e-05,1.0
16930,착상/Noun,4,0,4,0.0,4.4427660661527865e-05,1.0
16931,풍비박산/Noun,4,0,4,0.0,4.4427660661527865e-05,1.0
16932,강서연/Noun,4,0,4,0.0,4.4427660661527865e-05,1.0
16933,곰곰하다/Adjective,4,4,0,4.446124091323389e-05,0.0,1.0
16934,박해/Noun,4,4,0,4.446124091323389e-05,0.0,1.0
16935,옥한흠/Noun,4,4,0,4.446124091323389e-05,0.0,1.0
16936,대에나/Foreign,4,0,4,0.0,4.4427660661527865e-05,1.0
16937,만들엇을까/Noun,4,0,4,0.0,4.4427660661527865e-05,1.0
16938,ㅠㅅㅠ/KoreanParticle,4,4,0,4.446124091323389e-05,0.0,1.0
16939,..--;/Punctuation,4,0,4,0.0,4.4427660661527865e-05,1.0
16940,똥꾸/Noun,4,0,4,0.0,4.4427660661527865e-05,1.0
16941,불도/Noun,4,0,4,0.0,4.4427660661527865e-05,1.0
16942,엘리펀트/Noun,4,4,0,4.446124091323389e-05,0.0,1.0
16943,욀케/Noun,4,4,0,4.446124091323389e-05,0.0,1.0
16944,바나/Noun,4,4,0,4.446124091323389e-05,0.0,1.0
16945,노땅/Noun,4,0,4,0.0,4.4427660661527865e-05,1.0
16946,마루타/Noun,4,0,4,0.0,4.4427660661527865e-05,1.0
16947,대쉬/Noun,4,0,4,0.0,4.4427660661527865e-05,1.0
16948,빅엿/Noun,4,0,4,0.0,4.4427660661527865e-05,1.0
16949,강재/Noun,4,4,0,4.446124091323389e-05,0.0,1.0
16950,해투/Noun,4,0,4,0.0,4.4427660661527865e-05,1.0
16951,겁쟁이/Noun,4,4,0,4.446124091323389e-05,0.0,1.0
16952,액자/Noun,4,4,0,4.446124091323389e-05,0.0,1.0
16953,우희/Noun,4,4,0,4.446124091323389e-05,0.0,1.0
16954,got/Alpha,4,4,0,4.446124091323389e-05,0.0,1.0
16955,무속인/Noun,4,0,4,0.0,4.4427660661527865e-05,1.0
16956,".,.,.,/Punctuation",4,0,4,0.0,4.4427660661527865e-05,1.0
16957,china/Alpha,4,0,4,0.0,4.4427660661527865e-05,1.0
16958,꼽자/Noun,4,4,0,4.446124091323389e-05,0.0,1.0
16959,",?/Punctuation",4,0,4,0.0,4.4427660661527865e-05,1.0
16960,게이바/Noun,4,0,4,0.0,4.4427660661527865e-05,1.0
16961,만호/Noun,4,4,0,4.446124091323389e-05,0.0,1.0
16962,강동/Noun,4,4,0,4.446124091323389e-05,0.0,1.0
16963,겸손/Noun,4,4,0,4.446124091323389e-05,0.0,1.0
16964,정철/Noun,4,4,0,4.446124091323389e-05,0.0,1.0
16965,어인/Modifier,4,0,4,0.0,4.4427660661527865e-05,1.0
16966,으루/Noun,4,0,4,0.0,4.4427660661527865e-05,1.0
16967,완전체/Noun,4,4,0,4.446124091323389e-05,0.0,1.0
16968,검심/Noun,4,4,0,4.446124091323389e-05,0.0,1.0
16969,까지야/Josa,4,0,4,0.0,4.4427660661527865e-05,1.0
16970,하연수/Noun,4,4,0,4.446124091323389e-05,0.0,1.0
16971,생리/Noun,4,4,0,4.446124091323389e-05,0.0,1.0
16972,좋았슴/Noun,4,4,0,4.446124091323389e-05,0.0,1.0
16973,오뚜기/Noun,4,0,4,0.0,4.4427660661527865e-05,1.0
16974,Bravo/Alpha,4,4,0,4.446124091323389e-05,0.0,1.0
16975,성도착/Noun,4,0,4,0.0,4.4427660661527865e-05,1.0
16976,한동/Noun,4,4,0,4.446124091323389e-05,0.0,1.0
16977,소규모/Noun,4,0,4,0.0,4.4427660661527865e-05,1.0
16978,명나라/Noun,4,0,4,0.0,4.4427660661527865e-05,1.0
16979,~!!^^/Punctuation,4,4,0,4.446124091323389e-05,0.0,1.0
16980,테루/Noun,4,4,0,4.446124091323389e-05,0.0,1.0
16981,씨댕/Noun,4,0,4,0.0,4.4427660661527865e-05,1.0
16982,김지미/Noun,4,4,0,4.446124091323389e-05,0.0,1.0
16983,드웨/Noun,4,0,4,0.0,4.4427660661527865e-05,1.0
16984,엠넷/Noun,4,0,4,0.0,4.4427660661527865e-05,1.0
16985,심사평/Noun,4,0,4,0.0,4.4427660661527865e-05,1.0
16986,기성세대/Noun,4,4,0,4.446124091323389e-05,0.0,1.0
16987,goood/Alpha,4,4,0,4.446124091323389e-05,0.0,1.0
16988,셀룰러/Noun,4,0,4,0.0,4.4427660661527865e-05,1.0
16989,울컥울컥/Adverb,4,4,0,4.446124091323389e-05,0.0,1.0
16990,고나은/Noun,4,0,4,0.0,4.4427660661527865e-05,1.0
16991,어슬프/Noun,4,0,4,0.0,4.4427660661527865e-05,1.0
16992,날/Foreign,4,0,4,0.0,4.4427660661527865e-05,1.0
16993,회보/Noun,4,4,0,4.446124091323389e-05,0.0,1.0
16994,슈퍼배드/Noun,4,4,0,4.446124091323389e-05,0.0,1.0
16995,삭발/Noun,4,0,4,0.0,4.4427660661527865e-05,1.0
16996,완다/Noun,4,4,0,4.446124091323389e-05,0.0,1.0
16997,야합/Noun,4,0,4,0.0,4.4427660661527865e-05,1.0
16998,아릿하다/Adjective,4,4,0,4.446124091323389e-05,0.0,1.0
16999,이승환/Noun,4,4,0,4.446124091323389e-05,0.0,1.0
17000,치루/Noun,4,4,0,4.446124091323389e-05,0.0,1.0
17001,야훼/Noun,4,0,4,0.0,4.4427660661527865e-05,1.0
17002,▽/Foreign,4,4,0,4.446124091323389e-05,0.0,1.0
17003,히피/Noun,4,4,0,4.446124091323389e-05,0.0,1.0
17004,독실하다/Adjective,4,0,4,0.0,4.4427660661527865e-05,1.0
17005,파렴치하다/Adjective,4,0,4,0.0,4.4427660661527865e-05,1.0
17006,사기영화/Noun,4,0,4,0.0,4.4427660661527865e-05,1.0
17007,효효효/Noun,4,0,4,0.0,4.4427660661527865e-05,1.0
17008,전혜진/Noun,4,0,4,0.0,4.4427660661527865e-05,1.0
17009,펜대/Noun,4,0,4,0.0,4.4427660661527865e-05,1.0
17010,모히칸/Noun,4,4,0,4.446124091323389e-05,0.0,1.0
17011,글러/Noun,4,0,4,0.0,4.4427660661527865e-05,1.0
17012,정민/Noun,4,4,0,4.446124091323389e-05,0.0,1.0
17013,영홥/Noun,4,0,4,0.0,4.4427660661527865e-05,1.0
17014,돌직구/Noun,4,4,0,4.446124091323389e-05,0.0,1.0
17015,♥♥♥♥♥♥/Foreign,4,4,0,4.446124091323389e-05,0.0,1.0
17016,씨알/Noun,4,0,4,0.0,4.4427660661527865e-05,1.0
17017,여성향/Noun,4,0,4,0.0,4.4427660661527865e-05,1.0
17018,우상화/Noun,4,0,4,0.0,4.4427660661527865e-05,1.0
17019,천박/Noun,4,0,4,0.0,4.4427660661527865e-05,1.0
17020,썻는/Noun,4,0,4,0.0,4.4427660661527865e-05,1.0
17021,글쌔/Noun,4,0,4,0.0,4.4427660661527865e-05,1.0
17022,꺽꺽/Noun,4,4,0,4.446124091323389e-05,0.0,1.0
17023,La/Alpha,4,4,0,4.446124091323389e-05,0.0,1.0
17024,부동/Noun,4,0,4,0.0,4.4427660661527865e-05,1.0
17025,독신/Noun,4,0,4,0.0,4.4427660661527865e-05,1.0
17026,승하/Noun,4,4,0,4.446124091323389e-05,0.0,1.0
17027,뮤직뱅크/Noun,4,0,4,0.0,4.4427660661527865e-05,1.0
17028,몸둘/Noun,4,0,4,0.0,4.4427660661527865e-05,1.0
17029,도취/Noun,4,0,4,0.0,4.4427660661527865e-05,1.0
17030,...^^;/Punctuation,4,4,0,4.446124091323389e-05,0.0,1.0
17031,최약/Noun,4,0,4,0.0,4.4427660661527865e-05,1.0
17032,수요일/Noun,4,4,0,4.446124091323389e-05,0.0,1.0
17033,초등생/Noun,4,0,4,0.0,4.4427660661527865e-05,1.0
17034,웃낌/Noun,4,4,0,4.446124091323389e-05,0.0,1.0
17035,빨아들이다/Verb,4,4,0,4.446124091323389e-05,0.0,1.0
17036,파리스/Noun,4,4,0,4.446124091323389e-05,0.0,1.0
17037,김춘추/Noun,4,0,4,0.0,4.4427660661527865e-05,1.0
17038,유랑/Noun,4,0,4,0.0,4.4427660661527865e-05,1.0
17039,Wow/Alpha,4,4,0,4.446124091323389e-05,0.0,1.0
17040,실베스터/Noun,4,4,0,4.446124091323389e-05,0.0,1.0
17041,봣습/Noun,4,4,0,4.446124091323389e-05,0.0,1.0
17042,재및/Noun,4,4,0,4.446124091323389e-05,0.0,1.0
17043,dead/Alpha,4,0,4,0.0,4.4427660661527865e-05,1.0
17044,배분/Noun,4,0,4,0.0,4.4427660661527865e-05,1.0
17045,학구/Noun,4,4,0,4.446124091323389e-05,0.0,1.0
17046,험프리/Noun,4,4,0,4.446124091323389e-05,0.0,1.0
17047,박순희/Noun,4,0,4,0.0,4.4427660661527865e-05,1.0
17048,머겅다/Verb,4,0,4,0.0,4.4427660661527865e-05,1.0
17049,생수/Noun,4,0,4,0.0,4.4427660661527865e-05,1.0
17050,완성형/Noun,4,4,0,4.446124091323389e-05,0.0,1.0
17051,일본말/Noun,4,0,4,0.0,4.4427660661527865e-05,1.0
17052,가랑이/Noun,4,0,4,0.0,4.4427660661527865e-05,1.0
17053,불행중/Noun,4,0,4,0.0,4.4427660661527865e-05,1.0
17054,찌릿/Noun,4,4,0,4.446124091323389e-05,0.0,1.0
17055,메롱/Noun,4,0,4,0.0,4.4427660661527865e-05,1.0
17056,대용/Noun,4,0,4,0.0,4.4427660661527865e-05,1.0
17057,케나/Noun,4,0,4,0.0,4.4427660661527865e-05,1.0
17058,....-_-/Punctuation,4,0,4,0.0,4.4427660661527865e-05,1.0
17059,Blockbuster/Alpha,4,4,0,4.446124091323389e-05,0.0,1.0
17060,해피해피/Noun,4,0,4,0.0,4.4427660661527865e-05,1.0
17061,퇴행/Noun,4,0,4,0.0,4.4427660661527865e-05,1.0
17062,광속/Noun,4,0,4,0.0,4.4427660661527865e-05,1.0
17063,2.0/Number,4,0,4,0.0,4.4427660661527865e-05,1.0
17064,밧슈/Noun,4,4,0,4.446124091323389e-05,0.0,1.0
17065,Life/Alpha,4,4,0,4.446124091323389e-05,0.0,1.0
17066,깜둥이/Noun,4,0,4,0.0,4.4427660661527865e-05,1.0
17067,체코/Noun,4,4,0,4.446124091323389e-05,0.0,1.0
17068,배낌/Noun,4,0,4,0.0,4.4427660661527865e-05,1.0
17069,수색대/Noun,4,0,4,0.0,4.4427660661527865e-05,1.0
17070,잘라먹다/Verb,4,0,4,0.0,4.4427660661527865e-05,1.0
17071,이하일/Noun,4,0,4,0.0,4.4427660661527865e-05,1.0
17072,강문/Noun,4,4,0,4.446124091323389e-05,0.0,1.0
17073,보답/Noun,4,4,0,4.446124091323389e-05,0.0,1.0
17074,푸드/Noun,4,4,0,4.446124091323389e-05,0.0,1.0
17075,DDR/Alpha,4,0,4,0.0,4.4427660661527865e-05,1.0
17076,관영/Noun,4,0,4,0.0,4.4427660661527865e-05,1.0
17077,아스트랄/Noun,4,0,4,0.0,4.4427660661527865e-05,1.0
17078,권오중/Noun,4,0,4,0.0,4.4427660661527865e-05,1.0
17079,윤숙/Noun,4,4,0,4.446124091323389e-05,0.0,1.0
17080,조두순/Noun,4,4,0,4.446124091323389e-05,0.0,1.0
17081,도의/Foreign,4,4,0,4.446124091323389e-05,0.0,1.0
17082,풍도/Noun,4,0,4,0.0,4.4427660661527865e-05,1.0
17083,오딘/Noun,4,0,4,0.0,4.4427660661527865e-05,1.0
17084,담하다/Adjective,4,0,4,0.0,4.4427660661527865e-05,1.0
17085,평해/Noun,4,0,4,0.0,4.4427660661527865e-05,1.0
17086,이외수/Noun,4,0,4,0.0,4.4427660661527865e-05,1.0
17087,캄캄하다/Adjective,4,0,4,0.0,4.4427660661527865e-05,1.0
17088,스즈미/Noun,4,4,0,4.446124091323389e-05,0.0,1.0
17089,에이전트/Noun,4,0,4,0.0,4.4427660661527865e-05,1.0
17090,조페시/Noun,4,4,0,4.446124091323389e-05,0.0,1.0
17091,꺼림칙하다/Adjective,4,0,4,0.0,4.4427660661527865e-05,1.0
17092,무뇌아/Noun,4,0,4,0.0,4.4427660661527865e-05,1.0
17093,부감/Noun,4,4,0,4.446124091323389e-05,0.0,1.0
17094,로류/Noun,4,0,4,0.0,4.4427660661527865e-05,1.0
17095,강은비/Noun,4,0,4,0.0,4.4427660661527865e-05,1.0
17096,김보라/Noun,4,4,0,4.446124091323389e-05,0.0,1.0
17097,변죽/Noun,4,0,4,0.0,4.4427660661527865e-05,1.0
17098,보루/Noun,4,4,0,4.446124091323389e-05,0.0,1.0
17099,아가페/Noun,4,4,0,4.446124091323389e-05,0.0,1.0
17100,페지/Noun,4,0,4,0.0,4.4427660661527865e-05,1.0
17101,행해/Noun,4,4,0,4.446124091323389e-05,0.0,1.0
17102,정주/Noun,4,4,0,4.446124091323389e-05,0.0,1.0
17103,유호/Noun,4,0,4,0.0,4.4427660661527865e-05,1.0
17104,째즈/Noun,4,4,0,4.446124091323389e-05,0.0,1.0
17105,검프/Noun,4,4,0,4.446124091323389e-05,0.0,1.0
17106,제니/Noun,4,4,0,4.446124091323389e-05,0.0,1.0
17107,너비/Noun,4,4,0,4.446124091323389e-05,0.0,1.0
17108,수배/Noun,4,0,4,0.0,4.4427660661527865e-05,1.0
17109,프란시스/Noun,4,0,4,0.0,4.4427660661527865e-05,1.0
17110,으웩/Noun,4,0,4,0.0,4.4427660661527865e-05,1.0
17111,메리포핀스/Noun,4,4,0,4.446124091323389e-05,0.0,1.0
17112,창자/Noun,4,0,4,0.0,4.4427660661527865e-05,1.0
17113,멌/Noun,4,4,0,4.446124091323389e-05,0.0,1.0
17114,콜롬비아나/Noun,4,0,4,0.0,4.4427660661527865e-05,1.0
17115,자업자득/Noun,4,0,4,0.0,4.4427660661527865e-05,1.0
17116,윤승아/Noun,4,0,4,0.0,4.4427660661527865e-05,1.0
17117,카일/Noun,4,4,0,4.446124091323389e-05,0.0,1.0
17118,카와이/Noun,4,4,0,4.446124091323389e-05,0.0,1.0
17119,개낚였/Noun,4,0,4,0.0,4.4427660661527865e-05,1.0
17120,지해/Noun,4,0,4,0.0,4.4427660661527865e-05,1.0
17121,팅팅/Noun,4,4,0,4.446124091323389e-05,0.0,1.0
17122,때봣/Noun,4,4,0,4.446124091323389e-05,0.0,1.0
17123,이지나도/Foreign,4,4,0,4.446124091323389e-05,0.0,1.0
17124,서버/Noun,4,4,0,4.446124091323389e-05,0.0,1.0
17125,불순/Noun,4,0,4,0.0,4.4427660661527865e-05,1.0
17126,스티플러/Noun,4,4,0,4.446124091323389e-05,0.0,1.0
17127,주력/Noun,4,0,4,0.0,4.4427660661527865e-05,1.0
17128,트림/Noun,4,0,4,0.0,4.4427660661527865e-05,1.0
17129,임금님/Noun,4,0,4,0.0,4.4427660661527865e-05,1.0
17130,흐트러/Noun,4,0,4,0.0,4.4427660661527865e-05,1.0
17131,추정/Noun,4,4,0,4.446124091323389e-05,0.0,1.0
17132,교만하다/Adjective,4,0,4,0.0,4.4427660661527865e-05,1.0
17133,억울/Noun,4,0,4,0.0,4.4427660661527865e-05,1.0
17134,인민군/Noun,4,0,4,0.0,4.4427660661527865e-05,1.0
17135,판도라/Noun,4,0,4,0.0,4.4427660661527865e-05,1.0
17136,설산/Noun,4,4,0,4.446124091323389e-05,0.0,1.0
17137,무에타이/Noun,4,0,4,0.0,4.4427660661527865e-05,1.0
17138,훌룡하/Noun,4,4,0,4.446124091323389e-05,0.0,1.0
17139,!!!!!!!!!!!!!!!!!!/Punctuation,4,4,0,4.446124091323389e-05,0.0,1.0
17140,엇다/Noun,4,0,4,0.0,4.4427660661527865e-05,1.0
17141,뻔뻔/Noun,4,0,4,0.0,4.4427660661527865e-05,1.0
17142,근간/Noun,4,4,0,4.446124091323389e-05,0.0,1.0
17143,인치/Noun,4,4,0,4.446124091323389e-05,0.0,1.0
17144,sad/Alpha,4,4,0,4.446124091323389e-05,0.0,1.0
17145,용팔이/Noun,4,4,0,4.446124091323389e-05,0.0,1.0
17146,송창의/Noun,4,4,0,4.446124091323389e-05,0.0,1.0
17147,요동치다/Verb,4,4,0,4.446124091323389e-05,0.0,1.0
17148,초식/Noun,4,4,0,4.446124091323389e-05,0.0,1.0
17149,슷/Noun,4,0,4,0.0,4.4427660661527865e-05,1.0
17150,쫄깃해/Noun,4,4,0,4.446124091323389e-05,0.0,1.0
17151,철면피/Noun,4,0,4,0.0,4.4427660661527865e-05,1.0
17152,텔링/Noun,4,0,4,0.0,4.4427660661527865e-05,1.0
17153,체육관/Noun,4,0,4,0.0,4.4427660661527865e-05,1.0
17154,채피/Noun,4,4,0,4.446124091323389e-05,0.0,1.0
17155,시스터/Noun,4,0,4,0.0,4.4427660661527865e-05,1.0
17156,이민/Noun,4,4,0,4.446124091323389e-05,0.0,1.0
17157,모씨/Noun,4,0,4,0.0,4.4427660661527865e-05,1.0
17158,섹슈얼/Noun,4,0,4,0.0,4.4427660661527865e-05,1.0
17159,30일/Number,4,0,4,0.0,4.4427660661527865e-05,1.0
17160,돈맛/Noun,4,0,4,0.0,4.4427660661527865e-05,1.0
17161,천사몽/Noun,4,0,4,0.0,4.4427660661527865e-05,1.0
17162,잼썻음/Noun,4,4,0,4.446124091323389e-05,0.0,1.0
17163,무마/Noun,4,0,4,0.0,4.4427660661527865e-05,1.0
17164,기물/Noun,4,0,4,0.0,4.4427660661527865e-05,1.0
17165,유딩때/Noun,4,4,0,4.446124091323389e-05,0.0,1.0
17166,얼버무리다/Verb,4,0,4,0.0,4.4427660661527865e-05,1.0
17167,염원/Noun,4,4,0,4.446124091323389e-05,0.0,1.0
17168,형수/Noun,4,0,4,0.0,4.4427660661527865e-05,1.0
17169,정갈하다/Adjective,4,4,0,4.446124091323389e-05,0.0,1.0
17170,네임드/Noun,4,0,4,0.0,4.4427660661527865e-05,1.0
17171,객기/Noun,4,0,4,0.0,4.4427660661527865e-05,1.0
17172,WTF/Alpha,4,0,4,0.0,4.4427660661527865e-05,1.0
17173,갤럭투스/Noun,4,0,4,0.0,4.4427660661527865e-05,1.0
17174,우진/Noun,4,4,0,4.446124091323389e-05,0.0,1.0
17175,하우/Adverb,4,0,4,0.0,4.4427660661527865e-05,1.0
17176,내나라/Noun,4,0,4,0.0,4.4427660661527865e-05,1.0
17177,밨습니/Noun,4,4,0,4.446124091323389e-05,0.0,1.0
17178,프롯/Noun,4,4,0,4.446124091323389e-05,0.0,1.0
17179,달빛/Noun,4,4,0,4.446124091323389e-05,0.0,1.0
17180,짤리/Noun,4,0,4,0.0,4.4427660661527865e-05,1.0
17181,수줍다/Adjective,4,4,0,4.446124091323389e-05,0.0,1.0
17182,더지니어스/Noun,4,4,0,4.446124091323389e-05,0.0,1.0
17183,개봉시/Noun,4,4,0,4.446124091323389e-05,0.0,1.0
17184,전래/Noun,4,0,4,0.0,4.4427660661527865e-05,1.0
17185,!^/Punctuation,4,4,0,4.446124091323389e-05,0.0,1.0
17186,인턴/Noun,4,4,0,4.446124091323389e-05,0.0,1.0
17187,임시완/Noun,4,4,0,4.446124091323389e-05,0.0,1.0
17188,유서/Noun,4,4,0,4.446124091323389e-05,0.0,1.0
17189,젓가락/Noun,4,0,4,0.0,4.4427660661527865e-05,1.0
17190,포착/Noun,4,4,0,4.446124091323389e-05,0.0,1.0
17191,개인정보/Noun,4,0,4,0.0,4.4427660661527865e-05,1.0
17192,홈페이지/Noun,4,0,4,0.0,4.4427660661527865e-05,1.0
17193,데브/Noun,4,4,0,4.446124091323389e-05,0.0,1.0
17194,히드라/Noun,4,0,4,0.0,4.4427660661527865e-05,1.0
17195,혐의/Noun,4,0,4,0.0,4.4427660661527865e-05,1.0
17196,0.1%/Number,4,0,4,0.0,4.4427660661527865e-05,1.0
17197,.^^*/Punctuation,4,4,0,4.446124091323389e-05,0.0,1.0
17198,온스타일/Noun,4,4,0,4.446124091323389e-05,0.0,1.0
17199,허걱/Noun,4,0,4,0.0,4.4427660661527865e-05,1.0
17200,타무라/Noun,4,0,4,0.0,4.4427660661527865e-05,1.0
17201,이거볼빠/Noun,4,0,4,0.0,4.4427660661527865e-05,1.0
17202,1978년/Number,4,4,0,4.446124091323389e-05,0.0,1.0
17203,땐데/Noun,4,0,4,0.0,4.4427660661527865e-05,1.0
17204,종은/Noun,4,4,0,4.446124091323389e-05,0.0,1.0
17205,죠지/Noun,4,0,4,0.0,4.4427660661527865e-05,1.0
17206,졸예/Noun,4,4,0,4.446124091323389e-05,0.0,1.0
17207,주정/Noun,4,0,4,0.0,4.4427660661527865e-05,1.0
17208,개욕/Noun,4,0,4,0.0,4.4427660661527865e-05,1.0
17209,즌이/Foreign,4,4,0,4.446124091323389e-05,0.0,1.0
17210,울랄라/Noun,4,0,4,0.0,4.4427660661527865e-05,1.0
17211,허파/Noun,4,0,4,0.0,4.4427660661527865e-05,1.0
17212,애뜻함/Noun,4,4,0,4.446124091323389e-05,0.0,1.0
17213,.~^^/Punctuation,4,4,0,4.446124091323389e-05,0.0,1.0
17214,삐삐/Noun,4,4,0,4.446124091323389e-05,0.0,1.0
17215,에궁/Noun,4,0,4,0.0,4.4427660661527865e-05,1.0
17216,기증/Noun,4,0,4,0.0,4.4427660661527865e-05,1.0
17217,쪽발이/Noun,4,0,4,0.0,4.4427660661527865e-05,1.0
17218,갓뎀/Noun,4,0,4,0.0,4.4427660661527865e-05,1.0
17219,이태석/Noun,4,4,0,4.446124091323389e-05,0.0,1.0
17220,박규리/Noun,4,4,0,4.446124091323389e-05,0.0,1.0
17221,궁색하다/Adjective,4,0,4,0.0,4.4427660661527865e-05,1.0
17222,크래딧/Noun,4,4,0,4.446124091323389e-05,0.0,1.0
17223,격돌/Noun,4,4,0,4.446124091323389e-05,0.0,1.0
17224,기합/Noun,4,0,4,0.0,4.4427660661527865e-05,1.0
17225,생화학/Noun,4,0,4,0.0,4.4427660661527865e-05,1.0
17226,괴한/Noun,4,0,4,0.0,4.4427660661527865e-05,1.0
17227,TT/Alpha,4,4,0,4.446124091323389e-05,0.0,1.0
17228,울엇습니/Noun,4,4,0,4.446124091323389e-05,0.0,1.0
17229,카산드라/Noun,4,4,0,4.446124091323389e-05,0.0,1.0
17230,색휘/Noun,4,0,4,0.0,4.4427660661527865e-05,1.0
17231,지지자/Noun,4,0,4,0.0,4.4427660661527865e-05,1.0
17232,굿샷/Noun,4,4,0,4.446124091323389e-05,0.0,1.0
17233,온대/Noun,4,0,4,0.0,4.4427660661527865e-05,1.0
17234,506/Number,4,0,4,0.0,4.4427660661527865e-05,1.0
17235,황금의제국/Noun,4,4,0,4.446124091323389e-05,0.0,1.0
17236,빨간색/Noun,4,4,0,4.446124091323389e-05,0.0,1.0
17237,블리/Noun,4,4,0,4.446124091323389e-05,0.0,1.0
17238,불량하다/Adjective,4,0,4,0.0,4.4427660661527865e-05,1.0
17239,극대/Noun,4,4,0,4.446124091323389e-05,0.0,1.0
17240,강치/Noun,4,4,0,4.446124091323389e-05,0.0,1.0
17241,트위스트/Noun,4,4,0,4.446124091323389e-05,0.0,1.0
17242,글세/Noun,4,1,3,1.1115310228308472e-05,3.33207454961459e-05,0.75
17243,퍼붓다/Verb,4,1,3,1.1115310228308472e-05,3.33207454961459e-05,0.75
17244,나진/Noun,4,1,3,1.1115310228308472e-05,3.33207454961459e-05,0.75
17245,박치기/Noun,4,3,1,3.3345930684925414e-05,1.1106915165381966e-05,0.75
17246,베충/Noun,4,3,1,3.3345930684925414e-05,1.1106915165381966e-05,0.75
17247,개혁/Noun,4,3,1,3.3345930684925414e-05,1.1106915165381966e-05,0.75
17248,....'/Punctuation,4,1,3,1.1115310228308472e-05,3.33207454961459e-05,0.75
17249,안젤라/Noun,4,1,3,1.1115310228308472e-05,3.33207454961459e-05,0.75
17250,집권/Noun,4,1,3,1.1115310228308472e-05,3.33207454961459e-05,0.75
17251,지혜롭/Noun,4,3,1,3.3345930684925414e-05,1.1106915165381966e-05,0.75
17252,만화방/Noun,4,1,3,1.1115310228308472e-05,3.33207454961459e-05,0.75
17253,번갈아/Noun,4,3,1,3.3345930684925414e-05,1.1106915165381966e-05,0.75
17254,쓰다듬다/Verb,4,3,1,3.3345930684925414e-05,1.1106915165381966e-05,0.75
17255,근로자/Noun,4,3,1,3.3345930684925414e-05,1.1106915165381966e-05,0.75
17256,스캇/Noun,4,3,1,3.3345930684925414e-05,1.1106915165381966e-05,0.75
17257,非/Foreign,4,3,1,3.3345930684925414e-05,1.1106915165381966e-05,0.75
17258,괜챦/Noun,4,3,1,3.3345930684925414e-05,1.1106915165381966e-05,0.75
17259,엘런/Noun,4,1,3,1.1115310228308472e-05,3.33207454961459e-05,0.75
17260,돠/Noun,4,3,1,3.3345930684925414e-05,1.1106915165381966e-05,0.75
17261,실장/Noun,4,3,1,3.3345930684925414e-05,1.1106915165381966e-05,0.75
17262,러블/Noun,4,3,1,3.3345930684925414e-05,1.1106915165381966e-05,0.75
17263,잉글리쉬/Noun,4,1,3,1.1115310228308472e-05,3.33207454961459e-05,0.75
17264,꽃보다할배/Noun,4,1,3,1.1115310228308472e-05,3.33207454961459e-05,0.75
17265,이태원/Noun,4,1,3,1.1115310228308472e-05,3.33207454961459e-05,0.75
17266,1963년/Number,4,3,1,3.3345930684925414e-05,1.1106915165381966e-05,0.75
17267,신이치/Noun,4,3,1,3.3345930684925414e-05,1.1106915165381966e-05,0.75
17268,록산느/Noun,4,1,3,1.1115310228308472e-05,3.33207454961459e-05,0.75
17269,리즘/Noun,4,1,3,1.1115310228308472e-05,3.33207454961459e-05,0.75
17270,드라마영화/Noun,4,3,1,3.3345930684925414e-05,1.1106915165381966e-05,0.75
17271,짝패/Noun,4,1,3,1.1115310228308472e-05,3.33207454961459e-05,0.75
17272,9.9/Number,4,3,1,3.3345930684925414e-05,1.1106915165381966e-05,0.75
17273,얼티메이텀/Noun,4,1,3,1.1115310228308472e-05,3.33207454961459e-05,0.75
17274,늬들/Noun,4,1,3,1.1115310228308472e-05,3.33207454961459e-05,0.75
17275,태아/Noun,4,1,3,1.1115310228308472e-05,3.33207454961459e-05,0.75
17276,거볼때/Noun,4,3,1,3.3345930684925414e-05,1.1106915165381966e-05,0.75
17277,봤드/Noun,4,1,3,1.1115310228308472e-05,3.33207454961459e-05,0.75
17278,폐쇄된/Noun,4,3,1,3.3345930684925414e-05,1.1106915165381966e-05,0.75
17279,일본해/Noun,4,1,3,1.1115310228308472e-05,3.33207454961459e-05,0.75
17280,내/Foreign,4,1,3,1.1115310228308472e-05,3.33207454961459e-05,0.75
17281,!!!!~/Punctuation,4,3,1,3.3345930684925414e-05,1.1106915165381966e-05,0.75
17282,홍반장/Noun,4,3,1,3.3345930684925414e-05,1.1106915165381966e-05,0.75
17283,동지/Noun,4,1,3,1.1115310228308472e-05,3.33207454961459e-05,0.75
17284,김영광/Noun,4,3,1,3.3345930684925414e-05,1.1106915165381966e-05,0.75
17285,황인영/Noun,4,1,3,1.1115310228308472e-05,3.33207454961459e-05,0.75
17286,노수람/Noun,4,1,3,1.1115310228308472e-05,3.33207454961459e-05,0.75
17287,들썩들썩/Adverb,4,3,1,3.3345930684925414e-05,1.1106915165381966e-05,0.75
17288,끝맛/Noun,4,3,1,3.3345930684925414e-05,1.1106915165381966e-05,0.75
17289,채영/Noun,4,3,1,3.3345930684925414e-05,1.1106915165381966e-05,0.75
17290,쌈질/Noun,4,1,3,1.1115310228308472e-05,3.33207454961459e-05,0.75
17291,난하다/Adjective,4,1,3,1.1115310228308472e-05,3.33207454961459e-05,0.75
17292,스트라이커/Noun,4,1,3,1.1115310228308472e-05,3.33207454961459e-05,0.75
17293,꼽으/Noun,4,3,1,3.3345930684925414e-05,1.1106915165381966e-05,0.75
17294,0.2/Number,4,1,3,1.1115310228308472e-05,3.33207454961459e-05,0.75
17295,물가/Noun,4,1,3,1.1115310228308472e-05,3.33207454961459e-05,0.75
17296,나카타/Noun,4,1,3,1.1115310228308472e-05,3.33207454961459e-05,0.75
17297,지린다/Verb,4,1,3,1.1115310228308472e-05,3.33207454961459e-05,0.75
17298,우중충하다/Adjective,4,1,3,1.1115310228308472e-05,3.33207454961459e-05,0.75
17299,영미/Noun,4,3,1,3.3345930684925414e-05,1.1106915165381966e-05,0.75
17300,샛별/Noun,4,1,3,1.1115310228308472e-05,3.33207454961459e-05,0.75
17301,고지/Noun,4,3,1,3.3345930684925414e-05,1.1106915165381966e-05,0.75
17302,모리스/Noun,4,1,3,1.1115310228308472e-05,3.33207454961459e-05,0.75
17303,비틀/Noun,4,1,3,1.1115310228308472e-05,3.33207454961459e-05,0.75
17304,동기부여/Noun,4,1,3,1.1115310228308472e-05,3.33207454961459e-05,0.75
17305,전공/Noun,4,3,1,3.3345930684925414e-05,1.1106915165381966e-05,0.75
17306,생판/Noun,4,1,3,1.1115310228308472e-05,3.33207454961459e-05,0.75
17307,전위/Noun,4,3,1,3.3345930684925414e-05,1.1106915165381966e-05,0.75
17308,승무원/Noun,4,3,1,3.3345930684925414e-05,1.1106915165381966e-05,0.75
17309,으윽/Adverb,4,1,3,1.1115310228308472e-05,3.33207454961459e-05,0.75
17310,몽고/Noun,4,1,3,1.1115310228308472e-05,3.33207454961459e-05,0.75
17311,메이져/Noun,4,3,1,3.3345930684925414e-05,1.1106915165381966e-05,0.75
17312,월트/Noun,4,1,3,1.1115310228308472e-05,3.33207454961459e-05,0.75
17313,미실/Noun,4,3,1,3.3345930684925414e-05,1.1106915165381966e-05,0.75
17314,어리광/Noun,4,1,3,1.1115310228308472e-05,3.33207454961459e-05,0.75
17315,이방원/Noun,4,3,1,3.3345930684925414e-05,1.1106915165381966e-05,0.75
17316,(!)/Punctuation,4,1,3,1.1115310228308472e-05,3.33207454961459e-05,0.75
17317,어두침침하다/Adjective,4,1,3,1.1115310228308472e-05,3.33207454961459e-05,0.75
17318,보증수표/Noun,4,1,3,1.1115310228308472e-05,3.33207454961459e-05,0.75
17319,10101010/Number,4,1,3,1.1115310228308472e-05,3.33207454961459e-05,0.75
17320,대나/Foreign,4,1,3,1.1115310228308472e-05,3.33207454961459e-05,0.75
17321,훔/Noun,4,1,3,1.1115310228308472e-05,3.33207454961459e-05,0.75
17322,다코다/Noun,4,1,3,1.1115310228308472e-05,3.33207454961459e-05,0.75
17323,수호천사/Noun,4,3,1,3.3345930684925414e-05,1.1106915165381966e-05,0.75
17324,개속/Noun,4,1,3,1.1115310228308472e-05,3.33207454961459e-05,0.75
17325,가늘다/Adjective,4,1,3,1.1115310228308472e-05,3.33207454961459e-05,0.75
17326,노예제/Noun,4,3,1,3.3345930684925414e-05,1.1106915165381966e-05,0.75
17327,어른스럽다/Adjective,4,3,1,3.3345930684925414e-05,1.1106915165381966e-05,0.75
17328,성현/Noun,4,3,1,3.3345930684925414e-05,1.1106915165381966e-05,0.75
17329,스팀/Noun,4,1,3,1.1115310228308472e-05,3.33207454961459e-05,0.75
17330,예성/Noun,4,3,1,3.3345930684925414e-05,1.1106915165381966e-05,0.75
17331,판단력/Noun,4,1,3,1.1115310228308472e-05,3.33207454961459e-05,0.75
17332,상환/Noun,4,1,3,1.1115310228308472e-05,3.33207454961459e-05,0.75
17333,↑/Foreign,4,3,1,3.3345930684925414e-05,1.1106915165381966e-05,0.75
17334,복기/Noun,4,3,1,3.3345930684925414e-05,1.1106915165381966e-05,0.75
17335,구제역/Noun,4,1,3,1.1115310228308472e-05,3.33207454961459e-05,0.75
17336,겨울방학/Noun,4,3,1,3.3345930684925414e-05,1.1106915165381966e-05,0.75
17337,다자/Noun,4,1,3,1.1115310228308472e-05,3.33207454961459e-05,0.75
17338,어처구니없이/Adverb,4,1,3,1.1115310228308472e-05,3.33207454961459e-05,0.75
17339,포항/Noun,4,1,3,1.1115310228308472e-05,3.33207454961459e-05,0.75
17340,이채영/Noun,4,1,3,1.1115310228308472e-05,3.33207454961459e-05,0.75
17341,애꿎/Noun,4,1,3,1.1115310228308472e-05,3.33207454961459e-05,0.75
17342,엠씨몽/Noun,4,1,3,1.1115310228308472e-05,3.33207454961459e-05,0.75
17343,양성애자/Noun,4,1,3,1.1115310228308472e-05,3.33207454961459e-05,0.75
17344,찬송/Noun,4,3,1,3.3345930684925414e-05,1.1106915165381966e-05,0.75
17345,이계인/Noun,4,1,3,1.1115310228308472e-05,3.33207454961459e-05,0.75
17346,유실물/Noun,4,1,3,1.1115310228308472e-05,3.33207454961459e-05,0.75
17347,일률/Noun,4,1,3,1.1115310228308472e-05,3.33207454961459e-05,0.75
17348,직결/Noun,4,1,3,1.1115310228308472e-05,3.33207454961459e-05,0.75
17349,타계/Noun,4,3,1,3.3345930684925414e-05,1.1106915165381966e-05,0.75
17350,dp/Alpha,4,1,3,1.1115310228308472e-05,3.33207454961459e-05,0.75
17351,몰지각하다/Adjective,4,1,3,1.1115310228308472e-05,3.33207454961459e-05,0.75
17352,ㅋㅌ/KoreanParticle,4,1,3,1.1115310228308472e-05,3.33207454961459e-05,0.75
17353,황후/Noun,4,3,1,3.3345930684925414e-05,1.1106915165381966e-05,0.75
17354,20시간/Number,4,1,3,1.1115310228308472e-05,3.33207454961459e-05,0.75
17355,활보/Noun,4,1,3,1.1115310228308472e-05,3.33207454961459e-05,0.75
17356,killing/Alpha,4,1,3,1.1115310228308472e-05,3.33207454961459e-05,0.75
17357,명제/Noun,4,1,3,1.1115310228308472e-05,3.33207454961459e-05,0.75
17358,NOT/Alpha,4,1,3,1.1115310228308472e-05,3.33207454961459e-05,0.75
17359,박지수/Noun,4,3,1,3.3345930684925414e-05,1.1106915165381966e-05,0.75
17360,켄신/Noun,4,3,1,3.3345930684925414e-05,1.1106915165381966e-05,0.75
17361,칭호/Noun,4,1,3,1.1115310228308472e-05,3.33207454961459e-05,0.75
17362,임정은/Noun,4,1,3,1.1115310228308472e-05,3.33207454961459e-05,0.75
17363,허프/Noun,4,3,1,3.3345930684925414e-05,1.1106915165381966e-05,0.75
17364,94/Number,4,3,1,3.3345930684925414e-05,1.1106915165381966e-05,0.75
17365,02년/Number,4,3,1,3.3345930684925414e-05,1.1106915165381966e-05,0.75
17366,!!@/Punctuation,4,3,1,3.3345930684925414e-05,1.1106915165381966e-05,0.75
17367,반장/Noun,4,1,3,1.1115310228308472e-05,3.33207454961459e-05,0.75
17368,수란/Noun,4,1,3,1.1115310228308472e-05,3.33207454961459e-05,0.75
17369,담날/Noun,4,3,1,3.3345930684925414e-05,1.1106915165381966e-05,0.75
17370,것땜/Noun,4,3,1,3.3345930684925414e-05,1.1106915165381966e-05,0.75
17371,파스타/Noun,4,3,1,3.3345930684925414e-05,1.1106915165381966e-05,0.75
17372,".,.,.,./Punctuation",4,1,3,1.1115310228308472e-05,3.33207454961459e-05,0.75
17373,촤/Noun,4,3,1,3.3345930684925414e-05,1.1106915165381966e-05,0.75
17374,대에도/Foreign,4,1,3,1.1115310228308472e-05,3.33207454961459e-05,0.75
17375,발렌타인/Noun,4,3,1,3.3345930684925414e-05,1.1106915165381966e-05,0.75
17376,물랑루즈/Noun,4,1,3,1.1115310228308472e-05,3.33207454961459e-05,0.75
17377,개요/Noun,4,3,1,3.3345930684925414e-05,1.1106915165381966e-05,0.75
17378,아더왕/Noun,4,1,3,1.1115310228308472e-05,3.33207454961459e-05,0.75
17379,돌격/Noun,4,3,1,3.3345930684925414e-05,1.1106915165381966e-05,0.75
17380,오만석/Noun,4,3,1,3.3345930684925414e-05,1.1106915165381966e-05,0.75
17381,옜다/Noun,4,1,3,1.1115310228308472e-05,3.33207454961459e-05,0.75
17382,연필/Noun,4,3,1,3.3345930684925414e-05,1.1106915165381966e-05,0.75
17383,70~80년/Number,4,1,3,1.1115310228308472e-05,3.33207454961459e-05,0.75
17384,기하/Noun,4,1,3,1.1115310228308472e-05,3.33207454961459e-05,0.75
17385,아리아/Noun,4,1,3,1.1115310228308472e-05,3.33207454961459e-05,0.75
17386,돋보다/Verb,4,3,1,3.3345930684925414e-05,1.1106915165381966e-05,0.75
17387,BMW/Alpha,4,1,3,1.1115310228308472e-05,3.33207454961459e-05,0.75
17388,GT/Alpha,4,3,1,3.3345930684925414e-05,1.1106915165381966e-05,0.75
17389,파라노말액티비티/Noun,4,1,3,1.1115310228308472e-05,3.33207454961459e-05,0.75
17390,불어오다/Verb,4,3,1,3.3345930684925414e-05,1.1106915165381966e-05,0.75
17391,JJ/Alpha,4,1,3,1.1115310228308472e-05,3.33207454961459e-05,0.75
17392,이끼/Noun,4,1,3,1.1115310228308472e-05,3.33207454961459e-05,0.75
17393,바알/Noun,4,1,3,1.1115310228308472e-05,3.33207454961459e-05,0.75
17394,메구미/Noun,4,3,1,3.3345930684925414e-05,1.1106915165381966e-05,0.75
17395,Let/Alpha,4,3,1,3.3345930684925414e-05,1.1106915165381966e-05,0.75
17396,2003/Number,4,3,1,3.3345930684925414e-05,1.1106915165381966e-05,0.75
17397,5시/Number,4,3,1,3.3345930684925414e-05,1.1106915165381966e-05,0.75
17398,아테나/Noun,4,1,3,1.1115310228308472e-05,3.33207454961459e-05,0.75
17399,회고/Noun,4,3,1,3.3345930684925414e-05,1.1106915165381966e-05,0.75
17400,겉잡/Noun,4,3,1,3.3345930684925414e-05,1.1106915165381966e-05,0.75
17401,김혜성/Noun,4,1,3,1.1115310228308472e-05,3.33207454961459e-05,0.75
17402,작을/Foreign,4,1,3,1.1115310228308472e-05,3.33207454961459e-05,0.75
17403,딕/Noun,4,1,3,1.1115310228308472e-05,3.33207454961459e-05,0.75
17404,데스페라도/Noun,4,1,3,1.1115310228308472e-05,3.33207454961459e-05,0.75
17405,부지런하다/Adjective,4,3,1,3.3345930684925414e-05,1.1106915165381966e-05,0.75
17406,쿠로사와/Noun,4,1,3,1.1115310228308472e-05,3.33207454961459e-05,0.75
17407,허덕이다/Verb,4,3,1,3.3345930684925414e-05,1.1106915165381966e-05,0.75
17408,달아오르다/Verb,4,3,1,3.3345930684925414e-05,1.1106915165381966e-05,0.75
17409,의뢰인/Noun,4,1,3,1.1115310228308472e-05,3.33207454961459e-05,0.75
17410,마에다/Noun,4,3,1,3.3345930684925414e-05,1.1106915165381966e-05,0.75
17411,잏/Noun,4,3,1,3.3345930684925414e-05,1.1106915165381966e-05,0.75
17412,희망고문/Noun,4,3,1,3.3345930684925414e-05,1.1106915165381966e-05,0.75
17413,보디/Noun,4,1,3,1.1115310228308472e-05,3.33207454961459e-05,0.75
17414,스파르타/Noun,4,3,1,3.3345930684925414e-05,1.1106915165381966e-05,0.75
17415,프롤로그/Noun,4,1,3,1.1115310228308472e-05,3.33207454961459e-05,0.75
17416,초롱/Noun,4,3,1,3.3345930684925414e-05,1.1106915165381966e-05,0.75
17417,데헷/Noun,4,3,1,3.3345930684925414e-05,1.1106915165381966e-05,0.75
17418,지목/Noun,4,1,3,1.1115310228308472e-05,3.33207454961459e-05,0.75
17419,손짓/Noun,4,3,1,3.3345930684925414e-05,1.1106915165381966e-05,0.75
17420,BBC/Alpha,4,1,3,1.1115310228308472e-05,3.33207454961459e-05,0.75
17421,컴퍼니/Noun,4,3,1,3.3345930684925414e-05,1.1106915165381966e-05,0.75
17422,미영/Noun,4,3,1,3.3345930684925414e-05,1.1106915165381966e-05,0.75
17423,실리콘/Noun,4,1,3,1.1115310228308472e-05,3.33207454961459e-05,0.75
17424,봄여름가을겨울/Noun,4,3,1,3.3345930684925414e-05,1.1106915165381966e-05,0.75
17425,벌주다/Verb,4,1,3,1.1115310228308472e-05,3.33207454961459e-05,0.75
17426,헤드셋/Noun,4,3,1,3.3345930684925414e-05,1.1106915165381966e-05,0.75
17427,500만/Number,4,3,1,3.3345930684925414e-05,1.1106915165381966e-05,0.75
17428,인애/Noun,4,1,3,1.1115310228308472e-05,3.33207454961459e-05,0.75
17429,매달다/Verb,4,3,1,3.3345930684925414e-05,1.1106915165381966e-05,0.75
17430,24시간/Number,4,3,1,3.3345930684925414e-05,1.1106915165381966e-05,0.75
17431,애처/Noun,4,3,1,3.3345930684925414e-05,1.1106915165381966e-05,0.75
17432,에전/Noun,4,1,3,1.1115310228308472e-05,3.33207454961459e-05,0.75
17433,는야/Josa,4,3,1,3.3345930684925414e-05,1.1106915165381966e-05,0.75
17434,염력/Noun,4,1,3,1.1115310228308472e-05,3.33207454961459e-05,0.75
17435,발린/Noun,4,1,3,1.1115310228308472e-05,3.33207454961459e-05,0.75
17436,섬나라/Noun,4,1,3,1.1115310228308472e-05,3.33207454961459e-05,0.75
17437,이수아/Noun,4,1,3,1.1115310228308472e-05,3.33207454961459e-05,0.75
17438,99.9%/Number,4,1,3,1.1115310228308472e-05,3.33207454961459e-05,0.75
17439,반려동물/Noun,4,3,1,3.3345930684925414e-05,1.1106915165381966e-05,0.75
17440,청정/Noun,4,3,1,3.3345930684925414e-05,1.1106915165381966e-05,0.75
17441,화술/Noun,4,1,3,1.1115310228308472e-05,3.33207454961459e-05,0.75
17442,직진/Noun,4,3,1,3.3345930684925414e-05,1.1106915165381966e-05,0.75
17443,이승/Noun,4,3,1,3.3345930684925414e-05,1.1106915165381966e-05,0.75
17444,신조/Noun,4,1,3,1.1115310228308472e-05,3.33207454961459e-05,0.75
17445,뒤엎는/Noun,4,3,1,3.3345930684925414e-05,1.1106915165381966e-05,0.75
17446,구일/Noun,4,1,3,1.1115310228308472e-05,3.33207454961459e-05,0.75
17447,코카콜라/Noun,4,3,1,3.3345930684925414e-05,1.1106915165381966e-05,0.75
17448,쌍코피/Noun,4,3,1,3.3345930684925414e-05,1.1106915165381966e-05,0.75
17449,손담비/Noun,4,1,3,1.1115310228308472e-05,3.33207454961459e-05,0.75
17450,타라/Noun,4,1,3,1.1115310228308472e-05,3.33207454961459e-05,0.75
17451,이장면/Noun,4,1,3,1.1115310228308472e-05,3.33207454961459e-05,0.75
17452,카인/Noun,4,1,3,1.1115310228308472e-05,3.33207454961459e-05,0.75
17453,화염/Noun,4,1,3,1.1115310228308472e-05,3.33207454961459e-05,0.75
17454,안마/Noun,4,1,3,1.1115310228308472e-05,3.33207454961459e-05,0.75
17455,송가연/Noun,4,1,3,1.1115310228308472e-05,3.33207454961459e-05,0.75
17456,종대/Noun,4,1,3,1.1115310228308472e-05,3.33207454961459e-05,0.75
17457,유효/Noun,4,3,1,3.3345930684925414e-05,1.1106915165381966e-05,0.75
17458,동무/Noun,4,1,3,1.1115310228308472e-05,3.33207454961459e-05,0.75
17459,시들하다/Adjective,4,3,1,3.3345930684925414e-05,1.1106915165381966e-05,0.75
17460,원흉/Noun,4,1,3,1.1115310228308472e-05,3.33207454961459e-05,0.75
17461,대주/Noun,4,1,3,1.1115310228308472e-05,3.33207454961459e-05,0.75
17462,보좌/Noun,4,1,3,1.1115310228308472e-05,3.33207454961459e-05,0.75
17463,랭크/Noun,4,3,1,3.3345930684925414e-05,1.1106915165381966e-05,0.75
17464,도어즈/Noun,4,3,1,3.3345930684925414e-05,1.1106915165381966e-05,0.75
17465,다스리다/Verb,4,3,1,3.3345930684925414e-05,1.1106915165381966e-05,0.75
17466,백업/Noun,4,3,1,3.3345930684925414e-05,1.1106915165381966e-05,0.75
17467,이용만/Noun,4,1,3,1.1115310228308472e-05,3.33207454961459e-05,0.75
17468,헤리/Noun,4,3,1,3.3345930684925414e-05,1.1106915165381966e-05,0.75
17469,YOU/Alpha,4,3,1,3.3345930684925414e-05,1.1106915165381966e-05,0.75
17470,단다/Eomi,4,3,1,3.3345930684925414e-05,1.1106915165381966e-05,0.75
17471,이펙트/Noun,4,3,1,3.3345930684925414e-05,1.1106915165381966e-05,0.75
17472,Rock/Alpha,4,3,1,3.3345930684925414e-05,1.1106915165381966e-05,0.75
17473,서해/Noun,4,1,3,1.1115310228308472e-05,3.33207454961459e-05,0.75
17474,헝가리/Noun,4,3,1,3.3345930684925414e-05,1.1106915165381966e-05,0.75
17475,수중/Noun,4,3,1,3.3345930684925414e-05,1.1106915165381966e-05,0.75
17476,최우수/Noun,4,3,1,3.3345930684925414e-05,1.1106915165381966e-05,0.75
17477,확정/Noun,4,3,1,3.3345930684925414e-05,1.1106915165381966e-05,0.75
17478,7.9/Number,4,1,3,1.1115310228308472e-05,3.33207454961459e-05,0.75
17479,참전용사/Noun,4,3,1,3.3345930684925414e-05,1.1106915165381966e-05,0.75
17480,각하/Noun,4,1,3,1.1115310228308472e-05,3.33207454961459e-05,0.75
17481,거르/Noun,4,1,3,1.1115310228308472e-05,3.33207454961459e-05,0.75
17482,글로리/Noun,4,3,1,3.3345930684925414e-05,1.1106915165381966e-05,0.75
17483,봉황/Noun,4,3,1,3.3345930684925414e-05,1.1106915165381966e-05,0.75
17484,거진/Adverb,4,1,3,1.1115310228308472e-05,3.33207454961459e-05,0.75
17485,광경/Noun,4,1,3,1.1115310228308472e-05,3.33207454961459e-05,0.75
17486,나영/Noun,4,1,3,1.1115310228308472e-05,3.33207454961459e-05,0.75
17487,이반/Noun,4,3,1,3.3345930684925414e-05,1.1106915165381966e-05,0.75
17488,이라/Foreign,4,1,3,1.1115310228308472e-05,3.33207454961459e-05,0.75
17489,왕초/Noun,4,3,1,3.3345930684925414e-05,1.1106915165381966e-05,0.75
17490,김건모/Noun,4,3,1,3.3345930684925414e-05,1.1106915165381966e-05,0.75
17491,웅대림/Noun,4,1,3,1.1115310228308472e-05,3.33207454961459e-05,0.75
17492,발바닥/Noun,4,1,3,1.1115310228308472e-05,3.33207454961459e-05,0.75
17493,구조대/Noun,4,3,1,3.3345930684925414e-05,1.1106915165381966e-05,0.75
17494,남아공/Noun,4,3,1,3.3345930684925414e-05,1.1106915165381966e-05,0.75
17495,아디/Noun,4,1,3,1.1115310228308472e-05,3.33207454961459e-05,0.75
17496,신전/Noun,4,1,3,1.1115310228308472e-05,3.33207454961459e-05,0.75
17497,홀릭/Noun,4,3,1,3.3345930684925414e-05,1.1106915165381966e-05,0.75
17498,할러/Noun,4,3,1,3.3345930684925414e-05,1.1106915165381966e-05,0.75
17499,온화하다/Adjective,4,3,1,3.3345930684925414e-05,1.1106915165381966e-05,0.75
17500,사령관/Noun,4,3,1,3.3345930684925414e-05,1.1106915165381966e-05,0.75
17501,YB/Alpha,4,3,1,3.3345930684925414e-05,1.1106915165381966e-05,0.75
17502,다오/Noun,4,1,3,1.1115310228308472e-05,3.33207454961459e-05,0.75
17503,사주/Noun,4,1,3,1.1115310228308472e-05,3.33207454961459e-05,0.75
17504,점박이/Noun,4,1,3,1.1115310228308472e-05,3.33207454961459e-05,0.75
17505,점더줌/Noun,4,1,3,1.1115310228308472e-05,3.33207454961459e-05,0.75
17506,곳도/Noun,4,1,3,1.1115310228308472e-05,3.33207454961459e-05,0.75
17507,청아/Noun,4,3,1,3.3345930684925414e-05,1.1106915165381966e-05,0.75
17508,허섭/Noun,4,1,3,1.1115310228308472e-05,3.33207454961459e-05,0.75
17509,왼발/Noun,4,1,3,1.1115310228308472e-05,3.33207454961459e-05,0.75
17510,취학/Noun,4,1,3,1.1115310228308472e-05,3.33207454961459e-05,0.75
17511,뛰어오다/Verb,4,3,1,3.3345930684925414e-05,1.1106915165381966e-05,0.75
17512,당나귀/Noun,4,1,3,1.1115310228308472e-05,3.33207454961459e-05,0.75
17513,명칭/Noun,4,3,1,3.3345930684925414e-05,1.1106915165381966e-05,0.75
17514,이율/Noun,4,1,3,1.1115310228308472e-05,3.33207454961459e-05,0.75
17515,초자연적/Noun,4,1,3,1.1115310228308472e-05,3.33207454961459e-05,0.75
17516,전말/Noun,4,1,3,1.1115310228308472e-05,3.33207454961459e-05,0.75
17517,산타바바라/Noun,4,3,1,3.3345930684925414e-05,1.1106915165381966e-05,0.75
17518,8.6/Number,4,3,1,3.3345930684925414e-05,1.1106915165381966e-05,0.75
17519,의수/Noun,4,3,1,3.3345930684925414e-05,1.1106915165381966e-05,0.75
17520,마로/Noun,4,1,3,1.1115310228308472e-05,3.33207454961459e-05,0.75
17521,요나/Noun,4,3,1,3.3345930684925414e-05,1.1106915165381966e-05,0.75
17522,바서/Noun,4,3,1,3.3345930684925414e-05,1.1106915165381966e-05,0.75
17523,고우영/Noun,4,3,1,3.3345930684925414e-05,1.1106915165381966e-05,0.75
17524,보신탕/Noun,4,1,3,1.1115310228308472e-05,3.33207454961459e-05,0.75
17525,터프/Noun,4,3,1,3.3345930684925414e-05,1.1106915165381966e-05,0.75
17526,다시키/Noun,4,1,3,1.1115310228308472e-05,3.33207454961459e-05,0.75
17527,충의/Noun,4,3,1,3.3345930684925414e-05,1.1106915165381966e-05,0.75
17528,낸시/Noun,4,1,3,1.1115310228308472e-05,3.33207454961459e-05,0.75
17529,보배/Noun,4,1,3,1.1115310228308472e-05,3.33207454961459e-05,0.75
17530,48시간/Number,4,1,3,1.1115310228308472e-05,3.33207454961459e-05,0.75
17531,!!.../Punctuation,4,3,1,3.3345930684925414e-05,1.1106915165381966e-05,0.75
17532,damn/Alpha,4,1,3,1.1115310228308472e-05,3.33207454961459e-05,0.75
17533,찬송가/Noun,4,1,3,1.1115310228308472e-05,3.33207454961459e-05,0.75
17534,쟁/Noun,4,1,3,1.1115310228308472e-05,3.33207454961459e-05,0.75
17535,전이나/Foreign,4,3,1,3.3345930684925414e-05,1.1106915165381966e-05,0.75
17536,리트/Noun,4,1,3,1.1115310228308472e-05,3.33207454961459e-05,0.75
17537,목수/Noun,4,3,1,3.3345930684925414e-05,1.1106915165381966e-05,0.75
17538,확산/Noun,4,1,3,1.1115310228308472e-05,3.33207454961459e-05,0.75
17539,똘똘이/Noun,4,3,1,3.3345930684925414e-05,1.1106915165381966e-05,0.75
17540,진품/Noun,4,3,1,3.3345930684925414e-05,1.1106915165381966e-05,0.75
17541,트랜스/Noun,4,3,1,3.3345930684925414e-05,1.1106915165381966e-05,0.75
17542,지남/Noun,4,1,3,1.1115310228308472e-05,3.33207454961459e-05,0.75
17543,비밀스럽다/Adjective,4,1,3,1.1115310228308472e-05,3.33207454961459e-05,0.75
17544,듀얼/Noun,4,1,3,1.1115310228308472e-05,3.33207454961459e-05,0.75
17545,찿/Noun,4,1,3,1.1115310228308472e-05,3.33207454961459e-05,0.75
17546,귀타귀/Noun,4,1,3,1.1115310228308472e-05,3.33207454961459e-05,0.75
17547,낼때/Noun,4,1,3,1.1115310228308472e-05,3.33207454961459e-05,0.75
17548,의인화/Noun,4,3,1,3.3345930684925414e-05,1.1106915165381966e-05,0.75
17549,니노미야/Noun,4,3,1,3.3345930684925414e-05,1.1106915165381966e-05,0.75
17550,함보/Noun,4,3,1,3.3345930684925414e-05,1.1106915165381966e-05,0.75
17551,정호/Noun,4,1,3,1.1115310228308472e-05,3.33207454961459e-05,0.75
17552,에로씬/Noun,4,1,3,1.1115310228308472e-05,3.33207454961459e-05,0.75
17553,funny/Alpha,4,3,1,3.3345930684925414e-05,1.1106915165381966e-05,0.75
17554,her/Alpha,4,3,1,3.3345930684925414e-05,1.1106915165381966e-05,0.75
17555,벽돌/Noun,4,3,1,3.3345930684925414e-05,1.1106915165381966e-05,0.75
17556,지렁이/Noun,4,3,1,3.3345930684925414e-05,1.1106915165381966e-05,0.75
17557,감치/Noun,4,1,3,1.1115310228308472e-05,3.33207454961459e-05,0.75
17558,범행/Noun,4,1,3,1.1115310228308472e-05,3.33207454961459e-05,0.75
17559,기형/Noun,4,1,3,1.1115310228308472e-05,3.33207454961459e-05,0.75
17560,똘이장군/Noun,4,3,1,3.3345930684925414e-05,1.1106915165381966e-05,0.75
17561,박해미/Noun,4,1,3,1.1115310228308472e-05,3.33207454961459e-05,0.75
17562,부연/Noun,4,3,1,3.3345930684925414e-05,1.1106915165381966e-05,0.75
17563,.??/Punctuation,4,1,3,1.1115310228308472e-05,3.33207454961459e-05,0.75
17564,휘발/Noun,4,1,3,1.1115310228308472e-05,3.33207454961459e-05,0.75
17565,52/Number,4,3,1,3.3345930684925414e-05,1.1106915165381966e-05,0.75
17566,담보/Noun,4,3,1,3.3345930684925414e-05,1.1106915165381966e-05,0.75
17567,^^.../Punctuation,4,1,3,1.1115310228308472e-05,3.33207454961459e-05,0.75
17568,소이/Noun,4,3,1,3.3345930684925414e-05,1.1106915165381966e-05,0.75
17569,물러나다/Verb,4,1,3,1.1115310228308472e-05,3.33207454961459e-05,0.75
17570,데비/Noun,4,1,3,1.1115310228308472e-05,3.33207454961459e-05,0.75
17571,후련/Noun,4,3,1,3.3345930684925414e-05,1.1106915165381966e-05,0.75
17572,브레/Noun,4,3,1,3.3345930684925414e-05,1.1106915165381966e-05,0.75
17573,맛보기/Noun,4,3,1,3.3345930684925414e-05,1.1106915165381966e-05,0.75
17574,통탄/Noun,4,1,3,1.1115310228308472e-05,3.33207454961459e-05,0.75
17575,송어/Noun,4,3,1,3.3345930684925414e-05,1.1106915165381966e-05,0.75
17576,번인/Noun,4,3,1,3.3345930684925414e-05,1.1106915165381966e-05,0.75
17577,41분/Number,4,1,3,1.1115310228308472e-05,3.33207454961459e-05,0.75
17578,악플러/Noun,4,3,1,3.3345930684925414e-05,1.1106915165381966e-05,0.75
17579,헐/Exclamation,4,3,1,3.3345930684925414e-05,1.1106915165381966e-05,0.75
17580,호주영화/Noun,4,1,3,1.1115310228308472e-05,3.33207454961459e-05,0.75
17581,반일/Noun,4,3,1,3.3345930684925414e-05,1.1106915165381966e-05,0.75
17582,김산호/Noun,4,1,3,1.1115310228308472e-05,3.33207454961459e-05,0.75
17583,일동/Noun,4,1,3,1.1115310228308472e-05,3.33207454961459e-05,0.75
17584,신설/Noun,4,1,3,1.1115310228308472e-05,3.33207454961459e-05,0.75
17585,베스/Noun,4,3,1,3.3345930684925414e-05,1.1106915165381966e-05,0.75
17586,선상/Noun,4,3,1,3.3345930684925414e-05,1.1106915165381966e-05,0.75
17587,만추/Noun,4,1,3,1.1115310228308472e-05,3.33207454961459e-05,0.75
17588,쯔쯔쯔/Noun,4,1,3,1.1115310228308472e-05,3.33207454961459e-05,0.75
17589,숙희/Noun,4,3,1,3.3345930684925414e-05,1.1106915165381966e-05,0.75
17590,편집증/Noun,4,3,1,3.3345930684925414e-05,1.1106915165381966e-05,0.75
17591,파생/Noun,4,3,1,3.3345930684925414e-05,1.1106915165381966e-05,0.75
17592,1948년/Number,4,1,3,1.1115310228308472e-05,3.33207454961459e-05,0.75
17593,전북/Noun,4,1,3,1.1115310228308472e-05,3.33207454961459e-05,0.75
17594,바인/Noun,4,1,3,1.1115310228308472e-05,3.33207454961459e-05,0.75
17595,OBS/Alpha,4,3,1,3.3345930684925414e-05,1.1106915165381966e-05,0.75
17596,켯/Noun,4,3,1,3.3345930684925414e-05,1.1106915165381966e-05,0.75
17597,들여놓다/Verb,4,1,3,1.1115310228308472e-05,3.33207454961459e-05,0.75
17598,와타나베/Noun,4,3,1,3.3345930684925414e-05,1.1106915165381966e-05,0.75
17599,교환/Noun,4,1,3,1.1115310228308472e-05,3.33207454961459e-05,0.75
17600,무안하다/Adjective,4,1,3,1.1115310228308472e-05,3.33207454961459e-05,0.75
17601,동명이인/Noun,4,1,3,1.1115310228308472e-05,3.33207454961459e-05,0.75
17602,십/Suffix,4,3,1,3.3345930684925414e-05,1.1106915165381966e-05,0.75
17603,교주/Noun,4,3,1,3.3345930684925414e-05,1.1106915165381966e-05,0.75
17604,구암허준/Noun,4,3,1,3.3345930684925414e-05,1.1106915165381966e-05,0.75
17605,외할머니/Noun,4,3,1,3.3345930684925414e-05,1.1106915165381966e-05,0.75
17606,왁스/Noun,4,3,1,3.3345930684925414e-05,1.1106915165381966e-05,0.75
17607,인맥/Noun,4,1,3,1.1115310228308472e-05,3.33207454961459e-05,0.75
17608,부심/Noun,4,1,3,1.1115310228308472e-05,3.33207454961459e-05,0.75
17609,정밀/Noun,4,3,1,3.3345930684925414e-05,1.1106915165381966e-05,0.75
17610,이유나/Noun,4,1,3,1.1115310228308472e-05,3.33207454961459e-05,0.75
17611,루지/Noun,4,3,1,3.3345930684925414e-05,1.1106915165381966e-05,0.75
17612,이종원/Noun,4,3,1,3.3345930684925414e-05,1.1106915165381966e-05,0.75
17613,50원/Number,4,1,3,1.1115310228308472e-05,3.33207454961459e-05,0.75
17614,노하우/Noun,4,1,3,1.1115310228308472e-05,3.33207454961459e-05,0.75
17615,조반/Noun,4,1,3,1.1115310228308472e-05,3.33207454961459e-05,0.75
17616,뉴튼/Noun,4,1,3,1.1115310228308472e-05,3.33207454961459e-05,0.75
17617,대로는/Josa,4,1,3,1.1115310228308472e-05,3.33207454961459e-05,0.75
17618,듸/Noun,4,3,1,3.3345930684925414e-05,1.1106915165381966e-05,0.75
17619,잎/Noun,4,1,3,1.1115310228308472e-05,3.33207454961459e-05,0.75
17620,존재도/Noun,4,1,3,1.1115310228308472e-05,3.33207454961459e-05,0.75
17621,아랫사람/Noun,4,1,3,1.1115310228308472e-05,3.33207454961459e-05,0.75
17622,외곡/Noun,4,1,3,1.1115310228308472e-05,3.33207454961459e-05,0.75
17623,스완슨/Noun,4,3,1,3.3345930684925414e-05,1.1106915165381966e-05,0.75
17624,검거/Noun,4,3,1,3.3345930684925414e-05,1.1106915165381966e-05,0.75
17625,배끼/Noun,4,1,3,1.1115310228308472e-05,3.33207454961459e-05,0.75
17626,81분/Number,4,1,3,1.1115310228308472e-05,3.33207454961459e-05,0.75
17627,시방/Noun,4,3,1,3.3345930684925414e-05,1.1106915165381966e-05,0.75
17628,밥그릇/Noun,4,1,3,1.1115310228308472e-05,3.33207454961459e-05,0.75
17629,낚지마/Noun,4,1,3,1.1115310228308472e-05,3.33207454961459e-05,0.75
17630,about/Alpha,4,3,1,3.3345930684925414e-05,1.1106915165381966e-05,0.75
17631,뺑뺑/Noun,4,1,3,1.1115310228308472e-05,3.33207454961459e-05,0.75
17632,밖에/Foreign,4,3,1,3.3345930684925414e-05,1.1106915165381966e-05,0.75
17633,..;;;;/Punctuation,4,1,3,1.1115310228308472e-05,3.33207454961459e-05,0.75
17634,지애/Noun,4,3,1,3.3345930684925414e-05,1.1106915165381966e-05,0.75
17635,황소/Noun,4,1,3,1.1115310228308472e-05,3.33207454961459e-05,0.75
17636,파도치다/Verb,4,3,1,3.3345930684925414e-05,1.1106915165381966e-05,0.75
17637,속삭임/Noun,4,3,1,3.3345930684925414e-05,1.1106915165381966e-05,0.75
17638,구호/Noun,4,1,3,1.1115310228308472e-05,3.33207454961459e-05,0.75
17639,준걸/Noun,4,1,3,1.1115310228308472e-05,3.33207454961459e-05,0.75
17640,치민/Noun,4,1,3,1.1115310228308472e-05,3.33207454961459e-05,0.75
17641,누더기/Noun,4,1,3,1.1115310228308472e-05,3.33207454961459e-05,0.75
17642,광역/Noun,4,1,3,1.1115310228308472e-05,3.33207454961459e-05,0.75
17643,배송/Noun,4,3,1,3.3345930684925414e-05,1.1106915165381966e-05,0.75
17644,야스/Noun,4,3,1,3.3345930684925414e-05,1.1106915165381966e-05,0.75
17645,미켈란젤로/Noun,4,3,1,3.3345930684925414e-05,1.1106915165381966e-05,0.75
17646,윤지/Noun,4,3,1,3.3345930684925414e-05,1.1106915165381966e-05,0.75
17647,육상/Noun,4,1,3,1.1115310228308472e-05,3.33207454961459e-05,0.75
17648,캐쉬/Noun,4,3,1,3.3345930684925414e-05,1.1106915165381966e-05,0.75
17649,압력/Noun,4,3,1,3.3345930684925414e-05,1.1106915165381966e-05,0.75
17650,능동/Noun,4,3,1,3.3345930684925414e-05,1.1106915165381966e-05,0.75
17651,한은정/Noun,4,1,3,1.1115310228308472e-05,3.33207454961459e-05,0.75
17652,쟁탈전/Noun,4,1,3,1.1115310228308472e-05,3.33207454961459e-05,0.75
17653,구기다/Verb,4,1,3,1.1115310228308472e-05,3.33207454961459e-05,0.75
17654,차차/Noun,4,1,3,1.1115310228308472e-05,3.33207454961459e-05,0.75
17655,알싸하다/Adjective,4,3,1,3.3345930684925414e-05,1.1106915165381966e-05,0.75
17656,차츰/Adverb,4,3,1,3.3345930684925414e-05,1.1106915165381966e-05,0.75
17657,8분/Number,4,3,1,3.3345930684925414e-05,1.1106915165381966e-05,0.75
17658,fun/Alpha,4,3,1,3.3345930684925414e-05,1.1106915165381966e-05,0.75
17659,국제사회/Noun,4,3,1,3.3345930684925414e-05,1.1106915165381966e-05,0.75
17660,them/Alpha,4,3,1,3.3345930684925414e-05,1.1106915165381966e-05,0.75
17661,별표/Noun,4,1,3,1.1115310228308472e-05,3.33207454961459e-05,0.75
17662,づ/Foreign,4,3,1,3.3345930684925414e-05,1.1106915165381966e-05,0.75
17663,연식/Noun,4,3,1,3.3345930684925414e-05,1.1106915165381966e-05,0.75
17664,브로커/Noun,4,1,3,1.1115310228308472e-05,3.33207454961459e-05,0.75
17665,끈적끈적하다/Adjective,4,3,1,3.3345930684925414e-05,1.1106915165381966e-05,0.75
17666,갑작스레/Noun,4,3,1,3.3345930684925414e-05,1.1106915165381966e-05,0.75
17667,아화/Noun,4,3,1,3.3345930684925414e-05,1.1106915165381966e-05,0.75
17668,ㅅㅌㅊ/KoreanParticle,4,3,1,3.3345930684925414e-05,1.1106915165381966e-05,0.75
17669,레몬/Noun,4,3,1,3.3345930684925414e-05,1.1106915165381966e-05,0.75
17670,갤럭시/Noun,4,1,3,1.1115310228308472e-05,3.33207454961459e-05,0.75
17671,‥‥/Foreign,4,1,3,1.1115310228308472e-05,3.33207454961459e-05,0.75
17672,최종병기/Noun,4,1,3,1.1115310228308472e-05,3.33207454961459e-05,0.75
17673,블랙유머/Noun,4,3,1,3.3345930684925414e-05,1.1106915165381966e-05,0.75
17674,most/Alpha,4,1,3,1.1115310228308472e-05,3.33207454961459e-05,0.75
17675,개피/Noun,4,1,3,1.1115310228308472e-05,3.33207454961459e-05,0.75
17676,번지점프/Noun,4,1,3,1.1115310228308472e-05,3.33207454961459e-05,0.75
17677,연애소설/Noun,4,3,1,3.3345930684925414e-05,1.1106915165381966e-05,0.75
17678,너넨/Noun,4,1,3,1.1115310228308472e-05,3.33207454961459e-05,0.75
17679,깃털/Noun,4,3,1,3.3345930684925414e-05,1.1106915165381966e-05,0.75
17680,취침/Noun,4,3,1,3.3345930684925414e-05,1.1106915165381966e-05,0.75
17681,킬미힐미/Noun,4,3,1,3.3345930684925414e-05,1.1106915165381966e-05,0.75
17682,~.~/Punctuation,4,1,3,1.1115310228308472e-05,3.33207454961459e-05,0.75
17683,리얼스틸/Noun,4,3,1,3.3345930684925414e-05,1.1106915165381966e-05,0.75
17684,감개/Noun,4,3,1,3.3345930684925414e-05,1.1106915165381966e-05,0.75
17685,직도/Noun,4,3,1,3.3345930684925414e-05,1.1106915165381966e-05,0.75
17686,유시/Noun,4,3,1,3.3345930684925414e-05,1.1106915165381966e-05,0.75
17687,항적/Noun,4,3,1,3.3345930684925414e-05,1.1106915165381966e-05,0.75
17688,엘리엇/Noun,4,3,1,3.3345930684925414e-05,1.1106915165381966e-05,0.75
17689,크리스토프/Noun,4,3,1,3.3345930684925414e-05,1.1106915165381966e-05,0.75
17690,산속/Noun,4,1,3,1.1115310228308472e-05,3.33207454961459e-05,0.75
17691,아노하나/Noun,4,3,1,3.3345930684925414e-05,1.1106915165381966e-05,0.75
17692,오디/Noun,4,1,3,1.1115310228308472e-05,3.33207454961459e-05,0.75
17693,전광판/Noun,4,1,3,1.1115310228308472e-05,3.33207454961459e-05,0.75
17694,To/Alpha,4,3,1,3.3345930684925414e-05,1.1106915165381966e-05,0.75
17695,..^&^/Punctuation,4,1,3,1.1115310228308472e-05,3.33207454961459e-05,0.75
17696,선동렬/Noun,4,1,3,1.1115310228308472e-05,3.33207454961459e-05,0.75
17697,ㅅㅋ/KoreanParticle,4,1,3,1.1115310228308472e-05,3.33207454961459e-05,0.75
17698,실루엣/Noun,4,3,1,3.3345930684925414e-05,1.1106915165381966e-05,0.75
17699,적기/Noun,4,3,1,3.3345930684925414e-05,1.1106915165381966e-05,0.75
17700,차우/Noun,4,1,3,1.1115310228308472e-05,3.33207454961459e-05,0.75
17701,객석/Noun,4,1,3,1.1115310228308472e-05,3.33207454961459e-05,0.75
17702,군도/Noun,4,3,1,3.3345930684925414e-05,1.1106915165381966e-05,0.75
17703,후크/Noun,4,3,1,3.3345930684925414e-05,1.1106915165381966e-05,0.75
17704,밤바/Noun,4,3,1,3.3345930684925414e-05,1.1106915165381966e-05,0.75
17705,goes/Alpha,4,3,1,3.3345930684925414e-05,1.1106915165381966e-05,0.75
17706,얼라이브/Noun,4,1,3,1.1115310228308472e-05,3.33207454961459e-05,0.75
17707,출진/Noun,4,1,3,1.1115310228308472e-05,3.33207454961459e-05,0.75
17708,글거/Noun,4,1,3,1.1115310228308472e-05,3.33207454961459e-05,0.75
17709,덮이다/Verb,4,3,1,3.3345930684925414e-05,1.1106915165381966e-05,0.75
17710,유미/Noun,4,3,1,3.3345930684925414e-05,1.1106915165381966e-05,0.75
17711,트윈스/Noun,4,1,3,1.1115310228308472e-05,3.33207454961459e-05,0.75
17712,부안/Noun,4,1,3,1.1115310228308472e-05,3.33207454961459e-05,0.75
17713,비종/Noun,4,3,1,3.3345930684925414e-05,1.1106915165381966e-05,0.75
17714,솜사탕/Noun,4,3,1,3.3345930684925414e-05,1.1106915165381966e-05,0.75
17715,우시/Noun,4,1,3,1.1115310228308472e-05,3.33207454961459e-05,0.75
17716,세바퀴/Noun,4,1,3,1.1115310228308472e-05,3.33207454961459e-05,0.75
17717,5-6/Number,4,1,3,1.1115310228308472e-05,3.33207454961459e-05,0.75
17718,오진우/Noun,4,3,1,3.3345930684925414e-05,1.1106915165381966e-05,0.75
17719,루팡/Noun,4,3,1,3.3345930684925414e-05,1.1106915165381966e-05,0.75
17720,비굴하다/Adjective,4,1,3,1.1115310228308472e-05,3.33207454961459e-05,0.75
17721,싸늘하다/Adjective,4,3,1,3.3345930684925414e-05,1.1106915165381966e-05,0.75
17722,채경/Noun,4,1,3,1.1115310228308472e-05,3.33207454961459e-05,0.75
17723,공책/Noun,4,3,1,3.3345930684925414e-05,1.1106915165381966e-05,0.75
17724,3.4/Number,4,3,1,3.3345930684925414e-05,1.1106915165381966e-05,0.75
17725,신성하다/Adjective,4,3,1,3.3345930684925414e-05,1.1106915165381966e-05,0.75
17726,페러다임/Noun,4,3,1,3.3345930684925414e-05,1.1106915165381966e-05,0.75
17727,변수/Noun,4,3,1,3.3345930684925414e-05,1.1106915165381966e-05,0.75
17728,바그다드/Noun,4,3,1,3.3345930684925414e-05,1.1106915165381966e-05,0.75
17729,뿌잉/Noun,4,1,3,1.1115310228308472e-05,3.33207454961459e-05,0.75
17730,바퀴/Noun,4,1,3,1.1115310228308472e-05,3.33207454961459e-05,0.75
17731,도인/Noun,4,1,3,1.1115310228308472e-05,3.33207454961459e-05,0.75
17732,효주/Noun,4,1,3,1.1115310228308472e-05,3.33207454961459e-05,0.75
17733,00년/Number,4,1,3,1.1115310228308472e-05,3.33207454961459e-05,0.75
17734,다망하다/Adjective,4,3,1,3.3345930684925414e-05,1.1106915165381966e-05,0.75
17735,세현/Noun,4,3,1,3.3345930684925414e-05,1.1106915165381966e-05,0.75
17736,코브/Noun,4,3,1,3.3345930684925414e-05,1.1106915165381966e-05,0.75
17737,엄두/Noun,4,1,3,1.1115310228308472e-05,3.33207454961459e-05,0.75
17738,롭다/Noun,4,3,1,3.3345930684925414e-05,1.1106915165381966e-05,0.75
17739,애꾸/Noun,4,1,3,1.1115310228308472e-05,3.33207454961459e-05,0.75
17740,중재/Noun,4,1,3,1.1115310228308472e-05,3.33207454961459e-05,0.75
17741,은혁/Noun,4,1,3,1.1115310228308472e-05,3.33207454961459e-05,0.75
17742,그래프/Noun,4,1,3,1.1115310228308472e-05,3.33207454961459e-05,0.75
17743,개쩔/Noun,4,3,1,3.3345930684925414e-05,1.1106915165381966e-05,0.75
17744,추위/Noun,4,1,3,1.1115310228308472e-05,3.33207454961459e-05,0.75
17745,귤/Noun,4,1,3,1.1115310228308472e-05,3.33207454961459e-05,0.75
17746,린코/Noun,4,3,1,3.3345930684925414e-05,1.1106915165381966e-05,0.75
17747,재일동포/Noun,4,3,1,3.3345930684925414e-05,1.1106915165381966e-05,0.75
17748,나왓/Noun,4,1,3,1.1115310228308472e-05,3.33207454961459e-05,0.75
17749,부정부패/Noun,4,1,3,1.1115310228308472e-05,3.33207454961459e-05,0.75
17750,고살/Noun,4,3,1,3.3345930684925414e-05,1.1106915165381966e-05,0.75
17751,오른손/Noun,4,1,3,1.1115310228308472e-05,3.33207454961459e-05,0.75
17752,태자/Noun,4,3,1,3.3345930684925414e-05,1.1106915165381966e-05,0.75
17753,골프/Noun,4,3,1,3.3345930684925414e-05,1.1106915165381966e-05,0.75
17754,년뒤/Noun,4,3,1,3.3345930684925414e-05,1.1106915165381966e-05,0.75
17755,바토/Noun,4,3,1,3.3345930684925414e-05,1.1106915165381966e-05,0.75
17756,일루/Noun,4,1,3,1.1115310228308472e-05,3.33207454961459e-05,0.75
17757,킬링필드/Noun,4,1,3,1.1115310228308472e-05,3.33207454961459e-05,0.75
17758,좌표/Noun,4,1,3,1.1115310228308472e-05,3.33207454961459e-05,0.75
17759,양민/Noun,4,1,3,1.1115310228308472e-05,3.33207454961459e-05,0.75
17760,실검/Noun,4,1,3,1.1115310228308472e-05,3.33207454961459e-05,0.75
17761,............................../Punctuation,4,1,3,1.1115310228308472e-05,3.33207454961459e-05,0.75
17762,ㅎㄷ/KoreanParticle,4,3,1,3.3345930684925414e-05,1.1106915165381966e-05,0.75
17763,새싹/Noun,4,3,1,3.3345930684925414e-05,1.1106915165381966e-05,0.75
17764,액츄얼리/Noun,4,3,1,3.3345930684925414e-05,1.1106915165381966e-05,0.75
17765,텝/Noun,4,1,3,1.1115310228308472e-05,3.33207454961459e-05,0.75
17766,낙서/Noun,4,1,3,1.1115310228308472e-05,3.33207454961459e-05,0.75
17767,효연/Noun,4,1,3,1.1115310228308472e-05,3.33207454961459e-05,0.75
17768,그깟/Modifier,4,1,3,1.1115310228308472e-05,3.33207454961459e-05,0.75
17769,한가운데/Noun,4,1,3,1.1115310228308472e-05,3.33207454961459e-05,0.75
17770,오옷/Noun,4,3,1,3.3345930684925414e-05,1.1106915165381966e-05,0.75
17771,생떼/Noun,4,1,3,1.1115310228308472e-05,3.33207454961459e-05,0.75
17772,500일/Number,4,3,1,3.3345930684925414e-05,1.1106915165381966e-05,0.75
17773,겨루다/Verb,4,1,3,1.1115310228308472e-05,3.33207454961459e-05,0.75
17774,간달프/Noun,4,1,3,1.1115310228308472e-05,3.33207454961459e-05,0.75
17775,마다의/Josa,4,3,1,3.3345930684925414e-05,1.1106915165381966e-05,0.75
17776,짜리를/Foreign,4,1,3,1.1115310228308472e-05,3.33207454961459e-05,0.75
17777,강진/Noun,4,3,1,3.3345930684925414e-05,1.1106915165381966e-05,0.75
17778,101010/Number,4,3,1,3.3345930684925414e-05,1.1106915165381966e-05,0.75
17779,페이스오프/Noun,4,3,1,3.3345930684925414e-05,1.1106915165381966e-05,0.75
17780,역도산/Noun,4,3,1,3.3345930684925414e-05,1.1106915165381966e-05,0.75
17781,코지/Noun,4,3,1,3.3345930684925414e-05,1.1106915165381966e-05,0.75
17782,족쇄/Noun,4,3,1,3.3345930684925414e-05,1.1106915165381966e-05,0.75
17783,잠식/Noun,4,3,1,3.3345930684925414e-05,1.1106915165381966e-05,0.75
17784,되돌아오다/Verb,4,1,3,1.1115310228308472e-05,3.33207454961459e-05,0.75
17785,가십/Noun,4,3,1,3.3345930684925414e-05,1.1106915165381966e-05,0.75
17786,털끝/Noun,4,1,3,1.1115310228308472e-05,3.33207454961459e-05,0.75
17787,양말/Noun,4,3,1,3.3345930684925414e-05,1.1106915165381966e-05,0.75
17788,어엉/Noun,4,3,1,3.3345930684925414e-05,1.1106915165381966e-05,0.75
17789,텔론/Noun,4,3,1,3.3345930684925414e-05,1.1106915165381966e-05,0.75
17790,베스타스/Noun,4,3,1,3.3345930684925414e-05,1.1106915165381966e-05,0.75
17791,유대/Noun,4,1,3,1.1115310228308472e-05,3.33207454961459e-05,0.75
17792,오싹/Noun,4,3,1,3.3345930684925414e-05,1.1106915165381966e-05,0.75
17793,음하하/Exclamation,4,1,3,1.1115310228308472e-05,3.33207454961459e-05,0.75
17794,고속버스/Noun,4,3,1,3.3345930684925414e-05,1.1106915165381966e-05,0.75
17795,레이놀즈/Noun,4,1,3,1.1115310228308472e-05,3.33207454961459e-05,0.75
17796,here/Alpha,4,3,1,3.3345930684925414e-05,1.1106915165381966e-05,0.75
17797,칸느/Noun,4,1,3,1.1115310228308472e-05,3.33207454961459e-05,0.75
17798,콜라보레이션/Noun,4,3,1,3.3345930684925414e-05,1.1106915165381966e-05,0.75
17799,광우병/Noun,4,1,3,1.1115310228308472e-05,3.33207454961459e-05,0.75
17800,필견/Noun,4,3,1,3.3345930684925414e-05,1.1106915165381966e-05,0.75
17801,광신/Noun,4,1,3,1.1115310228308472e-05,3.33207454961459e-05,0.75
17802,본부/Noun,4,1,3,1.1115310228308472e-05,3.33207454961459e-05,0.75
17803,4000/Number,4,1,3,1.1115310228308472e-05,3.33207454961459e-05,0.75
17804,캐논/Noun,4,3,1,3.3345930684925414e-05,1.1106915165381966e-05,0.75
17805,생뚱/Noun,4,1,3,1.1115310228308472e-05,3.33207454961459e-05,0.75
17806,콘크리트/Noun,4,3,1,3.3345930684925414e-05,1.1106915165381966e-05,0.75
17807,하하호호/Noun,4,3,1,3.3345930684925414e-05,1.1106915165381966e-05,0.75
17808,견주/Noun,4,3,1,3.3345930684925414e-05,1.1106915165381966e-05,0.75
17809,아더/Noun,4,3,1,3.3345930684925414e-05,1.1106915165381966e-05,0.75
17810,전전긍긍/Noun,4,1,3,1.1115310228308472e-05,3.33207454961459e-05,0.75
17811,away/Alpha,4,3,1,3.3345930684925414e-05,1.1106915165381966e-05,0.75
17812,물리학/Noun,4,1,3,1.1115310228308472e-05,3.33207454961459e-05,0.75
17813,ㅠㅠㅋ/KoreanParticle,4,3,1,3.3345930684925414e-05,1.1106915165381966e-05,0.75
17814,핡핡/Noun,4,3,1,3.3345930684925414e-05,1.1106915165381966e-05,0.75
17815,승현/Noun,4,3,1,3.3345930684925414e-05,1.1106915165381966e-05,0.75
17816,!!!!!!!!!!!!!!!!!!!!!!!!!/Punctuation,4,3,1,3.3345930684925414e-05,1.1106915165381966e-05,0.75
17817,흡족하다/Adjective,4,3,1,3.3345930684925414e-05,1.1106915165381966e-05,0.75
17818,휴스턴/Noun,4,1,3,1.1115310228308472e-05,3.33207454961459e-05,0.75
17819,군무/Noun,4,3,1,3.3345930684925414e-05,1.1106915165381966e-05,0.75
17820,예여/Josa,4,3,1,3.3345930684925414e-05,1.1106915165381966e-05,0.75
17821,쿠라/Noun,4,1,3,1.1115310228308472e-05,3.33207454961459e-05,0.75
17822,쭉빵/Noun,4,1,3,1.1115310228308472e-05,3.33207454961459e-05,0.75
17823,랭보/Noun,4,3,1,3.3345930684925414e-05,1.1106915165381966e-05,0.75
17824,김득구/Noun,4,3,1,3.3345930684925414e-05,1.1106915165381966e-05,0.75
17825,백동수/Noun,4,1,3,1.1115310228308472e-05,3.33207454961459e-05,0.75
17826,퀀/Noun,4,3,1,3.3345930684925414e-05,1.1106915165381966e-05,0.75
17827,아미르/Noun,4,3,1,3.3345930684925414e-05,1.1106915165381966e-05,0.75
17828,맹신/Noun,4,1,3,1.1115310228308472e-05,3.33207454961459e-05,0.75
17829,웨이즈/Noun,4,1,3,1.1115310228308472e-05,3.33207454961459e-05,0.75
17830,몽타주/Noun,4,3,1,3.3345930684925414e-05,1.1106915165381966e-05,0.75
17831,26일/Number,4,1,3,1.1115310228308472e-05,3.33207454961459e-05,0.75
17832,분할/Noun,4,1,3,1.1115310228308472e-05,3.33207454961459e-05,0.75
17833,허영만/Noun,4,1,3,1.1115310228308472e-05,3.33207454961459e-05,0.75
17834,부당거래/Noun,4,3,1,3.3345930684925414e-05,1.1106915165381966e-05,0.75
17835,싸이트/Noun,4,1,3,1.1115310228308472e-05,3.33207454961459e-05,0.75
17836,메리크리스마스/Noun,4,3,1,3.3345930684925414e-05,1.1106915165381966e-05,0.75
17837,아차/Noun,4,3,1,3.3345930684925414e-05,1.1106915165381966e-05,0.75
17838,머드/Noun,4,3,1,3.3345930684925414e-05,1.1106915165381966e-05,0.75
17839,밝아지다/Verb,4,3,1,3.3345930684925414e-05,1.1106915165381966e-05,0.75
17840,야성/Noun,4,3,1,3.3345930684925414e-05,1.1106915165381966e-05,0.75
17841,습보/Noun,4,1,3,1.1115310228308472e-05,3.33207454961459e-05,0.75
17842,붙잡히다/Verb,4,1,3,1.1115310228308472e-05,3.33207454961459e-05,0.75
17843,인디밴드/Noun,4,3,1,3.3345930684925414e-05,1.1106915165381966e-05,0.75
17844,감돈/Noun,4,3,1,3.3345930684925414e-05,1.1106915165381966e-05,0.75
17845,굳어지다/Verb,4,3,1,3.3345930684925414e-05,1.1106915165381966e-05,0.75
17846,와웅/Noun,4,3,1,3.3345930684925414e-05,1.1106915165381966e-05,0.75
17847,뚝심/Noun,4,3,1,3.3345930684925414e-05,1.1106915165381966e-05,0.75
17848,.>/Punctuation,4,3,1,3.3345930684925414e-05,1.1106915165381966e-05,0.75
17849,부랑/Noun,4,1,3,1.1115310228308472e-05,3.33207454961459e-05,0.75
17850,우성/Noun,4,3,1,3.3345930684925414e-05,1.1106915165381966e-05,0.75
17851,여경/Noun,4,1,3,1.1115310228308472e-05,3.33207454961459e-05,0.75
17852,관지림/Noun,4,3,1,3.3345930684925414e-05,1.1106915165381966e-05,0.75
17853,이재희/Noun,4,1,3,1.1115310228308472e-05,3.33207454961459e-05,0.75
17854,진관희/Noun,4,3,1,3.3345930684925414e-05,1.1106915165381966e-05,0.75
17855,십덕/Noun,4,1,3,1.1115310228308472e-05,3.33207454961459e-05,0.75
17856,쿵짝/Noun,4,3,1,3.3345930684925414e-05,1.1106915165381966e-05,0.75
17857,으로선/Josa,4,3,1,3.3345930684925414e-05,1.1106915165381966e-05,0.75
17858,/./Punctuation,4,1,3,1.1115310228308472e-05,3.33207454961459e-05,0.75
17859,투덜대다/Verb,4,3,1,3.3345930684925414e-05,1.1106915165381966e-05,0.75
17860,현준/Noun,4,1,3,1.1115310228308472e-05,3.33207454961459e-05,0.75
17861,낚여/Noun,4,3,1,3.3345930684925414e-05,1.1106915165381966e-05,0.75
17862,소용없다/Adjective,4,1,3,1.1115310228308472e-05,3.33207454961459e-05,0.75
17863,디엠/Noun,4,3,1,3.3345930684925414e-05,1.1106915165381966e-05,0.75
17864,gta/Alpha,4,1,3,1.1115310228308472e-05,3.33207454961459e-05,0.75
17865,비기다/Verb,4,1,3,1.1115310228308472e-05,3.33207454961459e-05,0.75
17866,키리시/Noun,4,3,1,3.3345930684925414e-05,1.1106915165381966e-05,0.75
17867,이보희/Noun,4,3,1,3.3345930684925414e-05,1.1106915165381966e-05,0.75
17868,올란도/Noun,4,1,3,1.1115310228308472e-05,3.33207454961459e-05,0.75
17869,오바마/Noun,4,1,3,1.1115310228308472e-05,3.33207454961459e-05,0.75
17870,게이지/Noun,4,1,3,1.1115310228308472e-05,3.33207454961459e-05,0.75
17871,엔/Noun,4,1,3,1.1115310228308472e-05,3.33207454961459e-05,0.75
17872,대초반/Foreign,4,1,3,1.1115310228308472e-05,3.33207454961459e-05,0.75
17873,일급/Noun,4,1,3,1.1115310228308472e-05,3.33207454961459e-05,0.75
17874,마직막/Noun,4,1,3,1.1115310228308472e-05,3.33207454961459e-05,0.75
17875,후후훗/Exclamation,4,3,1,3.3345930684925414e-05,1.1106915165381966e-05,0.75
17876,파키스탄/Noun,4,1,3,1.1115310228308472e-05,3.33207454961459e-05,0.75
17877,프레드/Noun,4,3,1,3.3345930684925414e-05,1.1106915165381966e-05,0.75
17878,브루노/Noun,4,1,3,1.1115310228308472e-05,3.33207454961459e-05,0.75
17879,추세/Noun,4,1,3,1.1115310228308472e-05,3.33207454961459e-05,0.75
17880,일레인/Noun,4,3,1,3.3345930684925414e-05,1.1106915165381966e-05,0.75
17881,알바니/Noun,4,1,3,1.1115310228308472e-05,3.33207454961459e-05,0.75
17882,성품/Noun,4,1,3,1.1115310228308472e-05,3.33207454961459e-05,0.75
17883,버무러진/Noun,4,3,1,3.3345930684925414e-05,1.1106915165381966e-05,0.75
17884,비지스/Noun,4,3,1,3.3345930684925414e-05,1.1106915165381966e-05,0.75
17885,하이힐/Noun,4,1,3,1.1115310228308472e-05,3.33207454961459e-05,0.75
17886,totally/Alpha,4,1,3,1.1115310228308472e-05,3.33207454961459e-05,0.75
17887,정진영/Noun,4,1,3,1.1115310228308472e-05,3.33207454961459e-05,0.75
17888,멘타/Noun,4,1,3,1.1115310228308472e-05,3.33207454961459e-05,0.75
17889,히스레져/Noun,4,3,1,3.3345930684925414e-05,1.1106915165381966e-05,0.75
17890,낙엽/Noun,4,1,3,1.1115310228308472e-05,3.33207454961459e-05,0.75
17891,서신애/Noun,4,3,1,3.3345930684925414e-05,1.1106915165381966e-05,0.75
17892,가당/Noun,4,1,3,1.1115310228308472e-05,3.33207454961459e-05,0.75
17893,추종자/Noun,4,1,3,1.1115310228308472e-05,3.33207454961459e-05,0.75
17894,헤니/Noun,4,1,3,1.1115310228308472e-05,3.33207454961459e-05,0.75
17895,과속/Noun,4,3,1,3.3345930684925414e-05,1.1106915165381966e-05,0.75
17896,경감/Noun,4,1,3,1.1115310228308472e-05,3.33207454961459e-05,0.75
17897,꽁치/Noun,4,1,3,1.1115310228308472e-05,3.33207454961459e-05,0.75
17898,교가/Noun,4,3,1,3.3345930684925414e-05,1.1106915165381966e-05,0.75
17899,불가사의/Noun,4,1,3,1.1115310228308472e-05,3.33207454961459e-05,0.75
17900,소방/Noun,4,1,3,1.1115310228308472e-05,3.33207454961459e-05,0.75
17901,김기범/Noun,4,1,3,1.1115310228308472e-05,3.33207454961459e-05,0.75
17902,포지션/Noun,4,1,3,1.1115310228308472e-05,3.33207454961459e-05,0.75
17903,항거/Noun,4,1,3,1.1115310228308472e-05,3.33207454961459e-05,0.75
17904,왕조/Noun,4,1,3,1.1115310228308472e-05,3.33207454961459e-05,0.75
17905,장렬/Noun,4,3,1,3.3345930684925414e-05,1.1106915165381966e-05,0.75
17906,취직/Noun,4,1,3,1.1115310228308472e-05,3.33207454961459e-05,0.75
17907,.../Foreign,4,1,3,1.1115310228308472e-05,3.33207454961459e-05,0.75
17908,별수/Noun,4,1,3,1.1115310228308472e-05,3.33207454961459e-05,0.75
17909,세종대왕/Noun,4,1,3,1.1115310228308472e-05,3.33207454961459e-05,0.75
17910,외세/Noun,4,3,1,3.3345930684925414e-05,1.1106915165381966e-05,0.75
17911,강하늘/Noun,4,3,1,3.3345930684925414e-05,1.1106915165381966e-05,0.75
17912,수레기/Noun,4,1,3,1.1115310228308472e-05,3.33207454961459e-05,0.75
17913,카메룬/Noun,4,3,1,3.3345930684925414e-05,1.1106915165381966e-05,0.75
17914,마이티/Noun,4,3,1,3.3345930684925414e-05,1.1106915165381966e-05,0.75
17915,나드/Noun,4,1,3,1.1115310228308472e-05,3.33207454961459e-05,0.75
17916,봣던거/Noun,4,3,1,3.3345930684925414e-05,1.1106915165381966e-05,0.75
17917,뭐건/Noun,4,1,3,1.1115310228308472e-05,3.33207454961459e-05,0.75
17918,찡그리다/Verb,4,1,3,1.1115310228308472e-05,3.33207454961459e-05,0.75
17919,막상막하/Noun,4,1,3,1.1115310228308472e-05,3.33207454961459e-05,0.75
17920,명박/Noun,4,1,3,1.1115310228308472e-05,3.33207454961459e-05,0.75
17921,star/Alpha,4,3,1,3.3345930684925414e-05,1.1106915165381966e-05,0.75
17922,th/Alpha,4,3,1,3.3345930684925414e-05,1.1106915165381966e-05,0.75
17923,파묻히다/Verb,4,1,3,1.1115310228308472e-05,3.33207454961459e-05,0.75
17924,play/Alpha,4,3,1,3.3345930684925414e-05,1.1106915165381966e-05,0.75
17925,작이라고는/Foreign,4,1,3,1.1115310228308472e-05,3.33207454961459e-05,0.75
17926,소담/Noun,4,3,1,3.3345930684925414e-05,1.1106915165381966e-05,0.75
17927,실연/Noun,4,3,1,3.3345930684925414e-05,1.1106915165381966e-05,0.75
17928,외박/Noun,4,1,3,1.1115310228308472e-05,3.33207454961459e-05,0.75
17929,산화/Noun,4,1,3,1.1115310228308472e-05,3.33207454961459e-05,0.75
17930,이말년/Noun,4,1,3,1.1115310228308472e-05,3.33207454961459e-05,0.75
17931,맛탱/Noun,4,1,3,1.1115310228308472e-05,3.33207454961459e-05,0.75
17932,.;;;/Punctuation,4,1,3,1.1115310228308472e-05,3.33207454961459e-05,0.75
17933,꾸리다/Verb,4,1,3,1.1115310228308472e-05,3.33207454961459e-05,0.75
17934,축약/Noun,4,3,1,3.3345930684925414e-05,1.1106915165381966e-05,0.75
17935,미그/Noun,4,1,3,1.1115310228308472e-05,3.33207454961459e-05,0.75
17936,책정/Noun,4,1,3,1.1115310228308472e-05,3.33207454961459e-05,0.75
17937,청와대/Noun,4,1,3,1.1115310228308472e-05,3.33207454961459e-05,0.75
17938,설킨/Noun,4,3,1,3.3345930684925414e-05,1.1106915165381966e-05,0.75
17939,스탈린/Noun,4,3,1,3.3345930684925414e-05,1.1106915165381966e-05,0.75
17940,장재인/Noun,4,3,1,3.3345930684925414e-05,1.1106915165381966e-05,0.75
17941,윤다훈/Noun,4,1,3,1.1115310228308472e-05,3.33207454961459e-05,0.75
17942,_!/Punctuation,4,3,1,3.3345930684925414e-05,1.1106915165381966e-05,0.75
17943,장거리/Noun,4,3,1,3.3345930684925414e-05,1.1106915165381966e-05,0.75
17944,본새/Noun,4,1,3,1.1115310228308472e-05,3.33207454961459e-05,0.75
17945,굶주리다/Verb,4,3,1,3.3345930684925414e-05,1.1106915165381966e-05,0.75
17946,부적절하다/Adjective,4,1,3,1.1115310228308472e-05,3.33207454961459e-05,0.75
17947,동사/Noun,4,1,3,1.1115310228308472e-05,3.33207454961459e-05,0.75
17948,관좀/Noun,4,3,1,3.3345930684925414e-05,1.1106915165381966e-05,0.75
17949,곧이/Adverb,4,1,3,1.1115310228308472e-05,3.33207454961459e-05,0.75
17950,신기록/Noun,4,1,3,1.1115310228308472e-05,3.33207454961459e-05,0.75
17951,작가라/Noun,4,1,3,1.1115310228308472e-05,3.33207454961459e-05,0.75
17952,배수빈/Noun,4,3,1,3.3345930684925414e-05,1.1106915165381966e-05,0.75
17953,박노식/Noun,4,1,3,1.1115310228308472e-05,3.33207454961459e-05,0.75
17954,몽매/Noun,4,1,3,1.1115310228308472e-05,3.33207454961459e-05,0.75
17955,백마/Noun,4,1,3,1.1115310228308472e-05,3.33207454961459e-05,0.75
17956,헌터헌터/Noun,4,1,3,1.1115310228308472e-05,3.33207454961459e-05,0.75
17957,티셔츠/Noun,4,3,1,3.3345930684925414e-05,1.1106915165381966e-05,0.75
17958,어김없이/Adverb,4,1,3,1.1115310228308472e-05,3.33207454961459e-05,0.75
17959,도에도/Foreign,4,3,1,3.3345930684925414e-05,1.1106915165381966e-05,0.75
17960,가바/Noun,4,1,3,1.1115310228308472e-05,3.33207454961459e-05,0.75
17961,조디악/Noun,4,1,3,1.1115310228308472e-05,3.33207454961459e-05,0.75
17962,외할아버지/Noun,4,3,1,3.3345930684925414e-05,1.1106915165381966e-05,0.75
17963,간통죄/Noun,4,1,3,1.1115310228308472e-05,3.33207454961459e-05,0.75
17964,CJ/Alpha,4,1,3,1.1115310228308472e-05,3.33207454961459e-05,0.75
17965,엔젤아이즈/Noun,4,3,1,3.3345930684925414e-05,1.1106915165381966e-05,0.75
17966,유니세프/Noun,4,1,3,1.1115310228308472e-05,3.33207454961459e-05,0.75
17967,오라버니/Noun,4,3,1,3.3345930684925414e-05,1.1106915165381966e-05,0.75
17968,달동/Noun,4,3,1,3.3345930684925414e-05,1.1106915165381966e-05,0.75
17969,모범생/Noun,4,3,1,3.3345930684925414e-05,1.1106915165381966e-05,0.75
17970,숏컷/Noun,4,3,1,3.3345930684925414e-05,1.1106915165381966e-05,0.75
17971,무과/Noun,4,1,3,1.1115310228308472e-05,3.33207454961459e-05,0.75
17972,레비아탄/Noun,4,3,1,3.3345930684925414e-05,1.1106915165381966e-05,0.75
17973,사카모토/Noun,4,3,1,3.3345930684925414e-05,1.1106915165381966e-05,0.75
17974,종사/Noun,4,1,3,1.1115310228308472e-05,3.33207454961459e-05,0.75
17975,순례/Noun,4,3,1,3.3345930684925414e-05,1.1106915165381966e-05,0.75
17976,아이피/Noun,4,1,3,1.1115310228308472e-05,3.33207454961459e-05,0.75
17977,열대야/Noun,4,3,1,3.3345930684925414e-05,1.1106915165381966e-05,0.75
17978,without/Alpha,4,3,1,3.3345930684925414e-05,1.1106915165381966e-05,0.75
17979,경쟁력/Noun,4,1,3,1.1115310228308472e-05,3.33207454961459e-05,0.75
17980,라일/Noun,4,3,1,3.3345930684925414e-05,1.1106915165381966e-05,0.75
17981,왓습니/Noun,4,3,1,3.3345930684925414e-05,1.1106915165381966e-05,0.75
17982,왕비/Noun,4,3,1,3.3345930684925414e-05,1.1106915165381966e-05,0.75
17983,정일/Noun,4,1,3,1.1115310228308472e-05,3.33207454961459e-05,0.75
17984,롬/Noun,4,1,3,1.1115310228308472e-05,3.33207454961459e-05,0.75
17985,알렉산드라/Noun,4,1,3,1.1115310228308472e-05,3.33207454961459e-05,0.75
17986,슈왈제네거/Noun,4,3,1,3.3345930684925414e-05,1.1106915165381966e-05,0.75
17987,거사/Noun,4,1,3,1.1115310228308472e-05,3.33207454961459e-05,0.75
17988,지환/Noun,4,3,1,3.3345930684925414e-05,1.1106915165381966e-05,0.75
17989,심야식당/Noun,4,1,3,1.1115310228308472e-05,3.33207454961459e-05,0.75
17990,재인/Noun,4,3,1,3.3345930684925414e-05,1.1106915165381966e-05,0.75
17991,기로/Eomi,4,3,1,3.3345930684925414e-05,1.1106915165381966e-05,0.75
17992,크라이/Noun,4,3,1,3.3345930684925414e-05,1.1106915165381966e-05,0.75
17993,네마/Noun,4,1,3,1.1115310228308472e-05,3.33207454961459e-05,0.75
17994,진목승/Noun,4,1,3,1.1115310228308472e-05,3.33207454961459e-05,0.75
17995,감사히/Adverb,4,3,1,3.3345930684925414e-05,1.1106915165381966e-05,0.75
17996,한인/Noun,4,3,1,3.3345930684925414e-05,1.1106915165381966e-05,0.75
17997,측정/Noun,4,1,3,1.1115310228308472e-05,3.33207454961459e-05,0.75
17998,연개/Noun,4,1,3,1.1115310228308472e-05,3.33207454961459e-05,0.75
17999,지성인/Noun,4,3,1,3.3345930684925414e-05,1.1106915165381966e-05,0.75
18000,교시/Noun,4,1,3,1.1115310228308472e-05,3.33207454961459e-05,0.75
18001,왕도/Noun,4,3,1,3.3345930684925414e-05,1.1106915165381966e-05,0.75
18002,알콜중독/Noun,4,3,1,3.3345930684925414e-05,1.1106915165381966e-05,0.75
18003,나가시/Noun,4,1,3,1.1115310228308472e-05,3.33207454961459e-05,0.75
18004,섣불리/Noun,4,3,1,3.3345930684925414e-05,1.1106915165381966e-05,0.75
18005,망령/Noun,4,1,3,1.1115310228308472e-05,3.33207454961459e-05,0.75
18006,new/Alpha,4,3,1,3.3345930684925414e-05,1.1106915165381966e-05,0.75
18007,폐허/Noun,4,3,1,3.3345930684925414e-05,1.1106915165381966e-05,0.75
18008,이완용/Noun,4,1,3,1.1115310228308472e-05,3.33207454961459e-05,0.75
18009,요업/Noun,4,3,1,3.3345930684925414e-05,1.1106915165381966e-05,0.75
18010,태식/Noun,4,3,1,3.3345930684925414e-05,1.1106915165381966e-05,0.75
18011,단아/Noun,4,1,3,1.1115310228308472e-05,3.33207454961459e-05,0.75
18012,무제/Noun,4,3,1,3.3345930684925414e-05,1.1106915165381966e-05,0.75
18013,빰/Noun,4,1,3,1.1115310228308472e-05,3.33207454961459e-05,0.75
18014,가까이/Foreign,4,3,1,3.3345930684925414e-05,1.1106915165381966e-05,0.75
18015,용철/Noun,4,3,1,3.3345930684925414e-05,1.1106915165381966e-05,0.75
18016,태지/Noun,4,3,1,3.3345930684925414e-05,1.1106915165381966e-05,0.75
18017,친영/Noun,4,1,3,1.1115310228308472e-05,3.33207454961459e-05,0.75
18018,명단/Noun,4,1,3,1.1115310228308472e-05,3.33207454961459e-05,0.75
18019,망햇/Noun,4,1,3,1.1115310228308472e-05,3.33207454961459e-05,0.75
18020,장옥정/Noun,4,3,1,3.3345930684925414e-05,1.1106915165381966e-05,0.75
18021,!^^*/Punctuation,4,3,1,3.3345930684925414e-05,1.1106915165381966e-05,0.75
18022,인디음악/Noun,4,1,3,1.1115310228308472e-05,3.33207454961459e-05,0.75
18023,윤호/Noun,4,1,3,1.1115310228308472e-05,3.33207454961459e-05,0.75
18024,칵/Noun,4,1,3,1.1115310228308472e-05,3.33207454961459e-05,0.75
18025,백여/Modifier,4,3,1,3.3345930684925414e-05,1.1106915165381966e-05,0.75
18026,애견/Noun,4,1,3,1.1115310228308472e-05,3.33207454961459e-05,0.75
18027,기발/Noun,4,3,1,3.3345930684925414e-05,1.1106915165381966e-05,0.75
18028,판국/Noun,4,1,3,1.1115310228308472e-05,3.33207454961459e-05,0.75
18029,씨익/Noun,4,1,3,1.1115310228308472e-05,3.33207454961459e-05,0.75
18030,이엘/Noun,4,1,3,1.1115310228308472e-05,3.33207454961459e-05,0.75
18031,선우일란/Noun,4,1,3,1.1115310228308472e-05,3.33207454961459e-05,0.75
18032,휙/Noun,4,3,1,3.3345930684925414e-05,1.1106915165381966e-05,0.75
18033,배반/Noun,4,1,3,1.1115310228308472e-05,3.33207454961459e-05,0.75
18034,이상민/Noun,4,1,3,1.1115310228308472e-05,3.33207454961459e-05,0.75
18035,가위손/Noun,4,3,1,3.3345930684925414e-05,1.1106915165381966e-05,0.75
18036,감행/Noun,4,1,3,1.1115310228308472e-05,3.33207454961459e-05,0.75
18037,향기롭다/Adjective,4,3,1,3.3345930684925414e-05,1.1106915165381966e-05,0.75
18038,유족/Noun,4,1,3,1.1115310228308472e-05,3.33207454961459e-05,0.75
18039,천성/Noun,4,3,1,3.3345930684925414e-05,1.1106915165381966e-05,0.75
18040,비번/Noun,4,1,3,1.1115310228308472e-05,3.33207454961459e-05,0.75
18041,토리코/Noun,4,3,1,3.3345930684925414e-05,1.1106915165381966e-05,0.75
18042,털털/Noun,4,3,1,3.3345930684925414e-05,1.1106915165381966e-05,0.75
18043,..</Punctuation,4,3,1,3.3345930684925414e-05,1.1106915165381966e-05,0.75
18044,색정/Noun,4,1,3,1.1115310228308472e-05,3.33207454961459e-05,0.75
18045,참조/Noun,4,3,1,3.3345930684925414e-05,1.1106915165381966e-05,0.75
18046,통통하다/Adjective,4,3,1,3.3345930684925414e-05,1.1106915165381966e-05,0.75
18047,먹이사슬/Noun,4,3,1,3.3345930684925414e-05,1.1106915165381966e-05,0.75
18048,해어지다/Verb,4,3,1,3.3345930684925414e-05,1.1106915165381966e-05,0.75
18049,;;.../Punctuation,4,1,3,1.1115310228308472e-05,3.33207454961459e-05,0.75
18050,색계/Noun,4,3,1,3.3345930684925414e-05,1.1106915165381966e-05,0.75
18051,단물/Noun,4,1,3,1.1115310228308472e-05,3.33207454961459e-05,0.75
18052,증가/Noun,4,1,3,1.1115310228308472e-05,3.33207454961459e-05,0.75
18053,등용문/Noun,4,3,1,3.3345930684925414e-05,1.1106915165381966e-05,0.75
18054,발자취/Noun,4,3,1,3.3345930684925414e-05,1.1106915165381966e-05,0.75
18055,의논/Noun,4,1,3,1.1115310228308472e-05,3.33207454961459e-05,0.75
18056,티끌/Noun,4,3,1,3.3345930684925414e-05,1.1106915165381966e-05,0.75
18057,금욕/Noun,4,3,1,3.3345930684925414e-05,1.1106915165381966e-05,0.75
18058,뉴에이지/Noun,4,1,3,1.1115310228308472e-05,3.33207454961459e-05,0.75
18059,처럼만/Josa,4,1,3,1.1115310228308472e-05,3.33207454961459e-05,0.75
18060,고만고만하다/Adjective,4,1,3,1.1115310228308472e-05,3.33207454961459e-05,0.75
18061,어중/Noun,4,1,3,1.1115310228308472e-05,3.33207454961459e-05,0.75
18062,불평등/Noun,4,3,1,3.3345930684925414e-05,1.1106915165381966e-05,0.75
18063,소년원/Noun,4,1,3,1.1115310228308472e-05,3.33207454961459e-05,0.75
18064,육회/Noun,4,1,3,1.1115310228308472e-05,3.33207454961459e-05,0.75
18065,오스트리아/Noun,4,1,3,1.1115310228308472e-05,3.33207454961459e-05,0.75
18066,적성/Noun,4,1,3,1.1115310228308472e-05,3.33207454961459e-05,0.75
18067,얼떨결/Noun,4,3,1,3.3345930684925414e-05,1.1106915165381966e-05,0.75
18068,24시/Number,4,3,1,3.3345930684925414e-05,1.1106915165381966e-05,0.75
18069,이규형/Noun,4,3,1,3.3345930684925414e-05,1.1106915165381966e-05,0.75
18070,무극/Noun,4,1,3,1.1115310228308472e-05,3.33207454961459e-05,0.75
18071,규명/Noun,4,3,1,3.3345930684925414e-05,1.1106915165381966e-05,0.75
18072,반헬싱/Noun,4,1,3,1.1115310228308472e-05,3.33207454961459e-05,0.75
18073,여류/Noun,4,3,1,3.3345930684925414e-05,1.1106915165381966e-05,0.75
18074,어리석음/Noun,4,1,3,1.1115310228308472e-05,3.33207454961459e-05,0.75
18075,의드/Noun,4,3,1,3.3345930684925414e-05,1.1106915165381966e-05,0.75
18076,마하/Noun,4,1,3,1.1115310228308472e-05,3.33207454961459e-05,0.75
18077,빅뱅이론/Noun,4,1,3,1.1115310228308472e-05,3.33207454961459e-05,0.75
18078,수발/Noun,4,1,3,1.1115310228308472e-05,3.33207454961459e-05,0.75
18079,상사부일체/Noun,4,1,3,1.1115310228308472e-05,3.33207454961459e-05,0.75
18080,밨다/Noun,4,3,1,3.3345930684925414e-05,1.1106915165381966e-05,0.75
18081,풍경화/Noun,4,3,1,3.3345930684925414e-05,1.1106915165381966e-05,0.75
18082,캠벨/Noun,4,1,3,1.1115310228308472e-05,3.33207454961459e-05,0.75
18083,편입/Noun,4,3,1,3.3345930684925414e-05,1.1106915165381966e-05,0.75
18084,업슴/Noun,4,1,3,1.1115310228308472e-05,3.33207454961459e-05,0.75
18085,하란/Noun,4,1,3,1.1115310228308472e-05,3.33207454961459e-05,0.75
18086,다봣다/Noun,4,3,1,3.3345930684925414e-05,1.1106915165381966e-05,0.75
18087,중천/Noun,4,1,3,1.1115310228308472e-05,3.33207454961459e-05,0.75
18088,촉/Noun,4,1,3,1.1115310228308472e-05,3.33207454961459e-05,0.75
18089,이쁜이/Noun,4,3,1,3.3345930684925414e-05,1.1106915165381966e-05,0.75
18090,한우/Noun,4,1,3,1.1115310228308472e-05,3.33207454961459e-05,0.75
18091,한가하다/Adjective,4,1,3,1.1115310228308472e-05,3.33207454961459e-05,0.75
18092,......................................../Punctuation,4,1,3,1.1115310228308472e-05,3.33207454961459e-05,0.75
18093,토악질/Noun,4,1,3,1.1115310228308472e-05,3.33207454961459e-05,0.75
18094,수연/Noun,4,3,1,3.3345930684925414e-05,1.1106915165381966e-05,0.75
18095,70-80년/Number,4,1,3,1.1115310228308472e-05,3.33207454961459e-05,0.75
18096,지중해/Noun,4,3,1,3.3345930684925414e-05,1.1106915165381966e-05,0.75
18097,점심/Noun,4,3,1,3.3345930684925414e-05,1.1106915165381966e-05,0.75
18098,동맹/Noun,4,1,3,1.1115310228308472e-05,3.33207454961459e-05,0.75
18099,비탄/Noun,4,3,1,3.3345930684925414e-05,1.1106915165381966e-05,0.75
18100,느데/Noun,4,1,3,1.1115310228308472e-05,3.33207454961459e-05,0.75
18101,모텐슨/Noun,4,3,1,3.3345930684925414e-05,1.1106915165381966e-05,0.75
18102,종착역/Noun,4,3,1,3.3345930684925414e-05,1.1106915165381966e-05,0.75
18103,대장정/Noun,4,3,1,3.3345930684925414e-05,1.1106915165381966e-05,0.75
18104,자학/Noun,4,1,3,1.1115310228308472e-05,3.33207454961459e-05,0.75
18105,행진곡/Noun,4,3,1,3.3345930684925414e-05,1.1106915165381966e-05,0.75
18106,시조/Noun,4,3,1,3.3345930684925414e-05,1.1106915165381966e-05,0.75
18107,사육/Noun,4,1,3,1.1115310228308472e-05,3.33207454961459e-05,0.75
18108,아크로바틱/Noun,4,3,1,3.3345930684925414e-05,1.1106915165381966e-05,0.75
18109,변두리/Noun,4,3,1,3.3345930684925414e-05,1.1106915165381966e-05,0.75
18110,벼랑/Noun,4,3,1,3.3345930684925414e-05,1.1106915165381966e-05,0.75
18111,대피/Noun,4,1,3,1.1115310228308472e-05,3.33207454961459e-05,0.75
18112,아랑/Noun,4,3,1,3.3345930684925414e-05,1.1106915165381966e-05,0.75
18113,역린/Noun,4,3,1,3.3345930684925414e-05,1.1106915165381966e-05,0.75
18114,10위안/Number,4,3,1,3.3345930684925414e-05,1.1106915165381966e-05,0.75
18115,문관/Noun,4,1,3,1.1115310228308472e-05,3.33207454961459e-05,0.75
18116,주정뱅이/Noun,4,1,3,1.1115310228308472e-05,3.33207454961459e-05,0.75
18117,도살/Noun,4,1,3,1.1115310228308472e-05,3.33207454961459e-05,0.75
18118,장보고/Noun,4,3,1,3.3345930684925414e-05,1.1106915165381966e-05,0.75
18119,블랑쉐/Noun,4,3,1,3.3345930684925414e-05,1.1106915165381966e-05,0.75
18120,재중/Noun,4,3,1,3.3345930684925414e-05,1.1106915165381966e-05,0.75
18121,생중계/Noun,4,3,1,3.3345930684925414e-05,1.1106915165381966e-05,0.75
18122,바짝/Noun,4,3,1,3.3345930684925414e-05,1.1106915165381966e-05,0.75
18123,리까/Noun,4,3,1,3.3345930684925414e-05,1.1106915165381966e-05,0.75
18124,나태하다/Adjective,4,1,3,1.1115310228308472e-05,3.33207454961459e-05,0.75
18125,강탈/Noun,4,1,3,1.1115310228308472e-05,3.33207454961459e-05,0.75
18126,혜교/Noun,4,3,1,3.3345930684925414e-05,1.1106915165381966e-05,0.75
18127,저년/Noun,4,1,3,1.1115310228308472e-05,3.33207454961459e-05,0.75
18128,무용지물/Noun,4,1,3,1.1115310228308472e-05,3.33207454961459e-05,0.75
18129,플랜/Noun,4,1,3,1.1115310228308472e-05,3.33207454961459e-05,0.75
18130,쯔/Noun,4,3,1,3.3345930684925414e-05,1.1106915165381966e-05,0.75
18131,대딩/Noun,4,1,3,1.1115310228308472e-05,3.33207454961459e-05,0.75
18132,낚아/Noun,4,1,3,1.1115310228308472e-05,3.33207454961459e-05,0.75
18133,손수/Noun,4,1,3,1.1115310228308472e-05,3.33207454961459e-05,0.75
18134,김전일/Noun,4,1,3,1.1115310228308472e-05,3.33207454961459e-05,0.75
18135,즉흥/Noun,4,1,3,1.1115310228308472e-05,3.33207454961459e-05,0.75
18136,영도/Noun,4,1,3,1.1115310228308472e-05,3.33207454961459e-05,0.75
18137,대학시절/Noun,4,3,1,3.3345930684925414e-05,1.1106915165381966e-05,0.75
18138,됫는데/Noun,4,3,1,3.3345930684925414e-05,1.1106915165381966e-05,0.75
18139,노프/Noun,4,3,1,3.3345930684925414e-05,1.1106915165381966e-05,0.75
18140,방주/Noun,4,1,3,1.1115310228308472e-05,3.33207454961459e-05,0.75
18141,괜찬다/Noun,4,3,1,3.3345930684925414e-05,1.1106915165381966e-05,0.75
18142,끝낫/Noun,4,3,1,3.3345930684925414e-05,1.1106915165381966e-05,0.75
18143,!@/Punctuation,4,3,1,3.3345930684925414e-05,1.1106915165381966e-05,0.75
18144,브라우닝/Noun,4,3,1,3.3345930684925414e-05,1.1106915165381966e-05,0.75
18145,건배/Noun,4,1,3,1.1115310228308472e-05,3.33207454961459e-05,0.75
18146,way/Alpha,4,3,1,3.3345930684925414e-05,1.1106915165381966e-05,0.75
18147,명실/Noun,4,3,1,3.3345930684925414e-05,1.1106915165381966e-05,0.75
18148,고취/Noun,4,1,3,1.1115310228308472e-05,3.33207454961459e-05,0.75
18149,무적인/Noun,4,1,3,1.1115310228308472e-05,3.33207454961459e-05,0.75
18150,소치/Noun,4,1,3,1.1115310228308472e-05,3.33207454961459e-05,0.75
18151,시드니/Noun,4,3,1,3.3345930684925414e-05,1.1106915165381966e-05,0.75
18152,구점/Noun,4,3,1,3.3345930684925414e-05,1.1106915165381966e-05,0.75
18153,포핀스/Noun,4,3,1,3.3345930684925414e-05,1.1106915165381966e-05,0.75
18154,간신/Noun,4,3,1,3.3345930684925414e-05,1.1106915165381966e-05,0.75
18155,ㅡㅡㅗ/KoreanParticle,4,1,3,1.1115310228308472e-05,3.33207454961459e-05,0.75
18156,리수/Noun,4,1,3,1.1115310228308472e-05,3.33207454961459e-05,0.75
18157,비빔밥/Noun,4,1,3,1.1115310228308472e-05,3.33207454961459e-05,0.75
18158,5천원/Number,4,1,3,1.1115310228308472e-05,3.33207454961459e-05,0.75
18159,지란/Noun,4,1,3,1.1115310228308472e-05,3.33207454961459e-05,0.75
18160,10원/Number,4,1,3,1.1115310228308472e-05,3.33207454961459e-05,0.75
18161,센티/Noun,4,1,3,1.1115310228308472e-05,3.33207454961459e-05,0.75
18162,인트로/Noun,4,3,1,3.3345930684925414e-05,1.1106915165381966e-05,0.75
18163,체인/Noun,4,3,1,3.3345930684925414e-05,1.1106915165381966e-05,0.75
18164,규환/Noun,4,3,1,3.3345930684925414e-05,1.1106915165381966e-05,0.75
18165,소홀하다/Adjective,4,3,1,3.3345930684925414e-05,1.1106915165381966e-05,0.75
18166,조화로/Noun,4,3,1,3.3345930684925414e-05,1.1106915165381966e-05,0.75
18167,탑제/Noun,4,1,3,1.1115310228308472e-05,3.33207454961459e-05,0.75
18168,조련사/Noun,4,3,1,3.3345930684925414e-05,1.1106915165381966e-05,0.75
18169,학기/Noun,4,3,1,3.3345930684925414e-05,1.1106915165381966e-05,0.75
18170,부러워하다/Adjective,4,3,1,3.3345930684925414e-05,1.1106915165381966e-05,0.75
18171,고차원/Noun,4,1,3,1.1115310228308472e-05,3.33207454961459e-05,0.75
18172,녹정기/Noun,4,3,1,3.3345930684925414e-05,1.1106915165381966e-05,0.75
18173,충청도/Noun,4,1,3,1.1115310228308472e-05,3.33207454961459e-05,0.75
18174,물임/Noun,4,1,3,1.1115310228308472e-05,3.33207454961459e-05,0.75
18175,은폐/Noun,4,1,3,1.1115310228308472e-05,3.33207454961459e-05,0.75
18176,동엽신/Noun,4,3,1,3.3345930684925414e-05,1.1106915165381966e-05,0.75
18177,저우쉰/Noun,4,3,1,3.3345930684925414e-05,1.1106915165381966e-05,0.75
18178,위스키/Noun,4,1,3,1.1115310228308472e-05,3.33207454961459e-05,0.75
18179,가나다라/Noun,4,1,3,1.1115310228308472e-05,3.33207454961459e-05,0.75
18180,일임/Noun,4,3,1,3.3345930684925414e-05,1.1106915165381966e-05,0.75
18181,뮤턴트/Noun,4,1,3,1.1115310228308472e-05,3.33207454961459e-05,0.75
18182,3위안/Number,4,3,1,3.3345930684925414e-05,1.1106915165381966e-05,0.75
18183,베이컨시/Noun,4,1,3,1.1115310228308472e-05,3.33207454961459e-05,0.75
18184,설움/Noun,4,1,3,1.1115310228308472e-05,3.33207454961459e-05,0.75
18185,바나나/Noun,4,1,3,1.1115310228308472e-05,3.33207454961459e-05,0.75
18186,프랭코/Noun,4,3,1,3.3345930684925414e-05,1.1106915165381966e-05,0.75
18187,핑구/Noun,4,1,3,1.1115310228308472e-05,3.33207454961459e-05,0.75
18188,투명/Noun,4,1,3,1.1115310228308472e-05,3.33207454961459e-05,0.75
18189,김봉두/Noun,4,3,1,3.3345930684925414e-05,1.1106915165381966e-05,0.75
18190,고학년/Noun,4,1,3,1.1115310228308472e-05,3.33207454961459e-05,0.75
18191,천추/Noun,4,1,3,1.1115310228308472e-05,3.33207454961459e-05,0.75
18192,스톱모션/Noun,4,3,1,3.3345930684925414e-05,1.1106915165381966e-05,0.75
18193,쫑/Noun,4,3,1,3.3345930684925414e-05,1.1106915165381966e-05,0.75
18194,정씨/Noun,4,3,1,3.3345930684925414e-05,1.1106915165381966e-05,0.75
18195,우어어/Exclamation,4,1,3,1.1115310228308472e-05,3.33207454961459e-05,0.75
18196,버킷/Noun,4,3,1,3.3345930684925414e-05,1.1106915165381966e-05,0.75
18197,돌파구/Noun,4,3,1,3.3345930684925414e-05,1.1106915165381966e-05,0.75
18198,49회/Number,4,1,3,1.1115310228308472e-05,3.33207454961459e-05,0.75
18199,백투더퓨쳐/Noun,4,3,1,3.3345930684925414e-05,1.1106915165381966e-05,0.75
18200,윤진이/Noun,4,1,3,1.1115310228308472e-05,3.33207454961459e-05,0.75
18201,어렷/Noun,4,3,1,3.3345930684925414e-05,1.1106915165381966e-05,0.75
18202,본뜨다/Verb,4,1,3,1.1115310228308472e-05,3.33207454961459e-05,0.75
18203,잘되지/Noun,4,3,1,3.3345930684925414e-05,1.1106915165381966e-05,0.75
18204,비드/Noun,4,3,1,3.3345930684925414e-05,1.1106915165381966e-05,0.75
18205,산삼/Noun,4,1,3,1.1115310228308472e-05,3.33207454961459e-05,0.75
18206,ㅘ/KoreanParticle,4,3,1,3.3345930684925414e-05,1.1106915165381966e-05,0.75
18207,빛깔/Noun,4,3,1,3.3345930684925414e-05,1.1106915165381966e-05,0.75
18208,분홍/Noun,4,3,1,3.3345930684925414e-05,1.1106915165381966e-05,0.75
18209,배럴/Noun,4,1,3,1.1115310228308472e-05,3.33207454961459e-05,0.75
18210,스탁/Noun,4,1,3,1.1115310228308472e-05,3.33207454961459e-05,0.75
18211,슬럼프/Noun,4,1,3,1.1115310228308472e-05,3.33207454961459e-05,0.75
18212,조교/Noun,4,1,3,1.1115310228308472e-05,3.33207454961459e-05,0.75
18213,8.3/Number,4,3,1,3.3345930684925414e-05,1.1106915165381966e-05,0.75
18214,렁/Noun,4,3,1,3.3345930684925414e-05,1.1106915165381966e-05,0.75
18215,거린/Noun,4,1,3,1.1115310228308472e-05,3.33207454961459e-05,0.75
18216,안티크라이스트/Noun,4,3,1,3.3345930684925414e-05,1.1106915165381966e-05,0.75
18217,직선/Noun,4,3,1,3.3345930684925414e-05,1.1106915165381966e-05,0.75
18218,00/Number,4,3,1,3.3345930684925414e-05,1.1106915165381966e-05,0.75
18219,신야/Noun,4,3,1,3.3345930684925414e-05,1.1106915165381966e-05,0.75
18220,스타게이트/Noun,4,3,1,3.3345930684925414e-05,1.1106915165381966e-05,0.75
18221,똑살/Noun,4,3,1,3.3345930684925414e-05,1.1106915165381966e-05,0.75
18222,쿠로/Noun,4,3,1,3.3345930684925414e-05,1.1106915165381966e-05,0.75
18223,찍찍/Noun,4,1,3,1.1115310228308472e-05,3.33207454961459e-05,0.75
18224,흥신소/Noun,4,1,3,1.1115310228308472e-05,3.33207454961459e-05,0.75
18225,동하/Noun,4,3,1,3.3345930684925414e-05,1.1106915165381966e-05,0.75
18226,입시/Noun,4,3,1,3.3345930684925414e-05,1.1106915165381966e-05,0.75
18227,외심/Noun,4,3,1,3.3345930684925414e-05,1.1106915165381966e-05,0.75
18228,퀼트/Noun,4,3,1,3.3345930684925414e-05,1.1106915165381966e-05,0.75
18229,영구아트/Noun,4,1,3,1.1115310228308472e-05,3.33207454961459e-05,0.75
18230,털보/Noun,4,3,1,3.3345930684925414e-05,1.1106915165381966e-05,0.75
18231,개임/Noun,4,3,1,3.3345930684925414e-05,1.1106915165381966e-05,0.75
18232,액기스/Noun,4,3,1,3.3345930684925414e-05,1.1106915165381966e-05,0.75
18233,리만/Noun,4,1,3,1.1115310228308472e-05,3.33207454961459e-05,0.75
18234,채탁연/Noun,4,3,1,3.3345930684925414e-05,1.1106915165381966e-05,0.75
18235,티노/Noun,4,3,1,3.3345930684925414e-05,1.1106915165381966e-05,0.75
18236,다이너마이트/Noun,4,1,3,1.1115310228308472e-05,3.33207454961459e-05,0.75
18237,독점/Noun,4,3,1,3.3345930684925414e-05,1.1106915165381966e-05,0.75
18238,만수/Noun,4,3,1,3.3345930684925414e-05,1.1106915165381966e-05,0.75
18239,유플러스/Noun,4,1,3,1.1115310228308472e-05,3.33207454961459e-05,0.75
18240,배아/Noun,4,3,1,3.3345930684925414e-05,1.1106915165381966e-05,0.75
18241,헐떡거리다/Verb,4,1,3,1.1115310228308472e-05,3.33207454961459e-05,0.75
18242,죗값/Noun,4,1,3,1.1115310228308472e-05,3.33207454961459e-05,0.75
18243,불가사리/Noun,4,3,1,3.3345930684925414e-05,1.1106915165381966e-05,0.75
18244,하루빨리/Adverb,4,3,1,3.3345930684925414e-05,1.1106915165381966e-05,0.75
18245,빼기/Noun,4,1,3,1.1115310228308472e-05,3.33207454961459e-05,0.75
18246,네모/Noun,4,3,1,3.3345930684925414e-05,1.1106915165381966e-05,0.75
18247,ㅋㅎㅋㅎ/KoreanParticle,4,3,1,3.3345930684925414e-05,1.1106915165381966e-05,0.75
18248,윙거/Noun,4,3,1,3.3345930684925414e-05,1.1106915165381966e-05,0.75
18249,황순원/Noun,4,3,1,3.3345930684925414e-05,1.1106915165381966e-05,0.75
18250,카를로/Noun,4,3,1,3.3345930684925414e-05,1.1106915165381966e-05,0.75
18251,개쩌는데/Noun,4,1,3,1.1115310228308472e-05,3.33207454961459e-05,0.75
18252,마중/Noun,4,3,1,3.3345930684925414e-05,1.1106915165381966e-05,0.75
18253,기안/Noun,4,1,3,1.1115310228308472e-05,3.33207454961459e-05,0.75
18254,아카펠라/Noun,4,1,3,1.1115310228308472e-05,3.33207454961459e-05,0.75
18255,소꿉장난/Noun,4,1,3,1.1115310228308472e-05,3.33207454961459e-05,0.75
18256,ㅏㅏ/KoreanParticle,4,1,3,1.1115310228308472e-05,3.33207454961459e-05,0.75
18257,화물/Noun,4,1,3,1.1115310228308472e-05,3.33207454961459e-05,0.75
18258,테입/Noun,4,3,1,3.3345930684925414e-05,1.1106915165381966e-05,0.75
18259,함익병/Noun,4,1,3,1.1115310228308472e-05,3.33207454961459e-05,0.75
18260,수순/Noun,4,1,3,1.1115310228308472e-05,3.33207454961459e-05,0.75
18261,강력반/Noun,4,1,3,1.1115310228308472e-05,3.33207454961459e-05,0.75
18262,갯수/Noun,4,1,3,1.1115310228308472e-05,3.33207454961459e-05,0.75
18263,가꾸다/Verb,4,1,3,1.1115310228308472e-05,3.33207454961459e-05,0.75
18264,위층/Noun,4,1,3,1.1115310228308472e-05,3.33207454961459e-05,0.75
18265,경호/Noun,4,3,1,3.3345930684925414e-05,1.1106915165381966e-05,0.75
18266,주군의태양/Noun,4,3,1,3.3345930684925414e-05,1.1106915165381966e-05,0.75
18267,ddr/Alpha,4,1,3,1.1115310228308472e-05,3.33207454961459e-05,0.75
18268,결부/Noun,4,3,1,3.3345930684925414e-05,1.1106915165381966e-05,0.75
18269,장어/Noun,4,1,3,1.1115310228308472e-05,3.33207454961459e-05,0.75
18270,운전대/Noun,4,1,3,1.1115310228308472e-05,3.33207454961459e-05,0.75
18271,예비/Noun,4,3,1,3.3345930684925414e-05,1.1106915165381966e-05,0.75
18272,윈도우/Noun,4,3,1,3.3345930684925414e-05,1.1106915165381966e-05,0.75
18273,얼빠지다/Verb,4,1,3,1.1115310228308472e-05,3.33207454961459e-05,0.75
18274,메로/Noun,4,1,3,1.1115310228308472e-05,3.33207454961459e-05,0.75
18275,51/Number,4,1,3,1.1115310228308472e-05,3.33207454961459e-05,0.75
18276,유경/Noun,4,1,3,1.1115310228308472e-05,3.33207454961459e-05,0.75
18277,웍/Noun,4,3,1,3.3345930684925414e-05,1.1106915165381966e-05,0.75
18278,",,,,,,,,,,,/Punctuation",4,1,3,1.1115310228308472e-05,3.33207454961459e-05,0.75
18279,쌩뚱맞음/Noun,4,1,3,1.1115310228308472e-05,3.33207454961459e-05,0.75
18280,초사/Noun,4,1,3,1.1115310228308472e-05,3.33207454961459e-05,0.75
18281,헬멧/Noun,4,1,3,1.1115310228308472e-05,3.33207454961459e-05,0.75
18282,날렵하다/Adjective,4,3,1,3.3345930684925414e-05,1.1106915165381966e-05,0.75
18283,그야/Noun,4,1,3,1.1115310228308472e-05,3.33207454961459e-05,0.75
18284,강가/Noun,4,1,3,1.1115310228308472e-05,3.33207454961459e-05,0.75
18285,PS/Alpha,4,1,3,1.1115310228308472e-05,3.33207454961459e-05,0.75
18286,벌린/Noun,4,1,3,1.1115310228308472e-05,3.33207454961459e-05,0.75
18287,물정/Noun,4,3,1,3.3345930684925414e-05,1.1106915165381966e-05,0.75
18288,대영화/Foreign,4,1,3,1.1115310228308472e-05,3.33207454961459e-05,0.75
18289,박제/Noun,4,1,3,1.1115310228308472e-05,3.33207454961459e-05,0.75
18290,텐트/Noun,4,1,3,1.1115310228308472e-05,3.33207454961459e-05,0.75
18291,등산/Noun,4,1,3,1.1115310228308472e-05,3.33207454961459e-05,0.75
18292,지정/Noun,4,3,1,3.3345930684925414e-05,1.1106915165381966e-05,0.75
18293,이인/Noun,4,1,3,1.1115310228308472e-05,3.33207454961459e-05,0.75
18294,본가/Noun,4,1,3,1.1115310228308472e-05,3.33207454961459e-05,0.75
18295,차세대/Noun,4,3,1,3.3345930684925414e-05,1.1106915165381966e-05,0.75
18296,묵념/Noun,4,1,3,1.1115310228308472e-05,3.33207454961459e-05,0.75
18297,김태균/Noun,4,1,3,1.1115310228308472e-05,3.33207454961459e-05,0.75
18298,디안시/Noun,4,1,3,1.1115310228308472e-05,3.33207454961459e-05,0.75
18299,난치/Noun,4,1,3,1.1115310228308472e-05,3.33207454961459e-05,0.75
18300,울궈/Noun,4,1,3,1.1115310228308472e-05,3.33207454961459e-05,0.75
18301,웃픈/Noun,4,3,1,3.3345930684925414e-05,1.1106915165381966e-05,0.75
18302,어여쁘다/Adjective,4,3,1,3.3345930684925414e-05,1.1106915165381966e-05,0.75
18303,동산/Noun,4,3,1,3.3345930684925414e-05,1.1106915165381966e-05,0.75
18304,수갑/Noun,4,1,3,1.1115310228308472e-05,3.33207454961459e-05,0.75
18305,삐뚤다/Adjective,4,3,1,3.3345930684925414e-05,1.1106915165381966e-05,0.75
18306,황인/Noun,4,3,1,3.3345930684925414e-05,1.1106915165381966e-05,0.75
18307,아르헨/Noun,4,3,1,3.3345930684925414e-05,1.1106915165381966e-05,0.75
18308,man/Alpha,4,3,1,3.3345930684925414e-05,1.1106915165381966e-05,0.75
18309,티보/Noun,4,1,3,1.1115310228308472e-05,3.33207454961459e-05,0.75
18310,인디펜던스/Noun,4,1,3,1.1115310228308472e-05,3.33207454961459e-05,0.75
18311,약사/Noun,4,3,1,3.3345930684925414e-05,1.1106915165381966e-05,0.75
18312,엔/Foreign,4,2,2,2.2230620456616944e-05,2.2213830330763933e-05,0.5
18313,유채영/Noun,4,2,2,2.2230620456616944e-05,2.2213830330763933e-05,0.5
18314,국민성/Noun,4,2,2,2.2230620456616944e-05,2.2213830330763933e-05,0.5
18315,논문/Noun,4,2,2,2.2230620456616944e-05,2.2213830330763933e-05,0.5
18316,앞잡이/Noun,4,2,2,2.2230620456616944e-05,2.2213830330763933e-05,0.5
18317,over/Alpha,4,2,2,2.2230620456616944e-05,2.2213830330763933e-05,0.5
18318,OVA/Alpha,4,2,2,2.2230620456616944e-05,2.2213830330763933e-05,0.5
18319,미식축구/Noun,4,2,2,2.2230620456616944e-05,2.2213830330763933e-05,0.5
18320,500만원/Number,4,2,2,2.2230620456616944e-05,2.2213830330763933e-05,0.5
18321,때때로/Adverb,4,2,2,2.2230620456616944e-05,2.2213830330763933e-05,0.5
18322,저글링/Noun,4,2,2,2.2230620456616944e-05,2.2213830330763933e-05,0.5
18323,밀실/Noun,4,2,2,2.2230620456616944e-05,2.2213830330763933e-05,0.5
18324,말아톤/Noun,4,2,2,2.2230620456616944e-05,2.2213830330763933e-05,0.5
18325,w/Alpha,4,2,2,2.2230620456616944e-05,2.2213830330763933e-05,0.5
18326,루시퍼/Noun,4,2,2,2.2230620456616944e-05,2.2213830330763933e-05,0.5
18327,김지우/Noun,4,2,2,2.2230620456616944e-05,2.2213830330763933e-05,0.5
18328,장항준/Noun,4,2,2,2.2230620456616944e-05,2.2213830330763933e-05,0.5
18329,부제목/Noun,4,2,2,2.2230620456616944e-05,2.2213830330763933e-05,0.5
18330,랩퍼/Noun,4,2,2,2.2230620456616944e-05,2.2213830330763933e-05,0.5
18331,프린세스/Noun,4,2,2,2.2230620456616944e-05,2.2213830330763933e-05,0.5
18332,프린스/Noun,4,2,2,2.2230620456616944e-05,2.2213830330763933e-05,0.5
18333,매하/Noun,4,2,2,2.2230620456616944e-05,2.2213830330763933e-05,0.5
18334,말레이시아/Noun,4,2,2,2.2230620456616944e-05,2.2213830330763933e-05,0.5
18335,ㅎㅅㅎ/KoreanParticle,4,2,2,2.2230620456616944e-05,2.2213830330763933e-05,0.5
18336,zzzz/Alpha,4,2,2,2.2230620456616944e-05,2.2213830330763933e-05,0.5
18337,제복/Noun,4,2,2,2.2230620456616944e-05,2.2213830330763933e-05,0.5
18338,78/Number,4,2,2,2.2230620456616944e-05,2.2213830330763933e-05,0.5
18339,..?!/Punctuation,4,2,2,2.2230620456616944e-05,2.2213830330763933e-05,0.5
18340,득실/Noun,4,2,2,2.2230620456616944e-05,2.2213830330763933e-05,0.5
18341,쿠리다/Adjective,4,2,2,2.2230620456616944e-05,2.2213830330763933e-05,0.5
18342,품세/Noun,4,2,2,2.2230620456616944e-05,2.2213830330763933e-05,0.5
18343,스마우그/Noun,4,2,2,2.2230620456616944e-05,2.2213830330763933e-05,0.5
18344,유에프오/Noun,4,2,2,2.2230620456616944e-05,2.2213830330763933e-05,0.5
18345,무한대/Noun,4,2,2,2.2230620456616944e-05,2.2213830330763933e-05,0.5
18346,***/Punctuation,4,2,2,2.2230620456616944e-05,2.2213830330763933e-05,0.5
18347,밧줄/Noun,4,2,2,2.2230620456616944e-05,2.2213830330763933e-05,0.5
18348,오역/Noun,4,2,2,2.2230620456616944e-05,2.2213830330763933e-05,0.5
18349,수퍼/Noun,4,2,2,2.2230620456616944e-05,2.2213830330763933e-05,0.5
18350,간격/Noun,4,2,2,2.2230620456616944e-05,2.2213830330763933e-05,0.5
18351,태웅/Noun,4,2,2,2.2230620456616944e-05,2.2213830330763933e-05,0.5
18352,인도판/Noun,4,2,2,2.2230620456616944e-05,2.2213830330763933e-05,0.5
18353,듀오/Noun,4,2,2,2.2230620456616944e-05,2.2213830330763933e-05,0.5
18354,김탁구/Noun,4,2,2,2.2230620456616944e-05,2.2213830330763933e-05,0.5
18355,독재정/Noun,4,2,2,2.2230620456616944e-05,2.2213830330763933e-05,0.5
18356,기독교도/Noun,4,2,2,2.2230620456616944e-05,2.2213830330763933e-05,0.5
18357,조동혁/Noun,4,2,2,2.2230620456616944e-05,2.2213830330763933e-05,0.5
18358,파도처럼/Noun,4,2,2,2.2230620456616944e-05,2.2213830330763933e-05,0.5
18359,상봉/Noun,4,2,2,2.2230620456616944e-05,2.2213830330763933e-05,0.5
18360,세바스찬/Noun,4,2,2,2.2230620456616944e-05,2.2213830330763933e-05,0.5
18361,오사카/Noun,4,2,2,2.2230620456616944e-05,2.2213830330763933e-05,0.5
18362,두발/Noun,4,2,2,2.2230620456616944e-05,2.2213830330763933e-05,0.5
18363,동유럽/Noun,4,2,2,2.2230620456616944e-05,2.2213830330763933e-05,0.5
18364,코브라/Noun,4,2,2,2.2230620456616944e-05,2.2213830330763933e-05,0.5
18365,불리하다/Adjective,4,2,2,2.2230620456616944e-05,2.2213830330763933e-05,0.5
18366,트랄/Noun,4,2,2,2.2230620456616944e-05,2.2213830330763933e-05,0.5
18367,영등포/Noun,4,2,2,2.2230620456616944e-05,2.2213830330763933e-05,0.5
18368,외국어/Noun,4,2,2,2.2230620456616944e-05,2.2213830330763933e-05,0.5
18369,해탈/Noun,4,2,2,2.2230620456616944e-05,2.2213830330763933e-05,0.5
18370,랄라라/Noun,4,2,2,2.2230620456616944e-05,2.2213830330763933e-05,0.5
18371,모나리자/Noun,4,2,2,2.2230620456616944e-05,2.2213830330763933e-05,0.5
18372,개인주의/Noun,4,2,2,2.2230620456616944e-05,2.2213830330763933e-05,0.5
18373,시라소니/Noun,4,2,2,2.2230620456616944e-05,2.2213830330763933e-05,0.5
18374,왓다/Noun,4,2,2,2.2230620456616944e-05,2.2213830330763933e-05,0.5
18375,일영/Noun,4,2,2,2.2230620456616944e-05,2.2213830330763933e-05,0.5
18376,염려/Noun,4,2,2,2.2230620456616944e-05,2.2213830330763933e-05,0.5
18377,갱생/Noun,4,2,2,2.2230620456616944e-05,2.2213830330763933e-05,0.5
18378,갖힌/Noun,4,2,2,2.2230620456616944e-05,2.2213830330763933e-05,0.5
18379,수집/Noun,4,2,2,2.2230620456616944e-05,2.2213830330763933e-05,0.5
18380,지석/Noun,4,2,2,2.2230620456616944e-05,2.2213830330763933e-05,0.5
18381,와전/Noun,4,2,2,2.2230620456616944e-05,2.2213830330763933e-05,0.5
18382,새우다/Verb,4,2,2,2.2230620456616944e-05,2.2213830330763933e-05,0.5
18383,정품/Noun,4,2,2,2.2230620456616944e-05,2.2213830330763933e-05,0.5
18384,",(/Punctuation",4,2,2,2.2230620456616944e-05,2.2213830330763933e-05,0.5
18385,거너/Noun,4,2,2,2.2230620456616944e-05,2.2213830330763933e-05,0.5
18386,주저앉다/Verb,4,2,2,2.2230620456616944e-05,2.2213830330763933e-05,0.5
18387,오토봇/Noun,4,2,2,2.2230620456616944e-05,2.2213830330763933e-05,0.5
18388,버려진/Noun,4,2,2,2.2230620456616944e-05,2.2213830330763933e-05,0.5
18389,트릴/Noun,4,2,2,2.2230620456616944e-05,2.2213830330763933e-05,0.5
18390,회관/Noun,4,2,2,2.2230620456616944e-05,2.2213830330763933e-05,0.5
18391,원가/Noun,4,2,2,2.2230620456616944e-05,2.2213830330763933e-05,0.5
18392,시더/Noun,4,2,2,2.2230620456616944e-05,2.2213830330763933e-05,0.5
18393,never/Alpha,4,2,2,2.2230620456616944e-05,2.2213830330763933e-05,0.5
18394,의정/Noun,4,2,2,2.2230620456616944e-05,2.2213830330763933e-05,0.5
18395,데드캠프/Noun,4,2,2,2.2230620456616944e-05,2.2213830330763933e-05,0.5
18396,샤아/Noun,4,2,2,2.2230620456616944e-05,2.2213830330763933e-05,0.5
18397,도리어/Noun,4,2,2,2.2230620456616944e-05,2.2213830330763933e-05,0.5
18398,꼬투리/Noun,4,2,2,2.2230620456616944e-05,2.2213830330763933e-05,0.5
18399,선글라스/Noun,4,2,2,2.2230620456616944e-05,2.2213830330763933e-05,0.5
18400,헬보이/Noun,4,2,2,2.2230620456616944e-05,2.2213830330763933e-05,0.5
18401,^^:/Punctuation,4,2,2,2.2230620456616944e-05,2.2213830330763933e-05,0.5
18402,돼지고기/Noun,4,2,2,2.2230620456616944e-05,2.2213830330763933e-05,0.5
18403,프롬/Noun,4,2,2,2.2230620456616944e-05,2.2213830330763933e-05,0.5
18404,집사람/Noun,4,2,2,2.2230620456616944e-05,2.2213830330763933e-05,0.5
18405,작태/Noun,4,2,2,2.2230620456616944e-05,2.2213830330763933e-05,0.5
18406,사정없이/Adverb,4,2,2,2.2230620456616944e-05,2.2213830330763933e-05,0.5
18407,어선/Noun,4,2,2,2.2230620456616944e-05,2.2213830330763933e-05,0.5
18408,탈취/Noun,4,2,2,2.2230620456616944e-05,2.2213830330763933e-05,0.5
18409,선녀/Noun,4,2,2,2.2230620456616944e-05,2.2213830330763933e-05,0.5
18410,기침/Noun,4,2,2,2.2230620456616944e-05,2.2213830330763933e-05,0.5
18411,신병/Noun,4,2,2,2.2230620456616944e-05,2.2213830330763933e-05,0.5
18412,해하/Noun,4,2,2,2.2230620456616944e-05,2.2213830330763933e-05,0.5
18413,IN/Alpha,4,2,2,2.2230620456616944e-05,2.2213830330763933e-05,0.5
18414,세가족/Noun,4,2,2,2.2230620456616944e-05,2.2213830330763933e-05,0.5
18415,정애리/Noun,4,2,2,2.2230620456616944e-05,2.2213830330763933e-05,0.5
18416,서동/Noun,4,2,2,2.2230620456616944e-05,2.2213830330763933e-05,0.5
18417,이현/Noun,4,2,2,2.2230620456616944e-05,2.2213830330763933e-05,0.5
18418,모집/Noun,4,2,2,2.2230620456616944e-05,2.2213830330763933e-05,0.5
18419,알버트/Noun,4,2,2,2.2230620456616944e-05,2.2213830330763933e-05,0.5
18420,뀌/Noun,4,2,2,2.2230620456616944e-05,2.2213830330763933e-05,0.5
18421,배는/Foreign,4,2,2,2.2230620456616944e-05,2.2213830330763933e-05,0.5
18422,미라클/Noun,4,2,2,2.2230620456616944e-05,2.2213830330763933e-05,0.5
18423,복면/Noun,4,2,2,2.2230620456616944e-05,2.2213830330763933e-05,0.5
18424,괴뢰/Noun,4,2,2,2.2230620456616944e-05,2.2213830330763933e-05,0.5
18425,대일본제국/Noun,4,2,2,2.2230620456616944e-05,2.2213830330763933e-05,0.5
18426,임꺽정/Noun,4,2,2,2.2230620456616944e-05,2.2213830330763933e-05,0.5
18427,서고/Noun,4,2,2,2.2230620456616944e-05,2.2213830330763933e-05,0.5
18428,포르노그라피/Noun,4,2,2,2.2230620456616944e-05,2.2213830330763933e-05,0.5
18429,쥴리아/Noun,4,2,2,2.2230620456616944e-05,2.2213830330763933e-05,0.5
18430,피지/Noun,4,2,2,2.2230620456616944e-05,2.2213830330763933e-05,0.5
18431,다음생/Noun,4,2,2,2.2230620456616944e-05,2.2213830330763933e-05,0.5
18432,인트/Noun,4,2,2,2.2230620456616944e-05,2.2213830330763933e-05,0.5
18433,오명/Noun,4,2,2,2.2230620456616944e-05,2.2213830330763933e-05,0.5
18434,근엄하다/Adjective,4,2,2,2.2230620456616944e-05,2.2213830330763933e-05,0.5
18435,엇냐/Noun,4,2,2,2.2230620456616944e-05,2.2213830330763933e-05,0.5
18436,일면/Noun,4,2,2,2.2230620456616944e-05,2.2213830330763933e-05,0.5
18437,세인트/Noun,4,2,2,2.2230620456616944e-05,2.2213830330763933e-05,0.5
18438,일가/Noun,4,2,2,2.2230620456616944e-05,2.2213830330763933e-05,0.5
18439,당해/Modifier,4,2,2,2.2230620456616944e-05,2.2213830330763933e-05,0.5
18440,망토/Noun,4,2,2,2.2230620456616944e-05,2.2213830330763933e-05,0.5
18441,간정/Noun,4,2,2,2.2230620456616944e-05,2.2213830330763933e-05,0.5
18442,연애담/Noun,4,2,2,2.2230620456616944e-05,2.2213830330763933e-05,0.5
18443,살짝살짝/Adverb,4,2,2,2.2230620456616944e-05,2.2213830330763933e-05,0.5
18444,개웃/Adverb,4,2,2,2.2230620456616944e-05,2.2213830330763933e-05,0.5
18445,조선총잡이/Noun,4,2,2,2.2230620456616944e-05,2.2213830330763933e-05,0.5
18446,데뷰/Noun,4,2,2,2.2230620456616944e-05,2.2213830330763933e-05,0.5
18447,케이팝스타/Noun,4,2,2,2.2230620456616944e-05,2.2213830330763933e-05,0.5
18448,황시/Noun,4,2,2,2.2230620456616944e-05,2.2213830330763933e-05,0.5
18449,식인상어/Noun,4,2,2,2.2230620456616944e-05,2.2213830330763933e-05,0.5
18450,나왓음/Noun,4,2,2,2.2230620456616944e-05,2.2213830330763933e-05,0.5
18451,경도/Noun,4,2,2,2.2230620456616944e-05,2.2213830330763933e-05,0.5
18452,은평/Noun,4,2,2,2.2230620456616944e-05,2.2213830330763933e-05,0.5
18453,기정/Noun,4,2,2,2.2230620456616944e-05,2.2213830330763933e-05,0.5
18454,요망/Noun,4,2,2,2.2230620456616944e-05,2.2213830330763933e-05,0.5
18455,프로이트/Noun,4,2,2,2.2230620456616944e-05,2.2213830330763933e-05,0.5
18456,만사이/Noun,4,2,2,2.2230620456616944e-05,2.2213830330763933e-05,0.5
18457,굳히다/Verb,4,2,2,2.2230620456616944e-05,2.2213830330763933e-05,0.5
18458,세훈/Noun,4,2,2,2.2230620456616944e-05,2.2213830330763933e-05,0.5
18459,신호/Noun,4,2,2,2.2230620456616944e-05,2.2213830330763933e-05,0.5
18460,샘솟다/Verb,4,2,2,2.2230620456616944e-05,2.2213830330763933e-05,0.5
18461,40%/Number,4,2,2,2.2230620456616944e-05,2.2213830330763933e-05,0.5
18462,여유도/Noun,4,2,2,2.2230620456616944e-05,2.2213830330763933e-05,0.5
18463,..^^;/Punctuation,4,2,2,2.2230620456616944e-05,2.2213830330763933e-05,0.5
18464,샤시/Noun,4,2,2,2.2230620456616944e-05,2.2213830330763933e-05,0.5
18465,수구/Noun,4,2,2,2.2230620456616944e-05,2.2213830330763933e-05,0.5
18466,석도/Noun,4,2,2,2.2230620456616944e-05,2.2213830330763933e-05,0.5
18467,피안/Noun,4,2,2,2.2230620456616944e-05,2.2213830330763933e-05,0.5
18468,상냥하다/Adjective,4,2,2,2.2230620456616944e-05,2.2213830330763933e-05,0.5
18469,ㅁㅁ/KoreanParticle,4,2,2,2.2230620456616944e-05,2.2213830330763933e-05,0.5
18470,구하라/Noun,4,2,2,2.2230620456616944e-05,2.2213830330763933e-05,0.5
18471,감량/Noun,4,2,2,2.2230620456616944e-05,2.2213830330763933e-05,0.5
18472,응징자/Noun,4,2,2,2.2230620456616944e-05,2.2213830330763933e-05,0.5
18473,역주행/Noun,4,2,2,2.2230620456616944e-05,2.2213830330763933e-05,0.5
18474,9.2/Number,4,2,2,2.2230620456616944e-05,2.2213830330763933e-05,0.5
18475,어뢰/Noun,4,2,2,2.2230620456616944e-05,2.2213830330763933e-05,0.5
18476,조민수/Noun,4,2,2,2.2230620456616944e-05,2.2213830330763933e-05,0.5
18477,장래/Noun,4,2,2,2.2230620456616944e-05,2.2213830330763933e-05,0.5
18478,전반전/Noun,4,2,2,2.2230620456616944e-05,2.2213830330763933e-05,0.5
18479,양보/Noun,4,2,2,2.2230620456616944e-05,2.2213830330763933e-05,0.5
18480,소심/Noun,4,2,2,2.2230620456616944e-05,2.2213830330763933e-05,0.5
18481,메이슨/Noun,4,2,2,2.2230620456616944e-05,2.2213830330763933e-05,0.5
18482,전세/Noun,4,2,2,2.2230620456616944e-05,2.2213830330763933e-05,0.5
18483,의기/Noun,4,2,2,2.2230620456616944e-05,2.2213830330763933e-05,0.5
18484,주간아이돌/Noun,4,2,2,2.2230620456616944e-05,2.2213830330763933e-05,0.5
18485,터미널/Noun,4,2,2,2.2230620456616944e-05,2.2213830330763933e-05,0.5
18486,창희/Noun,4,2,2,2.2230620456616944e-05,2.2213830330763933e-05,0.5
18487,석궁/Noun,4,2,2,2.2230620456616944e-05,2.2213830330763933e-05,0.5
18488,기관사/Noun,4,2,2,2.2230620456616944e-05,2.2213830330763933e-05,0.5
18489,애니메이터/Noun,4,2,2,2.2230620456616944e-05,2.2213830330763933e-05,0.5
18490,꼬옥/Adverb,4,2,2,2.2230620456616944e-05,2.2213830330763933e-05,0.5
18491,찬미/Noun,4,2,2,2.2230620456616944e-05,2.2213830330763933e-05,0.5
18492,서울대/Noun,4,2,2,2.2230620456616944e-05,2.2213830330763933e-05,0.5
18493,흉악/Noun,4,2,2,2.2230620456616944e-05,2.2213830330763933e-05,0.5
18494,퇴마사/Noun,4,2,2,2.2230620456616944e-05,2.2213830330763933e-05,0.5
18495,리멤버/Noun,4,2,2,2.2230620456616944e-05,2.2213830330763933e-05,0.5
18496,신호탄/Noun,4,2,2,2.2230620456616944e-05,2.2213830330763933e-05,0.5
18497,전화기/Noun,4,2,2,2.2230620456616944e-05,2.2213830330763933e-05,0.5
18498,사관/Noun,4,2,2,2.2230620456616944e-05,2.2213830330763933e-05,0.5
18499,전해/Noun,4,2,2,2.2230620456616944e-05,2.2213830330763933e-05,0.5
18500,됫다/Noun,4,2,2,2.2230620456616944e-05,2.2213830330763933e-05,0.5
18501,십이/Noun,4,2,2,2.2230620456616944e-05,2.2213830330763933e-05,0.5
18502,떠밀다/Verb,4,2,2,2.2230620456616944e-05,2.2213830330763933e-05,0.5
18503,빈집/Noun,4,2,2,2.2230620456616944e-05,2.2213830330763933e-05,0.5
18504,6.0/Number,4,2,2,2.2230620456616944e-05,2.2213830330763933e-05,0.5
18505,기어이/Noun,4,2,2,2.2230620456616944e-05,2.2213830330763933e-05,0.5
18506,낚시바늘/Noun,4,2,2,2.2230620456616944e-05,2.2213830330763933e-05,0.5
18507,불시/Noun,4,2,2,2.2230620456616944e-05,2.2213830330763933e-05,0.5
18508,ㅇㅓ/KoreanParticle,4,2,2,2.2230620456616944e-05,2.2213830330763933e-05,0.5
18509,마야/Noun,4,2,2,2.2230620456616944e-05,2.2213830330763933e-05,0.5
18510,마도/Noun,4,2,2,2.2230620456616944e-05,2.2213830330763933e-05,0.5
18511,700/Number,4,2,2,2.2230620456616944e-05,2.2213830330763933e-05,0.5
18512,월트디즈니/Noun,4,2,2,2.2230620456616944e-05,2.2213830330763933e-05,0.5
18513,딸감/Noun,4,2,2,2.2230620456616944e-05,2.2213830330763933e-05,0.5
18514,팍팍하다/Adjective,4,2,2,2.2230620456616944e-05,2.2213830330763933e-05,0.5
18515,맥아/Noun,4,2,2,2.2230620456616944e-05,2.2213830330763933e-05,0.5
18516,노벨/Noun,4,2,2,2.2230620456616944e-05,2.2213830330763933e-05,0.5
18517,인하/Noun,4,2,2,2.2230620456616944e-05,2.2213830330763933e-05,0.5
18518,지호/Noun,4,2,2,2.2230620456616944e-05,2.2213830330763933e-05,0.5
18519,국장/Noun,4,2,2,2.2230620456616944e-05,2.2213830330763933e-05,0.5
18520,독사/Noun,4,2,2,2.2230620456616944e-05,2.2213830330763933e-05,0.5
18521,가정은/Noun,4,2,2,2.2230620456616944e-05,2.2213830330763933e-05,0.5
18522,겅/Noun,4,2,2,2.2230620456616944e-05,2.2213830330763933e-05,0.5
18523,2010/Number,4,2,2,2.2230620456616944e-05,2.2213830330763933e-05,0.5
18524,원리/Noun,4,2,2,2.2230620456616944e-05,2.2213830330763933e-05,0.5
18525,괜츈/Noun,4,2,2,2.2230620456616944e-05,2.2213830330763933e-05,0.5
18526,평안하다/Adjective,4,2,2,2.2230620456616944e-05,2.2213830330763933e-05,0.5
18527,해피투게더/Noun,4,2,2,2.2230620456616944e-05,2.2213830330763933e-05,0.5
18528,롤라/Noun,4,2,2,2.2230620456616944e-05,2.2213830330763933e-05,0.5
18529,체질/Noun,4,2,2,2.2230620456616944e-05,2.2213830330763933e-05,0.5
18530,입지/Noun,4,2,2,2.2230620456616944e-05,2.2213830330763933e-05,0.5
18531,서면/Noun,4,2,2,2.2230620456616944e-05,2.2213830330763933e-05,0.5
18532,위신/Noun,4,2,2,2.2230620456616944e-05,2.2213830330763933e-05,0.5
18533,유인영/Noun,4,2,2,2.2230620456616944e-05,2.2213830330763933e-05,0.5
18534,최적화/Noun,4,2,2,2.2230620456616944e-05,2.2213830330763933e-05,0.5
18535,UN/Alpha,4,2,2,2.2230620456616944e-05,2.2213830330763933e-05,0.5
18536,후원/Noun,4,2,2,2.2230620456616944e-05,2.2213830330763933e-05,0.5
18537,햇님/Noun,4,2,2,2.2230620456616944e-05,2.2213830330763933e-05,0.5
18538,열전/Noun,4,2,2,2.2230620456616944e-05,2.2213830330763933e-05,0.5
18539,원년/Noun,4,2,2,2.2230620456616944e-05,2.2213830330763933e-05,0.5
18540,입부/Noun,4,2,2,2.2230620456616944e-05,2.2213830330763933e-05,0.5
18541,발렌타인데이/Noun,4,2,2,2.2230620456616944e-05,2.2213830330763933e-05,0.5
18542,염세/Noun,4,2,2,2.2230620456616944e-05,2.2213830330763933e-05,0.5
18543,입금/Noun,4,2,2,2.2230620456616944e-05,2.2213830330763933e-05,0.5
18544,패거리/Noun,4,2,2,2.2230620456616944e-05,2.2213830330763933e-05,0.5
18545,치바/Noun,4,2,2,2.2230620456616944e-05,2.2213830330763933e-05,0.5
18546,파수/Noun,4,2,2,2.2230620456616944e-05,2.2213830330763933e-05,0.5
18547,본대/Noun,4,2,2,2.2230620456616944e-05,2.2213830330763933e-05,0.5
18548,장광/Noun,4,2,2,2.2230620456616944e-05,2.2213830330763933e-05,0.5
18549,제본/Noun,4,2,2,2.2230620456616944e-05,2.2213830330763933e-05,0.5
18550,문보령/Noun,4,2,2,2.2230620456616944e-05,2.2213830330763933e-05,0.5
18551,꿈나라/Noun,4,2,2,2.2230620456616944e-05,2.2213830330763933e-05,0.5
18552,펫/Noun,4,2,2,2.2230620456616944e-05,2.2213830330763933e-05,0.5
18553,화약/Noun,4,2,2,2.2230620456616944e-05,2.2213830330763933e-05,0.5
18554,행적/Noun,4,2,2,2.2230620456616944e-05,2.2213830330763933e-05,0.5
18555,ch/Alpha,4,2,2,2.2230620456616944e-05,2.2213830330763933e-05,0.5
18556,자만하다/Adjective,4,2,2,2.2230620456616944e-05,2.2213830330763933e-05,0.5
18557,게바라/Noun,4,2,2,2.2230620456616944e-05,2.2213830330763933e-05,0.5
18558,일요/Noun,4,2,2,2.2230620456616944e-05,2.2213830330763933e-05,0.5
18559,일후/Noun,4,2,2,2.2230620456616944e-05,2.2213830330763933e-05,0.5
18560,ㅡㅋ/KoreanParticle,4,2,2,2.2230620456616944e-05,2.2213830330763933e-05,0.5
18561,김보경/Noun,4,2,2,2.2230620456616944e-05,2.2213830330763933e-05,0.5
18562,심볼/Noun,4,2,2,2.2230620456616944e-05,2.2213830330763933e-05,0.5
18563,보그/Noun,4,2,2,2.2230620456616944e-05,2.2213830330763933e-05,0.5
18564,감임/Noun,4,2,2,2.2230620456616944e-05,2.2213830330763933e-05,0.5
18565,우월감/Noun,4,2,2,2.2230620456616944e-05,2.2213830330763933e-05,0.5
18566,술자리/Noun,4,2,2,2.2230620456616944e-05,2.2213830330763933e-05,0.5
18567,뛰어나가다/Verb,4,2,2,2.2230620456616944e-05,2.2213830330763933e-05,0.5
18568,염색/Noun,4,2,2,2.2230620456616944e-05,2.2213830330763933e-05,0.5
18569,신인시절/Noun,4,2,2,2.2230620456616944e-05,2.2213830330763933e-05,0.5
18570,카니/Noun,4,2,2,2.2230620456616944e-05,2.2213830330763933e-05,0.5
18571,버트/Noun,4,2,2,2.2230620456616944e-05,2.2213830330763933e-05,0.5
18572,출력/Noun,4,2,2,2.2230620456616944e-05,2.2213830330763933e-05,0.5
18573,장훈/Noun,4,2,2,2.2230620456616944e-05,2.2213830330763933e-05,0.5
18574,단죄/Noun,4,2,2,2.2230620456616944e-05,2.2213830330763933e-05,0.5
18575,주짓수/Noun,4,2,2,2.2230620456616944e-05,2.2213830330763933e-05,0.5
18576,성탄절/Noun,4,2,2,2.2230620456616944e-05,2.2213830330763933e-05,0.5
18577,대마/Noun,4,2,2,2.2230620456616944e-05,2.2213830330763933e-05,0.5
18578,해파리/Noun,4,2,2,2.2230620456616944e-05,2.2213830330763933e-05,0.5
18579,블루스/Noun,4,2,2,2.2230620456616944e-05,2.2213830330763933e-05,0.5
18580,테크노/Noun,4,2,2,2.2230620456616944e-05,2.2213830330763933e-05,0.5
18581,반역/Noun,4,2,2,2.2230620456616944e-05,2.2213830330763933e-05,0.5
18582,돈치/Noun,4,2,2,2.2230620456616944e-05,2.2213830330763933e-05,0.5
18583,안방/Noun,4,2,2,2.2230620456616944e-05,2.2213830330763933e-05,0.5
18584,퀄리/Noun,4,2,2,2.2230620456616944e-05,2.2213830330763933e-05,0.5
18585,코알라/Noun,4,2,2,2.2230620456616944e-05,2.2213830330763933e-05,0.5
18586,ㅝ/KoreanParticle,4,2,2,2.2230620456616944e-05,2.2213830330763933e-05,0.5
18587,베이커리/Noun,4,2,2,2.2230620456616944e-05,2.2213830330763933e-05,0.5
18588,체다/Noun,4,2,2,2.2230620456616944e-05,2.2213830330763933e-05,0.5
18589,괴이/Noun,4,2,2,2.2230620456616944e-05,2.2213830330763933e-05,0.5
18590,김용건/Noun,4,2,2,2.2230620456616944e-05,2.2213830330763933e-05,0.5
18591,2004/Number,4,2,2,2.2230620456616944e-05,2.2213830330763933e-05,0.5
18592,광산/Noun,4,2,2,2.2230620456616944e-05,2.2213830330763933e-05,0.5
18593,패배하다/Adjective,4,2,2,2.2230620456616944e-05,2.2213830330763933e-05,0.5
18594,이견/Noun,4,2,2,2.2230620456616944e-05,2.2213830330763933e-05,0.5
18595,-.../Punctuation,4,2,2,2.2230620456616944e-05,2.2213830330763933e-05,0.5
18596,고등/Noun,4,2,2,2.2230620456616944e-05,2.2213830330763933e-05,0.5
18597,이몽/Noun,4,2,2,2.2230620456616944e-05,2.2213830330763933e-05,0.5
18598,빈부격차/Noun,4,2,2,2.2230620456616944e-05,2.2213830330763933e-05,0.5
18599,초석/Noun,4,2,2,2.2230620456616944e-05,2.2213830330763933e-05,0.5
18600,무자/Noun,4,2,2,2.2230620456616944e-05,2.2213830330763933e-05,0.5
18601,최루탄/Noun,4,2,2,2.2230620456616944e-05,2.2213830330763933e-05,0.5
18602,모험물/Noun,4,2,2,2.2230620456616944e-05,2.2213830330763933e-05,0.5
18603,토드/Noun,4,2,2,2.2230620456616944e-05,2.2213830330763933e-05,0.5
18604,약국/Noun,4,2,2,2.2230620456616944e-05,2.2213830330763933e-05,0.5
18605,왼/Modifier,4,2,2,2.2230620456616944e-05,2.2213830330763933e-05,0.5
18606,브루/Noun,4,2,2,2.2230620456616944e-05,2.2213830330763933e-05,0.5
18607,수해/Noun,4,2,2,2.2230620456616944e-05,2.2213830330763933e-05,0.5
18608,본사/Noun,4,2,2,2.2230620456616944e-05,2.2213830330763933e-05,0.5
18609,일화/Noun,4,2,2,2.2230620456616944e-05,2.2213830330763933e-05,0.5
18610,센트/Noun,4,2,2,2.2230620456616944e-05,2.2213830330763933e-05,0.5
18611,온기/Noun,4,2,2,2.2230620456616944e-05,2.2213830330763933e-05,0.5
18612,군림/Noun,4,2,2,2.2230620456616944e-05,2.2213830330763933e-05,0.5
18613,압권임/Noun,4,2,2,2.2230620456616944e-05,2.2213830330763933e-05,0.5
18614,아이엠샘/Noun,4,2,2,2.2230620456616944e-05,2.2213830330763933e-05,0.5
18615,율도/Noun,4,2,2,2.2230620456616944e-05,2.2213830330763933e-05,0.5
18616,라카/Noun,4,2,2,2.2230620456616944e-05,2.2213830330763933e-05,0.5
18617,헤리포터/Noun,4,2,2,2.2230620456616944e-05,2.2213830330763933e-05,0.5
18618,트레/Noun,4,2,2,2.2230620456616944e-05,2.2213830330763933e-05,0.5
18619,트루라이즈/Noun,4,2,2,2.2230620456616944e-05,2.2213830330763933e-05,0.5
18620,군입대/Noun,4,2,2,2.2230620456616944e-05,2.2213830330763933e-05,0.5
18621,송일곤/Noun,4,2,2,2.2230620456616944e-05,2.2213830330763933e-05,0.5
18622,6.9/Number,4,2,2,2.2230620456616944e-05,2.2213830330763933e-05,0.5
18623,육중/Noun,4,2,2,2.2230620456616944e-05,2.2213830330763933e-05,0.5
18624,101/Number,4,2,2,2.2230620456616944e-05,2.2213830330763933e-05,0.5
18625,인현왕후/Noun,4,2,2,2.2230620456616944e-05,2.2213830330763933e-05,0.5
18626,이등병/Noun,4,2,2,2.2230620456616944e-05,2.2213830330763933e-05,0.5
18627,사교/Noun,4,2,2,2.2230620456616944e-05,2.2213830330763933e-05,0.5
18628,주사/Noun,4,2,2,2.2230620456616944e-05,2.2213830330763933e-05,0.5
18629,론서바이버/Noun,4,2,2,2.2230620456616944e-05,2.2213830330763933e-05,0.5
18630,사모님/Noun,4,2,2,2.2230620456616944e-05,2.2213830330763933e-05,0.5
18631,장마/Noun,4,2,2,2.2230620456616944e-05,2.2213830330763933e-05,0.5
18632,데이브/Noun,4,2,2,2.2230620456616944e-05,2.2213830330763933e-05,0.5
18633,직할/Noun,4,2,2,2.2230620456616944e-05,2.2213830330763933e-05,0.5
18634,헤피엔딩/Noun,4,2,2,2.2230620456616944e-05,2.2213830330763933e-05,0.5
18635,무채색/Noun,4,2,2,2.2230620456616944e-05,2.2213830330763933e-05,0.5
18636,마일리지/Noun,4,2,2,2.2230620456616944e-05,2.2213830330763933e-05,0.5
18637,구합/Noun,4,2,2,2.2230620456616944e-05,2.2213830330763933e-05,0.5
18638,해상/Noun,4,2,2,2.2230620456616944e-05,2.2213830330763933e-05,0.5
18639,구단/Noun,4,2,2,2.2230620456616944e-05,2.2213830330763933e-05,0.5
18640,모스맨/Noun,4,2,2,2.2230620456616944e-05,2.2213830330763933e-05,0.5
18641,해피엔드/Noun,4,2,2,2.2230620456616944e-05,2.2213830330763933e-05,0.5
18642,열애/Noun,4,2,2,2.2230620456616944e-05,2.2213830330763933e-05,0.5
18643,버질/Noun,4,2,2,2.2230620456616944e-05,2.2213830330763933e-05,0.5
18644,개솔/Noun,4,2,2,2.2230620456616944e-05,2.2213830330763933e-05,0.5
18645,애잔/Noun,4,2,2,2.2230620456616944e-05,2.2213830330763933e-05,0.5
18646,아프간/Noun,4,2,2,2.2230620456616944e-05,2.2213830330763933e-05,0.5
18647,개뿜/Noun,4,2,2,2.2230620456616944e-05,2.2213830330763933e-05,0.5
18648,홍주/Noun,4,2,2,2.2230620456616944e-05,2.2213830330763933e-05,0.5
18649,걔/Modifier,4,2,2,2.2230620456616944e-05,2.2213830330763933e-05,0.5
18650,원보/Noun,4,2,2,2.2230620456616944e-05,2.2213830330763933e-05,0.5
18651,자책/Noun,4,2,2,2.2230620456616944e-05,2.2213830330763933e-05,0.5
18652,가성/Noun,4,2,2,2.2230620456616944e-05,2.2213830330763933e-05,0.5
18653,이바/Noun,4,2,2,2.2230620456616944e-05,2.2213830330763933e-05,0.5
18654,유영/Noun,4,2,2,2.2230620456616944e-05,2.2213830330763933e-05,0.5
18655,쩌구/Noun,4,2,2,2.2230620456616944e-05,2.2213830330763933e-05,0.5
18656,!!!./Punctuation,4,2,2,2.2230620456616944e-05,2.2213830330763933e-05,0.5
18657,진술/Noun,4,2,2,2.2230620456616944e-05,2.2213830330763933e-05,0.5
18658,조신/Noun,4,2,2,2.2230620456616944e-05,2.2213830330763933e-05,0.5
18659,출하/Noun,4,2,2,2.2230620456616944e-05,2.2213830330763933e-05,0.5
18660,돌리지/Noun,4,2,2,2.2230620456616944e-05,2.2213830330763933e-05,0.5
18661,어메/Exclamation,4,2,2,2.2230620456616944e-05,2.2213830330763933e-05,0.5
18662,불합리/Noun,4,2,2,2.2230620456616944e-05,2.2213830330763933e-05,0.5
18663,승객/Noun,4,2,2,2.2230620456616944e-05,2.2213830330763933e-05,0.5
18664,첩첩산중/Noun,4,2,2,2.2230620456616944e-05,2.2213830330763933e-05,0.5
18665,이탈/Noun,4,2,2,2.2230620456616944e-05,2.2213830330763933e-05,0.5
18666,풀하우스/Noun,4,2,2,2.2230620456616944e-05,2.2213830330763933e-05,0.5
18667,스타크/Noun,4,2,2,2.2230620456616944e-05,2.2213830330763933e-05,0.5
18668,관절/Noun,4,2,2,2.2230620456616944e-05,2.2213830330763933e-05,0.5
18669,틀림없이/Adverb,4,2,2,2.2230620456616944e-05,2.2213830330763933e-05,0.5
18670,김성/Noun,4,2,2,2.2230620456616944e-05,2.2213830330763933e-05,0.5
18671,깜찍/Noun,4,2,2,2.2230620456616944e-05,2.2213830330763933e-05,0.5
18672,혜/Noun,4,2,2,2.2230620456616944e-05,2.2213830330763933e-05,0.5
18673,우하하/Noun,4,2,2,2.2230620456616944e-05,2.2213830330763933e-05,0.5
18674,추진/Noun,4,2,2,2.2230620456616944e-05,2.2213830330763933e-05,0.5
18675,쳇바퀴/Noun,4,2,2,2.2230620456616944e-05,2.2213830330763933e-05,0.5
18676,김준현/Noun,4,2,2,2.2230620456616944e-05,2.2213830330763933e-05,0.5
18677,채닝/Noun,4,2,2,2.2230620456616944e-05,2.2213830330763933e-05,0.5
18678,제갈량/Noun,4,2,2,2.2230620456616944e-05,2.2213830330763933e-05,0.5
18679,대여섯/Modifier,4,2,2,2.2230620456616944e-05,2.2213830330763933e-05,0.5
18680,모나/Noun,4,2,2,2.2230620456616944e-05,2.2213830330763933e-05,0.5
18681,숙성/Noun,4,2,2,2.2230620456616944e-05,2.2213830330763933e-05,0.5
18682,천옌시/Noun,4,2,2,2.2230620456616944e-05,2.2213830330763933e-05,0.5
18683,앤드류스/Noun,4,2,2,2.2230620456616944e-05,2.2213830330763933e-05,0.5
18684,민효린/Noun,4,2,2,2.2230620456616944e-05,2.2213830330763933e-05,0.5
18685,킨스키/Noun,4,2,2,2.2230620456616944e-05,2.2213830330763933e-05,0.5
18686,현태/Noun,4,2,2,2.2230620456616944e-05,2.2213830330763933e-05,0.5
18687,안바/Noun,4,2,2,2.2230620456616944e-05,2.2213830330763933e-05,0.5
18688,고속도로/Noun,4,2,2,2.2230620456616944e-05,2.2213830330763933e-05,0.5
18689,갑임/Noun,4,2,2,2.2230620456616944e-05,2.2213830330763933e-05,0.5
18690,헬레/Noun,4,2,2,2.2230620456616944e-05,2.2213830330763933e-05,0.5
18691,원안/Noun,4,2,2,2.2230620456616944e-05,2.2213830330763933e-05,0.5
18692,짐보/Noun,4,2,2,2.2230620456616944e-05,2.2213830330763933e-05,0.5
18693,태경/Noun,4,2,2,2.2230620456616944e-05,2.2213830330763933e-05,0.5
18694,1~5/Number,4,2,2,2.2230620456616944e-05,2.2213830330763933e-05,0.5
18695,팜플렛/Noun,4,2,2,2.2230620456616944e-05,2.2213830330763933e-05,0.5
18696,켄지/Noun,4,2,2,2.2230620456616944e-05,2.2213830330763933e-05,0.5
18697,변희봉/Noun,4,2,2,2.2230620456616944e-05,2.2213830330763933e-05,0.5
18698,통째/Noun,4,2,2,2.2230620456616944e-05,2.2213830330763933e-05,0.5
18699,뿔/Noun,4,2,2,2.2230620456616944e-05,2.2213830330763933e-05,0.5
18700,20초/Number,4,2,2,2.2230620456616944e-05,2.2213830330763933e-05,0.5
18701,요시노/Noun,4,2,2,2.2230620456616944e-05,2.2213830330763933e-05,0.5
18702,MOVIE/Alpha,4,2,2,2.2230620456616944e-05,2.2213830330763933e-05,0.5
18703,기요/Noun,4,2,2,2.2230620456616944e-05,2.2213830330763933e-05,0.5
18704,띵/Noun,4,2,2,2.2230620456616944e-05,2.2213830330763933e-05,0.5
18705,플라이/Noun,4,2,2,2.2230620456616944e-05,2.2213830330763933e-05,0.5
18706,하프/Noun,4,2,2,2.2230620456616944e-05,2.2213830330763933e-05,0.5
18707,음식점/Noun,4,2,2,2.2230620456616944e-05,2.2213830330763933e-05,0.5
18708,하사/Noun,4,2,2,2.2230620456616944e-05,2.2213830330763933e-05,0.5
18709,트루먼쇼/Noun,4,2,2,2.2230620456616944e-05,2.2213830330763933e-05,0.5
18710,If/Alpha,4,2,2,2.2230620456616944e-05,2.2213830330763933e-05,0.5
18711,))/Punctuation,4,2,2,2.2230620456616944e-05,2.2213830330763933e-05,0.5
18712,검은색/Noun,4,2,2,2.2230620456616944e-05,2.2213830330763933e-05,0.5
18713,뭣모르/Noun,4,2,2,2.2230620456616944e-05,2.2213830330763933e-05,0.5
18714,에놀/Noun,4,2,2,2.2230620456616944e-05,2.2213830330763933e-05,0.5
18715,음탕하다/Adjective,4,2,2,2.2230620456616944e-05,2.2213830330763933e-05,0.5
18716,지엠/Noun,4,2,2,2.2230620456616944e-05,2.2213830330763933e-05,0.5
18717,슬기/Noun,4,2,2,2.2230620456616944e-05,2.2213830330763933e-05,0.5
18718,오홋/Noun,4,2,2,2.2230620456616944e-05,2.2213830330763933e-05,0.5
18719,여의/Noun,4,2,2,2.2230620456616944e-05,2.2213830330763933e-05,0.5
18720,마찰/Noun,4,2,2,2.2230620456616944e-05,2.2213830330763933e-05,0.5
18721,카운터/Noun,4,2,2,2.2230620456616944e-05,2.2213830330763933e-05,0.5
18722,개티즌들/Noun,4,2,2,2.2230620456616944e-05,2.2213830330763933e-05,0.5
18723,장말/Noun,4,2,2,2.2230620456616944e-05,2.2213830330763933e-05,0.5
18724,home/Alpha,4,2,2,2.2230620456616944e-05,2.2213830330763933e-05,0.5
18725,푼돈/Noun,4,2,2,2.2230620456616944e-05,2.2213830330763933e-05,0.5
18726,much/Alpha,4,2,2,2.2230620456616944e-05,2.2213830330763933e-05,0.5
18727,웹/Noun,4,2,2,2.2230620456616944e-05,2.2213830330763933e-05,0.5
18728,쮸쮸/Noun,4,2,2,2.2230620456616944e-05,2.2213830330763933e-05,0.5
18729,헌팅/Noun,4,2,2,2.2230620456616944e-05,2.2213830330763933e-05,0.5
18730,압승/Noun,4,2,2,2.2230620456616944e-05,2.2213830330763933e-05,0.5
18731,제출/Noun,4,2,2,2.2230620456616944e-05,2.2213830330763933e-05,0.5
18732,스키장/Noun,4,2,2,2.2230620456616944e-05,2.2213830330763933e-05,0.5
18733,코러스/Noun,4,2,2,2.2230620456616944e-05,2.2213830330763933e-05,0.5
18734,이탈리안/Noun,4,2,2,2.2230620456616944e-05,2.2213830330763933e-05,0.5
18735,자본가/Noun,4,2,2,2.2230620456616944e-05,2.2213830330763933e-05,0.5
18736,맞선/Noun,4,2,2,2.2230620456616944e-05,2.2213830330763933e-05,0.5
18737,법치/Noun,4,2,2,2.2230620456616944e-05,2.2213830330763933e-05,0.5
18738,로메/Noun,4,2,2,2.2230620456616944e-05,2.2213830330763933e-05,0.5
18739,세차/Noun,4,2,2,2.2230620456616944e-05,2.2213830330763933e-05,0.5
18740,올려다보다/Verb,4,2,2,2.2230620456616944e-05,2.2213830330763933e-05,0.5
18741,만족도/Noun,4,2,2,2.2230620456616944e-05,2.2213830330763933e-05,0.5
18742,예이츠/Noun,4,2,2,2.2230620456616944e-05,2.2213830330763933e-05,0.5
18743,음료/Noun,4,2,2,2.2230620456616944e-05,2.2213830330763933e-05,0.5
18744,김성근/Noun,4,2,2,2.2230620456616944e-05,2.2213830330763933e-05,0.5
18745,뒷전/Noun,4,2,2,2.2230620456616944e-05,2.2213830330763933e-05,0.5
18746,"','/Punctuation",4,2,2,2.2230620456616944e-05,2.2213830330763933e-05,0.5
18747,차별성/Noun,4,2,2,2.2230620456616944e-05,2.2213830330763933e-05,0.5
18748,정령/Noun,4,2,2,2.2230620456616944e-05,2.2213830330763933e-05,0.5
18749,04년/Number,4,2,2,2.2230620456616944e-05,2.2213830330763933e-05,0.5
18750,사안/Noun,4,2,2,2.2230620456616944e-05,2.2213830330763933e-05,0.5
18751,37년/Number,4,2,2,2.2230620456616944e-05,2.2213830330763933e-05,0.5
18752,적나라/Noun,4,2,2,2.2230620456616944e-05,2.2213830330763933e-05,0.5
18753,만요/Noun,4,2,2,2.2230620456616944e-05,2.2213830330763933e-05,0.5
18754,일기토/Noun,4,2,2,2.2230620456616944e-05,2.2213830330763933e-05,0.5
18755,남상/Noun,4,2,2,2.2230620456616944e-05,2.2213830330763933e-05,0.5
18756,막강/Noun,4,2,2,2.2230620456616944e-05,2.2213830330763933e-05,0.5
18757,차근차근/Noun,4,2,2,2.2230620456616944e-05,2.2213830330763933e-05,0.5
18758,창공/Noun,4,2,2,2.2230620456616944e-05,2.2213830330763933e-05,0.5
18759,저울/Noun,4,2,2,2.2230620456616944e-05,2.2213830330763933e-05,0.5
18760,태극/Noun,4,2,2,2.2230620456616944e-05,2.2213830330763933e-05,0.5
18761,딸램/Noun,4,2,2,2.2230620456616944e-05,2.2213830330763933e-05,0.5
18762,고국/Noun,4,2,2,2.2230620456616944e-05,2.2213830330763933e-05,0.5
18763,3초/Number,4,2,2,2.2230620456616944e-05,2.2213830330763933e-05,0.5
18764,큰딸/Noun,4,2,2,2.2230620456616944e-05,2.2213830330763933e-05,0.5
18765,게로/Noun,4,2,2,2.2230620456616944e-05,2.2213830330763933e-05,0.5
18766,구질/Noun,4,2,2,2.2230620456616944e-05,2.2213830330763933e-05,0.5
18767,메간폭스/Noun,4,2,2,2.2230620456616944e-05,2.2213830330763933e-05,0.5
18768,성불/Noun,4,2,2,2.2230620456616944e-05,2.2213830330763933e-05,0.5
18769,로트/Noun,4,2,2,2.2230620456616944e-05,2.2213830330763933e-05,0.5
18770,적자/Noun,4,2,2,2.2230620456616944e-05,2.2213830330763933e-05,0.5
18771,에펠탑/Noun,4,2,2,2.2230620456616944e-05,2.2213830330763933e-05,0.5
18772,곽원갑/Noun,4,2,2,2.2230620456616944e-05,2.2213830330763933e-05,0.5
18773,Why/Alpha,4,2,2,2.2230620456616944e-05,2.2213830330763933e-05,0.5
18774,바르셀로나/Noun,4,2,2,2.2230620456616944e-05,2.2213830330763933e-05,0.5
18775,데도/Eomi,4,2,2,2.2230620456616944e-05,2.2213830330763933e-05,0.5
18776,큰코다치다/Verb,4,2,2,2.2230620456616944e-05,2.2213830330763933e-05,0.5
18777,블레이드러너/Noun,4,2,2,2.2230620456616944e-05,2.2213830330763933e-05,0.5
18778,45분/Number,4,2,2,2.2230620456616944e-05,2.2213830330763933e-05,0.5
18779,해결사/Noun,4,2,2,2.2230620456616944e-05,2.2213830330763933e-05,0.5
18780,종국/Noun,4,2,2,2.2230620456616944e-05,2.2213830330763933e-05,0.5
18781,띠리리/Noun,4,2,2,2.2230620456616944e-05,2.2213830330763933e-05,0.5
18782,안성맞춤/Noun,4,2,2,2.2230620456616944e-05,2.2213830330763933e-05,0.5
18783,파충류/Noun,4,2,2,2.2230620456616944e-05,2.2213830330763933e-05,0.5
18784,중공군/Noun,4,2,2,2.2230620456616944e-05,2.2213830330763933e-05,0.5
18785,패권/Noun,4,2,2,2.2230620456616944e-05,2.2213830330763933e-05,0.5
18786,얄/Noun,4,2,2,2.2230620456616944e-05,2.2213830330763933e-05,0.5
18787,위너/Noun,4,2,2,2.2230620456616944e-05,2.2213830330763933e-05,0.5
18788,당일/Noun,4,2,2,2.2230620456616944e-05,2.2213830330763933e-05,0.5
18789,저택/Noun,4,2,2,2.2230620456616944e-05,2.2213830330763933e-05,0.5
18790,무가/Noun,4,2,2,2.2230620456616944e-05,2.2213830330763933e-05,0.5
18791,길래/Eomi,4,2,2,2.2230620456616944e-05,2.2213830330763933e-05,0.5
18792,사려/Noun,4,2,2,2.2230620456616944e-05,2.2213830330763933e-05,0.5
18793,친부모/Noun,4,2,2,2.2230620456616944e-05,2.2213830330763933e-05,0.5
18794,전방/Noun,4,2,2,2.2230620456616944e-05,2.2213830330763933e-05,0.5
18795,도련님/Noun,4,2,2,2.2230620456616944e-05,2.2213830330763933e-05,0.5
18796,초/Foreign,4,2,2,2.2230620456616944e-05,2.2213830330763933e-05,0.5
18797,레트/Noun,4,2,2,2.2230620456616944e-05,2.2213830330763933e-05,0.5
18798,상통/Noun,4,2,2,2.2230620456616944e-05,2.2213830330763933e-05,0.5
18799,장인어른/Noun,4,2,2,2.2230620456616944e-05,2.2213830330763933e-05,0.5
18800,그리피스/Noun,4,2,2,2.2230620456616944e-05,2.2213830330763933e-05,0.5
18801,팀워크/Noun,4,2,2,2.2230620456616944e-05,2.2213830330763933e-05,0.5
18802,막둥이/Noun,4,2,2,2.2230620456616944e-05,2.2213830330763933e-05,0.5
18803,개뿜었다/Noun,4,2,2,2.2230620456616944e-05,2.2213830330763933e-05,0.5
18804,바바/Noun,4,2,2,2.2230620456616944e-05,2.2213830330763933e-05,0.5
18805,올랜도/Noun,4,2,2,2.2230620456616944e-05,2.2213830330763933e-05,0.5
18806,죄송스럽다/Adjective,4,2,2,2.2230620456616944e-05,2.2213830330763933e-05,0.5
18807,시마/Noun,4,2,2,2.2230620456616944e-05,2.2213830330763933e-05,0.5
18808,도태/Noun,4,2,2,2.2230620456616944e-05,2.2213830330763933e-05,0.5
18809,항쟁/Noun,4,2,2,2.2230620456616944e-05,2.2213830330763933e-05,0.5
18810,"""./Punctuation",4,2,2,2.2230620456616944e-05,2.2213830330763933e-05,0.5
18811,대낮/Noun,4,2,2,2.2230620456616944e-05,2.2213830330763933e-05,0.5
18812,베지터/Noun,4,2,2,2.2230620456616944e-05,2.2213830330763933e-05,0.5
18813,신성모독/Noun,4,2,2,2.2230620456616944e-05,2.2213830330763933e-05,0.5
18814,꼬락서니/Noun,4,2,2,2.2230620456616944e-05,2.2213830330763933e-05,0.5
18815,키포인트/Noun,4,2,2,2.2230620456616944e-05,2.2213830330763933e-05,0.5
18816,육덕/Noun,4,2,2,2.2230620456616944e-05,2.2213830330763933e-05,0.5
18817,호칭/Noun,4,2,2,2.2230620456616944e-05,2.2213830330763933e-05,0.5
18818,화때/Noun,4,2,2,2.2230620456616944e-05,2.2213830330763933e-05,0.5
18819,인문학/Noun,4,2,2,2.2230620456616944e-05,2.2213830330763933e-05,0.5
18820,차이코프스키/Noun,4,2,2,2.2230620456616944e-05,2.2213830330763933e-05,0.5
18821,만국/Noun,4,2,2,2.2230620456616944e-05,2.2213830330763933e-05,0.5
18822,디스커버리/Noun,4,2,2,2.2230620456616944e-05,2.2213830330763933e-05,0.5
18823,포식자/Noun,4,2,2,2.2230620456616944e-05,2.2213830330763933e-05,0.5
18824,이행/Noun,4,2,2,2.2230620456616944e-05,2.2213830330763933e-05,0.5
18825,빈스/Noun,4,2,2,2.2230620456616944e-05,2.2213830330763933e-05,0.5
18826,젝일/Noun,4,2,2,2.2230620456616944e-05,2.2213830330763933e-05,0.5
18827,삼각김밥/Noun,4,2,2,2.2230620456616944e-05,2.2213830330763933e-05,0.5
18828,×/Foreign,4,2,2,2.2230620456616944e-05,2.2213830330763933e-05,0.5
18829,광선/Noun,4,2,2,2.2230620456616944e-05,2.2213830330763933e-05,0.5
18830,1939년/Number,4,2,2,2.2230620456616944e-05,2.2213830330763933e-05,0.5
18831,헬조센/Noun,4,2,2,2.2230620456616944e-05,2.2213830330763933e-05,0.5
18832,픽픽/Noun,4,2,2,2.2230620456616944e-05,2.2213830330763933e-05,0.5
18833,어전/Noun,4,2,2,2.2230620456616944e-05,2.2213830330763933e-05,0.5
18834,폐쇄적/Noun,4,2,2,2.2230620456616944e-05,2.2213830330763933e-05,0.5
18835,편린/Noun,4,2,2,2.2230620456616944e-05,2.2213830330763933e-05,0.5
18836,느꼇/Noun,4,2,2,2.2230620456616944e-05,2.2213830330763933e-05,0.5
18837,오이/Noun,4,2,2,2.2230620456616944e-05,2.2213830330763933e-05,0.5
18838,헤프/Noun,4,2,2,2.2230620456616944e-05,2.2213830330763933e-05,0.5
18839,후지와라/Noun,4,2,2,2.2230620456616944e-05,2.2213830330763933e-05,0.5
18840,이상태/Noun,4,2,2,2.2230620456616944e-05,2.2213830330763933e-05,0.5
18841,빈부/Noun,4,2,2,2.2230620456616944e-05,2.2213830330763933e-05,0.5
18842,활개/Noun,4,2,2,2.2230620456616944e-05,2.2213830330763933e-05,0.5
18843,군부독재/Noun,4,2,2,2.2230620456616944e-05,2.2213830330763933e-05,0.5
18844,8.66/Number,4,2,2,2.2230620456616944e-05,2.2213830330763933e-05,0.5
18845,제독/Noun,4,2,2,2.2230620456616944e-05,2.2213830330763933e-05,0.5
18846,족구/Noun,4,2,2,2.2230620456616944e-05,2.2213830330763933e-05,0.5
18847,ng/Alpha,4,2,2,2.2230620456616944e-05,2.2213830330763933e-05,0.5
18848,편점/Noun,4,2,2,2.2230620456616944e-05,2.2213830330763933e-05,0.5
18849,익산/Noun,4,2,2,2.2230620456616944e-05,2.2213830330763933e-05,0.5
18850,스피커/Noun,4,2,2,2.2230620456616944e-05,2.2213830330763933e-05,0.5
18851,회화/Noun,4,2,2,2.2230620456616944e-05,2.2213830330763933e-05,0.5
18852,투사부일체/Noun,4,2,2,2.2230620456616944e-05,2.2213830330763933e-05,0.5
18853,신유/Noun,4,2,2,2.2230620456616944e-05,2.2213830330763933e-05,0.5
18854,뚱녀/Noun,4,2,2,2.2230620456616944e-05,2.2213830330763933e-05,0.5
18855,영화정보/Noun,4,2,2,2.2230620456616944e-05,2.2213830330763933e-05,0.5
18856,불면/Noun,4,2,2,2.2230620456616944e-05,2.2213830330763933e-05,0.5
18857,ㅏㄷ/KoreanParticle,4,2,2,2.2230620456616944e-05,2.2213830330763933e-05,0.5
18858,여보/Noun,4,2,2,2.2230620456616944e-05,2.2213830330763933e-05,0.5
18859,키스씬/Noun,4,2,2,2.2230620456616944e-05,2.2213830330763933e-05,0.5
18860,라틴/Noun,4,2,2,2.2230620456616944e-05,2.2213830330763933e-05,0.5
18861,2015.02/Number,4,2,2,2.2230620456616944e-05,2.2213830330763933e-05,0.5
18862,티모/Noun,4,2,2,2.2230620456616944e-05,2.2213830330763933e-05,0.5
18863,까마귀/Noun,4,2,2,2.2230620456616944e-05,2.2213830330763933e-05,0.5
18864,션트/Noun,4,2,2,2.2230620456616944e-05,2.2213830330763933e-05,0.5
18865,에서처럼/Josa,4,2,2,2.2230620456616944e-05,2.2213830330763933e-05,0.5
18866,건국/Noun,4,2,2,2.2230620456616944e-05,2.2213830330763933e-05,0.5
18867,익사/Noun,4,2,2,2.2230620456616944e-05,2.2213830330763933e-05,0.5
18868,체포/Noun,4,2,2,2.2230620456616944e-05,2.2213830330763933e-05,0.5
18869,105분/Number,4,2,2,2.2230620456616944e-05,2.2213830330763933e-05,0.5
18870,방아쇠/Noun,4,2,2,2.2230620456616944e-05,2.2213830330763933e-05,0.5
18871,쏠/Noun,4,2,2,2.2230620456616944e-05,2.2213830330763933e-05,0.5
18872,이선/Noun,4,2,2,2.2230620456616944e-05,2.2213830330763933e-05,0.5
18873,진저리/Noun,4,2,2,2.2230620456616944e-05,2.2213830330763933e-05,0.5
18874,다주/Noun,4,2,2,2.2230620456616944e-05,2.2213830330763933e-05,0.5
18875,캬캬캬/Noun,4,2,2,2.2230620456616944e-05,2.2213830330763933e-05,0.5
18876,피똥/Noun,4,2,2,2.2230620456616944e-05,2.2213830330763933e-05,0.5
18877,저편/Noun,4,2,2,2.2230620456616944e-05,2.2213830330763933e-05,0.5
18878,포악하다/Adjective,4,2,2,2.2230620456616944e-05,2.2213830330763933e-05,0.5
18879,자인/Noun,4,2,2,2.2230620456616944e-05,2.2213830330763933e-05,0.5
18880,몰리/Noun,4,2,2,2.2230620456616944e-05,2.2213830330763933e-05,0.5
18881,돈키호테/Noun,4,2,2,2.2230620456616944e-05,2.2213830330763933e-05,0.5
18882,진퉁/Noun,4,2,2,2.2230620456616944e-05,2.2213830330763933e-05,0.5
18883,풋내/Noun,4,2,2,2.2230620456616944e-05,2.2213830330763933e-05,0.5
18884,8.7/Number,4,2,2,2.2230620456616944e-05,2.2213830330763933e-05,0.5
18885,악연/Noun,4,2,2,2.2230620456616944e-05,2.2213830330763933e-05,0.5
18886,올킬/Noun,4,2,2,2.2230620456616944e-05,2.2213830330763933e-05,0.5
18887,360/Number,4,2,2,2.2230620456616944e-05,2.2213830330763933e-05,0.5
18888,처남/Noun,4,2,2,2.2230620456616944e-05,2.2213830330763933e-05,0.5
18889,편때/Noun,4,2,2,2.2230620456616944e-05,2.2213830330763933e-05,0.5
18890,견줄/Noun,4,2,2,2.2230620456616944e-05,2.2213830330763933e-05,0.5
18891,천은경/Noun,4,2,2,2.2230620456616944e-05,2.2213830330763933e-05,0.5
18892,",.,,,/Punctuation",4,2,2,2.2230620456616944e-05,2.2213830330763933e-05,0.5
18893,윌리암/Noun,4,2,2,2.2230620456616944e-05,2.2213830330763933e-05,0.5
18894,아이앰/Noun,4,2,2,2.2230620456616944e-05,2.2213830330763933e-05,0.5
18895,코렐/Noun,4,2,2,2.2230620456616944e-05,2.2213830330763933e-05,0.5
18896,선혈/Noun,4,2,2,2.2230620456616944e-05,2.2213830330763933e-05,0.5
18897,애완동물/Noun,4,2,2,2.2230620456616944e-05,2.2213830330763933e-05,0.5
18898,시원스럽다/Adjective,4,2,2,2.2230620456616944e-05,2.2213830330763933e-05,0.5
18899,동안의/Foreign,4,2,2,2.2230620456616944e-05,2.2213830330763933e-05,0.5
18900,핼드/Noun,4,2,2,2.2230620456616944e-05,2.2213830330763933e-05,0.5
18901,고고씽/Noun,4,2,2,2.2230620456616944e-05,2.2213830330763933e-05,0.5
18902,방면/Noun,4,2,2,2.2230620456616944e-05,2.2213830330763933e-05,0.5
18903,금메달/Noun,4,2,2,2.2230620456616944e-05,2.2213830330763933e-05,0.5
18904,력도/Noun,4,2,2,2.2230620456616944e-05,2.2213830330763933e-05,0.5
18905,장애물/Noun,4,2,2,2.2230620456616944e-05,2.2213830330763933e-05,0.5
18906,외상/Noun,4,2,2,2.2230620456616944e-05,2.2213830330763933e-05,0.5
18907,여름향기/Noun,4,2,2,2.2230620456616944e-05,2.2213830330763933e-05,0.5
18908,덕목/Noun,4,2,2,2.2230620456616944e-05,2.2213830330763933e-05,0.5
18909,비구니/Noun,4,2,2,2.2230620456616944e-05,2.2213830330763933e-05,0.5
18910,패전/Noun,4,2,2,2.2230620456616944e-05,2.2213830330763933e-05,0.5
18911,탄사/Noun,4,2,2,2.2230620456616944e-05,2.2213830330763933e-05,0.5
18912,똑똑/Noun,4,2,2,2.2230620456616944e-05,2.2213830330763933e-05,0.5
18913,항공/Noun,4,2,2,2.2230620456616944e-05,2.2213830330763933e-05,0.5
18914,드라/Noun,4,2,2,2.2230620456616944e-05,2.2213830330763933e-05,0.5
18915,깜빡이다/Verb,4,2,2,2.2230620456616944e-05,2.2213830330763933e-05,0.5
18916,비밀번호/Noun,4,2,2,2.2230620456616944e-05,2.2213830330763933e-05,0.5
18917,유혜리/Noun,4,2,2,2.2230620456616944e-05,2.2213830330763933e-05,0.5
18918,최명길/Noun,4,2,2,2.2230620456616944e-05,2.2213830330763933e-05,0.5
18919,죤내/Noun,4,2,2,2.2230620456616944e-05,2.2213830330763933e-05,0.5
18920,소년병/Noun,4,2,2,2.2230620456616944e-05,2.2213830330763933e-05,0.5
18921,!!!!!!!!!!!!!!!!!!!!/Punctuation,4,2,2,2.2230620456616944e-05,2.2213830330763933e-05,0.5
18922,판가름/Noun,4,2,2,2.2230620456616944e-05,2.2213830330763933e-05,0.5
18923,힛/Noun,4,2,2,2.2230620456616944e-05,2.2213830330763933e-05,0.5
18924,오작교/Noun,4,2,2,2.2230620456616944e-05,2.2213830330763933e-05,0.5
18925,칭하/Noun,4,2,2,2.2230620456616944e-05,2.2213830330763933e-05,0.5
18926,내려앉다/Verb,4,2,2,2.2230620456616944e-05,2.2213830330763933e-05,0.5
18927,만년필/Noun,4,2,2,2.2230620456616944e-05,2.2213830330763933e-05,0.5
18928,에서보다/Josa,4,2,2,2.2230620456616944e-05,2.2213830330763933e-05,0.5
18929,47/Number,4,2,2,2.2230620456616944e-05,2.2213830330763933e-05,0.5
18930,더시티/Noun,4,2,2,2.2230620456616944e-05,2.2213830330763933e-05,0.5
18931,워치/Noun,4,2,2,2.2230620456616944e-05,2.2213830330763933e-05,0.5
18932,일본제국/Noun,4,2,2,2.2230620456616944e-05,2.2213830330763933e-05,0.5
18933,그저께/Noun,4,2,2,2.2230620456616944e-05,2.2213830330763933e-05,0.5
18934,체중/Noun,4,2,2,2.2230620456616944e-05,2.2213830330763933e-05,0.5
18935,알제리/Noun,4,2,2,2.2230620456616944e-05,2.2213830330763933e-05,0.5
18936,yb/Alpha,4,2,2,2.2230620456616944e-05,2.2213830330763933e-05,0.5
18937,에버/Noun,4,2,2,2.2230620456616944e-05,2.2213830330763933e-05,0.5
18938,빈곤/Noun,4,2,2,2.2230620456616944e-05,2.2213830330763933e-05,0.5
18939,미쳣/Noun,4,2,2,2.2230620456616944e-05,2.2213830330763933e-05,0.5
18940,옹기종기/Noun,4,2,2,2.2230620456616944e-05,2.2213830330763933e-05,0.5
18941,독살/Noun,4,2,2,2.2230620456616944e-05,2.2213830330763933e-05,0.5
18942,박광수/Noun,4,2,2,2.2230620456616944e-05,2.2213830330763933e-05,0.5
18943,비결/Noun,4,2,2,2.2230620456616944e-05,2.2213830330763933e-05,0.5
18944,유타/Noun,4,2,2,2.2230620456616944e-05,2.2213830330763933e-05,0.5
18945,나일/Noun,4,2,2,2.2230620456616944e-05,2.2213830330763933e-05,0.5
18946,맨손/Noun,4,2,2,2.2230620456616944e-05,2.2213830330763933e-05,0.5
18947,러브씬/Noun,4,2,2,2.2230620456616944e-05,2.2213830330763933e-05,0.5
18948,룰루/Noun,4,2,2,2.2230620456616944e-05,2.2213830330763933e-05,0.5
18949,드라마정/Noun,4,2,2,2.2230620456616944e-05,2.2213830330763933e-05,0.5
18950,본심/Noun,4,2,2,2.2230620456616944e-05,2.2213830330763933e-05,0.5
18951,봣었는데/Noun,4,2,2,2.2230620456616944e-05,2.2213830330763933e-05,0.5
18952,오염시키다/Verb,4,2,2,2.2230620456616944e-05,2.2213830330763933e-05,0.5
18953,간단/Noun,4,2,2,2.2230620456616944e-05,2.2213830330763933e-05,0.5
18954,활활/Noun,4,2,2,2.2230620456616944e-05,2.2213830330763933e-05,0.5
18955,이라고/Foreign,4,2,2,2.2230620456616944e-05,2.2213830330763933e-05,0.5
18956,".,,,/Punctuation",4,2,2,2.2230620456616944e-05,2.2213830330763933e-05,0.5
18957,명이/Foreign,4,2,2,2.2230620456616944e-05,2.2213830330763933e-05,0.5
18958,다정/Noun,4,2,2,2.2230620456616944e-05,2.2213830330763933e-05,0.5
18959,모정/Noun,4,2,2,2.2230620456616944e-05,2.2213830330763933e-05,0.5
18960,수사극/Noun,4,2,2,2.2230620456616944e-05,2.2213830330763933e-05,0.5
18961,bj/Alpha,4,2,2,2.2230620456616944e-05,2.2213830330763933e-05,0.5
18962,김종국/Noun,4,2,2,2.2230620456616944e-05,2.2213830330763933e-05,0.5
18963,적의/Noun,4,2,2,2.2230620456616944e-05,2.2213830330763933e-05,0.5
18964,만의/Foreign,4,2,2,2.2230620456616944e-05,2.2213830330763933e-05,0.5
18965,탈바꿈/Noun,4,2,2,2.2230620456616944e-05,2.2213830330763933e-05,0.5
18966,선포/Noun,4,2,2,2.2230620456616944e-05,2.2213830330763933e-05,0.5
18967,관속/Noun,4,2,2,2.2230620456616944e-05,2.2213830330763933e-05,0.5
18968,우씨/Noun,4,2,2,2.2230620456616944e-05,2.2213830330763933e-05,0.5
18969,엄기준/Noun,4,2,2,2.2230620456616944e-05,2.2213830330763933e-05,0.5
18970,한겨례/Noun,4,2,2,2.2230620456616944e-05,2.2213830330763933e-05,0.5
18971,마노/Noun,4,2,2,2.2230620456616944e-05,2.2213830330763933e-05,0.5
18972,명보/Noun,4,2,2,2.2230620456616944e-05,2.2213830330763933e-05,0.5
18973,대마초/Noun,4,2,2,2.2230620456616944e-05,2.2213830330763933e-05,0.5
18974,불타/Noun,4,2,2,2.2230620456616944e-05,2.2213830330763933e-05,0.5
18975,척결/Noun,4,2,2,2.2230620456616944e-05,2.2213830330763933e-05,0.5
18976,혼미하다/Adjective,4,2,2,2.2230620456616944e-05,2.2213830330763933e-05,0.5
18977,럽라/Noun,4,2,2,2.2230620456616944e-05,2.2213830330763933e-05,0.5
18978,뱅크/Noun,4,2,2,2.2230620456616944e-05,2.2213830330763933e-05,0.5
18979,8.8/Number,4,2,2,2.2230620456616944e-05,2.2213830330763933e-05,0.5
18980,임명/Noun,4,2,2,2.2230620456616944e-05,2.2213830330763933e-05,0.5
18981,당혹/Noun,4,2,2,2.2230620456616944e-05,2.2213830330763933e-05,0.5
18982,"....,,,,/Punctuation",4,2,2,2.2230620456616944e-05,2.2213830330763933e-05,0.5
18983,입다/Noun,3,3,0,3.3345930684925414e-05,0.0,1.0
18984,-__-/Punctuation,3,0,3,0.0,3.33207454961459e-05,1.0
18985,전교조/Noun,3,0,3,0.0,3.33207454961459e-05,1.0
18986,분업/Noun,3,3,0,3.3345930684925414e-05,0.0,1.0
18987,우여곡절/Noun,3,3,0,3.3345930684925414e-05,0.0,1.0
18988,영화목록/Noun,3,3,0,3.3345930684925414e-05,0.0,1.0
18989,30억/Number,3,0,3,0.0,3.33207454961459e-05,1.0
18990,숙주/Noun,3,3,0,3.3345930684925414e-05,0.0,1.0
18991,삐지다/Adjective,3,0,3,0.0,3.33207454961459e-05,1.0
18992,친목질/Noun,3,0,3,0.0,3.33207454961459e-05,1.0
18993,서민호/Noun,3,3,0,3.3345930684925414e-05,0.0,1.0
18994,양해/Noun,3,0,3,0.0,3.33207454961459e-05,1.0
18995,습니다/Eomi,3,3,0,3.3345930684925414e-05,0.0,1.0
18996,☞☜/Foreign,3,3,0,3.3345930684925414e-05,0.0,1.0
18997,외인/Noun,3,3,0,3.3345930684925414e-05,0.0,1.0
18998,따땃해/Noun,3,3,0,3.3345930684925414e-05,0.0,1.0
18999,?//Punctuation,3,3,0,3.3345930684925414e-05,0.0,1.0
19000,쉽죠잉/Noun,3,0,3,0.0,3.33207454961459e-05,1.0
19001,아랐/Noun,3,0,3,0.0,3.33207454961459e-05,1.0
19002,..~!/Punctuation,3,3,0,3.3345930684925414e-05,0.0,1.0
19003,한의사/Noun,3,0,3,0.0,3.33207454961459e-05,1.0
19004,유플릭스/Noun,3,0,3,0.0,3.33207454961459e-05,1.0
19005,알았슴/Noun,3,0,3,0.0,3.33207454961459e-05,1.0
19006,다혈질/Noun,3,0,3,0.0,3.33207454961459e-05,1.0
19007,JYJ/Alpha,3,3,0,3.3345930684925414e-05,0.0,1.0
19008,이떄/Noun,3,3,0,3.3345930684925414e-05,0.0,1.0
19009,속죄/Noun,3,3,0,3.3345930684925414e-05,0.0,1.0
19010,는커녕/Josa,3,0,3,0.0,3.33207454961459e-05,1.0
19011,amour/Alpha,3,3,0,3.3345930684925414e-05,0.0,1.0
19012,때밀이/Noun,3,0,3,0.0,3.33207454961459e-05,1.0
19013,수험생/Noun,3,3,0,3.3345930684925414e-05,0.0,1.0
19014,천사도/Noun,3,3,0,3.3345930684925414e-05,0.0,1.0
19015,장기간/Noun,3,0,3,0.0,3.33207454961459e-05,1.0
19016,묶음/Noun,3,0,3,0.0,3.33207454961459e-05,1.0
19017,재무/Noun,3,0,3,0.0,3.33207454961459e-05,1.0
19018,게머임/Noun,3,0,3,0.0,3.33207454961459e-05,1.0
19019,영재/Noun,3,3,0,3.3345930684925414e-05,0.0,1.0
19020,알록달록하다/Adjective,3,3,0,3.3345930684925414e-05,0.0,1.0
19021,ㄵ/KoreanParticle,3,0,3,0.0,3.33207454961459e-05,1.0
19022,동민/Noun,3,3,0,3.3345930684925414e-05,0.0,1.0
19023,숨은그림찾기/Noun,3,3,0,3.3345930684925414e-05,0.0,1.0
19024,카프리/Noun,3,3,0,3.3345930684925414e-05,0.0,1.0
19025,바라나시/Noun,3,3,0,3.3345930684925414e-05,0.0,1.0
19026,est/Alpha,3,3,0,3.3345930684925414e-05,0.0,1.0
19027,발레리/Noun,3,3,0,3.3345930684925414e-05,0.0,1.0
19028,이송/Noun,3,0,3,0.0,3.33207454961459e-05,1.0
19029,..^.^/Punctuation,3,3,0,3.3345930684925414e-05,0.0,1.0
19030,로큰롤/Noun,3,3,0,3.3345930684925414e-05,0.0,1.0
19031,언어유희/Noun,3,3,0,3.3345930684925414e-05,0.0,1.0
19032,미니어처/Noun,3,0,3,0.0,3.33207454961459e-05,1.0
19033,BA/Alpha,3,3,0,3.3345930684925414e-05,0.0,1.0
19034,해공/Noun,3,3,0,3.3345930684925414e-05,0.0,1.0
19035,카츠/Noun,3,3,0,3.3345930684925414e-05,0.0,1.0
19036,음정/Noun,3,0,3,0.0,3.33207454961459e-05,1.0
19037,앤키/Noun,3,3,0,3.3345930684925414e-05,0.0,1.0
19038,쥬로링/Noun,3,3,0,3.3345930684925414e-05,0.0,1.0
19039,식/Foreign,3,0,3,0.0,3.33207454961459e-05,1.0
19040,쓰지맙시/Noun,3,0,3,0.0,3.33207454961459e-05,1.0
19041,bitch/Alpha,3,0,3,0.0,3.33207454961459e-05,1.0
19042,동인/Noun,3,0,3,0.0,3.33207454961459e-05,1.0
19043,롤로/Noun,3,3,0,3.3345930684925414e-05,0.0,1.0
19044,좇/Noun,3,0,3,0.0,3.33207454961459e-05,1.0
19045,열흘/Noun,3,3,0,3.3345930684925414e-05,0.0,1.0
19046,통신/Noun,3,3,0,3.3345930684925414e-05,0.0,1.0
19047,긴가민가하다/Adjective,3,3,0,3.3345930684925414e-05,0.0,1.0
19048,이뻣/Noun,3,3,0,3.3345930684925414e-05,0.0,1.0
19049,오사/Noun,3,0,3,0.0,3.33207454961459e-05,1.0
19050,군함/Noun,3,3,0,3.3345930684925414e-05,0.0,1.0
19051,짜릿짜릿하다/Adjective,3,3,0,3.3345930684925414e-05,0.0,1.0
19052,조성모/Noun,3,0,3,0.0,3.33207454961459e-05,1.0
19053,법안/Noun,3,3,0,3.3345930684925414e-05,0.0,1.0
19054,009/Number,3,3,0,3.3345930684925414e-05,0.0,1.0
19055,이응/Noun,3,3,0,3.3345930684925414e-05,0.0,1.0
19056,울렁증/Noun,3,0,3,0.0,3.33207454961459e-05,1.0
19057,또봇/Noun,3,0,3,0.0,3.33207454961459e-05,1.0
19058,반딧불/Noun,3,0,3,0.0,3.33207454961459e-05,1.0
19059,♡♥/Foreign,3,3,0,3.3345930684925414e-05,0.0,1.0
19060,쓰레/Noun,3,0,3,0.0,3.33207454961459e-05,1.0
19061,후반기/Noun,3,0,3,0.0,3.33207454961459e-05,1.0
19062,랑께요/Josa,3,0,3,0.0,3.33207454961459e-05,1.0
19063,폴포츠/Noun,3,3,0,3.3345930684925414e-05,0.0,1.0
19064,Bean/Alpha,3,0,3,0.0,3.33207454961459e-05,1.0
19065,잡종/Noun,3,0,3,0.0,3.33207454961459e-05,1.0
19066,은제/Noun,3,3,0,3.3345930684925414e-05,0.0,1.0
19067,선화공주/Noun,3,3,0,3.3345930684925414e-05,0.0,1.0
19068,기동/Noun,3,3,0,3.3345930684925414e-05,0.0,1.0
19069,철회/Noun,3,0,3,0.0,3.33207454961459e-05,1.0
19070,렘/Noun,3,3,0,3.3345930684925414e-05,0.0,1.0
19071,엿같아/Noun,3,0,3,0.0,3.33207454961459e-05,1.0
19072,대보면/Noun,3,0,3,0.0,3.33207454961459e-05,1.0
19073,녹아내리다/Verb,3,3,0,3.3345930684925414e-05,0.0,1.0
19074,류구/Noun,3,0,3,0.0,3.33207454961459e-05,1.0
19075,찌끄레기/Noun,3,0,3,0.0,3.33207454961459e-05,1.0
19076,거꼭/Noun,3,3,0,3.3345930684925414e-05,0.0,1.0
19077,꿀벌/Noun,3,3,0,3.3345930684925414e-05,0.0,1.0
19078,알흠/Noun,3,3,0,3.3345930684925414e-05,0.0,1.0
19079,쨩/Noun,3,3,0,3.3345930684925414e-05,0.0,1.0
19080,쉐리/Noun,3,3,0,3.3345930684925414e-05,0.0,1.0
19081,씨받이/Noun,3,0,3,0.0,3.33207454961459e-05,1.0
19082,59년/Number,3,3,0,3.3345930684925414e-05,0.0,1.0
19083,엘비스/Noun,3,3,0,3.3345930684925414e-05,0.0,1.0
19084,가이거/Noun,3,3,0,3.3345930684925414e-05,0.0,1.0
19085,서슴없이/Adverb,3,3,0,3.3345930684925414e-05,0.0,1.0
19086,상디/Noun,3,3,0,3.3345930684925414e-05,0.0,1.0
19087,귯/Noun,3,3,0,3.3345930684925414e-05,0.0,1.0
19088,현충일/Noun,3,3,0,3.3345930684925414e-05,0.0,1.0
19089,최영장군/Noun,3,3,0,3.3345930684925414e-05,0.0,1.0
19090,이현세/Noun,3,0,3,0.0,3.33207454961459e-05,1.0
19091,신상/Noun,3,0,3,0.0,3.33207454961459e-05,1.0
19092,출가/Noun,3,0,3,0.0,3.33207454961459e-05,1.0
19093,왼/Noun,3,0,3,0.0,3.33207454961459e-05,1.0
19094,팔방미인/Noun,3,3,0,3.3345930684925414e-05,0.0,1.0
19095,졸잼졸잼/Noun,3,3,0,3.3345930684925414e-05,0.0,1.0
19096,강우/Noun,3,3,0,3.3345930684925414e-05,0.0,1.0
19097,기장면/Noun,3,0,3,0.0,3.33207454961459e-05,1.0
19098,36%/Number,3,0,3,0.0,3.33207454961459e-05,1.0
19099,.^/Punctuation,3,3,0,3.3345930684925414e-05,0.0,1.0
19100,흠칫/Noun,3,3,0,3.3345930684925414e-05,0.0,1.0
19101,변방/Noun,3,0,3,0.0,3.33207454961459e-05,1.0
19102,뻑하/Noun,3,0,3,0.0,3.33207454961459e-05,1.0
19103,고원/Noun,3,3,0,3.3345930684925414e-05,0.0,1.0
19104,동준/Noun,3,0,3,0.0,3.33207454961459e-05,1.0
19105,touching/Alpha,3,3,0,3.3345930684925414e-05,0.0,1.0
19106,ㅜㅡㅠ/KoreanParticle,3,3,0,3.3345930684925414e-05,0.0,1.0
19107,역차별/Noun,3,0,3,0.0,3.33207454961459e-05,1.0
19108,thing/Alpha,3,3,0,3.3345930684925414e-05,0.0,1.0
19109,레시/Noun,3,0,3,0.0,3.33207454961459e-05,1.0
19110,기욤/Noun,3,3,0,3.3345930684925414e-05,0.0,1.0
19111,콩닥콩닥/Adverb,3,3,0,3.3345930684925414e-05,0.0,1.0
19112,크리스토퍼놀란/Noun,3,3,0,3.3345930684925414e-05,0.0,1.0
19113,독단/Noun,3,0,3,0.0,3.33207454961459e-05,1.0
19114,성미산/Noun,3,3,0,3.3345930684925414e-05,0.0,1.0
19115,이십분/Noun,3,0,3,0.0,3.33207454961459e-05,1.0
19116,무휼/Noun,3,3,0,3.3345930684925414e-05,0.0,1.0
19117,태왕사신기/Noun,3,0,3,0.0,3.33207454961459e-05,1.0
19118,지구촌/Noun,3,3,0,3.3345930684925414e-05,0.0,1.0
19119,췌/Noun,3,0,3,0.0,3.33207454961459e-05,1.0
19120,당산대형/Noun,3,3,0,3.3345930684925414e-05,0.0,1.0
19121,....-/Punctuation,3,0,3,0.0,3.33207454961459e-05,1.0
19122,ㅆㄹ/KoreanParticle,3,0,3,0.0,3.33207454961459e-05,1.0
19123,유해/Noun,3,0,3,0.0,3.33207454961459e-05,1.0
19124,졸짝/Noun,3,0,3,0.0,3.33207454961459e-05,1.0
19125,카가와/Noun,3,3,0,3.3345930684925414e-05,0.0,1.0
19126,주노/Noun,3,3,0,3.3345930684925414e-05,0.0,1.0
19127,미경/Noun,3,3,0,3.3345930684925414e-05,0.0,1.0
19128,베버리힐즈/Noun,3,3,0,3.3345930684925414e-05,0.0,1.0
19129,티저/Noun,3,0,3,0.0,3.33207454961459e-05,1.0
19130,도넛/Noun,3,3,0,3.3345930684925414e-05,0.0,1.0
19131,사지절단/Noun,3,0,3,0.0,3.33207454961459e-05,1.0
19132,WHO/Alpha,3,3,0,3.3345930684925414e-05,0.0,1.0
19133,파동/Noun,3,3,0,3.3345930684925414e-05,0.0,1.0
19134,시애틀/Noun,3,3,0,3.3345930684925414e-05,0.0,1.0
19135,벤치/Noun,3,3,0,3.3345930684925414e-05,0.0,1.0
19136,문화인/Noun,3,0,3,0.0,3.33207454961459e-05,1.0
19137,뽀잉/Noun,3,3,0,3.3345930684925414e-05,0.0,1.0
19138,솟아오르다/Verb,3,3,0,3.3345930684925414e-05,0.0,1.0
19139,치구/Noun,3,0,3,0.0,3.33207454961459e-05,1.0
19140,외적인/Noun,3,0,3,0.0,3.33207454961459e-05,1.0
19141,떠벌리다/Verb,3,0,3,0.0,3.33207454961459e-05,1.0
19142,총리와나/Noun,3,3,0,3.3345930684925414e-05,0.0,1.0
19143,밥줄/Noun,3,0,3,0.0,3.33207454961459e-05,1.0
19144,만장일치/Noun,3,0,3,0.0,3.33207454961459e-05,1.0
19145,더그/Noun,3,3,0,3.3345930684925414e-05,0.0,1.0
19146,프랜차이즈/Noun,3,0,3,0.0,3.33207454961459e-05,1.0
19147,스렉/Noun,3,0,3,0.0,3.33207454961459e-05,1.0
19148,투구/Noun,3,0,3,0.0,3.33207454961459e-05,1.0
19149,喜/Foreign,3,3,0,3.3345930684925414e-05,0.0,1.0
19150,박효주/Noun,3,3,0,3.3345930684925414e-05,0.0,1.0
19151,가구야/Noun,3,3,0,3.3345930684925414e-05,0.0,1.0
19152,처가/Noun,3,3,0,3.3345930684925414e-05,0.0,1.0
19153,고결하다/Adjective,3,3,0,3.3345930684925414e-05,0.0,1.0
19154,프리메이슨/Noun,3,0,3,0.0,3.33207454961459e-05,1.0
19155,침팬지/Noun,3,3,0,3.3345930684925414e-05,0.0,1.0
19156,켓/Noun,3,3,0,3.3345930684925414e-05,0.0,1.0
19157,"-,.-;;/Punctuation",3,0,3,0.0,3.33207454961459e-05,1.0
19158,자레드/Noun,3,3,0,3.3345930684925414e-05,0.0,1.0
19159,델리/Noun,3,3,0,3.3345930684925414e-05,0.0,1.0
19160,문어체/Noun,3,0,3,0.0,3.33207454961459e-05,1.0
19161,유호정/Noun,3,3,0,3.3345930684925414e-05,0.0,1.0
19162,서진/Noun,3,3,0,3.3345930684925414e-05,0.0,1.0
19163,대폭/Noun,3,0,3,0.0,3.33207454961459e-05,1.0
19164,they/Alpha,3,3,0,3.3345930684925414e-05,0.0,1.0
19165,boys/Alpha,3,3,0,3.3345930684925414e-05,0.0,1.0
19166,네버랜드/Noun,3,3,0,3.3345930684925414e-05,0.0,1.0
19167,채권/Noun,3,0,3,0.0,3.33207454961459e-05,1.0
19168,베오울프/Noun,3,3,0,3.3345930684925414e-05,0.0,1.0
19169,총지배인/Noun,3,0,3,0.0,3.33207454961459e-05,1.0
19170,AIDS/Alpha,3,0,3,0.0,3.33207454961459e-05,1.0
19171,놨음/Noun,3,0,3,0.0,3.33207454961459e-05,1.0
19172,개잼꿀잼/Noun,3,3,0,3.3345930684925414e-05,0.0,1.0
19173,가년/Noun,3,0,3,0.0,3.33207454961459e-05,1.0
19174,AKB/Alpha,3,0,3,0.0,3.33207454961459e-05,1.0
19175,비보/Noun,3,0,3,0.0,3.33207454961459e-05,1.0
19176,정은채/Noun,3,0,3,0.0,3.33207454961459e-05,1.0
19177,유하은/Noun,3,0,3,0.0,3.33207454961459e-05,1.0
19178,amazing/Alpha,3,3,0,3.3345930684925414e-05,0.0,1.0
19179,박진표/Noun,3,0,3,0.0,3.33207454961459e-05,1.0
19180,부옇다/Adjective,3,0,3,0.0,3.33207454961459e-05,1.0
19181,제밌다/Noun,3,3,0,3.3345930684925414e-05,0.0,1.0
19182,..;;;;;/Punctuation,3,0,3,0.0,3.33207454961459e-05,1.0
19183,조물/Noun,3,0,3,0.0,3.33207454961459e-05,1.0
19184,봤넹/Noun,3,3,0,3.3345930684925414e-05,0.0,1.0
19185,헤스/Noun,3,3,0,3.3345930684925414e-05,0.0,1.0
19186,찰톤/Noun,3,3,0,3.3345930684925414e-05,0.0,1.0
19187,웡/Noun,3,3,0,3.3345930684925414e-05,0.0,1.0
19188,냉동/Noun,3,0,3,0.0,3.33207454961459e-05,1.0
19189,스코필드/Noun,3,3,0,3.3345930684925414e-05,0.0,1.0
19190,live/Alpha,3,3,0,3.3345930684925414e-05,0.0,1.0
19191,등지/Noun,3,3,0,3.3345930684925414e-05,0.0,1.0
19192,배격/Noun,3,3,0,3.3345930684925414e-05,0.0,1.0
19193,기입/Noun,3,0,3,0.0,3.33207454961459e-05,1.0
19194,킹덤/Noun,3,3,0,3.3345930684925414e-05,0.0,1.0
19195,자기야/Noun,3,0,3,0.0,3.33207454961459e-05,1.0
19196,불확실/Noun,3,0,3,0.0,3.33207454961459e-05,1.0
19197,으레/Noun,3,0,3,0.0,3.33207454961459e-05,1.0
19198,!!)/Punctuation,3,3,0,3.3345930684925414e-05,0.0,1.0
19199,교도/Noun,3,0,3,0.0,3.33207454961459e-05,1.0
19200,윈다졸/Noun,3,0,3,0.0,3.33207454961459e-05,1.0
19201,나올껄/Noun,3,0,3,0.0,3.33207454961459e-05,1.0
19202,펄펄/Adverb,3,3,0,3.3345930684925414e-05,0.0,1.0
19203,;;;;;;;;/Punctuation,3,0,3,0.0,3.33207454961459e-05,1.0
19204,발명/Noun,3,0,3,0.0,3.33207454961459e-05,1.0
19205,유래/Noun,3,0,3,0.0,3.33207454961459e-05,1.0
19206,북조선/Noun,3,0,3,0.0,3.33207454961459e-05,1.0
19207,히어로즈/Noun,3,3,0,3.3345930684925414e-05,0.0,1.0
19208,굿구/Noun,3,3,0,3.3345930684925414e-05,0.0,1.0
19209,IMDb/Alpha,3,0,3,0.0,3.33207454961459e-05,1.0
19210,송재호/Noun,3,3,0,3.3345930684925414e-05,0.0,1.0
19211,y/Alpha,3,3,0,3.3345930684925414e-05,0.0,1.0
19212,엽서/Noun,3,3,0,3.3345930684925414e-05,0.0,1.0
19213,스모크/Noun,3,3,0,3.3345930684925414e-05,0.0,1.0
19214,만들엇네/Noun,3,0,3,0.0,3.33207454961459e-05,1.0
19215,섬뜻/Noun,3,3,0,3.3345930684925414e-05,0.0,1.0
19216,촤고/Noun,3,3,0,3.3345930684925414e-05,0.0,1.0
19217,망언/Noun,3,0,3,0.0,3.33207454961459e-05,1.0
19218,킥킥대다/Verb,3,3,0,3.3345930684925414e-05,0.0,1.0
19219,하이브리드/Noun,3,0,3,0.0,3.33207454961459e-05,1.0
19220,잘잘못/Noun,3,0,3,0.0,3.33207454961459e-05,1.0
19221,시에라/Noun,3,3,0,3.3345930684925414e-05,0.0,1.0
19222,인굿/Noun,3,3,0,3.3345930684925414e-05,0.0,1.0
19223,류진/Noun,3,0,3,0.0,3.33207454961459e-05,1.0
19224,이질/Noun,3,0,3,0.0,3.33207454961459e-05,1.0
19225,버럭버럭/Adverb,3,0,3,0.0,3.33207454961459e-05,1.0
19226,외숙모/Noun,3,0,3,0.0,3.33207454961459e-05,1.0
19227,선속/Noun,3,3,0,3.3345930684925414e-05,0.0,1.0
19228,세면/Noun,3,0,3,0.0,3.33207454961459e-05,1.0
19229,퀵실버/Noun,3,3,0,3.3345930684925414e-05,0.0,1.0
19230,사퇴/Noun,3,0,3,0.0,3.33207454961459e-05,1.0
19231,중학/Noun,3,3,0,3.3345930684925414e-05,0.0,1.0
19232,有/Foreign,3,0,3,0.0,3.33207454961459e-05,1.0
19233,잼있넹/Noun,3,3,0,3.3345930684925414e-05,0.0,1.0
19234,rain/Alpha,3,3,0,3.3345930684925414e-05,0.0,1.0
19235,기별/Noun,3,0,3,0.0,3.33207454961459e-05,1.0
19236,틀때/Noun,3,0,3,0.0,3.33207454961459e-05,1.0
19237,서하/Noun,3,0,3,0.0,3.33207454961459e-05,1.0
19238,밤늦다/Adjective,3,3,0,3.3345930684925414e-05,0.0,1.0
19239,남다름/Noun,3,3,0,3.3345930684925414e-05,0.0,1.0
19240,해괴/Noun,3,0,3,0.0,3.33207454961459e-05,1.0
19241,부림/Noun,3,0,3,0.0,3.33207454961459e-05,1.0
19242,낚였군/Noun,3,0,3,0.0,3.33207454961459e-05,1.0
19243,민페/Noun,3,0,3,0.0,3.33207454961459e-05,1.0
19244,김희철/Noun,3,0,3,0.0,3.33207454961459e-05,1.0
19245,정하나/Noun,3,0,3,0.0,3.33207454961459e-05,1.0
19246,김문옥/Noun,3,0,3,0.0,3.33207454961459e-05,1.0
19247,돈대/Noun,3,0,3,0.0,3.33207454961459e-05,1.0
19248,사비/Noun,3,0,3,0.0,3.33207454961459e-05,1.0
19249,??????????/Punctuation,3,0,3,0.0,3.33207454961459e-05,1.0
19250,불성실하다/Adjective,3,0,3,0.0,3.33207454961459e-05,1.0
19251,샤우팅/Noun,3,0,3,0.0,3.33207454961459e-05,1.0
19252,면욕/Noun,3,0,3,0.0,3.33207454961459e-05,1.0
19253,기차역/Noun,3,3,0,3.3345930684925414e-05,0.0,1.0
19254,줏/Noun,3,3,0,3.3345930684925414e-05,0.0,1.0
19255,쉬이/Noun,3,3,0,3.3345930684925414e-05,0.0,1.0
19256,부탄/Noun,3,3,0,3.3345930684925414e-05,0.0,1.0
19257,김성오/Noun,3,0,3,0.0,3.33207454961459e-05,1.0
19258,류승수/Noun,3,3,0,3.3345930684925414e-05,0.0,1.0
19259,머슴/Noun,3,0,3,0.0,3.33207454961459e-05,1.0
19260,육지/Noun,3,3,0,3.3345930684925414e-05,0.0,1.0
19261,점정/Noun,3,3,0,3.3345930684925414e-05,0.0,1.0
19262,화룡/Noun,3,3,0,3.3345930684925414e-05,0.0,1.0
19263,절름발이/Noun,3,3,0,3.3345930684925414e-05,0.0,1.0
19264,주모/Noun,3,0,3,0.0,3.33207454961459e-05,1.0
19265,인호/Noun,3,3,0,3.3345930684925414e-05,0.0,1.0
19266,120억/Number,3,0,3,0.0,3.33207454961459e-05,1.0
19267,영수/Noun,3,3,0,3.3345930684925414e-05,0.0,1.0
19268,프란/Noun,3,3,0,3.3345930684925414e-05,0.0,1.0
19269,짬밥/Noun,3,0,3,0.0,3.33207454961459e-05,1.0
19270,백야행/Noun,3,3,0,3.3345930684925414e-05,0.0,1.0
19271,.^^;/Punctuation,3,3,0,3.3345930684925414e-05,0.0,1.0
19272,퀸스/Noun,3,3,0,3.3345930684925414e-05,0.0,1.0
19273,이상현/Noun,3,0,3,0.0,3.33207454961459e-05,1.0
19274,Can/Alpha,3,3,0,3.3345930684925414e-05,0.0,1.0
19275,조급하다/Adjective,3,0,3,0.0,3.33207454961459e-05,1.0
19276,하렘/Noun,3,0,3,0.0,3.33207454961459e-05,1.0
19277,미묘/Noun,3,0,3,0.0,3.33207454961459e-05,1.0
19278,오하나/Noun,3,3,0,3.3345930684925414e-05,0.0,1.0
19279,즉시/Noun,3,3,0,3.3345930684925414e-05,0.0,1.0
19280,천대/Noun,3,0,3,0.0,3.33207454961459e-05,1.0
19281,사제/Noun,3,0,3,0.0,3.33207454961459e-05,1.0
19282,특효약/Noun,3,0,3,0.0,3.33207454961459e-05,1.0
19283,비닐봉지/Noun,3,0,3,0.0,3.33207454961459e-05,1.0
19284,끝일/Noun,3,3,0,3.3345930684925414e-05,0.0,1.0
19285,염증/Noun,3,3,0,3.3345930684925414e-05,0.0,1.0
19286,세부/Noun,3,0,3,0.0,3.33207454961459e-05,1.0
19287,실습/Noun,3,0,3,0.0,3.33207454961459e-05,1.0
19288,이니셜/Noun,3,0,3,0.0,3.33207454961459e-05,1.0
19289,!!@@/Punctuation,3,3,0,3.3345930684925414e-05,0.0,1.0
19290,호노카/Noun,3,0,3,0.0,3.33207454961459e-05,1.0
19291,칼리/Noun,3,3,0,3.3345930684925414e-05,0.0,1.0
19292,당시/Foreign,3,3,0,3.3345930684925414e-05,0.0,1.0
19293,제로센/Noun,3,0,3,0.0,3.33207454961459e-05,1.0
19294,켜지다/Verb,3,0,3,0.0,3.33207454961459e-05,1.0
19295,가슴성형/Noun,3,0,3,0.0,3.33207454961459e-05,1.0
19296,용씨/Noun,3,3,0,3.3345930684925414e-05,0.0,1.0
19297,사일런트/Noun,3,0,3,0.0,3.33207454961459e-05,1.0
19298,뭐합/Noun,3,0,3,0.0,3.33207454961459e-05,1.0
19299,돌려막기/Noun,3,0,3,0.0,3.33207454961459e-05,1.0
19300,효리/Noun,3,0,3,0.0,3.33207454961459e-05,1.0
19301,뱅크시/Noun,3,3,0,3.3345930684925414e-05,0.0,1.0
19302,나도꽃/Noun,3,3,0,3.3345930684925414e-05,0.0,1.0
19303,이정표/Noun,3,3,0,3.3345930684925414e-05,0.0,1.0
19304,염불/Noun,3,0,3,0.0,3.33207454961459e-05,1.0
19305,석가모니/Noun,3,0,3,0.0,3.33207454961459e-05,1.0
19306,가야로/Noun,3,3,0,3.3345930684925414e-05,0.0,1.0
19307,가대/Noun,3,0,3,0.0,3.33207454961459e-05,1.0
19308,차가워지다/Verb,3,3,0,3.3345930684925414e-05,0.0,1.0
19309,해양경찰/Noun,3,0,3,0.0,3.33207454961459e-05,1.0
19310,자고로/Noun,3,0,3,0.0,3.33207454961459e-05,1.0
19311,족적/Noun,3,3,0,3.3345930684925414e-05,0.0,1.0
19312,메이지/Noun,3,3,0,3.3345930684925414e-05,0.0,1.0
19313,샘물교회/Noun,3,0,3,0.0,3.33207454961459e-05,1.0
19314,ㅅㄱㅇ/KoreanParticle,3,0,3,0.0,3.33207454961459e-05,1.0
19315,이호/Noun,3,3,0,3.3345930684925414e-05,0.0,1.0
19316,뮤즈/Noun,3,3,0,3.3345930684925414e-05,0.0,1.0
19317,무용담/Noun,3,0,3,0.0,3.33207454961459e-05,1.0
19318,프사이/Noun,3,3,0,3.3345930684925414e-05,0.0,1.0
19319,크라임씬/Noun,3,3,0,3.3345930684925414e-05,0.0,1.0
19320,희로애락/Noun,3,3,0,3.3345930684925414e-05,0.0,1.0
19321,금상첨화/Noun,3,3,0,3.3345930684925414e-05,0.0,1.0
19322,레슬리닐슨/Noun,3,3,0,3.3345930684925414e-05,0.0,1.0
19323,밑천/Noun,3,0,3,0.0,3.33207454961459e-05,1.0
19324,관광지/Noun,3,0,3,0.0,3.33207454961459e-05,1.0
19325,생뚱맞는/Noun,3,0,3,0.0,3.33207454961459e-05,1.0
19326,come/Alpha,3,3,0,3.3345930684925414e-05,0.0,1.0
19327,벨아미/Noun,3,0,3,0.0,3.33207454961459e-05,1.0
19328,ㅈㅈㅈ/KoreanParticle,3,0,3,0.0,3.33207454961459e-05,1.0
19329,총상/Noun,3,0,3,0.0,3.33207454961459e-05,1.0
19330,연적/Noun,3,0,3,0.0,3.33207454961459e-05,1.0
19331,사표/Noun,3,0,3,0.0,3.33207454961459e-05,1.0
19332,떡대/Noun,3,0,3,0.0,3.33207454961459e-05,1.0
19333,섬찟하다/Adjective,3,3,0,3.3345930684925414e-05,0.0,1.0
19334,르누아르/Noun,3,3,0,3.3345930684925414e-05,0.0,1.0
19335,애마/Noun,3,0,3,0.0,3.33207454961459e-05,1.0
19336,퍼갈게/Noun,3,3,0,3.3345930684925414e-05,0.0,1.0
19337,두산베어스/Noun,3,0,3,0.0,3.33207454961459e-05,1.0
19338,개망작임/Noun,3,0,3,0.0,3.33207454961459e-05,1.0
19339,법정씬/Noun,3,0,3,0.0,3.33207454961459e-05,1.0
19340,저쪽/Noun,3,0,3,0.0,3.33207454961459e-05,1.0
19341,윤석화/Noun,3,0,3,0.0,3.33207454961459e-05,1.0
19342,경탄/Noun,3,3,0,3.3345930684925414e-05,0.0,1.0
19343,밥통/Noun,3,0,3,0.0,3.33207454961459e-05,1.0
19344,겉돈/Noun,3,0,3,0.0,3.33207454961459e-05,1.0
19345,상금/Noun,3,0,3,0.0,3.33207454961459e-05,1.0
19346,",.,.,.,.,./Punctuation",3,0,3,0.0,3.33207454961459e-05,1.0
19347,피땀/Noun,3,0,3,0.0,3.33207454961459e-05,1.0
19348,fu/Alpha,3,0,3,0.0,3.33207454961459e-05,1.0
19349,자발/Noun,3,0,3,0.0,3.33207454961459e-05,1.0
19350,아슬아슬/Noun,3,3,0,3.3345930684925414e-05,0.0,1.0
19351,견고하다/Adjective,3,3,0,3.3345930684925414e-05,0.0,1.0
19352,에스엠/Noun,3,3,0,3.3345930684925414e-05,0.0,1.0
19353,업로드/Noun,3,0,3,0.0,3.33207454961459e-05,1.0
19354,빠삐용/Noun,3,3,0,3.3345930684925414e-05,0.0,1.0
19355,TO/Alpha,3,3,0,3.3345930684925414e-05,0.0,1.0
19356,담대하다/Adjective,3,3,0,3.3345930684925414e-05,0.0,1.0
19357,한수아/Noun,3,0,3,0.0,3.33207454961459e-05,1.0
19358,밧데리/Noun,3,0,3,0.0,3.33207454961459e-05,1.0
19359,발다/Noun,3,0,3,0.0,3.33207454961459e-05,1.0
19360,후끈하다/Adjective,3,0,3,0.0,3.33207454961459e-05,1.0
19361,회안/Noun,3,0,3,0.0,3.33207454961459e-05,1.0
19362,부전/Noun,3,0,3,0.0,3.33207454961459e-05,1.0
19363,외한/Noun,3,3,0,3.3345930684925414e-05,0.0,1.0
19364,닝겐/Noun,3,3,0,3.3345930684925414e-05,0.0,1.0
19365,이륙/Noun,3,0,3,0.0,3.33207454961459e-05,1.0
19366,박하나/Noun,3,3,0,3.3345930684925414e-05,0.0,1.0
19367,외교/Noun,3,3,0,3.3345930684925414e-05,0.0,1.0
19368,자연인/Noun,3,3,0,3.3345930684925414e-05,0.0,1.0
19369,뜨끔하다/Adjective,3,3,0,3.3345930684925414e-05,0.0,1.0
19370,맞장구/Noun,3,0,3,0.0,3.33207454961459e-05,1.0
19371,발기다/Verb,3,3,0,3.3345930684925414e-05,0.0,1.0
19372,독립군/Noun,3,0,3,0.0,3.33207454961459e-05,1.0
19373,대문/Noun,3,0,3,0.0,3.33207454961459e-05,1.0
19374,거창/Noun,3,0,3,0.0,3.33207454961459e-05,1.0
19375,켄드릭/Noun,3,3,0,3.3345930684925414e-05,0.0,1.0
19376,쪼이다/Verb,3,3,0,3.3345930684925414e-05,0.0,1.0
19377,고라/Noun,3,0,3,0.0,3.33207454961459e-05,1.0
19378,기름값/Noun,3,0,3,0.0,3.33207454961459e-05,1.0
19379,힛힛/Noun,3,0,3,0.0,3.33207454961459e-05,1.0
19380,황석/Noun,3,3,0,3.3345930684925414e-05,0.0,1.0
19381,째보/Noun,3,3,0,3.3345930684925414e-05,0.0,1.0
19382,단세포/Noun,3,0,3,0.0,3.33207454961459e-05,1.0
19383,만분/Noun,3,0,3,0.0,3.33207454961459e-05,1.0
19384,에릭클랩튼/Noun,3,3,0,3.3345930684925414e-05,0.0,1.0
19385,~!!!!!!!!!!/Punctuation,3,3,0,3.3345930684925414e-05,0.0,1.0
19386,".,.,.,.,.,./Punctuation",3,0,3,0.0,3.33207454961459e-05,1.0
19387,같/Noun,3,0,3,0.0,3.33207454961459e-05,1.0
19388,큼은/Foreign,3,3,0,3.3345930684925414e-05,0.0,1.0
19389,커트코베인/Noun,3,3,0,3.3345930684925414e-05,0.0,1.0
19390,맨붕/Noun,3,0,3,0.0,3.33207454961459e-05,1.0
19391,홍종현/Noun,3,3,0,3.3345930684925414e-05,0.0,1.0
19392,선우/Noun,3,3,0,3.3345930684925414e-05,0.0,1.0
19393,조유영/Noun,3,0,3,0.0,3.33207454961459e-05,1.0
19394,좌편향/Noun,3,0,3,0.0,3.33207454961459e-05,1.0
19395,상현/Noun,3,3,0,3.3345930684925414e-05,0.0,1.0
19396,손상/Noun,3,0,3,0.0,3.33207454961459e-05,1.0
19397,처넌/Noun,3,0,3,0.0,3.33207454961459e-05,1.0
19398,부쵸/Noun,3,3,0,3.3345930684925414e-05,0.0,1.0
19399,변치/Noun,3,3,0,3.3345930684925414e-05,0.0,1.0
19400,건내다/Verb,3,3,0,3.3345930684925414e-05,0.0,1.0
19401,파트라/Noun,3,3,0,3.3345930684925414e-05,0.0,1.0
19402,서도영/Noun,3,3,0,3.3345930684925414e-05,0.0,1.0
19403,철판/Noun,3,0,3,0.0,3.33207454961459e-05,1.0
19404,안드네/Noun,3,0,3,0.0,3.33207454961459e-05,1.0
19405,스파/Noun,3,0,3,0.0,3.33207454961459e-05,1.0
19406,던스트/Noun,3,3,0,3.3345930684925414e-05,0.0,1.0
19407,알피/Noun,3,3,0,3.3345930684925414e-05,0.0,1.0
19408,델토/Noun,3,3,0,3.3345930684925414e-05,0.0,1.0
19409,첨부/Noun,3,3,0,3.3345930684925414e-05,0.0,1.0
19410,스윙스/Noun,3,0,3,0.0,3.33207454961459e-05,1.0
19411,고추가/Noun,3,3,0,3.3345930684925414e-05,0.0,1.0
19412,급상승/Noun,3,0,3,0.0,3.33207454961459e-05,1.0
19413,Captain/Alpha,3,3,0,3.3345930684925414e-05,0.0,1.0
19414,가랑비/Noun,3,3,0,3.3345930684925414e-05,0.0,1.0
19415,급사/Noun,3,0,3,0.0,3.33207454961459e-05,1.0
19416,숫처녀/Noun,3,0,3,0.0,3.33207454961459e-05,1.0
19417,꽁트/Noun,3,0,3,0.0,3.33207454961459e-05,1.0
19418,샴발라/Noun,3,0,3,0.0,3.33207454961459e-05,1.0
19419,눈웃음/Noun,3,3,0,3.3345930684925414e-05,0.0,1.0
19420,'-'/Punctuation,3,3,0,3.3345930684925414e-05,0.0,1.0
19421,80억/Number,3,0,3,0.0,3.33207454961459e-05,1.0
19422,1.3/Number,3,0,3,0.0,3.33207454961459e-05,1.0
19423,없엇어/Noun,3,3,0,3.3345930684925414e-05,0.0,1.0
19424,대한민국만세/Noun,3,3,0,3.3345930684925414e-05,0.0,1.0
19425,피상/Noun,3,0,3,0.0,3.33207454961459e-05,1.0
19426,서류/Noun,3,0,3,0.0,3.33207454961459e-05,1.0
19427,반추/Noun,3,3,0,3.3345930684925414e-05,0.0,1.0
19428,구봉서/Noun,3,3,0,3.3345930684925414e-05,0.0,1.0
19429,일장기/Noun,3,0,3,0.0,3.33207454961459e-05,1.0
19430,너포위/Noun,3,3,0,3.3345930684925414e-05,0.0,1.0
19431,기성용/Noun,3,3,0,3.3345930684925414e-05,0.0,1.0
19432,카메라감독/Noun,3,0,3,0.0,3.33207454961459e-05,1.0
19433,러신/Noun,3,3,0,3.3345930684925414e-05,0.0,1.0
19434,써클/Noun,3,0,3,0.0,3.33207454961459e-05,1.0
19435,글러브/Noun,3,0,3,0.0,3.33207454961459e-05,1.0
19436,발가벗기다/Verb,3,3,0,3.3345930684925414e-05,0.0,1.0
19437,타당성/Noun,3,0,3,0.0,3.33207454961459e-05,1.0
19438,뿡뿡이/Noun,3,0,3,0.0,3.33207454961459e-05,1.0
19439,다가서다/Verb,3,3,0,3.3345930684925414e-05,0.0,1.0
19440,호킨스/Noun,3,3,0,3.3345930684925414e-05,0.0,1.0
19441,손호영/Noun,3,0,3,0.0,3.33207454961459e-05,1.0
19442,살며시/Adverb,3,3,0,3.3345930684925414e-05,0.0,1.0
19443,방조/Noun,3,0,3,0.0,3.33207454961459e-05,1.0
19444,공모/Noun,3,0,3,0.0,3.33207454961459e-05,1.0
19445,엄니/Noun,3,0,3,0.0,3.33207454961459e-05,1.0
19446,김생민/Noun,3,0,3,0.0,3.33207454961459e-05,1.0
19447,싸움질/Noun,3,0,3,0.0,3.33207454961459e-05,1.0
19448,7~10/Number,3,0,3,0.0,3.33207454961459e-05,1.0
19449,미티/Noun,3,3,0,3.3345930684925414e-05,0.0,1.0
19450,avi/Alpha,3,0,3,0.0,3.33207454961459e-05,1.0
19451,강신일/Noun,3,0,3,0.0,3.33207454961459e-05,1.0
19452,예원/Noun,3,3,0,3.3345930684925414e-05,0.0,1.0
19453,안거/Noun,3,0,3,0.0,3.33207454961459e-05,1.0
19454,퍼니플래닛/Noun,3,0,3,0.0,3.33207454961459e-05,1.0
19455,험악하다/Adjective,3,0,3,0.0,3.33207454961459e-05,1.0
19456,취조/Noun,3,0,3,0.0,3.33207454961459e-05,1.0
19457,최대로/Noun,3,0,3,0.0,3.33207454961459e-05,1.0
19458,합심/Noun,3,0,3,0.0,3.33207454961459e-05,1.0
19459,--../Punctuation,3,0,3,0.0,3.33207454961459e-05,1.0
19460,위장결혼/Noun,3,0,3,0.0,3.33207454961459e-05,1.0
19461,슬로모션/Noun,3,3,0,3.3345930684925414e-05,0.0,1.0
19462,보물섬/Noun,3,3,0,3.3345930684925414e-05,0.0,1.0
19463,스탄/Noun,3,0,3,0.0,3.33207454961459e-05,1.0
19464,오호호/Adverb,3,3,0,3.3345930684925414e-05,0.0,1.0
19465,둘러대다/Verb,3,0,3,0.0,3.33207454961459e-05,1.0
19466,횡대/Noun,3,0,3,0.0,3.33207454961459e-05,1.0
19467,~~!!^^/Punctuation,3,3,0,3.3345930684925414e-05,0.0,1.0
19468,매국/Noun,3,0,3,0.0,3.33207454961459e-05,1.0
19469,유니버스/Noun,3,3,0,3.3345930684925414e-05,0.0,1.0
19470,아틀란티스/Noun,3,3,0,3.3345930684925414e-05,0.0,1.0
19471,진일/Noun,3,3,0,3.3345930684925414e-05,0.0,1.0
19472,그른/Noun,3,3,0,3.3345930684925414e-05,0.0,1.0
19473,묶인/Noun,3,3,0,3.3345930684925414e-05,0.0,1.0
19474,시피/Noun,3,0,3,0.0,3.33207454961459e-05,1.0
19475,왕리홍/Noun,3,0,3,0.0,3.33207454961459e-05,1.0
19476,오천원/Noun,3,0,3,0.0,3.33207454961459e-05,1.0
19477,앱등이/Noun,3,0,3,0.0,3.33207454961459e-05,1.0
19478,길용우/Noun,3,0,3,0.0,3.33207454961459e-05,1.0
19479,7.99/Number,3,3,0,3.3345930684925414e-05,0.0,1.0
19480,울진/Noun,3,3,0,3.3345930684925414e-05,0.0,1.0
19481,써로게이트/Noun,3,0,3,0.0,3.33207454961459e-05,1.0
19482,혼선/Noun,3,0,3,0.0,3.33207454961459e-05,1.0
19483,정완/Noun,3,3,0,3.3345930684925414e-05,0.0,1.0
19484,선데이/Noun,3,3,0,3.3345930684925414e-05,0.0,1.0
19485,이시하라/Noun,3,0,3,0.0,3.33207454961459e-05,1.0
19486,이수성/Noun,3,0,3,0.0,3.33207454961459e-05,1.0
19487,선데이서울/Noun,3,0,3,0.0,3.33207454961459e-05,1.0
19488,선심/Noun,3,0,3,0.0,3.33207454961459e-05,1.0
19489,하이스쿨/Noun,3,3,0,3.3345930684925414e-05,0.0,1.0
19490,트립/Noun,3,0,3,0.0,3.33207454961459e-05,1.0
19491,뱀검/Noun,3,3,0,3.3345930684925414e-05,0.0,1.0
19492,데니안/Noun,3,0,3,0.0,3.33207454961459e-05,1.0
19493,신안/Noun,3,0,3,0.0,3.33207454961459e-05,1.0
19494,해물/Noun,3,0,3,0.0,3.33207454961459e-05,1.0
19495,호로/Noun,3,0,3,0.0,3.33207454961459e-05,1.0
19496,라커/Noun,3,0,3,0.0,3.33207454961459e-05,1.0
19497,회전목마/Noun,3,3,0,3.3345930684925414e-05,0.0,1.0
19498,휠/Noun,3,0,3,0.0,3.33207454961459e-05,1.0
19499,넘겨주다/Verb,3,0,3,0.0,3.33207454961459e-05,1.0
19500,팬층/Noun,3,0,3,0.0,3.33207454961459e-05,1.0
19501,맺힌다/Noun,3,3,0,3.3345930684925414e-05,0.0,1.0
19502,대척점/Noun,3,0,3,0.0,3.33207454961459e-05,1.0
19503,디렉터스컷/Noun,3,3,0,3.3345930684925414e-05,0.0,1.0
19504,ㅠㅠㅋㅋㅋ/KoreanParticle,3,3,0,3.3345930684925414e-05,0.0,1.0
19505,디올/Noun,3,3,0,3.3345930684925414e-05,0.0,1.0
19506,컴버/Noun,3,3,0,3.3345930684925414e-05,0.0,1.0
19507,스벤/Noun,3,3,0,3.3345930684925414e-05,0.0,1.0
19508,DMB/Alpha,3,3,0,3.3345930684925414e-05,0.0,1.0
19509,심벌/Noun,3,0,3,0.0,3.33207454961459e-05,1.0
19510,김지석/Noun,3,3,0,3.3345930684925414e-05,0.0,1.0
19511,마르퀴스/Noun,3,3,0,3.3345930684925414e-05,0.0,1.0
19512,봉합/Noun,3,0,3,0.0,3.33207454961459e-05,1.0
19513,.....^^/Punctuation,3,3,0,3.3345930684925414e-05,0.0,1.0
19514,문명인/Noun,3,3,0,3.3345930684925414e-05,0.0,1.0
19515,순애/Noun,3,0,3,0.0,3.33207454961459e-05,1.0
19516,불씨/Noun,3,3,0,3.3345930684925414e-05,0.0,1.0
19517,윤개상/Noun,3,0,3,0.0,3.33207454961459e-05,1.0
19518,플러/Noun,3,3,0,3.3345930684925414e-05,0.0,1.0
19519,그랫음/Noun,3,0,3,0.0,3.33207454961459e-05,1.0
19520,무후/Noun,3,0,3,0.0,3.33207454961459e-05,1.0
19521,김운경/Noun,3,3,0,3.3345930684925414e-05,0.0,1.0
19522,Beautiful/Alpha,3,3,0,3.3345930684925414e-05,0.0,1.0
19523,단신/Noun,3,0,3,0.0,3.33207454961459e-05,1.0
19524,윤혜영/Noun,3,0,3,0.0,3.33207454961459e-05,1.0
19525,산산/Noun,3,0,3,0.0,3.33207454961459e-05,1.0
19526,용이하다/Adjective,3,3,0,3.3345930684925414e-05,0.0,1.0
19527,일산/Noun,3,0,3,0.0,3.33207454961459e-05,1.0
19528,횟집/Noun,3,0,3,0.0,3.33207454961459e-05,1.0
19529,나가이/Noun,3,0,3,0.0,3.33207454961459e-05,1.0
19530,이소리/Noun,3,0,3,0.0,3.33207454961459e-05,1.0
19531,못생겻/Noun,3,0,3,0.0,3.33207454961459e-05,1.0
19532,베리드/Noun,3,0,3,0.0,3.33207454961459e-05,1.0
19533,포청천/Noun,3,0,3,0.0,3.33207454961459e-05,1.0
19534,쁘/Noun,3,3,0,3.3345930684925414e-05,0.0,1.0
19535,FF/Alpha,3,0,3,0.0,3.33207454961459e-05,1.0
19536,유후/Noun,3,3,0,3.3345930684925414e-05,0.0,1.0
19537,신입생/Noun,3,0,3,0.0,3.33207454961459e-05,1.0
19538,대폭발/Noun,3,0,3,0.0,3.33207454961459e-05,1.0
19539,...~/Punctuation,3,0,3,0.0,3.33207454961459e-05,1.0
19540,무혁/Noun,3,3,0,3.3345930684925414e-05,0.0,1.0
19541,콘티/Noun,3,0,3,0.0,3.33207454961459e-05,1.0
19542,-*/Punctuation,3,3,0,3.3345930684925414e-05,0.0,1.0
19543,대동단결/Noun,3,0,3,0.0,3.33207454961459e-05,1.0
19544,실타/Noun,3,0,3,0.0,3.33207454961459e-05,1.0
19545,흐믓해/Noun,3,3,0,3.3345930684925414e-05,0.0,1.0
19546,미칀/Noun,3,0,3,0.0,3.33207454961459e-05,1.0
19547,화형식/Noun,3,3,0,3.3345930684925414e-05,0.0,1.0
19548,레게/Noun,3,0,3,0.0,3.33207454961459e-05,1.0
19549,논점/Noun,3,0,3,0.0,3.33207454961459e-05,1.0
19550,세원/Noun,3,0,3,0.0,3.33207454961459e-05,1.0
19551,꽁꽁/Noun,3,0,3,0.0,3.33207454961459e-05,1.0
19552,열병/Noun,3,3,0,3.3345930684925414e-05,0.0,1.0
19553,한길/Noun,3,3,0,3.3345930684925414e-05,0.0,1.0
19554,wrong/Alpha,3,3,0,3.3345930684925414e-05,0.0,1.0
19555,영화리뷰/Noun,3,0,3,0.0,3.33207454961459e-05,1.0
19556,능글능글하다/Adjective,3,3,0,3.3345930684925414e-05,0.0,1.0
19557,갈림길/Noun,3,3,0,3.3345930684925414e-05,0.0,1.0
19558,독불장군/Noun,3,3,0,3.3345930684925414e-05,0.0,1.0
19559,가압/Noun,3,3,0,3.3345930684925414e-05,0.0,1.0
19560,본방송/Noun,3,0,3,0.0,3.33207454961459e-05,1.0
19561,동구/Noun,3,3,0,3.3345930684925414e-05,0.0,1.0
19562,동그랗다/Adjective,3,0,3,0.0,3.33207454961459e-05,1.0
19563,강화/Noun,3,3,0,3.3345930684925414e-05,0.0,1.0
19564,돈까스/Noun,3,0,3,0.0,3.33207454961459e-05,1.0
19565,심난하다/Adjective,3,0,3,0.0,3.33207454961459e-05,1.0
19566,앙증맞다/Adjective,3,3,0,3.3345930684925414e-05,0.0,1.0
19567,쿠시/Noun,3,3,0,3.3345930684925414e-05,0.0,1.0
19568,3.6/Number,3,0,3,0.0,3.33207454961459e-05,1.0
19569,컨벤션/Noun,3,0,3,0.0,3.33207454961459e-05,1.0
19570,카르페디엠/Noun,3,3,0,3.3345930684925414e-05,0.0,1.0
19571,에타/Noun,3,3,0,3.3345930684925414e-05,0.0,1.0
19572,길리엄/Noun,3,3,0,3.3345930684925414e-05,0.0,1.0
19573,앵앵대다/Verb,3,0,3,0.0,3.33207454961459e-05,1.0
19574,잠적/Noun,3,0,3,0.0,3.33207454961459e-05,1.0
19575,빵구/Noun,3,0,3,0.0,3.33207454961459e-05,1.0
19576,능멸/Noun,3,0,3,0.0,3.33207454961459e-05,1.0
19577,평양/Noun,3,3,0,3.3345930684925414e-05,0.0,1.0
19578,==/Punctuation,3,0,3,0.0,3.33207454961459e-05,1.0
19579,오합지졸/Noun,3,0,3,0.0,3.33207454961459e-05,1.0
19580,에스텔/Noun,3,0,3,0.0,3.33207454961459e-05,1.0
19581,사돈/Noun,3,0,3,0.0,3.33207454961459e-05,1.0
19582,플스/Noun,3,3,0,3.3345930684925414e-05,0.0,1.0
19583,shall/Alpha,3,3,0,3.3345930684925414e-05,0.0,1.0
19584,남남/Noun,3,0,3,0.0,3.33207454961459e-05,1.0
19585,어두컴컴하다/Adjective,3,3,0,3.3345930684925414e-05,0.0,1.0
19586,스산/Noun,3,3,0,3.3345930684925414e-05,0.0,1.0
19587,헨/Noun,3,3,0,3.3345930684925414e-05,0.0,1.0
19588,효녀/Noun,3,3,0,3.3345930684925414e-05,0.0,1.0
19589,조병/Noun,3,3,0,3.3345930684925414e-05,0.0,1.0
19590,*^/Punctuation,3,3,0,3.3345930684925414e-05,0.0,1.0
19591,2008/Number,3,3,0,3.3345930684925414e-05,0.0,1.0
19592,리얼리/Noun,3,3,0,3.3345930684925414e-05,0.0,1.0
19593,머릿/Noun,3,3,0,3.3345930684925414e-05,0.0,1.0
19594,짜개/Noun,3,3,0,3.3345930684925414e-05,0.0,1.0
19595,핍박/Noun,3,3,0,3.3345930684925414e-05,0.0,1.0
19596,세요/Eomi,3,0,3,0.0,3.33207454961459e-05,1.0
19597,디아블로/Noun,3,0,3,0.0,3.33207454961459e-05,1.0
19598,조센진/Noun,3,0,3,0.0,3.33207454961459e-05,1.0
19599,채찍/Noun,3,0,3,0.0,3.33207454961459e-05,1.0
19600,.*^^*/Punctuation,3,3,0,3.3345930684925414e-05,0.0,1.0
19601,호주머니/Noun,3,0,3,0.0,3.33207454961459e-05,1.0
19602,ㅎㅋ/KoreanParticle,3,3,0,3.3345930684925414e-05,0.0,1.0
19603,얼치기/Noun,3,0,3,0.0,3.33207454961459e-05,1.0
19604,박초롱/Noun,3,3,0,3.3345930684925414e-05,0.0,1.0
19605,lovely/Alpha,3,3,0,3.3345930684925414e-05,0.0,1.0
19606,0.01/Number,3,0,3,0.0,3.33207454961459e-05,1.0
19607,객실/Noun,3,0,3,0.0,3.33207454961459e-05,1.0
19608,무치/Noun,3,0,3,0.0,3.33207454961459e-05,1.0
19609,요지/Noun,3,0,3,0.0,3.33207454961459e-05,1.0
19610,원어민/Noun,3,3,0,3.3345930684925414e-05,0.0,1.0
19611,븅/Noun,3,0,3,0.0,3.33207454961459e-05,1.0
19612,:))/Punctuation,3,3,0,3.3345930684925414e-05,0.0,1.0
19613,이라도/Foreign,3,0,3,0.0,3.33207454961459e-05,1.0
19614,부처님/Noun,3,3,0,3.3345930684925414e-05,0.0,1.0
19615,도화지/Noun,3,3,0,3.3345930684925414e-05,0.0,1.0
19616,재생산/Noun,3,0,3,0.0,3.33207454961459e-05,1.0
19617,~~./Punctuation,3,3,0,3.3345930684925414e-05,0.0,1.0
19618,응축/Noun,3,3,0,3.3345930684925414e-05,0.0,1.0
19619,Amazing/Alpha,3,3,0,3.3345930684925414e-05,0.0,1.0
19620,뿌리치다/Verb,3,0,3,0.0,3.33207454961459e-05,1.0
19621,뱀파/Noun,3,0,3,0.0,3.33207454961459e-05,1.0
19622,내/VerbPrefix,3,3,0,3.3345930684925414e-05,0.0,1.0
19623,허슬/Noun,3,0,3,0.0,3.33207454961459e-05,1.0
19624,cry/Alpha,3,3,0,3.3345930684925414e-05,0.0,1.0
19625,윤곽/Noun,3,0,3,0.0,3.33207454961459e-05,1.0
19626,재밍/Noun,3,3,0,3.3345930684925414e-05,0.0,1.0
19627,혜성/Noun,3,3,0,3.3345930684925414e-05,0.0,1.0
19628,사사롭다/Adjective,3,3,0,3.3345930684925414e-05,0.0,1.0
19629,남태현/Noun,3,0,3,0.0,3.33207454961459e-05,1.0
19630,가리키다/Verb,3,3,0,3.3345930684925414e-05,0.0,1.0
19631,나랏돈/Noun,3,0,3,0.0,3.33207454961459e-05,1.0
19632,댄싱나인/Noun,3,0,3,0.0,3.33207454961459e-05,1.0
19633,지갠뎃/Noun,3,0,3,0.0,3.33207454961459e-05,1.0
19634,찬스/Noun,3,3,0,3.3345930684925414e-05,0.0,1.0
19635,최은/Noun,3,0,3,0.0,3.33207454961459e-05,1.0
19636,고명환/Noun,3,0,3,0.0,3.33207454961459e-05,1.0
19637,연속성/Noun,3,0,3,0.0,3.33207454961459e-05,1.0
19638,요부/Noun,3,0,3,0.0,3.33207454961459e-05,1.0
19639,중에/Foreign,3,0,3,0.0,3.33207454961459e-05,1.0
19640,시진/Noun,3,3,0,3.3345930684925414e-05,0.0,1.0
19641,"-.,-/Punctuation",3,0,3,0.0,3.33207454961459e-05,1.0
19642,태백산맥/Noun,3,0,3,0.0,3.33207454961459e-05,1.0
19643,아라시/Noun,3,3,0,3.3345930684925414e-05,0.0,1.0
19644,어쨌/Noun,3,0,3,0.0,3.33207454961459e-05,1.0
19645,얼개/Noun,3,0,3,0.0,3.33207454961459e-05,1.0
19646,쌩쑈/Noun,3,0,3,0.0,3.33207454961459e-05,1.0
19647,총장/Noun,3,3,0,3.3345930684925414e-05,0.0,1.0
19648,우웅/Exclamation,3,3,0,3.3345930684925414e-05,0.0,1.0
19649,자격증/Noun,3,0,3,0.0,3.33207454961459e-05,1.0
19650,동현/Noun,3,3,0,3.3345930684925414e-05,0.0,1.0
19651,식자/Noun,3,0,3,0.0,3.33207454961459e-05,1.0
19652,결혼식장/Noun,3,0,3,0.0,3.33207454961459e-05,1.0
19653,일별/Noun,3,0,3,0.0,3.33207454961459e-05,1.0
19654,66/Number,3,3,0,3.3345930684925414e-05,0.0,1.0
19655,Say/Alpha,3,3,0,3.3345930684925414e-05,0.0,1.0
19656,had/Alpha,3,3,0,3.3345930684925414e-05,0.0,1.0
19657,완구/Noun,3,0,3,0.0,3.33207454961459e-05,1.0
19658,마물/Noun,3,0,3,0.0,3.33207454961459e-05,1.0
19659,￣∇￣/Foreign,3,3,0,3.3345930684925414e-05,0.0,1.0
19660,튼실하다/Adjective,3,0,3,0.0,3.33207454961459e-05,1.0
19661,이윤기/Noun,3,3,0,3.3345930684925414e-05,0.0,1.0
19662,워프/Noun,3,0,3,0.0,3.33207454961459e-05,1.0
19663,쓴웃음/Noun,3,0,3,0.0,3.33207454961459e-05,1.0
19664,fighting/Alpha,3,3,0,3.3345930684925414e-05,0.0,1.0
19665,음부/Noun,3,3,0,3.3345930684925414e-05,0.0,1.0
19666,데이빗보위/Noun,3,3,0,3.3345930684925414e-05,0.0,1.0
19667,칸영화제/Noun,3,3,0,3.3345930684925414e-05,0.0,1.0
19668,옷차림/Noun,3,0,3,0.0,3.33207454961459e-05,1.0
19669,결의/Noun,3,3,0,3.3345930684925414e-05,0.0,1.0
19670,특별판/Noun,3,3,0,3.3345930684925414e-05,0.0,1.0
19671,건쥐/Noun,3,0,3,0.0,3.33207454961459e-05,1.0
19672,배심원/Noun,3,3,0,3.3345930684925414e-05,0.0,1.0
19673,간문제/Noun,3,0,3,0.0,3.33207454961459e-05,1.0
19674,군필/Noun,3,0,3,0.0,3.33207454961459e-05,1.0
19675,아둔하다/Adjective,3,0,3,0.0,3.33207454961459e-05,1.0
19676,행선/Noun,3,0,3,0.0,3.33207454961459e-05,1.0
19677,면제/Noun,3,0,3,0.0,3.33207454961459e-05,1.0
19678,목줄/Noun,3,0,3,0.0,3.33207454961459e-05,1.0
19679,무량/Noun,3,3,0,3.3345930684925414e-05,0.0,1.0
19680,성내다/Verb,3,0,3,0.0,3.33207454961459e-05,1.0
19681,후에도/Foreign,3,3,0,3.3345930684925414e-05,0.0,1.0
19682,환도/Noun,3,3,0,3.3345930684925414e-05,0.0,1.0
19683,두리반/Noun,3,3,0,3.3345930684925414e-05,0.0,1.0
19684,이만/Adverb,3,0,3,0.0,3.33207454961459e-05,1.0
19685,뭐좀/Noun,3,0,3,0.0,3.33207454961459e-05,1.0
19686,민수/Noun,3,0,3,0.0,3.33207454961459e-05,1.0
19687,키노/Noun,3,3,0,3.3345930684925414e-05,0.0,1.0
19688,gv/Alpha,3,3,0,3.3345930684925414e-05,0.0,1.0
19689,꽈/Noun,3,0,3,0.0,3.33207454961459e-05,1.0
19690,gp/Alpha,3,0,3,0.0,3.33207454961459e-05,1.0
19691,떼쓰다/Verb,3,0,3,0.0,3.33207454961459e-05,1.0
19692,93분/Number,3,0,3,0.0,3.33207454961459e-05,1.0
19693,개런티/Noun,3,0,3,0.0,3.33207454961459e-05,1.0
19694,말썽/Noun,3,3,0,3.3345930684925414e-05,0.0,1.0
19695,넌더리/Noun,3,0,3,0.0,3.33207454961459e-05,1.0
19696,웬일/Noun,3,0,3,0.0,3.33207454961459e-05,1.0
19697,그랫다/Noun,3,0,3,0.0,3.33207454961459e-05,1.0
19698,미르/Noun,3,3,0,3.3345930684925414e-05,0.0,1.0
19699,정성껏/Noun,3,3,0,3.3345930684925414e-05,0.0,1.0
19700,낚인듯/Noun,3,0,3,0.0,3.33207454961459e-05,1.0
19701,시누이/Noun,3,0,3,0.0,3.33207454961459e-05,1.0
19702,돈줄/Noun,3,0,3,0.0,3.33207454961459e-05,1.0
19703,짊어지/Noun,3,3,0,3.3345930684925414e-05,0.0,1.0
19704,이은우/Noun,3,3,0,3.3345930684925414e-05,0.0,1.0
19705,봄비/Noun,3,3,0,3.3345930684925414e-05,0.0,1.0
19706,인민재판/Noun,3,0,3,0.0,3.33207454961459e-05,1.0
19707,북경/Noun,3,3,0,3.3345930684925414e-05,0.0,1.0
19708,불만제로/Noun,3,0,3,0.0,3.33207454961459e-05,1.0
19709,물탄/Noun,3,0,3,0.0,3.33207454961459e-05,1.0
19710,....;;;;/Punctuation,3,0,3,0.0,3.33207454961459e-05,1.0
19711,잿빛/Noun,3,3,0,3.3345930684925414e-05,0.0,1.0
19712,김유신/Noun,3,0,3,0.0,3.33207454961459e-05,1.0
19713,자그마하다/Adjective,3,3,0,3.3345930684925414e-05,0.0,1.0
19714,텨/Noun,3,0,3,0.0,3.33207454961459e-05,1.0
19715,로마군/Noun,3,0,3,0.0,3.33207454961459e-05,1.0
19716,트레이드/Noun,3,0,3,0.0,3.33207454961459e-05,1.0
19717,DJ/Alpha,3,0,3,0.0,3.33207454961459e-05,1.0
19718,갸우뚱/Adverb,3,0,3,0.0,3.33207454961459e-05,1.0
19719,장임/Noun,3,0,3,0.0,3.33207454961459e-05,1.0
19720,평정하다/Adjective,3,3,0,3.3345930684925414e-05,0.0,1.0
19721,어쩌란거/Noun,3,0,3,0.0,3.33207454961459e-05,1.0
19722,요로/Noun,3,0,3,0.0,3.33207454961459e-05,1.0
19723,랜스/Noun,3,3,0,3.3345930684925414e-05,0.0,1.0
19724,특허/Noun,3,0,3,0.0,3.33207454961459e-05,1.0
19725,game/Alpha,3,3,0,3.3345930684925414e-05,0.0,1.0
19726,킹오브/Noun,3,0,3,0.0,3.33207454961459e-05,1.0
19727,스페이시/Noun,3,3,0,3.3345930684925414e-05,0.0,1.0
19728,글타/Noun,3,0,3,0.0,3.33207454961459e-05,1.0
19729,90회/Number,3,0,3,0.0,3.33207454961459e-05,1.0
19730,팩스/Noun,3,3,0,3.3345930684925414e-05,0.0,1.0
19731,반반하다/Adjective,3,0,3,0.0,3.33207454961459e-05,1.0
19732,최지연/Noun,3,0,3,0.0,3.33207454961459e-05,1.0
19733,삼합회/Noun,3,0,3,0.0,3.33207454961459e-05,1.0
19734,본론/Noun,3,0,3,0.0,3.33207454961459e-05,1.0
19735,올리브/Noun,3,3,0,3.3345930684925414e-05,0.0,1.0
19736,끌벅쩍/Noun,3,0,3,0.0,3.33207454961459e-05,1.0
19737,승복/Noun,3,0,3,0.0,3.33207454961459e-05,1.0
19738,깨금이/Noun,3,3,0,3.3345930684925414e-05,0.0,1.0
19739,고분/Noun,3,0,3,0.0,3.33207454961459e-05,1.0
19740,븜/Noun,3,0,3,0.0,3.33207454961459e-05,1.0
19741,개황/Noun,3,0,3,0.0,3.33207454961459e-05,1.0
19742,유별나다/Adjective,3,0,3,0.0,3.33207454961459e-05,1.0
19743,똘똘하/Noun,3,3,0,3.3345930684925414e-05,0.0,1.0
19744,OK/Alpha,3,0,3,0.0,3.33207454961459e-05,1.0
19745,모되/Noun,3,0,3,0.0,3.33207454961459e-05,1.0
19746,방탄/Noun,3,0,3,0.0,3.33207454961459e-05,1.0
19747,만리/Noun,3,0,3,0.0,3.33207454961459e-05,1.0
19748,클라크/Noun,3,3,0,3.3345930684925414e-05,0.0,1.0
19749,7천원/Number,3,0,3,0.0,3.33207454961459e-05,1.0
19750,반세기/Noun,3,3,0,3.3345930684925414e-05,0.0,1.0
19751,사원/Noun,3,3,0,3.3345930684925414e-05,0.0,1.0
19752,소울메이트/Noun,3,3,0,3.3345930684925414e-05,0.0,1.0
19753,썸씽/Noun,3,0,3,0.0,3.33207454961459e-05,1.0
19754,북쪽/Noun,3,3,0,3.3345930684925414e-05,0.0,1.0
19755,조짐/Noun,3,0,3,0.0,3.33207454961459e-05,1.0
19756,주스/Noun,3,0,3,0.0,3.33207454961459e-05,1.0
19757,폴뉴먼/Noun,3,3,0,3.3345930684925414e-05,0.0,1.0
19758,쿄애니/Noun,3,3,0,3.3345930684925414e-05,0.0,1.0
19759,저녁식사/Noun,3,3,0,3.3345930684925414e-05,0.0,1.0
19760,mm/Alpha,3,0,3,0.0,3.33207454961459e-05,1.0
19761,굿잼/Noun,3,3,0,3.3345930684925414e-05,0.0,1.0
19762,괜차늠/Noun,3,3,0,3.3345930684925414e-05,0.0,1.0
19763,묵고/Noun,3,0,3,0.0,3.33207454961459e-05,1.0
19764,지음/Noun,3,3,0,3.3345930684925414e-05,0.0,1.0
19765,음료수/Noun,3,0,3,0.0,3.33207454961459e-05,1.0
19766,절봉/Noun,3,3,0,3.3345930684925414e-05,0.0,1.0
19767,유연/Noun,3,3,0,3.3345930684925414e-05,0.0,1.0
19768,데체/Noun,3,0,3,0.0,3.33207454961459e-05,1.0
19769,티슈/Noun,3,3,0,3.3345930684925414e-05,0.0,1.0
19770,크보/Noun,3,3,0,3.3345930684925414e-05,0.0,1.0
19771,spin/Alpha,3,0,3,0.0,3.33207454961459e-05,1.0
19772,주먹밥/Noun,3,3,0,3.3345930684925414e-05,0.0,1.0
19773,자자하다/Adjective,3,0,3,0.0,3.33207454961459e-05,1.0
19774,1800원/Number,3,0,3,0.0,3.33207454961459e-05,1.0
19775,Worst/Alpha,3,0,3,0.0,3.33207454961459e-05,1.0
19776,방랑/Noun,3,3,0,3.3345930684925414e-05,0.0,1.0
19777,닥본사/Noun,3,3,0,3.3345930684925414e-05,0.0,1.0
19778,아메바/Noun,3,0,3,0.0,3.33207454961459e-05,1.0
19779,애달프다/Adjective,3,3,0,3.3345930684925414e-05,0.0,1.0
19780,드랍/Noun,3,0,3,0.0,3.33207454961459e-05,1.0
19781,마사토/Noun,3,3,0,3.3345930684925414e-05,0.0,1.0
19782,사카이/Noun,3,3,0,3.3345930684925414e-05,0.0,1.0
19783,유착/Noun,3,3,0,3.3345930684925414e-05,0.0,1.0
19784,흉측하다/Adjective,3,0,3,0.0,3.33207454961459e-05,1.0
19785,ㅠㅋ/KoreanParticle,3,3,0,3.3345930684925414e-05,0.0,1.0
19786,문메이슨/Noun,3,3,0,3.3345930684925414e-05,0.0,1.0
19787,?-/Punctuation,3,0,3,0.0,3.33207454961459e-05,1.0
19788,주절거리다/Verb,3,0,3,0.0,3.33207454961459e-05,1.0
19789,전영화라니/Foreign,3,3,0,3.3345930684925414e-05,0.0,1.0
19790,반비례/Noun,3,0,3,0.0,3.33207454961459e-05,1.0
19791,쯩/Noun,3,0,3,0.0,3.33207454961459e-05,1.0
19792,연구원/Noun,3,0,3,0.0,3.33207454961459e-05,1.0
19793,나인뮤지스/Noun,3,3,0,3.3345930684925414e-05,0.0,1.0
19794,질라/Noun,3,3,0,3.3345930684925414e-05,0.0,1.0
19795,리타/Noun,3,3,0,3.3345930684925414e-05,0.0,1.0
19796,임진/Noun,3,0,3,0.0,3.33207454961459e-05,1.0
19797,사병/Noun,3,0,3,0.0,3.33207454961459e-05,1.0
19798,위급하다/Adjective,3,0,3,0.0,3.33207454961459e-05,1.0
19799,스무/Noun,3,3,0,3.3345930684925414e-05,0.0,1.0
19800,부르주아/Noun,3,0,3,0.0,3.33207454961459e-05,1.0
19801,최종회/Noun,3,3,0,3.3345930684925414e-05,0.0,1.0
19802,가비지/Noun,3,0,3,0.0,3.33207454961459e-05,1.0
19803,부터도/Josa,3,3,0,3.3345930684925414e-05,0.0,1.0
19804,극악하다/Adjective,3,3,0,3.3345930684925414e-05,0.0,1.0
19805,미스테리물/Noun,3,3,0,3.3345930684925414e-05,0.0,1.0
19806,유인촌/Noun,3,0,3,0.0,3.33207454961459e-05,1.0
19807,법조인/Noun,3,3,0,3.3345930684925414e-05,0.0,1.0
19808,근절/Noun,3,0,3,0.0,3.33207454961459e-05,1.0
19809,빠담빠담/Noun,3,3,0,3.3345930684925414e-05,0.0,1.0
19810,오물/Noun,3,0,3,0.0,3.33207454961459e-05,1.0
19811,끌뻔/Noun,3,0,3,0.0,3.33207454961459e-05,1.0
19812,넼/Noun,3,0,3,0.0,3.33207454961459e-05,1.0
19813,꼬우/Noun,3,0,3,0.0,3.33207454961459e-05,1.0
19814,기호/Noun,3,3,0,3.3345930684925414e-05,0.0,1.0
19815,완벽주의자/Noun,3,3,0,3.3345930684925414e-05,0.0,1.0
19816,양현석/Noun,3,0,3,0.0,3.33207454961459e-05,1.0
19817,날조하다/Adjective,3,0,3,0.0,3.33207454961459e-05,1.0
19818,벡실/Noun,3,3,0,3.3345930684925414e-05,0.0,1.0
19819,..................................................../Punctuation,3,0,3,0.0,3.33207454961459e-05,1.0
19820,검둥이/Noun,3,0,3,0.0,3.33207454961459e-05,1.0
19821,또볼/Noun,3,3,0,3.3345930684925414e-05,0.0,1.0
19822,더원/Noun,3,3,0,3.3345930684925414e-05,0.0,1.0
19823,퐝당/Noun,3,0,3,0.0,3.33207454961459e-05,1.0
19824,자석/Noun,3,0,3,0.0,3.33207454961459e-05,1.0
19825,극심하다/Adjective,3,0,3,0.0,3.33207454961459e-05,1.0
19826,박지르다/Verb,3,0,3,0.0,3.33207454961459e-05,1.0
19827,1700만/Number,3,0,3,0.0,3.33207454961459e-05,1.0
19828,표절의혹/Noun,3,0,3,0.0,3.33207454961459e-05,1.0
19829,알콜중독자/Noun,3,3,0,3.3345930684925414e-05,0.0,1.0
19830,눈사람/Noun,3,3,0,3.3345930684925414e-05,0.0,1.0
19831,덕심/Noun,3,3,0,3.3345930684925414e-05,0.0,1.0
19832,꼽겠다/Noun,3,3,0,3.3345930684925414e-05,0.0,1.0
19833,다면/Eomi,3,3,0,3.3345930684925414e-05,0.0,1.0
19834,벼슬/Noun,3,0,3,0.0,3.33207454961459e-05,1.0
19835,풍덩/Adverb,3,3,0,3.3345930684925414e-05,0.0,1.0
19836,폐차/Noun,3,0,3,0.0,3.33207454961459e-05,1.0
19837,전라디언/Noun,3,0,3,0.0,3.33207454961459e-05,1.0
19838,사이좋다/Adjective,3,0,3,0.0,3.33207454961459e-05,1.0
19839,PM/Alpha,3,3,0,3.3345930684925414e-05,0.0,1.0
19840,허지만/Noun,3,0,3,0.0,3.33207454961459e-05,1.0
19841,진가신/Noun,3,3,0,3.3345930684925414e-05,0.0,1.0
19842,거유/Noun,3,0,3,0.0,3.33207454961459e-05,1.0
19843,카악/Adverb,3,0,3,0.0,3.33207454961459e-05,1.0
19844,우체통/Noun,3,0,3,0.0,3.33207454961459e-05,1.0
19845,더줌/Noun,3,0,3,0.0,3.33207454961459e-05,1.0
19846,광끼/Noun,3,3,0,3.3345930684925414e-05,0.0,1.0
19847,천진/Noun,3,3,0,3.3345930684925414e-05,0.0,1.0
19848,bored/Alpha,3,0,3,0.0,3.33207454961459e-05,1.0
19849,후쿠야마/Noun,3,3,0,3.3345930684925414e-05,0.0,1.0
19850,라흐마니노프/Noun,3,3,0,3.3345930684925414e-05,0.0,1.0
19851,노숙/Noun,3,0,3,0.0,3.33207454961459e-05,1.0
19852,브라자/Noun,3,0,3,0.0,3.33207454961459e-05,1.0
19853,찔금/Adverb,3,3,0,3.3345930684925414e-05,0.0,1.0
19854,라이스/Noun,3,0,3,0.0,3.33207454961459e-05,1.0
19855,오카/Noun,3,0,3,0.0,3.33207454961459e-05,1.0
19856,이하임/Noun,3,0,3,0.0,3.33207454961459e-05,1.0
19857,개털/Noun,3,0,3,0.0,3.33207454961459e-05,1.0
19858,아코디언/Noun,3,3,0,3.3345930684925414e-05,0.0,1.0
19859,포장마차/Noun,3,0,3,0.0,3.33207454961459e-05,1.0
19860,환자연기/Noun,3,3,0,3.3345930684925414e-05,0.0,1.0
19861,자비롭다/Adjective,3,0,3,0.0,3.33207454961459e-05,1.0
19862,강서현/Noun,3,0,3,0.0,3.33207454961459e-05,1.0
19863,뤠/Noun,3,0,3,0.0,3.33207454961459e-05,1.0
19864,매칭/Noun,3,0,3,0.0,3.33207454961459e-05,1.0
19865,신주아/Noun,3,0,3,0.0,3.33207454961459e-05,1.0
19866,..^^*/Punctuation,3,3,0,3.3345930684925414e-05,0.0,1.0
19867,히든/Noun,3,0,3,0.0,3.33207454961459e-05,1.0
19868,괭장히/Noun,3,3,0,3.3345930684925414e-05,0.0,1.0
19869,쯧쯔/Noun,3,0,3,0.0,3.33207454961459e-05,1.0
19870,기품/Noun,3,3,0,3.3345930684925414e-05,0.0,1.0
19871,진드기/Noun,3,0,3,0.0,3.33207454961459e-05,1.0
19872,옵션/Noun,3,0,3,0.0,3.33207454961459e-05,1.0
19873,선영/Noun,3,3,0,3.3345930684925414e-05,0.0,1.0
19874,룸싸롱/Noun,3,0,3,0.0,3.33207454961459e-05,1.0
19875,WOW/Alpha,3,3,0,3.3345930684925414e-05,0.0,1.0
19876,열거/Noun,3,0,3,0.0,3.33207454961459e-05,1.0
19877,그랑블루/Noun,3,3,0,3.3345930684925414e-05,0.0,1.0
19878,기사단/Noun,3,0,3,0.0,3.33207454961459e-05,1.0
19879,우사/Noun,3,3,0,3.3345930684925414e-05,0.0,1.0
19880,↗/Foreign,3,3,0,3.3345930684925414e-05,0.0,1.0
19881,더냐/Noun,3,0,3,0.0,3.33207454961459e-05,1.0
19882,반미영/Noun,3,0,3,0.0,3.33207454961459e-05,1.0
19883,화근/Noun,3,0,3,0.0,3.33207454961459e-05,1.0
19884,탄창/Noun,3,0,3,0.0,3.33207454961459e-05,1.0
19885,후드/Noun,3,3,0,3.3345930684925414e-05,0.0,1.0
19886,애덤스/Noun,3,3,0,3.3345930684925414e-05,0.0,1.0
19887,뒷담화/Noun,3,0,3,0.0,3.33207454961459e-05,1.0
19888,필승/Noun,3,3,0,3.3345930684925414e-05,0.0,1.0
19889,모작/Noun,3,0,3,0.0,3.33207454961459e-05,1.0
19890,!!!.../Punctuation,3,3,0,3.3345930684925414e-05,0.0,1.0
19891,모함/Noun,3,0,3,0.0,3.33207454961459e-05,1.0
19892,리볼버/Noun,3,0,3,0.0,3.33207454961459e-05,1.0
19893,찬옥/Noun,3,3,0,3.3345930684925414e-05,0.0,1.0
19894,뢰/Noun,3,3,0,3.3345930684925414e-05,0.0,1.0
19895,"...,./Punctuation",3,0,3,0.0,3.33207454961459e-05,1.0
19896,공갈/Noun,3,0,3,0.0,3.33207454961459e-05,1.0
19897,공찬/Noun,3,3,0,3.3345930684925414e-05,0.0,1.0
19898,송능/Noun,3,3,0,3.3345930684925414e-05,0.0,1.0
19899,친정엄마/Noun,3,0,3,0.0,3.33207454961459e-05,1.0
19900,공갈빵/Noun,3,0,3,0.0,3.33207454961459e-05,1.0
19901,핵꿀/Noun,3,3,0,3.3345930684925414e-05,0.0,1.0
19902,한진/Noun,3,0,3,0.0,3.33207454961459e-05,1.0
19903,포가튼/Noun,3,0,3,0.0,3.33207454961459e-05,1.0
19904,으로부터의/Josa,3,3,0,3.3345930684925414e-05,0.0,1.0
19905,동창생/Noun,3,0,3,0.0,3.33207454961459e-05,1.0
19906,시정/Noun,3,0,3,0.0,3.33207454961459e-05,1.0
19907,의처증/Noun,3,0,3,0.0,3.33207454961459e-05,1.0
19908,궁디/Noun,3,0,3,0.0,3.33207454961459e-05,1.0
19909,단란/Noun,3,3,0,3.3345930684925414e-05,0.0,1.0
19910,탈탈/Adverb,3,0,3,0.0,3.33207454961459e-05,1.0
19911,또왜/Noun,3,0,3,0.0,3.33207454961459e-05,1.0
19912,제어/Noun,3,3,0,3.3345930684925414e-05,0.0,1.0
19913,。。/Foreign,3,3,0,3.3345930684925414e-05,0.0,1.0
19914,병과/Noun,3,0,3,0.0,3.33207454961459e-05,1.0
19915,몆번/Noun,3,3,0,3.3345930684925414e-05,0.0,1.0
19916,니코니코니/Noun,3,3,0,3.3345930684925414e-05,0.0,1.0
19917,Film/Alpha,3,0,3,0.0,3.33207454961459e-05,1.0
19918,지엔/Noun,3,3,0,3.3345930684925414e-05,0.0,1.0
19919,정소영/Noun,3,0,3,0.0,3.33207454961459e-05,1.0
19920,증권/Noun,3,3,0,3.3345930684925414e-05,0.0,1.0
19921,Park/Alpha,3,3,0,3.3345930684925414e-05,0.0,1.0
19922,쿨럭/Adverb,3,3,0,3.3345930684925414e-05,0.0,1.0
19923,1930년/Number,3,0,3,0.0,3.33207454961459e-05,1.0
19924,nc/Alpha,3,0,3,0.0,3.33207454961459e-05,1.0
19925,자스민/Noun,3,3,0,3.3345930684925414e-05,0.0,1.0
19926,흐엉/Noun,3,3,0,3.3345930684925414e-05,0.0,1.0
19927,혜정/Noun,3,0,3,0.0,3.33207454961459e-05,1.0
19928,함대/Noun,3,0,3,0.0,3.33207454961459e-05,1.0
19929,IP/Alpha,3,0,3,0.0,3.33207454961459e-05,1.0
19930,만듭/Noun,3,0,3,0.0,3.33207454961459e-05,1.0
19931,모네/Noun,3,3,0,3.3345930684925414e-05,0.0,1.0
19932,벙하다/Adjective,3,0,3,0.0,3.33207454961459e-05,1.0
19933,BOB/Alpha,3,3,0,3.3345930684925414e-05,0.0,1.0
19934,바랬어/Noun,3,3,0,3.3345930684925414e-05,0.0,1.0
19935,몬트리올/Noun,3,3,0,3.3345930684925414e-05,0.0,1.0
19936,머큐리/Noun,3,3,0,3.3345930684925414e-05,0.0,1.0
19937,나뮤/Noun,3,3,0,3.3345930684925414e-05,0.0,1.0
19938,발등/Noun,3,0,3,0.0,3.33207454961459e-05,1.0
19939,밤일/Noun,3,0,3,0.0,3.33207454961459e-05,1.0
19940,건개/Noun,3,0,3,0.0,3.33207454961459e-05,1.0
19941,~~../Punctuation,3,3,0,3.3345930684925414e-05,0.0,1.0
19942,박상면/Noun,3,0,3,0.0,3.33207454961459e-05,1.0
19943,천진하다/Adjective,3,3,0,3.3345930684925414e-05,0.0,1.0
19944,걸핏하면/Noun,3,0,3,0.0,3.33207454961459e-05,1.0
19945,우쭈쭈/Noun,3,0,3,0.0,3.33207454961459e-05,1.0
19946,^^~*/Punctuation,3,3,0,3.3345930684925414e-05,0.0,1.0
19947,^.~/Punctuation,3,3,0,3.3345930684925414e-05,0.0,1.0
19948,103분/Number,3,0,3,0.0,3.33207454961459e-05,1.0
19949,going/Alpha,3,3,0,3.3345930684925414e-05,0.0,1.0
19950,아쿠아리움/Noun,3,3,0,3.3345930684925414e-05,0.0,1.0
19951,와즈다/Noun,3,3,0,3.3345930684925414e-05,0.0,1.0
19952,war/Alpha,3,0,3,0.0,3.33207454961459e-05,1.0
19953,연루/Noun,3,0,3,0.0,3.33207454961459e-05,1.0
19954,네오나치/Noun,3,3,0,3.3345930684925414e-05,0.0,1.0
19955,불합격/Noun,3,0,3,0.0,3.33207454961459e-05,1.0
19956,방글라데시/Noun,3,0,3,0.0,3.33207454961459e-05,1.0
19957,~!~/Punctuation,3,3,0,3.3345930684925414e-05,0.0,1.0
19958,윤정희/Noun,3,3,0,3.3345930684925414e-05,0.0,1.0
19959,춘향뎐/Noun,3,0,3,0.0,3.33207454961459e-05,1.0
19960,무현/Noun,3,0,3,0.0,3.33207454961459e-05,1.0
19961,미비하다/Adjective,3,0,3,0.0,3.33207454961459e-05,1.0
19962,극상/Noun,3,0,3,0.0,3.33207454961459e-05,1.0
19963,이하이/Noun,3,0,3,0.0,3.33207454961459e-05,1.0
19964,패리/Noun,3,0,3,0.0,3.33207454961459e-05,1.0
19965,김은형/Noun,3,3,0,3.3345930684925414e-05,0.0,1.0
19966,어쩌지/Adverb,3,0,3,0.0,3.33207454961459e-05,1.0
19967,생활비/Noun,3,0,3,0.0,3.33207454961459e-05,1.0
19968,에이타/Noun,3,3,0,3.3345930684925414e-05,0.0,1.0
19969,퍼줘/Noun,3,0,3,0.0,3.33207454961459e-05,1.0
19970,9876543210/Number,3,3,0,3.3345930684925414e-05,0.0,1.0
19971,성조기/Noun,3,0,3,0.0,3.33207454961459e-05,1.0
19972,은행나무/Noun,3,0,3,0.0,3.33207454961459e-05,1.0
19973,춘추전국시대/Noun,3,3,0,3.3345930684925414e-05,0.0,1.0
19974,68/Number,3,3,0,3.3345930684925414e-05,0.0,1.0
19975,거외/Noun,3,0,3,0.0,3.33207454961459e-05,1.0
19976,케케묵/Noun,3,0,3,0.0,3.33207454961459e-05,1.0
19977,효시/Noun,3,3,0,3.3345930684925414e-05,0.0,1.0
19978,썸녀/Noun,3,0,3,0.0,3.33207454961459e-05,1.0
19979,오덕후/Noun,3,3,0,3.3345930684925414e-05,0.0,1.0
19980,수행평가/Noun,3,0,3,0.0,3.33207454961459e-05,1.0
19981,숙식/Noun,3,0,3,0.0,3.33207454961459e-05,1.0
19982,worst/Alpha,3,0,3,0.0,3.33207454961459e-05,1.0
19983,사랑과영혼/Noun,3,0,3,0.0,3.33207454961459e-05,1.0
19984,될런/Noun,3,0,3,0.0,3.33207454961459e-05,1.0
19985,하오/Eomi,3,3,0,3.3345930684925414e-05,0.0,1.0
19986,의방/Noun,3,0,3,0.0,3.33207454961459e-05,1.0
19987,전대/Noun,3,3,0,3.3345930684925414e-05,0.0,1.0
19988,종신형/Noun,3,3,0,3.3345930684925414e-05,0.0,1.0
19989,투리/Noun,3,0,3,0.0,3.33207454961459e-05,1.0
19990,톤즈/Noun,3,3,0,3.3345930684925414e-05,0.0,1.0
19991,타운/Noun,3,0,3,0.0,3.33207454961459e-05,1.0
19992,유약/Noun,3,3,0,3.3345930684925414e-05,0.0,1.0
19993,번지르르/Noun,3,0,3,0.0,3.33207454961459e-05,1.0
19994,속수무책/Noun,3,0,3,0.0,3.33207454961459e-05,1.0
19995,눈밑/Noun,3,0,3,0.0,3.33207454961459e-05,1.0
19996,꼴사납다/Adjective,3,0,3,0.0,3.33207454961459e-05,1.0
19997,영선/Noun,3,3,0,3.3345930684925414e-05,0.0,1.0
19998,아멜리아/Noun,3,3,0,3.3345930684925414e-05,0.0,1.0
19999,명정/Noun,3,0,3,0.0,3.33207454961459e-05,1.0
20000,청설/Noun,3,3,0,3.3345930684925414e-05,0.0,1.0
20001,조민아/Noun,3,0,3,0.0,3.33207454961459e-05,1.0
20002,생크림/Noun,3,0,3,0.0,3.33207454961459e-05,1.0
20003,제빵/Noun,3,0,3,0.0,3.33207454961459e-05,1.0
20004,어무이/Noun,3,3,0,3.3345930684925414e-05,0.0,1.0
20005,지부리/Noun,3,0,3,0.0,3.33207454961459e-05,1.0
20006,ㅡㅠ/KoreanParticle,3,0,3,0.0,3.33207454961459e-05,1.0
20007,카레이서/Noun,3,0,3,0.0,3.33207454961459e-05,1.0
20008,이태백/Noun,3,3,0,3.3345930684925414e-05,0.0,1.0
20009,1975년/Number,3,3,0,3.3345930684925414e-05,0.0,1.0
20010,후훗/Noun,3,3,0,3.3345930684925414e-05,0.0,1.0
20011,....................................................../Punctuation,3,0,3,0.0,3.33207454961459e-05,1.0
20012,매스/Noun,3,3,0,3.3345930684925414e-05,0.0,1.0
20013,프리허그/Noun,3,0,3,0.0,3.33207454961459e-05,1.0
20014,아치로/Noun,3,0,3,0.0,3.33207454961459e-05,1.0
20015,방위/Noun,3,0,3,0.0,3.33207454961459e-05,1.0
20016,..^/Punctuation,3,3,0,3.3345930684925414e-05,0.0,1.0
20017,즈/Noun,3,3,0,3.3345930684925414e-05,0.0,1.0
20018,복권/Noun,3,0,3,0.0,3.33207454961459e-05,1.0
20019,ㅂㄹ/KoreanParticle,3,0,3,0.0,3.33207454961459e-05,1.0
20020,쒸레/Noun,3,0,3,0.0,3.33207454961459e-05,1.0
20021,데미지/Noun,3,0,3,0.0,3.33207454961459e-05,1.0
20022,신빙/Noun,3,0,3,0.0,3.33207454961459e-05,1.0
20023,백도/Noun,3,0,3,0.0,3.33207454961459e-05,1.0
20024,RIP/Alpha,3,3,0,3.3345930684925414e-05,0.0,1.0
20025,강성민/Noun,3,3,0,3.3345930684925414e-05,0.0,1.0
20026,잭맨/Noun,3,3,0,3.3345930684925414e-05,0.0,1.0
20027,죽빵/Noun,3,0,3,0.0,3.33207454961459e-05,1.0
20028,띵똥/Noun,3,3,0,3.3345930684925414e-05,0.0,1.0
20029,안병기/Noun,3,0,3,0.0,3.33207454961459e-05,1.0
20030,운빨/Noun,3,0,3,0.0,3.33207454961459e-05,1.0
20031,발라드/Noun,3,3,0,3.3345930684925414e-05,0.0,1.0
20032,생물체/Noun,3,0,3,0.0,3.33207454961459e-05,1.0
20033,고등어/Noun,3,0,3,0.0,3.33207454961459e-05,1.0
20034,굴려/Noun,3,0,3,0.0,3.33207454961459e-05,1.0
20035,트래비스/Noun,3,3,0,3.3345930684925414e-05,0.0,1.0
20036,병림픽/Noun,3,0,3,0.0,3.33207454961459e-05,1.0
20037,초대장/Noun,3,0,3,0.0,3.33207454961459e-05,1.0
20038,요딴/Modifier,3,0,3,0.0,3.33207454961459e-05,1.0
20039,채택/Noun,3,0,3,0.0,3.33207454961459e-05,1.0
20040,아이칼리/Noun,3,3,0,3.3345930684925414e-05,0.0,1.0
20041,해태/Noun,3,3,0,3.3345930684925414e-05,0.0,1.0
20042,비투스/Noun,3,3,0,3.3345930684925414e-05,0.0,1.0
20043,방공/Noun,3,0,3,0.0,3.33207454961459e-05,1.0
20044,안드레아/Noun,3,3,0,3.3345930684925414e-05,0.0,1.0
20045,버즈/Noun,3,3,0,3.3345930684925414e-05,0.0,1.0
20046,알츠하이머/Noun,3,3,0,3.3345930684925414e-05,0.0,1.0
20047,호남/Noun,3,0,3,0.0,3.33207454961459e-05,1.0
20048,밨던/Noun,3,3,0,3.3345930684925414e-05,0.0,1.0
20049,학부/Noun,3,0,3,0.0,3.33207454961459e-05,1.0
20050,걸리버/Noun,3,0,3,0.0,3.33207454961459e-05,1.0
20051,태익/Noun,3,3,0,3.3345930684925414e-05,0.0,1.0
20052,아우슈비츠/Noun,3,3,0,3.3345930684925414e-05,0.0,1.0
20053,음흉하다/Adjective,3,0,3,0.0,3.33207454961459e-05,1.0
20054,킁킁/Adverb,3,0,3,0.0,3.33207454961459e-05,1.0
20055,다웠다/Noun,3,0,3,0.0,3.33207454961459e-05,1.0
20056,뽀뽀뽀/Noun,3,0,3,0.0,3.33207454961459e-05,1.0
20057,최오/Noun,3,3,0,3.3345930684925414e-05,0.0,1.0
20058,연예가중계/Noun,3,0,3,0.0,3.33207454961459e-05,1.0
20059,어쨌건/Adverb,3,0,3,0.0,3.33207454961459e-05,1.0
20060,만쉐이/Noun,3,3,0,3.3345930684925414e-05,0.0,1.0
20061,디스크/Noun,3,0,3,0.0,3.33207454961459e-05,1.0
20062,why/Alpha,3,3,0,3.3345930684925414e-05,0.0,1.0
20063,3.3/Number,3,0,3,0.0,3.33207454961459e-05,1.0
20064,스르르/Noun,3,3,0,3.3345930684925414e-05,0.0,1.0
20065,직감/Noun,3,0,3,0.0,3.33207454961459e-05,1.0
20066,턱턱/Noun,3,3,0,3.3345930684925414e-05,0.0,1.0
20067,성남/Noun,3,3,0,3.3345930684925414e-05,0.0,1.0
20068,아련아련/Noun,3,3,0,3.3345930684925414e-05,0.0,1.0
20069,>?/Punctuation,3,0,3,0.0,3.33207454961459e-05,1.0
20070,62년/Number,3,3,0,3.3345930684925414e-05,0.0,1.0
20071,몽크/Noun,3,3,0,3.3345930684925414e-05,0.0,1.0
20072,세드/Noun,3,3,0,3.3345930684925414e-05,0.0,1.0
20073,수도원/Noun,3,3,0,3.3345930684925414e-05,0.0,1.0
20074,병역/Noun,3,0,3,0.0,3.33207454961459e-05,1.0
20075,칙칙/Adverb,3,3,0,3.3345930684925414e-05,0.0,1.0
20076,희망버스/Noun,3,0,3,0.0,3.33207454961459e-05,1.0
20077,두드러지다/Adjective,3,0,3,0.0,3.33207454961459e-05,1.0
20078,쩌내/Noun,3,3,0,3.3345930684925414e-05,0.0,1.0
20079,방임/Noun,3,0,3,0.0,3.33207454961459e-05,1.0
20080,카니발/Noun,3,3,0,3.3345930684925414e-05,0.0,1.0
20081,급성/Noun,3,0,3,0.0,3.33207454961459e-05,1.0
20082,건성/Noun,3,0,3,0.0,3.33207454961459e-05,1.0
20083,whole/Alpha,3,3,0,3.3345930684925414e-05,0.0,1.0
20084,6~70년/Number,3,0,3,0.0,3.33207454961459e-05,1.0
20085,관문/Noun,3,3,0,3.3345930684925414e-05,0.0,1.0
20086,민혁/Noun,3,3,0,3.3345930684925414e-05,0.0,1.0
20087,김진명/Noun,3,0,3,0.0,3.33207454961459e-05,1.0
20088,김태용/Noun,3,3,0,3.3345930684925414e-05,0.0,1.0
20089,동수/Noun,3,3,0,3.3345930684925414e-05,0.0,1.0
20090,땜빵/Noun,3,0,3,0.0,3.33207454961459e-05,1.0
20091,폐륜/Noun,3,0,3,0.0,3.33207454961459e-05,1.0
20092,격파/Noun,3,0,3,0.0,3.33207454961459e-05,1.0
20093,천수/Noun,3,3,0,3.3345930684925414e-05,0.0,1.0
20094,이태/Noun,3,3,0,3.3345930684925414e-05,0.0,1.0
20095,에드가/Noun,3,3,0,3.3345930684925414e-05,0.0,1.0
20096,맹수/Noun,3,3,0,3.3345930684925414e-05,0.0,1.0
20097,퍼시픽/Noun,3,3,0,3.3345930684925414e-05,0.0,1.0
20098,밑밑/Noun,3,0,3,0.0,3.33207454961459e-05,1.0
20099,됴/Noun,3,3,0,3.3345930684925414e-05,0.0,1.0
20100,전념/Noun,3,0,3,0.0,3.33207454961459e-05,1.0
20101,양도/Noun,3,0,3,0.0,3.33207454961459e-05,1.0
20102,꼬띠아르/Noun,3,3,0,3.3345930684925414e-05,0.0,1.0
20103,성서/Noun,3,3,0,3.3345930684925414e-05,0.0,1.0
20104,급보/Noun,3,0,3,0.0,3.33207454961459e-05,1.0
20105,이즈미/Noun,3,0,3,0.0,3.33207454961459e-05,1.0
20106,시래기/Noun,3,0,3,0.0,3.33207454961459e-05,1.0
20107,쭝/Noun,3,0,3,0.0,3.33207454961459e-05,1.0
20108,볼껀/Noun,3,0,3,0.0,3.33207454961459e-05,1.0
20109,뿜음/Noun,3,0,3,0.0,3.33207454961459e-05,1.0
20110,병태/Noun,3,3,0,3.3345930684925414e-05,0.0,1.0
20111,엄석대/Noun,3,3,0,3.3345930684925414e-05,0.0,1.0
20112,원시/Noun,3,3,0,3.3345930684925414e-05,0.0,1.0
20113,꼬았으/Noun,3,0,3,0.0,3.33207454961459e-05,1.0
20114,세탁기/Noun,3,3,0,3.3345930684925414e-05,0.0,1.0
20115,이상보/Noun,3,0,3,0.0,3.33207454961459e-05,1.0
20116,전인데/Foreign,3,3,0,3.3345930684925414e-05,0.0,1.0
20117,어영부영/Adverb,3,0,3,0.0,3.33207454961459e-05,1.0
20118,애청/Noun,3,3,0,3.3345930684925414e-05,0.0,1.0
20119,빈스본/Noun,3,3,0,3.3345930684925414e-05,0.0,1.0
20120,당체/Noun,3,0,3,0.0,3.33207454961459e-05,1.0
20121,대수준/Foreign,3,0,3,0.0,3.33207454961459e-05,1.0
20122,약주/Noun,3,0,3,0.0,3.33207454961459e-05,1.0
20123,텅텅빈/Noun,3,0,3,0.0,3.33207454961459e-05,1.0
20124,재개발/Noun,3,3,0,3.3345930684925414e-05,0.0,1.0
20125,친구사이/Noun,3,3,0,3.3345930684925414e-05,0.0,1.0
20126,gooood/Alpha,3,3,0,3.3345930684925414e-05,0.0,1.0
20127,비원에이포/Noun,3,3,0,3.3345930684925414e-05,0.0,1.0
20128,카이스트/Noun,3,3,0,3.3345930684925414e-05,0.0,1.0
20129,뚝방/Noun,3,0,3,0.0,3.33207454961459e-05,1.0
20130,개낚임/Noun,3,0,3,0.0,3.33207454961459e-05,1.0
20131,김호진/Noun,3,0,3,0.0,3.33207454961459e-05,1.0
20132,대디/Noun,3,0,3,0.0,3.33207454961459e-05,1.0
20133,벌금/Noun,3,0,3,0.0,3.33207454961459e-05,1.0
20134,육남매/Noun,3,3,0,3.3345930684925414e-05,0.0,1.0
20135,여의사/Noun,3,0,3,0.0,3.33207454961459e-05,1.0
20136,장현성/Noun,3,3,0,3.3345930684925414e-05,0.0,1.0
20137,화목/Noun,3,3,0,3.3345930684925414e-05,0.0,1.0
20138,낮짝/Noun,3,0,3,0.0,3.33207454961459e-05,1.0
20139,김승호/Noun,3,3,0,3.3345930684925414e-05,0.0,1.0
20140,메스꺼움/Noun,3,0,3,0.0,3.33207454961459e-05,1.0
20141,일초/Noun,3,3,0,3.3345930684925414e-05,0.0,1.0
20142,칼침/Noun,3,0,3,0.0,3.33207454961459e-05,1.0
20143,중공/Noun,3,0,3,0.0,3.33207454961459e-05,1.0
20144,ㅣㅆ/KoreanParticle,3,3,0,3.3345930684925414e-05,0.0,1.0
20145,범죄소년/Noun,3,3,0,3.3345930684925414e-05,0.0,1.0
20146,꼴불견/Noun,3,0,3,0.0,3.33207454961459e-05,1.0
20147,날씬하다/Adjective,3,0,3,0.0,3.33207454961459e-05,1.0
20148,귀향/Noun,3,0,3,0.0,3.33207454961459e-05,1.0
20149,갈라/Noun,3,3,0,3.3345930684925414e-05,0.0,1.0
20150,약혼녀/Noun,3,0,3,0.0,3.33207454961459e-05,1.0
20151,화인/Noun,3,0,3,0.0,3.33207454961459e-05,1.0
20152,재맛/Noun,3,3,0,3.3345930684925414e-05,0.0,1.0
20153,니콜라스홀트/Noun,3,3,0,3.3345930684925414e-05,0.0,1.0
20154,울상/Noun,3,0,3,0.0,3.33207454961459e-05,1.0
20155,홧김/Noun,3,0,3,0.0,3.33207454961459e-05,1.0
20156,쉬쉬/Adverb,3,0,3,0.0,3.33207454961459e-05,1.0
20157,논쟁/Noun,3,0,3,0.0,3.33207454961459e-05,1.0
20158,망햇음/Noun,3,0,3,0.0,3.33207454961459e-05,1.0
20159,정초신/Noun,3,0,3,0.0,3.33207454961459e-05,1.0
20160,븐/Noun,3,0,3,0.0,3.33207454961459e-05,1.0
20161,느낌표/Noun,3,3,0,3.3345930684925414e-05,0.0,1.0
20162,주해/Noun,3,0,3,0.0,3.33207454961459e-05,1.0
20163,대로/Foreign,3,0,3,0.0,3.33207454961459e-05,1.0
20164,악담/Noun,3,3,0,3.3345930684925414e-05,0.0,1.0
20165,만가/Noun,3,0,3,0.0,3.33207454961459e-05,1.0
20166,ㅆㅏ/KoreanParticle,3,0,3,0.0,3.33207454961459e-05,1.0
20167,으잌/Noun,3,0,3,0.0,3.33207454961459e-05,1.0
20168,흥국/Noun,3,3,0,3.3345930684925414e-05,0.0,1.0
20169,악뮤/Noun,3,0,3,0.0,3.33207454961459e-05,1.0
20170,신속하다/Adjective,3,0,3,0.0,3.33207454961459e-05,1.0
20171,오십/Modifier,3,0,3,0.0,3.33207454961459e-05,1.0
20172,..^-^/Punctuation,3,3,0,3.3345930684925414e-05,0.0,1.0
20173,메뉴/Noun,3,0,3,0.0,3.33207454961459e-05,1.0
20174,앤젤/Noun,3,3,0,3.3345930684925414e-05,0.0,1.0
20175,유리가면/Noun,3,0,3,0.0,3.33207454961459e-05,1.0
20176,화장품/Noun,3,3,0,3.3345930684925414e-05,0.0,1.0
20177,누벨바그/Noun,3,3,0,3.3345930684925414e-05,0.0,1.0
20178,영화평론/Noun,3,3,0,3.3345930684925414e-05,0.0,1.0
20179,골초/Noun,3,0,3,0.0,3.33207454961459e-05,1.0
20180,drama/Alpha,3,3,0,3.3345930684925414e-05,0.0,1.0
20181,지근/Noun,3,0,3,0.0,3.33207454961459e-05,1.0
20182,뉘우침/Noun,3,0,3,0.0,3.33207454961459e-05,1.0
20183,350/Number,3,0,3,0.0,3.33207454961459e-05,1.0
20184,외교부/Noun,3,3,0,3.3345930684925414e-05,0.0,1.0
20185,여도/Eomi,3,0,3,0.0,3.33207454961459e-05,1.0
20186,여당/Noun,3,3,0,3.3345930684925414e-05,0.0,1.0
20187,솔트/Noun,3,0,3,0.0,3.33207454961459e-05,1.0
20188,든든하다/Adjective,3,3,0,3.3345930684925414e-05,0.0,1.0
20189,말론브란도/Noun,3,3,0,3.3345930684925414e-05,0.0,1.0
20190,허둥대다/Verb,3,0,3,0.0,3.33207454961459e-05,1.0
20191,에듬/Foreign,3,3,0,3.3345930684925414e-05,0.0,1.0
20192,뿅뿅/Adverb,3,3,0,3.3345930684925414e-05,0.0,1.0
20193,허가/Noun,3,0,3,0.0,3.33207454961459e-05,1.0
20194,간담/Noun,3,0,3,0.0,3.33207454961459e-05,1.0
20195,껏습니/Noun,3,0,3,0.0,3.33207454961459e-05,1.0
20196,그니/Noun,3,3,0,3.3345930684925414e-05,0.0,1.0
20197,인혜/Noun,3,0,3,0.0,3.33207454961459e-05,1.0
20198,친정/Noun,3,0,3,0.0,3.33207454961459e-05,1.0
20199,성전환/Noun,3,3,0,3.3345930684925414e-05,0.0,1.0
20200,대자/Noun,3,3,0,3.3345930684925414e-05,0.0,1.0
20201,벌거숭이/Noun,3,0,3,0.0,3.33207454961459e-05,1.0
20202,엮어내/Noun,3,3,0,3.3345930684925414e-05,0.0,1.0
20203,시동/Noun,3,0,3,0.0,3.33207454961459e-05,1.0
20204,정세운/Noun,3,0,3,0.0,3.33207454961459e-05,1.0
20205,백현/Noun,3,3,0,3.3345930684925414e-05,0.0,1.0
20206,음절/Noun,3,3,0,3.3345930684925414e-05,0.0,1.0
20207,건반/Noun,3,3,0,3.3345930684925414e-05,0.0,1.0
20208,필로미나/Noun,3,3,0,3.3345930684925414e-05,0.0,1.0
20209,교재/Noun,3,0,3,0.0,3.33207454961459e-05,1.0
20210,호두/Noun,3,0,3,0.0,3.33207454961459e-05,1.0
20211,!!!^/Punctuation,3,3,0,3.3345930684925414e-05,0.0,1.0
20212,주무르다/Verb,3,0,3,0.0,3.33207454961459e-05,1.0
20213,요런/Modifier,3,0,3,0.0,3.33207454961459e-05,1.0
20214,컨트리/Noun,3,3,0,3.3345930684925414e-05,0.0,1.0
20215,★★/Foreign,3,3,0,3.3345930684925414e-05,0.0,1.0
20216,준지/Noun,3,0,3,0.0,3.33207454961459e-05,1.0
20217,이토/Noun,3,0,3,0.0,3.33207454961459e-05,1.0
20218,최근영/Noun,3,3,0,3.3345930684925414e-05,0.0,1.0
20219,보고따/Noun,3,0,3,0.0,3.33207454961459e-05,1.0
20220,프로포폴/Noun,3,3,0,3.3345930684925414e-05,0.0,1.0
20221,도니/Noun,3,3,0,3.3345930684925414e-05,0.0,1.0
20222,탈레반/Noun,3,0,3,0.0,3.33207454961459e-05,1.0
20223,탐미/Noun,3,3,0,3.3345930684925414e-05,0.0,1.0
20224,국력/Noun,3,0,3,0.0,3.33207454961459e-05,1.0
20225,탤런트/Noun,3,0,3,0.0,3.33207454961459e-05,1.0
20226,몸집/Noun,3,0,3,0.0,3.33207454961459e-05,1.0
20227,하몽/Noun,3,0,3,0.0,3.33207454961459e-05,1.0
20228,쏙쏙/Noun,3,3,0,3.3345930684925414e-05,0.0,1.0
20229,사체/Noun,3,0,3,0.0,3.33207454961459e-05,1.0
20230,"10,000원/Number",3,0,3,0.0,3.33207454961459e-05,1.0
20231,모친/Noun,3,0,3,0.0,3.33207454961459e-05,1.0
20232,혼잣말/Noun,3,0,3,0.0,3.33207454961459e-05,1.0
20233,느무느무/Noun,3,3,0,3.3345930684925414e-05,0.0,1.0
20234,칭샤/Noun,3,3,0,3.3345930684925414e-05,0.0,1.0
20235,하드디스크/Noun,3,0,3,0.0,3.33207454961459e-05,1.0
20236,오경이/Noun,3,0,3,0.0,3.33207454961459e-05,1.0
20237,~~~~!/Punctuation,3,3,0,3.3345930684925414e-05,0.0,1.0
20238,일회용/Noun,3,0,3,0.0,3.33207454961459e-05,1.0
20239,파마머리/Noun,3,0,3,0.0,3.33207454961459e-05,1.0
20240,안산/Noun,3,0,3,0.0,3.33207454961459e-05,1.0
20241,보톡스/Noun,3,0,3,0.0,3.33207454961459e-05,1.0
20242,쓰랙/Noun,3,0,3,0.0,3.33207454961459e-05,1.0
20243,바바리안/Noun,3,0,3,0.0,3.33207454961459e-05,1.0
20244,5등/Number,3,3,0,3.3345930684925414e-05,0.0,1.0
20245,행동거지/Noun,3,0,3,0.0,3.33207454961459e-05,1.0
20246,원레/Noun,3,3,0,3.3345930684925414e-05,0.0,1.0
20247,파손/Noun,3,0,3,0.0,3.33207454961459e-05,1.0
20248,훤하/Noun,3,0,3,0.0,3.33207454961459e-05,1.0
20249,awesome/Alpha,3,3,0,3.3345930684925414e-05,0.0,1.0
20250,화단/Noun,3,0,3,0.0,3.33207454961459e-05,1.0
20251,즉사/Noun,3,0,3,0.0,3.33207454961459e-05,1.0
20252,~>/Punctuation,3,3,0,3.3345930684925414e-05,0.0,1.0
20253,+.+/Punctuation,3,3,0,3.3345930684925414e-05,0.0,1.0
20254,3000/Number,3,0,3,0.0,3.33207454961459e-05,1.0
20255,미어캣/Noun,3,3,0,3.3345930684925414e-05,0.0,1.0
20256,1989년/Number,3,3,0,3.3345930684925414e-05,0.0,1.0
20257,사류/Noun,3,0,3,0.0,3.33207454961459e-05,1.0
20258,마흔/Modifier,3,3,0,3.3345930684925414e-05,0.0,1.0
20259,쥰세이/Noun,3,3,0,3.3345930684925414e-05,0.0,1.0
20260,까지보다가/Foreign,3,0,3,0.0,3.33207454961459e-05,1.0
20261,에이브릴라빈/Noun,3,0,3,0.0,3.33207454961459e-05,1.0
20262,반군/Noun,3,3,0,3.3345930684925414e-05,0.0,1.0
20263,알러뷰/Noun,3,3,0,3.3345930684925414e-05,0.0,1.0
20264,규현/Noun,3,0,3,0.0,3.33207454961459e-05,1.0
20265,김국진/Noun,3,0,3,0.0,3.33207454961459e-05,1.0
20266,파문/Noun,3,3,0,3.3345930684925414e-05,0.0,1.0
20267,올드해/Noun,3,0,3,0.0,3.33207454961459e-05,1.0
20268,원형/Noun,3,3,0,3.3345930684925414e-05,0.0,1.0
20269,노오/Noun,3,0,3,0.0,3.33207454961459e-05,1.0
20270,동대문/Noun,3,0,3,0.0,3.33207454961459e-05,1.0
20271,도난/Noun,3,0,3,0.0,3.33207454961459e-05,1.0
20272,천만원/Noun,3,0,3,0.0,3.33207454961459e-05,1.0
20273,엄는/Noun,3,0,3,0.0,3.33207454961459e-05,1.0
20274,꼬시/Noun,3,0,3,0.0,3.33207454961459e-05,1.0
20275,것입/Noun,3,0,3,0.0,3.33207454961459e-05,1.0
20276,~^_^/Punctuation,3,3,0,3.3345930684925414e-05,0.0,1.0
20277,미래세/Noun,3,3,0,3.3345930684925414e-05,0.0,1.0
20278,한하유/Noun,3,3,0,3.3345930684925414e-05,0.0,1.0
20279,3~4년/Number,3,0,3,0.0,3.33207454961459e-05,1.0
20280,엄숙하다/Adjective,3,3,0,3.3345930684925414e-05,0.0,1.0
20281,한도/Noun,3,0,3,0.0,3.33207454961459e-05,1.0
20282,에스프레소/Noun,3,3,0,3.3345930684925414e-05,0.0,1.0
20283,호텔리어/Noun,3,0,3,0.0,3.33207454961459e-05,1.0
20284,곰신/Noun,3,3,0,3.3345930684925414e-05,0.0,1.0
20285,막시무스/Noun,3,3,0,3.3345930684925414e-05,0.0,1.0
20286,4등/Number,3,0,3,0.0,3.33207454961459e-05,1.0
20287,깨닭/Noun,3,0,3,0.0,3.33207454961459e-05,1.0
20288,애틋/Noun,3,3,0,3.3345930684925414e-05,0.0,1.0
20289,호환/Noun,3,0,3,0.0,3.33207454961459e-05,1.0
20290,ufo/Alpha,3,0,3,0.0,3.33207454961459e-05,1.0
20291,될껄/Noun,3,0,3,0.0,3.33207454961459e-05,1.0
20292,HBO/Alpha,3,3,0,3.3345930684925414e-05,0.0,1.0
20293,장량/Noun,3,0,3,0.0,3.33207454961459e-05,1.0
20294,오디세이/Noun,3,3,0,3.3345930684925414e-05,0.0,1.0
20295,단수/Noun,3,0,3,0.0,3.33207454961459e-05,1.0
20296,궁리/Noun,3,0,3,0.0,3.33207454961459e-05,1.0
20297,르망/Noun,3,0,3,0.0,3.33207454961459e-05,1.0
20298,500억/Number,3,0,3,0.0,3.33207454961459e-05,1.0
20299,미도리/Noun,3,0,3,0.0,3.33207454961459e-05,1.0
20300,무가치/Noun,3,0,3,0.0,3.33207454961459e-05,1.0
20301,유키오/Noun,3,3,0,3.3345930684925414e-05,0.0,1.0
20302,묘기/Noun,3,0,3,0.0,3.33207454961459e-05,1.0
20303,여캐/Noun,3,3,0,3.3345930684925414e-05,0.0,1.0
20304,Le/Alpha,3,3,0,3.3345930684925414e-05,0.0,1.0
20305,~@.@/Punctuation,3,0,3,0.0,3.33207454961459e-05,1.0
20306,Up/Alpha,3,3,0,3.3345930684925414e-05,0.0,1.0
20307,나찌/Noun,3,0,3,0.0,3.33207454961459e-05,1.0
20308,애등/Noun,3,3,0,3.3345930684925414e-05,0.0,1.0
20309,산업화/Noun,3,3,0,3.3345930684925414e-05,0.0,1.0
20310,일련/Noun,3,0,3,0.0,3.33207454961459e-05,1.0
20311,전으로/Foreign,3,0,3,0.0,3.33207454961459e-05,1.0
20312,개리/Noun,3,3,0,3.3345930684925414e-05,0.0,1.0
20313,years/Alpha,3,3,0,3.3345930684925414e-05,0.0,1.0
20314,문서/Noun,3,0,3,0.0,3.33207454961459e-05,1.0
20315,외주/Noun,3,0,3,0.0,3.33207454961459e-05,1.0
20316,이호영/Noun,3,3,0,3.3345930684925414e-05,0.0,1.0
20317,레이어/Noun,3,3,0,3.3345930684925414e-05,0.0,1.0
20318,야오이/Noun,3,0,3,0.0,3.33207454961459e-05,1.0
20319,싸리/Noun,3,0,3,0.0,3.33207454961459e-05,1.0
20320,job/Alpha,3,3,0,3.3345930684925414e-05,0.0,1.0
20321,득도/Noun,3,0,3,0.0,3.33207454961459e-05,1.0
20322,페트/Noun,3,0,3,0.0,3.33207454961459e-05,1.0
20323,동인녀/Noun,3,0,3,0.0,3.33207454961459e-05,1.0
20324,지극/Noun,3,3,0,3.3345930684925414e-05,0.0,1.0
20325,야매/Noun,3,0,3,0.0,3.33207454961459e-05,1.0
20326,운전기사/Noun,3,0,3,0.0,3.33207454961459e-05,1.0
20327,밤잠/Noun,3,3,0,3.3345930684925414e-05,0.0,1.0
20328,줄창/Noun,3,0,3,0.0,3.33207454961459e-05,1.0
20329,아잉/Exclamation,3,3,0,3.3345930684925414e-05,0.0,1.0
20330,@@@/Punctuation,3,3,0,3.3345930684925414e-05,0.0,1.0
20331,한낮/Noun,3,3,0,3.3345930684925414e-05,0.0,1.0
20332,피시/Noun,3,0,3,0.0,3.33207454961459e-05,1.0
20333,박인영/Noun,3,3,0,3.3345930684925414e-05,0.0,1.0
20334,아웅산/Noun,3,3,0,3.3345930684925414e-05,0.0,1.0
20335,평탄하다/Adjective,3,0,3,0.0,3.33207454961459e-05,1.0
20336,공민왕/Noun,3,3,0,3.3345930684925414e-05,0.0,1.0
20337,에이핑크/Noun,3,3,0,3.3345930684925414e-05,0.0,1.0
20338,편집자/Noun,3,0,3,0.0,3.33207454961459e-05,1.0
20339,3.2/Number,3,0,3,0.0,3.33207454961459e-05,1.0
20340,입구/Noun,3,0,3,0.0,3.33207454961459e-05,1.0
20341,융합/Noun,3,3,0,3.3345930684925414e-05,0.0,1.0
20342,만들엇냐/Noun,3,0,3,0.0,3.33207454961459e-05,1.0
20343,텐텐/Noun,3,3,0,3.3345930684925414e-05,0.0,1.0
20344,8-90년/Number,3,3,0,3.3345930684925414e-05,0.0,1.0
20345,흐규흐규/Noun,3,3,0,3.3345930684925414e-05,0.0,1.0
20346,달후/Noun,3,0,3,0.0,3.33207454961459e-05,1.0
20347,루트/Noun,3,0,3,0.0,3.33207454961459e-05,1.0
20348,얼토/Noun,3,0,3,0.0,3.33207454961459e-05,1.0
20349,아스라하다/Adjective,3,3,0,3.3345930684925414e-05,0.0,1.0
20350,어수룩하다/Adjective,3,0,3,0.0,3.33207454961459e-05,1.0
20351,황은정/Noun,3,0,3,0.0,3.33207454961459e-05,1.0
20352,중국역사/Noun,3,0,3,0.0,3.33207454961459e-05,1.0
20353,동북공정/Noun,3,0,3,0.0,3.33207454961459e-05,1.0
20354,살리에리/Noun,3,3,0,3.3345930684925414e-05,0.0,1.0
20355,구본승/Noun,3,0,3,0.0,3.33207454961459e-05,1.0
20356,그리샴/Noun,3,0,3,0.0,3.33207454961459e-05,1.0
20357,냄비/Noun,3,0,3,0.0,3.33207454961459e-05,1.0
20358,짜장/Noun,3,0,3,0.0,3.33207454961459e-05,1.0
20359,이그리/Noun,3,0,3,0.0,3.33207454961459e-05,1.0
20360,윈프리/Noun,3,3,0,3.3345930684925414e-05,0.0,1.0
20361,오프라/Noun,3,3,0,3.3345930684925414e-05,0.0,1.0
20362,질소/Noun,3,0,3,0.0,3.33207454961459e-05,1.0
20363,염복/Noun,3,3,0,3.3345930684925414e-05,0.0,1.0
20364,수수께끼/Noun,3,0,3,0.0,3.33207454961459e-05,1.0
20365,폭주족/Noun,3,0,3,0.0,3.33207454961459e-05,1.0
20366,카게무샤/Noun,3,3,0,3.3345930684925414e-05,0.0,1.0
20367,김경탁/Noun,3,3,0,3.3345930684925414e-05,0.0,1.0
20368,구질구질/Noun,3,0,3,0.0,3.33207454961459e-05,1.0
20369,대대손손/Noun,3,3,0,3.3345930684925414e-05,0.0,1.0
20370,암탉/Noun,3,0,3,0.0,3.33207454961459e-05,1.0
20371,개쒸레기/Noun,3,0,3,0.0,3.33207454961459e-05,1.0
20372,류시원/Noun,3,0,3,0.0,3.33207454961459e-05,1.0
20373,유가족/Noun,3,0,3,0.0,3.33207454961459e-05,1.0
20374,이기용/Noun,3,0,3,0.0,3.33207454961459e-05,1.0
20375,나주고/Noun,3,0,3,0.0,3.33207454961459e-05,1.0
20376,인물관계도/Noun,3,0,3,0.0,3.33207454961459e-05,1.0
20377,출판사/Noun,3,0,3,0.0,3.33207454961459e-05,1.0
20378,출입/Noun,3,0,3,0.0,3.33207454961459e-05,1.0
20379,서장/Noun,3,0,3,0.0,3.33207454961459e-05,1.0
20380,hot/Alpha,3,0,3,0.0,3.33207454961459e-05,1.0
20381,료마/Noun,3,3,0,3.3345930684925414e-05,0.0,1.0
20382,강태공/Noun,3,0,3,0.0,3.33207454961459e-05,1.0
20383,주술/Noun,3,0,3,0.0,3.33207454961459e-05,1.0
20384,악쓰다/Verb,3,0,3,0.0,3.33207454961459e-05,1.0
20385,퐁당/Noun,3,3,0,3.3345930684925414e-05,0.0,1.0
20386,보미/Noun,3,3,0,3.3345930684925414e-05,0.0,1.0
20387,지출/Noun,3,0,3,0.0,3.33207454961459e-05,1.0
20388,은위/Noun,3,3,0,3.3345930684925414e-05,0.0,1.0
20389,밑밥/Noun,3,0,3,0.0,3.33207454961459e-05,1.0
20390,라이드/Noun,3,3,0,3.3345930684925414e-05,0.0,1.0
20391,퀀시/Noun,3,0,3,0.0,3.33207454961459e-05,1.0
20392,라핀/Noun,3,3,0,3.3345930684925414e-05,0.0,1.0
20393,도정/Noun,3,2,1,2.2230620456616944e-05,1.1106915165381966e-05,0.6666666666666666
20394,아비게일/Noun,3,2,1,2.2230620456616944e-05,1.1106915165381966e-05,0.6666666666666666
20395,brilliant/Alpha,3,2,1,2.2230620456616944e-05,1.1106915165381966e-05,0.6666666666666666
20396,운남고/Noun,3,2,1,2.2230620456616944e-05,1.1106915165381966e-05,0.6666666666666666
20397,연옥/Noun,3,2,1,2.2230620456616944e-05,1.1106915165381966e-05,0.6666666666666666
20398,에그/Exclamation,3,1,2,1.1115310228308472e-05,2.2213830330763933e-05,0.6666666666666666
20399,무적자/Noun,3,1,2,1.1115310228308472e-05,2.2213830330763933e-05,0.6666666666666666
20400,법원/Noun,3,1,2,1.1115310228308472e-05,2.2213830330763933e-05,0.6666666666666666
20401,1920년/Number,3,2,1,2.2230620456616944e-05,1.1106915165381966e-05,0.6666666666666666
20402,ER/Alpha,3,2,1,2.2230620456616944e-05,1.1106915165381966e-05,0.6666666666666666
20403,존레넌/Noun,3,2,1,2.2230620456616944e-05,1.1106915165381966e-05,0.6666666666666666
20404,심연/Noun,3,2,1,2.2230620456616944e-05,1.1106915165381966e-05,0.6666666666666666
20405,바이킹/Noun,3,2,1,2.2230620456616944e-05,1.1106915165381966e-05,0.6666666666666666
20406,묵인/Noun,3,1,2,1.1115310228308472e-05,2.2213830330763933e-05,0.6666666666666666
20407,비크티니/Noun,3,2,1,2.2230620456616944e-05,1.1106915165381966e-05,0.6666666666666666
20408,쏭/Noun,3,2,1,2.2230620456616944e-05,1.1106915165381966e-05,0.6666666666666666
20409,이성진/Noun,3,2,1,2.2230620456616944e-05,1.1106915165381966e-05,0.6666666666666666
20410,..//Punctuation,3,1,2,1.1115310228308472e-05,2.2213830330763933e-05,0.6666666666666666
20411,더기/Noun,3,2,1,2.2230620456616944e-05,1.1106915165381966e-05,0.6666666666666666
20412,셩/Noun,3,2,1,2.2230620456616944e-05,1.1106915165381966e-05,0.6666666666666666
20413,젝스키스/Noun,3,1,2,1.1115310228308472e-05,2.2213830330763933e-05,0.6666666666666666
20414,트포/Noun,3,2,1,2.2230620456616944e-05,1.1106915165381966e-05,0.6666666666666666
20415,치/Exclamation,3,1,2,1.1115310228308472e-05,2.2213830330763933e-05,0.6666666666666666
20416,비욘세/Noun,3,2,1,2.2230620456616944e-05,1.1106915165381966e-05,0.6666666666666666
20417,배추/Noun,3,1,2,1.1115310228308472e-05,2.2213830330763933e-05,0.6666666666666666
20418,연씨/Noun,3,2,1,2.2230620456616944e-05,1.1106915165381966e-05,0.6666666666666666
20419,ㅋㅋㄲ/KoreanParticle,3,1,2,1.1115310228308472e-05,2.2213830330763933e-05,0.6666666666666666
20420,쪽국/Noun,3,1,2,1.1115310228308472e-05,2.2213830330763933e-05,0.6666666666666666
20421,파지/Noun,3,2,1,2.2230620456616944e-05,1.1106915165381966e-05,0.6666666666666666
20422,미국드라마/Noun,3,1,2,1.1115310228308472e-05,2.2213830330763933e-05,0.6666666666666666
20423,하주희/Noun,3,1,2,1.1115310228308472e-05,2.2213830330763933e-05,0.6666666666666666
20424,퓨처/Noun,3,2,1,2.2230620456616944e-05,1.1106915165381966e-05,0.6666666666666666
20425,범한/Noun,3,1,2,1.1115310228308472e-05,2.2213830330763933e-05,0.6666666666666666
20426,전원주/Noun,3,2,1,2.2230620456616944e-05,1.1106915165381966e-05,0.6666666666666666
20427,샘물/Noun,3,2,1,2.2230620456616944e-05,1.1106915165381966e-05,0.6666666666666666
20428,민영/Noun,3,2,1,2.2230620456616944e-05,1.1106915165381966e-05,0.6666666666666666
20429,히스테리/Noun,3,2,1,2.2230620456616944e-05,1.1106915165381966e-05,0.6666666666666666
20430,;;;;;;;;;;;;;;;;;/Punctuation,3,1,2,1.1115310228308472e-05,2.2213830330763933e-05,0.6666666666666666
20431,첫키스/Noun,3,2,1,2.2230620456616944e-05,1.1106915165381966e-05,0.6666666666666666
20432,구차하다/Adjective,3,1,2,1.1115310228308472e-05,2.2213830330763933e-05,0.6666666666666666
20433,싱글맘/Noun,3,1,2,1.1115310228308472e-05,2.2213830330763933e-05,0.6666666666666666
20434,사견/Noun,3,1,2,1.1115310228308472e-05,2.2213830330763933e-05,0.6666666666666666
20435,공화국/Noun,3,2,1,2.2230620456616944e-05,1.1106915165381966e-05,0.6666666666666666
20436,돌진/Noun,3,1,2,1.1115310228308472e-05,2.2213830330763933e-05,0.6666666666666666
20437,강민경/Noun,3,1,2,1.1115310228308472e-05,2.2213830330763933e-05,0.6666666666666666
20438,봤느데/Noun,3,1,2,1.1115310228308472e-05,2.2213830330763933e-05,0.6666666666666666
20439,개국/Noun,3,1,2,1.1115310228308472e-05,2.2213830330763933e-05,0.6666666666666666
20440,바토리/Noun,3,1,2,1.1115310228308472e-05,2.2213830330763933e-05,0.6666666666666666
20441,소양/Noun,3,1,2,1.1115310228308472e-05,2.2213830330763933e-05,0.6666666666666666
20442,잉글랜드/Noun,3,1,2,1.1115310228308472e-05,2.2213830330763933e-05,0.6666666666666666
20443,김광규/Noun,3,1,2,1.1115310228308472e-05,2.2213830330763933e-05,0.6666666666666666
20444,쩡쩡하다/Adjective,3,2,1,2.2230620456616944e-05,1.1106915165381966e-05,0.6666666666666666
20445,송전탑/Noun,3,1,2,1.1115310228308472e-05,2.2213830330763933e-05,0.6666666666666666
20446,겨를/Noun,3,2,1,2.2230620456616944e-05,1.1106915165381966e-05,0.6666666666666666
20447,OF/Alpha,3,2,1,2.2230620456616944e-05,1.1106915165381966e-05,0.6666666666666666
20448,스튜/Noun,3,1,2,1.1115310228308472e-05,2.2213830330763933e-05,0.6666666666666666
20449,멸/Noun,3,1,2,1.1115310228308472e-05,2.2213830330763933e-05,0.6666666666666666
20450,알라신/Noun,3,1,2,1.1115310228308472e-05,2.2213830330763933e-05,0.6666666666666666
20451,강점/Noun,3,2,1,2.2230620456616944e-05,1.1106915165381966e-05,0.6666666666666666
20452,협/Noun,3,1,2,1.1115310228308472e-05,2.2213830330763933e-05,0.6666666666666666
20453,이자웅/Noun,3,2,1,2.2230620456616944e-05,1.1106915165381966e-05,0.6666666666666666
20454,경위/Noun,3,2,1,2.2230620456616944e-05,1.1106915165381966e-05,0.6666666666666666
20455,서덜랜드/Noun,3,1,2,1.1115310228308472e-05,2.2213830330763933e-05,0.6666666666666666
20456,옆구리/Noun,3,2,1,2.2230620456616944e-05,1.1106915165381966e-05,0.6666666666666666
20457,하얀색/Noun,3,1,2,1.1115310228308472e-05,2.2213830330763933e-05,0.6666666666666666
20458,이승만/Noun,3,1,2,1.1115310228308472e-05,2.2213830330763933e-05,0.6666666666666666
20459,왕성/Noun,3,1,2,1.1115310228308472e-05,2.2213830330763933e-05,0.6666666666666666
20460,ㅜㅜㅎ/KoreanParticle,3,2,1,2.2230620456616944e-05,1.1106915165381966e-05,0.6666666666666666
20461,마카오/Noun,3,2,1,2.2230620456616944e-05,1.1106915165381966e-05,0.6666666666666666
20462,노비/Noun,3,1,2,1.1115310228308472e-05,2.2213830330763933e-05,0.6666666666666666
20463,색상/Noun,3,1,2,1.1115310228308472e-05,2.2213830330763933e-05,0.6666666666666666
20464,플래시백/Noun,3,1,2,1.1115310228308472e-05,2.2213830330763933e-05,0.6666666666666666
20465,다도/Noun,3,1,2,1.1115310228308472e-05,2.2213830330763933e-05,0.6666666666666666
20466,Shit/Alpha,3,1,2,1.1115310228308472e-05,2.2213830330763933e-05,0.6666666666666666
20467,만우절/Noun,3,1,2,1.1115310228308472e-05,2.2213830330763933e-05,0.6666666666666666
20468,down/Alpha,3,2,1,2.2230620456616944e-05,1.1106915165381966e-05,0.6666666666666666
20469,황실/Noun,3,1,2,1.1115310228308472e-05,2.2213830330763933e-05,0.6666666666666666
20470,스케치/Noun,3,1,2,1.1115310228308472e-05,2.2213830330763933e-05,0.6666666666666666
20471,드넓다/Adjective,3,2,1,2.2230620456616944e-05,1.1106915165381966e-05,0.6666666666666666
20472,대오/Noun,3,2,1,2.2230620456616944e-05,1.1106915165381966e-05,0.6666666666666666
20473,발끈/Noun,3,1,2,1.1115310228308472e-05,2.2213830330763933e-05,0.6666666666666666
20474,절름발/Noun,3,2,1,2.2230620456616944e-05,1.1106915165381966e-05,0.6666666666666666
20475,중공업/Noun,3,1,2,1.1115310228308472e-05,2.2213830330763933e-05,0.6666666666666666
20476,호모포비아/Noun,3,2,1,2.2230620456616944e-05,1.1106915165381966e-05,0.6666666666666666
20477,석상/Noun,3,1,2,1.1115310228308472e-05,2.2213830330763933e-05,0.6666666666666666
20478,오드/Noun,3,2,1,2.2230620456616944e-05,1.1106915165381966e-05,0.6666666666666666
20479,67/Number,3,2,1,2.2230620456616944e-05,1.1106915165381966e-05,0.6666666666666666
20480,카시오페아/Noun,3,2,1,2.2230620456616944e-05,1.1106915165381966e-05,0.6666666666666666
20481,중간고사/Noun,3,2,1,2.2230620456616944e-05,1.1106915165381966e-05,0.6666666666666666
20482,포위/Noun,3,2,1,2.2230620456616944e-05,1.1106915165381966e-05,0.6666666666666666
20483,5.7/Number,3,2,1,2.2230620456616944e-05,1.1106915165381966e-05,0.6666666666666666
20484,숀팬/Noun,3,2,1,2.2230620456616944e-05,1.1106915165381966e-05,0.6666666666666666
20485,ㄴㅅ/KoreanParticle,3,2,1,2.2230620456616944e-05,1.1106915165381966e-05,0.6666666666666666
20486,괜찬은듯/Noun,3,2,1,2.2230620456616944e-05,1.1106915165381966e-05,0.6666666666666666
20487,(?)./Punctuation,3,1,2,1.1115310228308472e-05,2.2213830330763933e-05,0.6666666666666666
20488,하이텔/Noun,3,1,2,1.1115310228308472e-05,2.2213830330763933e-05,0.6666666666666666
20489,3%/Number,3,1,2,1.1115310228308472e-05,2.2213830330763933e-05,0.6666666666666666
20490,화씨/Noun,3,2,1,2.2230620456616944e-05,1.1106915165381966e-05,0.6666666666666666
20491,성배/Noun,3,2,1,2.2230620456616944e-05,1.1106915165381966e-05,0.6666666666666666
20492,-./Punctuation,3,2,1,2.2230620456616944e-05,1.1106915165381966e-05,0.6666666666666666
20493,레이토/Noun,3,1,2,1.1115310228308472e-05,2.2213830330763933e-05,0.6666666666666666
20494,",....../Punctuation",3,1,2,1.1115310228308472e-05,2.2213830330763933e-05,0.6666666666666666
20495,말따/Noun,3,2,1,2.2230620456616944e-05,1.1106915165381966e-05,0.6666666666666666
20496,15회/Number,3,2,1,2.2230620456616944e-05,1.1106915165381966e-05,0.6666666666666666
20497,팝업/Noun,3,1,2,1.1115310228308472e-05,2.2213830330763933e-05,0.6666666666666666
20498,전구/Noun,3,2,1,2.2230620456616944e-05,1.1106915165381966e-05,0.6666666666666666
20499,극소/Noun,3,1,2,1.1115310228308472e-05,2.2213830330763933e-05,0.6666666666666666
20500,유럽인/Noun,3,1,2,1.1115310228308472e-05,2.2213830330763933e-05,0.6666666666666666
20501,언짢다/Adjective,3,1,2,1.1115310228308472e-05,2.2213830330763933e-05,0.6666666666666666
20502,does/Alpha,3,2,1,2.2230620456616944e-05,1.1106915165381966e-05,0.6666666666666666
20503,last/Alpha,3,1,2,1.1115310228308472e-05,2.2213830330763933e-05,0.6666666666666666
20504,통로/Noun,3,2,1,2.2230620456616944e-05,1.1106915165381966e-05,0.6666666666666666
20505,종목/Noun,3,1,2,1.1115310228308472e-05,2.2213830330763933e-05,0.6666666666666666
20506,야후/Noun,3,2,1,2.2230620456616944e-05,1.1106915165381966e-05,0.6666666666666666
20507,800억/Number,3,1,2,1.1115310228308472e-05,2.2213830330763933e-05,0.6666666666666666
20508,국사/Noun,3,1,2,1.1115310228308472e-05,2.2213830330763933e-05,0.6666666666666666
20509,남진/Noun,3,1,2,1.1115310228308472e-05,2.2213830330763933e-05,0.6666666666666666
20510,몰상식/Noun,3,2,1,2.2230620456616944e-05,1.1106915165381966e-05,0.6666666666666666
20511,도플갱어/Noun,3,1,2,1.1115310228308472e-05,2.2213830330763933e-05,0.6666666666666666
20512,천왕/Noun,3,1,2,1.1115310228308472e-05,2.2213830330763933e-05,0.6666666666666666
20513,불장난/Noun,3,1,2,1.1115310228308472e-05,2.2213830330763933e-05,0.6666666666666666
20514,임지연/Noun,3,1,2,1.1115310228308472e-05,2.2213830330763933e-05,0.6666666666666666
20515,보탬/Noun,3,2,1,2.2230620456616944e-05,1.1106915165381966e-05,0.6666666666666666
20516,625/Number,3,2,1,2.2230620456616944e-05,1.1106915165381966e-05,0.6666666666666666
20517,로소/Noun,3,2,1,2.2230620456616944e-05,1.1106915165381966e-05,0.6666666666666666
20518,불발/Noun,3,1,2,1.1115310228308472e-05,2.2213830330763933e-05,0.6666666666666666
20519,1-2/Number,3,2,1,2.2230620456616944e-05,1.1106915165381966e-05,0.6666666666666666
20520,데츠/Noun,3,1,2,1.1115310228308472e-05,2.2213830330763933e-05,0.6666666666666666
20521,소말리아/Noun,3,2,1,2.2230620456616944e-05,1.1106915165381966e-05,0.6666666666666666
20522,통령/Noun,3,2,1,2.2230620456616944e-05,1.1106915165381966e-05,0.6666666666666666
20523,석현/Noun,3,1,2,1.1115310228308472e-05,2.2213830330763933e-05,0.6666666666666666
20524,엘리스/Noun,3,2,1,2.2230620456616944e-05,1.1106915165381966e-05,0.6666666666666666
20525,데빌/Noun,3,2,1,2.2230620456616944e-05,1.1106915165381966e-05,0.6666666666666666
20526,황해/Noun,3,2,1,2.2230620456616944e-05,1.1106915165381966e-05,0.6666666666666666
20527,니니/Noun,3,1,2,1.1115310228308472e-05,2.2213830330763933e-05,0.6666666666666666
20528,미니어쳐/Noun,3,1,2,1.1115310228308472e-05,2.2213830330763933e-05,0.6666666666666666
20529,견자/Noun,3,1,2,1.1115310228308472e-05,2.2213830330763933e-05,0.6666666666666666
20530,리에티/Noun,3,1,2,1.1115310228308472e-05,2.2213830330763933e-05,0.6666666666666666
20531,한발/Adverb,3,2,1,2.2230620456616944e-05,1.1106915165381966e-05,0.6666666666666666
20532,빵셔틀/Noun,3,1,2,1.1115310228308472e-05,2.2213830330763933e-05,0.6666666666666666
20533,분위/Noun,3,1,2,1.1115310228308472e-05,2.2213830330763933e-05,0.6666666666666666
20534,훨남/Noun,3,1,2,1.1115310228308472e-05,2.2213830330763933e-05,0.6666666666666666
20535,땅바닥/Noun,3,1,2,1.1115310228308472e-05,2.2213830330763933e-05,0.6666666666666666
20536,클림트/Noun,3,1,2,1.1115310228308472e-05,2.2213830330763933e-05,0.6666666666666666
20537,2천/Number,3,1,2,1.1115310228308472e-05,2.2213830330763933e-05,0.6666666666666666
20538,반문/Noun,3,2,1,2.2230620456616944e-05,1.1106915165381966e-05,0.6666666666666666
20539,싱글즈/Noun,3,1,2,1.1115310228308472e-05,2.2213830330763933e-05,0.6666666666666666
20540,역기/Noun,3,2,1,2.2230620456616944e-05,1.1106915165381966e-05,0.6666666666666666
20541,프레스티지/Noun,3,2,1,2.2230620456616944e-05,1.1106915165381966e-05,0.6666666666666666
20542,한채아/Noun,3,2,1,2.2230620456616944e-05,1.1106915165381966e-05,0.6666666666666666
20543,트레인스포팅/Noun,3,1,2,1.1115310228308472e-05,2.2213830330763933e-05,0.6666666666666666
20544,타이완/Noun,3,2,1,2.2230620456616944e-05,1.1106915165381966e-05,0.6666666666666666
20545,맏/Noun,3,2,1,2.2230620456616944e-05,1.1106915165381966e-05,0.6666666666666666
20546,하넹/Noun,3,2,1,2.2230620456616944e-05,1.1106915165381966e-05,0.6666666666666666
20547,젖소/Noun,3,1,2,1.1115310228308472e-05,2.2213830330763933e-05,0.6666666666666666
20548,비속어/Noun,3,1,2,1.1115310228308472e-05,2.2213830330763933e-05,0.6666666666666666
20549,보병/Noun,3,2,1,2.2230620456616944e-05,1.1106915165381966e-05,0.6666666666666666
20550,앳킨스/Noun,3,1,2,1.1115310228308472e-05,2.2213830330763933e-05,0.6666666666666666
20551,허리케인/Noun,3,1,2,1.1115310228308472e-05,2.2213830330763933e-05,0.6666666666666666
20552,데프콘/Noun,3,2,1,2.2230620456616944e-05,1.1106915165381966e-05,0.6666666666666666
20553,찰흙/Noun,3,2,1,2.2230620456616944e-05,1.1106915165381966e-05,0.6666666666666666
20554,전일/Noun,3,2,1,2.2230620456616944e-05,1.1106915165381966e-05,0.6666666666666666
20555,-&/Punctuation,3,2,1,2.2230620456616944e-05,1.1106915165381966e-05,0.6666666666666666
20556,연상연하/Noun,3,2,1,2.2230620456616944e-05,1.1106915165381966e-05,0.6666666666666666
20557,중국집/Noun,3,2,1,2.2230620456616944e-05,1.1106915165381966e-05,0.6666666666666666
20558,키티/Noun,3,2,1,2.2230620456616944e-05,1.1106915165381966e-05,0.6666666666666666
20559,호빵/Noun,3,1,2,1.1115310228308472e-05,2.2213830330763933e-05,0.6666666666666666
20560,인동/Noun,3,1,2,1.1115310228308472e-05,2.2213830330763933e-05,0.6666666666666666
20561,구박/Noun,3,1,2,1.1115310228308472e-05,2.2213830330763933e-05,0.6666666666666666
20562,위정/Noun,3,2,1,2.2230620456616944e-05,1.1106915165381966e-05,0.6666666666666666
20563,특수요원/Noun,3,2,1,2.2230620456616944e-05,1.1106915165381966e-05,0.6666666666666666
20564,ㄱㅋ/KoreanParticle,3,2,1,2.2230620456616944e-05,1.1106915165381966e-05,0.6666666666666666
20565,앞쪽/Noun,3,1,2,1.1115310228308472e-05,2.2213830330763933e-05,0.6666666666666666
20566,예스맨/Noun,3,1,2,1.1115310228308472e-05,2.2213830330763933e-05,0.6666666666666666
20567,참혹/Noun,3,2,1,2.2230620456616944e-05,1.1106915165381966e-05,0.6666666666666666
20568,한씨/Noun,3,2,1,2.2230620456616944e-05,1.1106915165381966e-05,0.6666666666666666
20569,데드풀/Noun,3,2,1,2.2230620456616944e-05,1.1106915165381966e-05,0.6666666666666666
20570,무아/Noun,3,2,1,2.2230620456616944e-05,1.1106915165381966e-05,0.6666666666666666
20571,톰형/Noun,3,2,1,2.2230620456616944e-05,1.1106915165381966e-05,0.6666666666666666
20572,참견/Noun,3,1,2,1.1115310228308472e-05,2.2213830330763933e-05,0.6666666666666666
20573,오른/Modifier,3,2,1,2.2230620456616944e-05,1.1106915165381966e-05,0.6666666666666666
20574,씨름/Noun,3,1,2,1.1115310228308472e-05,2.2213830330763933e-05,0.6666666666666666
20575,때아닌/Modifier,3,1,2,1.1115310228308472e-05,2.2213830330763933e-05,0.6666666666666666
20576,오지은/Noun,3,2,1,2.2230620456616944e-05,1.1106915165381966e-05,0.6666666666666666
20577,남짓하다/Adjective,3,1,2,1.1115310228308472e-05,2.2213830330763933e-05,0.6666666666666666
20578,마르고/Noun,3,2,1,2.2230620456616944e-05,1.1106915165381966e-05,0.6666666666666666
20579,동양철학/Noun,3,2,1,2.2230620456616944e-05,1.1106915165381966e-05,0.6666666666666666
20580,110분/Number,3,1,2,1.1115310228308472e-05,2.2213830330763933e-05,0.6666666666666666
20581,집필/Noun,3,1,2,1.1115310228308472e-05,2.2213830330763933e-05,0.6666666666666666
20582,여친소/Noun,3,1,2,1.1115310228308472e-05,2.2213830330763933e-05,0.6666666666666666
20583,중국본토/Noun,3,1,2,1.1115310228308472e-05,2.2213830330763933e-05,0.6666666666666666
20584,조씨/Noun,3,1,2,1.1115310228308472e-05,2.2213830330763933e-05,0.6666666666666666
20585,오스트레일리아/Noun,3,2,1,2.2230620456616944e-05,1.1106915165381966e-05,0.6666666666666666
20586,빗겨/Noun,3,2,1,2.2230620456616944e-05,1.1106915165381966e-05,0.6666666666666666
20587,할떄/Noun,3,2,1,2.2230620456616944e-05,1.1106915165381966e-05,0.6666666666666666
20588,본자/Noun,3,2,1,2.2230620456616944e-05,1.1106915165381966e-05,0.6666666666666666
20589,",'/Punctuation",3,1,2,1.1115310228308472e-05,2.2213830330763933e-05,0.6666666666666666
20590,세일러문/Noun,3,1,2,1.1115310228308472e-05,2.2213830330763933e-05,0.6666666666666666
20591,편두통/Noun,3,1,2,1.1115310228308472e-05,2.2213830330763933e-05,0.6666666666666666
20592,5시간/Number,3,2,1,2.2230620456616944e-05,1.1106915165381966e-05,0.6666666666666666
20593,패틴슨때문/Noun,3,1,2,1.1115310228308472e-05,2.2213830330763933e-05,0.6666666666666666
20594,2001/Number,3,2,1,2.2230620456616944e-05,1.1106915165381966e-05,0.6666666666666666
20595,음지/Noun,3,1,2,1.1115310228308472e-05,2.2213830330763933e-05,0.6666666666666666
20596,피티/Noun,3,2,1,2.2230620456616944e-05,1.1106915165381966e-05,0.6666666666666666
20597,우/Noun,3,2,1,2.2230620456616944e-05,1.1106915165381966e-05,0.6666666666666666
20598,씹덕/Noun,3,1,2,1.1115310228308472e-05,2.2213830330763933e-05,0.6666666666666666
20599,좇는/Noun,3,2,1,2.2230620456616944e-05,1.1106915165381966e-05,0.6666666666666666
20600,시끌벅적/Adverb,3,2,1,2.2230620456616944e-05,1.1106915165381966e-05,0.6666666666666666
20601,도청/Noun,3,2,1,2.2230620456616944e-05,1.1106915165381966e-05,0.6666666666666666
20602,중얼거리다/Verb,3,2,1,2.2230620456616944e-05,1.1106915165381966e-05,0.6666666666666666
20603,어트케/Noun,3,1,2,1.1115310228308472e-05,2.2213830330763933e-05,0.6666666666666666
20604,콘스탄틴/Noun,3,1,2,1.1115310228308472e-05,2.2213830330763933e-05,0.6666666666666666
20605,보련/Noun,3,1,2,1.1115310228308472e-05,2.2213830330763933e-05,0.6666666666666666
20606,윤후/Noun,3,1,2,1.1115310228308472e-05,2.2213830330763933e-05,0.6666666666666666
20607,노루/Noun,3,2,1,2.2230620456616944e-05,1.1106915165381966e-05,0.6666666666666666
20608,.-_-;;/Punctuation,3,1,2,1.1115310228308472e-05,2.2213830330763933e-05,0.6666666666666666
20609,주문진/Noun,3,2,1,2.2230620456616944e-05,1.1106915165381966e-05,0.6666666666666666
20610,넛/Noun,3,2,1,2.2230620456616944e-05,1.1106915165381966e-05,0.6666666666666666
20611,국딩때/Noun,3,2,1,2.2230620456616944e-05,1.1106915165381966e-05,0.6666666666666666
20612,스트리트파이터/Noun,3,1,2,1.1115310228308472e-05,2.2213830330763933e-05,0.6666666666666666
20613,렌코/Noun,3,2,1,2.2230620456616944e-05,1.1106915165381966e-05,0.6666666666666666
20614,쿠릴/Noun,3,2,1,2.2230620456616944e-05,1.1106915165381966e-05,0.6666666666666666
20615,파이스토리/Noun,3,2,1,2.2230620456616944e-05,1.1106915165381966e-05,0.6666666666666666
20616,쿨러닝/Noun,3,1,2,1.1115310228308472e-05,2.2213830330763933e-05,0.6666666666666666
20617,알못/Noun,3,1,2,1.1115310228308472e-05,2.2213830330763933e-05,0.6666666666666666
20618,자넷/Noun,3,2,1,2.2230620456616944e-05,1.1106915165381966e-05,0.6666666666666666
20619,상대편/Noun,3,1,2,1.1115310228308472e-05,2.2213830330763933e-05,0.6666666666666666
20620,계성은/Noun,3,1,2,1.1115310228308472e-05,2.2213830330763933e-05,0.6666666666666666
20621,김부선/Noun,3,2,1,2.2230620456616944e-05,1.1106915165381966e-05,0.6666666666666666
20622,비법/Noun,3,2,1,2.2230620456616944e-05,1.1106915165381966e-05,0.6666666666666666
20623,용한/Noun,3,1,2,1.1115310228308472e-05,2.2213830330763933e-05,0.6666666666666666
20624,효언니/Noun,3,2,1,2.2230620456616944e-05,1.1106915165381966e-05,0.6666666666666666
20625,맥커너히/Noun,3,2,1,2.2230620456616944e-05,1.1106915165381966e-05,0.6666666666666666
20626,미리보기/Noun,3,1,2,1.1115310228308472e-05,2.2213830330763933e-05,0.6666666666666666
20627,~;/Punctuation,3,1,2,1.1115310228308472e-05,2.2213830330763933e-05,0.6666666666666666
20628,베개/Noun,3,2,1,2.2230620456616944e-05,1.1106915165381966e-05,0.6666666666666666
20629,"^,^/Punctuation",3,2,1,2.2230620456616944e-05,1.1106915165381966e-05,0.6666666666666666
20630,경건하다/Adjective,3,2,1,2.2230620456616944e-05,1.1106915165381966e-05,0.6666666666666666
20631,마리화나/Noun,3,2,1,2.2230620456616944e-05,1.1106915165381966e-05,0.6666666666666666
20632,○○○/Foreign,3,1,2,1.1115310228308472e-05,2.2213830330763933e-05,0.6666666666666666
20633,완장/Noun,3,1,2,1.1115310228308472e-05,2.2213830330763933e-05,0.6666666666666666
20634,ㅠㅡ/KoreanParticle,3,2,1,2.2230620456616944e-05,1.1106915165381966e-05,0.6666666666666666
20635,국밥/Noun,3,1,2,1.1115310228308472e-05,2.2213830330763933e-05,0.6666666666666666
20636,그렁/Adverb,3,2,1,2.2230620456616944e-05,1.1106915165381966e-05,0.6666666666666666
20637,바람소리/Noun,3,1,2,1.1115310228308472e-05,2.2213830330763933e-05,0.6666666666666666
20638,가마/Noun,3,1,2,1.1115310228308472e-05,2.2213830330763933e-05,0.6666666666666666
20639,혹사/Noun,3,2,1,2.2230620456616944e-05,1.1106915165381966e-05,0.6666666666666666
20640,서원/Noun,3,1,2,1.1115310228308472e-05,2.2213830330763933e-05,0.6666666666666666
20641,하겟/Noun,3,1,2,1.1115310228308472e-05,2.2213830330763933e-05,0.6666666666666666
20642,겟/PreEomi,3,2,1,2.2230620456616944e-05,1.1106915165381966e-05,0.6666666666666666
20643,실록/Noun,3,2,1,2.2230620456616944e-05,1.1106915165381966e-05,0.6666666666666666
20644,어쩜그리/Noun,3,2,1,2.2230620456616944e-05,1.1106915165381966e-05,0.6666666666666666
20645,발싸개/Noun,3,1,2,1.1115310228308472e-05,2.2213830330763933e-05,0.6666666666666666
20646,박원상/Noun,3,1,2,1.1115310228308472e-05,2.2213830330763933e-05,0.6666666666666666
20647,배구공/Noun,3,2,1,2.2230620456616944e-05,1.1106915165381966e-05,0.6666666666666666
20648,당구공/Noun,3,1,2,1.1115310228308472e-05,2.2213830330763933e-05,0.6666666666666666
20649,"!!!!""/Punctuation",3,1,2,1.1115310228308472e-05,2.2213830330763933e-05,0.6666666666666666
20650,박달/Noun,3,2,1,2.2230620456616944e-05,1.1106915165381966e-05,0.6666666666666666
20651,월리스/Noun,3,1,2,1.1115310228308472e-05,2.2213830330763933e-05,0.6666666666666666
20652,자립/Noun,3,2,1,2.2230620456616944e-05,1.1106915165381966e-05,0.6666666666666666
20653,총성/Noun,3,2,1,2.2230620456616944e-05,1.1106915165381966e-05,0.6666666666666666
20654,목구멍/Noun,3,1,2,1.1115310228308472e-05,2.2213830330763933e-05,0.6666666666666666
20655,노주현/Noun,3,2,1,2.2230620456616944e-05,1.1106915165381966e-05,0.6666666666666666
20656,~~~~~~~~~~~~~~/Punctuation,3,2,1,2.2230620456616944e-05,1.1106915165381966e-05,0.6666666666666666
20657,기울다/Verb,3,1,2,1.1115310228308472e-05,2.2213830330763933e-05,0.6666666666666666
20658,ㅎㅁ/KoreanParticle,3,2,1,2.2230620456616944e-05,1.1106915165381966e-05,0.6666666666666666
20659,뮤지/Noun,3,2,1,2.2230620456616944e-05,1.1106915165381966e-05,0.6666666666666666
20660,노니/Noun,3,2,1,2.2230620456616944e-05,1.1106915165381966e-05,0.6666666666666666
20661,커피숍/Noun,3,2,1,2.2230620456616944e-05,1.1106915165381966e-05,0.6666666666666666
20662,-!!/Punctuation,3,2,1,2.2230620456616944e-05,1.1106915165381966e-05,0.6666666666666666
20663,폐쇄공포증/Noun,3,2,1,2.2230620456616944e-05,1.1106915165381966e-05,0.6666666666666666
20664,포주/Noun,3,1,2,1.1115310228308472e-05,2.2213830330763933e-05,0.6666666666666666
20665,씨지브이/Noun,3,1,2,1.1115310228308472e-05,2.2213830330763933e-05,0.6666666666666666
20666,나불대다/Verb,3,2,1,2.2230620456616944e-05,1.1106915165381966e-05,0.6666666666666666
20667,재도/Noun,3,2,1,2.2230620456616944e-05,1.1106915165381966e-05,0.6666666666666666
20668,kg/Alpha,3,1,2,1.1115310228308472e-05,2.2213830330763933e-05,0.6666666666666666
20669,마사지/Noun,3,1,2,1.1115310228308472e-05,2.2213830330763933e-05,0.6666666666666666
20670,후론/Noun,3,1,2,1.1115310228308472e-05,2.2213830330763933e-05,0.6666666666666666
20671,방독면/Noun,3,1,2,1.1115310228308472e-05,2.2213830330763933e-05,0.6666666666666666
20672,먹물/Noun,3,1,2,1.1115310228308472e-05,2.2213830330763933e-05,0.6666666666666666
20673,까치/Noun,3,1,2,1.1115310228308472e-05,2.2213830330763933e-05,0.6666666666666666
20674,반사/Noun,3,1,2,1.1115310228308472e-05,2.2213830330763933e-05,0.6666666666666666
20675,Kill/Alpha,3,1,2,1.1115310228308472e-05,2.2213830330763933e-05,0.6666666666666666
20676,선원/Noun,3,1,2,1.1115310228308472e-05,2.2213830330763933e-05,0.6666666666666666
20677,도킹/Noun,3,1,2,1.1115310228308472e-05,2.2213830330763933e-05,0.6666666666666666
20678,얙션/Noun,3,2,1,2.2230620456616944e-05,1.1106915165381966e-05,0.6666666666666666
20679,부여잡다/Verb,3,2,1,2.2230620456616944e-05,1.1106915165381966e-05,0.6666666666666666
20680,봉달/Noun,3,2,1,2.2230620456616944e-05,1.1106915165381966e-05,0.6666666666666666
20681,밀가루/Noun,3,1,2,1.1115310228308472e-05,2.2213830330763933e-05,0.6666666666666666
20682,가화/Noun,3,2,1,2.2230620456616944e-05,1.1106915165381966e-05,0.6666666666666666
20683,cool/Alpha,3,2,1,2.2230620456616944e-05,1.1106915165381966e-05,0.6666666666666666
20684,유고/Noun,3,2,1,2.2230620456616944e-05,1.1106915165381966e-05,0.6666666666666666
20685,삼부작/Noun,3,2,1,2.2230620456616944e-05,1.1106915165381966e-05,0.6666666666666666
20686,킄/Noun,3,1,2,1.1115310228308472e-05,2.2213830330763933e-05,0.6666666666666666
20687,괜춘하/Noun,3,1,2,1.1115310228308472e-05,2.2213830330763933e-05,0.6666666666666666
20688,애석하다/Adjective,3,2,1,2.2230620456616944e-05,1.1106915165381966e-05,0.6666666666666666
20689,메카물/Noun,3,2,1,2.2230620456616944e-05,1.1106915165381966e-05,0.6666666666666666
20690,쌩까다/Verb,3,1,2,1.1115310228308472e-05,2.2213830330763933e-05,0.6666666666666666
20691,밤하늘/Noun,3,2,1,2.2230620456616944e-05,1.1106915165381966e-05,0.6666666666666666
20692,페북/Noun,3,2,1,2.2230620456616944e-05,1.1106915165381966e-05,0.6666666666666666
20693,무더기/Noun,3,1,2,1.1115310228308472e-05,2.2213830330763933e-05,0.6666666666666666
20694,부엌/Noun,3,1,2,1.1115310228308472e-05,2.2213830330763933e-05,0.6666666666666666
20695,난파선/Noun,3,2,1,2.2230620456616944e-05,1.1106915165381966e-05,0.6666666666666666
20696,물방울/Noun,3,1,2,1.1115310228308472e-05,2.2213830330763933e-05,0.6666666666666666
20697,꽃처럼/Noun,3,2,1,2.2230620456616944e-05,1.1106915165381966e-05,0.6666666666666666
20698,유저/Noun,3,2,1,2.2230620456616944e-05,1.1106915165381966e-05,0.6666666666666666
20699,쏫/Noun,3,2,1,2.2230620456616944e-05,1.1106915165381966e-05,0.6666666666666666
20700,검토/Noun,3,1,2,1.1115310228308472e-05,2.2213830330763933e-05,0.6666666666666666
20701,범접/Noun,3,2,1,2.2230620456616944e-05,1.1106915165381966e-05,0.6666666666666666
20702,휠체어/Noun,3,1,2,1.1115310228308472e-05,2.2213830330763933e-05,0.6666666666666666
20703,이무기/Noun,3,1,2,1.1115310228308472e-05,2.2213830330763933e-05,0.6666666666666666
20704,클루/Noun,3,1,2,1.1115310228308472e-05,2.2213830330763933e-05,0.6666666666666666
20705,핰/Noun,3,1,2,1.1115310228308472e-05,2.2213830330763933e-05,0.6666666666666666
20706,언노운/Noun,3,1,2,1.1115310228308472e-05,2.2213830330763933e-05,0.6666666666666666
20707,87/Number,3,1,2,1.1115310228308472e-05,2.2213830330763933e-05,0.6666666666666666
20708,총각파티/Noun,3,1,2,1.1115310228308472e-05,2.2213830330763933e-05,0.6666666666666666
20709,메디컬탑팀/Noun,3,2,1,2.2230620456616944e-05,1.1106915165381966e-05,0.6666666666666666
20710,건포도/Noun,3,1,2,1.1115310228308472e-05,2.2213830330763933e-05,0.6666666666666666
20711,이동건/Noun,3,2,1,2.2230620456616944e-05,1.1106915165381966e-05,0.6666666666666666
20712,미스터리물/Noun,3,1,2,1.1115310228308472e-05,2.2213830330763933e-05,0.6666666666666666
20713,지칭/Noun,3,1,2,1.1115310228308472e-05,2.2213830330763933e-05,0.6666666666666666
20714,크라운/Noun,3,1,2,1.1115310228308472e-05,2.2213830330763933e-05,0.6666666666666666
20715,변주곡/Noun,3,2,1,2.2230620456616944e-05,1.1106915165381966e-05,0.6666666666666666
20716,1954년/Number,3,2,1,2.2230620456616944e-05,1.1106915165381966e-05,0.6666666666666666
20717,카메런/Noun,3,2,1,2.2230620456616944e-05,1.1106915165381966e-05,0.6666666666666666
20718,소하/Noun,3,2,1,2.2230620456616944e-05,1.1106915165381966e-05,0.6666666666666666
20719,이러쿵저러쿵/Adverb,3,2,1,2.2230620456616944e-05,1.1106915165381966e-05,0.6666666666666666
20720,친미/Noun,3,1,2,1.1115310228308472e-05,2.2213830330763933e-05,0.6666666666666666
20721,먄/Noun,3,1,2,1.1115310228308472e-05,2.2213830330763933e-05,0.6666666666666666
20722,글쿠/Noun,3,1,2,1.1115310228308472e-05,2.2213830330763933e-05,0.6666666666666666
20723,끌때/Noun,3,1,2,1.1115310228308472e-05,2.2213830330763933e-05,0.6666666666666666
20724,화산폭발/Noun,3,2,1,2.2230620456616944e-05,1.1106915165381966e-05,0.6666666666666666
20725,동창/Noun,3,2,1,2.2230620456616944e-05,1.1106915165381966e-05,0.6666666666666666
20726,코엘료/Noun,3,2,1,2.2230620456616944e-05,1.1106915165381966e-05,0.6666666666666666
20727,터프가이/Noun,3,2,1,2.2230620456616944e-05,1.1106915165381966e-05,0.6666666666666666
20728,투톱/Noun,3,1,2,1.1115310228308472e-05,2.2213830330763933e-05,0.6666666666666666
20729,이휘재/Noun,3,1,2,1.1115310228308472e-05,2.2213830330763933e-05,0.6666666666666666
20730,곤조/Noun,3,2,1,2.2230620456616944e-05,1.1106915165381966e-05,0.6666666666666666
20731,미믹/Noun,3,2,1,2.2230620456616944e-05,1.1106915165381966e-05,0.6666666666666666
20732,과학기술/Noun,3,1,2,1.1115310228308472e-05,2.2213830330763933e-05,0.6666666666666666
20733,초청/Noun,3,1,2,1.1115310228308472e-05,2.2213830330763933e-05,0.6666666666666666
20734,크래쉬/Noun,3,1,2,1.1115310228308472e-05,2.2213830330763933e-05,0.6666666666666666
20735,자못/Noun,3,1,2,1.1115310228308472e-05,2.2213830330763933e-05,0.6666666666666666
20736,할하/Noun,3,1,2,1.1115310228308472e-05,2.2213830330763933e-05,0.6666666666666666
20737,오리진/Noun,3,1,2,1.1115310228308472e-05,2.2213830330763933e-05,0.6666666666666666
20738,곧잘/Noun,3,1,2,1.1115310228308472e-05,2.2213830330763933e-05,0.6666666666666666
20739,을사/Noun,3,1,2,1.1115310228308472e-05,2.2213830330763933e-05,0.6666666666666666
20740,강주희/Noun,3,2,1,2.2230620456616944e-05,1.1106915165381966e-05,0.6666666666666666
20741,배척/Noun,3,2,1,2.2230620456616944e-05,1.1106915165381966e-05,0.6666666666666666
20742,옌/Noun,3,2,1,2.2230620456616944e-05,1.1106915165381966e-05,0.6666666666666666
20743,성격장애/Noun,3,1,2,1.1115310228308472e-05,2.2213830330763933e-05,0.6666666666666666
20744,얘내/Noun,3,2,1,2.2230620456616944e-05,1.1106915165381966e-05,0.6666666666666666
20745,하이에나/Noun,3,1,2,1.1115310228308472e-05,2.2213830330763933e-05,0.6666666666666666
20746,냉동인간/Noun,3,1,2,1.1115310228308472e-05,2.2213830330763933e-05,0.6666666666666666
20747,자애/Noun,3,2,1,2.2230620456616944e-05,1.1106915165381966e-05,0.6666666666666666
20748,모모/Modifier,3,1,2,1.1115310228308472e-05,2.2213830330763933e-05,0.6666666666666666
20749,애애/Noun,3,1,2,1.1115310228308472e-05,2.2213830330763933e-05,0.6666666666666666
20750,"9,000원/Number",3,1,2,1.1115310228308472e-05,2.2213830330763933e-05,0.6666666666666666
20751,굶주림/Noun,3,1,2,1.1115310228308472e-05,2.2213830330763933e-05,0.6666666666666666
20752,ㅌ/KoreanParticle,3,1,2,1.1115310228308472e-05,2.2213830330763933e-05,0.6666666666666666
20753,..~~/Punctuation,3,2,1,2.2230620456616944e-05,1.1106915165381966e-05,0.6666666666666666
20754,자포자기/Noun,3,1,2,1.1115310228308472e-05,2.2213830330763933e-05,0.6666666666666666
20755,페티/Noun,3,2,1,2.2230620456616944e-05,1.1106915165381966e-05,0.6666666666666666
20756,순환선/Noun,3,2,1,2.2230620456616944e-05,1.1106915165381966e-05,0.6666666666666666
20757,건축물/Noun,3,2,1,2.2230620456616944e-05,1.1106915165381966e-05,0.6666666666666666
20758,하나같다/Adjective,3,1,2,1.1115310228308472e-05,2.2213830330763933e-05,0.6666666666666666
20759,맥카시/Noun,3,2,1,2.2230620456616944e-05,1.1106915165381966e-05,0.6666666666666666
20760,8.2/Number,3,2,1,2.2230620456616944e-05,1.1106915165381966e-05,0.6666666666666666
20761,인수/Noun,3,2,1,2.2230620456616944e-05,1.1106915165381966e-05,0.6666666666666666
20762,설립/Noun,3,2,1,2.2230620456616944e-05,1.1106915165381966e-05,0.6666666666666666
20763,김제동/Noun,3,2,1,2.2230620456616944e-05,1.1106915165381966e-05,0.6666666666666666
20764,부르스/Noun,3,1,2,1.1115310228308472e-05,2.2213830330763933e-05,0.6666666666666666
20765,88/Number,3,1,2,1.1115310228308472e-05,2.2213830330763933e-05,0.6666666666666666
20766,선역/Noun,3,1,2,1.1115310228308472e-05,2.2213830330763933e-05,0.6666666666666666
20767,유니콘/Noun,3,1,2,1.1115310228308472e-05,2.2213830330763933e-05,0.6666666666666666
20768,견우/Noun,3,2,1,2.2230620456616944e-05,1.1106915165381966e-05,0.6666666666666666
20769,분닥/Noun,3,2,1,2.2230620456616944e-05,1.1106915165381966e-05,0.6666666666666666
20770,표함/Noun,3,1,2,1.1115310228308472e-05,2.2213830330763933e-05,0.6666666666666666
20771,조아하다/Verb,3,1,2,1.1115310228308472e-05,2.2213830330763933e-05,0.6666666666666666
20772,정창화/Noun,3,1,2,1.1115310228308472e-05,2.2213830330763933e-05,0.6666666666666666
20773,스텔스/Noun,3,1,2,1.1115310228308472e-05,2.2213830330763933e-05,0.6666666666666666
20774,라야/Josa,3,1,2,1.1115310228308472e-05,2.2213830330763933e-05,0.6666666666666666
20775,심지/Noun,3,1,2,1.1115310228308472e-05,2.2213830330763933e-05,0.6666666666666666
20776,환호성/Noun,3,2,1,2.2230620456616944e-05,1.1106915165381966e-05,0.6666666666666666
20777,원전/Noun,3,2,1,2.2230620456616944e-05,1.1106915165381966e-05,0.6666666666666666
20778,변론/Noun,3,2,1,2.2230620456616944e-05,1.1106915165381966e-05,0.6666666666666666
20779,파울/Noun,3,2,1,2.2230620456616944e-05,1.1106915165381966e-05,0.6666666666666666
20780,전문용어/Noun,3,1,2,1.1115310228308472e-05,2.2213830330763933e-05,0.6666666666666666
20781,5천만/Number,3,1,2,1.1115310228308472e-05,2.2213830330763933e-05,0.6666666666666666
20782,홈런/Noun,3,2,1,2.2230620456616944e-05,1.1106915165381966e-05,0.6666666666666666
20783,우크라이나/Noun,3,2,1,2.2230620456616944e-05,1.1106915165381966e-05,0.6666666666666666
20784,쉰/Modifier,3,1,2,1.1115310228308472e-05,2.2213830330763933e-05,0.6666666666666666
20785,2006/Number,3,1,2,1.1115310228308472e-05,2.2213830330763933e-05,0.6666666666666666
20786,IMF/Alpha,3,2,1,2.2230620456616944e-05,1.1106915165381966e-05,0.6666666666666666
20787,결투씬/Noun,3,2,1,2.2230620456616944e-05,1.1106915165381966e-05,0.6666666666666666
20788,트레이닝/Noun,3,1,2,1.1115310228308472e-05,2.2213830330763933e-05,0.6666666666666666
20789,장난스럽다/Adjective,3,1,2,1.1115310228308472e-05,2.2213830330763933e-05,0.6666666666666666
20790,오페/Noun,3,2,1,2.2230620456616944e-05,1.1106915165381966e-05,0.6666666666666666
20791,음질/Noun,3,1,2,1.1115310228308472e-05,2.2213830330763933e-05,0.6666666666666666
20792,셋째/Modifier,3,2,1,2.2230620456616944e-05,1.1106915165381966e-05,0.6666666666666666
20793,과부/Noun,3,2,1,2.2230620456616944e-05,1.1106915165381966e-05,0.6666666666666666
20794,울음소리/Noun,3,2,1,2.2230620456616944e-05,1.1106915165381966e-05,0.6666666666666666
20795,그레픽/Noun,3,1,2,1.1115310228308472e-05,2.2213830330763933e-05,0.6666666666666666
20796,신디사이저/Noun,3,2,1,2.2230620456616944e-05,1.1106915165381966e-05,0.6666666666666666
20797,따발총/Noun,3,1,2,1.1115310228308472e-05,2.2213830330763933e-05,0.6666666666666666
20798,귀인/Noun,3,2,1,2.2230620456616944e-05,1.1106915165381966e-05,0.6666666666666666
20799,헛구역질/Noun,3,1,2,1.1115310228308472e-05,2.2213830330763933e-05,0.6666666666666666
20800,꼴등/Noun,3,1,2,1.1115310228308472e-05,2.2213830330763933e-05,0.6666666666666666
20801,치토/Noun,3,2,1,2.2230620456616944e-05,1.1106915165381966e-05,0.6666666666666666
20802,분수/Noun,3,2,1,2.2230620456616944e-05,1.1106915165381966e-05,0.6666666666666666
20803,피오/Noun,3,2,1,2.2230620456616944e-05,1.1106915165381966e-05,0.6666666666666666
20804,송지나/Noun,3,2,1,2.2230620456616944e-05,1.1106915165381966e-05,0.6666666666666666
20805,죄임/Noun,3,1,2,1.1115310228308472e-05,2.2213830330763933e-05,0.6666666666666666
20806,결사/Noun,3,1,2,1.1115310228308472e-05,2.2213830330763933e-05,0.6666666666666666
20807,첫방송/Noun,3,2,1,2.2230620456616944e-05,1.1106915165381966e-05,0.6666666666666666
20808,귓방맹/Noun,3,1,2,1.1115310228308472e-05,2.2213830330763933e-05,0.6666666666666666
20809,승차/Noun,3,1,2,1.1115310228308472e-05,2.2213830330763933e-05,0.6666666666666666
20810,무임/Noun,3,1,2,1.1115310228308472e-05,2.2213830330763933e-05,0.6666666666666666
20811,빨대/Noun,3,1,2,1.1115310228308472e-05,2.2213830330763933e-05,0.6666666666666666
20812,겨울연가/Noun,3,1,2,1.1115310228308472e-05,2.2213830330763933e-05,0.6666666666666666
20813,안변/Noun,3,1,2,1.1115310228308472e-05,2.2213830330763933e-05,0.6666666666666666
20814,의술/Noun,3,2,1,2.2230620456616944e-05,1.1106915165381966e-05,0.6666666666666666
20815,만지작/Adverb,3,2,1,2.2230620456616944e-05,1.1106915165381966e-05,0.6666666666666666
20816,렵/Noun,3,1,2,1.1115310228308472e-05,2.2213830330763933e-05,0.6666666666666666
20817,보호자/Noun,3,2,1,2.2230620456616944e-05,1.1106915165381966e-05,0.6666666666666666
20818,비포미드나잇/Noun,3,2,1,2.2230620456616944e-05,1.1106915165381966e-05,0.6666666666666666
20819,지원이/Noun,3,1,2,1.1115310228308472e-05,2.2213830330763933e-05,0.6666666666666666
20820,ㅃㅏ/KoreanParticle,3,2,1,2.2230620456616944e-05,1.1106915165381966e-05,0.6666666666666666
20821,미시/Noun,3,1,2,1.1115310228308472e-05,2.2213830330763933e-05,0.6666666666666666
20822,심화/Noun,3,1,2,1.1115310228308472e-05,2.2213830330763933e-05,0.6666666666666666
20823,드웨인존슨/Noun,3,1,2,1.1115310228308472e-05,2.2213830330763933e-05,0.6666666666666666
20824,티비영화/Noun,3,1,2,1.1115310228308472e-05,2.2213830330763933e-05,0.6666666666666666
20825,예배/Noun,3,2,1,2.2230620456616944e-05,1.1106915165381966e-05,0.6666666666666666
20826,공기인형/Noun,3,1,2,1.1115310228308472e-05,2.2213830330763933e-05,0.6666666666666666
20827,후쿠/Noun,3,1,2,1.1115310228308472e-05,2.2213830330763933e-05,0.6666666666666666
20828,-?/Punctuation,3,1,2,1.1115310228308472e-05,2.2213830330763933e-05,0.6666666666666666
20829,얘쁘/Noun,3,2,1,2.2230620456616944e-05,1.1106915165381966e-05,0.6666666666666666
20830,뿜어져/Noun,3,2,1,2.2230620456616944e-05,1.1106915165381966e-05,0.6666666666666666
20831,장금/Noun,3,2,1,2.2230620456616944e-05,1.1106915165381966e-05,0.6666666666666666
20832,범블비/Noun,3,1,2,1.1115310228308472e-05,2.2213830330763933e-05,0.6666666666666666
20833,거스/Noun,3,1,2,1.1115310228308472e-05,2.2213830330763933e-05,0.6666666666666666
20834,어데/Noun,3,1,2,1.1115310228308472e-05,2.2213830330763933e-05,0.6666666666666666
20835,연변/Noun,3,1,2,1.1115310228308472e-05,2.2213830330763933e-05,0.6666666666666666
20836,카아/Noun,3,1,2,1.1115310228308472e-05,2.2213830330763933e-05,0.6666666666666666
20837,부서/Noun,3,1,2,1.1115310228308472e-05,2.2213830330763933e-05,0.6666666666666666
20838,키치/Noun,3,1,2,1.1115310228308472e-05,2.2213830330763933e-05,0.6666666666666666
20839,ㅌㅌㅌ/KoreanParticle,3,1,2,1.1115310228308472e-05,2.2213830330763933e-05,0.6666666666666666
20840,황금박쥐/Noun,3,2,1,2.2230620456616944e-05,1.1106915165381966e-05,0.6666666666666666
20841,강민/Noun,3,1,2,1.1115310228308472e-05,2.2213830330763933e-05,0.6666666666666666
20842,심술/Noun,3,1,2,1.1115310228308472e-05,2.2213830330763933e-05,0.6666666666666666
20843,200분/Number,3,1,2,1.1115310228308472e-05,2.2213830330763933e-05,0.6666666666666666
20844,자결/Noun,3,2,1,2.2230620456616944e-05,1.1106915165381966e-05,0.6666666666666666
20845,공룡대탐험/Noun,3,2,1,2.2230620456616944e-05,1.1106915165381966e-05,0.6666666666666666
20846,헉헉/Adverb,3,2,1,2.2230620456616944e-05,1.1106915165381966e-05,0.6666666666666666
20847,리릭/Noun,3,1,2,1.1115310228308472e-05,2.2213830330763933e-05,0.6666666666666666
20848,개편/Noun,3,1,2,1.1115310228308472e-05,2.2213830330763933e-05,0.6666666666666666
20849,때껏/Noun,3,2,1,2.2230620456616944e-05,1.1106915165381966e-05,0.6666666666666666
20850,조용조/Noun,3,2,1,2.2230620456616944e-05,1.1106915165381966e-05,0.6666666666666666
20851,백일섭/Noun,3,2,1,2.2230620456616944e-05,1.1106915165381966e-05,0.6666666666666666
20852,상대역/Noun,3,1,2,1.1115310228308472e-05,2.2213830330763933e-05,0.6666666666666666
20853,건장하다/Adjective,3,1,2,1.1115310228308472e-05,2.2213830330763933e-05,0.6666666666666666
20854,증세/Noun,3,1,2,1.1115310228308472e-05,2.2213830330763933e-05,0.6666666666666666
20855,잘생겻어/Noun,3,2,1,2.2230620456616944e-05,1.1106915165381966e-05,0.6666666666666666
20856,해령/Noun,3,1,2,1.1115310228308472e-05,2.2213830330763933e-05,0.6666666666666666
20857,민재/Noun,3,1,2,1.1115310228308472e-05,2.2213830330763933e-05,0.6666666666666666
20858,라따뚜이/Noun,3,2,1,2.2230620456616944e-05,1.1106915165381966e-05,0.6666666666666666
20859,팩/Noun,3,1,2,1.1115310228308472e-05,2.2213830330763933e-05,0.6666666666666666
20860,경제학자/Noun,3,2,1,2.2230620456616944e-05,1.1106915165381966e-05,0.6666666666666666
20861,비도덕적/Noun,3,1,2,1.1115310228308472e-05,2.2213830330763933e-05,0.6666666666666666
20862,스즈키/Noun,3,2,1,2.2230620456616944e-05,1.1106915165381966e-05,0.6666666666666666
20863,비관/Noun,3,2,1,2.2230620456616944e-05,1.1106915165381966e-05,0.6666666666666666
20864,마마도/Noun,3,1,2,1.1115310228308472e-05,2.2213830330763933e-05,0.6666666666666666
20865,Made/Alpha,3,1,2,1.1115310228308472e-05,2.2213830330763933e-05,0.6666666666666666
20866,샬/Noun,3,2,1,2.2230620456616944e-05,1.1106915165381966e-05,0.6666666666666666
20867,함은정/Noun,3,1,2,1.1115310228308472e-05,2.2213830330763933e-05,0.6666666666666666
20868,도에는/Foreign,3,2,1,2.2230620456616944e-05,1.1106915165381966e-05,0.6666666666666666
20869,고령화/Noun,3,2,1,2.2230620456616944e-05,1.1106915165381966e-05,0.6666666666666666
20870,행군/Noun,3,1,2,1.1115310228308472e-05,2.2213830330763933e-05,0.6666666666666666
20871,서언/Noun,3,2,1,2.2230620456616944e-05,1.1106915165381966e-05,0.6666666666666666
20872,고별/Noun,3,1,2,1.1115310228308472e-05,2.2213830330763933e-05,0.6666666666666666
20873,똥찬/Noun,3,1,2,1.1115310228308472e-05,2.2213830330763933e-05,0.6666666666666666
20874,민족성/Noun,3,2,1,2.2230620456616944e-05,1.1106915165381966e-05,0.6666666666666666
20875,업주/Noun,3,2,1,2.2230620456616944e-05,1.1106915165381966e-05,0.6666666666666666
20876,*.*/Punctuation,3,2,1,2.2230620456616944e-05,1.1106915165381966e-05,0.6666666666666666
20877,김흥국/Noun,3,1,2,1.1115310228308472e-05,2.2213830330763933e-05,0.6666666666666666
20878,컷던/Noun,3,1,2,1.1115310228308472e-05,2.2213830330763933e-05,0.6666666666666666
20879,남자사용설명서/Noun,3,1,2,1.1115310228308472e-05,2.2213830330763933e-05,0.6666666666666666
20880,찟/Noun,3,2,1,2.2230620456616944e-05,1.1106915165381966e-05,0.6666666666666666
20881,짐꾼/Noun,3,2,1,2.2230620456616944e-05,1.1106915165381966e-05,0.6666666666666666
20882,황정/Noun,3,2,1,2.2230620456616944e-05,1.1106915165381966e-05,0.6666666666666666
20883,하용/Noun,3,1,2,1.1115310228308472e-05,2.2213830330763933e-05,0.6666666666666666
20884,별룬데/Noun,3,2,1,2.2230620456616944e-05,1.1106915165381966e-05,0.6666666666666666
20885,항일/Noun,3,1,2,1.1115310228308472e-05,2.2213830330763933e-05,0.6666666666666666
20886,카리/Noun,3,1,2,1.1115310228308472e-05,2.2213830330763933e-05,0.6666666666666666
20887,토박이/Noun,3,1,2,1.1115310228308472e-05,2.2213830330763933e-05,0.6666666666666666
20888,티비엔/Noun,3,2,1,2.2230620456616944e-05,1.1106915165381966e-05,0.6666666666666666
20889,깟/Modifier,3,2,1,2.2230620456616944e-05,1.1106915165381966e-05,0.6666666666666666
20890,저쩌구/Noun,3,1,2,1.1115310228308472e-05,2.2213830330763933e-05,0.6666666666666666
20891,타쿠미/Noun,3,1,2,1.1115310228308472e-05,2.2213830330763933e-05,0.6666666666666666
20892,yo/Alpha,3,1,2,1.1115310228308472e-05,2.2213830330763933e-05,0.6666666666666666
20893,하관/Noun,3,2,1,2.2230620456616944e-05,1.1106915165381966e-05,0.6666666666666666
20894,무명시절/Noun,3,2,1,2.2230620456616944e-05,1.1106915165381966e-05,0.6666666666666666
20895,쫓겨나다/Verb,3,1,2,1.1115310228308472e-05,2.2213830330763933e-05,0.6666666666666666
20896,불가사의하다/Adjective,3,2,1,2.2230620456616944e-05,1.1106915165381966e-05,0.6666666666666666
20897,발랑/Noun,3,1,2,1.1115310228308472e-05,2.2213830330763933e-05,0.6666666666666666
20898,영구시/Noun,3,2,1,2.2230620456616944e-05,1.1106915165381966e-05,0.6666666666666666
20899,곡선/Noun,3,2,1,2.2230620456616944e-05,1.1106915165381966e-05,0.6666666666666666
20900,욱일기/Noun,3,1,2,1.1115310228308472e-05,2.2213830330763933e-05,0.6666666666666666
20901,산지/Noun,3,2,1,2.2230620456616944e-05,1.1106915165381966e-05,0.6666666666666666
20902,빛바/Noun,3,1,2,1.1115310228308472e-05,2.2213830330763933e-05,0.6666666666666666
20903,생기발랄하다/Adjective,3,2,1,2.2230620456616944e-05,1.1106915165381966e-05,0.6666666666666666
20904,비정/Noun,3,1,2,1.1115310228308472e-05,2.2213830330763933e-05,0.6666666666666666
20905,지보면/Noun,3,1,2,1.1115310228308472e-05,2.2213830330763933e-05,0.6666666666666666
20906,보이드/Noun,3,2,1,2.2230620456616944e-05,1.1106915165381966e-05,0.6666666666666666
20907,_=/Punctuation,3,1,2,1.1115310228308472e-05,2.2213830330763933e-05,0.6666666666666666
20908,탕진/Noun,3,1,2,1.1115310228308472e-05,2.2213830330763933e-05,0.6666666666666666
20909,노역/Noun,3,1,2,1.1115310228308472e-05,2.2213830330763933e-05,0.6666666666666666
20910,박종훈/Noun,3,1,2,1.1115310228308472e-05,2.2213830330763933e-05,0.6666666666666666
20911,탑블/Noun,3,1,2,1.1115310228308472e-05,2.2213830330763933e-05,0.6666666666666666
20912,위대/Noun,3,1,2,1.1115310228308472e-05,2.2213830330763933e-05,0.6666666666666666
20913,성정체성/Noun,3,1,2,1.1115310228308472e-05,2.2213830330763933e-05,0.6666666666666666
20914,해기스/Noun,3,2,1,2.2230620456616944e-05,1.1106915165381966e-05,0.6666666666666666
20915,득실대다/Verb,3,2,1,2.2230620456616944e-05,1.1106915165381966e-05,0.6666666666666666
20916,3.8/Number,3,1,2,1.1115310228308472e-05,2.2213830330763933e-05,0.6666666666666666
20917,의연하다/Adjective,3,2,1,2.2230620456616944e-05,1.1106915165381966e-05,0.6666666666666666
20918,개띠껍/Noun,3,1,2,1.1115310228308472e-05,2.2213830330763933e-05,0.6666666666666666
20919,하석진/Noun,3,1,2,1.1115310228308472e-05,2.2213830330763933e-05,0.6666666666666666
20920,나잇스탠드/Noun,3,1,2,1.1115310228308472e-05,2.2213830330763933e-05,0.6666666666666666
20921,dog/Alpha,3,1,2,1.1115310228308472e-05,2.2213830330763933e-05,0.6666666666666666
20922,송곳니/Noun,3,1,2,1.1115310228308472e-05,2.2213830330763933e-05,0.6666666666666666
20923,스윙걸즈/Noun,3,2,1,2.2230620456616944e-05,1.1106915165381966e-05,0.6666666666666666
20924,오연수/Noun,3,2,1,2.2230620456616944e-05,1.1106915165381966e-05,0.6666666666666666
20925,보물찾기/Noun,3,1,2,1.1115310228308472e-05,2.2213830330763933e-05,0.6666666666666666
20926,게린/Noun,3,2,1,2.2230620456616944e-05,1.1106915165381966e-05,0.6666666666666666
20927,이영하/Noun,3,1,2,1.1115310228308472e-05,2.2213830330763933e-05,0.6666666666666666
20928,스텔라/Noun,3,2,1,2.2230620456616944e-05,1.1106915165381966e-05,0.6666666666666666
20929,피살/Noun,3,1,2,1.1115310228308472e-05,2.2213830330763933e-05,0.6666666666666666
20930,아이리쉬/Noun,3,2,1,2.2230620456616944e-05,1.1106915165381966e-05,0.6666666666666666
20931,영계/Noun,3,2,1,2.2230620456616944e-05,1.1106915165381966e-05,0.6666666666666666
20932,기분좋은날/Noun,3,2,1,2.2230620456616944e-05,1.1106915165381966e-05,0.6666666666666666
20933,사방/Noun,3,1,2,1.1115310228308472e-05,2.2213830330763933e-05,0.6666666666666666
20934,김창환/Noun,3,2,1,2.2230620456616944e-05,1.1106915165381966e-05,0.6666666666666666
20935,병인/Noun,3,2,1,2.2230620456616944e-05,1.1106915165381966e-05,0.6666666666666666
20936,대장군/Noun,3,2,1,2.2230620456616944e-05,1.1106915165381966e-05,0.6666666666666666
20937,스케이트/Noun,3,2,1,2.2230620456616944e-05,1.1106915165381966e-05,0.6666666666666666
20938,협객/Noun,3,1,2,1.1115310228308472e-05,2.2213830330763933e-05,0.6666666666666666
20939,벌판/Noun,3,1,2,1.1115310228308472e-05,2.2213830330763933e-05,0.6666666666666666
20940,바이올렛/Noun,3,1,2,1.1115310228308472e-05,2.2213830330763933e-05,0.6666666666666666
20941,혈연/Noun,3,2,1,2.2230620456616944e-05,1.1106915165381966e-05,0.6666666666666666
20942,슝다이린/Noun,3,2,1,2.2230620456616944e-05,1.1106915165381966e-05,0.6666666666666666
20943,연두/Noun,3,1,2,1.1115310228308472e-05,2.2213830330763933e-05,0.6666666666666666
20944,타임즈/Noun,3,2,1,2.2230620456616944e-05,1.1106915165381966e-05,0.6666666666666666
20945,플린트/Noun,3,2,1,2.2230620456616944e-05,1.1106915165381966e-05,0.6666666666666666
20946,숨가쁘다/Adjective,3,1,2,1.1115310228308472e-05,2.2213830330763933e-05,0.6666666666666666
20947,45/Number,3,1,2,1.1115310228308472e-05,2.2213830330763933e-05,0.6666666666666666
20948,관리자/Noun,3,2,1,2.2230620456616944e-05,1.1106915165381966e-05,0.6666666666666666
20949,대발/Noun,3,2,1,2.2230620456616944e-05,1.1106915165381966e-05,0.6666666666666666
20950,사우나/Noun,3,1,2,1.1115310228308472e-05,2.2213830330763933e-05,0.6666666666666666
20951,입니다/Foreign,3,1,2,1.1115310228308472e-05,2.2213830330763933e-05,0.6666666666666666
20952,이성계/Noun,3,2,1,2.2230620456616944e-05,1.1106915165381966e-05,0.6666666666666666
20953,무선/Noun,3,1,2,1.1115310228308472e-05,2.2213830330763933e-05,0.6666666666666666
20954,(..)/Punctuation,3,1,2,1.1115310228308472e-05,2.2213830330763933e-05,0.6666666666666666
20955,때마침/Noun,3,1,2,1.1115310228308472e-05,2.2213830330763933e-05,0.6666666666666666
20956,뽀얗다/Adjective,3,2,1,2.2230620456616944e-05,1.1106915165381966e-05,0.6666666666666666
20957,-../Punctuation,3,1,2,1.1115310228308472e-05,2.2213830330763933e-05,0.6666666666666666
20958,간절/Noun,3,1,2,1.1115310228308472e-05,2.2213830330763933e-05,0.6666666666666666
20959,시에나/Noun,3,1,2,1.1115310228308472e-05,2.2213830330763933e-05,0.6666666666666666
20960,면도칼/Noun,3,1,2,1.1115310228308472e-05,2.2213830330763933e-05,0.6666666666666666
20961,........................../Punctuation,3,1,2,1.1115310228308472e-05,2.2213830330763933e-05,0.6666666666666666
20962,한세상/Noun,3,2,1,2.2230620456616944e-05,1.1106915165381966e-05,0.6666666666666666
20963,젛/Noun,3,2,1,2.2230620456616944e-05,1.1106915165381966e-05,0.6666666666666666
20964,84분/Number,3,1,2,1.1115310228308472e-05,2.2213830330763933e-05,0.6666666666666666
20965,끝날떄/Noun,3,1,2,1.1115310228308472e-05,2.2213830330763933e-05,0.6666666666666666
20966,신시티/Noun,3,1,2,1.1115310228308472e-05,2.2213830330763933e-05,0.6666666666666666
20967,안간힘/Noun,3,1,2,1.1115310228308472e-05,2.2213830330763933e-05,0.6666666666666666
20968,하얀거탑/Noun,3,2,1,2.2230620456616944e-05,1.1106915165381966e-05,0.6666666666666666
20969,1조/Number,3,2,1,2.2230620456616944e-05,1.1106915165381966e-05,0.6666666666666666
20970,혈전/Noun,3,2,1,2.2230620456616944e-05,1.1106915165381966e-05,0.6666666666666666
20971,Go/Alpha,3,2,1,2.2230620456616944e-05,1.1106915165381966e-05,0.6666666666666666
20972,최홍만/Noun,3,1,2,1.1115310228308472e-05,2.2213830330763933e-05,0.6666666666666666
20973,숴/Noun,3,1,2,1.1115310228308472e-05,2.2213830330763933e-05,0.6666666666666666
20974,천신만고/Noun,3,1,2,1.1115310228308472e-05,2.2213830330763933e-05,0.6666666666666666
20975,청취/Noun,3,1,2,1.1115310228308472e-05,2.2213830330763933e-05,0.6666666666666666
20976,독고영재/Noun,3,2,1,2.2230620456616944e-05,1.1106915165381966e-05,0.6666666666666666
20977,전망/Noun,3,2,1,2.2230620456616944e-05,1.1106915165381966e-05,0.6666666666666666
20978,글코/Noun,3,1,2,1.1115310228308472e-05,2.2213830330763933e-05,0.6666666666666666
20979,123456789/Number,3,2,1,2.2230620456616944e-05,1.1106915165381966e-05,0.6666666666666666
20980,피구왕통키/Noun,3,1,2,1.1115310228308472e-05,2.2213830330763933e-05,0.6666666666666666
20981,장로/Noun,3,2,1,2.2230620456616944e-05,1.1106915165381966e-05,0.6666666666666666
20982,도면/Noun,3,2,1,2.2230620456616944e-05,1.1106915165381966e-05,0.6666666666666666
20983,트랜스젠더/Noun,3,1,2,1.1115310228308472e-05,2.2213830330763933e-05,0.6666666666666666
20984,언론인/Noun,3,2,1,2.2230620456616944e-05,1.1106915165381966e-05,0.6666666666666666
20985,曰/Foreign,3,1,2,1.1115310228308472e-05,2.2213830330763933e-05,0.6666666666666666
20986,코리/Noun,3,2,1,2.2230620456616944e-05,1.1106915165381966e-05,0.6666666666666666
20987,흣/Noun,3,2,1,2.2230620456616944e-05,1.1106915165381966e-05,0.6666666666666666
20988,고무/Noun,3,2,1,2.2230620456616944e-05,1.1106915165381966e-05,0.6666666666666666
20989,동네형/Noun,3,1,2,1.1115310228308472e-05,2.2213830330763933e-05,0.6666666666666666
20990,멧/Noun,3,2,1,2.2230620456616944e-05,1.1106915165381966e-05,0.6666666666666666
20991,장자/Noun,3,2,1,2.2230620456616944e-05,1.1106915165381966e-05,0.6666666666666666
20992,이라니/Foreign,3,1,2,1.1115310228308472e-05,2.2213830330763933e-05,0.6666666666666666
20993,불알/Noun,3,1,2,1.1115310228308472e-05,2.2213830330763933e-05,0.6666666666666666
20994,웃겻음/Noun,3,2,1,2.2230620456616944e-05,1.1106915165381966e-05,0.6666666666666666
20995,부술/Noun,3,1,2,1.1115310228308472e-05,2.2213830330763933e-05,0.6666666666666666
20996,이햐/Noun,3,2,1,2.2230620456616944e-05,1.1106915165381966e-05,0.6666666666666666
20997,숀코넬리/Noun,3,2,1,2.2230620456616944e-05,1.1106915165381966e-05,0.6666666666666666
20998,업데이트/Noun,3,2,1,2.2230620456616944e-05,1.1106915165381966e-05,0.6666666666666666
20999,731/Number,3,1,2,1.1115310228308472e-05,2.2213830330763933e-05,0.6666666666666666
21000,일변도/Noun,3,1,2,1.1115310228308472e-05,2.2213830330763933e-05,0.6666666666666666
21001,동창회/Noun,3,2,1,2.2230620456616944e-05,1.1106915165381966e-05,0.6666666666666666
21002,장작/Noun,3,1,2,1.1115310228308472e-05,2.2213830330763933e-05,0.6666666666666666
21003,참새/Noun,3,1,2,1.1115310228308472e-05,2.2213830330763933e-05,0.6666666666666666
21004,이해영/Noun,3,2,1,2.2230620456616944e-05,1.1106915165381966e-05,0.6666666666666666
21005,자칼/Noun,3,2,1,2.2230620456616944e-05,1.1106915165381966e-05,0.6666666666666666
21006,정향/Noun,3,1,2,1.1115310228308472e-05,2.2213830330763933e-05,0.6666666666666666
21007,개줌/Noun,3,1,2,1.1115310228308472e-05,2.2213830330763933e-05,0.6666666666666666
21008,랄랄라/Adverb,3,2,1,2.2230620456616944e-05,1.1106915165381966e-05,0.6666666666666666
21009,테크/Noun,3,1,2,1.1115310228308472e-05,2.2213830330763933e-05,0.6666666666666666
21010,김소희/Noun,3,2,1,2.2230620456616944e-05,1.1106915165381966e-05,0.6666666666666666
21011,따른/Modifier,3,2,1,2.2230620456616944e-05,1.1106915165381966e-05,0.6666666666666666
21012,펄프픽션/Noun,3,1,2,1.1115310228308472e-05,2.2213830330763933e-05,0.6666666666666666
21013,소나티네/Noun,3,2,1,2.2230620456616944e-05,1.1106915165381966e-05,0.6666666666666666
21014,장준환/Noun,3,2,1,2.2230620456616944e-05,1.1106915165381966e-05,0.6666666666666666
21015,설특집/Noun,3,1,2,1.1115310228308472e-05,2.2213830330763933e-05,0.6666666666666666
21016,법조/Noun,3,2,1,2.2230620456616944e-05,1.1106915165381966e-05,0.6666666666666666
21017,빈민/Noun,3,1,2,1.1115310228308472e-05,2.2213830330763933e-05,0.6666666666666666
21018,광팬임/Noun,3,2,1,2.2230620456616944e-05,1.1106915165381966e-05,0.6666666666666666
21019,장동직/Noun,3,1,2,1.1115310228308472e-05,2.2213830330763933e-05,0.6666666666666666
21020,오스틴파워/Noun,3,1,2,1.1115310228308472e-05,2.2213830330763933e-05,0.6666666666666666
21021,남학생/Noun,3,1,2,1.1115310228308472e-05,2.2213830330763933e-05,0.6666666666666666
21022,풀림/Noun,3,2,1,2.2230620456616944e-05,1.1106915165381966e-05,0.6666666666666666
21023,공중전화/Noun,3,2,1,2.2230620456616944e-05,1.1106915165381966e-05,0.6666666666666666
21024,역사교육/Noun,3,1,2,1.1115310228308472e-05,2.2213830330763933e-05,0.6666666666666666
21025,)-/Punctuation,3,1,2,1.1115310228308472e-05,2.2213830330763933e-05,0.6666666666666666
21026,멘탈리스트/Noun,3,1,2,1.1115310228308472e-05,2.2213830330763933e-05,0.6666666666666666
21027,주임/Noun,3,1,2,1.1115310228308472e-05,2.2213830330763933e-05,0.6666666666666666
21028,오태경/Noun,3,1,2,1.1115310228308472e-05,2.2213830330763933e-05,0.6666666666666666
21029,팰트/Noun,3,2,1,2.2230620456616944e-05,1.1106915165381966e-05,0.6666666666666666
21030,야시/Noun,3,1,2,1.1115310228308472e-05,2.2213830330763933e-05,0.6666666666666666
21031,떼돈/Noun,3,1,2,1.1115310228308472e-05,2.2213830330763933e-05,0.6666666666666666
21032,지나고/Foreign,3,1,2,1.1115310228308472e-05,2.2213830330763933e-05,0.6666666666666666
21033,융통성/Noun,3,1,2,1.1115310228308472e-05,2.2213830330763933e-05,0.6666666666666666
21034,가내/Noun,3,2,1,2.2230620456616944e-05,1.1106915165381966e-05,0.6666666666666666
21035,얜/Noun,3,1,2,1.1115310228308472e-05,2.2213830330763933e-05,0.6666666666666666
21036,사회자/Noun,3,1,2,1.1115310228308472e-05,2.2213830330763933e-05,0.6666666666666666
21037,장례/Noun,3,2,1,2.2230620456616944e-05,1.1106915165381966e-05,0.6666666666666666
21038,박성광/Noun,3,1,2,1.1115310228308472e-05,2.2213830330763933e-05,0.6666666666666666
21039,??^^/Punctuation,3,2,1,2.2230620456616944e-05,1.1106915165381966e-05,0.6666666666666666
21040,틴탑/Noun,3,1,2,1.1115310228308472e-05,2.2213830330763933e-05,0.6666666666666666
21041,태종/Noun,3,2,1,2.2230620456616944e-05,1.1106915165381966e-05,0.6666666666666666
21042,허이재/Noun,3,2,1,2.2230620456616944e-05,1.1106915165381966e-05,0.6666666666666666
21043,럭셔리/Noun,3,1,2,1.1115310228308472e-05,2.2213830330763933e-05,0.6666666666666666
21044,또르르/Noun,3,1,2,1.1115310228308472e-05,2.2213830330763933e-05,0.6666666666666666
21045,이내/Foreign,3,2,1,2.2230620456616944e-05,1.1106915165381966e-05,0.6666666666666666
21046,바랫/Noun,3,2,1,2.2230620456616944e-05,1.1106915165381966e-05,0.6666666666666666
21047,의개/Noun,3,2,1,2.2230620456616944e-05,1.1106915165381966e-05,0.6666666666666666
21048,응어리/Noun,3,2,1,2.2230620456616944e-05,1.1106915165381966e-05,0.6666666666666666
21049,say/Alpha,3,2,1,2.2230620456616944e-05,1.1106915165381966e-05,0.6666666666666666
21050,미수/Noun,3,1,2,1.1115310228308472e-05,2.2213830330763933e-05,0.6666666666666666
21051,황신/Noun,3,1,2,1.1115310228308472e-05,2.2213830330763933e-05,0.6666666666666666
21052,하멜/Noun,3,1,2,1.1115310228308472e-05,2.2213830330763933e-05,0.6666666666666666
21053,짧게하다/Adjective,3,2,1,2.2230620456616944e-05,1.1106915165381966e-05,0.6666666666666666
21054,불로장생/Noun,3,2,1,2.2230620456616944e-05,1.1106915165381966e-05,0.6666666666666666
21055,씽/Noun,3,2,1,2.2230620456616944e-05,1.1106915165381966e-05,0.6666666666666666
21056,투윅스/Noun,3,2,1,2.2230620456616944e-05,1.1106915165381966e-05,0.6666666666666666
21057,된장찌개/Noun,3,1,2,1.1115310228308472e-05,2.2213830330763933e-05,0.6666666666666666
21058,건너오다/Verb,3,1,2,1.1115310228308472e-05,2.2213830330763933e-05,0.6666666666666666
21059,극성/Noun,3,1,2,1.1115310228308472e-05,2.2213830330763933e-05,0.6666666666666666
21060,문신/Noun,3,1,2,1.1115310228308472e-05,2.2213830330763933e-05,0.6666666666666666
21061,마따나/Josa,3,1,2,1.1115310228308472e-05,2.2213830330763933e-05,0.6666666666666666
21062,단축/Noun,3,1,2,1.1115310228308472e-05,2.2213830330763933e-05,0.6666666666666666
21063,여덟/Determiner,3,2,1,2.2230620456616944e-05,1.1106915165381966e-05,0.6666666666666666
21064,1985년/Number,3,1,2,1.1115310228308472e-05,2.2213830330763933e-05,0.6666666666666666
21065,꾸벅꾸벅/Adverb,3,1,2,1.1115310228308472e-05,2.2213830330763933e-05,0.6666666666666666
21066,둘째/Modifier,3,1,2,1.1115310228308472e-05,2.2213830330763933e-05,0.6666666666666666
21067,팔지/Noun,3,2,1,2.2230620456616944e-05,1.1106915165381966e-05,0.6666666666666666
21068,노가리/Noun,3,1,2,1.1115310228308472e-05,2.2213830330763933e-05,0.6666666666666666
21069,세간/Noun,3,1,2,1.1115310228308472e-05,2.2213830330763933e-05,0.6666666666666666
21070,샘플/Noun,3,1,2,1.1115310228308472e-05,2.2213830330763933e-05,0.6666666666666666
21071,김재규/Noun,3,1,2,1.1115310228308472e-05,2.2213830330763933e-05,0.6666666666666666
21072,제프리/Noun,3,2,1,2.2230620456616944e-05,1.1106915165381966e-05,0.6666666666666666
21073,쇼헤이/Noun,3,2,1,2.2230620456616944e-05,1.1106915165381966e-05,0.6666666666666666
21074,~~~~!!/Punctuation,3,2,1,2.2230620456616944e-05,1.1106915165381966e-05,0.6666666666666666
21075,고산/Noun,3,2,1,2.2230620456616944e-05,1.1106915165381966e-05,0.6666666666666666
21076,????????????/Punctuation,3,2,1,2.2230620456616944e-05,1.1106915165381966e-05,0.6666666666666666
21077,버섯/Noun,3,1,2,1.1115310228308472e-05,2.2213830330763933e-05,0.6666666666666666
21078,문물/Noun,3,1,2,1.1115310228308472e-05,2.2213830330763933e-05,0.6666666666666666
21079,이또/Noun,3,2,1,2.2230620456616944e-05,1.1106915165381966e-05,0.6666666666666666
21080,주목할만하다/Adjective,3,2,1,2.2230620456616944e-05,1.1106915165381966e-05,0.6666666666666666
21081,배꼇다/Noun,3,1,2,1.1115310228308472e-05,2.2213830330763933e-05,0.6666666666666666
21082,오류로/Noun,3,1,2,1.1115310228308472e-05,2.2213830330763933e-05,0.6666666666666666
21083,김장/Noun,3,2,1,2.2230620456616944e-05,1.1106915165381966e-05,0.6666666666666666
21084,저스티스리그/Noun,3,2,1,2.2230620456616944e-05,1.1106915165381966e-05,0.6666666666666666
21085,아들내미/Noun,3,1,2,1.1115310228308472e-05,2.2213830330763933e-05,0.6666666666666666
21086,중량/Noun,3,2,1,2.2230620456616944e-05,1.1106915165381966e-05,0.6666666666666666
21087,파견/Noun,3,1,2,1.1115310228308472e-05,2.2213830330763933e-05,0.6666666666666666
21088,렛잇고/Noun,3,2,1,2.2230620456616944e-05,1.1106915165381966e-05,0.6666666666666666
21089,유즈/Noun,3,2,1,2.2230620456616944e-05,1.1106915165381966e-05,0.6666666666666666
21090,왕의남자/Noun,3,2,1,2.2230620456616944e-05,1.1106915165381966e-05,0.6666666666666666
21091,98/Number,3,1,2,1.1115310228308472e-05,2.2213830330763933e-05,0.6666666666666666
21092,바둑이/Noun,3,1,2,1.1115310228308472e-05,2.2213830330763933e-05,0.6666666666666666
21093,>.../Punctuation,3,2,1,2.2230620456616944e-05,1.1106915165381966e-05,0.6666666666666666
21094,도를/Foreign,3,2,1,2.2230620456616944e-05,1.1106915165381966e-05,0.6666666666666666
21095,블리치/Noun,3,2,1,2.2230620456616944e-05,1.1106915165381966e-05,0.6666666666666666
21096,방심하다/Adjective,3,2,1,2.2230620456616944e-05,1.1106915165381966e-05,0.6666666666666666
21097,숙모/Noun,3,1,2,1.1115310228308472e-05,2.2213830330763933e-05,0.6666666666666666
21098,스파크/Noun,3,2,1,2.2230620456616944e-05,1.1106915165381966e-05,0.6666666666666666
21099,었/PreEomi,3,2,1,2.2230620456616944e-05,1.1106915165381966e-05,0.6666666666666666
21100,깽판/Noun,3,1,2,1.1115310228308472e-05,2.2213830330763933e-05,0.6666666666666666
21101,민씨/Noun,3,1,2,1.1115310228308472e-05,2.2213830330763933e-05,0.6666666666666666
21102,택해/Noun,3,1,2,1.1115310228308472e-05,2.2213830330763933e-05,0.6666666666666666
21103,바스터즈/Noun,3,1,2,1.1115310228308472e-05,2.2213830330763933e-05,0.6666666666666666
21104,간섭/Noun,3,1,2,1.1115310228308472e-05,2.2213830330763933e-05,0.6666666666666666
21105,더랬/Noun,3,1,2,1.1115310228308472e-05,2.2213830330763933e-05,0.6666666666666666
21106,벽지/Noun,3,2,1,2.2230620456616944e-05,1.1106915165381966e-05,0.6666666666666666
21107,치료받다/Verb,3,1,2,1.1115310228308472e-05,2.2213830330763933e-05,0.6666666666666666
21108,허트로커/Noun,3,2,1,2.2230620456616944e-05,1.1106915165381966e-05,0.6666666666666666
21109,강예빈/Noun,3,2,1,2.2230620456616944e-05,1.1106915165381966e-05,0.6666666666666666
21110,강릉/Noun,3,2,1,2.2230620456616944e-05,1.1106915165381966e-05,0.6666666666666666
21111,낚인거/Noun,3,1,2,1.1115310228308472e-05,2.2213830330763933e-05,0.6666666666666666
21112,메가트론/Noun,3,1,2,1.1115310228308472e-05,2.2213830330763933e-05,0.6666666666666666
21113,연모/Noun,3,2,1,2.2230620456616944e-05,1.1106915165381966e-05,0.6666666666666666
21114,동아시아/Noun,3,1,2,1.1115310228308472e-05,2.2213830330763933e-05,0.6666666666666666
21115,렸다/Noun,3,1,2,1.1115310228308472e-05,2.2213830330763933e-05,0.6666666666666666
21116,장만/Noun,3,1,2,1.1115310228308472e-05,2.2213830330763933e-05,0.6666666666666666
21117,소질/Noun,3,2,1,2.2230620456616944e-05,1.1106915165381966e-05,0.6666666666666666
21118,무법/Noun,3,1,2,1.1115310228308472e-05,2.2213830330763933e-05,0.6666666666666666
21119,더크/Noun,3,1,2,1.1115310228308472e-05,2.2213830330763933e-05,0.6666666666666666
21120,???//Punctuation,3,1,2,1.1115310228308472e-05,2.2213830330763933e-05,0.6666666666666666
21121,도속/Noun,3,2,1,2.2230620456616944e-05,1.1106915165381966e-05,0.6666666666666666
21122,관방/Noun,3,1,2,1.1115310228308472e-05,2.2213830330763933e-05,0.6666666666666666
21123,미그기/Noun,3,1,2,1.1115310228308472e-05,2.2213830330763933e-05,0.6666666666666666
21124,어뜩하다/Adjective,3,2,1,2.2230620456616944e-05,1.1106915165381966e-05,0.6666666666666666
21125,오창민/Noun,3,2,1,2.2230620456616944e-05,1.1106915165381966e-05,0.6666666666666666
21126,씩이나/Foreign,3,1,2,1.1115310228308472e-05,2.2213830330763933e-05,0.6666666666666666
21127,날아오르다/Verb,3,2,1,2.2230620456616944e-05,1.1106915165381966e-05,0.6666666666666666
21128,겉보기/Noun,3,2,1,2.2230620456616944e-05,1.1106915165381966e-05,0.6666666666666666
21129,장의/Noun,3,2,1,2.2230620456616944e-05,1.1106915165381966e-05,0.6666666666666666
21130,봉투/Noun,3,1,2,1.1115310228308472e-05,2.2213830330763933e-05,0.6666666666666666
21131,디네/Noun,3,2,1,2.2230620456616944e-05,1.1106915165381966e-05,0.6666666666666666
21132,강대성/Noun,3,2,1,2.2230620456616944e-05,1.1106915165381966e-05,0.6666666666666666
21133,체위/Noun,3,1,2,1.1115310228308472e-05,2.2213830330763933e-05,0.6666666666666666
21134,네스트/Noun,3,2,1,2.2230620456616944e-05,1.1106915165381966e-05,0.6666666666666666
21135,천만이/Noun,3,1,2,1.1115310228308472e-05,2.2213830330763933e-05,0.6666666666666666
21136,스트로베리/Noun,3,2,1,2.2230620456616944e-05,1.1106915165381966e-05,0.6666666666666666
21137,겔러/Noun,3,1,2,1.1115310228308472e-05,2.2213830330763933e-05,0.6666666666666666
21138,으으윽/Adverb,3,1,2,1.1115310228308472e-05,2.2213830330763933e-05,0.6666666666666666
21139,인프라/Noun,3,1,2,1.1115310228308472e-05,2.2213830330763933e-05,0.6666666666666666
21140,돋아나다/Verb,3,1,2,1.1115310228308472e-05,2.2213830330763933e-05,0.6666666666666666
21141,유니폼/Noun,3,1,2,1.1115310228308472e-05,2.2213830330763933e-05,0.6666666666666666
21142,회부/Noun,3,2,1,2.2230620456616944e-05,1.1106915165381966e-05,0.6666666666666666
21143,미췬/Noun,3,1,2,1.1115310228308472e-05,2.2213830330763933e-05,0.6666666666666666
21144,메이즈/Noun,3,1,2,1.1115310228308472e-05,2.2213830330763933e-05,0.6666666666666666
21145,More/Alpha,3,2,1,2.2230620456616944e-05,1.1106915165381966e-05,0.6666666666666666
21146,콧구멍/Noun,3,2,1,2.2230620456616944e-05,1.1106915165381966e-05,0.6666666666666666
21147,지질/Noun,3,2,1,2.2230620456616944e-05,1.1106915165381966e-05,0.6666666666666666
21148,과목/Noun,3,2,1,2.2230620456616944e-05,1.1106915165381966e-05,0.6666666666666666
21149,Goodbye/Alpha,3,2,1,2.2230620456616944e-05,1.1106915165381966e-05,0.6666666666666666
21150,히힛/Noun,3,1,2,1.1115310228308472e-05,2.2213830330763933e-05,0.6666666666666666
21151,정액/Noun,3,2,1,2.2230620456616944e-05,1.1106915165381966e-05,0.6666666666666666
21152,유세/Noun,3,1,2,1.1115310228308472e-05,2.2213830330763933e-05,0.6666666666666666
21153,숏/Noun,3,2,1,2.2230620456616944e-05,1.1106915165381966e-05,0.6666666666666666
21154,호령/Noun,3,1,2,1.1115310228308472e-05,2.2213830330763933e-05,0.6666666666666666
21155,르그/Noun,3,2,1,2.2230620456616944e-05,1.1106915165381966e-05,0.6666666666666666
21156,세븐데이즈/Noun,3,2,1,2.2230620456616944e-05,1.1106915165381966e-05,0.6666666666666666
21157,레너/Noun,3,1,2,1.1115310228308472e-05,2.2213830330763933e-05,0.6666666666666666
21158,철거민/Noun,3,1,2,1.1115310228308472e-05,2.2213830330763933e-05,0.6666666666666666
21159,Time/Alpha,3,1,2,1.1115310228308472e-05,2.2213830330763933e-05,0.6666666666666666
21160,혜빈/Noun,3,2,1,2.2230620456616944e-05,1.1106915165381966e-05,0.6666666666666666
21161,페임/Noun,3,1,2,1.1115310228308472e-05,2.2213830330763933e-05,0.6666666666666666
21162,다야/Noun,3,1,2,1.1115310228308472e-05,2.2213830330763933e-05,0.6666666666666666
21163,멤피스/Noun,3,1,2,1.1115310228308472e-05,2.2213830330763933e-05,0.6666666666666666
21164,이류/Noun,3,1,2,1.1115310228308472e-05,2.2213830330763933e-05,0.6666666666666666
21165,마의/Noun,3,2,1,2.2230620456616944e-05,1.1106915165381966e-05,0.6666666666666666
21166,금연/Noun,3,1,2,1.1115310228308472e-05,2.2213830330763933e-05,0.6666666666666666
21167,페셔널/Noun,3,1,2,1.1115310228308472e-05,2.2213830330763933e-05,0.6666666666666666
21168,까지만/Foreign,3,1,2,1.1115310228308472e-05,2.2213830330763933e-05,0.6666666666666666
21169,구장/Noun,3,1,2,1.1115310228308472e-05,2.2213830330763933e-05,0.6666666666666666
21170,토키/Noun,3,2,1,2.2230620456616944e-05,1.1106915165381966e-05,0.6666666666666666
21171,둥글다/Adjective,3,1,2,1.1115310228308472e-05,2.2213830330763933e-05,0.6666666666666666
21172,섬세/Noun,3,2,1,2.2230620456616944e-05,1.1106915165381966e-05,0.6666666666666666
21173,만렙/Noun,3,1,2,1.1115310228308472e-05,2.2213830330763933e-05,0.6666666666666666
21174,썻어/Noun,3,1,2,1.1115310228308472e-05,2.2213830330763933e-05,0.6666666666666666
21175,쒸/Noun,3,1,2,1.1115310228308472e-05,2.2213830330763933e-05,0.6666666666666666
21176,우욱/Noun,3,1,2,1.1115310228308472e-05,2.2213830330763933e-05,0.6666666666666666
21177,띵하다/Adjective,3,2,1,2.2230620456616944e-05,1.1106915165381966e-05,0.6666666666666666
21178,넓어지다/Verb,3,2,1,2.2230620456616944e-05,1.1106915165381966e-05,0.6666666666666666
21179,혁/Noun,3,2,1,2.2230620456616944e-05,1.1106915165381966e-05,0.6666666666666666
21180,통조림/Noun,3,2,1,2.2230620456616944e-05,1.1106915165381966e-05,0.6666666666666666
21181,취화선/Noun,3,2,1,2.2230620456616944e-05,1.1106915165381966e-05,0.6666666666666666
21182,퓨젼/Noun,3,1,2,1.1115310228308472e-05,2.2213830330763933e-05,0.6666666666666666
21183,터들/Adverb,3,1,2,1.1115310228308472e-05,2.2213830330763933e-05,0.6666666666666666
21184,외인구단/Noun,3,2,1,2.2230620456616944e-05,1.1106915165381966e-05,0.6666666666666666
21185,꼽아/Noun,3,2,1,2.2230620456616944e-05,1.1106915165381966e-05,0.6666666666666666
21186,왕호/Noun,3,2,1,2.2230620456616944e-05,1.1106915165381966e-05,0.6666666666666666
21187,부러진화살/Noun,3,2,1,2.2230620456616944e-05,1.1106915165381966e-05,0.6666666666666666
21188,오대/Modifier,3,2,1,2.2230620456616944e-05,1.1106915165381966e-05,0.6666666666666666
21189,나무아미타불/Noun,3,1,2,1.1115310228308472e-05,2.2213830330763933e-05,0.6666666666666666
21190,등반/Noun,3,2,1,2.2230620456616944e-05,1.1106915165381966e-05,0.6666666666666666
21191,스엠/Noun,3,1,2,1.1115310228308472e-05,2.2213830330763933e-05,0.6666666666666666
21192,이일/Noun,3,2,1,2.2230620456616944e-05,1.1106915165381966e-05,0.6666666666666666
21193,명호/Noun,3,1,2,1.1115310228308472e-05,2.2213830330763933e-05,0.6666666666666666
21194,종용/Noun,3,1,2,1.1115310228308472e-05,2.2213830330763933e-05,0.6666666666666666
21195,와이키키/Noun,3,2,1,2.2230620456616944e-05,1.1106915165381966e-05,0.6666666666666666
21196,배배/Noun,3,2,1,2.2230620456616944e-05,1.1106915165381966e-05,0.6666666666666666
21197,레인보우/Noun,3,1,2,1.1115310228308472e-05,2.2213830330763933e-05,0.6666666666666666
21198,곽한구/Noun,3,1,2,1.1115310228308472e-05,2.2213830330763933e-05,0.6666666666666666
21199,아흐/Noun,3,2,1,2.2230620456616944e-05,1.1106915165381966e-05,0.6666666666666666
21200,욱김/Noun,3,1,2,1.1115310228308472e-05,2.2213830330763933e-05,0.6666666666666666
21201,호나우두/Noun,3,1,2,1.1115310228308472e-05,2.2213830330763933e-05,0.6666666666666666
21202,달걀/Noun,3,2,1,2.2230620456616944e-05,1.1106915165381966e-05,0.6666666666666666
21203,전립선/Noun,3,1,2,1.1115310228308472e-05,2.2213830330763933e-05,0.6666666666666666
21204,러더/Noun,3,1,2,1.1115310228308472e-05,2.2213830330763933e-05,0.6666666666666666
21205,공방전/Noun,3,2,1,2.2230620456616944e-05,1.1106915165381966e-05,0.6666666666666666
21206,선구/Noun,3,1,2,1.1115310228308472e-05,2.2213830330763933e-05,0.6666666666666666
21207,매트/Noun,3,1,2,1.1115310228308472e-05,2.2213830330763933e-05,0.6666666666666666
21208,인디안/Noun,3,2,1,2.2230620456616944e-05,1.1106915165381966e-05,0.6666666666666666
21209,별장/Noun,3,1,2,1.1115310228308472e-05,2.2213830330763933e-05,0.6666666666666666
21210,오금/Noun,3,2,1,2.2230620456616944e-05,1.1106915165381966e-05,0.6666666666666666
21211,지형/Noun,3,1,2,1.1115310228308472e-05,2.2213830330763933e-05,0.6666666666666666
21212,텔런트/Noun,3,1,2,1.1115310228308472e-05,2.2213830330763933e-05,0.6666666666666666
21213,어익후/Noun,3,2,1,2.2230620456616944e-05,1.1106915165381966e-05,0.6666666666666666
21214,교화/Noun,3,1,2,1.1115310228308472e-05,2.2213830330763933e-05,0.6666666666666666
21215,삼거리/Noun,3,1,2,1.1115310228308472e-05,2.2213830330763933e-05,0.6666666666666666
21216,플라워/Noun,3,2,1,2.2230620456616944e-05,1.1106915165381966e-05,0.6666666666666666
21217,스테파니/Noun,3,2,1,2.2230620456616944e-05,1.1106915165381966e-05,0.6666666666666666
21218,시리얼/Noun,3,2,1,2.2230620456616944e-05,1.1106915165381966e-05,0.6666666666666666
21219,로맨싱/Noun,3,2,1,2.2230620456616944e-05,1.1106915165381966e-05,0.6666666666666666
21220,Just/Alpha,3,2,1,2.2230620456616944e-05,1.1106915165381966e-05,0.6666666666666666
21221,유려/Noun,3,1,2,1.1115310228308472e-05,2.2213830330763933e-05,0.6666666666666666
21222,변절/Noun,3,1,2,1.1115310228308472e-05,2.2213830330763933e-05,0.6666666666666666
21223,Is/Alpha,3,2,1,2.2230620456616944e-05,1.1106915165381966e-05,0.6666666666666666
21224,보랑/Noun,3,1,2,1.1115310228308472e-05,2.2213830330763933e-05,0.6666666666666666
21225,아라가/Noun,3,1,2,1.1115310228308472e-05,2.2213830330763933e-05,0.6666666666666666
21226,왜꼭/Noun,3,2,1,2.2230620456616944e-05,1.1106915165381966e-05,0.6666666666666666
21227,경주마/Noun,3,2,1,2.2230620456616944e-05,1.1106915165381966e-05,0.6666666666666666
21228,9.8/Number,3,2,1,2.2230620456616944e-05,1.1106915165381966e-05,0.6666666666666666
21229,식물/Noun,3,1,2,1.1115310228308472e-05,2.2213830330763933e-05,0.6666666666666666
21230,흡혈/Noun,3,2,1,2.2230620456616944e-05,1.1106915165381966e-05,0.6666666666666666
21231,sea/Alpha,3,1,2,1.1115310228308472e-05,2.2213830330763933e-05,0.6666666666666666
21232,4~5년/Number,3,2,1,2.2230620456616944e-05,1.1106915165381966e-05,0.6666666666666666
21233,개명/Noun,3,1,2,1.1115310228308472e-05,2.2213830330763933e-05,0.6666666666666666
21234,120회/Number,3,1,2,1.1115310228308472e-05,2.2213830330763933e-05,0.6666666666666666
21235,탈북/Noun,3,2,1,2.2230620456616944e-05,1.1106915165381966e-05,0.6666666666666666
21236,게인/Noun,3,1,2,1.1115310228308472e-05,2.2213830330763933e-05,0.6666666666666666
21237,주차장/Noun,3,1,2,1.1115310228308472e-05,2.2213830330763933e-05,0.6666666666666666
21238,양치기/Noun,3,1,2,1.1115310228308472e-05,2.2213830330763933e-05,0.6666666666666666
21239,곰돌이/Noun,3,1,2,1.1115310228308472e-05,2.2213830330763933e-05,0.6666666666666666
21240,탭/Noun,3,2,1,2.2230620456616944e-05,1.1106915165381966e-05,0.6666666666666666
21241,토코/Noun,3,2,1,2.2230620456616944e-05,1.1106915165381966e-05,0.6666666666666666
21242,갱단/Noun,3,1,2,1.1115310228308472e-05,2.2213830330763933e-05,0.6666666666666666
21243,대초/Foreign,3,2,1,2.2230620456616944e-05,1.1106915165381966e-05,0.6666666666666666
21244,풍문/Noun,3,2,1,2.2230620456616944e-05,1.1106915165381966e-05,0.6666666666666666
21245,무력감/Noun,3,2,1,2.2230620456616944e-05,1.1106915165381966e-05,0.6666666666666666
21246,섭소천/Noun,3,2,1,2.2230620456616944e-05,1.1106915165381966e-05,0.6666666666666666
21247,9일/Number,3,2,1,2.2230620456616944e-05,1.1106915165381966e-05,0.6666666666666666
21248,웽크/Noun,3,1,2,1.1115310228308472e-05,2.2213830330763933e-05,0.6666666666666666
21249,oo/Alpha,3,2,1,2.2230620456616944e-05,1.1106915165381966e-05,0.6666666666666666
21250,짜들다/Verb,3,1,2,1.1115310228308472e-05,2.2213830330763933e-05,0.6666666666666666
21251,플래닛/Noun,3,1,2,1.1115310228308472e-05,2.2213830330763933e-05,0.6666666666666666
21252,9.6/Number,3,1,2,1.1115310228308472e-05,2.2213830330763933e-05,0.6666666666666666
21253,기재/Noun,3,2,1,2.2230620456616944e-05,1.1106915165381966e-05,0.6666666666666666
21254,옥동자/Noun,3,2,1,2.2230620456616944e-05,1.1106915165381966e-05,0.6666666666666666
21255,난도/Noun,3,2,1,2.2230620456616944e-05,1.1106915165381966e-05,0.6666666666666666
21256,억이/Noun,3,2,1,2.2230620456616944e-05,1.1106915165381966e-05,0.6666666666666666
21257,띤/Noun,3,2,1,2.2230620456616944e-05,1.1106915165381966e-05,0.6666666666666666
21258,럿/Noun,3,1,2,1.1115310228308472e-05,2.2213830330763933e-05,0.6666666666666666
21259,변호/Noun,3,1,2,1.1115310228308472e-05,2.2213830330763933e-05,0.6666666666666666
21260,MSG/Alpha,3,2,1,2.2230620456616944e-05,1.1106915165381966e-05,0.6666666666666666
21261,MTV/Alpha,3,1,2,1.1115310228308472e-05,2.2213830330763933e-05,0.6666666666666666
21262,옷장/Noun,3,1,2,1.1115310228308472e-05,2.2213830330763933e-05,0.6666666666666666
21263,꽹과리/Noun,3,1,2,1.1115310228308472e-05,2.2213830330763933e-05,0.6666666666666666
21264,야사/Noun,3,1,2,1.1115310228308472e-05,2.2213830330763933e-05,0.6666666666666666
21265,베뎃/Noun,3,1,2,1.1115310228308472e-05,2.2213830330763933e-05,0.6666666666666666
21266,괘안/Noun,3,2,1,2.2230620456616944e-05,1.1106915165381966e-05,0.6666666666666666
21267,똘망똘망/Noun,3,2,1,2.2230620456616944e-05,1.1106915165381966e-05,0.6666666666666666
21268,정망/Noun,3,2,1,2.2230620456616944e-05,1.1106915165381966e-05,0.6666666666666666
21269,바캉스/Noun,3,1,2,1.1115310228308472e-05,2.2213830330763933e-05,0.6666666666666666
21270,주례/Noun,3,1,2,1.1115310228308472e-05,2.2213830330763933e-05,0.6666666666666666
21271,넥스트/Noun,3,2,1,2.2230620456616944e-05,1.1106915165381966e-05,0.6666666666666666
21272,독기/Noun,3,2,1,2.2230620456616944e-05,1.1106915165381966e-05,0.6666666666666666
21273,궁궐/Noun,3,2,1,2.2230620456616944e-05,1.1106915165381966e-05,0.6666666666666666
21274,라고요/Eomi,3,2,1,2.2230620456616944e-05,1.1106915165381966e-05,0.6666666666666666
21275,전당/Noun,3,1,2,1.1115310228308472e-05,2.2213830330763933e-05,0.6666666666666666
21276,롭코헨/Noun,3,2,1,2.2230620456616944e-05,1.1106915165381966e-05,0.6666666666666666
21277,릭/Noun,3,2,1,2.2230620456616944e-05,1.1106915165381966e-05,0.6666666666666666
21278,매그니토/Noun,3,2,1,2.2230620456616944e-05,1.1106915165381966e-05,0.6666666666666666
21279,파란색/Noun,3,2,1,2.2230620456616944e-05,1.1106915165381966e-05,0.6666666666666666
21280,원체/Adverb,3,2,1,2.2230620456616944e-05,1.1106915165381966e-05,0.6666666666666666
21281,유희열/Noun,3,2,1,2.2230620456616944e-05,1.1106915165381966e-05,0.6666666666666666
21282,뻔햇/Noun,3,1,2,1.1115310228308472e-05,2.2213830330763933e-05,0.6666666666666666
21283,수비/Noun,3,1,2,1.1115310228308472e-05,2.2213830330763933e-05,0.6666666666666666
21284,불금/Noun,3,2,1,2.2230620456616944e-05,1.1106915165381966e-05,0.6666666666666666
21285,찜방/Noun,3,1,2,1.1115310228308472e-05,2.2213830330763933e-05,0.6666666666666666
21286,군복/Noun,3,1,2,1.1115310228308472e-05,2.2213830330763933e-05,0.6666666666666666
21287,국전/Noun,3,1,2,1.1115310228308472e-05,2.2213830330763933e-05,0.6666666666666666
21288,-;;;/Punctuation,3,2,1,2.2230620456616944e-05,1.1106915165381966e-05,0.6666666666666666
21289,자명하다/Adjective,3,1,2,1.1115310228308472e-05,2.2213830330763933e-05,0.6666666666666666
21290,1950년/Number,3,2,1,2.2230620456616944e-05,1.1106915165381966e-05,0.6666666666666666
21291,쇼걸/Noun,3,2,1,2.2230620456616944e-05,1.1106915165381966e-05,0.6666666666666666
21292,존잼임/Noun,3,2,1,2.2230620456616944e-05,1.1106915165381966e-05,0.6666666666666666
21293,포탄/Noun,3,2,1,2.2230620456616944e-05,1.1106915165381966e-05,0.6666666666666666
21294,브란/Noun,3,1,2,1.1115310228308472e-05,2.2213830330763933e-05,0.6666666666666666
21295,호암/Noun,3,2,1,2.2230620456616944e-05,1.1106915165381966e-05,0.6666666666666666
21296,구구구/Noun,3,2,1,2.2230620456616944e-05,1.1106915165381966e-05,0.6666666666666666
21297,화성인/Noun,3,1,2,1.1115310228308472e-05,2.2213830330763933e-05,0.6666666666666666
21298,뻥뻥/Noun,3,1,2,1.1115310228308472e-05,2.2213830330763933e-05,0.6666666666666666
21299,클라우드/Noun,3,1,2,1.1115310228308472e-05,2.2213830330763933e-05,0.6666666666666666
21300,미술품/Noun,3,1,2,1.1115310228308472e-05,2.2213830330763933e-05,0.6666666666666666
21301,가평/Noun,3,1,2,1.1115310228308472e-05,2.2213830330763933e-05,0.6666666666666666
21302,맬릭/Noun,3,2,1,2.2230620456616944e-05,1.1106915165381966e-05,0.6666666666666666
21303,지르르/Noun,3,1,2,1.1115310228308472e-05,2.2213830330763933e-05,0.6666666666666666
21304,수도승/Noun,3,1,2,1.1115310228308472e-05,2.2213830330763933e-05,0.6666666666666666
21305,해롤드/Noun,3,2,1,2.2230620456616944e-05,1.1106915165381966e-05,0.6666666666666666
21306,족발/Noun,3,2,1,2.2230620456616944e-05,1.1106915165381966e-05,0.6666666666666666
21307,하층/Noun,3,2,1,2.2230620456616944e-05,1.1106915165381966e-05,0.6666666666666666
21308,섭취/Noun,3,1,2,1.1115310228308472e-05,2.2213830330763933e-05,0.6666666666666666
21309,119/Number,3,1,2,1.1115310228308472e-05,2.2213830330763933e-05,0.6666666666666666
21310,밥딜런/Noun,3,2,1,2.2230620456616944e-05,1.1106915165381966e-05,0.6666666666666666
21311,젖통/Noun,3,1,2,1.1115310228308472e-05,2.2213830330763933e-05,0.6666666666666666
21312,신사동/Noun,3,2,1,2.2230620456616944e-05,1.1106915165381966e-05,0.6666666666666666
21313,리셋/Noun,3,1,2,1.1115310228308472e-05,2.2213830330763933e-05,0.6666666666666666
21314,리핑/Noun,3,2,1,2.2230620456616944e-05,1.1106915165381966e-05,0.6666666666666666
21315,약화/Noun,3,1,2,1.1115310228308472e-05,2.2213830330763933e-05,0.6666666666666666
21316,이경이/Noun,3,1,2,1.1115310228308472e-05,2.2213830330763933e-05,0.6666666666666666
21317,제자리걸음/Noun,3,1,2,1.1115310228308472e-05,2.2213830330763933e-05,0.6666666666666666
21318,삽/Noun,3,2,1,2.2230620456616944e-05,1.1106915165381966e-05,0.6666666666666666
21319,스카페이스/Noun,3,2,1,2.2230620456616944e-05,1.1106915165381966e-05,0.6666666666666666
21320,새우/Noun,3,2,1,2.2230620456616944e-05,1.1106915165381966e-05,0.6666666666666666
21321,어림없다/Adjective,3,1,2,1.1115310228308472e-05,2.2213830330763933e-05,0.6666666666666666
21322,렛미인/Noun,3,2,1,2.2230620456616944e-05,1.1106915165381966e-05,0.6666666666666666
21323,읔/Exclamation,3,1,2,1.1115310228308472e-05,2.2213830330763933e-05,0.6666666666666666
21324,유지인/Noun,3,2,1,2.2230620456616944e-05,1.1106915165381966e-05,0.6666666666666666
21325,삼국/Noun,3,2,1,2.2230620456616944e-05,1.1106915165381966e-05,0.6666666666666666
21326,무상함/Noun,3,2,1,2.2230620456616944e-05,1.1106915165381966e-05,0.6666666666666666
21327,키득키득/Adverb,3,1,2,1.1115310228308472e-05,2.2213830330763933e-05,0.6666666666666666
21328,변혁/Noun,3,1,2,1.1115310228308472e-05,2.2213830330763933e-05,0.6666666666666666
21329,피로하다/Adjective,3,1,2,1.1115310228308472e-05,2.2213830330763933e-05,0.6666666666666666
21330,쉬는시간/Noun,3,1,2,1.1115310228308472e-05,2.2213830330763933e-05,0.6666666666666666
21331,군번/Noun,3,2,1,2.2230620456616944e-05,1.1106915165381966e-05,0.6666666666666666
21332,버럭/Noun,3,1,2,1.1115310228308472e-05,2.2213830330763933e-05,0.6666666666666666
21333,-..-/Punctuation,3,1,2,1.1115310228308472e-05,2.2213830330763933e-05,0.6666666666666666
21334,fucking/Alpha,3,2,1,2.2230620456616944e-05,1.1106915165381966e-05,0.6666666666666666
21335,막회/Noun,3,1,2,1.1115310228308472e-05,2.2213830330763933e-05,0.6666666666666666
21336,서예/Noun,3,1,2,1.1115310228308472e-05,2.2213830330763933e-05,0.6666666666666666
21337,성녀/Noun,3,1,2,1.1115310228308472e-05,2.2213830330763933e-05,0.6666666666666666
21338,회사원/Noun,3,1,2,1.1115310228308472e-05,2.2213830330763933e-05,0.6666666666666666
21339,도돌이표/Noun,3,1,2,1.1115310228308472e-05,2.2213830330763933e-05,0.6666666666666666
21340,must/Alpha,3,2,1,2.2230620456616944e-05,1.1106915165381966e-05,0.6666666666666666
21341,징벌/Noun,3,2,1,2.2230620456616944e-05,1.1106915165381966e-05,0.6666666666666666
21342,은자/Noun,3,1,2,1.1115310228308472e-05,2.2213830330763933e-05,0.6666666666666666
21343,마츠준/Noun,3,2,1,2.2230620456616944e-05,1.1106915165381966e-05,0.6666666666666666
21344,조춘/Noun,3,1,2,1.1115310228308472e-05,2.2213830330763933e-05,0.6666666666666666
21345,피바디/Noun,3,1,2,1.1115310228308472e-05,2.2213830330763933e-05,0.6666666666666666
21346,김응수/Noun,3,2,1,2.2230620456616944e-05,1.1106915165381966e-05,0.6666666666666666
21347,토종/Noun,3,2,1,2.2230620456616944e-05,1.1106915165381966e-05,0.6666666666666666
21348,억세다/Adjective,3,2,1,2.2230620456616944e-05,1.1106915165381966e-05,0.6666666666666666
21349,꽈배기/Noun,3,2,1,2.2230620456616944e-05,1.1106915165381966e-05,0.6666666666666666
21350,불균형/Noun,3,1,2,1.1115310228308472e-05,2.2213830330763933e-05,0.6666666666666666
21351,홍진영/Noun,3,2,1,2.2230620456616944e-05,1.1106915165381966e-05,0.6666666666666666
21352,절판/Noun,3,2,1,2.2230620456616944e-05,1.1106915165381966e-05,0.6666666666666666
21353,고유키/Noun,3,1,2,1.1115310228308472e-05,2.2213830330763933e-05,0.6666666666666666
21354,난간/Noun,3,1,2,1.1115310228308472e-05,2.2213830330763933e-05,0.6666666666666666
21355,묶여서/Noun,3,2,1,2.2230620456616944e-05,1.1106915165381966e-05,0.6666666666666666
21356,휴양지/Noun,3,2,1,2.2230620456616944e-05,1.1106915165381966e-05,0.6666666666666666
21357,코시/Noun,3,1,2,1.1115310228308472e-05,2.2213830330763933e-05,0.6666666666666666
21358,고글/Noun,3,1,2,1.1115310228308472e-05,2.2213830330763933e-05,0.6666666666666666
21359,흫/Noun,3,1,2,1.1115310228308472e-05,2.2213830330763933e-05,0.6666666666666666
21360,가설/Noun,3,1,2,1.1115310228308472e-05,2.2213830330763933e-05,0.6666666666666666
21361,완전범죄/Noun,3,2,1,2.2230620456616944e-05,1.1106915165381966e-05,0.6666666666666666
21362,예지/Noun,3,2,1,2.2230620456616944e-05,1.1106915165381966e-05,0.6666666666666666
21363,하규/Noun,3,2,1,2.2230620456616944e-05,1.1106915165381966e-05,0.6666666666666666
21364,레논/Noun,3,2,1,2.2230620456616944e-05,1.1106915165381966e-05,0.6666666666666666
21365,황태자/Noun,3,1,2,1.1115310228308472e-05,2.2213830330763933e-05,0.6666666666666666
21366,워터보이즈/Noun,3,2,1,2.2230620456616944e-05,1.1106915165381966e-05,0.6666666666666666
21367,말끔/Adverb,3,2,1,2.2230620456616944e-05,1.1106915165381966e-05,0.6666666666666666
21368,조무래기/Noun,3,1,2,1.1115310228308472e-05,2.2213830330763933e-05,0.6666666666666666
21369,동/Noun,3,2,1,2.2230620456616944e-05,1.1106915165381966e-05,0.6666666666666666
21370,슬라이드/Noun,3,2,1,2.2230620456616944e-05,1.1106915165381966e-05,0.6666666666666666
21371,파묻다/Verb,3,2,1,2.2230620456616944e-05,1.1106915165381966e-05,0.6666666666666666
21372,고시원/Noun,3,2,1,2.2230620456616944e-05,1.1106915165381966e-05,0.6666666666666666
21373,레이브/Noun,3,1,2,1.1115310228308472e-05,2.2213830330763933e-05,0.6666666666666666
21374,신명/Noun,3,2,1,2.2230620456616944e-05,1.1106915165381966e-05,0.6666666666666666
21375,"...,,/Punctuation",3,1,2,1.1115310228308472e-05,2.2213830330763933e-05,0.6666666666666666
21376,강대위/Noun,3,2,1,2.2230620456616944e-05,1.1106915165381966e-05,0.6666666666666666
21377,컨져링/Noun,3,1,2,1.1115310228308472e-05,2.2213830330763933e-05,0.6666666666666666
21378,이었다/Foreign,3,1,2,1.1115310228308472e-05,2.2213830330763933e-05,0.6666666666666666
21379,땡잡다/Verb,3,1,2,1.1115310228308472e-05,2.2213830330763933e-05,0.6666666666666666
21380,와호장룡/Noun,3,1,2,1.1115310228308472e-05,2.2213830330763933e-05,0.6666666666666666
21381,이갑/Noun,3,1,2,1.1115310228308472e-05,2.2213830330763933e-05,0.6666666666666666
21382,앍다/Verb,3,1,2,1.1115310228308472e-05,2.2213830330763933e-05,0.6666666666666666
21383,릴레이/Noun,3,1,2,1.1115310228308472e-05,2.2213830330763933e-05,0.6666666666666666
21384,때기/Noun,3,1,2,1.1115310228308472e-05,2.2213830330763933e-05,0.6666666666666666
21385,해심/Noun,3,2,1,2.2230620456616944e-05,1.1106915165381966e-05,0.6666666666666666
21386,이었음/Eomi,3,1,2,1.1115310228308472e-05,2.2213830330763933e-05,0.6666666666666666
21387,리바이/Noun,3,1,2,1.1115310228308472e-05,2.2213830330763933e-05,0.6666666666666666
21388,롤러/Noun,3,2,1,2.2230620456616944e-05,1.1106915165381966e-05,0.6666666666666666
21389,영화제작진/Noun,3,1,2,1.1115310228308472e-05,2.2213830330763933e-05,0.6666666666666666
21390,보드카/Noun,3,2,1,2.2230620456616944e-05,1.1106915165381966e-05,0.6666666666666666
21391,기니/Noun,3,2,1,2.2230620456616944e-05,1.1106915165381966e-05,0.6666666666666666
21392,모래성/Noun,3,1,2,1.1115310228308472e-05,2.2213830330763933e-05,0.6666666666666666
21393,살피/Noun,3,2,1,2.2230620456616944e-05,1.1106915165381966e-05,0.6666666666666666
21394,실드/Noun,3,1,2,1.1115310228308472e-05,2.2213830330763933e-05,0.6666666666666666
21395,같아욤/Noun,3,2,1,2.2230620456616944e-05,1.1106915165381966e-05,0.6666666666666666
21396,여우비/Noun,3,2,1,2.2230620456616944e-05,1.1106915165381966e-05,0.6666666666666666
21397,대악/Noun,3,2,1,2.2230620456616944e-05,1.1106915165381966e-05,0.6666666666666666
21398,정도가/Foreign,3,2,1,2.2230620456616944e-05,1.1106915165381966e-05,0.6666666666666666
21399,cliche/Alpha,3,1,2,1.1115310228308472e-05,2.2213830330763933e-05,0.6666666666666666
21400,명랑만화/Noun,3,1,2,1.1115310228308472e-05,2.2213830330763933e-05,0.6666666666666666
21401,스타트/Noun,3,2,1,2.2230620456616944e-05,1.1106915165381966e-05,0.6666666666666666
21402,샛길/Noun,3,1,2,1.1115310228308472e-05,2.2213830330763933e-05,0.6666666666666666
21403,학점/Noun,3,1,2,1.1115310228308472e-05,2.2213830330763933e-05,0.6666666666666666
21404,두렁/Noun,3,2,1,2.2230620456616944e-05,1.1106915165381966e-05,0.6666666666666666
21405,하루키/Noun,3,2,1,2.2230620456616944e-05,1.1106915165381966e-05,0.6666666666666666
21406,중임/Noun,3,1,2,1.1115310228308472e-05,2.2213830330763933e-05,0.6666666666666666
21407,잣음/Noun,3,1,2,1.1115310228308472e-05,2.2213830330763933e-05,0.6666666666666666
21408,분쟁/Noun,3,2,1,2.2230620456616944e-05,1.1106915165381966e-05,0.6666666666666666
21409,불법체류/Noun,3,1,2,1.1115310228308472e-05,2.2213830330763933e-05,0.6666666666666666
21410,여관/Noun,3,1,2,1.1115310228308472e-05,2.2213830330763933e-05,0.6666666666666666
21411,123분/Number,3,1,2,1.1115310228308472e-05,2.2213830330763933e-05,0.6666666666666666
21412,주야/Noun,3,2,1,2.2230620456616944e-05,1.1106915165381966e-05,0.6666666666666666
21413,적발/Noun,3,2,1,2.2230620456616944e-05,1.1106915165381966e-05,0.6666666666666666
21414,블루아/Noun,3,1,2,1.1115310228308472e-05,2.2213830330763933e-05,0.6666666666666666
21415,케냐/Noun,3,2,1,2.2230620456616944e-05,1.1106915165381966e-05,0.6666666666666666
21416,워크샵/Noun,3,1,2,1.1115310228308472e-05,2.2213830330763933e-05,0.6666666666666666
21417,파파로티/Noun,3,2,1,2.2230620456616944e-05,1.1106915165381966e-05,0.6666666666666666
21418,秀作/Foreign,3,2,1,2.2230620456616944e-05,1.1106915165381966e-05,0.6666666666666666
21419,이맘때/Adverb,3,2,1,2.2230620456616944e-05,1.1106915165381966e-05,0.6666666666666666
21420,빛바랜/Noun,3,1,2,1.1115310228308472e-05,2.2213830330763933e-05,0.6666666666666666
21421,수필/Noun,3,2,1,2.2230620456616944e-05,1.1106915165381966e-05,0.6666666666666666
21422,-.-;;;/Punctuation,3,1,2,1.1115310228308472e-05,2.2213830330763933e-05,0.6666666666666666
21423,젋/Noun,3,2,1,2.2230620456616944e-05,1.1106915165381966e-05,0.6666666666666666
21424,후버/Noun,3,2,1,2.2230620456616944e-05,1.1106915165381966e-05,0.6666666666666666
21425,목각/Noun,3,2,1,2.2230620456616944e-05,1.1106915165381966e-05,0.6666666666666666
21426,세대차이/Noun,3,1,2,1.1115310228308472e-05,2.2213830330763933e-05,0.6666666666666666
21427,정은우/Noun,3,2,1,2.2230620456616944e-05,1.1106915165381966e-05,0.6666666666666666
21428,스타더스트/Noun,3,1,2,1.1115310228308472e-05,2.2213830330763933e-05,0.6666666666666666
21429,심오/Noun,3,2,1,2.2230620456616944e-05,1.1106915165381966e-05,0.6666666666666666
21430,인도네시아/Noun,3,2,1,2.2230620456616944e-05,1.1106915165381966e-05,0.6666666666666666
21431,마터스/Noun,3,1,2,1.1115310228308472e-05,2.2213830330763933e-05,0.6666666666666666
21432,기신/Noun,3,2,1,2.2230620456616944e-05,1.1106915165381966e-05,0.6666666666666666
21433,볼드윈/Noun,3,2,1,2.2230620456616944e-05,1.1106915165381966e-05,0.6666666666666666
21434,듀크/Noun,3,1,2,1.1115310228308472e-05,2.2213830330763933e-05,0.6666666666666666
21435,콸콸/Noun,3,2,1,2.2230620456616944e-05,1.1106915165381966e-05,0.6666666666666666
21436,플레인/Noun,3,1,2,1.1115310228308472e-05,2.2213830330763933e-05,0.6666666666666666
21437,말짱/Adverb,3,2,1,2.2230620456616944e-05,1.1106915165381966e-05,0.6666666666666666
21438,영국군/Noun,3,1,2,1.1115310228308472e-05,2.2213830330763933e-05,0.6666666666666666
21439,국기/Noun,3,2,1,2.2230620456616944e-05,1.1106915165381966e-05,0.6666666666666666
21440,청산/Noun,3,1,2,1.1115310228308472e-05,2.2213830330763933e-05,0.6666666666666666
21441,방송사고/Noun,3,1,2,1.1115310228308472e-05,2.2213830330763933e-05,0.6666666666666666
21442,거위/Noun,3,2,1,2.2230620456616944e-05,1.1106915165381966e-05,0.6666666666666666
21443,붓/Noun,3,1,2,1.1115310228308472e-05,2.2213830330763933e-05,0.6666666666666666
21444,미제국/Noun,3,2,1,2.2230620456616944e-05,1.1106915165381966e-05,0.6666666666666666
21445,43/Number,3,1,2,1.1115310228308472e-05,2.2213830330763933e-05,0.6666666666666666
21446,세속/Noun,3,2,1,2.2230620456616944e-05,1.1106915165381966e-05,0.6666666666666666
21447,펜더/Noun,3,2,1,2.2230620456616944e-05,1.1106915165381966e-05,0.6666666666666666
21448,Space/Alpha,3,2,1,2.2230620456616944e-05,1.1106915165381966e-05,0.6666666666666666
21449,마지막방송/Noun,3,2,1,2.2230620456616944e-05,1.1106915165381966e-05,0.6666666666666666
21450,렬/Noun,3,2,1,2.2230620456616944e-05,1.1106915165381966e-05,0.6666666666666666
21451,비젼/Noun,3,2,1,2.2230620456616944e-05,1.1106915165381966e-05,0.6666666666666666
21452,신급/Noun,3,2,1,2.2230620456616944e-05,1.1106915165381966e-05,0.6666666666666666
21453,푸른빛/Noun,3,2,1,2.2230620456616944e-05,1.1106915165381966e-05,0.6666666666666666
21454,신기다/Verb,3,2,1,2.2230620456616944e-05,1.1106915165381966e-05,0.6666666666666666
21455,설현/Noun,3,2,1,2.2230620456616944e-05,1.1106915165381966e-05,0.6666666666666666
21456,불화/Noun,3,2,1,2.2230620456616944e-05,1.1106915165381966e-05,0.6666666666666666
21457,변금련/Noun,3,2,1,2.2230620456616944e-05,1.1106915165381966e-05,0.6666666666666666
21458,플리/Noun,3,2,1,2.2230620456616944e-05,1.1106915165381966e-05,0.6666666666666666
21459,무제한/Noun,3,2,1,2.2230620456616944e-05,1.1106915165381966e-05,0.6666666666666666
21460,하이퍼/Noun,3,1,2,1.1115310228308472e-05,2.2213830330763933e-05,0.6666666666666666
21461,die/Alpha,3,2,1,2.2230620456616944e-05,1.1106915165381966e-05,0.6666666666666666
21462,째지다/Verb,3,2,1,2.2230620456616944e-05,1.1106915165381966e-05,0.6666666666666666
21463,ㄴㅐ/KoreanParticle,3,2,1,2.2230620456616944e-05,1.1106915165381966e-05,0.6666666666666666
21464,쿤/Noun,3,2,1,2.2230620456616944e-05,1.1106915165381966e-05,0.6666666666666666
21465,마테/Noun,3,2,1,2.2230620456616944e-05,1.1106915165381966e-05,0.6666666666666666
21466,서일/Noun,3,2,1,2.2230620456616944e-05,1.1106915165381966e-05,0.6666666666666666
21467,까진/Foreign,3,1,2,1.1115310228308472e-05,2.2213830330763933e-05,0.6666666666666666
21468,정문/Noun,3,2,1,2.2230620456616944e-05,1.1106915165381966e-05,0.6666666666666666
21469,목도/Noun,3,2,1,2.2230620456616944e-05,1.1106915165381966e-05,0.6666666666666666
21470,old/Alpha,3,2,1,2.2230620456616944e-05,1.1106915165381966e-05,0.6666666666666666
21471,한송이/Noun,3,1,2,1.1115310228308472e-05,2.2213830330763933e-05,0.6666666666666666
21472,먹고다/Verb,3,1,2,1.1115310228308472e-05,2.2213830330763933e-05,0.6666666666666666
21473,8시간/Number,3,2,1,2.2230620456616944e-05,1.1106915165381966e-05,0.6666666666666666
21474,1959년/Number,3,2,1,2.2230620456616944e-05,1.1106915165381966e-05,0.6666666666666666
21475,백화/Noun,3,1,2,1.1115310228308472e-05,2.2213830330763933e-05,0.6666666666666666
21476,밴디트/Noun,3,2,1,2.2230620456616944e-05,1.1106915165381966e-05,0.6666666666666666
21477,상품화/Noun,3,1,2,1.1115310228308472e-05,2.2213830330763933e-05,0.6666666666666666
21478,삻/Noun,3,2,1,2.2230620456616944e-05,1.1106915165381966e-05,0.6666666666666666
21479,비통하다/Adjective,3,2,1,2.2230620456616944e-05,1.1106915165381966e-05,0.6666666666666666
21480,새장/Noun,3,2,1,2.2230620456616944e-05,1.1106915165381966e-05,0.6666666666666666
21481,발길질/Noun,3,1,2,1.1115310228308472e-05,2.2213830330763933e-05,0.6666666666666666
21482,둘째딸/Noun,3,1,2,1.1115310228308472e-05,2.2213830330763933e-05,0.6666666666666666
21483,파먹다/Verb,3,2,1,2.2230620456616944e-05,1.1106915165381966e-05,0.6666666666666666
21484,an/Alpha,3,1,2,1.1115310228308472e-05,2.2213830330763933e-05,0.6666666666666666
21485,성차별/Noun,3,1,2,1.1115310228308472e-05,2.2213830330763933e-05,0.6666666666666666
21486,캥거루/Noun,3,1,2,1.1115310228308472e-05,2.2213830330763933e-05,0.6666666666666666
21487,실정/Noun,3,2,1,2.2230620456616944e-05,1.1106915165381966e-05,0.6666666666666666
21488,슈워/Noun,3,1,2,1.1115310228308472e-05,2.2213830330763933e-05,0.6666666666666666
21489,신생/Noun,3,1,2,1.1115310228308472e-05,2.2213830330763933e-05,0.6666666666666666
21490,"....""/Punctuation",3,2,1,2.2230620456616944e-05,1.1106915165381966e-05,0.6666666666666666
21491,자질구레하다/Adjective,3,2,1,2.2230620456616944e-05,1.1106915165381966e-05,0.6666666666666666
21492,르와르/Noun,3,1,2,1.1115310228308472e-05,2.2213830330763933e-05,0.6666666666666666
21493,주룩/Noun,3,2,1,2.2230620456616944e-05,1.1106915165381966e-05,0.6666666666666666
21494,강리나/Noun,3,2,1,2.2230620456616944e-05,1.1106915165381966e-05,0.6666666666666666
21495,"....,./Punctuation",3,1,2,1.1115310228308472e-05,2.2213830330763933e-05,0.6666666666666666
21496,풋풋/Noun,3,2,1,2.2230620456616944e-05,1.1106915165381966e-05,0.6666666666666666
21497,계심/Noun,3,1,2,1.1115310228308472e-05,2.2213830330763933e-05,0.6666666666666666
21498,손실/Noun,3,1,2,1.1115310228308472e-05,2.2213830330763933e-05,0.6666666666666666
21499,살인의추억/Noun,3,2,1,2.2230620456616944e-05,1.1106915165381966e-05,0.6666666666666666
21500,영화인데/Foreign,3,1,2,1.1115310228308472e-05,2.2213830330763933e-05,0.6666666666666666
21501,알흠답/Noun,3,2,1,2.2230620456616944e-05,1.1106915165381966e-05,0.6666666666666666
21502,띄엄/Noun,3,2,1,2.2230620456616944e-05,1.1106915165381966e-05,0.6666666666666666
21503,7~80년/Number,3,1,2,1.1115310228308472e-05,2.2213830330763933e-05,0.6666666666666666
21504,눈꽃/Noun,3,2,1,2.2230620456616944e-05,1.1106915165381966e-05,0.6666666666666666
21505,자켓/Noun,3,2,1,2.2230620456616944e-05,1.1106915165381966e-05,0.6666666666666666
21506,막노동/Noun,3,1,2,1.1115310228308472e-05,2.2213830330763933e-05,0.6666666666666666
21507,온난화/Noun,3,2,1,2.2230620456616944e-05,1.1106915165381966e-05,0.6666666666666666
21508,얌마/Noun,3,2,1,2.2230620456616944e-05,1.1106915165381966e-05,0.6666666666666666
21509,치욕스럽다/Adjective,3,1,2,1.1115310228308472e-05,2.2213830330763933e-05,0.6666666666666666
21510,만수무강/Noun,3,2,1,2.2230620456616944e-05,1.1106915165381966e-05,0.6666666666666666
21511,Again/Alpha,3,1,2,1.1115310228308472e-05,2.2213830330763933e-05,0.6666666666666666
21512,오션스일레븐/Noun,3,1,2,1.1115310228308472e-05,2.2213830330763933e-05,0.6666666666666666
21513,투기/Noun,3,1,2,1.1115310228308472e-05,2.2213830330763933e-05,0.6666666666666666
21514,싹둑/Noun,3,1,2,1.1115310228308472e-05,2.2213830330763933e-05,0.6666666666666666
21515,상부/Noun,3,2,1,2.2230620456616944e-05,1.1106915165381966e-05,0.6666666666666666
21516,허름/Noun,3,2,1,2.2230620456616944e-05,1.1106915165381966e-05,0.6666666666666666
21517,장애우/Noun,3,2,1,2.2230620456616944e-05,1.1106915165381966e-05,0.6666666666666666
21518,살면서/Foreign,3,1,2,1.1115310228308472e-05,2.2213830330763933e-05,0.6666666666666666
21519,김명곤/Noun,3,2,1,2.2230620456616944e-05,1.1106915165381966e-05,0.6666666666666666
21520,알리바이/Noun,3,1,2,1.1115310228308472e-05,2.2213830330763933e-05,0.6666666666666666
21521,모비딕/Noun,3,1,2,1.1115310228308472e-05,2.2213830330763933e-05,0.6666666666666666
21522,부티/Noun,3,1,2,1.1115310228308472e-05,2.2213830330763933e-05,0.6666666666666666
21523,화초/Noun,3,1,2,1.1115310228308472e-05,2.2213830330763933e-05,0.6666666666666666
21524,불빛/Noun,3,1,2,1.1115310228308472e-05,2.2213830330763933e-05,0.6666666666666666
21525,나누어지다/Verb,3,1,2,1.1115310228308472e-05,2.2213830330763933e-05,0.6666666666666666
21526,경수/Noun,3,2,1,2.2230620456616944e-05,1.1106915165381966e-05,0.6666666666666666
21527,패스트푸드/Noun,3,2,1,2.2230620456616944e-05,1.1106915165381966e-05,0.6666666666666666
21528,홀로코스트/Noun,3,2,1,2.2230620456616944e-05,1.1106915165381966e-05,0.6666666666666666
21529,강문영/Noun,3,1,2,1.1115310228308472e-05,2.2213830330763933e-05,0.6666666666666666
21530,억대/Noun,3,2,1,2.2230620456616944e-05,1.1106915165381966e-05,0.6666666666666666
21531,아이보리/Noun,3,2,1,2.2230620456616944e-05,1.1106915165381966e-05,0.6666666666666666
21532,!?!/Punctuation,3,1,2,1.1115310228308472e-05,2.2213830330763933e-05,0.6666666666666666
21533,월광/Noun,3,2,1,2.2230620456616944e-05,1.1106915165381966e-05,0.6666666666666666
21534,간단명료/Noun,3,2,1,2.2230620456616944e-05,1.1106915165381966e-05,0.6666666666666666
21535,군영/Noun,3,1,2,1.1115310228308472e-05,2.2213830330763933e-05,0.6666666666666666
21536,헐뜯다/Verb,3,2,1,2.2230620456616944e-05,1.1106915165381966e-05,0.6666666666666666
21537,정훈/Noun,3,2,1,2.2230620456616944e-05,1.1106915165381966e-05,0.6666666666666666
21538,남부/Noun,3,2,1,2.2230620456616944e-05,1.1106915165381966e-05,0.6666666666666666
21539,기분조타/Noun,3,1,2,1.1115310228308472e-05,2.2213830330763933e-05,0.6666666666666666
21540,너바나/Noun,3,1,2,1.1115310228308472e-05,2.2213830330763933e-05,0.6666666666666666
21541,",...../Punctuation",3,1,2,1.1115310228308472e-05,2.2213830330763933e-05,0.6666666666666666
21542,Are/Alpha,3,2,1,2.2230620456616944e-05,1.1106915165381966e-05,0.6666666666666666
21543,멕시칸/Noun,3,2,1,2.2230620456616944e-05,1.1106915165381966e-05,0.6666666666666666
21544,노근리/Noun,3,2,1,2.2230620456616944e-05,1.1106915165381966e-05,0.6666666666666666
21545,짜리몽땅/Noun,3,1,2,1.1115310228308472e-05,2.2213830330763933e-05,0.6666666666666666
21546,할꼬/Noun,3,1,2,1.1115310228308472e-05,2.2213830330763933e-05,0.6666666666666666
21547,평준화/Noun,3,1,2,1.1115310228308472e-05,2.2213830330763933e-05,0.6666666666666666
21548,생인/Noun,3,2,1,2.2230620456616944e-05,1.1106915165381966e-05,0.6666666666666666
21549,액선/Noun,3,2,1,2.2230620456616944e-05,1.1106915165381966e-05,0.6666666666666666
21550,환전/Noun,3,2,1,2.2230620456616944e-05,1.1106915165381966e-05,0.6666666666666666
21551,떠보다/Verb,3,1,2,1.1115310228308472e-05,2.2213830330763933e-05,0.6666666666666666
21552,오키나와/Noun,3,2,1,2.2230620456616944e-05,1.1106915165381966e-05,0.6666666666666666
21553,아이로봇/Noun,3,2,1,2.2230620456616944e-05,1.1106915165381966e-05,0.6666666666666666
21554,시안/Noun,3,1,2,1.1115310228308472e-05,2.2213830330763933e-05,0.6666666666666666
21555,발키리/Noun,3,1,2,1.1115310228308472e-05,2.2213830330763933e-05,0.6666666666666666
21556,웨이브/Noun,3,1,2,1.1115310228308472e-05,2.2213830330763933e-05,0.6666666666666666
21557,피터지다/Adjective,3,2,1,2.2230620456616944e-05,1.1106915165381966e-05,0.6666666666666666
21558,송곳/Noun,3,1,2,1.1115310228308472e-05,2.2213830330763933e-05,0.6666666666666666
21559,늑대개/Noun,3,1,2,1.1115310228308472e-05,2.2213830330763933e-05,0.6666666666666666
21560,카사블랑카/Noun,3,2,1,2.2230620456616944e-05,1.1106915165381966e-05,0.6666666666666666
21561,미소년/Noun,3,2,1,2.2230620456616944e-05,1.1106915165381966e-05,0.6666666666666666
21562,학업/Noun,3,2,1,2.2230620456616944e-05,1.1106915165381966e-05,0.6666666666666666
21563,에블린/Noun,3,2,1,2.2230620456616944e-05,1.1106915165381966e-05,0.6666666666666666
21564,이맘/Noun,3,2,1,2.2230620456616944e-05,1.1106915165381966e-05,0.6666666666666666
21565,동안은/Foreign,3,1,2,1.1115310228308472e-05,2.2213830330763933e-05,0.6666666666666666
21566,연애영화/Noun,3,2,1,2.2230620456616944e-05,1.1106915165381966e-05,0.6666666666666666
21567,배스/Noun,3,1,2,1.1115310228308472e-05,2.2213830330763933e-05,0.6666666666666666
21568,유니/Noun,3,1,2,1.1115310228308472e-05,2.2213830330763933e-05,0.6666666666666666
21569,고여/Noun,3,1,2,1.1115310228308472e-05,2.2213830330763933e-05,0.6666666666666666
21570,단속/Noun,3,1,2,1.1115310228308472e-05,2.2213830330763933e-05,0.6666666666666666
21571,윤간/Noun,3,1,2,1.1115310228308472e-05,2.2213830330763933e-05,0.6666666666666666
21572,류시퍼/Noun,3,1,2,1.1115310228308472e-05,2.2213830330763933e-05,0.6666666666666666
21573,기사도/Noun,3,2,1,2.2230620456616944e-05,1.1106915165381966e-05,0.6666666666666666
21574,장편소설/Noun,3,2,1,2.2230620456616944e-05,1.1106915165381966e-05,0.6666666666666666
21575,스파이더/Noun,3,1,2,1.1115310228308472e-05,2.2213830330763933e-05,0.6666666666666666
21576,전회/Noun,3,2,1,2.2230620456616944e-05,1.1106915165381966e-05,0.6666666666666666
21577,TVA/Alpha,3,2,1,2.2230620456616944e-05,1.1106915165381966e-05,0.6666666666666666
21578,아스카/Noun,3,2,1,2.2230620456616944e-05,1.1106915165381966e-05,0.6666666666666666
21579,보름달/Noun,3,2,1,2.2230620456616944e-05,1.1106915165381966e-05,0.6666666666666666
21580,크라이스트/Noun,3,1,2,1.1115310228308472e-05,2.2213830330763933e-05,0.6666666666666666
21581,주란/Noun,3,1,2,1.1115310228308472e-05,2.2213830330763933e-05,0.6666666666666666
21582,진장/Noun,3,2,1,2.2230620456616944e-05,1.1106915165381966e-05,0.6666666666666666
21583,선후배/Noun,3,2,1,2.2230620456616944e-05,1.1106915165381966e-05,0.6666666666666666
21584,아른/Noun,3,2,1,2.2230620456616944e-05,1.1106915165381966e-05,0.6666666666666666
21585,수아/Noun,3,2,1,2.2230620456616944e-05,1.1106915165381966e-05,0.6666666666666666
21586,빗물/Noun,3,2,1,2.2230620456616944e-05,1.1106915165381966e-05,0.6666666666666666
21587,태극기휘날리며/Noun,3,2,1,2.2230620456616944e-05,1.1106915165381966e-05,0.6666666666666666
21588,배구/Noun,3,1,2,1.1115310228308472e-05,2.2213830330763933e-05,0.6666666666666666
21589,소수민족/Noun,3,1,2,1.1115310228308472e-05,2.2213830330763933e-05,0.6666666666666666
21590,年/Foreign,3,2,1,2.2230620456616944e-05,1.1106915165381966e-05,0.6666666666666666
21591,기모노/Noun,3,1,2,1.1115310228308472e-05,2.2213830330763933e-05,0.6666666666666666
21592,낑기다/Adjective,3,1,2,1.1115310228308472e-05,2.2213830330763933e-05,0.6666666666666666
21593,곰플레이어/Noun,3,1,2,1.1115310228308472e-05,2.2213830330763933e-05,0.6666666666666666
21594,beauty/Alpha,3,2,1,2.2230620456616944e-05,1.1106915165381966e-05,0.6666666666666666
21595,sin/Alpha,3,1,2,1.1115310228308472e-05,2.2213830330763933e-05,0.6666666666666666
21596,이슬람권/Noun,3,1,2,1.1115310228308472e-05,2.2213830330763933e-05,0.6666666666666666
21597,가량/Foreign,3,1,2,1.1115310228308472e-05,2.2213830330763933e-05,0.6666666666666666
21598,난적/Noun,3,1,2,1.1115310228308472e-05,2.2213830330763933e-05,0.6666666666666666
21599,우리형/Noun,3,2,1,2.2230620456616944e-05,1.1106915165381966e-05,0.6666666666666666
21600,도부/Noun,3,1,2,1.1115310228308472e-05,2.2213830330763933e-05,0.6666666666666666
21601,친목/Noun,3,1,2,1.1115310228308472e-05,2.2213830330763933e-05,0.6666666666666666
21602,적대/Noun,3,2,1,2.2230620456616944e-05,1.1106915165381966e-05,0.6666666666666666
21603,권유리/Noun,3,1,2,1.1115310228308472e-05,2.2213830330763933e-05,0.6666666666666666
21604,기습/Noun,3,1,2,1.1115310228308472e-05,2.2213830330763933e-05,0.6666666666666666
21605,님말/Noun,3,1,2,1.1115310228308472e-05,2.2213830330763933e-05,0.6666666666666666
21606,고행/Noun,3,1,2,1.1115310228308472e-05,2.2213830330763933e-05,0.6666666666666666
21607,백점만점/Noun,3,2,1,2.2230620456616944e-05,1.1106915165381966e-05,0.6666666666666666
21608,신혜수/Noun,3,2,1,2.2230620456616944e-05,1.1106915165381966e-05,0.6666666666666666
21609,ㄱㅋㅋ/KoreanParticle,3,1,2,1.1115310228308472e-05,2.2213830330763933e-05,0.6666666666666666
21610,미역/Noun,3,2,1,2.2230620456616944e-05,1.1106915165381966e-05,0.6666666666666666
21611,썪/Noun,3,1,2,1.1115310228308472e-05,2.2213830330763933e-05,0.6666666666666666
21612,라드/Noun,3,1,2,1.1115310228308472e-05,2.2213830330763933e-05,0.6666666666666666
21613,~;;/Punctuation,3,1,2,1.1115310228308472e-05,2.2213830330763933e-05,0.6666666666666666
21614,반년/Noun,3,2,1,2.2230620456616944e-05,1.1106915165381966e-05,0.6666666666666666
21615,○○/Foreign,3,1,2,1.1115310228308472e-05,2.2213830330763933e-05,0.6666666666666666
21616,흡연/Noun,3,2,1,2.2230620456616944e-05,1.1106915165381966e-05,0.6666666666666666
21617,애띤/Noun,3,2,1,2.2230620456616944e-05,1.1106915165381966e-05,0.6666666666666666
21618,쉐일린/Noun,3,2,1,2.2230620456616944e-05,1.1106915165381966e-05,0.6666666666666666
21619,개한민국/Noun,3,2,1,2.2230620456616944e-05,1.1106915165381966e-05,0.6666666666666666
21620,스코틀랜드/Noun,3,2,1,2.2230620456616944e-05,1.1106915165381966e-05,0.6666666666666666
21621,l/Alpha,3,2,1,2.2230620456616944e-05,1.1106915165381966e-05,0.6666666666666666
21622,음악회/Noun,3,1,2,1.1115310228308472e-05,2.2213830330763933e-05,0.6666666666666666
21623,헤어지자/Noun,3,1,2,1.1115310228308472e-05,2.2213830330763933e-05,0.6666666666666666
21624,cia/Alpha,3,1,2,1.1115310228308472e-05,2.2213830330763933e-05,0.6666666666666666
21625,피타/Noun,3,1,2,1.1115310228308472e-05,2.2213830330763933e-05,0.6666666666666666
21626,산이면/Noun,3,1,2,1.1115310228308472e-05,2.2213830330763933e-05,0.6666666666666666
21627,정도는/Foreign,3,1,2,1.1115310228308472e-05,2.2213830330763933e-05,0.6666666666666666
21628,브롤/Noun,3,2,1,2.2230620456616944e-05,1.1106915165381966e-05,0.6666666666666666
21629,떳길/Noun,3,1,2,1.1115310228308472e-05,2.2213830330763933e-05,0.6666666666666666
21630,라리사/Noun,3,1,2,1.1115310228308472e-05,2.2213830330763933e-05,0.6666666666666666
21631,빅매치/Noun,3,1,2,1.1115310228308472e-05,2.2213830330763933e-05,0.6666666666666666
21632,스토크/Noun,3,1,2,1.1115310228308472e-05,2.2213830330763933e-05,0.6666666666666666
21633,이도경/Noun,3,1,2,1.1115310228308472e-05,2.2213830330763933e-05,0.6666666666666666
21634,완점/Noun,3,2,1,2.2230620456616944e-05,1.1106915165381966e-05,0.6666666666666666
21635,용광로/Noun,3,2,1,2.2230620456616944e-05,1.1106915165381966e-05,0.6666666666666666
21636,절루/Noun,3,1,2,1.1115310228308472e-05,2.2213830330763933e-05,0.6666666666666666
21637,호스/Noun,3,1,2,1.1115310228308472e-05,2.2213830330763933e-05,0.6666666666666666
21638,왜내/Noun,3,2,1,2.2230620456616944e-05,1.1106915165381966e-05,0.6666666666666666
21639,!?!?/Punctuation,3,1,2,1.1115310228308472e-05,2.2213830330763933e-05,0.6666666666666666
21640,주간/Noun,3,1,2,1.1115310228308472e-05,2.2213830330763933e-05,0.6666666666666666
21641,진쨔/Noun,3,1,2,1.1115310228308472e-05,2.2213830330763933e-05,0.6666666666666666
21642,충혈/Noun,3,2,1,2.2230620456616944e-05,1.1106915165381966e-05,0.6666666666666666
21643,핸콕/Noun,3,2,1,2.2230620456616944e-05,1.1106915165381966e-05,0.6666666666666666
21644,드마/Noun,3,1,2,1.1115310228308472e-05,2.2213830330763933e-05,0.6666666666666666
21645,종소리/Noun,3,2,1,2.2230620456616944e-05,1.1106915165381966e-05,0.6666666666666666
21646,장길산/Noun,3,2,1,2.2230620456616944e-05,1.1106915165381966e-05,0.6666666666666666
21647,간주/Noun,3,1,2,1.1115310228308472e-05,2.2213830330763933e-05,0.6666666666666666
21648,망라/Noun,3,2,1,2.2230620456616944e-05,1.1106915165381966e-05,0.6666666666666666
21649,매달/Noun,3,1,2,1.1115310228308472e-05,2.2213830330763933e-05,0.6666666666666666
21650,ㅇㄷ/KoreanParticle,3,2,1,2.2230620456616944e-05,1.1106915165381966e-05,0.6666666666666666
21651,삼분/Noun,3,1,2,1.1115310228308472e-05,2.2213830330763933e-05,0.6666666666666666
21652,렸/Noun,3,1,2,1.1115310228308472e-05,2.2213830330763933e-05,0.6666666666666666
21653,악귀/Noun,3,1,2,1.1115310228308472e-05,2.2213830330763933e-05,0.6666666666666666
21654,최윤영/Noun,3,2,1,2.2230620456616944e-05,1.1106915165381966e-05,0.6666666666666666
21655,봣을까/Noun,3,2,1,2.2230620456616944e-05,1.1106915165381966e-05,0.6666666666666666
21656,쾌걸조로/Noun,3,1,2,1.1115310228308472e-05,2.2213830330763933e-05,0.6666666666666666
21657,잡식/Noun,3,1,2,1.1115310228308472e-05,2.2213830330763933e-05,0.6666666666666666
21658,XTM/Alpha,3,1,2,1.1115310228308472e-05,2.2213830330763933e-05,0.6666666666666666
21659,셧다/Noun,3,2,1,2.2230620456616944e-05,1.1106915165381966e-05,0.6666666666666666
21660,반적/Noun,3,2,1,2.2230620456616944e-05,1.1106915165381966e-05,0.6666666666666666
21661,2016년/Number,3,1,2,1.1115310228308472e-05,2.2213830330763933e-05,0.6666666666666666
21662,dmb/Alpha,3,1,2,1.1115310228308472e-05,2.2213830330763933e-05,0.6666666666666666
21663,好/Foreign,3,1,2,1.1115310228308472e-05,2.2213830330763933e-05,0.6666666666666666
21664,아라/Eomi,3,2,1,2.2230620456616944e-05,1.1106915165381966e-05,0.6666666666666666
21665,왁/Adverb,3,2,1,2.2230620456616944e-05,1.1106915165381966e-05,0.6666666666666666
21666,소련군/Noun,3,2,1,2.2230620456616944e-05,1.1106915165381966e-05,0.6666666666666666
21667,53/Number,3,1,2,1.1115310228308472e-05,2.2213830330763933e-05,0.6666666666666666
21668,출근길/Noun,3,2,1,2.2230620456616944e-05,1.1106915165381966e-05,0.6666666666666666
21669,괴력/Noun,3,2,1,2.2230620456616944e-05,1.1106915165381966e-05,0.6666666666666666
21670,",,.../Punctuation",3,1,2,1.1115310228308472e-05,2.2213830330763933e-05,0.6666666666666666
21671,리프트/Noun,3,2,1,2.2230620456616944e-05,1.1106915165381966e-05,0.6666666666666666
21672,진격의거인/Noun,3,1,2,1.1115310228308472e-05,2.2213830330763933e-05,0.6666666666666666
21673,심상/Noun,3,2,1,2.2230620456616944e-05,1.1106915165381966e-05,0.6666666666666666
21674,조총/Noun,3,2,1,2.2230620456616944e-05,1.1106915165381966e-05,0.6666666666666666
21675,이라기보다는/Josa,3,2,1,2.2230620456616944e-05,1.1106915165381966e-05,0.6666666666666666
21676,전인/Foreign,3,2,1,2.2230620456616944e-05,1.1106915165381966e-05,0.6666666666666666
21677,공역/Noun,3,2,1,2.2230620456616944e-05,1.1106915165381966e-05,0.6666666666666666
21678,가정사/Noun,3,2,1,2.2230620456616944e-05,1.1106915165381966e-05,0.6666666666666666
21679,랑/Noun,3,1,2,1.1115310228308472e-05,2.2213830330763933e-05,0.6666666666666666
21680,유빈/Noun,3,1,2,1.1115310228308472e-05,2.2213830330763933e-05,0.6666666666666666
21681,부친/Noun,3,1,2,1.1115310228308472e-05,2.2213830330763933e-05,0.6666666666666666
21682,",,,,,,,,,,/Punctuation",3,1,2,1.1115310228308472e-05,2.2213830330763933e-05,0.6666666666666666
21683,연못/Noun,3,2,1,2.2230620456616944e-05,1.1106915165381966e-05,0.6666666666666666
21684,sun/Alpha,3,2,1,2.2230620456616944e-05,1.1106915165381966e-05,0.6666666666666666
21685,쑥/Noun,3,1,2,1.1115310228308472e-05,2.2213830330763933e-05,0.6666666666666666
21686,뉴요커/Noun,3,2,1,2.2230620456616944e-05,1.1106915165381966e-05,0.6666666666666666
21687,포크/Noun,3,2,1,2.2230620456616944e-05,1.1106915165381966e-05,0.6666666666666666
21688,마조히즘/Noun,3,2,1,2.2230620456616944e-05,1.1106915165381966e-05,0.6666666666666666
21689,가장자리/Noun,3,2,1,2.2230620456616944e-05,1.1106915165381966e-05,0.6666666666666666
21690,군말/Noun,3,1,2,1.1115310228308472e-05,2.2213830330763933e-05,0.6666666666666666
21691,57%/Number,3,1,2,1.1115310228308472e-05,2.2213830330763933e-05,0.6666666666666666
21692,데보라/Noun,3,2,1,2.2230620456616944e-05,1.1106915165381966e-05,0.6666666666666666
21693,스트리퍼/Noun,3,1,2,1.1115310228308472e-05,2.2213830330763933e-05,0.6666666666666666
21694,처녀작/Noun,3,2,1,2.2230620456616944e-05,1.1106915165381966e-05,0.6666666666666666
21695,방정식/Noun,3,1,2,1.1115310228308472e-05,2.2213830330763933e-05,0.6666666666666666
21696,데릭/Noun,3,1,2,1.1115310228308472e-05,2.2213830330763933e-05,0.6666666666666666
21697,경솔하다/Adjective,3,1,2,1.1115310228308472e-05,2.2213830330763933e-05,0.6666666666666666
21698,스폰지/Noun,3,2,1,2.2230620456616944e-05,1.1106915165381966e-05,0.6666666666666666
21699,망극/Noun,3,1,2,1.1115310228308472e-05,2.2213830330763933e-05,0.6666666666666666
21700,평가자/Noun,3,1,2,1.1115310228308472e-05,2.2213830330763933e-05,0.6666666666666666
21701,`~/Punctuation,3,1,2,1.1115310228308472e-05,2.2213830330763933e-05,0.6666666666666666
21702,스멀스멀/Adverb,3,2,1,2.2230620456616944e-05,1.1106915165381966e-05,0.6666666666666666
21703,라보/Noun,3,1,2,1.1115310228308472e-05,2.2213830330763933e-05,0.6666666666666666
21704,윗/Noun,3,2,1,2.2230620456616944e-05,1.1106915165381966e-05,0.6666666666666666
21705,넷다/Noun,3,2,1,2.2230620456616944e-05,1.1106915165381966e-05,0.6666666666666666
21706,정길/Noun,3,1,2,1.1115310228308472e-05,2.2213830330763933e-05,0.6666666666666666
21707,피치퍼펙트/Noun,3,2,1,2.2230620456616944e-05,1.1106915165381966e-05,0.6666666666666666
21708,"....,,/Punctuation",3,1,2,1.1115310228308472e-05,2.2213830330763933e-05,0.6666666666666666
21709,6.61/Number,3,1,2,1.1115310228308472e-05,2.2213830330763933e-05,0.6666666666666666
21710,뒤쪽/Noun,3,1,2,1.1115310228308472e-05,2.2213830330763933e-05,0.6666666666666666
21711,껀줄/Noun,3,1,2,1.1115310228308472e-05,2.2213830330763933e-05,0.6666666666666666
21712,혜원/Noun,3,2,1,2.2230620456616944e-05,1.1106915165381966e-05,0.6666666666666666
21713,수퍼히어로/Noun,3,1,2,1.1115310228308472e-05,2.2213830330763933e-05,0.6666666666666666
21714,리칸/Noun,3,1,2,1.1115310228308472e-05,2.2213830330763933e-05,0.6666666666666666
21715,오감도/Noun,3,1,2,1.1115310228308472e-05,2.2213830330763933e-05,0.6666666666666666
21716,포커/Noun,3,1,2,1.1115310228308472e-05,2.2213830330763933e-05,0.6666666666666666
21717,연세/Noun,3,2,1,2.2230620456616944e-05,1.1106915165381966e-05,0.6666666666666666
21718,정애연/Noun,3,2,1,2.2230620456616944e-05,1.1106915165381966e-05,0.6666666666666666
21719,상쇄/Noun,3,2,1,2.2230620456616944e-05,1.1106915165381966e-05,0.6666666666666666
21720,여든/Noun,3,1,2,1.1115310228308472e-05,2.2213830330763933e-05,0.6666666666666666
21721,여/Foreign,3,1,2,1.1115310228308472e-05,2.2213830330763933e-05,0.6666666666666666
21722,유혈/Noun,3,1,2,1.1115310228308472e-05,2.2213830330763933e-05,0.6666666666666666
21723,에스비에스/Noun,3,1,2,1.1115310228308472e-05,2.2213830330763933e-05,0.6666666666666666
21724,사법부/Noun,3,2,1,2.2230620456616944e-05,1.1106915165381966e-05,0.6666666666666666
21725,한적하다/Adjective,3,2,1,2.2230620456616944e-05,1.1106915165381966e-05,0.6666666666666666
21726,도진/Noun,3,1,2,1.1115310228308472e-05,2.2213830330763933e-05,0.6666666666666666
21727,떠들썩하다/Adjective,3,1,2,1.1115310228308472e-05,2.2213830330763933e-05,0.6666666666666666
21728,구의/Noun,3,2,1,2.2230620456616944e-05,1.1106915165381966e-05,0.6666666666666666
21729,이성애/Noun,3,2,1,2.2230620456616944e-05,1.1106915165381966e-05,0.6666666666666666
21730,사샤/Noun,3,1,2,1.1115310228308472e-05,2.2213830330763933e-05,0.6666666666666666
21731,무정/Noun,3,1,2,1.1115310228308472e-05,2.2213830330763933e-05,0.6666666666666666
21732,무무/Noun,3,2,1,2.2230620456616944e-05,1.1106915165381966e-05,0.6666666666666666
21733,에이지/Noun,3,2,1,2.2230620456616944e-05,1.1106915165381966e-05,0.6666666666666666
21734,머니볼/Noun,3,1,2,1.1115310228308472e-05,2.2213830330763933e-05,0.6666666666666666
21735,파코/Noun,3,1,2,1.1115310228308472e-05,2.2213830330763933e-05,0.6666666666666666
21736,씨네프/Noun,3,1,2,1.1115310228308472e-05,2.2213830330763933e-05,0.6666666666666666
21737,불우하다/Adjective,3,1,2,1.1115310228308472e-05,2.2213830330763933e-05,0.6666666666666666
21738,요추/Noun,3,2,1,2.2230620456616944e-05,1.1106915165381966e-05,0.6666666666666666
21739,얽매이다/Verb,3,2,1,2.2230620456616944e-05,1.1106915165381966e-05,0.6666666666666666
21740,홍홍/Noun,3,1,2,1.1115310228308472e-05,2.2213830330763933e-05,0.6666666666666666
21741,서강준/Noun,3,1,2,1.1115310228308472e-05,2.2213830330763933e-05,0.6666666666666666
21742,킥복싱/Noun,3,1,2,1.1115310228308472e-05,2.2213830330763933e-05,0.6666666666666666
21743,윙/Noun,3,2,1,2.2230620456616944e-05,1.1106915165381966e-05,0.6666666666666666
21744,../Foreign,3,2,1,2.2230620456616944e-05,1.1106915165381966e-05,0.6666666666666666
21745,양멱/Noun,3,1,2,1.1115310228308472e-05,2.2213830330763933e-05,0.6666666666666666
21746,케이팝/Noun,3,1,2,1.1115310228308472e-05,2.2213830330763933e-05,0.6666666666666666
21747,정시아/Noun,3,1,2,1.1115310228308472e-05,2.2213830330763933e-05,0.6666666666666666
21748,막문위/Noun,3,2,1,2.2230620456616944e-05,1.1106915165381966e-05,0.6666666666666666
21749,지보/Noun,3,1,2,1.1115310228308472e-05,2.2213830330763933e-05,0.6666666666666666
21750,○/Foreign,3,2,1,2.2230620456616944e-05,1.1106915165381966e-05,0.6666666666666666
21751,해악/Noun,3,1,2,1.1115310228308472e-05,2.2213830330763933e-05,0.6666666666666666
21752,개선문/Noun,3,2,1,2.2230620456616944e-05,1.1106915165381966e-05,0.6666666666666666
21753,거뜬하다/Adjective,3,1,2,1.1115310228308472e-05,2.2213830330763933e-05,0.6666666666666666
21754,검정/Noun,3,2,1,2.2230620456616944e-05,1.1106915165381966e-05,0.6666666666666666
21755,열혈남아/Noun,3,2,1,2.2230620456616944e-05,1.1106915165381966e-05,0.6666666666666666
21756,활기/Noun,3,2,1,2.2230620456616944e-05,1.1106915165381966e-05,0.6666666666666666
21757,ㅁㄴㅇㄹ/KoreanParticle,3,2,1,2.2230620456616944e-05,1.1106915165381966e-05,0.6666666666666666
21758,불의/Foreign,3,2,1,2.2230620456616944e-05,1.1106915165381966e-05,0.6666666666666666
21759,근로/Noun,3,1,2,1.1115310228308472e-05,2.2213830330763933e-05,0.6666666666666666
21760,고층/Noun,3,2,1,2.2230620456616944e-05,1.1106915165381966e-05,0.6666666666666666
21761,대와/Foreign,3,2,1,2.2230620456616944e-05,1.1106915165381966e-05,0.6666666666666666
21762,건맨/Noun,3,2,1,2.2230620456616944e-05,1.1106915165381966e-05,0.6666666666666666
21763,몹쓸/Modifier,3,1,2,1.1115310228308472e-05,2.2213830330763933e-05,0.6666666666666666
21764,꼇/Noun,3,2,1,2.2230620456616944e-05,1.1106915165381966e-05,0.6666666666666666
21765,음악인/Noun,3,2,1,2.2230620456616944e-05,1.1106915165381966e-05,0.6666666666666666
21766,초보자/Noun,3,2,1,2.2230620456616944e-05,1.1106915165381966e-05,0.6666666666666666
21767,뉴질랜드/Noun,3,2,1,2.2230620456616944e-05,1.1106915165381966e-05,0.6666666666666666
21768,조정래/Noun,3,2,1,2.2230620456616944e-05,1.1106915165381966e-05,0.6666666666666666
21769,니트/Noun,3,1,2,1.1115310228308472e-05,2.2213830330763933e-05,0.6666666666666666
21770,구절/Noun,3,1,2,1.1115310228308472e-05,2.2213830330763933e-05,0.6666666666666666
21771,은빛/Noun,3,1,2,1.1115310228308472e-05,2.2213830330763933e-05,0.6666666666666666
21772,루루/Noun,3,1,2,1.1115310228308472e-05,2.2213830330763933e-05,0.6666666666666666
21773,학문/Noun,3,2,1,2.2230620456616944e-05,1.1106915165381966e-05,0.6666666666666666
21774,안느/Noun,3,1,2,1.1115310228308472e-05,2.2213830330763933e-05,0.6666666666666666
21775,쪼그/Noun,3,2,1,2.2230620456616944e-05,1.1106915165381966e-05,0.6666666666666666
21776,사십/Modifier,3,2,1,2.2230620456616944e-05,1.1106915165381966e-05,0.6666666666666666
21777,점감/Noun,3,1,2,1.1115310228308472e-05,2.2213830330763933e-05,0.6666666666666666
21778,웤/Noun,3,1,2,1.1115310228308472e-05,2.2213830330763933e-05,0.6666666666666666
21779,어플/Noun,3,2,1,2.2230620456616944e-05,1.1106915165381966e-05,0.6666666666666666
21780,하소연/Noun,3,1,2,1.1115310228308472e-05,2.2213830330763933e-05,0.6666666666666666
21781,트레일러/Noun,3,1,2,1.1115310228308472e-05,2.2213830330763933e-05,0.6666666666666666
21782,메디/Noun,3,2,1,2.2230620456616944e-05,1.1106915165381966e-05,0.6666666666666666
21783,예인/Noun,3,2,1,2.2230620456616944e-05,1.1106915165381966e-05,0.6666666666666666
21784,농약/Noun,3,1,2,1.1115310228308472e-05,2.2213830330763933e-05,0.6666666666666666
21785,이과/Noun,3,1,2,1.1115310228308472e-05,2.2213830330763933e-05,0.6666666666666666
21786,비즈니스/Noun,3,1,2,1.1115310228308472e-05,2.2213830330763933e-05,0.6666666666666666
21787,비됴가게/Noun,3,2,1,2.2230620456616944e-05,1.1106915165381966e-05,0.6666666666666666
21788,왓치맨/Noun,3,1,2,1.1115310228308472e-05,2.2213830330763933e-05,0.6666666666666666
21789,후궁/Noun,3,2,1,2.2230620456616944e-05,1.1106915165381966e-05,0.6666666666666666
21790,명가/Noun,3,1,2,1.1115310228308472e-05,2.2213830330763933e-05,0.6666666666666666
21791,독약/Noun,3,1,2,1.1115310228308472e-05,2.2213830330763933e-05,0.6666666666666666
21792,오리무중/Noun,3,1,2,1.1115310228308472e-05,2.2213830330763933e-05,0.6666666666666666
21793,관왕/Noun,3,1,2,1.1115310228308472e-05,2.2213830330763933e-05,0.6666666666666666
21794,화창하다/Adjective,3,1,2,1.1115310228308472e-05,2.2213830330763933e-05,0.6666666666666666
21795,다재/Noun,3,1,2,1.1115310228308472e-05,2.2213830330763933e-05,0.6666666666666666
21796,통키/Noun,3,2,1,2.2230620456616944e-05,1.1106915165381966e-05,0.6666666666666666
21797,가어/Noun,3,2,1,2.2230620456616944e-05,1.1106915165381966e-05,0.6666666666666666
21798,거렸/Noun,3,2,1,2.2230620456616944e-05,1.1106915165381966e-05,0.6666666666666666
21799,프렌차이즈/Noun,3,1,2,1.1115310228308472e-05,2.2213830330763933e-05,0.6666666666666666
21800,버퍼링/Noun,3,1,2,1.1115310228308472e-05,2.2213830330763933e-05,0.6666666666666666
21801,키무/Noun,3,1,2,1.1115310228308472e-05,2.2213830330763933e-05,0.6666666666666666
21802,유관순/Noun,3,2,1,2.2230620456616944e-05,1.1106915165381966e-05,0.6666666666666666
21803,윤상/Noun,3,2,1,2.2230620456616944e-05,1.1106915165381966e-05,0.6666666666666666
21804,초고/Noun,3,1,2,1.1115310228308472e-05,2.2213830330763933e-05,0.6666666666666666
21805,채린/Noun,3,1,2,1.1115310228308472e-05,2.2213830330763933e-05,0.6666666666666666
21806,쉘/Noun,3,2,1,2.2230620456616944e-05,1.1106915165381966e-05,0.6666666666666666
21807,김동빈/Noun,3,1,2,1.1115310228308472e-05,2.2213830330763933e-05,0.6666666666666666
21808,작이지만/Foreign,3,2,1,2.2230620456616944e-05,1.1106915165381966e-05,0.6666666666666666
21809,양가/Noun,3,1,2,1.1115310228308472e-05,2.2213830330763933e-05,0.6666666666666666
21810,강희/Noun,3,1,2,1.1115310228308472e-05,2.2213830330763933e-05,0.6666666666666666
21811,지명도/Noun,3,1,2,1.1115310228308472e-05,2.2213830330763933e-05,0.6666666666666666
21812,사카/Noun,3,2,1,2.2230620456616944e-05,1.1106915165381966e-05,0.6666666666666666
21813,레인저/Noun,3,1,2,1.1115310228308472e-05,2.2213830330763933e-05,0.6666666666666666
21814,밀덕/Noun,3,2,1,2.2230620456616944e-05,1.1106915165381966e-05,0.6666666666666666
21815,정남/Noun,3,2,1,2.2230620456616944e-05,1.1106915165381966e-05,0.6666666666666666
21816,참회/Noun,3,2,1,2.2230620456616944e-05,1.1106915165381966e-05,0.6666666666666666
21817,량/Noun,3,2,1,2.2230620456616944e-05,1.1106915165381966e-05,0.6666666666666666
21818,movies/Alpha,3,2,1,2.2230620456616944e-05,1.1106915165381966e-05,0.6666666666666666
21819,화덕/Noun,3,2,1,2.2230620456616944e-05,1.1106915165381966e-05,0.6666666666666666
21820,쪼그리다/Verb,3,2,1,2.2230620456616944e-05,1.1106915165381966e-05,0.6666666666666666
21821,스퀘어/Noun,3,1,2,1.1115310228308472e-05,2.2213830330763933e-05,0.6666666666666666
21822,카를/Noun,3,1,2,1.1115310228308472e-05,2.2213830330763933e-05,0.6666666666666666
21823,가다듬다/Verb,3,1,2,1.1115310228308472e-05,2.2213830330763933e-05,0.6666666666666666
21824,갉다/Verb,3,1,2,1.1115310228308472e-05,2.2213830330763933e-05,0.6666666666666666
21825,우뚝/Noun,3,1,2,1.1115310228308472e-05,2.2213830330763933e-05,0.6666666666666666
21826,쌀밥/Noun,3,1,2,1.1115310228308472e-05,2.2213830330763933e-05,0.6666666666666666
21827,금수/Noun,3,2,1,2.2230620456616944e-05,1.1106915165381966e-05,0.6666666666666666
21828,만기/Noun,3,2,1,2.2230620456616944e-05,1.1106915165381966e-05,0.6666666666666666
21829,사자성어/Noun,3,2,1,2.2230620456616944e-05,1.1106915165381966e-05,0.6666666666666666
21830,수표/Noun,3,1,2,1.1115310228308472e-05,2.2213830330763933e-05,0.6666666666666666
21831,박애/Noun,3,2,1,2.2230620456616944e-05,1.1106915165381966e-05,0.6666666666666666
21832,경극/Noun,3,1,2,1.1115310228308472e-05,2.2213830330763933e-05,0.6666666666666666
21833,효진/Noun,3,1,2,1.1115310228308472e-05,2.2213830330763933e-05,0.6666666666666666
21834,오뎅/Noun,3,1,2,1.1115310228308472e-05,2.2213830330763933e-05,0.6666666666666666
21835,:-/Punctuation,3,1,2,1.1115310228308472e-05,2.2213830330763933e-05,0.6666666666666666
21836,엘리어트/Noun,3,2,1,2.2230620456616944e-05,1.1106915165381966e-05,0.6666666666666666
21837,than/Alpha,3,2,1,2.2230620456616944e-05,1.1106915165381966e-05,0.6666666666666666
21838,스패/Noun,3,1,2,1.1115310228308472e-05,2.2213830330763933e-05,0.6666666666666666
21839,써비스/Noun,3,1,2,1.1115310228308472e-05,2.2213830330763933e-05,0.6666666666666666
21840,연때/Noun,3,1,2,1.1115310228308472e-05,2.2213830330763933e-05,0.6666666666666666
21841,슬그머니/Noun,3,1,2,1.1115310228308472e-05,2.2213830330763933e-05,0.6666666666666666
21842,훤/Noun,3,1,2,1.1115310228308472e-05,2.2213830330763933e-05,0.6666666666666666
21843,eye/Alpha,3,1,2,1.1115310228308472e-05,2.2213830330763933e-05,0.6666666666666666
21844,알랭들롱/Noun,3,2,1,2.2230620456616944e-05,1.1106915165381966e-05,0.6666666666666666
21845,미동/Noun,3,2,1,2.2230620456616944e-05,1.1106915165381966e-05,0.6666666666666666
21846,불가피하다/Adjective,3,2,1,2.2230620456616944e-05,1.1106915165381966e-05,0.6666666666666666
21847,명소/Noun,3,1,2,1.1115310228308472e-05,2.2213830330763933e-05,0.6666666666666666
21848,코베/Noun,3,2,1,2.2230620456616944e-05,1.1106915165381966e-05,0.6666666666666666
21849,팀버/Noun,3,1,2,1.1115310228308472e-05,2.2213830330763933e-05,0.6666666666666666
21850,일약/Noun,3,2,1,2.2230620456616944e-05,1.1106915165381966e-05,0.6666666666666666
21851,숙취/Noun,3,1,2,1.1115310228308472e-05,2.2213830330763933e-05,0.6666666666666666
21852,일곱/Determiner,3,2,1,2.2230620456616944e-05,1.1106915165381966e-05,0.6666666666666666
21853,;)/Punctuation,3,2,1,2.2230620456616944e-05,1.1106915165381966e-05,0.6666666666666666
21854,글래스/Noun,3,2,1,2.2230620456616944e-05,1.1106915165381966e-05,0.6666666666666666
21855,해밀턴/Noun,3,2,1,2.2230620456616944e-05,1.1106915165381966e-05,0.6666666666666666
21856,오수민/Noun,3,1,2,1.1115310228308472e-05,2.2213830330763933e-05,0.6666666666666666
21857,구래/Noun,3,1,2,1.1115310228308472e-05,2.2213830330763933e-05,0.6666666666666666
21858,광녀/Noun,3,1,2,1.1115310228308472e-05,2.2213830330763933e-05,0.6666666666666666
21859,고공/Noun,3,2,1,2.2230620456616944e-05,1.1106915165381966e-05,0.6666666666666666
21860,Part/Alpha,3,2,1,2.2230620456616944e-05,1.1106915165381966e-05,0.6666666666666666
21861,불량품/Noun,3,1,2,1.1115310228308472e-05,2.2213830330763933e-05,0.6666666666666666
21862,더군요/Eomi,3,2,1,2.2230620456616944e-05,1.1106915165381966e-05,0.6666666666666666
21863,일사천리/Noun,3,1,2,1.1115310228308472e-05,2.2213830330763933e-05,0.6666666666666666
21864,맥도날드/Noun,3,2,1,2.2230620456616944e-05,1.1106915165381966e-05,0.6666666666666666
21865,심성/Noun,3,1,2,1.1115310228308472e-05,2.2213830330763933e-05,0.6666666666666666
21866,어린이집/Noun,3,1,2,1.1115310228308472e-05,2.2213830330763933e-05,0.6666666666666666
21867,원화/Noun,3,2,1,2.2230620456616944e-05,1.1106915165381966e-05,0.6666666666666666
21868,정립/Noun,3,2,1,2.2230620456616944e-05,1.1106915165381966e-05,0.6666666666666666
21869,맬깁슨/Noun,3,2,1,2.2230620456616944e-05,1.1106915165381966e-05,0.6666666666666666
21870,요조/Noun,3,1,2,1.1115310228308472e-05,2.2213830330763933e-05,0.6666666666666666
21871,하달/Noun,3,1,2,1.1115310228308472e-05,2.2213830330763933e-05,0.6666666666666666
21872,제하/Noun,3,1,2,1.1115310228308472e-05,2.2213830330763933e-05,0.6666666666666666
21873,고음/Noun,3,1,2,1.1115310228308472e-05,2.2213830330763933e-05,0.6666666666666666
21874,ㅇㅋㅋ/KoreanParticle,3,2,1,2.2230620456616944e-05,1.1106915165381966e-05,0.6666666666666666
21875,레니할린/Noun,3,2,1,2.2230620456616944e-05,1.1106915165381966e-05,0.6666666666666666
21876,페스티벌/Noun,3,1,2,1.1115310228308472e-05,2.2213830330763933e-05,0.6666666666666666
21877,아역시절/Noun,3,2,1,2.2230620456616944e-05,1.1106915165381966e-05,0.6666666666666666
21878,10.5/Number,3,1,2,1.1115310228308472e-05,2.2213830330763933e-05,0.6666666666666666
21879,평택/Noun,3,1,2,1.1115310228308472e-05,2.2213830330763933e-05,0.6666666666666666
21880,이스턴/Noun,3,2,1,2.2230620456616944e-05,1.1106915165381966e-05,0.6666666666666666
21881,쩌는구/Noun,3,2,1,2.2230620456616944e-05,1.1106915165381966e-05,0.6666666666666666
21882,!!!~~/Punctuation,3,1,2,1.1115310228308472e-05,2.2213830330763933e-05,0.6666666666666666
21883,제지/Noun,3,2,1,2.2230620456616944e-05,1.1106915165381966e-05,0.6666666666666666
21884,굿윌/Noun,3,2,1,2.2230620456616944e-05,1.1106915165381966e-05,0.6666666666666666
21885,패러독스/Noun,3,2,1,2.2230620456616944e-05,1.1106915165381966e-05,0.6666666666666666
21886,이석기/Noun,3,1,2,1.1115310228308472e-05,2.2213830330763933e-05,0.6666666666666666
21887,엣/Noun,3,2,1,2.2230620456616944e-05,1.1106915165381966e-05,0.6666666666666666
21888,장국/Noun,3,1,2,1.1115310228308472e-05,2.2213830330763933e-05,0.6666666666666666
21889,켁/Noun,3,1,2,1.1115310228308472e-05,2.2213830330763933e-05,0.6666666666666666
21890,홀리데이/Noun,3,2,1,2.2230620456616944e-05,1.1106915165381966e-05,0.6666666666666666
21891,나뭇잎/Noun,3,1,2,1.1115310228308472e-05,2.2213830330763933e-05,0.6666666666666666
21892,한소영/Noun,3,2,1,2.2230620456616944e-05,1.1106915165381966e-05,0.6666666666666666
21893,05년/Number,3,1,2,1.1115310228308472e-05,2.2213830330763933e-05,0.6666666666666666
21894,흑인음악/Noun,3,1,2,1.1115310228308472e-05,2.2213830330763933e-05,0.6666666666666666
21895,합창단/Noun,3,2,1,2.2230620456616944e-05,1.1106915165381966e-05,0.6666666666666666
21896,제조/Noun,3,1,2,1.1115310228308472e-05,2.2213830330763933e-05,0.6666666666666666
21897,에세/Noun,3,2,1,2.2230620456616944e-05,1.1106915165381966e-05,0.6666666666666666
21898,인분/Noun,3,1,2,1.1115310228308472e-05,2.2213830330763933e-05,0.6666666666666666
21899,부기/Noun,3,2,1,2.2230620456616944e-05,1.1106915165381966e-05,0.6666666666666666
21900,스쿨/Noun,3,2,1,2.2230620456616944e-05,1.1106915165381966e-05,0.6666666666666666
21901,트렌디/Noun,3,2,1,2.2230620456616944e-05,1.1106915165381966e-05,0.6666666666666666
21902,보셍/Noun,3,2,1,2.2230620456616944e-05,1.1106915165381966e-05,0.6666666666666666
21903,태반/Noun,3,2,1,2.2230620456616944e-05,1.1106915165381966e-05,0.6666666666666666
21904,자웅/Noun,3,1,2,1.1115310228308472e-05,2.2213830330763933e-05,0.6666666666666666
21905,러버/Noun,3,1,2,1.1115310228308472e-05,2.2213830330763933e-05,0.6666666666666666
21906,뿌옇다/Adjective,3,1,2,1.1115310228308472e-05,2.2213830330763933e-05,0.6666666666666666
21907,줄라이/Noun,3,2,1,2.2230620456616944e-05,1.1106915165381966e-05,0.6666666666666666
21908,피폐/Noun,3,2,1,2.2230620456616944e-05,1.1106915165381966e-05,0.6666666666666666
21909,zzzzzzzzzzzz/Alpha,3,2,1,2.2230620456616944e-05,1.1106915165381966e-05,0.6666666666666666
21910,에로의/Josa,3,2,1,2.2230620456616944e-05,1.1106915165381966e-05,0.6666666666666666
21911,정치성향/Noun,3,1,2,1.1115310228308472e-05,2.2213830330763933e-05,0.6666666666666666
21912,입성/Noun,3,2,1,2.2230620456616944e-05,1.1106915165381966e-05,0.6666666666666666
21913,차암/Noun,3,2,1,2.2230620456616944e-05,1.1106915165381966e-05,0.6666666666666666
21914,발가벗다/Verb,3,1,2,1.1115310228308472e-05,2.2213830330763933e-05,0.6666666666666666
21915,익명성/Noun,3,1,2,1.1115310228308472e-05,2.2213830330763933e-05,0.6666666666666666
21916,향취/Noun,3,2,1,2.2230620456616944e-05,1.1106915165381966e-05,0.6666666666666666
21917,인형사/Noun,3,2,1,2.2230620456616944e-05,1.1106915165381966e-05,0.6666666666666666
21918,ㅡㄱ/KoreanParticle,3,1,2,1.1115310228308472e-05,2.2213830330763933e-05,0.6666666666666666
21919,용품/Noun,3,2,1,2.2230620456616944e-05,1.1106915165381966e-05,0.6666666666666666
21920,사소설/Noun,3,1,2,1.1115310228308472e-05,2.2213830330763933e-05,0.6666666666666666
21921,이감/Noun,3,2,1,2.2230620456616944e-05,1.1106915165381966e-05,0.6666666666666666
21922,7%/Number,3,1,2,1.1115310228308472e-05,2.2213830330763933e-05,0.6666666666666666
21923,문과/Noun,3,2,1,2.2230620456616944e-05,1.1106915165381966e-05,0.6666666666666666
21924,럼스/Noun,3,2,1,2.2230620456616944e-05,1.1106915165381966e-05,0.6666666666666666
21925,정보전/Noun,3,2,1,2.2230620456616944e-05,1.1106915165381966e-05,0.6666666666666666
21926,정보기관/Noun,3,1,2,1.1115310228308472e-05,2.2213830330763933e-05,0.6666666666666666
21927,2000만/Number,3,1,2,1.1115310228308472e-05,2.2213830330763933e-05,0.6666666666666666
21928,데우다/Verb,3,1,2,1.1115310228308472e-05,2.2213830330763933e-05,0.6666666666666666
21929,전가/Noun,3,2,1,2.2230620456616944e-05,1.1106915165381966e-05,0.6666666666666666
21930,용해/Noun,3,1,2,1.1115310228308472e-05,2.2213830330763933e-05,0.6666666666666666
21931,뉴라이트/Noun,3,1,2,1.1115310228308472e-05,2.2213830330763933e-05,0.6666666666666666
21932,중국말/Noun,3,2,1,2.2230620456616944e-05,1.1106915165381966e-05,0.6666666666666666
21933,꾸욱/Noun,3,1,2,1.1115310228308472e-05,2.2213830330763933e-05,0.6666666666666666
21934,쫄면/Noun,3,2,1,2.2230620456616944e-05,1.1106915165381966e-05,0.6666666666666666
21935,뽀르노/Noun,3,1,2,1.1115310228308472e-05,2.2213830330763933e-05,0.6666666666666666
21936,주석/Noun,3,1,2,1.1115310228308472e-05,2.2213830330763933e-05,0.6666666666666666
21937,프라하/Noun,3,2,1,2.2230620456616944e-05,1.1106915165381966e-05,0.6666666666666666
21938,은데/Eomi,3,2,1,2.2230620456616944e-05,1.1106915165381966e-05,0.6666666666666666
21939,마빡/Noun,3,2,1,2.2230620456616944e-05,1.1106915165381966e-05,0.6666666666666666
21940,이사벨/Noun,3,1,2,1.1115310228308472e-05,2.2213830330763933e-05,0.6666666666666666
21941,적어지다/Verb,3,1,2,1.1115310228308472e-05,2.2213830330763933e-05,0.6666666666666666
21942,움찔움찔/Adverb,3,2,1,2.2230620456616944e-05,1.1106915165381966e-05,0.6666666666666666
21943,아닐런/Noun,3,2,1,2.2230620456616944e-05,1.1106915165381966e-05,0.6666666666666666
21944,설화/Noun,3,1,2,1.1115310228308472e-05,2.2213830330763933e-05,0.6666666666666666
21945,겟다/Noun,3,1,2,1.1115310228308472e-05,2.2213830330763933e-05,0.6666666666666666
21946,임돠/Noun,3,2,1,2.2230620456616944e-05,1.1106915165381966e-05,0.6666666666666666
21947,원서/Noun,3,1,2,1.1115310228308472e-05,2.2213830330763933e-05,0.6666666666666666
21948,환갑/Noun,3,2,1,2.2230620456616944e-05,1.1106915165381966e-05,0.6666666666666666
21949,폐쇄성/Noun,3,2,1,2.2230620456616944e-05,1.1106915165381966e-05,0.6666666666666666
21950,특수하다/Adjective,3,2,1,2.2230620456616944e-05,1.1106915165381966e-05,0.6666666666666666
21951,태작/Noun,3,1,2,1.1115310228308472e-05,2.2213830330763933e-05,0.6666666666666666
21952,영진위/Noun,3,2,1,2.2230620456616944e-05,1.1106915165381966e-05,0.6666666666666666
21953,효가/Noun,3,1,2,1.1115310228308472e-05,2.2213830330763933e-05,0.6666666666666666
21954,기독/Noun,3,1,2,1.1115310228308472e-05,2.2213830330763933e-05,0.6666666666666666
21955,그랬다고/Conjunction,3,1,2,1.1115310228308472e-05,2.2213830330763933e-05,0.6666666666666666
21956,궁금궁금/Noun,3,1,2,1.1115310228308472e-05,2.2213830330763933e-05,0.6666666666666666
21957,UFC/Alpha,3,1,2,1.1115310228308472e-05,2.2213830330763933e-05,0.6666666666666666
21958,비숫/Noun,3,1,2,1.1115310228308472e-05,2.2213830330763933e-05,0.6666666666666666
21959,피온/Noun,3,1,2,1.1115310228308472e-05,2.2213830330763933e-05,0.6666666666666666
21960,늣/Noun,3,1,2,1.1115310228308472e-05,2.2213830330763933e-05,0.6666666666666666
21961,let/Alpha,3,2,1,2.2230620456616944e-05,1.1106915165381966e-05,0.6666666666666666
21962,들러붙다/Verb,3,1,2,1.1115310228308472e-05,2.2213830330763933e-05,0.6666666666666666
21963,윤지민/Noun,3,2,1,2.2230620456616944e-05,1.1106915165381966e-05,0.6666666666666666
21964,나으니/Noun,3,1,2,1.1115310228308472e-05,2.2213830330763933e-05,0.6666666666666666
21965,선구자/Noun,3,2,1,2.2230620456616944e-05,1.1106915165381966e-05,0.6666666666666666
21966,적적하다/Adjective,3,2,1,2.2230620456616944e-05,1.1106915165381966e-05,0.6666666666666666
21967,소로/Noun,3,1,2,1.1115310228308472e-05,2.2213830330763933e-05,0.6666666666666666
21968,면회/Noun,3,2,1,2.2230620456616944e-05,1.1106915165381966e-05,0.6666666666666666
21969,케익/Noun,3,1,2,1.1115310228308472e-05,2.2213830330763933e-05,0.6666666666666666
21970,썻다/Noun,3,1,2,1.1115310228308472e-05,2.2213830330763933e-05,0.6666666666666666
21971,대냐/Foreign,3,1,2,1.1115310228308472e-05,2.2213830330763933e-05,0.6666666666666666
21972,남극일기/Noun,3,1,2,1.1115310228308472e-05,2.2213830330763933e-05,0.6666666666666666
21973,옥탑방/Noun,3,2,1,2.2230620456616944e-05,1.1106915165381966e-05,0.6666666666666666
21974,구함/Noun,3,2,1,2.2230620456616944e-05,1.1106915165381966e-05,0.6666666666666666
21975,에세이/Noun,3,2,1,2.2230620456616944e-05,1.1106915165381966e-05,0.6666666666666666
21976,울화/Noun,3,1,2,1.1115310228308472e-05,2.2213830330763933e-05,0.6666666666666666
21977,덕인/Noun,3,2,1,2.2230620456616944e-05,1.1106915165381966e-05,0.6666666666666666
21978,31년/Number,3,1,2,1.1115310228308472e-05,2.2213830330763933e-05,0.6666666666666666
21979,압축시키다/Verb,3,1,2,1.1115310228308472e-05,2.2213830330763933e-05,0.6666666666666666
21980,레일/Noun,3,2,1,2.2230620456616944e-05,1.1106915165381966e-05,0.6666666666666666
21981,햄릿/Noun,3,2,1,2.2230620456616944e-05,1.1106915165381966e-05,0.6666666666666666
21982,금세기/Noun,3,2,1,2.2230620456616944e-05,1.1106915165381966e-05,0.6666666666666666
21983,~~~./Punctuation,3,2,1,2.2230620456616944e-05,1.1106915165381966e-05,0.6666666666666666
21984,진씨/Noun,3,1,2,1.1115310228308472e-05,2.2213830330763933e-05,0.6666666666666666
21985,짓눌리다/Verb,3,2,1,2.2230620456616944e-05,1.1106915165381966e-05,0.6666666666666666
21986,워킹타이틀/Noun,3,2,1,2.2230620456616944e-05,1.1106915165381966e-05,0.6666666666666666
21987,거주/Noun,3,2,1,2.2230620456616944e-05,1.1106915165381966e-05,0.6666666666666666
21988,고성희/Noun,3,1,2,1.1115310228308472e-05,2.2213830330763933e-05,0.6666666666666666
21989,어브/Noun,3,1,2,1.1115310228308472e-05,2.2213830330763933e-05,0.6666666666666666
21990,ALL/Alpha,3,1,2,1.1115310228308472e-05,2.2213830330763933e-05,0.6666666666666666
21991,월화드라마/Noun,3,1,2,1.1115310228308472e-05,2.2213830330763933e-05,0.6666666666666666
21992,안온/Noun,3,1,2,1.1115310228308472e-05,2.2213830330763933e-05,0.6666666666666666
21993,래지/Noun,3,2,1,2.2230620456616944e-05,1.1106915165381966e-05,0.6666666666666666
21994,하랑/Noun,3,1,2,1.1115310228308472e-05,2.2213830330763933e-05,0.6666666666666666
21995,엄살/Noun,3,1,2,1.1115310228308472e-05,2.2213830330763933e-05,0.6666666666666666
21996,아란/Noun,3,1,2,1.1115310228308472e-05,2.2213830330763933e-05,0.6666666666666666
21997,치켜뜨다/Verb,3,1,2,1.1115310228308472e-05,2.2213830330763933e-05,0.6666666666666666
21998,베이트/Noun,3,2,1,2.2230620456616944e-05,1.1106915165381966e-05,0.6666666666666666
21999,소셜/Noun,3,2,1,2.2230620456616944e-05,1.1106915165381966e-05,0.6666666666666666
22000,게드전기/Noun,3,1,2,1.1115310228308472e-05,2.2213830330763933e-05,0.6666666666666666
22001,명상/Noun,3,1,2,1.1115310228308472e-05,2.2213830330763933e-05,0.6666666666666666
22002,블랙잭/Noun,3,2,1,2.2230620456616944e-05,1.1106915165381966e-05,0.6666666666666666
22003,학위/Noun,3,1,2,1.1115310228308472e-05,2.2213830330763933e-05,0.6666666666666666
22004,늪/Noun,3,1,2,1.1115310228308472e-05,2.2213830330763933e-05,0.6666666666666666
22005,드라마틱/Noun,3,1,2,1.1115310228308472e-05,2.2213830330763933e-05,0.6666666666666666
22006,놀이동산/Noun,3,1,2,1.1115310228308472e-05,2.2213830330763933e-05,0.6666666666666666
22007,니다/Eomi,3,2,1,2.2230620456616944e-05,1.1106915165381966e-05,0.6666666666666666
22008,방불/Noun,3,2,1,2.2230620456616944e-05,1.1106915165381966e-05,0.6666666666666666
22009,보유/Noun,3,2,1,2.2230620456616944e-05,1.1106915165381966e-05,0.6666666666666666
22010,파프리카/Noun,3,1,2,1.1115310228308472e-05,2.2213830330763933e-05,0.6666666666666666
22011,꿈쩍/Noun,3,2,1,2.2230620456616944e-05,1.1106915165381966e-05,0.6666666666666666
22012,어덜트/Noun,3,1,2,1.1115310228308472e-05,2.2213830330763933e-05,0.6666666666666666
22013,화교/Noun,3,1,2,1.1115310228308472e-05,2.2213830330763933e-05,0.6666666666666666
22014,천만배/Noun,3,1,2,1.1115310228308472e-05,2.2213830330763933e-05,0.6666666666666666
22015,셔틀/Noun,3,1,2,1.1115310228308472e-05,2.2213830330763933e-05,0.6666666666666666
22016,떼창/Noun,3,1,2,1.1115310228308472e-05,2.2213830330763933e-05,0.6666666666666666
22017,연방/Noun,3,1,2,1.1115310228308472e-05,2.2213830330763933e-05,0.6666666666666666
22018,오르내리다/Verb,3,1,2,1.1115310228308472e-05,2.2213830330763933e-05,0.6666666666666666
22019,푸네/Noun,3,1,2,1.1115310228308472e-05,2.2213830330763933e-05,0.6666666666666666
22020,(???)/Punctuation,3,1,2,1.1115310228308472e-05,2.2213830330763933e-05,0.6666666666666666
22021,대애/Noun,3,1,2,1.1115310228308472e-05,2.2213830330763933e-05,0.6666666666666666
22022,겨울전쟁/Noun,3,1,2,1.1115310228308472e-05,2.2213830330763933e-05,0.6666666666666666
22023,진압하/Noun,3,1,2,1.1115310228308472e-05,2.2213830330763933e-05,0.6666666666666666
22024,홍해/Noun,3,2,1,2.2230620456616944e-05,1.1106915165381966e-05,0.6666666666666666
22025,허우적거리다/Verb,3,2,1,2.2230620456616944e-05,1.1106915165381966e-05,0.6666666666666666
22026,읊어/Noun,3,2,1,2.2230620456616944e-05,1.1106915165381966e-05,0.6666666666666666
22027,망측하다/Adjective,3,1,2,1.1115310228308472e-05,2.2213830330763933e-05,0.6666666666666666
22028,한희정/Noun,3,2,1,2.2230620456616944e-05,1.1106915165381966e-05,0.6666666666666666
22029,뉴스데스크/Noun,3,2,1,2.2230620456616944e-05,1.1106915165381966e-05,0.6666666666666666
22030,헤헷/Exclamation,3,2,1,2.2230620456616944e-05,1.1106915165381966e-05,0.6666666666666666
22031,깨방정/Noun,3,2,1,2.2230620456616944e-05,1.1106915165381966e-05,0.6666666666666666
22032,레버/Noun,3,2,1,2.2230620456616944e-05,1.1106915165381966e-05,0.6666666666666666
22033,포괄/Noun,3,2,1,2.2230620456616944e-05,1.1106915165381966e-05,0.6666666666666666
22034,복용/Noun,3,1,2,1.1115310228308472e-05,2.2213830330763933e-05,0.6666666666666666
22035,스테로이드/Noun,3,2,1,2.2230620456616944e-05,1.1106915165381966e-05,0.6666666666666666
22036,백허그/Noun,3,1,2,1.1115310228308472e-05,2.2213830330763933e-05,0.6666666666666666
22037,고참/Noun,3,2,1,2.2230620456616944e-05,1.1106915165381966e-05,0.6666666666666666
22038,번주/Noun,3,2,1,2.2230620456616944e-05,1.1106915165381966e-05,0.6666666666666666
22039,하일/Noun,3,2,1,2.2230620456616944e-05,1.1106915165381966e-05,0.6666666666666666
22040,파병/Noun,3,2,1,2.2230620456616944e-05,1.1106915165381966e-05,0.6666666666666666
22041,몸속/Noun,3,1,2,1.1115310228308472e-05,2.2213830330763933e-05,0.6666666666666666
22042,아카네/Noun,3,2,1,2.2230620456616944e-05,1.1106915165381966e-05,0.6666666666666666
22043,금강/Noun,3,1,2,1.1115310228308472e-05,2.2213830330763933e-05,0.6666666666666666
22044,힣/Exclamation,3,2,1,2.2230620456616944e-05,1.1106915165381966e-05,0.6666666666666666
22045,쪼매/Noun,3,1,2,1.1115310228308472e-05,2.2213830330763933e-05,0.6666666666666666
22046,물기/Noun,3,1,2,1.1115310228308472e-05,2.2213830330763933e-05,0.6666666666666666
22047,달구다/Verb,3,1,2,1.1115310228308472e-05,2.2213830330763933e-05,0.6666666666666666
22048,악습/Noun,3,2,1,2.2230620456616944e-05,1.1106915165381966e-05,0.6666666666666666
22049,................................./Punctuation,3,1,2,1.1115310228308472e-05,2.2213830330763933e-05,0.6666666666666666
22050,효력/Noun,3,2,1,2.2230620456616944e-05,1.1106915165381966e-05,0.6666666666666666
22051,가짐/Noun,3,1,2,1.1115310228308472e-05,2.2213830330763933e-05,0.6666666666666666
22052,분임/Noun,3,1,2,1.1115310228308472e-05,2.2213830330763933e-05,0.6666666666666666
22053,무빙/Noun,3,1,2,1.1115310228308472e-05,2.2213830330763933e-05,0.6666666666666666
22054,개새/Noun,3,1,2,1.1115310228308472e-05,2.2213830330763933e-05,0.6666666666666666
22055,델마와루이스/Noun,3,1,2,1.1115310228308472e-05,2.2213830330763933e-05,0.6666666666666666
22056,책속/Noun,3,2,1,2.2230620456616944e-05,1.1106915165381966e-05,0.6666666666666666
22057,검객/Noun,3,2,1,2.2230620456616944e-05,1.1106915165381966e-05,0.6666666666666666
22058,겜블/Noun,3,1,2,1.1115310228308472e-05,2.2213830330763933e-05,0.6666666666666666
22059,드러눕다/Verb,3,1,2,1.1115310228308472e-05,2.2213830330763933e-05,0.6666666666666666
22060,tva/Alpha,3,2,1,2.2230620456616944e-05,1.1106915165381966e-05,0.6666666666666666
22061,틴물/Noun,3,2,1,2.2230620456616944e-05,1.1106915165381966e-05,0.6666666666666666
22062,한게임/Noun,3,1,2,1.1115310228308472e-05,2.2213830330763933e-05,0.6666666666666666
22063,세레나데/Noun,3,1,2,1.1115310228308472e-05,2.2213830330763933e-05,0.6666666666666666
22064,인해전술/Noun,3,1,2,1.1115310228308472e-05,2.2213830330763933e-05,0.6666666666666666
22065,멜랑꼴리/Noun,3,2,1,2.2230620456616944e-05,1.1106915165381966e-05,0.6666666666666666
22066,초현/Noun,3,2,1,2.2230620456616944e-05,1.1106915165381966e-05,0.6666666666666666
22067,윅/Noun,3,2,1,2.2230620456616944e-05,1.1106915165381966e-05,0.6666666666666666
22068,이타/Noun,3,1,2,1.1115310228308472e-05,2.2213830330763933e-05,0.6666666666666666
22069,6.8/Number,3,2,1,2.2230620456616944e-05,1.1106915165381966e-05,0.6666666666666666
22070,라바/Noun,3,2,1,2.2230620456616944e-05,1.1106915165381966e-05,0.6666666666666666
22071,박은빈/Noun,3,2,1,2.2230620456616944e-05,1.1106915165381966e-05,0.6666666666666666
22072,스랑/Noun,3,1,2,1.1115310228308472e-05,2.2213830330763933e-05,0.6666666666666666
22073,파파야/Noun,3,1,2,1.1115310228308472e-05,2.2213830330763933e-05,0.6666666666666666
22074,~~^-^/Punctuation,3,2,1,2.2230620456616944e-05,1.1106915165381966e-05,0.6666666666666666
22075,도축/Noun,3,1,2,1.1115310228308472e-05,2.2213830330763933e-05,0.6666666666666666
22076,가책/Noun,3,2,1,2.2230620456616944e-05,1.1106915165381966e-05,0.6666666666666666
22077,일식/Noun,3,2,1,2.2230620456616944e-05,1.1106915165381966e-05,0.6666666666666666
22078,몇장/Noun,3,1,2,1.1115310228308472e-05,2.2213830330763933e-05,0.6666666666666666
22079,김윤혜/Noun,3,1,2,1.1115310228308472e-05,2.2213830330763933e-05,0.6666666666666666
22080,가상세계/Noun,3,1,2,1.1115310228308472e-05,2.2213830330763933e-05,0.6666666666666666
22081,03/Number,3,2,1,2.2230620456616944e-05,1.1106915165381966e-05,0.6666666666666666
22082,소변/Noun,3,1,2,1.1115310228308472e-05,2.2213830330763933e-05,0.6666666666666666
22083,수하/Noun,3,1,2,1.1115310228308472e-05,2.2213830330763933e-05,0.6666666666666666
22084,앞길/Noun,3,2,1,2.2230620456616944e-05,1.1106915165381966e-05,0.6666666666666666
22085,".,.,.,.,.,/Punctuation",3,1,2,1.1115310228308472e-05,2.2213830330763933e-05,0.6666666666666666
22086,철의여인/Noun,3,1,2,1.1115310228308472e-05,2.2213830330763933e-05,0.6666666666666666
22087,그따위/Modifier,3,1,2,1.1115310228308472e-05,2.2213830330763933e-05,0.6666666666666666
22088,사이즈/Noun,3,2,1,2.2230620456616944e-05,1.1106915165381966e-05,0.6666666666666666
22089,특정하다/Adjective,3,1,2,1.1115310228308472e-05,2.2213830330763933e-05,0.6666666666666666
22090,키자루/Noun,3,2,1,2.2230620456616944e-05,1.1106915165381966e-05,0.6666666666666666
22091,펀/Noun,3,1,2,1.1115310228308472e-05,2.2213830330763933e-05,0.6666666666666666
22092,아무렴/Exclamation,3,1,2,1.1115310228308472e-05,2.2213830330763933e-05,0.6666666666666666
22093,용역/Noun,3,2,1,2.2230620456616944e-05,1.1106915165381966e-05,0.6666666666666666
22094,미러/Noun,3,2,1,2.2230620456616944e-05,1.1106915165381966e-05,0.6666666666666666
22095,농도/Noun,3,2,1,2.2230620456616944e-05,1.1106915165381966e-05,0.6666666666666666
22096,군사력/Noun,3,1,2,1.1115310228308472e-05,2.2213830330763933e-05,0.6666666666666666
22097,이문열/Noun,3,1,2,1.1115310228308472e-05,2.2213830330763933e-05,0.6666666666666666
22098,고관/Noun,3,1,2,1.1115310228308472e-05,2.2213830330763933e-05,0.6666666666666666
22099,아이비/Noun,3,2,1,2.2230620456616944e-05,1.1106915165381966e-05,0.6666666666666666
22100,핵전쟁/Noun,3,2,1,2.2230620456616944e-05,1.1106915165381966e-05,0.6666666666666666
22101,영은/Noun,3,2,1,2.2230620456616944e-05,1.1106915165381966e-05,0.6666666666666666
22102,카르텔/Noun,3,1,2,1.1115310228308472e-05,2.2213830330763933e-05,0.6666666666666666
22103,플래터/Noun,3,1,2,1.1115310228308472e-05,2.2213830330763933e-05,0.6666666666666666
22104,폐막/Noun,3,1,2,1.1115310228308472e-05,2.2213830330763933e-05,0.6666666666666666
22105,렌프/Noun,3,2,1,2.2230620456616944e-05,1.1106915165381966e-05,0.6666666666666666
22106,경찰청/Noun,3,1,2,1.1115310228308472e-05,2.2213830330763933e-05,0.6666666666666666
22107,듭/Noun,3,2,1,2.2230620456616944e-05,1.1106915165381966e-05,0.6666666666666666
22108,휘감다/Verb,3,1,2,1.1115310228308472e-05,2.2213830330763933e-05,0.6666666666666666
22109,차사/Noun,3,1,2,1.1115310228308472e-05,2.2213830330763933e-05,0.6666666666666666
22110,뿌리깊은나무/Noun,3,2,1,2.2230620456616944e-05,1.1106915165381966e-05,0.6666666666666666
22111,성화/Noun,3,2,1,2.2230620456616944e-05,1.1106915165381966e-05,0.6666666666666666
22112,유키에/Noun,3,1,2,1.1115310228308472e-05,2.2213830330763933e-05,0.6666666666666666
22113,센티미터/Noun,3,1,2,1.1115310228308472e-05,2.2213830330763933e-05,0.6666666666666666
22114,점사/Noun,3,1,2,1.1115310228308472e-05,2.2213830330763933e-05,0.6666666666666666
22115,게우다/Verb,3,2,1,2.2230620456616944e-05,1.1106915165381966e-05,0.6666666666666666
22116,!!!!!!!!!!!!!!!!!!!!!!/Punctuation,3,1,2,1.1115310228308472e-05,2.2213830330763933e-05,0.6666666666666666
22117,귀염둥이/Noun,3,2,1,2.2230620456616944e-05,1.1106915165381966e-05,0.6666666666666666
22118,밍키/Noun,3,2,1,2.2230620456616944e-05,1.1106915165381966e-05,0.6666666666666666
22119,-;;;;/Punctuation,3,2,1,2.2230620456616944e-05,1.1106915165381966e-05,0.6666666666666666
22120,해원/Noun,3,2,1,2.2230620456616944e-05,1.1106915165381966e-05,0.6666666666666666
22121,퀸카/Noun,3,1,2,1.1115310228308472e-05,2.2213830330763933e-05,0.6666666666666666
22122,낚았다/Noun,3,1,2,1.1115310228308472e-05,2.2213830330763933e-05,0.6666666666666666
22123,신품/Noun,3,2,1,2.2230620456616944e-05,1.1106915165381966e-05,0.6666666666666666
22124,움켜쥐다/Verb,3,1,2,1.1115310228308472e-05,2.2213830330763933e-05,0.6666666666666666
22125,ㅜㅜㅋㅋㅋ/KoreanParticle,3,2,1,2.2230620456616944e-05,1.1106915165381966e-05,0.6666666666666666
22126,4.6/Number,3,1,2,1.1115310228308472e-05,2.2213830330763933e-05,0.6666666666666666
22127,경비행기/Noun,3,1,2,1.1115310228308472e-05,2.2213830330763933e-05,0.6666666666666666
22128,김윤아/Noun,3,1,2,1.1115310228308472e-05,2.2213830330763933e-05,0.6666666666666666
22129,강약/Noun,3,1,2,1.1115310228308472e-05,2.2213830330763933e-05,0.6666666666666666
22130,스킨헤드/Noun,3,2,1,2.2230620456616944e-05,1.1106915165381966e-05,0.6666666666666666
22131,선화/Noun,3,1,2,1.1115310228308472e-05,2.2213830330763933e-05,0.6666666666666666
22132,딜/Noun,3,2,1,2.2230620456616944e-05,1.1106915165381966e-05,0.6666666666666666
22133,자진/Noun,3,1,2,1.1115310228308472e-05,2.2213830330763933e-05,0.6666666666666666
22134,샴쌍둥이/Noun,3,1,2,1.1115310228308472e-05,2.2213830330763933e-05,0.6666666666666666
22135,얇다/Adjective,3,1,2,1.1115310228308472e-05,2.2213830330763933e-05,0.6666666666666666
22136,장미꽃/Noun,3,1,2,1.1115310228308472e-05,2.2213830330763933e-05,0.6666666666666666
22137,흑협/Noun,3,1,2,1.1115310228308472e-05,2.2213830330763933e-05,0.6666666666666666
22138,장희진/Noun,3,1,2,1.1115310228308472e-05,2.2213830330763933e-05,0.6666666666666666
22139,엉뚱/Noun,3,1,2,1.1115310228308472e-05,2.2213830330763933e-05,0.6666666666666666
22140,교육자/Noun,3,2,1,2.2230620456616944e-05,1.1106915165381966e-05,0.6666666666666666
22141,기러기/Noun,3,1,2,1.1115310228308472e-05,2.2213830330763933e-05,0.6666666666666666
22142,충사/Noun,3,1,2,1.1115310228308472e-05,2.2213830330763933e-05,0.6666666666666666
22143,로섬/Noun,3,2,1,2.2230620456616944e-05,1.1106915165381966e-05,0.6666666666666666
22144,무럭무럭/Noun,3,2,1,2.2230620456616944e-05,1.1106915165381966e-05,0.6666666666666666
22145,어지르다/Verb,3,1,2,1.1115310228308472e-05,2.2213830330763933e-05,0.6666666666666666
22146,로빈슨/Noun,3,1,2,1.1115310228308472e-05,2.2213830330763933e-05,0.6666666666666666
22147,했슴/Noun,3,2,1,2.2230620456616944e-05,1.1106915165381966e-05,0.6666666666666666
22148,남았는데/Foreign,3,1,2,1.1115310228308472e-05,2.2213830330763933e-05,0.6666666666666666
22149,이태성/Noun,3,2,1,2.2230620456616944e-05,1.1106915165381966e-05,0.6666666666666666
22150,서클/Noun,3,1,2,1.1115310228308472e-05,2.2213830330763933e-05,0.6666666666666666
22151,쉡/Noun,3,1,2,1.1115310228308472e-05,2.2213830330763933e-05,0.6666666666666666
22152,담요/Noun,3,2,1,2.2230620456616944e-05,1.1106915165381966e-05,0.6666666666666666
22153,파마/Noun,3,1,2,1.1115310228308472e-05,2.2213830330763933e-05,0.6666666666666666
22154,4.44만/Number,3,2,1,2.2230620456616944e-05,1.1106915165381966e-05,0.6666666666666666
22155,격차/Noun,3,2,1,2.2230620456616944e-05,1.1106915165381966e-05,0.6666666666666666
22156,횐/Noun,3,1,2,1.1115310228308472e-05,2.2213830330763933e-05,0.6666666666666666
22157,가분/Noun,3,1,2,1.1115310228308472e-05,2.2213830330763933e-05,0.6666666666666666
22158,창수/Noun,3,2,1,2.2230620456616944e-05,1.1106915165381966e-05,0.6666666666666666
22159,자격지심/Noun,3,2,1,2.2230620456616944e-05,1.1106915165381966e-05,0.6666666666666666
22160,무교인/Noun,3,1,2,1.1115310228308472e-05,2.2213830330763933e-05,0.6666666666666666
22161,그림형제/Noun,3,1,2,1.1115310228308472e-05,2.2213830330763933e-05,0.6666666666666666
22162,호동/Noun,3,1,2,1.1115310228308472e-05,2.2213830330763933e-05,0.6666666666666666
22163,여권/Noun,3,1,2,1.1115310228308472e-05,2.2213830330763933e-05,0.6666666666666666
22164,공포증/Noun,3,2,1,2.2230620456616944e-05,1.1106915165381966e-05,0.6666666666666666
22165,80회/Number,3,1,2,1.1115310228308472e-05,2.2213830330763933e-05,0.6666666666666666
22166,양식/Noun,3,2,1,2.2230620456616944e-05,1.1106915165381966e-05,0.6666666666666666
22167,네가지/Noun,3,1,2,1.1115310228308472e-05,2.2213830330763933e-05,0.6666666666666666
22168,상륙작전/Noun,3,1,2,1.1115310228308472e-05,2.2213830330763933e-05,0.6666666666666666
22169,스코트/Noun,3,1,2,1.1115310228308472e-05,2.2213830330763933e-05,0.6666666666666666
22170,보편성/Noun,3,1,2,1.1115310228308472e-05,2.2213830330763933e-05,0.6666666666666666
22171,가약/Noun,3,2,1,2.2230620456616944e-05,1.1106915165381966e-05,0.6666666666666666
22172,@!!!/Punctuation,3,2,1,2.2230620456616944e-05,1.1106915165381966e-05,0.6666666666666666
22173,선두/Noun,3,2,1,2.2230620456616944e-05,1.1106915165381966e-05,0.6666666666666666
22174,츠시마/Noun,3,2,1,2.2230620456616944e-05,1.1106915165381966e-05,0.6666666666666666
22175,호성/Noun,3,2,1,2.2230620456616944e-05,1.1106915165381966e-05,0.6666666666666666
22176,분산/Noun,3,1,2,1.1115310228308472e-05,2.2213830330763933e-05,0.6666666666666666
22177,퍼시잭슨/Noun,3,1,2,1.1115310228308472e-05,2.2213830330763933e-05,0.6666666666666666
22178,셔츠/Noun,3,2,1,2.2230620456616944e-05,1.1106915165381966e-05,0.6666666666666666
22179,넘는/Foreign,3,1,2,1.1115310228308472e-05,2.2213830330763933e-05,0.6666666666666666
22180,무신경/Noun,3,1,2,1.1115310228308472e-05,2.2213830330763933e-05,0.6666666666666666
22181,스터리/Noun,3,2,1,2.2230620456616944e-05,1.1106915165381966e-05,0.6666666666666666
22182,루마니아/Noun,3,2,1,2.2230620456616944e-05,1.1106915165381966e-05,0.6666666666666666
22183,공형진/Noun,3,1,2,1.1115310228308472e-05,2.2213830330763933e-05,0.6666666666666666
22184,37/Number,3,1,2,1.1115310228308472e-05,2.2213830330763933e-05,0.6666666666666666
22185,교포/Noun,3,2,1,2.2230620456616944e-05,1.1106915165381966e-05,0.6666666666666666
22186,월리/Noun,3,2,1,2.2230620456616944e-05,1.1106915165381966e-05,0.6666666666666666
22187,치질/Noun,3,2,1,2.2230620456616944e-05,1.1106915165381966e-05,0.6666666666666666
22188,윗사람/Noun,3,1,2,1.1115310228308472e-05,2.2213830330763933e-05,0.6666666666666666
22189,연명/Noun,3,1,2,1.1115310228308472e-05,2.2213830330763933e-05,0.6666666666666666
22190,뛰어나오다/Verb,3,1,2,1.1115310228308472e-05,2.2213830330763933e-05,0.6666666666666666
22191,99분/Number,3,1,2,1.1115310228308472e-05,2.2213830330763933e-05,0.6666666666666666
22192,이태민/Noun,3,1,2,1.1115310228308472e-05,2.2213830330763933e-05,0.6666666666666666
22193,신우/Noun,3,2,1,2.2230620456616944e-05,1.1106915165381966e-05,0.6666666666666666
22194,눈밭/Noun,3,1,2,1.1115310228308472e-05,2.2213830330763933e-05,0.6666666666666666
22195,옹이/Noun,3,2,1,2.2230620456616944e-05,1.1106915165381966e-05,0.6666666666666666
22196,연주자/Noun,3,1,2,1.1115310228308472e-05,2.2213830330763933e-05,0.6666666666666666
22197,작법/Noun,3,1,2,1.1115310228308472e-05,2.2213830330763933e-05,0.6666666666666666
22198,겸허/Noun,3,2,1,2.2230620456616944e-05,1.1106915165381966e-05,0.6666666666666666
22199,우열/Noun,3,2,1,2.2230620456616944e-05,1.1106915165381966e-05,0.6666666666666666
22200,낙인/Noun,3,1,2,1.1115310228308472e-05,2.2213830330763933e-05,0.6666666666666666
22201,날고기/Noun,3,2,1,2.2230620456616944e-05,1.1106915165381966e-05,0.6666666666666666
22202,인민/Noun,3,1,2,1.1115310228308472e-05,2.2213830330763933e-05,0.6666666666666666
22203,빈민가/Noun,3,2,1,2.2230620456616944e-05,1.1106915165381966e-05,0.6666666666666666
22204,번뇌/Noun,3,2,1,2.2230620456616944e-05,1.1106915165381966e-05,0.6666666666666666
22205,갓난아이/Noun,3,1,2,1.1115310228308472e-05,2.2213830330763933e-05,0.6666666666666666
22206,근황/Noun,3,2,1,2.2230620456616944e-05,1.1106915165381966e-05,0.6666666666666666
22207,로선/Noun,3,2,1,2.2230620456616944e-05,1.1106915165381966e-05,0.6666666666666666
22208,여념/Noun,3,1,2,1.1115310228308472e-05,2.2213830330763933e-05,0.6666666666666666
22209,줄암/Noun,3,1,2,1.1115310228308472e-05,2.2213830330763933e-05,0.6666666666666666
22210,DD/Alpha,3,2,1,2.2230620456616944e-05,1.1106915165381966e-05,0.6666666666666666
22211,토달/Adverb,3,2,1,2.2230620456616944e-05,1.1106915165381966e-05,0.6666666666666666
22212,정혜영/Noun,3,1,2,1.1115310228308472e-05,2.2213830330763933e-05,0.6666666666666666
22213,단역배우/Noun,3,2,1,2.2230620456616944e-05,1.1106915165381966e-05,0.6666666666666666
22214,원더걸스/Noun,3,2,1,2.2230620456616944e-05,1.1106915165381966e-05,0.6666666666666666
22215,이수완/Noun,3,1,2,1.1115310228308472e-05,2.2213830330763933e-05,0.6666666666666666
22216,AI/Alpha,3,2,1,2.2230620456616944e-05,1.1106915165381966e-05,0.6666666666666666
22217,점마/Noun,3,1,2,1.1115310228308472e-05,2.2213830330763933e-05,0.6666666666666666
22218,걸스데이/Noun,3,2,1,2.2230620456616944e-05,1.1106915165381966e-05,0.6666666666666666
22219,착실하다/Adjective,3,1,2,1.1115310228308472e-05,2.2213830330763933e-05,0.6666666666666666
22220,ㅋㅋㄱㅋ/KoreanParticle,3,1,2,1.1115310228308472e-05,2.2213830330763933e-05,0.6666666666666666
22221,귀뚜라미/Noun,3,1,2,1.1115310228308472e-05,2.2213830330763933e-05,0.6666666666666666
22222,거처/Noun,3,1,2,1.1115310228308472e-05,2.2213830330763933e-05,0.6666666666666666
22223,위자/Noun,3,1,2,1.1115310228308472e-05,2.2213830330763933e-05,0.6666666666666666
22224,크래커/Noun,3,2,1,2.2230620456616944e-05,1.1106915165381966e-05,0.6666666666666666
22225,은사/Noun,3,2,1,2.2230620456616944e-05,1.1106915165381966e-05,0.6666666666666666
22226,싱글/Noun,3,2,1,2.2230620456616944e-05,1.1106915165381966e-05,0.6666666666666666
22227,ㅋㄱㅋㅋ/KoreanParticle,3,2,1,2.2230620456616944e-05,1.1106915165381966e-05,0.6666666666666666
22228,병크/Noun,3,2,1,2.2230620456616944e-05,1.1106915165381966e-05,0.6666666666666666
22229,대칭/Noun,3,1,2,1.1115310228308472e-05,2.2213830330763933e-05,0.6666666666666666
22230,억제/Noun,3,2,1,2.2230620456616944e-05,1.1106915165381966e-05,0.6666666666666666
22231,학자/Noun,3,1,2,1.1115310228308472e-05,2.2213830330763933e-05,0.6666666666666666
22232,츠코/Noun,3,2,1,2.2230620456616944e-05,1.1106915165381966e-05,0.6666666666666666
22233,쥐쥐/Noun,3,1,2,1.1115310228308472e-05,2.2213830330763933e-05,0.6666666666666666
22234,웃겻/Noun,3,1,2,1.1115310228308472e-05,2.2213830330763933e-05,0.6666666666666666
22235,그렘린/Noun,3,2,1,2.2230620456616944e-05,1.1106915165381966e-05,0.6666666666666666
22236,ㅃ/KoreanParticle,3,1,2,1.1115310228308472e-05,2.2213830330763933e-05,0.6666666666666666
22237,17일/Number,3,2,1,2.2230620456616944e-05,1.1106915165381966e-05,0.6666666666666666
22238,열성/Noun,3,1,2,1.1115310228308472e-05,2.2213830330763933e-05,0.6666666666666666
22239,플라토닉/Noun,3,2,1,2.2230620456616944e-05,1.1106915165381966e-05,0.6666666666666666
22240,Ctrl/Alpha,3,1,2,1.1115310228308472e-05,2.2213830330763933e-05,0.6666666666666666
22241,오마이/Noun,3,1,2,1.1115310228308472e-05,2.2213830330763933e-05,0.6666666666666666
22242,하쿠나마타타/Noun,3,2,1,2.2230620456616944e-05,1.1106915165381966e-05,0.6666666666666666
22243,상주/Noun,3,2,1,2.2230620456616944e-05,1.1106915165381966e-05,0.6666666666666666
22244,숀빈/Noun,3,2,1,2.2230620456616944e-05,1.1106915165381966e-05,0.6666666666666666
22245,뚱/Noun,3,2,1,2.2230620456616944e-05,1.1106915165381966e-05,0.6666666666666666
22246,엠마누엘/Noun,3,1,2,1.1115310228308472e-05,2.2213830330763933e-05,0.6666666666666666
22247,득점/Noun,3,1,2,1.1115310228308472e-05,2.2213830330763933e-05,0.6666666666666666
22248,칩스/Noun,3,1,2,1.1115310228308472e-05,2.2213830330763933e-05,0.6666666666666666
22249,아나키스트/Noun,3,2,1,2.2230620456616944e-05,1.1106915165381966e-05,0.6666666666666666
22250,주절대다/Verb,3,1,2,1.1115310228308472e-05,2.2213830330763933e-05,0.6666666666666666
22251,기록물/Noun,3,1,2,1.1115310228308472e-05,2.2213830330763933e-05,0.6666666666666666
22252,박영선/Noun,3,1,2,1.1115310228308472e-05,2.2213830330763933e-05,0.6666666666666666
22253,벌점/Noun,3,1,2,1.1115310228308472e-05,2.2213830330763933e-05,0.6666666666666666
22254,중첩/Noun,3,2,1,2.2230620456616944e-05,1.1106915165381966e-05,0.6666666666666666
22255,백신/Noun,3,1,2,1.1115310228308472e-05,2.2213830330763933e-05,0.6666666666666666
22256,괘/Noun,3,2,1,2.2230620456616944e-05,1.1106915165381966e-05,0.6666666666666666
22257,불똥/Noun,3,1,2,1.1115310228308472e-05,2.2213830330763933e-05,0.6666666666666666
22258,질때/Noun,3,2,1,2.2230620456616944e-05,1.1106915165381966e-05,0.6666666666666666
22259,데온/Noun,3,2,1,2.2230620456616944e-05,1.1106915165381966e-05,0.6666666666666666
22260,갈무리/Noun,3,1,2,1.1115310228308472e-05,2.2213830330763933e-05,0.6666666666666666
22261,유리하다/Adjective,3,1,2,1.1115310228308472e-05,2.2213830330763933e-05,0.6666666666666666
22262,당국/Noun,3,1,2,1.1115310228308472e-05,2.2213830330763933e-05,0.6666666666666666
22263,Mc/Alpha,3,1,2,1.1115310228308472e-05,2.2213830330763933e-05,0.6666666666666666
22264,다빈치/Noun,3,1,2,1.1115310228308472e-05,2.2213830330763933e-05,0.6666666666666666
22265,언변/Noun,3,1,2,1.1115310228308472e-05,2.2213830330763933e-05,0.6666666666666666
22266,상암/Noun,3,1,2,1.1115310228308472e-05,2.2213830330763933e-05,0.6666666666666666
22267,반발/Noun,3,1,2,1.1115310228308472e-05,2.2213830330763933e-05,0.6666666666666666
22268,일래/Noun,3,2,1,2.2230620456616944e-05,1.1106915165381966e-05,0.6666666666666666
22269,금일/Noun,3,1,2,1.1115310228308472e-05,2.2213830330763933e-05,0.6666666666666666
22270,무도회/Noun,3,2,1,2.2230620456616944e-05,1.1106915165381966e-05,0.6666666666666666
22271,왓던/Noun,3,2,1,2.2230620456616944e-05,1.1106915165381966e-05,0.6666666666666666
22272,도크/Noun,3,2,1,2.2230620456616944e-05,1.1106915165381966e-05,0.6666666666666666
22273,혈통/Noun,3,1,2,1.1115310228308472e-05,2.2213830330763933e-05,0.6666666666666666
22274,할복/Noun,3,1,2,1.1115310228308472e-05,2.2213830330763933e-05,0.6666666666666666
22275,불변/Noun,3,2,1,2.2230620456616944e-05,1.1106915165381966e-05,0.6666666666666666
22276,빽빽/Noun,3,1,2,1.1115310228308472e-05,2.2213830330763933e-05,0.6666666666666666
22277,신해/Noun,3,2,1,2.2230620456616944e-05,1.1106915165381966e-05,0.6666666666666666
22278,도널드/Noun,3,2,1,2.2230620456616944e-05,1.1106915165381966e-05,0.6666666666666666
22279,제천/Noun,3,2,1,2.2230620456616944e-05,1.1106915165381966e-05,0.6666666666666666
22280,쥑임/Noun,3,1,2,1.1115310228308472e-05,2.2213830330763933e-05,0.6666666666666666
22281,스토어/Noun,3,2,1,2.2230620456616944e-05,1.1106915165381966e-05,0.6666666666666666
22282,N/Alpha,3,1,2,1.1115310228308472e-05,2.2213830330763933e-05,0.6666666666666666
22283,친위대/Noun,3,1,2,1.1115310228308472e-05,2.2213830330763933e-05,0.6666666666666666
22284,어법/Noun,3,1,2,1.1115310228308472e-05,2.2213830330763933e-05,0.6666666666666666
22285,팸/Noun,3,1,2,1.1115310228308472e-05,2.2213830330763933e-05,0.6666666666666666
22286,^^&/Punctuation,3,1,2,1.1115310228308472e-05,2.2213830330763933e-05,0.6666666666666666
22287,사바나/Noun,3,1,2,1.1115310228308472e-05,2.2213830330763933e-05,0.6666666666666666
22288,프리덤/Noun,3,1,2,1.1115310228308472e-05,2.2213830330763933e-05,0.6666666666666666
22289,저따위/Modifier,3,2,1,2.2230620456616944e-05,1.1106915165381966e-05,0.6666666666666666
22290,사감/Noun,3,1,2,1.1115310228308472e-05,2.2213830330763933e-05,0.6666666666666666
22291,체벌/Noun,3,1,2,1.1115310228308472e-05,2.2213830330763933e-05,0.6666666666666666
22292,믹싱/Noun,3,1,2,1.1115310228308472e-05,2.2213830330763933e-05,0.6666666666666666
22293,마카로니웨스턴/Noun,3,1,2,1.1115310228308472e-05,2.2213830330763933e-05,0.6666666666666666
22294,정당/Noun,3,1,2,1.1115310228308472e-05,2.2213830330763933e-05,0.6666666666666666
22295,요전/Noun,3,1,2,1.1115310228308472e-05,2.2213830330763933e-05,0.6666666666666666
22296,김수철/Noun,3,2,1,2.2230620456616944e-05,1.1106915165381966e-05,0.6666666666666666
22297,호튼/Noun,3,1,2,1.1115310228308472e-05,2.2213830330763933e-05,0.6666666666666666
22298,농성/Noun,3,2,1,2.2230620456616944e-05,1.1106915165381966e-05,0.6666666666666666
22299,는데/Eomi,3,2,1,2.2230620456616944e-05,1.1106915165381966e-05,0.6666666666666666
22300,카르멘/Noun,3,2,1,2.2230620456616944e-05,1.1106915165381966e-05,0.6666666666666666
22301,파블로/Noun,3,1,2,1.1115310228308472e-05,2.2213830330763933e-05,0.6666666666666666
22302,가넷/Noun,3,2,1,2.2230620456616944e-05,1.1106915165381966e-05,0.6666666666666666
22303,또박또박/Noun,3,2,1,2.2230620456616944e-05,1.1106915165381966e-05,0.6666666666666666
22304,그런저런/Modifier,3,2,1,2.2230620456616944e-05,1.1106915165381966e-05,0.6666666666666666
22305,전부일/Noun,3,1,2,1.1115310228308472e-05,2.2213830330763933e-05,0.6666666666666666
22306,누드모델/Noun,3,1,2,1.1115310228308472e-05,2.2213830330763933e-05,0.6666666666666666
22307,1980/Number,3,1,2,1.1115310228308472e-05,2.2213830330763933e-05,0.6666666666666666
22308,핫칙/Noun,3,2,1,2.2230620456616944e-05,1.1106915165381966e-05,0.6666666666666666
22309,"...,,,/Punctuation",3,1,2,1.1115310228308472e-05,2.2213830330763933e-05,0.6666666666666666
22310,자미/Noun,3,1,2,1.1115310228308472e-05,2.2213830330763933e-05,0.6666666666666666
22311,저널리스트/Noun,3,1,2,1.1115310228308472e-05,2.2213830330763933e-05,0.6666666666666666
22312,think/Alpha,3,2,1,2.2230620456616944e-05,1.1106915165381966e-05,0.6666666666666666
22313,예선/Noun,3,2,1,2.2230620456616944e-05,1.1106915165381966e-05,0.6666666666666666
22314,>>>/Punctuation,3,1,2,1.1115310228308472e-05,2.2213830330763933e-05,0.6666666666666666
22315,토익/Noun,3,1,2,1.1115310228308472e-05,2.2213830330763933e-05,0.6666666666666666
22316,오유인/Noun,3,1,2,1.1115310228308472e-05,2.2213830330763933e-05,0.6666666666666666
22317,이양/Noun,3,2,1,2.2230620456616944e-05,1.1106915165381966e-05,0.6666666666666666
22318,이원종/Noun,3,2,1,2.2230620456616944e-05,1.1106915165381966e-05,0.6666666666666666
22319,여현수/Noun,3,2,1,2.2230620456616944e-05,1.1106915165381966e-05,0.6666666666666666
22320,김보연/Noun,3,1,2,1.1115310228308472e-05,2.2213830330763933e-05,0.6666666666666666
22321,부동산/Noun,3,1,2,1.1115310228308472e-05,2.2213830330763933e-05,0.6666666666666666
22322,면알/Noun,3,2,1,2.2230620456616944e-05,1.1106915165381966e-05,0.6666666666666666
22323,조델/Noun,3,2,1,2.2230620456616944e-05,1.1106915165381966e-05,0.6666666666666666
22324,킬러스/Noun,3,2,1,2.2230620456616944e-05,1.1106915165381966e-05,0.6666666666666666
22325,촐싹대다/Verb,3,2,1,2.2230620456616944e-05,1.1106915165381966e-05,0.6666666666666666
22326,조선소/Noun,3,1,2,1.1115310228308472e-05,2.2213830330763933e-05,0.6666666666666666
22327,월척/Noun,3,2,1,2.2230620456616944e-05,1.1106915165381966e-05,0.6666666666666666
22328,카셀/Noun,3,2,1,2.2230620456616944e-05,1.1106915165381966e-05,0.6666666666666666
22329,링거/Noun,3,2,1,2.2230620456616944e-05,1.1106915165381966e-05,0.6666666666666666
22330,식견/Noun,3,1,2,1.1115310228308472e-05,2.2213830330763933e-05,0.6666666666666666
22331,들고나다/Verb,3,2,1,2.2230620456616944e-05,1.1106915165381966e-05,0.6666666666666666
22332,크/Noun,3,2,1,2.2230620456616944e-05,1.1106915165381966e-05,0.6666666666666666
22333,달마시안/Noun,3,1,2,1.1115310228308472e-05,2.2213830330763933e-05,0.6666666666666666
22334,장현수/Noun,3,1,2,1.1115310228308472e-05,2.2213830330763933e-05,0.6666666666666666
22335,면세/Noun,3,2,1,2.2230620456616944e-05,1.1106915165381966e-05,0.6666666666666666
22336,파란만장/Noun,3,2,1,2.2230620456616944e-05,1.1106915165381966e-05,0.6666666666666666
22337,노르망디/Noun,3,2,1,2.2230620456616944e-05,1.1106915165381966e-05,0.6666666666666666
22338,간파/Noun,3,1,2,1.1115310228308472e-05,2.2213830330763933e-05,0.6666666666666666
22339,강경준/Noun,3,1,2,1.1115310228308472e-05,2.2213830330763933e-05,0.6666666666666666
22340,왕십리/Noun,3,1,2,1.1115310228308472e-05,2.2213830330763933e-05,0.6666666666666666
22341,뜯기다/Verb,3,1,2,1.1115310228308472e-05,2.2213830330763933e-05,0.6666666666666666
22342,남도/Noun,3,2,1,2.2230620456616944e-05,1.1106915165381966e-05,0.6666666666666666
22343,인건비/Noun,3,1,2,1.1115310228308472e-05,2.2213830330763933e-05,0.6666666666666666
22344,민종/Noun,3,1,2,1.1115310228308472e-05,2.2213830330763933e-05,0.6666666666666666
22345,바킨/Noun,3,2,1,2.2230620456616944e-05,1.1106915165381966e-05,0.6666666666666666
22346,최최/Noun,3,1,2,1.1115310228308472e-05,2.2213830330763933e-05,0.6666666666666666
22347,신촌/Noun,3,2,1,2.2230620456616944e-05,1.1106915165381966e-05,0.6666666666666666
22348,화상/Noun,3,1,2,1.1115310228308472e-05,2.2213830330763933e-05,0.6666666666666666
22349,happy/Alpha,3,2,1,2.2230620456616944e-05,1.1106915165381966e-05,0.6666666666666666
22350,유언/Noun,3,2,1,2.2230620456616944e-05,1.1106915165381966e-05,0.6666666666666666
22351,피곤/Noun,3,1,2,1.1115310228308472e-05,2.2213830330763933e-05,0.6666666666666666
22352,기립/Noun,3,2,1,2.2230620456616944e-05,1.1106915165381966e-05,0.6666666666666666
22353,데블/Noun,3,2,1,2.2230620456616944e-05,1.1106915165381966e-05,0.6666666666666666
22354,꽝꽝/Adverb,3,1,2,1.1115310228308472e-05,2.2213830330763933e-05,0.6666666666666666
22355,영양/Noun,3,2,1,2.2230620456616944e-05,1.1106915165381966e-05,0.6666666666666666
22356,오랑/Noun,3,1,2,1.1115310228308472e-05,2.2213830330763933e-05,0.6666666666666666
22357,6.7/Number,3,2,1,2.2230620456616944e-05,1.1106915165381966e-05,0.6666666666666666
22358,22분/Number,3,1,2,1.1115310228308472e-05,2.2213830330763933e-05,0.6666666666666666
22359,이종현/Noun,3,1,2,1.1115310228308472e-05,2.2213830330763933e-05,0.6666666666666666
22360,환경보호/Noun,3,2,1,2.2230620456616944e-05,1.1106915165381966e-05,0.6666666666666666
22361,빳/Noun,3,1,2,1.1115310228308472e-05,2.2213830330763933e-05,0.6666666666666666
22362,채령/Noun,3,2,1,2.2230620456616944e-05,1.1106915165381966e-05,0.6666666666666666
22363,선우용녀/Noun,3,1,2,1.1115310228308472e-05,2.2213830330763933e-05,0.6666666666666666
22364,이민우/Noun,3,2,1,2.2230620456616944e-05,1.1106915165381966e-05,0.6666666666666666
22365,구들/Noun,3,1,2,1.1115310228308472e-05,2.2213830330763933e-05,0.6666666666666666
22366,따리/Noun,3,1,2,1.1115310228308472e-05,2.2213830330763933e-05,0.6666666666666666
22367,미궁/Noun,3,2,1,2.2230620456616944e-05,1.1106915165381966e-05,0.6666666666666666
22368,고비/Noun,3,2,1,2.2230620456616944e-05,1.1106915165381966e-05,0.6666666666666666
22369,내비/Noun,3,1,2,1.1115310228308472e-05,2.2213830330763933e-05,0.6666666666666666
22370,미트/Noun,3,1,2,1.1115310228308472e-05,2.2213830330763933e-05,0.6666666666666666
22371,강경/Noun,3,1,2,1.1115310228308472e-05,2.2213830330763933e-05,0.6666666666666666
22372,하제/Noun,3,2,1,2.2230620456616944e-05,1.1106915165381966e-05,0.6666666666666666
22373,ㅈㅁ/KoreanParticle,3,1,2,1.1115310228308472e-05,2.2213830330763933e-05,0.6666666666666666
22374,샐러리맨/Noun,3,1,2,1.1115310228308472e-05,2.2213830330763933e-05,0.6666666666666666
22375,??...../Punctuation,3,2,1,2.2230620456616944e-05,1.1106915165381966e-05,0.6666666666666666
22376,졋음/Noun,3,1,2,1.1115310228308472e-05,2.2213830330763933e-05,0.6666666666666666
22377,왕중/Noun,3,2,1,2.2230620456616944e-05,1.1106915165381966e-05,0.6666666666666666
22378,베토벤바이러스/Noun,3,2,1,2.2230620456616944e-05,1.1106915165381966e-05,0.6666666666666666
22379,다세/Noun,3,2,1,2.2230620456616944e-05,1.1106915165381966e-05,0.6666666666666666
22380,보보/Noun,3,1,2,1.1115310228308472e-05,2.2213830330763933e-05,0.6666666666666666
22381,총구/Noun,3,2,1,2.2230620456616944e-05,1.1106915165381966e-05,0.6666666666666666
22382,특강/Noun,3,2,1,2.2230620456616944e-05,1.1106915165381966e-05,0.6666666666666666
22383,논산/Noun,3,1,2,1.1115310228308472e-05,2.2213830330763933e-05,0.6666666666666666
22384,범고래/Noun,3,2,1,2.2230620456616944e-05,1.1106915165381966e-05,0.6666666666666666
22385,화영/Noun,3,2,1,2.2230620456616944e-05,1.1106915165381966e-05,0.6666666666666666
22386,꽃말/Noun,3,2,1,2.2230620456616944e-05,1.1106915165381966e-05,0.6666666666666666
22387,비합리적/Noun,3,1,2,1.1115310228308472e-05,2.2213830330763933e-05,0.6666666666666666
22388,잘생겻다/Noun,3,2,1,2.2230620456616944e-05,1.1106915165381966e-05,0.6666666666666666
22389,오진희/Noun,3,1,2,1.1115310228308472e-05,2.2213830330763933e-05,0.6666666666666666
22390,주작/Noun,3,2,1,2.2230620456616944e-05,1.1106915165381966e-05,0.6666666666666666
22391,투견/Noun,3,2,1,2.2230620456616944e-05,1.1106915165381966e-05,0.6666666666666666
22392,패트와매트/Noun,3,1,2,1.1115310228308472e-05,2.2213830330763933e-05,0.6666666666666666
22393,보라카이/Noun,3,2,1,2.2230620456616944e-05,1.1106915165381966e-05,0.6666666666666666
22394,라사/Noun,3,1,2,1.1115310228308472e-05,2.2213830330763933e-05,0.6666666666666666
22395,마츠야마켄이치/Noun,3,2,1,2.2230620456616944e-05,1.1106915165381966e-05,0.6666666666666666
22396,진실인/Noun,3,1,2,1.1115310228308472e-05,2.2213830330763933e-05,0.6666666666666666
22397,불공정/Noun,3,1,2,1.1115310228308472e-05,2.2213830330763933e-05,0.6666666666666666
22398,절경/Noun,3,2,1,2.2230620456616944e-05,1.1106915165381966e-05,0.6666666666666666
22399,日/Foreign,3,2,1,2.2230620456616944e-05,1.1106915165381966e-05,0.6666666666666666
22400,잠그다/Verb,3,1,2,1.1115310228308472e-05,2.2213830330763933e-05,0.6666666666666666
22401,어두워지다/Verb,3,1,2,1.1115310228308472e-05,2.2213830330763933e-05,0.6666666666666666
22402,면은/Eomi,3,2,1,2.2230620456616944e-05,1.1106915165381966e-05,0.6666666666666666
22403,나팔/Noun,3,2,1,2.2230620456616944e-05,1.1106915165381966e-05,0.6666666666666666
22404,자연환경/Noun,3,2,1,2.2230620456616944e-05,1.1106915165381966e-05,0.6666666666666666
22405,김미화/Noun,3,1,2,1.1115310228308472e-05,2.2213830330763933e-05,0.6666666666666666
22406,수원/Noun,3,2,1,2.2230620456616944e-05,1.1106915165381966e-05,0.6666666666666666
22407,이례/Noun,3,1,2,1.1115310228308472e-05,2.2213830330763933e-05,0.6666666666666666
22408,카바/Noun,3,1,2,1.1115310228308472e-05,2.2213830330763933e-05,0.6666666666666666
22409,돌멩이/Noun,3,2,1,2.2230620456616944e-05,1.1106915165381966e-05,0.6666666666666666
22410,악장/Noun,3,2,1,2.2230620456616944e-05,1.1106915165381966e-05,0.6666666666666666
22411,뚱보/Noun,3,1,2,1.1115310228308472e-05,2.2213830330763933e-05,0.6666666666666666
22412,무속/Noun,3,2,1,2.2230620456616944e-05,1.1106915165381966e-05,0.6666666666666666
22413,박빙/Noun,3,1,2,1.1115310228308472e-05,2.2213830330763933e-05,0.6666666666666666
22414,로빈후드/Noun,3,2,1,2.2230620456616944e-05,1.1106915165381966e-05,0.6666666666666666
22415,비발디/Noun,3,1,2,1.1115310228308472e-05,2.2213830330763933e-05,0.6666666666666666
22416,클스/Noun,3,1,2,1.1115310228308472e-05,2.2213830330763933e-05,0.6666666666666666
22417,전쯤에/Foreign,3,1,2,1.1115310228308472e-05,2.2213830330763933e-05,0.6666666666666666
22418,인사이드아웃/Noun,3,1,2,1.1115310228308472e-05,2.2213830330763933e-05,0.6666666666666666
22419,폐쇄/Noun,3,1,2,1.1115310228308472e-05,2.2213830330763933e-05,0.6666666666666666
22420,업글/Noun,3,2,1,2.2230620456616944e-05,1.1106915165381966e-05,0.6666666666666666
22421,청나라/Noun,3,2,1,2.2230620456616944e-05,1.1106915165381966e-05,0.6666666666666666
22422,!!!!!!!!!!!!!!!!!!!!!/Punctuation,3,1,2,1.1115310228308472e-05,2.2213830330763933e-05,0.6666666666666666
22423,걸륜/Noun,3,1,2,1.1115310228308472e-05,2.2213830330763933e-05,0.6666666666666666
22424,전체주의/Noun,3,1,2,1.1115310228308472e-05,2.2213830330763933e-05,0.6666666666666666
22425,대중문화/Noun,3,2,1,2.2230620456616944e-05,1.1106915165381966e-05,0.6666666666666666
22426,인삼/Noun,3,1,2,1.1115310228308472e-05,2.2213830330763933e-05,0.6666666666666666
22427,손범수/Noun,3,1,2,1.1115310228308472e-05,2.2213830330763933e-05,0.6666666666666666
22428,룡/Noun,3,1,2,1.1115310228308472e-05,2.2213830330763933e-05,0.6666666666666666
22429,엊/Noun,3,1,2,1.1115310228308472e-05,2.2213830330763933e-05,0.6666666666666666
22430,세워지다/Verb,3,2,1,2.2230620456616944e-05,1.1106915165381966e-05,0.6666666666666666
22431,셀카/Noun,3,1,2,1.1115310228308472e-05,2.2213830330763933e-05,0.6666666666666666
22432,?!!!!/Punctuation,3,2,1,2.2230620456616944e-05,1.1106915165381966e-05,0.6666666666666666
22433,페르시아/Noun,3,1,2,1.1115310228308472e-05,2.2213830330763933e-05,0.6666666666666666
22434,이엉/Noun,3,2,1,2.2230620456616944e-05,1.1106915165381966e-05,0.6666666666666666
22435,웠다/Noun,3,2,1,2.2230620456616944e-05,1.1106915165381966e-05,0.6666666666666666
22436,아인/Noun,3,2,1,2.2230620456616944e-05,1.1106915165381966e-05,0.6666666666666666
22437,덤블링/Noun,3,1,2,1.1115310228308472e-05,2.2213830330763933e-05,0.6666666666666666
22438,준형/Noun,3,2,1,2.2230620456616944e-05,1.1106915165381966e-05,0.6666666666666666
22439,의뢰/Noun,3,1,2,1.1115310228308472e-05,2.2213830330763933e-05,0.6666666666666666
22440,커브/Noun,3,2,1,2.2230620456616944e-05,1.1106915165381966e-05,0.6666666666666666
22441,구딩/Noun,3,2,1,2.2230620456616944e-05,1.1106915165381966e-05,0.6666666666666666
22442,폭넓다/Adjective,3,2,1,2.2230620456616944e-05,1.1106915165381966e-05,0.6666666666666666
22443,나안/Noun,3,2,1,2.2230620456616944e-05,1.1106915165381966e-05,0.6666666666666666
22444,오메/Noun,3,1,2,1.1115310228308472e-05,2.2213830330763933e-05,0.6666666666666666
22445,포크레인/Noun,3,1,2,1.1115310228308472e-05,2.2213830330763933e-05,0.6666666666666666
22446,욕좀/Noun,3,2,1,2.2230620456616944e-05,1.1106915165381966e-05,0.6666666666666666
22447,400만/Number,3,2,1,2.2230620456616944e-05,1.1106915165381966e-05,0.6666666666666666
22448,김지원/Noun,3,2,1,2.2230620456616944e-05,1.1106915165381966e-05,0.6666666666666666
22449,PTA/Alpha,3,2,1,2.2230620456616944e-05,1.1106915165381966e-05,0.6666666666666666
22450,마구마구/Adverb,3,2,1,2.2230620456616944e-05,1.1106915165381966e-05,0.6666666666666666
22451,민가/Noun,3,2,1,2.2230620456616944e-05,1.1106915165381966e-05,0.6666666666666666
22452,ova/Alpha,3,1,2,1.1115310228308472e-05,2.2213830330763933e-05,0.6666666666666666
22453,장발/Noun,3,2,1,2.2230620456616944e-05,1.1106915165381966e-05,0.6666666666666666
22454,답니/Noun,3,1,2,1.1115310228308472e-05,2.2213830330763933e-05,0.6666666666666666
22455,money/Alpha,3,1,2,1.1115310228308472e-05,2.2213830330763933e-05,0.6666666666666666
22456,녓/Noun,3,2,1,2.2230620456616944e-05,1.1106915165381966e-05,0.6666666666666666
22457,사자후/Noun,3,2,1,2.2230620456616944e-05,1.1106915165381966e-05,0.6666666666666666
22458,웜홀/Noun,3,1,2,1.1115310228308472e-05,2.2213830330763933e-05,0.6666666666666666
22459,번외/Noun,3,1,2,1.1115310228308472e-05,2.2213830330763933e-05,0.6666666666666666
22460,레파토리/Noun,3,1,2,1.1115310228308472e-05,2.2213830330763933e-05,0.6666666666666666
22461,인가에/Foreign,3,2,1,2.2230620456616944e-05,1.1106915165381966e-05,0.6666666666666666
22462,로이스/Noun,3,1,2,1.1115310228308472e-05,2.2213830330763933e-05,0.6666666666666666
22463,무심/Noun,3,2,1,2.2230620456616944e-05,1.1106915165381966e-05,0.6666666666666666
22464,143분/Number,3,1,2,1.1115310228308472e-05,2.2213830330763933e-05,0.6666666666666666
22465,세이지/Noun,3,1,2,1.1115310228308472e-05,2.2213830330763933e-05,0.6666666666666666
22466,어지럽히다/Verb,3,1,2,1.1115310228308472e-05,2.2213830330763933e-05,0.6666666666666666
22467,명민좌/Noun,3,2,1,2.2230620456616944e-05,1.1106915165381966e-05,0.6666666666666666
22468,지코/Noun,3,1,2,1.1115310228308472e-05,2.2213830330763933e-05,0.6666666666666666
22469,캐산/Noun,3,1,2,1.1115310228308472e-05,2.2213830330763933e-05,0.6666666666666666
22470,well/Alpha,3,2,1,2.2230620456616944e-05,1.1106915165381966e-05,0.6666666666666666
22471,미인도/Noun,3,1,2,1.1115310228308472e-05,2.2213830330763933e-05,0.6666666666666666
22472,초연/Noun,3,2,1,2.2230620456616944e-05,1.1106915165381966e-05,0.6666666666666666
22473,한영/Noun,3,2,1,2.2230620456616944e-05,1.1106915165381966e-05,0.6666666666666666
22474,나가떨어지다/Verb,3,2,1,2.2230620456616944e-05,1.1106915165381966e-05,0.6666666666666666
22475,공수/Noun,3,2,1,2.2230620456616944e-05,1.1106915165381966e-05,0.6666666666666666
22476,번쩍번쩍/Adverb,3,1,2,1.1115310228308472e-05,2.2213830330763933e-05,0.6666666666666666
22477,중대/Noun,3,2,1,2.2230620456616944e-05,1.1106915165381966e-05,0.6666666666666666
22478,앤헤/Noun,3,1,2,1.1115310228308472e-05,2.2213830330763933e-05,0.6666666666666666
22479,됨됨이/Noun,3,2,1,2.2230620456616944e-05,1.1106915165381966e-05,0.6666666666666666
22480,제다이/Noun,3,1,2,1.1115310228308472e-05,2.2213830330763933e-05,0.6666666666666666
22481,수령/Noun,3,1,2,1.1115310228308472e-05,2.2213830330763933e-05,0.6666666666666666
22482,두아/Noun,3,2,1,2.2230620456616944e-05,1.1106915165381966e-05,0.6666666666666666
22483,예시/Noun,3,1,2,1.1115310228308472e-05,2.2213830330763933e-05,0.6666666666666666
22484,엘사/Noun,3,1,2,1.1115310228308472e-05,2.2213830330763933e-05,0.6666666666666666
22485,썬더일레븐/Noun,3,2,1,2.2230620456616944e-05,1.1106915165381966e-05,0.6666666666666666
22486,도열/Noun,3,1,2,1.1115310228308472e-05,2.2213830330763933e-05,0.6666666666666666
22487,그녈/Noun,3,2,1,2.2230620456616944e-05,1.1106915165381966e-05,0.6666666666666666
22488,암호/Noun,3,2,1,2.2230620456616944e-05,1.1106915165381966e-05,0.6666666666666666
22489,기류/Noun,3,1,2,1.1115310228308472e-05,2.2213830330763933e-05,0.6666666666666666
22490,48분/Number,3,1,2,1.1115310228308472e-05,2.2213830330763933e-05,0.6666666666666666
22491,곱창/Noun,3,1,2,1.1115310228308472e-05,2.2213830330763933e-05,0.6666666666666666
22492,정당방위/Noun,3,2,1,2.2230620456616944e-05,1.1106915165381966e-05,0.6666666666666666
22493,동독/Noun,3,1,2,1.1115310228308472e-05,2.2213830330763933e-05,0.6666666666666666
22494,레퍼토리/Noun,3,1,2,1.1115310228308472e-05,2.2213830330763933e-05,0.6666666666666666
22495,질끈/Noun,3,1,2,1.1115310228308472e-05,2.2213830330763933e-05,0.6666666666666666
22496,?-_-/Punctuation,3,1,2,1.1115310228308472e-05,2.2213830330763933e-05,0.6666666666666666
22497,윤태영/Noun,3,2,1,2.2230620456616944e-05,1.1106915165381966e-05,0.6666666666666666
22498,귱/Noun,3,1,2,1.1115310228308472e-05,2.2213830330763933e-05,0.6666666666666666
22499,애둘/Noun,3,1,2,1.1115310228308472e-05,2.2213830330763933e-05,0.6666666666666666
22500,수색/Noun,3,1,2,1.1115310228308472e-05,2.2213830330763933e-05,0.6666666666666666
22501,"?,,,/Punctuation",3,1,2,1.1115310228308472e-05,2.2213830330763933e-05,0.6666666666666666
22502,피바다/Noun,3,1,2,1.1115310228308472e-05,2.2213830330763933e-05,0.6666666666666666
22503,에손/Noun,3,1,2,1.1115310228308472e-05,2.2213830330763933e-05,0.6666666666666666
22504,무용수/Noun,3,2,1,2.2230620456616944e-05,1.1106915165381966e-05,0.6666666666666666
22505,니엘/Noun,3,2,1,2.2230620456616944e-05,1.1106915165381966e-05,0.6666666666666666
22506,쾌걸/Noun,3,2,1,2.2230620456616944e-05,1.1106915165381966e-05,0.6666666666666666
22507,바이스/Noun,3,2,1,2.2230620456616944e-05,1.1106915165381966e-05,0.6666666666666666
22508,안과/Noun,3,2,1,2.2230620456616944e-05,1.1106915165381966e-05,0.6666666666666666
22509,그르/Noun,3,1,2,1.1115310228308472e-05,2.2213830330763933e-05,0.6666666666666666
22510,3/2/Number,3,1,2,1.1115310228308472e-05,2.2213830330763933e-05,0.6666666666666666
22511,화들짝/Adverb,3,1,2,1.1115310228308472e-05,2.2213830330763933e-05,0.6666666666666666
22512,담시/Noun,3,2,1,2.2230620456616944e-05,1.1106915165381966e-05,0.6666666666666666
22513,흘/Noun,3,2,1,2.2230620456616944e-05,1.1106915165381966e-05,0.6666666666666666
22514,미유키/Noun,3,1,2,1.1115310228308472e-05,2.2213830330763933e-05,0.6666666666666666
22515,지수원/Noun,3,2,1,2.2230620456616944e-05,1.1106915165381966e-05,0.6666666666666666
22516,전철/Noun,3,1,2,1.1115310228308472e-05,2.2213830330763933e-05,0.6666666666666666
22517,-)/Punctuation,3,2,1,2.2230620456616944e-05,1.1106915165381966e-05,0.6666666666666666
22518,루터/Noun,3,2,1,2.2230620456616944e-05,1.1106915165381966e-05,0.6666666666666666
22519,폐하/Noun,3,1,2,1.1115310228308472e-05,2.2213830330763933e-05,0.6666666666666666
22520,퍼시/Noun,3,2,1,2.2230620456616944e-05,1.1106915165381966e-05,0.6666666666666666
22521,신해혁명/Noun,3,2,1,2.2230620456616944e-05,1.1106915165381966e-05,0.6666666666666666
22522,월동/Noun,3,2,1,2.2230620456616944e-05,1.1106915165381966e-05,0.6666666666666666
22523,국판/Noun,3,1,2,1.1115310228308472e-05,2.2213830330763933e-05,0.6666666666666666
22524,은꼴/Noun,3,1,2,1.1115310228308472e-05,2.2213830330763933e-05,0.6666666666666666
22525,박혁권/Noun,3,2,1,2.2230620456616944e-05,1.1106915165381966e-05,0.6666666666666666
22526,짠지/Noun,3,1,2,1.1115310228308472e-05,2.2213830330763933e-05,0.6666666666666666
22527,척박하다/Adjective,3,2,1,2.2230620456616944e-05,1.1106915165381966e-05,0.6666666666666666
22528,녁/Noun,3,2,1,2.2230620456616944e-05,1.1106915165381966e-05,0.6666666666666666
22529,운동권/Noun,3,1,2,1.1115310228308472e-05,2.2213830330763933e-05,0.6666666666666666
22530,틀어막다/Verb,3,1,2,1.1115310228308472e-05,2.2213830330763933e-05,0.6666666666666666
22531,",,,;;/Punctuation",3,1,2,1.1115310228308472e-05,2.2213830330763933e-05,0.6666666666666666
22532,스케줄/Noun,3,2,1,2.2230620456616944e-05,1.1106915165381966e-05,0.6666666666666666
22533,노엘/Noun,3,2,1,2.2230620456616944e-05,1.1106915165381966e-05,0.6666666666666666
22534,양철북/Noun,3,2,1,2.2230620456616944e-05,1.1106915165381966e-05,0.6666666666666666
22535,성사/Noun,3,2,1,2.2230620456616944e-05,1.1106915165381966e-05,0.6666666666666666
22536,인데도/Foreign,3,2,1,2.2230620456616944e-05,1.1106915165381966e-05,0.6666666666666666
22537,유성/Noun,3,1,2,1.1115310228308472e-05,2.2213830330763933e-05,0.6666666666666666
22538,올드먼/Noun,3,2,1,2.2230620456616944e-05,1.1106915165381966e-05,0.6666666666666666
22539,관찰자/Noun,3,2,1,2.2230620456616944e-05,1.1106915165381966e-05,0.6666666666666666
22540,가치나/Noun,3,1,2,1.1115310228308472e-05,2.2213830330763933e-05,0.6666666666666666
22541,까탈/Noun,3,2,1,2.2230620456616944e-05,1.1106915165381966e-05,0.6666666666666666
22542,alive/Alpha,3,2,1,2.2230620456616944e-05,1.1106915165381966e-05,0.6666666666666666
22543,Still/Alpha,3,2,1,2.2230620456616944e-05,1.1106915165381966e-05,0.6666666666666666
22544,드론/Noun,3,2,1,2.2230620456616944e-05,1.1106915165381966e-05,0.6666666666666666
22545,문화재/Noun,3,1,2,1.1115310228308472e-05,2.2213830330763933e-05,0.6666666666666666
22546,은실/Noun,3,2,1,2.2230620456616944e-05,1.1106915165381966e-05,0.6666666666666666
22547,오르다/Noun,3,2,1,2.2230620456616944e-05,1.1106915165381966e-05,0.6666666666666666
22548,폭발력/Noun,3,2,1,2.2230620456616944e-05,1.1106915165381966e-05,0.6666666666666666
22549,파이널판타지/Noun,3,2,1,2.2230620456616944e-05,1.1106915165381966e-05,0.6666666666666666
22550,공화당/Noun,3,1,2,1.1115310228308472e-05,2.2213830330763933e-05,0.6666666666666666
22551,2초/Number,3,1,2,1.1115310228308472e-05,2.2213830330763933e-05,0.6666666666666666
22552,읃/Noun,3,1,2,1.1115310228308472e-05,2.2213830330763933e-05,0.6666666666666666
22553,죠죠/Noun,3,1,2,1.1115310228308472e-05,2.2213830330763933e-05,0.6666666666666666
22554,복받치다/Verb,3,2,1,2.2230620456616944e-05,1.1106915165381966e-05,0.6666666666666666
22555,박태환/Noun,3,1,2,1.1115310228308472e-05,2.2213830330763933e-05,0.6666666666666666
22556,악용/Noun,3,1,2,1.1115310228308472e-05,2.2213830330763933e-05,0.6666666666666666
22557,뭐징/Noun,3,2,1,2.2230620456616944e-05,1.1106915165381966e-05,0.6666666666666666
22558,용호상박/Noun,3,1,2,1.1115310228308472e-05,2.2213830330763933e-05,0.6666666666666666
22559,ㅎㅋㅋ/KoreanParticle,3,2,1,2.2230620456616944e-05,1.1106915165381966e-05,0.6666666666666666
22560,패치/Noun,3,1,2,1.1115310228308472e-05,2.2213830330763933e-05,0.6666666666666666
22561,담당자/Noun,3,1,2,1.1115310228308472e-05,2.2213830330763933e-05,0.6666666666666666
22562,어니스트/Noun,3,2,1,2.2230620456616944e-05,1.1106915165381966e-05,0.6666666666666666
22563,안당/Noun,3,1,2,1.1115310228308472e-05,2.2213830330763933e-05,0.6666666666666666
22564,어으/Noun,3,1,2,1.1115310228308472e-05,2.2213830330763933e-05,0.6666666666666666
22565,놀이기구/Noun,3,2,1,2.2230620456616944e-05,1.1106915165381966e-05,0.6666666666666666
22566,디지몬/Noun,3,1,2,1.1115310228308472e-05,2.2213830330763933e-05,0.6666666666666666
22567,츠카/Noun,3,2,1,2.2230620456616944e-05,1.1106915165381966e-05,0.6666666666666666
22568,사업가/Noun,3,2,1,2.2230620456616944e-05,1.1106915165381966e-05,0.6666666666666666
22569,임정영/Noun,3,2,1,2.2230620456616944e-05,1.1106915165381966e-05,0.6666666666666666
22570,딘줄/Noun,3,1,2,1.1115310228308472e-05,2.2213830330763933e-05,0.6666666666666666
22571,뽕똘/Noun,3,1,2,1.1115310228308472e-05,2.2213830330763933e-05,0.6666666666666666
22572,싸매다/Verb,3,1,2,1.1115310228308472e-05,2.2213830330763933e-05,0.6666666666666666
22573,호옹이/Noun,3,1,2,1.1115310228308472e-05,2.2213830330763933e-05,0.6666666666666666
22574,니콜라/Noun,3,2,1,2.2230620456616944e-05,1.1106915165381966e-05,0.6666666666666666
22575,용맹하다/Adjective,3,2,1,2.2230620456616944e-05,1.1106915165381966e-05,0.6666666666666666
22576,정확/Noun,2,0,2,0.0,2.2213830330763933e-05,1.0
22577,투샷/Noun,2,0,2,0.0,2.2213830330763933e-05,1.0
22578,국민투표/Noun,2,0,2,0.0,2.2213830330763933e-05,1.0
22579,괜찬음/Noun,2,2,0,2.2230620456616944e-05,0.0,1.0
22580,보엿다/Noun,2,2,0,2.2230620456616944e-05,0.0,1.0
22581,배틀필드/Noun,2,0,2,0.0,2.2213830330763933e-05,1.0
22582,"-,-/Punctuation",2,0,2,0.0,2.2213830330763933e-05,1.0
22583,군중심리/Noun,2,2,0,2.2230620456616944e-05,0.0,1.0
22584,껍대기/Noun,2,0,2,0.0,2.2213830330763933e-05,1.0
22585,권해/Noun,2,2,0,2.2230620456616944e-05,0.0,1.0
22586,칙스/Noun,2,2,0,2.2230620456616944e-05,0.0,1.0
22587,전공자/Noun,2,0,2,0.0,2.2213830330763933e-05,1.0
22588,ㅌㅋ/KoreanParticle,2,0,2,0.0,2.2213830330763933e-05,1.0
22589,멸렬/Noun,2,0,2,0.0,2.2213830330763933e-05,1.0
22590,criminal/Alpha,2,2,0,2.2230620456616944e-05,0.0,1.0
22591,smooth/Alpha,2,2,0,2.2230620456616944e-05,0.0,1.0
22592,김광현/Noun,2,0,2,0.0,2.2213830330763933e-05,1.0
22593,차위/Noun,2,0,2,0.0,2.2213830330763933e-05,1.0
22594,더볼껄/Noun,2,0,2,0.0,2.2213830330763933e-05,1.0
22595,건너편/Noun,2,2,0,2.2230620456616944e-05,0.0,1.0
22596,분주하다/Adjective,2,0,2,0.0,2.2213830330763933e-05,1.0
22597,조개/Noun,2,2,0,2.2230620456616944e-05,0.0,1.0
22598,노쇄/Noun,2,0,2,0.0,2.2213830330763933e-05,1.0
22599,헥터/Noun,2,0,2,0.0,2.2213830330763933e-05,1.0
22600,안봣다/Noun,2,0,2,0.0,2.2213830330763933e-05,1.0
22601,48회/Number,2,0,2,0.0,2.2213830330763933e-05,1.0
22602,dream/Alpha,2,2,0,2.2230620456616944e-05,0.0,1.0
22603,백옥담/Noun,2,0,2,0.0,2.2213830330763933e-05,1.0
22604,식민/Noun,2,0,2,0.0,2.2213830330763933e-05,1.0
22605,...?!/Punctuation,2,2,0,2.2230620456616944e-05,0.0,1.0
22606,wish/Alpha,2,2,0,2.2230620456616944e-05,0.0,1.0
22607,역겁/Noun,2,0,2,0.0,2.2213830330763933e-05,1.0
22608,으흫/Noun,2,2,0,2.2230620456616944e-05,0.0,1.0
22609,우잉/Noun,2,2,0,2.2230620456616944e-05,0.0,1.0
22610,포토샵/Noun,2,0,2,0.0,2.2213830330763933e-05,1.0
22611,불로/Foreign,2,0,2,0.0,2.2213830330763933e-05,1.0
22612,브레스/Noun,2,2,0,2.2230620456616944e-05,0.0,1.0
22613,종속/Noun,2,2,0,2.2230620456616944e-05,0.0,1.0
22614,소리굽쇠/Noun,2,2,0,2.2230620456616944e-05,0.0,1.0
22615,번울/Noun,2,2,0,2.2230620456616944e-05,0.0,1.0
22616,글로브/Noun,2,2,0,2.2230620456616944e-05,0.0,1.0
22617,파인애플/Noun,2,0,2,0.0,2.2213830330763933e-05,1.0
22618,수탈/Noun,2,0,2,0.0,2.2213830330763933e-05,1.0
22619,masterpiece/Alpha,2,2,0,2.2230620456616944e-05,0.0,1.0
22620,일용직/Noun,2,2,0,2.2230620456616944e-05,0.0,1.0
22621,주르르/Noun,2,2,0,2.2230620456616944e-05,0.0,1.0
22622,래그/Noun,2,0,2,0.0,2.2213830330763933e-05,1.0
22623,후반전/Noun,2,0,2,0.0,2.2213830330763933e-05,1.0
22624,졸잼임/Noun,2,2,0,2.2230620456616944e-05,0.0,1.0
22625,정통파/Noun,2,2,0,2.2230620456616944e-05,0.0,1.0
22626,점에/Foreign,2,2,0,2.2230620456616944e-05,0.0,1.0
22627,"""'/Punctuation",2,0,2,0.0,2.2213830330763933e-05,1.0
22628,102회/Number,2,0,2,0.0,2.2213830330763933e-05,1.0
22629,뼘/Noun,2,2,0,2.2230620456616944e-05,0.0,1.0
22630,입냄새/Noun,2,0,2,0.0,2.2213830330763933e-05,1.0
22631,쪽문/Noun,2,2,0,2.2230620456616944e-05,0.0,1.0
22632,항시/Noun,2,0,2,0.0,2.2213830330763933e-05,1.0
22633,난폭/Noun,2,2,0,2.2230620456616944e-05,0.0,1.0
22634,호사/Noun,2,0,2,0.0,2.2213830330763933e-05,1.0
22635,겨드랑이/Noun,2,0,2,0.0,2.2213830330763933e-05,1.0
22636,픽/Noun,2,0,2,0.0,2.2213830330763933e-05,1.0
22637,블레임/Noun,2,0,2,0.0,2.2213830330763933e-05,1.0
22638,기적처럼/Noun,2,2,0,2.2230620456616944e-05,0.0,1.0
22639,페르난다/Noun,2,2,0,2.2230620456616944e-05,0.0,1.0
22640,!!./Punctuation,2,2,0,2.2230620456616944e-05,0.0,1.0
22641,엄써/Noun,2,0,2,0.0,2.2213830330763933e-05,1.0
22642,인도인/Noun,2,0,2,0.0,2.2213830330763933e-05,1.0
22643,의역/Noun,2,0,2,0.0,2.2213830330763933e-05,1.0
22644,bal/Alpha,2,0,2,0.0,2.2213830330763933e-05,1.0
22645,poor/Alpha,2,2,0,2.2230620456616944e-05,0.0,1.0
22646,저변/Noun,2,2,0,2.2230620456616944e-05,0.0,1.0
22647,야구선수/Noun,2,2,0,2.2230620456616944e-05,0.0,1.0
22648,책망/Noun,2,2,0,2.2230620456616944e-05,0.0,1.0
22649,거른다/Noun,2,0,2,0.0,2.2213830330763933e-05,1.0
22650,유교/Noun,2,2,0,2.2230620456616944e-05,0.0,1.0
22651,달렷/Noun,2,0,2,0.0,2.2213830330763933e-05,1.0
22652,가첨/Noun,2,0,2,0.0,2.2213830330763933e-05,1.0
22653,유인/Noun,2,0,2,0.0,2.2213830330763933e-05,1.0
22654,~!~!~!/Punctuation,2,2,0,2.2230620456616944e-05,0.0,1.0
22655,고어씬/Noun,2,0,2,0.0,2.2213830330763933e-05,1.0
22656,임형주/Noun,2,2,0,2.2230620456616944e-05,0.0,1.0
22657,무것/Noun,2,0,2,0.0,2.2213830330763933e-05,1.0
22658,목성/Noun,2,2,0,2.2230620456616944e-05,0.0,1.0
22659,헀다/Noun,2,2,0,2.2230620456616944e-05,0.0,1.0
22660,ㅎㅏ/KoreanParticle,2,0,2,0.0,2.2213830330763933e-05,1.0
22661,참고자료/Noun,2,0,2,0.0,2.2213830330763933e-05,1.0
22662,뷰티플/Noun,2,2,0,2.2230620456616944e-05,0.0,1.0
22663,free/Alpha,2,2,0,2.2230620456616944e-05,0.0,1.0
22664,격는/Noun,2,2,0,2.2230620456616944e-05,0.0,1.0
22665,작사/Noun,2,2,0,2.2230620456616944e-05,0.0,1.0
22666,-_-++/Punctuation,2,0,2,0.0,2.2213830330763933e-05,1.0
22667,윤미라/Noun,2,2,0,2.2230620456616944e-05,0.0,1.0
22668,sing/Alpha,2,2,0,2.2230620456616944e-05,0.0,1.0
22669,hear/Alpha,2,2,0,2.2230620456616944e-05,0.0,1.0
22670,삼일한/Noun,2,0,2,0.0,2.2213830330763933e-05,1.0
22671,무간지옥/Noun,2,2,0,2.2230620456616944e-05,0.0,1.0
22672,차화연/Noun,2,2,0,2.2230620456616944e-05,0.0,1.0
22673,돈세탁/Noun,2,0,2,0.0,2.2213830330763933e-05,1.0
22674,화물차/Noun,2,0,2,0.0,2.2213830330763933e-05,1.0
22675,이생/Noun,2,2,0,2.2230620456616944e-05,0.0,1.0
22676,할례/Noun,2,2,0,2.2230620456616944e-05,0.0,1.0
22677,900/Number,2,0,2,0.0,2.2213830330763933e-05,1.0
22678,가량의/Foreign,2,0,2,0.0,2.2213830330763933e-05,1.0
22679,2015.06/Number,2,0,2,0.0,2.2213830330763933e-05,1.0
22680,핼/Noun,2,0,2,0.0,2.2213830330763933e-05,1.0
22681,복만/Noun,2,0,2,0.0,2.2213830330763933e-05,1.0
22682,부기맨/Noun,2,0,2,0.0,2.2213830330763933e-05,1.0
22683,성악가/Noun,2,2,0,2.2230620456616944e-05,0.0,1.0
22684,파지다/Verb,2,2,0,2.2230620456616944e-05,0.0,1.0
22685,ee/Alpha,2,0,2,0.0,2.2213830330763933e-05,1.0
22686,모닝/Noun,2,2,0,2.2230620456616944e-05,0.0,1.0
22687,急/Foreign,2,0,2,0.0,2.2213830330763933e-05,1.0
22688,추신수/Noun,2,0,2,0.0,2.2213830330763933e-05,1.0
22689,고유명사/Noun,2,0,2,0.0,2.2213830330763933e-05,1.0
22690,ㅇㅎ/KoreanParticle,2,2,0,2.2230620456616944e-05,0.0,1.0
22691,유재하/Noun,2,2,0,2.2230620456616944e-05,0.0,1.0
22692,이탄/Noun,2,2,0,2.2230620456616944e-05,0.0,1.0
22693,식칼/Noun,2,0,2,0.0,2.2213830330763933e-05,1.0
22694,말랑말랑하다/Adjective,2,2,0,2.2230620456616944e-05,0.0,1.0
22695,던파/Noun,2,2,0,2.2230620456616944e-05,0.0,1.0
22696,75년/Number,2,2,0,2.2230620456616944e-05,0.0,1.0
22697,빠돌/Noun,2,0,2,0.0,2.2213830330763933e-05,1.0
22698,탈영병/Noun,2,2,0,2.2230620456616944e-05,0.0,1.0
22699,앳/Noun,2,2,0,2.2230620456616944e-05,0.0,1.0
22700,매니지먼트/Noun,2,2,0,2.2230620456616944e-05,0.0,1.0
22701,~!~!!/Punctuation,2,2,0,2.2230620456616944e-05,0.0,1.0
22702,신다리/Noun,2,2,0,2.2230620456616944e-05,0.0,1.0
22703,울타리/Noun,2,2,0,2.2230620456616944e-05,0.0,1.0
22704,다시다/Noun,2,2,0,2.2230620456616944e-05,0.0,1.0
22705,오도바이/Noun,2,0,2,0.0,2.2213830330763933e-05,1.0
22706,서두원/Noun,2,0,2,0.0,2.2213830330763933e-05,1.0
22707,오초희/Noun,2,0,2,0.0,2.2213830330763933e-05,1.0
22708,42/Number,2,2,0,2.2230620456616944e-05,0.0,1.0
22709,1122334455/Number,2,0,2,0.0,2.2213830330763933e-05,1.0
22710,>_<!/Punctuation,2,2,0,2.2230620456616944e-05,0.0,1.0
22711,취준생들/Noun,2,2,0,2.2230620456616944e-05,0.0,1.0
22712,강한나/Noun,2,0,2,0.0,2.2213830330763933e-05,1.0
22713,괸히봤다/Noun,2,0,2,0.0,2.2213830330763933e-05,1.0
22714,들쭉날쭉하다/Adjective,2,0,2,0.0,2.2213830330763933e-05,1.0
22715,졸업생/Noun,2,0,2,0.0,2.2213830330763933e-05,1.0
22716,영화아카데미/Noun,2,0,2,0.0,2.2213830330763933e-05,1.0
22717,견적/Noun,2,0,2,0.0,2.2213830330763933e-05,1.0
22718,5.8/Number,2,0,2,0.0,2.2213830330763933e-05,1.0
22719,바구니/Noun,2,2,0,2.2230620456616944e-05,0.0,1.0
22720,시각장애/Noun,2,2,0,2.2230620456616944e-05,0.0,1.0
22721,순다/Noun,2,2,0,2.2230620456616944e-05,0.0,1.0
22722,연지/Noun,2,2,0,2.2230620456616944e-05,0.0,1.0
22723,파주/Noun,2,0,2,0.0,2.2213830330763933e-05,1.0
22724,때무/Noun,2,2,0,2.2230620456616944e-05,0.0,1.0
22725,장항/Noun,2,2,0,2.2230620456616944e-05,0.0,1.0
22726,천차만별/Noun,2,2,0,2.2230620456616944e-05,0.0,1.0
22727,박준금/Noun,2,0,2,0.0,2.2213830330763933e-05,1.0
22728,가제트/Noun,2,0,2,0.0,2.2213830330763933e-05,1.0
22729,출발드림팀/Noun,2,0,2,0.0,2.2213830330763933e-05,1.0
22730,미혼녀/Noun,2,0,2,0.0,2.2213830330763933e-05,1.0
22731,윙크/Noun,2,2,0,2.2230620456616944e-05,0.0,1.0
22732,퓬/Noun,2,0,2,0.0,2.2213830330763933e-05,1.0
22733,책사/Noun,2,2,0,2.2230620456616944e-05,0.0,1.0
22734,항목/Noun,2,0,2,0.0,2.2213830330763933e-05,1.0
22735,짜쯩난다/Noun,2,0,2,0.0,2.2213830330763933e-05,1.0
22736,헉스/Noun,2,2,0,2.2230620456616944e-05,0.0,1.0
22737,미국정부/Noun,2,0,2,0.0,2.2213830330763933e-05,1.0
22738,유해하다/Adjective,2,0,2,0.0,2.2213830330763933e-05,1.0
22739,scene/Alpha,2,0,2,0.0,2.2213830330763933e-05,1.0
22740,블로펠드/Noun,2,2,0,2.2230620456616944e-05,0.0,1.0
22741,실라/Noun,2,2,0,2.2230620456616944e-05,0.0,1.0
22742,동백/Noun,2,2,0,2.2230620456616944e-05,0.0,1.0
22743,깡그리/Noun,2,0,2,0.0,2.2213830330763933e-05,1.0
22744,정담/Noun,2,2,0,2.2230620456616944e-05,0.0,1.0
22745,목함/Noun,2,2,0,2.2230620456616944e-05,0.0,1.0
22746,명바긔/Noun,2,2,0,2.2230620456616944e-05,0.0,1.0
22747,눈부심/Noun,2,2,0,2.2230620456616944e-05,0.0,1.0
22748,shame/Alpha,2,2,0,2.2230620456616944e-05,0.0,1.0
22749,귿/Noun,2,2,0,2.2230620456616944e-05,0.0,1.0
22750,대부도/Noun,2,2,0,2.2230620456616944e-05,0.0,1.0
22751,두절/Noun,2,2,0,2.2230620456616944e-05,0.0,1.0
22752,다완/Noun,2,0,2,0.0,2.2213830330763933e-05,1.0
22753,얄라/Noun,2,0,2,0.0,2.2213830330763933e-05,1.0
22754,루왁/Noun,2,2,0,2.2230620456616944e-05,0.0,1.0
22755,공임/Noun,2,0,2,0.0,2.2213830330763933e-05,1.0
22756,입맞춤/Noun,2,0,2,0.0,2.2213830330763933e-05,1.0
22757,해외진출/Noun,2,0,2,0.0,2.2213830330763933e-05,1.0
22758,견도/Noun,2,2,0,2.2230620456616944e-05,0.0,1.0
22759,선입/Noun,2,2,0,2.2230620456616944e-05,0.0,1.0
22760,1933년/Number,2,0,2,0.0,2.2213830330763933e-05,1.0
22761,란마/Noun,2,2,0,2.2230620456616944e-05,0.0,1.0
22762,금산/Noun,2,2,0,2.2230620456616944e-05,0.0,1.0
22763,이뭐냐/Foreign,2,0,2,0.0,2.2213830330763933e-05,1.0
22764,픕/Noun,2,0,2,0.0,2.2213830330763933e-05,1.0
22765,재밓/Noun,2,2,0,2.2230620456616944e-05,0.0,1.0
22766,속뜻/Noun,2,0,2,0.0,2.2213830330763933e-05,1.0
22767,스팍스/Noun,2,0,2,0.0,2.2213830330763933e-05,1.0
22768,경공/Noun,2,0,2,0.0,2.2213830330763933e-05,1.0
22769,굼뜨/Noun,2,0,2,0.0,2.2213830330763933e-05,1.0
22770,침스/Noun,2,0,2,0.0,2.2213830330763933e-05,1.0
22771,분방/Noun,2,0,2,0.0,2.2213830330763933e-05,1.0
22772,엇군/Noun,2,2,0,2.2230620456616944e-05,0.0,1.0
22773,포도주/Noun,2,2,0,2.2230620456616944e-05,0.0,1.0
22774,이상만/Noun,2,0,2,0.0,2.2213830330763933e-05,1.0
22775,기키/Noun,2,0,2,0.0,2.2213830330763933e-05,1.0
22776,5.16/Number,2,2,0,2.2230620456616944e-05,0.0,1.0
22777,꼭알/Noun,2,2,0,2.2230620456616944e-05,0.0,1.0
22778,볼려/Noun,2,0,2,0.0,2.2213830330763933e-05,1.0
22779,나현희/Noun,2,2,0,2.2230620456616944e-05,0.0,1.0
22780,태안/Noun,2,2,0,2.2230620456616944e-05,0.0,1.0
22781,안깝/Noun,2,0,2,0.0,2.2213830330763933e-05,1.0
22782,신령/Noun,2,0,2,0.0,2.2213830330763933e-05,1.0
22783,청연/Noun,2,2,0,2.2230620456616944e-05,0.0,1.0
22784,태국어/Noun,2,0,2,0.0,2.2213830330763933e-05,1.0
22785,SATC/Alpha,2,0,2,0.0,2.2213830330763933e-05,1.0
22786,기우/Noun,2,2,0,2.2230620456616944e-05,0.0,1.0
22787,박광춘/Noun,2,0,2,0.0,2.2213830330763933e-05,1.0
22788,거름/Noun,2,0,2,0.0,2.2213830330763933e-05,1.0
22789,증후군/Noun,2,0,2,0.0,2.2213830330763933e-05,1.0
22790,웨서방/Noun,2,0,2,0.0,2.2213830330763933e-05,1.0
22791,...????/Punctuation,2,0,2,0.0,2.2213830330763933e-05,1.0
22792,가배/Noun,2,0,2,0.0,2.2213830330763933e-05,1.0
22793,쟈밋/Noun,2,2,0,2.2230620456616944e-05,0.0,1.0
22794,드레곤/Noun,2,0,2,0.0,2.2213830330763933e-05,1.0
22795,truth/Alpha,2,2,0,2.2230620456616944e-05,0.0,1.0
22796,컬러풀/Noun,2,2,0,2.2230620456616944e-05,0.0,1.0
22797,스크랩/Noun,2,0,2,0.0,2.2213830330763933e-05,1.0
22798,후추/Noun,2,0,2,0.0,2.2213830330763933e-05,1.0
22799,망국/Noun,2,0,2,0.0,2.2213830330763933e-05,1.0
22800,정력/Noun,2,0,2,0.0,2.2213830330763933e-05,1.0
22801,골병/Noun,2,0,2,0.0,2.2213830330763933e-05,1.0
22802,제르/Noun,2,2,0,2.2230620456616944e-05,0.0,1.0
22803,운널/Noun,2,2,0,2.2230620456616944e-05,0.0,1.0
22804,EVER/Alpha,2,2,0,2.2230620456616944e-05,0.0,1.0
22805,엉킨/Noun,2,2,0,2.2230620456616944e-05,0.0,1.0
22806,???;;;/Punctuation,2,0,2,0.0,2.2213830330763933e-05,1.0
22807,있어욤/Noun,2,2,0,2.2230620456616944e-05,0.0,1.0
22808,란좀/Noun,2,2,0,2.2230620456616944e-05,0.0,1.0
22809,평화로움/Noun,2,0,2,0.0,2.2213830330763933e-05,1.0
22810,_-;;/Punctuation,2,0,2,0.0,2.2213830330763933e-05,1.0
22811,마리안느/Noun,2,2,0,2.2230620456616944e-05,0.0,1.0
22812,후문/Noun,2,0,2,0.0,2.2213830330763933e-05,1.0
22813,-^^/Punctuation,2,2,0,2.2230620456616944e-05,0.0,1.0
22814,몸안/Noun,2,2,0,2.2230620456616944e-05,0.0,1.0
22815,동경대/Noun,2,2,0,2.2230620456616944e-05,0.0,1.0
22816,:;/Punctuation,2,0,2,0.0,2.2213830330763933e-05,1.0
22817,오리온/Noun,2,2,0,2.2230620456616944e-05,0.0,1.0
22818,부랄/Noun,2,0,2,0.0,2.2213830330763933e-05,1.0
22819,개굿/Noun,2,2,0,2.2230620456616944e-05,0.0,1.0
22820,킹슬리/Noun,2,2,0,2.2230620456616944e-05,0.0,1.0
22821,쫌쫌쫌/Noun,2,0,2,0.0,2.2213830330763933e-05,1.0
22822,로시/Noun,2,0,2,0.0,2.2213830330763933e-05,1.0
22823,분홍신/Noun,2,0,2,0.0,2.2213830330763933e-05,1.0
22824,카프카/Noun,2,2,0,2.2230620456616944e-05,0.0,1.0
22825,드리우다/Verb,2,2,0,2.2230620456616944e-05,0.0,1.0
22826,"...^.,^/Punctuation",2,2,0,2.2230620456616944e-05,0.0,1.0
22827,pass/Alpha,2,2,0,2.2230620456616944e-05,0.0,1.0
22828,수퍼스타/Noun,2,0,2,0.0,2.2213830330763933e-05,1.0
22829,소대/Noun,2,2,0,2.2230620456616944e-05,0.0,1.0
22830,나데르/Noun,2,2,0,2.2230620456616944e-05,0.0,1.0
22831,씨민/Noun,2,2,0,2.2230620456616944e-05,0.0,1.0
22832,정연/Noun,2,0,2,0.0,2.2213830330763933e-05,1.0
22833,성악/Noun,2,0,2,0.0,2.2213830330763933e-05,1.0
22834,돈내/Noun,2,0,2,0.0,2.2213830330763933e-05,1.0
22835,나벨/Noun,2,0,2,0.0,2.2213830330763933e-05,1.0
22836,뱅이/Noun,2,0,2,0.0,2.2213830330763933e-05,1.0
22837,콰지모/Noun,2,2,0,2.2230620456616944e-05,0.0,1.0
22838,탠데/Noun,2,0,2,0.0,2.2213830330763933e-05,1.0
22839,dl/Alpha,2,2,0,2.2230620456616944e-05,0.0,1.0
22840,꿀꺽/Noun,2,0,2,0.0,2.2213830330763933e-05,1.0
22841,존론/Noun,2,2,0,2.2230620456616944e-05,0.0,1.0
22842,카라스/Noun,2,2,0,2.2230620456616944e-05,0.0,1.0
22843,지오디/Noun,2,0,2,0.0,2.2213830330763933e-05,1.0
22844,종북주의자/Noun,2,0,2,0.0,2.2213830330763933e-05,1.0
22845,⌒⌒/Foreign,2,2,0,2.2230620456616944e-05,0.0,1.0
22846,마즈/Noun,2,0,2,0.0,2.2213830330763933e-05,1.0
22847,반에/Foreign,2,0,2,0.0,2.2213830330763933e-05,1.0
22848,지쟈스/Noun,2,0,2,0.0,2.2213830330763933e-05,1.0
22849,게런티/Noun,2,0,2,0.0,2.2213830330763933e-05,1.0
22850,트러블/Noun,2,0,2,0.0,2.2213830330763933e-05,1.0
22851,한지붕/Noun,2,2,0,2.2230620456616944e-05,0.0,1.0
22852,낙인찍히다/Verb,2,2,0,2.2230620456616944e-05,0.0,1.0
22853,반효정/Noun,2,0,2,0.0,2.2213830330763933e-05,1.0
22854,경제학/Noun,2,2,0,2.2230620456616944e-05,0.0,1.0
22855,사이비종교/Noun,2,0,2,0.0,2.2213830330763933e-05,1.0
22856,이성미/Noun,2,0,2,0.0,2.2213830330763933e-05,1.0
22857,명도/Foreign,2,0,2,0.0,2.2213830330763933e-05,1.0
22858,트란/Noun,2,0,2,0.0,2.2213830330763933e-05,1.0
22859,서랍/Noun,2,2,0,2.2230620456616944e-05,0.0,1.0
22860,King/Alpha,2,2,0,2.2230620456616944e-05,0.0,1.0
22861,볼펜/Noun,2,2,0,2.2230620456616944e-05,0.0,1.0
22862,('/Punctuation,2,2,0,2.2230620456616944e-05,0.0,1.0
22863,탁후/Noun,2,0,2,0.0,2.2213830330763933e-05,1.0
22864,돋보기/Noun,2,2,0,2.2230620456616944e-05,0.0,1.0
22865,페어차일드/Noun,2,2,0,2.2230620456616944e-05,0.0,1.0
22866,엇움/Noun,2,2,0,2.2230620456616944e-05,0.0,1.0
22867,찌끼/Noun,2,0,2,0.0,2.2213830330763933e-05,1.0
22868,영월/Noun,2,2,0,2.2230620456616944e-05,0.0,1.0
22869,서러움/Noun,2,2,0,2.2230620456616944e-05,0.0,1.0
22870,2.33/Number,2,0,2,0.0,2.2213830330763933e-05,1.0
22871,욕불/Noun,2,0,2,0.0,2.2213830330763933e-05,1.0
22872,리페이스/Noun,2,2,0,2.2230620456616944e-05,0.0,1.0
22873,아트웍/Noun,2,0,2,0.0,2.2213830330763933e-05,1.0
22874,사르르/Noun,2,2,0,2.2230620456616944e-05,0.0,1.0
22875,봉춤/Noun,2,0,2,0.0,2.2213830330763933e-05,1.0
22876,~~~~~~~~~~~~~~~~~/Punctuation,2,2,0,2.2230620456616944e-05,0.0,1.0
22877,정도까진/Foreign,2,0,2,0.0,2.2213830330763933e-05,1.0
22878,.^-^/Punctuation,2,2,0,2.2230620456616944e-05,0.0,1.0
22879,몬페/Noun,2,2,0,2.2230620456616944e-05,0.0,1.0
22880,유병재/Noun,2,0,2,0.0,2.2213830330763933e-05,1.0
22881,빔벤더스/Noun,2,0,2,0.0,2.2213830330763933e-05,1.0
22882,라라라/Noun,2,2,0,2.2230620456616944e-05,0.0,1.0
22883,곰곰/Adverb,2,0,2,0.0,2.2213830330763933e-05,1.0
22884,클립/Noun,2,2,0,2.2230620456616944e-05,0.0,1.0
22885,의경/Noun,2,0,2,0.0,2.2213830330763933e-05,1.0
22886,bless/Alpha,2,2,0,2.2230620456616944e-05,0.0,1.0
22887,정연주/Noun,2,0,2,0.0,2.2213830330763933e-05,1.0
22888,이얼/Noun,2,0,2,0.0,2.2213830330763933e-05,1.0
22889,우동/Noun,2,0,2,0.0,2.2213830330763933e-05,1.0
22890,미행/Noun,2,0,2,0.0,2.2213830330763933e-05,1.0
22891,현도/Noun,2,0,2,0.0,2.2213830330763933e-05,1.0
22892,누렁이/Noun,2,2,0,2.2230620456616944e-05,0.0,1.0
22893,웃통/Noun,2,0,2,0.0,2.2213830330763933e-05,1.0
22894,사물놀이/Noun,2,0,2,0.0,2.2213830330763933e-05,1.0
22895,싸움씬/Noun,2,2,0,2.2230620456616944e-05,0.0,1.0
22896,마벨/Noun,2,2,0,2.2230620456616944e-05,0.0,1.0
22897,홍번구/Noun,2,2,0,2.2230620456616944e-05,0.0,1.0
22898,펜션/Noun,2,0,2,0.0,2.2213830330763933e-05,1.0
22899,녹음기/Noun,2,0,2,0.0,2.2213830330763933e-05,1.0
22900,완쾌/Noun,2,0,2,0.0,2.2213830330763933e-05,1.0
22901,즉석/Noun,2,0,2,0.0,2.2213830330763933e-05,1.0
22902,콩나물/Noun,2,0,2,0.0,2.2213830330763933e-05,1.0
22903,부트캠프/Noun,2,2,0,2.2230620456616944e-05,0.0,1.0
22904,엘레나/Noun,2,2,0,2.2230620456616944e-05,0.0,1.0
22905,딜런/Noun,2,2,0,2.2230620456616944e-05,0.0,1.0
22906,고령/Noun,2,2,0,2.2230620456616944e-05,0.0,1.0
22907,DO/Alpha,2,2,0,2.2230620456616944e-05,0.0,1.0
22908,도개/Noun,2,0,2,0.0,2.2213830330763933e-05,1.0
22909,동근/Noun,2,0,2,0.0,2.2213830330763933e-05,1.0
22910,전기충격기/Noun,2,0,2,0.0,2.2213830330763933e-05,1.0
22911,늦어지다/Verb,2,0,2,0.0,2.2213830330763933e-05,1.0
22912,자동차경주/Noun,2,2,0,2.2230620456616944e-05,0.0,1.0
22913,용무/Noun,2,0,2,0.0,2.2213830330763933e-05,1.0
22914,저자/Noun,2,0,2,0.0,2.2213830330763933e-05,1.0
22915,년차/Noun,2,0,2,0.0,2.2213830330763933e-05,1.0
22916,형통/Noun,2,2,0,2.2230620456616944e-05,0.0,1.0
22917,토킹/Noun,2,0,2,0.0,2.2213830330763933e-05,1.0
22918,수반/Noun,2,2,0,2.2230620456616944e-05,0.0,1.0
22919,내마스/Noun,2,2,0,2.2230620456616944e-05,0.0,1.0
22920,에게라도/Josa,2,2,0,2.2230620456616944e-05,0.0,1.0
22921,알투비/Noun,2,0,2,0.0,2.2213830330763933e-05,1.0
22922,지은이/Noun,2,0,2,0.0,2.2213830330763933e-05,1.0
22923,ns/Alpha,2,2,0,2.2230620456616944e-05,0.0,1.0
22924,도굴/Noun,2,0,2,0.0,2.2213830330763933e-05,1.0
22925,틸드/Noun,2,2,0,2.2230620456616944e-05,0.0,1.0
22926,ㄲㄲ/KoreanParticle,2,0,2,0.0,2.2213830330763933e-05,1.0
22927,제페토/Noun,2,2,0,2.2230620456616944e-05,0.0,1.0
22928,개열/Noun,2,0,2,0.0,2.2213830330763933e-05,1.0
22929,포켓/Noun,2,0,2,0.0,2.2213830330763933e-05,1.0
22930,조용원/Noun,2,2,0,2.2230620456616944e-05,0.0,1.0
22931,핏/Noun,2,2,0,2.2230620456616944e-05,0.0,1.0
22932,나귀/Noun,2,2,0,2.2230620456616944e-05,0.0,1.0
22933,볼보/Noun,2,0,2,0.0,2.2213830330763933e-05,1.0
22934,꺠알같/Noun,2,2,0,2.2230620456616944e-05,0.0,1.0
22935,교활하다/Adjective,2,0,2,0.0,2.2213830330763933e-05,1.0
22936,거미공포증/Noun,2,2,0,2.2230620456616944e-05,0.0,1.0
22937,기타로/Noun,2,2,0,2.2230620456616944e-05,0.0,1.0
22938,부적절/Noun,2,0,2,0.0,2.2213830330763933e-05,1.0
22939,도민준/Noun,2,2,0,2.2230620456616944e-05,0.0,1.0
22940,전보다/Foreign,2,0,2,0.0,2.2213830330763933e-05,1.0
22941,블랙박스/Noun,2,2,0,2.2230620456616944e-05,0.0,1.0
22942,새해/Noun,2,2,0,2.2230620456616944e-05,0.0,1.0
22943,초신성/Noun,2,0,2,0.0,2.2213830330763933e-05,1.0
22944,민사/Noun,2,2,0,2.2230620456616944e-05,0.0,1.0
22945,낱낱이/Noun,2,2,0,2.2230620456616944e-05,0.0,1.0
22946,됫으/Noun,2,2,0,2.2230620456616944e-05,0.0,1.0
22947,피봄/Noun,2,0,2,0.0,2.2213830330763933e-05,1.0
22948,유익/Noun,2,0,2,0.0,2.2213830330763933e-05,1.0
22949,바람기/Noun,2,0,2,0.0,2.2213830330763933e-05,1.0
22950,쥬네/Noun,2,2,0,2.2230620456616944e-05,0.0,1.0
22951,미요/Noun,2,2,0,2.2230620456616944e-05,0.0,1.0
22952,촤악/Noun,2,0,2,0.0,2.2213830330763933e-05,1.0
22953,간기남/Noun,2,0,2,0.0,2.2213830330763933e-05,1.0
22954,NWO/Alpha,2,0,2,0.0,2.2213830330763933e-05,1.0
22955,데뷔초/Noun,2,2,0,2.2230620456616944e-05,0.0,1.0
22956,부외/Noun,2,0,2,0.0,2.2213830330763933e-05,1.0
22957,매끈하다/Adjective,2,0,2,0.0,2.2213830330763933e-05,1.0
22958,원색/Noun,2,2,0,2.2230620456616944e-05,0.0,1.0
22959,gut/Alpha,2,2,0,2.2230620456616944e-05,0.0,1.0
22960,angel/Alpha,2,2,0,2.2230620456616944e-05,0.0,1.0
22961,지구인/Noun,2,2,0,2.2230620456616944e-05,0.0,1.0
22962,유승기/Noun,2,2,0,2.2230620456616944e-05,0.0,1.0
22963,웅거러/Noun,2,2,0,2.2230620456616944e-05,0.0,1.0
22964,경로당/Noun,2,0,2,0.0,2.2213830330763933e-05,1.0
22965,악취미/Noun,2,0,2,0.0,2.2213830330763933e-05,1.0
22966,에몽/Noun,2,2,0,2.2230620456616944e-05,0.0,1.0
22967,질실/Noun,2,2,0,2.2230620456616944e-05,0.0,1.0
22968,용병/Noun,2,0,2,0.0,2.2213830330763933e-05,1.0
22969,고뤠/Noun,2,0,2,0.0,2.2213830330763933e-05,1.0
22970,..^^:;/Punctuation,2,2,0,2.2230620456616944e-05,0.0,1.0
22971,message/Alpha,2,2,0,2.2230620456616944e-05,0.0,1.0
22972,동식/Noun,2,0,2,0.0,2.2213830330763933e-05,1.0
22973,u/Alpha,2,0,2,0.0,2.2213830330763933e-05,1.0
22974,Korean/Alpha,2,2,0,2.2230620456616944e-05,0.0,1.0
22975,케어드/Noun,2,2,0,2.2230620456616944e-05,0.0,1.0
22976,옛스럽다/Adjective,2,0,2,0.0,2.2213830330763933e-05,1.0
22977,"....,..../Punctuation",2,0,2,0.0,2.2213830330763933e-05,1.0
22978,스코어/Noun,2,0,2,0.0,2.2213830330763933e-05,1.0
22979,요리실/Noun,2,0,2,0.0,2.2213830330763933e-05,1.0
22980,윤재아/Noun,2,0,2,0.0,2.2213830330763933e-05,1.0
22981,양하다/Adjective,2,0,2,0.0,2.2213830330763933e-05,1.0
22982,펠릭스/Noun,2,2,0,2.2230620456616944e-05,0.0,1.0
22983,걸프렌즈/Noun,2,0,2,0.0,2.2213830330763933e-05,1.0
22984,복학생/Noun,2,0,2,0.0,2.2213830330763933e-05,1.0
22985,박란/Noun,2,0,2,0.0,2.2213830330763933e-05,1.0
22986,대길/Noun,2,2,0,2.2230620456616944e-05,0.0,1.0
22987,야간매점/Noun,2,0,2,0.0,2.2213830330763933e-05,1.0
22988,Show/Alpha,2,2,0,2.2230620456616944e-05,0.0,1.0
22989,절세/Noun,2,0,2,0.0,2.2213830330763933e-05,1.0
22990,퍼스트클래스/Noun,2,0,2,0.0,2.2213830330763933e-05,1.0
22991,모킹제이/Noun,2,2,0,2.2230620456616944e-05,0.0,1.0
22992,추행/Noun,2,0,2,0.0,2.2213830330763933e-05,1.0
22993,흐흠/Noun,2,0,2,0.0,2.2213830330763933e-05,1.0
22994,김정민/Noun,2,0,2,0.0,2.2213830330763933e-05,1.0
22995,지하철역/Noun,2,2,0,2.2230620456616944e-05,0.0,1.0
22996,정태호/Noun,2,0,2,0.0,2.2213830330763933e-05,1.0
22997,쓰리섬/Noun,2,0,2,0.0,2.2213830330763933e-05,1.0
22998,혼전/Noun,2,0,2,0.0,2.2213830330763933e-05,1.0
22999,욕지거리/Noun,2,0,2,0.0,2.2213830330763933e-05,1.0
23000,슌지/Noun,2,2,0,2.2230620456616944e-05,0.0,1.0
23001,커프/Noun,2,2,0,2.2230620456616944e-05,0.0,1.0
23002,주환/Noun,2,2,0,2.2230620456616944e-05,0.0,1.0
23003,Live/Alpha,2,0,2,0.0,2.2213830330763933e-05,1.0
23004,피프때/Noun,2,2,0,2.2230620456616944e-05,0.0,1.0
23005,형평/Noun,2,0,2,0.0,2.2213830330763933e-05,1.0
23006,파킨슨병/Noun,2,2,0,2.2230620456616944e-05,0.0,1.0
23007,팔콘/Noun,2,2,0,2.2230620456616944e-05,0.0,1.0
23008,상습/Noun,2,0,2,0.0,2.2213830330763933e-05,1.0
23009,옆집아저씨/Noun,2,2,0,2.2230620456616944e-05,0.0,1.0
23010,코털/Noun,2,0,2,0.0,2.2213830330763933e-05,1.0
23011,치과/Noun,2,0,2,0.0,2.2213830330763933e-05,1.0
23012,잘됫으/Noun,2,2,0,2.2230620456616944e-05,0.0,1.0
23013,너덜너덜하다/Adjective,2,0,2,0.0,2.2213830330763933e-05,1.0
23014,이혜/Noun,2,0,2,0.0,2.2213830330763933e-05,1.0
23015,김준수/Noun,2,2,0,2.2230620456616944e-05,0.0,1.0
23016,서화/Noun,2,2,0,2.2230620456616944e-05,0.0,1.0
23017,주영/Noun,2,0,2,0.0,2.2213830330763933e-05,1.0
23018,이강훈/Noun,2,2,0,2.2230620456616944e-05,0.0,1.0
23019,미타/Noun,2,2,0,2.2230620456616944e-05,0.0,1.0
23020,자빠짓/Noun,2,0,2,0.0,2.2213830330763933e-05,1.0
23021,났슴/Noun,2,0,2,0.0,2.2213830330763933e-05,1.0
23022,릐/Noun,2,2,0,2.2230620456616944e-05,0.0,1.0
23023,청계천/Noun,2,0,2,0.0,2.2213830330763933e-05,1.0
23024,압제/Noun,2,2,0,2.2230620456616944e-05,0.0,1.0
23025,재작/Noun,2,0,2,0.0,2.2213830330763933e-05,1.0
23026,친아빠/Noun,2,0,2,0.0,2.2213830330763933e-05,1.0
23027,재일조선인/Noun,2,2,0,2.2230620456616944e-05,0.0,1.0
23028,임지령/Noun,2,0,2,0.0,2.2213830330763933e-05,1.0
23029,계모/Noun,2,2,0,2.2230620456616944e-05,0.0,1.0
23030,사법/Noun,2,0,2,0.0,2.2213830330763933e-05,1.0
23031,얼룩말/Noun,2,2,0,2.2230620456616944e-05,0.0,1.0
23032,엄빠/Noun,2,2,0,2.2230620456616944e-05,0.0,1.0
23033,목마름/Noun,2,2,0,2.2230620456616944e-05,0.0,1.0
23034,발각/Noun,2,0,2,0.0,2.2213830330763933e-05,1.0
23035,어문/Noun,2,0,2,0.0,2.2213830330763933e-05,1.0
23036,middle/Alpha,2,2,0,2.2230620456616944e-05,0.0,1.0
23037,가동/Noun,2,2,0,2.2230620456616944e-05,0.0,1.0
23038,89분/Number,2,0,2,0.0,2.2213830330763933e-05,1.0
23039,꼴초/Noun,2,0,2,0.0,2.2213830330763933e-05,1.0
23040,종수/Noun,2,0,2,0.0,2.2213830330763933e-05,1.0
23041,ㄹㄴ/KoreanParticle,2,0,2,0.0,2.2213830330763933e-05,1.0
23042,원미경/Noun,2,2,0,2.2230620456616944e-05,0.0,1.0
23043,An/Alpha,2,2,0,2.2230620456616944e-05,0.0,1.0
23044,이노리/Noun,2,2,0,2.2230620456616944e-05,0.0,1.0
23045,노르/Noun,2,0,2,0.0,2.2213830330763933e-05,1.0
23046,빨좀/Noun,2,0,2,0.0,2.2213830330763933e-05,1.0
23047,디디다/Verb,2,2,0,2.2230620456616944e-05,0.0,1.0
23048,세례/Noun,2,0,2,0.0,2.2213830330763933e-05,1.0
23049,160분/Number,2,2,0,2.2230620456616944e-05,0.0,1.0
23050,모질다/Adjective,2,0,2,0.0,2.2213830330763933e-05,1.0
23051,원상/Noun,2,2,0,2.2230620456616944e-05,0.0,1.0
23052,아마존의눈물/Noun,2,2,0,2.2230620456616944e-05,0.0,1.0
23053,초중생/Noun,2,0,2,0.0,2.2213830330763933e-05,1.0
23054,한영환/Noun,2,2,0,2.2230620456616944e-05,0.0,1.0
23055,절데/Noun,2,0,2,0.0,2.2213830330763933e-05,1.0
23056,=)/Punctuation,2,2,0,2.2230620456616944e-05,0.0,1.0
23057,..^^!/Punctuation,2,2,0,2.2230620456616944e-05,0.0,1.0
23058,생날/Noun,2,0,2,0.0,2.2213830330763933e-05,1.0
23059,..-_-;;;/Punctuation,2,0,2,0.0,2.2213830330763933e-05,1.0
23060,true/Alpha,2,2,0,2.2230620456616944e-05,0.0,1.0
23061,쵝오임/Noun,2,2,0,2.2230620456616944e-05,0.0,1.0
23062,선재/Noun,2,2,0,2.2230620456616944e-05,0.0,1.0
23063,的/Foreign,2,2,0,2.2230620456616944e-05,0.0,1.0
23064,대쪽/Noun,2,0,2,0.0,2.2213830330763933e-05,1.0
23065,Killing/Alpha,2,2,0,2.2230620456616944e-05,0.0,1.0
23066,노량진/Noun,2,0,2,0.0,2.2213830330763933e-05,1.0
23067,소은/Noun,2,2,0,2.2230620456616944e-05,0.0,1.0
23068,매해/Adverb,2,2,0,2.2230620456616944e-05,0.0,1.0
23069,강정훈/Noun,2,0,2,0.0,2.2213830330763933e-05,1.0
23070,일렬/Noun,2,0,2,0.0,2.2213830330763933e-05,1.0
23071,광규/Noun,2,2,0,2.2230620456616944e-05,0.0,1.0
23072,아앜/Noun,2,0,2,0.0,2.2213830330763933e-05,1.0
23073,일레븐/Noun,2,0,2,0.0,2.2213830330763933e-05,1.0
23074,대본소/Noun,2,0,2,0.0,2.2213830330763933e-05,1.0
23075,인견/Noun,2,0,2,0.0,2.2213830330763933e-05,1.0
23076,쫀쫀/Noun,2,2,0,2.2230620456616944e-05,0.0,1.0
23077,엘베/Noun,2,2,0,2.2230620456616944e-05,0.0,1.0
23078,completely/Alpha,2,2,0,2.2230620456616944e-05,0.0,1.0
23079,츰/Noun,2,2,0,2.2230620456616944e-05,0.0,1.0
23080,키다리/Noun,2,0,2,0.0,2.2213830330763933e-05,1.0
23081,물일/Noun,2,0,2,0.0,2.2213830330763933e-05,1.0
23082,희박하다/Adjective,2,0,2,0.0,2.2213830330763933e-05,1.0
23083,뽜/Noun,2,0,2,0.0,2.2213830330763933e-05,1.0
23084,9-10/Number,2,0,2,0.0,2.2213830330763933e-05,1.0
23085,라크로스/Noun,2,0,2,0.0,2.2213830330763933e-05,1.0
23086,아야카/Noun,2,0,2,0.0,2.2213830330763933e-05,1.0
23087,자이니치/Noun,2,0,2,0.0,2.2213830330763933e-05,1.0
23088,미디/Noun,2,0,2,0.0,2.2213830330763933e-05,1.0
23089,쩐당/Noun,2,2,0,2.2230620456616944e-05,0.0,1.0
23090,쩌는놈/Noun,2,0,2,0.0,2.2213830330763933e-05,1.0
23091,육군사관학교/Noun,2,2,0,2.2230620456616944e-05,0.0,1.0
23092,노추/Noun,2,0,2,0.0,2.2213830330763933e-05,1.0
23093,4-7/Number,2,0,2,0.0,2.2213830330763933e-05,1.0
23094,광훈/Noun,2,2,0,2.2230620456616944e-05,0.0,1.0
23095,종북좌파/Noun,2,2,0,2.2230620456616944e-05,0.0,1.0
23096,-!!!!/Punctuation,2,2,0,2.2230620456616944e-05,0.0,1.0
23097,펭/Noun,2,2,0,2.2230620456616944e-05,0.0,1.0
23098,신기생뎐/Noun,2,0,2,0.0,2.2213830330763933e-05,1.0
23099,행정부/Noun,2,2,0,2.2230620456616944e-05,0.0,1.0
23100,카제/Noun,2,2,0,2.2230620456616944e-05,0.0,1.0
23101,파토/Noun,2,0,2,0.0,2.2213830330763933e-05,1.0
23102,이지스/Noun,2,0,2,0.0,2.2213830330763933e-05,1.0
23103,태엽/Noun,2,2,0,2.2230620456616944e-05,0.0,1.0
23104,걸알/Noun,2,2,0,2.2230620456616944e-05,0.0,1.0
23105,팽귄/Noun,2,2,0,2.2230620456616944e-05,0.0,1.0
23106,꼼짝/Noun,2,0,2,0.0,2.2213830330763933e-05,1.0
23107,을제/Noun,2,2,0,2.2230620456616944e-05,0.0,1.0
23108,찌릿하/Noun,2,2,0,2.2230620456616944e-05,0.0,1.0
23109,해선/Noun,2,0,2,0.0,2.2213830330763933e-05,1.0
23110,띄어쓰기/Noun,2,0,2,0.0,2.2213830330763933e-05,1.0
23111,................................/Punctuation,2,2,0,2.2230620456616944e-05,0.0,1.0
23112,....??/Punctuation,2,0,2,0.0,2.2213830330763933e-05,1.0
23113,아쥬/Noun,2,2,0,2.2230620456616944e-05,0.0,1.0
23114,지현/Noun,2,2,0,2.2230620456616944e-05,0.0,1.0
23115,메타크리틱/Noun,2,0,2,0.0,2.2213830330763933e-05,1.0
23116,즉각/Noun,2,0,2,0.0,2.2213830330763933e-05,1.0
23117,썰리다/Verb,2,0,2,0.0,2.2213830330763933e-05,1.0
23118,응가/Exclamation,2,0,2,0.0,2.2213830330763933e-05,1.0
23119,488/Number,2,0,2,0.0,2.2213830330763933e-05,1.0
23120,저릿하다/Adjective,2,2,0,2.2230620456616944e-05,0.0,1.0
23121,떨이/Noun,2,2,0,2.2230620456616944e-05,0.0,1.0
23122,^^!!!/Punctuation,2,2,0,2.2230620456616944e-05,0.0,1.0
23123,신터클라스/Noun,2,0,2,0.0,2.2213830330763933e-05,1.0
23124,아야나미/Noun,2,2,0,2.2230620456616944e-05,0.0,1.0
23125,이기욱/Noun,2,0,2,0.0,2.2213830330763933e-05,1.0
23126,오한/Noun,2,0,2,0.0,2.2213830330763933e-05,1.0
23127,레기들/Noun,2,2,0,2.2230620456616944e-05,0.0,1.0
23128,다이애나비/Noun,2,0,2,0.0,2.2213830330763933e-05,1.0
23129,별루였/Noun,2,0,2,0.0,2.2213830330763933e-05,1.0
23130,회임/Noun,2,0,2,0.0,2.2213830330763933e-05,1.0
23131,닥추/Noun,2,2,0,2.2230620456616944e-05,0.0,1.0
23132,주커버그/Noun,2,2,0,2.2230620456616944e-05,0.0,1.0
23133,달/Foreign,2,0,2,0.0,2.2213830330763933e-05,1.0
23134,부품/Noun,2,0,2,0.0,2.2213830330763933e-05,1.0
23135,볼랫더/Noun,2,0,2,0.0,2.2213830330763933e-05,1.0
23136,Honestly/Alpha,2,0,2,0.0,2.2213830330763933e-05,1.0
23137,쯤전에/Foreign,2,0,2,0.0,2.2213830330763933e-05,1.0
23138,조용필/Noun,2,2,0,2.2230620456616944e-05,0.0,1.0
23139,스탤/Noun,2,2,0,2.2230620456616944e-05,0.0,1.0
23140,120%/Number,2,0,2,0.0,2.2213830330763933e-05,1.0
23141,맻/Modifier,2,2,0,2.2230620456616944e-05,0.0,1.0
23142,김희라/Noun,2,2,0,2.2230620456616944e-05,0.0,1.0
23143,케이티홈즈/Noun,2,0,2,0.0,2.2213830330763933e-05,1.0
23144,여단/Noun,2,0,2,0.0,2.2213830330763933e-05,1.0
23145,봣는/Noun,2,2,0,2.2230620456616944e-05,0.0,1.0
23146,허송/Noun,2,0,2,0.0,2.2213830330763933e-05,1.0
23147,수강/Noun,2,2,0,2.2230620456616944e-05,0.0,1.0
23148,고부/Noun,2,0,2,0.0,2.2213830330763933e-05,1.0
23149,오누이/Noun,2,2,0,2.2230620456616944e-05,0.0,1.0
23150,단적비연수/Noun,2,0,2,0.0,2.2213830330763933e-05,1.0
23151,favorite/Alpha,2,2,0,2.2230620456616944e-05,0.0,1.0
23152,이현진/Noun,2,2,0,2.2230620456616944e-05,0.0,1.0
23153,SX/Alpha,2,0,2,0.0,2.2213830330763933e-05,1.0
23154,off/Alpha,2,0,2,0.0,2.2213830330763933e-05,1.0
23155,오타구/Noun,2,0,2,0.0,2.2213830330763933e-05,1.0
23156,벙쪘음/Noun,2,0,2,0.0,2.2213830330763933e-05,1.0
23157,슈퍼전대/Noun,2,0,2,0.0,2.2213830330763933e-05,1.0
23158,괴초/Noun,2,2,0,2.2230620456616944e-05,0.0,1.0
23159,소권/Noun,2,2,0,2.2230620456616944e-05,0.0,1.0
23160,내해/Noun,2,0,2,0.0,2.2213830330763933e-05,1.0
23161,진욱/Noun,2,0,2,0.0,2.2213830330763933e-05,1.0
23162,성가/Noun,2,2,0,2.2230620456616944e-05,0.0,1.0
23163,독일어/Noun,2,2,0,2.2230620456616944e-05,0.0,1.0
23164,킌/Noun,2,2,0,2.2230620456616944e-05,0.0,1.0
23165,점거/Noun,2,0,2,0.0,2.2213830330763933e-05,1.0
23166,김응룡/Noun,2,0,2,0.0,2.2213830330763933e-05,1.0
23167,부순/Noun,2,2,0,2.2230620456616944e-05,0.0,1.0
23168,키워지다/Verb,2,2,0,2.2230620456616944e-05,0.0,1.0
23169,불교도/Noun,2,0,2,0.0,2.2213830330763933e-05,1.0
23170,정속/Noun,2,2,0,2.2230620456616944e-05,0.0,1.0
23171,었으/Noun,2,0,2,0.0,2.2213830330763933e-05,1.0
23172,도진후/Noun,2,2,0,2.2230620456616944e-05,0.0,1.0
23173,이광/Noun,2,2,0,2.2230620456616944e-05,0.0,1.0
23174,모택동/Noun,2,0,2,0.0,2.2213830330763933e-05,1.0
23175,바줄/Noun,2,2,0,2.2230620456616944e-05,0.0,1.0
23176,번데기/Noun,2,0,2,0.0,2.2213830330763933e-05,1.0
23177,쓰리썸/Noun,2,0,2,0.0,2.2213830330763933e-05,1.0
23178,청년시절/Noun,2,0,2,0.0,2.2213830330763933e-05,1.0
23179,또뭐임/Noun,2,0,2,0.0,2.2213830330763933e-05,1.0
23180,도당시/Foreign,2,2,0,2.2230620456616944e-05,0.0,1.0
23181,벽화/Noun,2,2,0,2.2230620456616944e-05,0.0,1.0
23182,급수/Noun,2,0,2,0.0,2.2213830330763933e-05,1.0
23183,스퇄/Noun,2,2,0,2.2230620456616944e-05,0.0,1.0
23184,로봣/Noun,2,0,2,0.0,2.2213830330763933e-05,1.0
23185,850/Number,2,0,2,0.0,2.2213830330763933e-05,1.0
23186,그렉/Noun,2,2,0,2.2230620456616944e-05,0.0,1.0
23187,쓸모없이/Adverb,2,2,0,2.2230620456616944e-05,0.0,1.0
23188,콜럼버스/Noun,2,0,2,0.0,2.2213830330763933e-05,1.0
23189,ㅋㅇ/KoreanParticle,2,0,2,0.0,2.2213830330763933e-05,1.0
23190,BAD/Alpha,2,0,2,0.0,2.2213830330763933e-05,1.0
23191,제작발표회/Noun,2,0,2,0.0,2.2213830330763933e-05,1.0
23192,이태리타올/Noun,2,0,2,0.0,2.2213830330763933e-05,1.0
23193,김효원/Noun,2,0,2,0.0,2.2213830330763933e-05,1.0
23194,귓속말/Noun,2,0,2,0.0,2.2213830330763933e-05,1.0
23195,내려놓음/Noun,2,2,0,2.2230620456616944e-05,0.0,1.0
23196,요렇게/Adverb,2,0,2,0.0,2.2213830330763933e-05,1.0
23197,듀사/Noun,2,2,0,2.2230620456616944e-05,0.0,1.0
23198,진명호/Noun,2,2,0,2.2230620456616944e-05,0.0,1.0
23199,찌게/Noun,2,0,2,0.0,2.2213830330763933e-05,1.0
23200,족도/Foreign,2,0,2,0.0,2.2213830330763933e-05,1.0
23201,순백/Noun,2,2,0,2.2230620456616944e-05,0.0,1.0
23202,아라/Noun,2,2,0,2.2230620456616944e-05,0.0,1.0
23203,톰베린저/Noun,2,0,2,0.0,2.2213830330763933e-05,1.0
23204,Carpe/Alpha,2,2,0,2.2230620456616944e-05,0.0,1.0
23205,맞닿다/Verb,2,2,0,2.2230620456616944e-05,0.0,1.0
23206,Touching/Alpha,2,2,0,2.2230620456616944e-05,0.0,1.0
23207,삘나/Noun,2,2,0,2.2230620456616944e-05,0.0,1.0
23208,어딧어/Noun,2,0,2,0.0,2.2213830330763933e-05,1.0
23209,윙즈/Noun,2,0,2,0.0,2.2213830330763933e-05,1.0
23210,스텔/Noun,2,2,0,2.2230620456616944e-05,0.0,1.0
23211,포르노그래피/Noun,2,0,2,0.0,2.2213830330763933e-05,1.0
23212,조희봉/Noun,2,0,2,0.0,2.2213830330763933e-05,1.0
23213,포머/Noun,2,2,0,2.2230620456616944e-05,0.0,1.0
23214,yg/Alpha,2,0,2,0.0,2.2213830330763933e-05,1.0
23215,말수/Noun,2,2,0,2.2230620456616944e-05,0.0,1.0
23216,디스터비아/Noun,2,0,2,0.0,2.2213830330763933e-05,1.0
23217,이글스/Noun,2,0,2,0.0,2.2213830330763933e-05,1.0
23218,후레시맨/Noun,2,0,2,0.0,2.2213830330763933e-05,1.0
23219,써머/Noun,2,0,2,0.0,2.2213830330763933e-05,1.0
23220,장문/Noun,2,0,2,0.0,2.2213830330763933e-05,1.0
23221,??;;;/Punctuation,2,0,2,0.0,2.2213830330763933e-05,1.0
23222,불끈불끈/Noun,2,2,0,2.2230620456616944e-05,0.0,1.0
23223,",.,.,.,./Punctuation",2,0,2,0.0,2.2213830330763933e-05,1.0
23224,강우진/Noun,2,2,0,2.2230620456616944e-05,0.0,1.0
23225,콜렉션/Noun,2,0,2,0.0,2.2213830330763933e-05,1.0
23226,메모리카드/Noun,2,0,2,0.0,2.2213830330763933e-05,1.0
23227,응시/Noun,2,2,0,2.2230620456616944e-05,0.0,1.0
23228,유전공학/Noun,2,2,0,2.2230620456616944e-05,0.0,1.0
23229,메드/Noun,2,2,0,2.2230620456616944e-05,0.0,1.0
23230,이마이/Noun,2,0,2,0.0,2.2213830330763933e-05,1.0
23231,교섭/Noun,2,2,0,2.2230620456616944e-05,0.0,1.0
23232,간호/Noun,2,0,2,0.0,2.2213830330763933e-05,1.0
23233,브베/Noun,2,2,0,2.2230620456616944e-05,0.0,1.0
23234,굿윌헌팅/Noun,2,2,0,2.2230620456616944e-05,0.0,1.0
23235,6%/Number,2,0,2,0.0,2.2213830330763933e-05,1.0
23236,goooooooooooood/Alpha,2,2,0,2.2230620456616944e-05,0.0,1.0
23237,능사/Noun,2,0,2,0.0,2.2213830330763933e-05,1.0
23238,징텅/Noun,2,2,0,2.2230620456616944e-05,0.0,1.0
23239,별별/Noun,2,2,0,2.2230620456616944e-05,0.0,1.0
23240,",,!/Punctuation",2,2,0,2.2230620456616944e-05,0.0,1.0
23241,각의/Noun,2,0,2,0.0,2.2213830330763933e-05,1.0
23242,동맹국/Noun,2,0,2,0.0,2.2213830330763933e-05,1.0
23243,주점/Noun,2,0,2,0.0,2.2213830330763933e-05,1.0
23244,매치다/Verb,2,0,2,0.0,2.2213830330763933e-05,1.0
23245,빵칼/Noun,2,0,2,0.0,2.2213830330763933e-05,1.0
23246,발칸/Noun,2,2,0,2.2230620456616944e-05,0.0,1.0
23247,2.22만/Number,2,0,2,0.0,2.2213830330763933e-05,1.0
23248,적수/Noun,2,0,2,0.0,2.2213830330763933e-05,1.0
23249,러블리함/Noun,2,2,0,2.2230620456616944e-05,0.0,1.0
23250,유화/Noun,2,2,0,2.2230620456616944e-05,0.0,1.0
23251,!!!!!!!!!!!!!!!!!!!!!!!!/Punctuation,2,2,0,2.2230620456616944e-05,0.0,1.0
23252,골리앗/Noun,2,0,2,0.0,2.2213830330763933e-05,1.0
23253,이진우/Noun,2,2,0,2.2230620456616944e-05,0.0,1.0
23254,더킹/Noun,2,2,0,2.2230620456616944e-05,0.0,1.0
23255,각박하다/Adjective,2,2,0,2.2230620456616944e-05,0.0,1.0
23256,무질/Noun,2,0,2,0.0,2.2213830330763933e-05,1.0
23257,디럽/Noun,2,0,2,0.0,2.2213830330763933e-05,1.0
23258,♥♥♥♥♥♥♥♥/Foreign,2,2,0,2.2230620456616944e-05,0.0,1.0
23259,Well/Alpha,2,2,0,2.2230620456616944e-05,0.0,1.0
23260,방탄복/Noun,2,0,2,0.0,2.2213830330763933e-05,1.0
23261,매커니즘/Noun,2,2,0,2.2230620456616944e-05,0.0,1.0
23262,정소추/Noun,2,2,0,2.2230620456616944e-05,0.0,1.0
23263,나완/Noun,2,0,2,0.0,2.2213830330763933e-05,1.0
23264,흐흑/Noun,2,2,0,2.2230620456616944e-05,0.0,1.0
23265,하시모토/Noun,2,2,0,2.2230620456616944e-05,0.0,1.0
23266,챈들러/Noun,2,2,0,2.2230620456616944e-05,0.0,1.0
23267,善/Foreign,2,2,0,2.2230620456616944e-05,0.0,1.0
23268,쓰레빠/Noun,2,0,2,0.0,2.2213830330763933e-05,1.0
23269,작별인사/Noun,2,2,0,2.2230620456616944e-05,0.0,1.0
23270,파울로/Noun,2,2,0,2.2230620456616944e-05,0.0,1.0
23271,용녀/Noun,2,0,2,0.0,2.2213830330763933e-05,1.0
23272,조영호/Noun,2,0,2,0.0,2.2213830330763933e-05,1.0
23273,ㅜㅋ/KoreanParticle,2,2,0,2.2230620456616944e-05,0.0,1.0
23274,삼풍백화점/Noun,2,2,0,2.2230620456616944e-05,0.0,1.0
23275,..+_+/Punctuation,2,2,0,2.2230620456616944e-05,0.0,1.0
23276,봉건/Noun,2,0,2,0.0,2.2213830330763933e-05,1.0
23277,똘추/Noun,2,0,2,0.0,2.2213830330763933e-05,1.0
23278,ㅈㅏ/KoreanParticle,2,0,2,0.0,2.2213830330763933e-05,1.0
23279,배변/Noun,2,0,2,0.0,2.2213830330763933e-05,1.0
23280,시절인연/Noun,2,2,0,2.2230620456616944e-05,0.0,1.0
23281,불가항력/Noun,2,2,0,2.2230620456616944e-05,0.0,1.0
23282,샤오홍/Noun,2,2,0,2.2230620456616944e-05,0.0,1.0
23283,?????????????/Punctuation,2,0,2,0.0,2.2213830330763933e-05,1.0
23284,심란/Noun,2,0,2,0.0,2.2213830330763933e-05,1.0
23285,안지혜/Noun,2,0,2,0.0,2.2213830330763933e-05,1.0
23286,니콜라이/Noun,2,2,0,2.2230620456616944e-05,0.0,1.0
23287,보리밭/Noun,2,2,0,2.2230620456616944e-05,0.0,1.0
23288,전소현/Noun,2,2,0,2.2230620456616944e-05,0.0,1.0
23289,개그씬/Noun,2,0,2,0.0,2.2213830330763933e-05,1.0
23290,재우/Noun,2,2,0,2.2230620456616944e-05,0.0,1.0
23291,접임/Noun,2,0,2,0.0,2.2213830330763933e-05,1.0
23292,UP/Alpha,2,2,0,2.2230620456616944e-05,0.0,1.0
23293,요시다/Noun,2,2,0,2.2230620456616944e-05,0.0,1.0
23294,artist/Alpha,2,2,0,2.2230620456616944e-05,0.0,1.0
23295,아타/Noun,2,2,0,2.2230620456616944e-05,0.0,1.0
23296,，/Foreign,2,2,0,2.2230620456616944e-05,0.0,1.0
23297,징크스/Noun,2,0,2,0.0,2.2213830330763933e-05,1.0
23298,~>_/Punctuation,2,2,0,2.2230620456616944e-05,0.0,1.0
23299,손좀/Noun,2,0,2,0.0,2.2213830330763933e-05,1.0
23300,마오/Noun,2,2,0,2.2230620456616944e-05,0.0,1.0
23301,만장/Noun,2,0,2,0.0,2.2213830330763933e-05,1.0
23302,쪼그라들다/Verb,2,0,2,0.0,2.2213830330763933e-05,1.0
23303,≥∀≤/Foreign,2,2,0,2.2230620456616944e-05,0.0,1.0
23304,혜영/Noun,2,2,0,2.2230620456616944e-05,0.0,1.0
23305,양돈/Noun,2,2,0,2.2230620456616944e-05,0.0,1.0
23306,카미카제/Noun,2,0,2,0.0,2.2213830330763933e-05,1.0
23307,city/Alpha,2,2,0,2.2230620456616944e-05,0.0,1.0
23308,ㅠㅇ/KoreanParticle,2,2,0,2.2230620456616944e-05,0.0,1.0
23309,몬소리/Noun,2,0,2,0.0,2.2213830330763933e-05,1.0
23310,엄앵란/Noun,2,2,0,2.2230620456616944e-05,0.0,1.0
23311,대추나무/Noun,2,0,2,0.0,2.2213830330763933e-05,1.0
23312,naive/Alpha,2,0,2,0.0,2.2213830330763933e-05,1.0
23313,부단하다/Adjective,2,0,2,0.0,2.2213830330763933e-05,1.0
23314,ROCK/Alpha,2,2,0,2.2230620456616944e-05,0.0,1.0
23315,사임/Noun,2,2,0,2.2230620456616944e-05,0.0,1.0
23316,적룡/Noun,2,2,0,2.2230620456616944e-05,0.0,1.0
23317,머무/Noun,2,2,0,2.2230620456616944e-05,0.0,1.0
23318,인디스페이스/Noun,2,2,0,2.2230620456616944e-05,0.0,1.0
23319,Sbs/Alpha,2,0,2,0.0,2.2213830330763933e-05,1.0
23320,전국노래자랑/Noun,2,2,0,2.2230620456616944e-05,0.0,1.0
23321,수행자/Noun,2,0,2,0.0,2.2213830330763933e-05,1.0
23322,병상/Noun,2,2,0,2.2230620456616944e-05,0.0,1.0
23323,청사/Noun,2,0,2,0.0,2.2213830330763933e-05,1.0
23324,남우현/Noun,2,2,0,2.2230620456616944e-05,0.0,1.0
23325,우중충/Adverb,2,0,2,0.0,2.2213830330763933e-05,1.0
23326,아애/Noun,2,0,2,0.0,2.2213830330763933e-05,1.0
23327,베르디/Noun,2,2,0,2.2230620456616944e-05,0.0,1.0
23328,슈퍼마리오/Noun,2,0,2,0.0,2.2213830330763933e-05,1.0
23329,2022년/Number,2,2,0,2.2230620456616944e-05,0.0,1.0
23330,신세대/Noun,2,2,0,2.2230620456616944e-05,0.0,1.0
23331,이지난지금도/Foreign,2,2,0,2.2230620456616944e-05,0.0,1.0
23332,천민/Noun,2,2,0,2.2230620456616944e-05,0.0,1.0
23333,하나비/Noun,2,2,0,2.2230620456616944e-05,0.0,1.0
23334,밥줘/Noun,2,0,2,0.0,2.2213830330763933e-05,1.0
23335,대환영/Noun,2,2,0,2.2230620456616944e-05,0.0,1.0
23336,앱/Noun,2,0,2,0.0,2.2213830330763933e-05,1.0
23337,까짓/Modifier,2,0,2,0.0,2.2213830330763933e-05,1.0
23338,데츠카/Noun,2,0,2,0.0,2.2213830330763933e-05,1.0
23339,헤디/Noun,2,2,0,2.2230620456616944e-05,0.0,1.0
23340,ㅠㅅ/KoreanParticle,2,2,0,2.2230620456616944e-05,0.0,1.0
23341,못봣다/Noun,2,2,0,2.2230620456616944e-05,0.0,1.0
23342,중간광고/Noun,2,0,2,0.0,2.2213830330763933e-05,1.0
23343,하청/Noun,2,0,2,0.0,2.2213830330763933e-05,1.0
23344,다예/Noun,2,2,0,2.2230620456616944e-05,0.0,1.0
23345,랜다/Noun,2,0,2,0.0,2.2213830330763933e-05,1.0
23346,ㅋㅋㅋㅅㅂ/KoreanParticle,2,0,2,0.0,2.2213830330763933e-05,1.0
23347,콜트/Noun,2,2,0,2.2230620456616944e-05,0.0,1.0
23348,스티브맥퀸/Noun,2,2,0,2.2230620456616944e-05,0.0,1.0
23349,같이만/Josa,2,0,2,0.0,2.2213830330763933e-05,1.0
23350,운집/Noun,2,2,0,2.2230620456616944e-05,0.0,1.0
23351,얼기설기/Noun,2,0,2,0.0,2.2213830330763933e-05,1.0
23352,신주쿠/Noun,2,2,0,2.2230620456616944e-05,0.0,1.0
23353,피토/Noun,2,0,2,0.0,2.2213830330763933e-05,1.0
23354,갖다붙힌거/Noun,2,0,2,0.0,2.2213830330763933e-05,1.0
23355,낯짝/Noun,2,0,2,0.0,2.2213830330763933e-05,1.0
23356,김유석/Noun,2,2,0,2.2230620456616944e-05,0.0,1.0
23357,멋졋다/Noun,2,2,0,2.2230620456616944e-05,0.0,1.0
23358,실평/Noun,2,0,2,0.0,2.2213830330763933e-05,1.0
23359,하겐/Noun,2,2,0,2.2230620456616944e-05,0.0,1.0
23360,조중동/Noun,2,2,0,2.2230620456616944e-05,0.0,1.0
23361,샬림/Noun,2,2,0,2.2230620456616944e-05,0.0,1.0
23362,티켓파워/Noun,2,0,2,0.0,2.2213830330763933e-05,1.0
23363,",,-/Punctuation",2,0,2,0.0,2.2213830330763933e-05,1.0
23364,몸값/Noun,2,2,0,2.2230620456616944e-05,0.0,1.0
23365,세자매/Noun,2,0,2,0.0,2.2213830330763933e-05,1.0
23366,해마/Noun,2,0,2,0.0,2.2213830330763933e-05,1.0
23367,레인지/Noun,2,0,2,0.0,2.2213830330763933e-05,1.0
23368,시완/Noun,2,2,0,2.2230620456616944e-05,0.0,1.0
23369,봉씨/Noun,2,0,2,0.0,2.2213830330763933e-05,1.0
23370,마켓/Noun,2,2,0,2.2230620456616944e-05,0.0,1.0
23371,커리/Noun,2,0,2,0.0,2.2213830330763933e-05,1.0
23372,절교/Noun,2,0,2,0.0,2.2213830330763933e-05,1.0
23373,콰이어트/Noun,2,0,2,0.0,2.2213830330763933e-05,1.0
23374,DOG/Alpha,2,2,0,2.2230620456616944e-05,0.0,1.0
23375,???.../Punctuation,2,0,2,0.0,2.2213830330763933e-05,1.0
23376,유치장/Noun,2,2,0,2.2230620456616944e-05,0.0,1.0
23377,전야/Noun,2,0,2,0.0,2.2213830330763933e-05,1.0
23378,범죄수사/Noun,2,2,0,2.2230620456616944e-05,0.0,1.0
23379,는/Noun,2,2,0,2.2230620456616944e-05,0.0,1.0
23380,47분/Number,2,0,2,0.0,2.2213830330763933e-05,1.0
23381,-_-^^/Punctuation,2,0,2,0.0,2.2213830330763933e-05,1.0
23382,은심/Noun,2,2,0,2.2230620456616944e-05,0.0,1.0
23383,핵핵/Noun,2,0,2,0.0,2.2213830330763933e-05,1.0
23384,자욱하다/Adjective,2,2,0,2.2230620456616944e-05,0.0,1.0
23385,40만/Number,2,0,2,0.0,2.2213830330763933e-05,1.0
23386,너는내운명/Noun,2,2,0,2.2230620456616944e-05,0.0,1.0
23387,딩시/Noun,2,2,0,2.2230620456616944e-05,0.0,1.0
23388,장조/Noun,2,2,0,2.2230620456616944e-05,0.0,1.0
23389,발련/Noun,2,0,2,0.0,2.2213830330763933e-05,1.0
23390,혼재/Noun,2,0,2,0.0,2.2213830330763933e-05,1.0
23391,넝/Noun,2,2,0,2.2230620456616944e-05,0.0,1.0
23392,유유백서/Noun,2,0,2,0.0,2.2213830330763933e-05,1.0
23393,)/Foreign,2,0,2,0.0,2.2213830330763933e-05,1.0
23394,충북/Noun,2,0,2,0.0,2.2213830330763933e-05,1.0
23395,기범/Noun,2,2,0,2.2230620456616944e-05,0.0,1.0
23396,배팅/Noun,2,0,2,0.0,2.2213830330763933e-05,1.0
23397,떱/Noun,2,2,0,2.2230620456616944e-05,0.0,1.0
23398,유리아/Noun,2,2,0,2.2230620456616944e-05,0.0,1.0
23399,...???;;;/Punctuation,2,0,2,0.0,2.2213830330763933e-05,1.0
23400,shy/Alpha,2,2,0,2.2230620456616944e-05,0.0,1.0
23401,왓더/Noun,2,0,2,0.0,2.2213830330763933e-05,1.0
23402,doing/Alpha,2,2,0,2.2230620456616944e-05,0.0,1.0
23403,신혼/Noun,2,0,2,0.0,2.2213830330763933e-05,1.0
23404,무저갱/Noun,2,0,2,0.0,2.2213830330763933e-05,1.0
23405,pain/Alpha,2,2,0,2.2230620456616944e-05,0.0,1.0
23406,번잡/Noun,2,0,2,0.0,2.2213830330763933e-05,1.0
23407,uk/Alpha,2,0,2,0.0,2.2213830330763933e-05,1.0
23408,황찬성/Noun,2,2,0,2.2230620456616944e-05,0.0,1.0
23409,산낙지/Noun,2,0,2,0.0,2.2213830330763933e-05,1.0
23410,엘릭/Noun,2,0,2,0.0,2.2213830330763933e-05,1.0
23411,1974년/Number,2,2,0,2.2230620456616944e-05,0.0,1.0
23412,이기대/Noun,2,2,0,2.2230620456616944e-05,0.0,1.0
23413,흠결/Noun,2,0,2,0.0,2.2213830330763933e-05,1.0
23414,말꼬리/Noun,2,0,2,0.0,2.2213830330763933e-05,1.0
23415,낚었다/Noun,2,0,2,0.0,2.2213830330763933e-05,1.0
23416,범의/Noun,2,2,0,2.2230620456616944e-05,0.0,1.0
23417,안속/Noun,2,0,2,0.0,2.2213830330763933e-05,1.0
23418,냉대/Noun,2,2,0,2.2230620456616944e-05,0.0,1.0
23419,정신장애/Noun,2,0,2,0.0,2.2213830330763933e-05,1.0
23420,일위/Noun,2,2,0,2.2230620456616944e-05,0.0,1.0
23421,심승보/Noun,2,0,2,0.0,2.2213830330763933e-05,1.0
23422,응원가/Noun,2,2,0,2.2230620456616944e-05,0.0,1.0
23423,멋졋음/Noun,2,2,0,2.2230620456616944e-05,0.0,1.0
23424,샤프트/Noun,2,2,0,2.2230620456616944e-05,0.0,1.0
23425,후루/Noun,2,2,0,2.2230620456616944e-05,0.0,1.0
23426,강당/Noun,2,2,0,2.2230620456616944e-05,0.0,1.0
23427,폭력배/Noun,2,2,0,2.2230620456616944e-05,0.0,1.0
23428,내놔/Foreign,2,0,2,0.0,2.2213830330763933e-05,1.0
23429,ㅅㅇ/KoreanParticle,2,2,0,2.2230620456616944e-05,0.0,1.0
23430,DAY/Alpha,2,2,0,2.2230620456616944e-05,0.0,1.0
23431,땡깡/Noun,2,0,2,0.0,2.2213830330763933e-05,1.0
23432,~~~(/Punctuation,2,0,2,0.0,2.2213830330763933e-05,1.0
23433,든/Foreign,2,0,2,0.0,2.2213830330763933e-05,1.0
23434,기어오르다/Verb,2,2,0,2.2230620456616944e-05,0.0,1.0
23435,라비/Noun,2,0,2,0.0,2.2213830330763933e-05,1.0
23436,눈싸움/Noun,2,0,2,0.0,2.2213830330763933e-05,1.0
23437,ROLL/Alpha,2,2,0,2.2230620456616944e-05,0.0,1.0
23438,were/Alpha,2,2,0,2.2230620456616944e-05,0.0,1.0
23439,컬투/Noun,2,2,0,2.2230620456616944e-05,0.0,1.0
23440,하키/Noun,2,2,0,2.2230620456616944e-05,0.0,1.0
23441,큐슈/Noun,2,2,0,2.2230620456616944e-05,0.0,1.0
23442,위그/Noun,2,2,0,2.2230620456616944e-05,0.0,1.0
23443,볼살/Noun,2,2,0,2.2230620456616944e-05,0.0,1.0
23444,진땜/Noun,2,0,2,0.0,2.2213830330763933e-05,1.0
23445,현아/Noun,2,0,2,0.0,2.2213830330763933e-05,1.0
23446,아녜스/Noun,2,2,0,2.2230620456616944e-05,0.0,1.0
23447,절대다수/Noun,2,2,0,2.2230620456616944e-05,0.0,1.0
23448,아라곤/Noun,2,2,0,2.2230620456616944e-05,0.0,1.0
23449,맵/Noun,2,2,0,2.2230620456616944e-05,0.0,1.0
23450,안락하다/Adjective,2,2,0,2.2230620456616944e-05,0.0,1.0
23451,화실/Noun,2,2,0,2.2230620456616944e-05,0.0,1.0
23452,쉬망/Noun,2,0,2,0.0,2.2213830330763933e-05,1.0
23453,DRUG/Alpha,2,0,2,0.0,2.2213830330763933e-05,1.0
23454,..:)/Punctuation,2,2,0,2.2230620456616944e-05,0.0,1.0
23455,호두까기인형/Noun,2,0,2,0.0,2.2213830330763933e-05,1.0
23456,서브프라임/Noun,2,2,0,2.2230620456616944e-05,0.0,1.0
23457,해이/Noun,2,0,2,0.0,2.2213830330763933e-05,1.0
23458,멜빌/Noun,2,2,0,2.2230620456616944e-05,0.0,1.0
23459,법체계/Noun,2,2,0,2.2230620456616944e-05,0.0,1.0
23460,키퍼/Noun,2,2,0,2.2230620456616944e-05,0.0,1.0
23461,시스터즈/Noun,2,2,0,2.2230620456616944e-05,0.0,1.0
23462,이였다/Foreign,2,0,2,0.0,2.2213830330763933e-05,1.0
23463,열도/Noun,2,0,2,0.0,2.2213830330763933e-05,1.0
23464,수제/Noun,2,2,0,2.2230620456616944e-05,0.0,1.0
23465,테루유키/Noun,2,2,0,2.2230620456616944e-05,0.0,1.0
23466,꼬아놔/Noun,2,0,2,0.0,2.2213830330763933e-05,1.0
23467,Piece/Alpha,2,2,0,2.2230620456616944e-05,0.0,1.0
23468,Master/Alpha,2,2,0,2.2230620456616944e-05,0.0,1.0
23469,평땜/Noun,2,0,2,0.0,2.2213830330763933e-05,1.0
23470,이지메/Noun,2,0,2,0.0,2.2213830330763933e-05,1.0
23471,컥/Noun,2,0,2,0.0,2.2213830330763933e-05,1.0
23472,분당/Noun,2,2,0,2.2230620456616944e-05,0.0,1.0
23473,=_=;/Punctuation,2,0,2,0.0,2.2213830330763933e-05,1.0
23474,흘렷/Noun,2,2,0,2.2230620456616944e-05,0.0,1.0
23475,스테판/Noun,2,2,0,2.2230620456616944e-05,0.0,1.0
23476,졸뻔/Noun,2,0,2,0.0,2.2213830330763933e-05,1.0
23477,덮어놓고/Noun,2,0,2,0.0,2.2213830330763933e-05,1.0
23478,태곤/Noun,2,2,0,2.2230620456616944e-05,0.0,1.0
23479,세균/Noun,2,0,2,0.0,2.2213830330763933e-05,1.0
23480,황제펭귄/Noun,2,2,0,2.2230620456616944e-05,0.0,1.0
23481,엔티티/Noun,2,0,2,0.0,2.2213830330763933e-05,1.0
23482,큰아들/Noun,2,2,0,2.2230620456616944e-05,0.0,1.0
23483,달포/Noun,2,2,0,2.2230620456616944e-05,0.0,1.0
23484,excellent/Alpha,2,2,0,2.2230620456616944e-05,0.0,1.0
23485,현세/Noun,2,2,0,2.2230620456616944e-05,0.0,1.0
23486,365일/Number,2,2,0,2.2230620456616944e-05,0.0,1.0
23487,보지맙시/Noun,2,0,2,0.0,2.2213830330763933e-05,1.0
23488,40초/Number,2,0,2,0.0,2.2213830330763933e-05,1.0
23489,군주/Noun,2,2,0,2.2230620456616944e-05,0.0,1.0
23490,주다혜/Noun,2,0,2,0.0,2.2213830330763933e-05,1.0
23491,???????????????????????????/Punctuation,2,0,2,0.0,2.2213830330763933e-05,1.0
23492,정제/Noun,2,2,0,2.2230620456616944e-05,0.0,1.0
23493,악동뮤지션/Noun,2,2,0,2.2230620456616944e-05,0.0,1.0
23494,의회/Noun,2,2,0,2.2230620456616944e-05,0.0,1.0
23495,추어/Noun,2,0,2,0.0,2.2213830330763933e-05,1.0
23496,갈채/Noun,2,2,0,2.2230620456616944e-05,0.0,1.0
23497,Elvis/Alpha,2,2,0,2.2230620456616944e-05,0.0,1.0
23498,전능하다/Adjective,2,0,2,0.0,2.2213830330763933e-05,1.0
23499,장사꾼/Noun,2,0,2,0.0,2.2213830330763933e-05,1.0
23500,OZ/Alpha,2,2,0,2.2230620456616944e-05,0.0,1.0
23501,빅잼/Noun,2,2,0,2.2230620456616944e-05,0.0,1.0
23502,남루하다/Adjective,2,2,0,2.2230620456616944e-05,0.0,1.0
23503,카탈로그/Noun,2,0,2,0.0,2.2213830330763933e-05,1.0
23504,반론/Noun,2,0,2,0.0,2.2213830330763933e-05,1.0
23505,운오/Noun,2,2,0,2.2230620456616944e-05,0.0,1.0
23506,확나/Noun,2,0,2,0.0,2.2213830330763933e-05,1.0
23507,빠루/Noun,2,0,2,0.0,2.2213830330763933e-05,1.0
23508,경축/Noun,2,0,2,0.0,2.2213830330763933e-05,1.0
23509,노트르담/Noun,2,2,0,2.2230620456616944e-05,0.0,1.0
23510,질임/Noun,2,0,2,0.0,2.2213830330763933e-05,1.0
23511,맷집/Noun,2,0,2,0.0,2.2213830330763933e-05,1.0
23512,통괘/Noun,2,2,0,2.2230620456616944e-05,0.0,1.0
23513,ㅇㅂㅇ/KoreanParticle,2,2,0,2.2230620456616944e-05,0.0,1.0
23514,Real/Alpha,2,2,0,2.2230620456616944e-05,0.0,1.0
23515,장롱/Noun,2,0,2,0.0,2.2213830330763933e-05,1.0
23516,인철/Noun,2,2,0,2.2230620456616944e-05,0.0,1.0
23517,누들스/Noun,2,2,0,2.2230620456616944e-05,0.0,1.0
23518,훈련병/Noun,2,0,2,0.0,2.2213830330763933e-05,1.0
23519,캐쉬백/Noun,2,0,2,0.0,2.2213830330763933e-05,1.0
23520,만드심/Noun,2,0,2,0.0,2.2213830330763933e-05,1.0
23521,편햇/Noun,2,2,0,2.2230620456616944e-05,0.0,1.0
23522,셧겟/Noun,2,0,2,0.0,2.2213830330763933e-05,1.0
23523,택했/Noun,2,0,2,0.0,2.2213830330763933e-05,1.0
23524,뿌나/Noun,2,2,0,2.2230620456616944e-05,0.0,1.0
23525,ㅏㅇㅇ/KoreanParticle,2,2,0,2.2230620456616944e-05,0.0,1.0
23526,제제/Noun,2,2,0,2.2230620456616944e-05,0.0,1.0
23527,안성/Noun,2,0,2,0.0,2.2213830330763933e-05,1.0
23528,노태우/Noun,2,0,2,0.0,2.2213830330763933e-05,1.0
23529,도실/Noun,2,2,0,2.2230620456616944e-05,0.0,1.0
23530,)'/Punctuation,2,0,2,0.0,2.2213830330763933e-05,1.0
23531,발뒤꿈치/Noun,2,0,2,0.0,2.2213830330763933e-05,1.0
23532,획일/Noun,2,2,0,2.2230620456616944e-05,0.0,1.0
23533,베이글/Noun,2,0,2,0.0,2.2213830330763933e-05,1.0
23534,껌뻑/Adverb,2,0,2,0.0,2.2213830330763933e-05,1.0
23535,언듯/Adverb,2,2,0,2.2230620456616944e-05,0.0,1.0
23536,자은/Noun,2,2,0,2.2230620456616944e-05,0.0,1.0
23537,외과의사/Noun,2,0,2,0.0,2.2213830330763933e-05,1.0
23538,1.5시간/Number,2,2,0,2.2230620456616944e-05,0.0,1.0
23539,몰수/Noun,2,0,2,0.0,2.2213830330763933e-05,1.0
23540,쿠마/Noun,2,2,0,2.2230620456616944e-05,0.0,1.0
23541,머쓱하다/Adjective,2,2,0,2.2230620456616944e-05,0.0,1.0
23542,가야금/Noun,2,2,0,2.2230620456616944e-05,0.0,1.0
23543,대금/Noun,2,2,0,2.2230620456616944e-05,0.0,1.0
23544,노닥/Noun,2,0,2,0.0,2.2213830330763933e-05,1.0
23545,우대/Noun,2,0,2,0.0,2.2213830330763933e-05,1.0
23546,책받침/Noun,2,2,0,2.2230620456616944e-05,0.0,1.0
23547,염장/Noun,2,0,2,0.0,2.2213830330763933e-05,1.0
23548,첫씬/Noun,2,0,2,0.0,2.2213830330763933e-05,1.0
23549,무상식/Noun,2,0,2,0.0,2.2213830330763933e-05,1.0
23550,앞니/Noun,2,0,2,0.0,2.2213830330763933e-05,1.0
23551,구암/Noun,2,2,0,2.2230620456616944e-05,0.0,1.0
23552,ㄱㅡ/KoreanParticle,2,0,2,0.0,2.2213830330763933e-05,1.0
23553,통수치다/Verb,2,0,2,0.0,2.2213830330763933e-05,1.0
23554,황정리/Noun,2,2,0,2.2230620456616944e-05,0.0,1.0
23555,선풍기/Noun,2,0,2,0.0,2.2213830330763933e-05,1.0
23556,정다운/Noun,2,2,0,2.2230620456616944e-05,0.0,1.0
23557,젼혀/Noun,2,0,2,0.0,2.2213830330763933e-05,1.0
23558,이소라/Noun,2,0,2,0.0,2.2213830330763933e-05,1.0
23559,18일/Number,2,0,2,0.0,2.2213830330763933e-05,1.0
23560,배열/Noun,2,0,2,0.0,2.2213830330763933e-05,1.0
23561,?--/Punctuation,2,0,2,0.0,2.2213830330763933e-05,1.0
23562,치켜지다/Verb,2,2,0,2.2230620456616944e-05,0.0,1.0
23563,곘/Noun,2,0,2,0.0,2.2213830330763933e-05,1.0
23564,상종/Noun,2,0,2,0.0,2.2213830330763933e-05,1.0
23565,추카/Noun,2,0,2,0.0,2.2213830330763933e-05,1.0
23566,휴전/Noun,2,2,0,2.2230620456616944e-05,0.0,1.0
23567,얼샤/Noun,2,2,0,2.2230620456616944e-05,0.0,1.0
23568,블링블링/Noun,2,2,0,2.2230620456616944e-05,0.0,1.0
23569,엮기/Noun,2,2,0,2.2230620456616944e-05,0.0,1.0
23570,초단/Noun,2,0,2,0.0,2.2213830330763933e-05,1.0
23571,몬티/Noun,2,0,2,0.0,2.2213830330763933e-05,1.0
23572,바수다/Verb,2,0,2,0.0,2.2213830330763933e-05,1.0
23573,버팔로/Noun,2,2,0,2.2230620456616944e-05,0.0,1.0
23574,...--/Punctuation,2,0,2,0.0,2.2213830330763933e-05,1.0
23575,슬퍼욤/Noun,2,2,0,2.2230620456616944e-05,0.0,1.0
23576,문짝/Noun,2,0,2,0.0,2.2213830330763933e-05,1.0
23577,루터킹/Noun,2,2,0,2.2230620456616944e-05,0.0,1.0
23578,full/Alpha,2,0,2,0.0,2.2213830330763933e-05,1.0
23579,스테마루/Noun,2,2,0,2.2230620456616944e-05,0.0,1.0
23580,고고학자/Noun,2,2,0,2.2230620456616944e-05,0.0,1.0
23581,ㅁㄴㅇ/KoreanParticle,2,0,2,0.0,2.2213830330763933e-05,1.0
23582,코어/Noun,2,0,2,0.0,2.2213830330763933e-05,1.0
23583,햇습/Noun,2,2,0,2.2230620456616944e-05,0.0,1.0
23584,에브라/Noun,2,2,0,2.2230620456616944e-05,0.0,1.0
23585,니시다/Noun,2,2,0,2.2230620456616944e-05,0.0,1.0
23586,황효명/Noun,2,0,2,0.0,2.2213830330763933e-05,1.0
23587,천우희/Noun,2,2,0,2.2230620456616944e-05,0.0,1.0
23588,쿨가이/Noun,2,2,0,2.2230620456616944e-05,0.0,1.0
23589,요귀/Noun,2,2,0,2.2230620456616944e-05,0.0,1.0
23590,최세영/Noun,2,0,2,0.0,2.2213830330763933e-05,1.0
23591,야유/Noun,2,0,2,0.0,2.2213830330763933e-05,1.0
23592,소실/Noun,2,2,0,2.2230620456616944e-05,0.0,1.0
23593,췌장암/Noun,2,2,0,2.2230620456616944e-05,0.0,1.0
23594,섀도우/Noun,2,0,2,0.0,2.2213830330763933e-05,1.0
23595,요게/Noun,2,2,0,2.2230620456616944e-05,0.0,1.0
23596,바이오/Noun,2,0,2,0.0,2.2213830330763933e-05,1.0
23597,호한/Noun,2,0,2,0.0,2.2213830330763933e-05,1.0
23598,동물실험/Noun,2,2,0,2.2230620456616944e-05,0.0,1.0
23599,After/Alpha,2,0,2,0.0,2.2213830330763933e-05,1.0
23600,청개구리/Noun,2,2,0,2.2230620456616944e-05,0.0,1.0
23601,total/Alpha,2,0,2,0.0,2.2213830330763933e-05,1.0
23602,리조트/Noun,2,0,2,0.0,2.2213830330763933e-05,1.0
23603,믈/Noun,2,0,2,0.0,2.2213830330763933e-05,1.0
23604,해무/Noun,2,0,2,0.0,2.2213830330763933e-05,1.0
23605,면조/Noun,2,2,0,2.2230620456616944e-05,0.0,1.0
23606,주거침입/Noun,2,0,2,0.0,2.2213830330763933e-05,1.0
23607,은초딩/Noun,2,0,2,0.0,2.2213830330763933e-05,1.0
23608,작별/Noun,2,2,0,2.2230620456616944e-05,0.0,1.0
23609,마헤/Noun,2,2,0,2.2230620456616944e-05,0.0,1.0
23610,대라면/Foreign,2,0,2,0.0,2.2213830330763933e-05,1.0
23611,공공재/Noun,2,2,0,2.2230620456616944e-05,0.0,1.0
23612,유송/Noun,2,0,2,0.0,2.2213830330763933e-05,1.0
23613,쇼음악중심/Noun,2,0,2,0.0,2.2213830330763933e-05,1.0
23614,안절부절/Adverb,2,0,2,0.0,2.2213830330763933e-05,1.0
23615,~~!!!!!!/Punctuation,2,2,0,2.2230620456616944e-05,0.0,1.0
23616,스테덤/Noun,2,0,2,0.0,2.2213830330763933e-05,1.0
23617,ㅕㄴ/KoreanParticle,2,2,0,2.2230620456616944e-05,0.0,1.0
23618,창조주/Noun,2,2,0,2.2230620456616944e-05,0.0,1.0
23619,헌제/Noun,2,0,2,0.0,2.2213830330763933e-05,1.0
23620,기이/Noun,2,0,2,0.0,2.2213830330763933e-05,1.0
23621,멘티/Noun,2,0,2,0.0,2.2213830330763933e-05,1.0
23622,호에/Exclamation,2,2,0,2.2230620456616944e-05,0.0,1.0
23623,유주얼서스펙트/Noun,2,2,0,2.2230620456616944e-05,0.0,1.0
23624,좀볼/Noun,2,0,2,0.0,2.2213830330763933e-05,1.0
23625,KKK/Alpha,2,2,0,2.2230620456616944e-05,0.0,1.0
23626,……/Punctuation,2,0,2,0.0,2.2213830330763933e-05,1.0
23627,윤윤제/Noun,2,2,0,2.2230620456616944e-05,0.0,1.0
23628,여론조작/Noun,2,2,0,2.2230620456616944e-05,0.0,1.0
23629,대도시/Noun,2,2,0,2.2230620456616944e-05,0.0,1.0
23630,류란/Noun,2,0,2,0.0,2.2213830330763933e-05,1.0
23631,엇을텐/Noun,2,0,2,0.0,2.2213830330763933e-05,1.0
23632,삼보/Noun,2,2,0,2.2230620456616944e-05,0.0,1.0
23633,거겟/Noun,2,2,0,2.2230620456616944e-05,0.0,1.0
23634,치더/Noun,2,0,2,0.0,2.2213830330763933e-05,1.0
23635,하이재킹/Noun,2,2,0,2.2230620456616944e-05,0.0,1.0
23636,세이버/Noun,2,2,0,2.2230620456616944e-05,0.0,1.0
23637,ㅋㄱㄱ/KoreanParticle,2,0,2,0.0,2.2213830330763933e-05,1.0
23638,종지부/Noun,2,2,0,2.2230620456616944e-05,0.0,1.0
23639,;-)/Punctuation,2,2,0,2.2230620456616944e-05,0.0,1.0
23640,마커스/Noun,2,2,0,2.2230620456616944e-05,0.0,1.0
23641,어쩜좋/Noun,2,0,2,0.0,2.2213830330763933e-05,1.0
23642,고세원/Noun,2,2,0,2.2230620456616944e-05,0.0,1.0
23643,연준석/Noun,2,2,0,2.2230620456616944e-05,0.0,1.0
23644,패싸움/Noun,2,0,2,0.0,2.2213830330763933e-05,1.0
23645,명필름/Noun,2,0,2,0.0,2.2213830330763933e-05,1.0
23646,능숙하다/Adjective,2,2,0,2.2230620456616944e-05,0.0,1.0
23647,잼엄따/Noun,2,0,2,0.0,2.2213830330763933e-05,1.0
23648,stars/Alpha,2,2,0,2.2230620456616944e-05,0.0,1.0
23649,빠저/Noun,2,2,0,2.2230620456616944e-05,0.0,1.0
23650,리보/Noun,2,0,2,0.0,2.2213830330763933e-05,1.0
23651,이발/Noun,2,0,2,0.0,2.2213830330763933e-05,1.0
23652,영심/Noun,2,2,0,2.2230620456616944e-05,0.0,1.0
23653,철퇴/Noun,2,2,0,2.2230620456616944e-05,0.0,1.0
23654,스트리트댄스/Noun,2,2,0,2.2230620456616944e-05,0.0,1.0
23655,시행착오/Noun,2,2,0,2.2230620456616944e-05,0.0,1.0
23656,견제/Noun,2,0,2,0.0,2.2213830330763933e-05,1.0
23657,비무장/Noun,2,0,2,0.0,2.2213830330763933e-05,1.0
23658,보셈/Noun,2,2,0,2.2230620456616944e-05,0.0,1.0
23659,기까지는/Eomi,2,0,2,0.0,2.2213830330763933e-05,1.0
23660,의사결정/Noun,2,0,2,0.0,2.2213830330763933e-05,1.0
23661,굴릴/Noun,2,0,2,0.0,2.2213830330763933e-05,1.0
23662,~!?/Punctuation,2,0,2,0.0,2.2213830330763933e-05,1.0
23663,신영진/Noun,2,2,0,2.2230620456616944e-05,0.0,1.0
23664,승룡/Noun,2,2,0,2.2230620456616944e-05,0.0,1.0
23665,MY/Alpha,2,2,0,2.2230620456616944e-05,0.0,1.0
23666,에서야/Foreign,2,2,0,2.2230620456616944e-05,0.0,1.0
23667,심청/Noun,2,2,0,2.2230620456616944e-05,0.0,1.0
23668,루크에반스/Noun,2,2,0,2.2230620456616944e-05,0.0,1.0
23669,일본국/Noun,2,0,2,0.0,2.2213830330763933e-05,1.0
23670,헌납/Noun,2,0,2,0.0,2.2213830330763933e-05,1.0
23671,이은미/Noun,2,0,2,0.0,2.2213830330763933e-05,1.0
23672,"-,-;;;;/Punctuation",2,0,2,0.0,2.2213830330763933e-05,1.0
23673,국보법/Noun,2,0,2,0.0,2.2213830330763933e-05,1.0
23674,ak/Alpha,2,0,2,0.0,2.2213830330763933e-05,1.0
23675,자닌/Noun,2,0,2,0.0,2.2213830330763933e-05,1.0
23676,포텐터지/Noun,2,2,0,2.2230620456616944e-05,0.0,1.0
23677,평글/Noun,2,2,0,2.2230620456616944e-05,0.0,1.0
23678,틈타다/Verb,2,0,2,0.0,2.2213830330763933e-05,1.0
23679,sucks/Alpha,2,0,2,0.0,2.2213830330763933e-05,1.0
23680,김남희/Noun,2,2,0,2.2230620456616944e-05,0.0,1.0
23681,페어플레이/Noun,2,2,0,2.2230620456616944e-05,0.0,1.0
23682,하울링/Noun,2,0,2,0.0,2.2213830330763933e-05,1.0
23683,풀발/Noun,2,0,2,0.0,2.2213830330763933e-05,1.0
23684,아무르/Noun,2,2,0,2.2230620456616944e-05,0.0,1.0
23685,자이언츠/Noun,2,2,0,2.2230620456616944e-05,0.0,1.0
23686,레드카펫/Noun,2,0,2,0.0,2.2213830330763933e-05,1.0
23687,비행접시/Noun,2,2,0,2.2230620456616944e-05,0.0,1.0
23688,류근지/Noun,2,0,2,0.0,2.2213830330763933e-05,1.0
23689,인간중독/Noun,2,2,0,2.2230620456616944e-05,0.0,1.0
23690,아졸/Noun,2,0,2,0.0,2.2213830330763933e-05,1.0
23691,ㅑㅅ/KoreanParticle,2,0,2,0.0,2.2213830330763933e-05,1.0
23692,비호/Noun,2,0,2,0.0,2.2213830330763933e-05,1.0
23693,이레이저/Noun,2,2,0,2.2230620456616944e-05,0.0,1.0
23694,wants/Alpha,2,2,0,2.2230620456616944e-05,0.0,1.0
23695,청혼/Noun,2,2,0,2.2230620456616944e-05,0.0,1.0
23696,머리색/Noun,2,0,2,0.0,2.2213830330763933e-05,1.0
23697,극진하다/Adjective,2,2,0,2.2230620456616944e-05,0.0,1.0
23698,생매장/Noun,2,2,0,2.2230620456616944e-05,0.0,1.0
23699,꿀꿀이/Noun,2,0,2,0.0,2.2213830330763933e-05,1.0
23700,이태준/Noun,2,2,0,2.2230620456616944e-05,0.0,1.0
23701,부산스럽다/Adjective,2,0,2,0.0,2.2213830330763933e-05,1.0
23702,구경꾼/Noun,2,0,2,0.0,2.2213830330763933e-05,1.0
23703,모카/Noun,2,2,0,2.2230620456616944e-05,0.0,1.0
23704,두시/Noun,2,2,0,2.2230620456616944e-05,0.0,1.0
23705,wonder/Alpha,2,2,0,2.2230620456616944e-05,0.0,1.0
23706,얼티/Noun,2,2,0,2.2230620456616944e-05,0.0,1.0
23707,피겨/Noun,2,2,0,2.2230620456616944e-05,0.0,1.0
23708,따땃/Noun,2,2,0,2.2230620456616944e-05,0.0,1.0
23709,윤해영/Noun,2,2,0,2.2230620456616944e-05,0.0,1.0
23710,졋으/Noun,2,2,0,2.2230620456616944e-05,0.0,1.0
23711,미역국/Noun,2,0,2,0.0,2.2213830330763933e-05,1.0
23712,정글피쉬/Noun,2,2,0,2.2230620456616944e-05,0.0,1.0
23713,끌로델/Noun,2,2,0,2.2230620456616944e-05,0.0,1.0
23714,뭉쿨/Noun,2,2,0,2.2230620456616944e-05,0.0,1.0
23715,중장비/Noun,2,0,2,0.0,2.2213830330763933e-05,1.0
23716,막사/Noun,2,0,2,0.0,2.2213830330763933e-05,1.0
23717,마유/Noun,2,2,0,2.2230620456616944e-05,0.0,1.0
23718,후쿠다/Noun,2,2,0,2.2230620456616944e-05,0.0,1.0
23719,격변/Noun,2,2,0,2.2230620456616944e-05,0.0,1.0
23720,서적/Noun,2,0,2,0.0,2.2213830330763933e-05,1.0
23721,백구/Noun,2,2,0,2.2230620456616944e-05,0.0,1.0
23722,루쏘/Noun,2,0,2,0.0,2.2213830330763933e-05,1.0
23723,영등위/Noun,2,0,2,0.0,2.2213830330763933e-05,1.0
23724,면허증/Noun,2,0,2,0.0,2.2213830330763933e-05,1.0
23725,14분/Number,2,0,2,0.0,2.2213830330763933e-05,1.0
23726,한서진/Noun,2,2,0,2.2230620456616944e-05,0.0,1.0
23727,송삼동/Noun,2,0,2,0.0,2.2213830330763933e-05,1.0
23728,친가/Noun,2,0,2,0.0,2.2213830330763933e-05,1.0
23729,유체이탈/Noun,2,0,2,0.0,2.2213830330763933e-05,1.0
23730,에렌/Noun,2,0,2,0.0,2.2213830330763933e-05,1.0
23731,정형돈/Noun,2,0,2,0.0,2.2213830330763933e-05,1.0
23732,웅주/Noun,2,0,2,0.0,2.2213830330763933e-05,1.0
23733,가박/Adverb,2,2,0,2.2230620456616944e-05,0.0,1.0
23734,자영/Noun,2,2,0,2.2230620456616944e-05,0.0,1.0
23735,다홍/Noun,2,0,2,0.0,2.2213830330763933e-05,1.0
23736,비티/Noun,2,2,0,2.2230620456616944e-05,0.0,1.0
23737,호킹/Noun,2,2,0,2.2230620456616944e-05,0.0,1.0
23738,Wall/Alpha,2,0,2,0.0,2.2213830330763933e-05,1.0
23739,프로파일러/Noun,2,0,2,0.0,2.2213830330763933e-05,1.0
23740,700원/Number,2,0,2,0.0,2.2213830330763933e-05,1.0
23741,윈저/Noun,2,0,2,0.0,2.2213830330763933e-05,1.0
23742,절댜/Noun,2,0,2,0.0,2.2213830330763933e-05,1.0
23743,파닥파닥/Adverb,2,0,2,0.0,2.2213830330763933e-05,1.0
23744,나오고/Foreign,2,0,2,0.0,2.2213830330763933e-05,1.0
23745,긍지/Noun,2,2,0,2.2230620456616944e-05,0.0,1.0
23746,리반/Noun,2,2,0,2.2230620456616944e-05,0.0,1.0
23747,방인/Noun,2,0,2,0.0,2.2213830330763933e-05,1.0
23748,여운계/Noun,2,2,0,2.2230620456616944e-05,0.0,1.0
23749,클레이애니메이션/Noun,2,2,0,2.2230620456616944e-05,0.0,1.0
23750,적선/Noun,2,0,2,0.0,2.2213830330763933e-05,1.0
23751,356/Number,2,0,2,0.0,2.2213830330763933e-05,1.0
23752,몸뚱아리/Noun,2,0,2,0.0,2.2213830330763933e-05,1.0
23753,배알/Noun,2,0,2,0.0,2.2213830330763933e-05,1.0
23754,소생/Noun,2,0,2,0.0,2.2213830330763933e-05,1.0
23755,발도/Noun,2,0,2,0.0,2.2213830330763933e-05,1.0
23756,군기/Noun,2,0,2,0.0,2.2213830330763933e-05,1.0
23757,와를/Josa,2,2,0,2.2230620456616944e-05,0.0,1.0
23758,몬영화/Noun,2,0,2,0.0,2.2213830330763933e-05,1.0
23759,독립운동가/Noun,2,2,0,2.2230620456616944e-05,0.0,1.0
23760,셧던/Noun,2,2,0,2.2230620456616944e-05,0.0,1.0
23761,져서/Eomi,2,0,2,0.0,2.2213830330763933e-05,1.0
23762,내자/Noun,2,0,2,0.0,2.2213830330763933e-05,1.0
23763,1972/Number,2,0,2,0.0,2.2213830330763933e-05,1.0
23764,불이익/Noun,2,0,2,0.0,2.2213830330763933e-05,1.0
23765,600/Number,2,0,2,0.0,2.2213830330763933e-05,1.0
23766,나쵸/Noun,2,0,2,0.0,2.2213830330763933e-05,1.0
23767,인체/Noun,2,0,2,0.0,2.2213830330763933e-05,1.0
23768,Ever/Alpha,2,0,2,0.0,2.2213830330763933e-05,1.0
23769,르완다/Noun,2,2,0,2.2230620456616944e-05,0.0,1.0
23770,la/Alpha,2,2,0,2.2230620456616944e-05,0.0,1.0
23771,순둥순둥/Noun,2,2,0,2.2230620456616944e-05,0.0,1.0
23772,라벤더/Noun,2,2,0,2.2230620456616944e-05,0.0,1.0
23773,광탈/Noun,2,0,2,0.0,2.2213830330763933e-05,1.0
23774,아오키/Noun,2,0,2,0.0,2.2213830330763933e-05,1.0
23775,지느러미/Noun,2,0,2,0.0,2.2213830330763933e-05,1.0
23776,서무/Noun,2,2,0,2.2230620456616944e-05,0.0,1.0
23777,././Punctuation,2,2,0,2.2230620456616944e-05,0.0,1.0
23778,인감/Noun,2,0,2,0.0,2.2213830330763933e-05,1.0
23779,꺤/Noun,2,2,0,2.2230620456616944e-05,0.0,1.0
23780,5천만달러/Number,2,0,2,0.0,2.2213830330763933e-05,1.0
23781,코언/Noun,2,0,2,0.0,2.2213830330763933e-05,1.0
23782,노무현정부/Noun,2,0,2,0.0,2.2213830330763933e-05,1.0
23783,현주/Noun,2,2,0,2.2230620456616944e-05,0.0,1.0
23784,김호준/Noun,2,0,2,0.0,2.2213830330763933e-05,1.0
23785,자정/Noun,2,2,0,2.2230620456616944e-05,0.0,1.0
23786,펠리니/Noun,2,2,0,2.2230620456616944e-05,0.0,1.0
23787,재밌긔/Noun,2,2,0,2.2230620456616944e-05,0.0,1.0
23788,황진호/Noun,2,0,2,0.0,2.2213830330763933e-05,1.0
23789,keep/Alpha,2,2,0,2.2230620456616944e-05,0.0,1.0
23790,포탈/Noun,2,2,0,2.2230620456616944e-05,0.0,1.0
23791,불새/Noun,2,2,0,2.2230620456616944e-05,0.0,1.0
23792,출연/Foreign,2,0,2,0.0,2.2213830330763933e-05,1.0
23793,틴틴/Noun,2,2,0,2.2230620456616944e-05,0.0,1.0
23794,어강/Noun,2,0,2,0.0,2.2213830330763933e-05,1.0
23795,카무이/Noun,2,0,2,0.0,2.2213830330763933e-05,1.0
23796,로체스터/Noun,2,2,0,2.2230620456616944e-05,0.0,1.0
23797,갸륵/Noun,2,0,2,0.0,2.2213830330763933e-05,1.0
23798,준면/Noun,2,2,0,2.2230620456616944e-05,0.0,1.0
23799,향수병/Noun,2,2,0,2.2230620456616944e-05,0.0,1.0
23800,혼령/Noun,2,0,2,0.0,2.2213830330763933e-05,1.0
23801,있을런/Noun,2,0,2,0.0,2.2213830330763933e-05,1.0
23802,더라/Eomi,2,0,2,0.0,2.2213830330763933e-05,1.0
23803,국토/Noun,2,2,0,2.2230620456616944e-05,0.0,1.0
23804,투게더/Noun,2,2,0,2.2230620456616944e-05,0.0,1.0
23805,프로펠러/Noun,2,2,0,2.2230620456616944e-05,0.0,1.0
23806,인사동/Noun,2,0,2,0.0,2.2213830330763933e-05,1.0
23807,Neo/Alpha,2,2,0,2.2230620456616944e-05,0.0,1.0
23808,전인데도/Foreign,2,2,0,2.2230620456616944e-05,0.0,1.0
23809,82/Number,2,2,0,2.2230620456616944e-05,0.0,1.0
23810,오자룡이간다/Noun,2,0,2,0.0,2.2213830330763933e-05,1.0
23811,마스다/Noun,2,2,0,2.2230620456616944e-05,0.0,1.0
23812,판치기/Noun,2,0,2,0.0,2.2213830330763933e-05,1.0
23813,팍스/Noun,2,0,2,0.0,2.2213830330763933e-05,1.0
23814,케블/Noun,2,0,2,0.0,2.2213830330763933e-05,1.0
23815,가로등/Noun,2,2,0,2.2230620456616944e-05,0.0,1.0
23816,방때/Noun,2,0,2,0.0,2.2213830330763933e-05,1.0
23817,멌있어/Noun,2,2,0,2.2230620456616944e-05,0.0,1.0
23818,맹기용/Noun,2,0,2,0.0,2.2213830330763933e-05,1.0
23819,.....;;;/Punctuation,2,0,2,0.0,2.2213830330763933e-05,1.0
23820,World/Alpha,2,2,0,2.2230620456616944e-05,0.0,1.0
23821,박효신/Noun,2,2,0,2.2230620456616944e-05,0.0,1.0
23822,순교자/Noun,2,2,0,2.2230620456616944e-05,0.0,1.0
23823,고슴도치/Noun,2,2,0,2.2230620456616944e-05,0.0,1.0
23824,란건/Noun,2,2,0,2.2230620456616944e-05,0.0,1.0
23825,눼/Noun,2,0,2,0.0,2.2213830330763933e-05,1.0
23826,그랬구나/Exclamation,2,0,2,0.0,2.2213830330763933e-05,1.0
23827,인디/Noun,2,0,2,0.0,2.2213830330763933e-05,1.0
23828,백만장자/Noun,2,2,0,2.2230620456616944e-05,0.0,1.0
23829,경미/Noun,2,2,0,2.2230620456616944e-05,0.0,1.0
23830,셀린/Noun,2,2,0,2.2230620456616944e-05,0.0,1.0
23831,장단점/Noun,2,0,2,0.0,2.2213830330763933e-05,1.0
23832,목청/Noun,2,0,2,0.0,2.2213830330763933e-05,1.0
23833,또봄/Noun,2,2,0,2.2230620456616944e-05,0.0,1.0
23834,코헨/Noun,2,0,2,0.0,2.2213830330763933e-05,1.0
23835,비지니스/Noun,2,2,0,2.2230620456616944e-05,0.0,1.0
23836,저럭/Noun,2,0,2,0.0,2.2213830330763933e-05,1.0
23837,그럭/Noun,2,0,2,0.0,2.2213830330763933e-05,1.0
23838,월요커플/Noun,2,2,0,2.2230620456616944e-05,0.0,1.0
23839,아핡핡/Noun,2,2,0,2.2230620456616944e-05,0.0,1.0
23840,술수/Noun,2,0,2,0.0,2.2213830330763933e-05,1.0
23841,쿵쾅/Noun,2,2,0,2.2230620456616944e-05,0.0,1.0
23842,흑마술/Noun,2,0,2,0.0,2.2213830330763933e-05,1.0
23843,가소/Noun,2,0,2,0.0,2.2213830330763933e-05,1.0
23844,급변/Noun,2,2,0,2.2230620456616944e-05,0.0,1.0
23845,불을/Foreign,2,0,2,0.0,2.2213830330763933e-05,1.0
23846,질환/Noun,2,0,2,0.0,2.2213830330763933e-05,1.0
23847,정신질환/Noun,2,0,2,0.0,2.2213830330763933e-05,1.0
23848,볼륜/Noun,2,0,2,0.0,2.2213830330763933e-05,1.0
23849,은부/Noun,2,0,2,0.0,2.2213830330763933e-05,1.0
23850,어쌔신/Noun,2,2,0,2.2230620456616944e-05,0.0,1.0
23851,남주/Noun,2,0,2,0.0,2.2213830330763933e-05,1.0
23852,sex/Alpha,2,0,2,0.0,2.2213830330763933e-05,1.0
23853,대문짝만하다/Adjective,2,0,2,0.0,2.2213830330763933e-05,1.0
23854,깁스/Noun,2,0,2,0.0,2.2213830330763933e-05,1.0
23855,돈벌레/Noun,2,0,2,0.0,2.2213830330763933e-05,1.0
23856,Everyone/Alpha,2,2,0,2.2230620456616944e-05,0.0,1.0
23857,윤복/Noun,2,2,0,2.2230620456616944e-05,0.0,1.0
23858,오아시스/Noun,2,2,0,2.2230620456616944e-05,0.0,1.0
23859,과다르/Noun,2,0,2,0.0,2.2213830330763933e-05,1.0
23860,올라타다/Verb,2,2,0,2.2230620456616944e-05,0.0,1.0
23861,참여자/Noun,2,0,2,0.0,2.2213830330763933e-05,1.0
23862,아깝다/Foreign,2,0,2,0.0,2.2213830330763933e-05,1.0
23863,바꼇/Noun,2,0,2,0.0,2.2213830330763933e-05,1.0
23864,탈진/Noun,2,0,2,0.0,2.2213830330763933e-05,1.0
23865,후쿠베/Noun,2,2,0,2.2230620456616944e-05,0.0,1.0
23866,데이터베이스/Noun,2,2,0,2.2230620456616944e-05,0.0,1.0
23867,광고지/Noun,2,0,2,0.0,2.2213830330763933e-05,1.0
23868,적격/Noun,2,0,2,0.0,2.2213830330763933e-05,1.0
23869,빠심/Noun,2,0,2,0.0,2.2213830330763933e-05,1.0
23870,화형/Noun,2,2,0,2.2230620456616944e-05,0.0,1.0
23871,DID/Alpha,2,2,0,2.2230620456616944e-05,0.0,1.0
23872,번재/Noun,2,2,0,2.2230620456616944e-05,0.0,1.0
23873,현정/Noun,2,2,0,2.2230620456616944e-05,0.0,1.0
23874,조수정/Noun,2,0,2,0.0,2.2213830330763933e-05,1.0
23875,조적/Noun,2,2,0,2.2230620456616944e-05,0.0,1.0
23876,신겐/Noun,2,2,0,2.2230620456616944e-05,0.0,1.0
23877,터전/Noun,2,2,0,2.2230620456616944e-05,0.0,1.0
23878,쇄골/Noun,2,0,2,0.0,2.2213830330763933e-05,1.0
23879,동렬/Noun,2,0,2,0.0,2.2213830330763933e-05,1.0
23880,ㄲㅋㅋㅋ/KoreanParticle,2,0,2,0.0,2.2213830330763933e-05,1.0
23881,자화자찬/Noun,2,0,2,0.0,2.2213830330763933e-05,1.0
23882,블레이즈/Noun,2,0,2,0.0,2.2213830330763933e-05,1.0
23883,색끼/Noun,2,0,2,0.0,2.2213830330763933e-05,1.0
23884,7초/Number,2,0,2,0.0,2.2213830330763933e-05,1.0
23885,1408/Number,2,0,2,0.0,2.2213830330763933e-05,1.0
23886,옐친/Noun,2,0,2,0.0,2.2213830330763933e-05,1.0
23887,전현/Noun,2,0,2,0.0,2.2213830330763933e-05,1.0
23888,좋아욤/Noun,2,2,0,2.2230620456616944e-05,0.0,1.0
23889,편차/Noun,2,2,0,2.2230620456616944e-05,0.0,1.0
23890,김종학/Noun,2,0,2,0.0,2.2213830330763933e-05,1.0
23891,아유미/Noun,2,0,2,0.0,2.2213830330763933e-05,1.0
23892,Keep/Alpha,2,2,0,2.2230620456616944e-05,0.0,1.0
23893,공수부대/Noun,2,0,2,0.0,2.2213830330763933e-05,1.0
23894,대인줄/Foreign,2,0,2,0.0,2.2213830330763933e-05,1.0
23895,ctrl/Alpha,2,0,2,0.0,2.2213830330763933e-05,1.0
23896,다슬이/Noun,2,2,0,2.2230620456616944e-05,0.0,1.0
23897,다각/Noun,2,2,0,2.2230620456616944e-05,0.0,1.0
23898,도독/Noun,2,0,2,0.0,2.2213830330763933e-05,1.0
23899,뉴트/Noun,2,2,0,2.2230620456616944e-05,0.0,1.0
23900,다날/Noun,2,0,2,0.0,2.2213830330763933e-05,1.0
23901,봄방학/Noun,2,2,0,2.2230620456616944e-05,0.0,1.0
23902,코메디언/Noun,2,2,0,2.2230620456616944e-05,0.0,1.0
23903,푸시/Noun,2,0,2,0.0,2.2213830330763933e-05,1.0
23904,1000억/Number,2,0,2,0.0,2.2213830330763933e-05,1.0
23905,막차/Noun,2,0,2,0.0,2.2213830330763933e-05,1.0
23906,09년/Number,2,2,0,2.2230620456616944e-05,0.0,1.0
23907,$/Punctuation,2,0,2,0.0,2.2213830330763933e-05,1.0
23908,핑크색/Noun,2,2,0,2.2230620456616944e-05,0.0,1.0
23909,뚤리/Noun,2,2,0,2.2230620456616944e-05,0.0,1.0
23910,영훤히/Noun,2,2,0,2.2230620456616944e-05,0.0,1.0
23911,연소자/Noun,2,0,2,0.0,2.2213830330763933e-05,1.0
23912,legend/Alpha,2,2,0,2.2230620456616944e-05,0.0,1.0
23913,마약상/Noun,2,0,2,0.0,2.2213830330763933e-05,1.0
23914,유캔/Noun,2,0,2,0.0,2.2213830330763933e-05,1.0
23915,캐치미/Noun,2,0,2,0.0,2.2213830330763933e-05,1.0
23916,크랙/Noun,2,0,2,0.0,2.2213830330763933e-05,1.0
23917,유탄/Noun,2,0,2,0.0,2.2213830330763933e-05,1.0
23918,!!?/Punctuation,2,0,2,0.0,2.2213830330763933e-05,1.0
23919,만들빠/Noun,2,0,2,0.0,2.2213830330763933e-05,1.0
23920,늙다리/Noun,2,0,2,0.0,2.2213830330763933e-05,1.0
23921,됫을까/Noun,2,2,0,2.2230620456616944e-05,0.0,1.0
23922,펠리시티/Noun,2,2,0,2.2230620456616944e-05,0.0,1.0
23923,세찬/Noun,2,2,0,2.2230620456616944e-05,0.0,1.0
23924,naver/Alpha,2,0,2,0.0,2.2213830330763933e-05,1.0
23925,도영/Noun,2,2,0,2.2230620456616944e-05,0.0,1.0
23926,각양각색/Noun,2,2,0,2.2230620456616944e-05,0.0,1.0
23927,란거/Noun,2,2,0,2.2230620456616944e-05,0.0,1.0
23928,헐렁하다/Adjective,2,0,2,0.0,2.2213830330763933e-05,1.0
23929,만무하다/Adjective,2,0,2,0.0,2.2213830330763933e-05,1.0
23930,일명/Noun,2,0,2,0.0,2.2213830330763933e-05,1.0
23931,어울어/Noun,2,2,0,2.2230620456616944e-05,0.0,1.0
23932,위풍/Noun,2,2,0,2.2230620456616944e-05,0.0,1.0
23933,진아/Noun,2,0,2,0.0,2.2213830330763933e-05,1.0
23934,췟/Noun,2,0,2,0.0,2.2213830330763933e-05,1.0
23935,설문/Noun,2,0,2,0.0,2.2213830330763933e-05,1.0
23936,코다카/Noun,2,0,2,0.0,2.2213830330763933e-05,1.0
23937,야애니/Noun,2,0,2,0.0,2.2213830330763933e-05,1.0
23938,이동희/Noun,2,0,2,0.0,2.2213830330763933e-05,1.0
23939,러브크래프트/Noun,2,2,0,2.2230620456616944e-05,0.0,1.0
23940,빠트리/Noun,2,0,2,0.0,2.2213830330763933e-05,1.0
23941,Kia/Alpha,2,0,2,0.0,2.2213830330763933e-05,1.0
23942,뚜힌/Noun,2,2,0,2.2230620456616944e-05,0.0,1.0
23943,전운/Noun,2,0,2,0.0,2.2213830330763933e-05,1.0
23944,연회/Noun,2,0,2,0.0,2.2213830330763933e-05,1.0
23945,처나/Noun,2,0,2,0.0,2.2213830330763933e-05,1.0
23946,본진/Noun,2,2,0,2.2230620456616944e-05,0.0,1.0
23947,홍등/Noun,2,2,0,2.2230620456616944e-05,0.0,1.0
23948,일판/Noun,2,0,2,0.0,2.2213830330763933e-05,1.0
23949,가이즈/Noun,2,2,0,2.2230620456616944e-05,0.0,1.0
23950,다봣음/Noun,2,2,0,2.2230620456616944e-05,0.0,1.0
23951,홧팅이/Noun,2,2,0,2.2230620456616944e-05,0.0,1.0
23952,어페어/Noun,2,0,2,0.0,2.2213830330763933e-05,1.0
23953,공도/Noun,2,2,0,2.2230620456616944e-05,0.0,1.0
23954,흐억/Noun,2,0,2,0.0,2.2213830330763933e-05,1.0
23955,스태덤/Noun,2,2,0,2.2230620456616944e-05,0.0,1.0
23956,9/11/Number,2,0,2,0.0,2.2213830330763933e-05,1.0
23957,상관관계/Noun,2,2,0,2.2230620456616944e-05,0.0,1.0
23958,산들바람/Noun,2,2,0,2.2230620456616944e-05,0.0,1.0
23959,노어/Noun,2,2,0,2.2230620456616944e-05,0.0,1.0
23960,꼬부기/Noun,2,0,2,0.0,2.2213830330763933e-05,1.0
23961,맹씨/Noun,2,0,2,0.0,2.2213830330763933e-05,1.0
23962,imagine/Alpha,2,2,0,2.2230620456616944e-05,0.0,1.0
23963,스네이크/Noun,2,0,2,0.0,2.2213830330763933e-05,1.0
23964,한새/Noun,2,0,2,0.0,2.2213830330763933e-05,1.0
23965,hd/Alpha,2,0,2,0.0,2.2213830330763933e-05,1.0
23966,Lady/Alpha,2,0,2,0.0,2.2213830330763933e-05,1.0
23967,제보자/Noun,2,0,2,0.0,2.2213830330763933e-05,1.0
23968,갑인/Noun,2,2,0,2.2230620456616944e-05,0.0,1.0
23969,미조/Noun,2,0,2,0.0,2.2213830330763933e-05,1.0
23970,서열/Noun,2,2,0,2.2230620456616944e-05,0.0,1.0
23971,김세준/Noun,2,0,2,0.0,2.2213830330763933e-05,1.0
23972,콤비네이션/Noun,2,2,0,2.2230620456616944e-05,0.0,1.0
23973,초밥/Noun,2,0,2,0.0,2.2213830330763933e-05,1.0
23974,롭스/Noun,2,2,0,2.2230620456616944e-05,0.0,1.0
23975,말대꾸/Noun,2,0,2,0.0,2.2213830330763933e-05,1.0
23976,사랑방/Noun,2,2,0,2.2230620456616944e-05,0.0,1.0
23977,경마장/Noun,2,2,0,2.2230620456616944e-05,0.0,1.0
23978,준기/Noun,2,0,2,0.0,2.2213830330763933e-05,1.0
23979,력/Noun,2,0,2,0.0,2.2213830330763933e-05,1.0
23980,이윤성/Noun,2,2,0,2.2230620456616944e-05,0.0,1.0
23981,기범이/Noun,2,0,2,0.0,2.2213830330763933e-05,1.0
23982,분개하다/Adjective,2,0,2,0.0,2.2213830330763933e-05,1.0
23983,틀법/Noun,2,0,2,0.0,2.2213830330763933e-05,1.0
23984,추론/Noun,2,0,2,0.0,2.2213830330763933e-05,1.0
23985,.........................../Punctuation,2,0,2,0.0,2.2213830330763933e-05,1.0
23986,흑룡/Noun,2,0,2,0.0,2.2213830330763933e-05,1.0
23987,뚜렸/Noun,2,2,0,2.2230620456616944e-05,0.0,1.0
23988,*-*/Punctuation,2,2,0,2.2230620456616944e-05,0.0,1.0
23989,미코/Noun,2,2,0,2.2230620456616944e-05,0.0,1.0
23990,라보프/Noun,2,2,0,2.2230620456616944e-05,0.0,1.0
23991,샤이/Noun,2,2,0,2.2230620456616944e-05,0.0,1.0
23992,hhh/Alpha,2,0,2,0.0,2.2213830330763933e-05,1.0
23993,연구소/Noun,2,0,2,0.0,2.2213830330763933e-05,1.0
23994,김순옥/Noun,2,0,2,0.0,2.2213830330763933e-05,1.0
23995,앨리샤/Noun,2,0,2,0.0,2.2213830330763933e-05,1.0
23996,쌘건/Noun,2,0,2,0.0,2.2213830330763933e-05,1.0
23997,방탕/Noun,2,2,0,2.2230620456616944e-05,0.0,1.0
23998,강냉이/Noun,2,2,0,2.2230620456616944e-05,0.0,1.0
23999,등광영/Noun,2,2,0,2.2230620456616944e-05,0.0,1.0
24000,보험금/Noun,2,2,0,2.2230620456616944e-05,0.0,1.0
24001,대국/Noun,2,2,0,2.2230620456616944e-05,0.0,1.0
24002,것멋/Noun,2,0,2,0.0,2.2213830330763933e-05,1.0
24003,편좀/Noun,2,2,0,2.2230620456616944e-05,0.0,1.0
24004,연남생/Noun,2,2,0,2.2230620456616944e-05,0.0,1.0
24005,폭포수/Noun,2,2,0,2.2230620456616944e-05,0.0,1.0
24006,1500만/Number,2,2,0,2.2230620456616944e-05,0.0,1.0
24007,범법/Noun,2,0,2,0.0,2.2213830330763933e-05,1.0
24008,이혼소송/Noun,2,0,2,0.0,2.2213830330763933e-05,1.0
24009,로마인/Noun,2,0,2,0.0,2.2213830330763933e-05,1.0
24010,진해/Noun,2,2,0,2.2230620456616944e-05,0.0,1.0
24011,뼈채/Noun,2,2,0,2.2230620456616944e-05,0.0,1.0
24012,8.9/Number,2,2,0,2.2230620456616944e-05,0.0,1.0
24013,옹녀/Noun,2,0,2,0.0,2.2213830330763933e-05,1.0
24014,need/Alpha,2,2,0,2.2230620456616944e-05,0.0,1.0
24015,지프/Noun,2,0,2,0.0,2.2213830330763933e-05,1.0
24016,명령/Noun,2,0,2,0.0,2.2213830330763933e-05,1.0
24017,진압/Noun,2,0,2,0.0,2.2213830330763933e-05,1.0
24018,헐헐/Adverb,2,0,2,0.0,2.2213830330763933e-05,1.0
24019,형무소/Noun,2,2,0,2.2230620456616944e-05,0.0,1.0
24020,쥬쥬/Noun,2,0,2,0.0,2.2213830330763933e-05,1.0
24021,남영/Noun,2,0,2,0.0,2.2213830330763933e-05,1.0
24022,부축/Noun,2,0,2,0.0,2.2213830330763933e-05,1.0
24023,모큐멘터리/Noun,2,0,2,0.0,2.2213830330763933e-05,1.0
24024,페넬/Noun,2,2,0,2.2230620456616944e-05,0.0,1.0
24025,기호품/Noun,2,2,0,2.2230620456616944e-05,0.0,1.0
24026,허영은/Noun,2,2,0,2.2230620456616944e-05,0.0,1.0
24027,간물/Noun,2,0,2,0.0,2.2213830330763933e-05,1.0
24028,졍/Noun,2,0,2,0.0,2.2213830330763933e-05,1.0
24029,타성/Noun,2,2,0,2.2230620456616944e-05,0.0,1.0
24030,병균/Noun,2,0,2,0.0,2.2213830330763933e-05,1.0
24031,무가치하다/Adjective,2,0,2,0.0,2.2213830330763933e-05,1.0
24032,아슬하다/Adjective,2,2,0,2.2230620456616944e-05,0.0,1.0
24033,아슬/Noun,2,2,0,2.2230620456616944e-05,0.0,1.0
24034,뱀뱀죽/Noun,2,2,0,2.2230620456616944e-05,0.0,1.0
24035,후집/Noun,2,0,2,0.0,2.2213830330763933e-05,1.0
24036,오웰/Noun,2,2,0,2.2230620456616944e-05,0.0,1.0
24037,적합/Noun,2,0,2,0.0,2.2213830330763933e-05,1.0
24038,배재/Noun,2,2,0,2.2230620456616944e-05,0.0,1.0
24039,축구장/Noun,2,2,0,2.2230620456616944e-05,0.0,1.0
24040,접전/Noun,2,0,2,0.0,2.2213830330763933e-05,1.0
24041,김준성/Noun,2,2,0,2.2230620456616944e-05,0.0,1.0
24042,코유키/Noun,2,0,2,0.0,2.2213830330763933e-05,1.0
24043,한소리/Noun,2,0,2,0.0,2.2213830330763933e-05,1.0
24044,냇/Noun,2,0,2,0.0,2.2213830330763933e-05,1.0
24045,카미/Noun,2,0,2,0.0,2.2213830330763933e-05,1.0
24046,이돌/Noun,2,0,2,0.0,2.2213830330763933e-05,1.0
24047,중박/Noun,2,0,2,0.0,2.2213830330763933e-05,1.0
24048,마동/Noun,2,0,2,0.0,2.2213830330763933e-05,1.0
24049,오도일/Noun,2,2,0,2.2230620456616944e-05,0.0,1.0
24050,임사체험/Noun,2,0,2,0.0,2.2213830330763933e-05,1.0
24051,송광호/Noun,2,2,0,2.2230620456616944e-05,0.0,1.0
24052,곳곳이/Noun,2,0,2,0.0,2.2213830330763933e-05,1.0
24053,심형례/Noun,2,0,2,0.0,2.2213830330763933e-05,1.0
24054,2~30/Number,2,2,0,2.2230620456616944e-05,0.0,1.0
24055,쌘/Noun,2,2,0,2.2230620456616944e-05,0.0,1.0
24056,영물/Noun,2,0,2,0.0,2.2213830330763933e-05,1.0
24057,웬만큼/Noun,2,0,2,0.0,2.2213830330763933e-05,1.0
24058,Us/Alpha,2,2,0,2.2230620456616944e-05,0.0,1.0
24059,해제/Noun,2,0,2,0.0,2.2213830330763933e-05,1.0
24060,므이/Noun,2,0,2,0.0,2.2213830330763933e-05,1.0
24061,무좀/Noun,2,0,2,0.0,2.2213830330763933e-05,1.0
24062,천룡팔부/Noun,2,2,0,2.2230620456616944e-05,0.0,1.0
24063,페이트/Noun,2,2,0,2.2230620456616944e-05,0.0,1.0
24064,줸좡/Noun,2,2,0,2.2230620456616944e-05,0.0,1.0
24065,시미즈/Noun,2,0,2,0.0,2.2213830330763933e-05,1.0
24066,성애물/Noun,2,2,0,2.2230620456616944e-05,0.0,1.0
24067,힙/Noun,2,2,0,2.2230620456616944e-05,0.0,1.0
24068,아니메/Noun,2,2,0,2.2230620456616944e-05,0.0,1.0
24069,치렁치렁/Adverb,2,0,2,0.0,2.2213830330763933e-05,1.0
24070,읍슴/Noun,2,0,2,0.0,2.2213830330763933e-05,1.0
24071,씨티/Noun,2,2,0,2.2230620456616944e-05,0.0,1.0
24072,발로/Noun,2,0,2,0.0,2.2213830330763933e-05,1.0
24073,카핑/Noun,2,0,2,0.0,2.2213830330763933e-05,1.0
24074,정여립/Noun,2,2,0,2.2230620456616944e-05,0.0,1.0
24075,에로티즘/Noun,2,0,2,0.0,2.2213830330763933e-05,1.0
24076,역임/Noun,2,2,0,2.2230620456616944e-05,0.0,1.0
24077,김봉은/Noun,2,0,2,0.0,2.2213830330763933e-05,1.0
24078,칼로리/Noun,2,0,2,0.0,2.2213830330763933e-05,1.0
24079,노지마/Noun,2,2,0,2.2230620456616944e-05,0.0,1.0
24080,접작/Noun,2,0,2,0.0,2.2213830330763933e-05,1.0
24081,삐라/Noun,2,0,2,0.0,2.2213830330763933e-05,1.0
24082,.................................../Punctuation,2,0,2,0.0,2.2213830330763933e-05,1.0
24083,손꼭/Noun,2,0,2,0.0,2.2213830330763933e-05,1.0
24084,돈의화신/Noun,2,2,0,2.2230620456616944e-05,0.0,1.0
24085,기까지/Eomi,2,2,0,2.2230620456616944e-05,0.0,1.0
24086,문란/Noun,2,0,2,0.0,2.2213830330763933e-05,1.0
24087,맑음/Noun,2,2,0,2.2230620456616944e-05,0.0,1.0
24088,맹세코/Noun,2,0,2,0.0,2.2213830330763933e-05,1.0
24089,카카/Noun,2,2,0,2.2230620456616944e-05,0.0,1.0
24090,마비스/Noun,2,2,0,2.2230620456616944e-05,0.0,1.0
24091,5~10분/Number,2,0,2,0.0,2.2213830330763933e-05,1.0
24092,29만원/Number,2,0,2,0.0,2.2213830330763933e-05,1.0
24093,미국사/Noun,2,2,0,2.2230620456616944e-05,0.0,1.0
24094,자장/Noun,2,0,2,0.0,2.2213830330763933e-05,1.0
24095,재학/Noun,2,2,0,2.2230620456616944e-05,0.0,1.0
24096,스카이워커/Noun,2,2,0,2.2230620456616944e-05,0.0,1.0
24097,갈아엎다/Verb,2,0,2,0.0,2.2213830330763933e-05,1.0
24098,뜻임/Noun,2,0,2,0.0,2.2213830330763933e-05,1.0
24099,온라인게임/Noun,2,0,2,0.0,2.2213830330763933e-05,1.0
24100,최민호/Noun,2,2,0,2.2230620456616944e-05,0.0,1.0
24101,편땜/Noun,2,0,2,0.0,2.2213830330763933e-05,1.0
24102,흩다/Verb,2,0,2,0.0,2.2213830330763933e-05,1.0
24103,뗼/Noun,2,2,0,2.2230620456616944e-05,0.0,1.0
24104,체념하다/Adjective,2,2,0,2.2230620456616944e-05,0.0,1.0
24105,형석/Noun,2,2,0,2.2230620456616944e-05,0.0,1.0
24106,ㄷㅅ/KoreanParticle,2,2,0,2.2230620456616944e-05,0.0,1.0
24107,9.88/Number,2,2,0,2.2230620456616944e-05,0.0,1.0
24108,http://movie.naver.com/movie/bi/mi/reviewread.nhn?code=100987&nid=3431254#tab/URL,2,2,0,2.2230620456616944e-05,0.0,1.0
24109,퍼드/Noun,2,2,0,2.2230620456616944e-05,0.0,1.0
24110,나경/Noun,2,0,2,0.0,2.2213830330763933e-05,1.0
24111,piece/Alpha,2,0,2,0.0,2.2213830330763933e-05,1.0
24112,마이웨이/Noun,2,0,2,0.0,2.2213830330763933e-05,1.0
24113,서하면/Noun,2,2,0,2.2230620456616944e-05,0.0,1.0
24114,퐝/Noun,2,0,2,0.0,2.2213830330763933e-05,1.0
24115,건빵/Noun,2,0,2,0.0,2.2213830330763933e-05,1.0
24116,태광/Noun,2,2,0,2.2230620456616944e-05,0.0,1.0
24117,양호/Noun,2,0,2,0.0,2.2213830330763933e-05,1.0
24118,대풍/Foreign,2,0,2,0.0,2.2213830330763933e-05,1.0
24119,피렌체/Noun,2,2,0,2.2230620456616944e-05,0.0,1.0
24120,화통/Noun,2,0,2,0.0,2.2213830330763933e-05,1.0
24121,심빠들/Noun,2,0,2,0.0,2.2213830330763933e-05,1.0
24122,고상/Noun,2,2,0,2.2230620456616944e-05,0.0,1.0
24123,봄내/Noun,2,2,0,2.2230620456616944e-05,0.0,1.0
24124,다루어지다/Verb,2,0,2,0.0,2.2213830330763933e-05,1.0
24125,엄다혜/Noun,2,2,0,2.2230620456616944e-05,0.0,1.0
24126,오늘의유머/Noun,2,0,2,0.0,2.2213830330763933e-05,1.0
24127,램페이지/Noun,2,2,0,2.2230620456616944e-05,0.0,1.0
24128,헐벗/Noun,2,0,2,0.0,2.2213830330763933e-05,1.0
24129,키트/Noun,2,2,0,2.2230620456616944e-05,0.0,1.0
24130,몰랏/Noun,2,2,0,2.2230620456616944e-05,0.0,1.0
24131,조마/Noun,2,2,0,2.2230620456616944e-05,0.0,1.0
24132,초자연/Noun,2,0,2,0.0,2.2213830330763933e-05,1.0
24133,1965년/Number,2,0,2,0.0,2.2213830330763933e-05,1.0
24134,스트라빈스키/Noun,2,0,2,0.0,2.2213830330763933e-05,1.0
24135,아르바이트/Noun,2,2,0,2.2230620456616944e-05,0.0,1.0
24136,라디오헤드/Noun,2,2,0,2.2230620456616944e-05,0.0,1.0
24137,...--;;/Punctuation,2,0,2,0.0,2.2213830330763933e-05,1.0
24138,노재/Noun,2,0,2,0.0,2.2213830330763933e-05,1.0
24139,직관/Noun,2,2,0,2.2230620456616944e-05,0.0,1.0
24140,큭큭/Noun,2,2,0,2.2230620456616944e-05,0.0,1.0
24141,길고양이/Noun,2,2,0,2.2230620456616944e-05,0.0,1.0
24142,DOO/Alpha,2,0,2,0.0,2.2213830330763933e-05,1.0
24143,HUSTLE/Alpha,2,0,2,0.0,2.2213830330763933e-05,1.0
24144,세탁소/Noun,2,0,2,0.0,2.2213830330763933e-05,1.0
24145,.^^../Punctuation,2,0,2,0.0,2.2213830330763933e-05,1.0
24146,포교/Noun,2,2,0,2.2230620456616944e-05,0.0,1.0
24147,뻘짓하/Noun,2,0,2,0.0,2.2213830330763933e-05,1.0
24148,개잼졸잼/Noun,2,2,0,2.2230620456616944e-05,0.0,1.0
24149,술처/Noun,2,0,2,0.0,2.2213830330763933e-05,1.0
24150,뱅기/Noun,2,0,2,0.0,2.2213830330763933e-05,1.0
24151,엄태구/Noun,2,2,0,2.2230620456616944e-05,0.0,1.0
24152,로스쿨/Noun,2,0,2,0.0,2.2213830330763933e-05,1.0
24153,실가/Noun,2,2,0,2.2230620456616944e-05,0.0,1.0
24154,매운탕/Noun,2,0,2,0.0,2.2213830330763933e-05,1.0
24155,등록증/Noun,2,0,2,0.0,2.2213830330763933e-05,1.0
24156,붕유/Noun,2,0,2,0.0,2.2213830330763933e-05,1.0
24157,^^^^/Punctuation,2,2,0,2.2230620456616944e-05,0.0,1.0
24158,민초/Noun,2,2,0,2.2230620456616944e-05,0.0,1.0
24159,밥알/Noun,2,0,2,0.0,2.2213830330763933e-05,1.0
24160,쪼아쪼/Noun,2,2,0,2.2230620456616944e-05,0.0,1.0
24161,임효성/Noun,2,0,2,0.0,2.2213830330763933e-05,1.0
24162,시외/Noun,2,0,2,0.0,2.2213830330763933e-05,1.0
24163,전도현/Noun,2,2,0,2.2230620456616944e-05,0.0,1.0
24164,돌맹/Noun,2,0,2,0.0,2.2213830330763933e-05,1.0
24165,송편/Noun,2,2,0,2.2230620456616944e-05,0.0,1.0
24166,급물/Noun,2,0,2,0.0,2.2213830330763933e-05,1.0
24167,죽통/Noun,2,0,2,0.0,2.2213830330763933e-05,1.0
24168,어처/Noun,2,0,2,0.0,2.2213830330763933e-05,1.0
24169,500년/Number,2,0,2,0.0,2.2213830330763933e-05,1.0
24170,양순/Noun,2,2,0,2.2230620456616944e-05,0.0,1.0
24171,앨리슨/Noun,2,2,0,2.2230620456616944e-05,0.0,1.0
24172,캠핑카/Noun,2,0,2,0.0,2.2213830330763933e-05,1.0
24173,SS/Alpha,2,0,2,0.0,2.2213830330763933e-05,1.0
24174,태사기/Noun,2,0,2,0.0,2.2213830330763933e-05,1.0
24175,"..,,///Punctuation",2,0,2,0.0,2.2213830330763933e-05,1.0
24176,한준/Noun,2,0,2,0.0,2.2213830330763933e-05,1.0
24177,아듀/Noun,2,2,0,2.2230620456616944e-05,0.0,1.0
24178,KGB/Alpha,2,0,2,0.0,2.2213830330763933e-05,1.0
24179,완죤히/Noun,2,0,2,0.0,2.2213830330763933e-05,1.0
24180,부조/Noun,2,0,2,0.0,2.2213830330763933e-05,1.0
24181,모로코/Noun,2,2,0,2.2230620456616944e-05,0.0,1.0
24182,정의롭/Noun,2,2,0,2.2230620456616944e-05,0.0,1.0
24183,놨으/Noun,2,0,2,0.0,2.2213830330763933e-05,1.0
24184,56분/Number,2,0,2,0.0,2.2213830330763933e-05,1.0
24185,받아랏/Noun,2,0,2,0.0,2.2213830330763933e-05,1.0
24186,being/Alpha,2,2,0,2.2230620456616944e-05,0.0,1.0
24187,학교생활/Noun,2,0,2,0.0,2.2213830330763933e-05,1.0
24188,천억/Noun,2,0,2,0.0,2.2213830330763933e-05,1.0
24189,?!?!/Punctuation,2,0,2,0.0,2.2213830330763933e-05,1.0
24190,카오루/Noun,2,2,0,2.2230620456616944e-05,0.0,1.0
24191,고바야시/Noun,2,2,0,2.2230620456616944e-05,0.0,1.0
24192,제이미벨/Noun,2,2,0,2.2230620456616944e-05,0.0,1.0
24193,벽보/Noun,2,0,2,0.0,2.2213830330763933e-05,1.0
24194,뀰잼/Noun,2,2,0,2.2230620456616944e-05,0.0,1.0
24195,쥑이/Noun,2,2,0,2.2230620456616944e-05,0.0,1.0
24196,뭬/Noun,2,0,2,0.0,2.2213830330763933e-05,1.0
24197,fg/Alpha,2,2,0,2.2230620456616944e-05,0.0,1.0
24198,성대/Noun,2,0,2,0.0,2.2213830330763933e-05,1.0
24199,뉴올리언스/Noun,2,2,0,2.2230620456616944e-05,0.0,1.0
24200,ㄷㄱ/KoreanParticle,2,0,2,0.0,2.2213830330763933e-05,1.0
24201,티격태격하/Noun,2,2,0,2.2230620456616944e-05,0.0,1.0
24202,갑동/Noun,2,2,0,2.2230620456616944e-05,0.0,1.0
24203,나우시카/Noun,2,2,0,2.2230620456616944e-05,0.0,1.0
24204,희비극/Noun,2,2,0,2.2230620456616944e-05,0.0,1.0
24205,핰핰/Noun,2,2,0,2.2230620456616944e-05,0.0,1.0
24206,느꼇구/Noun,2,2,0,2.2230620456616944e-05,0.0,1.0
24207,타요/Noun,2,0,2,0.0,2.2213830330763933e-05,1.0
24208,Be/Alpha,2,2,0,2.2230620456616944e-05,0.0,1.0
24209,팜프파탈/Noun,2,2,0,2.2230620456616944e-05,0.0,1.0
24210,찰영/Noun,2,2,0,2.2230620456616944e-05,0.0,1.0
24211,장맨/Noun,2,2,0,2.2230620456616944e-05,0.0,1.0
24212,코닌/Noun,2,2,0,2.2230620456616944e-05,0.0,1.0
24213,회시/Noun,2,2,0,2.2230620456616944e-05,0.0,1.0
24214,작인걸/Foreign,2,2,0,2.2230620456616944e-05,0.0,1.0
24215,ㅋㅋㄱㄱ/KoreanParticle,2,0,2,0.0,2.2213830330763933e-05,1.0
24216,입수/Noun,2,2,0,2.2230620456616944e-05,0.0,1.0
24217,[?]/Punctuation,2,2,0,2.2230620456616944e-05,0.0,1.0
24218,...!!!!!/Punctuation,2,2,0,2.2230620456616944e-05,0.0,1.0
24219,텔미/Noun,2,0,2,0.0,2.2213830330763933e-05,1.0
24220,데드사일런스/Noun,2,2,0,2.2230620456616944e-05,0.0,1.0
24221,칼러/Noun,2,2,0,2.2230620456616944e-05,0.0,1.0
24222,피파/Noun,2,2,0,2.2230620456616944e-05,0.0,1.0
24223,"~,~/Punctuation",2,2,0,2.2230620456616944e-05,0.0,1.0
24224,벤치마킹/Noun,2,0,2,0.0,2.2213830330763933e-05,1.0
24225,사코/Noun,2,2,0,2.2230620456616944e-05,0.0,1.0
24226,치코/Noun,2,2,0,2.2230620456616944e-05,0.0,1.0
24227,!!!!^^/Punctuation,2,2,0,2.2230620456616944e-05,0.0,1.0
24228,mb/Alpha,2,0,2,0.0,2.2213830330763933e-05,1.0
24229,금잔디/Noun,2,0,2,0.0,2.2213830330763933e-05,1.0
24230,죙일/Noun,2,0,2,0.0,2.2213830330763933e-05,1.0
24231,포아/Noun,2,0,2,0.0,2.2213830330763933e-05,1.0
24232,쿠도/Noun,2,2,0,2.2230620456616944e-05,0.0,1.0
24233,짤림/Noun,2,2,0,2.2230620456616944e-05,0.0,1.0
24234,남부럽다/Adjective,2,0,2,0.0,2.2213830330763933e-05,1.0
24235,로지은/Noun,2,2,0,2.2230620456616944e-05,0.0,1.0
24236,공적/Noun,2,2,0,2.2230620456616944e-05,0.0,1.0
24237,면역/Noun,2,0,2,0.0,2.2213830330763933e-05,1.0
24238,발치/Noun,2,0,2,0.0,2.2213830330763933e-05,1.0
24239,화염병/Noun,2,0,2,0.0,2.2213830330763933e-05,1.0
24240,홍콩인/Noun,2,0,2,0.0,2.2213830330763933e-05,1.0
24241,질척/Adverb,2,0,2,0.0,2.2213830330763933e-05,1.0
24242,엄포스/Noun,2,2,0,2.2230620456616944e-05,0.0,1.0
24243,가전제품/Noun,2,2,0,2.2230620456616944e-05,0.0,1.0
24244,카포에라/Noun,2,0,2,0.0,2.2213830330763933e-05,1.0
24245,argentina/Alpha,2,2,0,2.2230620456616944e-05,0.0,1.0
24246,한가롭다/Adjective,2,2,0,2.2230620456616944e-05,0.0,1.0
24247,전교생/Noun,2,0,2,0.0,2.2213830330763933e-05,1.0
24248,폭주기관차/Noun,2,2,0,2.2230620456616944e-05,0.0,1.0
24249,곰인형/Noun,2,2,0,2.2230620456616944e-05,0.0,1.0
24250,제군/Noun,2,0,2,0.0,2.2213830330763933e-05,1.0
24251,재창/Noun,2,2,0,2.2230620456616944e-05,0.0,1.0
24252,작픔/Noun,2,0,2,0.0,2.2213830330763933e-05,1.0
24253,케잌/Noun,2,2,0,2.2230620456616944e-05,0.0,1.0
24254,사타구니/Noun,2,2,0,2.2230620456616944e-05,0.0,1.0
24255,납자루/Noun,2,0,2,0.0,2.2213830330763933e-05,1.0
24256,space/Alpha,2,2,0,2.2230620456616944e-05,0.0,1.0
24257,백승/Noun,2,0,2,0.0,2.2213830330763933e-05,1.0
24258,풍요롭/Noun,2,2,0,2.2230620456616944e-05,0.0,1.0
24259,양아버지/Noun,2,2,0,2.2230620456616944e-05,0.0,1.0
24260,임필/Noun,2,0,2,0.0,2.2213830330763933e-05,1.0
24261,!!..../Punctuation,2,0,2,0.0,2.2213830330763933e-05,1.0
24262,쇼핑몰/Noun,2,0,2,0.0,2.2213830330763933e-05,1.0
24263,탄핵/Noun,2,2,0,2.2230620456616944e-05,0.0,1.0
24264,팔색조/Noun,2,2,0,2.2230620456616944e-05,0.0,1.0
24265,칠면조/Noun,2,2,0,2.2230620456616944e-05,0.0,1.0
24266,렉기/Noun,2,0,2,0.0,2.2213830330763933e-05,1.0
24267,쉐키/Noun,2,0,2,0.0,2.2213830330763933e-05,1.0
24268,9.17/Number,2,0,2,0.0,2.2213830330763933e-05,1.0
24269,!!!~~~/Punctuation,2,2,0,2.2230620456616944e-05,0.0,1.0
24270,꼭좀/Noun,2,2,0,2.2230620456616944e-05,0.0,1.0
24271,사진기/Noun,2,2,0,2.2230620456616944e-05,0.0,1.0
24272,영위/Noun,2,2,0,2.2230620456616944e-05,0.0,1.0
24273,히노키/Noun,2,2,0,2.2230620456616944e-05,0.0,1.0
24274,...^_^/Punctuation,2,2,0,2.2230620456616944e-05,0.0,1.0
24275,사대부/Noun,2,0,2,0.0,2.2213830330763933e-05,1.0
24276,릭스/Noun,2,2,0,2.2230620456616944e-05,0.0,1.0
24277,벡/Noun,2,2,0,2.2230620456616944e-05,0.0,1.0
24278,외양/Noun,2,0,2,0.0,2.2213830330763933e-05,1.0
24279,악독하다/Adjective,2,2,0,2.2230620456616944e-05,0.0,1.0
24280,집아/Noun,2,0,2,0.0,2.2213830330763933e-05,1.0
24281,신생아/Noun,2,0,2,0.0,2.2213830330763933e-05,1.0
24282,hope/Alpha,2,2,0,2.2230620456616944e-05,0.0,1.0
24283,디렉션/Noun,2,0,2,0.0,2.2213830330763933e-05,1.0
24284,땟/Noun,2,0,2,0.0,2.2213830330763933e-05,1.0
24285,은어/Noun,2,0,2,0.0,2.2213830330763933e-05,1.0
24286,하산/Noun,2,2,0,2.2230620456616944e-05,0.0,1.0
24287,왕세자/Noun,2,2,0,2.2230620456616944e-05,0.0,1.0
24288,줸장/Noun,2,0,2,0.0,2.2213830330763933e-05,1.0
24289,캬캬/Noun,2,2,0,2.2230620456616944e-05,0.0,1.0
24290,국도극장/Noun,2,2,0,2.2230620456616944e-05,0.0,1.0
24291,달봉/Noun,2,0,2,0.0,2.2213830330763933e-05,1.0
24292,조양/Noun,2,0,2,0.0,2.2213830330763933e-05,1.0
24293,산울림/Noun,2,2,0,2.2230620456616944e-05,0.0,1.0
24294,만신창이/Noun,2,2,0,2.2230620456616944e-05,0.0,1.0
24295,윗트/Noun,2,2,0,2.2230620456616944e-05,0.0,1.0
24296,190/Number,2,2,0,2.2230620456616944e-05,0.0,1.0
24297,:)))/Punctuation,2,2,0,2.2230620456616944e-05,0.0,1.0
24298,뼈속/Noun,2,2,0,2.2230620456616944e-05,0.0,1.0
24299,작두/Noun,2,2,0,2.2230620456616944e-05,0.0,1.0
24300,정치계/Noun,2,2,0,2.2230620456616944e-05,0.0,1.0
24301,60회/Number,2,2,0,2.2230620456616944e-05,0.0,1.0
24302,도드라지다/Verb,2,0,2,0.0,2.2213830330763933e-05,1.0
24303,홧팅입니/Noun,2,2,0,2.2230620456616944e-05,0.0,1.0
24304,이구아나/Noun,2,0,2,0.0,2.2213830330763933e-05,1.0
24305,정막/Noun,2,2,0,2.2230620456616944e-05,0.0,1.0
24306,증후/Noun,2,0,2,0.0,2.2213830330763933e-05,1.0
24307,샛기/Noun,2,2,0,2.2230620456616944e-05,0.0,1.0
24308,40억/Number,2,0,2,0.0,2.2213830330763933e-05,1.0
24309,성분/Noun,2,0,2,0.0,2.2213830330763933e-05,1.0
24310,남신/Noun,2,2,0,2.2230620456616944e-05,0.0,1.0
24311,슬랩스틱/Noun,2,2,0,2.2230620456616944e-05,0.0,1.0
24312,만풍/Noun,2,2,0,2.2230620456616944e-05,0.0,1.0
24313,적각비협/Noun,2,2,0,2.2230620456616944e-05,0.0,1.0
24314,소정/Noun,2,2,0,2.2230620456616944e-05,0.0,1.0
24315,아리조나/Noun,2,0,2,0.0,2.2213830330763933e-05,1.0
24316,때메봣/Noun,2,0,2,0.0,2.2213830330763933e-05,1.0
24317,욕심꾸러기/Noun,2,0,2,0.0,2.2213830330763933e-05,1.0
24318,접시/Noun,2,0,2,0.0,2.2213830330763933e-05,1.0
24319,주먹구구/Noun,2,0,2,0.0,2.2213830330763933e-05,1.0
24320,먼산/Noun,2,0,2,0.0,2.2213830330763933e-05,1.0
24321,도요다/Noun,2,0,2,0.0,2.2213830330763933e-05,1.0
24322,조명하/Noun,2,2,0,2.2230620456616944e-05,0.0,1.0
24323,Boy/Alpha,2,2,0,2.2230620456616944e-05,0.0,1.0
24324,직조/Noun,2,2,0,2.2230620456616944e-05,0.0,1.0
24325,마츠모토준/Noun,2,2,0,2.2230620456616944e-05,0.0,1.0
24326,섥혀/Noun,2,2,0,2.2230620456616944e-05,0.0,1.0
24327,엏/Noun,2,0,2,0.0,2.2213830330763933e-05,1.0
24328,배임/Noun,2,2,0,2.2230620456616944e-05,0.0,1.0
24329,적군파/Noun,2,2,0,2.2230620456616944e-05,0.0,1.0
24330,어셈블리/Noun,2,2,0,2.2230620456616944e-05,0.0,1.0
24331,15~20분/Number,2,0,2,0.0,2.2213830330763933e-05,1.0
24332,우르르/Noun,2,2,0,2.2230620456616944e-05,0.0,1.0
24333,처방/Noun,2,0,2,0.0,2.2213830330763933e-05,1.0
24334,야속하다/Adjective,2,2,0,2.2230620456616944e-05,0.0,1.0
24335,시추/Noun,2,0,2,0.0,2.2213830330763933e-05,1.0
24336,미니미/Noun,2,2,0,2.2230620456616944e-05,0.0,1.0
24337,사형선고/Noun,2,0,2,0.0,2.2213830330763933e-05,1.0
24338,이빨요정/Noun,2,0,2,0.0,2.2213830330763933e-05,1.0
24339,망가뜨릴수/Noun,2,2,0,2.2230620456616944e-05,0.0,1.0
24340,오거/Noun,2,2,0,2.2230620456616944e-05,0.0,1.0
24341,_)/Punctuation,2,2,0,2.2230620456616944e-05,0.0,1.0
24342,(_/Punctuation,2,2,0,2.2230620456616944e-05,0.0,1.0
24343,석호/Noun,2,2,0,2.2230620456616944e-05,0.0,1.0
24344,안정감/Noun,2,2,0,2.2230620456616944e-05,0.0,1.0
24345,조앙/Noun,2,2,0,2.2230620456616944e-05,0.0,1.0
24346,싸이월드/Noun,2,0,2,0.0,2.2213830330763933e-05,1.0
24347,사케/Noun,2,0,2,0.0,2.2213830330763933e-05,1.0
24348,흐접하/Noun,2,0,2,0.0,2.2213830330763933e-05,1.0
24349,깍아/Noun,2,0,2,0.0,2.2213830330763933e-05,1.0
24350,rock/Alpha,2,2,0,2.2230620456616944e-05,0.0,1.0
24351,그루지아/Noun,2,0,2,0.0,2.2213830330763933e-05,1.0
24352,감속/Noun,2,2,0,2.2230620456616944e-05,0.0,1.0
24353,벽감/Noun,2,2,0,2.2230620456616944e-05,0.0,1.0
24354,젬나/Noun,2,2,0,2.2230620456616944e-05,0.0,1.0
24355,??????????????????????????/Punctuation,2,0,2,0.0,2.2213830330763933e-05,1.0
24356,때렷/Noun,2,0,2,0.0,2.2213830330763933e-05,1.0
24357,소음공해/Noun,2,0,2,0.0,2.2213830330763933e-05,1.0
24358,렐/Noun,2,2,0,2.2230620456616944e-05,0.0,1.0
24359,해빙/Noun,2,2,0,2.2230620456616944e-05,0.0,1.0
24360,뽀록나다/Verb,2,0,2,0.0,2.2213830330763933e-05,1.0
24361,기쿠지/Noun,2,2,0,2.2230620456616944e-05,0.0,1.0
24362,이준석/Noun,2,0,2,0.0,2.2213830330763933e-05,1.0
24363,Roll/Alpha,2,2,0,2.2230620456616944e-05,0.0,1.0
24364,Here/Alpha,2,2,0,2.2230620456616944e-05,0.0,1.0
24365,최은희/Noun,2,2,0,2.2230620456616944e-05,0.0,1.0
24366,김희갑/Noun,2,2,0,2.2230620456616944e-05,0.0,1.0
24367,9.00/Number,2,2,0,2.2230620456616944e-05,0.0,1.0
24368,적하/Noun,2,0,2,0.0,2.2213830330763933e-05,1.0
24369,푸나/Noun,2,0,2,0.0,2.2213830330763933e-05,1.0
24370,바꿧/Noun,2,2,0,2.2230620456616944e-05,0.0,1.0
24371,까페/Noun,2,2,0,2.2230620456616944e-05,0.0,1.0
24372,심심찮/Noun,2,0,2,0.0,2.2213830330763933e-05,1.0
24373,눈독/Noun,2,2,0,2.2230620456616944e-05,0.0,1.0
24374,싸이렌/Noun,2,0,2,0.0,2.2213830330763933e-05,1.0
24375,리어왕/Noun,2,2,0,2.2230620456616944e-05,0.0,1.0
24376,낚고싶/Noun,2,0,2,0.0,2.2213830330763933e-05,1.0
24377,이소선/Noun,2,2,0,2.2230620456616944e-05,0.0,1.0
24378,saving/Alpha,2,2,0,2.2230620456616944e-05,0.0,1.0
24379,thank/Alpha,2,2,0,2.2230620456616944e-05,0.0,1.0
24380,염탐/Noun,2,0,2,0.0,2.2213830330763933e-05,1.0
24381,캣니스/Noun,2,0,2,0.0,2.2213830330763933e-05,1.0
24382,청룡영화상/Noun,2,2,0,2.2230620456616944e-05,0.0,1.0
24383,황무/Noun,2,2,0,2.2230620456616944e-05,0.0,1.0
24384,옮/Noun,2,2,0,2.2230620456616944e-05,0.0,1.0
24385,ㅣㅣㅣ/KoreanParticle,2,2,0,2.2230620456616944e-05,0.0,1.0
24386,헌티드/Noun,2,0,2,0.0,2.2213830330763933e-05,1.0
24387,안식/Noun,2,2,0,2.2230620456616944e-05,0.0,1.0
24388,감칠/Noun,2,2,0,2.2230620456616944e-05,0.0,1.0
24389,_&/Punctuation,2,2,0,2.2230620456616944e-05,0.0,1.0
24390,take/Alpha,2,2,0,2.2230620456616944e-05,0.0,1.0
24391,허장강/Noun,2,2,0,2.2230620456616944e-05,0.0,1.0
24392,연로/Noun,2,2,0,2.2230620456616944e-05,0.0,1.0
24393,틀려먹다/Verb,2,0,2,0.0,2.2213830330763933e-05,1.0
24394,재수생/Noun,2,0,2,0.0,2.2213830330763933e-05,1.0
24395,집결/Noun,2,0,2,0.0,2.2213830330763933e-05,1.0
24396,콜레트/Noun,2,2,0,2.2230620456616944e-05,0.0,1.0
24397,탕수육/Noun,2,2,0,2.2230620456616944e-05,0.0,1.0
24398,방통위/Noun,2,0,2,0.0,2.2213830330763933e-05,1.0
24399,착용/Noun,2,0,2,0.0,2.2213830330763933e-05,1.0
24400,마이라이프/Noun,2,0,2,0.0,2.2213830330763933e-05,1.0
24401,괜히봣다/Noun,2,0,2,0.0,2.2213830330763933e-05,1.0
24402,조준/Noun,2,0,2,0.0,2.2213830330763933e-05,1.0
24403,xtm/Alpha,2,0,2,0.0,2.2213830330763933e-05,1.0
24404,"-,./Punctuation",2,0,2,0.0,2.2213830330763933e-05,1.0
24405,배때/Noun,2,0,2,0.0,2.2213830330763933e-05,1.0
24406,적응도/Noun,2,0,2,0.0,2.2213830330763933e-05,1.0
24407,앨고어/Noun,2,0,2,0.0,2.2213830330763933e-05,1.0
24408,마랑/Noun,2,0,2,0.0,2.2213830330763933e-05,1.0
24409,경준/Noun,2,0,2,0.0,2.2213830330763933e-05,1.0
24410,EXO/Alpha,2,2,0,2.2230620456616944e-05,0.0,1.0
24411,타오/Noun,2,2,0,2.2230620456616944e-05,0.0,1.0
24412,;;;;;;;;;;;;;;;/Punctuation,2,0,2,0.0,2.2213830330763933e-05,1.0
24413,비틀리다/Verb,2,2,0,2.2230620456616944e-05,0.0,1.0
24414,♥♡/Foreign,2,2,0,2.2230620456616944e-05,0.0,1.0
24415,별룹니/Noun,2,0,2,0.0,2.2213830330763933e-05,1.0
24416,",</Punctuation",2,0,2,0.0,2.2213830330763933e-05,1.0
24417,노닥이다/Verb,2,0,2,0.0,2.2213830330763933e-05,1.0
24418,어쩌란겨/Noun,2,0,2,0.0,2.2213830330763933e-05,1.0
24419,부근/Noun,2,2,0,2.2230620456616944e-05,0.0,1.0
24420,이걱/Noun,2,0,2,0.0,2.2213830330763933e-05,1.0
24421,dc/Alpha,2,2,0,2.2230620456616944e-05,0.0,1.0
24422,지구온난화/Noun,2,2,0,2.2230620456616944e-05,0.0,1.0
24423,관객을/Foreign,2,0,2,0.0,2.2213830330763933e-05,1.0
24424,윤동주/Noun,2,0,2,0.0,2.2213830330763933e-05,1.0
24425,활공/Noun,2,2,0,2.2230620456616944e-05,0.0,1.0
24426,핑플/Noun,2,0,2,0.0,2.2213830330763933e-05,1.0
24427,아편/Noun,2,2,0,2.2230620456616944e-05,0.0,1.0
24428,봐/Noun,2,2,0,2.2230620456616944e-05,0.0,1.0
24429,땨/Noun,2,0,2,0.0,2.2213830330763933e-05,1.0
24430,쪼오끔/Noun,2,2,0,2.2230620456616944e-05,0.0,1.0
24431,./../Punctuation,2,0,2,0.0,2.2213830330763933e-05,1.0
24432,닷컴/Suffix,2,0,2,0.0,2.2213830330763933e-05,1.0
24433,정조대왕/Noun,2,2,0,2.2230620456616944e-05,0.0,1.0
24434,캐롤라인/Noun,2,2,0,2.2230620456616944e-05,0.0,1.0
24435,루퍼/Noun,2,0,2,0.0,2.2213830330763933e-05,1.0
24436,드리워지다/Verb,2,2,0,2.2230620456616944e-05,0.0,1.0
24437,부군/Noun,2,0,2,0.0,2.2213830330763933e-05,1.0
24438,인명/Noun,2,2,0,2.2230620456616944e-05,0.0,1.0
24439,245/Number,2,0,2,0.0,2.2213830330763933e-05,1.0
24440,시우민/Noun,2,2,0,2.2230620456616944e-05,0.0,1.0
24441,대영화도/Foreign,2,0,2,0.0,2.2213830330763933e-05,1.0
24442,바톤/Noun,2,0,2,0.0,2.2213830330763933e-05,1.0
24443,;;;;)/Punctuation,2,0,2,0.0,2.2213830330763933e-05,1.0
24444,의례/Noun,2,2,0,2.2230620456616944e-05,0.0,1.0
24445,비념/Noun,2,2,0,2.2230620456616944e-05,0.0,1.0
24446,skip/Alpha,2,2,0,2.2230620456616944e-05,0.0,1.0
24447,마리온/Noun,2,0,2,0.0,2.2213830330763933e-05,1.0
24448,첫인상/Noun,2,2,0,2.2230620456616944e-05,0.0,1.0
24449,유혈사태/Noun,2,2,0,2.2230620456616944e-05,0.0,1.0
24450,셀레스틴/Noun,2,2,0,2.2230620456616944e-05,0.0,1.0
24451,헤비메탈/Noun,2,0,2,0.0,2.2213830330763933e-05,1.0
24452,덜햇음/Noun,2,2,0,2.2230620456616944e-05,0.0,1.0
24453,옷스/Noun,2,2,0,2.2230620456616944e-05,0.0,1.0
24454,엘도라도/Noun,2,2,0,2.2230620456616944e-05,0.0,1.0
24455,오세암/Noun,2,2,0,2.2230620456616944e-05,0.0,1.0
24456,헛읏음/Noun,2,0,2,0.0,2.2213830330763933e-05,1.0
24457,전풍/Noun,2,2,0,2.2230620456616944e-05,0.0,1.0
24458,!!!!!!!!!!!!!!!!!!!!!!!!!!!!!!!!!!!!!!!!!!!!!!!!!!!!!/Punctuation,2,2,0,2.2230620456616944e-05,0.0,1.0
24459,쌍콤/Noun,2,2,0,2.2230620456616944e-05,0.0,1.0
24460,까/Noun,2,2,0,2.2230620456616944e-05,0.0,1.0
24461,아구창/Noun,2,0,2,0.0,2.2213830330763933e-05,1.0
24462,녀역/Noun,2,0,2,0.0,2.2213830330763933e-05,1.0
24463,최루/Noun,2,2,0,2.2230620456616944e-05,0.0,1.0
24464,')/Punctuation,2,0,2,0.0,2.2213830330763933e-05,1.0
24465,송신/Noun,2,2,0,2.2230620456616944e-05,0.0,1.0
24466,국교/Noun,2,0,2,0.0,2.2213830330763933e-05,1.0
24467,사약/Noun,2,0,2,0.0,2.2213830330763933e-05,1.0
24468,우측/Noun,2,2,0,2.2230620456616944e-05,0.0,1.0
24469,생이별/Noun,2,0,2,0.0,2.2213830330763933e-05,1.0
24470,캡사이신/Noun,2,0,2,0.0,2.2213830330763933e-05,1.0
24471,ㅇㅔ/KoreanParticle,2,2,0,2.2230620456616944e-05,0.0,1.0
24472,12시간/Number,2,2,0,2.2230620456616944e-05,0.0,1.0
24473,어험/Noun,2,0,2,0.0,2.2213830330763933e-05,1.0
24474,중매쟁이/Noun,2,0,2,0.0,2.2213830330763933e-05,1.0
24475,찌잉/Noun,2,2,0,2.2230620456616944e-05,0.0,1.0
24476,지푸라기/Noun,2,0,2,0.0,2.2213830330763933e-05,1.0
24477,아른아른/Adverb,2,2,0,2.2230620456616944e-05,0.0,1.0
24478,한진우/Noun,2,2,0,2.2230620456616944e-05,0.0,1.0
24479,수향/Noun,2,2,0,2.2230620456616944e-05,0.0,1.0
24480,급공무원/Noun,2,2,0,2.2230620456616944e-05,0.0,1.0
24481,동학/Noun,2,2,0,2.2230620456616944e-05,0.0,1.0
24482,빼빼/Noun,2,2,0,2.2230620456616944e-05,0.0,1.0
24483,뽀개/Noun,2,0,2,0.0,2.2213830330763933e-05,1.0
24484,매트리스/Noun,2,2,0,2.2230620456616944e-05,0.0,1.0
24485,부비/Noun,2,0,2,0.0,2.2213830330763933e-05,1.0
24486,옥수역/Noun,2,0,2,0.0,2.2213830330763933e-05,1.0
24487,차형사/Noun,2,0,2,0.0,2.2213830330763933e-05,1.0
24488,드미트리/Noun,2,2,0,2.2230620456616944e-05,0.0,1.0
24489,천계영/Noun,2,2,0,2.2230620456616944e-05,0.0,1.0
24490,기백/Noun,2,0,2,0.0,2.2213830330763933e-05,1.0
24491,불초/Noun,2,2,0,2.2230620456616944e-05,0.0,1.0
24492,65년/Number,2,2,0,2.2230620456616944e-05,0.0,1.0
24493,슬쩍슬쩍/Noun,2,0,2,0.0,2.2213830330763933e-05,1.0
24494,이츠키/Noun,2,2,0,2.2230620456616944e-05,0.0,1.0
24495,정물/Noun,2,0,2,0.0,2.2213830330763933e-05,1.0
24496,`~~/Punctuation,2,2,0,2.2230620456616944e-05,0.0,1.0
24497,give/Alpha,2,0,2,0.0,2.2213830330763933e-05,1.0
24498,ㅈㅇ/KoreanParticle,2,0,2,0.0,2.2213830330763933e-05,1.0
24499,쥬다이/Noun,2,2,0,2.2230620456616944e-05,0.0,1.0
24500,끊음/Noun,2,0,2,0.0,2.2213830330763933e-05,1.0
24501,매라/Noun,2,0,2,0.0,2.2213830330763933e-05,1.0
24502,TOD/Alpha,2,2,0,2.2230620456616944e-05,0.0,1.0
24503,울궈먹/Noun,2,0,2,0.0,2.2213830330763933e-05,1.0
24504,좆족/Noun,2,0,2,0.0,2.2213830330763933e-05,1.0
24505,pifan/Alpha,2,0,2,0.0,2.2213830330763933e-05,1.0
24506,전분/Noun,2,0,2,0.0,2.2213830330763933e-05,1.0
24507,과를/Josa,2,2,0,2.2230620456616944e-05,0.0,1.0
24508,.........?/Punctuation,2,0,2,0.0,2.2213830330763933e-05,1.0
24509,개풀/Noun,2,0,2,0.0,2.2213830330763933e-05,1.0
24510,칭구/Noun,2,0,2,0.0,2.2213830330763933e-05,1.0
24511,태러/Noun,2,0,2,0.0,2.2213830330763933e-05,1.0
24512,조형/Noun,2,0,2,0.0,2.2213830330763933e-05,1.0
24513,출타/Noun,2,0,2,0.0,2.2213830330763933e-05,1.0
24514,기갑/Noun,2,2,0,2.2230620456616944e-05,0.0,1.0
24515,김유빈/Noun,2,2,0,2.2230620456616944e-05,0.0,1.0
24516,김치양/Noun,2,0,2,0.0,2.2213830330763933e-05,1.0
24517,28시/Number,2,0,2,0.0,2.2213830330763933e-05,1.0
24518,도아깝다/Foreign,2,0,2,0.0,2.2213830330763933e-05,1.0
24519,먹튀/Noun,2,0,2,0.0,2.2213830330763933e-05,1.0
24520,선미/Noun,2,2,0,2.2230620456616944e-05,0.0,1.0
24521,수욜/Noun,2,2,0,2.2230620456616944e-05,0.0,1.0
24522,루이지/Noun,2,0,2,0.0,2.2213830330763933e-05,1.0
24523,츠치야/Noun,2,2,0,2.2230620456616944e-05,0.0,1.0
24524,변모/Noun,2,0,2,0.0,2.2213830330763933e-05,1.0
24525,복어/Noun,2,2,0,2.2230620456616944e-05,0.0,1.0
24526,위아래/Noun,2,0,2,0.0,2.2213830330763933e-05,1.0
24527,코드명/Noun,2,0,2,0.0,2.2213830330763933e-05,1.0
24528,미천하다/Adjective,2,0,2,0.0,2.2213830330763933e-05,1.0
24529,신역/Noun,2,0,2,0.0,2.2213830330763933e-05,1.0
24530,레레/Noun,2,2,0,2.2230620456616944e-05,0.0,1.0
24531,ⓒⓞⓞⓛ/Foreign,2,2,0,2.2230620456616944e-05,0.0,1.0
24532,다프네/Noun,2,2,0,2.2230620456616944e-05,0.0,1.0
24533,헤드윅/Noun,2,2,0,2.2230620456616944e-05,0.0,1.0
24534,애프터어스/Noun,2,0,2,0.0,2.2213830330763933e-05,1.0
24535,머찜/Noun,2,2,0,2.2230620456616944e-05,0.0,1.0
24536,괴랄/Noun,2,0,2,0.0,2.2213830330763933e-05,1.0
24537,유생/Noun,2,0,2,0.0,2.2213830330763933e-05,1.0
24538,^-^*/Punctuation,2,2,0,2.2230620456616944e-05,0.0,1.0
24539,지상렬/Noun,2,2,0,2.2230620456616944e-05,0.0,1.0
24540,하유미/Noun,2,0,2,0.0,2.2213830330763933e-05,1.0
24541,보이콧/Noun,2,0,2,0.0,2.2213830330763933e-05,1.0
24542,장애자/Noun,2,0,2,0.0,2.2213830330763933e-05,1.0
24543,다녀가다/Verb,2,2,0,2.2230620456616944e-05,0.0,1.0
24544,보면/Foreign,2,0,2,0.0,2.2213830330763933e-05,1.0
24545,나지막하다/Adjective,2,2,0,2.2230620456616944e-05,0.0,1.0
24546,125분/Number,2,0,2,0.0,2.2213830330763933e-05,1.0
24547,엽청문/Noun,2,2,0,2.2230620456616944e-05,0.0,1.0
24548,공론/Noun,2,2,0,2.2230620456616944e-05,0.0,1.0
24549,노멀/Noun,2,0,2,0.0,2.2213830330763933e-05,1.0
24550,바겐/Noun,2,0,2,0.0,2.2213830330763933e-05,1.0
24551,륜/Noun,2,0,2,0.0,2.2213830330763933e-05,1.0
24552,형돈/Noun,2,0,2,0.0,2.2213830330763933e-05,1.0
24553,우비/Noun,2,2,0,2.2230620456616944e-05,0.0,1.0
24554,아틀라스/Noun,2,0,2,0.0,2.2213830330763933e-05,1.0
24555,95%/Number,2,2,0,2.2230620456616944e-05,0.0,1.0
24556,미원/Noun,2,0,2,0.0,2.2213830330763933e-05,1.0
24557,폭한/Noun,2,2,0,2.2230620456616944e-05,0.0,1.0
24558,일루미나티/Noun,2,0,2,0.0,2.2213830330763933e-05,1.0
24559,서점/Noun,2,2,0,2.2230620456616944e-05,0.0,1.0
24560,크롤/Noun,2,2,0,2.2230620456616944e-05,0.0,1.0
24561,그림책/Noun,2,2,0,2.2230620456616944e-05,0.0,1.0
24562,!@!/Punctuation,2,2,0,2.2230620456616944e-05,0.0,1.0
24563,감사용/Noun,2,2,0,2.2230620456616944e-05,0.0,1.0
24564,곽시양/Noun,2,2,0,2.2230620456616944e-05,0.0,1.0
24565,하운/Noun,2,0,2,0.0,2.2213830330763933e-05,1.0
24566,디몬/Noun,2,0,2,0.0,2.2213830330763933e-05,1.0
24567,무영검/Noun,2,0,2,0.0,2.2213830330763933e-05,1.0
24568,좁히다/Verb,2,0,2,0.0,2.2213830330763933e-05,1.0
24569,백두산/Noun,2,0,2,0.0,2.2213830330763933e-05,1.0
24570,불지/Noun,2,0,2,0.0,2.2213830330763933e-05,1.0
24571,스키니진/Noun,2,0,2,0.0,2.2213830330763933e-05,1.0
24572,cent/Alpha,2,0,2,0.0,2.2213830330763933e-05,1.0
24573,나라짱/Noun,2,2,0,2.2230620456616944e-05,0.0,1.0
24574,샘해밍턴/Noun,2,0,2,0.0,2.2213830330763933e-05,1.0
24575,".,.,.,.,/Punctuation",2,0,2,0.0,2.2213830330763933e-05,1.0
24576,뿌직/Noun,2,0,2,0.0,2.2213830330763933e-05,1.0
24577,..!!!!/Punctuation,2,2,0,2.2230620456616944e-05,0.0,1.0
24578,치유계/Noun,2,0,2,0.0,2.2213830330763933e-05,1.0
24579,나가수/Noun,2,0,2,0.0,2.2213830330763933e-05,1.0
24580,금사/Noun,2,0,2,0.0,2.2213830330763933e-05,1.0
24581,엑설런트/Noun,2,2,0,2.2230620456616944e-05,0.0,1.0
24582,드팬/Noun,2,0,2,0.0,2.2213830330763933e-05,1.0
24583,스피시즈/Noun,2,2,0,2.2230620456616944e-05,0.0,1.0
24584,주파수/Noun,2,2,0,2.2230620456616944e-05,0.0,1.0
24585,웃프다/Noun,2,2,0,2.2230620456616944e-05,0.0,1.0
24586,게르만족/Noun,2,2,0,2.2230620456616944e-05,0.0,1.0
24587,120일/Number,2,0,2,0.0,2.2213830330763933e-05,1.0
24588,소돔/Noun,2,0,2,0.0,2.2213830330763933e-05,1.0
24589,게젤/Noun,2,2,0,2.2230620456616944e-05,0.0,1.0
24590,효자동/Noun,2,0,2,0.0,2.2213830330763933e-05,1.0
24591,셰인/Noun,2,0,2,0.0,2.2213830330763933e-05,1.0
24592,음치/Noun,2,2,0,2.2230620456616944e-05,0.0,1.0
24593,플레밍/Noun,2,2,0,2.2230620456616944e-05,0.0,1.0
24594,영통/Noun,2,2,0,2.2230620456616944e-05,0.0,1.0
24595,오란/Noun,2,0,2,0.0,2.2213830330763933e-05,1.0
24596,KIN/Alpha,2,0,2,0.0,2.2213830330763933e-05,1.0
24597,유아기/Noun,2,0,2,0.0,2.2213830330763933e-05,1.0
24598,교생/Noun,2,0,2,0.0,2.2213830330763933e-05,1.0
24599,바깥/Noun,2,2,0,2.2230620456616944e-05,0.0,1.0
24600,인디애나/Noun,2,0,2,0.0,2.2213830330763933e-05,1.0
24601,디씨/Noun,2,0,2,0.0,2.2213830330763933e-05,1.0
24602,쵝오쵝오/Noun,2,2,0,2.2230620456616944e-05,0.0,1.0
24603,크라잉넛/Noun,2,2,0,2.2230620456616944e-05,0.0,1.0
24604,대니얼/Noun,2,0,2,0.0,2.2213830330763933e-05,1.0
24605,확남/Noun,2,0,2,0.0,2.2213830330763933e-05,1.0
24606,재애애/Noun,2,2,0,2.2230620456616944e-05,0.0,1.0
24607,낑/Noun,2,0,2,0.0,2.2213830330763933e-05,1.0
24608,Nice/Alpha,2,2,0,2.2230620456616944e-05,0.0,1.0
24609,어땟는/Noun,2,0,2,0.0,2.2213830330763933e-05,1.0
24610,홍진경/Noun,2,0,2,0.0,2.2213830330763933e-05,1.0
24611,시미/Noun,2,2,0,2.2230620456616944e-05,0.0,1.0
24612,군중/Noun,2,2,0,2.2230620456616944e-05,0.0,1.0
24613,수십만/Modifier,2,0,2,0.0,2.2213830330763933e-05,1.0
24614,마시멜로/Noun,2,2,0,2.2230620456616944e-05,0.0,1.0
24615,밨음/Noun,2,0,2,0.0,2.2213830330763933e-05,1.0
24616,몬스터왕국/Noun,2,0,2,0.0,2.2213830330763933e-05,1.0
24617,오스카상/Noun,2,2,0,2.2230620456616944e-05,0.0,1.0
24618,6천원/Number,2,0,2,0.0,2.2213830330763933e-05,1.0
24619,젼나/Noun,2,0,2,0.0,2.2213830330763933e-05,1.0
24620,도시괴담/Noun,2,0,2,0.0,2.2213830330763933e-05,1.0
24621,찡긋/Noun,2,2,0,2.2230620456616944e-05,0.0,1.0
24622,팔로/Noun,2,2,0,2.2230620456616944e-05,0.0,1.0
24623,스페어/Noun,2,2,0,2.2230620456616944e-05,0.0,1.0
24624,전영화/Foreign,2,2,0,2.2230620456616944e-05,0.0,1.0
24625,아릅답다/Noun,2,2,0,2.2230620456616944e-05,0.0,1.0
24626,페르소나/Noun,2,2,0,2.2230620456616944e-05,0.0,1.0
24627,기내/Noun,2,0,2,0.0,2.2213830330763933e-05,1.0
24628,김성모/Noun,2,0,2,0.0,2.2213830330763933e-05,1.0
24629,퓨쳐/Noun,2,0,2,0.0,2.2213830330763933e-05,1.0
24630,청옥/Noun,2,2,0,2.2230620456616944e-05,0.0,1.0
24631,짝통/Noun,2,0,2,0.0,2.2213830330763933e-05,1.0
24632,드레드/Noun,2,2,0,2.2230620456616944e-05,0.0,1.0
24633,둘러쌓다/Verb,2,0,2,0.0,2.2213830330763933e-05,1.0
24634,가이드/Noun,2,0,2,0.0,2.2213830330763933e-05,1.0
24635,5.0/Number,2,2,0,2.2230620456616944e-05,0.0,1.0
24636,.~!/Punctuation,2,2,0,2.2230620456616944e-05,0.0,1.0
24637,요양원/Noun,2,2,0,2.2230620456616944e-05,0.0,1.0
24638,공경/Noun,2,2,0,2.2230620456616944e-05,0.0,1.0
24639,대여섯/Noun,2,2,0,2.2230620456616944e-05,0.0,1.0
24640,가까스로/Noun,2,0,2,0.0,2.2213830330763933e-05,1.0
24641,진즉/Noun,2,0,2,0.0,2.2213830330763933e-05,1.0
24642,운수좋은날/Noun,2,2,0,2.2230620456616944e-05,0.0,1.0
24643,정주리/Noun,2,0,2,0.0,2.2213830330763933e-05,1.0
24644,박성호/Noun,2,0,2,0.0,2.2213830330763933e-05,1.0
24645,몰겄다/Noun,2,0,2,0.0,2.2213830330763933e-05,1.0
24646,좐/Noun,2,2,0,2.2230620456616944e-05,0.0,1.0
24647,ㅇㄹ/KoreanParticle,2,0,2,0.0,2.2213830330763933e-05,1.0
24648,리즈중/Foreign,2,2,0,2.2230620456616944e-05,0.0,1.0
24649,미얀마/Noun,2,2,0,2.2230620456616944e-05,0.0,1.0
24650,문명진/Noun,2,2,0,2.2230620456616944e-05,0.0,1.0
24651,....???/Punctuation,2,0,2,0.0,2.2213830330763933e-05,1.0
24652,상극/Noun,2,0,2,0.0,2.2213830330763933e-05,1.0
24653,적그리스도/Noun,2,0,2,0.0,2.2213830330763933e-05,1.0
24654,만드나/Noun,2,0,2,0.0,2.2213830330763933e-05,1.0
24655,조이진/Noun,2,2,0,2.2230620456616944e-05,0.0,1.0
24656,킬리/Noun,2,2,0,2.2230620456616944e-05,0.0,1.0
24657,숯/Noun,2,2,0,2.2230620456616944e-05,0.0,1.0
24658,벅시/Noun,2,2,0,2.2230620456616944e-05,0.0,1.0
24659,토사/Noun,2,2,0,2.2230620456616944e-05,0.0,1.0
24660,김창만/Noun,2,2,0,2.2230620456616944e-05,0.0,1.0
24661,제갈/Noun,2,0,2,0.0,2.2213830330763933e-05,1.0
24662,셸리/Noun,2,2,0,2.2230620456616944e-05,0.0,1.0
24663,다빈/Noun,2,2,0,2.2230620456616944e-05,0.0,1.0
24664,박죽/Noun,2,0,2,0.0,2.2213830330763933e-05,1.0
24665,테로/Noun,2,0,2,0.0,2.2213830330763933e-05,1.0
24666,변비/Noun,2,0,2,0.0,2.2213830330763933e-05,1.0
24667,부랴부랴/Noun,2,0,2,0.0,2.2213830330763933e-05,1.0
24668,툼레이더/Noun,2,0,2,0.0,2.2213830330763933e-05,1.0
24669,몬구씨/Noun,2,2,0,2.2230620456616944e-05,0.0,1.0
24670,Iptv/Alpha,2,0,2,0.0,2.2213830330763933e-05,1.0
24671,입국/Noun,2,0,2,0.0,2.2213830330763933e-05,1.0
24672,japan/Alpha,2,0,2,0.0,2.2213830330763933e-05,1.0
24673,헝클어지다/Verb,2,0,2,0.0,2.2213830330763933e-05,1.0
24674,좋넹/Noun,2,0,2,0.0,2.2213830330763933e-05,1.0
24675,삼계탕/Noun,2,0,2,0.0,2.2213830330763933e-05,1.0
24676,<<</Punctuation,2,0,2,0.0,2.2213830330763933e-05,1.0
24677,뭉개/Noun,2,0,2,0.0,2.2213830330763933e-05,1.0
24678,지짐/Noun,2,0,2,0.0,2.2213830330763933e-05,1.0
24679,변영화/Noun,2,0,2,0.0,2.2213830330763933e-05,1.0
24680,ㅅㅍ/KoreanParticle,2,0,2,0.0,2.2213830330763933e-05,1.0
24681,잡친/Noun,2,0,2,0.0,2.2213830330763933e-05,1.0
24682,도거/Noun,2,2,0,2.2230620456616944e-05,0.0,1.0
24683,방과/Noun,2,2,0,2.2230620456616944e-05,0.0,1.0
24684,밝혀내다/Verb,2,0,2,0.0,2.2213830330763933e-05,1.0
24685,버젓히/Noun,2,0,2,0.0,2.2213830330763933e-05,1.0
24686,건알/Noun,2,0,2,0.0,2.2213830330763933e-05,1.0
24687,범죄인/Noun,2,0,2,0.0,2.2213830330763933e-05,1.0
24688,18회/Number,2,2,0,2.2230620456616944e-05,0.0,1.0
24689,고물상/Noun,2,0,2,0.0,2.2213830330763933e-05,1.0
24690,동체/Noun,2,0,2,0.0,2.2213830330763933e-05,1.0
24691,모리코네/Noun,2,2,0,2.2230620456616944e-05,0.0,1.0
24692,140분/Number,2,2,0,2.2230620456616944e-05,0.0,1.0
24693,ㅏㅋㅋㅋ/KoreanParticle,2,0,2,0.0,2.2213830330763933e-05,1.0
24694,페달/Noun,2,2,0,2.2230620456616944e-05,0.0,1.0
24695,즌다/Noun,2,2,0,2.2230620456616944e-05,0.0,1.0
24696,쵼/Noun,2,0,2,0.0,2.2213830330763933e-05,1.0
24697,밋음/Noun,2,2,0,2.2230620456616944e-05,0.0,1.0
24698,시즈쿠/Noun,2,2,0,2.2230620456616944e-05,0.0,1.0
24699,오피러스/Noun,2,0,2,0.0,2.2213830330763933e-05,1.0
24700,계영/Noun,2,2,0,2.2230620456616944e-05,0.0,1.0
24701,맨눈/Noun,2,0,2,0.0,2.2213830330763933e-05,1.0
24702,쌍카/Noun,2,2,0,2.2230620456616944e-05,0.0,1.0
24703,귀농/Noun,2,2,0,2.2230620456616944e-05,0.0,1.0
24704,우속/Noun,2,0,2,0.0,2.2213830330763933e-05,1.0
24705,위임/Noun,2,0,2,0.0,2.2213830330763933e-05,1.0
24706,이동규/Noun,2,0,2,0.0,2.2213830330763933e-05,1.0
24707,피카소/Noun,2,2,0,2.2230620456616944e-05,0.0,1.0
24708,샴푸/Noun,2,0,2,0.0,2.2213830330763933e-05,1.0
24709,구정/Noun,2,2,0,2.2230620456616944e-05,0.0,1.0
24710,괴안/Noun,2,2,0,2.2230620456616944e-05,0.0,1.0
24711,등려군/Noun,2,2,0,2.2230620456616944e-05,0.0,1.0
24712,문희준/Noun,2,0,2,0.0,2.2213830330763933e-05,1.0
24713,드나들다/Verb,2,2,0,2.2230620456616944e-05,0.0,1.0
24714,진공/Noun,2,0,2,0.0,2.2213830330763933e-05,1.0
24715,우메/Noun,2,0,2,0.0,2.2213830330763933e-05,1.0
24716,ㅛㅇ/KoreanParticle,2,0,2,0.0,2.2213830330763933e-05,1.0
24717,츤츤/Noun,2,2,0,2.2230620456616944e-05,0.0,1.0
24718,little/Alpha,2,2,0,2.2230620456616944e-05,0.0,1.0
24719,쯔레기/Noun,2,0,2,0.0,2.2213830330763933e-05,1.0
24720,태양계/Noun,2,2,0,2.2230620456616944e-05,0.0,1.0
24721,알밥/Noun,2,0,2,0.0,2.2213830330763933e-05,1.0
24722,둬/Modifier,2,0,2,0.0,2.2213830330763933e-05,1.0
24723,us/Alpha,2,2,0,2.2230620456616944e-05,0.0,1.0
24724,안철수/Noun,2,0,2,0.0,2.2213830330763933e-05,1.0
24725,마한/Noun,2,0,2,0.0,2.2213830330763933e-05,1.0
24726,(=/Punctuation,2,0,2,0.0,2.2213830330763933e-05,1.0
24727,제니주노/Noun,2,0,2,0.0,2.2213830330763933e-05,1.0
24728,fact/Alpha,2,2,0,2.2230620456616944e-05,0.0,1.0
24729,천연색/Noun,2,2,0,2.2230620456616944e-05,0.0,1.0
24730,모금/Noun,2,2,0,2.2230620456616944e-05,0.0,1.0
24731,드라마시티/Noun,2,0,2,0.0,2.2213830330763933e-05,1.0
24732,하렘물/Noun,2,2,0,2.2230620456616944e-05,0.0,1.0
24733,왼손잡이/Noun,2,2,0,2.2230620456616944e-05,0.0,1.0
24734,번치/Noun,2,2,0,2.2230620456616944e-05,0.0,1.0
24735,67분/Number,2,2,0,2.2230620456616944e-05,0.0,1.0
24736,도술/Noun,2,2,0,2.2230620456616944e-05,0.0,1.0
24737,앙드레김/Noun,2,0,2,0.0,2.2213830330763933e-05,1.0
24738,달이다/Verb,2,2,0,2.2230620456616944e-05,0.0,1.0
24739,멱/Noun,2,0,2,0.0,2.2213830330763933e-05,1.0
24740,퐈/Noun,2,0,2,0.0,2.2213830330763933e-05,1.0
24741,정한론/Noun,2,0,2,0.0,2.2213830330763933e-05,1.0
24742,피시방/Noun,2,0,2,0.0,2.2213830330763933e-05,1.0
24743,인거/Foreign,2,0,2,0.0,2.2213830330763933e-05,1.0
24744,트래킹/Noun,2,2,0,2.2230620456616944e-05,0.0,1.0
24745,안수/Noun,2,2,0,2.2230620456616944e-05,0.0,1.0
24746,7000만/Number,2,0,2,0.0,2.2213830330763933e-05,1.0
24747,메딘/Noun,2,0,2,0.0,2.2213830330763933e-05,1.0
24748,결혼전야/Noun,2,0,2,0.0,2.2213830330763933e-05,1.0
24749,러시안룰렛/Noun,2,0,2,0.0,2.2213830330763933e-05,1.0
24750,원문/Noun,2,2,0,2.2230620456616944e-05,0.0,1.0
24751,흐느/Noun,2,0,2,0.0,2.2213830330763933e-05,1.0
24752,소등/Noun,2,2,0,2.2230620456616944e-05,0.0,1.0
24753,곗돈/Noun,2,0,2,0.0,2.2213830330763933e-05,1.0
24754,걸스카우트/Noun,2,0,2,0.0,2.2213830330763933e-05,1.0
24755,욱이/Noun,2,2,0,2.2230620456616944e-05,0.0,1.0
24756,IMAX/Alpha,2,2,0,2.2230620456616944e-05,0.0,1.0
24757,1.6/Number,2,0,2,0.0,2.2213830330763933e-05,1.0
24758,어우리/Noun,2,2,0,2.2230620456616944e-05,0.0,1.0
24759,swee/Alpha,2,0,2,0.0,2.2213830330763933e-05,1.0
24760,로꼬/Noun,2,0,2,0.0,2.2213830330763933e-05,1.0
24761,신코/Noun,2,2,0,2.2230620456616944e-05,0.0,1.0
24762,오펀/Noun,2,2,0,2.2230620456616944e-05,0.0,1.0
24763,정구/Noun,2,2,0,2.2230620456616944e-05,0.0,1.0
24764,일락/Noun,2,2,0,2.2230620456616944e-05,0.0,1.0
24765,노시/Noun,2,2,0,2.2230620456616944e-05,0.0,1.0
24766,시빌/Noun,2,2,0,2.2230620456616944e-05,0.0,1.0
24767,만병통치약/Noun,2,0,2,0.0,2.2213830330763933e-05,1.0
24768,아이라인/Noun,2,0,2,0.0,2.2213830330763933e-05,1.0
24769,소화기/Noun,2,0,2,0.0,2.2213830330763933e-05,1.0
24770,굴창/Noun,2,0,2,0.0,2.2213830330763933e-05,1.0
24771,39년/Number,2,2,0,2.2230620456616944e-05,0.0,1.0
24772,바벨탑/Noun,2,2,0,2.2230620456616944e-05,0.0,1.0
24773,아뒤/Noun,2,0,2,0.0,2.2213830330763933e-05,1.0
24774,값싸다/Verb,2,0,2,0.0,2.2213830330763933e-05,1.0
24775,락앤롤/Noun,2,2,0,2.2230620456616944e-05,0.0,1.0
24776,보노보노/Noun,2,2,0,2.2230620456616944e-05,0.0,1.0
24777,돈의맛/Noun,2,0,2,0.0,2.2213830330763933e-05,1.0
24778,낟/Noun,2,0,2,0.0,2.2213830330763933e-05,1.0
24779,dx/Alpha,2,2,0,2.2230620456616944e-05,0.0,1.0
24780,구형/Noun,2,0,2,0.0,2.2213830330763933e-05,1.0
24781,해신/Noun,2,0,2,0.0,2.2213830330763933e-05,1.0
24782,문체/Noun,2,2,0,2.2230620456616944e-05,0.0,1.0
24783,법좀/Noun,2,2,0,2.2230620456616944e-05,0.0,1.0
24784,자살클럽/Noun,2,2,0,2.2230620456616944e-05,0.0,1.0
24785,미토/Noun,2,2,0,2.2230620456616944e-05,0.0,1.0
24786,50억/Number,2,0,2,0.0,2.2213830330763933e-05,1.0
24787,팔짝/Noun,2,0,2,0.0,2.2213830330763933e-05,1.0
24788,4/5/Number,2,0,2,0.0,2.2213830330763933e-05,1.0
24789,이니까/Foreign,2,0,2,0.0,2.2213830330763933e-05,1.0
24790,어음/Noun,2,0,2,0.0,2.2213830330763933e-05,1.0
24791,하앜하앜/Noun,2,0,2,0.0,2.2213830330763933e-05,1.0
24792,아이어/Noun,2,0,2,0.0,2.2213830330763933e-05,1.0
24793,네버엔딩/Noun,2,0,2,0.0,2.2213830330763933e-05,1.0
24794,불멸의이순신/Noun,2,0,2,0.0,2.2213830330763933e-05,1.0
24795,퍼뜨리/Noun,2,0,2,0.0,2.2213830330763933e-05,1.0
24796,걸엉/Noun,2,0,2,0.0,2.2213830330763933e-05,1.0
24797,쓰레긔/Noun,2,0,2,0.0,2.2213830330763933e-05,1.0
24798,시꺼멓다/Adjective,2,0,2,0.0,2.2213830330763933e-05,1.0
24799,견주어/Noun,2,2,0,2.2230620456616944e-05,0.0,1.0
24800,우로보로스/Noun,2,2,0,2.2230620456616944e-05,0.0,1.0
24801,부메랑/Noun,2,2,0,2.2230620456616944e-05,0.0,1.0
24802,사마리아/Noun,2,2,0,2.2230620456616944e-05,0.0,1.0
24803,개조차/Noun,2,0,2,0.0,2.2213830330763933e-05,1.0
24804,지혈/Noun,2,0,2,0.0,2.2213830330763933e-05,1.0
24805,실베/Noun,2,2,0,2.2230620456616944e-05,0.0,1.0
24806,에스에프/Noun,2,0,2,0.0,2.2213830330763933e-05,1.0
24807,Michael/Alpha,2,2,0,2.2230620456616944e-05,0.0,1.0
24808,석기시대/Noun,2,0,2,0.0,2.2213830330763933e-05,1.0
24809,법함/Noun,2,0,2,0.0,2.2213830330763933e-05,1.0
24810,초초/Noun,2,2,0,2.2230620456616944e-05,0.0,1.0
24811,우랑/Noun,2,2,0,2.2230620456616944e-05,0.0,1.0
24812,박차/Noun,2,2,0,2.2230620456616944e-05,0.0,1.0
24813,친형/Noun,2,2,0,2.2230620456616944e-05,0.0,1.0
24814,-_-)/Punctuation,2,2,0,2.2230620456616944e-05,0.0,1.0
24815,서리다/Verb,2,2,0,2.2230620456616944e-05,0.0,1.0
24816,삭았/Noun,2,0,2,0.0,2.2213830330763933e-05,1.0
24817,바이오하자드/Noun,2,2,0,2.2230620456616944e-05,0.0,1.0
24818,010/Number,2,2,0,2.2230620456616944e-05,0.0,1.0
24819,퍼가/Noun,2,2,0,2.2230620456616944e-05,0.0,1.0
24820,능데/Noun,2,2,0,2.2230620456616944e-05,0.0,1.0
24821,뭥/Noun,2,0,2,0.0,2.2213830330763933e-05,1.0
24822,움악/Noun,2,2,0,2.2230620456616944e-05,0.0,1.0
24823,샬레/Noun,2,2,0,2.2230620456616944e-05,0.0,1.0
24824,...////Punctuation,2,0,2,0.0,2.2213830330763933e-05,1.0
24825,아완/Noun,2,2,0,2.2230620456616944e-05,0.0,1.0
24826,서인석/Noun,2,2,0,2.2230620456616944e-05,0.0,1.0
24827,지붕킥/Noun,2,0,2,0.0,2.2213830330763933e-05,1.0
24828,분기점/Noun,2,0,2,0.0,2.2213830330763933e-05,1.0
24829,돈다/Noun,2,0,2,0.0,2.2213830330763933e-05,1.0
24830,짊어져/Noun,2,0,2,0.0,2.2213830330763933e-05,1.0
24831,은박/Noun,2,0,2,0.0,2.2213830330763933e-05,1.0
24832,방패/Noun,2,0,2,0.0,2.2213830330763933e-05,1.0
24833,성웅/Noun,2,0,2,0.0,2.2213830330763933e-05,1.0
24834,썻으/Noun,2,2,0,2.2230620456616944e-05,0.0,1.0
24835,업넹/Noun,2,0,2,0.0,2.2213830330763933e-05,1.0
24836,이지애/Noun,2,0,2,0.0,2.2213830330763933e-05,1.0
24837,김우수/Noun,2,2,0,2.2230620456616944e-05,0.0,1.0
24838,스꺼스띵/Noun,2,0,2,0.0,2.2213830330763933e-05,1.0
24839,철규/Noun,2,2,0,2.2230620456616944e-05,0.0,1.0
24840,어인/Noun,2,0,2,0.0,2.2213830330763933e-05,1.0
24841,연극배우/Noun,2,2,0,2.2230620456616944e-05,0.0,1.0
24842,고수희/Noun,2,2,0,2.2230620456616944e-05,0.0,1.0
24843,취준생/Noun,2,2,0,2.2230620456616944e-05,0.0,1.0
24844,금괴/Noun,2,0,2,0.0,2.2213830330763933e-05,1.0
24845,풍부/Noun,2,2,0,2.2230620456616944e-05,0.0,1.0
24846,강성진/Noun,2,2,0,2.2230620456616944e-05,0.0,1.0
24847,별난/Noun,2,2,0,2.2230620456616944e-05,0.0,1.0
24848,쫄병/Noun,2,0,2,0.0,2.2213830330763933e-05,1.0
24849,브랜던/Noun,2,2,0,2.2230620456616944e-05,0.0,1.0
24850,그르타/Noun,2,0,2,0.0,2.2213830330763933e-05,1.0
24851,........;;/Punctuation,2,0,2,0.0,2.2213830330763933e-05,1.0
24852,존못/Noun,2,0,2,0.0,2.2213830330763933e-05,1.0
24853,히스토리/Noun,2,2,0,2.2230620456616944e-05,0.0,1.0
24854,홀짝/Noun,2,2,0,2.2230620456616944e-05,0.0,1.0
24855,바타/Noun,2,0,2,0.0,2.2213830330763933e-05,1.0
24856,장착/Noun,2,0,2,0.0,2.2213830330763933e-05,1.0
24857,효자/Noun,2,2,0,2.2230620456616944e-05,0.0,1.0
24858,성취향/Noun,2,0,2,0.0,2.2213830330763933e-05,1.0
24859,",.,./Punctuation",2,0,2,0.0,2.2213830330763933e-05,1.0
24860,;;../Punctuation,2,0,2,0.0,2.2213830330763933e-05,1.0
24861,이육사/Noun,2,2,0,2.2230620456616944e-05,0.0,1.0
24862,??-_-/Punctuation,2,0,2,0.0,2.2213830330763933e-05,1.0
24863,9.18/Number,2,0,2,0.0,2.2213830330763933e-05,1.0
24864,기약/Noun,2,2,0,2.2230620456616944e-05,0.0,1.0
24865,체불/Noun,2,0,2,0.0,2.2213830330763933e-05,1.0
24866,떄매/Noun,2,0,2,0.0,2.2213830330763933e-05,1.0
24867,컨닝/Noun,2,0,2,0.0,2.2213830330763933e-05,1.0
24868,평남/Noun,2,0,2,0.0,2.2213830330763933e-05,1.0
24869,우역/Noun,2,2,0,2.2230620456616944e-05,0.0,1.0
24870,납북자/Noun,2,0,2,0.0,2.2213830330763933e-05,1.0
24871,재촉/Noun,2,0,2,0.0,2.2213830330763933e-05,1.0
24872,픽업아티스트/Noun,2,0,2,0.0,2.2213830330763933e-05,1.0
24873,완전무결/Noun,2,2,0,2.2230620456616944e-05,0.0,1.0
24874,슬립/Noun,2,2,0,2.2230620456616944e-05,0.0,1.0
24875,robot/Alpha,2,2,0,2.2230620456616944e-05,0.0,1.0
24876,덩실/Adverb,2,0,2,0.0,2.2213830330763933e-05,1.0
24877,부적합하다/Adjective,2,0,2,0.0,2.2213830330763933e-05,1.0
24878,비꼼/Noun,2,0,2,0.0,2.2213830330763933e-05,1.0
24879,신삼국/Noun,2,2,0,2.2230620456616944e-05,0.0,1.0
24880,일편단심/Noun,2,0,2,0.0,2.2213830330763933e-05,1.0
24881,서울역/Noun,2,0,2,0.0,2.2213830330763933e-05,1.0
24882,이네요/Foreign,2,2,0,2.2230620456616944e-05,0.0,1.0
24883,개똥망/Noun,2,0,2,0.0,2.2213830330763933e-05,1.0
24884,!!!'/Punctuation,2,2,0,2.2230620456616944e-05,0.0,1.0
24885,었어/Noun,2,2,0,2.2230620456616944e-05,0.0,1.0
24886,미추/Noun,2,0,2,0.0,2.2213830330763933e-05,1.0
24887,goodgood/Alpha,2,2,0,2.2230620456616944e-05,0.0,1.0
24888,방범/Noun,2,0,2,0.0,2.2213830330763933e-05,1.0
24889,ㅂㅣ/KoreanParticle,2,0,2,0.0,2.2213830330763933e-05,1.0
24890,묵적/Noun,2,0,2,0.0,2.2213830330763933e-05,1.0
24891,신지식인/Noun,2,0,2,0.0,2.2213830330763933e-05,1.0
24892,도로로/Noun,2,2,0,2.2230620456616944e-05,0.0,1.0
24893,이상엽/Noun,2,0,2,0.0,2.2213830330763933e-05,1.0
24894,혼연/Noun,2,2,0,2.2230620456616944e-05,0.0,1.0
24895,23시/Number,2,0,2,0.0,2.2213830330763933e-05,1.0
24896,안팔/Noun,2,0,2,0.0,2.2213830330763933e-05,1.0
24897,생키/Noun,2,0,2,0.0,2.2213830330763933e-05,1.0
24898,비투비/Noun,2,2,0,2.2230620456616944e-05,0.0,1.0
24899,지선/Noun,2,2,0,2.2230620456616944e-05,0.0,1.0
24900,단짝/Noun,2,2,0,2.2230620456616944e-05,0.0,1.0
24901,亞流作/Foreign,2,0,2,0.0,2.2213830330763933e-05,1.0
24902,코요테/Noun,2,0,2,0.0,2.2213830330763933e-05,1.0
24903,츠지/Noun,2,2,0,2.2230620456616944e-05,0.0,1.0
24904,운전자/Noun,2,0,2,0.0,2.2213830330763933e-05,1.0
24905,커넥션/Noun,2,2,0,2.2230620456616944e-05,0.0,1.0
24906,느무/Noun,2,2,0,2.2230620456616944e-05,0.0,1.0
24907,컴팩트/Noun,2,2,0,2.2230620456616944e-05,0.0,1.0
24908,깔보다/Verb,2,0,2,0.0,2.2213830330763933e-05,1.0
24909,주병/Noun,2,0,2,0.0,2.2213830330763933e-05,1.0
24910,반달곰/Noun,2,2,0,2.2230620456616944e-05,0.0,1.0
24911,)*/Punctuation,2,0,2,0.0,2.2213830330763933e-05,1.0
24912,시반/Noun,2,0,2,0.0,2.2213830330763933e-05,1.0
24913,김진/Noun,2,0,2,0.0,2.2213830330763933e-05,1.0
24914,스릉흔드/Noun,2,2,0,2.2230620456616944e-05,0.0,1.0
24915,큼/Foreign,2,2,0,2.2230620456616944e-05,0.0,1.0
24916,촬영기/Noun,2,0,2,0.0,2.2213830330763933e-05,1.0
24917,순경/Noun,2,0,2,0.0,2.2213830330763933e-05,1.0
24918,만류/Noun,2,0,2,0.0,2.2213830330763933e-05,1.0
24919,나이프/Noun,2,2,0,2.2230620456616944e-05,0.0,1.0
24920,똥똥똥/Noun,2,0,2,0.0,2.2213830330763933e-05,1.0
24921,무릅쓰/Noun,2,0,2,0.0,2.2213830330763933e-05,1.0
24922,?>???/Punctuation,2,0,2,0.0,2.2213830330763933e-05,1.0
24923,역순/Noun,2,2,0,2.2230620456616944e-05,0.0,1.0
24924,오봉/Noun,2,0,2,0.0,2.2213830330763933e-05,1.0
24925,;;;;;;;;;;;;;/Punctuation,2,0,2,0.0,2.2213830330763933e-05,1.0
24926,시옷/Noun,2,2,0,2.2230620456616944e-05,0.0,1.0
24927,울엇음/Noun,2,2,0,2.2230620456616944e-05,0.0,1.0
24928,팬질/Noun,2,0,2,0.0,2.2213830330763933e-05,1.0
24929,악성/Noun,2,0,2,0.0,2.2213830330763933e-05,1.0
24930,떠지다/Verb,2,2,0,2.2230620456616944e-05,0.0,1.0
24931,자릿수/Noun,2,0,2,0.0,2.2213830330763933e-05,1.0
24932,예루살렘/Noun,2,0,2,0.0,2.2213830330763933e-05,1.0
24933,참호/Noun,2,2,0,2.2230620456616944e-05,0.0,1.0
24934,표준어/Noun,2,0,2,0.0,2.2213830330763933e-05,1.0
24935,일밤/Noun,2,0,2,0.0,2.2213830330763933e-05,1.0
24936,실의/Noun,2,2,0,2.2230620456616944e-05,0.0,1.0
24937,번역기/Noun,2,0,2,0.0,2.2213830330763933e-05,1.0
24938,중경/Noun,2,0,2,0.0,2.2213830330763933e-05,1.0
24939,어썸/Noun,2,2,0,2.2230620456616944e-05,0.0,1.0
24940,휘발유/Noun,2,0,2,0.0,2.2213830330763933e-05,1.0
24941,죕/Noun,2,0,2,0.0,2.2213830330763933e-05,1.0
24942,티렉스/Noun,2,0,2,0.0,2.2213830330763933e-05,1.0
24943,컴퓨터게임/Noun,2,0,2,0.0,2.2213830330763933e-05,1.0
24944,뭣좀/Noun,2,0,2,0.0,2.2213830330763933e-05,1.0
24945,비치슬랩/Noun,2,0,2,0.0,2.2213830330763933e-05,1.0
24946,이발관/Noun,2,2,0,2.2230620456616944e-05,0.0,1.0
24947,head/Alpha,2,2,0,2.2230620456616944e-05,0.0,1.0
24948,혼수상태/Noun,2,0,2,0.0,2.2213830330763933e-05,1.0
24949,뇌속/Noun,2,0,2,0.0,2.2213830330763933e-05,1.0
24950,????????????????????????/Punctuation,2,0,2,0.0,2.2213830330763933e-05,1.0
24951,맹구/Noun,2,0,2,0.0,2.2213830330763933e-05,1.0
24952,곤지/Noun,2,2,0,2.2230620456616944e-05,0.0,1.0
24953,키즈/Noun,2,0,2,0.0,2.2213830330763933e-05,1.0
24954,헥토르/Noun,2,2,0,2.2230620456616944e-05,0.0,1.0
24955,갸륵해/Noun,2,0,2,0.0,2.2213830330763933e-05,1.0
24956,긔요미/Noun,2,2,0,2.2230620456616944e-05,0.0,1.0
24957,평졈/Noun,2,2,0,2.2230620456616944e-05,0.0,1.0
24958,용두/Noun,2,0,2,0.0,2.2213830330763933e-05,1.0
24959,마드리드/Noun,2,0,2,0.0,2.2213830330763933e-05,1.0
24960,일학년/Noun,2,0,2,0.0,2.2213830330763933e-05,1.0
24961,별처럼/Noun,2,2,0,2.2230620456616944e-05,0.0,1.0
24962,쌍용차/Noun,2,0,2,0.0,2.2213830330763933e-05,1.0
24963,출렁이다/Verb,2,2,0,2.2230620456616944e-05,0.0,1.0
24964,폐위/Noun,2,0,2,0.0,2.2213830330763933e-05,1.0
24965,사뿐하다/Adjective,2,2,0,2.2230620456616944e-05,0.0,1.0
24966,나긋나긋/Adverb,2,2,0,2.2230620456616944e-05,0.0,1.0
24967,이중주/Noun,2,2,0,2.2230620456616944e-05,0.0,1.0
24968,영부인/Noun,2,0,2,0.0,2.2213830330763933e-05,1.0
24969,향기도/Noun,2,0,2,0.0,2.2213830330763933e-05,1.0
24970,ㅋㄲ/KoreanParticle,2,0,2,0.0,2.2213830330763933e-05,1.0
24971,부호/Noun,2,0,2,0.0,2.2213830330763933e-05,1.0
24972,아어/Noun,2,0,2,0.0,2.2213830330763933e-05,1.0
24973,Three/Alpha,2,2,0,2.2230620456616944e-05,0.0,1.0
24974,갓집/Noun,2,0,2,0.0,2.2213830330763933e-05,1.0
24975,대화면/Noun,2,2,0,2.2230620456616944e-05,0.0,1.0
24976,고담/Noun,2,2,0,2.2230620456616944e-05,0.0,1.0
24977,건축학/Noun,2,2,0,2.2230620456616944e-05,0.0,1.0
24978,친후/Noun,2,0,2,0.0,2.2213830330763933e-05,1.0
24979,메소드연기/Noun,2,2,0,2.2230620456616944e-05,0.0,1.0
24980,송은희/Noun,2,0,2,0.0,2.2213830330763933e-05,1.0
24981,조영은/Noun,2,0,2,0.0,2.2213830330763933e-05,1.0
24982,JK/Alpha,2,0,2,0.0,2.2213830330763933e-05,1.0
24983,기연/Noun,2,0,2,0.0,2.2213830330763933e-05,1.0
24984,젤루/Noun,2,2,0,2.2230620456616944e-05,0.0,1.0
24985,못구/Noun,2,2,0,2.2230620456616944e-05,0.0,1.0
24986,조범/Noun,2,0,2,0.0,2.2213830330763933e-05,1.0
24987,피아제/Noun,2,0,2,0.0,2.2213830330763933e-05,1.0
24988,보셩/Noun,2,2,0,2.2230620456616944e-05,0.0,1.0
24989,%/Punctuation,2,2,0,2.2230620456616944e-05,0.0,1.0
24990,실크/Noun,2,2,0,2.2230620456616944e-05,0.0,1.0
24991,river/Alpha,2,2,0,2.2230620456616944e-05,0.0,1.0
24992,Moon/Alpha,2,2,0,2.2230620456616944e-05,0.0,1.0
24993,잡침/Noun,2,0,2,0.0,2.2213830330763933e-05,1.0
24994,금붕어/Noun,2,0,2,0.0,2.2213830330763933e-05,1.0
24995,잼있슴/Noun,2,2,0,2.2230620456616944e-05,0.0,1.0
24996,펑위옌/Noun,2,2,0,2.2230620456616944e-05,0.0,1.0
24997,가스통/Noun,2,0,2,0.0,2.2213830330763933e-05,1.0
24998,텔레비젼/Noun,2,2,0,2.2230620456616944e-05,0.0,1.0
24999,루치/Noun,2,2,0,2.2230620456616944e-05,0.0,1.0
25000,베르톨/Noun,2,2,0,2.2230620456616944e-05,0.0,1.0
25001,레지나/Noun,2,0,2,0.0,2.2213830330763933e-05,1.0
25002,시효/Noun,2,0,2,0.0,2.2213830330763933e-05,1.0
25003,길소뜸/Noun,2,0,2,0.0,2.2213830330763933e-05,1.0
25004,돌팔매/Noun,2,0,2,0.0,2.2213830330763933e-05,1.0
25005,!!!!!^^/Punctuation,2,2,0,2.2230620456616944e-05,0.0,1.0
25006,3억/Number,2,2,0,2.2230620456616944e-05,0.0,1.0
25007,sk/Alpha,2,0,2,0.0,2.2213830330763933e-05,1.0
25008,...*/Punctuation,2,2,0,2.2230620456616944e-05,0.0,1.0
25009,승승/Noun,2,0,2,0.0,2.2213830330763933e-05,1.0
25010,프로모션/Noun,2,0,2,0.0,2.2213830330763933e-05,1.0
25011,전수진/Noun,2,2,0,2.2230620456616944e-05,0.0,1.0
25012,쯤보다가/Foreign,2,0,2,0.0,2.2213830330763933e-05,1.0
25013,once/Alpha,2,2,0,2.2230620456616944e-05,0.0,1.0
25014,장난감총/Noun,2,0,2,0.0,2.2213830330763933e-05,1.0
25015,들락날락/Noun,2,0,2,0.0,2.2213830330763933e-05,1.0
25016,여론몰이/Noun,2,0,2,0.0,2.2213830330763933e-05,1.0
25017,임도/Noun,2,0,2,0.0,2.2213830330763933e-05,1.0
25018,세코/Noun,2,2,0,2.2230620456616944e-05,0.0,1.0
25019,갓미넴/Noun,2,2,0,2.2230620456616944e-05,0.0,1.0
25020,무역/Noun,2,2,0,2.2230620456616944e-05,0.0,1.0
25021,run/Alpha,2,2,0,2.2230620456616944e-05,0.0,1.0
25022,˚/Foreign,2,2,0,2.2230620456616944e-05,0.0,1.0
25023,＼/Foreign,2,2,0,2.2230620456616944e-05,0.0,1.0
25024,(^.^/Punctuation,2,2,0,2.2230620456616944e-05,0.0,1.0
25025,여간/Noun,2,0,2,0.0,2.2213830330763933e-05,1.0
25026,안소희/Noun,2,0,2,0.0,2.2213830330763933e-05,1.0
25027,www/Alpha,2,2,0,2.2230620456616944e-05,0.0,1.0
25028,박신애/Noun,2,0,2,0.0,2.2213830330763933e-05,1.0
25029,북두의권/Noun,2,0,2,0.0,2.2213830330763933e-05,1.0
25030,대영제국/Noun,2,2,0,2.2230620456616944e-05,0.0,1.0
25031,프로게이머/Noun,2,2,0,2.2230620456616944e-05,0.0,1.0
25032,구보/Noun,2,0,2,0.0,2.2213830330763933e-05,1.0
25033,다누리/Noun,2,0,2,0.0,2.2213830330763933e-05,1.0
25034,에포닌/Noun,2,0,2,0.0,2.2213830330763933e-05,1.0
25035,한중/Noun,2,0,2,0.0,2.2213830330763933e-05,1.0
25036,점평/Noun,2,0,2,0.0,2.2213830330763933e-05,1.0
25037,병간호/Noun,2,0,2,0.0,2.2213830330763933e-05,1.0
25038,부라보/Noun,2,2,0,2.2230620456616944e-05,0.0,1.0
25039,개쓰랙/Noun,2,0,2,0.0,2.2213830330763933e-05,1.0
25040,땡초/Noun,2,0,2,0.0,2.2213830330763933e-05,1.0
25041,MJ/Alpha,2,0,2,0.0,2.2213830330763933e-05,1.0
25042,퍼뜩/Noun,2,0,2,0.0,2.2213830330763933e-05,1.0
25043,고스트쉽/Noun,2,0,2,0.0,2.2213830330763933e-05,1.0
25044,여한/Noun,2,2,0,2.2230620456616944e-05,0.0,1.0
25045,운스/Noun,2,2,0,2.2230620456616944e-05,0.0,1.0
25046,바운/Noun,2,2,0,2.2230620456616944e-05,0.0,1.0
25047,학번/Noun,2,2,0,2.2230620456616944e-05,0.0,1.0
25048,김용림/Noun,2,2,0,2.2230620456616944e-05,0.0,1.0
25049,이연두/Noun,2,0,2,0.0,2.2213830330763933e-05,1.0
25050,홀애비/Noun,2,0,2,0.0,2.2213830330763933e-05,1.0
25051,몽골인/Noun,2,2,0,2.2230620456616944e-05,0.0,1.0
25052,성주/Noun,2,0,2,0.0,2.2213830330763933e-05,1.0
25053,주얼리/Noun,2,0,2,0.0,2.2213830330763933e-05,1.0
25054,하프라이프/Noun,2,0,2,0.0,2.2213830330763933e-05,1.0
25055,shut/Alpha,2,0,2,0.0,2.2213830330763933e-05,1.0
25056,꿈결/Noun,2,2,0,2.2230620456616944e-05,0.0,1.0
25057,배위/Noun,2,2,0,2.2230620456616944e-05,0.0,1.0
25058,어중간/Noun,2,0,2,0.0,2.2213830330763933e-05,1.0
25059,?......../Punctuation,2,2,0,2.2230620456616944e-05,0.0,1.0
25060,압시/Noun,2,0,2,0.0,2.2213830330763933e-05,1.0
25061,요염/Noun,2,2,0,2.2230620456616944e-05,0.0,1.0
25062,멘체스터/Noun,2,0,2,0.0,2.2213830330763933e-05,1.0
25063,숑/Noun,2,0,2,0.0,2.2213830330763933e-05,1.0
25064,멋쩌/Noun,2,2,0,2.2230620456616944e-05,0.0,1.0
25065,풍년/Noun,2,0,2,0.0,2.2213830330763933e-05,1.0
25066,월슨/Noun,2,2,0,2.2230620456616944e-05,0.0,1.0
25067,병졸/Noun,2,0,2,0.0,2.2213830330763933e-05,1.0
25068,브래지어/Noun,2,0,2,0.0,2.2213830330763933e-05,1.0
25069,적국/Noun,2,0,2,0.0,2.2213830330763933e-05,1.0
25070,명을/Foreign,2,2,0,2.2230620456616944e-05,0.0,1.0
25071,핫바/Noun,2,0,2,0.0,2.2213830330763933e-05,1.0
25072,연관검색어/Noun,2,2,0,2.2230620456616944e-05,0.0,1.0
25073,그란트/Noun,2,2,0,2.2230620456616944e-05,0.0,1.0
25074,허버/Noun,2,2,0,2.2230620456616944e-05,0.0,1.0
25075,close/Alpha,2,2,0,2.2230620456616944e-05,0.0,1.0
25076,왜봣/Noun,2,0,2,0.0,2.2213830330763933e-05,1.0
25077,느낑/Noun,2,0,2,0.0,2.2213830330763933e-05,1.0
25078,밀스/Noun,2,2,0,2.2230620456616944e-05,0.0,1.0
25079,던컨/Noun,2,2,0,2.2230620456616944e-05,0.0,1.0
25080,자슥들/Noun,2,0,2,0.0,2.2213830330763933e-05,1.0
25081,지주/Noun,2,0,2,0.0,2.2213830330763933e-05,1.0
25082,시국/Noun,2,2,0,2.2230620456616944e-05,0.0,1.0
25083,낚였잖/Noun,2,0,2,0.0,2.2213830330763933e-05,1.0
25084,낙타/Noun,2,0,2,0.0,2.2213830330763933e-05,1.0
25085,선천/Noun,2,0,2,0.0,2.2213830330763933e-05,1.0
25086,고수만/Noun,2,0,2,0.0,2.2213830330763933e-05,1.0
25087,만오/Noun,2,0,2,0.0,2.2213830330763933e-05,1.0
25088,야쿠쇼/Noun,2,2,0,2.2230620456616944e-05,0.0,1.0
25089,모의고사/Noun,2,2,0,2.2230620456616944e-05,0.0,1.0
25090,군수/Noun,2,0,2,0.0,2.2213830330763933e-05,1.0
25091,성형미인/Noun,2,0,2,0.0,2.2213830330763933e-05,1.0
25092,이기자/Noun,2,0,2,0.0,2.2213830330763933e-05,1.0
25093,했드/Noun,2,0,2,0.0,2.2213830330763933e-05,1.0
25094,드봉/Noun,2,0,2,0.0,2.2213830330763933e-05,1.0
25095,돌쇠/Noun,2,2,0,2.2230620456616944e-05,0.0,1.0
25096,.....*^^*/Punctuation,2,2,0,2.2230620456616944e-05,0.0,1.0
25097,지단/Noun,2,2,0,2.2230620456616944e-05,0.0,1.0
25098,처용/Noun,2,0,2,0.0,2.2213830330763933e-05,1.0
25099,hate/Alpha,2,2,0,2.2230620456616944e-05,0.0,1.0
25100,생략도/Noun,2,0,2,0.0,2.2213830330763933e-05,1.0
25101,김씨표류기/Noun,2,2,0,2.2230620456616944e-05,0.0,1.0
25102,찌마/Noun,2,0,2,0.0,2.2213830330763933e-05,1.0
25103,항암제/Noun,2,0,2,0.0,2.2213830330763933e-05,1.0
25104,복창/Noun,2,0,2,0.0,2.2213830330763933e-05,1.0
25105,커피프린스/Noun,2,2,0,2.2230620456616944e-05,0.0,1.0
25106,퐈이팅/Noun,2,2,0,2.2230620456616944e-05,0.0,1.0
25107,히든카드/Noun,2,0,2,0.0,2.2213830330763933e-05,1.0
25108,쌍꺼풀/Noun,2,0,2,0.0,2.2213830330763933e-05,1.0
25109,이게므/Noun,2,0,2,0.0,2.2213830330763933e-05,1.0
25110,아반떼/Noun,2,0,2,0.0,2.2213830330763933e-05,1.0
25111,최곤/Noun,2,2,0,2.2230620456616944e-05,0.0,1.0
25112,윤회사상/Noun,2,2,0,2.2230620456616944e-05,0.0,1.0
25113,北/Foreign,2,0,2,0.0,2.2213830330763933e-05,1.0
25114,change/Alpha,2,2,0,2.2230620456616944e-05,0.0,1.0
25115,이동현/Noun,2,0,2,0.0,2.2213830330763933e-05,1.0
25116,정도보다가/Foreign,2,0,2,0.0,2.2213830330763933e-05,1.0
25117,rate/Alpha,2,0,2,0.0,2.2213830330763933e-05,1.0
25118,로켄/Noun,2,0,2,0.0,2.2213830330763933e-05,1.0
25119,건네주다/Verb,2,0,2,0.0,2.2213830330763933e-05,1.0
25120,전여친/Noun,2,0,2,0.0,2.2213830330763933e-05,1.0
25121,전남친/Noun,2,0,2,0.0,2.2213830330763933e-05,1.0
25122,잼밌/Noun,2,2,0,2.2230620456616944e-05,0.0,1.0
25123,~@/Punctuation,2,2,0,2.2230620456616944e-05,0.0,1.0
25124,고제/Noun,2,2,0,2.2230620456616944e-05,0.0,1.0
25125,broken/Alpha,2,2,0,2.2230620456616944e-05,0.0,1.0
25126,중간계/Noun,2,2,0,2.2230620456616944e-05,0.0,1.0
25127,가금/Noun,2,2,0,2.2230620456616944e-05,0.0,1.0
25128,romance/Alpha,2,2,0,2.2230620456616944e-05,0.0,1.0
25129,2014.11/Number,2,0,2,0.0,2.2213830330763933e-05,1.0
25130,펭이/Noun,2,2,0,2.2230620456616944e-05,0.0,1.0
25131,애널/Noun,2,0,2,0.0,2.2213830330763933e-05,1.0
25132,정인엽/Noun,2,0,2,0.0,2.2213830330763933e-05,1.0
25133,눈배렸다/Noun,2,0,2,0.0,2.2213830330763933e-05,1.0
25134,존추/Noun,2,0,2,0.0,2.2213830330763933e-05,1.0
25135,핸섬슈트/Noun,2,0,2,0.0,2.2213830330763933e-05,1.0
25136,^*)//Punctuation,2,2,0,2.2230620456616944e-05,0.0,1.0
25137,♥＼/Foreign,2,2,0,2.2230620456616944e-05,0.0,1.0
25138,겹겹이/Noun,2,0,2,0.0,2.2213830330763933e-05,1.0
25139,더블에이/Noun,2,0,2,0.0,2.2213830330763933e-05,1.0
25140,단도/Noun,2,2,0,2.2230620456616944e-05,0.0,1.0
25141,얼추/Noun,2,0,2,0.0,2.2213830330763933e-05,1.0
25142,에쿠/Exclamation,2,0,2,0.0,2.2213830330763933e-05,1.0
25143,미림/Noun,2,2,0,2.2230620456616944e-05,0.0,1.0
25144,빵꾸똥꾸/Noun,2,0,2,0.0,2.2213830330763933e-05,1.0
25145,웬즈데이/Noun,2,2,0,2.2230620456616944e-05,0.0,1.0
25146,미팅/Noun,2,2,0,2.2230620456616944e-05,0.0,1.0
25147,메이크/Noun,2,2,0,2.2230620456616944e-05,0.0,1.0
25148,냉엄/Noun,2,2,0,2.2230620456616944e-05,0.0,1.0
25149,귀부인/Noun,2,0,2,0.0,2.2213830330763933e-05,1.0
25150,Born/Alpha,2,2,0,2.2230620456616944e-05,0.0,1.0
25151,도요토미/Noun,2,2,0,2.2230620456616944e-05,0.0,1.0
25152,명시/Noun,2,2,0,2.2230620456616944e-05,0.0,1.0
25153,1992/Number,2,0,2,0.0,2.2213830330763933e-05,1.0
25154,제재/Noun,2,0,2,0.0,2.2213830330763933e-05,1.0
25155,이창훈/Noun,2,2,0,2.2230620456616944e-05,0.0,1.0
25156,watching/Alpha,2,2,0,2.2230620456616944e-05,0.0,1.0
25157,남창/Noun,2,0,2,0.0,2.2213830330763933e-05,1.0
25158,박휘순/Noun,2,0,2,0.0,2.2213830330763933e-05,1.0
25159,내에/Foreign,2,0,2,0.0,2.2213830330763933e-05,1.0
25160,존대/Noun,2,0,2,0.0,2.2213830330763933e-05,1.0
25161,스워드/Noun,2,0,2,0.0,2.2213830330763933e-05,1.0
25162,리징/Noun,2,2,0,2.2230620456616944e-05,0.0,1.0
25163,상함/Noun,2,0,2,0.0,2.2213830330763933e-05,1.0
25164,끙끙/Noun,2,2,0,2.2230620456616944e-05,0.0,1.0
25165,불끌때/Noun,2,0,2,0.0,2.2213830330763933e-05,1.0
25166,둑/Noun,2,0,2,0.0,2.2213830330763933e-05,1.0
25167,들들/Adverb,2,2,0,2.2230620456616944e-05,0.0,1.0
25168,태진/Noun,2,0,2,0.0,2.2213830330763933e-05,1.0
25169,천재신/Noun,2,2,0,2.2230620456616944e-05,0.0,1.0
25170,운율/Noun,2,2,0,2.2230620456616944e-05,0.0,1.0
25171,윤기준/Noun,2,2,0,2.2230620456616944e-05,0.0,1.0
25172,래서야/Noun,2,0,2,0.0,2.2213830330763933e-05,1.0
25173,심부름/Noun,2,0,2,0.0,2.2213830330763933e-05,1.0
25174,서수민/Noun,2,0,2,0.0,2.2213830330763933e-05,1.0
25175,술탄/Noun,2,0,2,0.0,2.2213830330763933e-05,1.0
25176,발보아/Noun,2,2,0,2.2230620456616944e-05,0.0,1.0
25177,쿠파/Noun,2,0,2,0.0,2.2213830330763933e-05,1.0
25178,직빵/Noun,2,0,2,0.0,2.2213830330763933e-05,1.0
25179,불친절/Noun,2,0,2,0.0,2.2213830330763933e-05,1.0
25180,70원/Number,2,0,2,0.0,2.2213830330763933e-05,1.0
25181,피부관리/Noun,2,0,2,0.0,2.2213830330763933e-05,1.0
25182,대리모/Noun,2,0,2,0.0,2.2213830330763933e-05,1.0
25183,은씨/Noun,2,2,0,2.2230620456616944e-05,0.0,1.0
25184,쩌름/Noun,2,2,0,2.2230620456616944e-05,0.0,1.0
25185,봉구/Noun,2,0,2,0.0,2.2213830330763933e-05,1.0
25186,볼날/Noun,2,2,0,2.2230620456616944e-05,0.0,1.0
25187,단박/Noun,2,0,2,0.0,2.2213830330763933e-05,1.0
25188,용왕/Noun,2,2,0,2.2230620456616944e-05,0.0,1.0
25189,강박장애/Noun,2,2,0,2.2230620456616944e-05,0.0,1.0
25190,더망작/Noun,2,0,2,0.0,2.2213830330763933e-05,1.0
25191,총살/Noun,2,2,0,2.2230620456616944e-05,0.0,1.0
25192,구준/Noun,2,0,2,0.0,2.2213830330763933e-05,1.0
25193,단기/Noun,2,0,2,0.0,2.2213830330763933e-05,1.0
25194,난만하다/Adjective,2,2,0,2.2230620456616944e-05,0.0,1.0
25195,상모/Noun,2,2,0,2.2230620456616944e-05,0.0,1.0
25196,텐슨/Noun,2,2,0,2.2230620456616944e-05,0.0,1.0
25197,캘리포니아/Noun,2,0,2,0.0,2.2213830330763933e-05,1.0
25198,키류/Noun,2,2,0,2.2230620456616944e-05,0.0,1.0
25199,노유정/Noun,2,2,0,2.2230620456616944e-05,0.0,1.0
25200,still/Alpha,2,2,0,2.2230620456616944e-05,0.0,1.0
25201,메로엣타/Noun,2,2,0,2.2230620456616944e-05,0.0,1.0
25202,부천역/Noun,2,0,2,0.0,2.2213830330763933e-05,1.0
25203,급행/Noun,2,0,2,0.0,2.2213830330763933e-05,1.0
25204,5만/Number,2,0,2,0.0,2.2213830330763933e-05,1.0
25205,그랜토리노/Noun,2,2,0,2.2230620456616944e-05,0.0,1.0
25206,사노타/Noun,2,2,0,2.2230620456616944e-05,0.0,1.0
25207,너절하다/Adjective,2,0,2,0.0,2.2213830330763933e-05,1.0
25208,엿다/Noun,2,2,0,2.2230620456616944e-05,0.0,1.0
25209,필욘/Noun,2,0,2,0.0,2.2213830330763933e-05,1.0
25210,항소/Noun,2,0,2,0.0,2.2213830330763933e-05,1.0
25211,몽키즈/Noun,2,0,2,0.0,2.2213830330763933e-05,1.0
25212,.....!/Punctuation,2,2,0,2.2230620456616944e-05,0.0,1.0
25213,오승아/Noun,2,2,0,2.2230620456616944e-05,0.0,1.0
25214,sign/Alpha,2,0,2,0.0,2.2213830330763933e-05,1.0
25215,ah/Alpha,2,0,2,0.0,2.2213830330763933e-05,1.0
25216,그린피스/Noun,2,0,2,0.0,2.2213830330763933e-05,1.0
25217,tu/Alpha,2,2,0,2.2230620456616944e-05,0.0,1.0
25218,~@@/Punctuation,2,2,0,2.2230620456616944e-05,0.0,1.0
25219,상회/Noun,2,2,0,2.2230620456616944e-05,0.0,1.0
25220,찡찡대다/Verb,2,0,2,0.0,2.2213830330763933e-05,1.0
25221,물소/Noun,2,0,2,0.0,2.2213830330763933e-05,1.0
25222,데몬/Noun,2,2,0,2.2230620456616944e-05,0.0,1.0
25223,밸붕/Noun,2,2,0,2.2230620456616944e-05,0.0,1.0
25224,펜싱/Noun,2,0,2,0.0,2.2213830330763933e-05,1.0
25225,영화대본/Noun,2,0,2,0.0,2.2213830330763933e-05,1.0
25226,신봉선/Noun,2,0,2,0.0,2.2213830330763933e-05,1.0
25227,바주카포/Noun,2,0,2,0.0,2.2213830330763933e-05,1.0
25228,비강/Noun,2,0,2,0.0,2.2213830330763933e-05,1.0
25229,수근/Noun,2,0,2,0.0,2.2213830330763933e-05,1.0
25230,냐옹/Noun,2,2,0,2.2230620456616944e-05,0.0,1.0
25231,미연/Noun,2,2,0,2.2230620456616944e-05,0.0,1.0
25232,중고나라/Noun,2,0,2,0.0,2.2213830330763933e-05,1.0
25233,ㅅㅂㅋㅋㅋ/KoreanParticle,2,0,2,0.0,2.2213830330763933e-05,1.0
25234,손잡이/Noun,2,0,2,0.0,2.2213830330763933e-05,1.0
25235,종북세력/Noun,2,0,2,0.0,2.2213830330763933e-05,1.0
25236,147분/Number,2,0,2,0.0,2.2213830330763933e-05,1.0
25237,승도/Noun,2,0,2,0.0,2.2213830330763933e-05,1.0
25238,거른/Noun,2,0,2,0.0,2.2213830330763933e-05,1.0
25239,백발백중/Noun,2,0,2,0.0,2.2213830330763933e-05,1.0
25240,장자연/Noun,2,0,2,0.0,2.2213830330763933e-05,1.0
25241,스토리보드/Noun,2,0,2,0.0,2.2213830330763933e-05,1.0
25242,시험관/Noun,2,0,2,0.0,2.2213830330763933e-05,1.0
25243,부르조아/Noun,2,0,2,0.0,2.2213830330763933e-05,1.0
25244,요명/Noun,2,2,0,2.2230620456616944e-05,0.0,1.0
25245,우는남자/Noun,2,0,2,0.0,2.2213830330763933e-05,1.0
25246,병정/Noun,2,0,2,0.0,2.2213830330763933e-05,1.0
25247,임하룡/Noun,2,0,2,0.0,2.2213830330763933e-05,1.0
25248,한역/Noun,2,0,2,0.0,2.2213830330763933e-05,1.0
25249,선우선/Noun,2,0,2,0.0,2.2213830330763933e-05,1.0
25250,맞붙다/Verb,2,2,0,2.2230620456616944e-05,0.0,1.0
25251,꽃잎/Noun,2,2,0,2.2230620456616944e-05,0.0,1.0
25252,아둥바둥/Noun,2,0,2,0.0,2.2213830330763933e-05,1.0
25253,스쿠루/Noun,2,2,0,2.2230620456616944e-05,0.0,1.0
25254,파노라마/Noun,2,2,0,2.2230620456616944e-05,0.0,1.0
25255,메가마인드/Noun,2,0,2,0.0,2.2213830330763933e-05,1.0
25256,돌싱/Noun,2,2,0,2.2230620456616944e-05,0.0,1.0
25257,론도/Noun,2,0,2,0.0,2.2213830330763933e-05,1.0
25258,김병욱/Noun,2,2,0,2.2230620456616944e-05,0.0,1.0
25259,凸/Foreign,2,0,2,0.0,2.2213830330763933e-05,1.0
25260,스팍/Noun,2,2,0,2.2230620456616944e-05,0.0,1.0
25261,부득불/Noun,2,2,0,2.2230620456616944e-05,0.0,1.0
25262,성우란/Noun,2,0,2,0.0,2.2213830330763933e-05,1.0
25263,가글/Noun,2,0,2,0.0,2.2213830330763933e-05,1.0
25264,뻑감/Noun,2,2,0,2.2230620456616944e-05,0.0,1.0
25265,닥터깽/Noun,2,2,0,2.2230620456616944e-05,0.0,1.0
25266,잼읍/Noun,2,0,2,0.0,2.2213830330763933e-05,1.0
25267,학교물/Noun,2,0,2,0.0,2.2213830330763933e-05,1.0
25268,유포/Noun,2,2,0,2.2230620456616944e-05,0.0,1.0
25269,특별나다/Adjective,2,0,2,0.0,2.2213830330763933e-05,1.0
25270,스쿼드/Noun,2,2,0,2.2230620456616944e-05,0.0,1.0
25271,내성천/Noun,2,2,0,2.2230620456616944e-05,0.0,1.0
25272,쟤내/Noun,2,2,0,2.2230620456616944e-05,0.0,1.0
25273,별일/Noun,2,2,0,2.2230620456616944e-05,0.0,1.0
25274,징거/Noun,2,0,2,0.0,2.2213830330763933e-05,1.0
25275,머싯어/Noun,2,2,0,2.2230620456616944e-05,0.0,1.0
25276,오리엔트/Noun,2,2,0,2.2230620456616944e-05,0.0,1.0
25277,둘때/Noun,2,0,2,0.0,2.2213830330763933e-05,1.0
25278,몸싸움/Noun,2,0,2,0.0,2.2213830330763933e-05,1.0
25279,점말/Noun,2,2,0,2.2230620456616944e-05,0.0,1.0
25280,중국공산당/Noun,2,0,2,0.0,2.2213830330763933e-05,1.0
25281,사요나라/Noun,2,0,2,0.0,2.2213830330763933e-05,1.0
25282,시해/Noun,2,0,2,0.0,2.2213830330763933e-05,1.0
25283,안젤로/Noun,2,2,0,2.2230620456616944e-05,0.0,1.0
25284,준희/Noun,2,2,0,2.2230620456616944e-05,0.0,1.0
25285,그린우드/Noun,2,2,0,2.2230620456616944e-05,0.0,1.0
25286,헨델/Noun,2,2,0,2.2230620456616944e-05,0.0,1.0
25287,봉미/Noun,2,2,0,2.2230620456616944e-05,0.0,1.0
25288,뇌출혈/Noun,2,0,2,0.0,2.2213830330763933e-05,1.0
25289,광대뼈/Noun,2,0,2,0.0,2.2213830330763933e-05,1.0
25290,절감/Noun,2,0,2,0.0,2.2213830330763933e-05,1.0
25291,2.2만/Number,2,0,2,0.0,2.2213830330763933e-05,1.0
25292,생사람/Noun,2,2,0,2.2230620456616944e-05,0.0,1.0
25293,홀릭하/Noun,2,2,0,2.2230620456616944e-05,0.0,1.0
25294,갉아먹다/Verb,2,0,2,0.0,2.2213830330763933e-05,1.0
25295,끼린/Noun,2,0,2,0.0,2.2213830330763933e-05,1.0
25296,살맛/Noun,2,2,0,2.2230620456616944e-05,0.0,1.0
25297,전이라면/Foreign,2,0,2,0.0,2.2213830330763933e-05,1.0
25298,Carnahan/Alpha,2,2,0,2.2230620456616944e-05,0.0,1.0
25299,Joe/Alpha,2,2,0,2.2230620456616944e-05,0.0,1.0
25300,황금시대/Noun,2,2,0,2.2230620456616944e-05,0.0,1.0
25301,fighing/Alpha,2,2,0,2.2230620456616944e-05,0.0,1.0
25302,hoo/Alpha,2,2,0,2.2230620456616944e-05,0.0,1.0
25303,si/Alpha,2,2,0,2.2230620456616944e-05,0.0,1.0
25304,도둑고양이/Noun,2,0,2,0.0,2.2213830330763933e-05,1.0
25305,비역/Noun,2,0,2,0.0,2.2213830330763933e-05,1.0
25306,배철수/Noun,2,0,2,0.0,2.2213830330763933e-05,1.0
25307,쫑긋/Noun,2,2,0,2.2230620456616944e-05,0.0,1.0
25308,95/Number,2,2,0,2.2230620456616944e-05,0.0,1.0
25309,딴지걸/Noun,2,0,2,0.0,2.2213830330763933e-05,1.0
25310,잡아넣다/Verb,2,0,2,0.0,2.2213830330763933e-05,1.0
25311,알맹/Noun,2,0,2,0.0,2.2213830330763933e-05,1.0
25312,추심/Noun,2,0,2,0.0,2.2213830330763933e-05,1.0
25313,혹성/Noun,2,0,2,0.0,2.2213830330763933e-05,1.0
25314,그케/Noun,2,0,2,0.0,2.2213830330763933e-05,1.0
25315,탱자/Noun,2,0,2,0.0,2.2213830330763933e-05,1.0
25316,놀랏다/Noun,2,0,2,0.0,2.2213830330763933e-05,1.0
25317,혈청/Noun,2,0,2,0.0,2.2213830330763933e-05,1.0
25318,6.2/Number,2,0,2,0.0,2.2213830330763933e-05,1.0
25319,아비정전/Noun,2,0,2,0.0,2.2213830330763933e-05,1.0
25320,정법/Noun,2,0,2,0.0,2.2213830330763933e-05,1.0
25321,식탐/Noun,2,0,2,0.0,2.2213830330763933e-05,1.0
25322,관심병사/Noun,2,2,0,2.2230620456616944e-05,0.0,1.0
25323,Believe/Alpha,2,2,0,2.2230620456616944e-05,0.0,1.0
25324,아시안/Noun,2,0,2,0.0,2.2213830330763933e-05,1.0
25325,~=_=/Punctuation,2,0,2,0.0,2.2213830330763933e-05,1.0
25326,신검/Noun,2,0,2,0.0,2.2213830330763933e-05,1.0
25327,5만원/Number,2,2,0,2.2230620456616944e-05,0.0,1.0
25328,괴고/Noun,2,2,0,2.2230620456616944e-05,0.0,1.0
25329,이왕이면/Noun,2,2,0,2.2230620456616944e-05,0.0,1.0
25330,도웁시/Noun,2,0,2,0.0,2.2213830330763933e-05,1.0
25331,트랜스모퍼/Noun,2,0,2,0.0,2.2213830330763933e-05,1.0
25332,스캐너/Noun,2,2,0,2.2230620456616944e-05,0.0,1.0
25333,0.0001/Number,2,0,2,0.0,2.2213830330763933e-05,1.0
25334,굿나잇/Noun,2,0,2,0.0,2.2213830330763933e-05,1.0
25335,짙어지다/Verb,2,2,0,2.2230620456616944e-05,0.0,1.0
25336,토레스/Noun,2,0,2,0.0,2.2213830330763933e-05,1.0
25337,한수연/Noun,2,2,0,2.2230620456616944e-05,0.0,1.0
25338,골동품/Noun,2,2,0,2.2230620456616944e-05,0.0,1.0
25339,동공/Noun,2,2,0,2.2230620456616944e-05,0.0,1.0
25340,쳥/Noun,2,0,2,0.0,2.2213830330763933e-05,1.0
25341,childish/Alpha,2,0,2,0.0,2.2213830330763933e-05,1.0
25342,우주기지/Noun,2,0,2,0.0,2.2213830330763933e-05,1.0
25343,백과사전/Noun,2,0,2,0.0,2.2213830330763933e-05,1.0
25344,쿠니/Noun,2,2,0,2.2230620456616944e-05,0.0,1.0
25345,살아생전/Noun,2,2,0,2.2230620456616944e-05,0.0,1.0
25346,25일/Number,2,2,0,2.2230620456616944e-05,0.0,1.0
25347,대왕의꿈/Noun,2,0,2,0.0,2.2213830330763933e-05,1.0
25348,고혈/Noun,2,0,2,0.0,2.2213830330763933e-05,1.0
25349,여걸/Noun,2,0,2,0.0,2.2213830330763933e-05,1.0
25350,치켜들다/Verb,2,2,0,2.2230620456616944e-05,0.0,1.0
25351,복태/Noun,2,2,0,2.2230620456616944e-05,0.0,1.0
25352,어드벤쳐영화/Noun,2,2,0,2.2230620456616944e-05,0.0,1.0
25353,통달/Noun,2,2,0,2.2230620456616944e-05,0.0,1.0
25354,에일리/Noun,2,2,0,2.2230620456616944e-05,0.0,1.0
25355,우주비행사/Noun,2,2,0,2.2230620456616944e-05,0.0,1.0
25356,작이라/Foreign,2,2,0,2.2230620456616944e-05,0.0,1.0
25357,짱구는못말려/Noun,2,2,0,2.2230620456616944e-05,0.0,1.0
25358,우영/Noun,2,2,0,2.2230620456616944e-05,0.0,1.0
25359,didn/Alpha,2,2,0,2.2230620456616944e-05,0.0,1.0
25360,하고야/Josa,2,0,2,0.0,2.2213830330763933e-05,1.0
25361,나올런/Noun,2,2,0,2.2230620456616944e-05,0.0,1.0
25362,재석/Noun,2,2,0,2.2230620456616944e-05,0.0,1.0
25363,오일/Noun,2,2,0,2.2230620456616944e-05,0.0,1.0
25364,레이더스/Noun,2,0,2,0.0,2.2213830330763933e-05,1.0
25365,세남자/Noun,2,0,2,0.0,2.2213830330763933e-05,1.0
25366,가수만/Noun,2,0,2,0.0,2.2213830330763933e-05,1.0
25367,시끌벅적하다/Adjective,2,2,0,2.2230620456616944e-05,0.0,1.0
25368,구성지다/Adjective,2,2,0,2.2230620456616944e-05,0.0,1.0
25369,OOOOOOO/Alpha,2,0,2,0.0,2.2213830330763933e-05,1.0
25370,연등/Noun,2,0,2,0.0,2.2213830330763933e-05,1.0
25371,뚝배기/Noun,2,2,0,2.2230620456616944e-05,0.0,1.0
25372,완적/Noun,2,0,2,0.0,2.2213830330763933e-05,1.0
25373,싹뚝/Noun,2,0,2,0.0,2.2213830330763933e-05,1.0
25374,Jesus/Alpha,2,2,0,2.2230620456616944e-05,0.0,1.0
25375,ㅐㅐㅐ/KoreanParticle,2,2,0,2.2230620456616944e-05,0.0,1.0
25376,ㅅㅁ/KoreanParticle,2,0,2,0.0,2.2213830330763933e-05,1.0
25377,조흔파/Noun,2,2,0,2.2230620456616944e-05,0.0,1.0
25378,이스터/Noun,2,2,0,2.2230620456616944e-05,0.0,1.0
25379,개빠/Noun,2,0,2,0.0,2.2213830330763933e-05,1.0
25380,꼴좀/Noun,2,0,2,0.0,2.2213830330763933e-05,1.0
25381,정신의학/Noun,2,0,2,0.0,2.2213830330763933e-05,1.0
25382,로멘틱코메디/Noun,2,2,0,2.2230620456616944e-05,0.0,1.0
25383,힝힝/Noun,2,2,0,2.2230620456616944e-05,0.0,1.0
25384,맹점/Noun,2,0,2,0.0,2.2213830330763933e-05,1.0
25385,무치다/Verb,2,0,2,0.0,2.2213830330763933e-05,1.0
25386,고양원더스/Noun,2,2,0,2.2230620456616944e-05,0.0,1.0
25387,다공/Noun,2,0,2,0.0,2.2213830330763933e-05,1.0
25388,머글/Noun,2,0,2,0.0,2.2213830330763933e-05,1.0
25389,토레/Noun,2,0,2,0.0,2.2213830330763933e-05,1.0
25390,디엔드/Noun,2,0,2,0.0,2.2213830330763933e-05,1.0
25391,낙후/Noun,2,0,2,0.0,2.2213830330763933e-05,1.0
25392,완정/Noun,2,2,0,2.2230620456616944e-05,0.0,1.0
25393,어오/Noun,2,0,2,0.0,2.2213830330763933e-05,1.0
25394,코코몽/Noun,2,2,0,2.2230620456616944e-05,0.0,1.0
25395,56년/Number,2,2,0,2.2230620456616944e-05,0.0,1.0
25396,산태/Noun,2,0,2,0.0,2.2213830330763933e-05,1.0
25397,희곡/Noun,2,2,0,2.2230620456616944e-05,0.0,1.0
25398,도랏멘/Noun,2,0,2,0.0,2.2213830330763933e-05,1.0
25399,장성/Noun,2,0,2,0.0,2.2213830330763933e-05,1.0
25400,산악인/Noun,2,2,0,2.2230620456616944e-05,0.0,1.0
25401,비일/Noun,2,2,0,2.2230620456616944e-05,0.0,1.0
25402,레터/Noun,2,0,2,0.0,2.2213830330763933e-05,1.0
25403,쁜/Noun,2,0,2,0.0,2.2213830330763933e-05,1.0
25404,뭘더/Noun,2,2,0,2.2230620456616944e-05,0.0,1.0
25405,이아주/Noun,2,2,0,2.2230620456616944e-05,0.0,1.0
25406,어쩌누/Noun,2,0,2,0.0,2.2213830330763933e-05,1.0
25407,김대우/Noun,2,2,0,2.2230620456616944e-05,0.0,1.0
25408,썻는데/Noun,2,0,2,0.0,2.2213830330763933e-05,1.0
25409,평접/Noun,2,0,2,0.0,2.2213830330763933e-05,1.0
25410,암스테르담/Noun,2,2,0,2.2230620456616944e-05,0.0,1.0
25411,공구/Noun,2,0,2,0.0,2.2213830330763933e-05,1.0
25412,JFK/Alpha,2,2,0,2.2230620456616944e-05,0.0,1.0
25413,혜진/Noun,2,0,2,0.0,2.2213830330763933e-05,1.0
25414,심쿵심쿵/Noun,2,2,0,2.2230620456616944e-05,0.0,1.0
25415,요미/Noun,2,2,0,2.2230620456616944e-05,0.0,1.0
25416,리진/Noun,2,2,0,2.2230620456616944e-05,0.0,1.0
25417,베프/Noun,2,0,2,0.0,2.2213830330763933e-05,1.0
25418,우중/Noun,2,2,0,2.2230620456616944e-05,0.0,1.0
25419,가디언/Noun,2,2,0,2.2230620456616944e-05,0.0,1.0
25420,스나이핑/Noun,2,0,2,0.0,2.2213830330763933e-05,1.0
25421,왜만들엇냐/Noun,2,0,2,0.0,2.2213830330763933e-05,1.0
25422,┏/Foreign,2,0,2,0.0,2.2213830330763933e-05,1.0
25423,자극제/Noun,2,2,0,2.2230620456616944e-05,0.0,1.0
25424,경전/Noun,2,2,0,2.2230620456616944e-05,0.0,1.0
25425,3천만달러/Number,2,2,0,2.2230620456616944e-05,0.0,1.0
25426,김태식/Noun,2,0,2,0.0,2.2213830330763933e-05,1.0
25427,허겁지겁/Noun,2,0,2,0.0,2.2213830330763933e-05,1.0
25428,원도/Noun,2,0,2,0.0,2.2213830330763933e-05,1.0
25429,행쇼/Noun,2,2,0,2.2230620456616944e-05,0.0,1.0
25430,6.77/Number,2,2,0,2.2230620456616944e-05,0.0,1.0
25431,.....-/Punctuation,2,0,2,0.0,2.2213830330763933e-05,1.0
25432,워터파크/Noun,2,0,2,0.0,2.2213830330763933e-05,1.0
25433,프리미어/Noun,2,0,2,0.0,2.2213830330763933e-05,1.0
25434,백건/Noun,2,0,2,0.0,2.2213830330763933e-05,1.0
25435,..[/Punctuation,2,0,2,0.0,2.2213830330763933e-05,1.0
25436,짝짝이/Noun,2,0,2,0.0,2.2213830330763933e-05,1.0
25437,사회인/Noun,2,2,0,2.2230620456616944e-05,0.0,1.0
25438,순직/Noun,2,2,0,2.2230620456616944e-05,0.0,1.0
25439,정마/Noun,2,2,0,2.2230620456616944e-05,0.0,1.0
25440,복숭아/Noun,2,0,2,0.0,2.2213830330763933e-05,1.0
25441,집문/Noun,2,0,2,0.0,2.2213830330763933e-05,1.0
25442,럽폭/Noun,2,0,2,0.0,2.2213830330763933e-05,1.0
25443,홍도/Noun,2,2,0,2.2230620456616944e-05,0.0,1.0
25444,조속/Noun,2,2,0,2.2230620456616944e-05,0.0,1.0
25445,곡예/Noun,2,0,2,0.0,2.2213830330763933e-05,1.0
25446,making/Alpha,2,0,2,0.0,2.2213830330763933e-05,1.0
25447,공용/Noun,2,0,2,0.0,2.2213830330763933e-05,1.0
25448,내게로/Noun,2,2,0,2.2230620456616944e-05,0.0,1.0
25449,더봄/Noun,2,2,0,2.2230620456616944e-05,0.0,1.0
25450,바운티/Noun,2,0,2,0.0,2.2213830330763933e-05,1.0
25451,신춘/Noun,2,0,2,0.0,2.2213830330763933e-05,1.0
25452,슬펏어/Noun,2,2,0,2.2230620456616944e-05,0.0,1.0
25453,어서어서/Noun,2,0,2,0.0,2.2213830330763933e-05,1.0
25454,처서/Noun,2,0,2,0.0,2.2213830330763933e-05,1.0
25455,벌렁벌렁/Adverb,2,0,2,0.0,2.2213830330763933e-05,1.0
25456,음색/Noun,2,2,0,2.2230620456616944e-05,0.0,1.0
25457,씐/Noun,2,2,0,2.2230620456616944e-05,0.0,1.0
25458,1원/Number,2,0,2,0.0,2.2213830330763933e-05,1.0
25459,걸림/Foreign,2,0,2,0.0,2.2213830330763933e-05,1.0
25460,카피라이트/Noun,2,0,2,0.0,2.2213830330763933e-05,1.0
25461,학당/Noun,2,0,2,0.0,2.2213830330763933e-05,1.0
25462,방중/Noun,2,0,2,0.0,2.2213830330763933e-05,1.0
25463,스필/Noun,2,2,0,2.2230620456616944e-05,0.0,1.0
25464,다락방/Noun,2,2,0,2.2230620456616944e-05,0.0,1.0
25465,애기야/Noun,2,2,0,2.2230620456616944e-05,0.0,1.0
25466,팩스톤/Noun,2,2,0,2.2230620456616944e-05,0.0,1.0
25467,흐느적/Noun,2,0,2,0.0,2.2213830330763933e-05,1.0
25468,마직/Noun,2,2,0,2.2230620456616944e-05,0.0,1.0
25469,++++/Punctuation,2,0,2,0.0,2.2213830330763933e-05,1.0
25470,이허/Noun,2,0,2,0.0,2.2213830330763933e-05,1.0
25471,고량주/Noun,2,2,0,2.2230620456616944e-05,0.0,1.0
25472,보따리/Noun,2,2,0,2.2230620456616944e-05,0.0,1.0
25473,눈배림/Noun,2,0,2,0.0,2.2213830330763933e-05,1.0
25474,zzzzzzzz/Alpha,2,0,2,0.0,2.2213830330763933e-05,1.0
25475,락웰/Noun,2,2,0,2.2230620456616944e-05,0.0,1.0
25476,월남/Noun,2,0,2,0.0,2.2213830330763933e-05,1.0
25477,도라애몽/Noun,2,2,0,2.2230620456616944e-05,0.0,1.0
25478,루하/Noun,2,0,2,0.0,2.2213830330763933e-05,1.0
25479,쥐꼬리/Noun,2,0,2,0.0,2.2213830330763933e-05,1.0
25480,작인/Foreign,2,0,2,0.0,2.2213830330763933e-05,1.0
25481,저물다/Verb,2,0,2,0.0,2.2213830330763933e-05,1.0
25482,밑에님말/Noun,2,0,2,0.0,2.2213830330763933e-05,1.0
25483,역적/Noun,2,0,2,0.0,2.2213830330763933e-05,1.0
25484,도라/Foreign,2,2,0,2.2230620456616944e-05,0.0,1.0
25485,봉안/Noun,2,2,0,2.2230620456616944e-05,0.0,1.0
25486,남주혁/Noun,2,2,0,2.2230620456616944e-05,0.0,1.0
25487,..-_/Punctuation,2,0,2,0.0,2.2213830330763933e-05,1.0
25488,부검/Noun,2,0,2,0.0,2.2213830330763933e-05,1.0
25489,호테/Noun,2,2,0,2.2230620456616944e-05,0.0,1.0
25490,~?!/Punctuation,2,2,0,2.2230620456616944e-05,0.0,1.0
25491,루치아/Noun,2,2,0,2.2230620456616944e-05,0.0,1.0
25492,난잼/Noun,2,2,0,2.2230620456616944e-05,0.0,1.0
25493,waste/Alpha,2,0,2,0.0,2.2213830330763933e-05,1.0
25494,노란색/Noun,2,2,0,2.2230620456616944e-05,0.0,1.0
25495,본당/Noun,2,0,2,0.0,2.2213830330763933e-05,1.0
25496,버클리/Noun,2,0,2,0.0,2.2213830330763933e-05,1.0
25497,노려보다/Verb,2,2,0,2.2230620456616944e-05,0.0,1.0
25498,밀랍/Noun,2,2,0,2.2230620456616944e-05,0.0,1.0
25499,오장육부/Noun,2,0,2,0.0,2.2213830330763933e-05,1.0
25500,글좀/Noun,2,2,0,2.2230620456616944e-05,0.0,1.0
25501,한경/Noun,2,0,2,0.0,2.2213830330763933e-05,1.0
25502,지윤/Noun,2,0,2,0.0,2.2213830330763933e-05,1.0
25503,테이텀/Noun,2,2,0,2.2230620456616944e-05,0.0,1.0
25504,거역/Noun,2,0,2,0.0,2.2213830330763933e-05,1.0
25505,노팅/Noun,2,0,2,0.0,2.2213830330763933e-05,1.0
25506,집년/Noun,2,0,2,0.0,2.2213830330763933e-05,1.0
25507,경민/Noun,2,2,0,2.2230620456616944e-05,0.0,1.0
25508,까투리/Noun,2,2,0,2.2230620456616944e-05,0.0,1.0
25509,.@_/ScreenName,2,2,0,2.2230620456616944e-05,0.0,1.0
25510,스릉/Noun,2,2,0,2.2230620456616944e-05,0.0,1.0
25511,부르트다/Verb,2,0,2,0.0,2.2213830330763933e-05,1.0
25512,고스트메신저/Noun,2,0,2,0.0,2.2213830330763933e-05,1.0
25513,발안/Noun,2,0,2,0.0,2.2213830330763933e-05,1.0
25514,석방/Noun,2,2,0,2.2230620456616944e-05,0.0,1.0
25515,양정/Noun,2,2,0,2.2230620456616944e-05,0.0,1.0
25516,렌토/Noun,2,2,0,2.2230620456616944e-05,0.0,1.0
25517,불건전/Noun,2,0,2,0.0,2.2213830330763933e-05,1.0
25518,흑백사진/Noun,2,2,0,2.2230620456616944e-05,0.0,1.0
25519,장화신은고양이/Noun,2,0,2,0.0,2.2213830330763933e-05,1.0
25520,난뭐/Noun,2,0,2,0.0,2.2213830330763933e-05,1.0
25521,돈처/Noun,2,0,2,0.0,2.2213830330763933e-05,1.0
25522,몸살/Noun,2,2,0,2.2230620456616944e-05,0.0,1.0
25523,백영규/Noun,2,2,0,2.2230620456616944e-05,0.0,1.0
25524,업햄/Noun,2,2,0,2.2230620456616944e-05,0.0,1.0
25525,본아이덴티티/Noun,2,2,0,2.2230620456616944e-05,0.0,1.0
25526,추후/Noun,2,2,0,2.2230620456616944e-05,0.0,1.0
25527,샌프란시스코/Noun,2,2,0,2.2230620456616944e-05,0.0,1.0
25528,자충수/Noun,2,0,2,0.0,2.2213830330763933e-05,1.0
25529,큐티/Noun,2,2,0,2.2230620456616944e-05,0.0,1.0
25530,찌찌뽕/Noun,2,0,2,0.0,2.2213830330763933e-05,1.0
25531,권투씬/Noun,2,0,2,0.0,2.2213830330763933e-05,1.0
25532,act/Alpha,2,0,2,0.0,2.2213830330763933e-05,1.0
25533,there/Alpha,2,2,0,2.2230620456616944e-05,0.0,1.0
25534,자슥/Noun,2,0,2,0.0,2.2213830330763933e-05,1.0
25535,팬됫음/Noun,2,2,0,2.2230620456616944e-05,0.0,1.0
25536,봤/Noun,2,0,2,0.0,2.2213830330763933e-05,1.0
25537,나빳어/Noun,2,2,0,2.2230620456616944e-05,0.0,1.0
25538,교신/Noun,2,2,0,2.2230620456616944e-05,0.0,1.0
25539,^^~~~/Punctuation,2,2,0,2.2230620456616944e-05,0.0,1.0
25540,금란/Noun,2,2,0,2.2230620456616944e-05,0.0,1.0
25541,김지환/Noun,2,0,2,0.0,2.2213830330763933e-05,1.0
25542,길강/Noun,2,2,0,2.2230620456616944e-05,0.0,1.0
25543,46%/Number,2,0,2,0.0,2.2213830330763933e-05,1.0
25544,형/Foreign,2,2,0,2.2230620456616944e-05,0.0,1.0
25545,김상석/Noun,2,2,0,2.2230620456616944e-05,0.0,1.0
25546,영롱하다/Adjective,2,2,0,2.2230620456616944e-05,0.0,1.0
25547,대항해시대/Noun,2,2,0,2.2230620456616944e-05,0.0,1.0
25548,군화/Noun,2,2,0,2.2230620456616944e-05,0.0,1.0
25549,에스퍼맨/Noun,2,2,0,2.2230620456616944e-05,0.0,1.0
25550,두레/Noun,2,2,0,2.2230620456616944e-05,0.0,1.0
25551,흥해/Noun,2,2,0,2.2230620456616944e-05,0.0,1.0
25552,박현진/Noun,2,0,2,0.0,2.2213830330763933e-05,1.0
25553,다크엔젤/Noun,2,2,0,2.2230620456616944e-05,0.0,1.0
25554,이필모/Noun,2,2,0,2.2230620456616944e-05,0.0,1.0
25555,마도카/Noun,2,2,0,2.2230620456616944e-05,0.0,1.0
25556,신덕/Noun,2,2,0,2.2230620456616944e-05,0.0,1.0
25557,pig/Alpha,2,2,0,2.2230620456616944e-05,0.0,1.0
25558,spider/Alpha,2,2,0,2.2230620456616944e-05,0.0,1.0
25559,강지영/Noun,2,2,0,2.2230620456616944e-05,0.0,1.0
25560,짝눈/Noun,2,2,0,2.2230620456616944e-05,0.0,1.0
25561,마초이즘/Noun,2,0,2,0.0,2.2213830330763933e-05,1.0
25562,주리다/Verb,2,2,0,2.2230620456616944e-05,0.0,1.0
25563,흉년/Noun,2,2,0,2.2230620456616944e-05,0.0,1.0
25564,싸이보그/Noun,2,0,2,0.0,2.2213830330763933e-05,1.0
25565,지언/Noun,2,0,2,0.0,2.2213830330763933e-05,1.0
25566,이상빈/Noun,2,0,2,0.0,2.2213830330763933e-05,1.0
25567,미식/Noun,2,0,2,0.0,2.2213830330763933e-05,1.0
25568,출장/Noun,2,0,2,0.0,2.2213830330763933e-05,1.0
25569,청사진/Noun,2,2,0,2.2230620456616944e-05,0.0,1.0
25570,른다/Noun,2,2,0,2.2230620456616944e-05,0.0,1.0
25571,신아/Noun,2,0,2,0.0,2.2213830330763933e-05,1.0
25572,삼륜차/Noun,2,2,0,2.2230620456616944e-05,0.0,1.0
25573,난립/Noun,2,0,2,0.0,2.2213830330763933e-05,1.0
25574,소춘/Noun,2,0,2,0.0,2.2213830330763933e-05,1.0
25575,오랬/Noun,2,2,0,2.2230620456616944e-05,0.0,1.0
25576,욕질/Noun,2,0,2,0.0,2.2213830330763933e-05,1.0
25577,허졉/Noun,2,0,2,0.0,2.2213830330763933e-05,1.0
25578,추월/Noun,2,2,0,2.2230620456616944e-05,0.0,1.0
25579,일확천금/Noun,2,0,2,0.0,2.2213830330763933e-05,1.0
25580,불후의명곡/Noun,2,0,2,0.0,2.2213830330763933e-05,1.0
25581,굿맨/Noun,2,2,0,2.2230620456616944e-05,0.0,1.0
25582,칸노/Noun,2,2,0,2.2230620456616944e-05,0.0,1.0
25583,데오퓨/Noun,2,2,0,2.2230620456616944e-05,0.0,1.0
25584,뭐병/Noun,2,0,2,0.0,2.2213830330763933e-05,1.0
25585,카르마/Noun,2,0,2,0.0,2.2213830330763933e-05,1.0
25586,잼엄슴/Noun,2,0,2,0.0,2.2213830330763933e-05,1.0
25587,팝핀/Noun,2,0,2,0.0,2.2213830330763933e-05,1.0
25588,절필/Noun,2,0,2,0.0,2.2213830330763933e-05,1.0
25589,청주/Noun,2,2,0,2.2230620456616944e-05,0.0,1.0
25590,from/Alpha,2,2,0,2.2230620456616944e-05,0.0,1.0
25591,could/Alpha,2,2,0,2.2230620456616944e-05,0.0,1.0
25592,뿡/Noun,2,0,2,0.0,2.2213830330763933e-05,1.0
25593,유권자/Noun,2,2,0,2.2230620456616944e-05,0.0,1.0
25594,신경숙/Noun,2,0,2,0.0,2.2213830330763933e-05,1.0
25595,환의/Noun,2,2,0,2.2230620456616944e-05,0.0,1.0
25596,안닌/Noun,2,2,0,2.2230620456616944e-05,0.0,1.0
25597,선지자/Noun,2,2,0,2.2230620456616944e-05,0.0,1.0
25598,토끼다/Verb,2,0,2,0.0,2.2213830330763933e-05,1.0
25599,야구단/Noun,2,2,0,2.2230620456616944e-05,0.0,1.0
25600,▶/Foreign,2,0,2,0.0,2.2213830330763933e-05,1.0
25601,더디츠/Noun,2,2,0,2.2230620456616944e-05,0.0,1.0
25602,남음/Noun,2,2,0,2.2230620456616944e-05,0.0,1.0
25603,~!!!!!!!!/Punctuation,2,2,0,2.2230620456616944e-05,0.0,1.0
25604,~&/Punctuation,2,2,0,2.2230620456616944e-05,0.0,1.0
25605,한길수/Noun,2,2,0,2.2230620456616944e-05,0.0,1.0
25606,폭언/Noun,2,0,2,0.0,2.2213830330763933e-05,1.0
25607,모간/Noun,2,2,0,2.2230620456616944e-05,0.0,1.0
25608,특수성/Noun,2,2,0,2.2230620456616944e-05,0.0,1.0
25609,액셕/Noun,2,0,2,0.0,2.2213830330763933e-05,1.0
25610,피우지/Noun,2,2,0,2.2230620456616944e-05,0.0,1.0
25611,불경/Noun,2,0,2,0.0,2.2213830330763933e-05,1.0
25612,알림/Noun,2,2,0,2.2230620456616944e-05,0.0,1.0
25613,요섭/Noun,2,2,0,2.2230620456616944e-05,0.0,1.0
25614,틀려지다/Verb,2,0,2,0.0,2.2213830330763933e-05,1.0
25615,발레리나/Noun,2,2,0,2.2230620456616944e-05,0.0,1.0
25616,깍지/Noun,2,2,0,2.2230620456616944e-05,0.0,1.0
25617,머신건/Noun,2,2,0,2.2230620456616944e-05,0.0,1.0
25618,불패/Noun,2,2,0,2.2230620456616944e-05,0.0,1.0
25619,이토히로부미/Noun,2,0,2,0.0,2.2213830330763933e-05,1.0
25620,캐나다인/Noun,2,2,0,2.2230620456616944e-05,0.0,1.0
25621,잘생겻/Noun,2,2,0,2.2230620456616944e-05,0.0,1.0
25622,마켓팅/Noun,2,0,2,0.0,2.2213830330763933e-05,1.0
25623,반창꼬/Noun,2,2,0,2.2230620456616944e-05,0.0,1.0
25624,허진/Noun,2,2,0,2.2230620456616944e-05,0.0,1.0
25625,조증/Noun,2,0,2,0.0,2.2213830330763933e-05,1.0
25626,쪼르르/Adverb,2,0,2,0.0,2.2213830330763933e-05,1.0
25627,44444/Number,2,0,2,0.0,2.2213830330763933e-05,1.0
25628,에스컬레이터/Noun,2,2,0,2.2230620456616944e-05,0.0,1.0
25629,1983/Number,2,2,0,2.2230620456616944e-05,0.0,1.0
25630,1978/Number,2,2,0,2.2230620456616944e-05,0.0,1.0
25631,)->/Punctuation,2,2,0,2.2230620456616944e-05,0.0,1.0
25632,맨트/Noun,2,0,2,0.0,2.2213830330763933e-05,1.0
25633,ㅡㅠㅠ/KoreanParticle,2,2,0,2.2230620456616944e-05,0.0,1.0
25634,굿윈/Noun,2,0,2,0.0,2.2213830330763933e-05,1.0
25635,3만원/Number,2,0,2,0.0,2.2213830330763933e-05,1.0
25636,본디지/Noun,2,2,0,2.2230620456616944e-05,0.0,1.0
25637,신포동/Noun,2,2,0,2.2230620456616944e-05,0.0,1.0
25638,손해배상/Noun,2,0,2,0.0,2.2213830330763933e-05,1.0
25639,이랑/Foreign,2,0,2,0.0,2.2213830330763933e-05,1.0
25640,4500원/Number,2,0,2,0.0,2.2213830330763933e-05,1.0
25641,빌리엘리어트/Noun,2,2,0,2.2230620456616944e-05,0.0,1.0
25642,분실/Noun,2,0,2,0.0,2.2213830330763933e-05,1.0
25643,택한건/Noun,2,0,2,0.0,2.2213830330763933e-05,1.0
25644,레닌그라드/Noun,2,2,0,2.2230620456616944e-05,0.0,1.0
25645,발놈/Noun,2,0,2,0.0,2.2213830330763933e-05,1.0
25646,은혼/Noun,2,2,0,2.2230620456616944e-05,0.0,1.0
25647,그을리다/Adjective,2,2,0,2.2230620456616944e-05,0.0,1.0
25648,김성주/Noun,2,0,2,0.0,2.2213830330763933e-05,1.0
25649,try/Alpha,2,2,0,2.2230620456616944e-05,0.0,1.0
25650,강선/Noun,2,2,0,2.2230620456616944e-05,0.0,1.0
25651,흐트러뜨리/Noun,2,0,2,0.0,2.2213830330763933e-05,1.0
25652,본집/Noun,2,2,0,2.2230620456616944e-05,0.0,1.0
25653,달변/Noun,2,2,0,2.2230620456616944e-05,0.0,1.0
25654,십중팔구/Noun,2,0,2,0.0,2.2213830330763933e-05,1.0
25655,결백/Noun,2,0,2,0.0,2.2213830330763933e-05,1.0
25656,캍/Noun,2,0,2,0.0,2.2213830330763933e-05,1.0
25657,핑도/Noun,2,2,0,2.2230620456616944e-05,0.0,1.0
25658,용호/Noun,2,2,0,2.2230620456616944e-05,0.0,1.0
25659,후계/Noun,2,0,2,0.0,2.2213830330763933e-05,1.0
25660,안구건조증/Noun,2,2,0,2.2230620456616944e-05,0.0,1.0
25661,뻥뚤리다/Verb,2,2,0,2.2230620456616944e-05,0.0,1.0
25662,각과/Noun,2,2,0,2.2230620456616944e-05,0.0,1.0
25663,쌉쌀하다/Adjective,2,2,0,2.2230620456616944e-05,0.0,1.0
25664,주기철/Noun,2,2,0,2.2230620456616944e-05,0.0,1.0
25665,여의도/Noun,2,2,0,2.2230620456616944e-05,0.0,1.0
25666,오세훈/Noun,2,2,0,2.2230620456616944e-05,0.0,1.0
25667,은하면/Noun,2,0,2,0.0,2.2213830330763933e-05,1.0
25668,lost/Alpha,2,2,0,2.2230620456616944e-05,0.0,1.0
25669,사화/Noun,2,2,0,2.2230620456616944e-05,0.0,1.0
25670,자선/Noun,2,0,2,0.0,2.2213830330763933e-05,1.0
25671,도미니크/Noun,2,2,0,2.2230620456616944e-05,0.0,1.0
25672,라이온/Noun,2,0,2,0.0,2.2213830330763933e-05,1.0
25673,잛/Noun,2,0,2,0.0,2.2213830330763933e-05,1.0
25674,변상국/Noun,2,0,2,0.0,2.2213830330763933e-05,1.0
25675,PIFF/Alpha,2,2,0,2.2230620456616944e-05,0.0,1.0
25676,퐌/Noun,2,2,0,2.2230620456616944e-05,0.0,1.0
25677,쩐/Noun,2,2,0,2.2230620456616944e-05,0.0,1.0
25678,지데루/Noun,2,0,2,0.0,2.2213830330763933e-05,1.0
25679,안봣음/Noun,2,0,2,0.0,2.2213830330763933e-05,1.0
25680,비리비리/Noun,2,0,2,0.0,2.2213830330763933e-05,1.0
25681,까마득하다/Adjective,2,0,2,0.0,2.2213830330763933e-05,1.0
25682,샊/Noun,2,0,2,0.0,2.2213830330763933e-05,1.0
25683,01년/Number,2,0,2,0.0,2.2213830330763933e-05,1.0
25684,박카스/Noun,2,0,2,0.0,2.2213830330763933e-05,1.0
25685,네팔/Noun,2,2,0,2.2230620456616944e-05,0.0,1.0
25686,모스크바/Noun,2,2,0,2.2230620456616944e-05,0.0,1.0
25687,섀넌/Noun,2,2,0,2.2230620456616944e-05,0.0,1.0
25688,꼬장/Noun,2,0,2,0.0,2.2213830330763933e-05,1.0
25689,격침/Noun,2,2,0,2.2230620456616944e-05,0.0,1.0
25690,벼로/Noun,2,0,2,0.0,2.2213830330763933e-05,1.0
25691,옥희/Noun,2,2,0,2.2230620456616944e-05,0.0,1.0
25692,럴슨/Noun,2,2,0,2.2230620456616944e-05,0.0,1.0
25693,로케트/Noun,2,0,2,0.0,2.2213830330763933e-05,1.0
25694,교대/Noun,2,0,2,0.0,2.2213830330763933e-05,1.0
25695,쵝고/Noun,2,2,0,2.2230620456616944e-05,0.0,1.0
25696,",,^^/Punctuation",2,2,0,2.2230620456616944e-05,0.0,1.0
25697,말랑하다/Adjective,2,0,2,0.0,2.2213830330763933e-05,1.0
25698,ㅊㄹ/KoreanParticle,2,2,0,2.2230620456616944e-05,0.0,1.0
25699,약소국/Noun,2,2,0,2.2230620456616944e-05,0.0,1.0
25700,jjladam/Alpha,2,2,0,2.2230620456616944e-05,0.0,1.0
25701,독파/Noun,2,2,0,2.2230620456616944e-05,0.0,1.0
25702,김혁/Noun,2,2,0,2.2230620456616944e-05,0.0,1.0
25703,패러/Noun,2,0,2,0.0,2.2213830330763933e-05,1.0
25704,그린호넷/Noun,2,0,2,0.0,2.2213830330763933e-05,1.0
25705,야학/Noun,2,2,0,2.2230620456616944e-05,0.0,1.0
25706,하바나/Noun,2,2,0,2.2230620456616944e-05,0.0,1.0
25707,생이라니/Foreign,2,2,0,2.2230620456616944e-05,0.0,1.0
25708,꼽습니/Noun,2,2,0,2.2230620456616944e-05,0.0,1.0
25709,정벌/Noun,2,0,2,0.0,2.2213830330763933e-05,1.0
25710,칭기즈칸/Noun,2,0,2,0.0,2.2213830330763933e-05,1.0
25711,탓하랴/Noun,2,0,2,0.0,2.2213830330763933e-05,1.0
25712,Yes/Alpha,2,2,0,2.2230620456616944e-05,0.0,1.0
25713,Merry/Alpha,2,2,0,2.2230620456616944e-05,0.0,1.0
25714,바스/Noun,2,0,2,0.0,2.2213830330763933e-05,1.0
25715,4%/Number,2,2,0,2.2230620456616944e-05,0.0,1.0
25716,...//Punctuation,2,2,0,2.2230620456616944e-05,0.0,1.0
25717,몀/Noun,2,2,0,2.2230620456616944e-05,0.0,1.0
25718,무우/Noun,2,2,0,2.2230620456616944e-05,0.0,1.0
25719,시달소/Noun,2,0,2,0.0,2.2213830330763933e-05,1.0
25720,탁구선수/Noun,2,2,0,2.2230620456616944e-05,0.0,1.0
25721,ㅏㅎ/KoreanParticle,2,0,2,0.0,2.2213830330763933e-05,1.0
25722,오상진/Noun,2,0,2,0.0,2.2213830330763933e-05,1.0
25723,김혜나/Noun,2,0,2,0.0,2.2213830330763933e-05,1.0
25724,잎새/Noun,2,0,2,0.0,2.2213830330763933e-05,1.0
25725,이능룡/Noun,2,2,0,2.2230620456616944e-05,0.0,1.0
25726,다윗/Noun,2,0,2,0.0,2.2213830330763933e-05,1.0
25727,jj/Alpha,2,2,0,2.2230620456616944e-05,0.0,1.0
25728,Brilliant/Alpha,2,2,0,2.2230620456616944e-05,0.0,1.0
25729,;;;;;;;;;;;/Punctuation,2,0,2,0.0,2.2213830330763933e-05,1.0
25730,...?.../Punctuation,2,0,2,0.0,2.2213830330763933e-05,1.0
25731,MMA/Alpha,2,0,2,0.0,2.2213830330763933e-05,1.0
25732,키팅/Noun,2,2,0,2.2230620456616944e-05,0.0,1.0
25733,폴폴/Noun,2,0,2,0.0,2.2213830330763933e-05,1.0
25734,꽃섬/Noun,2,2,0,2.2230620456616944e-05,0.0,1.0
25735,안무가/Noun,2,0,2,0.0,2.2213830330763933e-05,1.0
25736,유해정/Noun,2,2,0,2.2230620456616944e-05,0.0,1.0
25737,카시/Noun,2,0,2,0.0,2.2213830330763933e-05,1.0
25738,바름/Noun,2,0,2,0.0,2.2213830330763933e-05,1.0
25739,페미나치/Noun,2,0,2,0.0,2.2213830330763933e-05,1.0
25740,--;;;/Punctuation,2,0,2,0.0,2.2213830330763933e-05,1.0
25741,적요/Noun,2,0,2,0.0,2.2213830330763933e-05,1.0
25742,안착/Noun,2,0,2,0.0,2.2213830330763933e-05,1.0
25743,고재/Noun,2,2,0,2.2230620456616944e-05,0.0,1.0
25744,ㅆㅎㅌㅊ/KoreanParticle,2,0,2,0.0,2.2213830330763933e-05,1.0
25745,차단/Noun,2,0,2,0.0,2.2213830330763933e-05,1.0
25746,중배/Noun,2,2,0,2.2230620456616944e-05,0.0,1.0
25747,소방대/Noun,2,2,0,2.2230620456616944e-05,0.0,1.0
25748,열애설/Noun,2,0,2,0.0,2.2213830330763933e-05,1.0
25749,청구/Noun,2,0,2,0.0,2.2213830330763933e-05,1.0
25750,떵폼/Noun,2,0,2,0.0,2.2213830330763933e-05,1.0
25751,piff/Alpha,2,2,0,2.2230620456616944e-05,0.0,1.0
25752,음감/Noun,2,0,2,0.0,2.2213830330763933e-05,1.0
25753,재끼/Noun,2,0,2,0.0,2.2213830330763933e-05,1.0
25754,II/Alpha,2,0,2,0.0,2.2213830330763933e-05,1.0
25755,볼곳/Noun,2,2,0,2.2230620456616944e-05,0.0,1.0
25756,Sound/Alpha,2,2,0,2.2230620456616944e-05,0.0,1.0
25757,버스커/Noun,2,0,2,0.0,2.2213830330763933e-05,1.0
25758,우노/Noun,2,2,0,2.2230620456616944e-05,0.0,1.0
25759,연역/Noun,2,0,2,0.0,2.2213830330763933e-05,1.0
25760,lol/Alpha,2,0,2,0.0,2.2213830330763933e-05,1.0
25761,father/Alpha,2,2,0,2.2230620456616944e-05,0.0,1.0
25762,사차원/Noun,2,0,2,0.0,2.2213830330763933e-05,1.0
25763,인페르노/Noun,2,2,0,2.2230620456616944e-05,0.0,1.0
25764,캡슐/Noun,2,0,2,0.0,2.2213830330763933e-05,1.0
25765,김성령/Noun,2,0,2,0.0,2.2213830330763933e-05,1.0
25766,여리고/Noun,2,2,0,2.2230620456616944e-05,0.0,1.0
25767,밍숭맹숭하/Noun,2,0,2,0.0,2.2213830330763933e-05,1.0
25768,루브르/Noun,2,0,2,0.0,2.2213830330763933e-05,1.0
25769,최수영/Noun,2,2,0,2.2230620456616944e-05,0.0,1.0
25770,장미여관/Noun,2,0,2,0.0,2.2213830330763933e-05,1.0
25771,재밌쪙/Noun,2,2,0,2.2230620456616944e-05,0.0,1.0
25772,존칭/Noun,2,0,2,0.0,2.2213830330763933e-05,1.0
25773,로즈마리/Noun,2,2,0,2.2230620456616944e-05,0.0,1.0
25774,주교/Noun,2,0,2,0.0,2.2213830330763933e-05,1.0
25775,티엔/Noun,2,2,0,2.2230620456616944e-05,0.0,1.0
25776,소걸아/Noun,2,0,2,0.0,2.2213830330763933e-05,1.0
25777,윈드밀/Noun,2,0,2,0.0,2.2213830330763933e-05,1.0
25778,웨스트/Noun,2,2,0,2.2230620456616944e-05,0.0,1.0
25779,.--/Punctuation,2,0,2,0.0,2.2213830330763933e-05,1.0
25780,............................................../Punctuation,2,0,2,0.0,2.2213830330763933e-05,1.0
25781,19회/Number,2,2,0,2.2230620456616944e-05,0.0,1.0
25782,뚝방전설/Noun,2,0,2,0.0,2.2213830330763933e-05,1.0
25783,←/Foreign,2,2,0,2.2230620456616944e-05,0.0,1.0
25784,징창/Noun,2,0,2,0.0,2.2213830330763933e-05,1.0
25785,환란/Noun,2,2,0,2.2230620456616944e-05,0.0,1.0
25786,백정/Noun,2,0,2,0.0,2.2213830330763933e-05,1.0
25787,불완전/Noun,2,2,0,2.2230620456616944e-05,0.0,1.0
25788,소호/Noun,2,2,0,2.2230620456616944e-05,0.0,1.0
25789,우러나/Noun,2,2,0,2.2230620456616944e-05,0.0,1.0
25790,언어장애/Noun,2,0,2,0.0,2.2213830330763933e-05,1.0
25791,울브스/Noun,2,0,2,0.0,2.2213830330763933e-05,1.0
25792,퉷퉷/Noun,2,0,2,0.0,2.2213830330763933e-05,1.0
25793,낭만파/Noun,2,2,0,2.2230620456616944e-05,0.0,1.0
25794,night/Alpha,2,2,0,2.2230620456616944e-05,0.0,1.0
25795,팔로우/Noun,2,0,2,0.0,2.2213830330763933e-05,1.0
25796,포진/Noun,2,2,0,2.2230620456616944e-05,0.0,1.0
25797,뮬러/Noun,2,2,0,2.2230620456616944e-05,0.0,1.0
25798,군복무/Noun,2,0,2,0.0,2.2213830330763933e-05,1.0
25799,천제/Noun,2,2,0,2.2230620456616944e-05,0.0,1.0
25800,현미경/Noun,2,2,0,2.2230620456616944e-05,0.0,1.0
25801,==;/Punctuation,2,0,2,0.0,2.2213830330763933e-05,1.0
25802,핵꿀잼임/Noun,2,2,0,2.2230620456616944e-05,0.0,1.0
25803,58/Number,2,0,2,0.0,2.2213830330763933e-05,1.0
25804,알랭/Noun,2,2,0,2.2230620456616944e-05,0.0,1.0
25805,바버/Noun,2,2,0,2.2230620456616944e-05,0.0,1.0
25806,빼주/Noun,2,0,2,0.0,2.2213830330763933e-05,1.0
25807,의천/Noun,2,2,0,2.2230620456616944e-05,0.0,1.0
25808,우와한녀/Noun,2,2,0,2.2230620456616944e-05,0.0,1.0
25809,When/Alpha,2,2,0,2.2230620456616944e-05,0.0,1.0
25810,잔임함/Noun,2,0,2,0.0,2.2213830330763933e-05,1.0
25811,으러/Noun,2,0,2,0.0,2.2213830330763933e-05,1.0
25812,일대/Modifier,2,2,0,2.2230620456616944e-05,0.0,1.0
25813,볼끼/Noun,2,0,2,0.0,2.2213830330763933e-05,1.0
25814,12345678910/Number,2,2,0,2.2230620456616944e-05,0.0,1.0
25815,ARE/Alpha,2,2,0,2.2230620456616944e-05,0.0,1.0
25816,칠만/Noun,2,0,2,0.0,2.2213830330763933e-05,1.0
25817,두건/Noun,2,0,2,0.0,2.2213830330763933e-05,1.0
25818,번봣어/Noun,2,2,0,2.2230620456616944e-05,0.0,1.0
25819,손에꼽는/Noun,2,2,0,2.2230620456616944e-05,0.0,1.0
25820,승만/Noun,2,0,2,0.0,2.2213830330763933e-05,1.0
25821,알래스카/Noun,2,2,0,2.2230620456616944e-05,0.0,1.0
25822,첸카이거/Noun,2,2,0,2.2230620456616944e-05,0.0,1.0
25823,흐앙/Noun,2,2,0,2.2230620456616944e-05,0.0,1.0
25824,위악/Noun,2,0,2,0.0,2.2213830330763933e-05,1.0
25825,워홀/Noun,2,0,2,0.0,2.2213830330763933e-05,1.0
25826,쵸파/Noun,2,2,0,2.2230620456616944e-05,0.0,1.0
25827,아홉수/Noun,2,2,0,2.2230620456616944e-05,0.0,1.0
25828,.&/Punctuation,2,2,0,2.2230620456616944e-05,0.0,1.0
25829,카토/Noun,2,0,2,0.0,2.2213830330763933e-05,1.0
25830,",,,^-^/Punctuation",2,2,0,2.2230620456616944e-05,0.0,1.0
25831,사상가/Noun,2,2,0,2.2230620456616944e-05,0.0,1.0
25832,미스터리영화/Noun,2,0,2,0.0,2.2213830330763933e-05,1.0
25833,구덩이/Noun,2,0,2,0.0,2.2213830330763933e-05,1.0
25834,자투리/Noun,2,0,2,0.0,2.2213830330763933e-05,1.0
25835,"?,,/Punctuation",2,0,2,0.0,2.2213830330763933e-05,1.0
25836,미꾸라지/Noun,2,2,0,2.2230620456616944e-05,0.0,1.0
25837,육십/Modifier,2,0,2,0.0,2.2213830330763933e-05,1.0
25838,륵/Noun,2,2,0,2.2230620456616944e-05,0.0,1.0
25839,Naver/Alpha,2,0,2,0.0,2.2213830330763933e-05,1.0
25840,산업사/Noun,2,0,2,0.0,2.2213830330763933e-05,1.0
25841,할리데이비슨/Noun,2,2,0,2.2230620456616944e-05,0.0,1.0
25842,1500/Number,2,2,0,2.2230620456616944e-05,0.0,1.0
25843,뚜렷/Noun,2,2,0,2.2230620456616944e-05,0.0,1.0
25844,미즈노/Noun,2,0,2,0.0,2.2213830330763933e-05,1.0
25845,썪는다/Noun,2,0,2,0.0,2.2213830330763933e-05,1.0
25846,송영창/Noun,2,0,2,0.0,2.2213830330763933e-05,1.0
25847,대등하다/Adjective,2,0,2,0.0,2.2213830330763933e-05,1.0
25848,트레져/Noun,2,2,0,2.2230620456616944e-05,0.0,1.0
25849,은경/Noun,2,2,0,2.2230620456616944e-05,0.0,1.0
25850,03년/Number,2,2,0,2.2230620456616944e-05,0.0,1.0
25851,단백/Noun,2,2,0,2.2230620456616944e-05,0.0,1.0
25852,귀신의집/Noun,2,0,2,0.0,2.2213830330763933e-05,1.0
25853,dreams/Alpha,2,2,0,2.2230620456616944e-05,0.0,1.0
25854,난지도/Noun,2,0,2,0.0,2.2213830330763933e-05,1.0
25855,위조범/Noun,2,0,2,0.0,2.2213830330763933e-05,1.0
25856,간병/Noun,2,2,0,2.2230620456616944e-05,0.0,1.0
25857,잠수종/Noun,2,2,0,2.2230620456616944e-05,0.0,1.0
25858,허세영/Noun,2,0,2,0.0,2.2213830330763933e-05,1.0
25859,오공/Noun,2,2,0,2.2230620456616944e-05,0.0,1.0
25860,CNTV/Alpha,2,2,0,2.2230620456616944e-05,0.0,1.0
25861,고투/Noun,2,0,2,0.0,2.2213830330763933e-05,1.0
25862,켈/Noun,2,0,2,0.0,2.2213830330763933e-05,1.0
25863,거니/Noun,2,2,0,2.2230620456616944e-05,0.0,1.0
25864,시퍼렇다/Adjective,2,0,2,0.0,2.2213830330763933e-05,1.0
25865,통행/Noun,2,0,2,0.0,2.2213830330763933e-05,1.0
25866,슝슝/Noun,2,0,2,0.0,2.2213830330763933e-05,1.0
25867,해저/Noun,2,0,2,0.0,2.2213830330763933e-05,1.0
25868,잽싸다/Adjective,2,0,2,0.0,2.2213830330763933e-05,1.0
25869,별루구/Noun,2,0,2,0.0,2.2213830330763933e-05,1.0
25870,어만/Modifier,2,0,2,0.0,2.2213830330763933e-05,1.0
25871,저속/Noun,2,0,2,0.0,2.2213830330763933e-05,1.0
25872,빙그레/Noun,2,2,0,2.2230620456616944e-05,0.0,1.0
25873,유적/Noun,2,0,2,0.0,2.2213830330763933e-05,1.0
25874,실바/Noun,2,2,0,2.2230620456616944e-05,0.0,1.0
25875,놨네/Noun,2,0,2,0.0,2.2213830330763933e-05,1.0
25876,우일/Noun,2,0,2,0.0,2.2213830330763933e-05,1.0
25877,페티시/Noun,2,0,2,0.0,2.2213830330763933e-05,1.0
25878,마농/Noun,2,2,0,2.2230620456616944e-05,0.0,1.0
25879,Hope/Alpha,2,2,0,2.2230620456616944e-05,0.0,1.0
25880,Only/Alpha,2,2,0,2.2230620456616944e-05,0.0,1.0
25881,볼드/Noun,2,0,2,0.0,2.2213830330763933e-05,1.0
25882,애드리브/Noun,2,2,0,2.2230620456616944e-05,0.0,1.0
25883,막만드/Noun,2,0,2,0.0,2.2213830330763933e-05,1.0
25884,4.2/Number,2,0,2,0.0,2.2213830330763933e-05,1.0
25885,식성/Noun,2,2,0,2.2230620456616944e-05,0.0,1.0
25886,모스키토/Noun,2,0,2,0.0,2.2213830330763933e-05,1.0
25887,전집/Noun,2,0,2,0.0,2.2213830330763933e-05,1.0
25888,빅스/Noun,2,2,0,2.2230620456616944e-05,0.0,1.0
25889,면강/Noun,2,2,0,2.2230620456616944e-05,0.0,1.0
25890,타치/Noun,2,0,2,0.0,2.2213830330763933e-05,1.0
25891,차도남/Noun,2,2,0,2.2230620456616944e-05,0.0,1.0
25892,미기/Noun,2,0,2,0.0,2.2213830330763933e-05,1.0
25893,택했다/Noun,2,2,0,2.2230620456616944e-05,0.0,1.0
25894,노컷/Noun,2,2,0,2.2230620456616944e-05,0.0,1.0
25895,하악하악/Noun,2,0,2,0.0,2.2213830330763933e-05,1.0
25896,헷/Noun,2,2,0,2.2230620456616944e-05,0.0,1.0
25897,법외/Noun,2,0,2,0.0,2.2213830330763933e-05,1.0
25898,전갈/Noun,2,0,2,0.0,2.2213830330763933e-05,1.0
25899,손빈/Noun,2,2,0,2.2230620456616944e-05,0.0,1.0
25900,주술사/Noun,2,0,2,0.0,2.2213830330763933e-05,1.0
25901,카라멜/Noun,2,0,2,0.0,2.2213830330763933e-05,1.0
25902,엠블런스/Noun,2,0,2,0.0,2.2213830330763933e-05,1.0
25903,헛짓/Noun,2,0,2,0.0,2.2213830330763933e-05,1.0
25904,류임/Noun,2,0,2,0.0,2.2213830330763933e-05,1.0
25905,거냣/Noun,2,2,0,2.2230620456616944e-05,0.0,1.0
25906,꺠우/Noun,2,2,0,2.2230620456616944e-05,0.0,1.0
25907,비겁/Noun,2,0,2,0.0,2.2213830330763933e-05,1.0
25908,민좆/Noun,2,0,2,0.0,2.2213830330763933e-05,1.0
25909,쌕기/Noun,2,0,2,0.0,2.2213830330763933e-05,1.0
25910,씨나리오/Noun,2,0,2,0.0,2.2213830330763933e-05,1.0
25911,혁띠/Noun,2,2,0,2.2230620456616944e-05,0.0,1.0
25912,왕콩/Noun,2,2,0,2.2230620456616944e-05,0.0,1.0
25913,데인드/Noun,2,2,0,2.2230620456616944e-05,0.0,1.0
25914,knight/Alpha,2,2,0,2.2230620456616944e-05,0.0,1.0
25915,www.nemofile.co.kr/URL,2,2,0,2.2230620456616944e-05,0.0,1.0
25916,stop/Alpha,2,2,0,2.2230620456616944e-05,0.0,1.0
25917,얄궂/Noun,2,2,0,2.2230620456616944e-05,0.0,1.0
25918,금정/Noun,2,0,2,0.0,2.2213830330763933e-05,1.0
25919,식임/Noun,2,0,2,0.0,2.2213830330763933e-05,1.0
25920,woalTek/Alpha,2,2,0,2.2230620456616944e-05,0.0,1.0
25921,fine/Alpha,2,2,0,2.2230620456616944e-05,0.0,1.0
25922,anyway/Alpha,2,2,0,2.2230620456616944e-05,0.0,1.0
25923,333/Number,2,0,2,0.0,2.2213830330763933e-05,1.0
25924,술병/Noun,2,2,0,2.2230620456616944e-05,0.0,1.0
25925,귄/Noun,2,2,0,2.2230620456616944e-05,0.0,1.0
25926,800/Number,2,2,0,2.2230620456616944e-05,0.0,1.0
25927,노이즈마케팅/Noun,2,0,2,0.0,2.2213830330763933e-05,1.0
25928,둔하다/Adjective,2,0,2,0.0,2.2213830330763933e-05,1.0
25929,얄개/Noun,2,0,2,0.0,2.2213830330763933e-05,1.0
25930,빅똥/Noun,2,0,2,0.0,2.2213830330763933e-05,1.0
25931,너와나/Noun,2,2,0,2.2230620456616944e-05,0.0,1.0
25932,레인맨/Noun,2,2,0,2.2230620456616944e-05,0.0,1.0
25933,자증나/Noun,2,0,2,0.0,2.2213830330763933e-05,1.0
25934,엽덕한/Noun,2,2,0,2.2230620456616944e-05,0.0,1.0
25935,follow/Alpha,2,2,0,2.2230620456616944e-05,0.0,1.0
25936,강림도령/Noun,2,2,0,2.2230620456616944e-05,0.0,1.0
25937,태왕/Noun,2,0,2,0.0,2.2213830330763933e-05,1.0
25938,겻/Noun,2,2,0,2.2230620456616944e-05,0.0,1.0
25939,전이라는/Foreign,2,2,0,2.2230620456616944e-05,0.0,1.0
25940,맨션/Noun,2,2,0,2.2230620456616944e-05,0.0,1.0
25941,~^^!/Punctuation,2,2,0,2.2230620456616944e-05,0.0,1.0
25942,보은/Noun,2,2,0,2.2230620456616944e-05,0.0,1.0
25943,박혁거세/Noun,2,0,2,0.0,2.2213830330763933e-05,1.0
25944,마누/Noun,2,0,2,0.0,2.2213830330763933e-05,1.0
25945,진퇴양난/Noun,2,0,2,0.0,2.2213830330763933e-05,1.0
25946,북송/Noun,2,0,2,0.0,2.2213830330763933e-05,1.0
25947,대뜸/Noun,2,0,2,0.0,2.2213830330763933e-05,1.0
25948,무드/Noun,2,2,0,2.2230620456616944e-05,0.0,1.0
25949,1천만/Number,2,0,2,0.0,2.2213830330763933e-05,1.0
25950,대초/Noun,2,2,0,2.2230620456616944e-05,0.0,1.0
25951,방만/Noun,2,0,2,0.0,2.2213830330763933e-05,1.0
25952,작동/Noun,2,0,2,0.0,2.2213830330763933e-05,1.0
25953,라크/Noun,2,0,2,0.0,2.2213830330763933e-05,1.0
25954,부아/Noun,2,0,2,0.0,2.2213830330763933e-05,1.0
25955,".,,,,/Punctuation",2,2,0,2.2230620456616944e-05,0.0,1.0
25956,권고/Noun,2,0,2,0.0,2.2213830330763933e-05,1.0
25957,섥힌/Noun,2,2,0,2.2230620456616944e-05,0.0,1.0
25958,친밀하다/Adjective,2,2,0,2.2230620456616944e-05,0.0,1.0
25959,조촐하다/Adjective,2,0,2,0.0,2.2213830330763933e-05,1.0
25960,엘레/Noun,2,2,0,2.2230620456616944e-05,0.0,1.0
25961,장동/Noun,2,2,0,2.2230620456616944e-05,0.0,1.0
25962,에스메랄다/Noun,2,2,0,2.2230620456616944e-05,0.0,1.0
25963,밀착/Noun,2,0,2,0.0,2.2213830330763933e-05,1.0
25964,천상여자/Noun,2,2,0,2.2230620456616944e-05,0.0,1.0
25965,정현/Noun,2,2,0,2.2230620456616944e-05,0.0,1.0
25966,급감/Noun,2,0,2,0.0,2.2213830330763933e-05,1.0
25967,곤두박질/Noun,2,0,2,0.0,2.2213830330763933e-05,1.0
25968,박남정/Noun,2,2,0,2.2230620456616944e-05,0.0,1.0
25969,유증/Noun,2,2,0,2.2230620456616944e-05,0.0,1.0
25970,♥♥♥♥♥♥♥♥♥♥/Foreign,2,2,0,2.2230620456616944e-05,0.0,1.0
25971,작과는/Foreign,2,0,2,0.0,2.2213830330763933e-05,1.0
25972,두번쨰/Noun,2,0,2,0.0,2.2213830330763933e-05,1.0
25973,술잔/Noun,2,2,0,2.2230620456616944e-05,0.0,1.0
25974,묠니르/Noun,2,2,0,2.2230620456616944e-05,0.0,1.0
25975,꿰/Noun,2,0,2,0.0,2.2213830330763933e-05,1.0
25976,살결/Noun,2,2,0,2.2230620456616944e-05,0.0,1.0
25977,아드리안/Noun,2,2,0,2.2230620456616944e-05,0.0,1.0
25978,종아리/Noun,2,0,2,0.0,2.2213830330763933e-05,1.0
25979,이선진/Noun,2,2,0,2.2230620456616944e-05,0.0,1.0
25980,엮으려/Noun,2,0,2,0.0,2.2213830330763933e-05,1.0
25981,김희정/Noun,2,0,2,0.0,2.2213830330763933e-05,1.0
25982,게노세크트/Noun,2,2,0,2.2230620456616944e-05,0.0,1.0
25983,얽다/Verb,2,2,0,2.2230620456616944e-05,0.0,1.0
25984,면박/Noun,2,0,2,0.0,2.2213830330763933e-05,1.0
25985,장동혁/Noun,2,0,2,0.0,2.2213830330763933e-05,1.0
25986,그사세/Noun,2,2,0,2.2230620456616944e-05,0.0,1.0
25987,~^-^/Punctuation,2,2,0,2.2230620456616944e-05,0.0,1.0
25988,독서실/Noun,2,2,0,2.2230620456616944e-05,0.0,1.0
25989,성문/Noun,2,0,2,0.0,2.2213830330763933e-05,1.0
25990,방은진/Noun,2,2,0,2.2230620456616944e-05,0.0,1.0
25991,목젖/Noun,2,0,2,0.0,2.2213830330763933e-05,1.0
25992,과음/Noun,2,0,2,0.0,2.2213830330763933e-05,1.0
25993,끈끈함/Noun,2,2,0,2.2230620456616944e-05,0.0,1.0
25994,자살씬/Noun,2,0,2,0.0,2.2213830330763933e-05,1.0
25995,쿰척쿰척/Noun,2,0,2,0.0,2.2213830330763933e-05,1.0
25996,걸볼때/Noun,2,0,2,0.0,2.2213830330763933e-05,1.0
25997,개낚였음/Noun,2,0,2,0.0,2.2213830330763933e-05,1.0
25998,왓더뻑/Noun,2,0,2,0.0,2.2213830330763933e-05,1.0
25999,웨어/Noun,2,0,2,0.0,2.2213830330763933e-05,1.0
26000,생활고/Noun,2,0,2,0.0,2.2213830330763933e-05,1.0
26001,작이라는게/Foreign,2,2,0,2.2230620456616944e-05,0.0,1.0
26002,승패/Noun,2,2,0,2.2230620456616944e-05,0.0,1.0
26003,카체이싱/Noun,2,0,2,0.0,2.2213830330763933e-05,1.0
26004,할부/Noun,2,0,2,0.0,2.2213830330763933e-05,1.0
26005,온정/Noun,2,2,0,2.2230620456616944e-05,0.0,1.0
26006,이혜영/Noun,2,0,2,0.0,2.2213830330763933e-05,1.0
26007,미스터고/Noun,2,2,0,2.2230620456616944e-05,0.0,1.0
26008,트럼펫/Noun,2,2,0,2.2230620456616944e-05,0.0,1.0
26009,사망자/Noun,2,0,2,0.0,2.2213830330763933e-05,1.0
26010,란다/Eomi,2,0,2,0.0,2.2213830330763933e-05,1.0
26011,폭력써클/Noun,2,0,2,0.0,2.2213830330763933e-05,1.0
26012,알았드/Noun,2,0,2,0.0,2.2213830330763933e-05,1.0
26013,흥정/Noun,2,0,2,0.0,2.2213830330763933e-05,1.0
26014,114분/Number,2,0,2,0.0,2.2213830330763933e-05,1.0
26015,자무카/Noun,2,0,2,0.0,2.2213830330763933e-05,1.0
26016,57분/Number,2,0,2,0.0,2.2213830330763933e-05,1.0
26017,국새/Noun,2,0,2,0.0,2.2213830330763933e-05,1.0
26018,윤재문/Noun,2,2,0,2.2230620456616944e-05,0.0,1.0
26019,적우/Noun,2,2,0,2.2230620456616944e-05,0.0,1.0
26020,열시미/Adverb,2,2,0,2.2230620456616944e-05,0.0,1.0
26021,코아티/Noun,2,2,0,2.2230620456616944e-05,0.0,1.0
26022,악사/Noun,2,2,0,2.2230620456616944e-05,0.0,1.0
26023,속출/Noun,2,2,0,2.2230620456616944e-05,0.0,1.0
26024,피드/Noun,2,2,0,2.2230620456616944e-05,0.0,1.0
26025,왜나라/Noun,2,2,0,2.2230620456616944e-05,0.0,1.0
26026,어불성설/Noun,2,2,0,2.2230620456616944e-05,0.0,1.0
26027,어거스트러쉬/Noun,2,2,0,2.2230620456616944e-05,0.0,1.0
26028,타이틀곡/Noun,2,2,0,2.2230620456616944e-05,0.0,1.0
26029,만득이/Noun,2,0,2,0.0,2.2213830330763933e-05,1.0
26030,0.001/Number,2,0,2,0.0,2.2213830330763933e-05,1.0
26031,hell/Alpha,2,0,2,0.0,2.2213830330763933e-05,1.0
26032,외계어/Noun,2,0,2,0.0,2.2213830330763933e-05,1.0
26033,쉼표/Noun,2,2,0,2.2230620456616944e-05,0.0,1.0
26034,새퀴/Noun,2,0,2,0.0,2.2213830330763933e-05,1.0
26035,ㆀ/Foreign,2,0,2,0.0,2.2213830330763933e-05,1.0
26036,유투/Noun,2,2,0,2.2230620456616944e-05,0.0,1.0
26037,철철철/Noun,2,2,0,2.2230620456616944e-05,0.0,1.0
26038,관광객/Noun,2,0,2,0.0,2.2213830330763933e-05,1.0
26039,무근/Noun,2,0,2,0.0,2.2213830330763933e-05,1.0
26040,밋첼/Noun,2,2,0,2.2230620456616944e-05,0.0,1.0
26041,렴/Noun,2,2,0,2.2230620456616944e-05,0.0,1.0
26042,ㅁㄴㄹ/KoreanParticle,2,0,2,0.0,2.2213830330763933e-05,1.0
26043,ㅣㅁ/KoreanParticle,2,0,2,0.0,2.2213830330763933e-05,1.0
26044,meet/Alpha,2,2,0,2.2230620456616944e-05,0.0,1.0
26045,64회/Number,2,0,2,0.0,2.2213830330763933e-05,1.0
26046,팟팅/Noun,2,2,0,2.2230620456616944e-05,0.0,1.0
26047,후리/Noun,2,0,2,0.0,2.2213830330763933e-05,1.0
26048,울랄라세션/Noun,2,0,2,0.0,2.2213830330763933e-05,1.0
26049,병주/Noun,2,0,2,0.0,2.2213830330763933e-05,1.0
26050,인문/Noun,2,0,2,0.0,2.2213830330763933e-05,1.0
26051,궁금타/Noun,2,2,0,2.2230620456616944e-05,0.0,1.0
26052,깜빡깜빡/Adverb,2,0,2,0.0,2.2213830330763933e-05,1.0
26053,김민/Noun,2,0,2,0.0,2.2213830330763933e-05,1.0
26054,섭섭/Noun,2,2,0,2.2230620456616944e-05,0.0,1.0
26055,허우샤오시엔/Noun,2,2,0,2.2230620456616944e-05,0.0,1.0
26056,카툰/Noun,2,2,0,2.2230620456616944e-05,0.0,1.0
26057,박완규/Noun,2,2,0,2.2230620456616944e-05,0.0,1.0
26058,보재/Noun,2,0,2,0.0,2.2213830330763933e-05,1.0
26059,ㅎㅋㅎㅋ/KoreanParticle,2,0,2,0.0,2.2213830330763933e-05,1.0
26060,스테이크/Noun,2,0,2,0.0,2.2213830330763933e-05,1.0
26061,환멸/Noun,2,0,2,0.0,2.2213830330763933e-05,1.0
26062,아햏햏/Noun,2,2,0,2.2230620456616944e-05,0.0,1.0
26063,응급실/Noun,2,0,2,0.0,2.2213830330763933e-05,1.0
26064,머리모양/Noun,2,0,2,0.0,2.2213830330763933e-05,1.0
26065,리퍼/Noun,2,2,0,2.2230620456616944e-05,0.0,1.0
26066,싱숭생숭하다/Adjective,2,2,0,2.2230620456616944e-05,0.0,1.0
26067,뒤편/Noun,2,0,2,0.0,2.2213830330763933e-05,1.0
26068,아포/Noun,2,0,2,0.0,2.2213830330763933e-05,1.0
26069,드노/Noun,2,0,2,0.0,2.2213830330763933e-05,1.0
26070,종훈/Noun,2,0,2,0.0,2.2213830330763933e-05,1.0
26071,미하엘/Noun,2,2,0,2.2230620456616944e-05,0.0,1.0
26072,데미갓/Noun,2,0,2,0.0,2.2213830330763933e-05,1.0
26073,에버랜드/Noun,2,0,2,0.0,2.2213830330763933e-05,1.0
26074,7000원/Number,2,0,2,0.0,2.2213830330763933e-05,1.0
26075,---!!/Punctuation,2,2,0,2.2230620456616944e-05,0.0,1.0
26076,델핀/Noun,2,2,0,2.2230620456616944e-05,0.0,1.0
26077,리츠/Noun,2,2,0,2.2230620456616944e-05,0.0,1.0
26078,산티아고/Noun,2,2,0,2.2230620456616944e-05,0.0,1.0
26079,주영훈/Noun,2,2,0,2.2230620456616944e-05,0.0,1.0
26080,정욕/Noun,2,2,0,2.2230620456616944e-05,0.0,1.0
26081,쟈밋다/Noun,2,2,0,2.2230620456616944e-05,0.0,1.0
26082,한솔/Noun,2,2,0,2.2230620456616944e-05,0.0,1.0
26083,엄스/Noun,2,2,0,2.2230620456616944e-05,0.0,1.0
26084,MCU/Alpha,2,2,0,2.2230620456616944e-05,0.0,1.0
26085,당원/Noun,2,0,2,0.0,2.2213830330763933e-05,1.0
26086,노동당/Noun,2,0,2,0.0,2.2213830330763933e-05,1.0
26087,살림살이/Noun,2,0,2,0.0,2.2213830330763933e-05,1.0
26088,무법천지/Noun,2,0,2,0.0,2.2213830330763933e-05,1.0
26089,러브인아시아/Noun,2,0,2,0.0,2.2213830330763933e-05,1.0
26090,트루맛쇼/Noun,2,2,0,2.2230620456616944e-05,0.0,1.0
26091,렷습/Noun,2,0,2,0.0,2.2213830330763933e-05,1.0
26092,일대일/Noun,2,0,2,0.0,2.2213830330763933e-05,1.0
26093,감벽/Noun,2,0,2,0.0,2.2213830330763933e-05,1.0
26094,;:/Punctuation,2,0,2,0.0,2.2213830330763933e-05,1.0
26095,장총/Noun,2,0,2,0.0,2.2213830330763933e-05,1.0
26096,에스키모/Noun,2,2,0,2.2230620456616944e-05,0.0,1.0
26097,영락/Noun,2,0,2,0.0,2.2213830330763933e-05,1.0
26098,삘받아/Noun,2,0,2,0.0,2.2213830330763933e-05,1.0
26099,아일랜드인/Noun,2,2,0,2.2230620456616944e-05,0.0,1.0
26100,산림/Noun,2,2,0,2.2230620456616944e-05,0.0,1.0
26101,108/Number,2,0,2,0.0,2.2213830330763933e-05,1.0
26102,졸멋/Noun,2,2,0,2.2230620456616944e-05,0.0,1.0
26103,나랑께/Noun,2,0,2,0.0,2.2213830330763933e-05,1.0
26104,전학/Noun,2,2,0,2.2230620456616944e-05,0.0,1.0
26105,형재애/Noun,2,2,0,2.2230620456616944e-05,0.0,1.0
26106,개꿀임/Noun,2,2,0,2.2230620456616944e-05,0.0,1.0
26107,민서/Noun,2,0,2,0.0,2.2213830330763933e-05,1.0
26108,가조/Noun,2,2,0,2.2230620456616944e-05,0.0,1.0
26109,패시/Noun,2,2,0,2.2230620456616944e-05,0.0,1.0
26110,빠당/Noun,2,0,2,0.0,2.2213830330763933e-05,1.0
26111,기록영화/Noun,2,0,2,0.0,2.2213830330763933e-05,1.0
26112,쥬얼리/Noun,2,0,2,0.0,2.2213830330763933e-05,1.0
26113,고추장/Noun,2,0,2,0.0,2.2213830330763933e-05,1.0
26114,남훈/Noun,2,2,0,2.2230620456616944e-05,0.0,1.0
26115,MRI/Alpha,2,0,2,0.0,2.2213830330763933e-05,1.0
26116,말끝/Noun,2,0,2,0.0,2.2213830330763933e-05,1.0
26117,김재/Noun,2,2,0,2.2230620456616944e-05,0.0,1.0
26118,.............................................../Punctuation,2,0,2,0.0,2.2213830330763933e-05,1.0
26119,낚엿/Noun,2,0,2,0.0,2.2213830330763933e-05,1.0
26120,박지선/Noun,2,0,2,0.0,2.2213830330763933e-05,1.0
26121,가라이/Noun,2,2,0,2.2230620456616944e-05,0.0,1.0
26122,나노/Noun,2,0,2,0.0,2.2213830330763933e-05,1.0
26123,처음처럼/Noun,2,2,0,2.2230620456616944e-05,0.0,1.0
26124,횡령/Noun,2,0,2,0.0,2.2213830330763933e-05,1.0
26125,강간씬/Noun,2,0,2,0.0,2.2213830330763933e-05,1.0
26126,예습/Noun,2,2,0,2.2230620456616944e-05,0.0,1.0
26127,추자현/Noun,2,2,0,2.2230620456616944e-05,0.0,1.0
26128,몰입감쩌/Noun,2,2,0,2.2230620456616944e-05,0.0,1.0
26129,글토글/Noun,2,0,2,0.0,2.2213830330763933e-05,1.0
26130,킴베/Noun,2,2,0,2.2230620456616944e-05,0.0,1.0
26131,142분/Number,2,2,0,2.2230620456616944e-05,0.0,1.0
26132,젼/Noun,2,2,0,2.2230620456616944e-05,0.0,1.0
26133,프로이드/Noun,2,2,0,2.2230620456616944e-05,0.0,1.0
26134,인정옥/Noun,2,2,0,2.2230620456616944e-05,0.0,1.0
26135,서스팬스/Noun,2,0,2,0.0,2.2213830330763933e-05,1.0
26136,죽죽/Noun,2,0,2,0.0,2.2213830330763933e-05,1.0
26137,키킥/Noun,2,0,2,0.0,2.2213830330763933e-05,1.0
26138,맹도견/Noun,2,2,0,2.2230620456616944e-05,0.0,1.0
26139,설렛던/Noun,2,2,0,2.2230620456616944e-05,0.0,1.0
26140,음으로/Noun,2,2,0,2.2230620456616944e-05,0.0,1.0
26141,에마/Noun,2,2,0,2.2230620456616944e-05,0.0,1.0
26142,믿음직하다/Adjective,2,2,0,2.2230620456616944e-05,0.0,1.0
26143,이상을/Foreign,2,0,2,0.0,2.2213830330763933e-05,1.0
26144,조로아/Noun,2,2,0,2.2230620456616944e-05,0.0,1.0
26145,파탈/Noun,2,0,2,0.0,2.2213830330763933e-05,1.0
26146,이미테이션/Noun,2,0,2,0.0,2.2213830330763933e-05,1.0
26147,본겁/Noun,2,2,0,2.2230620456616944e-05,0.0,1.0
26148,오입/Noun,2,2,0,2.2230620456616944e-05,0.0,1.0
26149,몬한다/Noun,2,0,2,0.0,2.2213830330763933e-05,1.0
26150,이경은/Noun,2,0,2,0.0,2.2213830330763933e-05,1.0
26151,서울시장/Noun,2,0,2,0.0,2.2213830330763933e-05,1.0
26152,Ending/Alpha,2,2,0,2.2230620456616944e-05,0.0,1.0
26153,심바/Noun,2,2,0,2.2230620456616944e-05,0.0,1.0
26154,파사/Noun,2,2,0,2.2230620456616944e-05,0.0,1.0
26155,산전/Noun,2,2,0,2.2230620456616944e-05,0.0,1.0
26156,간웅/Noun,2,2,0,2.2230620456616944e-05,0.0,1.0
26157,신시/Noun,2,0,2,0.0,2.2213830330763933e-05,1.0
26158,체우/Noun,2,0,2,0.0,2.2213830330763933e-05,1.0
26159,엄격하다/Adjective,2,2,0,2.2230620456616944e-05,0.0,1.0
26160,250/Number,2,2,0,2.2230620456616944e-05,0.0,1.0
26161,베넷/Noun,2,2,0,2.2230620456616944e-05,0.0,1.0
26162,로마신화/Noun,2,0,2,0.0,2.2213830330763933e-05,1.0
26163,고철/Noun,2,0,2,0.0,2.2213830330763933e-05,1.0
26164,만듬새/Noun,2,0,2,0.0,2.2213830330763933e-05,1.0
26165,널널/Noun,2,0,2,0.0,2.2213830330763933e-05,1.0
26166,무답/Noun,2,0,2,0.0,2.2213830330763933e-05,1.0
26167,미니건/Noun,2,0,2,0.0,2.2213830330763933e-05,1.0
26168,....................................../Punctuation,2,0,2,0.0,2.2213830330763933e-05,1.0
26169,납골당/Noun,2,2,0,2.2230620456616944e-05,0.0,1.0
26170,라프/Noun,2,2,0,2.2230620456616944e-05,0.0,1.0
26171,lot/Alpha,2,2,0,2.2230620456616944e-05,0.0,1.0
26172,impressive/Alpha,2,2,0,2.2230620456616944e-05,0.0,1.0
26173,진차/Noun,2,2,0,2.2230620456616944e-05,0.0,1.0
26174,잘봣네/Noun,2,2,0,2.2230620456616944e-05,0.0,1.0
26175,애완/Noun,2,0,2,0.0,2.2213830330763933e-05,1.0
26176,등심/Noun,2,0,2,0.0,2.2213830330763933e-05,1.0
26177,=;/Punctuation,2,0,2,0.0,2.2213830330763933e-05,1.0
26178,프리윌리/Noun,2,2,0,2.2230620456616944e-05,0.0,1.0
26179,재미엄/Noun,2,0,2,0.0,2.2213830330763933e-05,1.0
26180,우프/Noun,2,2,0,2.2230620456616944e-05,0.0,1.0
26181,현숙/Noun,2,2,0,2.2230620456616944e-05,0.0,1.0
26182,name/Alpha,2,2,0,2.2230620456616944e-05,0.0,1.0
26183,밀로/Noun,2,2,0,2.2230620456616944e-05,0.0,1.0
26184,정정당당하다/Adjective,2,0,2,0.0,2.2213830330763933e-05,1.0
26185,greatest/Alpha,2,2,0,2.2230620456616944e-05,0.0,1.0
26186,민지/Noun,2,0,2,0.0,2.2213830330763933e-05,1.0
26187,나라고/Noun,2,0,2,0.0,2.2213830330763933e-05,1.0
26188,우보/Noun,2,0,2,0.0,2.2213830330763933e-05,1.0
26189,더봣/Noun,2,2,0,2.2230620456616944e-05,0.0,1.0
26190,리스본/Noun,2,2,0,2.2230620456616944e-05,0.0,1.0
26191,",,,../Punctuation",2,0,2,0.0,2.2213830330763933e-05,1.0
26192,마광수/Noun,2,0,2,0.0,2.2213830330763933e-05,1.0
26193,번뜩/Noun,2,0,2,0.0,2.2213830330763933e-05,1.0
26194,낚으/Noun,2,0,2,0.0,2.2213830330763933e-05,1.0
26195,청미/Noun,2,0,2,0.0,2.2213830330763933e-05,1.0
26196,경/Foreign,2,2,0,2.2230620456616944e-05,0.0,1.0
26197,아닥/Noun,2,2,0,2.2230620456616944e-05,0.0,1.0
26198,!!+_+/Punctuation,2,2,0,2.2230620456616944e-05,0.0,1.0
26199,승환/Noun,2,0,2,0.0,2.2213830330763933e-05,1.0
26200,7.59/Number,2,0,2,0.0,2.2213830330763933e-05,1.0
26201,덴마크어/Noun,2,0,2,0.0,2.2213830330763933e-05,1.0
26202,소론/Noun,2,2,0,2.2230620456616944e-05,0.0,1.0
26203,노론/Noun,2,2,0,2.2230620456616944e-05,0.0,1.0
26204,귓/Noun,2,0,2,0.0,2.2213830330763933e-05,1.0
26205,김근태/Noun,2,2,0,2.2230620456616944e-05,0.0,1.0
26206,나이키/Noun,2,2,0,2.2230620456616944e-05,0.0,1.0
26207,프로방스/Noun,2,2,0,2.2230620456616944e-05,0.0,1.0
26208,5억년/Number,2,0,2,0.0,2.2213830330763933e-05,1.0
26209,성악설/Noun,2,2,0,2.2230620456616944e-05,0.0,1.0
26210,마후라/Noun,2,2,0,2.2230620456616944e-05,0.0,1.0
26211,창조성/Noun,2,0,2,0.0,2.2213830330763933e-05,1.0
26212,릅/Noun,2,2,0,2.2230620456616944e-05,0.0,1.0
26213,이탈리아영화/Noun,2,2,0,2.2230620456616944e-05,0.0,1.0
26214,after/Alpha,2,2,0,2.2230620456616944e-05,0.0,1.0
26215,일본자위대/Noun,2,0,2,0.0,2.2213830330763933e-05,1.0
26216,계략/Noun,2,0,2,0.0,2.2213830330763933e-05,1.0
26217,요금/Noun,2,0,2,0.0,2.2213830330763933e-05,1.0
26218,츼/Noun,2,2,0,2.2230620456616944e-05,0.0,1.0
26219,꿀잼꿀/Noun,2,2,0,2.2230620456616944e-05,0.0,1.0
26220,공준수/Noun,2,2,0,2.2230620456616944e-05,0.0,1.0
26221,엿같다/Noun,2,0,2,0.0,2.2213830330763933e-05,1.0
26222,등줄기/Noun,2,2,0,2.2230620456616944e-05,0.0,1.0
26223,이민영/Noun,2,0,2,0.0,2.2213830330763933e-05,1.0
26224,술래잡기/Noun,2,0,2,0.0,2.2213830330763933e-05,1.0
26225,썜/Noun,2,0,2,0.0,2.2213830330763933e-05,1.0
26226,카탈/Noun,2,2,0,2.2230620456616944e-05,0.0,1.0
26227,시치미/Noun,2,0,2,0.0,2.2213830330763933e-05,1.0
26228,통닭/Noun,2,0,2,0.0,2.2213830330763933e-05,1.0
26229,페덱스/Noun,2,2,0,2.2230620456616944e-05,0.0,1.0
26230,연금술/Noun,2,2,0,2.2230620456616944e-05,0.0,1.0
26231,성괴녀/Noun,2,0,2,0.0,2.2213830330763933e-05,1.0
26232,존댓말/Noun,2,0,2,0.0,2.2213830330763933e-05,1.0
26233,착지/Noun,2,2,0,2.2230620456616944e-05,0.0,1.0
26234,퍼덕이다/Verb,2,0,2,0.0,2.2213830330763933e-05,1.0
26235,부끄럼/Noun,2,0,2,0.0,2.2213830330763933e-05,1.0
26236,쒸래기/Noun,2,0,2,0.0,2.2213830330763933e-05,1.0
26237,숀영/Noun,2,0,2,0.0,2.2213830330763933e-05,1.0
26238,옐로우/Noun,2,2,0,2.2230620456616944e-05,0.0,1.0
26239,공모전/Noun,2,0,2,0.0,2.2213830330763933e-05,1.0
26240,꼽음/Noun,2,2,0,2.2230620456616944e-05,0.0,1.0
26241,구구/Noun,2,2,0,2.2230620456616944e-05,0.0,1.0
26242,-_-+/Punctuation,2,0,2,0.0,2.2213830330763933e-05,1.0
26243,테이블/Noun,2,0,2,0.0,2.2213830330763933e-05,1.0
26244,whatever/Alpha,2,2,0,2.2230620456616944e-05,0.0,1.0
26245,레이디가가/Noun,2,0,2,0.0,2.2213830330763933e-05,1.0
26246,켄트/Noun,2,2,0,2.2230620456616944e-05,0.0,1.0
26247,어쩌거/Noun,2,0,2,0.0,2.2213830330763933e-05,1.0
26248,입소/Noun,2,0,2,0.0,2.2213830330763933e-05,1.0
26249,말박/Noun,2,2,0,2.2230620456616944e-05,0.0,1.0
26250,-^/Punctuation,2,2,0,2.2230620456616944e-05,0.0,1.0
26251,익룡/Noun,2,0,2,0.0,2.2213830330763933e-05,1.0
26252,150분/Number,2,0,2,0.0,2.2213830330763933e-05,1.0
26253,강별/Noun,2,2,0,2.2230620456616944e-05,0.0,1.0
26254,리가/Foreign,2,0,2,0.0,2.2213830330763933e-05,1.0
26255,서하준/Noun,2,0,2,0.0,2.2213830330763933e-05,1.0
26256,오창석/Noun,2,0,2,0.0,2.2213830330763933e-05,1.0
26257,우희진/Noun,2,2,0,2.2230620456616944e-05,0.0,1.0
26258,습성/Noun,2,0,2,0.0,2.2213830330763933e-05,1.0
26259,찬영/Noun,2,0,2,0.0,2.2213830330763933e-05,1.0
26260,제라/Noun,2,2,0,2.2230620456616944e-05,0.0,1.0
26261,곽동연/Noun,2,2,0,2.2230620456616944e-05,0.0,1.0
26262,루씨/Noun,2,2,0,2.2230620456616944e-05,0.0,1.0
26263,애액/Noun,2,0,2,0.0,2.2213830330763933e-05,1.0
26264,지난해/Noun,2,0,2,0.0,2.2213830330763933e-05,1.0
26265,쑥스럽다/Adjective,2,0,2,0.0,2.2213830330763933e-05,1.0
26266,내레이터/Noun,2,0,2,0.0,2.2213830330763933e-05,1.0
26267,0.27/Number,2,0,2,0.0,2.2213830330763933e-05,1.0
26268,못해/Noun,2,0,2,0.0,2.2213830330763933e-05,1.0
26269,사모/Noun,2,2,0,2.2230620456616944e-05,0.0,1.0
26270,철콘/Noun,2,2,0,2.2230620456616944e-05,0.0,1.0
26271,쉬레귀/Noun,2,0,2,0.0,2.2213830330763933e-05,1.0
26272,주체성/Noun,2,2,0,2.2230620456616944e-05,0.0,1.0
26273,오만상/Noun,2,0,2,0.0,2.2213830330763933e-05,1.0
26274,니체/Noun,2,2,0,2.2230620456616944e-05,0.0,1.0
26275,느꼇네/Noun,2,2,0,2.2230620456616944e-05,0.0,1.0
26276,밑그림/Noun,2,0,2,0.0,2.2213830330763933e-05,1.0
26277,보조개/Noun,2,2,0,2.2230620456616944e-05,0.0,1.0
26278,50초/Number,2,0,2,0.0,2.2213830330763933e-05,1.0
26279,;-/Punctuation,2,2,0,2.2230620456616944e-05,0.0,1.0
26280,더헌트/Noun,2,2,0,2.2230620456616944e-05,0.0,1.0
26281,개제/Noun,2,0,2,0.0,2.2213830330763933e-05,1.0
26282,교차점/Noun,2,2,0,2.2230620456616944e-05,0.0,1.0
26283,나이트클럽/Noun,2,0,2,0.0,2.2213830330763933e-05,1.0
26284,일절/Noun,2,2,0,2.2230620456616944e-05,0.0,1.0
26285,네오리얼리즘/Noun,2,2,0,2.2230620456616944e-05,0.0,1.0
26286,할렘/Noun,2,2,0,2.2230620456616944e-05,0.0,1.0
26287,외피/Noun,2,2,0,2.2230620456616944e-05,0.0,1.0
26288,종업원/Noun,2,2,0,2.2230620456616944e-05,0.0,1.0
26289,컬렉션/Noun,2,2,0,2.2230620456616944e-05,0.0,1.0
26290,김수안/Noun,2,2,0,2.2230620456616944e-05,0.0,1.0
26291,폴락/Noun,2,2,0,2.2230620456616944e-05,0.0,1.0
26292,조역/Noun,2,0,2,0.0,2.2213830330763933e-05,1.0
26293,together/Alpha,2,2,0,2.2230620456616944e-05,0.0,1.0
26294,액터/Noun,2,0,2,0.0,2.2213830330763933e-05,1.0
26295,기린/Noun,2,0,2,0.0,2.2213830330763933e-05,1.0
26296,로왓/Noun,2,2,0,2.2230620456616944e-05,0.0,1.0
26297,서인영/Noun,2,2,0,2.2230620456616944e-05,0.0,1.0
26298,프로잭/Noun,2,0,2,0.0,2.2213830330763933e-05,1.0
26299,았습니/Noun,2,0,2,0.0,2.2213830330763933e-05,1.0
26300,메겨/Noun,2,0,2,0.0,2.2213830330763933e-05,1.0
26301,하문/Noun,2,2,0,2.2230620456616944e-05,0.0,1.0
26302,에쓰/Noun,2,0,2,0.0,2.2213830330763933e-05,1.0
26303,오성/Noun,2,0,2,0.0,2.2213830330763933e-05,1.0
26304,밀접하다/Adjective,2,2,0,2.2230620456616944e-05,0.0,1.0
26305,게게/Noun,2,0,2,0.0,2.2213830330763933e-05,1.0
26306,껒/Noun,2,0,2,0.0,2.2213830330763933e-05,1.0
26307,BoA/Alpha,2,2,0,2.2230620456616944e-05,0.0,1.0
26308,말갛다/Adjective,2,0,2,0.0,2.2213830330763933e-05,1.0
26309,Off/Alpha,2,2,0,2.2230620456616944e-05,0.0,1.0
26310,록타/Noun,2,2,0,2.2230620456616944e-05,0.0,1.0
26311,-;;.../Punctuation,2,0,2,0.0,2.2213830330763933e-05,1.0
26312,활성화/Noun,2,0,2,0.0,2.2213830330763933e-05,1.0
26313,하윤/Noun,2,2,0,2.2230620456616944e-05,0.0,1.0
26314,존웃/Noun,2,2,0,2.2230620456616944e-05,0.0,1.0
26315,꼬기/Noun,2,0,2,0.0,2.2213830330763933e-05,1.0
26316,......;/Punctuation,2,0,2,0.0,2.2213830330763933e-05,1.0
26317,뉴타입/Noun,2,0,2,0.0,2.2213830330763933e-05,1.0
26318,띨빵/Noun,2,0,2,0.0,2.2213830330763933e-05,1.0
26319,우경/Noun,2,0,2,0.0,2.2213830330763933e-05,1.0
26320,모르모트/Noun,2,0,2,0.0,2.2213830330763933e-05,1.0
26321,영양소/Noun,2,2,0,2.2230620456616944e-05,0.0,1.0
26322,모빌/Noun,2,2,0,2.2230620456616944e-05,0.0,1.0
26323,카운티/Noun,2,2,0,2.2230620456616944e-05,0.0,1.0
26324,매디슨/Noun,2,2,0,2.2230620456616944e-05,0.0,1.0
26325,빈라덴/Noun,2,0,2,0.0,2.2213830330763933e-05,1.0
26326,?...../Punctuation,2,0,2,0.0,2.2213830330763933e-05,1.0
26327,@_/ScreenName,2,2,0,2.2230620456616944e-05,0.0,1.0
26328,쵝오네/Noun,2,2,0,2.2230620456616944e-05,0.0,1.0
26329,수여/Noun,2,0,2,0.0,2.2213830330763933e-05,1.0
26330,견학/Noun,2,0,2,0.0,2.2213830330763933e-05,1.0
26331,충청/Noun,2,0,2,0.0,2.2213830330763933e-05,1.0
26332,영상편집/Noun,2,0,2,0.0,2.2213830330763933e-05,1.0
26333,삘난다/Noun,2,0,2,0.0,2.2213830330763933e-05,1.0
26334,교집합/Noun,2,2,0,2.2230620456616944e-05,0.0,1.0
26335,단원/Noun,2,2,0,2.2230620456616944e-05,0.0,1.0
26336,어치/Noun,2,0,2,0.0,2.2213830330763933e-05,1.0
26337,치프/Noun,2,0,2,0.0,2.2213830330763933e-05,1.0
26338,휴고/Noun,2,2,0,2.2230620456616944e-05,0.0,1.0
26339,모델하우스/Noun,2,0,2,0.0,2.2213830330763933e-05,1.0
26340,사인방/Noun,2,2,0,2.2230620456616944e-05,0.0,1.0
26341,아세아극장/Noun,2,2,0,2.2230620456616944e-05,0.0,1.0
26342,도인가/Foreign,2,2,0,2.2230620456616944e-05,0.0,1.0
26343,마상/Noun,2,2,0,2.2230620456616944e-05,0.0,1.0
26344,곽지균/Noun,2,2,0,2.2230620456616944e-05,0.0,1.0
26345,카세트/Noun,2,2,0,2.2230620456616944e-05,0.0,1.0
26346,맹하/Noun,2,0,2,0.0,2.2213830330763933e-05,1.0
26347,나오키/Noun,2,0,2,0.0,2.2213830330763933e-05,1.0
26348,김기리/Noun,2,0,2,0.0,2.2213830330763933e-05,1.0
26349,네트렙코/Noun,2,2,0,2.2230620456616944e-05,0.0,1.0
26350,푸치니/Noun,2,2,0,2.2230620456616944e-05,0.0,1.0
26351,루디빈/Noun,2,2,0,2.2230620456616944e-05,0.0,1.0
26352,GooD/Alpha,2,2,0,2.2230620456616944e-05,0.0,1.0
26353,덜컥/Noun,2,0,2,0.0,2.2213830330763933e-05,1.0
26354,꼬았어/Noun,2,0,2,0.0,2.2213830330763933e-05,1.0
26355,꽈베기/Noun,2,0,2,0.0,2.2213830330763933e-05,1.0
26356,핫산/Noun,2,2,0,2.2230620456616944e-05,0.0,1.0
26357,아사카/Noun,2,2,0,2.2230620456616944e-05,0.0,1.0
26358,표피/Noun,2,0,2,0.0,2.2213830330763933e-05,1.0
26359,작이다/Foreign,2,2,0,2.2230620456616944e-05,0.0,1.0
26360,다독이다/Verb,2,2,0,2.2230620456616944e-05,0.0,1.0
26361,불로/Noun,2,0,2,0.0,2.2213830330763933e-05,1.0
26362,IBM/Alpha,2,2,0,2.2230620456616944e-05,0.0,1.0
26363,토양/Noun,2,0,2,0.0,2.2213830330763933e-05,1.0
26364,커터칼/Noun,2,0,2,0.0,2.2213830330763933e-05,1.0
26365,tomorrow/Alpha,2,2,0,2.2230620456616944e-05,0.0,1.0
26366,coming/Alpha,2,2,0,2.2230620456616944e-05,0.0,1.0
26367,用/Foreign,2,0,2,0.0,2.2213830330763933e-05,1.0
26368,호홉/Noun,2,2,0,2.2230620456616944e-05,0.0,1.0
26369,독학/Noun,2,0,2,0.0,2.2213830330763933e-05,1.0
26370,High/Alpha,2,2,0,2.2230620456616944e-05,0.0,1.0
26371,클로스/Noun,2,0,2,0.0,2.2213830330763933e-05,1.0
26372,안치우/Noun,2,0,2,0.0,2.2213830330763933e-05,1.0
26373,숙소/Noun,2,0,2,0.0,2.2213830330763933e-05,1.0
26374,무작위/Noun,2,0,2,0.0,2.2213830330763933e-05,1.0
26375,속궁합/Noun,2,0,2,0.0,2.2213830330763933e-05,1.0
26376,색소폰/Noun,2,2,0,2.2230620456616944e-05,0.0,1.0
26377,만루홈런/Noun,2,2,0,2.2230620456616944e-05,0.0,1.0
26378,십자군/Noun,2,2,0,2.2230620456616944e-05,0.0,1.0
26379,올빼미/Noun,2,2,0,2.2230620456616944e-05,0.0,1.0
26380,이재준/Noun,2,2,0,2.2230620456616944e-05,0.0,1.0
26381,웅역/Noun,2,2,0,2.2230620456616944e-05,0.0,1.0
26382,점검/Noun,2,2,0,2.2230620456616944e-05,0.0,1.0
26383,어쩌겠어/Noun,2,0,2,0.0,2.2213830330763933e-05,1.0
26384,관인/Noun,2,2,0,2.2230620456616944e-05,0.0,1.0
26385,감투/Noun,2,0,2,0.0,2.2213830330763933e-05,1.0
26386,비창/Noun,2,2,0,2.2230620456616944e-05,0.0,1.0
26387,애먼/Modifier,2,0,2,0.0,2.2213830330763933e-05,1.0
26388,건재/Noun,2,2,0,2.2230620456616944e-05,0.0,1.0
26389,알빠/Noun,2,0,2,0.0,2.2213830330763933e-05,1.0
26390,무호/Noun,2,2,0,2.2230620456616944e-05,0.0,1.0
26391,휘테/Noun,2,0,2,0.0,2.2213830330763933e-05,1.0
26392,출입구/Noun,2,2,0,2.2230620456616944e-05,0.0,1.0
26393,페시/Noun,2,2,0,2.2230620456616944e-05,0.0,1.0
26394,YES/Alpha,2,0,2,0.0,2.2213830330763933e-05,1.0
26395,홍여진/Noun,2,0,2,0.0,2.2213830330763933e-05,1.0
26396,장하/Noun,2,0,2,0.0,2.2213830330763933e-05,1.0
26397,앤워/Noun,2,2,0,2.2230620456616944e-05,0.0,1.0
26398,이탈리안잡/Noun,2,2,0,2.2230620456616944e-05,0.0,1.0
26399,아련/Noun,2,2,0,2.2230620456616944e-05,0.0,1.0
26400,워스/Noun,2,2,0,2.2230620456616944e-05,0.0,1.0
26401,!?../Punctuation,2,0,2,0.0,2.2213830330763933e-05,1.0
26402,법치국가/Noun,2,0,2,0.0,2.2213830330763933e-05,1.0
26403,태의/Noun,2,0,2,0.0,2.2213830330763933e-05,1.0
26404,용타/Noun,2,0,2,0.0,2.2213830330763933e-05,1.0
26405,초지일관/Noun,2,0,2,0.0,2.2213830330763933e-05,1.0
26406,엘렉트라/Noun,2,0,2,0.0,2.2213830330763933e-05,1.0
26407,비기닝/Noun,2,2,0,2.2230620456616944e-05,0.0,1.0
26408,지나서/Foreign,2,2,0,2.2230620456616944e-05,0.0,1.0
26409,절의/Noun,2,2,0,2.2230620456616944e-05,0.0,1.0
26410,프리러닝/Noun,2,0,2,0.0,2.2213830330763933e-05,1.0
26411,원사/Noun,2,0,2,0.0,2.2213830330763933e-05,1.0
26412,피해망상증/Noun,2,0,2,0.0,2.2213830330763933e-05,1.0
26413,과관/Noun,2,0,2,0.0,2.2213830330763933e-05,1.0
26414,선박/Noun,2,0,2,0.0,2.2213830330763933e-05,1.0
26415,개똥폼/Noun,2,0,2,0.0,2.2213830330763933e-05,1.0
26416,반어법/Noun,2,0,2,0.0,2.2213830330763933e-05,1.0
26417,읊어대/Noun,2,0,2,0.0,2.2213830330763933e-05,1.0
26418,Zzz/Alpha,2,0,2,0.0,2.2213830330763933e-05,1.0
26419,컬쳐쇼크/Noun,2,2,0,2.2230620456616944e-05,0.0,1.0
26420,loving/Alpha,2,2,0,2.2230620456616944e-05,0.0,1.0
26421,자치/Noun,2,0,2,0.0,2.2213830330763933e-05,1.0
26422,쿠데타/Noun,2,0,2,0.0,2.2213830330763933e-05,1.0
26423,~???/Punctuation,2,0,2,0.0,2.2213830330763933e-05,1.0
26424,200억원/Number,2,0,2,0.0,2.2213830330763933e-05,1.0
26425,더무/Noun,2,2,0,2.2230620456616944e-05,0.0,1.0
26426,오키도키/Noun,2,2,0,2.2230620456616944e-05,0.0,1.0
26427,Where/Alpha,2,2,0,2.2230620456616944e-05,0.0,1.0
26428,만고불변/Noun,2,2,0,2.2230620456616944e-05,0.0,1.0
26429,인고/Noun,2,2,0,2.2230620456616944e-05,0.0,1.0
26430,ㄴㅏ/KoreanParticle,2,2,0,2.2230620456616944e-05,0.0,1.0
26431,ㅇㅁㅇ/KoreanParticle,2,2,0,2.2230620456616944e-05,0.0,1.0
26432,타나/Noun,2,0,2,0.0,2.2213830330763933e-05,1.0
26433,남보라/Noun,2,0,2,0.0,2.2213830330763933e-05,1.0
26434,판타지아/Noun,2,2,0,2.2230620456616944e-05,0.0,1.0
26435,얼버/Noun,2,0,2,0.0,2.2213830330763933e-05,1.0
26436,능겨/Noun,2,0,2,0.0,2.2213830330763933e-05,1.0
26437,포멧/Noun,2,0,2,0.0,2.2213830330763933e-05,1.0
26438,퇴학/Noun,2,2,0,2.2230620456616944e-05,0.0,1.0
26439,갸웃/Adverb,2,0,2,0.0,2.2213830330763933e-05,1.0
26440,채용/Noun,2,0,2,0.0,2.2213830330763933e-05,1.0
26441,튕기/Noun,2,2,0,2.2230620456616944e-05,0.0,1.0
26442,꽃집/Noun,2,0,2,0.0,2.2213830330763933e-05,1.0
26443,희망사항/Noun,2,0,2,0.0,2.2213830330763933e-05,1.0
26444,..=_=/Punctuation,2,0,2,0.0,2.2213830330763933e-05,1.0
26445,액정/Noun,2,0,2,0.0,2.2213830330763933e-05,1.0
26446,수족관/Noun,2,2,0,2.2230620456616944e-05,0.0,1.0
26447,산채/Noun,2,0,2,0.0,2.2213830330763933e-05,1.0
26448,고룡/Noun,2,2,0,2.2230620456616944e-05,0.0,1.0
26449,ㅣㄹㅣ/KoreanParticle,2,2,0,2.2230620456616944e-05,0.0,1.0
26450,미당/Noun,2,2,0,2.2230620456616944e-05,0.0,1.0
26451,겜썸/Noun,2,0,2,0.0,2.2213830330763933e-05,1.0
26452,Zzzzz/Alpha,2,0,2,0.0,2.2213830330763933e-05,1.0
26453,스테이지/Noun,2,2,0,2.2230620456616944e-05,0.0,1.0
26454,쉣쉣/Noun,2,0,2,0.0,2.2213830330763933e-05,1.0
26455,쉣뜨쉣뜨쉐엣뜨쒯/Noun,2,0,2,0.0,2.2213830330763933e-05,1.0
26456,8~90년/Number,2,0,2,0.0,2.2213830330763933e-05,1.0
26457,순옥/Noun,2,0,2,0.0,2.2213830330763933e-05,1.0
26458,ㅠㅂㅠ/KoreanParticle,2,2,0,2.2230620456616944e-05,0.0,1.0
26459,화지/Noun,2,2,0,2.2230620456616944e-05,0.0,1.0
26460,칼국수/Noun,2,0,2,0.0,2.2213830330763933e-05,1.0
26461,배불뚝이/Noun,2,0,2,0.0,2.2213830330763933e-05,1.0
26462,앵앵/Adverb,2,0,2,0.0,2.2213830330763933e-05,1.0
26463,변검/Noun,2,2,0,2.2230620456616944e-05,0.0,1.0
26464,직딩/Noun,2,2,0,2.2230620456616944e-05,0.0,1.0
26465,해피앤드/Noun,2,2,0,2.2230620456616944e-05,0.0,1.0
26466,양비론/Noun,2,0,2,0.0,2.2213830330763933e-05,1.0
26467,^^//Punctuation,2,2,0,2.2230620456616944e-05,0.0,1.0
26468,그대만/Noun,2,2,0,2.2230620456616944e-05,0.0,1.0
26469,김용택/Noun,2,2,0,2.2230620456616944e-05,0.0,1.0
26470,패왕색/Noun,2,0,2,0.0,2.2213830330763933e-05,1.0
26471,오존/Noun,2,2,0,2.2230620456616944e-05,0.0,1.0
26472,sihoo/Alpha,2,2,0,2.2230620456616944e-05,0.0,1.0
26473,유단자/Noun,2,2,0,2.2230620456616944e-05,0.0,1.0
26474,쀍/Noun,2,0,2,0.0,2.2213830330763933e-05,1.0
26475,어니/Noun,2,2,0,2.2230620456616944e-05,0.0,1.0
26476,보노/Noun,2,2,0,2.2230620456616944e-05,0.0,1.0
26477,교수형/Noun,2,2,0,2.2230620456616944e-05,0.0,1.0
26478,Jennifer/Alpha,2,0,2,0.0,2.2213830330763933e-05,1.0
26479,서독/Noun,2,0,2,0.0,2.2213830330763933e-05,1.0
26480,불황/Noun,2,0,2,0.0,2.2213830330763933e-05,1.0
26481,봣다간/Noun,2,0,2,0.0,2.2213830330763933e-05,1.0
26482,손전등/Noun,2,0,2,0.0,2.2213830330763933e-05,1.0
26483,우창/Noun,2,0,2,0.0,2.2213830330763933e-05,1.0
26484,번안/Noun,2,2,0,2.2230620456616944e-05,0.0,1.0
26485,마블코믹스/Noun,2,0,2,0.0,2.2213830330763933e-05,1.0
26486,톱질/Noun,2,0,2,0.0,2.2213830330763933e-05,1.0
26487,에슬란/Noun,2,0,2,0.0,2.2213830330763933e-05,1.0
26488,또뭐/Noun,2,0,2,0.0,2.2213830330763933e-05,1.0
26489,신진/Noun,2,2,0,2.2230620456616944e-05,0.0,1.0
26490,스티커/Noun,2,2,0,2.2230620456616944e-05,0.0,1.0
26491,타투/Noun,2,2,0,2.2230620456616944e-05,0.0,1.0
26492,차비/Noun,2,0,2,0.0,2.2213830330763933e-05,1.0
26493,발레단/Noun,2,2,0,2.2230620456616944e-05,0.0,1.0
26494,전액/Noun,2,0,2,0.0,2.2213830330763933e-05,1.0
26495,룻/Noun,2,2,0,2.2230620456616944e-05,0.0,1.0
26496,번번하다/Adjective,2,0,2,0.0,2.2213830330763933e-05,1.0
26497,소취/Noun,2,2,0,2.2230620456616944e-05,0.0,1.0
26498,망또/Noun,2,2,0,2.2230620456616944e-05,0.0,1.0
26499,><!!/Punctuation,2,2,0,2.2230620456616944e-05,0.0,1.0
26500,나잼/Noun,2,0,2,0.0,2.2213830330763933e-05,1.0
26501,(^^)/Punctuation,2,2,0,2.2230620456616944e-05,0.0,1.0
26502,덴트/Noun,2,2,0,2.2230620456616944e-05,0.0,1.0
26503,NBA/Alpha,2,0,2,0.0,2.2213830330763933e-05,1.0
26504,패죽/Noun,2,0,2,0.0,2.2213830330763933e-05,1.0
26505,형대/Noun,2,0,2,0.0,2.2213830330763933e-05,1.0
26506,ㅠㅠㅋㅋ/KoreanParticle,2,2,0,2.2230620456616944e-05,0.0,1.0
26507,자메이카/Noun,2,2,0,2.2230620456616944e-05,0.0,1.0
26508,태정/Noun,2,0,2,0.0,2.2213830330763933e-05,1.0
26509,콘셉트/Noun,2,0,2,0.0,2.2213830330763933e-05,1.0
26510,넌지시/Noun,2,2,0,2.2230620456616944e-05,0.0,1.0
26511,당착/Noun,2,0,2,0.0,2.2213830330763933e-05,1.0
26512,넥슨/Noun,2,0,2,0.0,2.2213830330763933e-05,1.0
26513,제길슨/Noun,2,0,2,0.0,2.2213830330763933e-05,1.0
26514,똥누/Noun,2,0,2,0.0,2.2213830330763933e-05,1.0
26515,생년/Noun,2,0,2,0.0,2.2213830330763933e-05,1.0
26516,...^^~~/Punctuation,2,2,0,2.2230620456616944e-05,0.0,1.0
26517,흐믓하/Noun,2,2,0,2.2230620456616944e-05,0.0,1.0
26518,컴버배치/Noun,2,2,0,2.2230620456616944e-05,0.0,1.0
26519,스캐일/Noun,2,0,2,0.0,2.2213830330763933e-05,1.0
26520,갈껀데/Noun,2,2,0,2.2230620456616944e-05,0.0,1.0
26521,웅변/Noun,2,0,2,0.0,2.2213830330763933e-05,1.0
26522,부용/Noun,2,0,2,0.0,2.2213830330763933e-05,1.0
26523,줮/Noun,2,0,2,0.0,2.2213830330763933e-05,1.0
26524,빡빡/Noun,2,0,2,0.0,2.2213830330763933e-05,1.0
26525,체/Exclamation,2,0,2,0.0,2.2213830330763933e-05,1.0
26526,전성/Noun,2,2,0,2.2230620456616944e-05,0.0,1.0
26527,멋졍/Noun,2,2,0,2.2230620456616944e-05,0.0,1.0
26528,대대장/Noun,2,2,0,2.2230620456616944e-05,0.0,1.0
26529,병희/Noun,2,2,0,2.2230620456616944e-05,0.0,1.0
26530,도예/Noun,2,0,2,0.0,2.2213830330763933e-05,1.0
26531,조온/Noun,2,2,0,2.2230620456616944e-05,0.0,1.0
26532,핀카엡/Noun,2,0,2,0.0,2.2213830330763933e-05,1.0
26533,4.39/Number,2,0,2,0.0,2.2213830330763933e-05,1.0
26534,케다/Noun,2,2,0,2.2230620456616944e-05,0.0,1.0
26535,쿨쿨/Noun,2,0,2,0.0,2.2213830330763933e-05,1.0
26536,가렐/Noun,2,2,0,2.2230620456616944e-05,0.0,1.0
26537,이브생로랑/Noun,2,2,0,2.2230620456616944e-05,0.0,1.0
26538,happen/Alpha,2,2,0,2.2230620456616944e-05,0.0,1.0
26539,치열/Noun,2,2,0,2.2230620456616944e-05,0.0,1.0
26540,386/Number,2,2,0,2.2230620456616944e-05,0.0,1.0
26541,개관/Noun,2,0,2,0.0,2.2213830330763933e-05,1.0
26542,천일/Noun,2,2,0,2.2230620456616944e-05,0.0,1.0
26543,읹/Noun,2,0,2,0.0,2.2213830330763933e-05,1.0
26544,미스포터/Noun,2,2,0,2.2230620456616944e-05,0.0,1.0
26545,파판/Noun,2,0,2,0.0,2.2213830330763933e-05,1.0
26546,노먼/Noun,2,2,0,2.2230620456616944e-05,0.0,1.0
26547,이세창/Noun,2,0,2,0.0,2.2213830330763933e-05,1.0
26548,체육/Noun,2,2,0,2.2230620456616944e-05,0.0,1.0
26549,마콩/Noun,2,0,2,0.0,2.2213830330763933e-05,1.0
26550,장미란/Noun,2,0,2,0.0,2.2213830330763933e-05,1.0
26551,3500/Number,2,0,2,0.0,2.2213830330763933e-05,1.0
26552,비취/Noun,2,2,0,2.2230620456616944e-05,0.0,1.0
26553,전에도/Foreign,2,0,2,0.0,2.2213830330763933e-05,1.0
26554,운동장/Noun,2,2,0,2.2230620456616944e-05,0.0,1.0
26555,서성/Noun,2,2,0,2.2230620456616944e-05,0.0,1.0
26556,ㅡㅠㅡ/KoreanParticle,2,0,2,0.0,2.2213830330763933e-05,1.0
26557,페어/Noun,2,2,0,2.2230620456616944e-05,0.0,1.0
26558,극작/Noun,2,2,0,2.2230620456616944e-05,0.0,1.0
26559,핸폰/Noun,2,0,2,0.0,2.2213830330763933e-05,1.0
26560,kia/Alpha,2,0,2,0.0,2.2213830330763933e-05,1.0
26561,Fucking/Alpha,2,0,2,0.0,2.2213830330763933e-05,1.0
26562,건들건들/Adverb,2,0,2,0.0,2.2213830330763933e-05,1.0
26563,목욕씬/Noun,2,0,2,0.0,2.2213830330763933e-05,1.0
26564,자위대/Noun,2,0,2,0.0,2.2213830330763933e-05,1.0
26565,갈겨쓰다/Verb,2,0,2,0.0,2.2213830330763933e-05,1.0
26566,애사/Noun,2,0,2,0.0,2.2213830330763933e-05,1.0
26567,센송합니/Noun,2,2,0,2.2230620456616944e-05,0.0,1.0
26568,도울/Noun,2,0,2,0.0,2.2213830330763933e-05,1.0
26569,61년/Number,2,1,1,1.1115310228308472e-05,1.1106915165381966e-05,0.5
26570,사력/Noun,2,1,1,1.1115310228308472e-05,1.1106915165381966e-05,0.5
26571,소현/Noun,2,1,1,1.1115310228308472e-05,1.1106915165381966e-05,0.5
26572,대뷔작/Noun,2,1,1,1.1115310228308472e-05,1.1106915165381966e-05,0.5
26573,해놧/Noun,2,1,1,1.1115310228308472e-05,1.1106915165381966e-05,0.5
26574,패닉룸/Noun,2,1,1,1.1115310228308472e-05,1.1106915165381966e-05,0.5
26575,간도/Noun,2,1,1,1.1115310228308472e-05,1.1106915165381966e-05,0.5
26576,알받이/Noun,2,1,1,1.1115310228308472e-05,1.1106915165381966e-05,0.5
26577,태초/Noun,2,1,1,1.1115310228308472e-05,1.1106915165381966e-05,0.5
26578,7시간/Number,2,1,1,1.1115310228308472e-05,1.1106915165381966e-05,0.5
26579,최씨/Noun,2,1,1,1.1115310228308472e-05,1.1106915165381966e-05,0.5
26580,한정판/Noun,2,1,1,1.1115310228308472e-05,1.1106915165381966e-05,0.5
26581,휘태/Noun,2,1,1,1.1115310228308472e-05,1.1106915165381966e-05,0.5
26582,방광/Noun,2,1,1,1.1115310228308472e-05,1.1106915165381966e-05,0.5
26583,인공위성/Noun,2,1,1,1.1115310228308472e-05,1.1106915165381966e-05,0.5
26584,정치권/Noun,2,1,1,1.1115310228308472e-05,1.1106915165381966e-05,0.5
26585,김진숙/Noun,2,1,1,1.1115310228308472e-05,1.1106915165381966e-05,0.5
26586,cares/Alpha,2,1,1,1.1115310228308472e-05,1.1106915165381966e-05,0.5
26587,옥죄/Noun,2,1,1,1.1115310228308472e-05,1.1106915165381966e-05,0.5
26588,count/Alpha,2,1,1,1.1115310228308472e-05,1.1106915165381966e-05,0.5
26589,정성호/Noun,2,1,1,1.1115310228308472e-05,1.1106915165381966e-05,0.5
26590,",,!!/Punctuation",2,1,1,1.1115310228308472e-05,1.1106915165381966e-05,0.5
26591,구설수/Noun,2,1,1,1.1115310228308472e-05,1.1106915165381966e-05,0.5
26592,에선/Foreign,2,1,1,1.1115310228308472e-05,1.1106915165381966e-05,0.5
26593,곶/Noun,2,1,1,1.1115310228308472e-05,1.1106915165381966e-05,0.5
26594,asd/Alpha,2,1,1,1.1115310228308472e-05,1.1106915165381966e-05,0.5
26595,아인슈타인/Noun,2,1,1,1.1115310228308472e-05,1.1106915165381966e-05,0.5
26596,코란/Noun,2,1,1,1.1115310228308472e-05,1.1106915165381966e-05,0.5
26597,8.56/Number,2,1,1,1.1115310228308472e-05,1.1106915165381966e-05,0.5
26598,다양해지다/Verb,2,1,1,1.1115310228308472e-05,1.1106915165381966e-05,0.5
26599,대야/Noun,2,1,1,1.1115310228308472e-05,1.1106915165381966e-05,0.5
26600,후처/Noun,2,1,1,1.1115310228308472e-05,1.1106915165381966e-05,0.5
26601,조력자/Noun,2,1,1,1.1115310228308472e-05,1.1106915165381966e-05,0.5
26602,부사관/Noun,2,1,1,1.1115310228308472e-05,1.1106915165381966e-05,0.5
26603,밸루/Noun,2,1,1,1.1115310228308472e-05,1.1106915165381966e-05,0.5
26604,흙흙/Noun,2,1,1,1.1115310228308472e-05,1.1106915165381966e-05,0.5
26605,젬없다/Noun,2,1,1,1.1115310228308472e-05,1.1106915165381966e-05,0.5
26606,담합/Noun,2,1,1,1.1115310228308472e-05,1.1106915165381966e-05,0.5
26607,승부조작/Noun,2,1,1,1.1115310228308472e-05,1.1106915165381966e-05,0.5
26608,급소/Noun,2,1,1,1.1115310228308472e-05,1.1106915165381966e-05,0.5
26609,환경미화원/Noun,2,1,1,1.1115310228308472e-05,1.1106915165381966e-05,0.5
26610,방종/Noun,2,1,1,1.1115310228308472e-05,1.1106915165381966e-05,0.5
26611,쾌활하다/Adjective,2,1,1,1.1115310228308472e-05,1.1106915165381966e-05,0.5
26612,이승준/Noun,2,1,1,1.1115310228308472e-05,1.1106915165381966e-05,0.5
26613,덕만/Noun,2,1,1,1.1115310228308472e-05,1.1106915165381966e-05,0.5
26614,퍼킨/Noun,2,1,1,1.1115310228308472e-05,1.1106915165381966e-05,0.5
26615,수퍼노바/Noun,2,1,1,1.1115310228308472e-05,1.1106915165381966e-05,0.5
26616,노티/Noun,2,1,1,1.1115310228308472e-05,1.1106915165381966e-05,0.5
26617,레스토랑/Noun,2,1,1,1.1115310228308472e-05,1.1106915165381966e-05,0.5
26618,이유비/Noun,2,1,1,1.1115310228308472e-05,1.1106915165381966e-05,0.5
26619,윤세아/Noun,2,1,1,1.1115310228308472e-05,1.1106915165381966e-05,0.5
26620,펀하다/Adjective,2,1,1,1.1115310228308472e-05,1.1106915165381966e-05,0.5
26621,xy/Alpha,2,1,1,1.1115310228308472e-05,1.1106915165381966e-05,0.5
26622,스티븐킹/Noun,2,1,1,1.1115310228308472e-05,1.1106915165381966e-05,0.5
26623,침범/Noun,2,1,1,1.1115310228308472e-05,1.1106915165381966e-05,0.5
26624,9.08/Number,2,1,1,1.1115310228308472e-05,1.1106915165381966e-05,0.5
26625,dj/Alpha,2,1,1,1.1115310228308472e-05,1.1106915165381966e-05,0.5
26626,렙틸/Noun,2,1,1,1.1115310228308472e-05,1.1106915165381966e-05,0.5
26627,관계성/Noun,2,1,1,1.1115310228308472e-05,1.1106915165381966e-05,0.5
26628,슴돠/Noun,2,1,1,1.1115310228308472e-05,1.1106915165381966e-05,0.5
26629,big/Alpha,2,1,1,1.1115310228308472e-05,1.1106915165381966e-05,0.5
26630,알쏭달쏭하다/Adjective,2,1,1,1.1115310228308472e-05,1.1106915165381966e-05,0.5
26631,/.../Punctuation,2,1,1,1.1115310228308472e-05,1.1106915165381966e-05,0.5
26632,삼장법사/Noun,2,1,1,1.1115310228308472e-05,1.1106915165381966e-05,0.5
26633,로비스트/Noun,2,1,1,1.1115310228308472e-05,1.1106915165381966e-05,0.5
26634,번작/Noun,2,1,1,1.1115310228308472e-05,1.1106915165381966e-05,0.5
26635,액센트/Noun,2,1,1,1.1115310228308472e-05,1.1106915165381966e-05,0.5
26636,7.30/Number,2,1,1,1.1115310228308472e-05,1.1106915165381966e-05,0.5
26637,운기/Noun,2,1,1,1.1115310228308472e-05,1.1106915165381966e-05,0.5
26638,귻/Noun,2,1,1,1.1115310228308472e-05,1.1106915165381966e-05,0.5
26639,비욘드/Noun,2,1,1,1.1115310228308472e-05,1.1106915165381966e-05,0.5
26640,모종/Noun,2,1,1,1.1115310228308472e-05,1.1106915165381966e-05,0.5
26641,짐심/Noun,2,1,1,1.1115310228308472e-05,1.1106915165381966e-05,0.5
26642,오즈의마법사/Noun,2,1,1,1.1115310228308472e-05,1.1106915165381966e-05,0.5
26643,전에봤는데/Foreign,2,1,1,1.1115310228308472e-05,1.1106915165381966e-05,0.5
26644,메모리즈/Noun,2,1,1,1.1115310228308472e-05,1.1106915165381966e-05,0.5
26645,은신/Noun,2,1,1,1.1115310228308472e-05,1.1106915165381966e-05,0.5
26646,우리별/Noun,2,1,1,1.1115310228308472e-05,1.1106915165381966e-05,0.5
26647,쪼꼬/Noun,2,1,1,1.1115310228308472e-05,1.1106915165381966e-05,0.5
26648,헬스장/Noun,2,1,1,1.1115310228308472e-05,1.1106915165381966e-05,0.5
26649,퐁/Noun,2,1,1,1.1115310228308472e-05,1.1106915165381966e-05,0.5
26650,잠바/Noun,2,1,1,1.1115310228308472e-05,1.1106915165381966e-05,0.5
26651,똘기/Noun,2,1,1,1.1115310228308472e-05,1.1106915165381966e-05,0.5
26652,""".../Punctuation",2,1,1,1.1115310228308472e-05,1.1106915165381966e-05,0.5
26653,푸석하다/Adjective,2,1,1,1.1115310228308472e-05,1.1106915165381966e-05,0.5
26654,ㅣㅏ/KoreanParticle,2,1,1,1.1115310228308472e-05,1.1106915165381966e-05,0.5
26655,거렸다/Noun,2,1,1,1.1115310228308472e-05,1.1106915165381966e-05,0.5
26656,..?????/Punctuation,2,1,1,1.1115310228308472e-05,1.1106915165381966e-05,0.5
26657,곳좀/Noun,2,1,1,1.1115310228308472e-05,1.1106915165381966e-05,0.5
26658,고블린/Noun,2,1,1,1.1115310228308472e-05,1.1106915165381966e-05,0.5
26659,허허벌판/Noun,2,1,1,1.1115310228308472e-05,1.1106915165381966e-05,0.5
26660,에스터/Noun,2,1,1,1.1115310228308472e-05,1.1106915165381966e-05,0.5
26661,경박/Noun,2,1,1,1.1115310228308472e-05,1.1106915165381966e-05,0.5
26662,질겁/Noun,2,1,1,1.1115310228308472e-05,1.1106915165381966e-05,0.5
26663,베리만/Noun,2,1,1,1.1115310228308472e-05,1.1106915165381966e-05,0.5
26664,6일/Number,2,1,1,1.1115310228308472e-05,1.1106915165381966e-05,0.5
26665,콩빠들/Noun,2,1,1,1.1115310228308472e-05,1.1106915165381966e-05,0.5
26666,Les/Alpha,2,1,1,1.1115310228308472e-05,1.1106915165381966e-05,0.5
26667,저떻/Noun,2,1,1,1.1115310228308472e-05,1.1106915165381966e-05,0.5
26668,마스터베이션/Noun,2,1,1,1.1115310228308472e-05,1.1106915165381966e-05,0.5
26669,??./Punctuation,2,1,1,1.1115310228308472e-05,1.1106915165381966e-05,0.5
26670,VCD/Alpha,2,1,1,1.1115310228308472e-05,1.1106915165381966e-05,0.5
26671,흔쾌하다/Adjective,2,1,1,1.1115310228308472e-05,1.1106915165381966e-05,0.5
26672,지지도/Noun,2,1,1,1.1115310228308472e-05,1.1106915165381966e-05,0.5
26673,책좀/Noun,2,1,1,1.1115310228308472e-05,1.1106915165381966e-05,0.5
26674,자사/Noun,2,1,1,1.1115310228308472e-05,1.1106915165381966e-05,0.5
26675,센트럴/Noun,2,1,1,1.1115310228308472e-05,1.1106915165381966e-05,0.5
26676,행복찾기/Noun,2,1,1,1.1115310228308472e-05,1.1106915165381966e-05,0.5
26677,코딩/Noun,2,1,1,1.1115310228308472e-05,1.1106915165381966e-05,0.5
26678,닌깐/Noun,2,1,1,1.1115310228308472e-05,1.1106915165381966e-05,0.5
26679,샤프/Noun,2,1,1,1.1115310228308472e-05,1.1106915165381966e-05,0.5
26680,크리스에반스/Noun,2,1,1,1.1115310228308472e-05,1.1106915165381966e-05,0.5
26681,완저/Noun,2,1,1,1.1115310228308472e-05,1.1106915165381966e-05,0.5
26682,만평/Noun,2,1,1,1.1115310228308472e-05,1.1106915165381966e-05,0.5
26683,nothing/Alpha,2,1,1,1.1115310228308472e-05,1.1106915165381966e-05,0.5
26684,송가/Noun,2,1,1,1.1115310228308472e-05,1.1106915165381966e-05,0.5
26685,겨워/Noun,2,1,1,1.1115310228308472e-05,1.1106915165381966e-05,0.5
26686,흐느끼/Noun,2,1,1,1.1115310228308472e-05,1.1106915165381966e-05,0.5
26687,튿/Noun,2,1,1,1.1115310228308472e-05,1.1106915165381966e-05,0.5
26688,변색/Noun,2,1,1,1.1115310228308472e-05,1.1106915165381966e-05,0.5
26689,유로/Noun,2,1,1,1.1115310228308472e-05,1.1106915165381966e-05,0.5
26690,=>/Punctuation,2,1,1,1.1115310228308472e-05,1.1106915165381966e-05,0.5
26691,실례/Noun,2,1,1,1.1115310228308472e-05,1.1106915165381966e-05,0.5
26692,식감/Noun,2,1,1,1.1115310228308472e-05,1.1106915165381966e-05,0.5
26693,훜/Noun,2,1,1,1.1115310228308472e-05,1.1106915165381966e-05,0.5
26694,사치스럽다/Adjective,2,1,1,1.1115310228308472e-05,1.1106915165381966e-05,0.5
26695,기관단총/Noun,2,1,1,1.1115310228308472e-05,1.1106915165381966e-05,0.5
26696,침침하다/Adjective,2,1,1,1.1115310228308472e-05,1.1106915165381966e-05,0.5
26697,다난하다/Adjective,2,1,1,1.1115310228308472e-05,1.1106915165381966e-05,0.5
26698,지물/Noun,2,1,1,1.1115310228308472e-05,1.1106915165381966e-05,0.5
26699,말보로/Noun,2,1,1,1.1115310228308472e-05,1.1106915165381966e-05,0.5
26700,내신/Noun,2,1,1,1.1115310228308472e-05,1.1106915165381966e-05,0.5
26701,맥킨/Noun,2,1,1,1.1115310228308472e-05,1.1106915165381966e-05,0.5
26702,꼬드겨/Noun,2,1,1,1.1115310228308472e-05,1.1106915165381966e-05,0.5
26703,용비/Noun,2,1,1,1.1115310228308472e-05,1.1106915165381966e-05,0.5
26704,앙탈/Noun,2,1,1,1.1115310228308472e-05,1.1106915165381966e-05,0.5
26705,얔/Noun,2,1,1,1.1115310228308472e-05,1.1106915165381966e-05,0.5
26706,팅기다/Verb,2,1,1,1.1115310228308472e-05,1.1106915165381966e-05,0.5
26707,서민정/Noun,2,1,1,1.1115310228308472e-05,1.1106915165381966e-05,0.5
26708,항전/Noun,2,1,1,1.1115310228308472e-05,1.1106915165381966e-05,0.5
26709,라고도/Eomi,2,1,1,1.1115310228308472e-05,1.1106915165381966e-05,0.5
26710,--->/Punctuation,2,1,1,1.1115310228308472e-05,1.1106915165381966e-05,0.5
26711,없었슴/Noun,2,1,1,1.1115310228308472e-05,1.1106915165381966e-05,0.5
26712,마애/Noun,2,1,1,1.1115310228308472e-05,1.1106915165381966e-05,0.5
26713,멀린/Noun,2,1,1,1.1115310228308472e-05,1.1106915165381966e-05,0.5
26714,91분/Number,2,1,1,1.1115310228308472e-05,1.1106915165381966e-05,0.5
26715,김재철/Noun,2,1,1,1.1115310228308472e-05,1.1106915165381966e-05,0.5
26716,김지혜/Noun,2,1,1,1.1115310228308472e-05,1.1106915165381966e-05,0.5
26717,김성민/Noun,2,1,1,1.1115310228308472e-05,1.1106915165381966e-05,0.5
26718,독서/Noun,2,1,1,1.1115310228308472e-05,1.1106915165381966e-05,0.5
26719,팟/Noun,2,1,1,1.1115310228308472e-05,1.1106915165381966e-05,0.5
26720,김홍/Noun,2,1,1,1.1115310228308472e-05,1.1106915165381966e-05,0.5
26721,피로연/Noun,2,1,1,1.1115310228308472e-05,1.1106915165381966e-05,0.5
26722,클러치/Noun,2,1,1,1.1115310228308472e-05,1.1106915165381966e-05,0.5
26723,드랬/Noun,2,1,1,1.1115310228308472e-05,1.1106915165381966e-05,0.5
26724,설인/Noun,2,1,1,1.1115310228308472e-05,1.1106915165381966e-05,0.5
26725,앞줄/Noun,2,1,1,1.1115310228308472e-05,1.1106915165381966e-05,0.5
26726,cs/Alpha,2,1,1,1.1115310228308472e-05,1.1106915165381966e-05,0.5
26727,숨통/Noun,2,1,1,1.1115310228308472e-05,1.1106915165381966e-05,0.5
26728,미완/Noun,2,1,1,1.1115310228308472e-05,1.1106915165381966e-05,0.5
26729,중국드라마/Noun,2,1,1,1.1115310228308472e-05,1.1106915165381966e-05,0.5
26730,자등/Noun,2,1,1,1.1115310228308472e-05,1.1106915165381966e-05,0.5
26731,다채롭/Noun,2,1,1,1.1115310228308472e-05,1.1106915165381966e-05,0.5
26732,점유/Noun,2,1,1,1.1115310228308472e-05,1.1106915165381966e-05,0.5
26733,ㆍㆍ/Foreign,2,1,1,1.1115310228308472e-05,1.1106915165381966e-05,0.5
26734,?~~/Punctuation,2,1,1,1.1115310228308472e-05,1.1106915165381966e-05,0.5
26735,농업/Noun,2,1,1,1.1115310228308472e-05,1.1106915165381966e-05,0.5
26736,지바/Noun,2,1,1,1.1115310228308472e-05,1.1106915165381966e-05,0.5
26737,봈다/Noun,2,1,1,1.1115310228308472e-05,1.1106915165381966e-05,0.5
26738,~^^)/Punctuation,2,1,1,1.1115310228308472e-05,1.1106915165381966e-05,0.5
26739,힘나다/Adjective,2,1,1,1.1115310228308472e-05,1.1106915165381966e-05,0.5
26740,유능/Noun,2,1,1,1.1115310228308472e-05,1.1106915165381966e-05,0.5
26741,쿠퍼액/Noun,2,1,1,1.1115310228308472e-05,1.1106915165381966e-05,0.5
26742,!!!!~~/Punctuation,2,1,1,1.1115310228308472e-05,1.1106915165381966e-05,0.5
26743,주희/Noun,2,1,1,1.1115310228308472e-05,1.1106915165381966e-05,0.5
26744,펀집/Noun,2,1,1,1.1115310228308472e-05,1.1106915165381966e-05,0.5
26745,심리상담/Noun,2,1,1,1.1115310228308472e-05,1.1106915165381966e-05,0.5
26746,초승달/Noun,2,1,1,1.1115310228308472e-05,1.1106915165381966e-05,0.5
26747,마스터즈/Noun,2,1,1,1.1115310228308472e-05,1.1106915165381966e-05,0.5
26748,본점/Noun,2,1,1,1.1115310228308472e-05,1.1106915165381966e-05,0.5
26749,베가스/Noun,2,1,1,1.1115310228308472e-05,1.1106915165381966e-05,0.5
26750,애정씬/Noun,2,1,1,1.1115310228308472e-05,1.1106915165381966e-05,0.5
26751,크메르루즈/Noun,2,1,1,1.1115310228308472e-05,1.1106915165381966e-05,0.5
26752,캄보디아/Noun,2,1,1,1.1115310228308472e-05,1.1106915165381966e-05,0.5
26753,뱃살/Noun,2,1,1,1.1115310228308472e-05,1.1106915165381966e-05,0.5
26754,포섭/Noun,2,1,1,1.1115310228308472e-05,1.1106915165381966e-05,0.5
26755,영화라니/Foreign,2,1,1,1.1115310228308472e-05,1.1106915165381966e-05,0.5
26756,리본/Noun,2,1,1,1.1115310228308472e-05,1.1106915165381966e-05,0.5
26757,메시아/Noun,2,1,1,1.1115310228308472e-05,1.1106915165381966e-05,0.5
26758,붓기/Noun,2,1,1,1.1115310228308472e-05,1.1106915165381966e-05,0.5
26759,···./Punctuation,2,1,1,1.1115310228308472e-05,1.1106915165381966e-05,0.5
26760,악보/Noun,2,1,1,1.1115310228308472e-05,1.1106915165381966e-05,0.5
26761,정경애/Noun,2,1,1,1.1115310228308472e-05,1.1106915165381966e-05,0.5
26762,호위/Noun,2,1,1,1.1115310228308472e-05,1.1106915165381966e-05,0.5
26763,ne/Alpha,2,1,1,1.1115310228308472e-05,1.1106915165381966e-05,0.5
26764,민우/Noun,2,1,1,1.1115310228308472e-05,1.1106915165381966e-05,0.5
26765,제이든/Noun,2,1,1,1.1115310228308472e-05,1.1106915165381966e-05,0.5
26766,바람이분다/Noun,2,1,1,1.1115310228308472e-05,1.1106915165381966e-05,0.5
26767,발명왕/Noun,2,1,1,1.1115310228308472e-05,1.1106915165381966e-05,0.5
26768,ㅊㅈ/KoreanParticle,2,1,1,1.1115310228308472e-05,1.1106915165381966e-05,0.5
26769,이부/Noun,2,1,1,1.1115310228308472e-05,1.1106915165381966e-05,0.5
26770,한덕/Noun,2,1,1,1.1115310228308472e-05,1.1106915165381966e-05,0.5
26771,티카/Noun,2,1,1,1.1115310228308472e-05,1.1106915165381966e-05,0.5
26772,수사반장/Noun,2,1,1,1.1115310228308472e-05,1.1106915165381966e-05,0.5
26773,음서/Noun,2,1,1,1.1115310228308472e-05,1.1106915165381966e-05,0.5
26774,이강/Noun,2,1,1,1.1115310228308472e-05,1.1106915165381966e-05,0.5
26775,리미/Noun,2,1,1,1.1115310228308472e-05,1.1106915165381966e-05,0.5
26776,난교/Noun,2,1,1,1.1115310228308472e-05,1.1106915165381966e-05,0.5
26777,DIE/Alpha,2,1,1,1.1115310228308472e-05,1.1106915165381966e-05,0.5
26778,따블/Noun,2,1,1,1.1115310228308472e-05,1.1106915165381966e-05,0.5
26779,천안함프로젝트/Noun,2,1,1,1.1115310228308472e-05,1.1106915165381966e-05,0.5
26780,20만/Number,2,1,1,1.1115310228308472e-05,1.1106915165381966e-05,0.5
26781,괸찮/Noun,2,1,1,1.1115310228308472e-05,1.1106915165381966e-05,0.5
26782,윤희/Noun,2,1,1,1.1115310228308472e-05,1.1106915165381966e-05,0.5
26783,999/Number,2,1,1,1.1115310228308472e-05,1.1106915165381966e-05,0.5
26784,스타벅/Noun,2,1,1,1.1115310228308472e-05,1.1106915165381966e-05,0.5
26785,타키/Noun,2,1,1,1.1115310228308472e-05,1.1106915165381966e-05,0.5
26786,먹구름/Noun,2,1,1,1.1115310228308472e-05,1.1106915165381966e-05,0.5
26787,늑대아이/Noun,2,1,1,1.1115310228308472e-05,1.1106915165381966e-05,0.5
26788,원통/Noun,2,1,1,1.1115310228308472e-05,1.1106915165381966e-05,0.5
26789,"!!!""/Punctuation",2,1,1,1.1115310228308472e-05,1.1106915165381966e-05,0.5
26790,종두/Noun,2,1,1,1.1115310228308472e-05,1.1106915165381966e-05,0.5
26791,뚤/Noun,2,1,1,1.1115310228308472e-05,1.1106915165381966e-05,0.5
26792,걸성/Noun,2,1,1,1.1115310228308472e-05,1.1106915165381966e-05,0.5
26793,금주/Noun,2,1,1,1.1115310228308472e-05,1.1106915165381966e-05,0.5
26794,WAR/Alpha,2,1,1,1.1115310228308472e-05,1.1106915165381966e-05,0.5
26795,이착/Noun,2,1,1,1.1115310228308472e-05,1.1106915165381966e-05,0.5
26796,귀머거리/Noun,2,1,1,1.1115310228308472e-05,1.1106915165381966e-05,0.5
26797,정해준/Noun,2,1,1,1.1115310228308472e-05,1.1106915165381966e-05,0.5
26798,입자/Noun,2,1,1,1.1115310228308472e-05,1.1106915165381966e-05,0.5
26799,설연휴/Noun,2,1,1,1.1115310228308472e-05,1.1106915165381966e-05,0.5
26800,시림/Noun,2,1,1,1.1115310228308472e-05,1.1106915165381966e-05,0.5
26801,섬광탄/Noun,2,1,1,1.1115310228308472e-05,1.1106915165381966e-05,0.5
26802,김승연/Noun,2,1,1,1.1115310228308472e-05,1.1106915165381966e-05,0.5
26803,"""-/Punctuation",2,1,1,1.1115310228308472e-05,1.1106915165381966e-05,0.5
26804,산행/Noun,2,1,1,1.1115310228308472e-05,1.1106915165381966e-05,0.5
26805,데왜/Noun,2,1,1,1.1115310228308472e-05,1.1106915165381966e-05,0.5
26806,숀코너리/Noun,2,1,1,1.1115310228308472e-05,1.1106915165381966e-05,0.5
26807,이뻣다/Noun,2,1,1,1.1115310228308472e-05,1.1106915165381966e-05,0.5
26808,에쁘/Noun,2,1,1,1.1115310228308472e-05,1.1106915165381966e-05,0.5
26809,위노/Noun,2,1,1,1.1115310228308472e-05,1.1106915165381966e-05,0.5
26810,당부/Noun,2,1,1,1.1115310228308472e-05,1.1106915165381966e-05,0.5
26811,반값/Noun,2,1,1,1.1115310228308472e-05,1.1106915165381966e-05,0.5
26812,으응/Adverb,2,1,1,1.1115310228308472e-05,1.1106915165381966e-05,0.5
26813,러스/Noun,2,1,1,1.1115310228308472e-05,1.1106915165381966e-05,0.5
26814,쑥대밭/Noun,2,1,1,1.1115310228308472e-05,1.1106915165381966e-05,0.5
26815,모파상/Noun,2,1,1,1.1115310228308472e-05,1.1106915165381966e-05,0.5
26816,옷깃/Noun,2,1,1,1.1115310228308472e-05,1.1106915165381966e-05,0.5
26817,OP/Alpha,2,1,1,1.1115310228308472e-05,1.1106915165381966e-05,0.5
26818,몬스터주식회사/Noun,2,1,1,1.1115310228308472e-05,1.1106915165381966e-05,0.5
26819,BOBBY/Alpha,2,1,1,1.1115310228308472e-05,1.1106915165381966e-05,0.5
26820,.....!!/Punctuation,2,1,1,1.1115310228308472e-05,1.1106915165381966e-05,0.5
26821,황홀경/Noun,2,1,1,1.1115310228308472e-05,1.1106915165381966e-05,0.5
26822,의료인/Noun,2,1,1,1.1115310228308472e-05,1.1106915165381966e-05,0.5
26823,미담/Noun,2,1,1,1.1115310228308472e-05,1.1106915165381966e-05,0.5
26824,무정하다/Adjective,2,1,1,1.1115310228308472e-05,1.1106915165381966e-05,0.5
26825,마넌/Noun,2,1,1,1.1115310228308472e-05,1.1106915165381966e-05,0.5
26826,녹스빌/Noun,2,1,1,1.1115310228308472e-05,1.1106915165381966e-05,0.5
26827,정석원/Noun,2,1,1,1.1115310228308472e-05,1.1106915165381966e-05,0.5
26828,내무반/Noun,2,1,1,1.1115310228308472e-05,1.1106915165381966e-05,0.5
26829,장바닥/Noun,2,1,1,1.1115310228308472e-05,1.1106915165381966e-05,0.5
26830,가엽/Noun,2,1,1,1.1115310228308472e-05,1.1106915165381966e-05,0.5
26831,개대/Noun,2,1,1,1.1115310228308472e-05,1.1106915165381966e-05,0.5
26832,마이어/Noun,2,1,1,1.1115310228308472e-05,1.1106915165381966e-05,0.5
26833,페그/Noun,2,1,1,1.1115310228308472e-05,1.1106915165381966e-05,0.5
26834,스크리머스/Noun,2,1,1,1.1115310228308472e-05,1.1106915165381966e-05,0.5
26835,페럴/Noun,2,1,1,1.1115310228308472e-05,1.1106915165381966e-05,0.5
26836,피클/Noun,2,1,1,1.1115310228308472e-05,1.1106915165381966e-05,0.5
26837,가추/Noun,2,1,1,1.1115310228308472e-05,1.1106915165381966e-05,0.5
26838,개빡/Noun,2,1,1,1.1115310228308472e-05,1.1106915165381966e-05,0.5
26839,헤어스프레이/Noun,2,1,1,1.1115310228308472e-05,1.1106915165381966e-05,0.5
26840,메텔/Noun,2,1,1,1.1115310228308472e-05,1.1106915165381966e-05,0.5
26841,순발력/Noun,2,1,1,1.1115310228308472e-05,1.1106915165381966e-05,0.5
26842,김완선/Noun,2,1,1,1.1115310228308472e-05,1.1106915165381966e-05,0.5
26843,리옹/Noun,2,1,1,1.1115310228308472e-05,1.1106915165381966e-05,0.5
26844,팀원/Noun,2,1,1,1.1115310228308472e-05,1.1106915165381966e-05,0.5
26845,ㅜㅜㅋ/KoreanParticle,2,1,1,1.1115310228308472e-05,1.1106915165381966e-05,0.5
26846,대좌/Noun,2,1,1,1.1115310228308472e-05,1.1106915165381966e-05,0.5
26847,왜또/Noun,2,1,1,1.1115310228308472e-05,1.1106915165381966e-05,0.5
26848,05/Number,2,1,1,1.1115310228308472e-05,1.1106915165381966e-05,0.5
26849,2014.04/Number,2,1,1,1.1115310228308472e-05,1.1106915165381966e-05,0.5
26850,배겨/Noun,2,1,1,1.1115310228308472e-05,1.1106915165381966e-05,0.5
26851,절떄/Noun,2,1,1,1.1115310228308472e-05,1.1106915165381966e-05,0.5
26852,나왓다/Noun,2,1,1,1.1115310228308472e-05,1.1106915165381966e-05,0.5
26853,떠받다/Verb,2,1,1,1.1115310228308472e-05,1.1106915165381966e-05,0.5
26854,산더미/Noun,2,1,1,1.1115310228308472e-05,1.1106915165381966e-05,0.5
26855,ㅑㅋ/KoreanParticle,2,1,1,1.1115310228308472e-05,1.1106915165381966e-05,0.5
26856,나눠지다/Verb,2,1,1,1.1115310228308472e-05,1.1106915165381966e-05,0.5
26857,9.07/Number,2,1,1,1.1115310228308472e-05,1.1106915165381966e-05,0.5
26858,폰다/Noun,2,1,1,1.1115310228308472e-05,1.1106915165381966e-05,0.5
26859,쥬스/Noun,2,1,1,1.1115310228308472e-05,1.1106915165381966e-05,0.5
26860,직하/Noun,2,1,1,1.1115310228308472e-05,1.1106915165381966e-05,0.5
26861,귀국/Noun,2,1,1,1.1115310228308472e-05,1.1106915165381966e-05,0.5
26862,40~50/Number,2,1,1,1.1115310228308472e-05,1.1106915165381966e-05,0.5
26863,가호/Noun,2,1,1,1.1115310228308472e-05,1.1106915165381966e-05,0.5
26864,게르만/Noun,2,1,1,1.1115310228308472e-05,1.1106915165381966e-05,0.5
26865,갑사/Noun,2,1,1,1.1115310228308472e-05,1.1106915165381966e-05,0.5
26866,믹키/Noun,2,1,1,1.1115310228308472e-05,1.1106915165381966e-05,0.5
26867,????!!/Punctuation,2,1,1,1.1115310228308472e-05,1.1106915165381966e-05,0.5
26868,캐치마인드/Noun,2,1,1,1.1115310228308472e-05,1.1106915165381966e-05,0.5
26869,싱하형/Noun,2,1,1,1.1115310228308472e-05,1.1106915165381966e-05,0.5
26870,억해/Noun,2,1,1,1.1115310228308472e-05,1.1106915165381966e-05,0.5
26871,운부/Noun,2,1,1,1.1115310228308472e-05,1.1106915165381966e-05,0.5
26872,구국/Noun,2,1,1,1.1115310228308472e-05,1.1106915165381966e-05,0.5
26873,임안/Noun,2,1,1,1.1115310228308472e-05,1.1106915165381966e-05,0.5
26874,건너가다/Verb,2,1,1,1.1115310228308472e-05,1.1106915165381966e-05,0.5
26875,채연/Noun,2,1,1,1.1115310228308472e-05,1.1106915165381966e-05,0.5
26876,시들시들하다/Adjective,2,1,1,1.1115310228308472e-05,1.1106915165381966e-05,0.5
26877,박주미/Noun,2,1,1,1.1115310228308472e-05,1.1106915165381966e-05,0.5
26878,7.6/Number,2,1,1,1.1115310228308472e-05,1.1106915165381966e-05,0.5
26879,의정부/Noun,2,1,1,1.1115310228308472e-05,1.1106915165381966e-05,0.5
26880,윈터스/Noun,2,1,1,1.1115310228308472e-05,1.1106915165381966e-05,0.5
26881,새까맣다/Adjective,2,1,1,1.1115310228308472e-05,1.1106915165381966e-05,0.5
26882,연기상/Noun,2,1,1,1.1115310228308472e-05,1.1106915165381966e-05,0.5
26883,웃엇음/Noun,2,1,1,1.1115310228308472e-05,1.1106915165381966e-05,0.5
26884,/..../Punctuation,2,1,1,1.1115310228308472e-05,1.1106915165381966e-05,0.5
26885,164분/Number,2,1,1,1.1115310228308472e-05,1.1106915165381966e-05,0.5
26886,명세/Noun,2,1,1,1.1115310228308472e-05,1.1106915165381966e-05,0.5
26887,커뮤니티/Noun,2,1,1,1.1115310228308472e-05,1.1106915165381966e-05,0.5
26888,KAIST/Alpha,2,1,1,1.1115310228308472e-05,1.1106915165381966e-05,0.5
26889,난닝구/Noun,2,1,1,1.1115310228308472e-05,1.1106915165381966e-05,0.5
26890,아미타/Noun,2,1,1,1.1115310228308472e-05,1.1106915165381966e-05,0.5
26891,고해성사/Noun,2,1,1,1.1115310228308472e-05,1.1106915165381966e-05,0.5
26892,??~/Punctuation,2,1,1,1.1115310228308472e-05,1.1106915165381966e-05,0.5
26893,금나와라/Noun,2,1,1,1.1115310228308472e-05,1.1106915165381966e-05,0.5
26894,회계/Noun,2,1,1,1.1115310228308472e-05,1.1106915165381966e-05,0.5
26895,괜춘한듯/Noun,2,1,1,1.1115310228308472e-05,1.1106915165381966e-05,0.5
26896,힐끗/Adverb,2,1,1,1.1115310228308472e-05,1.1106915165381966e-05,0.5
26897,pmp/Alpha,2,1,1,1.1115310228308472e-05,1.1106915165381966e-05,0.5
26898,히달고/Noun,2,1,1,1.1115310228308472e-05,1.1106915165381966e-05,0.5
26899,탑팀/Noun,2,1,1,1.1115310228308472e-05,1.1106915165381966e-05,0.5
26900,죽순/Noun,2,1,1,1.1115310228308472e-05,1.1106915165381966e-05,0.5
26901,his/Alpha,2,1,1,1.1115310228308472e-05,1.1106915165381966e-05,0.5
26902,피폭/Noun,2,1,1,1.1115310228308472e-05,1.1106915165381966e-05,0.5
26903,볼리우드/Noun,2,1,1,1.1115310228308472e-05,1.1106915165381966e-05,0.5
26904,정알/Noun,2,1,1,1.1115310228308472e-05,1.1106915165381966e-05,0.5
26905,기저귀/Noun,2,1,1,1.1115310228308472e-05,1.1106915165381966e-05,0.5
26906,대는/Foreign,2,1,1,1.1115310228308472e-05,1.1106915165381966e-05,0.5
26907,봣드/Noun,2,1,1,1.1115310228308472e-05,1.1106915165381966e-05,0.5
26908,암살자/Noun,2,1,1,1.1115310228308472e-05,1.1106915165381966e-05,0.5
26909,스캔/Noun,2,1,1,1.1115310228308472e-05,1.1106915165381966e-05,0.5
26910,아프가니스탄/Noun,2,1,1,1.1115310228308472e-05,1.1106915165381966e-05,0.5
26911,실업자/Noun,2,1,1,1.1115310228308472e-05,1.1106915165381966e-05,0.5
26912,정수문/Noun,2,1,1,1.1115310228308472e-05,1.1106915165381966e-05,0.5
26913,우길/Noun,2,1,1,1.1115310228308472e-05,1.1106915165381966e-05,0.5
26914,임에도/Foreign,2,1,1,1.1115310228308472e-05,1.1106915165381966e-05,0.5
26915,라쇼몽/Noun,2,1,1,1.1115310228308472e-05,1.1106915165381966e-05,0.5
26916,조달환/Noun,2,1,1,1.1115310228308472e-05,1.1106915165381966e-05,0.5
26917,여인천하/Noun,2,1,1,1.1115310228308472e-05,1.1106915165381966e-05,0.5
26918,정세/Noun,2,1,1,1.1115310228308472e-05,1.1106915165381966e-05,0.5
26919,뽐뿌/Noun,2,1,1,1.1115310228308472e-05,1.1106915165381966e-05,0.5
26920,양요섭/Noun,2,1,1,1.1115310228308472e-05,1.1106915165381966e-05,0.5
26921,수송기/Noun,2,1,1,1.1115310228308472e-05,1.1106915165381966e-05,0.5
26922,노동권/Noun,2,1,1,1.1115310228308472e-05,1.1106915165381966e-05,0.5
26923,박진우/Noun,2,1,1,1.1115310228308472e-05,1.1106915165381966e-05,0.5
26924,프로듀서/Noun,2,1,1,1.1115310228308472e-05,1.1106915165381966e-05,0.5
26925,입양아/Noun,2,1,1,1.1115310228308472e-05,1.1106915165381966e-05,0.5
26926,대엔/Foreign,2,1,1,1.1115310228308472e-05,1.1106915165381966e-05,0.5
26927,서랜든/Noun,2,1,1,1.1115310228308472e-05,1.1106915165381966e-05,0.5
26928,6.35/Number,2,1,1,1.1115310228308472e-05,1.1106915165381966e-05,0.5
26929,대엿/Noun,2,1,1,1.1115310228308472e-05,1.1106915165381966e-05,0.5
26930,오나라/Noun,2,1,1,1.1115310228308472e-05,1.1106915165381966e-05,0.5
26931,박희/Noun,2,1,1,1.1115310228308472e-05,1.1106915165381966e-05,0.5
26932,콩쥐팥쥐/Noun,2,1,1,1.1115310228308472e-05,1.1106915165381966e-05,0.5
26933,은테/Noun,2,1,1,1.1115310228308472e-05,1.1106915165381966e-05,0.5
26934,어찌하여/Noun,2,1,1,1.1115310228308472e-05,1.1106915165381966e-05,0.5
26935,긴밀하다/Adjective,2,1,1,1.1115310228308472e-05,1.1106915165381966e-05,0.5
26936,결혼반지/Noun,2,1,1,1.1115310228308472e-05,1.1106915165381966e-05,0.5
26937,롤랑/Noun,2,1,1,1.1115310228308472e-05,1.1106915165381966e-05,0.5
26938,로켓단/Noun,2,1,1,1.1115310228308472e-05,1.1106915165381966e-05,0.5
26939,점왜/Noun,2,1,1,1.1115310228308472e-05,1.1106915165381966e-05,0.5
26940,헨젤과그레텔/Noun,2,1,1,1.1115310228308472e-05,1.1106915165381966e-05,0.5
26941,벌집/Noun,2,1,1,1.1115310228308472e-05,1.1106915165381966e-05,0.5
26942,일찐/Noun,2,1,1,1.1115310228308472e-05,1.1106915165381966e-05,0.5
26943,팅커벨/Noun,2,1,1,1.1115310228308472e-05,1.1106915165381966e-05,0.5
26944,단테/Noun,2,1,1,1.1115310228308472e-05,1.1106915165381966e-05,0.5
26945,태권소녀/Noun,2,1,1,1.1115310228308472e-05,1.1106915165381966e-05,0.5
26946,作/Foreign,2,1,1,1.1115310228308472e-05,1.1106915165381966e-05,0.5
26947,번복/Noun,2,1,1,1.1115310228308472e-05,1.1106915165381966e-05,0.5
26948,리머/Noun,2,1,1,1.1115310228308472e-05,1.1106915165381966e-05,0.5
26949,감겨/Noun,2,1,1,1.1115310228308472e-05,1.1106915165381966e-05,0.5
26950,걸짝/Noun,2,1,1,1.1115310228308472e-05,1.1106915165381966e-05,0.5
26951,염화/Noun,2,1,1,1.1115310228308472e-05,1.1106915165381966e-05,0.5
26952,ㅋㅎㅎㅎ/KoreanParticle,2,1,1,1.1115310228308472e-05,1.1106915165381966e-05,0.5
26953,캐스/Noun,2,1,1,1.1115310228308472e-05,1.1106915165381966e-05,0.5
26954,파랑주의보/Noun,2,1,1,1.1115310228308472e-05,1.1106915165381966e-05,0.5
26955,헬프/Noun,2,1,1,1.1115310228308472e-05,1.1106915165381966e-05,0.5
26956,코리안/Noun,2,1,1,1.1115310228308472e-05,1.1106915165381966e-05,0.5
26957,평평/Noun,2,1,1,1.1115310228308472e-05,1.1106915165381966e-05,0.5
26958,왕과비/Noun,2,1,1,1.1115310228308472e-05,1.1106915165381966e-05,0.5
26959,텃세/Noun,2,1,1,1.1115310228308472e-05,1.1106915165381966e-05,0.5
26960,타이머/Noun,2,1,1,1.1115310228308472e-05,1.1106915165381966e-05,0.5
26961,골프채/Noun,2,1,1,1.1115310228308472e-05,1.1106915165381966e-05,0.5
26962,하마터면/Adverb,2,1,1,1.1115310228308472e-05,1.1106915165381966e-05,0.5
26963,형도/Noun,2,1,1,1.1115310228308472e-05,1.1106915165381966e-05,0.5
26964,티거/Noun,2,1,1,1.1115310228308472e-05,1.1106915165381966e-05,0.5
26965,생강/Noun,2,1,1,1.1115310228308472e-05,1.1106915165381966e-05,0.5
26966,셔/PreEomi,2,1,1,1.1115310228308472e-05,1.1106915165381966e-05,0.5
26967,김태원/Noun,2,1,1,1.1115310228308472e-05,1.1106915165381966e-05,0.5
26968,노닥거리/Noun,2,1,1,1.1115310228308472e-05,1.1106915165381966e-05,0.5
26969,등짝/Noun,2,1,1,1.1115310228308472e-05,1.1106915165381966e-05,0.5
26970,번바/Noun,2,1,1,1.1115310228308472e-05,1.1106915165381966e-05,0.5
26971,변조/Noun,2,1,1,1.1115310228308472e-05,1.1106915165381966e-05,0.5
26972,까불까불/Adverb,2,1,1,1.1115310228308472e-05,1.1106915165381966e-05,0.5
26973,도희야/Noun,2,1,1,1.1115310228308472e-05,1.1106915165381966e-05,0.5
26974,어덯/Noun,2,1,1,1.1115310228308472e-05,1.1106915165381966e-05,0.5
26975,망연자실/Noun,2,1,1,1.1115310228308472e-05,1.1106915165381966e-05,0.5
26976,원초/Noun,2,1,1,1.1115310228308472e-05,1.1106915165381966e-05,0.5
26977,심드렁하다/Adjective,2,1,1,1.1115310228308472e-05,1.1106915165381966e-05,0.5
26978,곧바로/Noun,2,1,1,1.1115310228308472e-05,1.1106915165381966e-05,0.5
26979,또렷/Noun,2,1,1,1.1115310228308472e-05,1.1106915165381966e-05,0.5
26980,보육원/Noun,2,1,1,1.1115310228308472e-05,1.1106915165381966e-05,0.5
26981,게스/Noun,2,1,1,1.1115310228308472e-05,1.1106915165381966e-05,0.5
26982,법사/Noun,2,1,1,1.1115310228308472e-05,1.1106915165381966e-05,0.5
26983,키라/Noun,2,1,1,1.1115310228308472e-05,1.1106915165381966e-05,0.5
26984,쥬니어/Noun,2,1,1,1.1115310228308472e-05,1.1106915165381966e-05,0.5
26985,세관/Noun,2,1,1,1.1115310228308472e-05,1.1106915165381966e-05,0.5
26986,오순도순/Noun,2,1,1,1.1115310228308472e-05,1.1106915165381966e-05,0.5
26987,독도는우리땅/Noun,2,1,1,1.1115310228308472e-05,1.1106915165381966e-05,0.5
26988,이엄/Noun,2,1,1,1.1115310228308472e-05,1.1106915165381966e-05,0.5
26989,커뮤니케이션/Noun,2,1,1,1.1115310228308472e-05,1.1106915165381966e-05,0.5
26990,우세/Noun,2,1,1,1.1115310228308472e-05,1.1106915165381966e-05,0.5
26991,웨스커/Noun,2,1,1,1.1115310228308472e-05,1.1106915165381966e-05,0.5
26992,공단/Noun,2,1,1,1.1115310228308472e-05,1.1106915165381966e-05,0.5
26993,본답/Noun,2,1,1,1.1115310228308472e-05,1.1106915165381966e-05,0.5
26994,퐉퐉/Noun,2,1,1,1.1115310228308472e-05,1.1106915165381966e-05,0.5
26995,울렁이다/Verb,2,1,1,1.1115310228308472e-05,1.1106915165381966e-05,0.5
26996,at/Alpha,2,1,1,1.1115310228308472e-05,1.1106915165381966e-05,0.5
26997,불성/Noun,2,1,1,1.1115310228308472e-05,1.1106915165381966e-05,0.5
26998,밀지/Noun,2,1,1,1.1115310228308472e-05,1.1106915165381966e-05,0.5
26999,치인/Noun,2,1,1,1.1115310228308472e-05,1.1106915165381966e-05,0.5
27000,택하라/Noun,2,1,1,1.1115310228308472e-05,1.1106915165381966e-05,0.5
27001,가부/Noun,2,1,1,1.1115310228308472e-05,1.1106915165381966e-05,0.5
27002,정난정/Noun,2,1,1,1.1115310228308472e-05,1.1106915165381966e-05,0.5
27003,5~6년/Number,2,1,1,1.1115310228308472e-05,1.1106915165381966e-05,0.5
27004,테프/Noun,2,1,1,1.1115310228308472e-05,1.1106915165381966e-05,0.5
27005,말굽/Noun,2,1,1,1.1115310228308472e-05,1.1106915165381966e-05,0.5
27006,FUCK/Alpha,2,1,1,1.1115310228308472e-05,1.1106915165381966e-05,0.5
27007,윤정수/Noun,2,1,1,1.1115310228308472e-05,1.1106915165381966e-05,0.5
27008,알투/Noun,2,1,1,1.1115310228308472e-05,1.1106915165381966e-05,0.5
27009,급락/Noun,2,1,1,1.1115310228308472e-05,1.1106915165381966e-05,0.5
27010,하마/Noun,2,1,1,1.1115310228308472e-05,1.1106915165381966e-05,0.5
27011,뿜기/Noun,2,1,1,1.1115310228308472e-05,1.1106915165381966e-05,0.5
27012,진취/Noun,2,1,1,1.1115310228308472e-05,1.1106915165381966e-05,0.5
27013,채도/Noun,2,1,1,1.1115310228308472e-05,1.1106915165381966e-05,0.5
27014,"~~""/Punctuation",2,1,1,1.1115310228308472e-05,1.1106915165381966e-05,0.5
27015,베쏭/Noun,2,1,1,1.1115310228308472e-05,1.1106915165381966e-05,0.5
27016,아이돌가수/Noun,2,1,1,1.1115310228308472e-05,1.1106915165381966e-05,0.5
27017,?!!!/Punctuation,2,1,1,1.1115310228308472e-05,1.1106915165381966e-05,0.5
27018,콘텐츠/Noun,2,1,1,1.1115310228308472e-05,1.1106915165381966e-05,0.5
27019,마카로니/Noun,2,1,1,1.1115310228308472e-05,1.1106915165381966e-05,0.5
27020,규화보전/Noun,2,1,1,1.1115310228308472e-05,1.1106915165381966e-05,0.5
27021,!@@/Punctuation,2,1,1,1.1115310228308472e-05,1.1106915165381966e-05,0.5
27022,월간/Noun,2,1,1,1.1115310228308472e-05,1.1106915165381966e-05,0.5
27023,결집/Noun,2,1,1,1.1115310228308472e-05,1.1106915165381966e-05,0.5
27024,꿍/Noun,2,1,1,1.1115310228308472e-05,1.1106915165381966e-05,0.5
27025,진인/Noun,2,1,1,1.1115310228308472e-05,1.1106915165381966e-05,0.5
27026,디럭스/Noun,2,1,1,1.1115310228308472e-05,1.1106915165381966e-05,0.5
27027,급여/Noun,2,1,1,1.1115310228308472e-05,1.1106915165381966e-05,0.5
27028,인어아가씨/Noun,2,1,1,1.1115310228308472e-05,1.1106915165381966e-05,0.5
27029,물개/Noun,2,1,1,1.1115310228308472e-05,1.1106915165381966e-05,0.5
27030,이성규/Noun,2,1,1,1.1115310228308472e-05,1.1106915165381966e-05,0.5
27031,말단/Noun,2,1,1,1.1115310228308472e-05,1.1106915165381966e-05,0.5
27032,도치/Noun,2,1,1,1.1115310228308472e-05,1.1106915165381966e-05,0.5
27033,땅땅/Noun,2,1,1,1.1115310228308472e-05,1.1106915165381966e-05,0.5
27034,해일/Noun,2,1,1,1.1115310228308472e-05,1.1106915165381966e-05,0.5
27035,미주/Noun,2,1,1,1.1115310228308472e-05,1.1106915165381966e-05,0.5
27036,♩/Foreign,2,1,1,1.1115310228308472e-05,1.1106915165381966e-05,0.5
27037,다이어트/Noun,2,1,1,1.1115310228308472e-05,1.1106915165381966e-05,0.5
27038,희한/Noun,2,1,1,1.1115310228308472e-05,1.1106915165381966e-05,0.5
27039,mi/Alpha,2,1,1,1.1115310228308472e-05,1.1106915165381966e-05,0.5
27040,인자하다/Adjective,2,1,1,1.1115310228308472e-05,1.1106915165381966e-05,0.5
27041,1969년/Number,2,1,1,1.1115310228308472e-05,1.1106915165381966e-05,0.5
27042,기병/Noun,2,1,1,1.1115310228308472e-05,1.1106915165381966e-05,0.5
27043,씨아이/Noun,2,1,1,1.1115310228308472e-05,1.1106915165381966e-05,0.5
27044,똥차/Noun,2,1,1,1.1115310228308472e-05,1.1106915165381966e-05,0.5
27045,강성훈/Noun,2,1,1,1.1115310228308472e-05,1.1106915165381966e-05,0.5
27046,말듯/Noun,2,1,1,1.1115310228308472e-05,1.1106915165381966e-05,0.5
27047,배한성/Noun,2,1,1,1.1115310228308472e-05,1.1106915165381966e-05,0.5
27048,훌/Noun,2,1,1,1.1115310228308472e-05,1.1106915165381966e-05,0.5
27049,일본여행/Noun,2,1,1,1.1115310228308472e-05,1.1106915165381966e-05,0.5
27050,닥치고패밀리/Noun,2,1,1,1.1115310228308472e-05,1.1106915165381966e-05,0.5
27051,ㅣㄱ/KoreanParticle,2,1,1,1.1115310228308472e-05,1.1106915165381966e-05,0.5
27052,친누나/Noun,2,1,1,1.1115310228308472e-05,1.1106915165381966e-05,0.5
27053,포커페이스/Noun,2,1,1,1.1115310228308472e-05,1.1106915165381966e-05,0.5
27054,죽엇을때/Noun,2,1,1,1.1115310228308472e-05,1.1106915165381966e-05,0.5
27055,나부끼다/Verb,2,1,1,1.1115310228308472e-05,1.1106915165381966e-05,0.5
27056,이삼/Modifier,2,1,1,1.1115310228308472e-05,1.1106915165381966e-05,0.5
27057,아이작/Noun,2,1,1,1.1115310228308472e-05,1.1106915165381966e-05,0.5
27058,무대뽀/Noun,2,1,1,1.1115310228308472e-05,1.1106915165381966e-05,0.5
27059,김수영/Noun,2,1,1,1.1115310228308472e-05,1.1106915165381966e-05,0.5
27060,2~4/Number,2,1,1,1.1115310228308472e-05,1.1106915165381966e-05,0.5
27061,대한제국/Noun,2,1,1,1.1115310228308472e-05,1.1106915165381966e-05,0.5
27062,과반/Noun,2,1,1,1.1115310228308472e-05,1.1106915165381966e-05,0.5
27063,대담/Noun,2,1,1,1.1115310228308472e-05,1.1106915165381966e-05,0.5
27064,근대화/Noun,2,1,1,1.1115310228308472e-05,1.1106915165381966e-05,0.5
27065,액체/Noun,2,1,1,1.1115310228308472e-05,1.1106915165381966e-05,0.5
27066,읊조리다/Verb,2,1,1,1.1115310228308472e-05,1.1106915165381966e-05,0.5
27067,점밑/Noun,2,1,1,1.1115310228308472e-05,1.1106915165381966e-05,0.5
27068,해일이/Noun,2,1,1,1.1115310228308472e-05,1.1106915165381966e-05,0.5
27069,jk/Alpha,2,1,1,1.1115310228308472e-05,1.1106915165381966e-05,0.5
27070,중드/Noun,2,1,1,1.1115310228308472e-05,1.1106915165381966e-05,0.5
27071,카린/Noun,2,1,1,1.1115310228308472e-05,1.1106915165381966e-05,0.5
27072,발기부전/Noun,2,1,1,1.1115310228308472e-05,1.1106915165381966e-05,0.5
27073,버선/Noun,2,1,1,1.1115310228308472e-05,1.1106915165381966e-05,0.5
27074,속속/Adverb,2,1,1,1.1115310228308472e-05,1.1106915165381966e-05,0.5
27075,두/Foreign,2,1,1,1.1115310228308472e-05,1.1106915165381966e-05,0.5
27076,스위프트/Noun,2,1,1,1.1115310228308472e-05,1.1106915165381966e-05,0.5
27077,김만/Noun,2,1,1,1.1115310228308472e-05,1.1106915165381966e-05,0.5
27078,에누리/Noun,2,1,1,1.1115310228308472e-05,1.1106915165381966e-05,0.5
27079,LIFE/Alpha,2,1,1,1.1115310228308472e-05,1.1106915165381966e-05,0.5
27080,경북/Noun,2,1,1,1.1115310228308472e-05,1.1106915165381966e-05,0.5
27081,황선희/Noun,2,1,1,1.1115310228308472e-05,1.1106915165381966e-05,0.5
27082,전깃줄/Noun,2,1,1,1.1115310228308472e-05,1.1106915165381966e-05,0.5
27083,왜이케/Noun,2,1,1,1.1115310228308472e-05,1.1106915165381966e-05,0.5
27084,ㅔㅔ/KoreanParticle,2,1,1,1.1115310228308472e-05,1.1106915165381966e-05,0.5
27085,총재/Noun,2,1,1,1.1115310228308472e-05,1.1106915165381966e-05,0.5
27086,...;;;)/Punctuation,2,1,1,1.1115310228308472e-05,1.1106915165381966e-05,0.5
27087,빙수/Noun,2,1,1,1.1115310228308472e-05,1.1106915165381966e-05,0.5
27088,플립/Noun,2,1,1,1.1115310228308472e-05,1.1106915165381966e-05,0.5
27089,비행사/Noun,2,1,1,1.1115310228308472e-05,1.1106915165381966e-05,0.5
27090,서브컬쳐/Noun,2,1,1,1.1115310228308472e-05,1.1106915165381966e-05,0.5
27091,가혹/Noun,2,1,1,1.1115310228308472e-05,1.1106915165381966e-05,0.5
27092,다중성/Noun,2,1,1,1.1115310228308472e-05,1.1106915165381966e-05,0.5
27093,1971년/Number,2,1,1,1.1115310228308472e-05,1.1106915165381966e-05,0.5
27094,토막살인/Noun,2,1,1,1.1115310228308472e-05,1.1106915165381966e-05,0.5
27095,내관/Noun,2,1,1,1.1115310228308472e-05,1.1106915165381966e-05,0.5
27096,없엇음/Noun,2,1,1,1.1115310228308472e-05,1.1106915165381966e-05,0.5
27097,최고다이순신/Noun,2,1,1,1.1115310228308472e-05,1.1106915165381966e-05,0.5
27098,샐러맨더/Noun,2,1,1,1.1115310228308472e-05,1.1106915165381966e-05,0.5
27099,페리스/Noun,2,1,1,1.1115310228308472e-05,1.1106915165381966e-05,0.5
27100,영어권/Noun,2,1,1,1.1115310228308472e-05,1.1106915165381966e-05,0.5
27101,태그/Noun,2,1,1,1.1115310228308472e-05,1.1106915165381966e-05,0.5
27102,회로/Noun,2,1,1,1.1115310228308472e-05,1.1106915165381966e-05,0.5
27103,솔찍/Noun,2,1,1,1.1115310228308472e-05,1.1106915165381966e-05,0.5
27104,미심/Noun,2,1,1,1.1115310228308472e-05,1.1106915165381966e-05,0.5
27105,1986/Number,2,1,1,1.1115310228308472e-05,1.1106915165381966e-05,0.5
27106,경차/Noun,2,1,1,1.1115310228308472e-05,1.1106915165381966e-05,0.5
27107,교역/Noun,2,1,1,1.1115310228308472e-05,1.1106915165381966e-05,0.5
27108,로건레먼/Noun,2,1,1,1.1115310228308472e-05,1.1106915165381966e-05,0.5
27109,매복/Noun,2,1,1,1.1115310228308472e-05,1.1106915165381966e-05,0.5
27110,벨기에/Noun,2,1,1,1.1115310228308472e-05,1.1106915165381966e-05,0.5
27111,이동준/Noun,2,1,1,1.1115310228308472e-05,1.1106915165381966e-05,0.5
27112,최윤소/Noun,2,1,1,1.1115310228308472e-05,1.1106915165381966e-05,0.5
27113,쭌/Noun,2,1,1,1.1115310228308472e-05,1.1106915165381966e-05,0.5
27114,리콜/Noun,2,1,1,1.1115310228308472e-05,1.1106915165381966e-05,0.5
27115,시언/Noun,2,1,1,1.1115310228308472e-05,1.1106915165381966e-05,0.5
27116,山/Foreign,2,1,1,1.1115310228308472e-05,1.1106915165381966e-05,0.5
27117,적재/Noun,2,1,1,1.1115310228308472e-05,1.1106915165381966e-05,0.5
27118,여인숙/Noun,2,1,1,1.1115310228308472e-05,1.1106915165381966e-05,0.5
27119,노쟘/Noun,2,1,1,1.1115310228308472e-05,1.1106915165381966e-05,0.5
27120,미장셴/Noun,2,1,1,1.1115310228308472e-05,1.1106915165381966e-05,0.5
27121,상상마당/Noun,2,1,1,1.1115310228308472e-05,1.1106915165381966e-05,0.5
27122,캡숑/Noun,2,1,1,1.1115310228308472e-05,1.1106915165381966e-05,0.5
27123,로되/Josa,2,1,1,1.1115310228308472e-05,1.1106915165381966e-05,0.5
27124,1993/Number,2,1,1,1.1115310228308472e-05,1.1106915165381966e-05,0.5
27125,광풍/Noun,2,1,1,1.1115310228308472e-05,1.1106915165381966e-05,0.5
27126,정시/Noun,2,1,1,1.1115310228308472e-05,1.1106915165381966e-05,0.5
27127,리플레이/Noun,2,1,1,1.1115310228308472e-05,1.1106915165381966e-05,0.5
27128,허우적허우적/Adverb,2,1,1,1.1115310228308472e-05,1.1106915165381966e-05,0.5
27129,만연하다/Adjective,2,1,1,1.1115310228308472e-05,1.1106915165381966e-05,0.5
27130,아티/Noun,2,1,1,1.1115310228308472e-05,1.1106915165381966e-05,0.5
27131,universe/Alpha,2,1,1,1.1115310228308472e-05,1.1106915165381966e-05,0.5
27132,종철/Noun,2,1,1,1.1115310228308472e-05,1.1106915165381966e-05,0.5
27133,앙꼬없는/Noun,2,1,1,1.1115310228308472e-05,1.1106915165381966e-05,0.5
27134,잠재력/Noun,2,1,1,1.1115310228308472e-05,1.1106915165381966e-05,0.5
27135,7.7/Number,2,1,1,1.1115310228308472e-05,1.1106915165381966e-05,0.5
27136,정희/Noun,2,1,1,1.1115310228308472e-05,1.1106915165381966e-05,0.5
27137,칠판/Noun,2,1,1,1.1115310228308472e-05,1.1106915165381966e-05,0.5
27138,신발장/Noun,2,1,1,1.1115310228308472e-05,1.1106915165381966e-05,0.5
27139,♥♡♥♡♥/Foreign,2,1,1,1.1115310228308472e-05,1.1106915165381966e-05,0.5
27140,!!!!.../Punctuation,2,1,1,1.1115310228308472e-05,1.1106915165381966e-05,0.5
27141,구성면/Noun,2,1,1,1.1115310228308472e-05,1.1106915165381966e-05,0.5
27142,비전문가/Noun,2,1,1,1.1115310228308472e-05,1.1106915165381966e-05,0.5
27143,~!!!!!!/Punctuation,2,1,1,1.1115310228308472e-05,1.1106915165381966e-05,0.5
27144,난중/Noun,2,1,1,1.1115310228308472e-05,1.1106915165381966e-05,0.5
27145,혜주/Noun,2,1,1,1.1115310228308472e-05,1.1106915165381966e-05,0.5
27146,다는데/Eomi,2,1,1,1.1115310228308472e-05,1.1106915165381966e-05,0.5
27147,쵸콜렛/Noun,2,1,1,1.1115310228308472e-05,1.1106915165381966e-05,0.5
27148,빈공간/Noun,2,1,1,1.1115310228308472e-05,1.1106915165381966e-05,0.5
27149,니코틴/Noun,2,1,1,1.1115310228308472e-05,1.1106915165381966e-05,0.5
27150,지후/Noun,2,1,1,1.1115310228308472e-05,1.1106915165381966e-05,0.5
27151,??(/Punctuation,2,1,1,1.1115310228308472e-05,1.1106915165381966e-05,0.5
27152,신대륙/Noun,2,1,1,1.1115310228308472e-05,1.1106915165381966e-05,0.5
27153,궁녀/Noun,2,1,1,1.1115310228308472e-05,1.1106915165381966e-05,0.5
27154,폰줄/Noun,2,1,1,1.1115310228308472e-05,1.1106915165381966e-05,0.5
27155,요시모토/Noun,2,1,1,1.1115310228308472e-05,1.1106915165381966e-05,0.5
27156,은장도/Noun,2,1,1,1.1115310228308472e-05,1.1106915165381966e-05,0.5
27157,말솜씨/Noun,2,1,1,1.1115310228308472e-05,1.1106915165381966e-05,0.5
27158,대리인/Noun,2,1,1,1.1115310228308472e-05,1.1106915165381966e-05,0.5
27159,직함/Noun,2,1,1,1.1115310228308472e-05,1.1106915165381966e-05,0.5
27160,마스크맨/Noun,2,1,1,1.1115310228308472e-05,1.1106915165381966e-05,0.5
27161,폐암/Noun,2,1,1,1.1115310228308472e-05,1.1106915165381966e-05,0.5
27162,걸스/Noun,2,1,1,1.1115310228308472e-05,1.1106915165381966e-05,0.5
27163,밀란/Noun,2,1,1,1.1115310228308472e-05,1.1106915165381966e-05,0.5
27164,막드/Noun,2,1,1,1.1115310228308472e-05,1.1106915165381966e-05,0.5
27165,도올/Noun,2,1,1,1.1115310228308472e-05,1.1106915165381966e-05,0.5
27166,새로이/Noun,2,1,1,1.1115310228308472e-05,1.1106915165381966e-05,0.5
27167,땀날/Noun,2,1,1,1.1115310228308472e-05,1.1106915165381966e-05,0.5
27168,싱잉/Noun,2,1,1,1.1115310228308472e-05,1.1106915165381966e-05,0.5
27169,평행우주/Noun,2,1,1,1.1115310228308472e-05,1.1106915165381966e-05,0.5
27170,단맛/Noun,2,1,1,1.1115310228308472e-05,1.1106915165381966e-05,0.5
27171,이깟/Modifier,2,1,1,1.1115310228308472e-05,1.1106915165381966e-05,0.5
27172,언데드/Noun,2,1,1,1.1115310228308472e-05,1.1106915165381966e-05,0.5
27173,외압/Noun,2,1,1,1.1115310228308472e-05,1.1106915165381966e-05,0.5
27174,작사가/Noun,2,1,1,1.1115310228308472e-05,1.1106915165381966e-05,0.5
27175,기념관/Noun,2,1,1,1.1115310228308472e-05,1.1106915165381966e-05,0.5
27176,왜욕해/Noun,2,1,1,1.1115310228308472e-05,1.1106915165381966e-05,0.5
27177,몽골제국/Noun,2,1,1,1.1115310228308472e-05,1.1106915165381966e-05,0.5
27178,1234567891/Number,2,1,1,1.1115310228308472e-05,1.1106915165381966e-05,0.5
27179,박종원/Noun,2,1,1,1.1115310228308472e-05,1.1106915165381966e-05,0.5
27180,백분/Noun,2,1,1,1.1115310228308472e-05,1.1106915165381966e-05,0.5
27181,225/Number,2,1,1,1.1115310228308472e-05,1.1106915165381966e-05,0.5
27182,벽장/Noun,2,1,1,1.1115310228308472e-05,1.1106915165381966e-05,0.5
27183,과민반응/Noun,2,1,1,1.1115310228308472e-05,1.1106915165381966e-05,0.5
27184,말죽거리/Noun,2,1,1,1.1115310228308472e-05,1.1106915165381966e-05,0.5
27185,아리송하다/Adjective,2,1,1,1.1115310228308472e-05,1.1106915165381966e-05,0.5
27186,왕전/Noun,2,1,1,1.1115310228308472e-05,1.1106915165381966e-05,0.5
27187,합계/Noun,2,1,1,1.1115310228308472e-05,1.1106915165381966e-05,0.5
27188,아포칼립스/Noun,2,1,1,1.1115310228308472e-05,1.1106915165381966e-05,0.5
27189,이은희/Noun,2,1,1,1.1115310228308472e-05,1.1106915165381966e-05,0.5
27190,샤인/Noun,2,1,1,1.1115310228308472e-05,1.1106915165381966e-05,0.5
27191,색칠/Noun,2,1,1,1.1115310228308472e-05,1.1106915165381966e-05,0.5
27192,전단/Noun,2,1,1,1.1115310228308472e-05,1.1106915165381966e-05,0.5
27193,사이토/Noun,2,1,1,1.1115310228308472e-05,1.1106915165381966e-05,0.5
27194,씨스타/Noun,2,1,1,1.1115310228308472e-05,1.1106915165381966e-05,0.5
27195,무모/Noun,2,1,1,1.1115310228308472e-05,1.1106915165381966e-05,0.5
27196,격납고/Noun,2,1,1,1.1115310228308472e-05,1.1106915165381966e-05,0.5
27197,하옇튼/Noun,2,1,1,1.1115310228308472e-05,1.1106915165381966e-05,0.5
27198,옭아매다/Verb,2,1,1,1.1115310228308472e-05,1.1106915165381966e-05,0.5
27199,태교/Noun,2,1,1,1.1115310228308472e-05,1.1106915165381966e-05,0.5
27200,구치/Noun,2,1,1,1.1115310228308472e-05,1.1106915165381966e-05,0.5
27201,...~~~/Punctuation,2,1,1,1.1115310228308472e-05,1.1106915165381966e-05,0.5
27202,".......,/Punctuation",2,1,1,1.1115310228308472e-05,1.1106915165381966e-05,0.5
27203,그윽/Noun,2,1,1,1.1115310228308472e-05,1.1106915165381966e-05,0.5
27204,도조/Noun,2,1,1,1.1115310228308472e-05,1.1106915165381966e-05,0.5
27205,오진/Noun,2,1,1,1.1115310228308472e-05,1.1106915165381966e-05,0.5
27206,da/Alpha,2,1,1,1.1115310228308472e-05,1.1106915165381966e-05,0.5
27207,샤말론/Noun,2,1,1,1.1115310228308472e-05,1.1106915165381966e-05,0.5
27208,miss/Alpha,2,1,1,1.1115310228308472e-05,1.1106915165381966e-05,0.5
27209,일본사/Noun,2,1,1,1.1115310228308472e-05,1.1106915165381966e-05,0.5
27210,탱탱하다/Adjective,2,1,1,1.1115310228308472e-05,1.1106915165381966e-05,0.5
27211,구성요소/Noun,2,1,1,1.1115310228308472e-05,1.1106915165381966e-05,0.5
27212,양심수/Noun,2,1,1,1.1115310228308472e-05,1.1106915165381966e-05,0.5
27213,제노바/Noun,2,1,1,1.1115310228308472e-05,1.1106915165381966e-05,0.5
27214,사악/Noun,2,1,1,1.1115310228308472e-05,1.1106915165381966e-05,0.5
27215,개이버/Noun,2,1,1,1.1115310228308472e-05,1.1106915165381966e-05,0.5
27216,부합/Noun,2,1,1,1.1115310228308472e-05,1.1106915165381966e-05,0.5
27217,글픽/Noun,2,1,1,1.1115310228308472e-05,1.1106915165381966e-05,0.5
27218,100000000/Number,2,1,1,1.1115310228308472e-05,1.1106915165381966e-05,0.5
27219,보쌈/Noun,2,1,1,1.1115310228308472e-05,1.1106915165381966e-05,0.5
27220,대초반의/Foreign,2,1,1,1.1115310228308472e-05,1.1106915165381966e-05,0.5
27221,바바리/Noun,2,1,1,1.1115310228308472e-05,1.1106915165381966e-05,0.5
27222,촉발/Noun,2,1,1,1.1115310228308472e-05,1.1106915165381966e-05,0.5
27223,황금어장/Noun,2,1,1,1.1115310228308472e-05,1.1106915165381966e-05,0.5
27224,이형도/Noun,2,1,1,1.1115310228308472e-05,1.1106915165381966e-05,0.5
27225,사본/Noun,2,1,1,1.1115310228308472e-05,1.1106915165381966e-05,0.5
27226,ㅍㅎㅎㅎ/KoreanParticle,2,1,1,1.1115310228308472e-05,1.1106915165381966e-05,0.5
27227,부딫히/Noun,2,1,1,1.1115310228308472e-05,1.1106915165381966e-05,0.5
27228,트름/Noun,2,1,1,1.1115310228308472e-05,1.1106915165381966e-05,0.5
27229,으스스/Noun,2,1,1,1.1115310228308472e-05,1.1106915165381966e-05,0.5
27230,빠가/Noun,2,1,1,1.1115310228308472e-05,1.1106915165381966e-05,0.5
27231,괸찮은데/Noun,2,1,1,1.1115310228308472e-05,1.1106915165381966e-05,0.5
27232,국가보안법/Noun,2,1,1,1.1115310228308472e-05,1.1106915165381966e-05,0.5
27233,사천원/Noun,2,1,1,1.1115310228308472e-05,1.1106915165381966e-05,0.5
27234,이모티콘/Noun,2,1,1,1.1115310228308472e-05,1.1106915165381966e-05,0.5
27235,측근/Noun,2,1,1,1.1115310228308472e-05,1.1106915165381966e-05,0.5
27236,이배/Noun,2,1,1,1.1115310228308472e-05,1.1106915165381966e-05,0.5
27237,동굴씬/Noun,2,1,1,1.1115310228308472e-05,1.1106915165381966e-05,0.5
27238,컵라면/Noun,2,1,1,1.1115310228308472e-05,1.1106915165381966e-05,0.5
27239,걸행/Noun,2,1,1,1.1115310228308472e-05,1.1106915165381966e-05,0.5
27240,철문/Noun,2,1,1,1.1115310228308472e-05,1.1106915165381966e-05,0.5
27241,쨍쨍/Adverb,2,1,1,1.1115310228308472e-05,1.1106915165381966e-05,0.5
27242,MMORPG/Alpha,2,1,1,1.1115310228308472e-05,1.1106915165381966e-05,0.5
27243,win/Alpha,2,1,1,1.1115310228308472e-05,1.1106915165381966e-05,0.5
27244,영화봣/Noun,2,1,1,1.1115310228308472e-05,1.1106915165381966e-05,0.5
27245,메튜/Noun,2,1,1,1.1115310228308472e-05,1.1106915165381966e-05,0.5
27246,기리보이/Noun,2,1,1,1.1115310228308472e-05,1.1106915165381966e-05,0.5
27247,자기계발/Noun,2,1,1,1.1115310228308472e-05,1.1106915165381966e-05,0.5
27248,만무/Noun,2,1,1,1.1115310228308472e-05,1.1106915165381966e-05,0.5
27249,데스티니/Noun,2,1,1,1.1115310228308472e-05,1.1106915165381966e-05,0.5
27250,접대부/Noun,2,1,1,1.1115310228308472e-05,1.1106915165381966e-05,0.5
27251,피방/Noun,2,1,1,1.1115310228308472e-05,1.1106915165381966e-05,0.5
27252,부딛히다/Verb,2,1,1,1.1115310228308472e-05,1.1106915165381966e-05,0.5
27253,들르다/Verb,2,1,1,1.1115310228308472e-05,1.1106915165381966e-05,0.5
27254,아더스/Noun,2,1,1,1.1115310228308472e-05,1.1106915165381966e-05,0.5
27255,꿰매다/Verb,2,1,1,1.1115310228308472e-05,1.1106915165381966e-05,0.5
27256,베트콩/Noun,2,1,1,1.1115310228308472e-05,1.1106915165381966e-05,0.5
27257,~~~~~~~~~~~~~~~~~~~~~~~/Punctuation,2,1,1,1.1115310228308472e-05,1.1106915165381966e-05,0.5
27258,로기/Noun,2,1,1,1.1115310228308472e-05,1.1106915165381966e-05,0.5
27259,짓폰/Noun,2,1,1,1.1115310228308472e-05,1.1106915165381966e-05,0.5
27260,사하/Noun,2,1,1,1.1115310228308472e-05,1.1106915165381966e-05,0.5
27261,복식/Noun,2,1,1,1.1115310228308472e-05,1.1106915165381966e-05,0.5
27262,극일/Noun,2,1,1,1.1115310228308472e-05,1.1106915165381966e-05,0.5
27263,박모/Noun,2,1,1,1.1115310228308472e-05,1.1106915165381966e-05,0.5
27264,쯤인가/Foreign,2,1,1,1.1115310228308472e-05,1.1106915165381966e-05,0.5
27265,조이스/Noun,2,1,1,1.1115310228308472e-05,1.1106915165381966e-05,0.5
27266,1800년/Number,2,1,1,1.1115310228308472e-05,1.1106915165381966e-05,0.5
27267,.~~~/Punctuation,2,1,1,1.1115310228308472e-05,1.1106915165381966e-05,0.5
27268,캠핑/Noun,2,1,1,1.1115310228308472e-05,1.1106915165381966e-05,0.5
27269,메콩강/Noun,2,1,1,1.1115310228308472e-05,1.1106915165381966e-05,0.5
27270,SHIT/Alpha,2,1,1,1.1115310228308472e-05,1.1106915165381966e-05,0.5
27271,미남자/Noun,2,1,1,1.1115310228308472e-05,1.1106915165381966e-05,0.5
27272,실껏/Noun,2,1,1,1.1115310228308472e-05,1.1106915165381966e-05,0.5
27273,어슬픈/Noun,2,1,1,1.1115310228308472e-05,1.1106915165381966e-05,0.5
27274,나이트워치/Noun,2,1,1,1.1115310228308472e-05,1.1106915165381966e-05,0.5
27275,화투/Noun,2,1,1,1.1115310228308472e-05,1.1106915165381966e-05,0.5
27276,릭맨/Noun,2,1,1,1.1115310228308472e-05,1.1106915165381966e-05,0.5
27277,고교생/Noun,2,1,1,1.1115310228308472e-05,1.1106915165381966e-05,0.5
27278,불투명하다/Adjective,2,1,1,1.1115310228308472e-05,1.1106915165381966e-05,0.5
27279,나염/Noun,2,1,1,1.1115310228308472e-05,1.1106915165381966e-05,0.5
27280,핵폭발/Noun,2,1,1,1.1115310228308472e-05,1.1106915165381966e-05,0.5
27281,다다미/Noun,2,1,1,1.1115310228308472e-05,1.1106915165381966e-05,0.5
27282,버라이어티/Noun,2,1,1,1.1115310228308472e-05,1.1106915165381966e-05,0.5
27283,독거/Noun,2,1,1,1.1115310228308472e-05,1.1106915165381966e-05,0.5
27284,?....../Punctuation,2,1,1,1.1115310228308472e-05,1.1106915165381966e-05,0.5
27285,???)/Punctuation,2,1,1,1.1115310228308472e-05,1.1106915165381966e-05,0.5
27286,방소/Noun,2,1,1,1.1115310228308472e-05,1.1106915165381966e-05,0.5
27287,도래/Noun,2,1,1,1.1115310228308472e-05,1.1106915165381966e-05,0.5
27288,하반신/Noun,2,1,1,1.1115310228308472e-05,1.1106915165381966e-05,0.5
27289,단백질/Noun,2,1,1,1.1115310228308472e-05,1.1106915165381966e-05,0.5
27290,프랑수아/Noun,2,1,1,1.1115310228308472e-05,1.1106915165381966e-05,0.5
27291,가물다/Verb,2,1,1,1.1115310228308472e-05,1.1106915165381966e-05,0.5
27292,남파/Noun,2,1,1,1.1115310228308472e-05,1.1106915165381966e-05,0.5
27293,독후감/Noun,2,1,1,1.1115310228308472e-05,1.1106915165381966e-05,0.5
27294,사무소/Noun,2,1,1,1.1115310228308472e-05,1.1106915165381966e-05,0.5
27295,중광/Noun,2,1,1,1.1115310228308472e-05,1.1106915165381966e-05,0.5
27296,즐비하다/Adjective,2,1,1,1.1115310228308472e-05,1.1106915165381966e-05,0.5
27297,깁다/Verb,2,1,1,1.1115310228308472e-05,1.1106915165381966e-05,0.5
27298,우형/Noun,2,1,1,1.1115310228308472e-05,1.1106915165381966e-05,0.5
27299,그거슨/Noun,2,1,1,1.1115310228308472e-05,1.1106915165381966e-05,0.5
27300,스쿨오브락/Noun,2,1,1,1.1115310228308472e-05,1.1106915165381966e-05,0.5
27301,앞편/Noun,2,1,1,1.1115310228308472e-05,1.1106915165381966e-05,0.5
27302,몆/Noun,2,1,1,1.1115310228308472e-05,1.1106915165381966e-05,0.5
27303,첩혈/Noun,2,1,1,1.1115310228308472e-05,1.1106915165381966e-05,0.5
27304,대대로/Noun,2,1,1,1.1115310228308472e-05,1.1106915165381966e-05,0.5
27305,스프라이트/Noun,2,1,1,1.1115310228308472e-05,1.1106915165381966e-05,0.5
27306,바텀/Noun,2,1,1,1.1115310228308472e-05,1.1106915165381966e-05,0.5
27307,윈터/Noun,2,1,1,1.1115310228308472e-05,1.1106915165381966e-05,0.5
27308,제곱/Noun,2,1,1,1.1115310228308472e-05,1.1106915165381966e-05,0.5
27309,진보면/Noun,2,1,1,1.1115310228308472e-05,1.1106915165381966e-05,0.5
27310,혜미/Noun,2,1,1,1.1115310228308472e-05,1.1106915165381966e-05,0.5
27311,윤유선/Noun,2,1,1,1.1115310228308472e-05,1.1106915165381966e-05,0.5
27312,비공개/Noun,2,1,1,1.1115310228308472e-05,1.1106915165381966e-05,0.5
27313,더데/Noun,2,1,1,1.1115310228308472e-05,1.1106915165381966e-05,0.5
27314,아넷/Noun,2,1,1,1.1115310228308472e-05,1.1106915165381966e-05,0.5
27315,사디즘/Noun,2,1,1,1.1115310228308472e-05,1.1106915165381966e-05,0.5
27316,슨상/Noun,2,1,1,1.1115310228308472e-05,1.1106915165381966e-05,0.5
27317,Dead/Alpha,2,1,1,1.1115310228308472e-05,1.1106915165381966e-05,0.5
27318,펄프/Noun,2,1,1,1.1115310228308472e-05,1.1106915165381966e-05,0.5
27319,찰지구나/Noun,2,1,1,1.1115310228308472e-05,1.1106915165381966e-05,0.5
27320,시트/Noun,2,1,1,1.1115310228308472e-05,1.1106915165381966e-05,0.5
27321,남요/Noun,2,1,1,1.1115310228308472e-05,1.1106915165381966e-05,0.5
27322,베란다/Noun,2,1,1,1.1115310228308472e-05,1.1106915165381966e-05,0.5
27323,()/Punctuation,2,1,1,1.1115310228308472e-05,1.1106915165381966e-05,0.5
27324,고오/Noun,2,1,1,1.1115310228308472e-05,1.1106915165381966e-05,0.5
27325,국립공원/Noun,2,1,1,1.1115310228308472e-05,1.1106915165381966e-05,0.5
27326,수라/Noun,2,1,1,1.1115310228308472e-05,1.1106915165381966e-05,0.5
27327,헛것/Noun,2,1,1,1.1115310228308472e-05,1.1106915165381966e-05,0.5
27328,경하/Noun,2,1,1,1.1115310228308472e-05,1.1106915165381966e-05,0.5
27329,장지/Noun,2,1,1,1.1115310228308472e-05,1.1106915165381966e-05,0.5
27330,가절/Noun,2,1,1,1.1115310228308472e-05,1.1106915165381966e-05,0.5
27331,마레/Noun,2,1,1,1.1115310228308472e-05,1.1106915165381966e-05,0.5
27332,선불/Noun,2,1,1,1.1115310228308472e-05,1.1106915165381966e-05,0.5
27333,산들/Noun,2,1,1,1.1115310228308472e-05,1.1106915165381966e-05,0.5
27334,외동아들/Noun,2,1,1,1.1115310228308472e-05,1.1106915165381966e-05,0.5
27335,휩/Noun,2,1,1,1.1115310228308472e-05,1.1106915165381966e-05,0.5
27336,트로피/Noun,2,1,1,1.1115310228308472e-05,1.1106915165381966e-05,0.5
27337,또울/Noun,2,1,1,1.1115310228308472e-05,1.1106915165381966e-05,0.5
27338,분분/Noun,2,1,1,1.1115310228308472e-05,1.1106915165381966e-05,0.5
27339,ㅣㄴ/KoreanParticle,2,1,1,1.1115310228308472e-05,1.1106915165381966e-05,0.5
27340,끝내기/Noun,2,1,1,1.1115310228308472e-05,1.1106915165381966e-05,0.5
27341,엔트로피/Noun,2,1,1,1.1115310228308472e-05,1.1106915165381966e-05,0.5
27342,대유/Noun,2,1,1,1.1115310228308472e-05,1.1106915165381966e-05,0.5
27343,비디오카메라/Noun,2,1,1,1.1115310228308472e-05,1.1106915165381966e-05,0.5
27344,나잘하다/Adjective,2,1,1,1.1115310228308472e-05,1.1106915165381966e-05,0.5
27345,ㅡㅇㅡ/KoreanParticle,2,1,1,1.1115310228308472e-05,1.1106915165381966e-05,0.5
27346,수영화/Noun,2,1,1,1.1115310228308472e-05,1.1106915165381966e-05,0.5
27347,영악/Noun,2,1,1,1.1115310228308472e-05,1.1106915165381966e-05,0.5
27348,오버로드/Noun,2,1,1,1.1115310228308472e-05,1.1106915165381966e-05,0.5
27349,동쪽/Noun,2,1,1,1.1115310228308472e-05,1.1106915165381966e-05,0.5
27350,깡촌/Noun,2,1,1,1.1115310228308472e-05,1.1106915165381966e-05,0.5
27351,은성/Noun,2,1,1,1.1115310228308472e-05,1.1106915165381966e-05,0.5
27352,헤이엑/Noun,2,1,1,1.1115310228308472e-05,1.1106915165381966e-05,0.5
27353,홀홀/Noun,2,1,1,1.1115310228308472e-05,1.1106915165381966e-05,0.5
27354,애썻다/Noun,2,1,1,1.1115310228308472e-05,1.1106915165381966e-05,0.5
27355,소냐/Noun,2,1,1,1.1115310228308472e-05,1.1106915165381966e-05,0.5
27356,트랄라/Noun,2,1,1,1.1115310228308472e-05,1.1106915165381966e-05,0.5
27357,이퀼리브리엄/Noun,2,1,1,1.1115310228308472e-05,1.1106915165381966e-05,0.5
27358,숭인/Noun,2,1,1,1.1115310228308472e-05,1.1106915165381966e-05,0.5
27359,칫솔/Noun,2,1,1,1.1115310228308472e-05,1.1106915165381966e-05,0.5
27360,펑키/Noun,2,1,1,1.1115310228308472e-05,1.1106915165381966e-05,0.5
27361,섬머/Noun,2,1,1,1.1115310228308472e-05,1.1106915165381966e-05,0.5
27362,축산/Noun,2,1,1,1.1115310228308472e-05,1.1106915165381966e-05,0.5
27363,손맛/Noun,2,1,1,1.1115310228308472e-05,1.1106915165381966e-05,0.5
27364,경쟁자/Noun,2,1,1,1.1115310228308472e-05,1.1106915165381966e-05,0.5
27365,이솝우화/Noun,2,1,1,1.1115310228308472e-05,1.1106915165381966e-05,0.5
27366,부록/Noun,2,1,1,1.1115310228308472e-05,1.1106915165381966e-05,0.5
27367,부글부글/Adverb,2,1,1,1.1115310228308472e-05,1.1106915165381966e-05,0.5
27368,타석/Noun,2,1,1,1.1115310228308472e-05,1.1106915165381966e-05,0.5
27369,우우/Exclamation,2,1,1,1.1115310228308472e-05,1.1106915165381966e-05,0.5
27370,이사회/Noun,2,1,1,1.1115310228308472e-05,1.1106915165381966e-05,0.5
27371,하말/Noun,2,1,1,1.1115310228308472e-05,1.1106915165381966e-05,0.5
27372,블로거/Noun,2,1,1,1.1115310228308472e-05,1.1106915165381966e-05,0.5
27373,ㅌㅋㅋ/KoreanParticle,2,1,1,1.1115310228308472e-05,1.1106915165381966e-05,0.5
27374,일게이/Noun,2,1,1,1.1115310228308472e-05,1.1106915165381966e-05,0.5
27375,상무/Noun,2,1,1,1.1115310228308472e-05,1.1106915165381966e-05,0.5
27376,더후/Noun,2,1,1,1.1115310228308472e-05,1.1106915165381966e-05,0.5
27377,비열/Noun,2,1,1,1.1115310228308472e-05,1.1106915165381966e-05,0.5
27378,김진아/Noun,2,1,1,1.1115310228308472e-05,1.1106915165381966e-05,0.5
27379,우히히/Noun,2,1,1,1.1115310228308472e-05,1.1106915165381966e-05,0.5
27380,뒹군/Noun,2,1,1,1.1115310228308472e-05,1.1106915165381966e-05,0.5
27381,휘하다/Adjective,2,1,1,1.1115310228308472e-05,1.1106915165381966e-05,0.5
27382,BB/Alpha,2,1,1,1.1115310228308472e-05,1.1106915165381966e-05,0.5
27383,면접/Noun,2,1,1,1.1115310228308472e-05,1.1106915165381966e-05,0.5
27384,플래시맨/Noun,2,1,1,1.1115310228308472e-05,1.1106915165381966e-05,0.5
27385,뽀송뽀송/Adverb,2,1,1,1.1115310228308472e-05,1.1106915165381966e-05,0.5
27386,싣다/Verb,2,1,1,1.1115310228308472e-05,1.1106915165381966e-05,0.5
27387,animation/Alpha,2,1,1,1.1115310228308472e-05,1.1106915165381966e-05,0.5
27388,모던보이/Noun,2,1,1,1.1115310228308472e-05,1.1106915165381966e-05,0.5
27389,홀랜드/Noun,2,1,1,1.1115310228308472e-05,1.1106915165381966e-05,0.5
27390,승인/Noun,2,1,1,1.1115310228308472e-05,1.1106915165381966e-05,0.5
27391,최철호/Noun,2,1,1,1.1115310228308472e-05,1.1106915165381966e-05,0.5
27392,...///Punctuation,2,1,1,1.1115310228308472e-05,1.1106915165381966e-05,0.5
27393,에피타이저/Noun,2,1,1,1.1115310228308472e-05,1.1106915165381966e-05,0.5
27394,저출산/Noun,2,1,1,1.1115310228308472e-05,1.1106915165381966e-05,0.5
27395,역병/Noun,2,1,1,1.1115310228308472e-05,1.1106915165381966e-05,0.5
27396,대못/Noun,2,1,1,1.1115310228308472e-05,1.1106915165381966e-05,0.5
27397,미합중국/Noun,2,1,1,1.1115310228308472e-05,1.1106915165381966e-05,0.5
27398,대속/Noun,2,1,1,1.1115310228308472e-05,1.1106915165381966e-05,0.5
27399,러시아인/Noun,2,1,1,1.1115310228308472e-05,1.1106915165381966e-05,0.5
27400,기면증/Noun,2,1,1,1.1115310228308472e-05,1.1106915165381966e-05,0.5
27401,아리아리/Noun,2,1,1,1.1115310228308472e-05,1.1106915165381966e-05,0.5
27402,대결씬/Noun,2,1,1,1.1115310228308472e-05,1.1106915165381966e-05,0.5
27403,쾌도홍길동/Noun,2,1,1,1.1115310228308472e-05,1.1106915165381966e-05,0.5
27404,윅스/Noun,2,1,1,1.1115310228308472e-05,1.1106915165381966e-05,0.5
27405,성지고/Noun,2,1,1,1.1115310228308472e-05,1.1106915165381966e-05,0.5
27406,미나리/Noun,2,1,1,1.1115310228308472e-05,1.1106915165381966e-05,0.5
27407,young/Alpha,2,1,1,1.1115310228308472e-05,1.1106915165381966e-05,0.5
27408,Yesterday/Alpha,2,1,1,1.1115310228308472e-05,1.1106915165381966e-05,0.5
27409,으르렁/Noun,2,1,1,1.1115310228308472e-05,1.1106915165381966e-05,0.5
27410,도려내다/Verb,2,1,1,1.1115310228308472e-05,1.1106915165381966e-05,0.5
27411,일링/Noun,2,1,1,1.1115310228308472e-05,1.1106915165381966e-05,0.5
27412,허밍/Noun,2,1,1,1.1115310228308472e-05,1.1106915165381966e-05,0.5
27413,봄봄/Noun,2,1,1,1.1115310228308472e-05,1.1106915165381966e-05,0.5
27414,시엔/Noun,2,1,1,1.1115310228308472e-05,1.1106915165381966e-05,0.5
27415,투슬/Noun,2,1,1,1.1115310228308472e-05,1.1106915165381966e-05,0.5
27416,이대호/Noun,2,1,1,1.1115310228308472e-05,1.1106915165381966e-05,0.5
27417,피치/Noun,2,1,1,1.1115310228308472e-05,1.1106915165381966e-05,0.5
27418,59분/Number,2,1,1,1.1115310228308472e-05,1.1106915165381966e-05,0.5
27419,주영호/Noun,2,1,1,1.1115310228308472e-05,1.1106915165381966e-05,0.5
27420,이메일/Noun,2,1,1,1.1115310228308472e-05,1.1106915165381966e-05,0.5
27421,좉/Noun,2,1,1,1.1115310228308472e-05,1.1106915165381966e-05,0.5
27422,심층/Noun,2,1,1,1.1115310228308472e-05,1.1106915165381966e-05,0.5
27423,진핵/Noun,2,1,1,1.1115310228308472e-05,1.1106915165381966e-05,0.5
27424,전설의주먹/Noun,2,1,1,1.1115310228308472e-05,1.1106915165381966e-05,0.5
27425,만쉐/Noun,2,1,1,1.1115310228308472e-05,1.1106915165381966e-05,0.5
27426,게코/Noun,2,1,1,1.1115310228308472e-05,1.1106915165381966e-05,0.5
27427,도때/Foreign,2,1,1,1.1115310228308472e-05,1.1106915165381966e-05,0.5
27428,아코/Noun,2,1,1,1.1115310228308472e-05,1.1106915165381966e-05,0.5
27429,전조/Noun,2,1,1,1.1115310228308472e-05,1.1106915165381966e-05,0.5
27430,탈퇴/Noun,2,1,1,1.1115310228308472e-05,1.1106915165381966e-05,0.5
27431,76분/Number,2,1,1,1.1115310228308472e-05,1.1106915165381966e-05,0.5
27432,술사/Noun,2,1,1,1.1115310228308472e-05,1.1106915165381966e-05,0.5
27433,이봉원/Noun,2,1,1,1.1115310228308472e-05,1.1106915165381966e-05,0.5
27434,반신/Noun,2,1,1,1.1115310228308472e-05,1.1106915165381966e-05,0.5
27435,위배/Noun,2,1,1,1.1115310228308472e-05,1.1106915165381966e-05,0.5
27436,락음악/Noun,2,1,1,1.1115310228308472e-05,1.1106915165381966e-05,0.5
27437,인간세계/Noun,2,1,1,1.1115310228308472e-05,1.1106915165381966e-05,0.5
27438,ㅋㅑ/KoreanParticle,2,1,1,1.1115310228308472e-05,1.1106915165381966e-05,0.5
27439,유엔/Noun,2,1,1,1.1115310228308472e-05,1.1106915165381966e-05,0.5
27440,뺨칠/Noun,2,1,1,1.1115310228308472e-05,1.1106915165381966e-05,0.5
27441,다독/Noun,2,1,1,1.1115310228308472e-05,1.1106915165381966e-05,0.5
27442,쑥쑥/Adverb,2,1,1,1.1115310228308472e-05,1.1106915165381966e-05,0.5
27443,의복/Noun,2,1,1,1.1115310228308472e-05,1.1106915165381966e-05,0.5
27444,뽈노/Noun,2,1,1,1.1115310228308472e-05,1.1106915165381966e-05,0.5
27445,꼐/Noun,2,1,1,1.1115310228308472e-05,1.1106915165381966e-05,0.5
27446,친한척/Noun,2,1,1,1.1115310228308472e-05,1.1106915165381966e-05,0.5
27447,이재/Noun,2,1,1,1.1115310228308472e-05,1.1106915165381966e-05,0.5
27448,엠파이어/Noun,2,1,1,1.1115310228308472e-05,1.1106915165381966e-05,0.5
27449,양임/Noun,2,1,1,1.1115310228308472e-05,1.1106915165381966e-05,0.5
27450,박수갈채/Noun,2,1,1,1.1115310228308472e-05,1.1106915165381966e-05,0.5
27451,뷔/Noun,2,1,1,1.1115310228308472e-05,1.1106915165381966e-05,0.5
27452,모리꼬/Noun,2,1,1,1.1115310228308472e-05,1.1106915165381966e-05,0.5
27453,샬럿/Noun,2,1,1,1.1115310228308472e-05,1.1106915165381966e-05,0.5
27454,ㅅㅅㅅ/KoreanParticle,2,1,1,1.1115310228308472e-05,1.1106915165381966e-05,0.5
27455,오식/Noun,2,1,1,1.1115310228308472e-05,1.1106915165381966e-05,0.5
27456,나카/Noun,2,1,1,1.1115310228308472e-05,1.1106915165381966e-05,0.5
27457,선씨/Noun,2,1,1,1.1115310228308472e-05,1.1106915165381966e-05,0.5
27458,매카시/Noun,2,1,1,1.1115310228308472e-05,1.1106915165381966e-05,0.5
27459,성전/Noun,2,1,1,1.1115310228308472e-05,1.1106915165381966e-05,0.5
27460,월전/Noun,2,1,1,1.1115310228308472e-05,1.1106915165381966e-05,0.5
27461,취월/Noun,2,1,1,1.1115310228308472e-05,1.1106915165381966e-05,0.5
27462,김철수/Noun,2,1,1,1.1115310228308472e-05,1.1106915165381966e-05,0.5
27463,화풍/Noun,2,1,1,1.1115310228308472e-05,1.1106915165381966e-05,0.5
27464,콘셉/Noun,2,1,1,1.1115310228308472e-05,1.1106915165381966e-05,0.5
27465,....//Punctuation,2,1,1,1.1115310228308472e-05,1.1106915165381966e-05,0.5
27466,<--/Punctuation,2,1,1,1.1115310228308472e-05,1.1106915165381966e-05,0.5
27467,몰골/Noun,2,1,1,1.1115310228308472e-05,1.1106915165381966e-05,0.5
27468,일급살인/Noun,2,1,1,1.1115310228308472e-05,1.1106915165381966e-05,0.5
27469,연금/Noun,2,1,1,1.1115310228308472e-05,1.1106915165381966e-05,0.5
27470,체념/Noun,2,1,1,1.1115310228308472e-05,1.1106915165381966e-05,0.5
27471,남새/Noun,2,1,1,1.1115310228308472e-05,1.1106915165381966e-05,0.5
27472,샘닐/Noun,2,1,1,1.1115310228308472e-05,1.1106915165381966e-05,0.5
27473,뱃사람/Noun,2,1,1,1.1115310228308472e-05,1.1106915165381966e-05,0.5
27474,동주/Noun,2,1,1,1.1115310228308472e-05,1.1106915165381966e-05,0.5
27475,깨트린/Noun,2,1,1,1.1115310228308472e-05,1.1106915165381966e-05,0.5
27476,사찰/Noun,2,1,1,1.1115310228308472e-05,1.1106915165381966e-05,0.5
27477,스페샬/Noun,2,1,1,1.1115310228308472e-05,1.1106915165381966e-05,0.5
27478,우러/Noun,2,1,1,1.1115310228308472e-05,1.1106915165381966e-05,0.5
27479,뒤에도/Foreign,2,1,1,1.1115310228308472e-05,1.1106915165381966e-05,0.5
27480,벽력/Noun,2,1,1,1.1115310228308472e-05,1.1106915165381966e-05,0.5
27481,촌지/Noun,2,1,1,1.1115310228308472e-05,1.1106915165381966e-05,0.5
27482,모조품/Noun,2,1,1,1.1115310228308472e-05,1.1106915165381966e-05,0.5
27483,힐링캠프/Noun,2,1,1,1.1115310228308472e-05,1.1106915165381966e-05,0.5
27484,영정사진/Noun,2,1,1,1.1115310228308472e-05,1.1106915165381966e-05,0.5
27485,minutes/Alpha,2,1,1,1.1115310228308472e-05,1.1106915165381966e-05,0.5
27486,꿑/Noun,2,1,1,1.1115310228308472e-05,1.1106915165381966e-05,0.5
27487,삼청교육대/Noun,2,1,1,1.1115310228308472e-05,1.1106915165381966e-05,0.5
27488,옥에티/Noun,2,1,1,1.1115310228308472e-05,1.1106915165381966e-05,0.5
27489,아몬/Noun,2,1,1,1.1115310228308472e-05,1.1106915165381966e-05,0.5
27490,마데/Noun,2,1,1,1.1115310228308472e-05,1.1106915165381966e-05,0.5
27491,황현희/Noun,2,1,1,1.1115310228308472e-05,1.1106915165381966e-05,0.5
27492,만고/Noun,2,1,1,1.1115310228308472e-05,1.1106915165381966e-05,0.5
27493,최적/Noun,2,1,1,1.1115310228308472e-05,1.1106915165381966e-05,0.5
27494,르포/Noun,2,1,1,1.1115310228308472e-05,1.1106915165381966e-05,0.5
27495,즈칸/Noun,2,1,1,1.1115310228308472e-05,1.1106915165381966e-05,0.5
27496,괴테/Noun,2,1,1,1.1115310228308472e-05,1.1106915165381966e-05,0.5
27497,벙벙하다/Adjective,2,1,1,1.1115310228308472e-05,1.1106915165381966e-05,0.5
27498,맥도웰/Noun,2,1,1,1.1115310228308472e-05,1.1106915165381966e-05,0.5
27499,퐁네프/Noun,2,1,1,1.1115310228308472e-05,1.1106915165381966e-05,0.5
27500,드래스/Noun,2,1,1,1.1115310228308472e-05,1.1106915165381966e-05,0.5
27501,요별/Noun,2,1,1,1.1115310228308472e-05,1.1106915165381966e-05,0.5
27502,예스터데이/Noun,2,1,1,1.1115310228308472e-05,1.1106915165381966e-05,0.5
27503,엔간하다/Adjective,2,1,1,1.1115310228308472e-05,1.1106915165381966e-05,0.5
27504,꾸짖다/Verb,2,1,1,1.1115310228308472e-05,1.1106915165381966e-05,0.5
27505,퍼펙트게임/Noun,2,1,1,1.1115310228308472e-05,1.1106915165381966e-05,0.5
27506,합치/Noun,2,1,1,1.1115310228308472e-05,1.1106915165381966e-05,0.5
27507,악화/Noun,2,1,1,1.1115310228308472e-05,1.1106915165381966e-05,0.5
27508,댕김/Noun,2,1,1,1.1115310228308472e-05,1.1106915165381966e-05,0.5
27509,뇌종양/Noun,2,1,1,1.1115310228308472e-05,1.1106915165381966e-05,0.5
27510,고고싱/Noun,2,1,1,1.1115310228308472e-05,1.1106915165381966e-05,0.5
27511,신중/Noun,2,1,1,1.1115310228308472e-05,1.1106915165381966e-05,0.5
27512,손끝/Noun,2,1,1,1.1115310228308472e-05,1.1106915165381966e-05,0.5
27513,김민경/Noun,2,1,1,1.1115310228308472e-05,1.1106915165381966e-05,0.5
27514,Thank/Alpha,2,1,1,1.1115310228308472e-05,1.1106915165381966e-05,0.5
27515,김연우/Noun,2,1,1,1.1115310228308472e-05,1.1106915165381966e-05,0.5
27516,헤이/Noun,2,1,1,1.1115310228308472e-05,1.1106915165381966e-05,0.5
27517,로넌/Noun,2,1,1,1.1115310228308472e-05,1.1106915165381966e-05,0.5
27518,시얼샤/Noun,2,1,1,1.1115310228308472e-05,1.1106915165381966e-05,0.5
27519,멍뭉이/Noun,2,1,1,1.1115310228308472e-05,1.1106915165381966e-05,0.5
27520,1945년/Number,2,1,1,1.1115310228308472e-05,1.1106915165381966e-05,0.5
27521,네덜란드인/Noun,2,1,1,1.1115310228308472e-05,1.1106915165381966e-05,0.5
27522,패키지/Noun,2,1,1,1.1115310228308472e-05,1.1106915165381966e-05,0.5
27523,공전/Noun,2,1,1,1.1115310228308472e-05,1.1106915165381966e-05,0.5
27524,명민/Noun,2,1,1,1.1115310228308472e-05,1.1106915165381966e-05,0.5
27525,쇠주/Noun,2,1,1,1.1115310228308472e-05,1.1106915165381966e-05,0.5
27526,푱점/Noun,2,1,1,1.1115310228308472e-05,1.1106915165381966e-05,0.5
27527,체조/Noun,2,1,1,1.1115310228308472e-05,1.1106915165381966e-05,0.5
27528,숀코네리/Noun,2,1,1,1.1115310228308472e-05,1.1106915165381966e-05,0.5
27529,겡/Noun,2,1,1,1.1115310228308472e-05,1.1106915165381966e-05,0.5
27530,최숙빈/Noun,2,1,1,1.1115310228308472e-05,1.1106915165381966e-05,0.5
27531,뒷구멍/Noun,2,1,1,1.1115310228308472e-05,1.1106915165381966e-05,0.5
27532,왜죽/Noun,2,1,1,1.1115310228308472e-05,1.1106915165381966e-05,0.5
27533,퍽퍽/Noun,2,1,1,1.1115310228308472e-05,1.1106915165381966e-05,0.5
27534,애무/Noun,2,1,1,1.1115310228308472e-05,1.1106915165381966e-05,0.5
27535,메가티비/Noun,2,1,1,1.1115310228308472e-05,1.1106915165381966e-05,0.5
27536,동우/Noun,2,1,1,1.1115310228308472e-05,1.1106915165381966e-05,0.5
27537,간음/Noun,2,1,1,1.1115310228308472e-05,1.1106915165381966e-05,0.5
27538,24일/Number,2,1,1,1.1115310228308472e-05,1.1106915165381966e-05,0.5
27539,무료함/Noun,2,1,1,1.1115310228308472e-05,1.1106915165381966e-05,0.5
27540,fall/Alpha,2,1,1,1.1115310228308472e-05,1.1106915165381966e-05,0.5
27541,라이플/Noun,2,1,1,1.1115310228308472e-05,1.1106915165381966e-05,0.5
27542,케니지/Noun,2,1,1,1.1115310228308472e-05,1.1106915165381966e-05,0.5
27543,재차/Noun,2,1,1,1.1115310228308472e-05,1.1106915165381966e-05,0.5
27544,팟캐스트/Noun,2,1,1,1.1115310228308472e-05,1.1106915165381966e-05,0.5
27545,19일/Number,2,1,1,1.1115310228308472e-05,1.1106915165381966e-05,0.5
27546,반기다/Verb,2,1,1,1.1115310228308472e-05,1.1106915165381966e-05,0.5
27547,다크서클/Noun,2,1,1,1.1115310228308472e-05,1.1106915165381966e-05,0.5
27548,가로지르다/Verb,2,1,1,1.1115310228308472e-05,1.1106915165381966e-05,0.5
27549,복서/Noun,2,1,1,1.1115310228308472e-05,1.1106915165381966e-05,0.5
27550,리스베트/Noun,2,1,1,1.1115310228308472e-05,1.1106915165381966e-05,0.5
27551,예리/Noun,2,1,1,1.1115310228308472e-05,1.1106915165381966e-05,0.5
27552,마취/Noun,2,1,1,1.1115310228308472e-05,1.1106915165381966e-05,0.5
27553,뽕빨/Noun,2,1,1,1.1115310228308472e-05,1.1106915165381966e-05,0.5
27554,조페/Noun,2,1,1,1.1115310228308472e-05,1.1106915165381966e-05,0.5
27555,개천/Noun,2,1,1,1.1115310228308472e-05,1.1106915165381966e-05,0.5
27556,칼라일/Noun,2,1,1,1.1115310228308472e-05,1.1106915165381966e-05,0.5
27557,사우론/Noun,2,1,1,1.1115310228308472e-05,1.1106915165381966e-05,0.5
27558,비하인드/Noun,2,1,1,1.1115310228308472e-05,1.1106915165381966e-05,0.5
27559,브루스리/Noun,2,1,1,1.1115310228308472e-05,1.1106915165381966e-05,0.5
27560,역자/Noun,2,1,1,1.1115310228308472e-05,1.1106915165381966e-05,0.5
27561,보스니아/Noun,2,1,1,1.1115310228308472e-05,1.1106915165381966e-05,0.5
27562,부회장/Noun,2,1,1,1.1115310228308472e-05,1.1106915165381966e-05,0.5
27563,지잔/Noun,2,1,1,1.1115310228308472e-05,1.1106915165381966e-05,0.5
27564,페테/Noun,2,1,1,1.1115310228308472e-05,1.1106915165381966e-05,0.5
27565,촉구/Noun,2,1,1,1.1115310228308472e-05,1.1106915165381966e-05,0.5
27566,눈믈/Noun,2,1,1,1.1115310228308472e-05,1.1106915165381966e-05,0.5
27567,걸즈/Noun,2,1,1,1.1115310228308472e-05,1.1106915165381966e-05,0.5
27568,우주인/Noun,2,1,1,1.1115310228308472e-05,1.1106915165381966e-05,0.5
27569,서진우/Noun,2,1,1,1.1115310228308472e-05,1.1106915165381966e-05,0.5
27570,수혁/Noun,2,1,1,1.1115310228308472e-05,1.1106915165381966e-05,0.5
27571,굴다리/Noun,2,1,1,1.1115310228308472e-05,1.1106915165381966e-05,0.5
27572,도지/Noun,2,1,1,1.1115310228308472e-05,1.1106915165381966e-05,0.5
27573,Passion/Alpha,2,1,1,1.1115310228308472e-05,1.1106915165381966e-05,0.5
27574,부스/Noun,2,1,1,1.1115310228308472e-05,1.1106915165381966e-05,0.5
27575,부그/Noun,2,1,1,1.1115310228308472e-05,1.1106915165381966e-05,0.5
27576,가정불화/Noun,2,1,1,1.1115310228308472e-05,1.1106915165381966e-05,0.5
27577,",,,,,,,,,,,,/Punctuation",2,1,1,1.1115310228308472e-05,1.1106915165381966e-05,0.5
27578,아츠코/Noun,2,1,1,1.1115310228308472e-05,1.1106915165381966e-05,0.5
27579,2030/Number,2,1,1,1.1115310228308472e-05,1.1106915165381966e-05,0.5
27580,크윽/Exclamation,2,1,1,1.1115310228308472e-05,1.1106915165381966e-05,0.5
27581,요령/Noun,2,1,1,1.1115310228308472e-05,1.1106915165381966e-05,0.5
27582,연마/Noun,2,1,1,1.1115310228308472e-05,1.1106915165381966e-05,0.5
27583,캐슬/Noun,2,1,1,1.1115310228308472e-05,1.1106915165381966e-05,0.5
27584,추이/Noun,2,1,1,1.1115310228308472e-05,1.1106915165381966e-05,0.5
27585,닉네임/Noun,2,1,1,1.1115310228308472e-05,1.1106915165381966e-05,0.5
27586,유혼/Noun,2,1,1,1.1115310228308472e-05,1.1106915165381966e-05,0.5
27587,의과/Noun,2,1,1,1.1115310228308472e-05,1.1106915165381966e-05,0.5
27588,쿄/Noun,2,1,1,1.1115310228308472e-05,1.1106915165381966e-05,0.5
27589,섹씬/Noun,2,1,1,1.1115310228308472e-05,1.1106915165381966e-05,0.5
27590,안코/Noun,2,1,1,1.1115310228308472e-05,1.1106915165381966e-05,0.5
27591,덕택/Noun,2,1,1,1.1115310228308472e-05,1.1106915165381966e-05,0.5
27592,굿일/Noun,2,1,1,1.1115310228308472e-05,1.1106915165381966e-05,0.5
27593,열한시/Noun,2,1,1,1.1115310228308472e-05,1.1106915165381966e-05,0.5
27594,잭애프론/Noun,2,1,1,1.1115310228308472e-05,1.1106915165381966e-05,0.5
27595,맟춰/Noun,2,1,1,1.1115310228308472e-05,1.1106915165381966e-05,0.5
27596,차선/Noun,2,1,1,1.1115310228308472e-05,1.1106915165381966e-05,0.5
27597,나좀/Noun,2,1,1,1.1115310228308472e-05,1.1106915165381966e-05,0.5
27598,크으/Exclamation,2,1,1,1.1115310228308472e-05,1.1106915165381966e-05,0.5
27599,너프/Noun,2,1,1,1.1115310228308472e-05,1.1106915165381966e-05,0.5
27600,호전/Noun,2,1,1,1.1115310228308472e-05,1.1106915165381966e-05,0.5
27601,혼다/Noun,2,1,1,1.1115310228308472e-05,1.1106915165381966e-05,0.5
27602,부터는/Foreign,2,1,1,1.1115310228308472e-05,1.1106915165381966e-05,0.5
27603,다중/Noun,2,1,1,1.1115310228308472e-05,1.1106915165381966e-05,0.5
27604,주피터/Noun,2,1,1,1.1115310228308472e-05,1.1106915165381966e-05,0.5
27605,적벽/Noun,2,1,1,1.1115310228308472e-05,1.1106915165381966e-05,0.5
27606,리하나/Noun,2,1,1,1.1115310228308472e-05,1.1106915165381966e-05,0.5
27607,일심동체/Noun,2,1,1,1.1115310228308472e-05,1.1106915165381966e-05,0.5
27608,사미자/Noun,2,1,1,1.1115310228308472e-05,1.1106915165381966e-05,0.5
27609,눈디/Noun,2,1,1,1.1115310228308472e-05,1.1106915165381966e-05,0.5
27610,화필/Noun,2,1,1,1.1115310228308472e-05,1.1106915165381966e-05,0.5
27611,특희/Noun,2,1,1,1.1115310228308472e-05,1.1106915165381966e-05,0.5
27612,안배/Noun,2,1,1,1.1115310228308472e-05,1.1106915165381966e-05,0.5
27613,시부/Noun,2,1,1,1.1115310228308472e-05,1.1106915165381966e-05,0.5
27614,쿸/Noun,2,1,1,1.1115310228308472e-05,1.1106915165381966e-05,0.5
27615,ㅋㅎㅎ/KoreanParticle,2,1,1,1.1115310228308472e-05,1.1106915165381966e-05,0.5
27616,결별/Noun,2,1,1,1.1115310228308472e-05,1.1106915165381966e-05,0.5
27617,4만/Number,2,1,1,1.1115310228308472e-05,1.1106915165381966e-05,0.5
27618,Rec/Alpha,2,1,1,1.1115310228308472e-05,1.1106915165381966e-05,0.5
27619,윌비/Noun,2,1,1,1.1115310228308472e-05,1.1106915165381966e-05,0.5
27620,히바/Noun,2,1,1,1.1115310228308472e-05,1.1106915165381966e-05,0.5
27621,는게/Eomi,2,1,1,1.1115310228308472e-05,1.1106915165381966e-05,0.5
27622,씁슬/Noun,2,1,1,1.1115310228308472e-05,1.1106915165381966e-05,0.5
27623,네야/Noun,2,1,1,1.1115310228308472e-05,1.1106915165381966e-05,0.5
27624,독방/Noun,2,1,1,1.1115310228308472e-05,1.1106915165381966e-05,0.5
27625,계세/Noun,2,1,1,1.1115310228308472e-05,1.1106915165381966e-05,0.5
27626,제리코/Noun,2,1,1,1.1115310228308472e-05,1.1106915165381966e-05,0.5
27627,질량/Noun,2,1,1,1.1115310228308472e-05,1.1106915165381966e-05,0.5
27628,슬럼가/Noun,2,1,1,1.1115310228308472e-05,1.1106915165381966e-05,0.5
27629,알렉산드리아/Noun,2,1,1,1.1115310228308472e-05,1.1106915165381966e-05,0.5
27630,매월/Noun,2,1,1,1.1115310228308472e-05,1.1106915165381966e-05,0.5
27631,가택연금/Noun,2,1,1,1.1115310228308472e-05,1.1106915165381966e-05,0.5
27632,다찌마와리/Noun,2,1,1,1.1115310228308472e-05,1.1106915165381966e-05,0.5
27633,54회/Number,2,1,1,1.1115310228308472e-05,1.1106915165381966e-05,0.5
27634,마안/Noun,2,1,1,1.1115310228308472e-05,1.1106915165381966e-05,0.5
27635,비누/Noun,2,1,1,1.1115310228308472e-05,1.1106915165381966e-05,0.5
27636,300년/Number,2,1,1,1.1115310228308472e-05,1.1106915165381966e-05,0.5
27637,지당/Noun,2,1,1,1.1115310228308472e-05,1.1106915165381966e-05,0.5
27638,똥구멍/Noun,2,1,1,1.1115310228308472e-05,1.1106915165381966e-05,0.5
27639,아저씬/Noun,2,1,1,1.1115310228308472e-05,1.1106915165381966e-05,0.5
27640,환상특급/Noun,2,1,1,1.1115310228308472e-05,1.1106915165381966e-05,0.5
27641,Classic/Alpha,2,1,1,1.1115310228308472e-05,1.1106915165381966e-05,0.5
27642,더티댄싱/Noun,2,1,1,1.1115310228308472e-05,1.1106915165381966e-05,0.5
27643,회때/Noun,2,1,1,1.1115310228308472e-05,1.1106915165381966e-05,0.5
27644,리메이크영화/Noun,2,1,1,1.1115310228308472e-05,1.1106915165381966e-05,0.5
27645,이래서/Conjunction,2,1,1,1.1115310228308472e-05,1.1106915165381966e-05,0.5
27646,서영춘/Noun,2,1,1,1.1115310228308472e-05,1.1106915165381966e-05,0.5
27647,까칠하다/Adjective,2,1,1,1.1115310228308472e-05,1.1106915165381966e-05,0.5
27648,앞장서다/Verb,2,1,1,1.1115310228308472e-05,1.1106915165381966e-05,0.5
27649,두둥/Noun,2,1,1,1.1115310228308472e-05,1.1106915165381966e-05,0.5
27650,현영은/Noun,2,1,1,1.1115310228308472e-05,1.1106915165381966e-05,0.5
27651,녕/Noun,2,1,1,1.1115310228308472e-05,1.1106915165381966e-05,0.5
27652,트윈픽스/Noun,2,1,1,1.1115310228308472e-05,1.1106915165381966e-05,0.5
27653,경제범죄/Noun,2,1,1,1.1115310228308472e-05,1.1106915165381966e-05,0.5
27654,베르날/Noun,2,1,1,1.1115310228308472e-05,1.1106915165381966e-05,0.5
27655,",,,,,,,,,,,,,/Punctuation",2,1,1,1.1115310228308472e-05,1.1106915165381966e-05,0.5
27656,몬테/Noun,2,1,1,1.1115310228308472e-05,1.1106915165381966e-05,0.5
27657,완급/Noun,2,1,1,1.1115310228308472e-05,1.1106915165381966e-05,0.5
27658,철컹철컹/Noun,2,1,1,1.1115310228308472e-05,1.1106915165381966e-05,0.5
27659,쥬금/Noun,2,1,1,1.1115310228308472e-05,1.1106915165381966e-05,0.5
27660,486/Number,2,1,1,1.1115310228308472e-05,1.1106915165381966e-05,0.5
27661,알프레드/Noun,2,1,1,1.1115310228308472e-05,1.1106915165381966e-05,0.5
27662,비련/Noun,2,1,1,1.1115310228308472e-05,1.1106915165381966e-05,0.5
27663,박통/Noun,2,1,1,1.1115310228308472e-05,1.1106915165381966e-05,0.5
27664,드래곤길들이기/Noun,2,1,1,1.1115310228308472e-05,1.1106915165381966e-05,0.5
27665,물레방아/Noun,2,1,1,1.1115310228308472e-05,1.1106915165381966e-05,0.5
27666,셋트장/Noun,2,1,1,1.1115310228308472e-05,1.1106915165381966e-05,0.5
27667,밴드오브브라더스/Noun,2,1,1,1.1115310228308472e-05,1.1106915165381966e-05,0.5
27668,챗/Noun,2,1,1,1.1115310228308472e-05,1.1106915165381966e-05,0.5
27669,마카/Noun,2,1,1,1.1115310228308472e-05,1.1106915165381966e-05,0.5
27670,7.32/Number,2,1,1,1.1115310228308472e-05,1.1106915165381966e-05,0.5
27671,매머드/Noun,2,1,1,1.1115310228308472e-05,1.1106915165381966e-05,0.5
27672,금뚝/Noun,2,1,1,1.1115310228308472e-05,1.1106915165381966e-05,0.5
27673,이후/Foreign,2,1,1,1.1115310228308472e-05,1.1106915165381966e-05,0.5
27674,1961년/Number,2,1,1,1.1115310228308472e-05,1.1106915165381966e-05,0.5
27675,중상/Noun,2,1,1,1.1115310228308472e-05,1.1106915165381966e-05,0.5
27676,개낚였다/Noun,2,1,1,1.1115310228308472e-05,1.1106915165381966e-05,0.5
27677,호탕/Noun,2,1,1,1.1115310228308472e-05,1.1106915165381966e-05,0.5
27678,시샘/Noun,2,1,1,1.1115310228308472e-05,1.1106915165381966e-05,0.5
27679,표때기/Noun,2,1,1,1.1115310228308472e-05,1.1106915165381966e-05,0.5
27680,기럭지/Noun,2,1,1,1.1115310228308472e-05,1.1106915165381966e-05,0.5
27681,보검/Noun,2,1,1,1.1115310228308472e-05,1.1106915165381966e-05,0.5
27682,의주/Noun,2,1,1,1.1115310228308472e-05,1.1106915165381966e-05,0.5
27683,오민석/Noun,2,1,1,1.1115310228308472e-05,1.1106915165381966e-05,0.5
27684,봄바람/Noun,2,1,1,1.1115310228308472e-05,1.1106915165381966e-05,0.5
27685,간편하다/Adjective,2,1,1,1.1115310228308472e-05,1.1106915165381966e-05,0.5
27686,강화하다/Adjective,2,1,1,1.1115310228308472e-05,1.1106915165381966e-05,0.5
27687,훨났다/Noun,2,1,1,1.1115310228308472e-05,1.1106915165381966e-05,0.5
27688,분타/Noun,2,1,1,1.1115310228308472e-05,1.1106915165381966e-05,0.5
27689,33분/Number,2,1,1,1.1115310228308472e-05,1.1106915165381966e-05,0.5
27690,조곤조곤/Adverb,2,1,1,1.1115310228308472e-05,1.1106915165381966e-05,0.5
27691,최재원/Noun,2,1,1,1.1115310228308472e-05,1.1106915165381966e-05,0.5
27692,츠카사/Noun,2,1,1,1.1115310228308472e-05,1.1106915165381966e-05,0.5
27693,조선영/Noun,2,1,1,1.1115310228308472e-05,1.1106915165381966e-05,0.5
27694,슈퍼마켓/Noun,2,1,1,1.1115310228308472e-05,1.1106915165381966e-05,0.5
27695,인력거/Noun,2,1,1,1.1115310228308472e-05,1.1106915165381966e-05,0.5
27696,일주/Noun,2,1,1,1.1115310228308472e-05,1.1106915165381966e-05,0.5
27697,아이돌스타/Noun,2,1,1,1.1115310228308472e-05,1.1106915165381966e-05,0.5
27698,혼탁/Noun,2,1,1,1.1115310228308472e-05,1.1106915165381966e-05,0.5
27699,운행/Noun,2,1,1,1.1115310228308472e-05,1.1106915165381966e-05,0.5
27700,40회/Number,2,1,1,1.1115310228308472e-05,1.1106915165381966e-05,0.5
27701,뱃사공/Noun,2,1,1,1.1115310228308472e-05,1.1106915165381966e-05,0.5
27702,스트롱/Noun,2,1,1,1.1115310228308472e-05,1.1106915165381966e-05,0.5
27703,인적/Noun,2,1,1,1.1115310228308472e-05,1.1106915165381966e-05,0.5
27704,천은/Noun,2,1,1,1.1115310228308472e-05,1.1106915165381966e-05,0.5
27705,2002/Number,2,1,1,1.1115310228308472e-05,1.1106915165381966e-05,0.5
27706,뺴고/Noun,2,1,1,1.1115310228308472e-05,1.1106915165381966e-05,0.5
27707,매표소/Noun,2,1,1,1.1115310228308472e-05,1.1106915165381966e-05,0.5
27708,누군데/Adverb,2,1,1,1.1115310228308472e-05,1.1106915165381966e-05,0.5
27709,되새김질/Noun,2,1,1,1.1115310228308472e-05,1.1106915165381966e-05,0.5
27710,부산영화제/Noun,2,1,1,1.1115310228308472e-05,1.1106915165381966e-05,0.5
27711,맙/Noun,2,1,1,1.1115310228308472e-05,1.1106915165381966e-05,0.5
27712,기소/Noun,2,1,1,1.1115310228308472e-05,1.1106915165381966e-05,0.5
27713,어허허/Adverb,2,1,1,1.1115310228308472e-05,1.1106915165381966e-05,0.5
27714,출두/Noun,2,1,1,1.1115310228308472e-05,1.1106915165381966e-05,0.5
27715,육군/Noun,2,1,1,1.1115310228308472e-05,1.1106915165381966e-05,0.5
27716,나요나/Noun,2,1,1,1.1115310228308472e-05,1.1106915165381966e-05,0.5
27717,통나무/Noun,2,1,1,1.1115310228308472e-05,1.1106915165381966e-05,0.5
27718,반칙왕/Noun,2,1,1,1.1115310228308472e-05,1.1106915165381966e-05,0.5
27719,소보/Noun,2,1,1,1.1115310228308472e-05,1.1106915165381966e-05,0.5
27720,▼/Foreign,2,1,1,1.1115310228308472e-05,1.1106915165381966e-05,0.5
27721,랜달/Noun,2,1,1,1.1115310228308472e-05,1.1106915165381966e-05,0.5
27722,레이서/Noun,2,1,1,1.1115310228308472e-05,1.1106915165381966e-05,0.5
27723,난처하다/Adjective,2,1,1,1.1115310228308472e-05,1.1106915165381966e-05,0.5
27724,호두까기/Noun,2,1,1,1.1115310228308472e-05,1.1106915165381966e-05,0.5
27725,400년/Number,2,1,1,1.1115310228308472e-05,1.1106915165381966e-05,0.5
27726,확끈/Noun,2,1,1,1.1115310228308472e-05,1.1106915165381966e-05,0.5
27727,키크/Noun,2,1,1,1.1115310228308472e-05,1.1106915165381966e-05,0.5
27728,돌입/Noun,2,1,1,1.1115310228308472e-05,1.1106915165381966e-05,0.5
27729,베이가/Noun,2,1,1,1.1115310228308472e-05,1.1106915165381966e-05,0.5
27730,USA/Alpha,2,1,1,1.1115310228308472e-05,1.1106915165381966e-05,0.5
27731,아쉅다/Noun,2,1,1,1.1115310228308472e-05,1.1106915165381966e-05,0.5
27732,op/Alpha,2,1,1,1.1115310228308472e-05,1.1106915165381966e-05,0.5
27733,1~2%/Number,2,1,1,1.1115310228308472e-05,1.1106915165381966e-05,0.5
27734,에딘버러/Noun,2,1,1,1.1115310228308472e-05,1.1106915165381966e-05,0.5
27735,Felicity/Alpha,2,1,1,1.1115310228308472e-05,1.1106915165381966e-05,0.5
27736,나영이/Noun,2,1,1,1.1115310228308472e-05,1.1106915165381966e-05,0.5
27737,취함/Noun,2,1,1,1.1115310228308472e-05,1.1106915165381966e-05,0.5
27738,ㅋㅋㄷㄷ/KoreanParticle,2,1,1,1.1115310228308472e-05,1.1106915165381966e-05,0.5
27739,오붓하다/Adjective,2,1,1,1.1115310228308472e-05,1.1106915165381966e-05,0.5
27740,스브스/Noun,2,1,1,1.1115310228308472e-05,1.1106915165381966e-05,0.5
27741,쉬더/Noun,2,1,1,1.1115310228308472e-05,1.1106915165381966e-05,0.5
27742,팜므/Noun,2,1,1,1.1115310228308472e-05,1.1106915165381966e-05,0.5
27743,수송/Noun,2,1,1,1.1115310228308472e-05,1.1106915165381966e-05,0.5
27744,팔찌/Noun,2,1,1,1.1115310228308472e-05,1.1106915165381966e-05,0.5
27745,섬멸/Noun,2,1,1,1.1115310228308472e-05,1.1106915165381966e-05,0.5
27746,학급/Noun,2,1,1,1.1115310228308472e-05,1.1106915165381966e-05,0.5
27747,겟음/Noun,2,1,1,1.1115310228308472e-05,1.1106915165381966e-05,0.5
27748,혀좀/Noun,2,1,1,1.1115310228308472e-05,1.1106915165381966e-05,0.5
27749,사시미/Noun,2,1,1,1.1115310228308472e-05,1.1106915165381966e-05,0.5
27750,기제/Noun,2,1,1,1.1115310228308472e-05,1.1106915165381966e-05,0.5
27751,의전/Noun,2,1,1,1.1115310228308472e-05,1.1106915165381966e-05,0.5
27752,월세/Noun,2,1,1,1.1115310228308472e-05,1.1106915165381966e-05,0.5
27753,고열/Noun,2,1,1,1.1115310228308472e-05,1.1106915165381966e-05,0.5
27754,노진구/Noun,2,1,1,1.1115310228308472e-05,1.1106915165381966e-05,0.5
27755,졸졸/Noun,2,1,1,1.1115310228308472e-05,1.1106915165381966e-05,0.5
27756,영해/Noun,2,1,1,1.1115310228308472e-05,1.1106915165381966e-05,0.5
27757,정민아/Noun,2,1,1,1.1115310228308472e-05,1.1106915165381966e-05,0.5
27758,베바/Noun,2,1,1,1.1115310228308472e-05,1.1106915165381966e-05,0.5
27759,전자제품/Noun,2,1,1,1.1115310228308472e-05,1.1106915165381966e-05,0.5
27760,가쉽/Noun,2,1,1,1.1115310228308472e-05,1.1106915165381966e-05,0.5
27761,허허/Exclamation,2,1,1,1.1115310228308472e-05,1.1106915165381966e-05,0.5
27762,허둥지둥/Noun,2,1,1,1.1115310228308472e-05,1.1106915165381966e-05,0.5
27763,쫄았는데/Noun,2,1,1,1.1115310228308472e-05,1.1106915165381966e-05,0.5
27764,코제트/Noun,2,1,1,1.1115310228308472e-05,1.1106915165381966e-05,0.5
27765,영령/Noun,2,1,1,1.1115310228308472e-05,1.1106915165381966e-05,0.5
27766,호국/Noun,2,1,1,1.1115310228308472e-05,1.1106915165381966e-05,0.5
27767,888/Number,2,1,1,1.1115310228308472e-05,1.1106915165381966e-05,0.5
27768,암벽등반/Noun,2,1,1,1.1115310228308472e-05,1.1106915165381966e-05,0.5
27769,네프/Noun,2,1,1,1.1115310228308472e-05,1.1106915165381966e-05,0.5
27770,특사/Noun,2,1,1,1.1115310228308472e-05,1.1106915165381966e-05,0.5
27771,지팡구/Noun,2,1,1,1.1115310228308472e-05,1.1106915165381966e-05,0.5
27772,양영희/Noun,2,1,1,1.1115310228308472e-05,1.1106915165381966e-05,0.5
27773,똘짓/Noun,2,1,1,1.1115310228308472e-05,1.1106915165381966e-05,0.5
27774,양자/Noun,2,1,1,1.1115310228308472e-05,1.1106915165381966e-05,0.5
27775,정도까지/Foreign,2,1,1,1.1115310228308472e-05,1.1106915165381966e-05,0.5
27776,몰랏다/Noun,2,1,1,1.1115310228308472e-05,1.1106915165381966e-05,0.5
27777,이산화탄소/Noun,2,1,1,1.1115310228308472e-05,1.1106915165381966e-05,0.5
27778,허언증/Noun,2,1,1,1.1115310228308472e-05,1.1106915165381966e-05,0.5
27779,1941년/Number,2,1,1,1.1115310228308472e-05,1.1106915165381966e-05,0.5
27780,영화/Foreign,2,1,1,1.1115310228308472e-05,1.1106915165381966e-05,0.5
27781,guns/Alpha,2,1,1,1.1115310228308472e-05,1.1106915165381966e-05,0.5
27782,폴버호벤/Noun,2,1,1,1.1115310228308472e-05,1.1106915165381966e-05,0.5
27783,왕식/Noun,2,1,1,1.1115310228308472e-05,1.1106915165381966e-05,0.5
27784,안량/Noun,2,1,1,1.1115310228308472e-05,1.1106915165381966e-05,0.5
27785,??'/Punctuation,2,1,1,1.1115310228308472e-05,1.1106915165381966e-05,0.5
27786,서쪽하늘/Noun,2,1,1,1.1115310228308472e-05,1.1106915165381966e-05,0.5
27787,곽진/Noun,2,1,1,1.1115310228308472e-05,1.1106915165381966e-05,0.5
27788,강승윤/Noun,2,1,1,1.1115310228308472e-05,1.1106915165381966e-05,0.5
27789,",,,,?/Punctuation",2,1,1,1.1115310228308472e-05,1.1106915165381966e-05,0.5
27790,김종욱/Noun,2,1,1,1.1115310228308472e-05,1.1106915165381966e-05,0.5
27791,교제/Noun,2,1,1,1.1115310228308472e-05,1.1106915165381966e-05,0.5
27792,명석하다/Adjective,2,1,1,1.1115310228308472e-05,1.1106915165381966e-05,0.5
27793,하숙집/Noun,2,1,1,1.1115310228308472e-05,1.1106915165381966e-05,0.5
27794,우등/Noun,2,1,1,1.1115310228308472e-05,1.1106915165381966e-05,0.5
27795,도그/Noun,2,1,1,1.1115310228308472e-05,1.1106915165381966e-05,0.5
27796,데몰리션맨/Noun,2,1,1,1.1115310228308472e-05,1.1106915165381966e-05,0.5
27797,New/Alpha,2,1,1,1.1115310228308472e-05,1.1106915165381966e-05,0.5
27798,철밥통/Noun,2,1,1,1.1115310228308472e-05,1.1106915165381966e-05,0.5
27799,ㅋㅌㅋ/KoreanParticle,2,1,1,1.1115310228308472e-05,1.1106915165381966e-05,0.5
27800,부화/Noun,2,1,1,1.1115310228308472e-05,1.1106915165381966e-05,0.5
27801,로서나/Josa,2,1,1,1.1115310228308472e-05,1.1106915165381966e-05,0.5
27802,금새/Modifier,2,1,1,1.1115310228308472e-05,1.1106915165381966e-05,0.5
27803,130분/Number,2,1,1,1.1115310228308472e-05,1.1106915165381966e-05,0.5
27804,치와와/Noun,2,1,1,1.1115310228308472e-05,1.1106915165381966e-05,0.5
27805,ㅎㅋㅋㅋ/KoreanParticle,2,1,1,1.1115310228308472e-05,1.1106915165381966e-05,0.5
27806,김장훈/Noun,2,1,1,1.1115310228308472e-05,1.1106915165381966e-05,0.5
27807,비담/Noun,2,1,1,1.1115310228308472e-05,1.1106915165381966e-05,0.5
27808,우미/Noun,2,1,1,1.1115310228308472e-05,1.1106915165381966e-05,0.5
27809,신정원/Noun,2,1,1,1.1115310228308472e-05,1.1106915165381966e-05,0.5
27810,사전투표/Noun,2,1,1,1.1115310228308472e-05,1.1106915165381966e-05,0.5
27811,하기야/Adverb,2,1,1,1.1115310228308472e-05,1.1106915165381966e-05,0.5
27812,스탠드/Noun,2,1,1,1.1115310228308472e-05,1.1106915165381966e-05,0.5
27813,CS/Alpha,2,1,1,1.1115310228308472e-05,1.1106915165381966e-05,0.5
27814,ㅏㅏㅏ/KoreanParticle,2,1,1,1.1115310228308472e-05,1.1106915165381966e-05,0.5
27815,"...,!/Punctuation",2,1,1,1.1115310228308472e-05,1.1106915165381966e-05,0.5
27816,지브리스튜디오/Noun,2,1,1,1.1115310228308472e-05,1.1106915165381966e-05,0.5
27817,승범/Noun,2,1,1,1.1115310228308472e-05,1.1106915165381966e-05,0.5
27818,롤리/Noun,2,1,1,1.1115310228308472e-05,1.1106915165381966e-05,0.5
27819,팔다리/Noun,2,1,1,1.1115310228308472e-05,1.1106915165381966e-05,0.5
27820,art/Alpha,2,1,1,1.1115310228308472e-05,1.1106915165381966e-05,0.5
27821,정도의/Foreign,2,1,1,1.1115310228308472e-05,1.1106915165381966e-05,0.5
27822,질타/Noun,2,1,1,1.1115310228308472e-05,1.1106915165381966e-05,0.5
27823,줠/Noun,2,1,1,1.1115310228308472e-05,1.1106915165381966e-05,0.5
27824,종적/Noun,2,1,1,1.1115310228308472e-05,1.1106915165381966e-05,0.5
27825,어버/Noun,2,1,1,1.1115310228308472e-05,1.1106915165381966e-05,0.5
27826,몽정/Noun,2,1,1,1.1115310228308472e-05,1.1106915165381966e-05,0.5
27827,빅피쉬/Noun,2,1,1,1.1115310228308472e-05,1.1106915165381966e-05,0.5
27828,참뜻/Noun,2,1,1,1.1115310228308472e-05,1.1106915165381966e-05,0.5
27829,안재환/Noun,2,1,1,1.1115310228308472e-05,1.1106915165381966e-05,0.5
27830,반나절/Noun,2,1,1,1.1115310228308472e-05,1.1106915165381966e-05,0.5
27831,씻기다/Verb,2,1,1,1.1115310228308472e-05,1.1106915165381966e-05,0.5
27832,힐난/Noun,2,1,1,1.1115310228308472e-05,1.1106915165381966e-05,0.5
27833,관할/Noun,2,1,1,1.1115310228308472e-05,1.1106915165381966e-05,0.5
27834,스틸러/Noun,2,1,1,1.1115310228308472e-05,1.1106915165381966e-05,0.5
27835,우레/Noun,2,1,1,1.1115310228308472e-05,1.1106915165381966e-05,0.5
27836,헝그리/Noun,2,1,1,1.1115310228308472e-05,1.1106915165381966e-05,0.5
27837,부글/Noun,2,1,1,1.1115310228308472e-05,1.1106915165381966e-05,0.5
27838,비룡/Noun,2,1,1,1.1115310228308472e-05,1.1106915165381966e-05,0.5
27839,인테리어/Noun,2,1,1,1.1115310228308472e-05,1.1106915165381966e-05,0.5
27840,림프비즈킷/Noun,2,1,1,1.1115310228308472e-05,1.1106915165381966e-05,0.5
27841,왕지혜/Noun,2,1,1,1.1115310228308472e-05,1.1106915165381966e-05,0.5
27842,본시/Noun,2,1,1,1.1115310228308472e-05,1.1106915165381966e-05,0.5
27843,어렴풋/Noun,2,1,1,1.1115310228308472e-05,1.1106915165381966e-05,0.5
27844,흑전사/Noun,2,1,1,1.1115310228308472e-05,1.1106915165381966e-05,0.5
27845,마님/Noun,2,1,1,1.1115310228308472e-05,1.1106915165381966e-05,0.5
27846,단돈/Noun,2,1,1,1.1115310228308472e-05,1.1106915165381966e-05,0.5
27847,머좀/Noun,2,1,1,1.1115310228308472e-05,1.1106915165381966e-05,0.5
27848,변천사/Noun,2,1,1,1.1115310228308472e-05,1.1106915165381966e-05,0.5
27849,에소/Noun,2,1,1,1.1115310228308472e-05,1.1106915165381966e-05,0.5
27850,어렴풋하다/Adjective,2,1,1,1.1115310228308472e-05,1.1106915165381966e-05,0.5
27851,사또/Noun,2,1,1,1.1115310228308472e-05,1.1106915165381966e-05,0.5
27852,원씨/Noun,2,1,1,1.1115310228308472e-05,1.1106915165381966e-05,0.5
27853,비방/Noun,2,1,1,1.1115310228308472e-05,1.1106915165381966e-05,0.5
27854,같넹/Noun,2,1,1,1.1115310228308472e-05,1.1106915165381966e-05,0.5
27855,서정시/Noun,2,1,1,1.1115310228308472e-05,1.1106915165381966e-05,0.5
27856,앞바다/Noun,2,1,1,1.1115310228308472e-05,1.1106915165381966e-05,0.5
27857,을기/Noun,2,1,1,1.1115310228308472e-05,1.1106915165381966e-05,0.5
27858,200만/Number,2,1,1,1.1115310228308472e-05,1.1106915165381966e-05,0.5
27859,경찰특공대/Noun,2,1,1,1.1115310228308472e-05,1.1106915165381966e-05,0.5
27860,카운트다운/Noun,2,1,1,1.1115310228308472e-05,1.1106915165381966e-05,0.5
27861,졸렵/Noun,2,1,1,1.1115310228308472e-05,1.1106915165381966e-05,0.5
27862,어두운곳/Noun,2,1,1,1.1115310228308472e-05,1.1106915165381966e-05,0.5
27863,눈팅/Noun,2,1,1,1.1115310228308472e-05,1.1106915165381966e-05,0.5
27864,이었음/Foreign,2,1,1,1.1115310228308472e-05,1.1106915165381966e-05,0.5
27865,이수만/Noun,2,1,1,1.1115310228308472e-05,1.1106915165381966e-05,0.5
27866,연합군/Noun,2,1,1,1.1115310228308472e-05,1.1106915165381966e-05,0.5
27867,뉴스룸/Noun,2,1,1,1.1115310228308472e-05,1.1106915165381966e-05,0.5
27868,무릇/Noun,2,1,1,1.1115310228308472e-05,1.1106915165381966e-05,0.5
27869,종인/Noun,2,1,1,1.1115310228308472e-05,1.1106915165381966e-05,0.5
27870,성안/Noun,2,1,1,1.1115310228308472e-05,1.1106915165381966e-05,0.5
27871,싼값/Noun,2,1,1,1.1115310228308472e-05,1.1106915165381966e-05,0.5
27872,빗다/Verb,2,1,1,1.1115310228308472e-05,1.1106915165381966e-05,0.5
27873,게실/Noun,2,1,1,1.1115310228308472e-05,1.1106915165381966e-05,0.5
27874,박봄/Noun,2,1,1,1.1115310228308472e-05,1.1106915165381966e-05,0.5
27875,나치스/Noun,2,1,1,1.1115310228308472e-05,1.1106915165381966e-05,0.5
27876,엮지마/Noun,2,1,1,1.1115310228308472e-05,1.1106915165381966e-05,0.5
27877,교토/Noun,2,1,1,1.1115310228308472e-05,1.1106915165381966e-05,0.5
27878,오셀로/Noun,2,1,1,1.1115310228308472e-05,1.1106915165381966e-05,0.5
27879,피콜로/Noun,2,1,1,1.1115310228308472e-05,1.1106915165381966e-05,0.5
27880,23일/Number,2,1,1,1.1115310228308472e-05,1.1106915165381966e-05,0.5
27881,배임죄/Noun,2,1,1,1.1115310228308472e-05,1.1106915165381966e-05,0.5
27882,화정/Noun,2,1,1,1.1115310228308472e-05,1.1106915165381966e-05,0.5
27883,디브디/Noun,2,1,1,1.1115310228308472e-05,1.1106915165381966e-05,0.5
27884,...~~/Punctuation,2,1,1,1.1115310228308472e-05,1.1106915165381966e-05,0.5
27885,퍼플/Noun,2,1,1,1.1115310228308472e-05,1.1106915165381966e-05,0.5
27886,키드캅/Noun,2,1,1,1.1115310228308472e-05,1.1106915165381966e-05,0.5
27887,외인부대/Noun,2,1,1,1.1115310228308472e-05,1.1106915165381966e-05,0.5
27888,샬토/Noun,2,1,1,1.1115310228308472e-05,1.1106915165381966e-05,0.5
27889,배갈/Noun,2,1,1,1.1115310228308472e-05,1.1106915165381966e-05,0.5
27890,안마방/Noun,2,1,1,1.1115310228308472e-05,1.1106915165381966e-05,0.5
27891,욷/Noun,2,1,1,1.1115310228308472e-05,1.1106915165381966e-05,0.5
27892,1/100/Number,2,1,1,1.1115310228308472e-05,1.1106915165381966e-05,0.5
27893,said/Alpha,2,1,1,1.1115310228308472e-05,1.1106915165381966e-05,0.5
27894,he/Alpha,2,1,1,1.1115310228308472e-05,1.1106915165381966e-05,0.5
27895,대론/Noun,2,1,1,1.1115310228308472e-05,1.1106915165381966e-05,0.5
27896,알렉/Noun,2,1,1,1.1115310228308472e-05,1.1106915165381966e-05,0.5
27897,빠가사리/Noun,2,1,1,1.1115310228308472e-05,1.1106915165381966e-05,0.5
27898,ㅊㅋㅊㅋ/KoreanParticle,2,1,1,1.1115310228308472e-05,1.1106915165381966e-05,0.5
27899,박은수/Noun,2,1,1,1.1115310228308472e-05,1.1106915165381966e-05,0.5
27900,실크로드/Noun,2,1,1,1.1115310228308472e-05,1.1106915165381966e-05,0.5
27901,출감/Noun,2,1,1,1.1115310228308472e-05,1.1106915165381966e-05,0.5
27902,1966년/Number,2,1,1,1.1115310228308472e-05,1.1106915165381966e-05,0.5
27903,티란/Noun,2,1,1,1.1115310228308472e-05,1.1106915165381966e-05,0.5
27904,살빼다/Adjective,2,1,1,1.1115310228308472e-05,1.1106915165381966e-05,0.5
27905,날기/Noun,2,1,1,1.1115310228308472e-05,1.1106915165381966e-05,0.5
27906,장날/Noun,2,1,1,1.1115310228308472e-05,1.1106915165381966e-05,0.5
27907,옥빈/Noun,2,1,1,1.1115310228308472e-05,1.1106915165381966e-05,0.5
27908,분/Foreign,2,1,1,1.1115310228308472e-05,1.1106915165381966e-05,0.5
27909,?????????????????/Punctuation,2,1,1,1.1115310228308472e-05,1.1106915165381966e-05,0.5
27910,美/Foreign,2,1,1,1.1115310228308472e-05,1.1106915165381966e-05,0.5
27911,자타공인/Noun,2,1,1,1.1115310228308472e-05,1.1106915165381966e-05,0.5
27912,음대/Noun,2,1,1,1.1115310228308472e-05,1.1106915165381966e-05,0.5
27913,박정/Noun,2,1,1,1.1115310228308472e-05,1.1106915165381966e-05,0.5
27914,알제/Noun,2,1,1,1.1115310228308472e-05,1.1106915165381966e-05,0.5
27915,부대끼다/Verb,2,1,1,1.1115310228308472e-05,1.1106915165381966e-05,0.5
27916,리/Foreign,2,1,1,1.1115310228308472e-05,1.1106915165381966e-05,0.5
27917,한양/Noun,2,1,1,1.1115310228308472e-05,1.1106915165381966e-05,0.5
27918,복도씬/Noun,2,1,1,1.1115310228308472e-05,1.1106915165381966e-05,0.5
27919,절임/Noun,2,1,1,1.1115310228308472e-05,1.1106915165381966e-05,0.5
27920,뉴논스톱/Noun,2,1,1,1.1115310228308472e-05,1.1106915165381966e-05,0.5
27921,폐소공포증/Noun,2,1,1,1.1115310228308472e-05,1.1106915165381966e-05,0.5
27922,가계/Noun,2,1,1,1.1115310228308472e-05,1.1106915165381966e-05,0.5
27923,fantastic/Alpha,2,1,1,1.1115310228308472e-05,1.1106915165381966e-05,0.5
27924,쉐어/Noun,2,1,1,1.1115310228308472e-05,1.1106915165381966e-05,0.5
27925,비너스/Noun,2,1,1,1.1115310228308472e-05,1.1106915165381966e-05,0.5
27926,식은땀/Noun,2,1,1,1.1115310228308472e-05,1.1106915165381966e-05,0.5
27927,서너/Noun,2,1,1,1.1115310228308472e-05,1.1106915165381966e-05,0.5
27928,YO/Alpha,2,1,1,1.1115310228308472e-05,1.1106915165381966e-05,0.5
27929,산소/Noun,2,1,1,1.1115310228308472e-05,1.1106915165381966e-05,0.5
27930,바스라지다/Verb,2,1,1,1.1115310228308472e-05,1.1106915165381966e-05,0.5
27931,자두/Noun,2,1,1,1.1115310228308472e-05,1.1106915165381966e-05,0.5
27932,저림/Noun,2,1,1,1.1115310228308472e-05,1.1106915165381966e-05,0.5
27933,스폐셜/Noun,2,1,1,1.1115310228308472e-05,1.1106915165381966e-05,0.5
27934,뽀록/Noun,2,1,1,1.1115310228308472e-05,1.1106915165381966e-05,0.5
27935,므흣하/Noun,2,1,1,1.1115310228308472e-05,1.1106915165381966e-05,0.5
27936,탄복/Noun,2,1,1,1.1115310228308472e-05,1.1106915165381966e-05,0.5
27937,아리까리하다/Adjective,2,1,1,1.1115310228308472e-05,1.1106915165381966e-05,0.5
27938,체르노빌/Noun,2,1,1,1.1115310228308472e-05,1.1106915165381966e-05,0.5
27939,디키/Noun,2,1,1,1.1115310228308472e-05,1.1106915165381966e-05,0.5
27940,삼바/Noun,2,1,1,1.1115310228308472e-05,1.1106915165381966e-05,0.5
27941,하루아침/Noun,2,1,1,1.1115310228308472e-05,1.1106915165381966e-05,0.5
27942,가뿐하다/Adjective,2,1,1,1.1115310228308472e-05,1.1106915165381966e-05,0.5
27943,빈골/Noun,2,1,1,1.1115310228308472e-05,1.1106915165381966e-05,0.5
27944,승부사/Noun,2,1,1,1.1115310228308472e-05,1.1106915165381966e-05,0.5
27945,널렸음/Noun,2,1,1,1.1115310228308472e-05,1.1106915165381966e-05,0.5
27946,바이올리니스트/Noun,2,1,1,1.1115310228308472e-05,1.1106915165381966e-05,0.5
27947,귓속/Noun,2,1,1,1.1115310228308472e-05,1.1106915165381966e-05,0.5
27948,믹서기/Noun,2,1,1,1.1115310228308472e-05,1.1106915165381966e-05,0.5
27949,이슬람교/Noun,2,1,1,1.1115310228308472e-05,1.1106915165381966e-05,0.5
27950,록커/Noun,2,1,1,1.1115310228308472e-05,1.1106915165381966e-05,0.5
27951,실낱/Noun,2,1,1,1.1115310228308472e-05,1.1106915165381966e-05,0.5
27952,용케/Noun,2,1,1,1.1115310228308472e-05,1.1106915165381966e-05,0.5
27953,노어이/Noun,2,1,1,1.1115310228308472e-05,1.1106915165381966e-05,0.5
27954,한낱/Modifier,2,1,1,1.1115310228308472e-05,1.1106915165381966e-05,0.5
27955,후라이드/Noun,2,1,1,1.1115310228308472e-05,1.1106915165381966e-05,0.5
27956,사슴벌레/Noun,2,1,1,1.1115310228308472e-05,1.1106915165381966e-05,0.5
27957,곱하기/Noun,2,1,1,1.1115310228308472e-05,1.1106915165381966e-05,0.5
27958,신칸센/Noun,2,1,1,1.1115310228308472e-05,1.1106915165381966e-05,0.5
27959,불가라/Noun,2,1,1,1.1115310228308472e-05,1.1106915165381966e-05,0.5
27960,종이컵/Noun,2,1,1,1.1115310228308472e-05,1.1106915165381966e-05,0.5
27961,피플/Noun,2,1,1,1.1115310228308472e-05,1.1106915165381966e-05,0.5
27962,초롱초롱/Noun,2,1,1,1.1115310228308472e-05,1.1106915165381966e-05,0.5
27963,벌렁/Noun,2,1,1,1.1115310228308472e-05,1.1106915165381966e-05,0.5
27964,...--;/Punctuation,2,1,1,1.1115310228308472e-05,1.1106915165381966e-05,0.5
27965,이뻣음/Noun,2,1,1,1.1115310228308472e-05,1.1106915165381966e-05,0.5
27966,미감/Noun,2,1,1,1.1115310228308472e-05,1.1106915165381966e-05,0.5
27967,나머/Noun,2,1,1,1.1115310228308472e-05,1.1106915165381966e-05,0.5
27968,대말/Noun,2,1,1,1.1115310228308472e-05,1.1106915165381966e-05,0.5
27969,똥떵어리/Noun,2,1,1,1.1115310228308472e-05,1.1106915165381966e-05,0.5
27970,ㄷㅅㅌ/KoreanParticle,2,1,1,1.1115310228308472e-05,1.1106915165381966e-05,0.5
27971,주덕/Noun,2,1,1,1.1115310228308472e-05,1.1106915165381966e-05,0.5
27972,학대받다/Verb,2,1,1,1.1115310228308472e-05,1.1106915165381966e-05,0.5
27973,소프/Noun,2,1,1,1.1115310228308472e-05,1.1106915165381966e-05,0.5
27974,경찰청장/Noun,2,1,1,1.1115310228308472e-05,1.1106915165381966e-05,0.5
27975,월량/Noun,2,1,1,1.1115310228308472e-05,1.1106915165381966e-05,0.5
27976,봇/Noun,2,1,1,1.1115310228308472e-05,1.1106915165381966e-05,0.5
27977,이마트/Noun,2,1,1,1.1115310228308472e-05,1.1106915165381966e-05,0.5
27978,차키/Noun,2,1,1,1.1115310228308472e-05,1.1106915165381966e-05,0.5
27979,★★★/Foreign,2,1,1,1.1115310228308472e-05,1.1106915165381966e-05,0.5
27980,이상호/Noun,2,1,1,1.1115310228308472e-05,1.1106915165381966e-05,0.5
27981,공명/Noun,2,1,1,1.1115310228308472e-05,1.1106915165381966e-05,0.5
27982,격의/Noun,2,1,1,1.1115310228308472e-05,1.1106915165381966e-05,0.5
27983,튜/Noun,2,1,1,1.1115310228308472e-05,1.1106915165381966e-05,0.5
27984,셔물/Noun,2,1,1,1.1115310228308472e-05,1.1106915165381966e-05,0.5
27985,도출/Noun,2,1,1,1.1115310228308472e-05,1.1106915165381966e-05,0.5
27986,반주/Noun,2,1,1,1.1115310228308472e-05,1.1106915165381966e-05,0.5
27987,겨자/Noun,2,1,1,1.1115310228308472e-05,1.1106915165381966e-05,0.5
27988,알프스/Noun,2,1,1,1.1115310228308472e-05,1.1106915165381966e-05,0.5
27989,노마/Noun,2,1,1,1.1115310228308472e-05,1.1106915165381966e-05,0.5
27990,필링/Noun,2,1,1,1.1115310228308472e-05,1.1106915165381966e-05,0.5
27991,걸음걸이/Noun,2,1,1,1.1115310228308472e-05,1.1106915165381966e-05,0.5
27992,윤균상/Noun,2,1,1,1.1115310228308472e-05,1.1106915165381966e-05,0.5
27993,크룩/Noun,2,1,1,1.1115310228308472e-05,1.1106915165381966e-05,0.5
27994,11일/Number,2,1,1,1.1115310228308472e-05,1.1106915165381966e-05,0.5
27995,자산/Noun,2,1,1,1.1115310228308472e-05,1.1106915165381966e-05,0.5
27996,손자병법/Noun,2,1,1,1.1115310228308472e-05,1.1106915165381966e-05,0.5
27997,신호등/Noun,2,1,1,1.1115310228308472e-05,1.1106915165381966e-05,0.5
27998,난삽/Noun,2,1,1,1.1115310228308472e-05,1.1106915165381966e-05,0.5
27999,간사하다/Adjective,2,1,1,1.1115310228308472e-05,1.1106915165381966e-05,0.5
28000,3천만/Number,2,1,1,1.1115310228308472e-05,1.1106915165381966e-05,0.5
28001,조운/Noun,2,1,1,1.1115310228308472e-05,1.1106915165381966e-05,0.5
28002,콩밥/Noun,2,1,1,1.1115310228308472e-05,1.1106915165381966e-05,0.5
28003,전이/Foreign,2,1,1,1.1115310228308472e-05,1.1106915165381966e-05,0.5
28004,굽/Noun,2,1,1,1.1115310228308472e-05,1.1106915165381966e-05,0.5
28005,모터사이클/Noun,2,1,1,1.1115310228308472e-05,1.1106915165381966e-05,0.5
28006,式/Foreign,2,1,1,1.1115310228308472e-05,1.1106915165381966e-05,0.5
28007,제물/Noun,2,1,1,1.1115310228308472e-05,1.1106915165381966e-05,0.5
28008,듬직하다/Adjective,2,1,1,1.1115310228308472e-05,1.1106915165381966e-05,0.5
28009,김여진/Noun,2,1,1,1.1115310228308472e-05,1.1106915165381966e-05,0.5
28010,완공/Noun,2,1,1,1.1115310228308472e-05,1.1106915165381966e-05,0.5
28011,순돌이/Noun,2,1,1,1.1115310228308472e-05,1.1106915165381966e-05,0.5
28012,스트로/Noun,2,1,1,1.1115310228308472e-05,1.1106915165381966e-05,0.5
28013,송호/Noun,2,1,1,1.1115310228308472e-05,1.1106915165381966e-05,0.5
28014,깅/Noun,2,1,1,1.1115310228308472e-05,1.1106915165381966e-05,0.5
28015,가사도/Noun,2,1,1,1.1115310228308472e-05,1.1106915165381966e-05,0.5
28016,이를테면/Adverb,2,1,1,1.1115310228308472e-05,1.1106915165381966e-05,0.5
28017,압살/Noun,2,1,1,1.1115310228308472e-05,1.1106915165381966e-05,0.5
28018,개돼지/Noun,2,1,1,1.1115310228308472e-05,1.1106915165381966e-05,0.5
28019,별점/Noun,2,1,1,1.1115310228308472e-05,1.1106915165381966e-05,0.5
28020,편대/Noun,2,1,1,1.1115310228308472e-05,1.1106915165381966e-05,0.5
28021,머함/Noun,2,1,1,1.1115310228308472e-05,1.1106915165381966e-05,0.5
28022,KG/Alpha,2,1,1,1.1115310228308472e-05,1.1106915165381966e-05,0.5
28023,전작품인데/Foreign,2,1,1,1.1115310228308472e-05,1.1106915165381966e-05,0.5
28024,프리즈/Noun,2,1,1,1.1115310228308472e-05,1.1106915165381966e-05,0.5
28025,마개/Noun,2,1,1,1.1115310228308472e-05,1.1106915165381966e-05,0.5
28026,고우리/Noun,2,1,1,1.1115310228308472e-05,1.1106915165381966e-05,0.5
28027,잼있드/Noun,2,1,1,1.1115310228308472e-05,1.1106915165381966e-05,0.5
28028,스탠다드/Noun,2,1,1,1.1115310228308472e-05,1.1106915165381966e-05,0.5
28029,규원/Noun,2,1,1,1.1115310228308472e-05,1.1106915165381966e-05,0.5
28030,비시/Noun,2,1,1,1.1115310228308472e-05,1.1106915165381966e-05,0.5
28031,서거/Noun,2,1,1,1.1115310228308472e-05,1.1106915165381966e-05,0.5
28032,궁굼/Noun,2,1,1,1.1115310228308472e-05,1.1106915165381966e-05,0.5
28033,선진/Noun,2,1,1,1.1115310228308472e-05,1.1106915165381966e-05,0.5
28034,이처/Noun,2,1,1,1.1115310228308472e-05,1.1106915165381966e-05,0.5
28035,가리우다/Verb,2,1,1,1.1115310228308472e-05,1.1106915165381966e-05,0.5
28036,엎치락뒤치락/Noun,2,1,1,1.1115310228308472e-05,1.1106915165381966e-05,0.5
28037,흐트러지/Noun,2,1,1,1.1115310228308472e-05,1.1106915165381966e-05,0.5
28038,도우미/Noun,2,1,1,1.1115310228308472e-05,1.1106915165381966e-05,0.5
28039,부관참시/Noun,2,1,1,1.1115310228308472e-05,1.1106915165381966e-05,0.5
28040,도스/Noun,2,1,1,1.1115310228308472e-05,1.1106915165381966e-05,0.5
28041,크레/Noun,2,1,1,1.1115310228308472e-05,1.1106915165381966e-05,0.5
28042,틸다스윈튼/Noun,2,1,1,1.1115310228308472e-05,1.1106915165381966e-05,0.5
28043,중령/Noun,2,1,1,1.1115310228308472e-05,1.1106915165381966e-05,0.5
28044,한선화/Noun,2,1,1,1.1115310228308472e-05,1.1106915165381966e-05,0.5
28045,스노우보드/Noun,2,1,1,1.1115310228308472e-05,1.1106915165381966e-05,0.5
28046,콜롬비아/Noun,2,1,1,1.1115310228308472e-05,1.1106915165381966e-05,0.5
28047,네이마르/Noun,2,1,1,1.1115310228308472e-05,1.1106915165381966e-05,0.5
28048,책방/Noun,2,1,1,1.1115310228308472e-05,1.1106915165381966e-05,0.5
28049,거제/Noun,2,1,1,1.1115310228308472e-05,1.1106915165381966e-05,0.5
28050,압사/Noun,2,1,1,1.1115310228308472e-05,1.1106915165381966e-05,0.5
28051,귀걸이/Noun,2,1,1,1.1115310228308472e-05,1.1106915165381966e-05,0.5
28052,코걸이/Noun,2,1,1,1.1115310228308472e-05,1.1106915165381966e-05,0.5
28053,군침/Noun,2,1,1,1.1115310228308472e-05,1.1106915165381966e-05,0.5
28054,분안/Noun,2,1,1,1.1115310228308472e-05,1.1106915165381966e-05,0.5
28055,포비아/Noun,2,1,1,1.1115310228308472e-05,1.1106915165381966e-05,0.5
28056,7-8/Number,2,1,1,1.1115310228308472e-05,1.1106915165381966e-05,0.5
28057,모바일/Noun,2,1,1,1.1115310228308472e-05,1.1106915165381966e-05,0.5
28058,제나라/Noun,2,1,1,1.1115310228308472e-05,1.1106915165381966e-05,0.5
28059,격투게임/Noun,2,1,1,1.1115310228308472e-05,1.1106915165381966e-05,0.5
28060,장기기증/Noun,2,1,1,1.1115310228308472e-05,1.1106915165381966e-05,0.5
28061,깉/Noun,2,1,1,1.1115310228308472e-05,1.1106915165381966e-05,0.5
28062,케함/Noun,2,1,1,1.1115310228308472e-05,1.1106915165381966e-05,0.5
28063,태양빛/Noun,2,1,1,1.1115310228308472e-05,1.1106915165381966e-05,0.5
28064,한씬/Noun,2,1,1,1.1115310228308472e-05,1.1106915165381966e-05,0.5
28065,다봣어/Noun,2,1,1,1.1115310228308472e-05,1.1106915165381966e-05,0.5
28066,눈속/Noun,2,1,1,1.1115310228308472e-05,1.1106915165381966e-05,0.5
28067,가후/Noun,2,1,1,1.1115310228308472e-05,1.1106915165381966e-05,0.5
28068,소군/Noun,2,1,1,1.1115310228308472e-05,1.1106915165381966e-05,0.5
28069,이력서/Noun,2,1,1,1.1115310228308472e-05,1.1106915165381966e-05,0.5
28070,수기/Noun,2,1,1,1.1115310228308472e-05,1.1106915165381966e-05,0.5
28071,노랫말/Noun,2,1,1,1.1115310228308472e-05,1.1106915165381966e-05,0.5
28072,괜찮드/Noun,2,1,1,1.1115310228308472e-05,1.1106915165381966e-05,0.5
28073,청안/Noun,2,1,1,1.1115310228308472e-05,1.1106915165381966e-05,0.5
28074,many/Alpha,2,1,1,1.1115310228308472e-05,1.1106915165381966e-05,0.5
28075,적정하다/Adjective,2,1,1,1.1115310228308472e-05,1.1106915165381966e-05,0.5
28076,밀림/Noun,2,1,1,1.1115310228308472e-05,1.1106915165381966e-05,0.5
28077,면전/Noun,2,1,1,1.1115310228308472e-05,1.1106915165381966e-05,0.5
28078,Soul/Alpha,2,1,1,1.1115310228308472e-05,1.1106915165381966e-05,0.5
28079,태운/Noun,2,1,1,1.1115310228308472e-05,1.1106915165381966e-05,0.5
28080,세스코/Noun,2,1,1,1.1115310228308472e-05,1.1106915165381966e-05,0.5
28081,10101010101010/Number,2,1,1,1.1115310228308472e-05,1.1106915165381966e-05,0.5
28082,^^~~/Punctuation,2,1,1,1.1115310228308472e-05,1.1106915165381966e-05,0.5
28083,산장/Noun,2,1,1,1.1115310228308472e-05,1.1106915165381966e-05,0.5
28084,라고만/Eomi,2,1,1,1.1115310228308472e-05,1.1106915165381966e-05,0.5
28085,메달/Noun,2,1,1,1.1115310228308472e-05,1.1106915165381966e-05,0.5
28086,왕보/Noun,2,1,1,1.1115310228308472e-05,1.1106915165381966e-05,0.5
28087,결리다/Verb,2,1,1,1.1115310228308472e-05,1.1106915165381966e-05,0.5
28088,목적지/Noun,2,1,1,1.1115310228308472e-05,1.1106915165381966e-05,0.5
28089,향옥/Noun,2,1,1,1.1115310228308472e-05,1.1106915165381966e-05,0.5
28090,여장부/Noun,2,1,1,1.1115310228308472e-05,1.1106915165381966e-05,0.5
28091,허관걸/Noun,2,1,1,1.1115310228308472e-05,1.1106915165381966e-05,0.5
28092,거애/Noun,2,1,1,1.1115310228308472e-05,1.1106915165381966e-05,0.5
28093,밤길/Noun,2,1,1,1.1115310228308472e-05,1.1106915165381966e-05,0.5
28094,정재/Noun,2,1,1,1.1115310228308472e-05,1.1106915165381966e-05,0.5
28095,심각해지다/Verb,2,1,1,1.1115310228308472e-05,1.1106915165381966e-05,0.5
28096,ㅏㅅ/KoreanParticle,2,1,1,1.1115310228308472e-05,1.1106915165381966e-05,0.5
28097,불길/Noun,2,1,1,1.1115310228308472e-05,1.1106915165381966e-05,0.5
28098,우박/Noun,2,1,1,1.1115310228308472e-05,1.1106915165381966e-05,0.5
28099,목꺽/Noun,2,1,1,1.1115310228308472e-05,1.1106915165381966e-05,0.5
28100,팔구/Modifier,2,1,1,1.1115310228308472e-05,1.1106915165381966e-05,0.5
28101,칭한다/Noun,2,1,1,1.1115310228308472e-05,1.1106915165381966e-05,0.5
28102,읅/Noun,2,1,1,1.1115310228308472e-05,1.1106915165381966e-05,0.5
28103,걸프전/Noun,2,1,1,1.1115310228308472e-05,1.1106915165381966e-05,0.5
28104,선물옵션/Noun,2,1,1,1.1115310228308472e-05,1.1106915165381966e-05,0.5
28105,오큘러스/Noun,2,1,1,1.1115310228308472e-05,1.1106915165381966e-05,0.5
28106,드앤딩/Noun,2,1,1,1.1115310228308472e-05,1.1106915165381966e-05,0.5
28107,서머/Noun,2,1,1,1.1115310228308472e-05,1.1106915165381966e-05,0.5
28108,명징/Noun,2,1,1,1.1115310228308472e-05,1.1106915165381966e-05,0.5
28109,후라이팬/Noun,2,1,1,1.1115310228308472e-05,1.1106915165381966e-05,0.5
28110,쉘위댄스/Noun,2,1,1,1.1115310228308472e-05,1.1106915165381966e-05,0.5
28111,중심부/Noun,2,1,1,1.1115310228308472e-05,1.1106915165381966e-05,0.5
28112,이방/Noun,2,1,1,1.1115310228308472e-05,1.1106915165381966e-05,0.5
28113,연고/Noun,2,1,1,1.1115310228308472e-05,1.1106915165381966e-05,0.5
28114,사일/Noun,2,1,1,1.1115310228308472e-05,1.1106915165381966e-05,0.5
28115,56회/Number,2,1,1,1.1115310228308472e-05,1.1106915165381966e-05,0.5
28116,방자전/Noun,2,1,1,1.1115310228308472e-05,1.1106915165381966e-05,0.5
28117,촌놈/Noun,2,1,1,1.1115310228308472e-05,1.1106915165381966e-05,0.5
28118,VJ/Alpha,2,1,1,1.1115310228308472e-05,1.1106915165381966e-05,0.5
28119,공헌/Noun,2,1,1,1.1115310228308472e-05,1.1106915165381966e-05,0.5
28120,동강/Noun,2,1,1,1.1115310228308472e-05,1.1106915165381966e-05,0.5
28121,물대포/Noun,2,1,1,1.1115310228308472e-05,1.1106915165381966e-05,0.5
28122,이머꼬/Noun,2,1,1,1.1115310228308472e-05,1.1106915165381966e-05,0.5
28123,보구/Foreign,2,1,1,1.1115310228308472e-05,1.1106915165381966e-05,0.5
28124,겔/Noun,2,1,1,1.1115310228308472e-05,1.1106915165381966e-05,0.5
28125,웃겻어/Noun,2,1,1,1.1115310228308472e-05,1.1106915165381966e-05,0.5
28126,서어/Noun,2,1,1,1.1115310228308472e-05,1.1106915165381966e-05,0.5
28127,러브러브/Noun,2,1,1,1.1115310228308472e-05,1.1106915165381966e-05,0.5
28128,머릿수/Noun,2,1,1,1.1115310228308472e-05,1.1106915165381966e-05,0.5
28129,박그리나/Noun,2,1,1,1.1115310228308472e-05,1.1106915165381966e-05,0.5
28130,책장/Noun,2,1,1,1.1115310228308472e-05,1.1106915165381966e-05,0.5
28131,디지털로/Noun,2,1,1,1.1115310228308472e-05,1.1106915165381966e-05,0.5
28132,국서/Noun,2,1,1,1.1115310228308472e-05,1.1106915165381966e-05,0.5
28133,강행/Noun,2,1,1,1.1115310228308472e-05,1.1106915165381966e-05,0.5
28134,건일/Noun,2,1,1,1.1115310228308472e-05,1.1106915165381966e-05,0.5
28135,ㅛㄹ/KoreanParticle,2,1,1,1.1115310228308472e-05,1.1106915165381966e-05,0.5
28136,은채/Noun,2,1,1,1.1115310228308472e-05,1.1106915165381966e-05,0.5
28137,노쇠하다/Adjective,2,1,1,1.1115310228308472e-05,1.1106915165381966e-05,0.5
28138,리크/Noun,2,1,1,1.1115310228308472e-05,1.1106915165381966e-05,0.5
28139,이채/Noun,2,1,1,1.1115310228308472e-05,1.1106915165381966e-05,0.5
28140,2046/Number,2,1,1,1.1115310228308472e-05,1.1106915165381966e-05,0.5
28141,재작년/Noun,2,1,1,1.1115310228308472e-05,1.1106915165381966e-05,0.5
28142,조성은/Noun,2,1,1,1.1115310228308472e-05,1.1106915165381966e-05,0.5
28143,존큐/Noun,2,1,1,1.1115310228308472e-05,1.1106915165381966e-05,0.5
28144,리제/Noun,2,1,1,1.1115310228308472e-05,1.1106915165381966e-05,0.5
28145,부일/Noun,2,1,1,1.1115310228308472e-05,1.1106915165381966e-05,0.5
28146,메트로폴리스/Noun,2,1,1,1.1115310228308472e-05,1.1106915165381966e-05,0.5
28147,피크/Noun,2,1,1,1.1115310228308472e-05,1.1106915165381966e-05,0.5
28148,새색시/Noun,2,1,1,1.1115310228308472e-05,1.1106915165381966e-05,0.5
28149,셜리/Noun,2,1,1,1.1115310228308472e-05,1.1106915165381966e-05,0.5
28150,임연/Noun,2,1,1,1.1115310228308472e-05,1.1106915165381966e-05,0.5
28151,김학철/Noun,2,1,1,1.1115310228308472e-05,1.1106915165381966e-05,0.5
28152,22일/Number,2,1,1,1.1115310228308472e-05,1.1106915165381966e-05,0.5
28153,법첩/Noun,2,1,1,1.1115310228308472e-05,1.1106915165381966e-05,0.5
28154,1996/Number,2,1,1,1.1115310228308472e-05,1.1106915165381966e-05,0.5
28155,영화마니아/Noun,2,1,1,1.1115310228308472e-05,1.1106915165381966e-05,0.5
28156,팩션/Noun,2,1,1,1.1115310228308472e-05,1.1106915165381966e-05,0.5
28157,도면/Foreign,2,1,1,1.1115310228308472e-05,1.1106915165381966e-05,0.5
28158,성모/Noun,2,1,1,1.1115310228308472e-05,1.1106915165381966e-05,0.5
28159,죽엇어/Noun,2,1,1,1.1115310228308472e-05,1.1106915165381966e-05,0.5
28160,개박/Noun,2,1,1,1.1115310228308472e-05,1.1106915165381966e-05,0.5
28161,벚/Noun,2,1,1,1.1115310228308472e-05,1.1106915165381966e-05,0.5
28162,앰/Noun,2,1,1,1.1115310228308472e-05,1.1106915165381966e-05,0.5
28163,사칭/Noun,2,1,1,1.1115310228308472e-05,1.1106915165381966e-05,0.5
28164,평수/Noun,2,1,1,1.1115310228308472e-05,1.1106915165381966e-05,0.5
28165,캅스/Noun,2,1,1,1.1115310228308472e-05,1.1106915165381966e-05,0.5
28166,하남/Noun,2,1,1,1.1115310228308472e-05,1.1106915165381966e-05,0.5
28167,장마철/Noun,2,1,1,1.1115310228308472e-05,1.1106915165381966e-05,0.5
28168,세컨/Noun,2,1,1,1.1115310228308472e-05,1.1106915165381966e-05,0.5
28169,도날드/Noun,2,1,1,1.1115310228308472e-05,1.1106915165381966e-05,0.5
28170,boy/Alpha,2,1,1,1.1115310228308472e-05,1.1106915165381966e-05,0.5
28171,cute/Alpha,2,1,1,1.1115310228308472e-05,1.1106915165381966e-05,0.5
28172,불굴/Noun,2,1,1,1.1115310228308472e-05,1.1106915165381966e-05,0.5
28173,올스타/Noun,2,1,1,1.1115310228308472e-05,1.1106915165381966e-05,0.5
28174,있엇구/Noun,2,1,1,1.1115310228308472e-05,1.1106915165381966e-05,0.5
28175,순교/Noun,2,1,1,1.1115310228308472e-05,1.1106915165381966e-05,0.5
28176,훤히보/Noun,2,1,1,1.1115310228308472e-05,1.1106915165381966e-05,0.5
28177,따따/Noun,2,1,1,1.1115310228308472e-05,1.1106915165381966e-05,0.5
28178,토마/Noun,2,1,1,1.1115310228308472e-05,1.1106915165381966e-05,0.5
28179,유신정권/Noun,2,1,1,1.1115310228308472e-05,1.1106915165381966e-05,0.5
28180,성인식/Noun,2,1,1,1.1115310228308472e-05,1.1106915165381966e-05,0.5
28181,조인/Noun,2,1,1,1.1115310228308472e-05,1.1106915165381966e-05,0.5
28182,토우/Noun,2,1,1,1.1115310228308472e-05,1.1106915165381966e-05,0.5
28183,린스/Noun,2,1,1,1.1115310228308472e-05,1.1106915165381966e-05,0.5
28184,기에/Eomi,2,1,1,1.1115310228308472e-05,1.1106915165381966e-05,0.5
28185,1-3/Number,2,1,1,1.1115310228308472e-05,1.1106915165381966e-05,0.5
28186,도공/Noun,2,1,1,1.1115310228308472e-05,1.1106915165381966e-05,0.5
28187,애용/Noun,2,1,1,1.1115310228308472e-05,1.1106915165381966e-05,0.5
28188,사미/Noun,2,1,1,1.1115310228308472e-05,1.1106915165381966e-05,0.5
28189,경민이/Noun,2,1,1,1.1115310228308472e-05,1.1106915165381966e-05,0.5
28190,자축/Noun,2,1,1,1.1115310228308472e-05,1.1106915165381966e-05,0.5
28191,조물주/Noun,2,1,1,1.1115310228308472e-05,1.1106915165381966e-05,0.5
28192,30~40/Number,2,1,1,1.1115310228308472e-05,1.1106915165381966e-05,0.5
28193,ㄴㅇ/KoreanParticle,2,1,1,1.1115310228308472e-05,1.1106915165381966e-05,0.5
28194,가미카제/Noun,2,1,1,1.1115310228308472e-05,1.1106915165381966e-05,0.5
28195,학교숙제/Noun,2,1,1,1.1115310228308472e-05,1.1106915165381966e-05,0.5
28196,how/Alpha,2,1,1,1.1115310228308472e-05,1.1106915165381966e-05,0.5
28197,캘리/Noun,2,1,1,1.1115310228308472e-05,1.1106915165381966e-05,0.5
28198,후를/Foreign,2,1,1,1.1115310228308472e-05,1.1106915165381966e-05,0.5
28199,안봣으/Noun,2,1,1,1.1115310228308472e-05,1.1106915165381966e-05,0.5
28200,@.@/Punctuation,2,1,1,1.1115310228308472e-05,1.1106915165381966e-05,0.5
28201,물리학자/Noun,2,1,1,1.1115310228308472e-05,1.1106915165381966e-05,0.5
28202,ㅐㄱ/KoreanParticle,2,1,1,1.1115310228308472e-05,1.1106915165381966e-05,0.5
28203,구구단/Noun,2,1,1,1.1115310228308472e-05,1.1106915165381966e-05,0.5
28204,도체/Noun,2,1,1,1.1115310228308472e-05,1.1106915165381966e-05,0.5
28205,어쩧/Noun,2,1,1,1.1115310228308472e-05,1.1106915165381966e-05,0.5
28206,영조/Noun,2,1,1,1.1115310228308472e-05,1.1106915165381966e-05,0.5
28207,알바썻/Noun,2,1,1,1.1115310228308472e-05,1.1106915165381966e-05,0.5
28208,제사/Noun,2,1,1,1.1115310228308472e-05,1.1106915165381966e-05,0.5
28209,세리/Noun,2,1,1,1.1115310228308472e-05,1.1106915165381966e-05,0.5
28210,하편/Noun,2,1,1,1.1115310228308472e-05,1.1106915165381966e-05,0.5
28211,봉변/Noun,2,1,1,1.1115310228308472e-05,1.1106915165381966e-05,0.5
28212,깜직/Noun,2,1,1,1.1115310228308472e-05,1.1106915165381966e-05,0.5
28213,백룡/Noun,2,1,1,1.1115310228308472e-05,1.1106915165381966e-05,0.5
28214,상등/Noun,2,1,1,1.1115310228308472e-05,1.1106915165381966e-05,0.5
28215,히죽/Noun,2,1,1,1.1115310228308472e-05,1.1106915165381966e-05,0.5
28216,양심적병역거부/Noun,2,1,1,1.1115310228308472e-05,1.1106915165381966e-05,0.5
28217,훈이/Noun,2,1,1,1.1115310228308472e-05,1.1106915165381966e-05,0.5
28218,일인칭/Noun,2,1,1,1.1115310228308472e-05,1.1106915165381966e-05,0.5
28219,Red/Alpha,2,1,1,1.1115310228308472e-05,1.1106915165381966e-05,0.5
28220,might/Alpha,2,1,1,1.1115310228308472e-05,1.1106915165381966e-05,0.5
28221,절호/Noun,2,1,1,1.1115310228308472e-05,1.1106915165381966e-05,0.5
28222,/?/?-/Punctuation,2,1,1,1.1115310228308472e-05,1.1106915165381966e-05,0.5
28223,하이랜더/Noun,2,1,1,1.1115310228308472e-05,1.1106915165381966e-05,0.5
28224,도막/Noun,2,1,1,1.1115310228308472e-05,1.1106915165381966e-05,0.5
28225,스승의날/Noun,2,1,1,1.1115310228308472e-05,1.1106915165381966e-05,0.5
28226,법죄/Noun,2,1,1,1.1115310228308472e-05,1.1106915165381966e-05,0.5
28227,컷음/Noun,2,1,1,1.1115310228308472e-05,1.1106915165381966e-05,0.5
28228,람세스/Noun,2,1,1,1.1115310228308472e-05,1.1106915165381966e-05,0.5
28229,모란/Noun,2,1,1,1.1115310228308472e-05,1.1106915165381966e-05,0.5
28230,아음/Noun,2,1,1,1.1115310228308472e-05,1.1106915165381966e-05,0.5
28231,바틀렛/Noun,2,1,1,1.1115310228308472e-05,1.1106915165381966e-05,0.5
28232,뇽/Noun,2,1,1,1.1115310228308472e-05,1.1106915165381966e-05,0.5
28233,백억/Noun,2,1,1,1.1115310228308472e-05,1.1106915165381966e-05,0.5
28234,킥킥/Adverb,2,1,1,1.1115310228308472e-05,1.1106915165381966e-05,0.5
28235,떠내다/Verb,2,1,1,1.1115310228308472e-05,1.1106915165381966e-05,0.5
28236,/.//Punctuation,2,1,1,1.1115310228308472e-05,1.1106915165381966e-05,0.5
28237,일장/Noun,2,1,1,1.1115310228308472e-05,1.1106915165381966e-05,0.5
28238,다단계/Noun,2,1,1,1.1115310228308472e-05,1.1106915165381966e-05,0.5
28239,에반/Noun,2,1,1,1.1115310228308472e-05,1.1106915165381966e-05,0.5
28240,장재/Noun,2,1,1,1.1115310228308472e-05,1.1106915165381966e-05,0.5
28241,담력/Noun,2,1,1,1.1115310228308472e-05,1.1106915165381966e-05,0.5
28242,파파라치/Noun,2,1,1,1.1115310228308472e-05,1.1106915165381966e-05,0.5
28243,콜렉터/Noun,2,1,1,1.1115310228308472e-05,1.1106915165381966e-05,0.5
28244,혼인/Noun,2,1,1,1.1115310228308472e-05,1.1106915165381966e-05,0.5
28245,손때/Noun,2,1,1,1.1115310228308472e-05,1.1106915165381966e-05,0.5
28246,초상화/Noun,2,1,1,1.1115310228308472e-05,1.1106915165381966e-05,0.5
28247,마취약/Noun,2,1,1,1.1115310228308472e-05,1.1106915165381966e-05,0.5
28248,새삼스럽다/Adjective,2,1,1,1.1115310228308472e-05,1.1106915165381966e-05,0.5
28249,아웃레이지/Noun,2,1,1,1.1115310228308472e-05,1.1106915165381966e-05,0.5
28250,매티/Noun,2,1,1,1.1115310228308472e-05,1.1106915165381966e-05,0.5
28251,시급/Noun,2,1,1,1.1115310228308472e-05,1.1106915165381966e-05,0.5
28252,억압받다/Verb,2,1,1,1.1115310228308472e-05,1.1106915165381966e-05,0.5
28253,80-90년/Number,2,1,1,1.1115310228308472e-05,1.1106915165381966e-05,0.5
28254,ㅎㅎㅋ/KoreanParticle,2,1,1,1.1115310228308472e-05,1.1106915165381966e-05,0.5
28255,체라/Noun,2,1,1,1.1115310228308472e-05,1.1106915165381966e-05,0.5
28256,손창민/Noun,2,1,1,1.1115310228308472e-05,1.1106915165381966e-05,0.5
28257,폭정/Noun,2,1,1,1.1115310228308472e-05,1.1106915165381966e-05,0.5
28258,국왕/Noun,2,1,1,1.1115310228308472e-05,1.1106915165381966e-05,0.5
28259,소시지/Noun,2,1,1,1.1115310228308472e-05,1.1106915165381966e-05,0.5
28260,깜방/Noun,2,1,1,1.1115310228308472e-05,1.1106915165381966e-05,0.5
28261,증어/Noun,2,1,1,1.1115310228308472e-05,1.1106915165381966e-05,0.5
28262,김선미/Noun,2,1,1,1.1115310228308472e-05,1.1106915165381966e-05,0.5
28263,손보/Noun,2,1,1,1.1115310228308472e-05,1.1106915165381966e-05,0.5
28264,다솔/Noun,2,1,1,1.1115310228308472e-05,1.1106915165381966e-05,0.5
28265,봣을텐데/Noun,2,1,1,1.1115310228308472e-05,1.1106915165381966e-05,0.5
28266,철거/Noun,2,1,1,1.1115310228308472e-05,1.1106915165381966e-05,0.5
28267,앙이다/Adjective,2,1,1,1.1115310228308472e-05,1.1106915165381966e-05,0.5
28268,델꼬/Noun,2,1,1,1.1115310228308472e-05,1.1106915165381966e-05,0.5
28269,초코렛/Noun,2,1,1,1.1115310228308472e-05,1.1106915165381966e-05,0.5
28270,기웃/Noun,2,1,1,1.1115310228308472e-05,1.1106915165381966e-05,0.5
28271,은인/Noun,2,1,1,1.1115310228308472e-05,1.1106915165381966e-05,0.5
28272,완고하다/Adjective,2,1,1,1.1115310228308472e-05,1.1106915165381966e-05,0.5
28273,??!!!/Punctuation,2,1,1,1.1115310228308472e-05,1.1106915165381966e-05,0.5
28274,개그야/Noun,2,1,1,1.1115310228308472e-05,1.1106915165381966e-05,0.5
28275,외진/Noun,2,1,1,1.1115310228308472e-05,1.1106915165381966e-05,0.5
28276,어퓨굿맨/Noun,2,1,1,1.1115310228308472e-05,1.1106915165381966e-05,0.5
28277,무예/Noun,2,1,1,1.1115310228308472e-05,1.1106915165381966e-05,0.5
28278,순자/Noun,2,1,1,1.1115310228308472e-05,1.1106915165381966e-05,0.5
28279,단일/Noun,2,1,1,1.1115310228308472e-05,1.1106915165381966e-05,0.5
28280,떼이다/Verb,2,1,1,1.1115310228308472e-05,1.1106915165381966e-05,0.5
28281,85/Number,2,1,1,1.1115310228308472e-05,1.1106915165381966e-05,0.5
28282,불끈쥐/Noun,2,1,1,1.1115310228308472e-05,1.1106915165381966e-05,0.5
28283,천추태후/Noun,2,1,1,1.1115310228308472e-05,1.1106915165381966e-05,0.5
28284,」/Foreign,2,1,1,1.1115310228308472e-05,1.1106915165381966e-05,0.5
28285,「/Foreign,2,1,1,1.1115310228308472e-05,1.1106915165381966e-05,0.5
28286,구렁텅이/Noun,2,1,1,1.1115310228308472e-05,1.1106915165381966e-05,0.5
28287,가래/Noun,2,1,1,1.1115310228308472e-05,1.1106915165381966e-05,0.5
28288,은공/Noun,2,1,1,1.1115310228308472e-05,1.1106915165381966e-05,0.5
28289,으로까지/Josa,2,1,1,1.1115310228308472e-05,1.1106915165381966e-05,0.5
28290,이조/Noun,2,1,1,1.1115310228308472e-05,1.1106915165381966e-05,0.5
28291,천당/Noun,2,1,1,1.1115310228308472e-05,1.1106915165381966e-05,0.5
28292,천륜/Noun,2,1,1,1.1115310228308472e-05,1.1106915165381966e-05,0.5
28293,아동성폭행/Noun,2,1,1,1.1115310228308472e-05,1.1106915165381966e-05,0.5
28294,환경문제/Noun,2,1,1,1.1115310228308472e-05,1.1106915165381966e-05,0.5
28295,몸무게/Noun,2,1,1,1.1115310228308472e-05,1.1106915165381966e-05,0.5
28296,허깨비/Noun,2,1,1,1.1115310228308472e-05,1.1106915165381966e-05,0.5
28297,여실/Noun,2,1,1,1.1115310228308472e-05,1.1106915165381966e-05,0.5
28298,히토미/Noun,2,1,1,1.1115310228308472e-05,1.1106915165381966e-05,0.5
28299,발짝/Noun,2,1,1,1.1115310228308472e-05,1.1106915165381966e-05,0.5
28300,귀청/Noun,2,1,1,1.1115310228308472e-05,1.1106915165381966e-05,0.5
28301,섬광/Noun,2,1,1,1.1115310228308472e-05,1.1106915165381966e-05,0.5
28302,move/Alpha,2,1,1,1.1115310228308472e-05,1.1106915165381966e-05,0.5
28303,메이저리그/Noun,2,1,1,1.1115310228308472e-05,1.1106915165381966e-05,0.5
28304,낙마/Noun,2,1,1,1.1115310228308472e-05,1.1106915165381966e-05,0.5
28305,π/Foreign,2,1,1,1.1115310228308472e-05,1.1106915165381966e-05,0.5
28306,이오니/Josa,2,1,1,1.1115310228308472e-05,1.1106915165381966e-05,0.5
28307,은찬/Noun,2,1,1,1.1115310228308472e-05,1.1106915165381966e-05,0.5
28308,MAN/Alpha,2,1,1,1.1115310228308472e-05,1.1106915165381966e-05,0.5
28309,건중/Noun,2,1,1,1.1115310228308472e-05,1.1106915165381966e-05,0.5
28310,자연보호/Noun,2,1,1,1.1115310228308472e-05,1.1106915165381966e-05,0.5
28311,09/Number,2,1,1,1.1115310228308472e-05,1.1106915165381966e-05,0.5
28312,레릭/Noun,2,1,1,1.1115310228308472e-05,1.1106915165381966e-05,0.5
28313,반작용/Noun,2,1,1,1.1115310228308472e-05,1.1106915165381966e-05,0.5
28314,04/Number,2,1,1,1.1115310228308472e-05,1.1106915165381966e-05,0.5
28315,.........................................../Punctuation,2,1,1,1.1115310228308472e-05,1.1106915165381966e-05,0.5
28316,매화/Noun,2,1,1,1.1115310228308472e-05,1.1106915165381966e-05,0.5
28317,기원전/Noun,2,1,1,1.1115310228308472e-05,1.1106915165381966e-05,0.5
28318,스위니/Noun,2,1,1,1.1115310228308472e-05,1.1106915165381966e-05,0.5
28319,줄다리기/Noun,2,1,1,1.1115310228308472e-05,1.1106915165381966e-05,0.5
28320,와이퍼/Noun,2,1,1,1.1115310228308472e-05,1.1106915165381966e-05,0.5
28321,승용차/Noun,2,1,1,1.1115310228308472e-05,1.1106915165381966e-05,0.5
28322,김인문/Noun,2,1,1,1.1115310228308472e-05,1.1106915165381966e-05,0.5
28323,땅굴/Noun,2,1,1,1.1115310228308472e-05,1.1106915165381966e-05,0.5
28324,괴뢰군/Noun,2,1,1,1.1115310228308472e-05,1.1106915165381966e-05,0.5
28325,회춘/Noun,2,1,1,1.1115310228308472e-05,1.1106915165381966e-05,0.5
28326,철장/Noun,2,1,1,1.1115310228308472e-05,1.1106915165381966e-05,0.5
28327,지병/Noun,2,1,1,1.1115310228308472e-05,1.1106915165381966e-05,0.5
28328,부쉬/Noun,2,1,1,1.1115310228308472e-05,1.1106915165381966e-05,0.5
28329,엄하/Noun,2,1,1,1.1115310228308472e-05,1.1106915165381966e-05,0.5
28330,오근/Noun,2,1,1,1.1115310228308472e-05,1.1106915165381966e-05,0.5
28331,난사람/Noun,2,1,1,1.1115310228308472e-05,1.1106915165381966e-05,0.5
28332,빂/Noun,2,1,1,1.1115310228308472e-05,1.1106915165381966e-05,0.5
28333,마셰티/Noun,2,1,1,1.1115310228308472e-05,1.1106915165381966e-05,0.5
28334,5.28/Number,2,1,1,1.1115310228308472e-05,1.1106915165381966e-05,0.5
28335,발발하다/Adjective,2,1,1,1.1115310228308472e-05,1.1106915165381966e-05,0.5
28336,~~~?/Punctuation,2,1,1,1.1115310228308472e-05,1.1106915165381966e-05,0.5
28337,포더/Noun,2,1,1,1.1115310228308472e-05,1.1106915165381966e-05,0.5
28338,트위터/Noun,2,1,1,1.1115310228308472e-05,1.1106915165381966e-05,0.5
28339,와카/Noun,2,1,1,1.1115310228308472e-05,1.1106915165381966e-05,0.5
28340,국명/Noun,2,1,1,1.1115310228308472e-05,1.1106915165381966e-05,0.5
28341,안떨어지다/Verb,2,1,1,1.1115310228308472e-05,1.1106915165381966e-05,0.5
28342,로베르/Noun,2,1,1,1.1115310228308472e-05,1.1106915165381966e-05,0.5
28343,똭/Noun,2,1,1,1.1115310228308472e-05,1.1106915165381966e-05,0.5
28344,교육방송/Noun,2,1,1,1.1115310228308472e-05,1.1106915165381966e-05,0.5
28345,잘봣는데/Noun,2,1,1,1.1115310228308472e-05,1.1106915165381966e-05,0.5
28346,카뮈/Noun,2,1,1,1.1115310228308472e-05,1.1106915165381966e-05,0.5
28347,도수/Noun,2,1,1,1.1115310228308472e-05,1.1106915165381966e-05,0.5
28348,포지/Noun,2,1,1,1.1115310228308472e-05,1.1106915165381966e-05,0.5
28349,시시콜콜하다/Adjective,2,1,1,1.1115310228308472e-05,1.1106915165381966e-05,0.5
28350,진시황제/Noun,2,1,1,1.1115310228308472e-05,1.1106915165381966e-05,0.5
28351,엘리시움/Noun,2,1,1,1.1115310228308472e-05,1.1106915165381966e-05,0.5
28352,데이터/Noun,2,1,1,1.1115310228308472e-05,1.1106915165381966e-05,0.5
28353,유나이티드/Noun,2,1,1,1.1115310228308472e-05,1.1106915165381966e-05,0.5
28354,초음파/Noun,2,1,1,1.1115310228308472e-05,1.1106915165381966e-05,0.5
28355,허졉함/Noun,2,1,1,1.1115310228308472e-05,1.1106915165381966e-05,0.5
28356,옛적/Noun,2,1,1,1.1115310228308472e-05,1.1106915165381966e-05,0.5
28357,SP/Alpha,2,1,1,1.1115310228308472e-05,1.1106915165381966e-05,0.5
28358,차츰차츰/Noun,2,1,1,1.1115310228308472e-05,1.1106915165381966e-05,0.5
28359,영화제작사/Noun,2,1,1,1.1115310228308472e-05,1.1106915165381966e-05,0.5
28360,박원숙/Noun,2,1,1,1.1115310228308472e-05,1.1106915165381966e-05,0.5
28361,이렁/Noun,2,1,1,1.1115310228308472e-05,1.1106915165381966e-05,0.5
28362,토스트/Noun,2,1,1,1.1115310228308472e-05,1.1106915165381966e-05,0.5
28363,허트/Noun,2,1,1,1.1115310228308472e-05,1.1106915165381966e-05,0.5
28364,웃음보/Noun,2,1,1,1.1115310228308472e-05,1.1106915165381966e-05,0.5
28365,--?/Punctuation,2,1,1,1.1115310228308472e-05,1.1106915165381966e-05,0.5
28366,퍽킹/Noun,2,1,1,1.1115310228308472e-05,1.1106915165381966e-05,0.5
28367,:(/Punctuation,2,1,1,1.1115310228308472e-05,1.1106915165381966e-05,0.5
28368,여느/Modifier,2,1,1,1.1115310228308472e-05,1.1106915165381966e-05,0.5
28369,포터/Noun,2,1,1,1.1115310228308472e-05,1.1106915165381966e-05,0.5
28370,도너/Noun,2,1,1,1.1115310228308472e-05,1.1106915165381966e-05,0.5
28371,시기상조/Noun,2,1,1,1.1115310228308472e-05,1.1106915165381966e-05,0.5
28372,쌩유/Noun,2,1,1,1.1115310228308472e-05,1.1106915165381966e-05,0.5
28373,형준/Noun,2,1,1,1.1115310228308472e-05,1.1106915165381966e-05,0.5
28374,홥니/Noun,2,1,1,1.1115310228308472e-05,1.1106915165381966e-05,0.5
28375,자끝/Noun,2,1,1,1.1115310228308472e-05,1.1106915165381966e-05,0.5
28376,창립/Noun,2,1,1,1.1115310228308472e-05,1.1106915165381966e-05,0.5
28377,진운/Noun,2,1,1,1.1115310228308472e-05,1.1106915165381966e-05,0.5
28378,오라클/Noun,2,1,1,1.1115310228308472e-05,1.1106915165381966e-05,0.5
28379,뒤뚱뒤뚱/Noun,2,1,1,1.1115310228308472e-05,1.1106915165381966e-05,0.5
28380,ㅢ/KoreanParticle,2,1,1,1.1115310228308472e-05,1.1106915165381966e-05,0.5
28381,베르히/Noun,2,1,1,1.1115310228308472e-05,1.1106915165381966e-05,0.5
28382,무가당/Noun,2,1,1,1.1115310228308472e-05,1.1106915165381966e-05,0.5
28383,fucker/Alpha,2,1,1,1.1115310228308472e-05,1.1106915165381966e-05,0.5
28384,랄랄/Noun,2,1,1,1.1115310228308472e-05,1.1106915165381966e-05,0.5
28385,아이참/Exclamation,2,1,1,1.1115310228308472e-05,1.1106915165381966e-05,0.5
28386,팡팡/Adverb,2,1,1,1.1115310228308472e-05,1.1106915165381966e-05,0.5
28387,주먹다짐/Noun,2,1,1,1.1115310228308472e-05,1.1106915165381966e-05,0.5
28388,신변/Noun,2,1,1,1.1115310228308472e-05,1.1106915165381966e-05,0.5
28389,꽁초/Noun,2,1,1,1.1115310228308472e-05,1.1106915165381966e-05,0.5
28390,낚았어/Noun,2,1,1,1.1115310228308472e-05,1.1106915165381966e-05,0.5
28391,연흥/Noun,2,1,1,1.1115310228308472e-05,1.1106915165381966e-05,0.5
28392,작으로/Foreign,2,1,1,1.1115310228308472e-05,1.1106915165381966e-05,0.5
28393,망명/Noun,2,1,1,1.1115310228308472e-05,1.1106915165381966e-05,0.5
28394,Smith/Alpha,2,1,1,1.1115310228308472e-05,1.1106915165381966e-05,0.5
28395,도란/Noun,2,1,1,1.1115310228308472e-05,1.1106915165381966e-05,0.5
28396,집행자/Noun,2,1,1,1.1115310228308472e-05,1.1106915165381966e-05,0.5
28397,그린마일/Noun,2,1,1,1.1115310228308472e-05,1.1106915165381966e-05,0.5
28398,dont/Alpha,2,1,1,1.1115310228308472e-05,1.1106915165381966e-05,0.5
28399,오미경/Noun,2,1,1,1.1115310228308472e-05,1.1106915165381966e-05,0.5
28400,자궁/Noun,2,1,1,1.1115310228308472e-05,1.1106915165381966e-05,0.5
28401,년층/Noun,2,1,1,1.1115310228308472e-05,1.1106915165381966e-05,0.5
28402,중장/Noun,2,1,1,1.1115310228308472e-05,1.1106915165381966e-05,0.5
28403,미즈/Noun,2,1,1,1.1115310228308472e-05,1.1106915165381966e-05,0.5
28404,Sm/Alpha,2,1,1,1.1115310228308472e-05,1.1106915165381966e-05,0.5
28405,유람선/Noun,2,1,1,1.1115310228308472e-05,1.1106915165381966e-05,0.5
28406,관종/Noun,2,1,1,1.1115310228308472e-05,1.1106915165381966e-05,0.5
28407,총보/Noun,2,1,1,1.1115310228308472e-05,1.1106915165381966e-05,0.5
28408,몸통/Noun,2,1,1,1.1115310228308472e-05,1.1106915165381966e-05,0.5
28409,프란시/Noun,2,1,1,1.1115310228308472e-05,1.1106915165381966e-05,0.5
28410,도로시/Noun,2,1,1,1.1115310228308472e-05,1.1106915165381966e-05,0.5
28411,애티튜드/Noun,2,1,1,1.1115310228308472e-05,1.1106915165381966e-05,0.5
28412,정태우/Noun,2,1,1,1.1115310228308472e-05,1.1106915165381966e-05,0.5
28413,민요/Noun,2,1,1,1.1115310228308472e-05,1.1106915165381966e-05,0.5
28414,약도/Noun,2,1,1,1.1115310228308472e-05,1.1106915165381966e-05,0.5
28415,ㅈㅣ/KoreanParticle,2,1,1,1.1115310228308472e-05,1.1106915165381966e-05,0.5
28416,"-""/Punctuation",2,1,1,1.1115310228308472e-05,1.1106915165381966e-05,0.5
28417,마타/Noun,2,1,1,1.1115310228308472e-05,1.1106915165381966e-05,0.5
28418,분대/Noun,2,1,1,1.1115310228308472e-05,1.1106915165381966e-05,0.5
28419,끄응/Exclamation,2,1,1,1.1115310228308472e-05,1.1106915165381966e-05,0.5
28420,잭라이언/Noun,2,1,1,1.1115310228308472e-05,1.1106915165381966e-05,0.5
28421,ㅋㅠㅠ/KoreanParticle,2,1,1,1.1115310228308472e-05,1.1106915165381966e-05,0.5
28422,파이이야기/Noun,2,1,1,1.1115310228308472e-05,1.1106915165381966e-05,0.5
28423,네이비씰/Noun,2,1,1,1.1115310228308472e-05,1.1106915165381966e-05,0.5
28424,쓰/Noun,2,1,1,1.1115310228308472e-05,1.1106915165381966e-05,0.5
28425,남산/Noun,2,1,1,1.1115310228308472e-05,1.1106915165381966e-05,0.5
28426,카드게임/Noun,2,1,1,1.1115310228308472e-05,1.1106915165381966e-05,0.5
28427,ㄴㅓ/KoreanParticle,2,1,1,1.1115310228308472e-05,1.1106915165381966e-05,0.5
28428,치얼스/Noun,2,1,1,1.1115310228308472e-05,1.1106915165381966e-05,0.5
28429,블루라군/Noun,2,1,1,1.1115310228308472e-05,1.1106915165381966e-05,0.5
28430,=.=/Punctuation,2,1,1,1.1115310228308472e-05,1.1106915165381966e-05,0.5
28431,바랬네/Noun,2,1,1,1.1115310228308472e-05,1.1106915165381966e-05,0.5
28432,왼손/Noun,2,1,1,1.1115310228308472e-05,1.1106915165381966e-05,0.5
28433,그림동화/Noun,2,1,1,1.1115310228308472e-05,1.1106915165381966e-05,0.5
28434,공공/Noun,2,1,1,1.1115310228308472e-05,1.1106915165381966e-05,0.5
28435,(?!)/Punctuation,2,1,1,1.1115310228308472e-05,1.1106915165381966e-05,0.5
28436,설국/Noun,2,1,1,1.1115310228308472e-05,1.1106915165381966e-05,0.5
28437,;;;;;;;;;;/Punctuation,2,1,1,1.1115310228308472e-05,1.1106915165381966e-05,0.5
28438,무슬림/Noun,2,1,1,1.1115310228308472e-05,1.1106915165381966e-05,0.5
28439,조우정/Noun,2,1,1,1.1115310228308472e-05,1.1106915165381966e-05,0.5
28440,수역/Noun,2,1,1,1.1115310228308472e-05,1.1106915165381966e-05,0.5
28441,땀방울/Noun,2,1,1,1.1115310228308472e-05,1.1106915165381966e-05,0.5
28442,사은/Noun,2,1,1,1.1115310228308472e-05,1.1106915165381966e-05,0.5
28443,피츠제럴드/Noun,2,1,1,1.1115310228308472e-05,1.1106915165381966e-05,0.5
28444,하늘이시여/Noun,2,1,1,1.1115310228308472e-05,1.1106915165381966e-05,0.5
28445,타부/Noun,2,1,1,1.1115310228308472e-05,1.1106915165381966e-05,0.5
28446,노스트라다무스/Noun,2,1,1,1.1115310228308472e-05,1.1106915165381966e-05,0.5
28447,!.!/Punctuation,2,1,1,1.1115310228308472e-05,1.1106915165381966e-05,0.5
28448,Gold/Alpha,2,1,1,1.1115310228308472e-05,1.1106915165381966e-05,0.5
28449,화재현장/Noun,2,1,1,1.1115310228308472e-05,1.1106915165381966e-05,0.5
28450,하길레/Noun,2,1,1,1.1115310228308472e-05,1.1106915165381966e-05,0.5
28451,루안/Noun,2,1,1,1.1115310228308472e-05,1.1106915165381966e-05,0.5
28452,맥히/Noun,2,1,1,1.1115310228308472e-05,1.1106915165381966e-05,0.5
28453,붕탁/Noun,2,1,1,1.1115310228308472e-05,1.1106915165381966e-05,0.5
28454,해링턴/Noun,2,1,1,1.1115310228308472e-05,1.1106915165381966e-05,0.5
28455,데칼코마니/Noun,2,1,1,1.1115310228308472e-05,1.1106915165381966e-05,0.5
28456,색히/Noun,2,1,1,1.1115310228308472e-05,1.1106915165381966e-05,0.5
28457,재범/Noun,2,1,1,1.1115310228308472e-05,1.1106915165381966e-05,0.5
28458,채색/Noun,2,1,1,1.1115310228308472e-05,1.1106915165381966e-05,0.5
28459,보쇼/Noun,2,1,1,1.1115310228308472e-05,1.1106915165381966e-05,0.5
28460,환원/Noun,2,1,1,1.1115310228308472e-05,1.1106915165381966e-05,0.5
28461,갈림/Noun,2,1,1,1.1115310228308472e-05,1.1106915165381966e-05,0.5
28462,벼락/Noun,2,1,1,1.1115310228308472e-05,1.1106915165381966e-05,0.5
28463,둘레/Noun,2,1,1,1.1115310228308472e-05,1.1106915165381966e-05,0.5
28464,빅맥/Noun,2,1,1,1.1115310228308472e-05,1.1106915165381966e-05,0.5
28465,국현/Noun,2,1,1,1.1115310228308472e-05,1.1106915165381966e-05,0.5
28466,짤린것/Noun,2,1,1,1.1115310228308472e-05,1.1106915165381966e-05,0.5
28467,감돌다/Verb,2,1,1,1.1115310228308472e-05,1.1106915165381966e-05,0.5
28468,졸부/Noun,2,1,1,1.1115310228308472e-05,1.1106915165381966e-05,0.5
28469,!??/Punctuation,2,1,1,1.1115310228308472e-05,1.1106915165381966e-05,0.5
28470,출판/Noun,2,1,1,1.1115310228308472e-05,1.1106915165381966e-05,0.5
28471,봄/Foreign,2,1,1,1.1115310228308472e-05,1.1106915165381966e-05,0.5
28472,종전/Noun,2,1,1,1.1115310228308472e-05,1.1106915165381966e-05,0.5
28473,우웨/Noun,2,1,1,1.1115310228308472e-05,1.1106915165381966e-05,0.5
28474,황홀/Noun,2,1,1,1.1115310228308472e-05,1.1106915165381966e-05,0.5
28475,자백/Noun,2,1,1,1.1115310228308472e-05,1.1106915165381966e-05,0.5
28476,드제/Noun,2,1,1,1.1115310228308472e-05,1.1106915165381966e-05,0.5
28477,행크/Noun,2,1,1,1.1115310228308472e-05,1.1106915165381966e-05,0.5
28478,보전/Noun,2,1,1,1.1115310228308472e-05,1.1106915165381966e-05,0.5
28479,흐트/Noun,2,1,1,1.1115310228308472e-05,1.1106915165381966e-05,0.5
28480,월레/Noun,2,1,1,1.1115310228308472e-05,1.1106915165381966e-05,0.5
28481,엽떡/Noun,2,1,1,1.1115310228308472e-05,1.1106915165381966e-05,0.5
28482,ㅊㅊㅊ/KoreanParticle,2,1,1,1.1115310228308472e-05,1.1106915165381966e-05,0.5
28483,수도권/Noun,2,1,1,1.1115310228308472e-05,1.1106915165381966e-05,0.5
28484,엉/Noun,2,1,1,1.1115310228308472e-05,1.1106915165381966e-05,0.5
28485,소각/Noun,2,1,1,1.1115310228308472e-05,1.1106915165381966e-05,0.5
28486,지악/Noun,2,1,1,1.1115310228308472e-05,1.1106915165381966e-05,0.5
28487,배회/Noun,2,1,1,1.1115310228308472e-05,1.1106915165381966e-05,0.5
28488,다운증후군/Noun,2,1,1,1.1115310228308472e-05,1.1106915165381966e-05,0.5
28489,안일/Noun,2,1,1,1.1115310228308472e-05,1.1106915165381966e-05,0.5
28490,아공/Noun,2,1,1,1.1115310228308472e-05,1.1106915165381966e-05,0.5
28491,Miss/Alpha,2,1,1,1.1115310228308472e-05,1.1106915165381966e-05,0.5
28492,놈땜/Noun,2,1,1,1.1115310228308472e-05,1.1106915165381966e-05,0.5
28493,베이츠/Noun,2,1,1,1.1115310228308472e-05,1.1106915165381966e-05,0.5
28494,백퍼센트/Noun,2,1,1,1.1115310228308472e-05,1.1106915165381966e-05,0.5
28495,comes/Alpha,2,1,1,1.1115310228308472e-05,1.1106915165381966e-05,0.5
28496,격언/Noun,2,1,1,1.1115310228308472e-05,1.1106915165381966e-05,0.5
28497,손나은/Noun,2,1,1,1.1115310228308472e-05,1.1106915165381966e-05,0.5
28498,볼링/Noun,2,1,1,1.1115310228308472e-05,1.1106915165381966e-05,0.5
28499,주거/Noun,2,1,1,1.1115310228308472e-05,1.1106915165381966e-05,0.5
28500,someone/Alpha,2,1,1,1.1115310228308472e-05,1.1106915165381966e-05,0.5
28501,팬카페/Noun,2,1,1,1.1115310228308472e-05,1.1106915165381966e-05,0.5
28502,후덕/Noun,2,1,1,1.1115310228308472e-05,1.1106915165381966e-05,0.5
28503,ㄷㅐ/KoreanParticle,2,1,1,1.1115310228308472e-05,1.1106915165381966e-05,0.5
28504,이발소/Noun,2,1,1,1.1115310228308472e-05,1.1106915165381966e-05,0.5
28505,이윤/Noun,2,1,1,1.1115310228308472e-05,1.1106915165381966e-05,0.5
28506,건어/Noun,2,1,1,1.1115310228308472e-05,1.1106915165381966e-05,0.5
28507,소스케/Noun,2,1,1,1.1115310228308472e-05,1.1106915165381966e-05,0.5
28508,비트박스/Noun,2,1,1,1.1115310228308472e-05,1.1106915165381966e-05,0.5
28509,세이프/Noun,2,1,1,1.1115310228308472e-05,1.1106915165381966e-05,0.5
28510,놉/Noun,2,1,1,1.1115310228308472e-05,1.1106915165381966e-05,0.5
28511,IG/Alpha,2,1,1,1.1115310228308472e-05,1.1106915165381966e-05,0.5
28512,드라이빙/Noun,2,1,1,1.1115310228308472e-05,1.1106915165381966e-05,0.5
28513,1억달러/Number,2,1,1,1.1115310228308472e-05,1.1106915165381966e-05,0.5
28514,이뻣던/Noun,2,1,1,1.1115310228308472e-05,1.1106915165381966e-05,0.5
28515,꼬치/Noun,2,1,1,1.1115310228308472e-05,1.1106915165381966e-05,0.5
28516,이태곤/Noun,2,1,1,1.1115310228308472e-05,1.1106915165381966e-05,0.5
28517,아조/Adverb,2,1,1,1.1115310228308472e-05,1.1106915165381966e-05,0.5
28518,7080시/Number,2,1,1,1.1115310228308472e-05,1.1106915165381966e-05,0.5
28519,좋드/Noun,2,1,1,1.1115310228308472e-05,1.1106915165381966e-05,0.5
28520,강도영/Noun,2,1,1,1.1115310228308472e-05,1.1106915165381966e-05,0.5
28521,도너츠/Noun,2,1,1,1.1115310228308472e-05,1.1106915165381966e-05,0.5
28522,디컬/Noun,2,1,1,1.1115310228308472e-05,1.1106915165381966e-05,0.5
28523,쿠르즈/Noun,2,1,1,1.1115310228308472e-05,1.1106915165381966e-05,0.5
28524,히스테릭/Noun,2,1,1,1.1115310228308472e-05,1.1106915165381966e-05,0.5
28525,대진/Noun,2,1,1,1.1115310228308472e-05,1.1106915165381966e-05,0.5
28526,소야/Noun,2,1,1,1.1115310228308472e-05,1.1106915165381966e-05,0.5
28527,역학/Noun,2,1,1,1.1115310228308472e-05,1.1106915165381966e-05,0.5
28528,루멧/Noun,2,1,1,1.1115310228308472e-05,1.1106915165381966e-05,0.5
28529,이거쫌/Noun,2,1,1,1.1115310228308472e-05,1.1106915165381966e-05,0.5
28530,ㅊㅋ/KoreanParticle,2,1,1,1.1115310228308472e-05,1.1106915165381966e-05,0.5
28531,원진/Noun,2,1,1,1.1115310228308472e-05,1.1106915165381966e-05,0.5
28532,모티프/Noun,2,1,1,1.1115310228308472e-05,1.1106915165381966e-05,0.5
28533,도스토예프스키/Noun,2,1,1,1.1115310228308472e-05,1.1106915165381966e-05,0.5
28534,마리나/Noun,2,1,1,1.1115310228308472e-05,1.1106915165381966e-05,0.5
28535,마셰코/Noun,2,1,1,1.1115310228308472e-05,1.1106915165381966e-05,0.5
28536,불협/Noun,2,1,1,1.1115310228308472e-05,1.1106915165381966e-05,0.5
28537,젠틀/Noun,2,1,1,1.1115310228308472e-05,1.1106915165381966e-05,0.5
28538,의협/Noun,2,1,1,1.1115310228308472e-05,1.1106915165381966e-05,0.5
28539,레비/Noun,2,1,1,1.1115310228308472e-05,1.1106915165381966e-05,0.5
28540,못바/Noun,2,1,1,1.1115310228308472e-05,1.1106915165381966e-05,0.5
28541,MEN/Alpha,2,1,1,1.1115310228308472e-05,1.1106915165381966e-05,0.5
28542,ㄹㄱ/KoreanParticle,2,1,1,1.1115310228308472e-05,1.1106915165381966e-05,0.5
28543,청강/Noun,2,1,1,1.1115310228308472e-05,1.1106915165381966e-05,0.5
28544,방송/Foreign,2,1,1,1.1115310228308472e-05,1.1106915165381966e-05,0.5
28545,요장/Noun,2,1,1,1.1115310228308472e-05,1.1106915165381966e-05,0.5
28546,측/Noun,2,1,1,1.1115310228308472e-05,1.1106915165381966e-05,0.5
28547,신해철/Noun,2,1,1,1.1115310228308472e-05,1.1106915165381966e-05,0.5
28548,투탑/Noun,2,1,1,1.1115310228308472e-05,1.1106915165381966e-05,0.5
28549,꼽을/Noun,2,1,1,1.1115310228308472e-05,1.1106915165381966e-05,0.5
28550,??)/Punctuation,2,1,1,1.1115310228308472e-05,1.1106915165381966e-05,0.5
28551,바랬건/Noun,2,1,1,1.1115310228308472e-05,1.1106915165381966e-05,0.5
28552,이름나다/Adjective,2,1,1,1.1115310228308472e-05,1.1106915165381966e-05,0.5
28553,골목길/Noun,2,1,1,1.1115310228308472e-05,1.1106915165381966e-05,0.5
28554,응용/Noun,2,1,1,1.1115310228308472e-05,1.1106915165381966e-05,0.5
28555,등부/Noun,2,1,1,1.1115310228308472e-05,1.1106915165381966e-05,0.5
28556,메트로/Noun,2,1,1,1.1115310228308472e-05,1.1106915165381966e-05,0.5
28557,홍보팀/Noun,2,1,1,1.1115310228308472e-05,1.1106915165381966e-05,0.5
28558,원숙하다/Adjective,2,1,1,1.1115310228308472e-05,1.1106915165381966e-05,0.5
28559,Will/Alpha,2,1,1,1.1115310228308472e-05,1.1106915165381966e-05,0.5
28560,시늉/Noun,2,1,1,1.1115310228308472e-05,1.1106915165381966e-05,0.5
28561,신화로/Noun,2,1,1,1.1115310228308472e-05,1.1106915165381966e-05,0.5
28562,마멧/Noun,2,1,1,1.1115310228308472e-05,1.1106915165381966e-05,0.5
28563,뚱뚱/Noun,2,1,1,1.1115310228308472e-05,1.1106915165381966e-05,0.5
28564,yes/Alpha,2,1,1,1.1115310228308472e-05,1.1106915165381966e-05,0.5
28565,전과/Foreign,2,1,1,1.1115310228308472e-05,1.1106915165381966e-05,0.5
28566,^^?/Punctuation,2,1,1,1.1115310228308472e-05,1.1106915165381966e-05,0.5
28567,배낭여행/Noun,2,1,1,1.1115310228308472e-05,1.1106915165381966e-05,0.5
28568,별의별/Noun,2,1,1,1.1115310228308472e-05,1.1106915165381966e-05,0.5
28569,j/Alpha,2,1,1,1.1115310228308472e-05,1.1106915165381966e-05,0.5
28570,공성전/Noun,2,1,1,1.1115310228308472e-05,1.1106915165381966e-05,0.5
28571,미첼/Noun,2,1,1,1.1115310228308472e-05,1.1106915165381966e-05,0.5
28572,왕위/Noun,2,1,1,1.1115310228308472e-05,1.1106915165381966e-05,0.5
28573,셍/Noun,2,1,1,1.1115310228308472e-05,1.1106915165381966e-05,0.5
28574,염색머리/Noun,2,1,1,1.1115310228308472e-05,1.1106915165381966e-05,0.5
28575,짝짓기/Noun,2,1,1,1.1115310228308472e-05,1.1106915165381966e-05,0.5
28576,여성학/Noun,2,1,1,1.1115310228308472e-05,1.1106915165381966e-05,0.5
28577,몽유병/Noun,2,1,1,1.1115310228308472e-05,1.1106915165381966e-05,0.5
28578,만지작거리다/Adjective,2,1,1,1.1115310228308472e-05,1.1106915165381966e-05,0.5
28579,제롬/Noun,2,1,1,1.1115310228308472e-05,1.1106915165381966e-05,0.5
28580,브르스/Noun,2,1,1,1.1115310228308472e-05,1.1106915165381966e-05,0.5
28581,PMP/Alpha,2,1,1,1.1115310228308472e-05,1.1106915165381966e-05,0.5
28582,설리번/Noun,2,1,1,1.1115310228308472e-05,1.1106915165381966e-05,0.5
28583,들이키다/Verb,2,1,1,1.1115310228308472e-05,1.1106915165381966e-05,0.5
28584,내한/Noun,2,1,1,1.1115310228308472e-05,1.1106915165381966e-05,0.5
28585,막내아들/Noun,2,1,1,1.1115310228308472e-05,1.1106915165381966e-05,0.5
28586,호잇/Noun,2,1,1,1.1115310228308472e-05,1.1106915165381966e-05,0.5
28587,저조/Noun,2,1,1,1.1115310228308472e-05,1.1106915165381966e-05,0.5
28588,연체/Noun,2,1,1,1.1115310228308472e-05,1.1106915165381966e-05,0.5
28589,회당/Noun,2,1,1,1.1115310228308472e-05,1.1106915165381966e-05,0.5
28590,샤머니즘/Noun,2,1,1,1.1115310228308472e-05,1.1106915165381966e-05,0.5
28591,1400원/Number,2,1,1,1.1115310228308472e-05,1.1106915165381966e-05,0.5
28592,고속/Noun,2,1,1,1.1115310228308472e-05,1.1106915165381966e-05,0.5
28593,고명/Noun,2,1,1,1.1115310228308472e-05,1.1106915165381966e-05,0.5
28594,파스/Noun,2,1,1,1.1115310228308472e-05,1.1106915165381966e-05,0.5
28595,정수리/Noun,2,1,1,1.1115310228308472e-05,1.1106915165381966e-05,0.5
28596,대명/Noun,2,1,1,1.1115310228308472e-05,1.1106915165381966e-05,0.5
28597,엇구/Noun,2,1,1,1.1115310228308472e-05,1.1106915165381966e-05,0.5
28598,깨우침/Noun,2,1,1,1.1115310228308472e-05,1.1106915165381966e-05,0.5
28599,지놈/Noun,2,1,1,1.1115310228308472e-05,1.1106915165381966e-05,0.5
28600,공준/Noun,2,1,1,1.1115310228308472e-05,1.1106915165381966e-05,0.5
28601,Day/Alpha,2,1,1,1.1115310228308472e-05,1.1106915165381966e-05,0.5
28602,능이/Noun,2,1,1,1.1115310228308472e-05,1.1106915165381966e-05,0.5
28603,섹드립/Noun,2,1,1,1.1115310228308472e-05,1.1106915165381966e-05,0.5
28604,???..../Punctuation,2,1,1,1.1115310228308472e-05,1.1106915165381966e-05,0.5
28605,뿌뿌/Noun,2,1,1,1.1115310228308472e-05,1.1106915165381966e-05,0.5
28606,선뜻/Noun,2,1,1,1.1115310228308472e-05,1.1106915165381966e-05,0.5
28607,킹오파/Noun,2,1,1,1.1115310228308472e-05,1.1106915165381966e-05,0.5
28608,안재현/Noun,2,1,1,1.1115310228308472e-05,1.1106915165381966e-05,0.5
28609,케케/Noun,2,1,1,1.1115310228308472e-05,1.1106915165381966e-05,0.5
28610,클로버/Noun,2,1,1,1.1115310228308472e-05,1.1106915165381966e-05,0.5
28611,맥거핀/Noun,2,1,1,1.1115310228308472e-05,1.1106915165381966e-05,0.5
28612,가디/Noun,2,1,1,1.1115310228308472e-05,1.1106915165381966e-05,0.5
28613,노원/Noun,2,1,1,1.1115310228308472e-05,1.1106915165381966e-05,0.5
28614,유일신/Noun,2,1,1,1.1115310228308472e-05,1.1106915165381966e-05,0.5
28615,존웨인/Noun,2,1,1,1.1115310228308472e-05,1.1106915165381966e-05,0.5
28616,앵커/Noun,2,1,1,1.1115310228308472e-05,1.1106915165381966e-05,0.5
28617,공로/Noun,2,1,1,1.1115310228308472e-05,1.1106915165381966e-05,0.5
28618,캣츠/Noun,2,1,1,1.1115310228308472e-05,1.1106915165381966e-05,0.5
28619,낙하/Noun,2,1,1,1.1115310228308472e-05,1.1106915165381966e-05,0.5
28620,Want/Alpha,2,1,1,1.1115310228308472e-05,1.1106915165381966e-05,0.5
28621,뒤따르다/Verb,2,1,1,1.1115310228308472e-05,1.1106915165381966e-05,0.5
28622,혈기/Noun,2,1,1,1.1115310228308472e-05,1.1106915165381966e-05,0.5
28623,신약/Noun,2,1,1,1.1115310228308472e-05,1.1106915165381966e-05,0.5
28624,최우/Noun,2,1,1,1.1115310228308472e-05,1.1106915165381966e-05,0.5
28625,숙녀/Noun,2,1,1,1.1115310228308472e-05,1.1106915165381966e-05,0.5
28626,청앨/Noun,2,1,1,1.1115310228308472e-05,1.1106915165381966e-05,0.5
28627,종초홍/Noun,2,1,1,1.1115310228308472e-05,1.1106915165381966e-05,0.5
28628,오작/Noun,2,1,1,1.1115310228308472e-05,1.1106915165381966e-05,0.5
28629,재거/Noun,2,1,1,1.1115310228308472e-05,1.1106915165381966e-05,0.5
28630,믹/Noun,2,1,1,1.1115310228308472e-05,1.1106915165381966e-05,0.5
28631,동장/Noun,2,1,1,1.1115310228308472e-05,1.1106915165381966e-05,0.5
28632,멸시/Noun,2,1,1,1.1115310228308472e-05,1.1106915165381966e-05,0.5
28633,제스쳐/Noun,2,1,1,1.1115310228308472e-05,1.1106915165381966e-05,0.5
28634,!~~~/Punctuation,2,1,1,1.1115310228308472e-05,1.1106915165381966e-05,0.5
28635,더리더/Noun,2,1,1,1.1115310228308472e-05,1.1106915165381966e-05,0.5
28636,SSS/Alpha,2,1,1,1.1115310228308472e-05,1.1106915165381966e-05,0.5
28637,밥값/Noun,2,1,1,1.1115310228308472e-05,1.1106915165381966e-05,0.5
28638,머린/Noun,2,1,1,1.1115310228308472e-05,1.1106915165381966e-05,0.5
28639,~~??/Punctuation,2,1,1,1.1115310228308472e-05,1.1106915165381966e-05,0.5
28640,구렛나루/Noun,2,1,1,1.1115310228308472e-05,1.1106915165381966e-05,0.5
28641,~~~../Punctuation,2,1,1,1.1115310228308472e-05,1.1106915165381966e-05,0.5
28642,무간/Noun,2,1,1,1.1115310228308472e-05,1.1106915165381966e-05,0.5
28643,300분/Number,2,1,1,1.1115310228308472e-05,1.1106915165381966e-05,0.5
28644,김정식/Noun,2,1,1,1.1115310228308472e-05,1.1106915165381966e-05,0.5
28645,음량/Noun,2,1,1,1.1115310228308472e-05,1.1106915165381966e-05,0.5
28646,한없다/Adjective,2,1,1,1.1115310228308472e-05,1.1106915165381966e-05,0.5
28647,느꼇던/Noun,2,1,1,1.1115310228308472e-05,1.1106915165381966e-05,0.5
28648,작치고/Foreign,2,1,1,1.1115310228308472e-05,1.1106915165381966e-05,0.5
28649,거돈/Noun,2,1,1,1.1115310228308472e-05,1.1106915165381966e-05,0.5
28650,타락천사/Noun,2,1,1,1.1115310228308472e-05,1.1106915165381966e-05,0.5
28651,새우깡/Noun,2,1,1,1.1115310228308472e-05,1.1106915165381966e-05,0.5
28652,ㅂㅇ/KoreanParticle,2,1,1,1.1115310228308472e-05,1.1106915165381966e-05,0.5
28653,................................../Punctuation,2,1,1,1.1115310228308472e-05,1.1106915165381966e-05,0.5
28654,RPG/Alpha,2,1,1,1.1115310228308472e-05,1.1106915165381966e-05,0.5
28655,사이클/Noun,2,1,1,1.1115310228308472e-05,1.1106915165381966e-05,0.5
28656,Justice/Alpha,2,1,1,1.1115310228308472e-05,1.1106915165381966e-05,0.5
28657,보랏/Noun,2,1,1,1.1115310228308472e-05,1.1106915165381966e-05,0.5
28658,놈임/Noun,2,1,1,1.1115310228308472e-05,1.1106915165381966e-05,0.5
28659,이필립/Noun,2,1,1,1.1115310228308472e-05,1.1106915165381966e-05,0.5
28660,..????/Punctuation,2,1,1,1.1115310228308472e-05,1.1106915165381966e-05,0.5
28661,우한/Noun,2,1,1,1.1115310228308472e-05,1.1106915165381966e-05,0.5
28662,신소현/Noun,2,1,1,1.1115310228308472e-05,1.1106915165381966e-05,0.5
28663,마땅/Noun,2,1,1,1.1115310228308472e-05,1.1106915165381966e-05,0.5
28664,동백꽃/Noun,2,1,1,1.1115310228308472e-05,1.1106915165381966e-05,0.5
28665,닐조단/Noun,2,1,1,1.1115310228308472e-05,1.1106915165381966e-05,0.5
28666,이형은/Noun,2,1,1,1.1115310228308472e-05,1.1106915165381966e-05,0.5
28667,제이비/Noun,2,1,1,1.1115310228308472e-05,1.1106915165381966e-05,0.5
28668,퀸틴/Noun,2,1,1,1.1115310228308472e-05,1.1106915165381966e-05,0.5
28669,ass/Alpha,2,1,1,1.1115310228308472e-05,1.1106915165381966e-05,0.5
28670,색퀴/Noun,2,1,1,1.1115310228308472e-05,1.1106915165381966e-05,0.5
28671,응석/Noun,2,1,1,1.1115310228308472e-05,1.1106915165381966e-05,0.5
28672,관계씬/Noun,2,1,1,1.1115310228308472e-05,1.1106915165381966e-05,0.5
28673,심리치료/Noun,2,1,1,1.1115310228308472e-05,1.1106915165381966e-05,0.5
28674,양탄자/Noun,2,1,1,1.1115310228308472e-05,1.1106915165381966e-05,0.5
28675,9.4/Number,2,1,1,1.1115310228308472e-05,1.1106915165381966e-05,0.5
28676,인장/Noun,2,1,1,1.1115310228308472e-05,1.1106915165381966e-05,0.5
28677,비타민/Noun,2,1,1,1.1115310228308472e-05,1.1106915165381966e-05,0.5
28678,살금/Noun,2,1,1,1.1115310228308472e-05,1.1106915165381966e-05,0.5
28679,엄지손가락/Noun,2,1,1,1.1115310228308472e-05,1.1106915165381966e-05,0.5
28680,생으로/Foreign,2,1,1,1.1115310228308472e-05,1.1106915165381966e-05,0.5
28681,민병/Noun,2,1,1,1.1115310228308472e-05,1.1106915165381966e-05,0.5
28682,새정치/Noun,2,1,1,1.1115310228308472e-05,1.1106915165381966e-05,0.5
28683,천이/Noun,2,1,1,1.1115310228308472e-05,1.1106915165381966e-05,0.5
28684,거탑/Noun,2,1,1,1.1115310228308472e-05,1.1106915165381966e-05,0.5
28685,노름/Noun,2,1,1,1.1115310228308472e-05,1.1106915165381966e-05,0.5
28686,겨울나그네/Noun,2,1,1,1.1115310228308472e-05,1.1106915165381966e-05,0.5
28687,뱃/Noun,2,1,1,1.1115310228308472e-05,1.1106915165381966e-05,0.5
28688,구급/Noun,2,1,1,1.1115310228308472e-05,1.1106915165381966e-05,0.5
28689,함깨/Noun,2,1,1,1.1115310228308472e-05,1.1106915165381966e-05,0.5
28690,샬라샬/Noun,2,1,1,1.1115310228308472e-05,1.1106915165381966e-05,0.5
28691,로마노프/Noun,2,1,1,1.1115310228308472e-05,1.1106915165381966e-05,0.5
28692,동자/Noun,2,1,1,1.1115310228308472e-05,1.1106915165381966e-05,0.5
28693,선제/Noun,2,1,1,1.1115310228308472e-05,1.1106915165381966e-05,0.5
28694,암술/Noun,2,1,1,1.1115310228308472e-05,1.1106915165381966e-05,0.5
28695,대준/Noun,2,1,1,1.1115310228308472e-05,1.1106915165381966e-05,0.5
28696,단디/Noun,2,1,1,1.1115310228308472e-05,1.1106915165381966e-05,0.5
28697,800만/Number,2,1,1,1.1115310228308472e-05,1.1106915165381966e-05,0.5
28698,모루/Noun,2,1,1,1.1115310228308472e-05,1.1106915165381966e-05,0.5
28699,마사무네/Noun,2,1,1,1.1115310228308472e-05,1.1106915165381966e-05,0.5
28700,씬때/Noun,2,1,1,1.1115310228308472e-05,1.1106915165381966e-05,0.5
28701,안티히어로/Noun,2,1,1,1.1115310228308472e-05,1.1106915165381966e-05,0.5
28702,쓴소리/Noun,2,1,1,1.1115310228308472e-05,1.1106915165381966e-05,0.5
28703,싱가폴/Noun,2,1,1,1.1115310228308472e-05,1.1106915165381966e-05,0.5
28704,을지/Noun,2,1,1,1.1115310228308472e-05,1.1106915165381966e-05,0.5
28705,재스민/Noun,2,1,1,1.1115310228308472e-05,1.1106915165381966e-05,0.5
28706,캬하/Noun,2,1,1,1.1115310228308472e-05,1.1106915165381966e-05,0.5
28707,54년/Number,2,1,1,1.1115310228308472e-05,1.1106915165381966e-05,0.5
28708,송혜/Noun,2,1,1,1.1115310228308472e-05,1.1106915165381966e-05,0.5
28709,청문회/Noun,2,1,1,1.1115310228308472e-05,1.1106915165381966e-05,0.5
28710,모해/Noun,2,1,1,1.1115310228308472e-05,1.1106915165381966e-05,0.5
28711,구니/Noun,2,1,1,1.1115310228308472e-05,1.1106915165381966e-05,0.5
28712,잭더리퍼/Noun,2,1,1,1.1115310228308472e-05,1.1106915165381966e-05,0.5
28713,뇌사/Noun,2,1,1,1.1115310228308472e-05,1.1106915165381966e-05,0.5
28714,추남/Noun,2,1,1,1.1115310228308472e-05,1.1106915165381966e-05,0.5
28715,강수진/Noun,2,1,1,1.1115310228308472e-05,1.1106915165381966e-05,0.5
28716,순의/Noun,2,1,1,1.1115310228308472e-05,1.1106915165381966e-05,0.5
28717,레빈슨/Noun,2,1,1,1.1115310228308472e-05,1.1106915165381966e-05,0.5
28718,알러지/Noun,2,1,1,1.1115310228308472e-05,1.1106915165381966e-05,0.5
28719,체취/Noun,2,1,1,1.1115310228308472e-05,1.1106915165381966e-05,0.5
28720,매사/Noun,2,1,1,1.1115310228308472e-05,1.1106915165381966e-05,0.5
28721,미려/Noun,2,1,1,1.1115310228308472e-05,1.1106915165381966e-05,0.5
28722,70회/Number,2,1,1,1.1115310228308472e-05,1.1106915165381966e-05,0.5
28723,ㅔㅎ/KoreanParticle,2,1,1,1.1115310228308472e-05,1.1106915165381966e-05,0.5
28724,견인/Noun,2,1,1,1.1115310228308472e-05,1.1106915165381966e-05,0.5
28725,청렴/Noun,2,1,1,1.1115310228308472e-05,1.1106915165381966e-05,0.5
28726,재능기부/Noun,2,1,1,1.1115310228308472e-05,1.1106915165381966e-05,0.5
28727,0원/Number,2,1,1,1.1115310228308472e-05,1.1106915165381966e-05,0.5
28728,10만원/Number,2,1,1,1.1115310228308472e-05,1.1106915165381966e-05,0.5
28729,벅스/Noun,2,1,1,1.1115310228308472e-05,1.1106915165381966e-05,0.5
28730,넝쿨/Noun,2,1,1,1.1115310228308472e-05,1.1106915165381966e-05,0.5
28731,김원준/Noun,2,1,1,1.1115310228308472e-05,1.1106915165381966e-05,0.5
28732,상체/Noun,2,1,1,1.1115310228308472e-05,1.1106915165381966e-05,0.5
28733,열강/Noun,2,1,1,1.1115310228308472e-05,1.1106915165381966e-05,0.5
28734,한기주/Noun,2,1,1,1.1115310228308472e-05,1.1106915165381966e-05,0.5
28735,피카츄/Noun,2,1,1,1.1115310228308472e-05,1.1106915165381966e-05,0.5
28736,농후/Noun,2,1,1,1.1115310228308472e-05,1.1106915165381966e-05,0.5
28737,다낚여/Noun,2,1,1,1.1115310228308472e-05,1.1106915165381966e-05,0.5
28738,형법/Noun,2,1,1,1.1115310228308472e-05,1.1106915165381966e-05,0.5
28739,이빈/Noun,2,1,1,1.1115310228308472e-05,1.1106915165381966e-05,0.5
28740,시타/Noun,2,1,1,1.1115310228308472e-05,1.1106915165381966e-05,0.5
28741,코일/Noun,2,1,1,1.1115310228308472e-05,1.1106915165381966e-05,0.5
28742,무집/Noun,2,1,1,1.1115310228308472e-05,1.1106915165381966e-05,0.5
28743,김지민/Noun,2,1,1,1.1115310228308472e-05,1.1106915165381966e-05,0.5
28744,희재/Noun,2,1,1,1.1115310228308472e-05,1.1106915165381966e-05,0.5
28745,미상/Noun,2,1,1,1.1115310228308472e-05,1.1106915165381966e-05,0.5
28746,김선경/Noun,2,1,1,1.1115310228308472e-05,1.1106915165381966e-05,0.5
28747,친히/Noun,2,1,1,1.1115310228308472e-05,1.1106915165381966e-05,0.5
28748,자연도/Noun,2,1,1,1.1115310228308472e-05,1.1106915165381966e-05,0.5
28749,반을/Foreign,2,1,1,1.1115310228308472e-05,1.1106915165381966e-05,0.5
28750,짦/Noun,2,1,1,1.1115310228308472e-05,1.1106915165381966e-05,0.5
28751,깊숙이/Adverb,2,1,1,1.1115310228308472e-05,1.1106915165381966e-05,0.5
28752,1968년/Number,2,1,1,1.1115310228308472e-05,1.1106915165381966e-05,0.5
28753,멋찜/Noun,2,1,1,1.1115310228308472e-05,1.1106915165381966e-05,0.5
28754,카론/Noun,2,1,1,1.1115310228308472e-05,1.1106915165381966e-05,0.5
28755,네트워크/Noun,2,1,1,1.1115310228308472e-05,1.1106915165381966e-05,0.5
28756,크론/Noun,2,1,1,1.1115310228308472e-05,1.1106915165381966e-05,0.5
28757,dirty/Alpha,2,1,1,1.1115310228308472e-05,1.1106915165381966e-05,0.5
28758,리심/Noun,2,1,1,1.1115310228308472e-05,1.1106915165381966e-05,0.5
28759,드래프트/Noun,2,1,1,1.1115310228308472e-05,1.1106915165381966e-05,0.5
28760,무궁무진/Noun,2,1,1,1.1115310228308472e-05,1.1106915165381966e-05,0.5
28761,350만/Number,2,1,1,1.1115310228308472e-05,1.1106915165381966e-05,0.5
28762,ㅇㄱ/KoreanParticle,2,1,1,1.1115310228308472e-05,1.1106915165381966e-05,0.5
28763,엄꼬/Noun,2,1,1,1.1115310228308472e-05,1.1106915165381966e-05,0.5
28764,버번/Noun,2,1,1,1.1115310228308472e-05,1.1106915165381966e-05,0.5
28765,벨벳/Noun,2,1,1,1.1115310228308472e-05,1.1106915165381966e-05,0.5
28766,소모품/Noun,2,1,1,1.1115310228308472e-05,1.1106915165381966e-05,0.5
28767,유퀘/Noun,2,1,1,1.1115310228308472e-05,1.1106915165381966e-05,0.5
28768,궁예/Noun,2,1,1,1.1115310228308472e-05,1.1106915165381966e-05,0.5
28769,곡예사/Noun,2,1,1,1.1115310228308472e-05,1.1106915165381966e-05,0.5
28770,장보/Noun,2,1,1,1.1115310228308472e-05,1.1106915165381966e-05,0.5
28771,성금/Noun,2,1,1,1.1115310228308472e-05,1.1106915165381966e-05,0.5
28772,적기가/Noun,2,1,1,1.1115310228308472e-05,1.1106915165381966e-05,0.5
28773,아무로/Noun,2,1,1,1.1115310228308472e-05,1.1106915165381966e-05,0.5
28774,법률/Noun,2,1,1,1.1115310228308472e-05,1.1106915165381966e-05,0.5
28775,듀엣/Noun,2,1,1,1.1115310228308472e-05,1.1106915165381966e-05,0.5
28776,모른체/Noun,2,1,1,1.1115310228308472e-05,1.1106915165381966e-05,0.5
28777,korea/Alpha,2,1,1,1.1115310228308472e-05,1.1106915165381966e-05,0.5
28778,쌔빠지/Noun,2,1,1,1.1115310228308472e-05,1.1106915165381966e-05,0.5
28779,시냐/Noun,2,1,1,1.1115310228308472e-05,1.1106915165381966e-05,0.5
28780,육신/Noun,2,1,1,1.1115310228308472e-05,1.1106915165381966e-05,0.5
28781,자토이치/Noun,2,1,1,1.1115310228308472e-05,1.1106915165381966e-05,0.5
28782,.;../Punctuation,2,1,1,1.1115310228308472e-05,1.1106915165381966e-05,0.5
28783,요타/Noun,2,1,1,1.1115310228308472e-05,1.1106915165381966e-05,0.5
28784,레이리/Noun,2,1,1,1.1115310228308472e-05,1.1106915165381966e-05,0.5
28785,해방구/Noun,2,1,1,1.1115310228308472e-05,1.1106915165381966e-05,0.5
28786,품일/Noun,2,1,1,1.1115310228308472e-05,1.1106915165381966e-05,0.5
28787,방점/Noun,2,1,1,1.1115310228308472e-05,1.1106915165381966e-05,0.5
28788,헛되이/Noun,2,1,1,1.1115310228308472e-05,1.1106915165381966e-05,0.5
28789,보채다/Verb,2,1,1,1.1115310228308472e-05,1.1106915165381966e-05,0.5
28790,전임을/Foreign,2,1,1,1.1115310228308472e-05,1.1106915165381966e-05,0.5
28791,모유/Noun,2,1,1,1.1115310228308472e-05,1.1106915165381966e-05,0.5
28792,하드락/Noun,2,1,1,1.1115310228308472e-05,1.1106915165381966e-05,0.5
28793,어쩌려/Noun,2,1,1,1.1115310228308472e-05,1.1106915165381966e-05,0.5
28794,쇄키/Noun,2,1,1,1.1115310228308472e-05,1.1106915165381966e-05,0.5
28795,키친/Noun,2,1,1,1.1115310228308472e-05,1.1106915165381966e-05,0.5
28796,북방/Noun,2,1,1,1.1115310228308472e-05,1.1106915165381966e-05,0.5
28797,뿜는데/Noun,2,1,1,1.1115310228308472e-05,1.1106915165381966e-05,0.5
28798,렛잇비/Noun,2,1,1,1.1115310228308472e-05,1.1106915165381966e-05,0.5
28799,해경/Noun,2,1,1,1.1115310228308472e-05,1.1106915165381966e-05,0.5
28800,웅얼/Noun,2,1,1,1.1115310228308472e-05,1.1106915165381966e-05,0.5
28801,밍크/Noun,2,1,1,1.1115310228308472e-05,1.1106915165381966e-05,0.5
28802,저렴/Noun,2,1,1,1.1115310228308472e-05,1.1106915165381966e-05,0.5
28803,2007/Number,2,1,1,1.1115310228308472e-05,1.1106915165381966e-05,0.5
28804,성질죽이기/Noun,2,1,1,1.1115310228308472e-05,1.1106915165381966e-05,0.5
28805,한/Foreign,2,1,1,1.1115310228308472e-05,1.1106915165381966e-05,0.5
28806,ㅇㅇㅋ/KoreanParticle,2,1,1,1.1115310228308472e-05,1.1106915165381966e-05,0.5
28807,분포도/Noun,2,1,1,1.1115310228308472e-05,1.1106915165381966e-05,0.5
28808,어쩌고저쩌고/Adverb,2,1,1,1.1115310228308472e-05,1.1106915165381966e-05,0.5
28809,때부터/Foreign,2,1,1,1.1115310228308472e-05,1.1106915165381966e-05,0.5
28810,전화통화/Noun,2,1,1,1.1115310228308472e-05,1.1106915165381966e-05,0.5
28811,개티즌/Noun,2,1,1,1.1115310228308472e-05,1.1106915165381966e-05,0.5
28812,안젤라베이비/Noun,2,1,1,1.1115310228308472e-05,1.1106915165381966e-05,0.5
28813,엔도/Noun,2,1,1,1.1115310228308472e-05,1.1106915165381966e-05,0.5
28814,절대자/Noun,2,1,1,1.1115310228308472e-05,1.1106915165381966e-05,0.5
28815,임예진/Noun,2,1,1,1.1115310228308472e-05,1.1106915165381966e-05,0.5
28816,권한/Noun,2,1,1,1.1115310228308472e-05,1.1106915165381966e-05,0.5
28817,엮이/Noun,2,1,1,1.1115310228308472e-05,1.1106915165381966e-05,0.5
28818,시영/Noun,2,1,1,1.1115310228308472e-05,1.1106915165381966e-05,0.5
28819,박영린/Noun,2,1,1,1.1115310228308472e-05,1.1106915165381966e-05,0.5
28820,사우/Noun,2,1,1,1.1115310228308472e-05,1.1106915165381966e-05,0.5
28821,인터폴/Noun,2,1,1,1.1115310228308472e-05,1.1106915165381966e-05,0.5
28822,라파스/Noun,2,1,1,1.1115310228308472e-05,1.1106915165381966e-05,0.5
28823,뚜렸하/Noun,2,1,1,1.1115310228308472e-05,1.1106915165381966e-05,0.5
28824,요법/Noun,2,1,1,1.1115310228308472e-05,1.1106915165381966e-05,0.5
28825,입생로랑/Noun,2,1,1,1.1115310228308472e-05,1.1106915165381966e-05,0.5
28826,",-/Punctuation",2,1,1,1.1115310228308472e-05,1.1106915165381966e-05,0.5
28827,야구공/Noun,2,1,1,1.1115310228308472e-05,1.1106915165381966e-05,0.5
28828,pop/Alpha,2,1,1,1.1115310228308472e-05,1.1106915165381966e-05,0.5
28829,브릭/Noun,2,1,1,1.1115310228308472e-05,1.1106915165381966e-05,0.5
28830,훅훅/Noun,2,1,1,1.1115310228308472e-05,1.1106915165381966e-05,0.5
28831,모나코/Noun,2,1,1,1.1115310228308472e-05,1.1106915165381966e-05,0.5
28832,다감/Noun,2,1,1,1.1115310228308472e-05,1.1106915165381966e-05,0.5
28833,우인태/Noun,2,1,1,1.1115310228308472e-05,1.1106915165381966e-05,0.5
28834,이장/Noun,2,1,1,1.1115310228308472e-05,1.1106915165381966e-05,0.5
28835,01/Number,2,1,1,1.1115310228308472e-05,1.1106915165381966e-05,0.5
28836,2014.10/Number,2,1,1,1.1115310228308472e-05,1.1106915165381966e-05,0.5
28837,방심/Noun,2,1,1,1.1115310228308472e-05,1.1106915165381966e-05,0.5
28838,출격/Noun,2,1,1,1.1115310228308472e-05,1.1106915165381966e-05,0.5
28839,주축/Noun,2,1,1,1.1115310228308472e-05,1.1106915165381966e-05,0.5
28840,난타/Noun,2,1,1,1.1115310228308472e-05,1.1106915165381966e-05,0.5
28841,갑질/Noun,2,1,1,1.1115310228308472e-05,1.1106915165381966e-05,0.5
28842,모레츠/Noun,2,1,1,1.1115310228308472e-05,1.1106915165381966e-05,0.5
28843,롤링스타즈/Noun,2,1,1,1.1115310228308472e-05,1.1106915165381966e-05,0.5
28844,fast/Alpha,2,1,1,1.1115310228308472e-05,1.1106915165381966e-05,0.5
28845,............................................/Punctuation,2,1,1,1.1115310228308472e-05,1.1106915165381966e-05,0.5
28846,....~~~/Punctuation,2,1,1,1.1115310228308472e-05,1.1106915165381966e-05,0.5
28847,장차/Noun,2,1,1,1.1115310228308472e-05,1.1106915165381966e-05,0.5
28848,Too/Alpha,2,1,1,1.1115310228308472e-05,1.1106915165381966e-05,0.5
28849,해크/Noun,2,1,1,1.1115310228308472e-05,1.1106915165381966e-05,0.5
28850,어설품/Noun,2,1,1,1.1115310228308472e-05,1.1106915165381966e-05,0.5
28851,원숙/Noun,2,1,1,1.1115310228308472e-05,1.1106915165381966e-05,0.5
28852,의제/Noun,2,1,1,1.1115310228308472e-05,1.1106915165381966e-05,0.5
28853,07년/Number,2,1,1,1.1115310228308472e-05,1.1106915165381966e-05,0.5
28854,때즘/Noun,2,1,1,1.1115310228308472e-05,1.1106915165381966e-05,0.5
28855,이물/Noun,2,1,1,1.1115310228308472e-05,1.1106915165381966e-05,0.5
28856,ac/Alpha,2,1,1,1.1115310228308472e-05,1.1106915165381966e-05,0.5
28857,ff/Alpha,2,1,1,1.1115310228308472e-05,1.1106915165381966e-05,0.5
28858,권율/Noun,2,1,1,1.1115310228308472e-05,1.1106915165381966e-05,0.5
28859,똘마니들/Noun,2,1,1,1.1115310228308472e-05,1.1106915165381966e-05,0.5
28860,꼬리표/Noun,2,1,1,1.1115310228308472e-05,1.1106915165381966e-05,0.5
28861,미치겄다/Noun,2,1,1,1.1115310228308472e-05,1.1106915165381966e-05,0.5
28862,명기/Noun,2,1,1,1.1115310228308472e-05,1.1106915165381966e-05,0.5
28863,오욕/Noun,2,1,1,1.1115310228308472e-05,1.1106915165381966e-05,0.5
28864,띠워/Noun,2,1,1,1.1115310228308472e-05,1.1106915165381966e-05,0.5
28865,성폭력/Noun,2,1,1,1.1115310228308472e-05,1.1106915165381966e-05,0.5
28866,표창/Noun,2,1,1,1.1115310228308472e-05,1.1106915165381966e-05,0.5
28867,김정학/Noun,2,1,1,1.1115310228308472e-05,1.1106915165381966e-05,0.5
28868,국익/Noun,2,1,1,1.1115310228308472e-05,1.1106915165381966e-05,0.5
28869,포스트모던/Noun,2,1,1,1.1115310228308472e-05,1.1106915165381966e-05,0.5
28870,ㅡㅅ/KoreanParticle,2,1,1,1.1115310228308472e-05,1.1106915165381966e-05,0.5
28871,박경림/Noun,2,1,1,1.1115310228308472e-05,1.1106915165381966e-05,0.5
28872,내연/Noun,2,1,1,1.1115310228308472e-05,1.1106915165381966e-05,0.5
28873,김영민/Noun,2,1,1,1.1115310228308472e-05,1.1106915165381966e-05,0.5
28874,이스탄불/Noun,2,1,1,1.1115310228308472e-05,1.1106915165381966e-05,0.5
28875,대왕세종/Noun,2,1,1,1.1115310228308472e-05,1.1106915165381966e-05,0.5
28876,전통문화/Noun,2,1,1,1.1115310228308472e-05,1.1106915165381966e-05,0.5
28877,귀중/Noun,2,1,1,1.1115310228308472e-05,1.1106915165381966e-05,0.5
28878,혈육/Noun,2,1,1,1.1115310228308472e-05,1.1106915165381966e-05,0.5
28879,38년/Number,2,1,1,1.1115310228308472e-05,1.1106915165381966e-05,0.5
28880,보약/Noun,2,1,1,1.1115310228308472e-05,1.1106915165381966e-05,0.5
28881,송포유/Noun,2,1,1,1.1115310228308472e-05,1.1106915165381966e-05,0.5
28882,34년/Number,2,1,1,1.1115310228308472e-05,1.1106915165381966e-05,0.5
28883,워리어스/Noun,2,1,1,1.1115310228308472e-05,1.1106915165381966e-05,0.5
28884,모형/Noun,2,1,1,1.1115310228308472e-05,1.1106915165381966e-05,0.5
28885,수녀원/Noun,2,1,1,1.1115310228308472e-05,1.1106915165381966e-05,0.5
28886,차유람/Noun,2,1,1,1.1115310228308472e-05,1.1106915165381966e-05,0.5
28887,갈고/Noun,2,1,1,1.1115310228308472e-05,1.1106915165381966e-05,0.5
28888,남아나다/Verb,2,1,1,1.1115310228308472e-05,1.1106915165381966e-05,0.5
28889,눈곱/Noun,2,1,1,1.1115310228308472e-05,1.1106915165381966e-05,0.5
28890,준드/Noun,2,1,1,1.1115310228308472e-05,1.1106915165381966e-05,0.5
28891,줄기차다/Adjective,2,1,1,1.1115310228308472e-05,1.1106915165381966e-05,0.5
28892,간걸/Noun,2,1,1,1.1115310228308472e-05,1.1106915165381966e-05,0.5
28893,고마츠/Noun,2,1,1,1.1115310228308472e-05,1.1106915165381966e-05,0.5
28894,마약범/Noun,2,1,1,1.1115310228308472e-05,1.1106915165381966e-05,0.5
28895,.+/Punctuation,2,1,1,1.1115310228308472e-05,1.1106915165381966e-05,0.5
28896,look/Alpha,2,1,1,1.1115310228308472e-05,1.1106915165381966e-05,0.5
28897,품행제로/Noun,2,1,1,1.1115310228308472e-05,1.1106915165381966e-05,0.5
28898,바악/Noun,2,1,1,1.1115310228308472e-05,1.1106915165381966e-05,0.5
28899,담배값/Noun,2,1,1,1.1115310228308472e-05,1.1106915165381966e-05,0.5
28900,권지용/Noun,2,1,1,1.1115310228308472e-05,1.1106915165381966e-05,0.5
28901,무진/Noun,2,1,1,1.1115310228308472e-05,1.1106915165381966e-05,0.5
28902,주름살/Noun,2,1,1,1.1115310228308472e-05,1.1106915165381966e-05,0.5
28903,천여/Modifier,2,1,1,1.1115310228308472e-05,1.1106915165381966e-05,0.5
28904,다재다능하다/Adjective,2,1,1,1.1115310228308472e-05,1.1106915165381966e-05,0.5
28905,~!!!!!!!!!!!!!!!!!/Punctuation,2,1,1,1.1115310228308472e-05,1.1106915165381966e-05,0.5
28906,느꼇습니/Noun,2,1,1,1.1115310228308472e-05,1.1106915165381966e-05,0.5
28907,명자/Noun,2,1,1,1.1115310228308472e-05,1.1106915165381966e-05,0.5
28908,VIP/Alpha,2,1,1,1.1115310228308472e-05,1.1106915165381966e-05,0.5
28909,86분/Number,2,1,1,1.1115310228308472e-05,1.1106915165381966e-05,0.5
28910,개암/Noun,2,1,1,1.1115310228308472e-05,1.1106915165381966e-05,0.5
28911,샌디/Noun,2,1,1,1.1115310228308472e-05,1.1106915165381966e-05,0.5
28912,오밤중/Noun,2,1,1,1.1115310228308472e-05,1.1106915165381966e-05,0.5
28913,단결/Noun,2,1,1,1.1115310228308472e-05,1.1106915165381966e-05,0.5
28914,NGC/Alpha,2,1,1,1.1115310228308472e-05,1.1106915165381966e-05,0.5
28915,실족/Noun,2,1,1,1.1115310228308472e-05,1.1106915165381966e-05,0.5
28916,채식주의자/Noun,2,1,1,1.1115310228308472e-05,1.1106915165381966e-05,0.5
28917,더블린/Noun,2,1,1,1.1115310228308472e-05,1.1106915165381966e-05,0.5
28918,Cgv/Alpha,2,1,1,1.1115310228308472e-05,1.1106915165381966e-05,0.5
28919,1~3회/Number,2,1,1,1.1115310228308472e-05,1.1106915165381966e-05,0.5
28920,증거물/Noun,2,1,1,1.1115310228308472e-05,1.1106915165381966e-05,0.5
28921,ㅔㅔㅔ/KoreanParticle,2,1,1,1.1115310228308472e-05,1.1106915165381966e-05,0.5
28922,뽀삐/Noun,2,1,1,1.1115310228308472e-05,1.1106915165381966e-05,0.5
28923,6.6/Number,2,1,1,1.1115310228308472e-05,1.1106915165381966e-05,0.5
28924,천적/Noun,2,1,1,1.1115310228308472e-05,1.1106915165381966e-05,0.5
28925,성계/Noun,2,1,1,1.1115310228308472e-05,1.1106915165381966e-05,0.5
28926,실시/Noun,2,1,1,1.1115310228308472e-05,1.1106915165381966e-05,0.5
28927,풍만/Noun,2,1,1,1.1115310228308472e-05,1.1106915165381966e-05,0.5
28928,기차씬/Noun,2,1,1,1.1115310228308472e-05,1.1106915165381966e-05,0.5
28929,대행/Noun,2,1,1,1.1115310228308472e-05,1.1106915165381966e-05,0.5
28930,장시간/Noun,2,1,1,1.1115310228308472e-05,1.1106915165381966e-05,0.5
28931,매뉴얼/Noun,2,1,1,1.1115310228308472e-05,1.1106915165381966e-05,0.5
28932,방법론/Noun,2,1,1,1.1115310228308472e-05,1.1106915165381966e-05,0.5
28933,필라/Noun,2,1,1,1.1115310228308472e-05,1.1106915165381966e-05,0.5
28934,퓨터/Noun,2,1,1,1.1115310228308472e-05,1.1106915165381966e-05,0.5
28935,진땅/Noun,2,1,1,1.1115310228308472e-05,1.1106915165381966e-05,0.5
28936,슈퍼로봇/Noun,2,1,1,1.1115310228308472e-05,1.1106915165381966e-05,0.5
28937,한과/Noun,2,1,1,1.1115310228308472e-05,1.1106915165381966e-05,0.5
28938,고자라니/Noun,2,1,1,1.1115310228308472e-05,1.1106915165381966e-05,0.5
28939,호크아이/Noun,2,1,1,1.1115310228308472e-05,1.1106915165381966e-05,0.5
28940,블랙위도우/Noun,2,1,1,1.1115310228308472e-05,1.1106915165381966e-05,0.5
28941,리애리티/Noun,2,1,1,1.1115310228308472e-05,1.1106915165381966e-05,0.5
28942,홀아비/Noun,2,1,1,1.1115310228308472e-05,1.1106915165381966e-05,0.5
28943,흑/Noun,2,1,1,1.1115310228308472e-05,1.1106915165381966e-05,0.5
28944,달님/Noun,2,1,1,1.1115310228308472e-05,1.1106915165381966e-05,0.5
28945,보슈/Noun,2,1,1,1.1115310228308472e-05,1.1106915165381966e-05,0.5
28946,내시/Noun,2,1,1,1.1115310228308472e-05,1.1106915165381966e-05,0.5
28947,주객/Noun,2,1,1,1.1115310228308472e-05,1.1106915165381966e-05,0.5
28948,교육과정/Noun,2,1,1,1.1115310228308472e-05,1.1106915165381966e-05,0.5
28949,벤다/Noun,2,1,1,1.1115310228308472e-05,1.1106915165381966e-05,0.5
28950,이야/Foreign,2,1,1,1.1115310228308472e-05,1.1106915165381966e-05,0.5
28951,1940년/Number,2,1,1,1.1115310228308472e-05,1.1106915165381966e-05,0.5
28952,간간/Noun,2,1,1,1.1115310228308472e-05,1.1106915165381966e-05,0.5
28953,줄리엔/Noun,2,1,1,1.1115310228308472e-05,1.1106915165381966e-05,0.5
28954,대후/Noun,2,1,1,1.1115310228308472e-05,1.1106915165381966e-05,0.5
28955,막간/Noun,2,1,1,1.1115310228308472e-05,1.1106915165381966e-05,0.5
28956,Crazy/Alpha,2,1,1,1.1115310228308472e-05,1.1106915165381966e-05,0.5
28957,예비역/Noun,2,1,1,1.1115310228308472e-05,1.1106915165381966e-05,0.5
28958,짝꿍/Noun,2,1,1,1.1115310228308472e-05,1.1106915165381966e-05,0.5
28959,견미리/Noun,2,1,1,1.1115310228308472e-05,1.1106915165381966e-05,0.5
28960,드문드문/Adverb,2,1,1,1.1115310228308472e-05,1.1106915165381966e-05,0.5
28961,감등/Noun,2,1,1,1.1115310228308472e-05,1.1106915165381966e-05,0.5
28962,해안선/Noun,2,1,1,1.1115310228308472e-05,1.1106915165381966e-05,0.5
28963,벽면/Noun,2,1,1,1.1115310228308472e-05,1.1106915165381966e-05,0.5
28964,개심/Noun,2,1,1,1.1115310228308472e-05,1.1106915165381966e-05,0.5
28965,폼좀/Noun,2,1,1,1.1115310228308472e-05,1.1106915165381966e-05,0.5
28966,걸왜봣/Noun,2,1,1,1.1115310228308472e-05,1.1106915165381966e-05,0.5
28967,소우/Noun,2,1,1,1.1115310228308472e-05,1.1106915165381966e-05,0.5
28968,6.66/Number,2,1,1,1.1115310228308472e-05,1.1106915165381966e-05,0.5
28969,잊혀짐/Noun,2,1,1,1.1115310228308472e-05,1.1106915165381966e-05,0.5
28970,보얗다/Adjective,2,1,1,1.1115310228308472e-05,1.1106915165381966e-05,0.5
28971,랑그/Noun,2,1,1,1.1115310228308472e-05,1.1106915165381966e-05,0.5
28972,바사라/Noun,2,1,1,1.1115310228308472e-05,1.1106915165381966e-05,0.5
28973,외관/Noun,2,1,1,1.1115310228308472e-05,1.1106915165381966e-05,0.5
28974,무전기/Noun,2,1,1,1.1115310228308472e-05,1.1106915165381966e-05,0.5
28975,연탄/Noun,2,1,1,1.1115310228308472e-05,1.1106915165381966e-05,0.5
28976,곰탱이/Noun,2,1,1,1.1115310228308472e-05,1.1106915165381966e-05,0.5
28977,빅히트/Noun,2,1,1,1.1115310228308472e-05,1.1106915165381966e-05,0.5
28978,떼쟁이/Noun,2,1,1,1.1115310228308472e-05,1.1106915165381966e-05,0.5
28979,반물질/Noun,2,1,1,1.1115310228308472e-05,1.1106915165381966e-05,0.5
28980,향후/Noun,2,1,1,1.1115310228308472e-05,1.1106915165381966e-05,0.5
28981,사부일체/Noun,2,1,1,1.1115310228308472e-05,1.1106915165381966e-05,0.5
28982,거두/Noun,2,1,1,1.1115310228308472e-05,1.1106915165381966e-05,0.5
28983,수잔서랜든/Noun,2,1,1,1.1115310228308472e-05,1.1106915165381966e-05,0.5
28984,장전/Noun,2,1,1,1.1115310228308472e-05,1.1106915165381966e-05,0.5
28985,걸봣/Noun,2,1,1,1.1115310228308472e-05,1.1106915165381966e-05,0.5
28986,뇌파/Noun,2,1,1,1.1115310228308472e-05,1.1106915165381966e-05,0.5
28987,신규/Noun,2,1,1,1.1115310228308472e-05,1.1106915165381966e-05,0.5
28988,들락거리/Noun,2,1,1,1.1115310228308472e-05,1.1106915165381966e-05,0.5
28989,저작권료/Noun,2,1,1,1.1115310228308472e-05,1.1106915165381966e-05,0.5
28990,DMX/Alpha,2,1,1,1.1115310228308472e-05,1.1106915165381966e-05,0.5
28991,플레쳐/Noun,2,1,1,1.1115310228308472e-05,1.1106915165381966e-05,0.5
28992,운용/Noun,2,1,1,1.1115310228308472e-05,1.1106915165381966e-05,0.5
28993,차장/Noun,2,1,1,1.1115310228308472e-05,1.1106915165381966e-05,0.5
28994,공법/Noun,2,1,1,1.1115310228308472e-05,1.1106915165381966e-05,0.5
28995,열한/Noun,2,1,1,1.1115310228308472e-05,1.1106915165381966e-05,0.5
28996,채닝테이텀/Noun,2,1,1,1.1115310228308472e-05,1.1106915165381966e-05,0.5
28997,엄선/Noun,2,1,1,1.1115310228308472e-05,1.1106915165381966e-05,0.5
28998,벤킹슬리/Noun,2,1,1,1.1115310228308472e-05,1.1106915165381966e-05,0.5
28999,도루/Noun,2,1,1,1.1115310228308472e-05,1.1106915165381966e-05,0.5
29000,초글링/Noun,2,1,1,1.1115310228308472e-05,1.1106915165381966e-05,0.5
29001,의거/Noun,2,1,1,1.1115310228308472e-05,1.1106915165381966e-05,0.5
29002,st/Alpha,2,1,1,1.1115310228308472e-05,1.1106915165381966e-05,0.5
29003,7.37/Number,2,1,1,1.1115310228308472e-05,1.1106915165381966e-05,0.5
29004,광어/Noun,2,1,1,1.1115310228308472e-05,1.1106915165381966e-05,0.5
29005,아나키즘/Noun,2,1,1,1.1115310228308472e-05,1.1106915165381966e-05,0.5
29006,강철의연금술사/Noun,2,1,1,1.1115310228308472e-05,1.1106915165381966e-05,0.5
29007,캔슬/Noun,2,1,1,1.1115310228308472e-05,1.1106915165381966e-05,0.5
29008,내정/Noun,2,1,1,1.1115310228308472e-05,1.1106915165381966e-05,0.5
29009,일인자/Noun,2,1,1,1.1115310228308472e-05,1.1106915165381966e-05,0.5
29010,비니/Noun,2,1,1,1.1115310228308472e-05,1.1106915165381966e-05,0.5
29011,빈도/Noun,2,1,1,1.1115310228308472e-05,1.1106915165381966e-05,0.5
29012,억만배/Noun,2,1,1,1.1115310228308472e-05,1.1106915165381966e-05,0.5
29013,................................................./Punctuation,2,1,1,1.1115310228308472e-05,1.1106915165381966e-05,0.5
29014,인륜/Noun,2,1,1,1.1115310228308472e-05,1.1106915165381966e-05,0.5
29015,기니피그/Noun,2,1,1,1.1115310228308472e-05,1.1106915165381966e-05,0.5
29016,랑/Foreign,2,1,1,1.1115310228308472e-05,1.1106915165381966e-05,0.5
29017,회고록/Noun,2,1,1,1.1115310228308472e-05,1.1106915165381966e-05,0.5
29018,국밥집/Noun,2,1,1,1.1115310228308472e-05,1.1106915165381966e-05,0.5
29019,기체/Noun,2,1,1,1.1115310228308472e-05,1.1106915165381966e-05,0.5
29020,애호가/Noun,2,1,1,1.1115310228308472e-05,1.1106915165381966e-05,0.5
29021,레밍/Noun,2,1,1,1.1115310228308472e-05,1.1106915165381966e-05,0.5
29022,전과자/Noun,2,1,1,1.1115310228308472e-05,1.1106915165381966e-05,0.5
29023,(^-^)/Punctuation,2,1,1,1.1115310228308472e-05,1.1106915165381966e-05,0.5
29024,안위/Noun,2,1,1,1.1115310228308472e-05,1.1106915165381966e-05,0.5
29025,조장혁/Noun,2,1,1,1.1115310228308472e-05,1.1106915165381966e-05,0.5
29026,nobody/Alpha,2,1,1,1.1115310228308472e-05,1.1106915165381966e-05,0.5
29027,유색인종/Noun,2,1,1,1.1115310228308472e-05,1.1106915165381966e-05,0.5
29028,산뜻/Noun,2,1,1,1.1115310228308472e-05,1.1106915165381966e-05,0.5
29029,균열/Noun,2,1,1,1.1115310228308472e-05,1.1106915165381966e-05,0.5
29030,미해결/Noun,2,1,1,1.1115310228308472e-05,1.1106915165381966e-05,0.5
29031,창궐/Noun,2,1,1,1.1115310228308472e-05,1.1106915165381966e-05,0.5
29032,ㅏㄴ/KoreanParticle,2,1,1,1.1115310228308472e-05,1.1106915165381966e-05,0.5
29033,신기하/Noun,2,1,1,1.1115310228308472e-05,1.1106915165381966e-05,0.5
29034,지성은/Noun,2,1,1,1.1115310228308472e-05,1.1106915165381966e-05,0.5
29035,세계사/Noun,2,1,1,1.1115310228308472e-05,1.1106915165381966e-05,0.5
29036,랄수/Noun,2,1,1,1.1115310228308472e-05,1.1106915165381966e-05,0.5
29037,집계/Noun,2,1,1,1.1115310228308472e-05,1.1106915165381966e-05,0.5
29038,장미정/Noun,2,1,1,1.1115310228308472e-05,1.1106915165381966e-05,0.5
29039,서바이버/Noun,2,1,1,1.1115310228308472e-05,1.1106915165381966e-05,0.5
29040,존쿠샥/Noun,2,1,1,1.1115310228308472e-05,1.1106915165381966e-05,0.5
29041,9.7/Number,2,1,1,1.1115310228308472e-05,1.1106915165381966e-05,0.5
29042,어나더데이/Noun,2,1,1,1.1115310228308472e-05,1.1106915165381966e-05,0.5
29043,Happily/Alpha,2,1,1,1.1115310228308472e-05,1.1106915165381966e-05,0.5
29044,수영복/Noun,2,1,1,1.1115310228308472e-05,1.1106915165381966e-05,0.5
29045,이공/Noun,2,1,1,1.1115310228308472e-05,1.1106915165381966e-05,0.5
29046,어뜨카/Noun,2,1,1,1.1115310228308472e-05,1.1106915165381966e-05,0.5
29047,셰릴/Noun,2,1,1,1.1115310228308472e-05,1.1106915165381966e-05,0.5
29048,휴대/Noun,2,1,1,1.1115310228308472e-05,1.1106915165381966e-05,0.5
29049,춘자/Noun,2,1,1,1.1115310228308472e-05,1.1106915165381966e-05,0.5
29050,추태/Noun,2,1,1,1.1115310228308472e-05,1.1106915165381966e-05,0.5
29051,차요/Noun,2,1,1,1.1115310228308472e-05,1.1106915165381966e-05,0.5
29052,GO/Alpha,2,1,1,1.1115310228308472e-05,1.1106915165381966e-05,0.5
29053,번보/Noun,2,1,1,1.1115310228308472e-05,1.1106915165381966e-05,0.5
29054,50만/Number,2,1,1,1.1115310228308472e-05,1.1106915165381966e-05,0.5
29055,가정교육/Noun,2,1,1,1.1115310228308472e-05,1.1106915165381966e-05,0.5
29056,방자/Noun,2,1,1,1.1115310228308472e-05,1.1106915165381966e-05,0.5
29057,".,.,.,.,./Punctuation",2,1,1,1.1115310228308472e-05,1.1106915165381966e-05,0.5
29058,비열한거리/Noun,2,1,1,1.1115310228308472e-05,1.1106915165381966e-05,0.5
29059,마음가짐/Noun,2,1,1,1.1115310228308472e-05,1.1106915165381966e-05,0.5
29060,1962년/Number,2,1,1,1.1115310228308472e-05,1.1106915165381966e-05,0.5
29061,출애굽기/Noun,2,1,1,1.1115310228308472e-05,1.1106915165381966e-05,0.5
29062,4천만/Number,2,1,1,1.1115310228308472e-05,1.1106915165381966e-05,0.5
29063,두바이/Noun,2,1,1,1.1115310228308472e-05,1.1106915165381966e-05,0.5
29064,전소민/Noun,2,1,1,1.1115310228308472e-05,1.1106915165381966e-05,0.5
29065,아름이/Noun,2,1,1,1.1115310228308472e-05,1.1106915165381966e-05,0.5
29066,꽃누나/Noun,2,1,1,1.1115310228308472e-05,1.1106915165381966e-05,0.5
29067,인품/Noun,2,1,1,1.1115310228308472e-05,1.1106915165381966e-05,0.5
29068,ㅋㅅㅋ/KoreanParticle,2,1,1,1.1115310228308472e-05,1.1106915165381966e-05,0.5
29069,예수회/Noun,2,1,1,1.1115310228308472e-05,1.1106915165381966e-05,0.5
29070,버드맨/Noun,2,1,1,1.1115310228308472e-05,1.1106915165381966e-05,0.5
29071,쫄딱망/Noun,2,1,1,1.1115310228308472e-05,1.1106915165381966e-05,0.5
29072,수주/Noun,2,1,1,1.1115310228308472e-05,1.1106915165381966e-05,0.5
29073,적역/Noun,2,1,1,1.1115310228308472e-05,1.1106915165381966e-05,0.5
29074,14일/Number,2,1,1,1.1115310228308472e-05,1.1106915165381966e-05,0.5
29075,~?!!/Punctuation,2,1,1,1.1115310228308472e-05,1.1106915165381966e-05,0.5
29076,걸루/Noun,2,1,1,1.1115310228308472e-05,1.1106915165381966e-05,0.5
29077,노심초사/Noun,2,1,1,1.1115310228308472e-05,1.1106915165381966e-05,0.5
29078,갈고리/Noun,2,1,1,1.1115310228308472e-05,1.1106915165381966e-05,0.5
29079,샤이아/Noun,2,1,1,1.1115310228308472e-05,1.1106915165381966e-05,0.5
29080,반일감정/Noun,2,1,1,1.1115310228308472e-05,1.1106915165381966e-05,0.5
29081,시민군/Noun,2,1,1,1.1115310228308472e-05,1.1106915165381966e-05,0.5
29082,괴롭힘/Noun,2,1,1,1.1115310228308472e-05,1.1106915165381966e-05,0.5
29083,강민혁/Noun,2,1,1,1.1115310228308472e-05,1.1106915165381966e-05,0.5
29084,6만/Number,2,1,1,1.1115310228308472e-05,1.1106915165381966e-05,0.5
29085,음습/Noun,2,1,1,1.1115310228308472e-05,1.1106915165381966e-05,0.5
29086,사망일/Noun,2,1,1,1.1115310228308472e-05,1.1106915165381966e-05,0.5
29087,cj/Alpha,2,1,1,1.1115310228308472e-05,1.1106915165381966e-05,0.5
29088,속눈썹/Noun,2,1,1,1.1115310228308472e-05,1.1106915165381966e-05,0.5
29089,한집안/Noun,2,1,1,1.1115310228308472e-05,1.1106915165381966e-05,0.5
29090,개토/Noun,2,1,1,1.1115310228308472e-05,1.1106915165381966e-05,0.5
29091,박광현/Noun,2,1,1,1.1115310228308472e-05,1.1106915165381966e-05,0.5
29092,Queen/Alpha,2,1,1,1.1115310228308472e-05,1.1106915165381966e-05,0.5
29093,선임/Noun,2,1,1,1.1115310228308472e-05,1.1106915165381966e-05,0.5
29094,Back/Alpha,2,1,1,1.1115310228308472e-05,1.1106915165381966e-05,0.5
29095,나눔/Noun,2,1,1,1.1115310228308472e-05,1.1106915165381966e-05,0.5
29096,제각기/Noun,2,1,1,1.1115310228308472e-05,1.1106915165381966e-05,0.5
29097,라떼/Noun,2,1,1,1.1115310228308472e-05,1.1106915165381966e-05,0.5
29098,시리우스/Noun,2,1,1,1.1115310228308472e-05,1.1106915165381966e-05,0.5
29099,~~~~~!!!/Punctuation,2,1,1,1.1115310228308472e-05,1.1106915165381966e-05,0.5
29100,theme/Alpha,2,1,1,1.1115310228308472e-05,1.1106915165381966e-05,0.5
29101,fresh/Alpha,2,1,1,1.1115310228308472e-05,1.1106915165381966e-05,0.5
29102,사바세계/Noun,2,1,1,1.1115310228308472e-05,1.1106915165381966e-05,0.5
29103,미남이시네요/Noun,2,1,1,1.1115310228308472e-05,1.1106915165381966e-05,0.5
29104,엑스칼리버/Noun,2,1,1,1.1115310228308472e-05,1.1106915165381966e-05,0.5
29105,정지우/Noun,2,1,1,1.1115310228308472e-05,1.1106915165381966e-05,0.5
29106,DNA/Alpha,2,1,1,1.1115310228308472e-05,1.1106915165381966e-05,0.5
29107,최화정/Noun,2,1,1,1.1115310228308472e-05,1.1106915165381966e-05,0.5
29108,현무/Noun,2,1,1,1.1115310228308472e-05,1.1106915165381966e-05,0.5
29109,초동/Noun,2,1,1,1.1115310228308472e-05,1.1106915165381966e-05,0.5
29110,극좌/Noun,2,1,1,1.1115310228308472e-05,1.1106915165381966e-05,0.5
29111,신나라/Noun,2,1,1,1.1115310228308472e-05,1.1106915165381966e-05,0.5
29112,Rome/Alpha,2,1,1,1.1115310228308472e-05,1.1106915165381966e-05,0.5
29113,꼴레오네/Noun,2,1,1,1.1115310228308472e-05,1.1106915165381966e-05,0.5
29114,촉박하다/Adjective,2,1,1,1.1115310228308472e-05,1.1106915165381966e-05,0.5
29115,고카이/Noun,2,1,1,1.1115310228308472e-05,1.1106915165381966e-05,0.5
29116,아파치/Noun,2,1,1,1.1115310228308472e-05,1.1106915165381966e-05,0.5
29117,9.83/Number,2,1,1,1.1115310228308472e-05,1.1106915165381966e-05,0.5
29118,브라더/Noun,2,1,1,1.1115310228308472e-05,1.1106915165381966e-05,0.5
29119,깡철이/Noun,2,1,1,1.1115310228308472e-05,1.1106915165381966e-05,0.5
29120,무통/Noun,2,1,1,1.1115310228308472e-05,1.1106915165381966e-05,0.5
29121,TBS/Alpha,2,1,1,1.1115310228308472e-05,1.1106915165381966e-05,0.5
29122,쐐기/Noun,2,1,1,1.1115310228308472e-05,1.1106915165381966e-05,0.5
29123,빌라/Noun,2,1,1,1.1115310228308472e-05,1.1106915165381966e-05,0.5
29124,오페라가수/Noun,2,1,1,1.1115310228308472e-05,1.1106915165381966e-05,0.5
29125,입속/Noun,2,1,1,1.1115310228308472e-05,1.1106915165381966e-05,0.5
29126,생로랑/Noun,2,1,1,1.1115310228308472e-05,1.1106915165381966e-05,0.5
29127,최수지/Noun,2,1,1,1.1115310228308472e-05,1.1106915165381966e-05,0.5
29128,스팟/Noun,2,1,1,1.1115310228308472e-05,1.1106915165381966e-05,0.5
29129,알짝/Noun,2,1,1,1.1115310228308472e-05,1.1106915165381966e-05,0.5
29130,아토스/Noun,2,1,1,1.1115310228308472e-05,1.1106915165381966e-05,0.5
29131,도현이/Noun,2,1,1,1.1115310228308472e-05,1.1106915165381966e-05,0.5
29132,이지만/Foreign,2,1,1,1.1115310228308472e-05,1.1106915165381966e-05,0.5
29133,탐방/Noun,2,1,1,1.1115310228308472e-05,1.1106915165381966e-05,0.5
29134,푸켓/Noun,2,1,1,1.1115310228308472e-05,1.1106915165381966e-05,0.5
29135,허억/Exclamation,2,1,1,1.1115310228308472e-05,1.1106915165381966e-05,0.5
29136,두유/Noun,2,1,1,1.1115310228308472e-05,1.1106915165381966e-05,0.5
29137,리딩/Noun,2,1,1,1.1115310228308472e-05,1.1106915165381966e-05,0.5
29138,스마/Noun,2,1,1,1.1115310228308472e-05,1.1106915165381966e-05,0.5
29139,철렁/Noun,2,1,1,1.1115310228308472e-05,1.1106915165381966e-05,0.5
29140,토닥토닥/Noun,2,1,1,1.1115310228308472e-05,1.1106915165381966e-05,0.5
29141,백작/Noun,2,1,1,1.1115310228308472e-05,1.1106915165381966e-05,0.5
29142,대성공/Noun,2,1,1,1.1115310228308472e-05,1.1106915165381966e-05,0.5
29143,천방지축/Noun,2,1,1,1.1115310228308472e-05,1.1106915165381966e-05,0.5
29144,도그마/Noun,2,1,1,1.1115310228308472e-05,1.1106915165381966e-05,0.5
29145,신용문객잔/Noun,2,1,1,1.1115310228308472e-05,1.1106915165381966e-05,0.5
29146,기태영/Noun,2,1,1,1.1115310228308472e-05,1.1106915165381966e-05,0.5
29147,업성/Noun,2,1,1,1.1115310228308472e-05,1.1106915165381966e-05,0.5
29148,알루미늄/Noun,2,1,1,1.1115310228308472e-05,1.1106915165381966e-05,0.5
29149,이하늘/Noun,2,1,1,1.1115310228308472e-05,1.1106915165381966e-05,0.5
29150,솔라리스/Noun,2,1,1,1.1115310228308472e-05,1.1106915165381966e-05,0.5
29151,당분/Noun,2,1,1,1.1115310228308472e-05,1.1106915165381966e-05,0.5
29152,!!!(/Punctuation,2,1,1,1.1115310228308472e-05,1.1106915165381966e-05,0.5
29153,동아/Noun,2,1,1,1.1115310228308472e-05,1.1106915165381966e-05,0.5
29154,??..../Punctuation,2,1,1,1.1115310228308472e-05,1.1106915165381966e-05,0.5
29155,반생/Noun,2,1,1,1.1115310228308472e-05,1.1106915165381966e-05,0.5
29156,혐일/Noun,2,1,1,1.1115310228308472e-05,1.1106915165381966e-05,0.5
29157,인서전트/Noun,2,1,1,1.1115310228308472e-05,1.1106915165381966e-05,0.5
29158,한족/Noun,2,1,1,1.1115310228308472e-05,1.1106915165381966e-05,0.5
29159,쑨원/Noun,2,1,1,1.1115310228308472e-05,1.1106915165381966e-05,0.5
29160,군벌/Noun,2,1,1,1.1115310228308472e-05,1.1106915165381966e-05,0.5
29161,잔일/Noun,2,1,1,1.1115310228308472e-05,1.1106915165381966e-05,0.5
29162,소주잔/Noun,2,1,1,1.1115310228308472e-05,1.1106915165381966e-05,0.5
29163,차곡차곡/Noun,2,1,1,1.1115310228308472e-05,1.1106915165381966e-05,0.5
29164,만이해/Noun,2,1,1,1.1115310228308472e-05,1.1106915165381966e-05,0.5
29165,뉴욕시/Noun,2,1,1,1.1115310228308472e-05,1.1106915165381966e-05,0.5
29166,햇수/Noun,2,1,1,1.1115310228308472e-05,1.1106915165381966e-05,0.5
29167,괜스레/Noun,2,1,1,1.1115310228308472e-05,1.1106915165381966e-05,0.5
29168,1001/Number,2,1,1,1.1115310228308472e-05,1.1106915165381966e-05,0.5
29169,변영주/Noun,2,1,1,1.1115310228308472e-05,1.1106915165381966e-05,0.5
29170,프릭스/Noun,2,1,1,1.1115310228308472e-05,1.1106915165381966e-05,0.5
29171,ㅈㄱ/KoreanParticle,2,1,1,1.1115310228308472e-05,1.1106915165381966e-05,0.5
29172,민수형/Noun,2,1,1,1.1115310228308472e-05,1.1106915165381966e-05,0.5
29173,에머슨/Noun,2,1,1,1.1115310228308472e-05,1.1106915165381966e-05,0.5
29174,네코/Noun,2,1,1,1.1115310228308472e-05,1.1106915165381966e-05,0.5
29175,약초/Noun,2,1,1,1.1115310228308472e-05,1.1106915165381966e-05,0.5
29176,칵테일/Noun,2,1,1,1.1115310228308472e-05,1.1106915165381966e-05,0.5
29177,엄브릿지/Noun,2,1,1,1.1115310228308472e-05,1.1106915165381966e-05,0.5
29178,합격자/Noun,2,1,1,1.1115310228308472e-05,1.1106915165381966e-05,0.5
29179,서산/Noun,2,1,1,1.1115310228308472e-05,1.1106915165381966e-05,0.5
29180,응응/Adverb,2,1,1,1.1115310228308472e-05,1.1106915165381966e-05,0.5
29181,에크/Exclamation,2,1,1,1.1115310228308472e-05,1.1106915165381966e-05,0.5
29182,전등/Noun,2,1,1,1.1115310228308472e-05,1.1106915165381966e-05,0.5
29183,슈미트/Noun,2,1,1,1.1115310228308472e-05,1.1106915165381966e-05,0.5
29184,상여/Noun,2,1,1,1.1115310228308472e-05,1.1106915165381966e-05,0.5
29185,크레인/Noun,2,1,1,1.1115310228308472e-05,1.1106915165381966e-05,0.5
29186,넷이/Noun,2,1,1,1.1115310228308472e-05,1.1106915165381966e-05,0.5
29187,문재인/Noun,2,1,1,1.1115310228308472e-05,1.1106915165381966e-05,0.5
29188,야금야금/Adverb,2,1,1,1.1115310228308472e-05,1.1106915165381966e-05,0.5
29189,앙큼하다/Adjective,2,1,1,1.1115310228308472e-05,1.1106915165381966e-05,0.5
29190,못햇/Noun,2,1,1,1.1115310228308472e-05,1.1106915165381966e-05,0.5
29191,장첸/Noun,2,1,1,1.1115310228308472e-05,1.1106915165381966e-05,0.5
29192,아릴/Noun,2,1,1,1.1115310228308472e-05,1.1106915165381966e-05,0.5
29193,뻘쭘/Noun,2,1,1,1.1115310228308472e-05,1.1106915165381966e-05,0.5
29194,세실리아/Noun,2,1,1,1.1115310228308472e-05,1.1106915165381966e-05,0.5
29195,2013.07/Number,2,1,1,1.1115310228308472e-05,1.1106915165381966e-05,0.5
29196,사강/Noun,2,1,1,1.1115310228308472e-05,1.1106915165381966e-05,0.5
29197,염정/Noun,2,1,1,1.1115310228308472e-05,1.1106915165381966e-05,0.5
29198,칠검/Noun,2,1,1,1.1115310228308472e-05,1.1106915165381966e-05,0.5
29199,낚일순없/Noun,2,1,1,1.1115310228308472e-05,1.1106915165381966e-05,0.5
29200,사마의/Noun,2,1,1,1.1115310228308472e-05,1.1106915165381966e-05,0.5
29201,기행/Noun,2,1,1,1.1115310228308472e-05,1.1106915165381966e-05,0.5
29202,부풀다/Verb,2,1,1,1.1115310228308472e-05,1.1106915165381966e-05,0.5
29203,강두/Noun,2,1,1,1.1115310228308472e-05,1.1106915165381966e-05,0.5
29204,훈수/Noun,2,1,1,1.1115310228308472e-05,1.1106915165381966e-05,0.5
29205,봉창/Noun,2,1,1,1.1115310228308472e-05,1.1106915165381966e-05,0.5
29206,개학/Noun,2,1,1,1.1115310228308472e-05,1.1106915165381966e-05,0.5
29207,재간둥이/Noun,2,1,1,1.1115310228308472e-05,1.1106915165381966e-05,0.5
29208,궁핍하다/Adjective,2,1,1,1.1115310228308472e-05,1.1106915165381966e-05,0.5
29209,지하세계/Noun,2,1,1,1.1115310228308472e-05,1.1106915165381966e-05,0.5
29210,토머스/Noun,2,1,1,1.1115310228308472e-05,1.1106915165381966e-05,0.5
29211,Come/Alpha,2,1,1,1.1115310228308472e-05,1.1106915165381966e-05,0.5
29212,송병준/Noun,2,1,1,1.1115310228308472e-05,1.1106915165381966e-05,0.5
29213,닭목/Noun,2,1,1,1.1115310228308472e-05,1.1106915165381966e-05,0.5
29214,망할삘/Noun,2,1,1,1.1115310228308472e-05,1.1106915165381966e-05,0.5
29215,돌프룬드그렌/Noun,2,1,1,1.1115310228308472e-05,1.1106915165381966e-05,0.5
29216,단무지/Noun,2,1,1,1.1115310228308472e-05,1.1106915165381966e-05,0.5
29217,고물/Noun,2,1,1,1.1115310228308472e-05,1.1106915165381966e-05,0.5
29218,신곡/Noun,2,1,1,1.1115310228308472e-05,1.1106915165381966e-05,0.5
29219,올드스쿨/Noun,2,1,1,1.1115310228308472e-05,1.1106915165381966e-05,0.5
29220,김희원/Noun,2,1,1,1.1115310228308472e-05,1.1106915165381966e-05,0.5
29221,고혈압/Noun,2,1,1,1.1115310228308472e-05,1.1106915165381966e-05,0.5
29222,콜튼/Noun,2,1,1,1.1115310228308472e-05,1.1106915165381966e-05,0.5
29223,음악상/Noun,2,1,1,1.1115310228308472e-05,1.1106915165381966e-05,0.5
29224,드라고/Noun,2,1,1,1.1115310228308472e-05,1.1106915165381966e-05,0.5
29225,마지노선/Noun,2,1,1,1.1115310228308472e-05,1.1106915165381966e-05,0.5
29226,!~~~~/Punctuation,2,1,1,1.1115310228308472e-05,1.1106915165381966e-05,0.5
29227,커크/Noun,2,1,1,1.1115310228308472e-05,1.1106915165381966e-05,0.5
29228,에블/Noun,2,1,1,1.1115310228308472e-05,1.1106915165381966e-05,0.5
29229,뼛속/Noun,2,1,1,1.1115310228308472e-05,1.1106915165381966e-05,0.5
29230,실타레/Noun,2,1,1,1.1115310228308472e-05,1.1106915165381966e-05,0.5
29231,문턱/Noun,2,1,1,1.1115310228308472e-05,1.1106915165381966e-05,0.5
29232,부채질/Noun,2,1,1,1.1115310228308472e-05,1.1106915165381966e-05,0.5
29233,이준혁/Noun,2,1,1,1.1115310228308472e-05,1.1106915165381966e-05,0.5
29234,적적/Noun,2,1,1,1.1115310228308472e-05,1.1106915165381966e-05,0.5
29235,티드/Noun,2,1,1,1.1115310228308472e-05,1.1106915165381966e-05,0.5
29236,격투가/Noun,2,1,1,1.1115310228308472e-05,1.1106915165381966e-05,0.5
29237,미진하다/Adjective,2,1,1,1.1115310228308472e-05,1.1106915165381966e-05,0.5
29238,투정/Noun,2,1,1,1.1115310228308472e-05,1.1106915165381966e-05,0.5
29239,심호/Noun,2,1,1,1.1115310228308472e-05,1.1106915165381966e-05,0.5
29240,클라인/Noun,2,1,1,1.1115310228308472e-05,1.1106915165381966e-05,0.5
29241,대관/Noun,2,1,1,1.1115310228308472e-05,1.1106915165381966e-05,0.5
29242,아지트/Noun,2,1,1,1.1115310228308472e-05,1.1106915165381966e-05,0.5
29243,은거/Noun,2,1,1,1.1115310228308472e-05,1.1106915165381966e-05,0.5
29244,마티유/Noun,2,1,1,1.1115310228308472e-05,1.1106915165381966e-05,0.5
29245,고기만/Noun,2,1,1,1.1115310228308472e-05,1.1106915165381966e-05,0.5
29246,밎/Noun,2,1,1,1.1115310228308472e-05,1.1106915165381966e-05,0.5
29247,".,?/Punctuation",2,1,1,1.1115310228308472e-05,1.1106915165381966e-05,0.5
29248,픽쳐스/Noun,2,1,1,1.1115310228308472e-05,1.1106915165381966e-05,0.5
29249,명맥/Noun,2,1,1,1.1115310228308472e-05,1.1106915165381966e-05,0.5
29250,(...)/Punctuation,2,1,1,1.1115310228308472e-05,1.1106915165381966e-05,0.5
29251,불미/Noun,2,1,1,1.1115310228308472e-05,1.1106915165381966e-05,0.5
29252,꽃할배/Noun,2,1,1,1.1115310228308472e-05,1.1106915165381966e-05,0.5
29253,가오리/Noun,2,1,1,1.1115310228308472e-05,1.1106915165381966e-05,0.5
29254,미음/Noun,2,1,1,1.1115310228308472e-05,1.1106915165381966e-05,0.5
29255,날자/Noun,2,1,1,1.1115310228308472e-05,1.1106915165381966e-05,0.5
29256,양은용/Noun,2,1,1,1.1115310228308472e-05,1.1106915165381966e-05,0.5
29257,유지됨/Noun,2,1,1,1.1115310228308472e-05,1.1106915165381966e-05,0.5
29258,동욱/Noun,2,1,1,1.1115310228308472e-05,1.1106915165381966e-05,0.5
29259,전무송/Noun,2,1,1,1.1115310228308472e-05,1.1106915165381966e-05,0.5
29260,낙관/Noun,2,1,1,1.1115310228308472e-05,1.1106915165381966e-05,0.5
29261,민생/Noun,2,1,1,1.1115310228308472e-05,1.1106915165381966e-05,0.5
29262,인중/Noun,2,1,1,1.1115310228308472e-05,1.1106915165381966e-05,0.5
29263,콜로/Noun,2,1,1,1.1115310228308472e-05,1.1106915165381966e-05,0.5
29264,시트론/Noun,2,1,1,1.1115310228308472e-05,1.1106915165381966e-05,0.5
29265,권택/Noun,2,1,1,1.1115310228308472e-05,1.1106915165381966e-05,0.5
29266,어항/Noun,2,1,1,1.1115310228308472e-05,1.1106915165381966e-05,0.5
29267,텔레비/Noun,2,1,1,1.1115310228308472e-05,1.1106915165381966e-05,0.5
29268,어랏/Noun,2,1,1,1.1115310228308472e-05,1.1106915165381966e-05,0.5
29269,뛰어놀다/Verb,2,1,1,1.1115310228308472e-05,1.1106915165381966e-05,0.5
29270,비아그라/Noun,2,1,1,1.1115310228308472e-05,1.1106915165381966e-05,0.5
29271,웨형/Noun,2,1,1,1.1115310228308472e-05,1.1106915165381966e-05,0.5
29272,공정/Noun,2,1,1,1.1115310228308472e-05,1.1106915165381966e-05,0.5
29273,조미령/Noun,2,1,1,1.1115310228308472e-05,1.1106915165381966e-05,0.5
29274,하명중/Noun,2,1,1,1.1115310228308472e-05,1.1106915165381966e-05,0.5
29275,Fuck/Alpha,2,1,1,1.1115310228308472e-05,1.1106915165381966e-05,0.5
29276,대라는/Foreign,2,1,1,1.1115310228308472e-05,1.1106915165381966e-05,0.5
29277,한명인/Noun,2,1,1,1.1115310228308472e-05,1.1106915165381966e-05,0.5
29278,지난/Foreign,2,1,1,1.1115310228308472e-05,1.1106915165381966e-05,0.5
29279,은덕/Noun,1,0,1,0.0,1.1106915165381966e-05,1.0
29280,거슬러듣/Noun,1,0,1,0.0,1.1106915165381966e-05,1.0
29281,Awesome/Alpha,1,1,0,1.1115310228308472e-05,0.0,1.0
29282,선선/Noun,1,1,0,1.1115310228308472e-05,0.0,1.0
29283,밑엣놈/Noun,1,0,1,0.0,1.1106915165381966e-05,1.0
29284,보려느/Noun,1,0,1,0.0,1.1106915165381966e-05,1.0
29285,느굿굿/Noun,1,1,0,1.1115310228308472e-05,0.0,1.0
29286,싯달/Noun,1,1,0,1.1115310228308472e-05,0.0,1.0
29287,아장아장/Adverb,1,0,1,0.0,1.1106915165381966e-05,1.0
29288,고창/Noun,1,0,1,0.0,1.1106915165381966e-05,1.0
29289,갈현/Noun,1,0,1,0.0,1.1106915165381966e-05,1.0
29290,살타/Noun,1,0,1,0.0,1.1106915165381966e-05,1.0
29291,괞찬길/Noun,1,0,1,0.0,1.1106915165381966e-05,1.0
29292,생경/Noun,1,0,1,0.0,1.1106915165381966e-05,1.0
29293,론펄/Noun,1,1,0,1.1115310228308472e-05,0.0,1.0
29294,이확/Noun,1,1,0,1.1115310228308472e-05,0.0,1.0
29295,용례/Noun,1,0,1,0.0,1.1106915165381966e-05,1.0
29296,오용/Noun,1,0,1,0.0,1.1106915165381966e-05,1.0
29297,교도관/Noun,1,0,1,0.0,1.1106915165381966e-05,1.0
29298,폼나/Noun,1,1,0,1.1115310228308472e-05,0.0,1.0
29299,understanding/Alpha,1,1,0,1.1115310228308472e-05,0.0,1.0
29300,complete/Alpha,1,1,0,1.1115310228308472e-05,0.0,1.0
29301,진좀/Noun,1,1,0,1.1115310228308472e-05,0.0,1.0
29302,이즈리얼/Noun,1,0,1,0.0,1.1106915165381966e-05,1.0
29303,마고리엄/Noun,1,1,0,1.1115310228308472e-05,0.0,1.0
29304,진오/Noun,1,1,0,1.1115310228308472e-05,0.0,1.0
29305,방송이오니/Foreign,1,1,0,1.1115310228308472e-05,0.0,1.0
29306,우민화/Noun,1,0,1,0.0,1.1106915165381966e-05,1.0
29307,MMORGP/Alpha,1,0,1,0.0,1.1106915165381966e-05,1.0
29308,",;/Punctuation",1,0,1,0.0,1.1106915165381966e-05,1.0
29309,땐꽤/Noun,1,0,1,0.0,1.1106915165381966e-05,1.0
29310,비지/Noun,1,0,1,0.0,1.1106915165381966e-05,1.0
29311,통디/Noun,1,0,1,0.0,1.1106915165381966e-05,1.0
29312,난창/Noun,1,0,1,0.0,1.1106915165381966e-05,1.0
29313,햄스터/Noun,1,1,0,1.1115310228308472e-05,0.0,1.0
29314,불위/Noun,1,0,1,0.0,1.1106915165381966e-05,1.0
29315,**^^*/Punctuation,1,1,0,1.1115310228308472e-05,0.0,1.0
29316,Files/Alpha,1,0,1,0.0,1.1106915165381966e-05,1.0
29317,가자지구/Noun,1,0,1,0.0,1.1106915165381966e-05,1.0
29318,저먼/Noun,1,0,1,0.0,1.1106915165381966e-05,1.0
29319,논리학/Noun,1,1,0,1.1115310228308472e-05,0.0,1.0
29320,버시/Noun,1,0,1,0.0,1.1106915165381966e-05,1.0
29321,더준놈/Noun,1,0,1,0.0,1.1106915165381966e-05,1.0
29322,버프해/Noun,1,0,1,0.0,1.1106915165381966e-05,1.0
29323,나왓단거/Noun,1,0,1,0.0,1.1106915165381966e-05,1.0
29324,썩혔다/Noun,1,0,1,0.0,1.1106915165381966e-05,1.0
29325,아릿/Noun,1,1,0,1.1115310228308472e-05,0.0,1.0
29326,거스트/Noun,1,1,0,1.1115310228308472e-05,0.0,1.0
29327,걸걸하다/Adjective,1,0,1,0.0,1.1106915165381966e-05,1.0
29328,한순/Noun,1,0,1,0.0,1.1106915165381966e-05,1.0
29329,...>__/Punctuation,1,1,0,1.1115310228308472e-05,0.0,1.0
29330,국궁/Noun,1,1,0,1.1115310228308472e-05,0.0,1.0
29331,황천/Noun,1,1,0,1.1115310228308472e-05,0.0,1.0
29332,점었/Noun,1,0,1,0.0,1.1106915165381966e-05,1.0
29333,바싹/Noun,1,0,1,0.0,1.1106915165381966e-05,1.0
29334,김정난/Noun,1,1,0,1.1115310228308472e-05,0.0,1.0
29335,거래소/Noun,1,1,0,1.1115310228308472e-05,0.0,1.0
29336,증시/Noun,1,1,0,1.1115310228308472e-05,0.0,1.0
29337,은안/Noun,1,1,0,1.1115310228308472e-05,0.0,1.0
29338,지수현/Noun,1,1,0,1.1115310228308472e-05,0.0,1.0
29339,인지상정/Noun,1,0,1,0.0,1.1106915165381966e-05,1.0
29340,비듬/Noun,1,0,1,0.0,1.1106915165381966e-05,1.0
29341,암내/Noun,1,0,1,0.0,1.1106915165381966e-05,1.0
29342,땟국/Noun,1,0,1,0.0,1.1106915165381966e-05,1.0
29343,위기탈출넘버원/Noun,1,0,1,0.0,1.1106915165381966e-05,1.0
29344,어쩜이러/Noun,1,0,1,0.0,1.1106915165381966e-05,1.0
29345,쓰렉빠같/Noun,1,0,1,0.0,1.1106915165381966e-05,1.0
29346,말안/Noun,1,0,1,0.0,1.1106915165381966e-05,1.0
29347,..?-/Punctuation,1,0,1,0.0,1.1106915165381966e-05,1.0
29348,꼽추/Noun,1,0,1,0.0,1.1106915165381966e-05,1.0
29349,서림/Noun,1,1,0,1.1115310228308472e-05,0.0,1.0
29350,건사/Noun,1,1,0,1.1115310228308472e-05,0.0,1.0
29351,괴변/Noun,1,0,1,0.0,1.1106915165381966e-05,1.0
29352,PoP/Alpha,1,1,0,1.1115310228308472e-05,0.0,1.0
29353,퍼온말/Noun,1,1,0,1.1115310228308472e-05,0.0,1.0
29354,기업가/Noun,1,0,1,0.0,1.1106915165381966e-05,1.0
29355,좌선/Noun,1,0,1,0.0,1.1106915165381966e-05,1.0
29356,반시민/Noun,1,0,1,0.0,1.1106915165381966e-05,1.0
29357,법학/Noun,1,0,1,0.0,1.1106915165381966e-05,1.0
29358,9112012/Number,1,1,0,1.1115310228308472e-05,0.0,1.0
29359,핼기씬/Noun,1,1,0,1.1115310228308472e-05,0.0,1.0
29360,항주/Noun,1,0,1,0.0,1.1106915165381966e-05,1.0
29361,알티/Noun,1,1,0,1.1115310228308472e-05,0.0,1.0
29362,좉같/Noun,1,1,0,1.1115310228308472e-05,0.0,1.0
29363,린단/Noun,1,1,0,1.1115310228308472e-05,0.0,1.0
29364,전고/Foreign,1,1,0,1.1115310228308472e-05,0.0,1.0
29365,츄파/Noun,1,0,1,0.0,1.1106915165381966e-05,1.0
29366,붕떠/Noun,1,1,0,1.1115310228308472e-05,0.0,1.0
29367,좀옴/Noun,1,0,1,0.0,1.1106915165381966e-05,1.0
29368,3134/Number,1,1,0,1.1115310228308472e-05,0.0,1.0
29369,kan/Alpha,1,1,0,1.1115310228308472e-05,0.0,1.0
29370,책책책/Noun,1,0,1,0.0,1.1106915165381966e-05,1.0
29371,신종/Noun,1,1,0,1.1115310228308472e-05,0.0,1.0
29372,볼겸/Noun,1,1,0,1.1115310228308472e-05,0.0,1.0
29373,원자력/Noun,1,1,0,1.1115310228308472e-05,0.0,1.0
29374,발에밟힌/Noun,1,1,0,1.1115310228308472e-05,0.0,1.0
29375,고진화/Noun,1,1,0,1.1115310228308472e-05,0.0,1.0
29376,삭막/Noun,1,0,1,0.0,1.1106915165381966e-05,1.0
29377,어눌언/Noun,1,0,1,0.0,1.1106915165381966e-05,1.0
29378,목포역/Noun,1,1,0,1.1115310228308472e-05,0.0,1.0
29379,목포고/Noun,1,1,0,1.1115310228308472e-05,0.0,1.0
29380,괴연/Noun,1,1,0,1.1115310228308472e-05,0.0,1.0
29381,짬좀/Noun,1,1,0,1.1115310228308472e-05,0.0,1.0
29382,맺혔/Noun,1,1,0,1.1115310228308472e-05,0.0,1.0
29383,타카피/Noun,1,1,0,1.1115310228308472e-05,0.0,1.0
29384,쫌있으/Noun,1,0,1,0.0,1.1106915165381966e-05,1.0
29385,날리는거지/Foreign,1,0,1,0.0,1.1106915165381966e-05,1.0
29386,가슴떄문/Noun,1,1,0,1.1115310228308472e-05,0.0,1.0
29387,아씌/Noun,1,1,0,1.1115310228308472e-05,0.0,1.0
29388,2222222/Number,1,1,0,1.1115310228308472e-05,0.0,1.0
29389,월컴투더/Noun,1,0,1,0.0,1.1106915165381966e-05,1.0
29390,몸조리/Noun,1,0,1,0.0,1.1106915165381966e-05,1.0
29391,사활/Noun,1,1,0,1.1115310228308472e-05,0.0,1.0
29392,aozora/Alpha,1,1,0,1.1115310228308472e-05,0.0,1.0
29393,bibo/Alpha,1,1,0,1.1115310228308472e-05,0.0,1.0
29394,깄/Noun,1,0,1,0.0,1.1106915165381966e-05,1.0
29395,곪음/Noun,1,1,0,1.1115310228308472e-05,0.0,1.0
29396,신론/Noun,1,0,1,0.0,1.1106915165381966e-05,1.0
29397,엄철/Noun,1,1,0,1.1115310228308472e-05,0.0,1.0
29398,에드는드라마/Foreign,1,1,0,1.1115310228308472e-05,0.0,1.0
29399,400%/Number,1,0,1,0.0,1.1106915165381966e-05,1.0
29400,점슛/Noun,1,1,0,1.1115310228308472e-05,0.0,1.0
29401,!!!???/Punctuation,1,0,1,0.0,1.1106915165381966e-05,1.0
29402,계집애/Noun,1,0,1,0.0,1.1106915165381966e-05,1.0
29403,간닼/Noun,1,0,1,0.0,1.1106915165381966e-05,1.0
29404,awsome/Alpha,1,1,0,1.1115310228308472e-05,0.0,1.0
29405,ㄱㄹ/KoreanParticle,1,0,1,0.0,1.1106915165381966e-05,1.0
29406,MASTERPIECE/Alpha,1,1,0,1.1115310228308472e-05,0.0,1.0
29407,괸찬은댕/Noun,1,1,0,1.1115310228308472e-05,0.0,1.0
29408,건카타/Noun,1,1,0,1.1115310228308472e-05,0.0,1.0
29409,니코니/Noun,1,1,0,1.1115310228308472e-05,0.0,1.0
29410,케빈횽/Noun,1,0,1,0.0,1.1106915165381966e-05,1.0
29411,어앙/Noun,1,1,0,1.1115310228308472e-05,0.0,1.0
29412,쯧쯗/Noun,1,0,1,0.0,1.1106915165381966e-05,1.0
29413,<---/Punctuation,1,0,1,0.0,1.1106915165381966e-05,1.0
29414,79/Number,1,0,1,0.0,1.1106915165381966e-05,1.0
29415,철스/Noun,1,0,1,0.0,1.1106915165381966e-05,1.0
29416,않드/Noun,1,0,1,0.0,1.1106915165381966e-05,1.0
29417,..-_-?/Punctuation,1,0,1,0.0,1.1106915165381966e-05,1.0
29418,나애리/Noun,1,0,1,0.0,1.1106915165381966e-05,1.0
29419,DEA/Alpha,1,0,1,0.0,1.1106915165381966e-05,1.0
29420,대인기피증/Noun,1,0,1,0.0,1.1106915165381966e-05,1.0
29421,거찌/Noun,1,0,1,0.0,1.1106915165381966e-05,1.0
29422,슈레더/Noun,1,0,1,0.0,1.1106915165381966e-05,1.0
29423,계약해지/Noun,1,0,1,0.0,1.1106915165381966e-05,1.0
29424,은연중/Noun,1,1,0,1.1115310228308472e-05,0.0,1.0
29425,뿡뿡뿌/Noun,1,0,1,0.0,1.1106915165381966e-05,1.0
29426,제레마/Noun,1,0,1,0.0,1.1106915165381966e-05,1.0
29427,백석/Noun,1,0,1,0.0,1.1106915165381966e-05,1.0
29428,그늠/Noun,1,0,1,0.0,1.1106915165381966e-05,1.0
29429,지송/Noun,1,0,1,0.0,1.1106915165381966e-05,1.0
29430,아쟈씨/Noun,1,1,0,1.1115310228308472e-05,0.0,1.0
29431,한껃/Noun,1,0,1,0.0,1.1106915165381966e-05,1.0
29432,쉐도우/Noun,1,1,0,1.1115310228308472e-05,0.0,1.0
29433,코드네임/Noun,1,1,0,1.1115310228308472e-05,0.0,1.0
29434,볼루/Noun,1,0,1,0.0,1.1106915165381966e-05,1.0
29435,모던패밀리/Noun,1,0,1,0.0,1.1106915165381966e-05,1.0
29436,점잖다/Adjective,1,1,0,1.1115310228308472e-05,0.0,1.0
29437,산발/Noun,1,1,0,1.1115310228308472e-05,0.0,1.0
29438,패숀/Noun,1,1,0,1.1115310228308472e-05,0.0,1.0
29439,tas/Alpha,1,0,1,0.0,1.1106915165381966e-05,1.0
29440,bak/Alpha,1,0,1,0.0,1.1106915165381966e-05,1.0
29441,민쥬당/Noun,1,1,0,1.1115310228308472e-05,0.0,1.0
29442,ㅠㅋㅋㅋ/KoreanParticle,1,1,0,1.1115310228308472e-05,0.0,1.0
29443,계속쭈욱햇으/Noun,1,1,0,1.1115310228308472e-05,0.0,1.0
29444,완줜/Noun,1,1,0,1.1115310228308472e-05,0.0,1.0
29445,유세영/Noun,1,1,0,1.1115310228308472e-05,0.0,1.0
29446,차석/Noun,1,1,0,1.1115310228308472e-05,0.0,1.0
29447,모터/Noun,1,1,0,1.1115310228308472e-05,0.0,1.0
29448,돌렷/Noun,1,0,1,0.0,1.1106915165381966e-05,1.0
29449,엄썻/Noun,1,0,1,0.0,1.1106915165381966e-05,1.0
29450,유신론/Noun,1,0,1,0.0,1.1106915165381966e-05,1.0
29451,압정/Noun,1,0,1,0.0,1.1106915165381966e-05,1.0
29452,./_/_/Punctuation,1,1,0,1.1115310228308472e-05,0.0,1.0
29453,조위횽/Noun,1,1,0,1.1115310228308472e-05,0.0,1.0
29454,생이었다니/Foreign,1,0,1,0.0,1.1106915165381966e-05,1.0
29455,glee/Alpha,1,0,1,0.0,1.1106915165381966e-05,1.0
29456,아낫/Noun,1,0,1,0.0,1.1106915165381966e-05,1.0
29457,솔말/Noun,1,0,1,0.0,1.1106915165381966e-05,1.0
29458,타다노/Noun,1,1,0,1.1115310228308472e-05,0.0,1.0
29459,저화질/Noun,1,1,0,1.1115310228308472e-05,0.0,1.0
29460,^.*/Punctuation,1,1,0,1.1115310228308472e-05,0.0,1.0
29461,청년실업/Noun,1,0,1,0.0,1.1106915165381966e-05,1.0
29462,참이슬/Noun,1,1,0,1.1115310228308472e-05,0.0,1.0
29463,터터/Noun,1,1,0,1.1115310228308472e-05,0.0,1.0
29464,ㅛㄷ/KoreanParticle,1,1,0,1.1115310228308472e-05,0.0,1.0
29465,뮤뇨/Noun,1,1,0,1.1115310228308472e-05,0.0,1.0
29466,강연정/Noun,1,1,0,1.1115310228308472e-05,0.0,1.0
29467,혼인신고/Noun,1,0,1,0.0,1.1106915165381966e-05,1.0
29468,링거액/Noun,1,0,1,0.0,1.1106915165381966e-05,1.0
29469,Fly/Alpha,1,1,0,1.1115310228308472e-05,0.0,1.0
29470,읺/Noun,1,0,1,0.0,1.1106915165381966e-05,1.0
29471,2엔/Number,1,1,0,1.1115310228308472e-05,0.0,1.0
29472,.~~~~~/Punctuation,1,1,0,1.1115310228308472e-05,0.0,1.0
29473,Serious/Alpha,1,1,0,1.1115310228308472e-05,0.0,1.0
29474,도뻥/Noun,1,1,0,1.1115310228308472e-05,0.0,1.0
29475,완죤이쁘더/Noun,1,0,1,0.0,1.1106915165381966e-05,1.0
29476,8.77/Number,1,1,0,1.1115310228308472e-05,0.0,1.0
29477,핵페/Noun,1,0,1,0.0,1.1106915165381966e-05,1.0
29478,창란/Noun,1,0,1,0.0,1.1106915165381966e-05,1.0
29479,깔따구/Noun,1,0,1,0.0,1.1106915165381966e-05,1.0
29480,Persuit/Alpha,1,1,0,1.1115310228308472e-05,0.0,1.0
29481,Hot/Alpha,1,1,0,1.1115310228308472e-05,0.0,1.0
29482,리얼타임/Noun,1,1,0,1.1115310228308472e-05,0.0,1.0
29483,공화정/Noun,1,1,0,1.1115310228308472e-05,0.0,1.0
29484,감지/Noun,1,1,0,1.1115310228308472e-05,0.0,1.0
29485,쪼록/Adverb,1,1,0,1.1115310228308472e-05,0.0,1.0
29486,쥬니/Noun,1,0,1,0.0,1.1106915165381966e-05,1.0
29487,다웠던/Noun,1,1,0,1.1115310228308472e-05,0.0,1.0
29488,편도봣엇/Noun,1,1,0,1.1115310228308472e-05,0.0,1.0
29489,꼴칰/Noun,1,0,1,0.0,1.1106915165381966e-05,1.0
29490,이라는거/Foreign,1,0,1,0.0,1.1106915165381966e-05,1.0
29491,1200만/Number,1,0,1,0.0,1.1106915165381966e-05,1.0
29492,야생마/Noun,1,1,0,1.1115310228308472e-05,0.0,1.0
29493,냇가/Noun,1,1,0,1.1115310228308472e-05,0.0,1.0
29494,연소/Noun,1,1,0,1.1115310228308472e-05,0.0,1.0
29495,흐졉/Noun,1,0,1,0.0,1.1106915165381966e-05,1.0
29496,수혜/Noun,1,0,1,0.0,1.1106915165381966e-05,1.0
29497,쌀싸름/Noun,1,1,0,1.1115310228308472e-05,0.0,1.0
29498,동일인/Noun,1,1,0,1.1115310228308472e-05,0.0,1.0
29499,Mind/Alpha,1,1,0,1.1115310228308472e-05,0.0,1.0
29500,뤽베쏭/Noun,1,0,1,0.0,1.1106915165381966e-05,1.0
29501,사성/Noun,1,1,0,1.1115310228308472e-05,0.0,1.0
29502,느드르므브/Noun,1,1,0,1.1115310228308472e-05,0.0,1.0
29503,드으므/Noun,1,1,0,1.1115310228308472e-05,0.0,1.0
29504,페이턴/Noun,1,1,0,1.1115310228308472e-05,0.0,1.0
29505,해저드/Noun,1,0,1,0.0,1.1106915165381966e-05,1.0
29506,우이/Noun,1,0,1,0.0,1.1106915165381966e-05,1.0
29507,오스트/Noun,1,1,0,1.1115310228308472e-05,0.0,1.0
29508,가락/Noun,1,0,1,0.0,1.1106915165381966e-05,1.0
29509,액숀들/Noun,1,1,0,1.1115310228308472e-05,0.0,1.0
29510,영안/Noun,1,1,0,1.1115310228308472e-05,0.0,1.0
29511,제상/Noun,1,1,0,1.1115310228308472e-05,0.0,1.0
29512,북두신권/Noun,1,0,1,0.0,1.1106915165381966e-05,1.0
29513,Belong/Alpha,1,1,0,1.1115310228308472e-05,0.0,1.0
29514,김기호/Noun,1,1,0,1.1115310228308472e-05,0.0,1.0
29515,whgek/Alpha,1,1,0,1.1115310228308472e-05,0.0,1.0
29516,ㅣㄷ/KoreanParticle,1,0,1,0.0,1.1106915165381966e-05,1.0
29517,방준석/Noun,1,1,0,1.1115310228308472e-05,0.0,1.0
29518,대인배/Noun,1,0,1,0.0,1.1106915165381966e-05,1.0
29519,lsm/Alpha,1,0,1,0.0,1.1106915165381966e-05,1.0
29520,써놧/Noun,1,1,0,1.1115310228308472e-05,0.0,1.0
29521,랑게/Noun,1,1,0,1.1115310228308472e-05,0.0,1.0
29522,기울어지다/Verb,1,1,0,1.1115310228308472e-05,0.0,1.0
29523,23.5/Number,1,1,0,1.1115310228308472e-05,0.0,1.0
29524,46억년/Number,1,1,0,1.1115310228308472e-05,0.0,1.0
29525,창술/Noun,1,1,0,1.1115310228308472e-05,0.0,1.0
29526,강경희/Noun,1,1,0,1.1115310228308472e-05,0.0,1.0
29527,!!!_/Punctuation,1,1,0,1.1115310228308472e-05,0.0,1.0
29528,괜챃/Noun,1,1,0,1.1115310228308472e-05,0.0,1.0
29529,2.8/Number,1,0,1,0.0,1.1106915165381966e-05,1.0
29530,반준/Noun,1,0,1,0.0,1.1106915165381966e-05,1.0
29531,반러/Noun,1,0,1,0.0,1.1106915165381966e-05,1.0
29532,황금종려상/Noun,1,0,1,0.0,1.1106915165381966e-05,1.0
29533,루기아/Noun,1,1,0,1.1115310228308472e-05,0.0,1.0
29534,튕겼어/Noun,1,0,1,0.0,1.1106915165381966e-05,1.0
29535,하노이/Noun,1,0,1,0.0,1.1106915165381966e-05,1.0
29536,솜털/Noun,1,0,1,0.0,1.1106915165381966e-05,1.0
29537,쿠안/Noun,1,0,1,0.0,1.1106915165381966e-05,1.0
29538,은고/Eomi,1,0,1,0.0,1.1106915165381966e-05,1.0
29539,트린/Noun,1,0,1,0.0,1.1106915165381966e-05,1.0
29540,스탤론님/Noun,1,1,0,1.1115310228308472e-05,0.0,1.0
29541,최창민/Noun,1,1,0,1.1115310228308472e-05,0.0,1.0
29542,잿빝색/Noun,1,0,1,0.0,1.1106915165381966e-05,1.0
29543,20-30/Number,1,1,0,1.1115310228308472e-05,0.0,1.0
29544,♧/Foreign,1,1,0,1.1115310228308472e-05,0.0,1.0
29545,타이후/Noun,1,1,0,1.1115310228308472e-05,0.0,1.0
29546,부보/Noun,1,1,0,1.1115310228308472e-05,0.0,1.0
29547,527/Number,1,1,0,1.1115310228308472e-05,0.0,1.0
29548,흦/Noun,1,1,0,1.1115310228308472e-05,0.0,1.0
29549,초류향/Noun,1,1,0,1.1115310228308472e-05,0.0,1.0
29550,6~8/Number,1,1,0,1.1115310228308472e-05,0.0,1.0
29551,파크라이/Noun,1,0,1,0.0,1.1106915165381966e-05,1.0
29552,인더/Noun,1,0,1,0.0,1.1106915165381966e-05,1.0
29553,샷변환/Noun,1,1,0,1.1115310228308472e-05,0.0,1.0
29554,난체/Noun,1,0,1,0.0,1.1106915165381966e-05,1.0
29555,나능/Noun,1,1,0,1.1115310228308472e-05,0.0,1.0
29556,+_+;/Punctuation,1,1,0,1.1115310228308472e-05,0.0,1.0
29557,동계올림픽/Noun,1,1,0,1.1115310228308472e-05,0.0,1.0
29558,잠수정/Noun,1,1,0,1.1115310228308472e-05,0.0,1.0
29559,소형/Noun,1,1,0,1.1115310228308472e-05,0.0,1.0
29560,주정이/Noun,1,1,0,1.1115310228308472e-05,0.0,1.0
29561,진달/Noun,1,1,0,1.1115310228308472e-05,0.0,1.0
29562,종혁/Noun,1,1,0,1.1115310228308472e-05,0.0,1.0
29563,타격씬/Noun,1,1,0,1.1115310228308472e-05,0.0,1.0
29564,오븐/Noun,1,0,1,0.0,1.1106915165381966e-05,1.0
29565,-_-./Punctuation,1,0,1,0.0,1.1106915165381966e-05,1.0
29566,꺽꺽해/Noun,1,0,1,0.0,1.1106915165381966e-05,1.0
29567,에만든거인줄알았음고래가육지에서퍼득거리는건삼뉴아동비디오도요즘그거보다잘나오는데감독누군지궁금함차라리심형래가더잘안들겠다절대보지마/Foreign,1,0,1,0.0,1.1106915165381966e-05,1.0
29568,개꾸르잼/Noun,1,1,0,1.1115310228308472e-05,0.0,1.0
29569,이화여고/Noun,1,1,0,1.1115310228308472e-05,0.0,1.0
29570,팽현숙/Noun,1,1,0,1.1115310228308472e-05,0.0,1.0
29571,최양락/Noun,1,1,0,1.1115310228308472e-05,0.0,1.0
29572,키아로스타미/Noun,1,1,0,1.1115310228308472e-05,0.0,1.0
29573,뚜디/Noun,1,0,1,0.0,1.1106915165381966e-05,1.0
29574,신원진/Noun,1,0,1,0.0,1.1106915165381966e-05,1.0
29575,반소영/Noun,1,0,1,0.0,1.1106915165381966e-05,1.0
29576,꽦/Noun,1,0,1,0.0,1.1106915165381966e-05,1.0
29577,가득가득/Adverb,1,1,0,1.1115310228308472e-05,0.0,1.0
29578,훨잘씀/Noun,1,0,1,0.0,1.1106915165381966e-05,1.0
29579,.???/Punctuation,1,0,1,0.0,1.1106915165381966e-05,1.0
29580,보두앵/Noun,1,1,0,1.1115310228308472e-05,0.0,1.0
29581,맹큼/Noun,1,1,0,1.1115310228308472e-05,0.0,1.0
29582,갈소원/Noun,1,1,0,1.1115310228308472e-05,0.0,1.0
29583,드마리/Noun,1,0,1,0.0,1.1106915165381966e-05,1.0
29584,쓸헤기/Noun,1,0,1,0.0,1.1106915165381966e-05,1.0
29585,별루더/Noun,1,0,1,0.0,1.1106915165381966e-05,1.0
29586,상호작용/Noun,1,1,0,1.1115310228308472e-05,0.0,1.0
29587,비행기표/Noun,1,0,1,0.0,1.1106915165381966e-05,1.0
29588,육년/Noun,1,1,0,1.1115310228308472e-05,0.0,1.0
29589,표값좀/Noun,1,0,1,0.0,1.1106915165381966e-05,1.0
29590,꾀다/Verb,1,0,1,0.0,1.1106915165381966e-05,1.0
29591,origin/Alpha,1,1,0,1.1115310228308472e-05,0.0,1.0
29592,홍진/Noun,1,1,0,1.1115310228308472e-05,0.0,1.0
29593,ㄴㅏㄷ/KoreanParticle,1,1,0,1.1115310228308472e-05,0.0,1.0
29594,완이/Noun,1,1,0,1.1115310228308472e-05,0.0,1.0
29595,슾픈/Noun,1,1,0,1.1115310228308472e-05,0.0,1.0
29596,???../Punctuation,1,0,1,0.0,1.1106915165381966e-05,1.0
29597,디렉팅된/Noun,1,1,0,1.1115310228308472e-05,0.0,1.0
29598,자꾸나/Noun,1,1,0,1.1115310228308472e-05,0.0,1.0
29599,러브라이브/Noun,1,1,0,1.1115310228308472e-05,0.0,1.0
29600,여드름/Noun,1,1,0,1.1115310228308472e-05,0.0,1.0
29601,똥꾸녕/Noun,1,1,0,1.1115310228308472e-05,0.0,1.0
29602,대장장이/Noun,1,1,0,1.1115310228308472e-05,0.0,1.0
29603,오인헤/Noun,1,0,1,0.0,1.1106915165381966e-05,1.0
29604,에비게일/Noun,1,0,1,0.0,1.1106915165381966e-05,1.0
29605,첬/Noun,1,0,1,0.0,1.1106915165381966e-05,1.0
29606,효린/Noun,1,0,1,0.0,1.1106915165381966e-05,1.0
29607,희극인/Noun,1,1,0,1.1115310228308472e-05,0.0,1.0
29608,군가/Noun,1,1,0,1.1115310228308472e-05,0.0,1.0
29609,함포/Noun,1,0,1,0.0,1.1106915165381966e-05,1.0
29610,웹진/Noun,1,0,1,0.0,1.1106915165381966e-05,1.0
29611,러쇼/Noun,1,1,0,1.1115310228308472e-05,0.0,1.0
29612,유골/Noun,1,1,0,1.1115310228308472e-05,0.0,1.0
29613,evil/Alpha,1,0,1,0.0,1.1106915165381966e-05,1.0
29614,와리/Noun,1,0,1,0.0,1.1106915165381966e-05,1.0
29615,세윤/Noun,1,1,0,1.1115310228308472e-05,0.0,1.0
29616,리환/Noun,1,1,0,1.1115310228308472e-05,0.0,1.0
29617,쨔져/Noun,1,0,1,0.0,1.1106915165381966e-05,1.0
29618,181818/Number,1,0,1,0.0,1.1106915165381966e-05,1.0
29619,도축장/Noun,1,0,1,0.0,1.1106915165381966e-05,1.0
29620,북실북실/Adverb,1,1,0,1.1115310228308472e-05,0.0,1.0
29621,쿼런틴/Noun,1,1,0,1.1115310228308472e-05,0.0,1.0
29622,퐁당퐁당/Adverb,1,1,0,1.1115310228308472e-05,0.0,1.0
29623,인런글/Noun,1,0,1,0.0,1.1106915165381966e-05,1.0
29624,비됴로봐/Noun,1,0,1,0.0,1.1106915165381966e-05,1.0
29625,밈/Noun,1,0,1,0.0,1.1106915165381966e-05,1.0
29626,파레/Noun,1,1,0,1.1115310228308472e-05,0.0,1.0
29627,헬맷/Noun,1,1,0,1.1115310228308472e-05,0.0,1.0
29628,말질/Noun,1,0,1,0.0,1.1106915165381966e-05,1.0
29629,키덜트/Noun,1,0,1,0.0,1.1106915165381966e-05,1.0
29630,한예인/Noun,1,0,1,0.0,1.1106915165381966e-05,1.0
29631,마리아치/Noun,1,1,0,1.1115310228308472e-05,0.0,1.0
29632,재선/Noun,1,1,0,1.1115310228308472e-05,0.0,1.0
29633,관데/Noun,1,0,1,0.0,1.1106915165381966e-05,1.0
29634,취득/Noun,1,0,1,0.0,1.1106915165381966e-05,1.0
29635,480만/Number,1,0,1,0.0,1.1106915165381966e-05,1.0
29636,살떄/Noun,1,1,0,1.1115310228308472e-05,0.0,1.0
29637,폴리머/Noun,1,1,0,1.1115310228308472e-05,0.0,1.0
29638,작치고는/Foreign,1,1,0,1.1115310228308472e-05,0.0,1.0
29639,그닥재미었/Noun,1,0,1,0.0,1.1106915165381966e-05,1.0
29640,사귄/Foreign,1,0,1,0.0,1.1106915165381966e-05,1.0
29641,됫을텐/Noun,1,1,0,1.1115310228308472e-05,0.0,1.0
29642,유완/Noun,1,1,0,1.1115310228308472e-05,0.0,1.0
29643,쟘있내/Noun,1,0,1,0.0,1.1106915165381966e-05,1.0
29644,척좀/Noun,1,0,1,0.0,1.1106915165381966e-05,1.0
29645,티격대격해/Noun,1,1,0,1.1115310228308472e-05,0.0,1.0
29646,Around/Alpha,1,1,0,1.1115310228308472e-05,0.0,1.0
29647,Mess/Alpha,1,1,0,1.1115310228308472e-05,0.0,1.0
29648,웩더독/Noun,1,0,1,0.0,1.1106915165381966e-05,1.0
29649,독착/Noun,1,0,1,0.0,1.1106915165381966e-05,1.0
29650,예뻣음/Noun,1,1,0,1.1115310228308472e-05,0.0,1.0
29651,거꾸러지다/Verb,1,0,1,0.0,1.1106915165381966e-05,1.0
29652,퓨쳐라마/Noun,1,1,0,1.1115310228308472e-05,0.0,1.0
29653,아윕/Noun,1,1,0,1.1115310228308472e-05,0.0,1.0
29654,헥헥/Noun,1,0,1,0.0,1.1106915165381966e-05,1.0
29655,루첼/Noun,1,1,0,1.1115310228308472e-05,0.0,1.0
29656,어두운삘일줄/Noun,1,1,0,1.1115310228308472e-05,0.0,1.0
29657,나바호족/Noun,1,1,0,1.1115310228308472e-05,0.0,1.0
29658,유용원/Noun,1,0,1,0.0,1.1106915165381966e-05,1.0
29659,탄흔/Noun,1,0,1,0.0,1.1106915165381966e-05,1.0
29660,xhbfhhg/Alpha,1,1,0,1.1115310228308472e-05,0.0,1.0
29661,dmahfdcgigjkkhbyjjhkjumvxh/Alpha,1,1,0,1.1115310228308472e-05,0.0,1.0
29662,3천만원/Number,1,1,0,1.1115310228308472e-05,0.0,1.0
29663,철새/Noun,1,0,1,0.0,1.1106915165381966e-05,1.0
29664,문구로/Noun,1,0,1,0.0,1.1106915165381966e-05,1.0
29665,창해/Noun,1,1,0,1.1115310228308472e-05,0.0,1.0
29666,잇끼/Noun,1,1,0,1.1115310228308472e-05,0.0,1.0
29667,질겨별/Noun,1,0,1,0.0,1.1106915165381966e-05,1.0
29668,바둑기사/Noun,1,0,1,0.0,1.1106915165381966e-05,1.0
29669,재밓머/Noun,1,1,0,1.1115310228308472e-05,0.0,1.0
29670,궅굳/Noun,1,1,0,1.1115310228308472e-05,0.0,1.0
29671,중소기업청/Noun,1,0,1,0.0,1.1106915165381966e-05,1.0
29672,하겟네별/Noun,1,0,1,0.0,1.1106915165381966e-05,1.0
29673,남도일/Noun,1,1,0,1.1115310228308472e-05,0.0,1.0
29674,슈돌/Noun,1,1,0,1.1115310228308472e-05,0.0,1.0
29675,ㅋㅇㅎㅅ/KoreanParticle,1,1,0,1.1115310228308472e-05,0.0,1.0
29676,거렸는데/Noun,1,0,1,0.0,1.1106915165381966e-05,1.0
29677,외과/Noun,1,0,1,0.0,1.1106915165381966e-05,1.0
29678,타타타/Noun,1,0,1,0.0,1.1106915165381966e-05,1.0
29679,분까지/Foreign,1,1,0,1.1115310228308472e-05,0.0,1.0
29680,거스를수/Noun,1,0,1,0.0,1.1106915165381966e-05,1.0
29681,Fate/Alpha,1,0,1,0.0,1.1106915165381966e-05,1.0
29682,애니팡/Noun,1,0,1,0.0,1.1106915165381966e-05,1.0
29683,짓함/Noun,1,0,1,0.0,1.1106915165381966e-05,1.0
29684,과로사/Noun,1,0,1,0.0,1.1106915165381966e-05,1.0
29685,박봉/Noun,1,0,1,0.0,1.1106915165381966e-05,1.0
29686,뒤부터/Foreign,1,0,1,0.0,1.1106915165381966e-05,1.0
29687,팔랑거리다/Verb,1,0,1,0.0,1.1106915165381966e-05,1.0
29688,렌탈비/Noun,1,0,1,0.0,1.1106915165381966e-05,1.0
29689,슬예/Noun,1,0,1,0.0,1.1106915165381966e-05,1.0
29690,황우/Noun,1,0,1,0.0,1.1106915165381966e-05,1.0
29691,Copy/Alpha,1,0,1,0.0,1.1106915165381966e-05,1.0
29692,블랙호크/Noun,1,0,1,0.0,1.1106915165381966e-05,1.0
29693,넘젬/Noun,1,1,0,1.1115310228308472e-05,0.0,1.0
29694,tea/Alpha,1,1,0,1.1115310228308472e-05,0.0,1.0
29695,Koukako/Alpha,1,1,0,1.1115310228308472e-05,0.0,1.0
29696,김다빈/Noun,1,1,0,1.1115310228308472e-05,0.0,1.0
29697,보는/Foreign,1,1,0,1.1115310228308472e-05,0.0,1.0
29698,Jason/Alpha,1,0,1,0.0,1.1106915165381966e-05,1.0
29699,tk/Alpha,1,0,1,0.0,1.1106915165381966e-05,1.0
29700,브라가/Noun,1,0,1,0.0,1.1106915165381966e-05,1.0
29701,철칙/Noun,1,0,1,0.0,1.1106915165381966e-05,1.0
29702,눈배렸/Noun,1,0,1,0.0,1.1106915165381966e-05,1.0
29703,백제인/Noun,1,0,1,0.0,1.1106915165381966e-05,1.0
29704,민기/Noun,1,1,0,1.1115310228308472e-05,0.0,1.0
29705,호고/Noun,1,0,1,0.0,1.1106915165381966e-05,1.0
29706,치레/Noun,1,0,1,0.0,1.1106915165381966e-05,1.0
29707,안나윈투어/Noun,1,1,0,1.1115310228308472e-05,0.0,1.0
29708,상연/Noun,1,0,1,0.0,1.1106915165381966e-05,1.0
29709,미네랄/Noun,1,0,1,0.0,1.1106915165381966e-05,1.0
29710,삼다수/Noun,1,0,1,0.0,1.1106915165381966e-05,1.0
29711,일인극/Noun,1,0,1,0.0,1.1106915165381966e-05,1.0
29712,윤선생님/Noun,1,1,0,1.1115310228308472e-05,0.0,1.0
29713,!!!!!!!!!!!!!!!!!!!!!!!!!!!!!!!/Punctuation,1,1,0,1.1115310228308472e-05,0.0,1.0
29714,얏/Noun,1,1,0,1.1115310228308472e-05,0.0,1.0
29715,남구만/Noun,1,1,0,1.1115310228308472e-05,0.0,1.0
29716,충정/Noun,1,0,1,0.0,1.1106915165381966e-05,1.0
29717,김대/Noun,1,0,1,0.0,1.1106915165381966e-05,1.0
29718,박정권/Noun,1,0,1,0.0,1.1106915165381966e-05,1.0
29719,팬이됐슴/Noun,1,1,0,1.1115310228308472e-05,0.0,1.0
29720,복병/Noun,1,1,0,1.1115310228308472e-05,0.0,1.0
29721,^-^)/Punctuation,1,1,0,1.1115310228308472e-05,0.0,1.0
29722,패퓨/Noun,1,0,1,0.0,1.1106915165381966e-05,1.0
29723,?<-/Punctuation,1,0,1,0.0,1.1106915165381966e-05,1.0
29724,호미/Noun,1,0,1,0.0,1.1106915165381966e-05,1.0
29725,헤니씨/Noun,1,1,0,1.1115310228308472e-05,0.0,1.0
29726,~>-</Punctuation,1,1,0,1.1115310228308472e-05,0.0,1.0
29727,빠빵/Noun,1,1,0,1.1115310228308472e-05,0.0,1.0
29728,히어/Noun,1,1,0,1.1115310228308472e-05,0.0,1.0
29729,제중원/Noun,1,1,0,1.1115310228308472e-05,0.0,1.0
29730,깻는데/Noun,1,0,1,0.0,1.1106915165381966e-05,1.0
29731,샤무/Noun,1,1,0,1.1115310228308472e-05,0.0,1.0
29732,드라마넷/Noun,1,0,1,0.0,1.1106915165381966e-05,1.0
29733,들엇어/Noun,1,1,0,1.1115310228308472e-05,0.0,1.0
29734,타타/Noun,1,1,0,1.1115310228308472e-05,0.0,1.0
29735,파카/Noun,1,1,0,1.1115310228308472e-05,0.0,1.0
29736,힝/Exclamation,1,0,1,0.0,1.1106915165381966e-05,1.0
29737,지정학적/Noun,1,1,0,1.1115310228308472e-05,0.0,1.0
29738,예비신부/Noun,1,0,1,0.0,1.1106915165381966e-05,1.0
29739,보믄됨/Noun,1,0,1,0.0,1.1106915165381966e-05,1.0
29740,-???/Punctuation,1,0,1,0.0,1.1106915165381966e-05,1.0
29741,꼭지딴/Noun,1,1,0,1.1115310228308472e-05,0.0,1.0
29742,호준이/Noun,1,0,1,0.0,1.1106915165381966e-05,1.0
29743,조지훈/Noun,1,1,0,1.1115310228308472e-05,0.0,1.0
29744,정숙/Noun,1,0,1,0.0,1.1106915165381966e-05,1.0
29745,스프린트/Noun,1,0,1,0.0,1.1106915165381966e-05,1.0
29746,칠이만/Noun,1,0,1,0.0,1.1106915165381966e-05,1.0
29747,march/Alpha,1,0,1,0.0,1.1106915165381966e-05,1.0
29748,디토/Noun,1,0,1,0.0,1.1106915165381966e-05,1.0
29749,훈내나/Noun,1,1,0,1.1115310228308472e-05,0.0,1.0
29750,짜리광고/Foreign,1,0,1,0.0,1.1106915165381966e-05,1.0
29751,쿠쿠/Noun,1,0,1,0.0,1.1106915165381966e-05,1.0
29752,영상통화/Noun,1,0,1,0.0,1.1106915165381966e-05,1.0
29753,와이파이/Noun,1,0,1,0.0,1.1106915165381966e-05,1.0
29754,느깜/Noun,1,0,1,0.0,1.1106915165381966e-05,1.0
29755,야돈/Noun,1,0,1,0.0,1.1106915165381966e-05,1.0
29756,impressed/Alpha,1,1,0,1.1115310228308472e-05,0.0,1.0
29757,글레머/Noun,1,0,1,0.0,1.1106915165381966e-05,1.0
29758,경어/Noun,1,0,1,0.0,1.1106915165381966e-05,1.0
29759,빅토르/Noun,1,0,1,0.0,1.1106915165381966e-05,1.0
29760,스톨른/Noun,1,1,0,1.1115310228308472e-05,0.0,1.0
29761,과격/Noun,1,0,1,0.0,1.1106915165381966e-05,1.0
29762,정돌/Noun,1,1,0,1.1115310228308472e-05,0.0,1.0
29763,해피피트/Noun,1,1,0,1.1115310228308472e-05,0.0,1.0
29764,프사/Noun,1,1,0,1.1115310228308472e-05,0.0,1.0
29765,거닐다/Verb,1,1,0,1.1115310228308472e-05,0.0,1.0
29766,갯지렁이/Noun,1,0,1,0.0,1.1106915165381966e-05,1.0
29767,고토/Noun,1,1,0,1.1115310228308472e-05,0.0,1.0
29768,흐릿함/Noun,1,0,1,0.0,1.1106915165381966e-05,1.0
29769,나보이/Noun,1,1,0,1.1115310228308472e-05,0.0,1.0
29770,버철/Noun,1,0,1,0.0,1.1106915165381966e-05,1.0
29771,아꼽넹/Noun,1,0,1,0.0,1.1106915165381966e-05,1.0
29772,거마/Noun,1,0,1,0.0,1.1106915165381966e-05,1.0
29773,괴성/Noun,1,1,0,1.1115310228308472e-05,0.0,1.0
29774,왜낫/Noun,1,1,0,1.1115310228308472e-05,0.0,1.0
29775,뻘영화/Noun,1,0,1,0.0,1.1106915165381966e-05,1.0
29776,느껴졋습니/Noun,1,1,0,1.1115310228308472e-05,0.0,1.0
29777,태동/Noun,1,1,0,1.1115310228308472e-05,0.0,1.0
29778,평쩜/Noun,1,0,1,0.0,1.1106915165381966e-05,1.0
29779,태세/Noun,1,0,1,0.0,1.1106915165381966e-05,1.0
29780,유얼/Noun,1,1,0,1.1115310228308472e-05,0.0,1.0
29781,바더/Noun,1,1,0,1.1115310228308472e-05,0.0,1.0
29782,띵소리/Noun,1,0,1,0.0,1.1106915165381966e-05,1.0
29783,박소현/Noun,1,1,0,1.1115310228308472e-05,0.0,1.0
29784,-.-.../Punctuation,1,0,1,0.0,1.1106915165381966e-05,1.0
29785,쯤뒤부터/Foreign,1,0,1,0.0,1.1106915165381966e-05,1.0
29786,스쿠터/Noun,1,1,0,1.1115310228308472e-05,0.0,1.0
29787,응당/Noun,1,0,1,0.0,1.1106915165381966e-05,1.0
29788,이용대/Noun,1,0,1,0.0,1.1106915165381966e-05,1.0
29789,"?!!""/Punctuation",1,1,0,1.1115310228308472e-05,0.0,1.0
29790,있었엌/Noun,1,1,0,1.1115310228308472e-05,0.0,1.0
29791,플레이걸/Noun,1,0,1,0.0,1.1106915165381966e-05,1.0
29792,오스트레일리아영화/Noun,1,0,1,0.0,1.1106915165381966e-05,1.0
29793,낫넹/Noun,1,1,0,1.1115310228308472e-05,0.0,1.0
29794,허영란/Noun,1,0,1,0.0,1.1106915165381966e-05,1.0
29795,피빨/Noun,1,0,1,0.0,1.1106915165381966e-05,1.0
29796,높을껀데/Noun,1,0,1,0.0,1.1106915165381966e-05,1.0
29797,해표/Noun,1,1,0,1.1115310228308472e-05,0.0,1.0
29798,Bed/Alpha,1,0,1,0.0,1.1106915165381966e-05,1.0
29799,",,,,,,,,,,,,,,,,,,,,,,,,,,,/Punctuation",1,0,1,0.0,1.1106915165381966e-05,1.0
29800,ㅏㅜㅠㅜ/KoreanParticle,1,1,0,1.1115310228308472e-05,0.0,1.0
29801,있었슴/Noun,1,0,1,0.0,1.1106915165381966e-05,1.0
29802,꼬신놈/Noun,1,0,1,0.0,1.1106915165381966e-05,1.0
29803,쇼리/Noun,1,1,0,1.1115310228308472e-05,0.0,1.0
29804,보쑈/Noun,1,1,0,1.1115310228308472e-05,0.0,1.0
29805,해드셋끼/Noun,1,1,0,1.1115310228308472e-05,0.0,1.0
29806,볼레로/Noun,1,1,0,1.1115310228308472e-05,0.0,1.0
29807,".,..,..,.,/Punctuation",1,0,1,0.0,1.1106915165381966e-05,1.0
29808,라티오스/Noun,1,0,1,0.0,1.1106915165381966e-05,1.0
29809,라티아스/Noun,1,0,1,0.0,1.1106915165381966e-05,1.0
29810,펄기아/Noun,1,0,1,0.0,1.1106915165381966e-05,1.0
29811,디아루가/Noun,1,0,1,0.0,1.1106915165381966e-05,1.0
29812,세레비/Noun,1,0,1,0.0,1.1106915165381966e-05,1.0
29813,BW/Alpha,1,0,1,0.0,1.1106915165381966e-05,1.0
29814,가카/Noun,1,0,1,0.0,1.1106915165381966e-05,1.0
29815,반같은/Foreign,1,0,1,0.0,1.1106915165381966e-05,1.0
29816,돈줌/Noun,1,1,0,1.1115310228308472e-05,0.0,1.0
29817,완전열/Noun,1,0,1,0.0,1.1106915165381966e-05,1.0
29818,ss/Alpha,1,1,0,1.1115310228308472e-05,0.0,1.0
29819,디파티드/Noun,1,1,0,1.1115310228308472e-05,0.0,1.0
29820,ㄱㅏ/KoreanParticle,1,0,1,0.0,1.1106915165381966e-05,1.0
29821,개쫄딱/Noun,1,0,1,0.0,1.1106915165381966e-05,1.0
29822,어설피/Noun,1,0,1,0.0,1.1106915165381966e-05,1.0
29823,여교사/Noun,1,0,1,0.0,1.1106915165381966e-05,1.0
29824,정쩜을찍/Noun,1,1,0,1.1115310228308472e-05,0.0,1.0
29825,neighborhood/Alpha,1,1,0,1.1115310228308472e-05,0.0,1.0
29826,ㅋㅋㅋㅠㅠㅠ/KoreanParticle,1,1,0,1.1115310228308472e-05,0.0,1.0
29827,프리큐어/Noun,1,1,0,1.1115310228308472e-05,0.0,1.0
29828,햇볕정책/Noun,1,1,0,1.1115310228308472e-05,0.0,1.0
29829,WCW/Alpha,1,0,1,0.0,1.1106915165381966e-05,1.0
29830,애바임/Noun,1,1,0,1.1115310228308472e-05,0.0,1.0
29831,만에울고끝날때낀지울었다정말로/Foreign,1,1,0,1.1115310228308472e-05,0.0,1.0
29832,스탭롤/Noun,1,1,0,1.1115310228308472e-05,0.0,1.0
29833,은재/Noun,1,0,1,0.0,1.1106915165381966e-05,1.0
29834,At/Alpha,1,0,1,0.0,1.1106915165381966e-05,1.0
29835,위스퍼/Noun,1,0,1,0.0,1.1106915165381966e-05,1.0
29836,쵸의/Noun,1,1,0,1.1115310228308472e-05,0.0,1.0
29837,마츠모토/Noun,1,1,0,1.1115310228308472e-05,0.0,1.0
29838,삼진아웃/Noun,1,0,1,0.0,1.1106915165381966e-05,1.0
29839,~~~!!~~~/Punctuation,1,1,0,1.1115310228308472e-05,0.0,1.0
29840,배싹/Noun,1,0,1,0.0,1.1106915165381966e-05,1.0
29841,헛기둥/Noun,1,0,1,0.0,1.1106915165381966e-05,1.0
29842,바랜다/Noun,1,0,1,0.0,1.1106915165381966e-05,1.0
29843,데드맨다운/Noun,1,0,1,0.0,1.1106915165381966e-05,1.0
29844,늑인/Noun,1,0,1,0.0,1.1106915165381966e-05,1.0
29845,잇뽀/Noun,1,1,0,1.1115310228308472e-05,0.0,1.0
29846,진싲/Noun,1,0,1,0.0,1.1106915165381966e-05,1.0
29847,꺼라/Foreign,1,1,0,1.1115310228308472e-05,0.0,1.0
29848,이훨/Noun,1,0,1,0.0,1.1106915165381966e-05,1.0
29849,비혼/Noun,1,1,0,1.1115310228308472e-05,0.0,1.0
29850,사허/Noun,1,0,1,0.0,1.1106915165381966e-05,1.0
29851,67회/Number,1,1,0,1.1115310228308472e-05,0.0,1.0
29852,을써먹음/Foreign,1,0,1,0.0,1.1106915165381966e-05,1.0
29853,도체안되고끝남/Foreign,1,0,1,0.0,1.1106915165381966e-05,1.0
29854,건/Foreign,1,0,1,0.0,1.1106915165381966e-05,1.0
29855,슬프넹/Noun,1,0,1,0.0,1.1106915165381966e-05,1.0
29856,버무러져/Noun,1,1,0,1.1115310228308472e-05,0.0,1.0
29857,찌웠을까/Noun,1,0,1,0.0,1.1106915165381966e-05,1.0
29858,석사/Noun,1,0,1,0.0,1.1106915165381966e-05,1.0
29859,개봉작을/Foreign,1,0,1,0.0,1.1106915165381966e-05,1.0
29860,강정원/Noun,1,0,1,0.0,1.1106915165381966e-05,1.0
29861,會者定離/Foreign,1,1,0,1.1115310228308472e-05,0.0,1.0
29862,러운/Noun,1,1,0,1.1115310228308472e-05,0.0,1.0
29863,빵점못주/Noun,1,0,1,0.0,1.1106915165381966e-05,1.0
29864,얼렁/Noun,1,1,0,1.1115310228308472e-05,0.0,1.0
29865,신천지/Noun,1,1,0,1.1115310228308472e-05,0.0,1.0
29866,고렇/Noun,1,0,1,0.0,1.1106915165381966e-05,1.0
29867,레깅/Noun,1,0,1,0.0,1.1106915165381966e-05,1.0
29868,디셉티콘/Noun,1,0,1,0.0,1.1106915165381966e-05,1.0
29869,오게됫는/Noun,1,0,1,0.0,1.1106915165381966e-05,1.0
29870,리쉘웨폰/Noun,1,1,0,1.1115310228308472e-05,0.0,1.0
29871,모락모락/Noun,1,1,0,1.1115310228308472e-05,0.0,1.0
29872,물량공세/Noun,1,1,0,1.1115310228308472e-05,0.0,1.0
29873,베이식/Noun,1,1,0,1.1115310228308472e-05,0.0,1.0
29874,후원자/Noun,1,1,0,1.1115310228308472e-05,0.0,1.0
29875,글렀다/Noun,1,0,1,0.0,1.1106915165381966e-05,1.0
29876,봣다해/Noun,1,1,0,1.1115310228308472e-05,0.0,1.0
29877,방음/Noun,1,1,0,1.1115310228308472e-05,0.0,1.0
29878,Fish/Alpha,1,1,0,1.1115310228308472e-05,0.0,1.0
29879,?-_=;/Punctuation,1,0,1,0.0,1.1106915165381966e-05,1.0
29880,미결/Noun,1,1,0,1.1115310228308472e-05,0.0,1.0
29881,사구조/Noun,1,1,0,1.1115310228308472e-05,0.0,1.0
29882,보러갈껀데/Noun,1,1,0,1.1115310228308472e-05,0.0,1.0
29883,john/Alpha,1,1,0,1.1115310228308472e-05,0.0,1.0
29884,싸울레/Noun,1,0,1,0.0,1.1106915165381966e-05,1.0
29885,파니핑크/Noun,1,1,0,1.1115310228308472e-05,0.0,1.0
29886,~-_-/Punctuation,1,0,1,0.0,1.1106915165381966e-05,1.0
29887,ㄶ/KoreanParticle,1,1,0,1.1115310228308472e-05,0.0,1.0
29888,ㅁㅁㄴ/KoreanParticle,1,1,0,1.1115310228308472e-05,0.0,1.0
29889,adklfjvhalkdjvhalkdh/Alpha,1,0,1,0.0,1.1106915165381966e-05,1.0
29890,children/Alpha,1,1,0,1.1115310228308472e-05,0.0,1.0
29891,scary/Alpha,1,1,0,1.1115310228308472e-05,0.0,1.0
29892,Animation/Alpha,1,1,0,1.1115310228308472e-05,0.0,1.0
29893,...........!!/Punctuation,1,1,0,1.1115310228308472e-05,0.0,1.0
29894,좆불/Noun,1,0,1,0.0,1.1106915165381966e-05,1.0
29895,노뽕/Noun,1,0,1,0.0,1.1106915165381966e-05,1.0
29896,qkdeodnd/Alpha,1,0,1,0.0,1.1106915165381966e-05,1.0
29897,엠브리/Noun,1,0,1,0.0,1.1106915165381966e-05,1.0
29898,작이니/Foreign,1,1,0,1.1115310228308472e-05,0.0,1.0
29899,색킈/Noun,1,0,1,0.0,1.1106915165381966e-05,1.0
29900,ㄱㅈ/KoreanParticle,1,0,1,0.0,1.1106915165381966e-05,1.0
29901,개최/Noun,1,0,1,0.0,1.1106915165381966e-05,1.0
29902,줄곳/Noun,1,0,1,0.0,1.1106915165381966e-05,1.0
29903,시체놀이/Noun,1,0,1,0.0,1.1106915165381966e-05,1.0
29904,~~~~~~~~~~~~~~~~~~~~~~/Punctuation,1,1,0,1.1115310228308472e-05,0.0,1.0
29905,얘쁜/Noun,1,0,1,0.0,1.1106915165381966e-05,1.0
29906,여제/Noun,1,1,0,1.1115310228308472e-05,0.0,1.0
29907,Bird/Alpha,1,1,0,1.1115310228308472e-05,0.0,1.0
29908,Black/Alpha,1,1,0,1.1115310228308472e-05,0.0,1.0
29909,Bye/Alpha,1,1,0,1.1115310228308472e-05,0.0,1.0
29910,햇답니/Noun,1,1,0,1.1115310228308472e-05,0.0,1.0
29911,으헤헤헤헹/Noun,1,1,0,1.1115310228308472e-05,0.0,1.0
29912,층격/Noun,1,1,0,1.1115310228308472e-05,0.0,1.0
29913,넘는제작비/Foreign,1,0,1,0.0,1.1106915165381966e-05,1.0
29914,...;_;/Punctuation,1,1,0,1.1115310228308472e-05,0.0,1.0
29915,료움/Noun,1,1,0,1.1115310228308472e-05,0.0,1.0
29916,박훈/Noun,1,1,0,1.1115310228308472e-05,0.0,1.0
29917,회현면/Noun,1,1,0,1.1115310228308472e-05,0.0,1.0
29918,군산시/Noun,1,1,0,1.1115310228308472e-05,0.0,1.0
29919,handsome/Alpha,1,1,0,1.1115310228308472e-05,0.0,1.0
29920,evans/Alpha,1,1,0,1.1115310228308472e-05,0.0,1.0
29921,chris/Alpha,1,1,0,1.1115310228308472e-05,0.0,1.0
29922,10.00/Number,1,0,1,0.0,1.1106915165381966e-05,1.0
29923,남길/Noun,1,1,0,1.1115310228308472e-05,0.0,1.0
29924,생긱/Noun,1,1,0,1.1115310228308472e-05,0.0,1.0
29925,고얀/Modifier,1,0,1,0.0,1.1106915165381966e-05,1.0
29926,8.42/Number,1,1,0,1.1115310228308472e-05,0.0,1.0
29927,잇럽/Noun,1,1,0,1.1115310228308472e-05,0.0,1.0
29928,프론가/Noun,1,0,1,0.0,1.1106915165381966e-05,1.0
29929,앞전/Noun,1,0,1,0.0,1.1106915165381966e-05,1.0
29930,진형태/Noun,1,0,1,0.0,1.1106915165381966e-05,1.0
29931,병속/Noun,1,0,1,0.0,1.1106915165381966e-05,1.0
29932,테닥어쩔/Noun,1,1,0,1.1115310228308472e-05,0.0,1.0
29933,hoon/Alpha,1,0,1,0.0,1.1106915165381966e-05,1.0
29934,빙그르르/Noun,1,0,1,0.0,1.1106915165381966e-05,1.0
29935,훌류/Noun,1,1,0,1.1115310228308472e-05,0.0,1.0
29936,;;;;;;;;;;;;;;;;;;;;/Punctuation,1,0,1,0.0,1.1106915165381966e-05,1.0
29937,그엇/Noun,1,0,1,0.0,1.1106915165381966e-05,1.0
29938,118/Number,1,0,1,0.0,1.1106915165381966e-05,1.0
29939,opus/Alpha,1,0,1,0.0,1.1106915165381966e-05,1.0
29940,Intermezzo/Alpha,1,0,1,0.0,1.1106915165381966e-05,1.0
29941,개일/Noun,1,0,1,0.0,1.1106915165381966e-05,1.0
29942,ufotable/Alpha,1,1,0,1.1115310228308472e-05,0.0,1.0
29943,드슈/Noun,1,0,1,0.0,1.1106915165381966e-05,1.0
29944,앤티크/Noun,1,1,0,1.1115310228308472e-05,0.0,1.0
29945,인양씬/Noun,1,1,0,1.1115310228308472e-05,0.0,1.0
29946,갸루/Noun,1,0,1,0.0,1.1106915165381966e-05,1.0
29947,가야대/Noun,1,1,0,1.1115310228308472e-05,0.0,1.0
29948,장학퀴즈/Noun,1,0,1,0.0,1.1106915165381966e-05,1.0
29949,씨걸/Noun,1,0,1,0.0,1.1106915165381966e-05,1.0
29950,아망딘/Noun,1,1,0,1.1115310228308472e-05,0.0,1.0
29951,홍콩르와르/Noun,1,0,1,0.0,1.1106915165381966e-05,1.0
29952,이선아/Noun,1,1,0,1.1115310228308472e-05,0.0,1.0
29953,스노보드/Noun,1,0,1,0.0,1.1106915165381966e-05,1.0
29954,구차/Noun,1,0,1,0.0,1.1106915165381966e-05,1.0
29955,배배꼬아/Noun,1,1,0,1.1115310228308472e-05,0.0,1.0
29956,정혁/Noun,1,0,1,0.0,1.1106915165381966e-05,1.0
29957,생활용품/Noun,1,1,0,1.1115310228308472e-05,0.0,1.0
29958,반등/Noun,1,1,0,1.1115310228308472e-05,0.0,1.0
29959,007만/Number,1,1,0,1.1115310228308472e-05,0.0,1.0
29960,musch/Alpha,1,1,0,1.1115310228308472e-05,0.0,1.0
29961,나츠/Noun,1,1,0,1.1115310228308472e-05,0.0,1.0
29962,코바/Noun,1,1,0,1.1115310228308472e-05,0.0,1.0
29963,동메달/Noun,1,1,0,1.1115310228308472e-05,0.0,1.0
29964,찰포/Noun,1,0,1,0.0,1.1106915165381966e-05,1.0
29965,병임/Noun,1,0,1,0.0,1.1106915165381966e-05,1.0
29966,웨딩드레스/Noun,1,0,1,0.0,1.1106915165381966e-05,1.0
29967,통일한국/Noun,1,1,0,1.1115310228308472e-05,0.0,1.0
29968,촉각/Noun,1,1,0,1.1115310228308472e-05,0.0,1.0
29969,믕지/Noun,1,1,0,1.1115310228308472e-05,0.0,1.0
29970,헤링턴/Noun,1,0,1,0.0,1.1106915165381966e-05,1.0
29971,린킨파크/Noun,1,1,0,1.1115310228308472e-05,0.0,1.0
29972,유난히/Adverb,1,1,0,1.1115310228308472e-05,0.0,1.0
29973,오색/Noun,1,1,0,1.1115310228308472e-05,0.0,1.0
29974,사릉/Noun,1,1,0,1.1115310228308472e-05,0.0,1.0
29975,깍아야겟기/Noun,1,0,1,0.0,1.1106915165381966e-05,1.0
29976,korealv/Alpha,1,0,1,0.0,1.1106915165381966e-05,1.0
29977,구임/Noun,1,0,1,0.0,1.1106915165381966e-05,1.0
29978,앞축/Noun,1,1,0,1.1115310228308472e-05,0.0,1.0
29979,오골계/Noun,1,0,1,0.0,1.1106915165381966e-05,1.0
29980,칼잡이/Noun,1,1,0,1.1115310228308472e-05,0.0,1.0
29981,zxcvfgrwdgyj/Alpha,1,1,0,1.1115310228308472e-05,0.0,1.0
29982,Under/Alpha,1,1,0,1.1115310228308472e-05,0.0,1.0
29983,앁/Noun,1,0,1,0.0,1.1106915165381966e-05,1.0
29984,볼썽/Noun,1,0,1,0.0,1.1106915165381966e-05,1.0
29985,퍼넘음/Noun,1,0,1,0.0,1.1106915165381966e-05,1.0
29986,양공주/Noun,1,0,1,0.0,1.1106915165381966e-05,1.0
29987,읊어댐/Noun,1,0,1,0.0,1.1106915165381966e-05,1.0
29988,절절이/Noun,1,0,1,0.0,1.1106915165381966e-05,1.0
29989,사이버포뮬러/Noun,1,1,0,1.1115310228308472e-05,0.0,1.0
29990,ic/Alpha,1,1,0,1.1115310228308472e-05,0.0,1.0
29991,산호수/Noun,1,1,0,1.1115310228308472e-05,0.0,1.0
29992,가염/Noun,1,0,1,0.0,1.1106915165381966e-05,1.0
29993,젠못/Noun,1,1,0,1.1115310228308472e-05,0.0,1.0
29994,페인팅/Noun,1,1,0,1.1115310228308472e-05,0.0,1.0
29995,송재빈/Noun,1,1,0,1.1115310228308472e-05,0.0,1.0
29996,송재민/Noun,1,1,0,1.1115310228308472e-05,0.0,1.0
29997,겸연쩍다/Adjective,1,1,0,1.1115310228308472e-05,0.0,1.0
29998,Star/Alpha,1,1,0,1.1115310228308472e-05,0.0,1.0
29999,Radio/Alpha,1,1,0,1.1115310228308472e-05,0.0,1.0
30000,Killed/Alpha,1,1,0,1.1115310228308472e-05,0.0,1.0
30001,Video/Alpha,1,1,0,1.1115310228308472e-05,0.0,1.0
30002,괜챦구/Noun,1,1,0,1.1115310228308472e-05,0.0,1.0
30003,썻군/Noun,1,1,0,1.1115310228308472e-05,0.0,1.0
30004,돈꽤/Noun,1,1,0,1.1115310228308472e-05,0.0,1.0
30005,위고/Noun,1,1,0,1.1115310228308472e-05,0.0,1.0
30006,ㅜㅠㅜ/KoreanParticle,1,1,0,1.1115310228308472e-05,0.0,1.0
30007,-_-::::/Punctuation,1,0,1,0.0,1.1106915165381966e-05,1.0
30008,쇼티/Noun,1,0,1,0.0,1.1106915165381966e-05,1.0
30009,Forward/Alpha,1,1,0,1.1115310228308472e-05,0.0,1.0
30010,Moving/Alpha,1,1,0,1.1115310228308472e-05,0.0,1.0
30011,Trust/Alpha,1,0,1,0.0,1.1106915165381966e-05,1.0
30012,!!!!'/Punctuation,1,1,0,1.1115310228308472e-05,0.0,1.0
30013,보카/Noun,1,1,0,1.1115310228308472e-05,0.0,1.0
30014,등뒤/Noun,1,0,1,0.0,1.1106915165381966e-05,1.0
30015,..?;/Punctuation,1,0,1,0.0,1.1106915165381966e-05,1.0
30016,가쇼/Noun,1,1,0,1.1115310228308472e-05,0.0,1.0
30017,우보면/Noun,1,1,0,1.1115310228308472e-05,0.0,1.0
30018,짇/Noun,1,0,1,0.0,1.1106915165381966e-05,1.0
30019,레오폴드/Noun,1,1,0,1.1115310228308472e-05,0.0,1.0
30020,진노/Noun,1,1,0,1.1115310228308472e-05,0.0,1.0
30021,goodnight/Alpha,1,1,0,1.1115310228308472e-05,0.0,1.0
30022,켁켁/Noun,1,0,1,0.0,1.1106915165381966e-05,1.0
30023,백남준/Noun,1,0,1,0.0,1.1106915165381966e-05,1.0
30024,hauwbdmxkdudb/Alpha,1,0,1,0.0,1.1106915165381966e-05,1.0
30025,51%/Number,1,1,0,1.1115310228308472e-05,0.0,1.0
30026,gjwl/Alpha,1,0,1,0.0,1.1106915165381966e-05,1.0
30027,들레다/Verb,1,0,1,0.0,1.1106915165381966e-05,1.0
30028,더스트/Noun,1,1,0,1.1115310228308472e-05,0.0,1.0
30029,실용/Noun,1,0,1,0.0,1.1106915165381966e-05,1.0
30030,쉐퍼드/Noun,1,1,0,1.1115310228308472e-05,0.0,1.0
30031,블루문/Noun,1,1,0,1.1115310228308472e-05,0.0,1.0
30032,시바견/Noun,1,0,1,0.0,1.1106915165381966e-05,1.0
30033,진돗개/Noun,1,0,1,0.0,1.1106915165381966e-05,1.0
30034,붙겄/Noun,1,0,1,0.0,1.1106915165381966e-05,1.0
30035,웃엇구/Noun,1,1,0,1.1115310228308472e-05,0.0,1.0
30036,안봣자/Noun,1,1,0,1.1115310228308472e-05,0.0,1.0
30037,매스게임/Noun,1,0,1,0.0,1.1106915165381966e-05,1.0
30038,이원록/Noun,1,1,0,1.1115310228308472e-05,0.0,1.0
30039,디테일햐/Noun,1,1,0,1.1115310228308472e-05,0.0,1.0
30040,같곸/Noun,1,0,1,0.0,1.1106915165381966e-05,1.0
30041,트렌트/Noun,1,1,0,1.1115310228308472e-05,0.0,1.0
30042,코콬코/Noun,1,0,1,0.0,1.1106915165381966e-05,1.0
30043,흐어/Exclamation,1,1,0,1.1115310228308472e-05,0.0,1.0
30044,DADDY/Alpha,1,1,0,1.1115310228308472e-05,0.0,1.0
30045,FLY/Alpha,1,1,0,1.1115310228308472e-05,0.0,1.0
30046,갈라파고스/Noun,1,0,1,0.0,1.1106915165381966e-05,1.0
30047,변괴/Noun,1,0,1,0.0,1.1106915165381966e-05,1.0
30048,천재영/Noun,1,1,0,1.1115310228308472e-05,0.0,1.0
30049,려던/Noun,1,1,0,1.1115310228308472e-05,0.0,1.0
30050,┑/Foreign,1,0,1,0.0,1.1106915165381966e-05,1.0
30051,콜렛/Noun,1,1,0,1.1115310228308472e-05,0.0,1.0
30052,fucked/Alpha,1,0,1,0.0,1.1106915165381966e-05,1.0
30053,Marvel/Alpha,1,0,1,0.0,1.1106915165381966e-05,1.0
30054,Ang/Alpha,1,0,1,0.0,1.1106915165381966e-05,1.0
30055,어물쩍/Adverb,1,1,0,1.1115310228308472e-05,0.0,1.0
30056,Ophelia/Alpha,1,1,0,1.1115310228308472e-05,0.0,1.0
30057,realism/Alpha,1,1,0,1.1115310228308472e-05,0.0,1.0
30058,고도리/Noun,1,0,1,0.0,1.1106915165381966e-05,1.0
30059,문수/Noun,1,0,1,0.0,1.1106915165381966e-05,1.0
30060,톰히/Noun,1,1,0,1.1115310228308472e-05,0.0,1.0
30061,human/Alpha,1,1,0,1.1115310228308472e-05,0.0,1.0
30062,사금융/Noun,1,0,1,0.0,1.1106915165381966e-05,1.0
30063,컬두/Noun,1,0,1,0.0,1.1106915165381966e-05,1.0
30064,청량감/Noun,1,1,0,1.1115310228308472e-05,0.0,1.0
30065,1239/Number,1,1,0,1.1115310228308472e-05,0.0,1.0
30066,다미앙/Noun,1,0,1,0.0,1.1106915165381966e-05,1.0
30067,에탄/Noun,1,1,0,1.1115310228308472e-05,0.0,1.0
30068,팬터/Noun,1,0,1,0.0,1.1106915165381966e-05,1.0
30069,닮은꼴/Noun,1,1,0,1.1115310228308472e-05,0.0,1.0
30070,도니브래스코/Noun,1,1,0,1.1115310228308472e-05,0.0,1.0
30071,희소성/Noun,1,0,1,0.0,1.1106915165381966e-05,1.0
30072,빵집/Noun,1,0,1,0.0,1.1106915165381966e-05,1.0
30073,기개/Noun,1,0,1,0.0,1.1106915165381966e-05,1.0
30074,대장부/Noun,1,0,1,0.0,1.1106915165381966e-05,1.0
30075,350억/Number,1,0,1,0.0,1.1106915165381966e-05,1.0
30076,쌍용/Noun,1,1,0,1.1115310228308472e-05,0.0,1.0
30077,Deep/Alpha,1,0,1,0.0,1.1106915165381966e-05,1.0
30078,앞서서/Noun,1,0,1,0.0,1.1106915165381966e-05,1.0
30079,환각제/Noun,1,1,0,1.1115310228308472e-05,0.0,1.0
30080,아낰/Noun,1,1,0,1.1115310228308472e-05,0.0,1.0
30081,쌍칼행/Noun,1,0,1,0.0,1.1106915165381966e-05,1.0
30082,합장/Noun,1,1,0,1.1115310228308472e-05,0.0,1.0
30083,현인/Noun,1,1,0,1.1115310228308472e-05,0.0,1.0
30084,웅얼대/Noun,1,0,1,0.0,1.1106915165381966e-05,1.0
30085,스파이스/Noun,1,0,1,0.0,1.1106915165381966e-05,1.0
30086,위법성/Noun,1,1,0,1.1115310228308472e-05,0.0,1.0
30087,행위자/Noun,1,1,0,1.1115310228308472e-05,0.0,1.0
30088,丙女/Foreign,1,1,0,1.1115310228308472e-05,0.0,1.0
30089,358/Number,1,1,0,1.1115310228308472e-05,0.0,1.0
30090,89/Number,1,1,0,1.1115310228308472e-05,0.0,1.0
30091,1989.8/Number,1,1,0,1.1115310228308472e-05,0.0,1.0
30092,Trouble/Alpha,1,0,1,0.0,1.1106915165381966e-05,1.0
30093,.!!!!!!!~~~~~~~~~/Punctuation,1,1,0,1.1115310228308472e-05,0.0,1.0
30094,"-,,-/Punctuation",1,0,1,0.0,1.1106915165381966e-05,1.0
30095,환타지아/Noun,1,1,0,1.1115310228308472e-05,0.0,1.0
30096,쟁있음/Noun,1,1,0,1.1115310228308472e-05,0.0,1.0
30097,gd/Alpha,1,1,0,1.1115310228308472e-05,0.0,1.0
30098,펄펙/Noun,1,1,0,1.1115310228308472e-05,0.0,1.0
30099,앤서니/Noun,1,1,0,1.1115310228308472e-05,0.0,1.0
30100,썻더/Noun,1,0,1,0.0,1.1106915165381966e-05,1.0
30101,다케시류/Noun,1,0,1,0.0,1.1106915165381966e-05,1.0
30102,cuck/Alpha,1,1,0,1.1115310228308472e-05,0.0,1.0
30103,감언이설/Noun,1,0,1,0.0,1.1106915165381966e-05,1.0
30104,gear/Alpha,1,1,0,1.1115310228308472e-05,0.0,1.0
30105,Reverse/Alpha,1,1,0,1.1115310228308472e-05,0.0,1.0
30106,!!~^^/Punctuation,1,1,0,1.1115310228308472e-05,0.0,1.0
30107,루명쓰/Noun,1,0,1,0.0,1.1106915165381966e-05,1.0
30108,안그리/Noun,1,0,1,0.0,1.1106915165381966e-05,1.0
30109,과인/Noun,1,0,1,0.0,1.1106915165381966e-05,1.0
30110,버터플라이/Noun,1,1,0,1.1115310228308472e-05,0.0,1.0
30111,호선/Noun,1,1,0,1.1115310228308472e-05,0.0,1.0
30112,...-_/Punctuation,1,0,1,0.0,1.1106915165381966e-05,1.0
30113,우컥한다/Noun,1,1,0,1.1115310228308472e-05,0.0,1.0
30114,10~20%/Number,1,0,1,0.0,1.1106915165381966e-05,1.0
30115,골몰/Noun,1,1,0,1.1115310228308472e-05,0.0,1.0
30116,콩코드/Noun,1,1,0,1.1115310228308472e-05,0.0,1.0
30117,申/Foreign,1,0,1,0.0,1.1106915165381966e-05,1.0
30118,인혁인이에유/Noun,1,1,0,1.1115310228308472e-05,0.0,1.0
30119,클레오파트라/Noun,1,0,1,0.0,1.1106915165381966e-05,1.0
30120,영생교/Noun,1,1,0,1.1115310228308472e-05,0.0,1.0
30121,솰/Noun,1,1,0,1.1115310228308472e-05,0.0,1.0
30122,쭈그리다/Verb,1,1,0,1.1115310228308472e-05,0.0,1.0
30123,모조/Noun,1,0,1,0.0,1.1106915165381966e-05,1.0
30124,_-_;;;/Punctuation,1,0,1,0.0,1.1106915165381966e-05,1.0
30125,천년여왕/Noun,1,1,0,1.1115310228308472e-05,0.0,1.0
30126,칫/Noun,1,0,1,0.0,1.1106915165381966e-05,1.0
30127,능구렁이/Noun,1,1,0,1.1115310228308472e-05,0.0,1.0
30128,xOOO/Alpha,1,0,1,0.0,1.1106915165381966e-05,1.0
30129,조트망/Noun,1,0,1,0.0,1.1106915165381966e-05,1.0
30130,크라잉/Noun,1,0,1,0.0,1.1106915165381966e-05,1.0
30131,매니/Noun,1,1,0,1.1115310228308472e-05,0.0,1.0
30132,카카시/Noun,1,0,1,0.0,1.1106915165381966e-05,1.0
30133,지라이야/Noun,1,0,1,0.0,1.1106915165381966e-05,1.0
30134,루토/Noun,1,0,1,0.0,1.1106915165381966e-05,1.0
30135,낚네/Noun,1,0,1,0.0,1.1106915165381966e-05,1.0
30136,청량제/Noun,1,1,0,1.1115310228308472e-05,0.0,1.0
30137,꼬는거/Noun,1,1,0,1.1115310228308472e-05,0.0,1.0
30138,바꼇음/Noun,1,1,0,1.1115310228308472e-05,0.0,1.0
30139,敵/Foreign,1,0,1,0.0,1.1106915165381966e-05,1.0
30140,개낚/Noun,1,0,1,0.0,1.1106915165381966e-05,1.0
30141,뚯밖/Noun,1,0,1,0.0,1.1106915165381966e-05,1.0
30142,tothe/Alpha,1,0,1,0.0,1.1106915165381966e-05,1.0
30143,에브디/Noun,1,0,1,0.0,1.1106915165381966e-05,1.0
30144,여라븐/Noun,1,0,1,0.0,1.1106915165381966e-05,1.0
30145,몰캉몰캉/Adverb,1,1,0,1.1115310228308472e-05,0.0,1.0
30146,험난/Noun,1,1,0,1.1115310228308472e-05,0.0,1.0
30147,전여자친구/Noun,1,0,1,0.0,1.1106915165381966e-05,1.0
30148,리즈는/Foreign,1,1,0,1.1115310228308472e-05,0.0,1.0
30149,관개/Noun,1,0,1,0.0,1.1106915165381966e-05,1.0
30150,코옆/Noun,1,1,0,1.1115310228308472e-05,0.0,1.0
30151,배신쩌/Noun,1,0,1,0.0,1.1106915165381966e-05,1.0
30152,양태/Noun,1,1,0,1.1115310228308472e-05,0.0,1.0
30153,초굿/Noun,1,1,0,1.1115310228308472e-05,0.0,1.0
30154,닌듯/Noun,1,0,1,0.0,1.1106915165381966e-05,1.0
30155,디질레/Noun,1,0,1,0.0,1.1106915165381966e-05,1.0
30156,길잡이/Noun,1,1,0,1.1115310228308472e-05,0.0,1.0
30157,쓱삭/Noun,1,1,0,1.1115310228308472e-05,0.0,1.0
30158,쓱싹/Noun,1,1,0,1.1115310228308472e-05,0.0,1.0
30159,포동포동/Noun,1,1,0,1.1115310228308472e-05,0.0,1.0
30160,난입/Noun,1,1,0,1.1115310228308472e-05,0.0,1.0
30161,조오오오/Noun,1,0,1,0.0,1.1106915165381966e-05,1.0
30162,철두철미/Noun,1,1,0,1.1115310228308472e-05,0.0,1.0
30163,회볼때/Noun,1,1,0,1.1115310228308472e-05,0.0,1.0
30164,명사/Noun,1,0,1,0.0,1.1106915165381966e-05,1.0
30165,부산물/Noun,1,0,1,0.0,1.1106915165381966e-05,1.0
30166,찌워/Noun,1,0,1,0.0,1.1106915165381966e-05,1.0
30167,175/110/Number,1,0,1,0.0,1.1106915165381966e-05,1.0
30168,"..,,,..,,/Punctuation",1,1,0,1.1115310228308472e-05,0.0,1.0
30169,홍지민/Noun,1,0,1,0.0,1.1106915165381966e-05,1.0
30170,칸코쿠진다제/Noun,1,0,1,0.0,1.1106915165381966e-05,1.0
30171,마르다/Noun,1,1,0,1.1115310228308472e-05,0.0,1.0
30172,아즈/Noun,1,1,0,1.1115310228308472e-05,0.0,1.0
30173,2.38/Number,1,0,1,0.0,1.1106915165381966e-05,1.0
30174,기관차/Noun,1,1,0,1.1115310228308472e-05,0.0,1.0
30175,결탁/Noun,1,1,0,1.1115310228308472e-05,0.0,1.0
30176,틴좀/Noun,1,0,1,0.0,1.1106915165381966e-05,1.0
30177,엘라스/Noun,1,0,1,0.0,1.1106915165381966e-05,1.0
30178,7.69/Number,1,1,0,1.1115310228308472e-05,0.0,1.0
30179,개추/Noun,1,0,1,0.0,1.1106915165381966e-05,1.0
30180,갈라고/Noun,1,0,1,0.0,1.1106915165381966e-05,1.0
30181,눈땡/Noun,1,0,1,0.0,1.1106915165381966e-05,1.0
30182,물라/Noun,1,1,0,1.1115310228308472e-05,0.0,1.0
30183,tmda/Alpha,1,1,0,1.1115310228308472e-05,0.0,1.0
30184,Rickman/Alpha,1,0,1,0.0,1.1106915165381966e-05,1.0
30185,Alan/Alpha,1,0,1,0.0,1.1106915165381966e-05,1.0
30186,텐에드/Noun,1,1,0,1.1115310228308472e-05,0.0,1.0
30187,벽돌깨기/Noun,1,0,1,0.0,1.1106915165381966e-05,1.0
30188,시장경제/Noun,1,0,1,0.0,1.1106915165381966e-05,1.0
30189,길버트/Noun,1,1,0,1.1115310228308472e-05,0.0,1.0
30190,중색/Noun,1,0,1,0.0,1.1106915165381966e-05,1.0
30191,쭉쭉쭉/Noun,1,0,1,0.0,1.1106915165381966e-05,1.0
30192,삻증/Noun,1,0,1,0.0,1.1106915165381966e-05,1.0
30193,어록/Noun,1,1,0,1.1115310228308472e-05,0.0,1.0
30194,ㄷㄴ/KoreanParticle,1,0,1,0.0,1.1106915165381966e-05,1.0
30195,엉킬/Noun,1,1,0,1.1115310228308472e-05,0.0,1.0
30196,액숀배우/Noun,1,0,1,0.0,1.1106915165381966e-05,1.0
30197,빡빢/Noun,1,0,1,0.0,1.1106915165381966e-05,1.0
30198,우왓/Noun,1,1,0,1.1115310228308472e-05,0.0,1.0
30199,흔드/Noun,1,0,1,0.0,1.1106915165381966e-05,1.0
30200,음모론자/Noun,1,1,0,1.1115310228308472e-05,0.0,1.0
30201,태환/Noun,1,0,1,0.0,1.1106915165381966e-05,1.0
30202,썩창/Noun,1,0,1,0.0,1.1106915165381966e-05,1.0
30203,쓉노잼/Noun,1,0,1,0.0,1.1106915165381966e-05,1.0
30204,스렇/Noun,1,0,1,0.0,1.1106915165381966e-05,1.0
30205,뒹촌/Noun,1,0,1,0.0,1.1106915165381966e-05,1.0
30206,bye/Alpha,1,0,1,0.0,1.1106915165381966e-05,1.0
30207,협연/Noun,1,1,0,1.1115310228308472e-05,0.0,1.0
30208,돌프때문/Noun,1,0,1,0.0,1.1106915165381966e-05,1.0
30209,딥블루/Noun,1,0,1,0.0,1.1106915165381966e-05,1.0
30210,最高峰/Foreign,1,1,0,1.1115310228308472e-05,0.0,1.0
30211,갓챠맨/Noun,1,1,0,1.1115310228308472e-05,0.0,1.0
30212,대서양/Noun,1,1,0,1.1115310228308472e-05,0.0,1.0
30213,잉글랜드인/Noun,1,1,0,1.1115310228308472e-05,0.0,1.0
30214,큰아버지/Noun,1,0,1,0.0,1.1106915165381966e-05,1.0
30215,교편/Noun,1,0,1,0.0,1.1106915165381966e-05,1.0
30216,군조/Noun,1,1,0,1.1115310228308472e-05,0.0,1.0
30217,욕햇/Noun,1,0,1,0.0,1.1106915165381966e-05,1.0
30218,시기심/Noun,1,0,1,0.0,1.1106915165381966e-05,1.0
30219,세팅/Noun,1,0,1,0.0,1.1106915165381966e-05,1.0
30220,햇슴/Noun,1,0,1,0.0,1.1106915165381966e-05,1.0
30221,베스트일레븐/Noun,1,1,0,1.1115310228308472e-05,0.0,1.0
30222,범사/Noun,1,1,0,1.1115310228308472e-05,0.0,1.0
30223,관짝/Noun,1,0,1,0.0,1.1106915165381966e-05,1.0
30224,데드같/Noun,1,0,1,0.0,1.1106915165381966e-05,1.0
30225,퀵앤/Noun,1,0,1,0.0,1.1106915165381966e-05,1.0
30226,승방/Noun,1,0,1,0.0,1.1106915165381966e-05,1.0
30227,납작하다/Adjective,1,1,0,1.1115310228308472e-05,0.0,1.0
30228,자알살/Noun,1,1,0,1.1115310228308472e-05,0.0,1.0
30229,////////////Punctuation,1,1,0,1.1115310228308472e-05,0.0,1.0
30230,쩐쩐쩐/Noun,1,1,0,1.1115310228308472e-05,0.0,1.0
30231,피타고라스/Noun,1,0,1,0.0,1.1106915165381966e-05,1.0
30232,GOOOOOOOOOOOOOOOOOOOOOOOOOOOOOOOOOOOOOOOOOOOD/Alpha,1,1,0,1.1115310228308472e-05,0.0,1.0
30233,종석/Noun,1,1,0,1.1115310228308472e-05,0.0,1.0
30234,나남/Noun,1,1,0,1.1115310228308472e-05,0.0,1.0
30235,라무/Noun,1,1,0,1.1115310228308472e-05,0.0,1.0
30236,짤방/Noun,1,0,1,0.0,1.1106915165381966e-05,1.0
30237,하교/Noun,1,0,1,0.0,1.1106915165381966e-05,1.0
30238,발렌스/Noun,1,1,0,1.1115310228308472e-05,0.0,1.0
30239,에너지드링크/Noun,1,0,1,0.0,1.1106915165381966e-05,1.0
30240,증명서/Noun,1,0,1,0.0,1.1106915165381966e-05,1.0
30241,굿인뎀/Noun,1,1,0,1.1115310228308472e-05,0.0,1.0
30242,..^^.../Punctuation,1,1,0,1.1115310228308472e-05,0.0,1.0
30243,관불/Noun,1,0,1,0.0,1.1106915165381966e-05,1.0
30244,거러/Noun,1,0,1,0.0,1.1106915165381966e-05,1.0
30245,횐상/Noun,1,1,0,1.1115310228308472e-05,0.0,1.0
30246,금마좀/Noun,1,0,1,0.0,1.1106915165381966e-05,1.0
30247,베트멘/Noun,1,1,0,1.1115310228308472e-05,0.0,1.0
30248,끼울다/Verb,1,0,1,0.0,1.1106915165381966e-05,1.0
30249,쥬음/Noun,1,1,0,1.1115310228308472e-05,0.0,1.0
30250,주음/Noun,1,1,0,1.1115310228308472e-05,0.0,1.0
30251,송인화/Noun,1,0,1,0.0,1.1106915165381966e-05,1.0
30252,단양/Noun,1,0,1,0.0,1.1106915165381966e-05,1.0
30253,45236/Number,1,0,1,0.0,1.1106915165381966e-05,1.0
30254,난소/Noun,1,1,0,1.1115310228308472e-05,0.0,1.0
30255,야산/Noun,1,1,0,1.1115310228308472e-05,0.0,1.0
30256,강토/Noun,1,1,0,1.1115310228308472e-05,0.0,1.0
30257,널맛/Noun,1,0,1,0.0,1.1106915165381966e-05,1.0
30258,매출량/Noun,1,0,1,0.0,1.1106915165381966e-05,1.0
30259,딸땜/Noun,1,1,0,1.1115310228308472e-05,0.0,1.0
30260,이주헌/Noun,1,0,1,0.0,1.1106915165381966e-05,1.0
30261,지류/Noun,1,0,1,0.0,1.1106915165381966e-05,1.0
30262,muljomdao/Alpha,1,1,0,1.1115310228308472e-05,0.0,1.0
30263,emiya/Alpha,1,1,0,1.1115310228308472e-05,0.0,1.0
30264,^_^----/Punctuation,1,0,1,0.0,1.1106915165381966e-05,1.0
30265,허세씬/Noun,1,0,1,0.0,1.1106915165381966e-05,1.0
30266,포르투갈어/Noun,1,0,1,0.0,1.1106915165381966e-05,1.0
30267,섬칫하/Noun,1,1,0,1.1115310228308472e-05,0.0,1.0
30268,컨텍/Noun,1,0,1,0.0,1.1106915165381966e-05,1.0
30269,DMZ/Alpha,1,1,0,1.1115310228308472e-05,0.0,1.0
30270,이환경/Noun,1,0,1,0.0,1.1106915165381966e-05,1.0
30271,어째뜬/Noun,1,1,0,1.1115310228308472e-05,0.0,1.0
30272,내뿜/Noun,1,0,1,0.0,1.1106915165381966e-05,1.0
30273,삼패/Noun,1,0,1,0.0,1.1106915165381966e-05,1.0
30274,WONDERS/Alpha,1,1,0,1.1115310228308472e-05,0.0,1.0
30275,NOW/Alpha,1,1,0,1.1115310228308472e-05,0.0,1.0
30276,BLIND/Alpha,1,1,0,1.1115310228308472e-05,0.0,1.0
30277,OR/Alpha,1,1,0,1.1115310228308472e-05,0.0,1.0
30278,SEEING/Alpha,1,1,0,1.1115310228308472e-05,0.0,1.0
30279,MUTE/Alpha,1,1,0,1.1115310228308472e-05,0.0,1.0
30280,DEAF/Alpha,1,1,0,1.1115310228308472e-05,0.0,1.0
30281,MOUTH/Alpha,1,1,0,1.1115310228308472e-05,0.0,1.0
30282,MADE/Alpha,1,1,0,1.1115310228308472e-05,0.0,1.0
30283,리멬/Noun,1,1,0,1.1115310228308472e-05,0.0,1.0
30284,갈색/Noun,1,1,0,1.1115310228308472e-05,0.0,1.0
30285,흠좀무/Noun,1,0,1,0.0,1.1106915165381966e-05,1.0
30286,bear/Alpha,1,0,1,0.0,1.1106915165381966e-05,1.0
30287,오떼블/Noun,1,0,1,0.0,1.1106915165381966e-05,1.0
30288,버리셧/Noun,1,0,1,0.0,1.1106915165381966e-05,1.0
30289,!>/Punctuation,1,0,1,0.0,1.1106915165381966e-05,1.0
30290,!!<~/Punctuation,1,0,1,0.0,1.1106915165381966e-05,1.0
30291,8.70/Number,1,0,1,0.0,1.1106915165381966e-05,1.0
30292,나치즘/Noun,1,0,1,0.0,1.1106915165381966e-05,1.0
30293,아리아인/Noun,1,0,1,0.0,1.1106915165381966e-05,1.0
30294,봈/Noun,1,0,1,0.0,1.1106915165381966e-05,1.0
30295,우쒸/Noun,1,0,1,0.0,1.1106915165381966e-05,1.0
30296,이겻다/Noun,1,0,1,0.0,1.1106915165381966e-05,1.0
30297,사이만/Noun,1,1,0,1.1115310228308472e-05,0.0,1.0
30298,인펙트/Noun,1,0,1,0.0,1.1106915165381966e-05,1.0
30299,줄껀데/Noun,1,0,1,0.0,1.1106915165381966e-05,1.0
30300,깝스/Noun,1,1,0,1.1115310228308472e-05,0.0,1.0
30301,제만/Noun,1,1,0,1.1115310228308472e-05,0.0,1.0
30302,1966/Number,1,1,0,1.1115310228308472e-05,0.0,1.0
30303,이탈리아전/Noun,1,1,0,1.1115310228308472e-05,0.0,1.0
30304,폭설/Noun,1,0,1,0.0,1.1106915165381966e-05,1.0
30305,세컨즈/Noun,1,0,1,0.0,1.1106915165381966e-05,1.0
30306,좀넘었을때본영화/Foreign,1,0,1,0.0,1.1106915165381966e-05,1.0
30307,맹랑하/Noun,1,1,0,1.1115310228308472e-05,0.0,1.0
30308,~^^&/Punctuation,1,1,0,1.1115310228308472e-05,0.0,1.0
30309,읏/Noun,1,1,0,1.1115310228308472e-05,0.0,1.0
30310,꼬뤠/Noun,1,0,1,0.0,1.1106915165381966e-05,1.0
30311,젠안/Noun,1,0,1,0.0,1.1106915165381966e-05,1.0
30312,생쑈/Noun,1,0,1,0.0,1.1106915165381966e-05,1.0
30313,평시/Noun,1,0,1,0.0,1.1106915165381966e-05,1.0
30314,엄밀하다/Adjective,1,0,1,0.0,1.1106915165381966e-05,1.0
30315,최진희/Noun,1,1,0,1.1115310228308472e-05,0.0,1.0
30316,손원일/Noun,1,1,0,1.1115310228308472e-05,0.0,1.0
30317,곽희성/Noun,1,1,0,1.1115310228308472e-05,0.0,1.0
30318,김형준/Noun,1,1,0,1.1115310228308472e-05,0.0,1.0
30319,김다솜/Noun,1,1,0,1.1115310228308472e-05,0.0,1.0
30320,신형/Noun,1,1,0,1.1115310228308472e-05,0.0,1.0
30321,뚱보흑/Noun,1,0,1,0.0,1.1106915165381966e-05,1.0
30322,두피/Noun,1,0,1,0.0,1.1106915165381966e-05,1.0
30323,아떻/Noun,1,0,1,0.0,1.1106915165381966e-05,1.0
30324,토착/Noun,1,1,0,1.1115310228308472e-05,0.0,1.0
30325,재밌졍/Noun,1,1,0,1.1115310228308472e-05,0.0,1.0
30326,연장했는지/Foreign,1,0,1,0.0,1.1106915165381966e-05,1.0
30327,깇체/Noun,1,0,1,0.0,1.1106915165381966e-05,1.0
30328,가쁘/Noun,1,1,0,1.1115310228308472e-05,0.0,1.0
30329,렌달/Noun,1,1,0,1.1115310228308472e-05,0.0,1.0
30330,fragility/Alpha,1,1,0,1.1115310228308472e-05,0.0,1.0
30331,산골/Noun,1,0,1,0.0,1.1106915165381966e-05,1.0
30332,영일/Noun,1,0,1,0.0,1.1106915165381966e-05,1.0
30333,거숙재/Noun,1,1,0,1.1115310228308472e-05,0.0,1.0
30334,호탄/Noun,1,0,1,0.0,1.1106915165381966e-05,1.0
30335,드렿어/Noun,1,1,0,1.1115310228308472e-05,0.0,1.0
30336,임칙서/Noun,1,1,0,1.1115310228308472e-05,0.0,1.0
30337,림보/Noun,1,1,0,1.1115310228308472e-05,0.0,1.0
30338,엔들/Josa,1,0,1,0.0,1.1106915165381966e-05,1.0
30339,bbbbbbbbbb/Alpha,1,1,0,1.1115310228308472e-05,0.0,1.0
30340,"-""-_)/Punctuation",1,0,1,0.0,1.1106915165381966e-05,1.0
30341,~~'(/Punctuation,1,0,1,0.0,1.1106915165381966e-05,1.0
30342,한냐/Noun,1,1,0,1.1115310228308472e-05,0.0,1.0
30343,디케이드/Noun,1,1,0,1.1115310228308472e-05,0.0,1.0
30344,점퀸/Noun,1,1,0,1.1115310228308472e-05,0.0,1.0
30345,광내/Noun,1,0,1,0.0,1.1106915165381966e-05,1.0
30346,..///Punctuation,1,0,1,0.0,1.1106915165381966e-05,1.0
30347,wacked/Alpha,1,0,1,0.0,1.1106915165381966e-05,1.0
30348,daredevil/Alpha,1,0,1,0.0,1.1106915165381966e-05,1.0
30349,seeing/Alpha,1,0,1,0.0,1.1106915165381966e-05,1.0
30350,worth/Alpha,1,0,1,0.0,1.1106915165381966e-05,1.0
30351,돌림빵/Noun,1,0,1,0.0,1.1106915165381966e-05,1.0
30352,...^^;;;;/Punctuation,1,1,0,1.1115310228308472e-05,0.0,1.0
30353,플로피디스크/Noun,1,1,0,1.1115310228308472e-05,0.0,1.0
30354,어바웃/Noun,1,1,0,1.1115310228308472e-05,0.0,1.0
30355,돌발행동/Noun,1,1,0,1.1115310228308472e-05,0.0,1.0
30356,쓸애긔/Noun,1,0,1,0.0,1.1106915165381966e-05,1.0
30357,애긔/Noun,1,0,1,0.0,1.1106915165381966e-05,1.0
30358,Roman/Alpha,1,1,0,1.1115310228308472e-05,0.0,1.0
30359,판임/Noun,1,0,1,0.0,1.1106915165381966e-05,1.0
30360,파라노만/Noun,1,1,0,1.1115310228308472e-05,0.0,1.0
30361,항아리/Noun,1,1,0,1.1115310228308472e-05,0.0,1.0
30362,슨놈/Noun,1,0,1,0.0,1.1106915165381966e-05,1.0
30363,냇다/Noun,1,0,1,0.0,1.1106915165381966e-05,1.0
30364,새롭웠/Noun,1,1,0,1.1115310228308472e-05,0.0,1.0
30365,가족오락관/Noun,1,0,1,0.0,1.1106915165381966e-05,1.0
30366,엮어가/Noun,1,0,1,0.0,1.1106915165381966e-05,1.0
30367,폐륜이엿을때/Noun,1,1,0,1.1115310228308472e-05,0.0,1.0
30368,정맖/Noun,1,1,0,1.1115310228308472e-05,0.0,1.0
30369,나연/Noun,1,0,1,0.0,1.1106915165381966e-05,1.0
30370,뜍딱빼곸/Noun,1,0,1,0.0,1.1106915165381966e-05,1.0
30371,;_;/Punctuation,1,0,1,0.0,1.1106915165381966e-05,1.0
30372,"??,/Punctuation",1,1,0,1.1115310228308472e-05,0.0,1.0
30373,~~^^!/Punctuation,1,1,0,1.1115310228308472e-05,0.0,1.0
30374,6.42/Number,1,0,1,0.0,1.1106915165381966e-05,1.0
30375,키넥트/Noun,1,0,1,0.0,1.1106915165381966e-05,1.0
30376,원로/Noun,1,0,1,0.0,1.1106915165381966e-05,1.0
30377,쯤보면/Foreign,1,0,1,0.0,1.1106915165381966e-05,1.0
30378,섹슈/Noun,1,0,1,0.0,1.1106915165381966e-05,1.0
30379,흨흨/Noun,1,0,1,0.0,1.1106915165381966e-05,1.0
30380,몆억하/Noun,1,0,1,0.0,1.1106915165381966e-05,1.0
30381,간병인/Noun,1,0,1,0.0,1.1106915165381966e-05,1.0
30382,홍칠/Noun,1,1,0,1.1115310228308472e-05,0.0,1.0
30383,키오/Noun,1,1,0,1.1115310228308472e-05,0.0,1.0
30384,굳굳잉/Noun,1,1,0,1.1115310228308472e-05,0.0,1.0
30385,!!!!&@/Punctuation,1,1,0,1.1115310228308472e-05,0.0,1.0
30386,어짤거/Noun,1,0,1,0.0,1.1106915165381966e-05,1.0
30387,짤린건/Noun,1,0,1,0.0,1.1106915165381966e-05,1.0
30388,300%/Number,1,0,1,0.0,1.1106915165381966e-05,1.0
30389,재앰/Noun,1,1,0,1.1115310228308472e-05,0.0,1.0
30390,어류/Noun,1,1,0,1.1115310228308472e-05,0.0,1.0
30391,바침/Noun,1,1,0,1.1115310228308472e-05,0.0,1.0
30392,14111141516/Number,1,0,1,0.0,1.1106915165381966e-05,1.0
30393,봐왛/Noun,1,1,0,1.1115310228308472e-05,0.0,1.0
30394,지하철도/Noun,1,0,1,0.0,1.1106915165381966e-05,1.0
30395,.....!!!/Punctuation,1,0,1,0.0,1.1106915165381966e-05,1.0
30396,-.-;/Punctuation,1,0,1,0.0,1.1106915165381966e-05,1.0
30397,object/Alpha,1,1,0,1.1115310228308472e-05,0.0,1.0
30398,곱절/Noun,1,0,1,0.0,1.1106915165381966e-05,1.0
30399,애술임/Noun,1,1,0,1.1115310228308472e-05,0.0,1.0
30400,헝헝/Noun,1,1,0,1.1115310228308472e-05,0.0,1.0
30401,퍼슈/Noun,1,0,1,0.0,1.1106915165381966e-05,1.0
30402,입툭/Noun,1,0,1,0.0,1.1106915165381966e-05,1.0
30403,인슾/Noun,1,0,1,0.0,1.1106915165381966e-05,1.0
30404,얷/Noun,1,0,1,0.0,1.1106915165381966e-05,1.0
30405,애썻/Noun,1,0,1,0.0,1.1106915165381966e-05,1.0
30406,유영준/Noun,1,0,1,0.0,1.1106915165381966e-05,1.0
30407,손영목/Noun,1,0,1,0.0,1.1106915165381966e-05,1.0
30408,도작이어도/Foreign,1,1,0,1.1115310228308472e-05,0.0,1.0
30409,냉수/Noun,1,0,1,0.0,1.1106915165381966e-05,1.0
30410,팎/Noun,1,0,1,0.0,1.1106915165381966e-05,1.0
30411,어트케잘/Noun,1,0,1,0.0,1.1106915165381966e-05,1.0
30412,풀샷/Noun,1,0,1,0.0,1.1106915165381966e-05,1.0
30413,기고가/Noun,1,0,1,0.0,1.1106915165381966e-05,1.0
30414,닥빙녀/Noun,1,1,0,1.1115310228308472e-05,0.0,1.0
30415,읶얶/Noun,1,0,1,0.0,1.1106915165381966e-05,1.0
30416,버둥버둥/Adverb,1,0,1,0.0,1.1106915165381966e-05,1.0
30417,Putrefaction/Alpha,1,1,0,1.1115310228308472e-05,0.0,1.0
30418,Quasi/Alpha,1,1,0,1.1115310228308472e-05,0.0,1.0
30419,Chthonic/Alpha,1,1,0,1.1115310228308472e-05,0.0,1.0
30420,노웨어보이/Noun,1,1,0,1.1115310228308472e-05,0.0,1.0
30421,:-):-)/Punctuation,1,1,0,1.1115310228308472e-05,0.0,1.0
30422,퀄리티란/Noun,1,1,0,1.1115310228308472e-05,0.0,1.0
30423,재밍벗음/Noun,1,0,1,0.0,1.1106915165381966e-05,1.0
30424,도애/Noun,1,1,0,1.1115310228308472e-05,0.0,1.0
30425,씁쓰름/Noun,1,1,0,1.1115310228308472e-05,0.0,1.0
30426,달콤새콤/Noun,1,1,0,1.1115310228308472e-05,0.0,1.0
30427,주제음악/Noun,1,1,0,1.1115310228308472e-05,0.0,1.0
30428,했느/Noun,1,0,1,0.0,1.1106915165381966e-05,1.0
30429,메신저/Noun,1,1,0,1.1115310228308472e-05,0.0,1.0
30430,에노/Noun,1,1,0,1.1115310228308472e-05,0.0,1.0
30431,식해/Noun,1,1,0,1.1115310228308472e-05,0.0,1.0
30432,ㄲㅣ/KoreanParticle,1,0,1,0.0,1.1106915165381966e-05,1.0
30433,베이스볼/Noun,1,0,1,0.0,1.1106915165381966e-05,1.0
30434,루피해적단/Noun,1,1,0,1.1115310228308472e-05,0.0,1.0
30435,맥닐/Noun,1,0,1,0.0,1.1106915165381966e-05,1.0
30436,最高/Foreign,1,1,0,1.1115310228308472e-05,0.0,1.0
30437,항공권/Noun,1,1,0,1.1115310228308472e-05,0.0,1.0
30438,다단/Noun,1,1,0,1.1115310228308472e-05,0.0,1.0
30439,방지법/Noun,1,0,1,0.0,1.1106915165381966e-05,1.0
30440,의투자로/Foreign,1,0,1,0.0,1.1106915165381966e-05,1.0
30441,1300억/Number,1,0,1,0.0,1.1106915165381966e-05,1.0
30442,엘르페닝/Noun,1,0,1,0.0,1.1106915165381966e-05,1.0
30443,드믈게본/Noun,1,0,1,0.0,1.1106915165381966e-05,1.0
30444,일직선/Noun,1,1,0,1.1115310228308472e-05,0.0,1.0
30445,잗같/Noun,1,1,0,1.1115310228308472e-05,0.0,1.0
30446,밥삼/Noun,1,1,0,1.1115310228308472e-05,0.0,1.0
30447,생해/Noun,1,0,1,0.0,1.1106915165381966e-05,1.0
30448,렉서스/Noun,1,0,1,0.0,1.1106915165381966e-05,1.0
30449,어렿을때/Noun,1,1,0,1.1115310228308472e-05,0.0,1.0
30450,재야/Noun,1,0,1,0.0,1.1106915165381966e-05,1.0
30451,녹음테이프/Noun,1,1,0,1.1115310228308472e-05,0.0,1.0
30452,베네수엘라/Noun,1,1,0,1.1115310228308472e-05,0.0,1.0
30453,투페이스/Noun,1,0,1,0.0,1.1106915165381966e-05,1.0
30454,유용/Noun,1,0,1,0.0,1.1106915165381966e-05,1.0
30455,곁가지/Noun,1,1,0,1.1115310228308472e-05,0.0,1.0
30456,킷스이소/Noun,1,1,0,1.1115310228308472e-05,0.0,1.0
30457,땐디/Noun,1,0,1,0.0,1.1106915165381966e-05,1.0
30458,위워회/Noun,1,1,0,1.1115310228308472e-05,0.0,1.0
30459,힛츄/Noun,1,0,1,0.0,1.1106915165381966e-05,1.0
30460,폭락/Noun,1,0,1,0.0,1.1106915165381966e-05,1.0
30461,먹는게/Foreign,1,0,1,0.0,1.1106915165381966e-05,1.0
30462,불친철/Noun,1,1,0,1.1115310228308472e-05,0.0,1.0
30463,--..../Punctuation,1,0,1,0.0,1.1106915165381966e-05,1.0
30464,살발/Noun,1,1,0,1.1115310228308472e-05,0.0,1.0
30465,똑바르다/Adjective,1,1,0,1.1115310228308472e-05,0.0,1.0
30466,12:10/Number,1,1,0,1.1115310228308472e-05,0.0,1.0
30467,섀도우헌터스/Noun,1,0,1,0.0,1.1106915165381966e-05,1.0
30468,老/Foreign,1,0,1,0.0,1.1106915165381966e-05,1.0
30469,ㅎㅜ/KoreanParticle,1,1,0,1.1115310228308472e-05,0.0,1.0
30470,잔망스럽다/Adjective,1,1,0,1.1115310228308472e-05,0.0,1.0
30471,나누기/Noun,1,0,1,0.0,1.1106915165381966e-05,1.0
30472,어쩜조/Noun,1,1,0,1.1115310228308472e-05,0.0,1.0
30473,칸쿠로/Noun,1,1,0,1.1115310228308472e-05,0.0,1.0
30474,!+/Punctuation,1,1,0,1.1115310228308472e-05,0.0,1.0
30475,낮워/Noun,1,0,1,0.0,1.1106915165381966e-05,1.0
30476,쉑히들/Noun,1,0,1,0.0,1.1106915165381966e-05,1.0
30477,못하겟다/Noun,1,0,1,0.0,1.1106915165381966e-05,1.0
30478,베땅/Noun,1,1,0,1.1115310228308472e-05,0.0,1.0
30479,브레겐츠/Noun,1,1,0,1.1115310228308472e-05,0.0,1.0
30480,102%/Number,1,1,0,1.1115310228308472e-05,0.0,1.0
30481,꿋꿋이사/Noun,1,0,1,0.0,1.1106915165381966e-05,1.0
30482,상급자/Noun,1,0,1,0.0,1.1106915165381966e-05,1.0
30483,고성/Noun,1,0,1,0.0,1.1106915165381966e-05,1.0
30484,一品/Foreign,1,1,0,1.1115310228308472e-05,0.0,1.0
30485,파계/Noun,1,0,1,0.0,1.1106915165381966e-05,1.0
30486,띨띨/Noun,1,0,1,0.0,1.1106915165381966e-05,1.0
30487,무뎌/Noun,1,1,0,1.1115310228308472e-05,0.0,1.0
30488,ssibal/Alpha,1,1,0,1.1115310228308472e-05,0.0,1.0
30489,디빠들/Noun,1,0,1,0.0,1.1106915165381966e-05,1.0
30490,상쇄목적/Noun,1,0,1,0.0,1.1106915165381966e-05,1.0
30491,4/24/Number,1,0,1,0.0,1.1106915165381966e-05,1.0
30492,떠내려가다/Verb,1,0,1,0.0,1.1106915165381966e-05,1.0
30493,옹옹/Noun,1,1,0,1.1115310228308472e-05,0.0,1.0
30494,유잼/Noun,1,1,0,1.1115310228308472e-05,0.0,1.0
30495,(../Punctuation,1,0,1,0.0,1.1106915165381966e-05,1.0
30496,안창남/Noun,1,0,1,0.0,1.1106915165381966e-05,1.0
30497,이러나저러나/Adverb,1,0,1,0.0,1.1106915165381966e-05,1.0
30498,헛짚/Noun,1,0,1,0.0,1.1106915165381966e-05,1.0
30499,투석기/Noun,1,0,1,0.0,1.1106915165381966e-05,1.0
30500,켈트/Noun,1,0,1,0.0,1.1106915165381966e-05,1.0
30501,냉병기/Noun,1,0,1,0.0,1.1106915165381966e-05,1.0
30502,닥터챔프/Noun,1,1,0,1.1115310228308472e-05,0.0,1.0
30503,찹찹하다/Adjective,1,1,0,1.1115310228308472e-05,0.0,1.0
30504,럭키루/Noun,1,1,0,1.1115310228308472e-05,0.0,1.0
30505,여로/Noun,1,1,0,1.1115310228308472e-05,0.0,1.0
30506,매젬/Noun,1,1,0,1.1115310228308472e-05,0.0,1.0
30507,착색제/Noun,1,0,1,0.0,1.1106915165381966e-05,1.0
30508,감미료/Noun,1,0,1,0.0,1.1106915165381966e-05,1.0
30509,바둑용어/Noun,1,0,1,0.0,1.1106915165381966e-05,1.0
30510,よし！/Foreign,1,1,0,1.1115310228308472e-05,0.0,1.0
30511,後部よし、信/Foreign,1,1,0,1.1115310228308472e-05,0.0,1.0
30512,플림턴식/Noun,1,1,0,1.1115310228308472e-05,0.0,1.0
30513,nous/Alpha,1,1,0,1.1115310228308472e-05,0.0,1.0
30514,monde/Alpha,1,1,0,1.1115310228308472e-05,0.0,1.0
30515,중훈햄/Noun,1,1,0,1.1115310228308472e-05,0.0,1.0
30516,삐끼/Noun,1,1,0,1.1115310228308472e-05,0.0,1.0
30517,으흐흣/Noun,1,1,0,1.1115310228308472e-05,0.0,1.0
30518,더렵혀진/Noun,1,1,0,1.1115310228308472e-05,0.0,1.0
30519,맘에들면/Noun,1,0,1,0.0,1.1106915165381966e-05,1.0
30520,사진가/Noun,1,1,0,1.1115310228308472e-05,0.0,1.0
30521,Portrait/Alpha,1,1,0,1.1115310228308472e-05,0.0,1.0
30522,강잠/Noun,1,1,0,1.1115310228308472e-05,0.0,1.0
30523,멍텅/Noun,1,0,1,0.0,1.1106915165381966e-05,1.0
30524,정도만/Foreign,1,0,1,0.0,1.1106915165381966e-05,1.0
30525,때민/Noun,1,0,1,0.0,1.1106915165381966e-05,1.0
30526,개잘생겻다/Noun,1,1,0,1.1115310228308472e-05,0.0,1.0
30527,낸스/Noun,1,1,0,1.1115310228308472e-05,0.0,1.0
30528,용감/Noun,1,1,0,1.1115310228308472e-05,0.0,1.0
30529,웨웨/Noun,1,1,0,1.1115310228308472e-05,0.0,1.0
30530,셀틈/Noun,1,1,0,1.1115310228308472e-05,0.0,1.0
30531,후쿠아/Noun,1,0,1,0.0,1.1106915165381966e-05,1.0
30532,남에껄/Noun,1,0,1,0.0,1.1106915165381966e-05,1.0
30533,마영전/Noun,1,1,0,1.1115310228308472e-05,0.0,1.0
30534,까요/Foreign,1,1,0,1.1115310228308472e-05,0.0,1.0
30535,8.86일/Number,1,1,0,1.1115310228308472e-05,0.0,1.0
30536,틈새/Noun,1,0,1,0.0,1.1106915165381966e-05,1.0
30537,유덕/Noun,1,1,0,1.1115310228308472e-05,0.0,1.0
30538,부터만/Foreign,1,0,1,0.0,1.1106915165381966e-05,1.0
30539,1231234/Number,1,0,1,0.0,1.1106915165381966e-05,1.0
30540,마라천/Noun,1,0,1,0.0,1.1106915165381966e-05,1.0
30541,이소윤/Noun,1,1,0,1.1115310228308472e-05,0.0,1.0
30542,쫄리/Noun,1,1,0,1.1115310228308472e-05,0.0,1.0
30543,조달/Noun,1,1,0,1.1115310228308472e-05,0.0,1.0
30544,엤다/Noun,1,0,1,0.0,1.1106915165381966e-05,1.0
30545,0411/Number,1,0,1,0.0,1.1106915165381966e-05,1.0
30546,bmh/Alpha,1,0,1,0.0,1.1106915165381966e-05,1.0
30547,젠맘/Noun,1,1,0,1.1115310228308472e-05,0.0,1.0
30548,므슨/Noun,1,1,0,1.1115310228308472e-05,0.0,1.0
30549,통분/Noun,1,0,1,0.0,1.1106915165381966e-05,1.0
30550,sexy/Alpha,1,0,1,0.0,1.1106915165381966e-05,1.0
30551,통랄/Noun,1,1,0,1.1115310228308472e-05,0.0,1.0
30552,검차/Noun,1,1,0,1.1115310228308472e-05,0.0,1.0
30553,사가라/Noun,1,0,1,0.0,1.1106915165381966e-05,1.0
30554,파로/Noun,1,1,0,1.1115310228308472e-05,0.0,1.0
30555,에이치/Noun,1,1,0,1.1115310228308472e-05,0.0,1.0
30556,삼위/Noun,1,1,0,1.1115310228308472e-05,0.0,1.0
30557,부캐/Noun,1,0,1,0.0,1.1106915165381966e-05,1.0
30558,인조반정/Noun,1,0,1,0.0,1.1106915165381966e-05,1.0
30559,팽팽하/Noun,1,1,0,1.1115310228308472e-05,0.0,1.0
30560,키려/Noun,1,1,0,1.1115310228308472e-05,0.0,1.0
30561,사/Foreign,1,0,1,0.0,1.1106915165381966e-05,1.0
30562,1911년/Number,1,0,1,0.0,1.1106915165381966e-05,1.0
30563,비됴로/Noun,1,0,1,0.0,1.1106915165381966e-05,1.0
30564,만든뇬/Noun,1,0,1,0.0,1.1106915165381966e-05,1.0
30565,".!?,-/Punctuation",1,0,1,0.0,1.1106915165381966e-05,1.0
30566,아주까리/Noun,1,1,0,1.1115310228308472e-05,0.0,1.0
30567,횐줄/Noun,1,1,0,1.1115310228308472e-05,0.0,1.0
30568,도영화에/Foreign,1,1,0,1.1115310228308472e-05,0.0,1.0
30569,세터/Noun,1,1,0,1.1115310228308472e-05,0.0,1.0
30570,배렸어/Noun,1,0,1,0.0,1.1106915165381966e-05,1.0
30571,가셧/Noun,1,1,0,1.1115310228308472e-05,0.0,1.0
30572,해바/Noun,1,0,1,0.0,1.1106915165381966e-05,1.0
30573,등외/Noun,1,0,1,0.0,1.1106915165381966e-05,1.0
30574,소리내기/Noun,1,1,0,1.1115310228308472e-05,0.0,1.0
30575,해달/Noun,1,1,0,1.1115310228308472e-05,0.0,1.0
30576,뉴스메이커/Noun,1,0,1,0.0,1.1106915165381966e-05,1.0
30577,샘슨/Noun,1,1,0,1.1115310228308472e-05,0.0,1.0
30578,더임/Noun,1,1,0,1.1115310228308472e-05,0.0,1.0
30579,연공/Noun,1,1,0,1.1115310228308472e-05,0.0,1.0
30580,섷/Noun,1,1,0,1.1115310228308472e-05,0.0,1.0
30581,얽매/Noun,1,1,0,1.1115310228308472e-05,0.0,1.0
30582,부페/Noun,1,0,1,0.0,1.1106915165381966e-05,1.0
30583,80원/Number,1,0,1,0.0,1.1106915165381966e-05,1.0
30584,거로/Noun,1,0,1,0.0,1.1106915165381966e-05,1.0
30585,쟈넷/Noun,1,1,0,1.1115310228308472e-05,0.0,1.0
30586,、、/Foreign,1,1,0,1.1115310228308472e-05,0.0,1.0
30587,40~40/Number,1,1,0,1.1115310228308472e-05,0.0,1.0
30588,다감하다/Adjective,1,1,0,1.1115310228308472e-05,0.0,1.0
30589,드뭄/Noun,1,1,0,1.1115310228308472e-05,0.0,1.0
30590,백악기/Noun,1,1,0,1.1115310228308472e-05,0.0,1.0
30591,꼬디/Noun,1,1,0,1.1115310228308472e-05,0.0,1.0
30592,인욕/Noun,1,0,1,0.0,1.1106915165381966e-05,1.0
30593,스팁유/Noun,1,0,1,0.0,1.1106915165381966e-05,1.0
30594,빠걸/Noun,1,0,1,0.0,1.1106915165381966e-05,1.0
30595,gaga/Alpha,1,1,0,1.1115310228308472e-05,0.0,1.0
30596,Laby/Alpha,1,1,0,1.1115310228308472e-05,0.0,1.0
30597,삿을수/Noun,1,1,0,1.1115310228308472e-05,0.0,1.0
30598,남국/Noun,1,1,0,1.1115310228308472e-05,0.0,1.0
30599,괜찬았/Noun,1,0,1,0.0,1.1106915165381966e-05,1.0
30600,사운트/Noun,1,1,0,1.1115310228308472e-05,0.0,1.0
30601,유처운/Noun,1,1,0,1.1115310228308472e-05,0.0,1.0
30602,ㅂㅃ/KoreanParticle,1,0,1,0.0,1.1106915165381966e-05,1.0
30603,해론/Noun,1,0,1,0.0,1.1106915165381966e-05,1.0
30604,leesj/Alpha,1,1,0,1.1115310228308472e-05,0.0,1.0
30605,톱안/Noun,1,1,0,1.1115310228308472e-05,0.0,1.0
30606,.!!!!!!!!/Punctuation,1,1,0,1.1115310228308472e-05,0.0,1.0
30607,........^*^/Punctuation,1,1,0,1.1115310228308472e-05,0.0,1.0
30608,네이비실/Noun,1,1,0,1.1115310228308472e-05,0.0,1.0
30609,미주리호/Noun,1,1,0,1.1115310228308472e-05,0.0,1.0
30610,dfa/Alpha,1,1,0,1.1115310228308472e-05,0.0,1.0
30611,동방박사/Noun,1,1,0,1.1115310228308472e-05,0.0,1.0
30612,졷니뎁/Noun,1,0,1,0.0,1.1106915165381966e-05,1.0
30613,~:)/Punctuation,1,1,0,1.1115310228308472e-05,0.0,1.0
30614,권보아/Noun,1,1,0,1.1115310228308472e-05,0.0,1.0
30615,드레/Noun,1,0,1,0.0,1.1106915165381966e-05,1.0
30616,예컨대/Adverb,1,0,1,0.0,1.1106915165381966e-05,1.0
30617,낛시/Noun,1,1,0,1.1115310228308472e-05,0.0,1.0
30618,볼껄했던/Noun,1,0,1,0.0,1.1106915165381966e-05,1.0
30619,.@./Email,1,1,0,1.1115310228308472e-05,0.0,1.0
30620,간전/Noun,1,1,0,1.1115310228308472e-05,0.0,1.0
30621,.@3/Email,1,1,0,1.1115310228308472e-05,0.0,1.0
30622,~@/Foreign,1,1,0,1.1115310228308472e-05,0.0,1.0
30623,rainbow/Alpha,1,1,0,1.1115310228308472e-05,0.0,1.0
30624,꽁/Noun,1,1,0,1.1115310228308472e-05,0.0,1.0
30625,코이츠/Noun,1,1,0,1.1115310228308472e-05,0.0,1.0
30626,뉴하프/Noun,1,0,1,0.0,1.1106915165381966e-05,1.0
30627,수애떄문/Noun,1,0,1,0.0,1.1106915165381966e-05,1.0
30628,괘심/Noun,1,0,1,0.0,1.1106915165381966e-05,1.0
30629,oddity/Alpha,1,1,0,1.1115310228308472e-05,0.0,1.0
30630,모만/Noun,1,0,1,0.0,1.1106915165381966e-05,1.0
30631,동래/Noun,1,0,1,0.0,1.1106915165381966e-05,1.0
30632,레기작/Noun,1,0,1,0.0,1.1106915165381966e-05,1.0
30633,검검/Noun,1,1,0,1.1115310228308472e-05,0.0,1.0
30634,냣/Noun,1,0,1,0.0,1.1106915165381966e-05,1.0
30635,~??????/Punctuation,1,1,0,1.1115310228308472e-05,0.0,1.0
30636,Atelier/Alpha,1,1,0,1.1115310228308472e-05,0.0,1.0
30637,Dior/Alpha,1,1,0,1.1115310228308472e-05,0.0,1.0
30638,반내내/Foreign,1,1,0,1.1115310228308472e-05,0.0,1.0
30639,과방/Noun,1,0,1,0.0,1.1106915165381966e-05,1.0
30640,구천원/Noun,1,0,1,0.0,1.1106915165381966e-05,1.0
30641,틀함/Noun,1,1,0,1.1115310228308472e-05,0.0,1.0
30642,졸드/Noun,1,0,1,0.0,1.1106915165381966e-05,1.0
30643,마커스란/Noun,1,1,0,1.1115310228308472e-05,0.0,1.0
30644,구검/Noun,1,1,0,1.1115310228308472e-05,0.0,1.0
30645,떽/Noun,1,0,1,0.0,1.1106915165381966e-05,1.0
30646,었음/Eomi,1,1,0,1.1115310228308472e-05,0.0,1.0
30647,대생이라서/Foreign,1,1,0,1.1115310228308472e-05,0.0,1.0
30648,기름기/Noun,1,0,1,0.0,1.1106915165381966e-05,1.0
30649,나도향/Noun,1,0,1,0.0,1.1106915165381966e-05,1.0
30650,맹아/Noun,1,1,0,1.1115310228308472e-05,0.0,1.0
30651,닌까/Noun,1,0,1,0.0,1.1106915165381966e-05,1.0
30652,쓰롁뀌/Noun,1,0,1,0.0,1.1106915165381966e-05,1.0
30653,쪼앗성/Noun,1,1,0,1.1115310228308472e-05,0.0,1.0
30654,안땡겻/Noun,1,1,0,1.1115310228308472e-05,0.0,1.0
30655,모르보/Noun,1,1,0,1.1115310228308472e-05,0.0,1.0
30656,Ip/Alpha,1,1,0,1.1115310228308472e-05,0.0,1.0
30657,산타크로스/Noun,1,1,0,1.1115310228308472e-05,0.0,1.0
30658,쾌남/Noun,1,1,0,1.1115310228308472e-05,0.0,1.0
30659,쇠맛/Noun,1,0,1,0.0,1.1106915165381966e-05,1.0
30660,겨눌때/Noun,1,0,1,0.0,1.1106915165381966e-05,1.0
30661,샤오/Noun,1,0,1,0.0,1.1106915165381966e-05,1.0
30662,블랏체/Noun,1,1,0,1.1115310228308472e-05,0.0,1.0
30663,위닝/Noun,1,1,0,1.1115310228308472e-05,0.0,1.0
30664,포테이토/Noun,1,1,0,1.1115310228308472e-05,0.0,1.0
30665,진연희/Noun,1,1,0,1.1115310228308472e-05,0.0,1.0
30666,하이테크/Noun,1,0,1,0.0,1.1106915165381966e-05,1.0
30667,시간버/Noun,1,0,1,0.0,1.1106915165381966e-05,1.0
30668,ㅃㅃ/KoreanParticle,1,0,1,0.0,1.1106915165381966e-05,1.0
30669,운세/Noun,1,0,1,0.0,1.1106915165381966e-05,1.0
30670,유흑/Noun,1,1,0,1.1115310228308472e-05,0.0,1.0
30671,끝/Foreign,1,0,1,0.0,1.1106915165381966e-05,1.0
30672,싼타모/Noun,1,0,1,0.0,1.1106915165381966e-05,1.0
30673,낚이셨군/Noun,1,1,0,1.1115310228308472e-05,0.0,1.0
30674,노예무역/Noun,1,1,0,1.1115310228308472e-05,0.0,1.0
30675,쓸개/Noun,1,1,0,1.1115310228308472e-05,0.0,1.0
30676,김병세/Noun,1,0,1,0.0,1.1106915165381966e-05,1.0
30677,달주/Noun,1,0,1,0.0,1.1106915165381966e-05,1.0
30678,레즈씬/Noun,1,0,1,0.0,1.1106915165381966e-05,1.0
30679,믹스견/Noun,1,1,0,1.1115310228308472e-05,0.0,1.0
30680,포룸/Noun,1,0,1,0.0,1.1106915165381966e-05,1.0
30681,웃감/Noun,1,1,0,1.1115310228308472e-05,0.0,1.0
30682,정패/Noun,1,1,0,1.1115310228308472e-05,0.0,1.0
30683,베뤼/Noun,1,1,0,1.1115310228308472e-05,0.0,1.0
30684,chr/Alpha,1,1,0,1.1115310228308472e-05,0.0,1.0
30685,krystal/Alpha,1,1,0,1.1115310228308472e-05,0.0,1.0
30686,Rain/Alpha,1,1,0,1.1115310228308472e-05,0.0,1.0
30687,미렌/Noun,1,1,0,1.1115310228308472e-05,0.0,1.0
30688,왜안봣을까/Noun,1,1,0,1.1115310228308472e-05,0.0,1.0
30689,타임스/Noun,1,1,0,1.1115310228308472e-05,0.0,1.0
30690,췌말/Noun,1,0,1,0.0,1.1106915165381966e-05,1.0
30691,이툰/Noun,1,1,0,1.1115310228308472e-05,0.0,1.0
30692,아르빌/Noun,1,1,0,1.1115310228308472e-05,0.0,1.0
30693,토파즈/Noun,1,1,0,1.1115310228308472e-05,0.0,1.0
30694,육적/Noun,1,0,1,0.0,1.1106915165381966e-05,1.0
30695,함교/Noun,1,0,1,0.0,1.1106915165381966e-05,1.0
30696,Recall/Alpha,1,0,1,0.0,1.1106915165381966e-05,1.0
30697,Total/Alpha,1,0,1,0.0,1.1106915165381966e-05,1.0
30698,Robocop/Alpha,1,0,1,0.0,1.1106915165381966e-05,1.0
30699,Terminator/Alpha,1,0,1,0.0,1.1106915165381966e-05,1.0
30700,Alien/Alpha,1,0,1,0.0,1.1106915165381966e-05,1.0
30701,대패/Noun,1,0,1,0.0,1.1106915165381966e-05,1.0
30702,꽃사진/Noun,1,0,1,0.0,1.1106915165381966e-05,1.0
30703,얄쭈/Noun,1,1,0,1.1115310228308472e-05,0.0,1.0
30704,캐피탈/Noun,1,0,1,0.0,1.1106915165381966e-05,1.0
30705,"!"",/Punctuation",1,1,0,1.1115310228308472e-05,0.0,1.0
30706,73/Number,1,1,0,1.1115310228308472e-05,0.0,1.0
30707,가끔가다/Adverb,1,0,1,0.0,1.1106915165381966e-05,1.0
30708,시중/Noun,1,0,1,0.0,1.1106915165381966e-05,1.0
30709,남성성/Noun,1,1,0,1.1115310228308472e-05,0.0,1.0
30710,섀런/Noun,1,1,0,1.1115310228308472e-05,0.0,1.0
30711,신조협려/Noun,1,1,0,1.1115310228308472e-05,0.0,1.0
30712,사조영웅전/Noun,1,1,0,1.1115310228308472e-05,0.0,1.0
30713,죷또/Noun,1,0,1,0.0,1.1106915165381966e-05,1.0
30714,뺑/Noun,1,0,1,0.0,1.1106915165381966e-05,1.0
30715,준말/Noun,1,0,1,0.0,1.1106915165381966e-05,1.0
30716,관심없었고/Foreign,1,1,0,1.1115310228308472e-05,0.0,1.0
30717,구겐하임/Noun,1,0,1,0.0,1.1106915165381966e-05,1.0
30718,목잡/Noun,1,0,1,0.0,1.1106915165381966e-05,1.0
30719,독촉/Noun,1,1,0,1.1115310228308472e-05,0.0,1.0
30720,대코미디영화/Foreign,1,0,1,0.0,1.1106915165381966e-05,1.0
30721,잔느/Noun,1,1,0,1.1115310228308472e-05,0.0,1.0
30722,?''........................../Punctuation,1,1,0,1.1115310228308472e-05,0.0,1.0
30723,진쩌잼잇어/Noun,1,1,0,1.1115310228308472e-05,0.0,1.0
30724,유루/Noun,1,0,1,0.0,1.1106915165381966e-05,1.0
30725,나블루스/Noun,1,1,0,1.1115310228308472e-05,0.0,1.0
30726,하바/Noun,1,1,0,1.1115310228308472e-05,0.0,1.0
30727,늦어서/Foreign,1,0,1,0.0,1.1106915165381966e-05,1.0
30728,꼽을때/Noun,1,0,1,0.0,1.1106915165381966e-05,1.0
30729,부숴진/Noun,1,1,0,1.1115310228308472e-05,0.0,1.0
30730,해라잉/Noun,1,0,1,0.0,1.1106915165381966e-05,1.0
30731,샴류/Noun,1,0,1,0.0,1.1106915165381966e-05,1.0
30732,빈정거리다/Verb,1,1,0,1.1115310228308472e-05,0.0,1.0
30733,에쁘군/Noun,1,1,0,1.1115310228308472e-05,0.0,1.0
30734,프루프/Noun,1,1,0,1.1115310228308472e-05,0.0,1.0
30735,생활사/Noun,1,0,1,0.0,1.1106915165381966e-05,1.0
30736,쳉/Noun,1,1,0,1.1115310228308472e-05,0.0,1.0
30737,주한/Noun,1,1,0,1.1115310228308472e-05,0.0,1.0
30738,머징/Noun,1,1,0,1.1115310228308472e-05,0.0,1.0
30739,인숙/Noun,1,1,0,1.1115310228308472e-05,0.0,1.0
30740,4/16/Number,1,1,0,1.1115310228308472e-05,0.0,1.0
30741,wellmade/Alpha,1,0,1,0.0,1.1106915165381966e-05,1.0
30742,가려내다/Verb,1,0,1,0.0,1.1106915165381966e-05,1.0
30743,YTN/Alpha,1,1,0,1.1115310228308472e-05,0.0,1.0
30744,과물/Noun,1,0,1,0.0,1.1106915165381966e-05,1.0
30745,희희낙락/Noun,1,0,1,0.0,1.1106915165381966e-05,1.0
30746,동안에도/Foreign,1,1,0,1.1115310228308472e-05,0.0,1.0
30747,침벹기/Noun,1,1,0,1.1115310228308472e-05,0.0,1.0
30748,최코디/Noun,1,0,1,0.0,1.1106915165381966e-05,1.0
30749,배슬/Noun,1,0,1,0.0,1.1106915165381966e-05,1.0
30750,Carl/Alpha,1,1,0,1.1115310228308472e-05,0.0,1.0
30751,헛간/Noun,1,0,1,0.0,1.1106915165381966e-05,1.0
30752,door/Alpha,1,1,0,1.1115310228308472e-05,0.0,1.0
30753,next/Alpha,1,1,0,1.1115310228308472e-05,0.0,1.0
30754,작지않은시간가을동화처럼송혜교의남매의사랑감동느끼고싶어밨는데좌절이다/Foreign,1,0,1,0.0,1.1106915165381966e-05,1.0
30755,크미치스/Noun,1,1,0,1.1115310228308472e-05,0.0,1.0
30756,처러/Noun,1,1,0,1.1115310228308472e-05,0.0,1.0
30757,주귀/Noun,1,1,0,1.1115310228308472e-05,0.0,1.0
30758,몰랏던/Noun,1,1,0,1.1115310228308472e-05,0.0,1.0
30759,하셧을까/Noun,1,1,0,1.1115310228308472e-05,0.0,1.0
30760,".........,/Punctuation",1,1,0,1.1115310228308472e-05,0.0,1.0
30761,booldy/Alpha,1,1,0,1.1115310228308472e-05,0.0,1.0
30762,sunday/Alpha,1,1,0,1.1115310228308472e-05,0.0,1.0
30763,놋북/Noun,1,0,1,0.0,1.1106915165381966e-05,1.0
30764,Pd/Alpha,1,0,1,0.0,1.1106915165381966e-05,1.0
30765,밌었음/Noun,1,1,0,1.1115310228308472e-05,0.0,1.0
30766,대중반/Foreign,1,0,1,0.0,1.1106915165381966e-05,1.0
30767,뵛/Noun,1,1,0,1.1115310228308472e-05,0.0,1.0
30768,살제/Noun,1,1,0,1.1115310228308472e-05,0.0,1.0
30769,............?/Punctuation,1,0,1,0.0,1.1106915165381966e-05,1.0
30770,옷입/Noun,1,1,0,1.1115310228308472e-05,0.0,1.0
30771,검정색/Noun,1,1,0,1.1115310228308472e-05,0.0,1.0
30772,-_-~!/Punctuation,1,0,1,0.0,1.1106915165381966e-05,1.0
30773,부신/Noun,1,0,1,0.0,1.1106915165381966e-05,1.0
30774,제생/Noun,1,1,0,1.1115310228308472e-05,0.0,1.0
30775,피격/Noun,1,0,1,0.0,1.1106915165381966e-05,1.0
30776,남아프리카공화국/Noun,1,0,1,0.0,1.1106915165381966e-05,1.0
30777,1944년/Number,1,0,1,0.0,1.1106915165381966e-05,1.0
30778,급땜빵/Noun,1,0,1,0.0,1.1106915165381966e-05,1.0
30779,왜칼/Noun,1,1,0,1.1115310228308472e-05,0.0,1.0
30780,계장/Noun,1,1,0,1.1115310228308472e-05,0.0,1.0
30781,외톨이야/Noun,1,1,0,1.1115310228308472e-05,0.0,1.0
30782,날쭈/Noun,1,1,0,1.1115310228308472e-05,0.0,1.0
30783,라꾸/Noun,1,1,0,1.1115310228308472e-05,0.0,1.0
30784,뻈/Noun,1,0,1,0.0,1.1106915165381966e-05,1.0
30785,땀좀/Noun,1,0,1,0.0,1.1106915165381966e-05,1.0
30786,-__-+/Punctuation,1,0,1,0.0,1.1106915165381966e-05,1.0
30787,맘에안드/Noun,1,0,1,0.0,1.1106915165381966e-05,1.0
30788,뱐/Noun,1,0,1,0.0,1.1106915165381966e-05,1.0
30789,에나/Foreign,1,0,1,0.0,1.1106915165381966e-05,1.0
30790,뻑갔던/Noun,1,1,0,1.1115310228308472e-05,0.0,1.0
30791,동안어디서살게해주면슈퍼배드있는데서있을꺼임/Foreign,1,1,0,1.1115310228308472e-05,0.0,1.0
30792,송영길/Noun,1,0,1,0.0,1.1106915165381966e-05,1.0
30793,촐랑대다/Verb,1,0,1,0.0,1.1106915165381966e-05,1.0
30794,함무/Noun,1,0,1,0.0,1.1106915165381966e-05,1.0
30795,비됴방/Noun,1,0,1,0.0,1.1106915165381966e-05,1.0
30796,모래폭풍/Noun,1,1,0,1.1115310228308472e-05,0.0,1.0
30797,속인/Noun,1,1,0,1.1115310228308472e-05,0.0,1.0
30798,양성애/Noun,1,1,0,1.1115310228308472e-05,0.0,1.0
30799,미란다커/Noun,1,1,0,1.1115310228308472e-05,0.0,1.0
30800,전이군요/Foreign,1,1,0,1.1115310228308472e-05,0.0,1.0
30801,노락/Noun,1,0,1,0.0,1.1106915165381966e-05,1.0
30802,우체부/Noun,1,1,0,1.1115310228308472e-05,0.0,1.0
30803,평잠/Noun,1,0,1,0.0,1.1106915165381966e-05,1.0
30804,Ver/Alpha,1,0,1,0.0,1.1106915165381966e-05,1.0
30805,썻을까/Noun,1,0,1,0.0,1.1106915165381966e-05,1.0
30806,건욱이/Noun,1,0,1,0.0,1.1106915165381966e-05,1.0
30807,답답햐/Noun,1,0,1,0.0,1.1106915165381966e-05,1.0
30808,감감/Adverb,1,1,0,1.1115310228308472e-05,0.0,1.0
30809,식인종/Noun,1,1,0,1.1115310228308472e-05,0.0,1.0
30810,팔목/Noun,1,1,0,1.1115310228308472e-05,0.0,1.0
30811,때임/Noun,1,1,0,1.1115310228308472e-05,0.0,1.0
30812,엮겨운/Noun,1,0,1,0.0,1.1106915165381966e-05,1.0
30813,형평성/Noun,1,1,0,1.1115310228308472e-05,0.0,1.0
30814,흥흥/Noun,1,0,1,0.0,1.1106915165381966e-05,1.0
30815,스키야키/Noun,1,1,0,1.1115310228308472e-05,0.0,1.0
30816,돈잘버/Noun,1,1,0,1.1115310228308472e-05,0.0,1.0
30817,호겐/Noun,1,1,0,1.1115310228308472e-05,0.0,1.0
30818,강태식/Noun,1,1,0,1.1115310228308472e-05,0.0,1.0
30819,킼흫흐/Noun,1,1,0,1.1115310228308472e-05,0.0,1.0
30820,킼킼흫흐흫훟/Noun,1,1,0,1.1115310228308472e-05,0.0,1.0
30821,19383930/Number,1,0,1,0.0,1.1106915165381966e-05,1.0
30822,샤월들/Noun,1,1,0,1.1115310228308472e-05,0.0,1.0
30823,\(^/Punctuation,1,1,0,1.1115310228308472e-05,0.0,1.0
30824,원정출산/Noun,1,1,0,1.1115310228308472e-05,0.0,1.0
30825,ekfns/Alpha,1,0,1,0.0,1.1106915165381966e-05,1.0
30826,떄뜻/Noun,1,1,0,1.1115310228308472e-05,0.0,1.0
30827,Class/Alpha,1,1,0,1.1115310228308472e-05,0.0,1.0
30828,당룡/Noun,1,1,0,1.1115310228308472e-05,0.0,1.0
30829,problems/Alpha,1,1,0,1.1115310228308472e-05,0.0,1.0
30830,도지나/Foreign,1,1,0,1.1115310228308472e-05,0.0,1.0
30831,번집/Noun,1,1,0,1.1115310228308472e-05,0.0,1.0
30832,번봣다/Noun,1,1,0,1.1115310228308472e-05,0.0,1.0
30833,김독/Noun,1,0,1,0.0,1.1106915165381966e-05,1.0
30834,슬러쉬/Noun,1,0,1,0.0,1.1106915165381966e-05,1.0
30835,칸토나/Noun,1,0,1,0.0,1.1106915165381966e-05,1.0
30836,껄걸/Noun,1,0,1,0.0,1.1106915165381966e-05,1.0
30837,팀등/Noun,1,1,0,1.1115310228308472e-05,0.0,1.0
30838,=;;/Punctuation,1,0,1,0.0,1.1106915165381966e-05,1.0
30839,팬도럼/Noun,1,0,1,0.0,1.1106915165381966e-05,1.0
30840,촥오/Noun,1,1,0,1.1115310228308472e-05,0.0,1.0
30841,왜안뜸/Noun,1,0,1,0.0,1.1106915165381966e-05,1.0
30842,연기력논란/Noun,1,0,1,0.0,1.1106915165381966e-05,1.0
30843,남사/Noun,1,0,1,0.0,1.1106915165381966e-05,1.0
30844,캐붕/Noun,1,0,1,0.0,1.1106915165381966e-05,1.0
30845,반스/Noun,1,0,1,0.0,1.1106915165381966e-05,1.0
30846,키사/Noun,1,1,0,1.1115310228308472e-05,0.0,1.0
30847,우지/Noun,1,0,1,0.0,1.1106915165381966e-05,1.0
30848,졸렬/Noun,1,0,1,0.0,1.1106915165381966e-05,1.0
30849,청소기/Noun,1,1,0,1.1115310228308472e-05,0.0,1.0
30850,폐각/Noun,1,0,1,0.0,1.1106915165381966e-05,1.0
30851,오목/Noun,1,1,0,1.1115310228308472e-05,0.0,1.0
30852,영화였군요/Foreign,1,1,0,1.1115310228308472e-05,0.0,1.0
30853,에스카플로네/Noun,1,1,0,1.1115310228308472e-05,0.0,1.0
30854,더잼남/Noun,1,0,1,0.0,1.1106915165381966e-05,1.0
30855,못힌/Noun,1,1,0,1.1115310228308472e-05,0.0,1.0
30856,오열연기/Noun,1,0,1,0.0,1.1106915165381966e-05,1.0
30857,홍영/Noun,1,1,0,1.1115310228308472e-05,0.0,1.0
30858,엔조이/Noun,1,0,1,0.0,1.1106915165381966e-05,1.0
30859,쒜레기/Noun,1,0,1,0.0,1.1106915165381966e-05,1.0
30860,에에/Noun,1,1,0,1.1115310228308472e-05,0.0,1.0
30861,보호색/Noun,1,1,0,1.1115310228308472e-05,0.0,1.0
30862,~!!~!~!~!/Punctuation,1,0,1,0.0,1.1106915165381966e-05,1.0
30863,끽끼/Noun,1,0,1,0.0,1.1106915165381966e-05,1.0
30864,끾끾/Noun,1,0,1,0.0,1.1106915165381966e-05,1.0
30865,엮일/Noun,1,1,0,1.1115310228308472e-05,0.0,1.0
30866,!!!!!!!>_</Punctuation,1,1,0,1.1115310228308472e-05,0.0,1.0
30867,부작임/Noun,1,1,0,1.1115310228308472e-05,0.0,1.0
30868,에서는/Foreign,1,1,0,1.1115310228308472e-05,0.0,1.0
30869,추풍낙엽/Noun,1,0,1,0.0,1.1106915165381966e-05,1.0
30870,홍삼/Noun,1,1,0,1.1115310228308472e-05,0.0,1.0
30871,이지루하지않았다와/Foreign,1,1,0,1.1115310228308472e-05,0.0,1.0
30872,꼰다잉/Noun,1,0,1,0.0,1.1106915165381966e-05,1.0
30873,꿰멜/Noun,1,0,1,0.0,1.1106915165381966e-05,1.0
30874,미스테리영화/Noun,1,0,1,0.0,1.1106915165381966e-05,1.0
30875,ssu/Alpha,1,1,0,1.1115310228308472e-05,0.0,1.0
30876,수요기획/Noun,1,1,0,1.1115310228308472e-05,0.0,1.0
30877,종려제/Noun,1,1,0,1.1115310228308472e-05,0.0,1.0
30878,가흥/Noun,1,0,1,0.0,1.1106915165381966e-05,1.0
30879,쉐리던/Noun,1,1,0,1.1115310228308472e-05,0.0,1.0
30880,운동선수/Noun,1,0,1,0.0,1.1106915165381966e-05,1.0
30881,박신헤/Noun,1,1,0,1.1115310228308472e-05,0.0,1.0
30882,맴맴/Adverb,1,1,0,1.1115310228308472e-05,0.0,1.0
30883,궁궁궁/Noun,1,1,0,1.1115310228308472e-05,0.0,1.0
30884,등정/Noun,1,1,0,1.1115310228308472e-05,0.0,1.0
30885,교차로/Noun,1,1,0,1.1115310228308472e-05,0.0,1.0
30886,잘잘/Noun,1,1,0,1.1115310228308472e-05,0.0,1.0
30887,다뎜벼/Noun,1,0,1,0.0,1.1106915165381966e-05,1.0
30888,노깝/Noun,1,0,1,0.0,1.1106915165381966e-05,1.0
30889,국도/Noun,1,0,1,0.0,1.1106915165381966e-05,1.0
30890,도둑/Foreign,1,0,1,0.0,1.1106915165381966e-05,1.0
30891,23억/Number,1,0,1,0.0,1.1106915165381966e-05,1.0
30892,;)./Punctuation,1,0,1,0.0,1.1106915165381966e-05,1.0
30893,봣어욤/Noun,1,1,0,1.1115310228308472e-05,0.0,1.0
30894,점오/Noun,1,0,1,0.0,1.1106915165381966e-05,1.0
30895,보이스카웃/Noun,1,0,1,0.0,1.1106915165381966e-05,1.0
30896,방송위/Noun,1,0,1,0.0,1.1106915165381966e-05,1.0
30897,걍섹해/Noun,1,0,1,0.0,1.1106915165381966e-05,1.0
30898,뻘게지/Noun,1,1,0,1.1115310228308472e-05,0.0,1.0
30899,...-_-;;;/Punctuation,1,0,1,0.0,1.1106915165381966e-05,1.0
30900,키쓰씬/Noun,1,0,1,0.0,1.1106915165381966e-05,1.0
30901,이지났는데아직도/Foreign,1,1,0,1.1115310228308472e-05,0.0,1.0
30902,쉣트/Noun,1,0,1,0.0,1.1106915165381966e-05,1.0
30903,인지부조화/Noun,1,1,0,1.1115310228308472e-05,0.0,1.0
30904,reality/Alpha,1,1,0,1.1115310228308472e-05,0.0,1.0
30905,visions/Alpha,1,1,0,1.1115310228308472e-05,0.0,1.0
30906,떳구/Noun,1,1,0,1.1115310228308472e-05,0.0,1.0
30907,재성/Noun,1,0,1,0.0,1.1106915165381966e-05,1.0
30908,급속/Noun,1,0,1,0.0,1.1106915165381966e-05,1.0
30909,강빈/Noun,1,1,0,1.1115310228308472e-05,0.0,1.0
30910,혜자/Noun,1,1,0,1.1115310228308472e-05,0.0,1.0
30911,뱎/Noun,1,1,0,1.1115310228308472e-05,0.0,1.0
30912,댸/Noun,1,1,0,1.1115310228308472e-05,0.0,1.0
30913,축사/Noun,1,1,0,1.1115310228308472e-05,0.0,1.0
30914,댠순/Noun,1,1,0,1.1115310228308472e-05,0.0,1.0
30915,친환경/Noun,1,1,0,1.1115310228308472e-05,0.0,1.0
30916,!!!>^</Punctuation,1,1,0,1.1115310228308472e-05,0.0,1.0
30917,알력/Noun,1,0,1,0.0,1.1106915165381966e-05,1.0
30918,맥카닉/Noun,1,0,1,0.0,1.1106915165381966e-05,1.0
30919,52초/Number,1,0,1,0.0,1.1106915165381966e-05,1.0
30920,옴청/Noun,1,0,1,0.0,1.1106915165381966e-05,1.0
30921,왓어야됫/Noun,1,1,0,1.1115310228308472e-05,0.0,1.0
30922,'';;/Punctuation,1,0,1,0.0,1.1106915165381966e-05,1.0
30923,퍼마시/Noun,1,0,1,0.0,1.1106915165381966e-05,1.0
30924,어구/Noun,1,1,0,1.1115310228308472e-05,0.0,1.0
30925,;?/Punctuation,1,0,1,0.0,1.1106915165381966e-05,1.0
30926,곱빼기/Noun,1,0,1,0.0,1.1106915165381966e-05,1.0
30927,흑색선전/Noun,1,0,1,0.0,1.1106915165381966e-05,1.0
30928,래는/Foreign,1,1,0,1.1115310228308472e-05,0.0,1.0
30929,김용만/Noun,1,0,1,0.0,1.1106915165381966e-05,1.0
30930,7.46/Number,1,1,0,1.1115310228308472e-05,0.0,1.0
30931,한채원/Noun,1,1,0,1.1115310228308472e-05,0.0,1.0
30932,샹각합니/Noun,1,1,0,1.1115310228308472e-05,0.0,1.0
30933,뇌쇄/Noun,1,1,0,1.1115310228308472e-05,0.0,1.0
30934,bullshit/Alpha,1,0,1,0.0,1.1106915165381966e-05,1.0
30935,실아/Noun,1,1,0,1.1115310228308472e-05,0.0,1.0
30936,노총각/Noun,1,1,0,1.1115310228308472e-05,0.0,1.0
30937,?!..../Punctuation,1,0,1,0.0,1.1106915165381966e-05,1.0
30938,8090/Number,1,0,1,0.0,1.1106915165381966e-05,1.0
30939,빼낼때/Noun,1,1,0,1.1115310228308472e-05,0.0,1.0
30940,희진/Noun,1,1,0,1.1115310228308472e-05,0.0,1.0
30941,현식/Noun,1,1,0,1.1115310228308472e-05,0.0,1.0
30942,아니좐/Noun,1,0,1,0.0,1.1106915165381966e-05,1.0
30943,허스크/Noun,1,0,1,0.0,1.1106915165381966e-05,1.0
30944,밣히기/Noun,1,0,1,0.0,1.1106915165381966e-05,1.0
30945,Jeez/Alpha,1,1,0,1.1115310228308472e-05,0.0,1.0
30946,스핏파이어/Noun,1,1,0,1.1115310228308472e-05,0.0,1.0
30947,"...,..../Punctuation",1,0,1,0.0,1.1106915165381966e-05,1.0
30948,잼밌는건/Noun,1,0,1,0.0,1.1106915165381966e-05,1.0
30949,작인거보고완전깜놀/Foreign,1,1,0,1.1115310228308472e-05,0.0,1.0
30950,십이지장/Noun,1,0,1,0.0,1.1106915165381966e-05,1.0
30951,볶음밥/Noun,1,0,1,0.0,1.1106915165381966e-05,1.0
30952,섬칫했음/Noun,1,0,1,0.0,1.1106915165381966e-05,1.0
30953,비참/Noun,1,1,0,1.1115310228308472e-05,0.0,1.0
30954,Family/Alpha,1,1,0,1.1115310228308472e-05,0.0,1.0
30955,66년/Number,1,0,1,0.0,1.1106915165381966e-05,1.0
30956,2015.01/Number,1,0,1,0.0,1.1106915165381966e-05,1.0
30957,허처슨/Noun,1,0,1,0.0,1.1106915165381966e-05,1.0
30958,급박/Noun,1,1,0,1.1115310228308472e-05,0.0,1.0
30959,물러서다/Verb,1,0,1,0.0,1.1106915165381966e-05,1.0
30960,?:/Punctuation,1,1,0,1.1115310228308472e-05,0.0,1.0
30961,3.7/Number,1,0,1,0.0,1.1106915165381966e-05,1.0
30962,니뿡/Noun,1,0,1,0.0,1.1106915165381966e-05,1.0
30963,ㄹㅎ/KoreanParticle,1,1,0,1.1115310228308472e-05,0.0,1.0
30964,body/Alpha,1,0,1,0.0,1.1106915165381966e-05,1.0
30965,쯔쯧/Noun,1,0,1,0.0,1.1106915165381966e-05,1.0
30966,전자담배/Noun,1,1,0,1.1115310228308472e-05,0.0,1.0
30967,woman/Alpha,1,1,0,1.1115310228308472e-05,0.0,1.0
30968,independent/Alpha,1,1,0,1.1115310228308472e-05,0.0,1.0
30969,빵상/Noun,1,1,0,1.1115310228308472e-05,0.0,1.0
30970,밴트해머/Noun,1,1,0,1.1115310228308472e-05,0.0,1.0
30971,제밌음/Noun,1,0,1,0.0,1.1106915165381966e-05,1.0
30972,영어실력/Noun,1,1,0,1.1115310228308472e-05,0.0,1.0
30973,미술사/Noun,1,1,0,1.1115310228308472e-05,0.0,1.0
30974,ㅈㅎ/KoreanParticle,1,1,0,1.1115310228308472e-05,0.0,1.0
30975,의료기기/Noun,1,0,1,0.0,1.1106915165381966e-05,1.0
30976,Feather/Alpha,1,1,0,1.1115310228308472e-05,0.0,1.0
30977,페더맨/Noun,1,1,0,1.1115310228308472e-05,0.0,1.0
30978,Melody/Alpha,1,1,0,1.1115310228308472e-05,0.0,1.0
30979,택할때/Noun,1,1,0,1.1115310228308472e-05,0.0,1.0
30980,ZERO/Alpha,1,0,1,0.0,1.1106915165381966e-05,1.0
30981,웨폰/Noun,1,0,1,0.0,1.1106915165381966e-05,1.0
30982,양기원/Noun,1,0,1,0.0,1.1106915165381966e-05,1.0
30983,배경/Foreign,1,1,0,1.1115310228308472e-05,0.0,1.0
30984,2187년/Number,1,1,0,1.1115310228308472e-05,0.0,1.0
30985,유호진/Noun,1,0,1,0.0,1.1106915165381966e-05,1.0
30986,양극성장애/Noun,1,1,0,1.1115310228308472e-05,0.0,1.0
30987,민패/Noun,1,0,1,0.0,1.1106915165381966e-05,1.0
30988,Togom/Alpha,1,0,1,0.0,1.1106915165381966e-05,1.0
30989,촤근/Noun,1,1,0,1.1115310228308472e-05,0.0,1.0
30990,애욕/Noun,1,1,0,1.1115310228308472e-05,0.0,1.0
30991,장꿈/Noun,1,1,0,1.1115310228308472e-05,0.0,1.0
30992,사이퍼즈/Noun,1,0,1,0.0,1.1106915165381966e-05,1.0
30993,전바로영화다/Foreign,1,1,0,1.1115310228308472e-05,0.0,1.0
30994,6.85/Number,1,0,1,0.0,1.1106915165381966e-05,1.0
30995,서행/Noun,1,0,1,0.0,1.1106915165381966e-05,1.0
30996,어젠정말쉣/Noun,1,0,1,0.0,1.1106915165381966e-05,1.0
30997,철용/Noun,1,1,0,1.1115310228308472e-05,0.0,1.0
30998,마쉬멜로우/Noun,1,1,0,1.1115310228308472e-05,0.0,1.0
30999,http://blog.naver.com/oroblast/220232917660/URL,1,1,0,1.1115310228308472e-05,0.0,1.0
31000,응답기/Noun,1,0,1,0.0,1.1106915165381966e-05,1.0
31001,생식기/Noun,1,0,1,0.0,1.1106915165381966e-05,1.0
31002,생이라는/Foreign,1,0,1,0.0,1.1106915165381966e-05,1.0
31003,바바리맨/Noun,1,0,1,0.0,1.1106915165381966e-05,1.0
31004,노출증/Noun,1,0,1,0.0,1.1106915165381966e-05,1.0
31005,민용/Noun,1,0,1,0.0,1.1106915165381966e-05,1.0
31006,핸썸/Noun,1,0,1,0.0,1.1106915165381966e-05,1.0
31007,뽄/Noun,1,0,1,0.0,1.1106915165381966e-05,1.0
31008,찌릿함/Noun,1,1,0,1.1115310228308472e-05,0.0,1.0
31009,나옮/Noun,1,0,1,0.0,1.1106915165381966e-05,1.0
31010,제너/Noun,1,1,0,1.1115310228308472e-05,0.0,1.0
31011,풕/Noun,1,1,0,1.1115310228308472e-05,0.0,1.0
31012,우웽/Noun,1,1,0,1.1115310228308472e-05,0.0,1.0
31013,평화주의자/Noun,1,1,0,1.1115310228308472e-05,0.0,1.0
31014,형을/Foreign,1,0,1,0.0,1.1106915165381966e-05,1.0
31015,유기한/Noun,1,0,1,0.0,1.1106915165381966e-05,1.0
31016,"..,.,/Punctuation",1,0,1,0.0,1.1106915165381966e-05,1.0
31017,아쉽넹/Noun,1,0,1,0.0,1.1106915165381966e-05,1.0
31018,동티모르/Noun,1,1,0,1.1115310228308472e-05,0.0,1.0
31019,히딩크/Noun,1,1,0,1.1115310228308472e-05,0.0,1.0
31020,아두/Noun,1,1,0,1.1115310228308472e-05,0.0,1.0
31021,걸흉/Noun,1,1,0,1.1115310228308472e-05,0.0,1.0
31022,생인/Foreign,1,1,0,1.1115310228308472e-05,0.0,1.0
31023,손수현/Noun,1,0,1,0.0,1.1106915165381966e-05,1.0
31024,죤내아까움/Noun,1,0,1,0.0,1.1106915165381966e-05,1.0
31025,훟귝/Noun,1,0,1,0.0,1.1106915165381966e-05,1.0
31026,1600원/Number,1,0,1,0.0,1.1106915165381966e-05,1.0
31027,골골/Adverb,1,0,1,0.0,1.1106915165381966e-05,1.0
31028,실종사건/Foreign,1,0,1,0.0,1.1106915165381966e-05,1.0
31029,...\/Punctuation,1,1,0,1.1115310228308472e-05,0.0,1.0
31030,아마티/Noun,1,1,0,1.1115310228308472e-05,0.0,1.0
31031,?http://me2.do/FJtbrCiA/URL,1,1,0,1.1115310228308472e-05,0.0,1.0
31032,Necessary/Alpha,1,1,0,1.1115310228308472e-05,0.0,1.0
31033,必要/Foreign,1,1,0,1.1115310228308472e-05,0.0,1.0
31034,→→→/Foreign,1,1,0,1.1115310228308472e-05,0.0,1.0
31035,손금/Noun,1,1,0,1.1115310228308472e-05,0.0,1.0
31036,NAVER/Alpha,1,1,0,1.1115310228308472e-05,0.0,1.0
31037,나영은/Noun,1,0,1,0.0,1.1106915165381966e-05,1.0
31038,문화상/Noun,1,0,1,0.0,1.1106915165381966e-05,1.0
31039,시큰둥/Noun,1,1,0,1.1115310228308472e-05,0.0,1.0
31040,의슴/Noun,1,0,1,0.0,1.1106915165381966e-05,1.0
31041,레빈/Noun,1,1,0,1.1115310228308472e-05,0.0,1.0
31042,변우민/Noun,1,1,0,1.1115310228308472e-05,0.0,1.0
31043,선약/Noun,1,1,0,1.1115310228308472e-05,0.0,1.0
31044,연하남/Noun,1,1,0,1.1115310228308472e-05,0.0,1.0
31045,날이갈수록/Noun,1,0,1,0.0,1.1106915165381966e-05,1.0
31046,sound/Alpha,1,1,0,1.1115310228308472e-05,0.0,1.0
31047,느킴/Noun,1,0,1,0.0,1.1106915165381966e-05,1.0
31048,입밖/Noun,1,0,1,0.0,1.1106915165381966e-05,1.0
31049,~!(/Punctuation,1,1,0,1.1115310228308472e-05,0.0,1.0
31050,홍기선/Noun,1,1,0,1.1115310228308472e-05,0.0,1.0
31051,봫/Noun,1,1,0,1.1115310228308472e-05,0.0,1.0
31052,스펄/Noun,1,1,0,1.1115310228308472e-05,0.0,1.0
31053,신격/Noun,1,0,1,0.0,1.1106915165381966e-05,1.0
31054,파텔/Noun,1,1,0,1.1115310228308472e-05,0.0,1.0
31055,때란/Noun,1,1,0,1.1115310228308472e-05,0.0,1.0
31056,시연/Noun,1,1,0,1.1115310228308472e-05,0.0,1.0
31057,황혁/Noun,1,0,1,0.0,1.1106915165381966e-05,1.0
31058,락션허그씬/Noun,1,0,1,0.0,1.1106915165381966e-05,1.0
31059,배잼/Noun,1,0,1,0.0,1.1106915165381966e-05,1.0
31060,헤즈/Noun,1,0,1,0.0,1.1106915165381966e-05,1.0
31061,아뵤오/Noun,1,0,1,0.0,1.1106915165381966e-05,1.0
31062,룩희/Noun,1,0,1,0.0,1.1106915165381966e-05,1.0
31063,박동하/Noun,1,1,0,1.1115310228308472e-05,0.0,1.0
31064,ㅎㅇㄷ/KoreanParticle,1,1,0,1.1115310228308472e-05,0.0,1.0
31065,난캉이/Noun,1,1,0,1.1115310228308472e-05,0.0,1.0
31066,락카칠/Noun,1,1,0,1.1115310228308472e-05,0.0,1.0
31067,처뭐/Noun,1,0,1,0.0,1.1106915165381966e-05,1.0
31068,황급/Noun,1,0,1,0.0,1.1106915165381966e-05,1.0
31069,머뭇/Noun,1,1,0,1.1115310228308472e-05,0.0,1.0
31070,설펏/Noun,1,0,1,0.0,1.1106915165381966e-05,1.0
31071,델젤/Noun,1,0,1,0.0,1.1106915165381966e-05,1.0
31072,razor/Alpha,1,0,1,0.0,1.1106915165381966e-05,1.0
31073,occam/Alpha,1,0,1,0.0,1.1106915165381966e-05,1.0
31074,메친/Noun,1,0,1,0.0,1.1106915165381966e-05,1.0
31075,솔드/Noun,1,0,1,0.0,1.1106915165381966e-05,1.0
31076,매카시즘/Noun,1,0,1,0.0,1.1106915165381966e-05,1.0
31077,츠차오/Noun,1,0,1,0.0,1.1106915165381966e-05,1.0
31078,EH/Alpha,1,1,0,1.1115310228308472e-05,0.0,1.0
31079,뵨/Noun,1,1,0,1.1115310228308472e-05,0.0,1.0
31080,디졸브/Noun,1,0,1,0.0,1.1106915165381966e-05,1.0
31081,숏들/Noun,1,1,0,1.1115310228308472e-05,0.0,1.0
31082,이란인/Noun,1,1,0,1.1115310228308472e-05,0.0,1.0
31083,씨밫/Noun,1,0,1,0.0,1.1106915165381966e-05,1.0
31084,쭈니/Noun,1,1,0,1.1115310228308472e-05,0.0,1.0
31085,재동/Noun,1,0,1,0.0,1.1106915165381966e-05,1.0
31086,탱크로리/Noun,1,0,1,0.0,1.1106915165381966e-05,1.0
31087,공황/Noun,1,1,0,1.1115310228308472e-05,0.0,1.0
31088,맥팔레인/Noun,1,1,0,1.1115310228308472e-05,0.0,1.0
31089,러닝머신/Noun,1,1,0,1.1115310228308472e-05,0.0,1.0
31090,에서만이/Josa,1,0,1,0.0,1.1106915165381966e-05,1.0
31091,6000원/Number,1,1,0,1.1115310228308472e-05,0.0,1.0
31092,울브즈/Noun,1,1,0,1.1115310228308472e-05,0.0,1.0
31093,수험표/Noun,1,1,0,1.1115310228308472e-05,0.0,1.0
31094,스킨푸드/Noun,1,0,1,0.0,1.1106915165381966e-05,1.0
31095,goldstar/Alpha,1,1,0,1.1115310228308472e-05,0.0,1.0
31096,신애리/Noun,1,1,0,1.1115310228308472e-05,0.0,1.0
31097,아웅산수지/Noun,1,1,0,1.1115310228308472e-05,0.0,1.0
31098,파즈였다/Noun,1,0,1,0.0,1.1106915165381966e-05,1.0
31099,송계/Noun,1,0,1,0.0,1.1106915165381966e-05,1.0
31100,당구대/Noun,1,1,0,1.1115310228308472e-05,0.0,1.0
31101,러미/Noun,1,0,1,0.0,1.1106915165381966e-05,1.0
31102,완젼웃겨/Noun,1,1,0,1.1115310228308472e-05,0.0,1.0
31103,66회/Number,1,0,1,0.0,1.1106915165381966e-05,1.0
31104,Qwtugffyuhfddfgg/Alpha,1,1,0,1.1115310228308472e-05,0.0,1.0
31105,"..>,/Punctuation",1,1,0,1.1115310228308472e-05,0.0,1.0
31106,츨연/Noun,1,0,1,0.0,1.1106915165381966e-05,1.0
31107,크리슈나/Noun,1,1,0,1.1115310228308472e-05,0.0,1.0
31108,=_=......./Punctuation,1,0,1,0.0,1.1106915165381966e-05,1.0
31109,투피엠/Noun,1,1,0,1.1115310228308472e-05,0.0,1.0
31110,쿤이/Noun,1,1,0,1.1115310228308472e-05,0.0,1.0
31111,루다별루/Noun,1,0,1,0.0,1.1106915165381966e-05,1.0
31112,줬을껀데/Noun,1,0,1,0.0,1.1106915165381966e-05,1.0
31113,발호새/Noun,1,0,1,0.0,1.1106915165381966e-05,1.0
31114,동족상잔/Noun,1,1,0,1.1115310228308472e-05,0.0,1.0
31115,조강/Noun,1,1,0,1.1115310228308472e-05,0.0,1.0
31116,]./Punctuation,1,1,0,1.1115310228308472e-05,0.0,1.0
31117,출산율/Noun,1,0,1,0.0,1.1106915165381966e-05,1.0
31118,파포/Noun,1,0,1,0.0,1.1106915165381966e-05,1.0
31119,상타취/Noun,1,1,0,1.1115310228308472e-05,0.0,1.0
31120,뱃김/Noun,1,0,1,0.0,1.1106915165381966e-05,1.0
31121,혼숙/Noun,1,0,1,0.0,1.1106915165381966e-05,1.0
31122,앱스토어/Noun,1,1,0,1.1115310228308472e-05,0.0,1.0
31123,APP/Alpha,1,1,0,1.1115310228308472e-05,0.0,1.0
31124,옥토넛/Noun,1,0,1,0.0,1.1106915165381966e-05,1.0
31125,닐스/Noun,1,0,1,0.0,1.1106915165381966e-05,1.0
31126,셔쇼셔쇼셔/Noun,1,1,0,1.1115310228308472e-05,0.0,1.0
31127,셔쇼셔/Noun,1,1,0,1.1115310228308472e-05,0.0,1.0
31128,으흐/Noun,1,1,0,1.1115310228308472e-05,0.0,1.0
31129,뿌쁘루/Noun,1,1,0,1.1115310228308472e-05,0.0,1.0
31130,사그라들다/Verb,1,1,0,1.1115310228308472e-05,0.0,1.0
31131,욱할때/Noun,1,1,0,1.1115310228308472e-05,0.0,1.0
31132,선사시대/Noun,1,1,0,1.1115310228308472e-05,0.0,1.0
31133,맄퀴/Noun,1,1,0,1.1115310228308472e-05,0.0,1.0
31134,자혹/Noun,1,0,1,0.0,1.1106915165381966e-05,1.0
31135,신정균/Noun,1,0,1,0.0,1.1106915165381966e-05,1.0
31136,품번/Noun,1,0,1,0.0,1.1106915165381966e-05,1.0
31137,한밤/Noun,1,0,1,0.0,1.1106915165381966e-05,1.0
31138,giant/Alpha,1,1,0,1.1115310228308472e-05,0.0,1.0
31139,귿귿/Noun,1,1,0,1.1115310228308472e-05,0.0,1.0
31140,野史/Foreign,1,0,1,0.0,1.1106915165381966e-05,1.0
31141,사이코메트리/Noun,1,0,1,0.0,1.1106915165381966e-05,1.0
31142,빅밴드/Noun,1,0,1,0.0,1.1106915165381966e-05,1.0
31143,걸끝/Noun,1,1,0,1.1115310228308472e-05,0.0,1.0
31144,걸내/Noun,1,0,1,0.0,1.1106915165381966e-05,1.0
31145,귯귯/Noun,1,1,0,1.1115310228308472e-05,0.0,1.0
31146,JAM/Alpha,1,0,1,0.0,1.1106915165381966e-05,1.0
31147,....^^*/Punctuation,1,1,0,1.1115310228308472e-05,0.0,1.0
31148,후감삼/Noun,1,0,1,0.0,1.1106915165381966e-05,1.0
31149,자판/Noun,1,0,1,0.0,1.1106915165381966e-05,1.0
31150,많턴데/Noun,1,1,0,1.1115310228308472e-05,0.0,1.0
31151,141218/Number,1,1,0,1.1115310228308472e-05,0.0,1.0
31152,박혜련작가/Noun,1,1,0,1.1115310228308472e-05,0.0,1.0
31153,능인/Noun,1,0,1,0.0,1.1106915165381966e-05,1.0
31154,역무/Noun,1,1,0,1.1115310228308472e-05,0.0,1.0
31155,꼳친/Noun,1,0,1,0.0,1.1106915165381966e-05,1.0
31156,아리만/Noun,1,0,1,0.0,1.1106915165381966e-05,1.0
31157,몸뚱/Noun,1,0,1,0.0,1.1106915165381966e-05,1.0
31158,법부/Noun,1,1,0,1.1115310228308472e-05,0.0,1.0
31159,탄피/Noun,1,1,0,1.1115310228308472e-05,0.0,1.0
31160,ㅅㅂㄹ/KoreanParticle,1,0,1,0.0,1.1106915165381966e-05,1.0
31161,김용균/Noun,1,0,1,0.0,1.1106915165381966e-05,1.0
31162,정도로/Foreign,1,0,1,0.0,1.1106915165381966e-05,1.0
31163,신실하다/Adjective,1,1,0,1.1115310228308472e-05,0.0,1.0
31164,식용유/Noun,1,0,1,0.0,1.1106915165381966e-05,1.0
31165,머시쪙/Noun,1,1,0,1.1115310228308472e-05,0.0,1.0
31166,cock/Alpha,1,0,1,0.0,1.1106915165381966e-05,1.0
31167,nice/Alpha,1,0,1,0.0,1.1106915165381966e-05,1.0
31168,whdmsp/Alpha,1,1,0,1.1115310228308472e-05,0.0,1.0
31169,보는섀끼/Noun,1,0,1,0.0,1.1106915165381966e-05,1.0
31170,윈터바텀/Noun,1,1,0,1.1115310228308472e-05,0.0,1.0
31171,전이다/Foreign,1,1,0,1.1115310228308472e-05,0.0,1.0
31172,74년/Number,1,1,0,1.1115310228308472e-05,0.0,1.0
31173,호손/Noun,1,0,1,0.0,1.1106915165381966e-05,1.0
31174,나다니엘/Noun,1,0,1,0.0,1.1106915165381966e-05,1.0
31175,williams/Alpha,1,1,0,1.1115310228308472e-05,0.0,1.0
31176,Robin/Alpha,1,1,0,1.1115310228308472e-05,0.0,1.0
31177,청어/Noun,1,1,0,1.1115310228308472e-05,0.0,1.0
31178,청출어람/Noun,1,1,0,1.1115310228308472e-05,0.0,1.0
31179,마추픽추/Noun,1,1,0,1.1115310228308472e-05,0.0,1.0
31180,부녀자/Noun,1,0,1,0.0,1.1106915165381966e-05,1.0
31181,이재정/Noun,1,0,1,0.0,1.1106915165381966e-05,1.0
31182,임슬옹/Noun,1,0,1,0.0,1.1106915165381966e-05,1.0
31183,계약서/Noun,1,1,0,1.1115310228308472e-05,0.0,1.0
31184,고사전/Noun,1,0,1,0.0,1.1106915165381966e-05,1.0
31185,나하시/Noun,1,0,1,0.0,1.1106915165381966e-05,1.0
31186,로익/Noun,1,0,1,0.0,1.1106915165381966e-05,1.0
31187,한일월드컵/Noun,1,0,1,0.0,1.1106915165381966e-05,1.0
31188,에돌아가시기전에웃음면서같이보던그장면국수집에찾아가밀가루맞고싸움던장면/Foreign,1,1,0,1.1115310228308472e-05,0.0,1.0
31189,비놈/Noun,1,0,1,0.0,1.1106915165381966e-05,1.0
31190,굿다/Noun,1,1,0,1.1115310228308472e-05,0.0,1.0
31191,땓대댇댇킬미/Noun,1,1,0,1.1115310228308472e-05,0.0,1.0
31192,스트롱거때문/Noun,1,1,0,1.1115310228308472e-05,0.0,1.0
31193,로멘틱할/Noun,1,1,0,1.1115310228308472e-05,0.0,1.0
31194,개밥그릇/Noun,1,0,1,0.0,1.1106915165381966e-05,1.0
31195,brave/Alpha,1,1,0,1.1115310228308472e-05,0.0,1.0
31196,서시/Noun,1,0,1,0.0,1.1106915165381966e-05,1.0
31197,됫지/Noun,1,0,1,0.0,1.1106915165381966e-05,1.0
31198,애청햇던/Noun,1,0,1,0.0,1.1106915165381966e-05,1.0
31199,나올껀/Noun,1,0,1,0.0,1.1106915165381966e-05,1.0
31200,합편/Noun,1,0,1,0.0,1.1106915165381966e-05,1.0
31201,asdasdasda/Alpha,1,1,0,1.1115310228308472e-05,0.0,1.0
31202,4.99/Number,1,0,1,0.0,1.1106915165381966e-05,1.0
31203,쏜살같다/Adjective,1,1,0,1.1115310228308472e-05,0.0,1.0
31204,골든글러브/Noun,1,0,1,0.0,1.1106915165381966e-05,1.0
31205,응급구조사/Noun,1,1,0,1.1115310228308472e-05,0.0,1.0
31206,..........!/Punctuation,1,1,0,1.1115310228308472e-05,0.0,1.0
31207,샤워실/Noun,1,1,0,1.1115310228308472e-05,0.0,1.0
31208,트리트먼트/Noun,1,0,1,0.0,1.1106915165381966e-05,1.0
31209,나름괜찬/Noun,1,1,0,1.1115310228308472e-05,0.0,1.0
31210,이현승/Noun,1,0,1,0.0,1.1106915165381966e-05,1.0
31211,에스엪/Noun,1,1,0,1.1115310228308472e-05,0.0,1.0
31212,넙죽넙죽/Adverb,1,0,1,0.0,1.1106915165381966e-05,1.0
31213,악센트/Noun,1,0,1,0.0,1.1106915165381966e-05,1.0
31214,...^-^;;;/Punctuation,1,0,1,0.0,1.1106915165381966e-05,1.0
31215,..(+/Punctuation,1,1,0,1.1115310228308472e-05,0.0,1.0
31216,감오/Noun,1,0,1,0.0,1.1106915165381966e-05,1.0
31217,황성열/Noun,1,1,0,1.1115310228308472e-05,0.0,1.0
31218,신우현/Noun,1,1,0,1.1115310228308472e-05,0.0,1.0
31219,ㅎㅛㅇ/KoreanParticle,1,1,0,1.1115310228308472e-05,0.0,1.0
31220,Steet/Alpha,1,0,1,0.0,1.1106915165381966e-05,1.0
31221,지완/Noun,1,1,0,1.1115310228308472e-05,0.0,1.0
31222,재는/Noun,1,0,1,0.0,1.1106915165381966e-05,1.0
31223,병고/Noun,1,0,1,0.0,1.1106915165381966e-05,1.0
31224,수도꼭지/Noun,1,1,0,1.1115310228308472e-05,0.0,1.0
31225,~^-^!!/Punctuation,1,1,0,1.1115310228308472e-05,0.0,1.0
31226,OsT/Alpha,1,1,0,1.1115310228308472e-05,0.0,1.0
31227,500만달러/Number,1,1,0,1.1115310228308472e-05,0.0,1.0
31228,흐헝헝/Noun,1,1,0,1.1115310228308472e-05,0.0,1.0
31229,개봉당시/Foreign,1,1,0,1.1115310228308472e-05,0.0,1.0
31230,Fi/Alpha,1,0,1,0.0,1.1106915165381966e-05,1.0
31231,Sci/Alpha,1,0,1,0.0,1.1106915165381966e-05,1.0
31232,마브/Noun,1,1,0,1.1115310228308472e-05,0.0,1.0
31233,왜일캐/Noun,1,0,1,0.0,1.1106915165381966e-05,1.0
31234,><*/Punctuation,1,1,0,1.1115310228308472e-05,0.0,1.0
31235,마펭/Noun,1,1,0,1.1115310228308472e-05,0.0,1.0
31236,않으셧으/Noun,1,1,0,1.1115310228308472e-05,0.0,1.0
31237,성태/Noun,1,1,0,1.1115310228308472e-05,0.0,1.0
31238,귀두/Noun,1,0,1,0.0,1.1106915165381966e-05,1.0
31239,공중발차기/Noun,1,1,0,1.1115310228308472e-05,0.0,1.0
31240,컨설팅펌/Noun,1,1,0,1.1115310228308472e-05,0.0,1.0
31241,용평/Noun,1,1,0,1.1115310228308472e-05,0.0,1.0
31242,맛임/Noun,1,0,1,0.0,1.1106915165381966e-05,1.0
31243,낳겄/Noun,1,0,1,0.0,1.1106915165381966e-05,1.0
31244,호골/Noun,1,1,0,1.1115310228308472e-05,0.0,1.0
31245,아우크스부르크/Noun,1,1,0,1.1115310228308472e-05,0.0,1.0
31246,지동원/Noun,1,1,0,1.1115310228308472e-05,0.0,1.0
31247,샤이엔/Noun,1,0,1,0.0,1.1106915165381966e-05,1.0
31248,동치/Noun,1,1,0,1.1115310228308472e-05,0.0,1.0
31249,흘릴떄/Noun,1,1,0,1.1115310228308472e-05,0.0,1.0
31250,정안/Noun,1,0,1,0.0,1.1106915165381966e-05,1.0
31251,드러븐/Noun,1,0,1,0.0,1.1106915165381966e-05,1.0
31252,다림질/Noun,1,0,1,0.0,1.1106915165381966e-05,1.0
31253,김성태/Noun,1,1,0,1.1115310228308472e-05,0.0,1.0
31254,살대/Noun,1,1,0,1.1115310228308472e-05,0.0,1.0
31255,어쨋다/Noun,1,0,1,0.0,1.1106915165381966e-05,1.0
31256,LE/Alpha,1,0,1,0.0,1.1106915165381966e-05,1.0
31257,대륙이동설/Noun,1,0,1,0.0,1.1106915165381966e-05,1.0
31258,베리야/Noun,1,1,0,1.1115310228308472e-05,0.0,1.0
31259,뒤쥐/Noun,1,1,0,1.1115310228308472e-05,0.0,1.0
31260,엔딩다시봤넹/Foreign,1,1,0,1.1115310228308472e-05,0.0,1.0
31261,엔딩/Foreign,1,1,0,1.1115310228308472e-05,0.0,1.0
31262,엠페러/Noun,1,1,0,1.1115310228308472e-05,0.0,1.0
31263,븨/Noun,1,1,0,1.1115310228308472e-05,0.0,1.0
31264,스포츠인/Noun,1,1,0,1.1115310228308472e-05,0.0,1.0
31265,페이스메이커/Noun,1,1,0,1.1115310228308472e-05,0.0,1.0
31266,원적/Noun,1,1,0,1.1115310228308472e-05,0.0,1.0
31267,upon/Alpha,1,1,0,1.1115310228308472e-05,0.0,1.0
31268,이재환/Noun,1,0,1,0.0,1.1106915165381966e-05,1.0
31269,땃/Noun,1,0,1,0.0,1.1106915165381966e-05,1.0
31270,남촌/Noun,1,1,0,1.1115310228308472e-05,0.0,1.0
31271,산너머/Noun,1,1,0,1.1115310228308472e-05,0.0,1.0
31272,라서/Foreign,1,1,0,1.1115310228308472e-05,0.0,1.0
31273,뒹굴러/Noun,1,0,1,0.0,1.1106915165381966e-05,1.0
31274,감무/Noun,1,0,1,0.0,1.1106915165381966e-05,1.0
31275,비녀/Noun,1,0,1,0.0,1.1106915165381966e-05,1.0
31276,>>>>>>>>>>/Punctuation,1,1,0,1.1115310228308472e-05,0.0,1.0
31277,코소/Noun,1,1,0,1.1115310228308472e-05,0.0,1.0
31278,반짜린데/Foreign,1,1,0,1.1115310228308472e-05,0.0,1.0
31279,케이블카/Noun,1,1,0,1.1115310228308472e-05,0.0,1.0
31280,자메티/Noun,1,0,1,0.0,1.1106915165381966e-05,1.0
31281,귀뚤귀뚤/Adverb,1,1,0,1.1115310228308472e-05,0.0,1.0
31282,7.68/Number,1,0,1,0.0,1.1106915165381966e-05,1.0
31283,파업전야/Noun,1,0,1,0.0,1.1106915165381966e-05,1.0
31284,14:17/Number,1,0,1,0.0,1.1106915165381966e-05,1.0
31285,2012.12/Number,1,0,1,0.0,1.1106915165381966e-05,1.0
31286,fndl/Alpha,1,0,1,0.0,1.1106915165381966e-05,1.0
31287,lucky/Alpha,1,0,1,0.0,1.1106915165381966e-05,1.0
31288,러썰웨폰/Noun,1,1,0,1.1115310228308472e-05,0.0,1.0
31289,러쎌웨폰따위/Noun,1,1,0,1.1115310228308472e-05,0.0,1.0
31290,뮌미/Noun,1,0,1,0.0,1.1106915165381966e-05,1.0
31291,고집쟁이/Noun,1,1,0,1.1115310228308472e-05,0.0,1.0
31292,본듲/Noun,1,1,0,1.1115310228308472e-05,0.0,1.0
31293,수렁/Noun,1,1,0,1.1115310228308472e-05,0.0,1.0
31294,포일/Noun,1,0,1,0.0,1.1106915165381966e-05,1.0
31295,열씨/Noun,1,0,1,0.0,1.1106915165381966e-05,1.0
31296,케루/Noun,1,0,1,0.0,1.1106915165381966e-05,1.0
31297,유승옥/Noun,1,1,0,1.1115310228308472e-05,0.0,1.0
31298,추임새/Noun,1,1,0,1.1115310228308472e-05,0.0,1.0
31299,은년/Noun,1,0,1,0.0,1.1106915165381966e-05,1.0
31300,신내/Noun,1,1,0,1.1115310228308472e-05,0.0,1.0
31301,",,,,,,,,,/Punctuation",1,0,1,0.0,1.1106915165381966e-05,1.0
31302,맹정/Noun,1,1,0,1.1115310228308472e-05,0.0,1.0
31303,망산/Noun,1,1,0,1.1115310228308472e-05,0.0,1.0
31304,로버/Noun,1,1,0,1.1115310228308472e-05,0.0,1.0
31305,토니스타크/Noun,1,1,0,1.1115310228308472e-05,0.0,1.0
31306,밀면/Noun,1,1,0,1.1115310228308472e-05,0.0,1.0
31307,어폰/Noun,1,0,1,0.0,1.1106915165381966e-05,1.0
31308,이지났다/Foreign,1,1,0,1.1115310228308472e-05,0.0,1.0
31309,콜로세움/Noun,1,1,0,1.1115310228308472e-05,0.0,1.0
31310,빠에야/Noun,1,0,1,0.0,1.1106915165381966e-05,1.0
31311,신지훈/Noun,1,0,1,0.0,1.1106915165381966e-05,1.0
31312,액숀하/Noun,1,1,0,1.1115310228308472e-05,0.0,1.0
31313,뱉/Noun,1,0,1,0.0,1.1106915165381966e-05,1.0
31314,7000/Number,1,0,1,0.0,1.1106915165381966e-05,1.0
31315,ㅋㄱㄱㄱ/KoreanParticle,1,0,1,0.0,1.1106915165381966e-05,1.0
31316,닥돌/Noun,1,0,1,0.0,1.1106915165381966e-05,1.0
31317,치솟다/Verb,1,0,1,0.0,1.1106915165381966e-05,1.0
31318,엄지발가락/Noun,1,0,1,0.0,1.1106915165381966e-05,1.0
31319,시시덕거리다/Verb,1,0,1,0.0,1.1106915165381966e-05,1.0
31320,런줄/Noun,1,0,1,0.0,1.1106915165381966e-05,1.0
31321,"....,,../Punctuation",1,0,1,0.0,1.1106915165381966e-05,1.0
31322,강자/Noun,1,0,1,0.0,1.1106915165381966e-05,1.0
31323,권민석/Noun,1,0,1,0.0,1.1106915165381966e-05,1.0
31324,냉랭하다/Adjective,1,0,1,0.0,1.1106915165381966e-05,1.0
31325,원소스멀티유즈/Noun,1,1,0,1.1115310228308472e-05,0.0,1.0
31326,내선일체/Noun,1,0,1,0.0,1.1106915165381966e-05,1.0
31327,께름칙하/Noun,1,0,1,0.0,1.1106915165381966e-05,1.0
31328,요코이야기/Noun,1,0,1,0.0,1.1106915165381966e-05,1.0
31329,아임즈에/Noun,1,1,0,1.1115310228308472e-05,0.0,1.0
31330,안스구/Noun,1,1,0,1.1115310228308472e-05,0.0,1.0
31331,ㅋㅁㄻㄹ/KoreanParticle,1,0,1,0.0,1.1106915165381966e-05,1.0
31332,쫑냅시/Noun,1,0,1,0.0,1.1106915165381966e-05,1.0
31333,godmother/Alpha,1,1,0,1.1115310228308472e-05,0.0,1.0
31334,헛된사랑/Noun,1,1,0,1.1115310228308472e-05,0.0,1.0
31335,강인철/Noun,1,0,1,0.0,1.1106915165381966e-05,1.0
31336,김미숙/Noun,1,1,0,1.1115310228308472e-05,0.0,1.0
31337,임재/Noun,1,0,1,0.0,1.1106915165381966e-05,1.0
31338,부즘/Noun,1,1,0,1.1115310228308472e-05,0.0,1.0
31339,질머/Noun,1,1,0,1.1115310228308472e-05,0.0,1.0
31340,기혼/Noun,1,1,0,1.1115310228308472e-05,0.0,1.0
31341,린듯/Noun,1,1,0,1.1115310228308472e-05,0.0,1.0
31342,은이야기/Foreign,1,0,1,0.0,1.1106915165381966e-05,1.0
31343,추크/Noun,1,0,1,0.0,1.1106915165381966e-05,1.0
31344,브릿영화/Noun,1,1,0,1.1115310228308472e-05,0.0,1.0
31345,궂연기/Noun,1,1,0,1.1115310228308472e-05,0.0,1.0
31346,ㅓㅓ/KoreanParticle,1,1,0,1.1115310228308472e-05,0.0,1.0
31347,10000%/Number,1,1,0,1.1115310228308472e-05,0.0,1.0
31348,마지막여행/Noun,1,1,0,1.1115310228308472e-05,0.0,1.0
31349,티백횽/Noun,1,1,0,1.1115310228308472e-05,0.0,1.0
31350,티백/Noun,1,1,0,1.1115310228308472e-05,0.0,1.0
31351,!/Foreign,1,1,0,1.1115310228308472e-05,0.0,1.0
31352,셋트같/Noun,1,1,0,1.1115310228308472e-05,0.0,1.0
31353,확깨/Noun,1,1,0,1.1115310228308472e-05,0.0,1.0
31354,=-=/Punctuation,1,0,1,0.0,1.1106915165381966e-05,1.0
31355,마그리트/Noun,1,0,1,0.0,1.1106915165381966e-05,1.0
31356,비등/Noun,1,0,1,0.0,1.1106915165381966e-05,1.0
31357,샹큼/Noun,1,0,1,0.0,1.1106915165381966e-05,1.0
31358,아이다호/Noun,1,1,0,1.1115310228308472e-05,0.0,1.0
31359,ghdz/Alpha,1,1,0,1.1115310228308472e-05,0.0,1.0
31360,다웠음/Noun,1,1,0,1.1115310228308472e-05,0.0,1.0
31361,7~80/Number,1,1,0,1.1115310228308472e-05,0.0,1.0
31362,젠장/Exclamation,1,0,1,0.0,1.1106915165381966e-05,1.0
31363,점문/Noun,1,0,1,0.0,1.1106915165381966e-05,1.0
31364,칀더/Noun,1,0,1,0.0,1.1106915165381966e-05,1.0
31365,삐리리씬/Noun,1,0,1,0.0,1.1106915165381966e-05,1.0
31366,예일대/Noun,1,0,1,0.0,1.1106915165381966e-05,1.0
31367,라퓨/Noun,1,0,1,0.0,1.1106915165381966e-05,1.0
31368,wind/Alpha,1,1,0,1.1115310228308472e-05,0.0,1.0
31369,개시시/Adverb,1,0,1,0.0,1.1106915165381966e-05,1.0
31370,팔뿌러지/Noun,1,0,1,0.0,1.1106915165381966e-05,1.0
31371,해좀/Noun,1,0,1,0.0,1.1106915165381966e-05,1.0
31372,좇대딩/Noun,1,0,1,0.0,1.1106915165381966e-05,1.0
31373,준우승/Noun,1,0,1,0.0,1.1106915165381966e-05,1.0
31374,괘변입니/Noun,1,0,1,0.0,1.1106915165381966e-05,1.0
31375,헝으혀향/Noun,1,1,0,1.1115310228308472e-05,0.0,1.0
31376,웅얼거려/Noun,1,0,1,0.0,1.1106915165381966e-05,1.0
31377,윤시내/Noun,1,1,0,1.1115310228308472e-05,0.0,1.0
31378,쉿트/Noun,1,0,1,0.0,1.1106915165381966e-05,1.0
31379,폴링스카이즈/Noun,1,0,1,0.0,1.1106915165381966e-05,1.0
31380,서지훈/Noun,1,1,0,1.1115310228308472e-05,0.0,1.0
31381,몰압/Noun,1,0,1,0.0,1.1106915165381966e-05,1.0
31382,그렌체몰/Noun,1,1,0,1.1115310228308472e-05,0.0,1.0
31383,간식/Noun,1,1,0,1.1115310228308472e-05,0.0,1.0
31384,워니/Noun,1,0,1,0.0,1.1106915165381966e-05,1.0
31385,~~<?|??/Punctuation,1,1,0,1.1115310228308472e-05,0.0,1.0
31386,<~~?~???/Punctuation,1,1,0,1.1115310228308472e-05,0.0,1.0
31387,훓/Noun,1,1,0,1.1115310228308472e-05,0.0,1.0
31388,대우받다/Verb,1,1,0,1.1115310228308472e-05,0.0,1.0
31389,우두머리/Noun,1,1,0,1.1115310228308472e-05,0.0,1.0
31390,성직자/Noun,1,1,0,1.1115310228308472e-05,0.0,1.0
31391,~~!~~!~~!~~!/Punctuation,1,1,0,1.1115310228308472e-05,0.0,1.0
31392,?...;/Punctuation,1,0,1,0.0,1.1106915165381966e-05,1.0
31393,3.33/Number,1,1,0,1.1115310228308472e-05,0.0,1.0
31394,삘리감기/Noun,1,0,1,0.0,1.1106915165381966e-05,1.0
31395,치안/Noun,1,0,1,0.0,1.1106915165381966e-05,1.0
31396,어른껀/Noun,1,0,1,0.0,1.1106915165381966e-05,1.0
31397,애덜껀/Noun,1,0,1,0.0,1.1106915165381966e-05,1.0
31398,747/Number,1,1,0,1.1115310228308472e-05,0.0,1.0
31399,5.11/Number,1,0,1,0.0,1.1106915165381966e-05,1.0
31400,조차도/Foreign,1,0,1,0.0,1.1106915165381966e-05,1.0
31401,영합/Noun,1,0,1,0.0,1.1106915165381966e-05,1.0
31402,etc/Alpha,1,0,1,0.0,1.1106915165381966e-05,1.0
31403,우누/Noun,1,1,0,1.1115310228308472e-05,0.0,1.0
31404,skeeter/Alpha,1,1,0,1.1115310228308472e-05,0.0,1.0
31405,차뒤/Noun,1,0,1,0.0,1.1106915165381966e-05,1.0
31406,강변북로/Noun,1,0,1,0.0,1.1106915165381966e-05,1.0
31407,칼로/Noun,1,1,0,1.1115310228308472e-05,0.0,1.0
31408,외간/Noun,1,0,1,0.0,1.1106915165381966e-05,1.0
31409,게끝/Noun,1,0,1,0.0,1.1106915165381966e-05,1.0
31410,마스코트/Noun,1,1,0,1.1115310228308472e-05,0.0,1.0
31411,마리우스/Noun,1,1,0,1.1115310228308472e-05,0.0,1.0
31412,레미/Noun,1,1,0,1.1115310228308472e-05,0.0,1.0
31413,광야/Noun,1,0,1,0.0,1.1106915165381966e-05,1.0
31414,꼴물견/Noun,1,0,1,0.0,1.1106915165381966e-05,1.0
31415,양장/Noun,1,1,0,1.1115310228308472e-05,0.0,1.0
31416,끈킨기분/Noun,1,0,1,0.0,1.1106915165381966e-05,1.0
31417,날더/Noun,1,0,1,0.0,1.1106915165381966e-05,1.0
31418,눈배맀다/Noun,1,0,1,0.0,1.1106915165381966e-05,1.0
31419,경상/Noun,1,0,1,0.0,1.1106915165381966e-05,1.0
31420,잘봣는디/Noun,1,1,0,1.1115310228308472e-05,0.0,1.0
31421,눈물닥느/Noun,1,1,0,1.1115310228308472e-05,0.0,1.0
31422,호색/Noun,1,1,0,1.1115310228308472e-05,0.0,1.0
31423,맺힌것들/Noun,1,1,0,1.1115310228308472e-05,0.0,1.0
31424,햇었/Noun,1,1,0,1.1115310228308472e-05,0.0,1.0
31425,김기열/Noun,1,0,1,0.0,1.1106915165381966e-05,1.0
31426,난꽤/Noun,1,1,0,1.1115310228308472e-05,0.0,1.0
31427,틀길레/Noun,1,0,1,0.0,1.1106915165381966e-05,1.0
31428,crap/Alpha,1,0,1,0.0,1.1106915165381966e-05,1.0
31429,script/Alpha,1,0,1,0.0,1.1106915165381966e-05,1.0
31430,dangers/Alpha,1,0,1,0.0,1.1106915165381966e-05,1.0
31431,example/Alpha,1,0,1,0.0,1.1106915165381966e-05,1.0
31432,쫌빨리/Noun,1,0,1,0.0,1.1106915165381966e-05,1.0
31433,스톤콜드/Noun,1,0,1,0.0,1.1106915165381966e-05,1.0
31434,거푸집/Noun,1,1,0,1.1115310228308472e-05,0.0,1.0
31435,gone/Alpha,1,1,0,1.1115310228308472e-05,0.0,1.0
31436,ㅎㅎㅎㅡㅡ/KoreanParticle,1,0,1,0.0,1.1106915165381966e-05,1.0
31437,굴뚝/Noun,1,0,1,0.0,1.1106915165381966e-05,1.0
31438,최로/Noun,1,1,0,1.1115310228308472e-05,0.0,1.0
31439,곪/Noun,1,1,0,1.1115310228308472e-05,0.0,1.0
31440,찐드기/Noun,1,1,0,1.1115310228308472e-05,0.0,1.0
31441,전학생/Noun,1,0,1,0.0,1.1106915165381966e-05,1.0
31442,급비/Noun,1,0,1,0.0,1.1106915165381966e-05,1.0
31443,내항/Noun,1,1,0,1.1115310228308472e-05,0.0,1.0
31444,셋방/Noun,1,0,1,0.0,1.1106915165381966e-05,1.0
31445,추도/Noun,1,1,0,1.1115310228308472e-05,0.0,1.0
31446,안밖혀/Noun,1,1,0,1.1115310228308472e-05,0.0,1.0
31447,왜정/Noun,1,0,1,0.0,1.1106915165381966e-05,1.0
31448,랄거/Noun,1,0,1,0.0,1.1106915165381966e-05,1.0
31449,법회/Noun,1,1,0,1.1115310228308472e-05,0.0,1.0
31450,겨짐/Noun,1,1,0,1.1115310228308472e-05,0.0,1.0
31451,대흉내에어이없는스토리/Foreign,1,0,1,0.0,1.1106915165381966e-05,1.0
31452,미켈레/Noun,1,1,0,1.1115310228308472e-05,0.0,1.0
31453,룰거/Noun,1,0,1,0.0,1.1106915165381966e-05,1.0
31454,아깝딘/Noun,1,0,1,0.0,1.1106915165381966e-05,1.0
31455,쯔무시/Noun,1,1,0,1.1115310228308472e-05,0.0,1.0
31456,유선영/Noun,1,1,0,1.1115310228308472e-05,0.0,1.0
31457,おもひでぽろぽろ/Foreign,1,1,0,1.1115310228308472e-05,0.0,1.0
31458,스쿨버스/Noun,1,1,0,1.1115310228308472e-05,0.0,1.0
31459,대체복무/Noun,1,1,0,1.1115310228308472e-05,0.0,1.0
31460,8-809/Number,1,1,0,1.1115310228308472e-05,0.0,1.0
31461,재방봄막/Noun,1,1,0,1.1115310228308472e-05,0.0,1.0
31462,직일/Noun,1,0,1,0.0,1.1106915165381966e-05,1.0
31463,씬인데/Noun,1,0,1,0.0,1.1106915165381966e-05,1.0
31464,거죄/Noun,1,0,1,0.0,1.1106915165381966e-05,1.0
31465,festival/Alpha,1,1,0,1.1115310228308472e-05,0.0,1.0
31466,ros/Alpha,1,1,0,1.1115310228308472e-05,0.0,1.0
31467,sigur/Alpha,1,1,0,1.1115310228308472e-05,0.0,1.0
31468,훼이크/Noun,1,0,1,0.0,1.1106915165381966e-05,1.0
31469,낚은거/Noun,1,0,1,0.0,1.1106915165381966e-05,1.0
31470,구세준/Noun,1,0,1,0.0,1.1106915165381966e-05,1.0
31471,없는뎁/Noun,1,1,0,1.1115310228308472e-05,0.0,1.0
31472,허경환/Noun,1,0,1,0.0,1.1106915165381966e-05,1.0
31473,데꼬/Noun,1,0,1,0.0,1.1106915165381966e-05,1.0
31474,만수르/Noun,1,0,1,0.0,1.1106915165381966e-05,1.0
31475,전영화인데/Foreign,1,1,0,1.1115310228308472e-05,0.0,1.0
31476,awful/Alpha,1,1,0,1.1115310228308472e-05,0.0,1.0
31477,UNLESS/Alpha,1,1,0,1.1115310228308472e-05,0.0,1.0
31478,~~|^^/Punctuation,1,1,0,1.1115310228308472e-05,0.0,1.0
31479,땟음/Noun,1,0,1,0.0,1.1106915165381966e-05,1.0
31480,zzzzz/Alpha,1,1,0,1.1115310228308472e-05,0.0,1.0
31481,쫀득쫀득/Noun,1,0,1,0.0,1.1106915165381966e-05,1.0
31482,잼쬬/Noun,1,1,0,1.1115310228308472e-05,0.0,1.0
31483,헬머/Noun,1,1,0,1.1115310228308472e-05,0.0,1.0
31484,학창/Noun,1,0,1,0.0,1.1106915165381966e-05,1.0
31485,crazy/Alpha,1,1,0,1.1115310228308472e-05,0.0,1.0
31486,쩌릿쩌릿/Noun,1,1,0,1.1115310228308472e-05,0.0,1.0
31487,합본/Noun,1,1,0,1.1115310228308472e-05,0.0,1.0
31488,봏/Noun,1,1,0,1.1115310228308472e-05,0.0,1.0
31489,주견/Noun,1,1,0,1.1115310228308472e-05,0.0,1.0
31490,음담패설/Noun,1,0,1,0.0,1.1106915165381966e-05,1.0
31491,부터한회도안빠지고본방사수한드라마♥/Foreign,1,1,0,1.1115310228308472e-05,0.0,1.0
31492,썽내/Noun,1,0,1,0.0,1.1106915165381966e-05,1.0
31493,주딩/Noun,1,0,1,0.0,1.1106915165381966e-05,1.0
31494,헥토파스칼/Noun,1,0,1,0.0,1.1106915165381966e-05,1.0
31495,버서/Noun,1,0,1,0.0,1.1106915165381966e-05,1.0
31496,짧아지다/Verb,1,0,1,0.0,1.1106915165381966e-05,1.0
31497,목적의식/Noun,1,0,1,0.0,1.1106915165381966e-05,1.0
31498,땜질/Noun,1,0,1,0.0,1.1106915165381966e-05,1.0
31499,도라지/Noun,1,0,1,0.0,1.1106915165381966e-05,1.0
31500,주민수/Noun,1,0,1,0.0,1.1106915165381966e-05,1.0
31501,회지/Noun,1,0,1,0.0,1.1106915165381966e-05,1.0
31502,대보다/Foreign,1,0,1,0.0,1.1106915165381966e-05,1.0
31503,ICBM/Alpha,1,0,1,0.0,1.1106915165381966e-05,1.0
31504,준엄/Noun,1,1,0,1.1115310228308472e-05,0.0,1.0
31505,박수진/Noun,1,0,1,0.0,1.1106915165381966e-05,1.0
31506,엽구/Noun,1,1,0,1.1115310228308472e-05,0.0,1.0
31507,노민혁/Noun,1,1,0,1.1115310228308472e-05,0.0,1.0
31508,우해/Noun,1,0,1,0.0,1.1106915165381966e-05,1.0
31509,카펜터스/Noun,1,1,0,1.1115310228308472e-05,0.0,1.0
31510,서진용/Noun,1,0,1,0.0,1.1106915165381966e-05,1.0
31511,디행/Noun,1,0,1,0.0,1.1106915165381966e-05,1.0
31512,barbeque/Alpha,1,0,1,0.0,1.1106915165381966e-05,1.0
31513,Koreans.Love/URL,1,0,1,0.0,1.1106915165381966e-05,1.0
31514,koreans/Alpha,1,0,1,0.0,1.1106915165381966e-05,1.0
31515,Maybe/Alpha,1,0,1,0.0,1.1106915165381966e-05,1.0
31516,세라복/Noun,1,0,1,0.0,1.1106915165381966e-05,1.0
31517,왜나왓/Noun,1,0,1,0.0,1.1106915165381966e-05,1.0
31518,병수/Noun,1,0,1,0.0,1.1106915165381966e-05,1.0
31519,김유진/Noun,1,0,1,0.0,1.1106915165381966e-05,1.0
31520,",......../Punctuation",1,0,1,0.0,1.1106915165381966e-05,1.0
31521,무곡/Noun,1,1,0,1.1115310228308472e-05,0.0,1.0
31522,이핵/Noun,1,1,0,1.1115310228308472e-05,0.0,1.0
31523,코다이/Noun,1,1,0,1.1115310228308472e-05,0.0,1.0
31524,프레슬리/Noun,1,1,0,1.1115310228308472e-05,0.0,1.0
31525,늠들/Noun,1,1,0,1.1115310228308472e-05,0.0,1.0
31526,쒸레기들임/Noun,1,1,0,1.1115310228308472e-05,0.0,1.0
31527,김성곤/Noun,1,1,0,1.1115310228308472e-05,0.0,1.0
31528,최세/Noun,1,1,0,1.1115310228308472e-05,0.0,1.0
31529,100등/Number,1,0,1,0.0,1.1106915165381966e-05,1.0
31530,99등/Number,1,0,1,0.0,1.1106915165381966e-05,1.0
31531,.@/Punctuation,1,0,1,0.0,1.1106915165381966e-05,1.0
31532,좇되/Noun,1,0,1,0.0,1.1106915165381966e-05,1.0
31533,?>??/Punctuation,1,1,0,1.1115310228308472e-05,0.0,1.0
31534,밴디/Noun,1,0,1,0.0,1.1106915165381966e-05,1.0
31535,비카/Noun,1,0,1,0.0,1.1106915165381966e-05,1.0
31536,승마/Noun,1,1,0,1.1115310228308472e-05,0.0,1.0
31537,베꼇다/Noun,1,0,1,0.0,1.1106915165381966e-05,1.0
31538,...........?/Punctuation,1,1,0,1.1115310228308472e-05,0.0,1.0
31539,",.,.,.,.,.,/Punctuation",1,0,1,0.0,1.1106915165381966e-05,1.0
31540,통일기/Noun,1,0,1,0.0,1.1106915165381966e-05,1.0
31541,끈김/Noun,1,1,0,1.1115310228308472e-05,0.0,1.0
31542,그것떄문/Noun,1,1,0,1.1115310228308472e-05,0.0,1.0
31543,쌘척/Noun,1,1,0,1.1115310228308472e-05,0.0,1.0
31544,노빠들/Noun,1,0,1,0.0,1.1106915165381966e-05,1.0
31545,팔만/Noun,1,0,1,0.0,1.1106915165381966e-05,1.0
31546,팰/Noun,1,0,1,0.0,1.1106915165381966e-05,1.0
31547,두두/Noun,1,0,1,0.0,1.1106915165381966e-05,1.0
31548,사과문/Noun,1,0,1,0.0,1.1106915165381966e-05,1.0
31549,행등/Noun,1,0,1,0.0,1.1106915165381966e-05,1.0
31550,엘팬/Noun,1,0,1,0.0,1.1106915165381966e-05,1.0
31551,왜엮냐/Noun,1,0,1,0.0,1.1106915165381966e-05,1.0
31552,헤피/Noun,1,1,0,1.1115310228308472e-05,0.0,1.0
31553,졸도/Noun,1,1,0,1.1115310228308472e-05,0.0,1.0
31554,".........""/Punctuation",1,1,0,1.1115310228308472e-05,0.0,1.0
31555,이혜인/Noun,1,0,1,0.0,1.1106915165381966e-05,1.0
31556,토스카니니/Noun,1,0,1,0.0,1.1106915165381966e-05,1.0
31557,해성/Noun,1,1,0,1.1115310228308472e-05,0.0,1.0
31558,4.02/Number,1,0,1,0.0,1.1106915165381966e-05,1.0
31559,끈점/Noun,1,0,1,0.0,1.1106915165381966e-05,1.0
31560,난점/Noun,1,0,1,0.0,1.1106915165381966e-05,1.0
31561,쩌란거/Noun,1,0,1,0.0,1.1106915165381966e-05,1.0
31562,동안앉아서집중해서봤는데도데체이영화줄거리가뭐죠/Foreign,1,0,1,0.0,1.1106915165381966e-05,1.0
31563,97분/Number,1,0,1,0.0,1.1106915165381966e-05,1.0
31564,"--,/Punctuation",1,0,1,0.0,1.1106915165381966e-05,1.0
31565,오에이/Noun,1,1,0,1.1115310228308472e-05,0.0,1.0
31566,주니엘/Noun,1,1,0,1.1115310228308472e-05,0.0,1.0
31567,에프티아일랜드/Noun,1,1,0,1.1115310228308472e-05,0.0,1.0
31568,잼낭/Noun,1,1,0,1.1115310228308472e-05,0.0,1.0
31569,박약/Noun,1,0,1,0.0,1.1106915165381966e-05,1.0
31570,일환/Noun,1,0,1,0.0,1.1106915165381966e-05,1.0
31571,친뒤/Noun,1,0,1,0.0,1.1106915165381966e-05,1.0
31572,쬬쬬/Noun,1,1,0,1.1115310228308472e-05,0.0,1.0
31573,범상하다/Adjective,1,0,1,0.0,1.1106915165381966e-05,1.0
31574,어쩌란건/Noun,1,0,1,0.0,1.1106915165381966e-05,1.0
31575,삼림/Noun,1,1,0,1.1115310228308472e-05,0.0,1.0
31576,쯤아님/Foreign,1,1,0,1.1115310228308472e-05,0.0,1.0
31577,허천/Noun,1,1,0,1.1115310228308472e-05,0.0,1.0
31578,못하겟/Noun,1,1,0,1.1115310228308472e-05,0.0,1.0
31579,물불/Noun,1,0,1,0.0,1.1106915165381966e-05,1.0
31580,소철나무/Noun,1,1,0,1.1115310228308472e-05,0.0,1.0
31581,네온싸인/Noun,1,0,1,0.0,1.1106915165381966e-05,1.0
31582,박씨/Noun,1,0,1,0.0,1.1106915165381966e-05,1.0
31583,십지/Noun,1,0,1,0.0,1.1106915165381966e-05,1.0
31584,8.06/Number,1,0,1,0.0,1.1106915165381966e-05,1.0
31585,킥좀/Noun,1,1,0,1.1115310228308472e-05,0.0,1.0
31586,지랄/Noun,1,1,0,1.1115310228308472e-05,0.0,1.0
31587,",,,,(,,,,/Punctuation",1,1,0,1.1115310228308472e-05,0.0,1.0
31588,짐돠/Noun,1,1,0,1.1115310228308472e-05,0.0,1.0
31589,주근/Noun,1,1,0,1.1115310228308472e-05,0.0,1.0
31590,북수단/Noun,1,1,0,1.1115310228308472e-05,0.0,1.0
31591,남수단/Noun,1,1,0,1.1115310228308472e-05,0.0,1.0
31592,남북분단/Noun,1,1,0,1.1115310228308472e-05,0.0,1.0
31593,Niggar/Alpha,1,1,0,1.1115310228308472e-05,0.0,1.0
31594,뭐지/Foreign,1,0,1,0.0,1.1106915165381966e-05,1.0
31595,힙겨웠다/Noun,1,0,1,0.0,1.1106915165381966e-05,1.0
31596,다빈치코드/Noun,1,1,0,1.1115310228308472e-05,0.0,1.0
31597,청룽/Noun,1,1,0,1.1115310228308472e-05,0.0,1.0
31598,불국사/Noun,1,1,0,1.1115310228308472e-05,0.0,1.0
31599,초견/Noun,1,0,1,0.0,1.1106915165381966e-05,1.0
31600,워렌버핏/Noun,1,0,1,0.0,1.1106915165381966e-05,1.0
31601,0.24/Number,1,0,1,0.0,1.1106915165381966e-05,1.0
31602,폄훼하/Noun,1,1,0,1.1115310228308472e-05,0.0,1.0
31603,그뇬때매/Noun,1,0,1,0.0,1.1106915165381966e-05,1.0
31604,껄끄럽습니/Noun,1,0,1,0.0,1.1106915165381966e-05,1.0
31605,230/Number,1,1,0,1.1115310228308472e-05,0.0,1.0
31606,아나고/Noun,1,0,1,0.0,1.1106915165381966e-05,1.0
31607,잔비/Noun,1,1,0,1.1115310228308472e-05,0.0,1.0
31608,집들이/Noun,1,1,0,1.1115310228308472e-05,0.0,1.0
31609,힐거/Noun,1,0,1,0.0,1.1106915165381966e-05,1.0
31610,클픽/Noun,1,0,1,0.0,1.1106915165381966e-05,1.0
31611,똘빡/Noun,1,0,1,0.0,1.1106915165381966e-05,1.0
31612,정글북/Noun,1,1,0,1.1115310228308472e-05,0.0,1.0
31613,파브로/Noun,1,1,0,1.1115310228308472e-05,0.0,1.0
31614,컷신/Noun,1,0,1,0.0,1.1106915165381966e-05,1.0
31615,지배자/Noun,1,1,0,1.1115310228308472e-05,0.0,1.0
31616,정치체제/Noun,1,1,0,1.1115310228308472e-05,0.0,1.0
31617,ppl/Alpha,1,0,1,0.0,1.1106915165381966e-05,1.0
31618,끈나버례/Noun,1,1,0,1.1115310228308472e-05,0.0,1.0
31619,러블리해/Noun,1,1,0,1.1115310228308472e-05,0.0,1.0
31620,로맨티시즘/Noun,1,1,0,1.1115310228308472e-05,0.0,1.0
31621,ㅋㅌㅌㅌ/KoreanParticle,1,0,1,0.0,1.1106915165381966e-05,1.0
31622,ㅋㅋㅋㅌㅌㅌ/KoreanParticle,1,0,1,0.0,1.1106915165381966e-05,1.0
31623,램지/Noun,1,0,1,0.0,1.1106915165381966e-05,1.0
31624,밤활키/Noun,1,1,0,1.1115310228308472e-05,0.0,1.0
31625,빈형/Noun,1,1,0,1.1115310228308472e-05,0.0,1.0
31626,동안지루하지않고재미있었다/Foreign,1,1,0,1.1115310228308472e-05,0.0,1.0
31627,161분/Number,1,1,0,1.1115310228308472e-05,0.0,1.0
31628,분계/Noun,1,0,1,0.0,1.1106915165381966e-05,1.0
31629,>??/Punctuation,1,0,1,0.0,1.1106915165381966e-05,1.0
31630,8.44/Number,1,1,0,1.1115310228308472e-05,0.0,1.0
31631,안봣는/Noun,1,1,0,1.1115310228308472e-05,0.0,1.0
31632,꼴패/Noun,1,0,1,0.0,1.1106915165381966e-05,1.0
31633,헛된망상/Noun,1,0,1,0.0,1.1106915165381966e-05,1.0
31634,rma/Alpha,1,1,0,1.1115310228308472e-05,0.0,1.0
31635,했겄네/Noun,1,1,0,1.1115310228308472e-05,0.0,1.0
31636,깨나/Noun,1,1,0,1.1115310228308472e-05,0.0,1.0
31637,촬령하랴/Noun,1,1,0,1.1115310228308472e-05,0.0,1.0
31638,팽브러더스/Noun,1,0,1,0.0,1.1106915165381966e-05,1.0
31639,저작물/Noun,1,1,0,1.1115310228308472e-05,0.0,1.0
31640,씌래기/Noun,1,0,1,0.0,1.1106915165381966e-05,1.0
31641,목그/Noun,1,0,1,0.0,1.1106915165381966e-05,1.0
31642,안됑/Noun,1,1,0,1.1115310228308472e-05,0.0,1.0
31643,착시/Noun,1,1,0,1.1115310228308472e-05,0.0,1.0
31644,케네스/Noun,1,0,1,0.0,1.1106915165381966e-05,1.0
31645,AT/Alpha,1,0,1,0.0,1.1106915165381966e-05,1.0
31646,섹신/Noun,1,0,1,0.0,1.1106915165381966e-05,1.0
31647,",!!/Punctuation",1,1,0,1.1115310228308472e-05,0.0,1.0
31648,이여진/Noun,1,0,1,0.0,1.1106915165381966e-05,1.0
31649,9.84/Number,1,1,0,1.1115310228308472e-05,0.0,1.0
31650,아오뽁쳐/Noun,1,0,1,0.0,1.1106915165381966e-05,1.0
31651,20140919일/Number,1,0,1,0.0,1.1106915165381966e-05,1.0
31652,변화무쌍하다/Adjective,1,0,1,0.0,1.1106915165381966e-05,1.0
31653,만에봄/Foreign,1,0,1,0.0,1.1106915165381966e-05,1.0
31654,고진/Noun,1,0,1,0.0,1.1106915165381966e-05,1.0
31655,10000000/Number,1,1,0,1.1115310228308472e-05,0.0,1.0
31656,만취연기/Noun,1,0,1,0.0,1.1106915165381966e-05,1.0
31657,65/Number,1,0,1,0.0,1.1106915165381966e-05,1.0
31658,사오정/Noun,1,1,0,1.1115310228308472e-05,0.0,1.0
31659,밟힌다/Noun,1,1,0,1.1115310228308472e-05,0.0,1.0
31660,메가턴/Noun,1,0,1,0.0,1.1106915165381966e-05,1.0
31661,발가/VerbPrefix,1,1,0,1.1115310228308472e-05,0.0,1.0
31662,오메가/Noun,1,1,0,1.1115310228308472e-05,0.0,1.0
31663,력쩌/Noun,1,1,0,1.1115310228308472e-05,0.0,1.0
31664,ㄳㄳ/KoreanParticle,1,1,0,1.1115310228308472e-05,0.0,1.0
31665,썹스/Noun,1,1,0,1.1115310228308472e-05,0.0,1.0
31666,이음/Noun,1,0,1,0.0,1.1106915165381966e-05,1.0
31667,고세/Noun,1,1,0,1.1115310228308472e-05,0.0,1.0
31668,",)/Punctuation",1,1,0,1.1115310228308472e-05,0.0,1.0
31669,ㅃㅋ/KoreanParticle,1,1,0,1.1115310228308472e-05,0.0,1.0
31670,론데/Noun,1,0,1,0.0,1.1106915165381966e-05,1.0
31671,받으며/Foreign,1,0,1,0.0,1.1106915165381966e-05,1.0
31672,800원/Number,1,0,1,0.0,1.1106915165381966e-05,1.0
31673,비옴/Noun,1,0,1,0.0,1.1106915165381966e-05,1.0
31674,원히트원더/Noun,1,0,1,0.0,1.1106915165381966e-05,1.0
31675,병닥/Noun,1,1,0,1.1115310228308472e-05,0.0,1.0
31676,102분/Number,1,0,1,0.0,1.1106915165381966e-05,1.0
31677,반영/Foreign,1,0,1,0.0,1.1106915165381966e-05,1.0
31678,드보르작/Noun,1,1,0,1.1115310228308472e-05,0.0,1.0
31679,기몀비/Noun,1,1,0,1.1115310228308472e-05,0.0,1.0
31680,더반/Noun,1,1,0,1.1115310228308472e-05,0.0,1.0
31681,!!!!!*^^*/Punctuation,1,1,0,1.1115310228308472e-05,0.0,1.0
31682,.</Punctuation,1,1,0,1.1115310228308472e-05,0.0,1.0
31683,향료/Noun,1,0,1,0.0,1.1106915165381966e-05,1.0
31684,8.91/Number,1,1,0,1.1115310228308472e-05,0.0,1.0
31685,이거드/Noun,1,1,0,1.1115310228308472e-05,0.0,1.0
31686,슁/Noun,1,0,1,0.0,1.1106915165381966e-05,1.0
31687,설명하고/Foreign,1,0,1,0.0,1.1106915165381966e-05,1.0
31688,탐웰링때메/Noun,1,0,1,0.0,1.1106915165381966e-05,1.0
31689,wjdakfwoalcdfsfsewf/Alpha,1,1,0,1.1115310228308472e-05,0.0,1.0
31690,낚겼/Noun,1,0,1,0.0,1.1106915165381966e-05,1.0
31691,반파/Noun,1,1,0,1.1115310228308472e-05,0.0,1.0
31692,유진동/Noun,1,1,0,1.1115310228308472e-05,0.0,1.0
31693,지진파/Noun,1,1,0,1.1115310228308472e-05,0.0,1.0
31694,백령도/Noun,1,1,0,1.1115310228308472e-05,0.0,1.0
31695,료타/Noun,1,1,0,1.1115310228308472e-05,0.0,1.0
31696,묵힌/Foreign,1,0,1,0.0,1.1106915165381966e-05,1.0
31697,변테/Noun,1,0,1,0.0,1.1106915165381966e-05,1.0
31698,옷버겨버린/Noun,1,0,1,0.0,1.1106915165381966e-05,1.0
31699,사이프러스/Noun,1,1,0,1.1115310228308472e-05,0.0,1.0
31700,미니모이/Noun,1,1,0,1.1115310228308472e-05,0.0,1.0
31701,초촉/Noun,1,1,0,1.1115310228308472e-05,0.0,1.0
31702,기념으로/Foreign,1,1,0,1.1115310228308472e-05,0.0,1.0
31703,40일/Number,1,1,0,1.1115310228308472e-05,0.0,1.0
31704,금딸/Noun,1,1,0,1.1115310228308472e-05,0.0,1.0
31705,글라도스/Noun,1,1,0,1.1115310228308472e-05,0.0,1.0
31706,simple/Alpha,1,1,0,1.1115310228308472e-05,0.0,1.0
31707,thought/Alpha,1,1,0,1.1115310228308472e-05,0.0,1.0
31708,first/Alpha,1,1,0,1.1115310228308472e-05,0.0,1.0
31709,로어/Noun,1,1,0,1.1115310228308472e-05,0.0,1.0
31710,톰쉴링/Noun,1,1,0,1.1115310228308472e-05,0.0,1.0
31711,몽족/Noun,1,1,0,1.1115310228308472e-05,0.0,1.0
31712,젤못/Noun,1,0,1,0.0,1.1106915165381966e-05,1.0
31713,젤제/Noun,1,0,1,0.0,1.1106915165381966e-05,1.0
31714,김선화/Noun,1,1,0,1.1115310228308472e-05,0.0,1.0
31715,정성스럽다/Adjective,1,1,0,1.1115310228308472e-05,0.0,1.0
31716,특박가/Noun,1,0,1,0.0,1.1106915165381966e-05,1.0
31717,맜있/Noun,1,0,1,0.0,1.1106915165381966e-05,1.0
31718,도초반/Foreign,1,0,1,0.0,1.1106915165381966e-05,1.0
31719,독침/Noun,1,0,1,0.0,1.1106915165381966e-05,1.0
31720,9039973/Number,1,0,1,0.0,1.1106915165381966e-05,1.0
31721,yozy/Alpha,1,0,1,0.0,1.1106915165381966e-05,1.0
31722,나비야/Noun,1,0,1,0.0,1.1106915165381966e-05,1.0
31723,개떵철학/Noun,1,0,1,0.0,1.1106915165381966e-05,1.0
31724,내집마련/Noun,1,0,1,0.0,1.1106915165381966e-05,1.0
31725,쯔씽처/Noun,1,1,0,1.1115310228308472e-05,0.0,1.0
31726,7~8년/Number,1,1,0,1.1115310228308472e-05,0.0,1.0
31727,넙치/Noun,1,0,1,0.0,1.1106915165381966e-05,1.0
31728,들여/Foreign,1,0,1,0.0,1.1106915165381966e-05,1.0
31729,150억/Number,1,0,1,0.0,1.1106915165381966e-05,1.0
31730,870억원/Number,1,0,1,0.0,1.1106915165381966e-05,1.0
31731,처임/Noun,1,1,0,1.1115310228308472e-05,0.0,1.0
31732,개멍/Noun,1,0,1,0.0,1.1106915165381966e-05,1.0
31733,김정석/Noun,1,1,0,1.1115310228308472e-05,0.0,1.0
31734,",,,,,,,,,,,,,,,,,,,,,,,,,,,,,,,,,,,,,,,,,/Punctuation",1,0,1,0.0,1.1106915165381966e-05,1.0
31735,신들의전쟁/Noun,1,0,1,0.0,1.1106915165381966e-05,1.0
31736,최상학/Noun,1,0,1,0.0,1.1106915165381966e-05,1.0
31737,어설푼/Noun,1,0,1,0.0,1.1106915165381966e-05,1.0
31738,ㅋㅋㅋㄲㅋㅋㅋ/KoreanParticle,1,0,1,0.0,1.1106915165381966e-05,1.0
31739,유노/Noun,1,0,1,0.0,1.1106915165381966e-05,1.0
31740,악법/Noun,1,0,1,0.0,1.1106915165381966e-05,1.0
31741,보안법/Noun,1,0,1,0.0,1.1106915165381966e-05,1.0
31742,???(/Punctuation,1,0,1,0.0,1.1106915165381966e-05,1.0
31743,jtotal/Alpha,1,0,1,0.0,1.1106915165381966e-05,1.0
31744,원챈스/Noun,1,0,1,0.0,1.1106915165381966e-05,1.0
31745,오재무/Noun,1,0,1,0.0,1.1106915165381966e-05,1.0
31746,길음/Noun,1,0,1,0.0,1.1106915165381966e-05,1.0
31747,달도/Noun,1,0,1,0.0,1.1106915165381966e-05,1.0
31748,전영화라는/Foreign,1,1,0,1.1115310228308472e-05,0.0,1.0
31749,最高！/Foreign,1,1,0,1.1115310228308472e-05,0.0,1.0
31750,애핵/Noun,1,0,1,0.0,1.1106915165381966e-05,1.0
31751,firework/Alpha,1,1,0,1.1115310228308472e-05,0.0,1.0
31752,듀브/Noun,1,1,0,1.1115310228308472e-05,0.0,1.0
31753,방영금지/Noun,1,0,1,0.0,1.1106915165381966e-05,1.0
31754,이걸려도/Foreign,1,1,0,1.1115310228308472e-05,0.0,1.0
31755,위관/Noun,1,0,1,0.0,1.1106915165381966e-05,1.0
31756,부관/Noun,1,0,1,0.0,1.1106915165381966e-05,1.0
31757,뱃지/Noun,1,1,0,1.1115310228308472e-05,0.0,1.0
31758,<->/Punctuation,1,0,1,0.0,1.1106915165381966e-05,1.0
31759,인보/Noun,1,1,0,1.1115310228308472e-05,0.0,1.0
31760,신마/Noun,1,1,0,1.1115310228308472e-05,0.0,1.0
31761,뻘짓장/Noun,1,0,1,0.0,1.1106915165381966e-05,1.0
31762,봣느/Noun,1,0,1,0.0,1.1106915165381966e-05,1.0
31763,공휴일/Noun,1,1,0,1.1115310228308472e-05,0.0,1.0
31764,츠다보믄으뜩해/Noun,1,1,0,1.1115310228308472e-05,0.0,1.0
31765,으빠/Noun,1,1,0,1.1115310228308472e-05,0.0,1.0
31766,째연애중/Foreign,1,1,0,1.1115310228308472e-05,0.0,1.0
31767,국채/Noun,1,0,1,0.0,1.1106915165381966e-05,1.0
31768,8.68/Number,1,0,1,0.0,1.1106915165381966e-05,1.0
31769,사람족/Noun,1,0,1,0.0,1.1106915165381966e-05,1.0
31770,UMF/Alpha,1,1,0,1.1115310228308472e-05,0.0,1.0
31771,적그/Noun,1,0,1,0.0,1.1106915165381966e-05,1.0
31772,엮냐/Noun,1,1,0,1.1115310228308472e-05,0.0,1.0
31773,통일호/Noun,1,1,0,1.1115310228308472e-05,0.0,1.0
31774,처움/Noun,1,0,1,0.0,1.1106915165381966e-05,1.0
31775,나얼/Noun,1,1,0,1.1115310228308472e-05,0.0,1.0
31776,콜텍/Noun,1,1,0,1.1115310228308472e-05,0.0,1.0
31777,허투루/Noun,1,1,0,1.1115310228308472e-05,0.0,1.0
31778,왼플/Noun,1,1,0,1.1115310228308472e-05,0.0,1.0
31779,302/Number,1,0,1,0.0,1.1106915165381966e-05,1.0
31780,301/Number,1,0,1,0.0,1.1106915165381966e-05,1.0
31781,등씬땜/Noun,1,0,1,0.0,1.1106915165381966e-05,1.0
31782,어런/Noun,1,0,1,0.0,1.1106915165381966e-05,1.0
31783,민지아/Noun,1,0,1,0.0,1.1106915165381966e-05,1.0
31784,통교/Noun,1,1,0,1.1115310228308472e-05,0.0,1.0
31785,티답/Noun,1,0,1,0.0,1.1106915165381966e-05,1.0
31786,리혼/Noun,1,0,1,0.0,1.1106915165381966e-05,1.0
31787,11000원/Number,1,0,1,0.0,1.1106915165381966e-05,1.0
31788,벝/Noun,1,0,1,0.0,1.1106915165381966e-05,1.0
31789,오피/Noun,1,0,1,0.0,1.1106915165381966e-05,1.0
31790,그리네/Noun,1,0,1,0.0,1.1106915165381966e-05,1.0
31791,바비인형/Noun,1,0,1,0.0,1.1106915165381966e-05,1.0
31792,정서윤/Noun,1,1,0,1.1115310228308472e-05,0.0,1.0
31793,콩알/Noun,1,0,1,0.0,1.1106915165381966e-05,1.0
31794,봉천동/Noun,1,0,1,0.0,1.1106915165381966e-05,1.0
31795,쩌쩜쩜/Noun,1,0,1,0.0,1.1106915165381966e-05,1.0
31796,로주/Noun,1,1,0,1.1115310228308472e-05,0.0,1.0
31797,개식/Noun,1,0,1,0.0,1.1106915165381966e-05,1.0
31798,애듯/Noun,1,1,0,1.1115310228308472e-05,0.0,1.0
31799,거질/Noun,1,1,0,1.1115310228308472e-05,0.0,1.0
31800,학년었/Noun,1,1,0,1.1115310228308472e-05,0.0,1.0
31801,징용/Noun,1,0,1,0.0,1.1106915165381966e-05,1.0
31802,광자/Noun,1,0,1,0.0,1.1106915165381966e-05,1.0
31803,얼죽/Noun,1,0,1,0.0,1.1106915165381966e-05,1.0
31804,보는뎁/Noun,1,0,1,0.0,1.1106915165381966e-05,1.0
31805,모멘텀/Noun,1,0,1,0.0,1.1106915165381966e-05,1.0
31806,버진/Noun,1,0,1,0.0,1.1106915165381966e-05,1.0
31807,독거미/Noun,1,0,1,0.0,1.1106915165381966e-05,1.0
31808,여탯것/Noun,1,1,0,1.1115310228308472e-05,0.0,1.0
31809,533/Number,1,1,0,1.1115310228308472e-05,0.0,1.0
31810,환성/Noun,1,1,0,1.1115310228308472e-05,0.0,1.0
31811,9.25/Number,1,0,1,0.0,1.1106915165381966e-05,1.0
31812,핵잠수함/Noun,1,0,1,0.0,1.1106915165381966e-05,1.0
31813,괘변/Noun,1,0,1,0.0,1.1106915165381966e-05,1.0
31814,항공기/Noun,1,0,1,0.0,1.1106915165381966e-05,1.0
31815,않길바랬다/Noun,1,1,0,1.1115310228308472e-05,0.0,1.0
31816,머맨/Noun,1,1,0,1.1115310228308472e-05,0.0,1.0
31817,쪼매더/Noun,1,0,1,0.0,1.1106915165381966e-05,1.0
31818,괸찬긴/Noun,1,0,1,0.0,1.1106915165381966e-05,1.0
31819,막국수/Noun,1,0,1,0.0,1.1106915165381966e-05,1.0
31820,볼돈/Noun,1,0,1,0.0,1.1106915165381966e-05,1.0
31821,빙판/Noun,1,1,0,1.1115310228308472e-05,0.0,1.0
31822,재킷/Noun,1,1,0,1.1115310228308472e-05,0.0,1.0
31823,스펜서/Noun,1,0,1,0.0,1.1106915165381966e-05,1.0
31824,웨스트윙/Noun,1,1,0,1.1115310228308472e-05,0.0,1.0
31825,ㅆㄹㅇ/KoreanParticle,1,1,0,1.1115310228308472e-05,0.0,1.0
31826,ㅡㄴㅎ/KoreanParticle,1,1,0,1.1115310228308472e-05,0.0,1.0
31827,사중주/Noun,1,1,0,1.1115310228308472e-05,0.0,1.0
31828,바이브/Noun,1,1,0,1.1115310228308472e-05,0.0,1.0
31829,준법/Noun,1,0,1,0.0,1.1106915165381966e-05,1.0
31830,정거장/Noun,1,0,1,0.0,1.1106915165381966e-05,1.0
31831,히치하이킹/Noun,1,0,1,0.0,1.1106915165381966e-05,1.0
31832,;;_-/Punctuation,1,1,0,1.1115310228308472e-05,0.0,1.0
31833,^>^/Punctuation,1,0,1,0.0,1.1106915165381966e-05,1.0
31834,메스껍다/Adjective,1,0,1,0.0,1.1106915165381966e-05,1.0
31835,장징추/Noun,1,1,0,1.1115310228308472e-05,0.0,1.0
31836,dudwja/Alpha,1,0,1,0.0,1.1106915165381966e-05,1.0
31837,꽁트들/Noun,1,1,0,1.1115310228308472e-05,0.0,1.0
31838,티코/Noun,1,0,1,0.0,1.1106915165381966e-05,1.0
31839,마닐라/Noun,1,1,0,1.1115310228308472e-05,0.0,1.0
31840,델꼬와/Noun,1,1,0,1.1115310228308472e-05,0.0,1.0
31841,코뼈/Noun,1,1,0,1.1115310228308472e-05,0.0,1.0
31842,아강/Noun,1,1,0,1.1115310228308472e-05,0.0,1.0
31843,7.04/Number,1,0,1,0.0,1.1106915165381966e-05,1.0
31844,청탁/Noun,1,0,1,0.0,1.1106915165381966e-05,1.0
31845,에스팀/Noun,1,0,1,0.0,1.1106915165381966e-05,1.0
31846,전까진/Foreign,1,1,0,1.1115310228308472e-05,0.0,1.0
31847,앨렌/Noun,1,1,0,1.1115310228308472e-05,0.0,1.0
31848,doubt/Alpha,1,1,0,1.1115310228308472e-05,0.0,1.0
31849,왜엿/Noun,1,0,1,0.0,1.1106915165381966e-05,1.0
31850,윌폴터/Noun,1,1,0,1.1115310228308472e-05,0.0,1.0
31851,참고서/Noun,1,0,1,0.0,1.1106915165381966e-05,1.0
31852,창조자/Noun,1,1,0,1.1115310228308472e-05,0.0,1.0
31853,고름/Noun,1,1,0,1.1115310228308472e-05,0.0,1.0
31854,이한위/Noun,1,0,1,0.0,1.1106915165381966e-05,1.0
31855,뽐/Noun,1,0,1,0.0,1.1106915165381966e-05,1.0
31856,샾/Noun,1,0,1,0.0,1.1106915165381966e-05,1.0
31857,힙힙/Noun,1,0,1,0.0,1.1106915165381966e-05,1.0
31858,힙조/Noun,1,0,1,0.0,1.1106915165381966e-05,1.0
31859,투디/Noun,1,0,1,0.0,1.1106915165381966e-05,1.0
31860,김복남/Noun,1,1,0,1.1115310228308472e-05,0.0,1.0
31861,tm/Alpha,1,1,0,1.1115310228308472e-05,0.0,1.0
31862,문해/Noun,1,1,0,1.1115310228308472e-05,0.0,1.0
31863,줮내/Noun,1,1,0,1.1115310228308472e-05,0.0,1.0
31864,넙쩍이/Noun,1,0,1,0.0,1.1106915165381966e-05,1.0
31865,길쭉하다/Adjective,1,0,1,0.0,1.1106915165381966e-05,1.0
31866,진국곤/Noun,1,0,1,0.0,1.1106915165381966e-05,1.0
31867,신종국/Noun,1,1,0,1.1115310228308472e-05,0.0,1.0
31868,Kunis/Alpha,1,1,0,1.1115310228308472e-05,0.0,1.0
31869,Mila/Alpha,1,1,0,1.1115310228308472e-05,0.0,1.0
31870,부르마/Noun,1,0,1,0.0,1.1106915165381966e-05,1.0
31871,쉐임리스/Noun,1,0,1,0.0,1.1106915165381966e-05,1.0
31872,Mulligan/Alpha,1,0,1,0.0,1.1106915165381966e-05,1.0
31873,Carey/Alpha,1,0,1,0.0,1.1106915165381966e-05,1.0
31874,ds/Alpha,1,1,0,1.1115310228308472e-05,0.0,1.0
31875,쿠다/Noun,1,0,1,0.0,1.1106915165381966e-05,1.0
31876,껏읍니/Noun,1,0,1,0.0,1.1106915165381966e-05,1.0
31877,오로린/Noun,1,0,1,0.0,1.1106915165381966e-05,1.0
31878,삐리/Noun,1,1,0,1.1115310228308472e-05,0.0,1.0
31879,쀠양꼬/Noun,1,1,0,1.1115310228308472e-05,0.0,1.0
31880,끼양꼬/Noun,1,1,0,1.1115310228308472e-05,0.0,1.0
31881,7500/Number,1,1,0,1.1115310228308472e-05,0.0,1.0
31882,처녀귀신/Noun,1,0,1,0.0,1.1106915165381966e-05,1.0
31883,불게/Noun,1,1,0,1.1115310228308472e-05,0.0,1.0
31884,김윤성/Noun,1,1,0,1.1115310228308472e-05,0.0,1.0
31885,hsj1549@naver.com/Email,1,1,0,1.1115310228308472e-05,0.0,1.0
31886,~~~!!^^/Punctuation,1,0,1,0.0,1.1106915165381966e-05,1.0
31887,번전/Noun,1,1,0,1.1115310228308472e-05,0.0,1.0
31888,용두동/Noun,1,1,0,1.1115310228308472e-05,0.0,1.0
31889,눈말/Noun,1,1,0,1.1115310228308472e-05,0.0,1.0
31890,접속사/Noun,1,0,1,0.0,1.1106915165381966e-05,1.0
31891,3000억/Number,1,0,1,0.0,1.1106915165381966e-05,1.0
31892,저스틴팀버레이크/Noun,1,1,0,1.1115310228308472e-05,0.0,1.0
31893,샘김/Noun,1,0,1,0.0,1.1106915165381966e-05,1.0
31894,마란/Noun,1,1,0,1.1115310228308472e-05,0.0,1.0
31895,스짤때기/Noun,1,0,1,0.0,1.1106915165381966e-05,1.0
31896,에휴/Noun,1,0,1,0.0,1.1106915165381966e-05,1.0
31897,티칭/Noun,1,0,1,0.0,1.1106915165381966e-05,1.0
31898,가티/Noun,1,0,1,0.0,1.1106915165381966e-05,1.0
31899,찍으셧나/Noun,1,0,1,0.0,1.1106915165381966e-05,1.0
31900,박히셧/Noun,1,0,1,0.0,1.1106915165381966e-05,1.0
31901,미은/Noun,1,0,1,0.0,1.1106915165381966e-05,1.0
31902,뎃글/Noun,1,1,0,1.1115310228308472e-05,0.0,1.0
31903,중수/Noun,1,0,1,0.0,1.1106915165381966e-05,1.0
31904,670년/Number,1,0,1,0.0,1.1106915165381966e-05,1.0
31905,한드같/Noun,1,0,1,0.0,1.1106915165381966e-05,1.0
31906,녀용/Noun,1,0,1,0.0,1.1106915165381966e-05,1.0
31907,류떡/Noun,1,0,1,0.0,1.1106915165381966e-05,1.0
31908,엄첨됫북/Noun,1,0,1,0.0,1.1106915165381966e-05,1.0
31909,봉함/Noun,1,0,1,0.0,1.1106915165381966e-05,1.0
31910,지하방/Noun,1,0,1,0.0,1.1106915165381966e-05,1.0
31911,차석구/Noun,1,0,1,0.0,1.1106915165381966e-05,1.0
31912,개쩔죠잉/Noun,1,1,0,1.1115310228308472e-05,0.0,1.0
31913,츄리/Noun,1,1,0,1.1115310228308472e-05,0.0,1.0
31914,dsahhdfdhadhfhsa/Alpha,1,0,1,0.0,1.1106915165381966e-05,1.0
31915,혜연이/Noun,1,1,0,1.1115310228308472e-05,0.0,1.0
31916,위페르/Noun,1,1,0,1.1115310228308472e-05,0.0,1.0
31917,로니/Noun,1,0,1,0.0,1.1106915165381966e-05,1.0
31918,일천/Noun,1,0,1,0.0,1.1106915165381966e-05,1.0
31919,4~50/Number,1,0,1,0.0,1.1106915165381966e-05,1.0
31920,명머/Noun,1,0,1,0.0,1.1106915165381966e-05,1.0
31921,****>/Punctuation,1,1,0,1.1115310228308472e-05,0.0,1.0
31922,!!!)</Punctuation,1,1,0,1.1115310228308472e-05,0.0,1.0
31923,민악/Noun,1,0,1,0.0,1.1106915165381966e-05,1.0
31924,pokect/Alpha,1,1,0,1.1115310228308472e-05,0.0,1.0
31925,일벌/Noun,1,0,1,0.0,1.1106915165381966e-05,1.0
31926,비읍시옷/Noun,1,1,0,1.1115310228308472e-05,0.0,1.0
31927,강신/Noun,1,0,1,0.0,1.1106915165381966e-05,1.0
31928,신이준/Noun,1,1,0,1.1115310228308472e-05,0.0,1.0
31929,furious/Alpha,1,0,1,0.0,1.1106915165381966e-05,1.0
31930,..^^'/Punctuation,1,1,0,1.1115310228308472e-05,0.0,1.0
31931,Summer/Alpha,1,1,0,1.1115310228308472e-05,0.0,1.0
31932,섹터/Noun,1,0,1,0.0,1.1106915165381966e-05,1.0
31933,전에재밌게본작품/Foreign,1,1,0,1.1115310228308472e-05,0.0,1.0
31934,13000/Number,1,0,1,0.0,1.1106915165381966e-05,1.0
31935,white/Alpha,1,1,0,1.1115310228308472e-05,0.0,1.0
31936,Barry/Alpha,1,1,0,1.1115310228308472e-05,0.0,1.0
31937,투웨/Noun,1,0,1,0.0,1.1106915165381966e-05,1.0
31938,다케시답다/Noun,1,1,0,1.1115310228308472e-05,0.0,1.0
31939,!*_*/Punctuation,1,1,0,1.1115310228308472e-05,0.0,1.0
31940,미디어아트/Noun,1,1,0,1.1115310228308472e-05,0.0,1.0
31941,싱겹/Noun,1,0,1,0.0,1.1106915165381966e-05,1.0
31942,싀바/Noun,1,0,1,0.0,1.1106915165381966e-05,1.0
31943,작인데도/Foreign,1,1,0,1.1115310228308472e-05,0.0,1.0
31944,디온/Noun,1,1,0,1.1115310228308472e-05,0.0,1.0
31945,솝/Noun,1,1,0,1.1115310228308472e-05,0.0,1.0
31946,Pray/Alpha,1,1,0,1.1115310228308472e-05,0.0,1.0
31947,Little/Alpha,1,1,0,1.1115310228308472e-05,0.0,1.0
31948,Franklin/Alpha,1,1,0,1.1115310228308472e-05,0.0,1.0
31949,Aretha/Alpha,1,1,0,1.1115310228308472e-05,0.0,1.0
31950,아서왕/Noun,1,0,1,0.0,1.1106915165381966e-05,1.0
31951,20억엔/Number,1,0,1,0.0,1.1106915165381966e-05,1.0
31952,군의관/Noun,1,1,0,1.1115310228308472e-05,0.0,1.0
31953,PKF/Alpha,1,1,0,1.1115310228308472e-05,0.0,1.0
31954,공블링/Noun,1,1,0,1.1115310228308472e-05,0.0,1.0
31955,블링/Noun,1,1,0,1.1115310228308472e-05,0.0,1.0
31956,후남/Noun,1,1,0,1.1115310228308472e-05,0.0,1.0
31957,삐료/Noun,1,0,1,0.0,1.1106915165381966e-05,1.0
31958,어둔운/Noun,1,0,1,0.0,1.1106915165381966e-05,1.0
31959,드는/Foreign,1,0,1,0.0,1.1106915165381966e-05,1.0
31960,생입니다/Foreign,1,1,0,1.1115310228308472e-05,0.0,1.0
31961,수백향공주/Noun,1,1,0,1.1115310228308472e-05,0.0,1.0
31962,쫏기/Noun,1,0,1,0.0,1.1106915165381966e-05,1.0
31963,약인/Noun,1,1,0,1.1115310228308472e-05,0.0,1.0
31964,체격/Noun,1,1,0,1.1115310228308472e-05,0.0,1.0
31965,귀엽긔/Noun,1,1,0,1.1115310228308472e-05,0.0,1.0
31966,Diggity/Alpha,1,1,0,1.1115310228308472e-05,0.0,1.0
31967,천막/Noun,1,1,0,1.1115310228308472e-05,0.0,1.0
31968,1983년/Number,1,1,0,1.1115310228308472e-05,0.0,1.0
31969,터트렸구/Noun,1,0,1,0.0,1.1106915165381966e-05,1.0
31970,430/Number,1,1,0,1.1115310228308472e-05,0.0,1.0
31971,roki79@nate.com/Email,1,1,0,1.1115310228308472e-05,0.0,1.0
31972,이른바/Adverb,1,1,0,1.1115310228308472e-05,0.0,1.0
31973,PIXAR/Alpha,1,0,1,0.0,1.1106915165381966e-05,1.0
31974,훨싸/Noun,1,0,1,0.0,1.1106915165381966e-05,1.0
31975,어웨이크/Noun,1,0,1,0.0,1.1106915165381966e-05,1.0
31976,~~~!!!!!!!!!!!!/Punctuation,1,1,0,1.1115310228308472e-05,0.0,1.0
31977,저렇겐/Noun,1,0,1,0.0,1.1106915165381966e-05,1.0
31978,간친/Noun,1,0,1,0.0,1.1106915165381966e-05,1.0
31979,왜앞/Noun,1,0,1,0.0,1.1106915165381966e-05,1.0
31980,";/'/.,./Punctuation",1,1,0,1.1115310228308472e-05,0.0,1.0
31981,............................................................................/Punctuation,1,0,1,0.0,1.1106915165381966e-05,1.0
31982,웈/Noun,1,0,1,0.0,1.1106915165381966e-05,1.0
31983,뚫훓뚫훓/Noun,1,0,1,0.0,1.1106915165381966e-05,1.0
31984,아샤/Noun,1,1,0,1.1115310228308472e-05,0.0,1.0
31985,삼순/Noun,1,1,0,1.1115310228308472e-05,0.0,1.0
31986,skfm/Alpha,1,1,0,1.1115310228308472e-05,0.0,1.0
31987,똥창/Noun,1,1,0,1.1115310228308472e-05,0.0,1.0
31988,발시/Noun,1,0,1,0.0,1.1106915165381966e-05,1.0
31989,쫄았던/Noun,1,1,0,1.1115310228308472e-05,0.0,1.0
31990,특정시/Noun,1,0,1,0.0,1.1106915165381966e-05,1.0
31991,콕스였군/Noun,1,1,0,1.1115310228308472e-05,0.0,1.0
31992,잡지사/Noun,1,0,1,0.0,1.1106915165381966e-05,1.0
31993,여원/Noun,1,0,1,0.0,1.1106915165381966e-05,1.0
31994,해녀/Noun,1,1,0,1.1115310228308472e-05,0.0,1.0
31995,모더니즘/Noun,1,1,0,1.1115310228308472e-05,0.0,1.0
31996,눈코입/Noun,1,0,1,0.0,1.1106915165381966e-05,1.0
31997,꼬심/Noun,1,0,1,0.0,1.1106915165381966e-05,1.0
31998,질렌/Noun,1,0,1,0.0,1.1106915165381966e-05,1.0
31999,짛/Noun,1,1,0,1.1115310228308472e-05,0.0,1.0
32000,헏/Noun,1,1,0,1.1115310228308472e-05,0.0,1.0
32001,츄럴/Noun,1,0,1,0.0,1.1106915165381966e-05,1.0
32002,땔치/Noun,1,0,1,0.0,1.1106915165381966e-05,1.0
32003,픽픽나/Noun,1,0,1,0.0,1.1106915165381966e-05,1.0
32004,9999억/Number,1,0,1,0.0,1.1106915165381966e-05,1.0
32005,콧구녕큰/Noun,1,0,1,0.0,1.1106915165381966e-05,1.0
32006,김종/Noun,1,0,1,0.0,1.1106915165381966e-05,1.0
32007,앟앟/Noun,1,0,1,0.0,1.1106915165381966e-05,1.0
32008,정로/Noun,1,0,1,0.0,1.1106915165381966e-05,1.0
32009,1.11/Number,1,1,0,1.1115310228308472e-05,0.0,1.0
32010,효도르/Noun,1,0,1,0.0,1.1106915165381966e-05,1.0
32011,씨루/Noun,1,0,1,0.0,1.1106915165381966e-05,1.0
32012,34%/Number,1,0,1,0.0,1.1106915165381966e-05,1.0
32013,Voter/Alpha,1,0,1,0.0,1.1106915165381966e-05,1.0
32014,관객이란/Foreign,1,0,1,0.0,1.1106915165381966e-05,1.0
32015,벌었다/Foreign,1,0,1,0.0,1.1106915165381966e-05,1.0
32016,차무혁/Noun,1,1,0,1.1115310228308472e-05,0.0,1.0
32017,호파/Noun,1,1,0,1.1115310228308472e-05,0.0,1.0
32018,Van/Alpha,1,1,0,1.1115310228308472e-05,0.0,1.0
32019,에프엑스/Noun,1,0,1,0.0,1.1106915165381966e-05,1.0
32020,까무러치기/Noun,1,0,1,0.0,1.1106915165381966e-05,1.0
32021,님편/Noun,1,1,0,1.1115310228308472e-05,0.0,1.0
32022,김현식/Noun,1,1,0,1.1115310228308472e-05,0.0,1.0
32023,쥬김/Noun,1,0,1,0.0,1.1106915165381966e-05,1.0
32024,끝쪽/Noun,1,1,0,1.1115310228308472e-05,0.0,1.0
32025,합시다/Foreign,1,1,0,1.1115310228308472e-05,0.0,1.0
32026,악플다다/Verb,1,1,0,1.1115310228308472e-05,0.0,1.0
32027,권소현/Noun,1,0,1,0.0,1.1106915165381966e-05,1.0
32028,포미닛/Noun,1,0,1,0.0,1.1106915165381966e-05,1.0
32029,쓰레길세/Noun,1,0,1,0.0,1.1106915165381966e-05,1.0
32030,늣데/Noun,1,0,1,0.0,1.1106915165381966e-05,1.0
32031,호돌이/Noun,1,1,0,1.1115310228308472e-05,0.0,1.0
32032,나온느/Noun,1,0,1,0.0,1.1106915165381966e-05,1.0
32033,덜봣엉/Noun,1,1,0,1.1115310228308472e-05,0.0,1.0
32034,탁역/Noun,1,0,1,0.0,1.1106915165381966e-05,1.0
32035,맹상훈/Noun,1,0,1,0.0,1.1106915165381966e-05,1.0
32036,고대소설/Noun,1,0,1,0.0,1.1106915165381966e-05,1.0
32037,토속/Noun,1,0,1,0.0,1.1106915165381966e-05,1.0
32038,스매져/Noun,1,1,0,1.1115310228308472e-05,0.0,1.0
32039,덧칠/Noun,1,0,1,0.0,1.1106915165381966e-05,1.0
32040,옛애인/Noun,1,0,1,0.0,1.1106915165381966e-05,1.0
32041,커머스/Noun,1,1,0,1.1115310228308472e-05,0.0,1.0
32042,쇼셜/Noun,1,1,0,1.1115310228308472e-05,0.0,1.0
32043,진혁/Noun,1,1,0,1.1115310228308472e-05,0.0,1.0
32044,분연/Noun,1,1,0,1.1115310228308472e-05,0.0,1.0
32045,/./././././././/Punctuation,1,0,1,0.0,1.1106915165381966e-05,1.0
32046,즐겻움/Noun,1,1,0,1.1115310228308472e-05,0.0,1.0
32047,해놧내/Noun,1,0,1,0.0,1.1106915165381966e-05,1.0
32048,박주신/Noun,1,1,0,1.1115310228308472e-05,0.0,1.0
32049,뉴딜/Noun,1,0,1,0.0,1.1106915165381966e-05,1.0
32050,한기/Noun,1,0,1,0.0,1.1106915165381966e-05,1.0
32051,워해머/Noun,1,1,0,1.1115310228308472e-05,0.0,1.0
32052,백병/Noun,1,1,0,1.1115310228308472e-05,0.0,1.0
32053,거알/Noun,1,1,0,1.1115310228308472e-05,0.0,1.0
32054,멀뚱하다/Adjective,1,0,1,0.0,1.1106915165381966e-05,1.0
32055,핀트/Noun,1,1,0,1.1115310228308472e-05,0.0,1.0
32056,고수빈/Noun,1,1,0,1.1115310228308472e-05,0.0,1.0
32057,☻/Foreign,1,1,0,1.1115310228308472e-05,0.0,1.0
32058,뽀네뜨/Noun,1,1,0,1.1115310228308472e-05,0.0,1.0
32059,모꼬/Noun,1,0,1,0.0,1.1106915165381966e-05,1.0
32060,버스광고/Noun,1,0,1,0.0,1.1106915165381966e-05,1.0
32061,힐끆/Noun,1,1,0,1.1115310228308472e-05,0.0,1.0
32062,",^^/Punctuation",1,1,0,1.1115310228308472e-05,0.0,1.0
32063,뒷산/Noun,1,0,1,0.0,1.1106915165381966e-05,1.0
32064,뭔갈/Noun,1,1,0,1.1115310228308472e-05,0.0,1.0
32065,서든어택/Noun,1,0,1,0.0,1.1106915165381966e-05,1.0
32066,질령/Noun,1,0,1,0.0,1.1106915165381966e-05,1.0
32067,kl/Alpha,1,1,0,1.1115310228308472e-05,0.0,1.0
32068,홀복/Noun,1,0,1,0.0,1.1106915165381966e-05,1.0
32069,콩당콩당/Adverb,1,1,0,1.1115310228308472e-05,0.0,1.0
32070,염보라/Noun,1,1,0,1.1115310228308472e-05,0.0,1.0
32071,바다거북/Noun,1,0,1,0.0,1.1106915165381966e-05,1.0
32072,넥타이/Noun,1,1,0,1.1115310228308472e-05,0.0,1.0
32073,재밌읏다/Noun,1,1,0,1.1115310228308472e-05,0.0,1.0
32074,/(/^/Punctuation,1,1,0,1.1115310228308472e-05,0.0,1.0
32075,고래사냥/Noun,1,0,1,0.0,1.1106915165381966e-05,1.0
32076,Vdo/Alpha,1,1,0,1.1115310228308472e-05,0.0,1.0
32077,모면/Noun,1,0,1,0.0,1.1106915165381966e-05,1.0
32078,스태섬/Noun,1,1,0,1.1115310228308472e-05,0.0,1.0
32079,때나온영화치곤잘만들었네/Foreign,1,1,0,1.1115310228308472e-05,0.0,1.0
32080,스짓/Noun,1,0,1,0.0,1.1106915165381966e-05,1.0
32081,닾/Noun,1,1,0,1.1115310228308472e-05,0.0,1.0
32082,나왓는데/Noun,1,1,0,1.1115310228308472e-05,0.0,1.0
32083,밤샘/Noun,1,1,0,1.1115310228308472e-05,0.0,1.0
32084,물놀이/Noun,1,0,1,0.0,1.1106915165381966e-05,1.0
32085,Shame/Alpha,1,0,1,0.0,1.1106915165381966e-05,1.0
32086,ㅋㅌㅊ/KoreanParticle,1,0,1,0.0,1.1106915165381966e-05,1.0
32087,군내/Noun,1,0,1,0.0,1.1106915165381966e-05,1.0
32088,영생/Noun,1,1,0,1.1115310228308472e-05,0.0,1.0
32089,생활환경/Noun,1,0,1,0.0,1.1106915165381966e-05,1.0
32090,의장/Noun,1,0,1,0.0,1.1106915165381966e-05,1.0
32091,키스트/Noun,1,0,1,0.0,1.1106915165381966e-05,1.0
32092,프레이져/Noun,1,1,0,1.1115310228308472e-05,0.0,1.0
32093,본일/Noun,1,0,1,0.0,1.1106915165381966e-05,1.0
32094,미하/Noun,1,0,1,0.0,1.1106915165381966e-05,1.0
32095,얺될/Noun,1,0,1,0.0,1.1106915165381966e-05,1.0
32096,뻬곤/Noun,1,0,1,0.0,1.1106915165381966e-05,1.0
32097,꼬방동/Noun,1,1,0,1.1115310228308472e-05,0.0,1.0
32098,http://www.youtube.com/watch?v=bqo7KL2DrMY&wide=1&has_verified=1/URL,1,1,0,1.1115310228308472e-05,0.0,1.0
32099,asdfdavbadlkjlkj/Alpha,1,0,1,0.0,1.1106915165381966e-05,1.0
32100,푸른밤/Noun,1,0,1,0.0,1.1106915165381966e-05,1.0
32101,올로/Noun,1,0,1,0.0,1.1106915165381966e-05,1.0
32102,중남미/Noun,1,1,0,1.1115310228308472e-05,0.0,1.0
32103,영약/Noun,1,1,0,1.1115310228308472e-05,0.0,1.0
32104,송사/Noun,1,1,0,1.1115310228308472e-05,0.0,1.0
32105,싸울떄/Noun,1,1,0,1.1115310228308472e-05,0.0,1.0
32106,수련할떄/Noun,1,1,0,1.1115310228308472e-05,0.0,1.0
32107,구창식/Noun,1,1,0,1.1115310228308472e-05,0.0,1.0
32108,1만달러/Number,1,1,0,1.1115310228308472e-05,0.0,1.0
32109,왜남/Noun,1,1,0,1.1115310228308472e-05,0.0,1.0
32110,이오만/Noun,1,0,1,0.0,1.1106915165381966e-05,1.0
32111,~~~~~~~~~~~~~~~/Punctuation,1,1,0,1.1115310228308472e-05,0.0,1.0
32112,짜셰/Noun,1,1,0,1.1115310228308472e-05,0.0,1.0
32113,답따압/Noun,1,0,1,0.0,1.1106915165381966e-05,1.0
32114,enthsiasm/Alpha,1,1,0,1.1115310228308472e-05,0.0,1.0
32115,courage/Alpha,1,1,0,1.1115310228308472e-05,0.0,1.0
32116,faith/Alpha,1,1,0,1.1115310228308472e-05,0.0,1.0
32117,cuz/Alpha,1,1,0,1.1115310228308472e-05,0.0,1.0
32118,뭘봣다/Noun,1,0,1,0.0,1.1106915165381966e-05,1.0
32119,크림/Noun,1,0,1,0.0,1.1106915165381966e-05,1.0
32120,또봗느/Noun,1,1,0,1.1115310228308472e-05,0.0,1.0
32121,레조/Noun,1,0,1,0.0,1.1106915165381966e-05,1.0
32122,로우스/Noun,1,0,1,0.0,1.1106915165381966e-05,1.0
32123,2286/Number,1,1,0,1.1115310228308472e-05,0.0,1.0
32124,토기/Noun,1,1,0,1.1115310228308472e-05,0.0,1.0
32125,산야/Noun,1,1,0,1.1115310228308472e-05,0.0,1.0
32126,시냇가/Noun,1,1,0,1.1115310228308472e-05,0.0,1.0
32127,후에라도/Foreign,1,1,0,1.1115310228308472e-05,0.0,1.0
32128,동엽/Noun,1,1,0,1.1115310228308472e-05,0.0,1.0
32129,진로/Noun,1,0,1,0.0,1.1106915165381966e-05,1.0
32130,공항씬/Noun,1,1,0,1.1115310228308472e-05,0.0,1.0
32131,꼽습/Noun,1,1,0,1.1115310228308472e-05,0.0,1.0
32132,인생중에/Foreign,1,1,0,1.1115310228308472e-05,0.0,1.0
32133,쭈쭈인디/Noun,1,1,0,1.1115310228308472e-05,0.0,1.0
32134,구유/Noun,1,1,0,1.1115310228308472e-05,0.0,1.0
32135,4-5분/Number,1,1,0,1.1115310228308472e-05,0.0,1.0
32136,주정하/Noun,1,0,1,0.0,1.1106915165381966e-05,1.0
32137,엮이더/Noun,1,1,0,1.1115310228308472e-05,0.0,1.0
32138,이었습니다/Foreign,1,1,0,1.1115310228308472e-05,0.0,1.0
32139,절영/Noun,1,1,0,1.1115310228308472e-05,0.0,1.0
32140,가시나무/Noun,1,0,1,0.0,1.1106915165381966e-05,1.0
32141,했더랬/Noun,1,0,1,0.0,1.1106915165381966e-05,1.0
32142,이상향/Noun,1,1,0,1.1115310228308472e-05,0.0,1.0
32143,567/Number,1,0,1,0.0,1.1106915165381966e-05,1.0
32144,마우스피스/Noun,1,0,1,0.0,1.1106915165381966e-05,1.0
32145,다/Foreign,1,1,0,1.1115310228308472e-05,0.0,1.0
32146,신드/Noun,1,0,1,0.0,1.1106915165381966e-05,1.0
32147,스톡홀롬/Noun,1,0,1,0.0,1.1106915165381966e-05,1.0
32148,핑돌/Noun,1,1,0,1.1115310228308472e-05,0.0,1.0
32149,여우로/Noun,1,1,0,1.1115310228308472e-05,0.0,1.0
32150,기다림/Foreign,1,1,0,1.1115310228308472e-05,0.0,1.0
32151,로빈스/Noun,1,1,0,1.1115310228308472e-05,0.0,1.0
32152,불명예/Noun,1,0,1,0.0,1.1106915165381966e-05,1.0
32153,뤼카/Noun,1,1,0,1.1115310228308472e-05,0.0,1.0
32154,아메/Noun,1,1,0,1.1115310228308472e-05,0.0,1.0
32155,131/Number,1,0,1,0.0,1.1106915165381966e-05,1.0
32156,大作/Foreign,1,1,0,1.1115310228308472e-05,0.0,1.0
32157,념겨보기/Noun,1,0,1,0.0,1.1106915165381966e-05,1.0
32158,티머/Noun,1,1,0,1.1115310228308472e-05,0.0,1.0
32159,다이크/Noun,1,0,1,0.0,1.1106915165381966e-05,1.0
32160,쉐인/Noun,1,0,1,0.0,1.1106915165381966e-05,1.0
32161,어쩜들/Noun,1,0,1,0.0,1.1106915165381966e-05,1.0
32162,널판/Noun,1,1,0,1.1115310228308472e-05,0.0,1.0
32163,마리앙투아네트/Noun,1,0,1,0.0,1.1106915165381966e-05,1.0
32164,님들봄/Noun,1,1,0,1.1115310228308472e-05,0.0,1.0
32165,ㄲㅔ/KoreanParticle,1,1,0,1.1115310228308472e-05,0.0,1.0
32166,잼께봣/Noun,1,1,0,1.1115310228308472e-05,0.0,1.0
32167,스니치/Noun,1,1,0,1.1115310228308472e-05,0.0,1.0
32168,리부팅/Noun,1,0,1,0.0,1.1106915165381966e-05,1.0
32169,友田彩也香/Foreign,1,0,1,0.0,1.1106915165381966e-05,1.0
32170,Tomoda/Alpha,1,0,1,0.0,1.1106915165381966e-05,1.0
32171,Ayaka/Alpha,1,0,1,0.0,1.1106915165381966e-05,1.0
32172,시율/Noun,1,1,0,1.1115310228308472e-05,0.0,1.0
32173,덕임/Noun,1,0,1,0.0,1.1106915165381966e-05,1.0
32174,삼점준/Noun,1,0,1,0.0,1.1106915165381966e-05,1.0
32175,하뎡우/Noun,1,0,1,0.0,1.1106915165381966e-05,1.0
32176,퍼렐/Noun,1,1,0,1.1115310228308472e-05,0.0,1.0
32177,머싯쪄/Noun,1,1,0,1.1115310228308472e-05,0.0,1.0
32178,ㅛㅕㅇㄴ/KoreanParticle,1,0,1,0.0,1.1106915165381966e-05,1.0
32179,퍄/Noun,1,0,1,0.0,1.1106915165381966e-05,1.0
32180,오런뫃/Noun,1,0,1,0.0,1.1106915165381966e-05,1.0
32181,분꼭/Noun,1,1,0,1.1115310228308472e-05,0.0,1.0
32182,아육대/Noun,1,0,1,0.0,1.1106915165381966e-05,1.0
32183,Nadasaka/Alpha,1,0,1,0.0,1.1106915165381966e-05,1.0
32184,Mai/Alpha,1,0,1,0.0,1.1106915165381966e-05,1.0
32185,개뻥/Noun,1,0,1,0.0,1.1106915165381966e-05,1.0
32186,센송/Noun,1,1,0,1.1115310228308472e-05,0.0,1.0
32187,토템/Noun,1,0,1,0.0,1.1106915165381966e-05,1.0
32188,무형문화재/Noun,1,1,0,1.1115310228308472e-05,0.0,1.0
32189,자형/Noun,1,0,1,0.0,1.1106915165381966e-05,1.0
32190,버추/Noun,1,1,0,1.1115310228308472e-05,0.0,1.0
32191,갵/Noun,1,0,1,0.0,1.1106915165381966e-05,1.0
32192,dark/Alpha,1,1,0,1.1115310228308472e-05,0.0,1.0
32193,near/Alpha,1,1,0,1.1115310228308472e-05,0.0,1.0
32194,뻔하딘/Noun,1,0,1,0.0,1.1106915165381966e-05,1.0
32195,데니스강/Noun,1,1,0,1.1115310228308472e-05,0.0,1.0
32196,",///Punctuation",1,1,0,1.1115310228308472e-05,0.0,1.0
32197,마츠/Noun,1,0,1,0.0,1.1106915165381966e-05,1.0
32198,쥴리델피/Noun,1,0,1,0.0,1.1106915165381966e-05,1.0
32199,장폴골티/Noun,1,1,0,1.1115310228308472e-05,0.0,1.0
32200,원함/Noun,1,1,0,1.1115310228308472e-05,0.0,1.0
32201,엄쪄/Noun,1,0,1,0.0,1.1106915165381966e-05,1.0
32202,명규/Noun,1,0,1,0.0,1.1106915165381966e-05,1.0
32203,고지은/Noun,1,0,1,0.0,1.1106915165381966e-05,1.0
32204,92/Number,1,0,1,0.0,1.1106915165381966e-05,1.0
32205,태무/Noun,1,0,1,0.0,1.1106915165381966e-05,1.0
32206,거머/Noun,1,0,1,0.0,1.1106915165381966e-05,1.0
32207,..?!!/Punctuation,1,0,1,0.0,1.1106915165381966e-05,1.0
32208,더좋아욤/Noun,1,1,0,1.1115310228308472e-05,0.0,1.0
32209,홍대클럽/Noun,1,0,1,0.0,1.1106915165381966e-05,1.0
32210,90-00년/Number,1,1,0,1.1115310228308472e-05,0.0,1.0
32211,둦/Noun,1,0,1,0.0,1.1106915165381966e-05,1.0
32212,샨준/Noun,1,0,1,0.0,1.1106915165381966e-05,1.0
32213,랗/Noun,1,1,0,1.1115310228308472e-05,0.0,1.0
32214,불곰/Noun,1,0,1,0.0,1.1106915165381966e-05,1.0
32215,축구공/Noun,1,0,1,0.0,1.1106915165381966e-05,1.0
32216,지겟넼/Noun,1,0,1,0.0,1.1106915165381966e-05,1.0
32217,허그/Noun,1,0,1,0.0,1.1106915165381966e-05,1.0
32218,공부의신/Noun,1,1,0,1.1115310228308472e-05,0.0,1.0
32219,하수오/Noun,1,0,1,0.0,1.1106915165381966e-05,1.0
32220,fault/Alpha,1,1,0,1.1115310228308472e-05,0.0,1.0
32221,??^.~/Punctuation,1,1,0,1.1115310228308472e-05,0.0,1.0
32222,다웠을듯/Noun,1,0,1,0.0,1.1106915165381966e-05,1.0
32223,뎐/Noun,1,1,0,1.1115310228308472e-05,0.0,1.0
32224,itf/Alpha,1,1,0,1.1115310228308472e-05,0.0,1.0
32225,봤었드랬/Noun,1,1,0,1.1115310228308472e-05,0.0,1.0
32226,생텀/Noun,1,1,0,1.1115310228308472e-05,0.0,1.0
32227,급삘/Noun,1,0,1,0.0,1.1106915165381966e-05,1.0
32228,아맬릭/Noun,1,1,0,1.1115310228308472e-05,0.0,1.0
32229,쉣더뻑/Noun,1,0,1,0.0,1.1106915165381966e-05,1.0
32230,daum/Alpha,1,1,0,1.1115310228308472e-05,0.0,1.0
32231,★☆☆☆☆/Foreign,1,0,1,0.0,1.1106915165381966e-05,1.0
32232,개월전/Noun,1,1,0,1.1115310228308472e-05,0.0,1.0
32233,레바/Noun,1,1,0,1.1115310228308472e-05,0.0,1.0
32234,유리카/Noun,1,1,0,1.1115310228308472e-05,0.0,1.0
32235,세레나/Noun,1,1,0,1.1115310228308472e-05,0.0,1.0
32236,우후/Noun,1,1,0,1.1115310228308472e-05,0.0,1.0
32237,은한/Noun,1,0,1,0.0,1.1106915165381966e-05,1.0
32238,우루스/Noun,1,0,1,0.0,1.1106915165381966e-05,1.0
32239,핵극혐/Noun,1,0,1,0.0,1.1106915165381966e-05,1.0
32240,한비/Noun,1,0,1,0.0,1.1106915165381966e-05,1.0
32241,충천/Noun,1,0,1,0.0,1.1106915165381966e-05,1.0
32242,"!!>,.//Punctuation",1,1,0,1.1115310228308472e-05,0.0,1.0
32243,댰/Noun,1,1,0,1.1115310228308472e-05,0.0,1.0
32244,^^)/Punctuation,1,1,0,1.1115310228308472e-05,0.0,1.0
32245,인도음악/Noun,1,1,0,1.1115310228308472e-05,0.0,1.0
32246,사궜으/Noun,1,0,1,0.0,1.1106915165381966e-05,1.0
32247,떄갈좋/Noun,1,0,1,0.0,1.1106915165381966e-05,1.0
32248,들엇구/Noun,1,0,1,0.0,1.1106915165381966e-05,1.0
32249,두둔/Noun,1,0,1,0.0,1.1106915165381966e-05,1.0
32250,겹친게/Noun,1,0,1,0.0,1.1106915165381966e-05,1.0
32251,핀년/Noun,1,0,1,0.0,1.1106915165381966e-05,1.0
32252,FT/Alpha,1,1,0,1.1115310228308472e-05,0.0,1.0
32253,야누스/Noun,1,1,0,1.1115310228308472e-05,0.0,1.0
32254,쥐략펴락하/Noun,1,1,0,1.1115310228308472e-05,0.0,1.0
32255,와킨/Noun,1,1,0,1.1115310228308472e-05,0.0,1.0
32256,캠밸/Noun,1,1,0,1.1115310228308472e-05,0.0,1.0
32257,디활티팅/Noun,1,1,0,1.1115310228308472e-05,0.0,1.0
32258,리라는/Eomi,1,1,0,1.1115310228308472e-05,0.0,1.0
32259,의뭉스럽다/Adjective,1,0,1,0.0,1.1106915165381966e-05,1.0
32260,켜줌/Noun,1,1,0,1.1115310228308472e-05,0.0,1.0
32261,프러/Noun,1,1,0,1.1115310228308472e-05,0.0,1.0
32262,유뷰유뷰/Noun,1,1,0,1.1115310228308472e-05,0.0,1.0
32263,같은뇬/Noun,1,0,1,0.0,1.1106915165381966e-05,1.0
32264,데기/Noun,1,0,1,0.0,1.1106915165381966e-05,1.0
32265,칙었/Noun,1,1,0,1.1115310228308472e-05,0.0,1.0
32266,동방명주/Noun,1,1,0,1.1115310228308472e-05,0.0,1.0
32267,헛봤다/Noun,1,1,0,1.1115310228308472e-05,0.0,1.0
32268,惡手/Foreign,1,0,1,0.0,1.1106915165381966e-05,1.0
32269,결례/Noun,1,0,1,0.0,1.1106915165381966e-05,1.0
32270,울먹거리다/Verb,1,1,0,1.1115310228308472e-05,0.0,1.0
32271,200년/Number,1,1,0,1.1115310228308472e-05,0.0,1.0
32272,까지라도/Josa,1,1,0,1.1115310228308472e-05,0.0,1.0
32273,샷따/Noun,1,0,1,0.0,1.1106915165381966e-05,1.0
32274,06/2/Number,1,1,0,1.1115310228308472e-05,0.0,1.0
32275,alsdkfhl/Alpha,1,0,1,0.0,1.1106915165381966e-05,1.0
32276,분수령/Noun,1,1,0,1.1115310228308472e-05,0.0,1.0
32277,wicked/Alpha,1,1,0,1.1115310228308472e-05,0.0,1.0
32278,Lo/Alpha,1,0,1,0.0,1.1106915165381966e-05,1.0
32279,퍼억/Noun,1,1,0,1.1115310228308472e-05,0.0,1.0
32280,몬테네그로/Noun,1,1,0,1.1115310228308472e-05,0.0,1.0
32281,이취/Noun,1,0,1,0.0,1.1106915165381966e-05,1.0
32282,캡틴하록/Noun,1,0,1,0.0,1.1106915165381966e-05,1.0
32283,우주해적/Noun,1,0,1,0.0,1.1106915165381966e-05,1.0
32284,충격젹/Noun,1,1,0,1.1115310228308472e-05,0.0,1.0
32285,면/Foreign,1,0,1,0.0,1.1106915165381966e-05,1.0
32286,사계/Noun,1,1,0,1.1115310228308472e-05,0.0,1.0
32287,간바레/Noun,1,1,0,1.1115310228308472e-05,0.0,1.0
32288,뿜엇다/Noun,1,0,1,0.0,1.1106915165381966e-05,1.0
32289,편점왜/Noun,1,0,1,0.0,1.1106915165381966e-05,1.0
32290,바리새인/Noun,1,0,1,0.0,1.1106915165381966e-05,1.0
32291,바습니/Noun,1,0,1,0.0,1.1106915165381966e-05,1.0
32292,로뎅/Noun,1,1,0,1.1115310228308472e-05,0.0,1.0
32293,계명/Noun,1,1,0,1.1115310228308472e-05,0.0,1.0
32294,가물치/Noun,1,1,0,1.1115310228308472e-05,0.0,1.0
32295,김애경/Noun,1,1,0,1.1115310228308472e-05,0.0,1.0
32296,김무생/Noun,1,1,0,1.1115310228308472e-05,0.0,1.0
32297,와일드캣/Noun,1,1,0,1.1115310228308472e-05,0.0,1.0
32298,왓팀/Noun,1,1,0,1.1115310228308472e-05,0.0,1.0
32299,도쯤/Foreign,1,1,0,1.1115310228308472e-05,0.0,1.0
32300,메아리/Noun,1,1,0,1.1115310228308472e-05,0.0,1.0
32301,러브홀릭/Noun,1,1,0,1.1115310228308472e-05,0.0,1.0
32302,3719/Number,1,1,0,1.1115310228308472e-05,0.0,1.0
32303,돈텔파파/Noun,1,1,0,1.1115310228308472e-05,0.0,1.0
32304,분방하다/Adjective,1,0,1,0.0,1.1106915165381966e-05,1.0
32305,신고식/Noun,1,1,0,1.1115310228308472e-05,0.0,1.0
32306,밤벌레/Noun,1,1,0,1.1115310228308472e-05,0.0,1.0
32307,글라스/Noun,1,1,0,1.1115310228308472e-05,0.0,1.0
32308,비속/Noun,1,1,0,1.1115310228308472e-05,0.0,1.0
32309,청진기/Noun,1,1,0,1.1115310228308472e-05,0.0,1.0
32310,옴믐음흠음/Noun,1,0,1,0.0,1.1106915165381966e-05,1.0
32311,만에다봤어요다시빠져들었네요보는내내웃다가/Foreign,1,1,0,1.1115310228308472e-05,0.0,1.0
32312,만에다시봤는데/Foreign,1,1,0,1.1115310228308472e-05,0.0,1.0
32313,싶은뎈/Noun,1,1,0,1.1115310228308472e-05,0.0,1.0
32314,버나드박/Noun,1,1,0,1.1115310228308472e-05,0.0,1.0
32315,해봣자/Noun,1,0,1,0.0,1.1106915165381966e-05,1.0
32316,대적반/Noun,1,1,0,1.1115310228308472e-05,0.0,1.0
32317,짓음/Noun,1,1,0,1.1115310228308472e-05,0.0,1.0
32318,아프리카인/Noun,1,1,0,1.1115310228308472e-05,0.0,1.0
32319,공의롭/Noun,1,1,0,1.1115310228308472e-05,0.0,1.0
32320,레트로/Noun,1,0,1,0.0,1.1106915165381966e-05,1.0
32321,잼임스므니/Noun,1,1,0,1.1115310228308472e-05,0.0,1.0
32322,탈걸/Noun,1,0,1,0.0,1.1106915165381966e-05,1.0
32323,에이프런/Noun,1,0,1,0.0,1.1106915165381966e-05,1.0
32324,막컷/Noun,1,0,1,0.0,1.1106915165381966e-05,1.0
32325,01:23/Number,1,0,1,0.0,1.1106915165381966e-05,1.0
32326,figure/Alpha,1,1,0,1.1115310228308472e-05,0.0,1.0
32327,caring/Alpha,1,1,0,1.1115310228308472e-05,0.0,1.0
32328,becomes/Alpha,1,1,0,1.1115310228308472e-05,0.0,1.0
32329,aged/Alpha,1,1,0,1.1115310228308472e-05,0.0,1.0
32330,Wasted/Alpha,1,1,0,1.1115310228308472e-05,0.0,1.0
32331,양종철/Noun,1,0,1,0.0,1.1106915165381966e-05,1.0
32332,질쇼/Noun,1,0,1,0.0,1.1106915165381966e-05,1.0
32333,우글우글/Adverb,1,0,1,0.0,1.1106915165381966e-05,1.0
32334,압수/Noun,1,0,1,0.0,1.1106915165381966e-05,1.0
32335,황광희/Noun,1,0,1,0.0,1.1106915165381966e-05,1.0
32336,하앜하앜임/Noun,1,1,0,1.1115310228308472e-05,0.0,1.0
32337,니힐리스트/Noun,1,0,1,0.0,1.1106915165381966e-05,1.0
32338,윈작/Noun,1,0,1,0.0,1.1106915165381966e-05,1.0
32339,갓세븐/Noun,1,1,0,1.1115310228308472e-05,0.0,1.0
32340,팬됐넹/Noun,1,1,0,1.1115310228308472e-05,0.0,1.0
32341,대준이/Noun,1,1,0,1.1115310228308472e-05,0.0,1.0
32342,형돈이/Noun,1,1,0,1.1115310228308472e-05,0.0,1.0
32343,미츄/Noun,1,0,1,0.0,1.1106915165381966e-05,1.0
32344,으으응/Adverb,1,1,0,1.1115310228308472e-05,0.0,1.0
32345,빠졋다/Noun,1,1,0,1.1115310228308472e-05,0.0,1.0
32346,웃겻대/Noun,1,0,1,0.0,1.1106915165381966e-05,1.0
32347,평안도/Noun,1,1,0,1.1115310228308472e-05,0.0,1.0
32348,장생/Noun,1,1,0,1.1115310228308472e-05,0.0,1.0
32349,버릿다/Noun,1,0,1,0.0,1.1106915165381966e-05,1.0
32350,goal/Alpha,1,0,1,0.0,1.1106915165381966e-05,1.0
32351,gola/Alpha,1,0,1,0.0,1.1106915165381966e-05,1.0
32352,콩콩콬/Noun,1,0,1,0.0,1.1106915165381966e-05,1.0
32353,ㅋㄹㅇ/KoreanParticle,1,0,1,0.0,1.1106915165381966e-05,1.0
32354,칙잡해/Noun,1,1,0,1.1115310228308472e-05,0.0,1.0
32355,!;;;;;/Punctuation,1,0,1,0.0,1.1106915165381966e-05,1.0
32356,Suit/Alpha,1,0,1,0.0,1.1106915165381966e-05,1.0
32357,늘그막/Noun,1,0,1,0.0,1.1106915165381966e-05,1.0
32358,훋/Noun,1,1,0,1.1115310228308472e-05,0.0,1.0
32359,적확하다/Adjective,1,1,0,1.1115310228308472e-05,0.0,1.0
32360,깔아뭉게/Noun,1,0,1,0.0,1.1106915165381966e-05,1.0
32361,트위스트김/Noun,1,1,0,1.1115310228308472e-05,0.0,1.0
32362,카스텔리/Noun,1,1,0,1.1115310228308472e-05,0.0,1.0
32363,하쿠/Noun,1,1,0,1.1115310228308472e-05,0.0,1.0
32364,Remember/Alpha,1,1,0,1.1115310228308472e-05,0.0,1.0
32365,박욱/Noun,1,0,1,0.0,1.1106915165381966e-05,1.0
32366,휴전선/Noun,1,0,1,0.0,1.1106915165381966e-05,1.0
32367,성가대/Noun,1,0,1,0.0,1.1106915165381966e-05,1.0
32368,고귀/Noun,1,0,1,0.0,1.1106915165381966e-05,1.0
32369,쌍피/Noun,1,1,0,1.1115310228308472e-05,0.0,1.0
32370,멕여놓/Noun,1,1,0,1.1115310228308472e-05,0.0,1.0
32371,THIS/Alpha,1,1,0,1.1115310228308472e-05,0.0,1.0
32372,ON/Alpha,1,1,0,1.1115310228308472e-05,0.0,1.0
32373,AND/Alpha,1,1,0,1.1115310228308472e-05,0.0,1.0
32374,LIVE/Alpha,1,1,0,1.1115310228308472e-05,0.0,1.0
32375,호노카아보이/Noun,1,1,0,1.1115310228308472e-05,0.0,1.0
32376,쉿트임/Noun,1,0,1,0.0,1.1106915165381966e-05,1.0
32377,꼭보/Noun,1,1,0,1.1115310228308472e-05,0.0,1.0
32378,엄네/Noun,1,0,1,0.0,1.1106915165381966e-05,1.0
32379,완죤반했엇/Noun,1,1,0,1.1115310228308472e-05,0.0,1.0
32380,일중독/Noun,1,0,1,0.0,1.1106915165381966e-05,1.0
32381,과전/Noun,1,0,1,0.0,1.1106915165381966e-05,1.0
32382,이설/Noun,1,0,1,0.0,1.1106915165381966e-05,1.0
32383,뻣음/Noun,1,1,0,1.1115310228308472e-05,0.0,1.0
32384,짜리다/Foreign,1,0,1,0.0,1.1106915165381966e-05,1.0
32385,미앳/Noun,1,1,0,1.1115310228308472e-05,0.0,1.0
32386,콜옵/Noun,1,1,0,1.1115310228308472e-05,0.0,1.0
32387,반만년/Noun,1,0,1,0.0,1.1106915165381966e-05,1.0
32388,아침공기/Noun,1,1,0,1.1115310228308472e-05,0.0,1.0
32389,Guccione/Alpha,1,0,1,0.0,1.1106915165381966e-05,1.0
32390,??!?/Punctuation,1,0,1,0.0,1.1106915165381966e-05,1.0
32391,~~)/Punctuation,1,0,1,0.0,1.1106915165381966e-05,1.0
32392,독차지/Noun,1,1,0,1.1115310228308472e-05,0.0,1.0
32393,creep/Alpha,1,1,0,1.1115310228308472e-05,0.0,1.0
32394,짚신/Noun,1,1,0,1.1115310228308472e-05,0.0,1.0
32395,64억/Number,1,0,1,0.0,1.1106915165381966e-05,1.0
32396,블라블라/Noun,1,0,1,0.0,1.1106915165381966e-05,1.0
32397,만에봣는데도/Foreign,1,1,0,1.1115310228308472e-05,0.0,1.0
32398,충붆시/Noun,1,1,0,1.1115310228308472e-05,0.0,1.0
32399,Happy/Alpha,1,0,1,0.0,1.1106915165381966e-05,1.0
32400,병렬/Noun,1,0,1,0.0,1.1106915165381966e-05,1.0
32401,마르티노/Noun,1,1,0,1.1115310228308472e-05,0.0,1.0
32402,삼국시대/Noun,1,0,1,0.0,1.1106915165381966e-05,1.0
32403,판취/Noun,1,0,1,0.0,1.1106915165381966e-05,1.0
32404,-_-''/Punctuation,1,0,1,0.0,1.1106915165381966e-05,1.0
32405,부여선/Noun,1,1,0,1.1115310228308472e-05,0.0,1.0
32406,8.09/Number,1,0,1,0.0,1.1106915165381966e-05,1.0
32407,정좌/Noun,1,0,1,0.0,1.1106915165381966e-05,1.0
32408,루잼/Noun,1,0,1,0.0,1.1106915165381966e-05,1.0
32409,필독/Noun,1,1,0,1.1115310228308472e-05,0.0,1.0
32410,쯤보고있을때/Foreign,1,0,1,0.0,1.1106915165381966e-05,1.0
32411,쓸쓸/Adverb,1,0,1,0.0,1.1106915165381966e-05,1.0
32412,킴베싱어/Noun,1,0,1,0.0,1.1106915165381966e-05,1.0
32413,비온뒤/Noun,1,1,0,1.1115310228308472e-05,0.0,1.0
32414,알람/Noun,1,1,0,1.1115310228308472e-05,0.0,1.0
32415,뽀르뚜까/Noun,1,1,0,1.1115310228308472e-05,0.0,1.0
32416,....==/Punctuation,1,0,1,0.0,1.1106915165381966e-05,1.0
32417,등쌀/Noun,1,0,1,0.0,1.1106915165381966e-05,1.0
32418,별롭니/Noun,1,0,1,0.0,1.1106915165381966e-05,1.0
32419,강도짓/Noun,1,0,1,0.0,1.1106915165381966e-05,1.0
32420,붕유땜시/Noun,1,0,1,0.0,1.1106915165381966e-05,1.0
32421,ㄲㅡㅇ/KoreanParticle,1,0,1,0.0,1.1106915165381966e-05,1.0
32422,졸업식/Noun,1,1,0,1.1115310228308472e-05,0.0,1.0
32423,ssi/Alpha,1,0,1,0.0,1.1106915165381966e-05,1.0
32424,웅카스/Noun,1,0,1,0.0,1.1106915165381966e-05,1.0
32425,이인수/Noun,1,1,0,1.1115310228308472e-05,0.0,1.0
32426,노락질하/Noun,1,0,1,0.0,1.1106915165381966e-05,1.0
32427,밥말아드심/Noun,1,0,1,0.0,1.1106915165381966e-05,1.0
32428,갈분/Noun,1,0,1,0.0,1.1106915165381966e-05,1.0
32429,",!!!/Punctuation",1,1,0,1.1115310228308472e-05,0.0,1.0
32430,후잼/Noun,1,0,1,0.0,1.1106915165381966e-05,1.0
32431,갓말띤줄알았/Noun,1,0,1,0.0,1.1106915165381966e-05,1.0
32432,뻔헸/Noun,1,0,1,0.0,1.1106915165381966e-05,1.0
32433,조진/Noun,1,0,1,0.0,1.1106915165381966e-05,1.0
32434,터프하/Noun,1,0,1,0.0,1.1106915165381966e-05,1.0
32435,토니안/Noun,1,0,1,0.0,1.1106915165381966e-05,1.0
32436,나수영/Noun,1,0,1,0.0,1.1106915165381966e-05,1.0
32437,"...,...!!!!/Punctuation",1,1,0,1.1115310228308472e-05,0.0,1.0
32438,탑안/Noun,1,1,0,1.1115310228308472e-05,0.0,1.0
32439,탑차/Noun,1,1,0,1.1115310228308472e-05,0.0,1.0
32440,더임파서블/Noun,1,0,1,0.0,1.1106915165381966e-05,1.0
32441,추하/Noun,1,1,0,1.1115310228308472e-05,0.0,1.0
32442,자연과학/Noun,1,1,0,1.1115310228308472e-05,0.0,1.0
32443,추겨/Noun,1,0,1,0.0,1.1106915165381966e-05,1.0
32444,Malkovich/Alpha,1,1,0,1.1115310228308472e-05,0.0,1.0
32445,이육사만/Noun,1,1,0,1.1115310228308472e-05,0.0,1.0
32446,젖가슴/Noun,1,0,1,0.0,1.1106915165381966e-05,1.0
32447,치킨런/Noun,1,1,0,1.1115310228308472e-05,0.0,1.0
32448,헤이카/Noun,1,0,1,0.0,1.1106915165381966e-05,1.0
32449,덴노/Noun,1,0,1,0.0,1.1106915165381966e-05,1.0
32450,야욕/Noun,1,0,1,0.0,1.1106915165381966e-05,1.0
32451,멌있엇어/Noun,1,1,0,1.1115310228308472e-05,0.0,1.0
32452,XXXXXXXXXXX/Alpha,1,1,0,1.1115310228308472e-05,0.0,1.0
32453,왕추/Noun,1,1,0,1.1115310228308472e-05,0.0,1.0
32454,반신론/Noun,1,0,1,0.0,1.1106915165381966e-05,1.0
32455,의쌰해/Noun,1,0,1,0.0,1.1106915165381966e-05,1.0
32456,몬산다/Noun,1,0,1,0.0,1.1106915165381966e-05,1.0
32457,영률/Noun,1,0,1,0.0,1.1106915165381966e-05,1.0
32458,왕민/Noun,1,1,0,1.1115310228308472e-05,0.0,1.0
32459,김조한/Noun,1,1,0,1.1115310228308472e-05,0.0,1.0
32460,했어욤/Noun,1,1,0,1.1115310228308472e-05,0.0,1.0
32461,미싱/Noun,1,1,0,1.1115310228308472e-05,0.0,1.0
32462,엘리트스포츠/Noun,1,1,0,1.1115310228308472e-05,0.0,1.0
32463,막파/Noun,1,1,0,1.1115310228308472e-05,0.0,1.0
32464,웹소설/Noun,1,0,1,0.0,1.1106915165381966e-05,1.0
32465,없어졋음/Noun,1,0,1,0.0,1.1106915165381966e-05,1.0
32466,다용/Noun,1,1,0,1.1115310228308472e-05,0.0,1.0
32467,부터보게되었는뎅/Foreign,1,1,0,1.1115310228308472e-05,0.0,1.0
32468,포텐쩌/Noun,1,1,0,1.1115310228308472e-05,0.0,1.0
32469,밍숭맹숭한데/Noun,1,1,0,1.1115310228308472e-05,0.0,1.0
32470,번즈/Noun,1,1,0,1.1115310228308472e-05,0.0,1.0
32471,신처리/Noun,1,0,1,0.0,1.1106915165381966e-05,1.0
32472,말도/Noun,1,0,1,0.0,1.1106915165381966e-05,1.0
32473,ㅋㅋㅋㅎ/KoreanParticle,1,1,0,1.1115310228308472e-05,0.0,1.0
32474,호안/Noun,1,0,1,0.0,1.1106915165381966e-05,1.0
32475,찿으러/Noun,1,0,1,0.0,1.1106915165381966e-05,1.0
32476,흉칙/Noun,1,0,1,0.0,1.1106915165381966e-05,1.0
32477,쭝국/Noun,1,0,1,0.0,1.1106915165381966e-05,1.0
32478,/.????/Punctuation,1,0,1,0.0,1.1106915165381966e-05,1.0
32479,연습곡/Noun,1,1,0,1.1115310228308472e-05,0.0,1.0
32480,버릿/Noun,1,1,0,1.1115310228308472e-05,0.0,1.0
32481,유진박/Noun,1,1,0,1.1115310228308472e-05,0.0,1.0
32482,드넹/Noun,1,0,1,0.0,1.1106915165381966e-05,1.0
32483,개쩌는듯/Noun,1,1,0,1.1115310228308472e-05,0.0,1.0
32484,파출소/Noun,1,0,1,0.0,1.1106915165381966e-05,1.0
32485,네모선장/Noun,1,1,0,1.1115310228308472e-05,0.0,1.0
32486,지독/Noun,1,1,0,1.1115310228308472e-05,0.0,1.0
32487,체리나무/Noun,1,1,0,1.1115310228308472e-05,0.0,1.0
32488,잫/Noun,1,1,0,1.1115310228308472e-05,0.0,1.0
32489,뚱뗑이/Noun,1,1,0,1.1115310228308472e-05,0.0,1.0
32490,ㅡㅡㅋㅋㅋ/KoreanParticle,1,0,1,0.0,1.1106915165381966e-05,1.0
32491,퀘벡/Noun,1,1,0,1.1115310228308472e-05,0.0,1.0
32492,병윈/Noun,1,0,1,0.0,1.1106915165381966e-05,1.0
32493,똑바루해/Noun,1,0,1,0.0,1.1106915165381966e-05,1.0
32494,치사/Noun,1,1,0,1.1115310228308472e-05,0.0,1.0
32495,자이르/Noun,1,1,0,1.1115310228308472e-05,0.0,1.0
32496,맨앤/Noun,1,1,0,1.1115310228308472e-05,0.0,1.0
32497,인표횽/Noun,1,0,1,0.0,1.1106915165381966e-05,1.0
32498,거렸음/Noun,1,1,0,1.1115310228308472e-05,0.0,1.0
32499,17422/Number,1,0,1,0.0,1.1106915165381966e-05,1.0
32500,이쓉/Noun,1,0,1,0.0,1.1106915165381966e-05,1.0
32501,달타냥/Noun,1,1,0,1.1115310228308472e-05,0.0,1.0
32502,향현/Noun,1,0,1,0.0,1.1106915165381966e-05,1.0
32503,디바/Noun,1,0,1,0.0,1.1106915165381966e-05,1.0
32504,카세료/Noun,1,1,0,1.1115310228308472e-05,0.0,1.0
32505,영국문학/Noun,1,0,1,0.0,1.1106915165381966e-05,1.0
32506,염사씬/Noun,1,1,0,1.1115310228308472e-05,0.0,1.0
32507,그라샴/Noun,1,1,0,1.1115310228308472e-05,0.0,1.0
32508,깊엇음/Noun,1,1,0,1.1115310228308472e-05,0.0,1.0
32509,뻔핫/Noun,1,0,1,0.0,1.1106915165381966e-05,1.0
32510,sally/Alpha,1,1,0,1.1115310228308472e-05,0.0,1.0
32511,Lay/Alpha,1,1,0,1.1115310228308472e-05,0.0,1.0
32512,20시/Number,1,0,1,0.0,1.1106915165381966e-05,1.0
32513,끝애/Noun,1,0,1,0.0,1.1106915165381966e-05,1.0
32514,뇌남/Noun,1,1,0,1.1115310228308472e-05,0.0,1.0
32515,....=_=;/Punctuation,1,1,0,1.1115310228308472e-05,0.0,1.0
32516,명껀/Noun,1,0,1,0.0,1.1106915165381966e-05,1.0
32517,흐트려놓음/Noun,1,0,1,0.0,1.1106915165381966e-05,1.0
32518,2020/Number,1,1,0,1.1115310228308472e-05,0.0,1.0
32519,자자삥크스/Noun,1,0,1,0.0,1.1106915165381966e-05,1.0
32520,뭣땜/Noun,1,0,1,0.0,1.1106915165381966e-05,1.0
32521,임관/Noun,1,1,0,1.1115310228308472e-05,0.0,1.0
32522,시스타/Noun,1,1,0,1.1115310228308472e-05,0.0,1.0
32523,갑숑/Noun,1,0,1,0.0,1.1106915165381966e-05,1.0
32524,김민교/Noun,1,1,0,1.1115310228308472e-05,0.0,1.0
32525,construction/Alpha,1,1,0,1.1115310228308472e-05,0.0,1.0
32526,上/Foreign,1,1,0,1.1115310228308472e-05,0.0,1.0
32527,목뼈/Noun,1,0,1,0.0,1.1106915165381966e-05,1.0
32528,유괘/Noun,1,1,0,1.1115310228308472e-05,0.0,1.0
32529,아카시아나무/Noun,1,0,1,0.0,1.1106915165381966e-05,1.0
32530,오리가/Noun,1,1,0,1.1115310228308472e-05,0.0,1.0
32531,걸좀/Noun,1,1,0,1.1115310228308472e-05,0.0,1.0
32532,....-.-/Punctuation,1,1,0,1.1115310228308472e-05,0.0,1.0
32533,간뒤/Noun,1,0,1,0.0,1.1106915165381966e-05,1.0
32534,날린/Foreign,1,0,1,0.0,1.1106915165381966e-05,1.0
32535,왜업/Noun,1,1,0,1.1115310228308472e-05,0.0,1.0
32536,코르부스/Noun,1,0,1,0.0,1.1106915165381966e-05,1.0
32537,팔분/Noun,1,1,0,1.1115310228308472e-05,0.0,1.0
32538,꽃게/Noun,1,1,0,1.1115310228308472e-05,0.0,1.0
32539,젬슴/Noun,1,1,0,1.1115310228308472e-05,0.0,1.0
32540,ㅅㅇㄴ/KoreanParticle,1,0,1,0.0,1.1106915165381966e-05,1.0
32541,컷구/Noun,1,0,1,0.0,1.1106915165381966e-05,1.0
32542,조퇴/Noun,1,0,1,0.0,1.1106915165381966e-05,1.0
32543,포션/Noun,1,0,1,0.0,1.1106915165381966e-05,1.0
32544,산통/Noun,1,0,1,0.0,1.1106915165381966e-05,1.0
32545,이국주/Noun,1,0,1,0.0,1.1106915165381966e-05,1.0
32546,상열/Noun,1,1,0,1.1115310228308472e-05,0.0,1.0
32547,목솔/Noun,1,0,1,0.0,1.1106915165381966e-05,1.0
32548,점그/Noun,1,0,1,0.0,1.1106915165381966e-05,1.0
32549,이은하/Noun,1,0,1,0.0,1.1106915165381966e-05,1.0
32550,하츠/Noun,1,0,1,0.0,1.1106915165381966e-05,1.0
32551,호옷옷오/Noun,1,1,0,1.1115310228308472e-05,0.0,1.0
32552,숙수/Noun,1,1,0,1.1115310228308472e-05,0.0,1.0
32553,라고까지/Josa,1,1,0,1.1115310228308472e-05,0.0,1.0
32554,몰랑몰랑/Adverb,1,1,0,1.1115310228308472e-05,0.0,1.0
32555,!!!!!!!!!!!!!!!!!!!!!!!!!!!!!!!!!!!!!!!!!!!/Punctuation,1,1,0,1.1115310228308472e-05,0.0,1.0
32556,베스킨라빈스/Noun,1,1,0,1.1115310228308472e-05,0.0,1.0
32557,이정화/Noun,1,1,0,1.1115310228308472e-05,0.0,1.0
32558,변희재/Noun,1,1,0,1.1115310228308472e-05,0.0,1.0
32559,우훗/Noun,1,0,1,0.0,1.1106915165381966e-05,1.0
32560,왜일케/Noun,1,0,1,0.0,1.1106915165381966e-05,1.0
32561,살작/Noun,1,1,0,1.1115310228308472e-05,0.0,1.0
32562,쉭쉭/Noun,1,1,0,1.1115310228308472e-05,0.0,1.0
32563,부왘/Noun,1,1,0,1.1115310228308472e-05,0.0,1.0
32564,훕져대/Noun,1,0,1,0.0,1.1106915165381966e-05,1.0
32565,토피도/Noun,1,0,1,0.0,1.1106915165381966e-05,1.0
32566,20억원/Number,1,0,1,0.0,1.1106915165381966e-05,1.0
32567,이됬어/Foreign,1,1,0,1.1115310228308472e-05,0.0,1.0
32568,떡삽겹살/Noun,1,1,0,1.1115310228308472e-05,0.0,1.0
32569,목재/Noun,1,0,1,0.0,1.1106915165381966e-05,1.0
32570,bottom/Alpha,1,1,0,1.1115310228308472e-05,0.0,1.0
32571,Soggy/Alpha,1,1,0,1.1115310228308472e-05,0.0,1.0
32572,펌점/Noun,1,0,1,0.0,1.1106915165381966e-05,1.0
32573,정인지/Noun,1,0,1,0.0,1.1106915165381966e-05,1.0
32574,게른/Noun,1,0,1,0.0,1.1106915165381966e-05,1.0
32575,",),/Punctuation",1,0,1,0.0,1.1106915165381966e-05,1.0
32576,꼭돈/Noun,1,0,1,0.0,1.1106915165381966e-05,1.0
32577,맹진/Noun,1,1,0,1.1115310228308472e-05,0.0,1.0
32578,행온/Noun,1,0,1,0.0,1.1106915165381966e-05,1.0
32579,송구/Noun,1,0,1,0.0,1.1106915165381966e-05,1.0
32580,밤씬/Noun,1,0,1,0.0,1.1106915165381966e-05,1.0
32581,라비니아/Noun,1,1,0,1.1115310228308472e-05,0.0,1.0
32582,낭비가넘아깝다/Foreign,1,0,1,0.0,1.1106915165381966e-05,1.0
32583,"""//Punctuation",1,0,1,0.0,1.1106915165381966e-05,1.0
32584,먼너므/Noun,1,0,1,0.0,1.1106915165381966e-05,1.0
32585,스톤즈/Noun,1,1,0,1.1115310228308472e-05,0.0,1.0
32586,진우도/Noun,1,1,0,1.1115310228308472e-05,0.0,1.0
32587,73회/Number,1,1,0,1.1115310228308472e-05,0.0,1.0
32588,즌보고있는데/Foreign,1,1,0,1.1115310228308472e-05,0.0,1.0
32589,>.<?/Punctuation,1,1,0,1.1115310228308472e-05,0.0,1.0
32590,응원단/Noun,1,1,0,1.1115310228308472e-05,0.0,1.0
32591,왜합/Noun,1,1,0,1.1115310228308472e-05,0.0,1.0
32592,레드윙/Noun,1,1,0,1.1115310228308472e-05,0.0,1.0
32593,http://blog.naver.com/oroblast/220232240012/URL,1,1,0,1.1115310228308472e-05,0.0,1.0
32594,이용도/Noun,1,0,1,0.0,1.1106915165381966e-05,1.0
32595,처럼도/Josa,1,1,0,1.1115310228308472e-05,0.0,1.0
32596,최종훈/Noun,1,1,0,1.1115310228308472e-05,0.0,1.0
32597,기실/Adverb,1,0,1,0.0,1.1106915165381966e-05,1.0
32598,롹스/Noun,1,0,1,0.0,1.1106915165381966e-05,1.0
32599,"..,.,.,.,./Punctuation",1,1,0,1.1115310228308472e-05,0.0,1.0
32600,피포/Noun,1,0,1,0.0,1.1106915165381966e-05,1.0
32601,헤호파피/Noun,1,0,1,0.0,1.1106915165381966e-05,1.0
32602,히후/Noun,1,0,1,0.0,1.1106915165381966e-05,1.0
32603,결신/Noun,1,1,0,1.1115310228308472e-05,0.0,1.0
32604,격퇴/Noun,1,0,1,0.0,1.1106915165381966e-05,1.0
32605,개활지/Noun,1,0,1,0.0,1.1106915165381966e-05,1.0
32606,탁트인/Noun,1,0,1,0.0,1.1106915165381966e-05,1.0
32607,개흐접/Noun,1,0,1,0.0,1.1106915165381966e-05,1.0
32608,김준평/Noun,1,1,0,1.1115310228308472e-05,0.0,1.0
32609,발할라/Noun,1,0,1,0.0,1.1106915165381966e-05,1.0
32610,goooood/Alpha,1,1,0,1.1115310228308472e-05,0.0,1.0
32611,랑거의비싯/Noun,1,1,0,1.1115310228308472e-05,0.0,1.0
32612,후부키/Noun,1,1,0,1.1115310228308472e-05,0.0,1.0
32613,드빠르디유/Noun,1,1,0,1.1115310228308472e-05,0.0,1.0
32614,젠데/Noun,1,0,1,0.0,1.1106915165381966e-05,1.0
32615,조규현/Noun,1,0,1,0.0,1.1106915165381966e-05,1.0
32616,솎았단/Noun,1,0,1,0.0,1.1106915165381966e-05,1.0
32617,콘팅/Noun,1,1,0,1.1115310228308472e-05,0.0,1.0
32618,놘/Noun,1,0,1,0.0,1.1106915165381966e-05,1.0
32619,시그널/Noun,1,0,1,0.0,1.1106915165381966e-05,1.0
32620,laundry/Alpha,1,1,0,1.1115310228308472e-05,0.0,1.0
32621,has/Alpha,1,1,0,1.1115310228308472e-05,0.0,1.0
32622,열중쉬어/Noun,1,0,1,0.0,1.1106915165381966e-05,1.0
32623,비데/Noun,1,0,1,0.0,1.1106915165381966e-05,1.0
32624,Exo/Alpha,1,0,1,0.0,1.1106915165381966e-05,1.0
32625,Exodus/Alpha,1,0,1,0.0,1.1106915165381966e-05,1.0
32626,많았슴/Noun,1,1,0,1.1115310228308472e-05,0.0,1.0
32627,쌍으루/Noun,1,0,1,0.0,1.1106915165381966e-05,1.0
32628,Dvd/Alpha,1,1,0,1.1115310228308472e-05,0.0,1.0
32629,부득이/Noun,1,0,1,0.0,1.1106915165381966e-05,1.0
32630,번설/Noun,1,1,0,1.1115310228308472e-05,0.0,1.0
32631,dmgkgkgkgkg/Alpha,1,0,1,0.0,1.1106915165381966e-05,1.0
32632,aritfact/Alpha,1,0,1,0.0,1.1106915165381966e-05,1.0
32633,번역자/Noun,1,0,1,0.0,1.1106915165381966e-05,1.0
32634,couperet/Alpha,1,1,0,1.1115310228308472e-05,0.0,1.0
32635,le/Alpha,1,1,0,1.1115310228308472e-05,0.0,1.0
32636,잘려지다/Verb,1,1,0,1.1115310228308472e-05,0.0,1.0
32637,2012.08/Number,1,1,0,1.1115310228308472e-05,0.0,1.0
32638,안되드/Noun,1,0,1,0.0,1.1106915165381966e-05,1.0
32639,작품집/Noun,1,0,1,0.0,1.1106915165381966e-05,1.0
32640,.../../Punctuation,1,0,1,0.0,1.1106915165381966e-05,1.0
32641,必/Foreign,1,0,1,0.0,1.1106915165381966e-05,1.0
32642,NY/Alpha,1,1,0,1.1115310228308472e-05,0.0,1.0
32643,........................................................................................../Punctuation,1,0,1,0.0,1.1106915165381966e-05,1.0
32644,이상훈/Noun,1,0,1,0.0,1.1106915165381966e-05,1.0
32645,발몽/Noun,1,1,0,1.1115310228308472e-05,0.0,1.0
32646,오지랍/Noun,1,0,1,0.0,1.1106915165381966e-05,1.0
32647,바운스/Noun,1,0,1,0.0,1.1106915165381966e-05,1.0
32648,Qweert/Alpha,1,1,0,1.1115310228308472e-05,0.0,1.0
32649,년말/Noun,1,1,0,1.1115310228308472e-05,0.0,1.0
32650,버스정류장/Noun,1,0,1,0.0,1.1106915165381966e-05,1.0
32651,떼움/Noun,1,0,1,0.0,1.1106915165381966e-05,1.0
32652,금천/Noun,1,1,0,1.1115310228308472e-05,0.0,1.0
32653,나사못/Noun,1,0,1,0.0,1.1106915165381966e-05,1.0
32654,절벽씬/Noun,1,0,1,0.0,1.1106915165381966e-05,1.0
32655,김영재/Noun,1,1,0,1.1115310228308472e-05,0.0,1.0
32656,년끝/Noun,1,0,1,0.0,1.1106915165381966e-05,1.0
32657,과열/Noun,1,1,0,1.1115310228308472e-05,0.0,1.0
32658,골절/Noun,1,0,1,0.0,1.1106915165381966e-05,1.0
32659,지슬/Noun,1,0,1,0.0,1.1106915165381966e-05,1.0
32660,ㄹㅇㄴㅁㄹㅇㄴㅁㄹㅇㄴㅁㄹㅇㄴㅁㄹㅇㄴㅁㄹㅇㄴㅁㄹㅇㄴㅁㄹㅇㄴㅁㄹㅇㄴㅁ/KoreanParticle,1,1,0,1.1115310228308472e-05,0.0,1.0
32661,볼모/Noun,1,0,1,0.0,1.1106915165381966e-05,1.0
32662,스크레치남기/Noun,1,0,1,0.0,1.1106915165381966e-05,1.0
32663,점장님/Noun,1,1,0,1.1115310228308472e-05,0.0,1.0
32664,대실뫙/Noun,1,0,1,0.0,1.1106915165381966e-05,1.0
32665,넛져/Noun,1,1,0,1.1115310228308472e-05,0.0,1.0
32666,탐험가/Noun,1,1,0,1.1115310228308472e-05,0.0,1.0
32667,생지옥/Noun,1,1,0,1.1115310228308472e-05,0.0,1.0
32668,낯술/Noun,1,0,1,0.0,1.1106915165381966e-05,1.0
32669,배은/Noun,1,1,0,1.1115310228308472e-05,0.0,1.0
32670,.^^^/Punctuation,1,1,0,1.1115310228308472e-05,0.0,1.0
32671,스테파노/Noun,1,1,0,1.1115310228308472e-05,0.0,1.0
32672,pepoi/Alpha,1,0,1,0.0,1.1106915165381966e-05,1.0
32673,네나/Noun,1,0,1,0.0,1.1106915165381966e-05,1.0
32674,넸/Modifier,1,0,1,0.0,1.1106915165381966e-05,1.0
32675,SKY/Alpha,1,1,0,1.1115310228308472e-05,0.0,1.0
32676,EYE/Alpha,1,1,0,1.1115310228308472e-05,0.0,1.0
32677,낚었어/Noun,1,0,1,0.0,1.1106915165381966e-05,1.0
32678,김연경/Noun,1,1,0,1.1115310228308472e-05,0.0,1.0
32679,호주판/Noun,1,0,1,0.0,1.1106915165381966e-05,1.0
32680,음약/Noun,1,1,0,1.1115310228308472e-05,0.0,1.0
32681,헬리오스/Noun,1,1,0,1.1115310228308472e-05,0.0,1.0
32682,제명/Noun,1,1,0,1.1115310228308472e-05,0.0,1.0
32683,으릴/Noun,1,0,1,0.0,1.1106915165381966e-05,1.0
32684,나오셧는대꾀/Foreign,1,1,0,1.1115310228308472e-05,0.0,1.0
32685,링링/Noun,1,0,1,0.0,1.1106915165381966e-05,1.0
32686,르겐드/Noun,1,0,1,0.0,1.1106915165381966e-05,1.0
32687,재입대/Noun,1,0,1,0.0,1.1106915165381966e-05,1.0
32688,다시볼빠/Noun,1,0,1,0.0,1.1106915165381966e-05,1.0
32689,문정혁/Noun,1,1,0,1.1115310228308472e-05,0.0,1.0
32690,장정진/Noun,1,0,1,0.0,1.1106915165381966e-05,1.0
32691,펜트하우스/Noun,1,0,1,0.0,1.1106915165381966e-05,1.0
32692,리스닝/Noun,1,0,1,0.0,1.1106915165381966e-05,1.0
32693,끌끌끌/Noun,1,0,1,0.0,1.1106915165381966e-05,1.0
32694,엔트랩먼트/Noun,1,1,0,1.1115310228308472e-05,0.0,1.0
32695,안나왓으/Noun,1,0,1,0.0,1.1106915165381966e-05,1.0
32696,흝/Noun,1,1,0,1.1115310228308472e-05,0.0,1.0
32697,떡방아/Noun,1,0,1,0.0,1.1106915165381966e-05,1.0
32698,보신전쟁/Noun,1,1,0,1.1115310228308472e-05,0.0,1.0
32699,리피아/Noun,1,1,0,1.1115310228308472e-05,0.0,1.0
32700,웨렌/Noun,1,1,0,1.1115310228308472e-05,0.0,1.0
32701,셜리맥/Noun,1,1,0,1.1115310228308472e-05,0.0,1.0
32702,늦가을/Noun,1,1,0,1.1115310228308472e-05,0.0,1.0
32703,명사회/Noun,1,1,0,1.1115310228308472e-05,0.0,1.0
32704,잼내욘/Noun,1,1,0,1.1115310228308472e-05,0.0,1.0
32705,브스/Noun,1,1,0,1.1115310228308472e-05,0.0,1.0
32706,빨통/Noun,1,0,1,0.0,1.1106915165381966e-05,1.0
32707,플레어/Noun,1,0,1,0.0,1.1106915165381966e-05,1.0
32708,햔먀디/Noun,1,0,1,0.0,1.1106915165381966e-05,1.0
32709,담뱃불/Noun,1,0,1,0.0,1.1106915165381966e-05,1.0
32710,Divided/Alpha,1,0,1,0.0,1.1106915165381966e-05,1.0
32711,Sara/Alpha,1,0,1,0.0,1.1106915165381966e-05,1.0
32712,Tegan/Alpha,1,0,1,0.0,1.1106915165381966e-05,1.0
32713,55초/Number,1,0,1,0.0,1.1106915165381966e-05,1.0
32714,까막눈/Noun,1,0,1,0.0,1.1106915165381966e-05,1.0
32715,뭐녜/Noun,1,0,1,0.0,1.1106915165381966e-05,1.0
32716,발찍/Noun,1,0,1,0.0,1.1106915165381966e-05,1.0
32717,송정우/Noun,1,1,0,1.1115310228308472e-05,0.0,1.0
32718,넹이벙/Noun,1,0,1,0.0,1.1106915165381966e-05,1.0
32719,고복/Noun,1,0,1,0.0,1.1106915165381966e-05,1.0
32720,키찬/Noun,1,0,1,0.0,1.1106915165381966e-05,1.0
32721,떼놈/Noun,1,0,1,0.0,1.1106915165381966e-05,1.0
32722,떼돈버/Noun,1,0,1,0.0,1.1106915165381966e-05,1.0
32723,언넝/Noun,1,1,0,1.1115310228308472e-05,0.0,1.0
32724,전식/Noun,1,0,1,0.0,1.1106915165381966e-05,1.0
32725,넘어가는데/Foreign,1,1,0,1.1115310228308472e-05,0.0,1.0
32726,가람이/Noun,1,0,1,0.0,1.1106915165381966e-05,1.0
32727,강현민/Noun,1,1,0,1.1115310228308472e-05,0.0,1.0
32728,그냔/Noun,1,0,1,0.0,1.1106915165381966e-05,1.0
32729,넘게뭐한거지난/Foreign,1,0,1,0.0,1.1106915165381966e-05,1.0
32730,병탕/Noun,1,1,0,1.1115310228308472e-05,0.0,1.0
32731,야식/Noun,1,0,1,0.0,1.1106915165381966e-05,1.0
32732,장개/Noun,1,0,1,0.0,1.1106915165381966e-05,1.0
32733,Oo/Alpha,1,0,1,0.0,1.1106915165381966e-05,1.0
32734,히라가나/Noun,1,0,1,0.0,1.1106915165381966e-05,1.0
32735,켈베러스/Noun,1,0,1,0.0,1.1106915165381966e-05,1.0
32736,케르베로스/Noun,1,0,1,0.0,1.1106915165381966e-05,1.0
32737,복성고조/Noun,1,1,0,1.1115310228308472e-05,0.0,1.0
32738,알랍/Noun,1,1,0,1.1115310228308472e-05,0.0,1.0
32739,광일/Noun,1,1,0,1.1115310228308472e-05,0.0,1.0
32740,자바/Noun,1,1,0,1.1115310228308472e-05,0.0,1.0
32741,루커/Noun,1,1,0,1.1115310228308472e-05,0.0,1.0
32742,Punk/Alpha,1,1,0,1.1115310228308472e-05,0.0,1.0
32743,Daft/Alpha,1,1,0,1.1115310228308472e-05,0.0,1.0
32744,안전교육/Noun,1,0,1,0.0,1.1106915165381966e-05,1.0
32745,뀌띵꿍꿔또/Noun,1,0,1,0.0,1.1106915165381966e-05,1.0
32746,'-^/Punctuation,1,0,1,0.0,1.1106915165381966e-05,1.0
32747,ㅜㅜㅜㅎ/KoreanParticle,1,1,0,1.1115310228308472e-05,0.0,1.0
32748,당뇨병/Noun,1,1,0,1.1115310228308472e-05,0.0,1.0
32749,하프웨이/Noun,1,0,1,0.0,1.1106915165381966e-05,1.0
32750,하르프웨이/Noun,1,0,1,0.0,1.1106915165381966e-05,1.0
32751,루편현/Noun,1,0,1,0.0,1.1106915165381966e-05,1.0
32752,むしし/Foreign,1,0,1,0.0,1.1106915165381966e-05,1.0
32753,蟲師/Foreign,1,0,1,0.0,1.1106915165381966e-05,1.0
32754,마지막부분은/Foreign,1,1,0,1.1115310228308472e-05,0.0,1.0
32755,호서/Noun,1,0,1,0.0,1.1106915165381966e-05,1.0
32756,".!!!""/Punctuation",1,0,1,0.0,1.1106915165381966e-05,1.0
32757,씬시/Noun,1,0,1,0.0,1.1106915165381966e-05,1.0
32758,총신/Noun,1,0,1,0.0,1.1106915165381966e-05,1.0
32759,Home/Alpha,1,1,0,1.1115310228308472e-05,0.0,1.0
32760,Going/Alpha,1,1,0,1.1115310228308472e-05,0.0,1.0
32761,rlghks1688@naver.com/Email,1,0,1,0.0,1.1106915165381966e-05,1.0
32762,YOURSELF/Alpha,1,1,0,1.1115310228308472e-05,0.0,1.0
32763,LOSE/Alpha,1,1,0,1.1115310228308472e-05,0.0,1.0
32764,EMINEM/Alpha,1,1,0,1.1115310228308472e-05,0.0,1.0
32765,hmr/Alpha,1,1,0,1.1115310228308472e-05,0.0,1.0
32766,붇잡/Noun,1,0,1,0.0,1.1106915165381966e-05,1.0
32767,솜망/Noun,1,0,1,0.0,1.1106915165381966e-05,1.0
32768,ㅋㅋㅎㅎ/KoreanParticle,1,0,1,0.0,1.1106915165381966e-05,1.0
32769,_-../Punctuation,1,0,1,0.0,1.1106915165381966e-05,1.0
32770,뮝미/Noun,1,0,1,0.0,1.1106915165381966e-05,1.0
32771,^-^;;;/Punctuation,1,1,0,1.1115310228308472e-05,0.0,1.0
32772,브리티쉬/Noun,1,1,0,1.1115310228308472e-05,0.0,1.0
32773,아직껏/Adverb,1,1,0,1.1115310228308472e-05,0.0,1.0
32774,정키/Noun,1,0,1,0.0,1.1106915165381966e-05,1.0
32775,FAIL/Alpha,1,0,1,0.0,1.1106915165381966e-05,1.0
32776,봵/Noun,1,0,1,0.0,1.1106915165381966e-05,1.0
32777,헛봤/Noun,1,0,1,0.0,1.1106915165381966e-05,1.0
32778,양지운/Noun,1,1,0,1.1115310228308472e-05,0.0,1.0
32779,노스웨스트항공/Noun,1,1,0,1.1115310228308472e-05,0.0,1.0
32780,얼싸다/Verb,1,0,1,0.0,1.1106915165381966e-05,1.0
32781,업종/Noun,1,1,0,1.1115310228308472e-05,0.0,1.0
32782,애타/Noun,1,1,0,1.1115310228308472e-05,0.0,1.0
32783,특수촬영/Noun,1,0,1,0.0,1.1106915165381966e-05,1.0
32784,도디/Noun,1,0,1,0.0,1.1106915165381966e-05,1.0
32785,커스버트때문/Noun,1,0,1,0.0,1.1106915165381966e-05,1.0
32786,530/Number,1,1,0,1.1115310228308472e-05,0.0,1.0
32787,17만/Number,1,1,0,1.1115310228308472e-05,0.0,1.0
32788,좋겠슴/Noun,1,1,0,1.1115310228308472e-05,0.0,1.0
32789,다볼랬는데/Noun,1,0,1,0.0,1.1106915165381966e-05,1.0
32790,",,>////Punctuation",1,1,0,1.1115310228308472e-05,0.0,1.0
32791,렷음/Noun,1,1,0,1.1115310228308472e-05,0.0,1.0
32792,스렉의/Noun,1,0,1,0.0,1.1106915165381966e-05,1.0
32793,빚나/Noun,1,0,1,0.0,1.1106915165381966e-05,1.0
32794,세피아/Noun,1,1,0,1.1115310228308472e-05,0.0,1.0
32795,날아들다/Verb,1,1,0,1.1115310228308472e-05,0.0,1.0
32796,의재/Noun,1,1,0,1.1115310228308472e-05,0.0,1.0
32797,담묵/Noun,1,1,0,1.1115310228308472e-05,0.0,1.0
32798,목마/Noun,1,1,0,1.1115310228308472e-05,0.0,1.0
32799,도매/Noun,1,0,1,0.0,1.1106915165381966e-05,1.0
32800,몸팔/Noun,1,0,1,0.0,1.1106915165381966e-05,1.0
32801,식신로드/Noun,1,0,1,0.0,1.1106915165381966e-05,1.0
32802,웰웰웰/Noun,1,1,0,1.1115310228308472e-05,0.0,1.0
32803,계념/Noun,1,0,1,0.0,1.1106915165381966e-05,1.0
32804,모기지/Noun,1,1,0,1.1115310228308472e-05,0.0,1.0
32805,휘청이다/Verb,1,0,1,0.0,1.1106915165381966e-05,1.0
32806,망촐수/Noun,1,0,1,0.0,1.1106915165381966e-05,1.0
32807,나은지/Noun,1,1,0,1.1115310228308472e-05,0.0,1.0
32808,6.91/Number,1,1,0,1.1115310228308472e-05,0.0,1.0
32809,느켜지/Noun,1,0,1,0.0,1.1106915165381966e-05,1.0
32810,북치/Noun,1,0,1,0.0,1.1106915165381966e-05,1.0
32811,프레데릭/Noun,1,0,1,0.0,1.1106915165381966e-05,1.0
32812,개뻥임/Noun,1,0,1,0.0,1.1106915165381966e-05,1.0
32813,그렇넹/Noun,1,0,1,0.0,1.1106915165381966e-05,1.0
32814,머싯음/Noun,1,1,0,1.1115310228308472e-05,0.0,1.0
32815,넵튠/Noun,1,0,1,0.0,1.1106915165381966e-05,1.0
32816,일렇/Noun,1,1,0,1.1115310228308472e-05,0.0,1.0
32817,~~~!!!!!!!!.../Punctuation,1,1,0,1.1115310228308472e-05,0.0,1.0
32818,토요로드쇼/Noun,1,1,0,1.1115310228308472e-05,0.0,1.0
32819,어쨓/Noun,1,0,1,0.0,1.1106915165381966e-05,1.0
32820,반기독교/Noun,1,1,0,1.1115310228308472e-05,0.0,1.0
32821,",,.,.,/Punctuation",1,0,1,0.0,1.1106915165381966e-05,1.0
32822,나답/Noun,1,1,0,1.1115310228308472e-05,0.0,1.0
32823,이주희/Noun,1,1,0,1.1115310228308472e-05,0.0,1.0
32824,위법/Noun,1,0,1,0.0,1.1106915165381966e-05,1.0
32825,햄내/Noun,1,1,0,1.1115310228308472e-05,0.0,1.0
32826,어찌될런/Noun,1,1,0,1.1115310228308472e-05,0.0,1.0
32827,동뮬/Noun,1,1,0,1.1115310228308472e-05,0.0,1.0
32828,머진/Noun,1,0,1,0.0,1.1106915165381966e-05,1.0
32829,모큐드라마/Noun,1,1,0,1.1115310228308472e-05,0.0,1.0
32830,하고/Foreign,1,1,0,1.1115310228308472e-05,0.0,1.0
32831,샤방/Noun,1,1,0,1.1115310228308472e-05,0.0,1.0
32832,페허/Noun,1,0,1,0.0,1.1106915165381966e-05,1.0
32833,뜨레기/Noun,1,0,1,0.0,1.1106915165381966e-05,1.0
32834,그랫었/Noun,1,0,1,0.0,1.1106915165381966e-05,1.0
32835,찮케/Noun,1,1,0,1.1115310228308472e-05,0.0,1.0
32836,겸사겸사/Noun,1,1,0,1.1115310228308472e-05,0.0,1.0
32837,4.13/Number,1,0,1,0.0,1.1106915165381966e-05,1.0
32838,별주부전/Noun,1,1,0,1.1115310228308472e-05,0.0,1.0
32839,토끼전/Noun,1,1,0,1.1115310228308472e-05,0.0,1.0
32840,머뭇거리다/Verb,1,0,1,0.0,1.1106915165381966e-05,1.0
32841,해뇰/Noun,1,0,1,0.0,1.1106915165381966e-05,1.0
32842,아리야/Noun,1,0,1,0.0,1.1106915165381966e-05,1.0
32843,LAPD/Alpha,1,1,0,1.1115310228308472e-05,0.0,1.0
32844,후덜둘/Noun,1,0,1,0.0,1.1106915165381966e-05,1.0
32845,러블리하/Noun,1,1,0,1.1115310228308472e-05,0.0,1.0
32846,뺨치/Noun,1,1,0,1.1115310228308472e-05,0.0,1.0
32847,덤스/Noun,1,1,0,1.1115310228308472e-05,0.0,1.0
32848,형국/Noun,1,0,1,0.0,1.1106915165381966e-05,1.0
32849,미얀마어/Noun,1,0,1,0.0,1.1106915165381966e-05,1.0
32850,훨빼/Noun,1,0,1,0.0,1.1106915165381966e-05,1.0
32851,괴위섀위꾸이드롸/Noun,1,0,1,0.0,1.1106915165381966e-05,1.0
32852,화쥐뫄/Noun,1,0,1,0.0,1.1106915165381966e-05,1.0
32853,아이큐점프/Noun,1,1,0,1.1115310228308472e-05,0.0,1.0
32854,감독샠히/Noun,1,0,1,0.0,1.1106915165381966e-05,1.0
32855,격리/Noun,1,1,0,1.1115310228308472e-05,0.0,1.0
32856,덴젤형님/Noun,1,1,0,1.1115310228308472e-05,0.0,1.0
32857,무토/Noun,1,0,1,0.0,1.1106915165381966e-05,1.0
32858,침대씬/Noun,1,1,0,1.1115310228308472e-05,0.0,1.0
32859,떈/Noun,1,1,0,1.1115310228308472e-05,0.0,1.0
32860,surgery/Alpha,1,0,1,0.0,1.1106915165381966e-05,1.0
32861,plastic/Alpha,1,0,1,0.0,1.1106915165381966e-05,1.0
32862,어획/Noun,1,0,1,0.0,1.1106915165381966e-05,1.0
32863,화미/Noun,1,1,0,1.1115310228308472e-05,0.0,1.0
32864,바진/Noun,1,0,1,0.0,1.1106915165381966e-05,1.0
32865,병때/Foreign,1,1,0,1.1115310228308472e-05,0.0,1.0
32866,두루미/Noun,1,1,0,1.1115310228308472e-05,0.0,1.0
32867,!!*^^*/Punctuation,1,1,0,1.1115310228308472e-05,0.0,1.0
32868,;-.-/Punctuation,1,0,1,0.0,1.1106915165381966e-05,1.0
32869,쉽네잉/Noun,1,0,1,0.0,1.1106915165381966e-05,1.0
32870,답게/Noun,1,0,1,0.0,1.1106915165381966e-05,1.0
32871,군왕/Noun,1,1,0,1.1115310228308472e-05,0.0,1.0
32872,케이드/Noun,1,0,1,0.0,1.1106915165381966e-05,1.0
32873,이철/Noun,1,0,1,0.0,1.1106915165381966e-05,1.0
32874,만에다봣는데처음엔/Foreign,1,1,0,1.1115310228308472e-05,0.0,1.0
32875,살벌/Noun,1,1,0,1.1115310228308472e-05,0.0,1.0
32876,황구/Noun,1,1,0,1.1115310228308472e-05,0.0,1.0
32877,ㅁㄷ/KoreanParticle,1,0,1,0.0,1.1106915165381966e-05,1.0
32878,랗그/Noun,1,0,1,0.0,1.1106915165381966e-05,1.0
32879,꾸룩루/Noun,1,1,0,1.1115310228308472e-05,0.0,1.0
32880,다크호스/Noun,1,1,0,1.1115310228308472e-05,0.0,1.0
32881,일직/Noun,1,1,0,1.1115310228308472e-05,0.0,1.0
32882,빙햄/Noun,1,1,0,1.1115310228308472e-05,0.0,1.0
32883,에해주길래/Foreign,1,0,1,0.0,1.1106915165381966e-05,1.0
32884,봣으므/Noun,1,1,0,1.1115310228308472e-05,0.0,1.0
32885,대우리나라/Foreign,1,1,0,1.1115310228308472e-05,0.0,1.0
32886,곤경/Noun,1,1,0,1.1115310228308472e-05,0.0,1.0
32887,우사인/Noun,1,0,1,0.0,1.1106915165381966e-05,1.0
32888,닥명작닥명작닥/Noun,1,1,0,1.1115310228308472e-05,0.0,1.0
32889,TDN/Alpha,1,1,0,1.1115310228308472e-05,0.0,1.0
32890,罪人/Foreign,1,1,0,1.1115310228308472e-05,0.0,1.0
32891,중흥/Noun,1,1,0,1.1115310228308472e-05,0.0,1.0
32892,ㅡㅏ/KoreanParticle,1,0,1,0.0,1.1106915165381966e-05,1.0
32893,뻘쭘했다/Noun,1,0,1,0.0,1.1106915165381966e-05,1.0
32894,Belongs/Alpha,1,1,0,1.1115310228308472e-05,0.0,1.0
32895,!!??!?!?!?!?/Punctuation,1,1,0,1.1115310228308472e-05,0.0,1.0
32896,려욱/Noun,1,1,0,1.1115310228308472e-05,0.0,1.0
32897,농축/Noun,1,1,0,1.1115310228308472e-05,0.0,1.0
32898,외장하드/Noun,1,0,1,0.0,1.1106915165381966e-05,1.0
32899,애스턴/Noun,1,1,0,1.1115310228308472e-05,0.0,1.0
32900,헐랭헐랭/Noun,1,0,1,0.0,1.1106915165381966e-05,1.0
32901,소록소록/Noun,1,1,0,1.1115310228308472e-05,0.0,1.0
32902,눈위/Noun,1,1,0,1.1115310228308472e-05,0.0,1.0
32903,웃옷/Noun,1,1,0,1.1115310228308472e-05,0.0,1.0
32904,이중간첩/Noun,1,1,0,1.1115310228308472e-05,0.0,1.0
32905,걸스온탑/Noun,1,0,1,0.0,1.1106915165381966e-05,1.0
32906,사주면/Noun,1,0,1,0.0,1.1106915165381966e-05,1.0
32907,딜도/Noun,1,0,1,0.0,1.1106915165381966e-05,1.0
32908,이재룡/Noun,1,1,0,1.1115310228308472e-05,0.0,1.0
32909,박인환/Noun,1,1,0,1.1115310228308472e-05,0.0,1.0
32910,우러러/Noun,1,1,0,1.1115310228308472e-05,0.0,1.0
32911,이고/Foreign,1,0,1,0.0,1.1106915165381966e-05,1.0
32912,430억/Number,1,0,1,0.0,1.1106915165381966e-05,1.0
32913,터트려/Noun,1,1,0,1.1115310228308472e-05,0.0,1.0
32914,까지봣다/Noun,1,1,0,1.1115310228308472e-05,0.0,1.0
32915,환몽/Noun,1,0,1,0.0,1.1106915165381966e-05,1.0
32916,힘줄/Noun,1,0,1,0.0,1.1106915165381966e-05,1.0
32917,양갱/Noun,1,0,1,0.0,1.1106915165381966e-05,1.0
32918,마준/Noun,1,1,0,1.1115310228308472e-05,0.0,1.0
32919,멋졍음/Noun,1,1,0,1.1115310228308472e-05,0.0,1.0
32920,';;/Punctuation,1,0,1,0.0,1.1106915165381966e-05,1.0
32921,띨/Noun,1,0,1,0.0,1.1106915165381966e-05,1.0
32922,딸칠/Noun,1,1,0,1.1115310228308472e-05,0.0,1.0
32923,포르코/Noun,1,1,0,1.1115310228308472e-05,0.0,1.0
32924,물품/Noun,1,1,0,1.1115310228308472e-05,0.0,1.0
32925,Garbage/Alpha,1,0,1,0.0,1.1106915165381966e-05,1.0
32926,집결호/Noun,1,0,1,0.0,1.1106915165381966e-05,1.0
32927,50회/Number,1,1,0,1.1115310228308472e-05,0.0,1.0
32928,땜빵용/Noun,1,1,0,1.1115310228308472e-05,0.0,1.0
32929,들국화/Noun,1,1,0,1.1115310228308472e-05,0.0,1.0
32930,HONOR/Alpha,1,1,0,1.1115310228308472e-05,0.0,1.0
32931,http://blog.naver.com/hanainde/220012850005/URL,1,1,0,1.1115310228308472e-05,0.0,1.0
32932,포스팅/Noun,1,1,0,1.1115310228308472e-05,0.0,1.0
32933,데터/Noun,1,0,1,0.0,1.1106915165381966e-05,1.0
32934,7.80년/Number,1,0,1,0.0,1.1106915165381966e-05,1.0
32935,욕직/Noun,1,0,1,0.0,1.1106915165381966e-05,1.0
32936,쿠선/Noun,1,0,1,0.0,1.1106915165381966e-05,1.0
32937,이진수/Noun,1,1,0,1.1115310228308472e-05,0.0,1.0
32938,원군/Noun,1,1,0,1.1115310228308472e-05,0.0,1.0
32939,사유화/Noun,1,1,0,1.1115310228308472e-05,0.0,1.0
32940,인시/Noun,1,0,1,0.0,1.1106915165381966e-05,1.0
32941,현정이/Noun,1,0,1,0.0,1.1106915165381966e-05,1.0
32942,삼일분/Noun,1,0,1,0.0,1.1106915165381966e-05,1.0
32943,karl/Alpha,1,0,1,0.0,1.1106915165381966e-05,1.0
32944,되니츠/Noun,1,0,1,0.0,1.1106915165381966e-05,1.0
32945,꽃임/Noun,1,1,0,1.1115310228308472e-05,0.0,1.0
32946,닥비추/Noun,1,0,1,0.0,1.1106915165381966e-05,1.0
32947,피신/Noun,1,1,0,1.1115310228308472e-05,0.0,1.0
32948,스맬난다/Noun,1,0,1,0.0,1.1106915165381966e-05,1.0
32949,보다껏음/Foreign,1,0,1,0.0,1.1106915165381966e-05,1.0
32950,불평등조약/Noun,1,0,1,0.0,1.1106915165381966e-05,1.0
32951,조선군/Noun,1,0,1,0.0,1.1106915165381966e-05,1.0
32952,본선/Noun,1,0,1,0.0,1.1106915165381966e-05,1.0
32953,4600만달러/Number,1,0,1,0.0,1.1106915165381966e-05,1.0
32954,볼테르/Noun,1,0,1,0.0,1.1106915165381966e-05,1.0
32955,가셧음/Noun,1,1,0,1.1115310228308472e-05,0.0,1.0
32956,붐씨느/Noun,1,1,0,1.1115310228308472e-05,0.0,1.0
32957,볠/Noun,1,0,1,0.0,1.1106915165381966e-05,1.0
32958,인목/Noun,1,0,1,0.0,1.1106915165381966e-05,1.0
32959,보탰다/Noun,1,0,1,0.0,1.1106915165381966e-05,1.0
32960,변실금/Noun,1,0,1,0.0,1.1106915165381966e-05,1.0
32961,과꽃/Noun,1,0,1,0.0,1.1106915165381966e-05,1.0
32962,카트맨/Noun,1,1,0,1.1115310228308472e-05,0.0,1.0
32963,버터스/Noun,1,1,0,1.1115310228308472e-05,0.0,1.0
32964,슽리/Noun,1,0,1,0.0,1.1106915165381966e-05,1.0
32965,벌로/Noun,1,0,1,0.0,1.1106915165381966e-05,1.0
32966,쿠테타/Noun,1,1,0,1.1115310228308472e-05,0.0,1.0
32967,뷐/Noun,1,0,1,0.0,1.1106915165381966e-05,1.0
32968,조호/Noun,1,0,1,0.0,1.1106915165381966e-05,1.0
32969,경인선/Noun,1,0,1,0.0,1.1106915165381966e-05,1.0
32970,경운/Noun,1,1,0,1.1115310228308472e-05,0.0,1.0
32971,절수/Noun,1,0,1,0.0,1.1106915165381966e-05,1.0
32972,ㅜㅇㅇㅇ/KoreanParticle,1,1,0,1.1115310228308472e-05,0.0,1.0
32973,링고스타/Noun,1,1,0,1.1115310228308472e-05,0.0,1.0
32974,~~/Foreign,1,1,0,1.1115310228308472e-05,0.0,1.0
32975,로으드/Noun,1,0,1,0.0,1.1106915165381966e-05,1.0
32976,마차경주/Noun,1,1,0,1.1115310228308472e-05,0.0,1.0
32977,Australia/Alpha,1,1,0,1.1115310228308472e-05,0.0,1.0
32978,스크루볼/Noun,1,1,0,1.1115310228308472e-05,0.0,1.0
32979,그어렷슬떄/Noun,1,1,0,1.1115310228308472e-05,0.0,1.0
32980,앖네/Noun,1,0,1,0.0,1.1106915165381966e-05,1.0
32981,헤롱헤롱/Noun,1,0,1,0.0,1.1106915165381966e-05,1.0
32982,재밌욤/Noun,1,1,0,1.1115310228308472e-05,0.0,1.0
32983,빠구/Noun,1,1,0,1.1115310228308472e-05,0.0,1.0
32984,↘/Foreign,1,1,0,1.1115310228308472e-05,0.0,1.0
32985,전에찍었었나/Foreign,1,0,1,0.0,1.1106915165381966e-05,1.0
32986,회색분자/Noun,1,1,0,1.1115310228308472e-05,0.0,1.0
32987,정재형/Noun,1,0,1,0.0,1.1106915165381966e-05,1.0
32988,아뿔싸/Noun,1,0,1,0.0,1.1106915165381966e-05,1.0
32989,비숍/Noun,1,1,0,1.1115310228308472e-05,0.0,1.0
32990,유쾨하/Noun,1,1,0,1.1115310228308472e-05,0.0,1.0
32991,페렐만/Noun,1,1,0,1.1115310228308472e-05,0.0,1.0
32992,바딤/Noun,1,1,0,1.1115310228308472e-05,0.0,1.0
32993,落葉飛刀/Foreign,1,0,1,0.0,1.1106915165381966e-05,1.0
32994,몸좀/Noun,1,0,1,0.0,1.1106915165381966e-05,1.0
32995,^^^~!!!!!/Punctuation,1,1,0,1.1115310228308472e-05,0.0,1.0
32996,탈임/Noun,1,0,1,0.0,1.1106915165381966e-05,1.0
32997,지옥도/Noun,1,1,0,1.1115310228308472e-05,0.0,1.0
32998,TNC/Alpha,1,1,0,1.1115310228308472e-05,0.0,1.0
32999,서인철/Noun,1,1,0,1.1115310228308472e-05,0.0,1.0
33000,킥킥거렸던/Noun,1,1,0,1.1115310228308472e-05,0.0,1.0
33001,프리마돈나/Noun,1,1,0,1.1115310228308472e-05,0.0,1.0
33002,Faith/Alpha,1,1,0,1.1115310228308472e-05,0.0,1.0
33003,who/Alpha,1,1,0,1.1115310228308472e-05,0.0,1.0
33004,respect/Alpha,1,1,0,1.1115310228308472e-05,0.0,1.0
33005,귀욤/Noun,1,1,0,1.1115310228308472e-05,0.0,1.0
33006,엘라의계곡/Noun,1,1,0,1.1115310228308472e-05,0.0,1.0
33007,촛대/Noun,1,1,0,1.1115310228308472e-05,0.0,1.0
33008,자전거여행/Noun,1,1,0,1.1115310228308472e-05,0.0,1.0
33009,랬다/Noun,1,0,1,0.0,1.1106915165381966e-05,1.0
33010,...?;;/Punctuation,1,1,0,1.1115310228308472e-05,0.0,1.0
33011,남배/Noun,1,0,1,0.0,1.1106915165381966e-05,1.0
33012,노랜/Noun,1,1,0,1.1115310228308472e-05,0.0,1.0
33013,xg/Alpha,1,0,1,0.0,1.1106915165381966e-05,1.0
33014,그랜저/Noun,1,0,1,0.0,1.1106915165381966e-05,1.0
33015,goflvhxjsms/Alpha,1,1,0,1.1115310228308472e-05,0.0,1.0
33016,몽실몽실하다/Adjective,1,1,0,1.1115310228308472e-05,0.0,1.0
33017,천안문/Noun,1,0,1,0.0,1.1106915165381966e-05,1.0
33018,돌충/Noun,1,0,1,0.0,1.1106915165381966e-05,1.0
33019,사대/Noun,1,0,1,0.0,1.1106915165381966e-05,1.0
33020,possible/Alpha,1,1,0,1.1115310228308472e-05,0.0,1.0
33021,With/Alpha,1,1,0,1.1115310228308472e-05,0.0,1.0
33022,묻혓다/Noun,1,0,1,0.0,1.1106915165381966e-05,1.0
33023,왓어염/Noun,1,1,0,1.1115310228308472e-05,0.0,1.0
33024,루루공주/Noun,1,1,0,1.1115310228308472e-05,0.0,1.0
33025,휠허브/Noun,1,0,1,0.0,1.1106915165381966e-05,1.0
33026,션걸/Noun,1,1,0,1.1115310228308472e-05,0.0,1.0
33027,쓸레기/Noun,1,0,1,0.0,1.1106915165381966e-05,1.0
33028,텨재어챠아쥴/Noun,1,0,1,0.0,1.1106915165381966e-05,1.0
33029,너애욷/Noun,1,0,1,0.0,1.1106915165381966e-05,1.0
33030,hetero/Alpha,1,0,1,0.0,1.1106915165381966e-05,1.0
33031,개엿/Noun,1,0,1,0.0,1.1106915165381966e-05,1.0
33032,bridge/Alpha,1,1,0,1.1115310228308472e-05,0.0,1.0
33033,스란/Noun,1,1,0,1.1115310228308472e-05,0.0,1.0
33034,Tresh/Alpha,1,0,1,0.0,1.1106915165381966e-05,1.0
33035,어리둥절하다/Adjective,1,0,1,0.0,1.1106915165381966e-05,1.0
33036,봤는데/Foreign,1,0,1,0.0,1.1106915165381966e-05,1.0
33037,자택/Noun,1,1,0,1.1115310228308472e-05,0.0,1.0
33038,고르가/Noun,1,1,0,1.1115310228308472e-05,0.0,1.0
33039,이연/Noun,1,0,1,0.0,1.1106915165381966e-05,1.0
33040,이만원/Noun,1,1,0,1.1115310228308472e-05,0.0,1.0
33041,죄것/Noun,1,0,1,0.0,1.1106915165381966e-05,1.0
33042,눌린/Noun,1,1,0,1.1115310228308472e-05,0.0,1.0
33043,훌륭헸다/Noun,1,1,0,1.1115310228308472e-05,0.0,1.0
33044,차에/Foreign,1,1,0,1.1115310228308472e-05,0.0,1.0
33045,아이오/Noun,1,0,1,0.0,1.1106915165381966e-05,1.0
33046,심현섭/Noun,1,1,0,1.1115310228308472e-05,0.0,1.0
33047,오지영/Noun,1,0,1,0.0,1.1106915165381966e-05,1.0
33048,매니큐어/Noun,1,0,1,0.0,1.1106915165381966e-05,1.0
33049,손톰/Noun,1,0,1,0.0,1.1106915165381966e-05,1.0
33050,제네바/Noun,1,0,1,0.0,1.1106915165381966e-05,1.0
33051,메인스트리트/Noun,1,0,1,0.0,1.1106915165381966e-05,1.0
33052,jcs/Alpha,1,1,0,1.1115310228308472e-05,0.0,1.0
33053,생가지/Noun,1,0,1,0.0,1.1106915165381966e-05,1.0
33054,7.81/Number,1,1,0,1.1115310228308472e-05,0.0,1.0
33055,보새/Noun,1,0,1,0.0,1.1106915165381966e-05,1.0
33056,젹/Noun,1,0,1,0.0,1.1106915165381966e-05,1.0
33057,스왜/Noun,1,0,1,0.0,1.1106915165381966e-05,1.0
33058,광년/Noun,1,0,1,0.0,1.1106915165381966e-05,1.0
33059,!!!!!!!!!!!!!!!!!!!!!!!!!!!!!!!!!!!!!/Punctuation,1,1,0,1.1115310228308472e-05,0.0,1.0
33060,핑돕니/Noun,1,1,0,1.1115310228308472e-05,0.0,1.0
33061,박혜미/Noun,1,0,1,0.0,1.1106915165381966e-05,1.0
33062,멋녀/Noun,1,1,0,1.1115310228308472e-05,0.0,1.0
33063,멋남/Noun,1,1,0,1.1115310228308472e-05,0.0,1.0
33064,앤트맨/Noun,1,0,1,0.0,1.1106915165381966e-05,1.0
33065,1929년/Number,1,1,0,1.1115310228308472e-05,0.0,1.0
33066,뒹굼/Noun,1,0,1,0.0,1.1106915165381966e-05,1.0
33067,짭잘하다/Adjective,1,1,0,1.1115310228308472e-05,0.0,1.0
33068,쭛/Noun,1,0,1,0.0,1.1106915165381966e-05,1.0
33069,역할모델/Noun,1,0,1,0.0,1.1106915165381966e-05,1.0
33070,의암/Noun,1,0,1,0.0,1.1106915165381966e-05,1.0
33071,잘랬드만/Noun,1,0,1,0.0,1.1106915165381966e-05,1.0
33072,서츠/Noun,1,1,0,1.1115310228308472e-05,0.0,1.0
33073,오미희/Noun,1,1,0,1.1115310228308472e-05,0.0,1.0
33074,한인수/Noun,1,1,0,1.1115310228308472e-05,0.0,1.0
33075,뒷돈/Noun,1,0,1,0.0,1.1106915165381966e-05,1.0
33076,ㅋㅋㅋㄹㅋㅋㅋ/KoreanParticle,1,0,1,0.0,1.1106915165381966e-05,1.0
33077,ㅋㅋㄱㅋㅋㅋㄱㅋㄱㅋㅋㅋ/KoreanParticle,1,0,1,0.0,1.1106915165381966e-05,1.0
33078,",..,,/Punctuation",1,0,1,0.0,1.1106915165381966e-05,1.0
33079,few/Alpha,1,0,1,0.0,1.1106915165381966e-05,1.0
33080,until/Alpha,1,0,1,0.0,1.1106915165381966e-05,1.0
33081,Slow/Alpha,1,0,1,0.0,1.1106915165381966e-05,1.0
33082,처갓집/Noun,1,0,1,0.0,1.1106915165381966e-05,1.0
33083,...^_^;/Punctuation,1,1,0,1.1115310228308472e-05,0.0,1.0
33084,단문/Noun,1,0,1,0.0,1.1106915165381966e-05,1.0
33085,정도나/Foreign,1,0,1,0.0,1.1106915165381966e-05,1.0
33086,에조차도/Josa,1,0,1,0.0,1.1106915165381966e-05,1.0
33087,특종/Noun,1,0,1,0.0,1.1106915165381966e-05,1.0
33088,유사성/Noun,1,0,1,0.0,1.1106915165381966e-05,1.0
33089,토브후퍼감독/Noun,1,1,0,1.1115310228308472e-05,0.0,1.0
33090,트옹/Noun,1,1,0,1.1115310228308472e-05,0.0,1.0
33091,랫미인/Noun,1,0,1,0.0,1.1106915165381966e-05,1.0
33092,쩍발/Noun,1,0,1,0.0,1.1106915165381966e-05,1.0
33093,인플루엔자/Noun,1,0,1,0.0,1.1106915165381966e-05,1.0
33094,또다력/Noun,1,1,0,1.1115310228308472e-05,0.0,1.0
33095,생맥주/Noun,1,1,0,1.1115310228308472e-05,0.0,1.0
33096,바뎀/Noun,1,1,0,1.1115310228308472e-05,0.0,1.0
33097,오배/Noun,1,1,0,1.1115310228308472e-05,0.0,1.0
33098,잭팟/Noun,1,1,0,1.1115310228308472e-05,0.0,1.0
33099,쟉꼬/Noun,1,1,0,1.1115310228308472e-05,0.0,1.0
33100,브누/Noun,1,1,0,1.1115310228308472e-05,0.0,1.0
33101,프라자/Noun,1,1,0,1.1115310228308472e-05,0.0,1.0
33102,이재규/Noun,1,1,0,1.1115310228308472e-05,0.0,1.0
33103,사이클론/Noun,1,0,1,0.0,1.1106915165381966e-05,1.0
33104,미군정/Noun,1,1,0,1.1115310228308472e-05,0.0,1.0
33105,할말없듬/Noun,1,0,1,0.0,1.1106915165381966e-05,1.0
33106,퍽퍽나/Noun,1,0,1,0.0,1.1106915165381966e-05,1.0
33107,장기중/Noun,1,0,1,0.0,1.1106915165381966e-05,1.0
33108,커피잔/Noun,1,1,0,1.1115310228308472e-05,0.0,1.0
33109,Voyage/Alpha,1,1,0,1.1115310228308472e-05,0.0,1.0
33110,Hopkin/Alpha,1,1,0,1.1115310228308472e-05,0.0,1.0
33111,Mary/Alpha,1,1,0,1.1115310228308472e-05,0.0,1.0
33112,사마염/Noun,1,1,0,1.1115310228308472e-05,0.0,1.0
33113,점준럼/Noun,1,0,1,0.0,1.1106915165381966e-05,1.0
33114,전기의자/Noun,1,0,1,0.0,1.1106915165381966e-05,1.0
33115,어쭙잔/Noun,1,0,1,0.0,1.1106915165381966e-05,1.0
33116,별미/Noun,1,0,1,0.0,1.1106915165381966e-05,1.0
33117,런닝타임중/Foreign,1,0,1,0.0,1.1106915165381966e-05,1.0
33118,108분/Number,1,0,1,0.0,1.1106915165381966e-05,1.0
33119,히뜩/Noun,1,0,1,0.0,1.1106915165381966e-05,1.0
33120,훅감/Noun,1,1,0,1.1115310228308472e-05,0.0,1.0
33121,mary/Alpha,1,1,0,1.1115310228308472e-05,0.0,1.0
33122,었던/Noun,1,1,0,1.1115310228308472e-05,0.0,1.0
33123,성보고/Noun,1,0,1,0.0,1.1106915165381966e-05,1.0
33124,누버/Noun,1,0,1,0.0,1.1106915165381966e-05,1.0
33125,옌날/Noun,1,0,1,0.0,1.1106915165381966e-05,1.0
33126,너무업슴/Noun,1,0,1,0.0,1.1106915165381966e-05,1.0
33127,아엠인빈서블/Noun,1,1,0,1.1115310228308472e-05,0.0,1.0
33128,탈출씬/Noun,1,1,0,1.1115310228308472e-05,0.0,1.0
33129,준딸/Noun,1,0,1,0.0,1.1106915165381966e-05,1.0
33130,퀼스/Noun,1,0,1,0.0,1.1106915165381966e-05,1.0
33131,프란츠/Noun,1,1,0,1.1115310228308472e-05,0.0,1.0
33132,깝놀/Noun,1,0,1,0.0,1.1106915165381966e-05,1.0
33133,슷비슷/Noun,1,0,1,0.0,1.1106915165381966e-05,1.0
33134,꽥꽥대다/Verb,1,0,1,0.0,1.1106915165381966e-05,1.0
33135,Buddha/Alpha,1,1,0,1.1115310228308472e-05,0.0,1.0
33136,wjdq/Alpha,1,1,0,1.1115310228308472e-05,0.0,1.0
33137,>>>>->>>>->>>>->>)>>/Punctuation,1,0,1,0.0,1.1106915165381966e-05,1.0
33138,윙카/Noun,1,1,0,1.1115310228308472e-05,0.0,1.0
33139,민준/Noun,1,1,0,1.1115310228308472e-05,0.0,1.0
33140,알았넴/Noun,1,0,1,0.0,1.1106915165381966e-05,1.0
33141,....????!!/Punctuation,1,0,1,0.0,1.1106915165381966e-05,1.0
33142,앙뱌/Noun,1,0,1,0.0,1.1106915165381966e-05,1.0
33143,EP/Alpha,1,0,1,0.0,1.1106915165381966e-05,1.0
33144,고춧가루/Noun,1,0,1,0.0,1.1106915165381966e-05,1.0
33145,들여만든애니/Foreign,1,0,1,0.0,1.1106915165381966e-05,1.0
33146,카테고리/Noun,1,0,1,0.0,1.1106915165381966e-05,1.0
33147,hfddggffvbgghjkkkjjhh/Alpha,1,1,0,1.1115310228308472e-05,0.0,1.0
33148,Abduction/Alpha,1,0,1,0.0,1.1106915165381966e-05,1.0
33149,어브덕션/Noun,1,0,1,0.0,1.1106915165381966e-05,1.0
33150,가줄/Noun,1,0,1,0.0,1.1106915165381966e-05,1.0
33151,표독/Noun,1,0,1,0.0,1.1106915165381966e-05,1.0
33152,악몸/Noun,1,0,1,0.0,1.1106915165381966e-05,1.0
33153,낚으시네/Noun,1,0,1,0.0,1.1106915165381966e-05,1.0
33154,애둘맘/Noun,1,0,1,0.0,1.1106915165381966e-05,1.0
33155,신혼여행/Noun,1,0,1,0.0,1.1106915165381966e-05,1.0
33156,팔아드셧/Noun,1,0,1,0.0,1.1106915165381966e-05,1.0
33157,에디슨/Noun,1,1,0,1.1115310228308472e-05,0.0,1.0
33158,엄매/Noun,1,1,0,1.1115310228308472e-05,0.0,1.0
33159,mma/Alpha,1,1,0,1.1115310228308472e-05,0.0,1.0
33160,생트집/Noun,1,1,0,1.1115310228308472e-05,0.0,1.0
33161,플레잉/Noun,1,0,1,0.0,1.1106915165381966e-05,1.0
33162,ㅂㅂㅂ/KoreanParticle,1,0,1,0.0,1.1106915165381966e-05,1.0
33163,딘데/Noun,1,1,0,1.1115310228308472e-05,0.0,1.0
33164,드리머/Noun,1,1,0,1.1115310228308472e-05,0.0,1.0
33165,데이라잇/Noun,1,0,1,0.0,1.1106915165381966e-05,1.0
33166,최음제/Noun,1,0,1,0.0,1.1106915165381966e-05,1.0
33167,스카이림/Noun,1,0,1,0.0,1.1106915165381966e-05,1.0
33168,뭐해/Noun,1,1,0,1.1115310228308472e-05,0.0,1.0
33169,')~/Punctuation,1,1,0,1.1115310228308472e-05,0.0,1.0
33170,(~'/Punctuation,1,1,0,1.1115310228308472e-05,0.0,1.0
33171,맙시다/Noun,1,1,0,1.1115310228308472e-05,0.0,1.0
33172,고퀄러티/Noun,1,1,0,1.1115310228308472e-05,0.0,1.0
33173,나자빠지다/Verb,1,0,1,0.0,1.1106915165381966e-05,1.0
33174,스트레쑤/Noun,1,0,1,0.0,1.1106915165381966e-05,1.0
33175,야오/Noun,1,1,0,1.1115310228308472e-05,0.0,1.0
33176,단촐/Noun,1,0,1,0.0,1.1106915165381966e-05,1.0
33177,젯따이/Noun,1,0,1,0.0,1.1106915165381966e-05,1.0
33178,이최선/Noun,1,0,1,0.0,1.1106915165381966e-05,1.0
33179,슬푸/Noun,1,0,1,0.0,1.1106915165381966e-05,1.0
33180,이딸리아/Noun,1,1,0,1.1115310228308472e-05,0.0,1.0
33181,안길강/Noun,1,0,1,0.0,1.1106915165381966e-05,1.0
33182,유석/Noun,1,0,1,0.0,1.1106915165381966e-05,1.0
33183,진통/Noun,1,1,0,1.1115310228308472e-05,0.0,1.0
33184,도반/Noun,1,0,1,0.0,1.1106915165381966e-05,1.0
33185,지산/Noun,1,0,1,0.0,1.1106915165381966e-05,1.0
33186,법운/Noun,1,0,1,0.0,1.1106915165381966e-05,1.0
33187,만다라/Noun,1,0,1,0.0,1.1106915165381966e-05,1.0
33188,관세음/Noun,1,0,1,0.0,1.1106915165381966e-05,1.0
33189,스로리/Noun,1,1,0,1.1115310228308472e-05,0.0,1.0
33190,정신대/Noun,1,0,1,0.0,1.1106915165381966e-05,1.0
33191,알수없음/Noun,1,0,1,0.0,1.1106915165381966e-05,1.0
33192,GTO/Alpha,1,1,0,1.1115310228308472e-05,0.0,1.0
33193,씬스틸러/Noun,1,0,1,0.0,1.1106915165381966e-05,1.0
33194,힌즈/Noun,1,0,1,0.0,1.1106915165381966e-05,1.0
33195,시아란/Noun,1,0,1,0.0,1.1106915165381966e-05,1.0
33196,물물교환/Noun,1,0,1,0.0,1.1106915165381966e-05,1.0
33197,드링/Noun,1,1,0,1.1115310228308472e-05,0.0,1.0
33198,프레스토/Noun,1,1,0,1.1115310228308472e-05,0.0,1.0
33199,수시/Noun,1,1,0,1.1115310228308472e-05,0.0,1.0
33200,추워지다/Verb,1,1,0,1.1115310228308472e-05,0.0,1.0
33201,자릿세/Noun,1,1,0,1.1115310228308472e-05,0.0,1.0
33202,또깡/Noun,1,1,0,1.1115310228308472e-05,0.0,1.0
33203,하야시/Noun,1,1,0,1.1115310228308472e-05,0.0,1.0
33204,........-_-/Punctuation,1,0,1,0.0,1.1106915165381966e-05,1.0
33205,절재/Noun,1,1,0,1.1115310228308472e-05,0.0,1.0
33206,날때꼭/Noun,1,1,0,1.1115310228308472e-05,0.0,1.0
33207,흥건/Noun,1,1,0,1.1115310228308472e-05,0.0,1.0
33208,쿠궁/Noun,1,0,1,0.0,1.1106915165381966e-05,1.0
33209,떄/Foreign,1,1,0,1.1115310228308472e-05,0.0,1.0
33210,청경채/Noun,1,1,0,1.1115310228308472e-05,0.0,1.0
33211,밀푀유/Noun,1,1,0,1.1115310228308472e-05,0.0,1.0
33212,잘봣다/Noun,1,0,1,0.0,1.1106915165381966e-05,1.0
33213,카달/Noun,1,0,1,0.0,1.1106915165381966e-05,1.0
33214,봭빵슥/Noun,1,1,0,1.1115310228308472e-05,0.0,1.0
33215,궛물줄/Noun,1,1,0,1.1115310228308472e-05,0.0,1.0
33216,뙀/Noun,1,1,0,1.1115310228308472e-05,0.0,1.0
33217,궈무붸엔드/Noun,1,1,0,1.1115310228308472e-05,0.0,1.0
33218,쏴으뢍/Noun,1,1,0,1.1115310228308472e-05,0.0,1.0
33219,랩도/Noun,1,0,1,0.0,1.1106915165381966e-05,1.0
33220,떵떵대다/Verb,1,0,1,0.0,1.1106915165381966e-05,1.0
33221,롹을/Noun,1,0,1,0.0,1.1106915165381966e-05,1.0
33222,덩한/Foreign,1,0,1,0.0,1.1106915165381966e-05,1.0
33223,돈퍼주러/Noun,1,0,1,0.0,1.1106915165381966e-05,1.0
33224,포춘쿠키/Noun,1,0,1,0.0,1.1106915165381966e-05,1.0
33225,",,,!/Punctuation",1,1,0,1.1115310228308472e-05,0.0,1.0
33226,아다다/Noun,1,1,0,1.1115310228308472e-05,0.0,1.0
33227,남존/Noun,1,1,0,1.1115310228308472e-05,0.0,1.0
33228,손진영/Noun,1,0,1,0.0,1.1106915165381966e-05,1.0
33229,임팩/Noun,1,1,0,1.1115310228308472e-05,0.0,1.0
33230,텁/Noun,1,0,1,0.0,1.1106915165381966e-05,1.0
33231,99.99%/Number,1,0,1,0.0,1.1106915165381966e-05,1.0
33232,조공/Noun,1,0,1,0.0,1.1106915165381966e-05,1.0
33233,장녹수/Noun,1,0,1,0.0,1.1106915165381966e-05,1.0
33234,thes/Alpha,1,1,0,1.1115310228308472e-05,0.0,1.0
33235,라롸/Noun,1,1,0,1.1115310228308472e-05,0.0,1.0
33236,!~!!!/Punctuation,1,1,0,1.1115310228308472e-05,0.0,1.0
33237,태욱/Noun,1,1,0,1.1115310228308472e-05,0.0,1.0
33238,...^^;;/Punctuation,1,1,0,1.1115310228308472e-05,0.0,1.0
33239,빨놈/Noun,1,0,1,0.0,1.1106915165381966e-05,1.0
33240,버럭대다/Verb,1,0,1,0.0,1.1106915165381966e-05,1.0
33241,경쇠/Noun,1,1,0,1.1115310228308472e-05,0.0,1.0
33242,에가까운영화인데도/Foreign,1,1,0,1.1115310228308472e-05,0.0,1.0
33243,볼놈/Noun,1,0,1,0.0,1.1106915165381966e-05,1.0
33244,웃어요/Noun,1,0,1,0.0,1.1106915165381966e-05,1.0
33245,Toll/Alpha,1,1,0,1.1115310228308472e-05,0.0,1.0
33246,꿧습니/Noun,1,1,0,1.1115310228308472e-05,0.0,1.0
33247,비셧/Noun,1,1,0,1.1115310228308472e-05,0.0,1.0
33248,역하렘물/Noun,1,0,1,0.0,1.1106915165381966e-05,1.0
33249,웃엇/Noun,1,1,0,1.1115310228308472e-05,0.0,1.0
33250,엎어치/Noun,1,0,1,0.0,1.1106915165381966e-05,1.0
33251,두어/Modifier,1,0,1,0.0,1.1106915165381966e-05,1.0
33252,타츠미/Noun,1,0,1,0.0,1.1106915165381966e-05,1.0
33253,wnsrjdp/Alpha,1,1,0,1.1115310228308472e-05,0.0,1.0
33254,rj/Alpha,1,1,0,1.1115310228308472e-05,0.0,1.0
33255,qhkTejs/Alpha,1,1,0,1.1115310228308472e-05,0.0,1.0
33256,sork/Alpha,1,1,0,1.1115310228308472e-05,0.0,1.0
33257,wkrvnadms/Alpha,1,1,0,1.1115310228308472e-05,0.0,1.0
33258,옹려/Noun,1,1,0,1.1115310228308472e-05,0.0,1.0
33259,잼게봣는뎅/Noun,1,1,0,1.1115310228308472e-05,0.0,1.0
33260,리첸/Noun,1,1,0,1.1115310228308472e-05,0.0,1.0
33261,호역/Noun,1,0,1,0.0,1.1106915165381966e-05,1.0
33262,unforgettable/Alpha,1,1,0,1.1115310228308472e-05,0.0,1.0
33263,Rubber/Alpha,1,0,1,0.0,1.1106915165381966e-05,1.0
33264,율리시즈/Noun,1,1,0,1.1115310228308472e-05,0.0,1.0
33265,.;;;;;;;/Punctuation,1,0,1,0.0,1.1106915165381966e-05,1.0
33266,곽현아/Noun,1,0,1,0.0,1.1106915165381966e-05,1.0
33267,죳/Noun,1,0,1,0.0,1.1106915165381966e-05,1.0
33268,청첩/Noun,1,0,1,0.0,1.1106915165381966e-05,1.0
33269,supercalifragilisticexpialidocious/Alpha,1,1,0,1.1115310228308472e-05,0.0,1.0
33270,극빈/Noun,1,0,1,0.0,1.1106915165381966e-05,1.0
33271,죄먀았/Noun,1,1,0,1.1115310228308472e-05,0.0,1.0
33272,권혜효/Noun,1,1,0,1.1115310228308472e-05,0.0,1.0
33273,끌벌쩍/Noun,1,0,1,0.0,1.1106915165381966e-05,1.0
33274,캔슬되/Noun,1,1,0,1.1115310228308472e-05,0.0,1.0
33275,뽀샵/Noun,1,0,1,0.0,1.1106915165381966e-05,1.0
33276,휠윈드/Noun,1,0,1,0.0,1.1106915165381966e-05,1.0
33277,손검/Noun,1,0,1,0.0,1.1106915165381966e-05,1.0
33278,자생/Noun,1,0,1,0.0,1.1106915165381966e-05,1.0
33279,684/Number,1,0,1,0.0,1.1106915165381966e-05,1.0
33280,웅자/Noun,1,1,0,1.1115310228308472e-05,0.0,1.0
33281,알속/Noun,1,0,1,0.0,1.1106915165381966e-05,1.0
33282,의드네/Noun,1,1,0,1.1115310228308472e-05,0.0,1.0
33283,몰래꼬셔/Noun,1,1,0,1.1115310228308472e-05,0.0,1.0
33284,명꼴/Noun,1,1,0,1.1115310228308472e-05,0.0,1.0
33285,빠구리/Noun,1,1,0,1.1115310228308472e-05,0.0,1.0
33286,슈퍼쇼/Noun,1,1,0,1.1115310228308472e-05,0.0,1.0
33287,브릿노래/Noun,1,1,0,1.1115310228308472e-05,0.0,1.0
33288,겍/Noun,1,1,0,1.1115310228308472e-05,0.0,1.0
33289,케케케켁/Noun,1,1,0,1.1115310228308472e-05,0.0,1.0
33290,황태희/Noun,1,1,0,1.1115310228308472e-05,0.0,1.0
33291,건모/Noun,1,0,1,0.0,1.1106915165381966e-05,1.0
33292,면허정지인게스트/Foreign,1,0,1,0.0,1.1106915165381966e-05,1.0
33293,화http://blog.naver.com/gatorade1/90139940631/URL,1,1,0,1.1115310228308472e-05,0.0,1.0
33294,영/Foreign,1,1,0,1.1115310228308472e-05,0.0,1.0
33295,......;;;;;;'/Punctuation,1,0,1,0.0,1.1106915165381966e-05,1.0
33296,사까시/Noun,1,0,1,0.0,1.1106915165381966e-05,1.0
33297,전자오락실/Noun,1,1,0,1.1115310228308472e-05,0.0,1.0
33298,생존권/Noun,1,1,0,1.1115310228308472e-05,0.0,1.0
33299,밀양아리랑/Noun,1,1,0,1.1115310228308472e-05,0.0,1.0
33300,핵발전소/Noun,1,1,0,1.1115310228308472e-05,0.0,1.0
33301,욱긴/Noun,1,1,0,1.1115310228308472e-05,0.0,1.0
33302,오종은/Noun,1,1,0,1.1115310228308472e-05,0.0,1.0
33303,서질/Noun,1,0,1,0.0,1.1106915165381966e-05,1.0
33304,어밴져스등/Noun,1,0,1,0.0,1.1106915165381966e-05,1.0
33305,뤡/Noun,1,0,1,0.0,1.1106915165381966e-05,1.0
33306,월월/Noun,1,0,1,0.0,1.1106915165381966e-05,1.0
33307,빰빠라빰밤빰빠/Noun,1,0,1,0.0,1.1106915165381966e-05,1.0
33308,진리콩까르/Noun,1,0,1,0.0,1.1106915165381966e-05,1.0
33309,Duel/Alpha,1,1,0,1.1115310228308472e-05,0.0,1.0
33310,알짜/Noun,1,1,0,1.1115310228308472e-05,0.0,1.0
33311,쿈텐츠드려/Noun,1,1,0,1.1115310228308472e-05,0.0,1.0
33312,영어학원/Noun,1,1,0,1.1115310228308472e-05,0.0,1.0
33313,농아/Noun,1,0,1,0.0,1.1106915165381966e-05,1.0
33314,헤밍웨이/Noun,1,0,1,0.0,1.1106915165381966e-05,1.0
33315,드렁큰타이거/Noun,1,1,0,1.1115310228308472e-05,0.0,1.0
33316,곤돌라/Noun,1,0,1,0.0,1.1106915165381966e-05,1.0
33317,Greene/Alpha,1,0,1,0.0,1.1106915165381966e-05,1.0
33318,Stephen/Alpha,1,0,1,0.0,1.1106915165381966e-05,1.0
33319,마사코/Noun,1,1,0,1.1115310228308472e-05,0.0,1.0
33320,"],/Punctuation",1,0,1,0.0,1.1106915165381966e-05,1.0
33321,......;;/Punctuation,1,0,1,0.0,1.1106915165381966e-05,1.0
33322,배지/Noun,1,0,1,0.0,1.1106915165381966e-05,1.0
33323,정근/Noun,1,0,1,0.0,1.1106915165381966e-05,1.0
33324,긛/Noun,1,1,0,1.1115310228308472e-05,0.0,1.0
33325,ㄱㄴ/KoreanParticle,1,1,0,1.1115310228308472e-05,0.0,1.0
33326,도인듯/Foreign,1,0,1,0.0,1.1106915165381966e-05,1.0
33327,활빈당/Noun,1,1,0,1.1115310228308472e-05,0.0,1.0
33328,혹독/Noun,1,1,0,1.1115310228308472e-05,0.0,1.0
33329,원활하다/Adjective,1,0,1,0.0,1.1106915165381966e-05,1.0
33330,치워지다/Verb,1,0,1,0.0,1.1106915165381966e-05,1.0
33331,이즈마/Noun,1,1,0,1.1115310228308472e-05,0.0,1.0
33332,장맛비/Noun,1,1,0,1.1115310228308472e-05,0.0,1.0
33333,플라잉/Noun,1,0,1,0.0,1.1106915165381966e-05,1.0
33334,씬외/Noun,1,0,1,0.0,1.1106915165381966e-05,1.0
33335,모태솔로/Noun,1,0,1,0.0,1.1106915165381966e-05,1.0
33336,젤러스/Noun,1,0,1,0.0,1.1106915165381966e-05,1.0
33337,스프레드/Noun,1,0,1,0.0,1.1106915165381966e-05,1.0
33338,임임/Noun,1,0,1,0.0,1.1106915165381966e-05,1.0
33339,임땡/Noun,1,0,1,0.0,1.1106915165381966e-05,1.0
33340,??????????????????????????????/Punctuation,1,0,1,0.0,1.1106915165381966e-05,1.0
33341,미국군/Noun,1,0,1,0.0,1.1106915165381966e-05,1.0
33342,SHOW/Alpha,1,1,0,1.1115310228308472e-05,0.0,1.0
33343,takes/Alpha,1,1,0,1.1115310228308472e-05,0.0,1.0
33344,때캬/Noun,1,1,0,1.1115310228308472e-05,0.0,1.0
33345,베코/Noun,1,1,0,1.1115310228308472e-05,0.0,1.0
33346,쀼잉쀼잉/Noun,1,1,0,1.1115310228308472e-05,0.0,1.0
33347,빌즈/Noun,1,1,0,1.1115310228308472e-05,0.0,1.0
33348,가모라/Noun,1,1,0,1.1115310228308472e-05,0.0,1.0
33349,멸족/Noun,1,0,1,0.0,1.1106915165381966e-05,1.0
33350,만여/Modifier,1,1,0,1.1115310228308472e-05,0.0,1.0
33351,Boot/Alpha,1,1,0,1.1115310228308472e-05,0.0,1.0
33352,Das/Alpha,1,1,0,1.1115310228308472e-05,0.0,1.0
33353,특전/Noun,1,1,0,1.1115310228308472e-05,0.0,1.0
33354,밌어/Noun,1,1,0,1.1115310228308472e-05,0.0,1.0
33355,전영화라고해도/Foreign,1,0,1,0.0,1.1106915165381966e-05,1.0
33356,8.72/Number,1,0,1,0.0,1.1106915165381966e-05,1.0
33357,비스티보이즈/Noun,1,1,0,1.1115310228308472e-05,0.0,1.0
33358,짤랐을꺼/Noun,1,0,1,0.0,1.1106915165381966e-05,1.0
33359,장소혜/Noun,1,0,1,0.0,1.1106915165381966e-05,1.0
33360,물때/Noun,1,0,1,0.0,1.1106915165381966e-05,1.0
33361,티똥년똥/Noun,1,0,1,0.0,1.1106915165381966e-05,1.0
33362,7.94/Number,1,1,0,1.1115310228308472e-05,0.0,1.0
33363,jaji/Alpha,1,0,1,0.0,1.1106915165381966e-05,1.0
33364,혼주/Noun,1,0,1,0.0,1.1106915165381966e-05,1.0
33365,꽃장식/Noun,1,0,1,0.0,1.1106915165381966e-05,1.0
33366,예식/Noun,1,0,1,0.0,1.1106915165381966e-05,1.0
33367,트레쉬/Noun,1,0,1,0.0,1.1106915165381966e-05,1.0
33368,궁금치/Noun,1,0,1,0.0,1.1106915165381966e-05,1.0
33369,애린/Noun,1,1,0,1.1115310228308472e-05,0.0,1.0
33370,교민/Noun,1,0,1,0.0,1.1106915165381966e-05,1.0
33371,기종은/Noun,1,1,0,1.1115310228308472e-05,0.0,1.0
33372,살갗/Noun,1,0,1,0.0,1.1106915165381966e-05,1.0
33373,",>/Punctuation",1,0,1,0.0,1.1106915165381966e-05,1.0
33374,상문/Noun,1,0,1,0.0,1.1106915165381966e-05,1.0
33375,4~6/Number,1,0,1,0.0,1.1106915165381966e-05,1.0
33376,여성혐오증/Noun,1,0,1,0.0,1.1106915165381966e-05,1.0
33377,!!!~^^/Punctuation,1,1,0,1.1115310228308472e-05,0.0,1.0
33378,코렌/Noun,1,1,0,1.1115310228308472e-05,0.0,1.0
33379,또봣/Noun,1,1,0,1.1115310228308472e-05,0.0,1.0
33380,정형기/Noun,1,1,0,1.1115310228308472e-05,0.0,1.0
33381,홀리모터스/Noun,1,1,0,1.1115310228308472e-05,0.0,1.0
33382,ㅎㅎㅅ/KoreanParticle,1,1,0,1.1115310228308472e-05,0.0,1.0
33383,눈눈/Noun,1,0,1,0.0,1.1106915165381966e-05,1.0
33384,샤이아라보프/Noun,1,1,0,1.1115310228308472e-05,0.0,1.0
33385,왔슴/Noun,1,0,1,0.0,1.1106915165381966e-05,1.0
33386,헤수/Noun,1,0,1,0.0,1.1106915165381966e-05,1.0
33387,노국공주/Noun,1,1,0,1.1115310228308472e-05,0.0,1.0
33388,홍림/Noun,1,1,0,1.1115310228308472e-05,0.0,1.0
33389,홀릭했기/Noun,1,1,0,1.1115310228308472e-05,0.0,1.0
33390,밀수/Noun,1,1,0,1.1115310228308472e-05,0.0,1.0
33391,Diamonds/Alpha,1,1,0,1.1115310228308472e-05,0.0,1.0
33392,Sky/Alpha,1,1,0,1.1115310228308472e-05,0.0,1.0
33393,Lucy/Alpha,1,1,0,1.1115310228308472e-05,0.0,1.0
33394,요키/Noun,1,1,0,1.1115310228308472e-05,0.0,1.0
33395,소형견/Noun,1,1,0,1.1115310228308472e-05,0.0,1.0
33396,테리어/Noun,1,1,0,1.1115310228308472e-05,0.0,1.0
33397,요크셔/Noun,1,1,0,1.1115310228308472e-05,0.0,1.0
33398,가여웠/Noun,1,1,0,1.1115310228308472e-05,0.0,1.0
33399,느긋/Noun,1,0,1,0.0,1.1106915165381966e-05,1.0
33400,아메리카노/Noun,1,1,0,1.1115310228308472e-05,0.0,1.0
33401,zzzzzz/Alpha,1,0,1,0.0,1.1106915165381966e-05,1.0
33402,대영화인듯긴박한상황에/Foreign,1,0,1,0.0,1.1106915165381966e-05,1.0
33403,gooD/Alpha,1,1,0,1.1115310228308472e-05,0.0,1.0
33404,700만/Number,1,1,0,1.1115310228308472e-05,0.0,1.0
33405,브늰늬/Noun,1,1,0,1.1115310228308472e-05,0.0,1.0
33406,ㄷㄴㅁㄹ/KoreanParticle,1,1,0,1.1115310228308472e-05,0.0,1.0
33407,회문/Noun,1,1,0,1.1115310228308472e-05,0.0,1.0
33408,29년/Number,1,1,0,1.1115310228308472e-05,0.0,1.0
33409,떄려눕힌/Noun,1,0,1,0.0,1.1106915165381966e-05,1.0
33410,빅키/Noun,1,1,0,1.1115310228308472e-05,0.0,1.0
33411,깜냥/Noun,1,1,0,1.1115310228308472e-05,0.0,1.0
33412,...;;;;;/Punctuation,1,0,1,0.0,1.1106915165381966e-05,1.0
33413,Festival/Alpha,1,0,1,0.0,1.1106915165381966e-05,1.0
33414,Iran/Alpha,1,0,1,0.0,1.1106915165381966e-05,1.0
33415,늙엇어/Noun,1,0,1,0.0,1.1106915165381966e-05,1.0
33416,챠리셀한용철/Noun,1,1,0,1.1115310228308472e-05,0.0,1.0
33417,76%/Number,1,0,1,0.0,1.1106915165381966e-05,1.0
33418,가지났다는/Foreign,1,1,0,1.1115310228308472e-05,0.0,1.0
33419,이되면/Foreign,1,1,0,1.1115310228308472e-05,0.0,1.0
33420,을다봤다고는/Foreign,1,1,0,1.1115310228308472e-05,0.0,1.0
33421,Millions/Alpha,1,0,1,0.0,1.1106915165381966e-05,1.0
33422,Familiar/Alpha,1,0,1,0.0,1.1106915165381966e-05,1.0
33423,Oasis/Alpha,1,0,1,0.0,1.1106915165381966e-05,1.0
33424,시올/Noun,1,1,0,1.1115310228308472e-05,0.0,1.0
33425,충심/Noun,1,1,0,1.1115310228308472e-05,0.0,1.0
33426,윤재엄마/Noun,1,0,1,0.0,1.1106915165381966e-05,1.0
33427,듀코브/Noun,1,1,0,1.1115310228308472e-05,0.0,1.0
33428,콘서트장/Noun,1,0,1,0.0,1.1106915165381966e-05,1.0
33429,지도사/Noun,1,0,1,0.0,1.1106915165381966e-05,1.0
33430,다프/Noun,1,1,0,1.1115310228308472e-05,0.0,1.0
33431,낚였던/Noun,1,0,1,0.0,1.1106915165381966e-05,1.0
33432,.........................................................................................................................................../Punctuation,1,0,1,0.0,1.1106915165381966e-05,1.0
33433,루츠/Noun,1,0,1,0.0,1.1106915165381966e-05,1.0
33434,켈란/Noun,1,0,1,0.0,1.1106915165381966e-05,1.0
33435,글라디에이터/Noun,1,0,1,0.0,1.1106915165381966e-05,1.0
33436,들어/Foreign,1,1,0,1.1115310228308472e-05,0.0,1.0
33437,뭐르겠다/Noun,1,0,1,0.0,1.1106915165381966e-05,1.0
33438,앰버/Noun,1,0,1,0.0,1.1106915165381966e-05,1.0
33439,렷었/Noun,1,1,0,1.1115310228308472e-05,0.0,1.0
33440,10000000000%/Number,1,0,1,0.0,1.1106915165381966e-05,1.0
33441,2.67/Number,1,0,1,0.0,1.1106915165381966e-05,1.0
33442,입학식/Noun,1,1,0,1.1115310228308472e-05,0.0,1.0
33443,Harrison/Alpha,1,0,1,0.0,1.1106915165381966e-05,1.0
33444,똑깥다/Noun,1,1,0,1.1115310228308472e-05,0.0,1.0
33445,깍깍/Adverb,1,1,0,1.1115310228308472e-05,0.0,1.0
33446,아우리가/Noun,1,1,0,1.1115310228308472e-05,0.0,1.0
33447,말일/Noun,1,1,0,1.1115310228308472e-05,0.0,1.0
33448,말다툼/Noun,1,1,0,1.1115310228308472e-05,0.0,1.0
33449,륭합니/Noun,1,1,0,1.1115310228308472e-05,0.0,1.0
33450,맛감/Noun,1,0,1,0.0,1.1106915165381966e-05,1.0
33451,개쉬/Noun,1,0,1,0.0,1.1106915165381966e-05,1.0
33452,타우/Noun,1,1,0,1.1115310228308472e-05,0.0,1.0
33453,이지호/Noun,1,0,1,0.0,1.1106915165381966e-05,1.0
33454,길위/Noun,1,1,0,1.1115310228308472e-05,0.0,1.0
33455,뽀려다/Noun,1,0,1,0.0,1.1106915165381966e-05,1.0
33456,남해/Noun,1,1,0,1.1115310228308472e-05,0.0,1.0
33457,mrost/Alpha,1,0,1,0.0,1.1106915165381966e-05,1.0
33458,객잔신/Noun,1,1,0,1.1115310228308472e-05,0.0,1.0
33459,용문/Noun,1,1,0,1.1115310228308472e-05,0.0,1.0
33460,물말/Noun,1,0,1,0.0,1.1106915165381966e-05,1.0
33461,"?',/Punctuation",1,0,1,0.0,1.1106915165381966e-05,1.0
33462,서지영/Noun,1,1,0,1.1115310228308472e-05,0.0,1.0
33463,철통/Noun,1,0,1,0.0,1.1106915165381966e-05,1.0
33464,870억/Number,1,0,1,0.0,1.1106915165381966e-05,1.0
33465,슴둥/Noun,1,1,0,1.1115310228308472e-05,0.0,1.0
33466,공수도/Noun,1,0,1,0.0,1.1106915165381966e-05,1.0
33467,경력/Foreign,1,0,1,0.0,1.1106915165381966e-05,1.0
33468,영구아트무비/Noun,1,0,1,0.0,1.1106915165381966e-05,1.0
33469,깜직함/Noun,1,1,0,1.1115310228308472e-05,0.0,1.0
33470,도움말/Noun,1,0,1,0.0,1.1106915165381966e-05,1.0
33471,PG/Alpha,1,0,1,0.0,1.1106915165381966e-05,1.0
33472,행콕/Noun,1,0,1,0.0,1.1106915165381966e-05,1.0
33473,등불/Noun,1,0,1,0.0,1.1106915165381966e-05,1.0
33474,마굿/Noun,1,0,1,0.0,1.1106915165381966e-05,1.0
33475,축소하여/Foreign,1,0,1,0.0,1.1106915165381966e-05,1.0
33476,42회/Number,1,0,1,0.0,1.1106915165381966e-05,1.0
33477,홈스위트홈/Noun,1,1,0,1.1115310228308472e-05,0.0,1.0
33478,트레이스/Noun,1,1,0,1.1115310228308472e-05,0.0,1.0
33479,괄목/Noun,1,1,0,1.1115310228308472e-05,0.0,1.0
33480,인터내셔널/Noun,1,1,0,1.1115310228308472e-05,0.0,1.0
33481,트럼프/Noun,1,1,0,1.1115310228308472e-05,0.0,1.0
33482,접핑/Noun,1,1,0,1.1115310228308472e-05,0.0,1.0
33483,취음/Noun,1,1,0,1.1115310228308472e-05,0.0,1.0
33484,장음/Noun,1,1,0,1.1115310228308472e-05,0.0,1.0
33485,욱씬/Noun,1,1,0,1.1115310228308472e-05,0.0,1.0
33486,신처/Noun,1,0,1,0.0,1.1106915165381966e-05,1.0
33487,펌프/Noun,1,0,1,0.0,1.1106915165381966e-05,1.0
33488,데빗/Noun,1,1,0,1.1115310228308472e-05,0.0,1.0
33489,adoptes/Alpha,1,1,0,1.1115310228308472e-05,0.0,1.0
33490,우군/Noun,1,1,0,1.1115310228308472e-05,0.0,1.0
33491,루민/Noun,1,1,0,1.1115310228308472e-05,0.0,1.0
33492,터트렸음/Noun,1,1,0,1.1115310228308472e-05,0.0,1.0
33493,섹영화/Noun,1,0,1,0.0,1.1106915165381966e-05,1.0
33494,저랗/Noun,1,1,0,1.1115310228308472e-05,0.0,1.0
33495,노모쇼/Noun,1,0,1,0.0,1.1106915165381966e-05,1.0
33496,야전/Noun,1,1,0,1.1115310228308472e-05,0.0,1.0
33497,_./Punctuation,1,1,0,1.1115310228308472e-05,0.0,1.0
33498,집앤데/Noun,1,0,1,0.0,1.1106915165381966e-05,1.0
33499,이혜숙/Noun,1,1,0,1.1115310228308472e-05,0.0,1.0
33500,센티넬/Noun,1,1,0,1.1115310228308472e-05,0.0,1.0
33501,봣는데똥/Noun,1,0,1,0.0,1.1106915165381966e-05,1.0
33502,개오지/Noun,1,1,0,1.1115310228308472e-05,0.0,1.0
33503,끼니/Noun,1,1,0,1.1115310228308472e-05,0.0,1.0
33504,2038/Number,1,1,0,1.1115310228308472e-05,0.0,1.0
33505,소권괴초/Noun,1,0,1,0.0,1.1106915165381966e-05,1.0
33506,모욕죄/Noun,1,0,1,0.0,1.1106915165381966e-05,1.0
33507,발노/Noun,1,1,0,1.1115310228308472e-05,0.0,1.0
33508,꽝임/Noun,1,0,1,0.0,1.1106915165381966e-05,1.0
33509,엉엉대다/Verb,1,1,0,1.1115310228308472e-05,0.0,1.0
33510,단념/Noun,1,1,0,1.1115310228308472e-05,0.0,1.0
33511,낮징/Noun,1,1,0,1.1115310228308472e-05,0.0,1.0
33512,로드킬/Noun,1,0,1,0.0,1.1106915165381966e-05,1.0
33513,여깄던/Noun,1,0,1,0.0,1.1106915165381966e-05,1.0
33514,古典/Foreign,1,1,0,1.1115310228308472e-05,0.0,1.0
33515,대영화같움/Foreign,1,0,1,0.0,1.1106915165381966e-05,1.0
33516,새마을/Noun,1,1,0,1.1115310228308472e-05,0.0,1.0
33517,망원경/Noun,1,1,0,1.1115310228308472e-05,0.0,1.0
33518,따끈따끈/Noun,1,0,1,0.0,1.1106915165381966e-05,1.0
33519,명약/Noun,1,0,1,0.0,1.1106915165381966e-05,1.0
33520,_!!/Punctuation,1,1,0,1.1115310228308472e-05,0.0,1.0
33521,Better/Alpha,1,1,0,1.1115310228308472e-05,0.0,1.0
33522,상차림/Noun,1,1,0,1.1115310228308472e-05,0.0,1.0
33523,어쨌던/Noun,1,1,0,1.1115310228308472e-05,0.0,1.0
33524,게생/Noun,1,1,0,1.1115310228308472e-05,0.0,1.0
33525,생액/Noun,1,1,0,1.1115310228308472e-05,0.0,1.0
33526,움등/Noun,1,0,1,0.0,1.1106915165381966e-05,1.0
33527,환지/Noun,1,0,1,0.0,1.1106915165381966e-05,1.0
33528,펌질합니/Noun,1,1,0,1.1115310228308472e-05,0.0,1.0
33529,밤임/Noun,1,0,1,0.0,1.1106915165381966e-05,1.0
33530,~~~~~~~~~~~~~~~~~~~~~~~~~~~~~~~~~~/Punctuation,1,1,0,1.1115310228308472e-05,0.0,1.0
33531,저러껒/Noun,1,0,1,0.0,1.1106915165381966e-05,1.0
33532,런닝하/Noun,1,1,0,1.1115310228308472e-05,0.0,1.0
33533,Tiger/Alpha,1,1,0,1.1115310228308472e-05,0.0,1.0
33534,Eye/Alpha,1,1,0,1.1115310228308472e-05,0.0,1.0
33535,떼베/Noun,1,1,0,1.1115310228308472e-05,0.0,1.0
33536,밀루유/Noun,1,1,0,1.1115310228308472e-05,0.0,1.0
33537,밀루/Noun,1,1,0,1.1115310228308472e-05,0.0,1.0
33538,흝어/Noun,1,0,1,0.0,1.1106915165381966e-05,1.0
33539,ft/Alpha,1,1,0,1.1115310228308472e-05,0.0,1.0
33540,자다옮/Noun,1,0,1,0.0,1.1106915165381966e-05,1.0
33541,이디야/Noun,1,0,1,0.0,1.1106915165381966e-05,1.0
33542,겉절이/Noun,1,0,1,0.0,1.1106915165381966e-05,1.0
33543,더하기/Noun,1,0,1,0.0,1.1106915165381966e-05,1.0
33544,꽁무니/Noun,1,0,1,0.0,1.1106915165381966e-05,1.0
33545,윖/Noun,1,0,1,0.0,1.1106915165381966e-05,1.0
33546,이등박문/Noun,1,0,1,0.0,1.1106915165381966e-05,1.0
33547,;~~/Punctuation,1,1,0,1.1115310228308472e-05,0.0,1.0
33548,엔화/Noun,1,0,1,0.0,1.1106915165381966e-05,1.0
33549,꿀밤/Noun,1,0,1,0.0,1.1106915165381966e-05,1.0
33550,푹빠쟈/Noun,1,1,0,1.1115310228308472e-05,0.0,1.0
33551,엄슴슴/Noun,1,0,1,0.0,1.1106915165381966e-05,1.0
33552,혼마찌깡/Noun,1,0,1,0.0,1.1106915165381966e-05,1.0
33553,잔땜/Noun,1,1,0,1.1115310228308472e-05,0.0,1.0
33554,http://m.blog.naver.com/t_kim81/60158612192/URL,1,1,0,1.1115310228308472e-05,0.0,1.0
33555,최고의작품/Foreign,1,1,0,1.1115310228308472e-05,0.0,1.0
33556,상반기에/Foreign,1,0,1,0.0,1.1106915165381966e-05,1.0
33557,아웃랜더/Noun,1,0,1,0.0,1.1106915165381966e-05,1.0
33558,저럿케/Noun,1,0,1,0.0,1.1106915165381966e-05,1.0
33559,조재희/Noun,1,1,0,1.1115310228308472e-05,0.0,1.0
33560,아방가르드/Noun,1,0,1,0.0,1.1106915165381966e-05,1.0
33561,호팬/Noun,1,1,0,1.1115310228308472e-05,0.0,1.0
33562,-.-;;)/Punctuation,1,0,1,0.0,1.1106915165381966e-05,1.0
33563,population/Alpha,1,1,0,1.1115310228308472e-05,0.0,1.0
33564,뭣같다/Noun,1,0,1,0.0,1.1106915165381966e-05,1.0
33565,킹리/Noun,1,0,1,0.0,1.1106915165381966e-05,1.0
33566,깄으닝컁/Noun,1,0,1,0.0,1.1106915165381966e-05,1.0
33567,꿀잼핵잼존잼/Noun,1,1,0,1.1115310228308472e-05,0.0,1.0
33568,나벌었어/Foreign,1,0,1,0.0,1.1106915165381966e-05,1.0
33569,BECK/Alpha,1,1,0,1.1115310228308472e-05,0.0,1.0
33570,이넘는데/Foreign,1,1,0,1.1115310228308472e-05,0.0,1.0
33571,안토니/Noun,1,1,0,1.1115310228308472e-05,0.0,1.0
33572,nicho/Alpha,1,1,0,1.1115310228308472e-05,0.0,1.0
33573,amor/Alpha,1,1,0,1.1115310228308472e-05,0.0,1.0
33574,del/Alpha,1,1,0,1.1115310228308472e-05,0.0,1.0
33575,sentimiento/Alpha,1,1,0,1.1115310228308472e-05,0.0,1.0
33576,왓어영/Noun,1,0,1,0.0,1.1106915165381966e-05,1.0
33577,숫굿/Noun,1,1,0,1.1115310228308472e-05,0.0,1.0
33578,대배경인데/Foreign,1,0,1,0.0,1.1106915165381966e-05,1.0
33579,엿먹/Noun,1,0,1,0.0,1.1106915165381966e-05,1.0
33580,다별루임/Noun,1,0,1,0.0,1.1106915165381966e-05,1.0
33581,인간드/Noun,1,0,1,0.0,1.1106915165381966e-05,1.0
33582,귀자모신/Noun,1,0,1,0.0,1.1106915165381966e-05,1.0
33583,서랖/Noun,1,1,0,1.1115310228308472e-05,0.0,1.0
33584,바르가/Noun,1,1,0,1.1115310228308472e-05,0.0,1.0
33585,록키산맥/Noun,1,1,0,1.1115310228308472e-05,0.0,1.0
33586,웅활/Noun,1,1,0,1.1115310228308472e-05,0.0,1.0
33587,언다/Noun,1,1,0,1.1115310228308472e-05,0.0,1.0
33588,.....;/Punctuation,1,1,0,1.1115310228308472e-05,0.0,1.0
33589,다봤넹/Noun,1,1,0,1.1115310228308472e-05,0.0,1.0
33590,트럼/Noun,1,0,1,0.0,1.1106915165381966e-05,1.0
33591,뚜비/Noun,1,0,1,0.0,1.1106915165381966e-05,1.0
33592,보라돌이/Noun,1,0,1,0.0,1.1106915165381966e-05,1.0
33593,...^^~/Punctuation,1,1,0,1.1115310228308472e-05,0.0,1.0
33594,Christmas/Alpha,1,1,0,1.1115310228308472e-05,0.0,1.0
33595,Have/Alpha,1,1,0,1.1115310228308472e-05,0.0,1.0
33596,",~!/Punctuation",1,1,0,1.1115310228308472e-05,0.0,1.0
33597,40시간/Number,1,0,1,0.0,1.1106915165381966e-05,1.0
33598,영화를/Foreign,1,0,1,0.0,1.1106915165381966e-05,1.0
33599,취했는/Noun,1,1,0,1.1115310228308472e-05,0.0,1.0
33600,자작하다/Adjective,1,0,1,0.0,1.1106915165381966e-05,1.0
33601,생명윤리/Noun,1,0,1,0.0,1.1106915165381966e-05,1.0
33602,......................................................................../Punctuation,1,0,1,0.0,1.1106915165381966e-05,1.0
33603,바랫던/Noun,1,0,1,0.0,1.1106915165381966e-05,1.0
33604,꽃가루/Noun,1,0,1,0.0,1.1106915165381966e-05,1.0
33605,헤이헤이/Noun,1,0,1,0.0,1.1106915165381966e-05,1.0
33606,수오/Noun,1,0,1,0.0,1.1106915165381966e-05,1.0
33607,채미/Noun,1,1,0,1.1115310228308472e-05,0.0,1.0
33608,!???/Punctuation,1,0,1,0.0,1.1106915165381966e-05,1.0
33609,플로베르/Noun,1,1,0,1.1115310228308472e-05,0.0,1.0
33610,제레민/Noun,1,0,1,0.0,1.1106915165381966e-05,1.0
33611,가녀리다/Adjective,1,0,1,0.0,1.1106915165381966e-05,1.0
33612,사하라/Noun,1,0,1,0.0,1.1106915165381966e-05,1.0
33613,누가바/Noun,1,0,1,0.0,1.1106915165381966e-05,1.0
33614,모닝커피/Noun,1,1,0,1.1115310228308472e-05,0.0,1.0
33615,하늠/Noun,1,1,0,1.1115310228308472e-05,0.0,1.0
33616,괄련/Noun,1,1,0,1.1115310228308472e-05,0.0,1.0
33617,러웠/Noun,1,1,0,1.1115310228308472e-05,0.0,1.0
33618,웠습/Noun,1,1,0,1.1115310228308472e-05,0.0,1.0
33619,패딩/Noun,1,1,0,1.1115310228308472e-05,0.0,1.0
33620,mv/Alpha,1,0,1,0.0,1.1106915165381966e-05,1.0
33621,항아/Noun,1,0,1,0.0,1.1106915165381966e-05,1.0
33622,쫗아염/Noun,1,1,0,1.1115310228308472e-05,0.0,1.0
33623,숭실대/Noun,1,1,0,1.1115310228308472e-05,0.0,1.0
33624,세버/Noun,1,1,0,1.1115310228308472e-05,0.0,1.0
33625,걸죽/Noun,1,1,0,1.1115310228308472e-05,0.0,1.0
33626,똑똑이/Noun,1,0,1,0.0,1.1106915165381966e-05,1.0
33627,알쏭달쏭/Noun,1,0,1,0.0,1.1106915165381966e-05,1.0
33628,http://movie.naver.com/movie/bi/mi/basic.nhn?code=18465/URL,1,0,1,0.0,1.1106915165381966e-05,1.0
33629,1991/Number,1,0,1,0.0,1.1106915165381966e-05,1.0
33630,Shattered/Alpha,1,0,1,0.0,1.1106915165381966e-05,1.0
33631,나그네/Noun,1,1,0,1.1115310228308472e-05,0.0,1.0
33632,차후/Noun,1,1,0,1.1115310228308472e-05,0.0,1.0
33633,2014등/Number,1,1,0,1.1115310228308472e-05,0.0,1.0
33634,차이니즈/Noun,1,1,0,1.1115310228308472e-05,0.0,1.0
33635,샤오린/Noun,1,1,0,1.1115310228308472e-05,0.0,1.0
33636,대병소장/Noun,1,1,0,1.1115310228308472e-05,0.0,1.0
33637,더비/Noun,1,0,1,0.0,1.1106915165381966e-05,1.0
33638,엘클라시코/Noun,1,0,1,0.0,1.1106915165381966e-05,1.0
33639,뭏/Noun,1,0,1,0.0,1.1106915165381966e-05,1.0
33640,알리오/Noun,1,1,0,1.1115310228308472e-05,0.0,1.0
33641,언넝해/Noun,1,1,0,1.1115310228308472e-05,0.0,1.0
33642,순택/Noun,1,1,0,1.1115310228308472e-05,0.0,1.0
33643,시광/Noun,1,1,0,1.1115310228308472e-05,0.0,1.0
33644,최호/Noun,1,1,0,1.1115310228308472e-05,0.0,1.0
33645,설씨/Noun,1,0,1,0.0,1.1106915165381966e-05,1.0
33646,~-/Punctuation,1,0,1,0.0,1.1106915165381966e-05,1.0
33647,구사해/Noun,1,0,1,0.0,1.1106915165381966e-05,1.0
33648,공겸/Noun,1,0,1,0.0,1.1106915165381966e-05,1.0
33649,펑퍼짐하다/Adjective,1,0,1,0.0,1.1106915165381966e-05,1.0
33650,피프/Noun,1,1,0,1.1115310228308472e-05,0.0,1.0
33651,불이라는/Foreign,1,0,1,0.0,1.1106915165381966e-05,1.0
33652,7천만/Number,1,0,1,0.0,1.1106915165381966e-05,1.0
33653,밭일/Noun,1,1,0,1.1115310228308472e-05,0.0,1.0
33654,논일/Noun,1,1,0,1.1115310228308472e-05,0.0,1.0
33655,개빠들/Noun,1,0,1,0.0,1.1106915165381966e-05,1.0
33656,꽥꽥거렸/Noun,1,0,1,0.0,1.1106915165381966e-05,1.0
33657,아그네스/Noun,1,0,1,0.0,1.1106915165381966e-05,1.0
33658,쓰뤠긔/Noun,1,0,1,0.0,1.1106915165381966e-05,1.0
33659,바람이불어오는곳/Noun,1,1,0,1.1115310228308472e-05,0.0,1.0
33660,Kjy/Alpha,1,1,0,1.1115310228308472e-05,0.0,1.0
33661,카누/Noun,1,0,1,0.0,1.1106915165381966e-05,1.0
33662,셀린디온/Noun,1,1,0,1.1115310228308472e-05,0.0,1.0
33663,IV/Alpha,1,0,1,0.0,1.1106915165381966e-05,1.0
33664,좋쿠/Noun,1,1,0,1.1115310228308472e-05,0.0,1.0
33665,사국/Noun,1,0,1,0.0,1.1106915165381966e-05,1.0
33666,한륰/Noun,1,1,0,1.1115310228308472e-05,0.0,1.0
33667,있으셧내/Noun,1,0,1,0.0,1.1106915165381966e-05,1.0
33668,상항/Noun,1,0,1,0.0,1.1106915165381966e-05,1.0
33669,숄더/Noun,1,1,0,1.1115310228308472e-05,0.0,1.0
33670,타조/Noun,1,0,1,0.0,1.1106915165381966e-05,1.0
33671,놋본/Noun,1,1,0,1.1115310228308472e-05,0.0,1.0
33672,말레이지아/Noun,1,0,1,0.0,1.1106915165381966e-05,1.0
33673,보게됫/Noun,1,1,0,1.1115310228308472e-05,0.0,1.0
33674,한선수/Noun,1,1,0,1.1115310228308472e-05,0.0,1.0
33675,킬미/Noun,1,1,0,1.1115310228308472e-05,0.0,1.0
33676,트날/Noun,1,1,0,1.1115310228308472e-05,0.0,1.0
33677,도지원/Noun,1,1,0,1.1115310228308472e-05,0.0,1.0
33678,스티붕유/Noun,1,0,1,0.0,1.1106915165381966e-05,1.0
33679,돌잔치/Noun,1,1,0,1.1115310228308472e-05,0.0,1.0
33680,경조사/Noun,1,1,0,1.1115310228308472e-05,0.0,1.0
33681,민것/Noun,1,0,1,0.0,1.1106915165381966e-05,1.0
33682,60억/Number,1,1,0,1.1115310228308472e-05,0.0,1.0
33683,호르몬/Noun,1,0,1,0.0,1.1106915165381966e-05,1.0
33684,에티켓/Noun,1,0,1,0.0,1.1106915165381966e-05,1.0
33685,고릴라즈/Noun,1,1,0,1.1115310228308472e-05,0.0,1.0
33686,스타스크림/Noun,1,1,0,1.1115310228308472e-05,0.0,1.0
33687,메각하킬/Noun,1,1,0,1.1115310228308472e-05,0.0,1.0
33688,더빙떄문/Noun,1,0,1,0.0,1.1106915165381966e-05,1.0
33689,ijwsd/Alpha,1,1,0,1.1115310228308472e-05,0.0,1.0
33690,진도명/Noun,1,1,0,1.1115310228308472e-05,0.0,1.0
33691,天下/Foreign,1,1,0,1.1115310228308472e-05,0.0,1.0
33692,파검/Noun,1,1,0,1.1115310228308472e-05,0.0,1.0
33693,궁긍해/Noun,1,1,0,1.1115310228308472e-05,0.0,1.0
33694,유술/Noun,1,0,1,0.0,1.1106915165381966e-05,1.0
33695,찡찡/Noun,1,0,1,0.0,1.1106915165381966e-05,1.0
33696,미몽/Noun,1,0,1,0.0,1.1106915165381966e-05,1.0
33697,진사/Noun,1,0,1,0.0,1.1106915165381966e-05,1.0
33698,호치/Noun,1,0,1,0.0,1.1106915165381966e-05,1.0
33699,뒈졋/Noun,1,0,1,0.0,1.1106915165381966e-05,1.0
33700,치드/Noun,1,1,0,1.1115310228308472e-05,0.0,1.0
33701,피톤/Noun,1,1,0,1.1115310228308472e-05,0.0,1.0
33702,뒤엎어놓/Noun,1,1,0,1.1115310228308472e-05,0.0,1.0
33703,은막/Noun,1,1,0,1.1115310228308472e-05,0.0,1.0
33704,회오리바람/Noun,1,1,0,1.1115310228308472e-05,0.0,1.0
33705,너울/Noun,1,1,0,1.1115310228308472e-05,0.0,1.0
33706,느지막/Noun,1,1,0,1.1115310228308472e-05,0.0,1.0
33707,starwars/Alpha,1,0,1,0.0,1.1106915165381966e-05,1.0
33708,뮬/Noun,1,0,1,0.0,1.1106915165381966e-05,1.0
33709,양상국/Noun,1,0,1,0.0,1.1106915165381966e-05,1.0
33710,내숭/Noun,1,1,0,1.1115310228308472e-05,0.0,1.0
33711,버켄세일/Noun,1,1,0,1.1115310228308472e-05,0.0,1.0
33712,도안되서하나둘씩나간다/Foreign,1,0,1,0.0,1.1106915165381966e-05,1.0
33713,촏잉일때/Noun,1,0,1,0.0,1.1106915165381966e-05,1.0
33714,담뿍/Noun,1,0,1,0.0,1.1106915165381966e-05,1.0
33715,핏물/Noun,1,1,0,1.1115310228308472e-05,0.0,1.0
33716,창살/Noun,1,1,0,1.1115310228308472e-05,0.0,1.0
33717,왓다갓다/Noun,1,1,0,1.1115310228308472e-05,0.0,1.0
33718,대죄/Noun,1,0,1,0.0,1.1106915165381966e-05,1.0
33719,obs/Alpha,1,1,0,1.1115310228308472e-05,0.0,1.0
33720,컴텨/Noun,1,0,1,0.0,1.1106915165381966e-05,1.0
33721,조이스틱/Noun,1,0,1,0.0,1.1106915165381966e-05,1.0
33722,잇힝/Noun,1,0,1,0.0,1.1106915165381966e-05,1.0
33723,.!!!!!!!!!!!!!!!!!!!!!!!!!!!!!!!!!!!!!!!!!!!!!/Punctuation,1,1,0,1.1115310228308472e-05,0.0,1.0
33724,다애/Noun,1,0,1,0.0,1.1106915165381966e-05,1.0
33725,굴절/Noun,1,1,0,1.1115310228308472e-05,0.0,1.0
33726,병짓/Noun,1,1,0,1.1115310228308472e-05,0.0,1.0
33727,픽처스/Noun,1,1,0,1.1115310228308472e-05,0.0,1.0
33728,박윤/Noun,1,0,1,0.0,1.1106915165381966e-05,1.0
33729,회음부/Noun,1,0,1,0.0,1.1106915165381966e-05,1.0
33730,comedy/Alpha,1,1,0,1.1115310228308472e-05,0.0,1.0
33731,romantic/Alpha,1,1,0,1.1115310228308472e-05,0.0,1.0
33732,lesbian/Alpha,1,1,0,1.1115310228308472e-05,0.0,1.0
33733,완젼빠/Noun,1,0,1,0.0,1.1106915165381966e-05,1.0
33734,Sydney/Alpha,1,1,0,1.1115310228308472e-05,0.0,1.0
33735,Wallaby/Alpha,1,1,0,1.1115310228308472e-05,0.0,1.0
33736,Sherman/Alpha,1,1,0,1.1115310228308472e-05,0.0,1.0
33737,아랏/Noun,1,0,1,0.0,1.1106915165381966e-05,1.0
33738,강쇠/Noun,1,0,1,0.0,1.1106915165381966e-05,1.0
33739,머릿결/Noun,1,0,1,0.0,1.1106915165381966e-05,1.0
33740,♡♥♡♥/Foreign,1,1,0,1.1115310228308472e-05,0.0,1.0
33741,선데/Noun,1,1,0,1.1115310228308472e-05,0.0,1.0
33742,어드밴처/Noun,1,0,1,0.0,1.1106915165381966e-05,1.0
33743,환멸감/Noun,1,1,0,1.1115310228308472e-05,0.0,1.0
33744,통햐/Noun,1,0,1,0.0,1.1106915165381966e-05,1.0
33745,～～/Foreign,1,1,0,1.1115310228308472e-05,0.0,1.0
33746,그득하다/Adjective,1,0,1,0.0,1.1106915165381966e-05,1.0
33747,심일/Noun,1,1,0,1.1115310228308472e-05,0.0,1.0
33748,자이몬/Noun,1,1,0,1.1115310228308472e-05,0.0,1.0
33749,시에라리온/Noun,1,1,0,1.1115310228308472e-05,0.0,1.0
33750,라이언즈/Noun,1,1,0,1.1115310228308472e-05,0.0,1.0
33751,악화시키다/Verb,1,0,1,0.0,1.1106915165381966e-05,1.0
33752,입인/Noun,1,0,1,0.0,1.1106915165381966e-05,1.0
33753,파고드/Noun,1,0,1,0.0,1.1106915165381966e-05,1.0
33754,풀쾌/Noun,1,0,1,0.0,1.1106915165381966e-05,1.0
33755,chCGV/Alpha,1,0,1,0.0,1.1106915165381966e-05,1.0
33756,점을/Foreign,1,1,0,1.1115310228308472e-05,0.0,1.0
33757,홍금버/Noun,1,1,0,1.1115310228308472e-05,0.0,1.0
33758,뎄/Noun,1,1,0,1.1115310228308472e-05,0.0,1.0
33759,쉣임/Noun,1,0,1,0.0,1.1106915165381966e-05,1.0
33760,누르기/Noun,1,0,1,0.0,1.1106915165381966e-05,1.0
33761,선댁/Noun,1,0,1,0.0,1.1106915165381966e-05,1.0
33762,~!./Punctuation,1,0,1,0.0,1.1106915165381966e-05,1.0
33763,꼬집힌/Noun,1,0,1,0.0,1.1106915165381966e-05,1.0
33764,xfjdsklafj/Alpha,1,0,1,0.0,1.1106915165381966e-05,1.0
33765,특전팀/Noun,1,0,1,0.0,1.1106915165381966e-05,1.0
33766,갈도/Noun,1,0,1,0.0,1.1106915165381966e-05,1.0
33767,평화로/Noun,1,0,1,0.0,1.1106915165381966e-05,1.0
33768,크랭크/Noun,1,0,1,0.0,1.1106915165381966e-05,1.0
33769,Reflection/Alpha,1,1,0,1.1115310228308472e-05,0.0,1.0
33770,범식/Noun,1,0,1,0.0,1.1106915165381966e-05,1.0
33771,방향키/Noun,1,0,1,0.0,1.1106915165381966e-05,1.0
33772,ㅏㅣㅇ/KoreanParticle,1,0,1,0.0,1.1106915165381966e-05,1.0
33773,뇬놈/Noun,1,1,0,1.1115310228308472e-05,0.0,1.0
33774,얼굴떔/Noun,1,0,1,0.0,1.1106915165381966e-05,1.0
33775,가만두다/Verb,1,0,1,0.0,1.1106915165381966e-05,1.0
33776,러물/Noun,1,0,1,0.0,1.1106915165381966e-05,1.0
33777,통땜/Noun,1,0,1,0.0,1.1106915165381966e-05,1.0
33778,보깜/Noun,1,0,1,0.0,1.1106915165381966e-05,1.0
33779,대접받다/Verb,1,0,1,0.0,1.1106915165381966e-05,1.0
33780,사오리/Noun,1,0,1,0.0,1.1106915165381966e-05,1.0
33781,참매/Noun,1,1,0,1.1115310228308472e-05,0.0,1.0
33782,담독/Noun,1,0,1,0.0,1.1106915165381966e-05,1.0
33783,슬러러/Noun,1,0,1,0.0,1.1106915165381966e-05,1.0
33784,넿/Noun,1,0,1,0.0,1.1106915165381966e-05,1.0
33785,인터/Noun,1,0,1,0.0,1.1106915165381966e-05,1.0
33786,FUUUUCK/Alpha,1,0,1,0.0,1.1106915165381966e-05,1.0
33787,선수권/Noun,1,0,1,0.0,1.1106915165381966e-05,1.0
33788,편성표/Noun,1,0,1,0.0,1.1106915165381966e-05,1.0
33789,잉여인간/Noun,1,1,0,1.1115310228308472e-05,0.0,1.0
33790,보사노바/Noun,1,1,0,1.1115310228308472e-05,0.0,1.0
33791,곻/Noun,1,1,0,1.1115310228308472e-05,0.0,1.0
33792,꼬자/Noun,1,1,0,1.1115310228308472e-05,0.0,1.0
33793,에잌씨/Noun,1,1,0,1.1115310228308472e-05,0.0,1.0
33794,윤재균/Noun,1,0,1,0.0,1.1106915165381966e-05,1.0
33795,LILY/Alpha,1,1,0,1.1115310228308472e-05,0.0,1.0
33796,빙점/Noun,1,1,0,1.1115310228308472e-05,0.0,1.0
33797,사월/Noun,1,1,0,1.1115310228308472e-05,0.0,1.0
33798,각트/Noun,1,1,0,1.1115310228308472e-05,0.0,1.0
33799,별루냉/Noun,1,0,1,0.0,1.1106915165381966e-05,1.0
33800,소트/Noun,1,1,0,1.1115310228308472e-05,0.0,1.0
33801,권현정/Noun,1,1,0,1.1115310228308472e-05,0.0,1.0
33802,Bike/Alpha,1,0,1,0.0,1.1106915165381966e-05,1.0
33803,Commando/Alpha,1,0,1,0.0,1.1106915165381966e-05,1.0
33804,Norton/Alpha,1,0,1,0.0,1.1106915165381966e-05,1.0
33805,동협/Noun,1,0,1,0.0,1.1106915165381966e-05,1.0
33806,~!!^/Punctuation,1,1,0,1.1115310228308472e-05,0.0,1.0
33807,요동/Noun,1,0,1,0.0,1.1106915165381966e-05,1.0
33808,지났고/Foreign,1,0,1,0.0,1.1106915165381966e-05,1.0
33809,괘아낫/Noun,1,1,0,1.1115310228308472e-05,0.0,1.0
33810,쉘든/Noun,1,1,0,1.1115310228308472e-05,0.0,1.0
33811,넌전/Noun,1,1,0,1.1115310228308472e-05,0.0,1.0
33812,멍텅함/Noun,1,0,1,0.0,1.1106915165381966e-05,1.0
33813,테런/Noun,1,1,0,1.1115310228308472e-05,0.0,1.0
33814,점몇/Noun,1,1,0,1.1115310228308472e-05,0.0,1.0
33815,동안이라니/Foreign,1,1,0,1.1115310228308472e-05,0.0,1.0
33816,텔포/Noun,1,0,1,0.0,1.1106915165381966e-05,1.0
33817,6785/Number,1,0,1,0.0,1.1106915165381966e-05,1.0
33818,봣구/Noun,1,1,0,1.1115310228308472e-05,0.0,1.0
33819,디아틀로프/Noun,1,0,1,0.0,1.1106915165381966e-05,1.0
33820,오딧세이/Noun,1,1,0,1.1115310228308472e-05,0.0,1.0
33821,왜짤랐냐/Noun,1,0,1,0.0,1.1106915165381966e-05,1.0
33822,훌룔/Noun,1,1,0,1.1115310228308472e-05,0.0,1.0
33823,거식증/Noun,1,1,0,1.1115310228308472e-05,0.0,1.0
33824,외줄/Noun,1,1,0,1.1115310228308472e-05,0.0,1.0
33825,위테/Noun,1,0,1,0.0,1.1106915165381966e-05,1.0
33826,진척/Noun,1,0,1,0.0,1.1106915165381966e-05,1.0
33827,니넨/Noun,1,0,1,0.0,1.1106915165381966e-05,1.0
33828,7080/Number,1,0,1,0.0,1.1106915165381966e-05,1.0
33829,박수홍/Noun,1,1,0,1.1115310228308472e-05,0.0,1.0
33830,샌드맨/Noun,1,1,0,1.1115310228308472e-05,0.0,1.0
33831,워트/Noun,1,1,0,1.1115310228308472e-05,0.0,1.0
33832,떙떙땡/Noun,1,1,0,1.1115310228308472e-05,0.0,1.0
33833,..::/Punctuation,1,1,0,1.1115310228308472e-05,0.0,1.0
33834,디펜더/Noun,1,0,1,0.0,1.1106915165381966e-05,1.0
33835,롤줄/Noun,1,1,0,1.1115310228308472e-05,0.0,1.0
33836,뚱하다/Adjective,1,1,0,1.1115310228308472e-05,0.0,1.0
33837,도령/Noun,1,0,1,0.0,1.1106915165381966e-05,1.0
33838,목단/Noun,1,1,0,1.1115310228308472e-05,0.0,1.0
33839,쪽나/Noun,1,1,0,1.1115310228308472e-05,0.0,1.0
33840,이나즈마/Noun,1,0,1,0.0,1.1106915165381966e-05,1.0
33841,하쿠류/Noun,1,0,1,0.0,1.1106915165381966e-05,1.0
33842,불앞/Noun,1,1,0,1.1115310228308472e-05,0.0,1.0
33843,Beatles/Alpha,1,1,0,1.1115310228308472e-05,0.0,1.0
33844,3.14159/Number,1,0,1,0.0,1.1106915165381966e-05,1.0
33845,^^^^***/Punctuation,1,0,1,0.0,1.1106915165381966e-05,1.0
33846,잇죵/Noun,1,1,0,1.1115310228308472e-05,0.0,1.0
33847,런치/Noun,1,0,1,0.0,1.1106915165381966e-05,1.0
33848,뜷있늬/Noun,1,0,1,0.0,1.1106915165381966e-05,1.0
33849,스나총/Noun,1,0,1,0.0,1.1106915165381966e-05,1.0
33850,슈빌/Noun,1,0,1,0.0,1.1106915165381966e-05,1.0
33851,science/Alpha,1,1,0,1.1115310228308472e-05,0.0,1.0
33852,신안군/Noun,1,1,0,1.1115310228308472e-05,0.0,1.0
33853,정처/Noun,1,0,1,0.0,1.1106915165381966e-05,1.0
33854,괜객/Noun,1,0,1,0.0,1.1106915165381966e-05,1.0
33855,!?@.@/Punctuation,1,0,1,0.0,1.1106915165381966e-05,1.0
33856,...??)/Punctuation,1,0,1,0.0,1.1106915165381966e-05,1.0
33857,추렸어/Noun,1,1,0,1.1115310228308472e-05,0.0,1.0
33858,;??.();;/Punctuation,1,0,1,0.0,1.1106915165381966e-05,1.0
33859,체리쉬/Noun,1,1,0,1.1115310228308472e-05,0.0,1.0
33860,셍긱/Noun,1,0,1,0.0,1.1106915165381966e-05,1.0
33861,키메/Noun,1,0,1,0.0,1.1106915165381966e-05,1.0
33862,얍삽하/Noun,1,0,1,0.0,1.1106915165381966e-05,1.0
33863,ㅌㅋㅋㅋ/KoreanParticle,1,0,1,0.0,1.1106915165381966e-05,1.0
33864,패스파인더/Noun,1,0,1,0.0,1.1106915165381966e-05,1.0
33865,도안지났는데/Foreign,1,0,1,0.0,1.1106915165381966e-05,1.0
33866,삼각지/Noun,1,0,1,0.0,1.1106915165381966e-05,1.0
33867,버뮤다/Noun,1,0,1,0.0,1.1106915165381966e-05,1.0
33868,어쩜좋으/Noun,1,0,1,0.0,1.1106915165381966e-05,1.0
33869,임상준/Noun,1,1,0,1.1115310228308472e-05,0.0,1.0
33870,모르겄다/Noun,1,0,1,0.0,1.1106915165381966e-05,1.0
33871,종량제/Noun,1,0,1,0.0,1.1106915165381966e-05,1.0
33872,좋었슺니/Noun,1,1,0,1.1115310228308472e-05,0.0,1.0
33873,낫유/Noun,1,1,0,1.1115310228308472e-05,0.0,1.0
33874,쌩얼/Noun,1,1,0,1.1115310228308472e-05,0.0,1.0
33875,7.05/Number,1,1,0,1.1115310228308472e-05,0.0,1.0
33876,부채/Noun,1,0,1,0.0,1.1106915165381966e-05,1.0
33877,울프맨/Noun,1,1,0,1.1115310228308472e-05,0.0,1.0
33878,상쇄될/Noun,1,1,0,1.1115310228308472e-05,0.0,1.0
33879,볼껀데/Noun,1,0,1,0.0,1.1106915165381966e-05,1.0
33880,낚였었/Noun,1,0,1,0.0,1.1106915165381966e-05,1.0
33881,쥑이삔다/Noun,1,0,1,0.0,1.1106915165381966e-05,1.0
33882,눈베렸/Noun,1,0,1,0.0,1.1106915165381966e-05,1.0
33883,마이오/Noun,1,0,1,0.0,1.1106915165381966e-05,1.0
33884,숙/Noun,1,0,1,0.0,1.1106915165381966e-05,1.0
33885,시숙/Noun,1,0,1,0.0,1.1106915165381966e-05,1.0
33886,인쇄/Noun,1,0,1,0.0,1.1106915165381966e-05,1.0
33887,마녀유희/Noun,1,1,0,1.1115310228308472e-05,0.0,1.0
33888,미인대회/Noun,1,0,1,0.0,1.1106915165381966e-05,1.0
33889,비됴빌려온/Noun,1,0,1,0.0,1.1106915165381966e-05,1.0
33890,봤다잉/Noun,1,0,1,0.0,1.1106915165381966e-05,1.0
33891,정음/Noun,1,1,0,1.1115310228308472e-05,0.0,1.0
33892,으쓱/Noun,1,0,1,0.0,1.1106915165381966e-05,1.0
33893,도봣는데/Noun,1,0,1,0.0,1.1106915165381966e-05,1.0
33894,분가/Noun,1,1,0,1.1115310228308472e-05,0.0,1.0
33895,작은어머니/Noun,1,1,0,1.1115310228308472e-05,0.0,1.0
33896,자중/Noun,1,0,1,0.0,1.1106915165381966e-05,1.0
33897,싸랑햐/Noun,1,1,0,1.1115310228308472e-05,0.0,1.0
33898,휘거/Noun,1,1,0,1.1115310228308472e-05,0.0,1.0
33899,변정수/Noun,1,1,0,1.1115310228308472e-05,0.0,1.0
33900,2000초/Number,1,1,0,1.1115310228308472e-05,0.0,1.0
33901,5060/Number,1,0,1,0.0,1.1106915165381966e-05,1.0
33902,목졸렷/Noun,1,1,0,1.1115310228308472e-05,0.0,1.0
33903,일순간/Noun,1,1,0,1.1115310228308472e-05,0.0,1.0
33904,뽀렸다/Noun,1,0,1,0.0,1.1106915165381966e-05,1.0
33905,Merr/Alpha,1,1,0,1.1115310228308472e-05,0.0,1.0
33906,낙지/Noun,1,1,0,1.1115310228308472e-05,0.0,1.0
33907,이겡/Noun,1,0,1,0.0,1.1106915165381966e-05,1.0
33908,썱을거/Noun,1,0,1,0.0,1.1106915165381966e-05,1.0
33909,8282/Number,1,1,0,1.1115310228308472e-05,0.0,1.0
33910,빈번히/Adverb,1,1,0,1.1115310228308472e-05,0.0,1.0
33911,이깐/Modifier,1,0,1,0.0,1.1106915165381966e-05,1.0
33912,천희/Noun,1,1,0,1.1115310228308472e-05,0.0,1.0
33913,사람낚/Noun,1,0,1,0.0,1.1106915165381966e-05,1.0
33914,켓넹/Noun,1,0,1,0.0,1.1106915165381966e-05,1.0
33915,명대/Noun,1,0,1,0.0,1.1106915165381966e-05,1.0
33916,넘게동안/Foreign,1,0,1,0.0,1.1106915165381966e-05,1.0
33917,어머나/Noun,1,0,1,0.0,1.1106915165381966e-05,1.0
33918,힐줄/Noun,1,0,1,0.0,1.1106915165381966e-05,1.0
33919,홍길동전/Noun,1,0,1,0.0,1.1106915165381966e-05,1.0
33920,사회면/Noun,1,0,1,0.0,1.1106915165381966e-05,1.0
33921,ㅍㅖ/KoreanParticle,1,0,1,0.0,1.1106915165381966e-05,1.0
33922,evolution/Alpha,1,0,1,0.0,1.1106915165381966e-05,1.0
33923,르꽁트/Noun,1,1,0,1.1115310228308472e-05,0.0,1.0
33924,파트리스/Noun,1,1,0,1.1115310228308472e-05,0.0,1.0
33925,친지/Noun,1,0,1,0.0,1.1106915165381966e-05,1.0
33926,~~~~~~!!!!!!!!!!!!!!!!!!!!!!!!/Punctuation,1,1,0,1.1115310228308472e-05,0.0,1.0
33927,~~~~~~~~~^^!!!!!!!/Punctuation,1,1,0,1.1115310228308472e-05,0.0,1.0
33928,최은설/Noun,1,1,0,1.1115310228308472e-05,0.0,1.0
33929,",,,,,,,,,,,,,,,,,,,,,,,,,,,,,,,/Punctuation",1,1,0,1.1115310228308472e-05,0.0,1.0
33930,??!?!?/Punctuation,1,0,1,0.0,1.1106915165381966e-05,1.0
33931,촘촘하/Noun,1,1,0,1.1115310228308472e-05,0.0,1.0
33932,름답다/Noun,1,1,0,1.1115310228308472e-05,0.0,1.0
33933,괜찬군/Noun,1,1,0,1.1115310228308472e-05,0.0,1.0
33934,투구꽃/Noun,1,0,1,0.0,1.1106915165381966e-05,1.0
33935,본상/Noun,1,1,0,1.1115310228308472e-05,0.0,1.0
33936,움찔거리다/Verb,1,1,0,1.1115310228308472e-05,0.0,1.0
33937,씁슬함/Noun,1,1,0,1.1115310228308472e-05,0.0,1.0
33938,밍나/Noun,1,0,1,0.0,1.1106915165381966e-05,1.0
33939,딱인드/Noun,1,1,0,1.1115310228308472e-05,0.0,1.0
33940,정도볼려다가시간가는줄/Foreign,1,1,0,1.1115310228308472e-05,0.0,1.0
33941,쎅씨/Noun,1,1,0,1.1115310228308472e-05,0.0,1.0
33942,요조숙녀/Noun,1,1,0,1.1115310228308472e-05,0.0,1.0
33943,행로/Noun,1,1,0,1.1115310228308472e-05,0.0,1.0
33944,축구팀/Noun,1,0,1,0.0,1.1106915165381966e-05,1.0
33945,ㅛㅕ/KoreanParticle,1,1,0,1.1115310228308472e-05,0.0,1.0
33946,쇼호/Noun,1,1,0,1.1115310228308472e-05,0.0,1.0
33947,보고있는게/Foreign,1,0,1,0.0,1.1106915165381966e-05,1.0
33948,마장/Noun,1,0,1,0.0,1.1106915165381966e-05,1.0
33949,춧/Noun,1,0,1,0.0,1.1106915165381966e-05,1.0
33950,대우주/Noun,1,0,1,0.0,1.1106915165381966e-05,1.0
33951,토랜트/Noun,1,0,1,0.0,1.1106915165381966e-05,1.0
33952,강추입/Noun,1,1,0,1.1115310228308472e-05,0.0,1.0
33953,길티크라운/Noun,1,1,0,1.1115310228308472e-05,0.0,1.0
33954,애니상/Noun,1,1,0,1.1115310228308472e-05,0.0,1.0
33955,템페스트/Noun,1,1,0,1.1115310228308472e-05,0.0,1.0
33956,버무러/Noun,1,1,0,1.1115310228308472e-05,0.0,1.0
33957,프렌/Noun,1,1,0,1.1115310228308472e-05,0.0,1.0
33958,우투/Noun,1,1,0,1.1115310228308472e-05,0.0,1.0
33959,쎄이/Noun,1,1,0,1.1115310228308472e-05,0.0,1.0
33960,드마라/Noun,1,1,0,1.1115310228308472e-05,0.0,1.0
33961,눈물겨웠/Noun,1,1,0,1.1115310228308472e-05,0.0,1.0
33962,ㅇㅋㄷㅋ/KoreanParticle,1,0,1,0.0,1.1106915165381966e-05,1.0
33963,제수/Noun,1,0,1,0.0,1.1106915165381966e-05,1.0
33964,건욱/Noun,1,0,1,0.0,1.1106915165381966e-05,1.0
33965,감졸/Noun,1,0,1,0.0,1.1106915165381966e-05,1.0
33966,헛발질/Noun,1,0,1,0.0,1.1106915165381966e-05,1.0
33967,별똥별/Noun,1,1,0,1.1115310228308472e-05,0.0,1.0
33968,에브리데이/Noun,1,1,0,1.1115310228308472e-05,0.0,1.0
33969,루에다/Noun,1,1,0,1.1115310228308472e-05,0.0,1.0
33970,벨렌/Noun,1,1,0,1.1115310228308472e-05,0.0,1.0
33971,Smmms/Alpha,1,1,0,1.1115310228308472e-05,0.0,1.0
33972,~^.^*/Punctuation,1,1,0,1.1115310228308472e-05,0.0,1.0
33973,"..)""/Punctuation",1,0,1,0.0,1.1106915165381966e-05,1.0
33974,네비게이션/Noun,1,0,1,0.0,1.1106915165381966e-05,1.0
33975,알비/Noun,1,0,1,0.0,1.1106915165381966e-05,1.0
33976,엘리야/Noun,1,1,0,1.1115310228308472e-05,0.0,1.0
33977,원호/Noun,1,0,1,0.0,1.1106915165381966e-05,1.0
33978,중률/Noun,1,0,1,0.0,1.1106915165381966e-05,1.0
33979,시집살이/Noun,1,0,1,0.0,1.1106915165381966e-05,1.0
33980,장영란/Noun,1,0,1,0.0,1.1106915165381966e-05,1.0
33981,딸역/Noun,1,0,1,0.0,1.1106915165381966e-05,1.0
33982,꾸르르르잼/Noun,1,1,0,1.1115310228308472e-05,0.0,1.0
33983,피블스/Noun,1,0,1,0.0,1.1106915165381966e-05,1.0
33984,?......./Punctuation,1,0,1,0.0,1.1106915165381966e-05,1.0
33985,로껀/Noun,1,1,0,1.1115310228308472e-05,0.0,1.0
33986,노동법/Noun,1,1,0,1.1115310228308472e-05,0.0,1.0
33987,미용사/Noun,1,1,0,1.1115310228308472e-05,0.0,1.0
33988,완연/Noun,1,0,1,0.0,1.1106915165381966e-05,1.0
33989,굴착기/Noun,1,0,1,0.0,1.1106915165381966e-05,1.0
33990,널림/Noun,1,0,1,0.0,1.1106915165381966e-05,1.0
33991,달쏭/Noun,1,1,0,1.1115310228308472e-05,0.0,1.0
33992,알쏭/Noun,1,1,0,1.1115310228308472e-05,0.0,1.0
33993,가오가이가/Noun,1,1,0,1.1115310228308472e-05,0.0,1.0
33994,사자왕/Noun,1,1,0,1.1115310228308472e-05,0.0,1.0
33995,오나니/Noun,1,0,1,0.0,1.1106915165381966e-05,1.0
33996,판엠/Noun,1,1,0,1.1115310228308472e-05,0.0,1.0
33997,개패/Noun,1,1,0,1.1115310228308472e-05,0.0,1.0
33998,4:3/Number,1,1,0,1.1115310228308472e-05,0.0,1.0
33999,화면비율/Noun,1,1,0,1.1115310228308472e-05,0.0,1.0
34000,sword/Alpha,1,1,0,1.1115310228308472e-05,0.0,1.0
34001,Bitsnoop/Alpha,1,1,0,1.1115310228308472e-05,0.0,1.0
34002,코똔/Noun,1,1,0,1.1115310228308472e-05,0.0,1.0
34003,신홬/Noun,1,1,0,1.1115310228308472e-05,0.0,1.0
34004,이나걸려라중독되겟다/Foreign,1,0,1,0.0,1.1106915165381966e-05,1.0
34005,gang/Alpha,1,0,1,0.0,1.1106915165381966e-05,1.0
34006,Lyonnais/Alpha,1,0,1,0.0,1.1106915165381966e-05,1.0
34007,쓰레긴/Noun,1,0,1,0.0,1.1106915165381966e-05,1.0
34008,정유빈/Noun,1,1,0,1.1115310228308472e-05,0.0,1.0
34009,판타스딕/Noun,1,1,0,1.1115310228308472e-05,0.0,1.0
34010,두주니/Noun,1,1,0,1.1115310228308472e-05,0.0,1.0
34011,바랬는대/Noun,1,0,1,0.0,1.1106915165381966e-05,1.0
34012,ㅜㅜㅋㅋ/KoreanParticle,1,1,0,1.1115310228308472e-05,0.0,1.0
34013,재법/Noun,1,1,0,1.1115310228308472e-05,0.0,1.0
34014,트름같/Noun,1,0,1,0.0,1.1106915165381966e-05,1.0
34015,게머애/Noun,1,0,1,0.0,1.1106915165381966e-05,1.0
34016,슈햇/Noun,1,0,1,0.0,1.1106915165381966e-05,1.0
34017,후랑/Foreign,1,0,1,0.0,1.1106915165381966e-05,1.0
34018,파랑색/Noun,1,1,0,1.1115310228308472e-05,0.0,1.0
34019,판본/Noun,1,1,0,1.1115310228308472e-05,0.0,1.0
34020,아선/Eomi,1,0,1,0.0,1.1106915165381966e-05,1.0
34021,ㄷㅂ/KoreanParticle,1,1,0,1.1115310228308472e-05,0.0,1.0
34022,10~20분/Number,1,0,1,0.0,1.1106915165381966e-05,1.0
34023,러러/Noun,1,0,1,0.0,1.1106915165381966e-05,1.0
34024,욱끼/Noun,1,0,1,0.0,1.1106915165381966e-05,1.0
34025,1~10/Number,1,1,0,1.1115310228308472e-05,0.0,1.0
34026,EOD/Alpha,1,1,0,1.1115310228308472e-05,0.0,1.0
34027,무기징역/Noun,1,1,0,1.1115310228308472e-05,0.0,1.0
34028,잼임/Noun,1,1,0,1.1115310228308472e-05,0.0,1.0
34029,????????????????????????????????????/Punctuation,1,0,1,0.0,1.1106915165381966e-05,1.0
34030,윌버/Noun,1,1,0,1.1115310228308472e-05,0.0,1.0
34031,꺴음/Noun,1,0,1,0.0,1.1106915165381966e-05,1.0
34032,FRP/Alpha,1,0,1,0.0,1.1106915165381966e-05,1.0
34033,비닐/Noun,1,0,1,0.0,1.1106915165381966e-05,1.0
34034,닭살멘트/Noun,1,1,0,1.1115310228308472e-05,0.0,1.0
34035,비엡이들/Noun,1,0,1,0.0,1.1106915165381966e-05,1.0
34036,않그레/Noun,1,0,1,0.0,1.1106915165381966e-05,1.0
34037,않을껄/Noun,1,0,1,0.0,1.1106915165381966e-05,1.0
34038,춤작/Noun,1,0,1,0.0,1.1106915165381966e-05,1.0
34039,바콜/Noun,1,1,0,1.1115310228308472e-05,0.0,1.0
34040,허세쩌/Noun,1,0,1,0.0,1.1106915165381966e-05,1.0
34041,대두/Noun,1,1,0,1.1115310228308472e-05,0.0,1.0
34042,문지은/Noun,1,1,0,1.1115310228308472e-05,0.0,1.0
34043,지긋지긋/Noun,1,0,1,0.0,1.1106915165381966e-05,1.0
34044,짜글거리다/Verb,1,0,1,0.0,1.1106915165381966e-05,1.0
34045,SFX/Alpha,1,1,0,1.1115310228308472e-05,0.0,1.0
34046,더머/Noun,1,1,0,1.1115310228308472e-05,0.0,1.0
34047,소지품/Noun,1,0,1,0.0,1.1106915165381966e-05,1.0
34048,호작/Noun,1,1,0,1.1115310228308472e-05,0.0,1.0
34049,^^&../Punctuation,1,0,1,0.0,1.1106915165381966e-05,1.0
34050,어건/Noun,1,0,1,0.0,1.1106915165381966e-05,1.0
34051,셤기간/Noun,1,1,0,1.1115310228308472e-05,0.0,1.0
34052,하주/Noun,1,1,0,1.1115310228308472e-05,0.0,1.0
34053,카섹씬/Noun,1,0,1,0.0,1.1106915165381966e-05,1.0
34054,김현수/Noun,1,0,1,0.0,1.1106915165381966e-05,1.0
34055,척해/Noun,1,0,1,0.0,1.1106915165381966e-05,1.0
34056,궁중잔혹사/Noun,1,1,0,1.1115310228308472e-05,0.0,1.0
34057,번듯하다/Adjective,1,1,0,1.1115310228308472e-05,0.0,1.0
34058,전영화지만/Foreign,1,1,0,1.1115310228308472e-05,0.0,1.0
34059,콘센트/Noun,1,1,0,1.1115310228308472e-05,0.0,1.0
34060,귀빈/Noun,1,1,0,1.1115310228308472e-05,0.0,1.0
34061,떳어/Noun,1,0,1,0.0,1.1106915165381966e-05,1.0
34062,과식/Noun,1,0,1,0.0,1.1106915165381966e-05,1.0
34063,성원/Noun,1,0,1,0.0,1.1106915165381966e-05,1.0
34064,162/Number,1,0,1,0.0,1.1106915165381966e-05,1.0
34065,찍넴/Noun,1,0,1,0.0,1.1106915165381966e-05,1.0
34066,일쑤/Noun,1,0,1,0.0,1.1106915165381966e-05,1.0
34067,무협소설/Noun,1,1,0,1.1115310228308472e-05,0.0,1.0
34068,걸판/Noun,1,0,1,0.0,1.1106915165381966e-05,1.0
34069,크메르루주/Noun,1,1,0,1.1115310228308472e-05,0.0,1.0
34070,레긔/Noun,1,0,1,0.0,1.1106915165381966e-05,1.0
34071,헤로인/Noun,1,1,0,1.1115310228308472e-05,0.0,1.0
34072,자겄데/Noun,1,0,1,0.0,1.1106915165381966e-05,1.0
34073,해보슈/Noun,1,0,1,0.0,1.1106915165381966e-05,1.0
34074,견문/Noun,1,0,1,0.0,1.1106915165381966e-05,1.0
34075,묘합/Noun,1,1,0,1.1115310228308472e-05,0.0,1.0
34076,사야카/Noun,1,1,0,1.1115310228308472e-05,0.0,1.0
34077,산산이/Noun,1,0,1,0.0,1.1106915165381966e-05,1.0
34078,더듬이/Noun,1,1,0,1.1115310228308472e-05,0.0,1.0
34079,자밀라/Noun,1,0,1,0.0,1.1106915165381966e-05,1.0
34080,레다/Noun,1,0,1,0.0,1.1106915165381966e-05,1.0
34081,웨든/Noun,1,0,1,0.0,1.1106915165381966e-05,1.0
34082,목풀/Noun,1,0,1,0.0,1.1106915165381966e-05,1.0
34083,한센/Noun,1,1,0,1.1115310228308472e-05,0.0,1.0
34084,순간포착/Noun,1,1,0,1.1115310228308472e-05,0.0,1.0
34085,랭랭/Noun,1,0,1,0.0,1.1106915165381966e-05,1.0
34086,roles/Alpha,1,1,0,1.1115310228308472e-05,0.0,1.0
34087,ㅛㅓ/KoreanParticle,1,1,0,1.1115310228308472e-05,0.0,1.0
34088,".....,/Punctuation",1,0,1,0.0,1.1106915165381966e-05,1.0
34089,개역/Noun,1,0,1,0.0,1.1106915165381966e-05,1.0
34090,피티김/Noun,1,0,1,0.0,1.1106915165381966e-05,1.0
34091,더빽/Noun,1,0,1,0.0,1.1106915165381966e-05,1.0
34092,주주/Noun,1,0,1,0.0,1.1106915165381966e-05,1.0
34093,협동조합/Noun,1,0,1,0.0,1.1106915165381966e-05,1.0
34094,elwlsek/Alpha,1,0,1,0.0,1.1106915165381966e-05,1.0
34095,tlqkftorRLdi/Alpha,1,0,1,0.0,1.1106915165381966e-05,1.0
34096,rkaehr/Alpha,1,0,1,0.0,1.1106915165381966e-05,1.0
34097,서둘다/Verb,1,0,1,0.0,1.1106915165381966e-05,1.0
34098,마움/Noun,1,1,0,1.1115310228308472e-05,0.0,1.0
34099,도셨/Noun,1,0,1,0.0,1.1106915165381966e-05,1.0
34100,벵벵/Noun,1,0,1,0.0,1.1106915165381966e-05,1.0
34101,준용/Noun,1,1,0,1.1115310228308472e-05,0.0,1.0
34102,인기가요/Noun,1,0,1,0.0,1.1106915165381966e-05,1.0
34103,재방볼때/Noun,1,1,0,1.1115310228308472e-05,0.0,1.0
34104,Prologue/Alpha,1,0,1,0.0,1.1106915165381966e-05,1.0
34105,Kiss/Alpha,1,0,1,0.0,1.1106915165381966e-05,1.0
34106,Bela/Alpha,1,0,1,0.0,1.1106915165381966e-05,1.0
34107,사이키델릭/Noun,1,0,1,0.0,1.1106915165381966e-05,1.0
34108,벽난로/Noun,1,1,0,1.1115310228308472e-05,0.0,1.0
34109,지폐/Noun,1,1,0,1.1115310228308472e-05,0.0,1.0
34110,1:55/Number,1,0,1,0.0,1.1106915165381966e-05,1.0
34111,그엣전/Noun,1,1,0,1.1115310228308472e-05,0.0,1.0
34112,신산하다/Adjective,1,1,0,1.1115310228308472e-05,0.0,1.0
34113,홍가혜/Noun,1,0,1,0.0,1.1106915165381966e-05,1.0
34114,시청각/Noun,1,0,1,0.0,1.1106915165381966e-05,1.0
34115,진태/Noun,1,1,0,1.1115310228308472e-05,0.0,1.0
34116,태휘날/Noun,1,1,0,1.1115310228308472e-05,0.0,1.0
34117,ㄷㄴㄷㅅㄷㅅㄷㅇㄷㅎㅈㅆㅅㄹ/KoreanParticle,1,0,1,0.0,1.1106915165381966e-05,1.0
34118,복근/Noun,1,0,1,0.0,1.1106915165381966e-05,1.0
34119,재물/Noun,1,1,0,1.1115310228308472e-05,0.0,1.0
34120,컷컷/Noun,1,0,1,0.0,1.1106915165381966e-05,1.0
34121,ㅛㅂ/KoreanParticle,1,1,0,1.1115310228308472e-05,0.0,1.0
34122,ㅎㄱ/KoreanParticle,1,0,1,0.0,1.1106915165381966e-05,1.0
34123,쳬/Noun,1,0,1,0.0,1.1106915165381966e-05,1.0
34124,ㅍㅋ/KoreanParticle,1,0,1,0.0,1.1106915165381966e-05,1.0
34125,ㅅㄱㅃ/KoreanParticle,1,0,1,0.0,1.1106915165381966e-05,1.0
34126,게시/Noun,1,0,1,0.0,1.1106915165381966e-05,1.0
34127,형장/Noun,1,0,1,0.0,1.1106915165381966e-05,1.0
34128,졸잼꿀잼임/Noun,1,1,0,1.1115310228308472e-05,0.0,1.0
34129,요긴/Noun,1,0,1,0.0,1.1106915165381966e-05,1.0
34130,날때눈/Noun,1,0,1,0.0,1.1106915165381966e-05,1.0
34131,롤렌드/Noun,1,0,1,0.0,1.1106915165381966e-05,1.0
34132,알멩/Noun,1,0,1,0.0,1.1106915165381966e-05,1.0
34133,선현/Noun,1,1,0,1.1115310228308472e-05,0.0,1.0
34134,위업/Noun,1,1,0,1.1115310228308472e-05,0.0,1.0
34135,내사랑내곁에/Noun,1,1,0,1.1115310228308472e-05,0.0,1.0
34136,느므조타/Noun,1,1,0,1.1115310228308472e-05,0.0,1.0
34137,부르다/Adjective,1,1,0,1.1115310228308472e-05,0.0,1.0
34138,어휴샹/Noun,1,0,1,0.0,1.1106915165381966e-05,1.0
34139,?...;;/Punctuation,1,0,1,0.0,1.1106915165381966e-05,1.0
34140,조종실/Noun,1,0,1,0.0,1.1106915165381966e-05,1.0
34141,윈스턴/Noun,1,1,0,1.1115310228308472e-05,0.0,1.0
34142,디렉팅/Noun,1,0,1,0.0,1.1106915165381966e-05,1.0
34143,냉큼/Noun,1,0,1,0.0,1.1106915165381966e-05,1.0
34144,だ。/Foreign,1,1,0,1.1115310228308472e-05,0.0,1.0
34145,最高の映/Foreign,1,1,0,1.1115310228308472e-05,0.0,1.0
34146,봤더랬/Noun,1,0,1,0.0,1.1106915165381966e-05,1.0
34147,김재덕/Noun,1,0,1,0.0,1.1106915165381966e-05,1.0
34148,흑막/Noun,1,0,1,0.0,1.1106915165381966e-05,1.0
34149,셍각/Noun,1,0,1,0.0,1.1106915165381966e-05,1.0
34150,philadelpia/Alpha,1,1,0,1.1115310228308472e-05,0.0,1.0
34151,street/Alpha,1,1,0,1.1115310228308472e-05,0.0,1.0
34152,인반/Noun,1,1,0,1.1115310228308472e-05,0.0,1.0
34153,특수본/Noun,1,0,1,0.0,1.1106915165381966e-05,1.0
34154,도룡뇽/Noun,1,1,0,1.1115310228308472e-05,0.0,1.0
34155,츄이/Noun,1,1,0,1.1115310228308472e-05,0.0,1.0
34156,판타/Noun,1,0,1,0.0,1.1106915165381966e-05,1.0
34157,츠루기/Noun,1,1,0,1.1115310228308472e-05,0.0,1.0
34158,텐마/Noun,1,1,0,1.1115310228308472e-05,0.0,1.0
34159,할버지/Noun,1,1,0,1.1115310228308472e-05,0.0,1.0
34160,~!'/Punctuation,1,1,0,1.1115310228308472e-05,0.0,1.0
34161,싱감/Noun,1,1,0,1.1115310228308472e-05,0.0,1.0
34162,꼬끝찡할때/Noun,1,1,0,1.1115310228308472e-05,0.0,1.0
34163,짧게지나감/Foreign,1,1,0,1.1115310228308472e-05,0.0,1.0
34164,;_/Punctuation,1,1,0,1.1115310228308472e-05,0.0,1.0
34165,마르케/Noun,1,1,0,1.1115310228308472e-05,0.0,1.0
34166,때접/Noun,1,1,0,1.1115310228308472e-05,0.0,1.0
34167,살생/Noun,1,0,1,0.0,1.1106915165381966e-05,1.0
34168,물랑/Noun,1,0,1,0.0,1.1106915165381966e-05,1.0
34169,-.-../Punctuation,1,0,1,0.0,1.1106915165381966e-05,1.0
34170,슈네빠/Noun,1,0,1,0.0,1.1106915165381966e-05,1.0
34171,바가지머리/Noun,1,0,1,0.0,1.1106915165381966e-05,1.0
34172,몽골말/Noun,1,0,1,0.0,1.1106915165381966e-05,1.0
34173,;;;;.../Punctuation,1,0,1,0.0,1.1106915165381966e-05,1.0
34174,너무슬펏다/Noun,1,1,0,1.1115310228308472e-05,0.0,1.0
34175,돈아깝딘/Noun,1,0,1,0.0,1.1106915165381966e-05,1.0
34176,쿠리야마/Noun,1,0,1,0.0,1.1106915165381966e-05,1.0
34177,완화/Noun,1,0,1,0.0,1.1106915165381966e-05,1.0
34178,책찜/Noun,1,0,1,0.0,1.1106915165381966e-05,1.0
34179,젬있을라/Noun,1,0,1,0.0,1.1106915165381966e-05,1.0
34180,남전/Noun,1,0,1,0.0,1.1106915165381966e-05,1.0
34181,탱고씬/Noun,1,1,0,1.1115310228308472e-05,0.0,1.0
34182,".,,../Punctuation",1,0,1,0.0,1.1106915165381966e-05,1.0
34183,종마/Noun,1,0,1,0.0,1.1106915165381966e-05,1.0
34184,할랫/Noun,1,0,1,0.0,1.1106915165381966e-05,1.0
34185,바베트/Noun,1,0,1,0.0,1.1106915165381966e-05,1.0
34186,듀스/Noun,1,1,0,1.1115310228308472e-05,0.0,1.0
34187,자채/Noun,1,1,0,1.1115310228308472e-05,0.0,1.0
34188,닻별/Noun,1,1,0,1.1115310228308472e-05,0.0,1.0
34189,잡아먹히다/Verb,1,0,1,0.0,1.1106915165381966e-05,1.0
34190,공대생/Noun,1,1,0,1.1115310228308472e-05,0.0,1.0
34191,다흐/Noun,1,0,1,0.0,1.1106915165381966e-05,1.0
34192,:->/Punctuation,1,1,0,1.1115310228308472e-05,0.0,1.0
34193,랭크될/Noun,1,1,0,1.1115310228308472e-05,0.0,1.0
34194,죳운지/Noun,1,0,1,0.0,1.1106915165381966e-05,1.0
34195,Panabaker/Alpha,1,1,0,1.1115310228308472e-05,0.0,1.0
34196,Kay/Alpha,1,1,0,1.1115310228308472e-05,0.0,1.0
34197,투병/Noun,1,1,0,1.1115310228308472e-05,0.0,1.0
34198,한시각/Noun,1,0,1,0.0,1.1106915165381966e-05,1.0
34199,78회/Number,1,0,1,0.0,1.1106915165381966e-05,1.0
34200,전속/Noun,1,0,1,0.0,1.1106915165381966e-05,1.0
34201,♬♬♬♬/Foreign,1,0,1,0.0,1.1106915165381966e-05,1.0
34202,점정도/Foreign,1,1,0,1.1115310228308472e-05,0.0,1.0
34203,어머님께/Noun,1,1,0,1.1115310228308472e-05,0.0,1.0
34204,느그/Noun,1,1,0,1.1115310228308472e-05,0.0,1.0
34205,무뎌져/Noun,1,0,1,0.0,1.1106915165381966e-05,1.0
34206,이넘는시간동안/Foreign,1,1,0,1.1115310228308472e-05,0.0,1.0
34207,댕겨/Noun,1,0,1,0.0,1.1106915165381966e-05,1.0
34208,뮤티즌/Noun,1,0,1,0.0,1.1106915165381966e-05,1.0
34209,②/Foreign,1,0,1,0.0,1.1106915165381966e-05,1.0
34210,독득/Noun,1,1,0,1.1115310228308472e-05,0.0,1.0
34211,박영재/Noun,1,1,0,1.1115310228308472e-05,0.0,1.0
34212,쿨내나다/Verb,1,1,0,1.1115310228308472e-05,0.0,1.0
34213,주탱/Noun,1,0,1,0.0,1.1106915165381966e-05,1.0
34214,똥통년/Noun,1,0,1,0.0,1.1106915165381966e-05,1.0
34215,곰치/Noun,1,0,1,0.0,1.1106915165381966e-05,1.0
34216,김진규/Noun,1,1,0,1.1115310228308472e-05,0.0,1.0
34217,준치/Noun,1,1,0,1.1115310228308472e-05,0.0,1.0
34218,무흥/Noun,1,1,0,1.1115310228308472e-05,0.0,1.0
34219,".,....>_/Punctuation",1,1,0,1.1115310228308472e-05,0.0,1.0
34220,마이아/Noun,1,0,1,0.0,1.1106915165381966e-05,1.0
34221,kakao/Alpha,1,0,1,0.0,1.1106915165381966e-05,1.0
34222,록산/Noun,1,1,0,1.1115310228308472e-05,0.0,1.0
34223,잔대/Noun,1,0,1,0.0,1.1106915165381966e-05,1.0
34224,julie/Alpha,1,0,1,0.0,1.1106915165381966e-05,1.0
34225,섬왜/Noun,1,1,0,1.1115310228308472e-05,0.0,1.0
34226,갂으셨다/Noun,1,0,1,0.0,1.1106915165381966e-05,1.0
34227,헑/Noun,1,0,1,0.0,1.1106915165381966e-05,1.0
34228,학생졸업작품느낌/Foreign,1,0,1,0.0,1.1106915165381966e-05,1.0
34229,아윌백/Noun,1,0,1,0.0,1.1106915165381966e-05,1.0
34230,벨라도나/Noun,1,1,0,1.1115310228308472e-05,0.0,1.0
34231,삼팔육/Noun,1,0,1,0.0,1.1106915165381966e-05,1.0
34232,♥♥♥♥♥♥♥♥♥♥♥♥♥♥♥♥♥♥♥♥♥♥♥♥♥♥♥/Foreign,1,1,0,1.1115310228308472e-05,0.0,1.0
34233,완젼잘생겻음/Noun,1,1,0,1.1115310228308472e-05,0.0,1.0
34234,뇌까릴떄/Noun,1,0,1,0.0,1.1106915165381966e-05,1.0
34235,침상/Noun,1,0,1,0.0,1.1106915165381966e-05,1.0
34236,클램프/Noun,1,0,1,0.0,1.1106915165381966e-05,1.0
34237,뻬낀/Noun,1,0,1,0.0,1.1106915165381966e-05,1.0
34238,오키/Noun,1,1,0,1.1115310228308472e-05,0.0,1.0
34239,엇그제/Noun,1,1,0,1.1115310228308472e-05,0.0,1.0
34240,655/Number,1,0,1,0.0,1.1106915165381966e-05,1.0
34241,ㅌㄴㅇㄱㄹ/KoreanParticle,1,0,1,0.0,1.1106915165381966e-05,1.0
34242,못때/Noun,1,1,0,1.1115310228308472e-05,0.0,1.0
34243,강된장/Noun,1,0,1,0.0,1.1106915165381966e-05,1.0
34244,개쒜리개쒜리/Noun,1,0,1,0.0,1.1106915165381966e-05,1.0
34245,공황장애/Noun,1,0,1,0.0,1.1106915165381966e-05,1.0
34246,부부인/Noun,1,1,0,1.1115310228308472e-05,0.0,1.0
34247,맹량/Noun,1,1,0,1.1115310228308472e-05,0.0,1.0
34248,하묘/Noun,1,0,1,0.0,1.1106915165381966e-05,1.0
34249,탄넨바움/Noun,1,1,0,1.1115310228308472e-05,0.0,1.0
34250,파리하다/Adjective,1,0,1,0.0,1.1106915165381966e-05,1.0
34251,빛바랜듯/Noun,1,1,0,1.1115310228308472e-05,0.0,1.0
34252,40만원/Number,1,0,1,0.0,1.1106915165381966e-05,1.0
34253,들어주세요/Foreign,1,1,0,1.1115310228308472e-05,0.0,1.0
34254,↖/Foreign,1,1,0,1.1115310228308472e-05,0.0,1.0
34255,들어주시면제목숨걸고구가의서끝날떼까지/Foreign,1,1,0,1.1115310228308472e-05,0.0,1.0
34256,이상설/Noun,1,1,0,1.1115310228308472e-05,0.0,1.0
34257,솓아나/Noun,1,1,0,1.1115310228308472e-05,0.0,1.0
34258,샤크테일/Noun,1,0,1,0.0,1.1106915165381966e-05,1.0
34259,안산시/Noun,1,1,0,1.1115310228308472e-05,0.0,1.0
34260,세긴/Noun,1,1,0,1.1115310228308472e-05,0.0,1.0
34261,에어포스원/Noun,1,1,0,1.1115310228308472e-05,0.0,1.0
34262,요듬/Noun,1,1,0,1.1115310228308472e-05,0.0,1.0
34263,신분증/Noun,1,0,1,0.0,1.1106915165381966e-05,1.0
34264,귀결/Noun,1,0,1,0.0,1.1106915165381966e-05,1.0
34265,쎅시/Noun,1,0,1,0.0,1.1106915165381966e-05,1.0
34266,박재상/Noun,1,0,1,0.0,1.1106915165381966e-05,1.0
34267,사사/Noun,1,0,1,0.0,1.1106915165381966e-05,1.0
34268,옴뫄/Noun,1,0,1,0.0,1.1106915165381966e-05,1.0
34269,원프로덕션/Noun,1,0,1,0.0,1.1106915165381966e-05,1.0
34270,긑나지/Noun,1,0,1,0.0,1.1106915165381966e-05,1.0
34271,건대역/Noun,1,1,0,1.1115310228308472e-05,0.0,1.0
34272,신사역/Noun,1,1,0,1.1115310228308472e-05,0.0,1.0
34273,터트린/Noun,1,0,1,0.0,1.1106915165381966e-05,1.0
34274,~!(^-^)//Punctuation,1,1,0,1.1115310228308472e-05,0.0,1.0
34275,선잠/Noun,1,0,1,0.0,1.1106915165381966e-05,1.0
34276,꺼맹/Noun,1,1,0,1.1115310228308472e-05,0.0,1.0
34277,괴도/Noun,1,1,0,1.1115310228308472e-05,0.0,1.0
34278,거닷/Noun,1,1,0,1.1115310228308472e-05,0.0,1.0
34279,요쿠르트/Noun,1,1,0,1.1115310228308472e-05,0.0,1.0
34280,도답지않은영화/Foreign,1,1,0,1.1115310228308472e-05,0.0,1.0
34281,존엄사/Noun,1,1,0,1.1115310228308472e-05,0.0,1.0
34282,"!!!!,,/Punctuation",1,0,1,0.0,1.1106915165381966e-05,1.0
34283,래도/Eomi,1,0,1,0.0,1.1106915165381966e-05,1.0
34284,국말이/Noun,1,0,1,0.0,1.1106915165381966e-05,1.0
34285,밤중/Noun,1,1,0,1.1115310228308472e-05,0.0,1.0
34286,END/Alpha,1,1,0,1.1115310228308472e-05,0.0,1.0
34287,윤제/Noun,1,1,0,1.1115310228308472e-05,0.0,1.0
34288,외마디/Noun,1,1,0,1.1115310228308472e-05,0.0,1.0
34289,세드윅/Noun,1,1,0,1.1115310228308472e-05,0.0,1.0
34290,수백만/Modifier,1,1,0,1.1115310228308472e-05,0.0,1.0
34291,RATM/Alpha,1,1,0,1.1115310228308472e-05,0.0,1.0
34292,소액/Noun,1,0,1,0.0,1.1106915165381966e-05,1.0
34293,chef/Alpha,1,0,1,0.0,1.1106915165381966e-05,1.0
34294,???!!!/Punctuation,1,0,1,0.0,1.1106915165381966e-05,1.0
34295,뭐심/Noun,1,0,1,0.0,1.1106915165381966e-05,1.0
34296,철운역/Noun,1,0,1,0.0,1.1106915165381966e-05,1.0
34297,이우/Noun,1,1,0,1.1115310228308472e-05,0.0,1.0
34298,알겄다/Noun,1,0,1,0.0,1.1106915165381966e-05,1.0
34299,뉴매/Noun,1,1,0,1.1115310228308472e-05,0.0,1.0
34300,털이범/Noun,1,1,0,1.1115310228308472e-05,0.0,1.0
34301,샛노란/Noun,1,1,0,1.1115310228308472e-05,0.0,1.0
34302,확플/Noun,1,1,0,1.1115310228308472e-05,0.0,1.0
34303,허츠/Noun,1,0,1,0.0,1.1106915165381966e-05,1.0
34304,나자레쓰/Noun,1,0,1,0.0,1.1106915165381966e-05,1.0
34305,울궈멱/Noun,1,0,1,0.0,1.1106915165381966e-05,1.0
34306,유공/Noun,1,0,1,0.0,1.1106915165381966e-05,1.0
34307,한무/Noun,1,0,1,0.0,1.1106915165381966e-05,1.0
34308,휴머니스트/Noun,1,0,1,0.0,1.1106915165381966e-05,1.0
34309,골판지전사/Noun,1,1,0,1.1115310228308472e-05,0.0,1.0
34310,6/8일/Number,1,1,0,1.1115310228308472e-05,0.0,1.0
34311,6/6일/Number,1,1,0,1.1115310228308472e-05,0.0,1.0
34312,혹여/Noun,1,0,1,0.0,1.1106915165381966e-05,1.0
34313,dinner/Alpha,1,1,0,1.1115310228308472e-05,0.0,1.0
34314,Operation/Alpha,1,1,0,1.1115310228308472e-05,0.0,1.0
34315,8.65/Number,1,0,1,0.0,1.1106915165381966e-05,1.0
34316,대설/Noun,1,1,0,1.1115310228308472e-05,0.0,1.0
34317,대공습/Noun,1,1,0,1.1115310228308472e-05,0.0,1.0
34318,백합/Noun,1,1,0,1.1115310228308472e-05,0.0,1.0
34319,~!!!!!!!!!!!!!!!!!!!!!!!!!!!!!!!!!/Punctuation,1,0,1,0.0,1.1106915165381966e-05,1.0
34320,자탄/Noun,1,1,0,1.1115310228308472e-05,0.0,1.0
34321,바닷물/Noun,1,1,0,1.1115310228308472e-05,0.0,1.0
34322,거거거/Noun,1,0,1,0.0,1.1106915165381966e-05,1.0
34323,아녓음/Noun,1,0,1,0.0,1.1106915165381966e-05,1.0
34324,상신/Noun,1,0,1,0.0,1.1106915165381966e-05,1.0
34325,다잊어/Noun,1,1,0,1.1115310228308472e-05,0.0,1.0
34326,선픽/Noun,1,1,0,1.1115310228308472e-05,0.0,1.0
34327,클라슫/Noun,1,0,1,0.0,1.1106915165381966e-05,1.0
34328,멸도/Noun,1,0,1,0.0,1.1106915165381966e-05,1.0
34329,튜브/Noun,1,1,0,1.1115310228308472e-05,0.0,1.0
34330,많넹/Noun,1,1,0,1.1115310228308472e-05,0.0,1.0
34331,지취/Noun,1,0,1,0.0,1.1106915165381966e-05,1.0
34332,구룡포/Noun,1,0,1,0.0,1.1106915165381966e-05,1.0
34333,어묵/Noun,1,0,1,0.0,1.1106915165381966e-05,1.0
34334,서문시장/Noun,1,0,1,0.0,1.1106915165381966e-05,1.0
34335,낙엿다/Noun,1,0,1,0.0,1.1106915165381966e-05,1.0
34336,미본/Noun,1,1,0,1.1115310228308472e-05,0.0,1.0
34337,붕가해/Noun,1,0,1,0.0,1.1106915165381966e-05,1.0
34338,존대말/Noun,1,0,1,0.0,1.1106915165381966e-05,1.0
34339,버수스/Noun,1,0,1,0.0,1.1106915165381966e-05,1.0
34340,파기/Noun,1,1,0,1.1115310228308472e-05,0.0,1.0
34341,쥤/Noun,1,1,0,1.1115310228308472e-05,0.0,1.0
34342,멋있엄/Noun,1,1,0,1.1115310228308472e-05,0.0,1.0
34343,맹렬하다/Adjective,1,0,1,0.0,1.1106915165381966e-05,1.0
34344,뒤라스/Noun,1,0,1,0.0,1.1106915165381966e-05,1.0
34345,....:)/Punctuation,1,1,0,1.1115310228308472e-05,0.0,1.0
34346,권렵납/Noun,1,1,0,1.1115310228308472e-05,0.0,1.0
34347,?!!!!!!/Punctuation,1,1,0,1.1115310228308472e-05,0.0,1.0
34348,이예린/Noun,1,0,1,0.0,1.1106915165381966e-05,1.0
34349,금쪽/Noun,1,0,1,0.0,1.1106915165381966e-05,1.0
34350,잔걸/Noun,1,0,1,0.0,1.1106915165381966e-05,1.0
34351,ffffffffffffffffffffffffffffffffff/Alpha,1,0,1,0.0,1.1106915165381966e-05,1.0
34352,꿀좀/Noun,1,0,1,0.0,1.1106915165381966e-05,1.0
34353,젠디/Noun,1,0,1,0.0,1.1106915165381966e-05,1.0
34354,알레그/Noun,1,1,0,1.1115310228308472e-05,0.0,1.0
34355,다봣더/Noun,1,0,1,0.0,1.1106915165381966e-05,1.0
34356,나왓을때/Noun,1,0,1,0.0,1.1106915165381966e-05,1.0
34357,음영/Noun,1,1,0,1.1115310228308472e-05,0.0,1.0
34358,피학/Noun,1,1,0,1.1115310228308472e-05,0.0,1.0
34359,개찌/Noun,1,0,1,0.0,1.1106915165381966e-05,1.0
34360,어흐/Noun,1,1,0,1.1115310228308472e-05,0.0,1.0
34361,돌프룬드그렌형/Noun,1,0,1,0.0,1.1106915165381966e-05,1.0
34362,핸기/Noun,1,1,0,1.1115310228308472e-05,0.0,1.0
34363,찍지맙시/Noun,1,0,1,0.0,1.1106915165381966e-05,1.0
34364,토목/Noun,1,1,0,1.1115310228308472e-05,0.0,1.0
34365,한나라당/Noun,1,1,0,1.1115310228308472e-05,0.0,1.0
34366,불교인/Noun,1,0,1,0.0,1.1106915165381966e-05,1.0
34367,응급/Noun,1,0,1,0.0,1.1106915165381966e-05,1.0
34368,용괴작/Noun,1,0,1,0.0,1.1106915165381966e-05,1.0
34369,바둑판/Noun,1,1,0,1.1115310228308472e-05,0.0,1.0
34370,투란도트/Noun,1,0,1,0.0,1.1106915165381966e-05,1.0
34371,도요새/Noun,1,0,1,0.0,1.1106915165381966e-05,1.0
34372,dddddddddddddddddddddddddddddddddddddddddd/Alpha,1,1,0,1.1115310228308472e-05,0.0,1.0
34373,손결/Noun,1,1,0,1.1115310228308472e-05,0.0,1.0
34374,~~!~/Punctuation,1,1,0,1.1115310228308472e-05,0.0,1.0
34375,40~50년/Number,1,0,1,0.0,1.1106915165381966e-05,1.0
34376,드려는/Foreign,1,1,0,1.1115310228308472e-05,0.0,1.0
34377,직지/Noun,1,0,1,0.0,1.1106915165381966e-05,1.0
34378,펄론/Noun,1,0,1,0.0,1.1106915165381966e-05,1.0
34379,범죄예방/Noun,1,0,1,0.0,1.1106915165381966e-05,1.0
34380,!!--!!--!!--!!--!!/Punctuation,1,1,0,1.1115310228308472e-05,0.0,1.0
34381,바랬겠/Noun,1,0,1,0.0,1.1106915165381966e-05,1.0
34382,대단원/Noun,1,1,0,1.1115310228308472e-05,0.0,1.0
34383,ydg/Alpha,1,0,1,0.0,1.1106915165381966e-05,1.0
34384,쫑났다/Noun,1,0,1,0.0,1.1106915165381966e-05,1.0
34385,얼머/Noun,1,0,1,0.0,1.1106915165381966e-05,1.0
34386,유메/Noun,1,0,1,0.0,1.1106915165381966e-05,1.0
34387,TAPE/Alpha,1,0,1,0.0,1.1106915165381966e-05,1.0
34388,백약무효/Noun,1,0,1,0.0,1.1106915165381966e-05,1.0
34389,계급투쟁/Noun,1,0,1,0.0,1.1106915165381966e-05,1.0
34390,기바/Noun,1,1,0,1.1115310228308472e-05,0.0,1.0
34391,카미유/Noun,1,1,0,1.1115310228308472e-05,0.0,1.0
34392,조각가/Noun,1,1,0,1.1115310228308472e-05,0.0,1.0
34393,가까이되는/Foreign,1,1,0,1.1115310228308472e-05,0.0,1.0
34394,위블리/Noun,1,0,1,0.0,1.1106915165381966e-05,1.0
34395,쌍룡회/Noun,1,0,1,0.0,1.1106915165381966e-05,1.0
34396,정몽주/Noun,1,1,0,1.1115310228308472e-05,0.0,1.0
34397,이인임/Noun,1,1,0,1.1115310228308472e-05,0.0,1.0
34398,엄중하다/Adjective,1,0,1,0.0,1.1106915165381966e-05,1.0
34399,~~~~-_-/Punctuation,1,1,0,1.1115310228308472e-05,0.0,1.0
34400,뭐봣/Noun,1,0,1,0.0,1.1106915165381966e-05,1.0
34401,cinef/Alpha,1,0,1,0.0,1.1106915165381966e-05,1.0
34402,헬기뿌시/Noun,1,0,1,0.0,1.1106915165381966e-05,1.0
34403,치타/Noun,1,1,0,1.1115310228308472e-05,0.0,1.0
34404,쥐락펴락하/Noun,1,1,0,1.1115310228308472e-05,0.0,1.0
34405,야끼소바/Noun,1,1,0,1.1115310228308472e-05,0.0,1.0
34406,젤루쪼/Noun,1,1,0,1.1115310228308472e-05,0.0,1.0
34407,엄유커플/Noun,1,1,0,1.1115310228308472e-05,0.0,1.0
34408,둘립/Noun,1,1,0,1.1115310228308472e-05,0.0,1.0
34409,윈윈할수/Noun,1,1,0,1.1115310228308472e-05,0.0,1.0
34410,리얄/Noun,1,0,1,0.0,1.1106915165381966e-05,1.0
34411,짬임새/Noun,1,1,0,1.1115310228308472e-05,0.0,1.0
34412,ㅏㄱ/KoreanParticle,1,1,0,1.1115310228308472e-05,0.0,1.0
34413,고거/Noun,1,1,0,1.1115310228308472e-05,0.0,1.0
34414,인관/Noun,1,1,0,1.1115310228308472e-05,0.0,1.0
34415,느거/Noun,1,1,0,1.1115310228308472e-05,0.0,1.0
34416,...^^)/Punctuation,1,1,0,1.1115310228308472e-05,0.0,1.0
34417,퐛팅/Noun,1,1,0,1.1115310228308472e-05,0.0,1.0
34418,거림낌/Noun,1,0,1,0.0,1.1106915165381966e-05,1.0
34419,이라지만/Foreign,1,1,0,1.1115310228308472e-05,0.0,1.0
34420,살인죄/Noun,1,0,1,0.0,1.1106915165381966e-05,1.0
34421,레거시/Noun,1,0,1,0.0,1.1106915165381966e-05,1.0
34422,톰성님/Noun,1,1,0,1.1115310228308472e-05,0.0,1.0
34423,검트/Noun,1,0,1,0.0,1.1106915165381966e-05,1.0
34424,이용주/Noun,1,0,1,0.0,1.1106915165381966e-05,1.0
34425,뒤죽/Noun,1,0,1,0.0,1.1106915165381966e-05,1.0
34426,둘일때/Noun,1,0,1,0.0,1.1106915165381966e-05,1.0
34427,뎡말뎡/Noun,1,1,0,1.1115310228308472e-05,0.0,1.0
34428,+!!/Punctuation,1,1,0,1.1115310228308472e-05,0.0,1.0
34429,이나됐지만/Foreign,1,1,0,1.1115310228308472e-05,0.0,1.0
34430,개섀꺄/Noun,1,0,1,0.0,1.1106915165381966e-05,1.0
34431,로섀꺄/Noun,1,0,1,0.0,1.1106915165381966e-05,1.0
34432,싑호/Noun,1,0,1,0.0,1.1106915165381966e-05,1.0
34433,섀끼/Noun,1,0,1,0.0,1.1106915165381966e-05,1.0
34434,알바니아/Noun,1,1,0,1.1115310228308472e-05,0.0,1.0
34435,샤차/Noun,1,1,0,1.1115310228308472e-05,0.0,1.0
34436,더봣다/Noun,1,1,0,1.1115310228308472e-05,0.0,1.0
34437,온에어/Noun,1,1,0,1.1115310228308472e-05,0.0,1.0
34438,크라스/Noun,1,1,0,1.1115310228308472e-05,0.0,1.0
34439,30-40/Number,1,1,0,1.1115310228308472e-05,0.0,1.0
34440,편전/Noun,1,1,0,1.1115310228308472e-05,0.0,1.0
34441,ㅏㅋㅋ/KoreanParticle,1,0,1,0.0,1.1106915165381966e-05,1.0
34442,11:11/Number,1,1,0,1.1115310228308472e-05,0.0,1.0
34443,일리네어/Noun,1,1,0,1.1115310228308472e-05,0.0,1.0
34444,★★★★★★★★★★/Foreign,1,1,0,1.1115310228308472e-05,0.0,1.0
34445,방백/Noun,1,1,0,1.1115310228308472e-05,0.0,1.0
34446,소란스러움/Noun,1,1,0,1.1115310228308472e-05,0.0,1.0
34447,퀸즈/Noun,1,0,1,0.0,1.1106915165381966e-05,1.0
34448,안좋쟎아/Noun,1,0,1,0.0,1.1106915165381966e-05,1.0
34449,미씨/Noun,1,0,1,0.0,1.1106915165381966e-05,1.0
34450,조은경/Noun,1,0,1,0.0,1.1106915165381966e-05,1.0
34451,쩜더/Noun,1,1,0,1.1115310228308472e-05,0.0,1.0
34452,르겔/Noun,1,1,0,1.1115310228308472e-05,0.0,1.0
34453,뇔/Noun,1,1,0,1.1115310228308472e-05,0.0,1.0
34454,능거/Noun,1,0,1,0.0,1.1106915165381966e-05,1.0
34455,이무송/Noun,1,1,0,1.1115310228308472e-05,0.0,1.0
34456,*--*/Punctuation,1,1,0,1.1115310228308472e-05,0.0,1.0
34457,쫄딱쫄딱/Noun,1,1,0,1.1115310228308472e-05,0.0,1.0
34458,이언정/Noun,1,0,1,0.0,1.1106915165381966e-05,1.0
34459,최민재/Noun,1,1,0,1.1115310228308472e-05,0.0,1.0
34460,줬웠으/Noun,1,0,1,0.0,1.1106915165381966e-05,1.0
34461,그떈/Noun,1,1,0,1.1115310228308472e-05,0.0,1.0
34462,전에나왔는데/Foreign,1,0,1,0.0,1.1106915165381966e-05,1.0
34463,대절/Noun,1,0,1,0.0,1.1106915165381966e-05,1.0
34464,ㅗㅓㅇㄴ/KoreanParticle,1,1,0,1.1115310228308472e-05,0.0,1.0
34465,-~~~/Punctuation,1,1,0,1.1115310228308472e-05,0.0,1.0
34466,헨젤과그레텔영화/Noun,1,0,1,0.0,1.1106915165381966e-05,1.0
34467,쓱액/Noun,1,0,1,0.0,1.1106915165381966e-05,1.0
34468,;-_-/Punctuation,1,0,1,0.0,1.1106915165381966e-05,1.0
34469,간댕이다/Verb,1,1,0,1.1115310228308472e-05,0.0,1.0
34470,유성우/Noun,1,0,1,0.0,1.1106915165381966e-05,1.0
34471,완숙/Noun,1,0,1,0.0,1.1106915165381966e-05,1.0
34472,쎄고쎗다/Noun,1,0,1,0.0,1.1106915165381966e-05,1.0
34473,150년/Number,1,1,0,1.1115310228308472e-05,0.0,1.0
34474,Wicker/Alpha,1,1,0,1.1115310228308472e-05,0.0,1.0
34475,순위도/Noun,1,0,1,0.0,1.1106915165381966e-05,1.0
34476,게릴라전/Noun,1,1,0,1.1115310228308472e-05,0.0,1.0
34477,쎅스/Noun,1,0,1,0.0,1.1106915165381966e-05,1.0
34478,사두/Noun,1,0,1,0.0,1.1106915165381966e-05,1.0
34479,7.78/Number,1,0,1,0.0,1.1106915165381966e-05,1.0
34480,스위브트/Noun,1,1,0,1.1115310228308472e-05,0.0,1.0
34481,740/Number,1,0,1,0.0,1.1106915165381966e-05,1.0
34482,트롯/Noun,1,0,1,0.0,1.1106915165381966e-05,1.0
34483,꼬라박/Noun,1,0,1,0.0,1.1106915165381966e-05,1.0
34484,불심/Noun,1,1,0,1.1115310228308472e-05,0.0,1.0
34485,엿같으/Noun,1,1,0,1.1115310228308472e-05,0.0,1.0
34486,멸함/Noun,1,0,1,0.0,1.1106915165381966e-05,1.0
34487,end/Alpha,1,0,1,0.0,1.1106915165381966e-05,1.0
34488,본넷/Noun,1,0,1,0.0,1.1106915165381966e-05,1.0
34489,관직/Noun,1,1,0,1.1115310228308472e-05,0.0,1.0
34490,김남진/Noun,1,0,1,0.0,1.1106915165381966e-05,1.0
34491,...;;;./Punctuation,1,0,1,0.0,1.1106915165381966e-05,1.0
34492,보다맘/Foreign,1,0,1,0.0,1.1106915165381966e-05,1.0
34493,언더그라운드/Noun,1,1,0,1.1115310228308472e-05,0.0,1.0
34494,쩜쩌/Noun,1,0,1,0.0,1.1106915165381966e-05,1.0
34495,성신/Noun,1,0,1,0.0,1.1106915165381966e-05,1.0
34496,Smoke/Alpha,1,1,0,1.1115310228308472e-05,0.0,1.0
34497,살일/Noun,1,0,1,0.0,1.1106915165381966e-05,1.0
34498,스크릴렉스/Noun,1,1,0,1.1115310228308472e-05,0.0,1.0
34499,이쥰영/Noun,1,0,1,0.0,1.1106915165381966e-05,1.0
34500,92분/Number,1,1,0,1.1115310228308472e-05,0.0,1.0
34501,공포소설/Noun,1,1,0,1.1115310228308472e-05,0.0,1.0
34502,Asdfgnvtrw/Alpha,1,1,0,1.1115310228308472e-05,0.0,1.0
34503,마넥/Noun,1,1,0,1.1115310228308472e-05,0.0,1.0
34504,초구/Noun,1,0,1,0.0,1.1106915165381966e-05,1.0
34505,숙변/Noun,1,0,1,0.0,1.1106915165381966e-05,1.0
34506,리버풀/Noun,1,1,0,1.1115310228308472e-05,0.0,1.0
34507,호진/Noun,1,0,1,0.0,1.1106915165381966e-05,1.0
34508,폭행죄/Noun,1,0,1,0.0,1.1106915165381966e-05,1.0
34509,엮겨웠/Noun,1,0,1,0.0,1.1106915165381966e-05,1.0
34510,정정은/Noun,1,1,0,1.1115310228308472e-05,0.0,1.0
34511,비쿨/Noun,1,1,0,1.1115310228308472e-05,0.0,1.0
34512,"(?),/Punctuation",1,0,1,0.0,1.1106915165381966e-05,1.0
34513,어럈을때/Noun,1,1,0,1.1115310228308472e-05,0.0,1.0
34514,건산홀/Noun,1,0,1,0.0,1.1106915165381966e-05,1.0
34515,휘경여고/Noun,1,0,1,0.0,1.1106915165381966e-05,1.0
34516,휘경동/Noun,1,0,1,0.0,1.1106915165381966e-05,1.0
34517,동대문구/Noun,1,0,1,0.0,1.1106915165381966e-05,1.0
34518,승격/Noun,1,0,1,0.0,1.1106915165381966e-05,1.0
34519,masterpieces/Alpha,1,1,0,1.1115310228308472e-05,0.0,1.0
34520,unknown/Alpha,1,1,0,1.1115310228308472e-05,0.0,1.0
34521,금광/Noun,1,1,0,1.1115310228308472e-05,0.0,1.0
34522,!!!!!!!!!!!!!!!!!!!!!!!!!!!!!!!!!!!!!!!!!!!!!!!!!!!!!!!!!!!!!!!!/Punctuation,1,1,0,1.1115310228308472e-05,0.0,1.0
34523,채보/Noun,1,0,1,0.0,1.1106915165381966e-05,1.0
34524,재광/Noun,1,1,0,1.1115310228308472e-05,0.0,1.0
34525,낚였건/Noun,1,0,1,0.0,1.1106915165381966e-05,1.0
34526,제우/Noun,1,1,0,1.1115310228308472e-05,0.0,1.0
34527,future/Alpha,1,0,1,0.0,1.1106915165381966e-05,1.0
34528,bact/Alpha,1,0,1,0.0,1.1106915165381966e-05,1.0
34529,상대성이론/Noun,1,0,1,0.0,1.1106915165381966e-05,1.0
34530,예산제약/Noun,1,0,1,0.0,1.1106915165381966e-05,1.0
34531,헤드뱅잉/Noun,1,0,1,0.0,1.1106915165381966e-05,1.0
34532,산탈때임/Noun,1,0,1,0.0,1.1106915165381966e-05,1.0
34533,슬라이딩/Noun,1,0,1,0.0,1.1106915165381966e-05,1.0
34534,엄창걸/Noun,1,0,1,0.0,1.1106915165381966e-05,1.0
34535,배교/Noun,1,0,1,0.0,1.1106915165381966e-05,1.0
34536,24/6/Number,1,0,1,0.0,1.1106915165381966e-05,1.0
34537,인세/Noun,1,0,1,0.0,1.1106915165381966e-05,1.0
34538,다분/Noun,1,0,1,0.0,1.1106915165381966e-05,1.0
34539,폐업/Noun,1,1,0,1.1115310228308472e-05,0.0,1.0
34540,망아/Noun,1,1,0,1.1115310228308472e-05,0.0,1.0
34541,..^^~/Punctuation,1,1,0,1.1115310228308472e-05,0.0,1.0
34542,수석/Noun,1,1,0,1.1115310228308472e-05,0.0,1.0
34543,>?</Punctuation,1,1,0,1.1115310228308472e-05,0.0,1.0
34544,그뚱뚱보/Noun,1,1,0,1.1115310228308472e-05,0.0,1.0
34545,타깃/Noun,1,0,1,0.0,1.1106915165381966e-05,1.0
34546,옥련/Noun,1,1,0,1.1115310228308472e-05,0.0,1.0
34547,정태/Noun,1,1,0,1.1115310228308472e-05,0.0,1.0
34548,기름종이/Noun,1,0,1,0.0,1.1106915165381966e-05,1.0
34549,이꽉차있음/Foreign,1,1,0,1.1115310228308472e-05,0.0,1.0
34550,무삼/Noun,1,0,1,0.0,1.1106915165381966e-05,1.0
34551,꺼/Foreign,1,0,1,0.0,1.1106915165381966e-05,1.0
34552,슈왈츠먼/Noun,1,0,1,0.0,1.1106915165381966e-05,1.0
34553,덜렁덜렁/Adverb,1,0,1,0.0,1.1106915165381966e-05,1.0
34554,젤위거빠들/Noun,1,0,1,0.0,1.1106915165381966e-05,1.0
34555,마요네즈/Noun,1,1,0,1.1115310228308472e-05,0.0,1.0
34556,비계/Noun,1,1,0,1.1115310228308472e-05,0.0,1.0
34557,팽겨/Noun,1,0,1,0.0,1.1106915165381966e-05,1.0
34558,모여들다/Verb,1,1,0,1.1115310228308472e-05,0.0,1.0
34559,~~<</Punctuation,1,1,0,1.1115310228308472e-05,0.0,1.0
34560,이국/Noun,1,0,1,0.0,1.1106915165381966e-05,1.0
34561,보라마/Noun,1,0,1,0.0,1.1106915165381966e-05,1.0
34562,2.7/Number,1,0,1,0.0,1.1106915165381966e-05,1.0
34563,드릅개/Noun,1,0,1,0.0,1.1106915165381966e-05,1.0
34564,dom/Alpha,1,1,0,1.1115310228308472e-05,0.0,1.0
34565,Free/Alpha,1,1,0,1.1115310228308472e-05,0.0,1.0
34566,레시람/Noun,1,1,0,1.1115310228308472e-05,0.0,1.0
34567,재밌엇습니/Noun,1,1,0,1.1115310228308472e-05,0.0,1.0
34568,음회/Noun,1,1,0,1.1115310228308472e-05,0.0,1.0
34569,빠순/Noun,1,0,1,0.0,1.1106915165381966e-05,1.0
34570,어캐함/Noun,1,1,0,1.1115310228308472e-05,0.0,1.0
34571,월렘/Noun,1,0,1,0.0,1.1106915165381966e-05,1.0
34572,☜/Foreign,1,1,0,1.1115310228308472e-05,0.0,1.0
34573,Promenade/Alpha,1,1,0,1.1115310228308472e-05,0.0,1.0
34574,여내/Foreign,1,1,0,1.1115310228308472e-05,0.0,1.0
34575,오백만/Noun,1,1,0,1.1115310228308472e-05,0.0,1.0
34576,쪼꼬쪼꼬/Noun,1,1,0,1.1115310228308472e-05,0.0,1.0
34577,즌부터/Foreign,1,1,0,1.1115310228308472e-05,0.0,1.0
34578,13시/Number,1,1,0,1.1115310228308472e-05,0.0,1.0
34579,아드만/Noun,1,1,0,1.1115310228308472e-05,0.0,1.0
34580,후쯤에/Foreign,1,1,0,1.1115310228308472e-05,0.0,1.0
34581,라씨/Noun,1,1,0,1.1115310228308472e-05,0.0,1.0
34582,펑크록/Noun,1,1,0,1.1115310228308472e-05,0.0,1.0
34583,우완/Noun,1,1,0,1.1115310228308472e-05,0.0,1.0
34584,쭈누/Noun,1,1,0,1.1115310228308472e-05,0.0,1.0
34585,허달프/Noun,1,1,0,1.1115310228308472e-05,0.0,1.0
34586,느슷한/Noun,1,0,1,0.0,1.1106915165381966e-05,1.0
34587,ㅜㅜㅜㅡ/KoreanParticle,1,1,0,1.1115310228308472e-05,0.0,1.0
34588,후륭/Noun,1,1,0,1.1115310228308472e-05,0.0,1.0
34589,삼사일/Noun,1,1,0,1.1115310228308472e-05,0.0,1.0
34590,철책/Noun,1,0,1,0.0,1.1106915165381966e-05,1.0
34591,Shot/Alpha,1,0,1,0.0,1.1106915165381966e-05,1.0
34592,하겟구/Noun,1,0,1,0.0,1.1106915165381966e-05,1.0
34593,han/Alpha,1,1,0,1.1115310228308472e-05,0.0,1.0
34594,나륺해/Noun,1,1,0,1.1115310228308472e-05,0.0,1.0
34595,산초/Noun,1,1,0,1.1115310228308472e-05,0.0,1.0
34596,얀켈/Noun,1,0,1,0.0,1.1106915165381966e-05,1.0
34597,모튼/Noun,1,0,1,0.0,1.1106915165381966e-05,1.0
34598,Earn/Alpha,1,1,0,1.1115310228308472e-05,0.0,1.0
34599,fabulous/Alpha,1,1,0,1.1115310228308472e-05,0.0,1.0
34600,수국사/Noun,1,0,1,0.0,1.1106915165381966e-05,1.0
34601,김두수/Noun,1,1,0,1.1115310228308472e-05,0.0,1.0
34602,로데오/Noun,1,1,0,1.1115310228308472e-05,0.0,1.0
34603,붙힌거/Noun,1,0,1,0.0,1.1106915165381966e-05,1.0
34604,엄마젖/Noun,1,1,0,1.1115310228308472e-05,0.0,1.0
34605,김정/Noun,1,1,0,1.1115310228308472e-05,0.0,1.0
34606,판티/Noun,1,1,0,1.1115310228308472e-05,0.0,1.0
34607,츠츠미/Noun,1,1,0,1.1115310228308472e-05,0.0,1.0
34608,결구/Noun,1,1,0,1.1115310228308472e-05,0.0,1.0
34609,개핵극혐/Noun,1,0,1,0.0,1.1106915165381966e-05,1.0
34610,다각도로/Adverb,1,1,0,1.1115310228308472e-05,0.0,1.0
34611,지죤/Noun,1,0,1,0.0,1.1106915165381966e-05,1.0
34612,골져스/Noun,1,1,0,1.1115310228308472e-05,0.0,1.0
34613,고독사/Noun,1,1,0,1.1115310228308472e-05,0.0,1.0
34614,공포영화중/Foreign,1,1,0,1.1115310228308472e-05,0.0,1.0
34615,졸랭/Noun,1,1,0,1.1115310228308472e-05,0.0,1.0
34616,따뚯함/Noun,1,1,0,1.1115310228308472e-05,0.0,1.0
34617,제트기/Noun,1,1,0,1.1115310228308472e-05,0.0,1.0
34618,다웠습니/Noun,1,1,0,1.1115310228308472e-05,0.0,1.0
34619,제이제이/Noun,1,1,0,1.1115310228308472e-05,0.0,1.0
34620,예지력/Noun,1,0,1,0.0,1.1106915165381966e-05,1.0
34621,Before/Alpha,1,1,0,1.1115310228308472e-05,0.0,1.0
34622,왜차/Noun,1,1,0,1.1115310228308472e-05,0.0,1.0
34623,straight/Alpha,1,0,1,0.0,1.1106915165381966e-05,1.0
34624,gayest/Alpha,1,0,1,0.0,1.1106915165381966e-05,1.0
34625,제레미아/Noun,1,1,0,1.1115310228308472e-05,0.0,1.0
34626,척머슬러/Noun,1,0,1,0.0,1.1106915165381966e-05,1.0
34627,사관학교/Noun,1,0,1,0.0,1.1106915165381966e-05,1.0
34628,http://www.youtube.com/watch?v=vp77rRvoTkM/URL,1,0,1,0.0,1.1106915165381966e-05,1.0
34629,서연/Noun,1,0,1,0.0,1.1106915165381966e-05,1.0
34630,찻기/Noun,1,0,1,0.0,1.1106915165381966e-05,1.0
34631,Xx/Alpha,1,1,0,1.1115310228308472e-05,0.0,1.0
34632,언더우드/Noun,1,1,0,1.1115310228308472e-05,0.0,1.0
34633,우뤠매/Noun,1,0,1,0.0,1.1106915165381966e-05,1.0
34634,파바로티/Noun,1,1,0,1.1115310228308472e-05,0.0,1.0
34635,임피/Noun,1,0,1,0.0,1.1106915165381966e-05,1.0
34636,이몽학/Noun,1,1,0,1.1115310228308472e-05,0.0,1.0
34637,왜군/Noun,1,1,0,1.1115310228308472e-05,0.0,1.0
34638,느보랭/Noun,1,1,0,1.1115310228308472e-05,0.0,1.0
34639,priaphos/Alpha,1,0,1,0.0,1.1106915165381966e-05,1.0
34640,심폐소생술/Noun,1,0,1,0.0,1.1106915165381966e-05,1.0
34641,7.2%/Number,1,0,1,0.0,1.1106915165381966e-05,1.0
34642,알파파/Noun,1,1,0,1.1115310228308472e-05,0.0,1.0
34643,찌방/Noun,1,1,0,1.1115310228308472e-05,0.0,1.0
34644,첫날/Foreign,1,1,0,1.1115310228308472e-05,0.0,1.0
34645,최진/Noun,1,1,0,1.1115310228308472e-05,0.0,1.0
34646,박정우/Noun,1,1,0,1.1115310228308472e-05,0.0,1.0
34647,미국만화/Noun,1,1,0,1.1115310228308472e-05,0.0,1.0
34648,고교야구/Noun,1,1,0,1.1115310228308472e-05,0.0,1.0
34649,쫌전/Noun,1,1,0,1.1115310228308472e-05,0.0,1.0
34650,샹것들/Noun,1,0,1,0.0,1.1106915165381966e-05,1.0
34651,샤오리/Noun,1,1,0,1.1115310228308472e-05,0.0,1.0
34652,내리쬐다/Verb,1,1,0,1.1115310228308472e-05,0.0,1.0
34653,1000년/Number,1,1,0,1.1115310228308472e-05,0.0,1.0
34654,알통좀/Noun,1,1,0,1.1115310228308472e-05,0.0,1.0
34655,대본리딩/Noun,1,0,1,0.0,1.1106915165381966e-05,1.0
34656,바벨/Noun,1,0,1,0.0,1.1106915165381966e-05,1.0
34657,히로유키/Noun,1,1,0,1.1115310228308472e-05,0.0,1.0
34658,만주국/Noun,1,0,1,0.0,1.1106915165381966e-05,1.0
34659,액스멘/Noun,1,1,0,1.1115310228308472e-05,0.0,1.0
34660,김향기/Noun,1,1,0,1.1115310228308472e-05,0.0,1.0
34661,두런두런/Noun,1,1,0,1.1115310228308472e-05,0.0,1.0
34662,소박/Noun,1,1,0,1.1115310228308472e-05,0.0,1.0
34663,가비얍/Noun,1,1,0,1.1115310228308472e-05,0.0,1.0
34664,맹추/Noun,1,1,0,1.1115310228308472e-05,0.0,1.0
34665,원만하다/Adjective,1,1,0,1.1115310228308472e-05,0.0,1.0
34666,재은/Noun,1,0,1,0.0,1.1106915165381966e-05,1.0
34667,안씨/Noun,1,1,0,1.1115310228308472e-05,0.0,1.0
34668,장미나/Noun,1,0,1,0.0,1.1106915165381966e-05,1.0
34669,118분/Number,1,0,1,0.0,1.1106915165381966e-05,1.0
34670,보역/Noun,1,1,0,1.1115310228308472e-05,0.0,1.0
34671,사이영상/Noun,1,0,1,0.0,1.1106915165381966e-05,1.0
34672,곽가/Noun,1,0,1,0.0,1.1106915165381966e-05,1.0
34673,장료/Noun,1,0,1,0.0,1.1106915165381966e-05,1.0
34674,ㅈㅗㅎ/KoreanParticle,1,1,0,1.1115310228308472e-05,0.0,1.0
34675,가당찮다/Adjective,1,0,1,0.0,1.1106915165381966e-05,1.0
34676,정듬/Noun,1,0,1,0.0,1.1106915165381966e-05,1.0
34677,-_-............./Punctuation,1,0,1,0.0,1.1106915165381966e-05,1.0
34678,완존잼있/Noun,1,1,0,1.1115310228308472e-05,0.0,1.0
34679,제풀이/Noun,1,1,0,1.1115310228308472e-05,0.0,1.0
34680,belong/Alpha,1,1,0,1.1115310228308472e-05,0.0,1.0
34681,donna/Alpha,1,1,0,1.1115310228308472e-05,0.0,1.0
34682,모터스포츠/Noun,1,1,0,1.1115310228308472e-05,0.0,1.0
34683,마킹/Noun,1,1,0,1.1115310228308472e-05,0.0,1.0
34684,멕라렌팀/Noun,1,1,0,1.1115310228308472e-05,0.0,1.0
34685,sehr/Alpha,1,1,0,1.1115310228308472e-05,0.0,1.0
34686,잼썻습니/Noun,1,1,0,1.1115310228308472e-05,0.0,1.0
34687,쩌비/Noun,1,0,1,0.0,1.1106915165381966e-05,1.0
34688,through/Alpha,1,1,0,1.1115310228308472e-05,0.0,1.0
34689,1970/Number,1,1,0,1.1115310228308472e-05,0.0,1.0
34690,게맛살/Noun,1,1,0,1.1115310228308472e-05,0.0,1.0
34691,뚱년/Noun,1,0,1,0.0,1.1106915165381966e-05,1.0
34692,라라피포/Noun,1,1,0,1.1115310228308472e-05,0.0,1.0
34693,...[/Punctuation,1,0,1,0.0,1.1106915165381966e-05,1.0
34694,............................................................./Punctuation,1,0,1,0.0,1.1106915165381966e-05,1.0
34695,갑동이/Noun,1,1,0,1.1115310228308472e-05,0.0,1.0
34696,구럼비/Noun,1,0,1,0.0,1.1106915165381966e-05,1.0
34697,혜은이/Noun,1,0,1,0.0,1.1106915165381966e-05,1.0
34698,노새/Noun,1,0,1,0.0,1.1106915165381966e-05,1.0
34699,퐉퐉나/Noun,1,0,1,0.0,1.1106915165381966e-05,1.0
34700,요물/Noun,1,1,0,1.1115310228308472e-05,0.0,1.0
34701,자성/Noun,1,0,1,0.0,1.1106915165381966e-05,1.0
34702,밥말/Noun,1,0,1,0.0,1.1106915165381966e-05,1.0
34703,롭던/Noun,1,1,0,1.1115310228308472e-05,0.0,1.0
34704,떼제베/Noun,1,1,0,1.1115310228308472e-05,0.0,1.0
34705,해킹씬/Noun,1,1,0,1.1115310228308472e-05,0.0,1.0
34706,데렉/Noun,1,1,0,1.1115310228308472e-05,0.0,1.0
34707,능신/Noun,1,1,0,1.1115310228308472e-05,0.0,1.0
34708,쌈마/Noun,1,0,1,0.0,1.1106915165381966e-05,1.0
34709,심잠/Noun,1,1,0,1.1115310228308472e-05,0.0,1.0
34710,배치기/Noun,1,0,1,0.0,1.1106915165381966e-05,1.0
34711,길문/Noun,1,0,1,0.0,1.1106915165381966e-05,1.0
34712,길달/Noun,1,0,1,0.0,1.1106915165381966e-05,1.0
34713,150원/Number,1,0,1,0.0,1.1106915165381966e-05,1.0
34714,메라/Noun,1,0,1,0.0,1.1106915165381966e-05,1.0
34715,숩/Noun,1,1,0,1.1115310228308472e-05,0.0,1.0
34716,메들리/Noun,1,0,1,0.0,1.1106915165381966e-05,1.0
34717,형극/Noun,1,0,1,0.0,1.1106915165381966e-05,1.0
34718,^//Punctuation,1,1,0,1.1115310228308472e-05,0.0,1.0
34719,레몬이/Noun,1,1,0,1.1115310228308472e-05,0.0,1.0
34720,게념/Noun,1,0,1,0.0,1.1106915165381966e-05,1.0
34721,dfhgdfbdfb/Alpha,1,0,1,0.0,1.1106915165381966e-05,1.0
34722,거쫌/Noun,1,0,1,0.0,1.1106915165381966e-05,1.0
34723,제임스맥어보이/Noun,1,1,0,1.1115310228308472e-05,0.0,1.0
34724,뭔/Noun,1,1,0,1.1115310228308472e-05,0.0,1.0
34725,핸디켐/Noun,1,1,0,1.1115310228308472e-05,0.0,1.0
34726,만든샤기/Noun,1,0,1,0.0,1.1106915165381966e-05,1.0
34727,폴링/Noun,1,0,1,0.0,1.1106915165381966e-05,1.0
34728,돌체/Noun,1,1,0,1.1115310228308472e-05,0.0,1.0
34729,이된/Foreign,1,1,0,1.1115310228308472e-05,0.0,1.0
34730,쁠/Noun,1,0,1,0.0,1.1106915165381966e-05,1.0
34731,조한철/Noun,1,1,0,1.1115310228308472e-05,0.0,1.0
34732,야햐/Noun,1,1,0,1.1115310228308472e-05,0.0,1.0
34733,괸히봣어/Noun,1,1,0,1.1115310228308472e-05,0.0,1.0
34734,낼막/Noun,1,1,0,1.1115310228308472e-05,0.0,1.0
34735,진굿/Noun,1,1,0,1.1115310228308472e-05,0.0,1.0
34736,junk/Alpha,1,0,1,0.0,1.1106915165381966e-05,1.0
34737,탐구생활/Noun,1,1,0,1.1115310228308472e-05,0.0,1.0
34738,블리츠크랭크/Noun,1,1,0,1.1115310228308472e-05,0.0,1.0
34739,81/Number,1,1,0,1.1115310228308472e-05,0.0,1.0
34740,후루꾸/Noun,1,0,1,0.0,1.1106915165381966e-05,1.0
34741,겅떻/Noun,1,0,1,0.0,1.1106915165381966e-05,1.0
34742,잡아쥬셔/Noun,1,1,0,1.1115310228308472e-05,0.0,1.0
34743,사브/Noun,1,1,0,1.1115310228308472e-05,0.0,1.0
34744,언브레이커블/Noun,1,1,0,1.1115310228308472e-05,0.0,1.0
34745,핀걸/Noun,1,0,1,0.0,1.1106915165381966e-05,1.0
34746,고동/Noun,1,0,1,0.0,1.1106915165381966e-05,1.0
34747,뒷짐/Noun,1,0,1,0.0,1.1106915165381966e-05,1.0
34748,난재밌엇음/Noun,1,1,0,1.1115310228308472e-05,0.0,1.0
34749,안에망해/Foreign,1,0,1,0.0,1.1106915165381966e-05,1.0
34750,김신영/Noun,1,0,1,0.0,1.1106915165381966e-05,1.0
34751,BL/Alpha,1,0,1,0.0,1.1106915165381966e-05,1.0
34752,25초/Number,1,0,1,0.0,1.1106915165381966e-05,1.0
34753,훼밀리마트/Noun,1,0,1,0.0,1.1106915165381966e-05,1.0
34754,럭스/Noun,1,0,1,0.0,1.1106915165381966e-05,1.0
34755,rjfqjwkd/Alpha,1,0,1,0.0,1.1106915165381966e-05,1.0
34756,호블릣/Noun,1,0,1,0.0,1.1106915165381966e-05,1.0
34757,슬램/Noun,1,1,0,1.1115310228308472e-05,0.0,1.0
34758,제닛/Noun,1,0,1,0.0,1.1106915165381966e-05,1.0
34759,마젠타/Noun,1,0,1,0.0,1.1106915165381966e-05,1.0
34760,납량특집/Noun,1,1,0,1.1115310228308472e-05,0.0,1.0
34761,9.37/Number,1,0,1,0.0,1.1106915165381966e-05,1.0
34762,2~7/Number,1,0,1,0.0,1.1106915165381966e-05,1.0
34763,진혼곡/Noun,1,1,0,1.1115310228308472e-05,0.0,1.0
34764,긌/Noun,1,0,1,0.0,1.1106915165381966e-05,1.0
34765,주욱/Noun,1,1,0,1.1115310228308472e-05,0.0,1.0
34766,DIY/Alpha,1,1,0,1.1115310228308472e-05,0.0,1.0
34767,천호진/Noun,1,1,0,1.1115310228308472e-05,0.0,1.0
34768,프루스트/Noun,1,1,0,1.1115310228308472e-05,0.0,1.0
34769,쌩뚱맞긴/Noun,1,1,0,1.1115310228308472e-05,0.0,1.0
34770,ㄴㄱ/KoreanParticle,1,0,1,0.0,1.1106915165381966e-05,1.0
34771,최규식/Noun,1,1,0,1.1115310228308472e-05,0.0,1.0
34772,fm/Alpha,1,0,1,0.0,1.1106915165381966e-05,1.0
34773,거릴/Noun,1,0,1,0.0,1.1106915165381966e-05,1.0
34774,하학/Noun,1,0,1,0.0,1.1106915165381966e-05,1.0
34775,연구개발/Noun,1,1,0,1.1115310228308472e-05,0.0,1.0
34776,장윤현/Noun,1,1,0,1.1115310228308472e-05,0.0,1.0
34777,석주일/Noun,1,0,1,0.0,1.1106915165381966e-05,1.0
34778,패트리버/Noun,1,0,1,0.0,1.1106915165381966e-05,1.0
34779,포트리스/Noun,1,1,0,1.1115310228308472e-05,0.0,1.0
34780,KMDB/Alpha,1,1,0,1.1115310228308472e-05,0.0,1.0
34781,헛질하/Noun,1,0,1,0.0,1.1106915165381966e-05,1.0
34782,낙시/Noun,1,0,1,0.0,1.1106915165381966e-05,1.0
34783,검술씬/Noun,1,1,0,1.1115310228308472e-05,0.0,1.0
34784,칼리포니아/Noun,1,1,0,1.1115310228308472e-05,0.0,1.0
34785,이나와서/Foreign,1,1,0,1.1115310228308472e-05,0.0,1.0
34786,데릭허프/Noun,1,1,0,1.1115310228308472e-05,0.0,1.0
34787,product/Alpha,1,1,0,1.1115310228308472e-05,0.0,1.0
34788,눌릴뻔/Noun,1,1,0,1.1115310228308472e-05,0.0,1.0
34789,cbgb/Alpha,1,1,0,1.1115310228308472e-05,0.0,1.0
34790,스틴던스트/Noun,1,0,1,0.0,1.1106915165381966e-05,1.0
34791,띡/Noun,1,0,1,0.0,1.1106915165381966e-05,1.0
34792,목스들/Noun,1,1,0,1.1115310228308472e-05,0.0,1.0
34793,444.44/Number,1,0,1,0.0,1.1106915165381966e-05,1.0
34794,444.444/Number,1,0,1,0.0,1.1106915165381966e-05,1.0
34795,4.444/Number,1,0,1,0.0,1.1106915165381966e-05,1.0
34796,께나/Noun,1,0,1,0.0,1.1106915165381966e-05,1.0
34797,-_-;;;;/Punctuation,1,0,1,0.0,1.1106915165381966e-05,1.0
34798,가각/Noun,1,0,1,0.0,1.1106915165381966e-05,1.0
34799,앤츠/Noun,1,1,0,1.1115310228308472e-05,0.0,1.0
34800,한서영/Noun,1,1,0,1.1115310228308472e-05,0.0,1.0
34801,강화도/Noun,1,1,0,1.1115310228308472e-05,0.0,1.0
34802,뭐얌/Noun,1,0,1,0.0,1.1106915165381966e-05,1.0
34803,용구/Noun,1,0,1,0.0,1.1106915165381966e-05,1.0
34804,전화번호부/Noun,1,0,1,0.0,1.1106915165381966e-05,1.0
34805,od/Alpha,1,1,0,1.1115310228308472e-05,0.0,1.0
34806,내세/Noun,1,0,1,0.0,1.1106915165381966e-05,1.0
34807,친생자/Noun,1,0,1,0.0,1.1106915165381966e-05,1.0
34808,검표/Noun,1,1,0,1.1115310228308472e-05,0.0,1.0
34809,커피숖/Noun,1,1,0,1.1115310228308472e-05,0.0,1.0
34810,계절풍/Noun,1,1,0,1.1115310228308472e-05,0.0,1.0
34811,쌋다/Noun,1,1,0,1.1115310228308472e-05,0.0,1.0
34812,moments/Alpha,1,1,0,1.1115310228308472e-05,0.0,1.0
34813,구준표/Noun,1,0,1,0.0,1.1106915165381966e-05,1.0
34814,~....../Punctuation,1,0,1,0.0,1.1106915165381966e-05,1.0
34815,pardise/Alpha,1,0,1,0.0,1.1106915165381966e-05,1.0
34816,almost/Alpha,1,0,1,0.0,1.1106915165381966e-05,1.0
34817,장/Foreign,1,0,1,0.0,1.1106915165381966e-05,1.0
34818,......^^/Punctuation,1,0,1,0.0,1.1106915165381966e-05,1.0
34819,쉬땜/Noun,1,0,1,0.0,1.1106915165381966e-05,1.0
34820,상쇄되/Noun,1,0,1,0.0,1.1106915165381966e-05,1.0
34821,매리/Noun,1,1,0,1.1115310228308472e-05,0.0,1.0
34822,랒우루어/Noun,1,1,0,1.1115310228308472e-05,0.0,1.0
34823,임영영/Noun,1,1,0,1.1115310228308472e-05,0.0,1.0
34824,휘청/Adverb,1,0,1,0.0,1.1106915165381966e-05,1.0
34825,전영화라고/Foreign,1,0,1,0.0,1.1106915165381966e-05,1.0
34826,eda/Alpha,1,0,1,0.0,1.1106915165381966e-05,1.0
34827,mcconaughey/Alpha,1,1,0,1.1115310228308472e-05,0.0,1.0
34828,matthew/Alpha,1,1,0,1.1115310228308472e-05,0.0,1.0
34829,얻지/Noun,1,0,1,0.0,1.1106915165381966e-05,1.0
34830,넬리/Noun,1,1,0,1.1115310228308472e-05,0.0,1.0
34831,어비/Noun,1,0,1,0.0,1.1106915165381966e-05,1.0
34832,뫼/Noun,1,0,1,0.0,1.1106915165381966e-05,1.0
34833,똥차반/Noun,1,0,1,0.0,1.1106915165381966e-05,1.0
34834,데예/Noun,1,0,1,0.0,1.1106915165381966e-05,1.0
34835,자룡/Noun,1,0,1,0.0,1.1106915165381966e-05,1.0
34836,천사구/Noun,1,1,0,1.1115310228308472e-05,0.0,1.0
34837,음악처럼/Noun,1,1,0,1.1115310228308472e-05,0.0,1.0
34838,번채/Noun,1,1,0,1.1115310228308472e-05,0.0,1.0
34839,동문/Noun,1,0,1,0.0,1.1106915165381966e-05,1.0
34840,남잠/Noun,1,0,1,0.0,1.1106915165381966e-05,1.0
34841,awg/Alpha,1,0,1,0.0,1.1106915165381966e-05,1.0
34842,혜교언/Noun,1,1,0,1.1115310228308472e-05,0.0,1.0
34843,재스퍼/Noun,1,1,0,1.1115310228308472e-05,0.0,1.0
34844,기결/Noun,1,0,1,0.0,1.1106915165381966e-05,1.0
34845,ToT/Alpha,1,1,0,1.1115310228308472e-05,0.0,1.0
34846,효고/Noun,1,0,1,0.0,1.1106915165381966e-05,1.0
34847,폴록/Noun,1,1,0,1.1115310228308472e-05,0.0,1.0
34848,모던아트/Noun,1,1,0,1.1115310228308472e-05,0.0,1.0
34849,안보리/Noun,1,0,1,0.0,1.1106915165381966e-05,1.0
34850,양으로/Noun,1,0,1,0.0,1.1106915165381966e-05,1.0
34851,인터네셔널/Noun,1,1,0,1.1115310228308472e-05,0.0,1.0
34852,출제/Noun,1,1,0,1.1115310228308472e-05,0.0,1.0
34853,극약/Noun,1,0,1,0.0,1.1106915165381966e-05,1.0
34854,마오쩌뚱/Noun,1,1,0,1.1115310228308472e-05,0.0,1.0
34855,넘어서/Foreign,1,1,0,1.1115310228308472e-05,0.0,1.0
34856,땸애/Noun,1,1,0,1.1115310228308472e-05,0.0,1.0
34857,시뮬레이터/Noun,1,0,1,0.0,1.1106915165381966e-05,1.0
34858,box/Alpha,1,0,1,0.0,1.1106915165381966e-05,1.0
34859,wig/Alpha,1,0,1,0.0,1.1106915165381966e-05,1.0
34860,죴같/Noun,1,0,1,0.0,1.1106915165381966e-05,1.0
34861,데드쉽/Noun,1,1,0,1.1115310228308472e-05,0.0,1.0
34862,전기문/Noun,1,1,0,1.1115310228308472e-05,0.0,1.0
34863,unconvincing/Alpha,1,0,1,0.0,1.1106915165381966e-05,1.0
34864,스트릿댄스/Noun,1,0,1,0.0,1.1106915165381966e-05,1.0
34865,괜탆/Noun,1,1,0,1.1115310228308472e-05,0.0,1.0
34866,사각사각/Adverb,1,0,1,0.0,1.1106915165381966e-05,1.0
34867,배렸음/Noun,1,0,1,0.0,1.1106915165381966e-05,1.0
34868,말괄량이/Noun,1,0,1,0.0,1.1106915165381966e-05,1.0
34869,웬빤쭈/Noun,1,0,1,0.0,1.1106915165381966e-05,1.0
34870,기달렸드/Noun,1,0,1,0.0,1.1106915165381966e-05,1.0
34871,대판/Foreign,1,0,1,0.0,1.1106915165381966e-05,1.0
34872,레이첵맥아덤스/Noun,1,0,1,0.0,1.1106915165381966e-05,1.0
34873,옹알거리다/Verb,1,0,1,0.0,1.1106915165381966e-05,1.0
34874,떽떽거리/Noun,1,1,0,1.1115310228308472e-05,0.0,1.0
34875,Emotion/Alpha,1,1,0,1.1115310228308472e-05,0.0,1.0
34876,cet/Alpha,1,1,0,1.1115310228308472e-05,0.0,1.0
34877,vu/Alpha,1,1,0,1.1115310228308472e-05,0.0,1.0
34878,jamais/Alpha,1,1,0,1.1115310228308472e-05,0.0,1.0
34879,ai/Alpha,1,1,0,1.1115310228308472e-05,0.0,1.0
34880,manifique/Alpha,1,1,0,1.1115310228308472e-05,0.0,1.0
34881,별안간/Noun,1,0,1,0.0,1.1106915165381966e-05,1.0
34882,~~>.</Punctuation,1,1,0,1.1115310228308472e-05,0.0,1.0
34883,흘럿/Noun,1,1,0,1.1115310228308472e-05,0.0,1.0
34884,비요/Noun,1,0,1,0.0,1.1106915165381966e-05,1.0
34885,주귬/Noun,1,1,0,1.1115310228308472e-05,0.0,1.0
34886,은상/Noun,1,1,0,1.1115310228308472e-05,0.0,1.0
34887,헬렌켈러/Noun,1,0,1,0.0,1.1106915165381966e-05,1.0
34888,업뎃/Noun,1,0,1,0.0,1.1106915165381966e-05,1.0
34889,bakseryung/Alpha,1,0,1,0.0,1.1106915165381966e-05,1.0
34890,생활관/Noun,1,1,0,1.1115310228308472e-05,0.0,1.0
34891,떡신/Noun,1,1,0,1.1115310228308472e-05,0.0,1.0
34892,공터/Noun,1,1,0,1.1115310228308472e-05,0.0,1.0
34893,더성/Noun,1,1,0,1.1115310228308472e-05,0.0,1.0
34894,미니멀리즘/Noun,1,1,0,1.1115310228308472e-05,0.0,1.0
34895,daughter/Alpha,1,0,1,0.0,1.1106915165381966e-05,1.0
34896,blower/Alpha,1,0,1,0.0,1.1106915165381966e-05,1.0
34897,동임/Noun,1,0,1,0.0,1.1106915165381966e-05,1.0
34898,적월/Noun,1,1,0,1.1115310228308472e-05,0.0,1.0
34899,병중/Noun,1,1,0,1.1115310228308472e-05,0.0,1.0
34900,속아봣/Noun,1,0,1,0.0,1.1106915165381966e-05,1.0
34901,청테이프/Noun,1,0,1,0.0,1.1106915165381966e-05,1.0
34902,계발/Noun,1,0,1,0.0,1.1106915165381966e-05,1.0
34903,169회/Number,1,0,1,0.0,1.1106915165381966e-05,1.0
34904,징http://www.podbbang.com/ch/7286/URL,1,1,0,1.1115310228308472e-05,0.0,1.0
34905,상/Foreign,1,1,0,1.1115310228308472e-05,0.0,1.0
34906,except/Alpha,1,0,1,0.0,1.1106915165381966e-05,1.0
34907,등장씬/Noun,1,0,1,0.0,1.1106915165381966e-05,1.0
34908,블랭크/Noun,1,0,1,0.0,1.1106915165381966e-05,1.0
34909,왜그/Noun,1,0,1,0.0,1.1106915165381966e-05,1.0
34910,까지잘해오셨으면서/Foreign,1,0,1,0.0,1.1106915165381966e-05,1.0
34911,ㅠㅠㅇㅇ/KoreanParticle,1,1,0,1.1115310228308472e-05,0.0,1.0
34912,CCM/Alpha,1,1,0,1.1115310228308472e-05,0.0,1.0
34913,컨트리송/Noun,1,1,0,1.1115310228308472e-05,0.0,1.0
34914,하챤/Noun,1,0,1,0.0,1.1106915165381966e-05,1.0
34915,영식/Noun,1,0,1,0.0,1.1106915165381966e-05,1.0
34916,작업복/Noun,1,1,0,1.1115310228308472e-05,0.0,1.0
34917,"),../Punctuation",1,1,0,1.1115310228308472e-05,0.0,1.0
34918,?///Punctuation,1,0,1,0.0,1.1106915165381966e-05,1.0
34919,글마/Noun,1,0,1,0.0,1.1106915165381966e-05,1.0
34920,생스터/Noun,1,1,0,1.1115310228308472e-05,0.0,1.0
34921,ㅡㅜㅜ/KoreanParticle,1,1,0,1.1115310228308472e-05,0.0,1.0
34922,뎁쇼/Noun,1,0,1,0.0,1.1106915165381966e-05,1.0
34923,븨디/Noun,1,1,0,1.1115310228308472e-05,0.0,1.0
34924,팬이므/Noun,1,1,0,1.1115310228308472e-05,0.0,1.0
34925,서번트/Noun,1,0,1,0.0,1.1106915165381966e-05,1.0
34926,도작인데/Foreign,1,1,0,1.1115310228308472e-05,0.0,1.0
34927,한약/Noun,1,0,1,0.0,1.1106915165381966e-05,1.0
34928,고기잡이/Noun,1,1,0,1.1115310228308472e-05,0.0,1.0
34929,漁火/Foreign,1,1,0,1.1115310228308472e-05,0.0,1.0
34930,어화/Noun,1,1,0,1.1115310228308472e-05,0.0,1.0
34931,왜일/Noun,1,0,1,0.0,1.1106915165381966e-05,1.0
34932,괜챦음/Noun,1,1,0,1.1115310228308472e-05,0.0,1.0
34933,要/Foreign,1,0,1,0.0,1.1106915165381966e-05,1.0
34934,냉동차/Noun,1,0,1,0.0,1.1106915165381966e-05,1.0
34935,무하/Noun,1,0,1,0.0,1.1106915165381966e-05,1.0
34936,정정아/Noun,1,0,1,0.0,1.1106915165381966e-05,1.0
34937,듭시/Noun,1,0,1,0.0,1.1106915165381966e-05,1.0
34938,경화/Noun,1,1,0,1.1115310228308472e-05,0.0,1.0
34939,이슬비/Noun,1,0,1,0.0,1.1106915165381966e-05,1.0
34940,헤화/Noun,1,1,0,1.1115310228308472e-05,0.0,1.0
34941,ㄹㅇㅇㅈ/KoreanParticle,1,0,1,0.0,1.1106915165381966e-05,1.0
34942,몬생김/Noun,1,0,1,0.0,1.1106915165381966e-05,1.0
34943,후천/Noun,1,0,1,0.0,1.1106915165381966e-05,1.0
34944,Syndrome/Alpha,1,0,1,0.0,1.1106915165381966e-05,1.0
34945,Deficiency/Alpha,1,0,1,0.0,1.1106915165381966e-05,1.0
34946,Immune/Alpha,1,0,1,0.0,1.1106915165381966e-05,1.0
34947,Acquired/Alpha,1,0,1,0.0,1.1106915165381966e-05,1.0
34948,겉모양/Noun,1,1,0,1.1115310228308472e-05,0.0,1.0
34949,생의/Foreign,1,1,0,1.1115310228308472e-05,0.0,1.0
34950,태배/Noun,1,0,1,0.0,1.1106915165381966e-05,1.0
34951,스파르탄/Noun,1,0,1,0.0,1.1106915165381966e-05,1.0
34952,남침/Noun,1,0,1,0.0,1.1106915165381966e-05,1.0
34953,고려사/Noun,1,0,1,0.0,1.1106915165381966e-05,1.0
34954,뭉첬구/Noun,1,0,1,0.0,1.1106915165381966e-05,1.0
34955,시대정신/Noun,1,1,0,1.1115310228308472e-05,0.0,1.0
34956,피크타임/Noun,1,0,1,0.0,1.1106915165381966e-05,1.0
34957,생물학자/Noun,1,0,1,0.0,1.1106915165381966e-05,1.0
34958,염기/Noun,1,0,1,0.0,1.1106915165381966e-05,1.0
34959,닝기미/Noun,1,0,1,0.0,1.1106915165381966e-05,1.0
34960,엄떠/Noun,1,0,1,0.0,1.1106915165381966e-05,1.0
34961,"...,,,,/Punctuation",1,0,1,0.0,1.1106915165381966e-05,1.0
34962,아틀란틱/Noun,1,1,0,1.1115310228308472e-05,0.0,1.0
34963,에그머니/Exclamation,1,1,0,1.1115310228308472e-05,0.0,1.0
34964,휠씬잼밌/Noun,1,0,1,0.0,1.1106915165381966e-05,1.0
34965,;;;;;;;;;;;;;;/Punctuation,1,0,1,0.0,1.1106915165381966e-05,1.0
34966,.............................../Punctuation,1,0,1,0.0,1.1106915165381966e-05,1.0
34967,.^.^/Punctuation,1,1,0,1.1115310228308472e-05,0.0,1.0
34968,몆번을봐/Noun,1,1,0,1.1115310228308472e-05,0.0,1.0
34969,커스틴던스트/Noun,1,1,0,1.1115310228308472e-05,0.0,1.0
34970,comegod.org/URL,1,1,0,1.1115310228308472e-05,0.0,1.0
34971,70일/Number,1,1,0,1.1115310228308472e-05,0.0,1.0
34972,꺼버릴껄/Noun,1,0,1,0.0,1.1106915165381966e-05,1.0
34973,유벙언/Noun,1,0,1,0.0,1.1106915165381966e-05,1.0
34974,너무촌스롭/Noun,1,0,1,0.0,1.1106915165381966e-05,1.0
34975,벽뒤/Noun,1,1,0,1.1115310228308472e-05,0.0,1.0
34976,엔들리스러브/Noun,1,1,0,1.1115310228308472e-05,0.0,1.0
34977,멀끔하다/Adjective,1,1,0,1.1115310228308472e-05,0.0,1.0
34978,왕복/Noun,1,0,1,0.0,1.1106915165381966e-05,1.0
34979,DVDRIP/Alpha,1,0,1,0.0,1.1106915165381966e-05,1.0
34980,경일/Noun,1,0,1,0.0,1.1106915165381966e-05,1.0
34981,실세/Noun,1,1,0,1.1115310228308472e-05,0.0,1.0
34982,팬스가/Noun,1,1,0,1.1115310228308472e-05,0.0,1.0
34983,한우물/Noun,1,0,1,0.0,1.1106915165381966e-05,1.0
34984,~!~!~!~!~!~!~!~/Punctuation,1,1,0,1.1115310228308472e-05,0.0,1.0
34985,바꼇다/Noun,1,1,0,1.1115310228308472e-05,0.0,1.0
34986,옴마니반메훔/Noun,1,1,0,1.1115310228308472e-05,0.0,1.0
34987,미륵/Noun,1,1,0,1.1115310228308472e-05,0.0,1.0
34988,인전/Noun,1,0,1,0.0,1.1106915165381966e-05,1.0
34989,만화챡/Noun,1,0,1,0.0,1.1106915165381966e-05,1.0
34990,ㅡㅡㅇ/KoreanParticle,1,0,1,0.0,1.1106915165381966e-05,1.0
34991,드보브/Noun,1,1,0,1.1115310228308472e-05,0.0,1.0
34992,낙선군/Noun,1,0,1,0.0,1.1106915165381966e-05,1.0
34993,숭선군/Noun,1,0,1,0.0,1.1106915165381966e-05,1.0
34994,효명옹주/Noun,1,0,1,0.0,1.1106915165381966e-05,1.0
34995,Screen/Alpha,1,1,0,1.1115310228308472e-05,0.0,1.0
34996,pas/Alpha,1,1,0,1.1115310228308472e-05,0.0,1.0
34997,quitte/Alpha,1,1,0,1.1115310228308472e-05,0.0,1.0
34998,mon/Alpha,1,1,0,1.1115310228308472e-05,0.0,1.0
34999,케드/Noun,1,1,0,1.1115310228308472e-05,0.0,1.0
35000,소사이어티/Noun,1,0,1,0.0,1.1106915165381966e-05,1.0
35001,ㅉㅉㅅㅋ/KoreanParticle,1,1,0,1.1115310228308472e-05,0.0,1.0
35002,hi/Alpha,1,1,0,1.1115310228308472e-05,0.0,1.0
35003,5740/Number,1,1,0,1.1115310228308472e-05,0.0,1.0
35004,hihi/Alpha,1,1,0,1.1115310228308472e-05,0.0,1.0
35005,으랏차/Noun,1,0,1,0.0,1.1106915165381966e-05,1.0
35006,WATER/Alpha,1,0,1,0.0,1.1106915165381966e-05,1.0
35007,WOOOOOOD/Alpha,1,0,1,0.0,1.1106915165381966e-05,1.0
35008,노라애프론/Noun,1,1,0,1.1115310228308472e-05,0.0,1.0
35009,쨍쨍거리다/Verb,1,0,1,0.0,1.1106915165381966e-05,1.0
35010,날달걀/Noun,1,1,0,1.1115310228308472e-05,0.0,1.0
35011,김기현/Noun,1,0,1,0.0,1.1106915165381966e-05,1.0
35012,pc/Alpha,1,1,0,1.1115310228308472e-05,0.0,1.0
35013,장기판/Noun,1,1,0,1.1115310228308472e-05,0.0,1.0
35014,코키/Noun,1,1,0,1.1115310228308472e-05,0.0,1.0
35015,헛주먹/Noun,1,1,0,1.1115310228308472e-05,0.0,1.0
35016,73억/Number,1,1,0,1.1115310228308472e-05,0.0,1.0
35017,나긋나긋하다/Adjective,1,1,0,1.1115310228308472e-05,0.0,1.0
35018,ㅅㅂㅅㅂ/KoreanParticle,1,0,1,0.0,1.1106915165381966e-05,1.0
35019,스팽킹/Noun,1,0,1,0.0,1.1106915165381966e-05,1.0
35020,드라마등극/Foreign,1,1,0,1.1115310228308472e-05,0.0,1.0
35021,2.223423434324434/Number,1,0,1,0.0,1.1106915165381966e-05,1.0
35022,이종/Noun,1,0,1,0.0,1.1106915165381966e-05,1.0
35023,버디버디/Noun,1,0,1,0.0,1.1106915165381966e-05,1.0
35024,이녕/Noun,1,1,0,1.1115310228308472e-05,0.0,1.0
35025,★☆/Foreign,1,1,0,1.1115310228308472e-05,0.0,1.0
35026,재중이/Noun,1,1,0,1.1115310228308472e-05,0.0,1.0
35027,차악/Noun,1,0,1,0.0,1.1106915165381966e-05,1.0
35028,토나쟈/Noun,1,1,0,1.1115310228308472e-05,0.0,1.0
35029,도거라지만/Foreign,1,1,0,1.1115310228308472e-05,0.0,1.0
35030,말짱하다/Adjective,1,0,1,0.0,1.1106915165381966e-05,1.0
35031,점초/Noun,1,0,1,0.0,1.1106915165381966e-05,1.0
35032,레지/Noun,1,0,1,0.0,1.1106915165381966e-05,1.0
35033,잊지맙시/Noun,1,1,0,1.1115310228308472e-05,0.0,1.0
35034,..^^//Punctuation,1,1,0,1.1115310228308472e-05,0.0,1.0
35035,베슬/Noun,1,1,0,1.1115310228308472e-05,0.0,1.0
35036,사이오닉/Noun,1,1,0,1.1115310228308472e-05,0.0,1.0
35037,엄폐/Noun,1,0,1,0.0,1.1106915165381966e-05,1.0
35038,날밤/Noun,1,1,0,1.1115310228308472e-05,0.0,1.0
35039,갈비뼈/Noun,1,1,0,1.1115310228308472e-05,0.0,1.0
35040,거것/Noun,1,0,1,0.0,1.1106915165381966e-05,1.0
35041,페레/Noun,1,1,0,1.1115310228308472e-05,0.0,1.0
35042,각설이/Noun,1,0,1,0.0,1.1106915165381966e-05,1.0
35043,FR/Alpha,1,0,1,0.0,1.1106915165381966e-05,1.0
35044,GTR/Alpha,1,0,1,0.0,1.1106915165381966e-05,1.0
35045,타케히코/Noun,1,0,1,0.0,1.1106915165381966e-05,1.0
35046,연탄재/Noun,1,1,0,1.1115310228308472e-05,0.0,1.0
35047,개쥣불반/Noun,1,0,1,0.0,1.1106915165381966e-05,1.0
35048,어렷울때/Noun,1,1,0,1.1115310228308472e-05,0.0,1.0
35049,전섹/Noun,1,1,0,1.1115310228308472e-05,0.0,1.0
35050,꼭짓점/Noun,1,0,1,0.0,1.1106915165381966e-05,1.0
35051,...^^!/Punctuation,1,1,0,1.1115310228308472e-05,0.0,1.0
35052,Between/Alpha,1,1,0,1.1115310228308472e-05,0.0,1.0
35053,강철수/Noun,1,0,1,0.0,1.1106915165381966e-05,1.0
35054,데레사/Noun,1,1,0,1.1115310228308472e-05,0.0,1.0
35055,유마/Noun,1,1,0,1.1115310228308472e-05,0.0,1.0
35056,151분/Number,1,1,0,1.1115310228308472e-05,0.0,1.0
35057,가포/Noun,1,0,1,0.0,1.1106915165381966e-05,1.0
35058,진두/Noun,1,0,1,0.0,1.1106915165381966e-05,1.0
35059,피페/Noun,1,0,1,0.0,1.1106915165381966e-05,1.0
35060,샠키/Noun,1,0,1,0.0,1.1106915165381966e-05,1.0
35061,함대지/Noun,1,0,1,0.0,1.1106915165381966e-05,1.0
35062,트레이시/Noun,1,1,0,1.1115310228308472e-05,0.0,1.0
35063,과중/Noun,1,1,0,1.1115310228308472e-05,0.0,1.0
35064,힘드넹/Noun,1,0,1,0.0,1.1106915165381966e-05,1.0
35065,핮/Noun,1,1,0,1.1115310228308472e-05,0.0,1.0
35066,슈츠/Noun,1,0,1,0.0,1.1106915165381966e-05,1.0
35067,Singer/Alpha,1,1,0,1.1115310228308472e-05,0.0,1.0
35068,오세홍/Noun,1,1,0,1.1115310228308472e-05,0.0,1.0
35069,청률이/Foreign,1,0,1,0.0,1.1106915165381966e-05,1.0
35070,8.4시/Number,1,0,1,0.0,1.1106915165381966e-05,1.0
35071,娼婦街はノッムビ/Foreign,1,1,0,1.1115310228308472e-05,0.0,1.0
35072,に悲しい現/Foreign,1,1,0,1.1115310228308472e-05,0.0,1.0
35073,あ、セックスしたいのにセックスできない本/Foreign,1,1,0,1.1115310228308472e-05,0.0,1.0
35074,セックス/Foreign,1,1,0,1.1115310228308472e-05,0.0,1.0
35075,日自慰をして自衛することよりセックスがしたいです。女性生殖器に私の生殖器を朴で熱くセックスをしたいですセックス/Foreign,1,1,0,1.1115310228308472e-05,0.0,1.0
35076,の男の子ですセックス家庭話したいです/Foreign,1,1,0,1.1115310228308472e-05,0.0,1.0
35077,にしたい/Foreign,1,1,0,1.1115310228308472e-05,0.0,1.0
35078,私はセックスが本/Foreign,1,1,0,1.1115310228308472e-05,0.0,1.0
35079,??????????????????????????????????????/Punctuation,1,1,0,1.1115310228308472e-05,0.0,1.0
35080,무왜/Noun,1,1,0,1.1115310228308472e-05,0.0,1.0
35081,느므느므/Noun,1,1,0,1.1115310228308472e-05,0.0,1.0
35082,폰섹스/Noun,1,0,1,0.0,1.1106915165381966e-05,1.0
35083,중궈애들/Noun,1,0,1,0.0,1.1106915165381966e-05,1.0
35084,김형규/Noun,1,0,1,0.0,1.1106915165381966e-05,1.0
35085,흐뭇다/Adjective,1,1,0,1.1115310228308472e-05,0.0,1.0
35086,좋네엽/Noun,1,1,0,1.1115310228308472e-05,0.0,1.0
35087,만세덕/Noun,1,1,0,1.1115310228308472e-05,0.0,1.0
35088,장적/Noun,1,0,1,0.0,1.1106915165381966e-05,1.0
35089,바교/Noun,1,1,0,1.1115310228308472e-05,0.0,1.0
35090,꾸기다/Verb,1,0,1,0.0,1.1106915165381966e-05,1.0
35091,찟긴데/Noun,1,0,1,0.0,1.1106915165381966e-05,1.0
35092,러브레턴/Noun,1,0,1,0.0,1.1106915165381966e-05,1.0
35093,기가믹히/Noun,1,0,1,0.0,1.1106915165381966e-05,1.0
35094,김선재/Noun,1,1,0,1.1115310228308472e-05,0.0,1.0
35095,지요/Eomi,1,0,1,0.0,1.1106915165381966e-05,1.0
35096,흘깃/Noun,1,0,1,0.0,1.1106915165381966e-05,1.0
35097,수희/Noun,1,1,0,1.1115310228308472e-05,0.0,1.0
35098,ADHD/Alpha,1,0,1,0.0,1.1106915165381966e-05,1.0
35099,판용/Noun,1,1,0,1.1115310228308472e-05,0.0,1.0
35100,쓰뤠/Noun,1,0,1,0.0,1.1106915165381966e-05,1.0
35101,꼬매버릴뻔/Noun,1,0,1,0.0,1.1106915165381966e-05,1.0
35102,마이나스/Noun,1,0,1,0.0,1.1106915165381966e-05,1.0
35103,쫑훈이/Noun,1,1,0,1.1115310228308472e-05,0.0,1.0
35104,Horrorfest/Alpha,1,0,1,0.0,1.1106915165381966e-05,1.0
35105,Dark/Alpha,1,0,1,0.0,1.1106915165381966e-05,1.0
35106,ㄱㄷ/KoreanParticle,1,1,0,1.1115310228308472e-05,0.0,1.0
35107,싖/Noun,1,1,0,1.1115310228308472e-05,0.0,1.0
35108,참나훗그/Noun,1,1,0,1.1115310228308472e-05,0.0,1.0
35109,트롤링/Noun,1,0,1,0.0,1.1106915165381966e-05,1.0
35110,프로파일링/Noun,1,0,1,0.0,1.1106915165381966e-05,1.0
35111,점준뇬/Noun,1,0,1,0.0,1.1106915165381966e-05,1.0
35112,옥죈다/Noun,1,1,0,1.1115310228308472e-05,0.0,1.0
35113,일거리/Noun,1,1,0,1.1115310228308472e-05,0.0,1.0
35114,느러뜨려놓/Noun,1,0,1,0.0,1.1106915165381966e-05,1.0
35115,뉴윤/Noun,1,1,0,1.1115310228308472e-05,0.0,1.0
35116,Boxi/Alpha,1,1,0,1.1115310228308472e-05,0.0,1.0
35117,감득/Noun,1,1,0,1.1115310228308472e-05,0.0,1.0
35118,벤드/Noun,1,1,0,1.1115310228308472e-05,0.0,1.0
35119,엘빈/Noun,1,1,0,1.1115310228308472e-05,0.0,1.0
35120,선점/Noun,1,0,1,0.0,1.1106915165381966e-05,1.0
35121,bravo/Alpha,1,1,0,1.1115310228308472e-05,0.0,1.0
35122,미천/Noun,1,0,1,0.0,1.1106915165381966e-05,1.0
35123,동안봤다니/Foreign,1,0,1,0.0,1.1106915165381966e-05,1.0
35124,업씬/Noun,1,0,1,0.0,1.1106915165381966e-05,1.0
35125,코핑/Noun,1,0,1,0.0,1.1106915165381966e-05,1.0
35126,로토스/Noun,1,0,1,0.0,1.1106915165381966e-05,1.0
35127,척후/Noun,1,0,1,0.0,1.1106915165381966e-05,1.0
35128,픽트족/Noun,1,0,1,0.0,1.1106915165381966e-05,1.0
35129,평행봉/Noun,1,1,0,1.1115310228308472e-05,0.0,1.0
35130,코마네치/Noun,1,1,0,1.1115310228308472e-05,0.0,1.0
35131,사자춤/Noun,1,1,0,1.1115310228308472e-05,0.0,1.0
35132,아랏시노/Noun,1,1,0,1.1115310228308472e-05,0.0,1.0
35133,거늘/Eomi,1,0,1,0.0,1.1106915165381966e-05,1.0
35134,아진짜쫭쫭쫭/Noun,1,1,0,1.1115310228308472e-05,0.0,1.0
35135,브레너/Noun,1,1,0,1.1115310228308472e-05,0.0,1.0
35136,줄넘기/Noun,1,0,1,0.0,1.1106915165381966e-05,1.0
35137,Seydoux/Alpha,1,0,1,0.0,1.1106915165381966e-05,1.0
35138,Lea/Alpha,1,0,1,0.0,1.1106915165381966e-05,1.0
35139,탈리즘/Foreign,1,0,1,0.0,1.1106915165381966e-05,1.0
35140,19엔/Number,1,0,1,0.0,1.1106915165381966e-05,1.0
35141,쿰/Noun,1,1,0,1.1115310228308472e-05,0.0,1.0
35142,~??^^;;/Punctuation,1,0,1,0.0,1.1106915165381966e-05,1.0
35143,빽투더/Noun,1,0,1,0.0,1.1106915165381966e-05,1.0
35144,판이하다/Adjective,1,0,1,0.0,1.1106915165381966e-05,1.0
35145,양감/Noun,1,1,0,1.1115310228308472e-05,0.0,1.0
35146,잉글로바/Noun,1,1,0,1.1115310228308472e-05,0.0,1.0
35147,마케타/Noun,1,1,0,1.1115310228308472e-05,0.0,1.0
35148,청담동앨리스/Noun,1,1,0,1.1115310228308472e-05,0.0,1.0
35149,만에다봤다/Foreign,1,1,0,1.1115310228308472e-05,0.0,1.0
35150,ㅆㅑㅇ/KoreanParticle,1,1,0,1.1115310228308472e-05,0.0,1.0
35151,핵답답/Noun,1,0,1,0.0,1.1106915165381966e-05,1.0
35152,가빈/Noun,1,0,1,0.0,1.1106915165381966e-05,1.0
35153,말복/Noun,1,0,1,0.0,1.1106915165381966e-05,1.0
35154,초복/Noun,1,0,1,0.0,1.1106915165381966e-05,1.0
35155,대까지/Foreign,1,0,1,0.0,1.1106915165381966e-05,1.0
35156,신날떄/Noun,1,1,0,1.1115310228308472e-05,0.0,1.0
35157,모르거나/Noun,1,1,0,1.1115310228308472e-05,0.0,1.0
35158,가엽더/Noun,1,0,1,0.0,1.1106915165381966e-05,1.0
35159,초딩떄였/Noun,1,1,0,1.1115310228308472e-05,0.0,1.0
35160,수통/Noun,1,0,1,0.0,1.1106915165381966e-05,1.0
35161,보딩/Noun,1,0,1,0.0,1.1106915165381966e-05,1.0
35162,레포츠/Noun,1,0,1,0.0,1.1106915165381966e-05,1.0
35163,코스모폴리스/Noun,1,0,1,0.0,1.1106915165381966e-05,1.0
35164,스메/Noun,1,0,1,0.0,1.1106915165381966e-05,1.0
35165,목쪽/Noun,1,0,1,0.0,1.1106915165381966e-05,1.0
35166,▶◀/Foreign,1,1,0,1.1115310228308472e-05,0.0,1.0
35167,배곱/Noun,1,1,0,1.1115310228308472e-05,0.0,1.0
35168,4만원/Number,1,0,1,0.0,1.1106915165381966e-05,1.0
35169,송년/Noun,1,0,1,0.0,1.1106915165381966e-05,1.0
35170,시경/Noun,1,0,1,0.0,1.1106915165381966e-05,1.0
35171,차렷/Exclamation,1,1,0,1.1115310228308472e-05,0.0,1.0
35172,엣끼/Noun,1,0,1,0.0,1.1106915165381966e-05,1.0
35173,딥디/Noun,1,1,0,1.1115310228308472e-05,0.0,1.0
35174,런거안해/Noun,1,0,1,0.0,1.1106915165381966e-05,1.0
35175,수락폭포/Noun,1,1,0,1.1115310228308472e-05,0.0,1.0
35176,지리산/Noun,1,1,0,1.1115310228308472e-05,0.0,1.0
35177,조휘/Noun,1,1,0,1.1115310228308472e-05,0.0,1.0
35178,연맹/Noun,1,1,0,1.1115310228308472e-05,0.0,1.0
35179,"""../Punctuation",1,1,0,1.1115310228308472e-05,0.0,1.0
35180,조지아/Noun,1,0,1,0.0,1.1106915165381966e-05,1.0
35181,김규원/Noun,1,0,1,0.0,1.1106915165381966e-05,1.0
35182,면발/Noun,1,0,1,0.0,1.1106915165381966e-05,1.0
35183,밍아웃/Suffix,1,0,1,0.0,1.1106915165381966e-05,1.0
35184,말죽거리잔혹사/Noun,1,1,0,1.1115310228308472e-05,0.0,1.0
35185,푸춰핸섭/Noun,1,0,1,0.0,1.1106915165381966e-05,1.0
35186,저스트/Noun,1,0,1,0.0,1.1106915165381966e-05,1.0
35187,지프로/Noun,1,1,0,1.1115310228308472e-05,0.0,1.0
35188,수뤠기/Noun,1,0,1,0.0,1.1106915165381966e-05,1.0
35189,괞찬아/Noun,1,1,0,1.1115310228308472e-05,0.0,1.0
35190,어씨/Noun,1,0,1,0.0,1.1106915165381966e-05,1.0
35191,좋늡니/Noun,1,1,0,1.1115310228308472e-05,0.0,1.0
35192,프리즈너스/Noun,1,0,1,0.0,1.1106915165381966e-05,1.0
35193,브레이크다운/Noun,1,1,0,1.1115310228308472e-05,0.0,1.0
35194,훗까시남/Noun,1,0,1,0.0,1.1106915165381966e-05,1.0
35195,씨등/Noun,1,0,1,0.0,1.1106915165381966e-05,1.0
35196,족장/Noun,1,0,1,0.0,1.1106915165381966e-05,1.0
35197,와오라니/Noun,1,0,1,0.0,1.1106915165381966e-05,1.0
35198,백내장/Noun,1,0,1,0.0,1.1106915165381966e-05,1.0
35199,water/Alpha,1,0,1,0.0,1.1106915165381966e-05,1.0
35200,버는듯/Noun,1,0,1,0.0,1.1106915165381966e-05,1.0
35201,힘따윈/Noun,1,0,1,0.0,1.1106915165381966e-05,1.0
35202,밎어지/Noun,1,0,1,0.0,1.1106915165381966e-05,1.0
35203,들어주셈/Foreign,1,1,0,1.1115310228308472e-05,0.0,1.0
35204,인신공격/Noun,1,1,0,1.1115310228308472e-05,0.0,1.0
35205,음거/Noun,1,0,1,0.0,1.1106915165381966e-05,1.0
35206,리살/Noun,1,0,1,0.0,1.1106915165381966e-05,1.0
35207,잘못뎄/Noun,1,0,1,0.0,1.1106915165381966e-05,1.0
35208,축하파티/Noun,1,0,1,0.0,1.1106915165381966e-05,1.0
35209,학겨/Noun,1,0,1,0.0,1.1106915165381966e-05,1.0
35210,2-3/Number,1,0,1,0.0,1.1106915165381966e-05,1.0
35211,0.39/Number,1,0,1,0.0,1.1106915165381966e-05,1.0
35212,",;;/Punctuation",1,0,1,0.0,1.1106915165381966e-05,1.0
35213,아연/Noun,1,1,0,1.1115310228308472e-05,0.0,1.0
35214,외로이/Adverb,1,1,0,1.1115310228308472e-05,0.0,1.0
35215,thbn/Alpha,1,1,0,1.1115310228308472e-05,0.0,1.0
35216,tfvbvyt/Alpha,1,1,0,1.1115310228308472e-05,0.0,1.0
35217,6465/Number,1,1,0,1.1115310228308472e-05,0.0,1.0
35218,밀커스/Noun,1,0,1,0.0,1.1106915165381966e-05,1.0
35219,作品/Foreign,1,1,0,1.1115310228308472e-05,0.0,1.0
35220,神/Foreign,1,1,0,1.1115310228308472e-05,0.0,1.0
35221,.!?/Punctuation,1,1,0,1.1115310228308472e-05,0.0,1.0
35222,느닥없/Noun,1,0,1,0.0,1.1106915165381966e-05,1.0
35223,재밌쎠/Noun,1,1,0,1.1115310228308472e-05,0.0,1.0
35224,복거일/Noun,1,0,1,0.0,1.1106915165381966e-05,1.0
35225,대법/Noun,1,0,1,0.0,1.1106915165381966e-05,1.0
35226,상구/Noun,1,1,0,1.1115310228308472e-05,0.0,1.0
35227,뜨형/Noun,1,0,1,0.0,1.1106915165381966e-05,1.0
35228,롭도/Noun,1,1,0,1.1115310228308472e-05,0.0,1.0
35229,진기/Noun,1,1,0,1.1115310228308472e-05,0.0,1.0
35230,노팅엄/Noun,1,1,0,1.1115310228308472e-05,0.0,1.0
35231,잼잼꿀잼잼/Noun,1,1,0,1.1115310228308472e-05,0.0,1.0
35232,꾸르꾸르/Noun,1,1,0,1.1115310228308472e-05,0.0,1.0
35233,폭하/Noun,1,0,1,0.0,1.1106915165381966e-05,1.0
35234,김용옥/Noun,1,1,0,1.1115310228308472e-05,0.0,1.0
35235,제입/Noun,1,1,0,1.1115310228308472e-05,0.0,1.0
35236,봉건제/Noun,1,1,0,1.1115310228308472e-05,0.0,1.0
35237,개똥망납뜩/Noun,1,0,1,0.0,1.1106915165381966e-05,1.0
35238,뭐넀을때/Noun,1,1,0,1.1115310228308472e-05,0.0,1.0
35239,로즈껍니/Noun,1,1,0,1.1115310228308472e-05,0.0,1.0
35240,멕시코인/Noun,1,1,0,1.1115310228308472e-05,0.0,1.0
35241,21:58/Number,1,1,0,1.1115310228308472e-05,0.0,1.0
35242,2007-9/Number,1,1,0,1.1115310228308472e-05,0.0,1.0
35243,국내외/Noun,1,0,1,0.0,1.1106915165381966e-05,1.0
35244,1953년/Number,1,1,0,1.1115310228308472e-05,0.0,1.0
35245,인플레/Noun,1,1,0,1.1115310228308472e-05,0.0,1.0
35246,??;;/;////Punctuation,1,0,1,0.0,1.1106915165381966e-05,1.0
35247,아침이슬/Noun,1,0,1,0.0,1.1106915165381966e-05,1.0
35248,파쿠/Noun,1,1,0,1.1115310228308472e-05,0.0,1.0
35249,에지마/Noun,1,0,1,0.0,1.1106915165381966e-05,1.0
35250,민도희/Noun,1,1,0,1.1115310228308472e-05,0.0,1.0
35251,김정국/Noun,1,1,0,1.1115310228308472e-05,0.0,1.0
35252,페데리코/Noun,1,1,0,1.1115310228308472e-05,0.0,1.0
35253,베넷밀러/Noun,1,1,0,1.1115310228308472e-05,0.0,1.0
35254,일륜/Noun,1,0,1,0.0,1.1106915165381966e-05,1.0
35255,현풍/Noun,1,0,1,0.0,1.1106915165381966e-05,1.0
35256,김수/Noun,1,0,1,0.0,1.1106915165381966e-05,1.0
35257,분심/Noun,1,1,0,1.1115310228308472e-05,0.0,1.0
35258,인간시장/Noun,1,0,1,0.0,1.1106915165381966e-05,1.0
35259,레드라이트/Noun,1,0,1,0.0,1.1106915165381966e-05,1.0
35260,낭랑하다/Adjective,1,0,1,0.0,1.1106915165381966e-05,1.0
35261,..?^^/Punctuation,1,1,0,1.1115310228308472e-05,0.0,1.0
35262,노총각노처녀/Noun,1,1,0,1.1115310228308472e-05,0.0,1.0
35263,준정/Noun,1,0,1,0.0,1.1106915165381966e-05,1.0
35264,상중/Noun,1,1,0,1.1115310228308472e-05,0.0,1.0
35265,본성인/Noun,1,1,0,1.1115310228308472e-05,0.0,1.0
35266,",.~/Punctuation",1,0,1,0.0,1.1106915165381966e-05,1.0
35267,돌림노래/Noun,1,0,1,0.0,1.1106915165381966e-05,1.0
35268,태견등장/Noun,1,0,1,0.0,1.1106915165381966e-05,1.0
35269,킹스크로스/Noun,1,1,0,1.1115310228308472e-05,0.0,1.0
35270,윤둘/Noun,1,1,0,1.1115310228308472e-05,0.0,1.0
35271,핀첼/Noun,1,1,0,1.1115310228308472e-05,0.0,1.0
35272,상박/Noun,1,1,0,1.1115310228308472e-05,0.0,1.0
35273,배접/Noun,1,1,0,1.1115310228308472e-05,0.0,1.0
35274,이부자/Noun,1,1,0,1.1115310228308472e-05,0.0,1.0
35275,60일/Number,1,1,0,1.1115310228308472e-05,0.0,1.0
35276,로멘틱해/Noun,1,0,1,0.0,1.1106915165381966e-05,1.0
35277,돈나/Noun,1,0,1,0.0,1.1106915165381966e-05,1.0
35278,레곤/Noun,1,1,0,1.1115310228308472e-05,0.0,1.0
35279,콜로디/Noun,1,0,1,0.0,1.1106915165381966e-05,1.0
35280,형광등/Noun,1,1,0,1.1115310228308472e-05,0.0,1.0
35281,32분/Number,1,1,0,1.1115310228308472e-05,0.0,1.0
35282,ㄹㅈㅂㅇ/KoreanParticle,1,1,0,1.1115310228308472e-05,0.0,1.0
35283,닛뽀리/Noun,1,1,0,1.1115310228308472e-05,0.0,1.0
35284,만이네/Foreign,1,0,1,0.0,1.1106915165381966e-05,1.0
35285,보편화/Noun,1,1,0,1.1115310228308472e-05,0.0,1.0
35286,aint/Alpha,1,1,0,1.1115310228308472e-05,0.0,1.0
35287,날토/Noun,1,1,0,1.1115310228308472e-05,0.0,1.0
35288,꼬붕/Noun,1,0,1,0.0,1.1106915165381966e-05,1.0
35289,츠네모리/Noun,1,1,0,1.1115310228308472e-05,0.0,1.0
35290,이글거리다/Verb,1,0,1,0.0,1.1106915165381966e-05,1.0
35291,낚신/Noun,1,0,1,0.0,1.1106915165381966e-05,1.0
35292,웨이트리스/Noun,1,1,0,1.1115310228308472e-05,0.0,1.0
35293,델브/Noun,1,1,0,1.1115310228308472e-05,0.0,1.0
35294,야닌/Noun,1,0,1,0.0,1.1106915165381966e-05,1.0
35295,질뻔/Noun,1,1,0,1.1115310228308472e-05,0.0,1.0
35296,능지처참/Noun,1,1,0,1.1115310228308472e-05,0.0,1.0
35297,악의교전/Noun,1,1,0,1.1115310228308472e-05,0.0,1.0
35298,공차/Noun,1,1,0,1.1115310228308472e-05,0.0,1.0
35299,kame/Alpha,1,1,0,1.1115310228308472e-05,0.0,1.0
35300,정주연/Noun,1,1,0,1.1115310228308472e-05,0.0,1.0
35301,참회록/Noun,1,0,1,0.0,1.1106915165381966e-05,1.0
35302,트덕/Noun,1,1,0,1.1115310228308472e-05,0.0,1.0
35303,칙쇼/Noun,1,0,1,0.0,1.1106915165381966e-05,1.0
35304,정물화/Noun,1,0,1,0.0,1.1106915165381966e-05,1.0
35305,인물화/Noun,1,0,1,0.0,1.1106915165381966e-05,1.0
35306,추상화/Noun,1,0,1,0.0,1.1106915165381966e-05,1.0
35307,(-_-)..../Punctuation,1,0,1,0.0,1.1106915165381966e-05,1.0
35308,사상충/Noun,1,1,0,1.1115310228308472e-05,0.0,1.0
35309,임성언/Noun,1,0,1,0.0,1.1106915165381966e-05,1.0
35310,vsDC/Alpha,1,0,1,0.0,1.1106915165381966e-05,1.0
35311,궁내/Noun,1,0,1,0.0,1.1106915165381966e-05,1.0
35312,business/Alpha,1,0,1,0.0,1.1106915165381966e-05,1.0
35313,Music/Alpha,1,0,1,0.0,1.1106915165381966e-05,1.0
35314,Fucked/Alpha,1,0,1,0.0,1.1106915165381966e-05,1.0
35315,ZZANG/Alpha,1,1,0,1.1115310228308472e-05,0.0,1.0
35316,케보키언/Noun,1,0,1,0.0,1.1106915165381966e-05,1.0
35317,지역방송국/Noun,1,0,1,0.0,1.1106915165381966e-05,1.0
35318,!!~~@@/Punctuation,1,1,0,1.1115310228308472e-05,0.0,1.0
35319,자신만만하다/Adjective,1,1,0,1.1115310228308472e-05,0.0,1.0
35320,라프같/Noun,1,1,0,1.1115310228308472e-05,0.0,1.0
35321,이원석/Noun,1,0,1,0.0,1.1106915165381966e-05,1.0
35322,학대죄/Noun,1,0,1,0.0,1.1106915165381966e-05,1.0
35323,주크/Noun,1,0,1,0.0,1.1106915165381966e-05,1.0
35324,빈티/Noun,1,0,1,0.0,1.1106915165381966e-05,1.0
35325,0.00000001%/Number,1,0,1,0.0,1.1106915165381966e-05,1.0
35326,진흥/Noun,1,0,1,0.0,1.1106915165381966e-05,1.0
35327,양현종/Noun,1,0,1,0.0,1.1106915165381966e-05,1.0
35328,스톡홀름/Noun,1,1,0,1.1115310228308472e-05,0.0,1.0
35329,박얘쁜/Noun,1,0,1,0.0,1.1106915165381966e-05,1.0
35330,최광호/Noun,1,0,1,0.0,1.1106915165381966e-05,1.0
35331,그린로즈/Noun,1,1,0,1.1115310228308472e-05,0.0,1.0
35332,뭉술/Noun,1,0,1,0.0,1.1106915165381966e-05,1.0
35333,인파/Noun,1,0,1,0.0,1.1106915165381966e-05,1.0
35334,제세동기/Noun,1,0,1,0.0,1.1106915165381966e-05,1.0
35335,CPR/Alpha,1,0,1,0.0,1.1106915165381966e-05,1.0
35336,고은별/Noun,1,0,1,0.0,1.1106915165381966e-05,1.0
35337,최아라/Noun,1,1,0,1.1115310228308472e-05,0.0,1.0
35338,돈아까버/Noun,1,0,1,0.0,1.1106915165381966e-05,1.0
35339,133회/Number,1,1,0,1.1115310228308472e-05,0.0,1.0
35340,완잼/Noun,1,1,0,1.1115310228308472e-05,0.0,1.0
35341,히잉/Noun,1,0,1,0.0,1.1106915165381966e-05,1.0
35342,糞女/Foreign,1,0,1,0.0,1.1106915165381966e-05,1.0
35343,똥녀/Noun,1,0,1,0.0,1.1106915165381966e-05,1.0
35344,糞男/Foreign,1,0,1,0.0,1.1106915165381966e-05,1.0
35345,똥남/Noun,1,0,1,0.0,1.1106915165381966e-05,1.0
35346,몸빵/Noun,1,0,1,0.0,1.1106915165381966e-05,1.0
35347,드셧/Noun,1,0,1,0.0,1.1106915165381966e-05,1.0
35348,임임핵/Noun,1,0,1,0.0,1.1106915165381966e-05,1.0
35349,흐헤헤헹/Noun,1,0,1,0.0,1.1106915165381966e-05,1.0
35350,낚엿다/Noun,1,0,1,0.0,1.1106915165381966e-05,1.0
35351,단군/Noun,1,0,1,0.0,1.1106915165381966e-05,1.0
35352,뒤마/Noun,1,1,0,1.1115310228308472e-05,0.0,1.0
35353,필콜린스/Noun,1,1,0,1.1115310228308472e-05,0.0,1.0
35354,땐/Foreign,1,0,1,0.0,1.1106915165381966e-05,1.0
35355,쇄뇌/Noun,1,0,1,0.0,1.1106915165381966e-05,1.0
35356,외계생물/Noun,1,0,1,0.0,1.1106915165381966e-05,1.0
35357,기생물/Noun,1,0,1,0.0,1.1106915165381966e-05,1.0
35358,릴꼬/Noun,1,0,1,0.0,1.1106915165381966e-05,1.0
35359,페션/Noun,1,0,1,0.0,1.1106915165381966e-05,1.0
35360,극뽁/Noun,1,1,0,1.1115310228308472e-05,0.0,1.0
35361,말랑말랑/Adverb,1,0,1,0.0,1.1106915165381966e-05,1.0
35362,직업여성/Noun,1,0,1,0.0,1.1106915165381966e-05,1.0
35363,센치하다/Adjective,1,0,1,0.0,1.1106915165381966e-05,1.0
35364,실만/Noun,1,1,0,1.1115310228308472e-05,0.0,1.0
35365,987654321/Number,1,1,0,1.1115310228308472e-05,0.0,1.0
35366,박훈카드/Noun,1,0,1,0.0,1.1106915165381966e-05,1.0
35367,과업/Noun,1,0,1,0.0,1.1106915165381966e-05,1.0
35368,레알마드리드/Noun,1,0,1,0.0,1.1106915165381966e-05,1.0
35369,순천만/Noun,1,1,0,1.1115310228308472e-05,0.0,1.0
35370,종방후/Noun,1,1,0,1.1115310228308472e-05,0.0,1.0
35371,나/Foreign,1,1,0,1.1115310228308472e-05,0.0,1.0
35372,샴프신/Noun,1,1,0,1.1115310228308472e-05,0.0,1.0
35373,석권/Noun,1,1,0,1.1115310228308472e-05,0.0,1.0
35374,풓히히/Noun,1,0,1,0.0,1.1106915165381966e-05,1.0
35375,~!@.@/Punctuation,1,0,1,0.0,1.1106915165381966e-05,1.0
35376,흐격사/Noun,1,0,1,0.0,1.1106915165381966e-05,1.0
35377,이라해도/Foreign,1,0,1,0.0,1.1106915165381966e-05,1.0
35378,뻣뻣/Noun,1,0,1,0.0,1.1106915165381966e-05,1.0
35379,랑스/Noun,1,1,0,1.1115310228308472e-05,0.0,1.0
35380,완소하/Noun,1,1,0,1.1115310228308472e-05,0.0,1.0
35381,(^^;)/Punctuation,1,1,0,1.1115310228308472e-05,0.0,1.0
35382,다시마/Noun,1,1,0,1.1115310228308472e-05,0.0,1.0
35383,Dolittle/Alpha,1,1,0,1.1115310228308472e-05,0.0,1.0
35384,Dr/Alpha,1,1,0,1.1115310228308472e-05,0.0,1.0
35385,만보셔봐/Foreign,1,0,1,0.0,1.1106915165381966e-05,1.0
35386,넘도록/Foreign,1,0,1,0.0,1.1106915165381966e-05,1.0
35387,단막그/Noun,1,0,1,0.0,1.1106915165381966e-05,1.0
35388,얼굷본다/Noun,1,1,0,1.1115310228308472e-05,0.0,1.0
35389,강태환/Noun,1,0,1,0.0,1.1106915165381966e-05,1.0
35390,란욕/Noun,1,1,0,1.1115310228308472e-05,0.0,1.0
35391,bien/Alpha,1,1,0,1.1115310228308472e-05,0.0,1.0
35392,tr/Alpha,1,1,0,1.1115310228308472e-05,0.0,1.0
35393,는안버/Noun,1,1,0,1.1115310228308472e-05,0.0,1.0
35394,자새/Noun,1,0,1,0.0,1.1106915165381966e-05,1.0
35395,".""!?/Punctuation",1,0,1,0.0,1.1106915165381966e-05,1.0
35396,옴겨/Noun,1,1,0,1.1115310228308472e-05,0.0,1.0
35397,격었던/Noun,1,1,0,1.1115310228308472e-05,0.0,1.0
35398,Coffins/Alpha,1,1,0,1.1115310228308472e-05,0.0,1.0
35399,작품을이제야봤네요예쁘고잘생긴배우들/Foreign,1,1,0,1.1115310228308472e-05,0.0,1.0
35400,안바꿧으면조켓다/Noun,1,1,0,1.1115310228308472e-05,0.0,1.0
35401,이원근/Noun,1,1,0,1.1115310228308472e-05,0.0,1.0
35402,햇스/Noun,1,1,0,1.1115310228308472e-05,0.0,1.0
35403,뷔페/Noun,1,0,1,0.0,1.1106915165381966e-05,1.0
35404,영윈히/Noun,1,1,0,1.1115310228308472e-05,0.0,1.0
35405,샊드/Noun,1,1,0,1.1115310228308472e-05,0.0,1.0
35406,~~~~!!^/Punctuation,1,1,0,1.1115310228308472e-05,0.0,1.0
35407,아뵤/Noun,1,1,0,1.1115310228308472e-05,0.0,1.0
35408,탑재/Noun,1,0,1,0.0,1.1106915165381966e-05,1.0
35409,GIG/Alpha,1,0,1,0.0,1.1106915165381966e-05,1.0
35410,hhhhhhhhhhhhhhhhhhhhhhhhhh/Alpha,1,0,1,0.0,1.1106915165381966e-05,1.0
35411,잔고/Noun,1,1,0,1.1115310228308472e-05,0.0,1.0
35412,비브르/Noun,1,0,1,0.0,1.1106915165381966e-05,1.0
35413,──━ㆀ/Foreign,1,0,1,0.0,1.1106915165381966e-05,1.0
35414,─━/Foreign,1,0,1,0.0,1.1106915165381966e-05,1.0
35415,Metallica/Alpha,1,1,0,1.1115310228308472e-05,0.0,1.0
35416,쉑이들/Noun,1,0,1,0.0,1.1106915165381966e-05,1.0
35417,놈무/Noun,1,0,1,0.0,1.1106915165381966e-05,1.0
35418,코헨이었/Noun,1,1,0,1.1115310228308472e-05,0.0,1.0
35419,society/Alpha,1,1,0,1.1115310228308472e-05,0.0,1.0
35420,김상현/Noun,1,0,1,0.0,1.1106915165381966e-05,1.0
35421,대로가/Josa,1,0,1,0.0,1.1106915165381966e-05,1.0
35422,발바/Noun,1,1,0,1.1115310228308472e-05,0.0,1.0
35423,priceless/Alpha,1,1,0,1.1115310228308472e-05,0.0,1.0
35424,발밑/Noun,1,0,1,0.0,1.1106915165381966e-05,1.0
35425,툭탁/Noun,1,1,0,1.1115310228308472e-05,0.0,1.0
35426,야자나무/Noun,1,1,0,1.1115310228308472e-05,0.0,1.0
35427,fever/Alpha,1,1,0,1.1115310228308472e-05,0.0,1.0
35428,로어셰크/Noun,1,1,0,1.1115310228308472e-05,0.0,1.0
35429,케니/Noun,1,1,0,1.1115310228308472e-05,0.0,1.0
35430,랙픽/Noun,1,0,1,0.0,1.1106915165381966e-05,1.0
35431,공표/Noun,1,0,1,0.0,1.1106915165381966e-05,1.0
35432,빽빨/Noun,1,0,1,0.0,1.1106915165381966e-05,1.0
35433,븅들/Noun,1,0,1,0.0,1.1106915165381966e-05,1.0
35434,mvp/Alpha,1,0,1,0.0,1.1106915165381966e-05,1.0
35435,븅m.net/URL,1,0,1,0.0,1.1106915165381966e-05,1.0
35436,임팩터/Noun,1,1,0,1.1115310228308472e-05,0.0,1.0
35437,빤스젖음/Noun,1,1,0,1.1115310228308472e-05,0.0,1.0
35438,쯪/Noun,1,0,1,0.0,1.1106915165381966e-05,1.0
35439,컬쳐/Noun,1,0,1,0.0,1.1106915165381966e-05,1.0
35440,보수주의자/Noun,1,1,0,1.1115310228308472e-05,0.0,1.0
35441,아까버죽긋/Noun,1,0,1,0.0,1.1106915165381966e-05,1.0
35442,티워/Noun,1,1,0,1.1115310228308472e-05,0.0,1.0
35443,ㅇㅕ/KoreanParticle,1,1,0,1.1115310228308472e-05,0.0,1.0
35444,몀화/Noun,1,1,0,1.1115310228308472e-05,0.0,1.0
35445,刻苦/Foreign,1,1,0,1.1115310228308472e-05,0.0,1.0
35446,각고/Noun,1,1,0,1.1115310228308472e-05,0.0,1.0
35447,정말잘봣구/Noun,1,1,0,1.1115310228308472e-05,0.0,1.0
35448,웅대/Noun,1,1,0,1.1115310228308472e-05,0.0,1.0
35449,쟨/Noun,1,0,1,0.0,1.1106915165381966e-05,1.0
35450,먹/Noun,1,0,1,0.0,1.1106915165381966e-05,1.0
35451,두놈뇽/Noun,1,0,1,0.0,1.1106915165381966e-05,1.0
35452,ㅇㅅㅇㅋㅋㅋ/KoreanParticle,1,1,0,1.1115310228308472e-05,0.0,1.0
35453,이해경/Noun,1,1,0,1.1115310228308472e-05,0.0,1.0
35454,대무/Noun,1,1,0,1.1115310228308472e-05,0.0,1.0
35455,개뉴잼/Noun,1,0,1,0.0,1.1106915165381966e-05,1.0
35456,경제성장/Noun,1,0,1,0.0,1.1106915165381966e-05,1.0
35457,수강샹/Noun,1,0,1,0.0,1.1106915165381966e-05,1.0
35458,방부제/Noun,1,0,1,0.0,1.1106915165381966e-05,1.0
35459,중독증/Noun,1,1,0,1.1115310228308472e-05,0.0,1.0
35460,swat/Alpha,1,0,1,0.0,1.1106915165381966e-05,1.0
35461,띁을려/Noun,1,0,1,0.0,1.1106915165381966e-05,1.0
35462,진여/Noun,1,0,1,0.0,1.1106915165381966e-05,1.0
35463,싱하/Noun,1,1,0,1.1115310228308472e-05,0.0,1.0
35464,은퇘/Noun,1,0,1,0.0,1.1106915165381966e-05,1.0
35465,우국/Noun,1,0,1,0.0,1.1106915165381966e-05,1.0
35466,낱/Noun,1,1,0,1.1115310228308472e-05,0.0,1.0
35467,머합/Noun,1,0,1,0.0,1.1106915165381966e-05,1.0
35468,한연수/Noun,1,0,1,0.0,1.1106915165381966e-05,1.0
35469,시즈란/Noun,1,1,0,1.1115310228308472e-05,0.0,1.0
35470,환산/Noun,1,1,0,1.1115310228308472e-05,0.0,1.0
35471,제강/Noun,1,1,0,1.1115310228308472e-05,0.0,1.0
35472,살인소설/Noun,1,0,1,0.0,1.1106915165381966e-05,1.0
35473,버젖/Noun,1,0,1,0.0,1.1106915165381966e-05,1.0
35474,정정당당/Noun,1,1,0,1.1115310228308472e-05,0.0,1.0
35475,도투/Noun,1,0,1,0.0,1.1106915165381966e-05,1.0
35476,하이파이브/Noun,1,0,1,0.0,1.1106915165381966e-05,1.0
35477,감청/Noun,1,0,1,0.0,1.1106915165381966e-05,1.0
35478,띠마/Noun,1,1,0,1.1115310228308472e-05,0.0,1.0
35479,이지난지금/Foreign,1,0,1,0.0,1.1106915165381966e-05,1.0
35480,스트립쇼/Noun,1,0,1,0.0,1.1106915165381966e-05,1.0
35481,http://cafe.naver.com/cgv700/URL,1,0,1,0.0,1.1106915165381966e-05,1.0
35482,캡처/Noun,1,1,0,1.1115310228308472e-05,0.0,1.0
35483,20~30분/Number,1,1,0,1.1115310228308472e-05,0.0,1.0
35484,凡人/Foreign,1,0,1,0.0,1.1106915165381966e-05,1.0
35485,해사십/Noun,1,1,0,1.1115310228308472e-05,0.0,1.0
35486,찯/Noun,1,1,0,1.1115310228308472e-05,0.0,1.0
35487,멍때렷음/Noun,1,1,0,1.1115310228308472e-05,0.0,1.0
35488,왕래/Noun,1,1,0,1.1115310228308472e-05,0.0,1.0
35489,목하/Noun,1,1,0,1.1115310228308472e-05,0.0,1.0
35490,그까짓/Noun,1,1,0,1.1115310228308472e-05,0.0,1.0
35491,이원규/Noun,1,1,0,1.1115310228308472e-05,0.0,1.0
35492,거열/Noun,1,1,0,1.1115310228308472e-05,0.0,1.0
35493,손꾸락/Noun,1,1,0,1.1115310228308472e-05,0.0,1.0
35494,流/Foreign,1,0,1,0.0,1.1106915165381966e-05,1.0
35495,냉면/Noun,1,1,0,1.1115310228308472e-05,0.0,1.0
35496,점심때/Noun,1,1,0,1.1115310228308472e-05,0.0,1.0
35497,구사일생/Noun,1,1,0,1.1115310228308472e-05,0.0,1.0
35498,음악당/Noun,1,0,1,0.0,1.1106915165381966e-05,1.0
35499,웄던/Noun,1,0,1,0.0,1.1106915165381966e-05,1.0
35500,서준/Noun,1,1,0,1.1115310228308472e-05,0.0,1.0
35501,사랑비/Noun,1,1,0,1.1115310228308472e-05,0.0,1.0
35502,촣습니/Noun,1,1,0,1.1115310228308472e-05,0.0,1.0
35503,공업고등학교/Noun,1,1,0,1.1115310228308472e-05,0.0,1.0
35504,한별/Noun,1,1,0,1.1115310228308472e-05,0.0,1.0
35505,표연/Noun,1,1,0,1.1115310228308472e-05,0.0,1.0
35506,쓰레깁니/Noun,1,0,1,0.0,1.1106915165381966e-05,1.0
35507,브룩클린/Noun,1,1,0,1.1115310228308472e-05,0.0,1.0
35508,섥혀버린/Noun,1,0,1,0.0,1.1106915165381966e-05,1.0
35509,찍새/Noun,1,0,1,0.0,1.1106915165381966e-05,1.0
35510,응요/Noun,1,1,0,1.1115310228308472e-05,0.0,1.0
35511,취했을뿐/Noun,1,1,0,1.1115310228308472e-05,0.0,1.0
35512,너무잼슴/Noun,1,1,0,1.1115310228308472e-05,0.0,1.0
35513,세진/Noun,1,1,0,1.1115310228308472e-05,0.0,1.0
35514,김성원/Noun,1,1,0,1.1115310228308472e-05,0.0,1.0
35515,ㅎㅎㅁㅁ/KoreanParticle,1,1,0,1.1115310228308472e-05,0.0,1.0
35516,소셜리즘/Noun,1,1,0,1.1115310228308472e-05,0.0,1.0
35517,로넨스/Noun,1,0,1,0.0,1.1106915165381966e-05,1.0
35518,펄럭이다/Verb,1,0,1,0.0,1.1106915165381966e-05,1.0
35519,leader/Alpha,1,1,0,1.1115310228308472e-05,0.0,1.0
35520,stuff/Alpha,1,1,0,1.1115310228308472e-05,0.0,1.0
35521,Courage/Alpha,1,1,0,1.1115310228308472e-05,0.0,1.0
35522,spirit/Alpha,1,1,0,1.1115310228308472e-05,0.0,1.0
35523,amputated/Alpha,1,1,0,1.1115310228308472e-05,0.0,1.0
35524,friends/Alpha,1,1,0,1.1115310228308472e-05,0.0,1.0
35525,sell/Alpha,1,1,0,1.1115310228308472e-05,0.0,1.0
35526,Tango/Alpha,1,1,0,1.1115310228308472e-05,0.0,1.0
35527,Cabeza/Alpha,1,1,0,1.1115310228308472e-05,0.0,1.0
35528,Una/Alpha,1,1,0,1.1115310228308472e-05,0.0,1.0
35529,Por/Alpha,1,1,0,1.1115310228308472e-05,0.0,1.0
35530,웜바디스/Noun,1,1,0,1.1115310228308472e-05,0.0,1.0
35531,바디스/Noun,1,1,0,1.1115310228308472e-05,0.0,1.0
35532,윔/Noun,1,1,0,1.1115310228308472e-05,0.0,1.0
35533,되라얍/Noun,1,0,1,0.0,1.1106915165381966e-05,1.0
35534,봫는데/Noun,1,1,0,1.1115310228308472e-05,0.0,1.0
35535,프럼/Noun,1,0,1,0.0,1.1106915165381966e-05,1.0
35536,포스코/Noun,1,0,1,0.0,1.1106915165381966e-05,1.0
35537,mcks/Alpha,1,0,1,0.0,1.1106915165381966e-05,1.0
35538,패셔너블/Noun,1,0,1,0.0,1.1106915165381966e-05,1.0
35539,핀잔/Noun,1,0,1,0.0,1.1106915165381966e-05,1.0
35540,홈빵/Noun,1,1,0,1.1115310228308472e-05,0.0,1.0
35541,학력고사/Noun,1,1,0,1.1115310228308472e-05,0.0,1.0
35542,쟈르/Noun,1,1,0,1.1115310228308472e-05,0.0,1.0
35543,웅앙아/Noun,1,1,0,1.1115310228308472e-05,0.0,1.0
35544,나은정/Noun,1,0,1,0.0,1.1106915165381966e-05,1.0
35545,69%/Number,1,0,1,0.0,1.1106915165381966e-05,1.0
35546,솓/Noun,1,1,0,1.1115310228308472e-05,0.0,1.0
35547,어려윘/Noun,1,0,1,0.0,1.1106915165381966e-05,1.0
35548,ㅋㅋㅋㄱㄱ/KoreanParticle,1,1,0,1.1115310228308472e-05,0.0,1.0
35549,흠임/Noun,1,0,1,0.0,1.1106915165381966e-05,1.0
35550,알렉사/Noun,1,0,1,0.0,1.1106915165381966e-05,1.0
35551,맹탕이넹/Noun,1,0,1,0.0,1.1106915165381966e-05,1.0
35552,쥬인공/Noun,1,0,1,0.0,1.1106915165381966e-05,1.0
35553,船名/Foreign,1,0,1,0.0,1.1106915165381966e-05,1.0
35554,Amistad/Alpha,1,0,1,0.0,1.1106915165381966e-05,1.0
35555,해부학/Noun,1,0,1,0.0,1.1106915165381966e-05,1.0
35556,Anatomy/Alpha,1,0,1,0.0,1.1106915165381966e-05,1.0
35557,~!!!~!/Punctuation,1,1,0,1.1115310228308472e-05,0.0,1.0
35558,...*^^*../Punctuation,1,1,0,1.1115310228308472e-05,0.0,1.0
35559,은나왓으려/Noun,1,0,1,0.0,1.1106915165381966e-05,1.0
35560,악처/Noun,1,1,0,1.1115310228308472e-05,0.0,1.0
35561,TTL/Alpha,1,0,1,0.0,1.1106915165381966e-05,1.0
35562,역점/Noun,1,1,0,1.1115310228308472e-05,0.0,1.0
35563,신문지/Noun,1,1,0,1.1115310228308472e-05,0.0,1.0
35564,색연필/Noun,1,1,0,1.1115310228308472e-05,0.0,1.0
35565,때물/Noun,1,0,1,0.0,1.1106915165381966e-05,1.0
35566,박민호/Noun,1,0,1,0.0,1.1106915165381966e-05,1.0
35567,커츠/Noun,1,0,1,0.0,1.1106915165381966e-05,1.0
35568,츠케타/Noun,1,1,0,1.1115310228308472e-05,0.0,1.0
35569,멜로씬/Noun,1,0,1,0.0,1.1106915165381966e-05,1.0
35570,겉핧기/Noun,1,0,1,0.0,1.1106915165381966e-05,1.0
35571,킬각/Noun,1,0,1,0.0,1.1106915165381966e-05,1.0
35572,크리스티아노/Noun,1,0,1,0.0,1.1106915165381966e-05,1.0
35573,하앜/Noun,1,1,0,1.1115310228308472e-05,0.0,1.0
35574,철룡/Noun,1,1,0,1.1115310228308472e-05,0.0,1.0
35575,호경/Noun,1,1,0,1.1115310228308472e-05,0.0,1.0
35576,도가사상/Noun,1,1,0,1.1115310228308472e-05,0.0,1.0
35577,반월/Noun,1,0,1,0.0,1.1106915165381966e-05,1.0
35578,분장사/Noun,1,0,1,0.0,1.1106915165381966e-05,1.0
35579,백장미/Noun,1,1,0,1.1115310228308472e-05,0.0,1.0
35580,1-1/Number,1,0,1,0.0,1.1106915165381966e-05,1.0
35581,빵점은없낲/Noun,1,0,1,0.0,1.1106915165381966e-05,1.0
35582,스위트룸/Noun,1,0,1,0.0,1.1106915165381966e-05,1.0
35583,?)//Punctuation,1,0,1,0.0,1.1106915165381966e-05,1.0
35584,다금바리/Noun,1,0,1,0.0,1.1106915165381966e-05,1.0
35585,하명/Noun,1,1,0,1.1115310228308472e-05,0.0,1.0
35586,7.51/Number,1,0,1,0.0,1.1106915165381966e-05,1.0
35587,어웨/Noun,1,0,1,0.0,1.1106915165381966e-05,1.0
35588,스웹/Noun,1,0,1,0.0,1.1106915165381966e-05,1.0
35589,잼이썽/Noun,1,1,0,1.1115310228308472e-05,0.0,1.0
35590,바슈/Noun,1,1,0,1.1115310228308472e-05,0.0,1.0
35591,왕페이/Noun,1,1,0,1.1115310228308472e-05,0.0,1.0
35592,????????????????/Punctuation,1,1,0,1.1115310228308472e-05,0.0,1.0
35593,박혜련작/Noun,1,1,0,1.1115310228308472e-05,0.0,1.0
35594,카리용/Noun,1,0,1,0.0,1.1106915165381966e-05,1.0
35595,앙투완/Noun,1,0,1,0.0,1.1106915165381966e-05,1.0
35596,5101/Number,1,1,0,1.1115310228308472e-05,0.0,1.0
35597,dlals/Alpha,1,1,0,1.1115310228308472e-05,0.0,1.0
35598,퍼거슨/Noun,1,1,0,1.1115310228308472e-05,0.0,1.0
35599,안드로/Noun,1,0,1,0.0,1.1106915165381966e-05,1.0
35600,가슴띠/Noun,1,1,0,1.1115310228308472e-05,0.0,1.0
35601,8.59/Number,1,0,1,0.0,1.1106915165381966e-05,1.0
35602,상짓/Noun,1,0,1,0.0,1.1106915165381966e-05,1.0
35603,재미교포/Noun,1,0,1,0.0,1.1106915165381966e-05,1.0
35604,부선/Noun,1,1,0,1.1115310228308472e-05,0.0,1.0
35605,선녀뇬/Noun,1,1,0,1.1115310228308472e-05,0.0,1.0
35606,놈때매/Noun,1,1,0,1.1115310228308472e-05,0.0,1.0
35607,스페셜포스/Noun,1,1,0,1.1115310228308472e-05,0.0,1.0
35608,위힌/Noun,1,0,1,0.0,1.1106915165381966e-05,1.0
35609,CODA/Alpha,1,1,0,1.1115310228308472e-05,0.0,1.0
35610,농인/Noun,1,1,0,1.1115310228308472e-05,0.0,1.0
35611,영홬/Noun,1,0,1,0.0,1.1106915165381966e-05,1.0
35612,꼬드긴/Noun,1,1,0,1.1115310228308472e-05,0.0,1.0
35613,뱃겼/Noun,1,0,1,0.0,1.1106915165381966e-05,1.0
35614,목공/Noun,1,1,0,1.1115310228308472e-05,0.0,1.0
35615,비실/Noun,1,0,1,0.0,1.1106915165381966e-05,1.0
35616,우러또/Noun,1,1,0,1.1115310228308472e-05,0.0,1.0
35617,논바레/Noun,1,0,1,0.0,1.1106915165381966e-05,1.0
35618,jongholin/Alpha,1,1,0,1.1115310228308472e-05,0.0,1.0
35619,관서/Noun,1,1,0,1.1115310228308472e-05,0.0,1.0
35620,서유/Noun,1,1,0,1.1115310228308472e-05,0.0,1.0
35621,두엄/Noun,1,0,1,0.0,1.1106915165381966e-05,1.0
35622,에키/Exclamation,1,0,1,0.0,1.1106915165381966e-05,1.0
35623,불에/Foreign,1,0,1,0.0,1.1106915165381966e-05,1.0
35624,2천만/Number,1,0,1,0.0,1.1106915165381966e-05,1.0
35625,정윤석/Noun,1,0,1,0.0,1.1106915165381966e-05,1.0
35626,크릭/Noun,1,0,1,0.0,1.1106915165381966e-05,1.0
35627,비스타/Noun,1,0,1,0.0,1.1106915165381966e-05,1.0
35628,하스타/Noun,1,0,1,0.0,1.1106915165381966e-05,1.0
35629,예사로/Noun,1,0,1,0.0,1.1106915165381966e-05,1.0
35630,치조/Noun,1,1,0,1.1115310228308472e-05,0.0,1.0
35631,독립선언/Noun,1,0,1,0.0,1.1106915165381966e-05,1.0
35632,이백원/Noun,1,1,0,1.1115310228308472e-05,0.0,1.0
35633,Bang/Alpha,1,1,0,1.1115310228308472e-05,0.0,1.0
35634,으흐흑/Adverb,1,1,0,1.1115310228308472e-05,0.0,1.0
35635,매버/Noun,1,0,1,0.0,1.1106915165381966e-05,1.0
35636,애피/Noun,1,0,1,0.0,1.1106915165381966e-05,1.0
35637,엘리제궁/Noun,1,1,0,1.1115310228308472e-05,0.0,1.0
35638,완다언/Noun,1,1,0,1.1115310228308472e-05,0.0,1.0
35639,교습/Noun,1,0,1,0.0,1.1106915165381966e-05,1.0
35640,fegg/Alpha,1,1,0,1.1115310228308472e-05,0.0,1.0
35641,simon/Alpha,1,1,0,1.1115310228308472e-05,0.0,1.0
35642,이빙빙/Noun,1,1,0,1.1115310228308472e-05,0.0,1.0
35643,눈듯/Noun,1,0,1,0.0,1.1106915165381966e-05,1.0
35644,묭/Noun,1,0,1,0.0,1.1106915165381966e-05,1.0
35645,ㅣㅣ/KoreanParticle,1,0,1,0.0,1.1106915165381966e-05,1.0
35646,홈드라마/Noun,1,0,1,0.0,1.1106915165381966e-05,1.0
35647,섹끼/Noun,1,0,1,0.0,1.1106915165381966e-05,1.0
35648,홯후/Noun,1,0,1,0.0,1.1106915165381966e-05,1.0
35649,느꼇음/Noun,1,1,0,1.1115310228308472e-05,0.0,1.0
35650,7만달러/Number,1,0,1,0.0,1.1106915165381966e-05,1.0
35651,서울시/Noun,1,0,1,0.0,1.1106915165381966e-05,1.0
35652,"-,.-/Punctuation",1,1,0,1.1115310228308472e-05,0.0,1.0
35653,점합/Noun,1,0,1,0.0,1.1106915165381966e-05,1.0
35654,괸장히/Noun,1,1,0,1.1115310228308472e-05,0.0,1.0
35655,안띤/Noun,1,0,1,0.0,1.1106915165381966e-05,1.0
35656,Fou/Alpha,1,1,0,1.1115310228308472e-05,0.0,1.0
35657,구어/Noun,1,0,1,0.0,1.1106915165381966e-05,1.0
35658,Year/Alpha,1,0,1,0.0,1.1106915165381966e-05,1.0
35659,Leap/Alpha,1,0,1,0.0,1.1106915165381966e-05,1.0
35660,3600만달러/Number,1,0,1,0.0,1.1106915165381966e-05,1.0
35661,불이라니/Foreign,1,0,1,0.0,1.1106915165381966e-05,1.0
35662,열등하다/Adjective,1,0,1,0.0,1.1106915165381966e-05,1.0
35663,카덴자/Noun,1,1,0,1.1115310228308472e-05,0.0,1.0
35664,던것/Noun,1,1,0,1.1115310228308472e-05,0.0,1.0
35665,뉴코아/Noun,1,1,0,1.1115310228308472e-05,0.0,1.0
35666,매질/Noun,1,0,1,0.0,1.1106915165381966e-05,1.0
35667,덴버/Noun,1,1,0,1.1115310228308472e-05,0.0,1.0
35668,숭산/Noun,1,0,1,0.0,1.1106915165381966e-05,1.0
35669,qudvkf/Alpha,1,0,1,0.0,1.1106915165381966e-05,1.0
35670,야설록/Noun,1,0,1,0.0,1.1106915165381966e-05,1.0
35671,자살율/Noun,1,1,0,1.1115310228308472e-05,0.0,1.0
35672,아태/Noun,1,1,0,1.1115310228308472e-05,0.0,1.0
35673,리덕스/Noun,1,1,0,1.1115310228308472e-05,0.0,1.0
35674,축척/Noun,1,1,0,1.1115310228308472e-05,0.0,1.0
35675,2.71/Number,1,0,1,0.0,1.1106915165381966e-05,1.0
35676,알토/Noun,1,0,1,0.0,1.1106915165381966e-05,1.0
35677,지평선/Noun,1,1,0,1.1115310228308472e-05,0.0,1.0
35678,땅거미/Noun,1,1,0,1.1115310228308472e-05,0.0,1.0
35679,강욱/Noun,1,1,0,1.1115310228308472e-05,0.0,1.0
35680,의붓/Noun,1,0,1,0.0,1.1106915165381966e-05,1.0
35681,제크/Noun,1,1,0,1.1115310228308472e-05,0.0,1.0
35682,맟춘/Noun,1,0,1,0.0,1.1106915165381966e-05,1.0
35683,헤교씨/Noun,1,0,1,0.0,1.1106915165381966e-05,1.0
35684,더바/Noun,1,1,0,1.1115310228308472e-05,0.0,1.0
35685,북촌방향/Noun,1,1,0,1.1115310228308472e-05,0.0,1.0
35686,터트렸을때/Noun,1,1,0,1.1115310228308472e-05,0.0,1.0
35687,소마/Noun,1,1,0,1.1115310228308472e-05,0.0,1.0
35688,젠트/Noun,1,1,0,1.1115310228308472e-05,0.0,1.0
35689,빅오/Noun,1,1,0,1.1115310228308472e-05,0.0,1.0
35690,유교사상/Noun,1,0,1,0.0,1.1106915165381966e-05,1.0
35691,컴백홈/Noun,1,0,1,0.0,1.1106915165381966e-05,1.0
35692,털석/Noun,1,1,0,1.1115310228308472e-05,0.0,1.0
35693,수학자/Noun,1,1,0,1.1115310228308472e-05,0.0,1.0
35694,신짱구/Noun,1,1,0,1.1115310228308472e-05,0.0,1.0
35695,결손/Noun,1,1,0,1.1115310228308472e-05,0.0,1.0
35696,구세대/Noun,1,1,0,1.1115310228308472e-05,0.0,1.0
35697,인천공항/Noun,1,1,0,1.1115310228308472e-05,0.0,1.0
35698,41회/Number,1,1,0,1.1115310228308472e-05,0.0,1.0
35699,11111111/Number,1,1,0,1.1115310228308472e-05,0.0,1.0
35700,ㅠㅇㅠ/KoreanParticle,1,1,0,1.1115310228308472e-05,0.0,1.0
35701,Y/Alpha,1,1,0,1.1115310228308472e-05,0.0,1.0
35702,애니플러스/Noun,1,0,1,0.0,1.1106915165381966e-05,1.0
35703,빙송국/Noun,1,0,1,0.0,1.1106915165381966e-05,1.0
35704,ㅊㅚㄱ/KoreanParticle,1,1,0,1.1115310228308472e-05,0.0,1.0
35705,위칙/Noun,1,0,1,0.0,1.1106915165381966e-05,1.0
35706,엄다혜씨/Noun,1,1,0,1.1115310228308472e-05,0.0,1.0
35707,ㄱㅇㅅ/KoreanParticle,1,0,1,0.0,1.1106915165381966e-05,1.0
35708,보리스/Noun,1,0,1,0.0,1.1106915165381966e-05,1.0
35709,폴포트/Noun,1,0,1,0.0,1.1106915165381966e-05,1.0
35710,파스니/Noun,1,1,0,1.1115310228308472e-05,0.0,1.0
35711,대변인/Noun,1,0,1,0.0,1.1106915165381966e-05,1.0
35712,도라버치/Noun,1,0,1,0.0,1.1106915165381966e-05,1.0
35713,헛탕질/Noun,1,0,1,0.0,1.1106915165381966e-05,1.0
35714,관운장/Noun,1,0,1,0.0,1.1106915165381966e-05,1.0
35715,勇武/Foreign,1,0,1,0.0,1.1106915165381966e-05,1.0
35716,忠義/Foreign,1,0,1,0.0,1.1106915165381966e-05,1.0
35717,카포티/Noun,1,0,1,0.0,1.1106915165381966e-05,1.0
35718,좍좍/Noun,1,1,0,1.1115310228308472e-05,0.0,1.0
35719,SCREAM/Alpha,1,0,1,0.0,1.1106915165381966e-05,1.0
35720,MORE/Alpha,1,0,1,0.0,1.1106915165381966e-05,1.0
35721,?!!../Punctuation,1,1,0,1.1115310228308472e-05,0.0,1.0
35722,재화/Noun,1,0,1,0.0,1.1106915165381966e-05,1.0
35723,부속/Noun,1,0,1,0.0,1.1106915165381966e-05,1.0
35724,쌘데/Noun,1,1,0,1.1115310228308472e-05,0.0,1.0
35725,흉노족/Noun,1,0,1,0.0,1.1106915165381966e-05,1.0
35726,컬러링/Noun,1,1,0,1.1115310228308472e-05,0.0,1.0
35727,압권이엇다/Noun,1,1,0,1.1115310228308472e-05,0.0,1.0
35728,업소/Noun,1,0,1,0.0,1.1106915165381966e-05,1.0
35729,랐슴/Noun,1,1,0,1.1115310228308472e-05,0.0,1.0
35730,물올/Noun,1,1,0,1.1115310228308472e-05,0.0,1.0
35731,우렸다/Noun,1,0,1,0.0,1.1106915165381966e-05,1.0
35732,지문자/Noun,1,1,0,1.1115310228308472e-05,0.0,1.0
35733,쥐라/Noun,1,0,1,0.0,1.1106915165381966e-05,1.0
35734,신한/Noun,1,1,0,1.1115310228308472e-05,0.0,1.0
35735,달곰/Noun,1,1,0,1.1115310228308472e-05,0.0,1.0
35736,완잔/Noun,1,1,0,1.1115310228308472e-05,0.0,1.0
35737,.^-^*/Punctuation,1,1,0,1.1115310228308472e-05,0.0,1.0
35738,Awakening/Alpha,1,1,0,1.1115310228308472e-05,0.0,1.0
35739,Underworld/Alpha,1,1,0,1.1115310228308472e-05,0.0,1.0
35740,덕빠/Noun,1,0,1,0.0,1.1106915165381966e-05,1.0
35741,마이콜/Noun,1,1,0,1.1115310228308472e-05,0.0,1.0
35742,또치/Noun,1,1,0,1.1115310228308472e-05,0.0,1.0
35743,이라는시간에/Foreign,1,1,0,1.1115310228308472e-05,0.0,1.0
35744,으힛/Noun,1,1,0,1.1115310228308472e-05,0.0,1.0
35745,완점잼/Noun,1,1,0,1.1115310228308472e-05,0.0,1.0
35746,낙점/Noun,1,0,1,0.0,1.1106915165381966e-05,1.0
35747,스톱/Noun,1,0,1,0.0,1.1106915165381966e-05,1.0
35748,나경원/Noun,1,0,1,0.0,1.1106915165381966e-05,1.0
35749,돈번/Noun,1,1,0,1.1115310228308472e-05,0.0,1.0
35750,매스컴/Noun,1,1,0,1.1115310228308472e-05,0.0,1.0
35751,총감독/Noun,1,0,1,0.0,1.1106915165381966e-05,1.0
35752,마시모/Noun,1,1,0,1.1115310228308472e-05,0.0,1.0
35753,느와레/Noun,1,1,0,1.1115310228308472e-05,0.0,1.0
35754,PI/Alpha,1,0,1,0.0,1.1106915165381966e-05,1.0
35755,바다이야기/Noun,1,0,1,0.0,1.1106915165381966e-05,1.0
35756,765/Number,1,0,1,0.0,1.1106915165381966e-05,1.0
35757,한국전력/Noun,1,0,1,0.0,1.1106915165381966e-05,1.0
35758,->'/Punctuation,1,0,1,0.0,1.1106915165381966e-05,1.0
35759,잠뽕/Noun,1,0,1,0.0,1.1106915165381966e-05,1.0
35760,노안/Noun,1,1,0,1.1115310228308472e-05,0.0,1.0
35761,돈주고봣으/Noun,1,0,1,0.0,1.1106915165381966e-05,1.0
35762,농후함/Noun,1,0,1,0.0,1.1106915165381966e-05,1.0
35763,뭔미/Noun,1,0,1,0.0,1.1106915165381966e-05,1.0
35764,사해/Noun,1,0,1,0.0,1.1106915165381966e-05,1.0
35765,종횡/Noun,1,0,1,0.0,1.1106915165381966e-05,1.0
35766,발급/Noun,1,0,1,0.0,1.1106915165381966e-05,1.0
35767,부산하다/Adjective,1,0,1,0.0,1.1106915165381966e-05,1.0
35768,최측근/Noun,1,0,1,0.0,1.1106915165381966e-05,1.0
35769,분륜녀/Noun,1,0,1,0.0,1.1106915165381966e-05,1.0
35770,브론테/Noun,1,0,1,0.0,1.1106915165381966e-05,1.0
35771,안햇으/Noun,1,0,1,0.0,1.1106915165381966e-05,1.0
35772,헬땜/Noun,1,1,0,1.1115310228308472e-05,0.0,1.0
35773,4천/Number,1,0,1,0.0,1.1106915165381966e-05,1.0
35774,亡作/Foreign,1,0,1,0.0,1.1106915165381966e-05,1.0
35775,이었다니/Foreign,1,1,0,1.1115310228308472e-05,0.0,1.0
35776,흨/Noun,1,0,1,0.0,1.1106915165381966e-05,1.0
35777,Gunslinger/Alpha,1,0,1,0.0,1.1106915165381966e-05,1.0
35778,Juarez/Alpha,1,0,1,0.0,1.1106915165381966e-05,1.0
35779,Call/Alpha,1,0,1,0.0,1.1106915165381966e-05,1.0
35780,액션게임/Noun,1,0,1,0.0,1.1106915165381966e-05,1.0
35781,렸는/Noun,1,0,1,0.0,1.1106915165381966e-05,1.0
35782,개주고싶을정도로/Foreign,1,1,0,1.1115310228308472e-05,0.0,1.0
35783,낮선/Noun,1,0,1,0.0,1.1106915165381966e-05,1.0
35784,크라켄/Noun,1,0,1,0.0,1.1106915165381966e-05,1.0
35785,좋네욯/Noun,1,1,0,1.1115310228308472e-05,0.0,1.0
35786,공카/Noun,1,1,0,1.1115310228308472e-05,0.0,1.0
35787,홍의/Noun,1,0,1,0.0,1.1106915165381966e-05,1.0
35788,용궁/Noun,1,0,1,0.0,1.1106915165381966e-05,1.0
35789,개뿰/Noun,1,0,1,0.0,1.1106915165381966e-05,1.0
35790,성형전/Noun,1,1,0,1.1115310228308472e-05,0.0,1.0
35791,용검/Noun,1,0,1,0.0,1.1106915165381966e-05,1.0
35792,알고봤드/Noun,1,0,1,0.0,1.1106915165381966e-05,1.0
35793,첫경험/Noun,1,0,1,0.0,1.1106915165381966e-05,1.0
35794,쿄고/Noun,1,0,1,0.0,1.1106915165381966e-05,1.0
35795,쉣더퍽/Noun,1,0,1,0.0,1.1106915165381966e-05,1.0
35796,너덜너덜/Adverb,1,0,1,0.0,1.1106915165381966e-05,1.0
35797,체베트/Noun,1,0,1,0.0,1.1106915165381966e-05,1.0
35798,에만들어진고보고/Foreign,1,1,0,1.1115310228308472e-05,0.0,1.0
35799,around/Alpha,1,1,0,1.1115310228308472e-05,0.0,1.0
35800,actually/Alpha,1,1,0,1.1115310228308472e-05,0.0,1.0
35801,수신/Noun,1,0,1,0.0,1.1106915165381966e-05,1.0
35802,..--/Punctuation,1,0,1,0.0,1.1106915165381966e-05,1.0
35803,죱/Noun,1,0,1,0.0,1.1106915165381966e-05,1.0
35804,47년/Number,1,0,1,0.0,1.1106915165381966e-05,1.0
35805,댄싱퀸/Noun,1,1,0,1.1115310228308472e-05,0.0,1.0
35806,수천만/Modifier,1,0,1,0.0,1.1106915165381966e-05,1.0
35807,누런/Noun,1,1,0,1.1115310228308472e-05,0.0,1.0
35808,중등/Noun,1,0,1,0.0,1.1106915165381966e-05,1.0
35809,웃는남자/Noun,1,0,1,0.0,1.1106915165381966e-05,1.0
35810,배트먠/Noun,1,0,1,0.0,1.1106915165381966e-05,1.0
35811,일사일/Noun,1,1,0,1.1115310228308472e-05,0.0,1.0
35812,Wakana/Alpha,1,1,0,1.1115310228308472e-05,0.0,1.0
35813,Hikaru/Alpha,1,1,0,1.1115310228308472e-05,0.0,1.0
35814,풀엇구/Noun,1,0,1,0.0,1.1106915165381966e-05,1.0
35815,고봉/Noun,1,1,0,1.1115310228308472e-05,0.0,1.0
35816,무언극/Noun,1,1,0,1.1115310228308472e-05,0.0,1.0
35817,투닥/Noun,1,0,1,0.0,1.1106915165381966e-05,1.0
35818,말곤/Noun,1,0,1,0.0,1.1106915165381966e-05,1.0
35819,****)///Punctuation,1,1,0,1.1115310228308472e-05,0.0,1.0
35820,kjs/Alpha,1,1,0,1.1115310228308472e-05,0.0,1.0
35821,Js/Alpha,1,1,0,1.1115310228308472e-05,0.0,1.0
35822,Return/Alpha,1,1,0,1.1115310228308472e-05,0.0,1.0
35823,Rings/Alpha,1,1,0,1.1115310228308472e-05,0.0,1.0
35824,Lord/Alpha,1,1,0,1.1115310228308472e-05,0.0,1.0
35825,웃스/Noun,1,1,0,1.1115310228308472e-05,0.0,1.0
35826,운때/Noun,1,0,1,0.0,1.1106915165381966e-05,1.0
35827,맥고완/Noun,1,0,1,0.0,1.1106915165381966e-05,1.0
35828,....?..../Punctuation,1,0,1,0.0,1.1106915165381966e-05,1.0
35829,극기/Noun,1,1,0,1.1115310228308472e-05,0.0,1.0
35830,등가교환/Noun,1,0,1,0.0,1.1106915165381966e-05,1.0
35831,농염/Noun,1,0,1,0.0,1.1106915165381966e-05,1.0
35832,부여준/Noun,1,1,0,1.1115310228308472e-05,0.0,1.0
35833,큼지막하다/Adjective,1,0,1,0.0,1.1106915165381966e-05,1.0
35834,enjoy/Alpha,1,1,0,1.1115310228308472e-05,0.0,1.0
35835,디젹/Noun,1,0,1,0.0,1.1106915165381966e-05,1.0
35836,123412341234/Number,1,1,0,1.1115310228308472e-05,0.0,1.0
35837,퇴직/Noun,1,1,0,1.1115310228308472e-05,0.0,1.0
35838,꺜/Noun,1,1,0,1.1115310228308472e-05,0.0,1.0
35839,결합체/Noun,1,0,1,0.0,1.1106915165381966e-05,1.0
35840,카와사키/Noun,1,1,0,1.1115310228308472e-05,0.0,1.0
35841,-_-.........../Punctuation,1,0,1,0.0,1.1106915165381966e-05,1.0
35842,바부/Noun,1,0,1,0.0,1.1106915165381966e-05,1.0
35843,파니/Noun,1,1,0,1.1115310228308472e-05,0.0,1.0
35844,녕정/Noun,1,1,0,1.1115310228308472e-05,0.0,1.0
35845,좌측/Noun,1,1,0,1.1115310228308472e-05,0.0,1.0
35846,발코니/Noun,1,0,1,0.0,1.1106915165381966e-05,1.0
35847,남의껄/Noun,1,0,1,0.0,1.1106915165381966e-05,1.0
35848,싹스/Noun,1,0,1,0.0,1.1106915165381966e-05,1.0
35849,말껄/Noun,1,0,1,0.0,1.1106915165381966e-05,1.0
35850,헤니님/Noun,1,1,0,1.1115310228308472e-05,0.0,1.0
35851,동방예의지국/Noun,1,0,1,0.0,1.1106915165381966e-05,1.0
35852,알뜰하다/Adjective,1,1,0,1.1115310228308472e-05,0.0,1.0
35853,뉴저지/Noun,1,1,0,1.1115310228308472e-05,0.0,1.0
35854,spiderman/Alpha,1,1,0,1.1115310228308472e-05,0.0,1.0
35855,맥길/Noun,1,0,1,0.0,1.1106915165381966e-05,1.0
35856,하랫더/Noun,1,0,1,0.0,1.1106915165381966e-05,1.0
35857,(?)../Punctuation,1,0,1,0.0,1.1106915165381966e-05,1.0
35858,해칠/Noun,1,0,1,0.0,1.1106915165381966e-05,1.0
35859,준더/Noun,1,0,1,0.0,1.1106915165381966e-05,1.0
35860,렵구/Noun,1,0,1,0.0,1.1106915165381966e-05,1.0
35861,폴버호밴/Noun,1,0,1,0.0,1.1106915165381966e-05,1.0
35862,대완/Noun,1,0,1,0.0,1.1106915165381966e-05,1.0
35863,박도/Noun,1,0,1,0.0,1.1106915165381966e-05,1.0
35864,폭침/Noun,1,0,1,0.0,1.1106915165381966e-05,1.0
35865,취임/Noun,1,1,0,1.1115310228308472e-05,0.0,1.0
35866,뜽금/Noun,1,0,1,0.0,1.1106915165381966e-05,1.0
35867,격지전/Noun,1,0,1,0.0,1.1106915165381966e-05,1.0
35868,포/Foreign,1,0,1,0.0,1.1106915165381966e-05,1.0
35869,0000000000/Number,1,0,1,0.0,1.1106915165381966e-05,1.0
35870,었슴/Noun,1,1,0,1.1115310228308472e-05,0.0,1.0
35871,온영삼/Noun,1,0,1,0.0,1.1106915165381966e-05,1.0
35872,성선녀/Noun,1,0,1,0.0,1.1106915165381966e-05,1.0
35873,슨례/Noun,1,0,1,0.0,1.1106915165381966e-05,1.0
35874,물폭탄/Noun,1,0,1,0.0,1.1106915165381966e-05,1.0
35875,김경석/Noun,1,1,0,1.1115310228308472e-05,0.0,1.0
35876,실무/Noun,1,1,0,1.1115310228308472e-05,0.0,1.0
35877,쨍그랑/Noun,1,0,1,0.0,1.1106915165381966e-05,1.0
35878,스톱홀룸/Noun,1,1,0,1.1115310228308472e-05,0.0,1.0
35879,번쩨/Noun,1,0,1,0.0,1.1106915165381966e-05,1.0
35880,".,.,.,.,.,.,/Punctuation",1,0,1,0.0,1.1106915165381966e-05,1.0
35881,퍼티/Noun,1,1,0,1.1115310228308472e-05,0.0,1.0
35882,관범/Noun,1,0,1,0.0,1.1106915165381966e-05,1.0
35883,곰플/Noun,1,1,0,1.1115310228308472e-05,0.0,1.0
35884,잏다/Noun,1,1,0,1.1115310228308472e-05,0.0,1.0
35885,피씨통신/Noun,1,1,0,1.1115310228308472e-05,0.0,1.0
35886,먼데이/Noun,1,1,0,1.1115310228308472e-05,0.0,1.0
35887,Upgrade/Alpha,1,1,0,1.1115310228308472e-05,0.0,1.0
35888,견줄영화/Noun,1,0,1,0.0,1.1106915165381966e-05,1.0
35889,홧병/Noun,1,0,1,0.0,1.1106915165381966e-05,1.0
35890,블립/Noun,1,1,0,1.1115310228308472e-05,0.0,1.0
35891,ㅋㅋㅋㅌ/KoreanParticle,1,0,1,0.0,1.1106915165381966e-05,1.0
35892,실검뜸/Noun,1,0,1,0.0,1.1106915165381966e-05,1.0
35893,뫘/Noun,1,1,0,1.1115310228308472e-05,0.0,1.0
35894,걈/Noun,1,0,1,0.0,1.1106915165381966e-05,1.0
35895,ㅅㅂㅋㅋ/KoreanParticle,1,0,1,0.0,1.1106915165381966e-05,1.0
35896,쿼바디스/Noun,1,1,0,1.1115310228308472e-05,0.0,1.0
35897,까지가/Foreign,1,0,1,0.0,1.1106915165381966e-05,1.0
35898,진곤/Noun,1,1,0,1.1115310228308472e-05,0.0,1.0
35899,펙트가뭐/Noun,1,0,1,0.0,1.1106915165381966e-05,1.0
35900,임낫/Noun,1,1,0,1.1115310228308472e-05,0.0,1.0
35901,Zero/Alpha,1,0,1,0.0,1.1106915165381966e-05,1.0
35902,뭐데/Noun,1,0,1,0.0,1.1106915165381966e-05,1.0
35903,걸볼껄/Noun,1,0,1,0.0,1.1106915165381966e-05,1.0
35904,레오나/Noun,1,0,1,0.0,1.1106915165381966e-05,1.0
35905,보고삭제/Foreign,1,0,1,0.0,1.1106915165381966e-05,1.0
35906,leslie/Alpha,1,1,0,1.1115310228308472e-05,0.0,1.0
35907,무문/Noun,1,0,1,0.0,1.1106915165381966e-05,1.0
35908,엠마톤슨/Noun,1,1,0,1.1115310228308472e-05,0.0,1.0
35909,스투디/Noun,1,1,0,1.1115310228308472e-05,0.0,1.0
35910,마그/Noun,1,1,0,1.1115310228308472e-05,0.0,1.0
35911,방아/Noun,1,0,1,0.0,1.1106915165381966e-05,1.0
35912,머쉬멜로/Noun,1,0,1,0.0,1.1106915165381966e-05,1.0
35913,쇄도/Noun,1,1,0,1.1115310228308472e-05,0.0,1.0
35914,노박/Noun,1,1,0,1.1115310228308472e-05,0.0,1.0
35915,양동이/Noun,1,1,0,1.1115310228308472e-05,0.0,1.0
35916,urmukdmud/Alpha,1,0,1,0.0,1.1106915165381966e-05,1.0
35917,ㅑㅐㅡ/KoreanParticle,1,0,1,0.0,1.1106915165381966e-05,1.0
35918,나코/Noun,1,1,0,1.1115310228308472e-05,0.0,1.0
35919,민코/Noun,1,1,0,1.1115310228308472e-05,0.0,1.0
35920,후회맙시/Noun,1,0,1,0.0,1.1106915165381966e-05,1.0
35921,미스에이/Noun,1,0,1,0.0,1.1106915165381966e-05,1.0
35922,달렷어/Noun,1,0,1,0.0,1.1106915165381966e-05,1.0
35923,Crush/Alpha,1,0,1,0.0,1.1106915165381966e-05,1.0
35924,마흥/Noun,1,0,1,0.0,1.1106915165381966e-05,1.0
35925,수있는영화/Foreign,1,1,0,1.1115310228308472e-05,0.0,1.0
35926,뱅벵/Noun,1,1,0,1.1115310228308472e-05,0.0,1.0
35927,파상/Noun,1,1,0,1.1115310228308472e-05,0.0,1.0
35928,박왜이케/Noun,1,1,0,1.1115310228308472e-05,0.0,1.0
35929,찬연하다/Adjective,1,1,0,1.1115310228308472e-05,0.0,1.0
35930,sdfasdfasdf/Alpha,1,0,1,0.0,1.1106915165381966e-05,1.0
35931,도에나/Foreign,1,0,1,0.0,1.1106915165381966e-05,1.0
35932,큰형님뻘/Noun,1,1,0,1.1115310228308472e-05,0.0,1.0
35933,헛돈쓰/Noun,1,0,1,0.0,1.1106915165381966e-05,1.0
35934,번디/Noun,1,1,0,1.1115310228308472e-05,0.0,1.0
35935,얘때메/Noun,1,0,1,0.0,1.1106915165381966e-05,1.0
35936,느꼇을듯/Noun,1,0,1,0.0,1.1106915165381966e-05,1.0
35937,장법/Noun,1,1,0,1.1115310228308472e-05,0.0,1.0
35938,별사탕/Noun,1,0,1,0.0,1.1106915165381966e-05,1.0
35939,이선희/Noun,1,1,0,1.1115310228308472e-05,0.0,1.0
35940,복날/Noun,1,0,1,0.0,1.1106915165381966e-05,1.0
35941,자연사/Noun,1,0,1,0.0,1.1106915165381966e-05,1.0
35942,괴랄하/Noun,1,1,0,1.1115310228308472e-05,0.0,1.0
35943,인풋/Noun,1,1,0,1.1115310228308472e-05,0.0,1.0
35944,강한씬/Noun,1,0,1,0.0,1.1106915165381966e-05,1.0
35945,27회/Number,1,1,0,1.1115310228308472e-05,0.0,1.0
35946,내여귀/Noun,1,1,0,1.1115310228308472e-05,0.0,1.0
35947,jiff/Alpha,1,1,0,1.1115310228308472e-05,0.0,1.0
35948,최승희/Noun,1,0,1,0.0,1.1106915165381966e-05,1.0
35949,항공사/Noun,1,1,0,1.1115310228308472e-05,0.0,1.0
35950,상조/Noun,1,0,1,0.0,1.1106915165381966e-05,1.0
35951,numbers/Alpha,1,0,1,0.0,1.1106915165381966e-05,1.0
35952,murder/Alpha,1,0,1,0.0,1.1106915165381966e-05,1.0
35953,이해만/Noun,1,1,0,1.1115310228308472e-05,0.0,1.0
35954,들끓다/Verb,1,1,0,1.1115310228308472e-05,0.0,1.0
35955,이숭환/Noun,1,0,1,0.0,1.1106915165381966e-05,1.0
35956,돈철/Noun,1,0,1,0.0,1.1106915165381966e-05,1.0
35957,★★★★/Foreign,1,1,0,1.1115310228308472e-05,0.0,1.0
35958,스탠드업/Noun,1,1,0,1.1115310228308472e-05,0.0,1.0
35959,4.1/Number,1,0,1,0.0,1.1106915165381966e-05,1.0
35960,울엇죵/Noun,1,1,0,1.1115310228308472e-05,0.0,1.0
35961,권더/Noun,1,0,1,0.0,1.1106915165381966e-05,1.0
35962,대에사는인간들이/Foreign,1,0,1,0.0,1.1106915165381966e-05,1.0
35963,17만원/Number,1,0,1,0.0,1.1106915165381966e-05,1.0
35964,신승훈/Noun,1,0,1,0.0,1.1106915165381966e-05,1.0
35965,커미트먼트/Noun,1,0,1,0.0,1.1106915165381966e-05,1.0
35966,점처/Noun,1,0,1,0.0,1.1106915165381966e-05,1.0
35967,촹/Noun,1,1,0,1.1115310228308472e-05,0.0,1.0
35968,;(/Punctuation,1,0,1,0.0,1.1106915165381966e-05,1.0
35969,showdown/Alpha,1,1,0,1.1115310228308472e-05,0.0,1.0
35970,가림/Noun,1,0,1,0.0,1.1106915165381966e-05,1.0
35971,후호막/Noun,1,0,1,0.0,1.1106915165381966e-05,1.0
35972,경멸감/Noun,1,1,0,1.1115310228308472e-05,0.0,1.0
35973,americana/Alpha,1,0,1,0.0,1.1106915165381966e-05,1.0
35974,pax/Alpha,1,0,1,0.0,1.1106915165381966e-05,1.0
35975,코노야로/Noun,1,1,0,1.1115310228308472e-05,0.0,1.0
35976,테메/Noun,1,1,0,1.1115310228308472e-05,0.0,1.0
35977,ㅁㅊㅋㅋㅋ/KoreanParticle,1,0,1,0.0,1.1106915165381966e-05,1.0
35978,보슬/Noun,1,0,1,0.0,1.1106915165381966e-05,1.0
35979,아련돋/Noun,1,1,0,1.1115310228308472e-05,0.0,1.0
35980,ㅈㄷㄱ/KoreanParticle,1,0,1,0.0,1.1106915165381966e-05,1.0
35981,윌켄/Noun,1,0,1,0.0,1.1106915165381966e-05,1.0
35982,김재준/Noun,1,1,0,1.1115310228308472e-05,0.0,1.0
35983,쌍절/Noun,1,0,1,0.0,1.1106915165381966e-05,1.0
35984,편익/Noun,1,1,0,1.1115310228308472e-05,0.0,1.0
35985,갈취/Noun,1,0,1,0.0,1.1106915165381966e-05,1.0
35986,대부인/Noun,1,0,1,0.0,1.1106915165381966e-05,1.0
35987,쾅쾅/Adverb,1,0,1,0.0,1.1106915165381966e-05,1.0
35988,쿠르릉/Adverb,1,0,1,0.0,1.1106915165381966e-05,1.0
35989,후안/Noun,1,0,1,0.0,1.1106915165381966e-05,1.0
35990,유혼삘/Noun,1,0,1,0.0,1.1106915165381966e-05,1.0
35991,재웅이/Noun,1,1,0,1.1115310228308472e-05,0.0,1.0
35992,욕망의불꽃/Noun,1,0,1,0.0,1.1106915165381966e-05,1.0
35993,딘클/Noun,1,1,0,1.1115310228308472e-05,0.0,1.0
35994,26~7/Number,1,1,0,1.1115310228308472e-05,0.0,1.0
35995,Lawless/Alpha,1,0,1,0.0,1.1106915165381966e-05,1.0
35996,밀주/Noun,1,0,1,0.0,1.1106915165381966e-05,1.0
35997,에스파니아/Noun,1,1,0,1.1115310228308472e-05,0.0,1.0
35998,육포/Noun,1,0,1,0.0,1.1106915165381966e-05,1.0
35999,샤크나이트/Noun,1,0,1,0.0,1.1106915165381966e-05,1.0
36000,에드먼드/Noun,1,1,0,1.1115310228308472e-05,0.0,1.0
36001,천송이/Noun,1,1,0,1.1115310228308472e-05,0.0,1.0
36002,탁본/Noun,1,0,1,0.0,1.1106915165381966e-05,1.0
36003,애닌/Noun,1,1,0,1.1115310228308472e-05,0.0,1.0
36004,투투/Noun,1,0,1,0.0,1.1106915165381966e-05,1.0
36005,능터/Noun,1,0,1,0.0,1.1106915165381966e-05,1.0
36006,툥너/Noun,1,0,1,0.0,1.1106915165381966e-05,1.0
36007,간편/Noun,1,1,0,1.1115310228308472e-05,0.0,1.0
36008,~~!@/Punctuation,1,1,0,1.1115310228308472e-05,0.0,1.0
36009,보는순간/Foreign,1,0,1,0.0,1.1106915165381966e-05,1.0
36010,탕국/Noun,1,0,1,0.0,1.1106915165381966e-05,1.0
36011,다국적/Noun,1,0,1,0.0,1.1106915165381966e-05,1.0
36012,삘링들/Noun,1,0,1,0.0,1.1106915165381966e-05,1.0
36013,왜욕/Noun,1,1,0,1.1115310228308472e-05,0.0,1.0
36014,범생/Noun,1,0,1,0.0,1.1106915165381966e-05,1.0
36015,짜릴/Noun,1,0,1,0.0,1.1106915165381966e-05,1.0
36016,손볼/Noun,1,1,0,1.1115310228308472e-05,0.0,1.0
36017,이츠/Noun,1,1,0,1.1115310228308472e-05,0.0,1.0
36018,하기에는/Foreign,1,0,1,0.0,1.1106915165381966e-05,1.0
36019,섥히/Noun,1,1,0,1.1115310228308472e-05,0.0,1.0
36020,질렌홀/Noun,1,0,1,0.0,1.1106915165381966e-05,1.0
36021,애절/Noun,1,1,0,1.1115310228308472e-05,0.0,1.0
36022,맗/Noun,1,1,0,1.1115310228308472e-05,0.0,1.0
36023,마이스너/Noun,1,1,0,1.1115310228308472e-05,0.0,1.0
36024,HGM/Alpha,1,1,0,1.1115310228308472e-05,0.0,1.0
36025,은메달/Noun,1,1,0,1.1115310228308472e-05,0.0,1.0
36026,박의/Noun,1,1,0,1.1115310228308472e-05,0.0,1.0
36027,롤링스톤즈/Noun,1,1,0,1.1115310228308472e-05,0.0,1.0
36028,수소/Noun,1,1,0,1.1115310228308472e-05,0.0,1.0
36029,뷴/Noun,1,0,1,0.0,1.1106915165381966e-05,1.0
36030,재응/Noun,1,1,0,1.1115310228308472e-05,0.0,1.0
36031,True/Alpha,1,0,1,0.0,1.1106915165381966e-05,1.0
36032,전희주/Noun,1,0,1,0.0,1.1106915165381966e-05,1.0
36033,훵/Noun,1,1,0,1.1115310228308472e-05,0.0,1.0
36034,설자리/Noun,1,0,1,0.0,1.1106915165381966e-05,1.0
36035,킬빠/Noun,1,0,1,0.0,1.1106915165381966e-05,1.0
36036,적나특공/Noun,1,0,1,0.0,1.1106915165381966e-05,1.0
36037,맹탕물/Noun,1,0,1,0.0,1.1106915165381966e-05,1.0
36038,보몀/Noun,1,0,1,0.0,1.1106915165381966e-05,1.0
36039,맨슨/Noun,1,0,1,0.0,1.1106915165381966e-05,1.0
36040,숨졸/Noun,1,1,0,1.1115310228308472e-05,0.0,1.0
36041,수모/Noun,1,1,0,1.1115310228308472e-05,0.0,1.0
36042,목초액/Noun,1,1,0,1.1115310228308472e-05,0.0,1.0
36043,을불/Noun,1,1,0,1.1115310228308472e-05,0.0,1.0
36044,총동원/Noun,1,1,0,1.1115310228308472e-05,0.0,1.0
36045,주동/Noun,1,0,1,0.0,1.1106915165381966e-05,1.0
36046,광폭/Noun,1,0,1,0.0,1.1106915165381966e-05,1.0
36047,룸서비스/Noun,1,0,1,0.0,1.1106915165381966e-05,1.0
36048,컨시어즈/Noun,1,0,1,0.0,1.1106915165381966e-05,1.0
36049,detail/Alpha,1,1,0,1.1115310228308472e-05,0.0,1.0
36050,혐호물임별한개/Noun,1,0,1,0.0,1.1106915165381966e-05,1.0
36051,도로/Foreign,1,0,1,0.0,1.1106915165381966e-05,1.0
36052,REX/Alpha,1,1,0,1.1115310228308472e-05,0.0,1.0
36053,마모/Noun,1,1,0,1.1115310228308472e-05,0.0,1.0
36054,짱이엇어/Noun,1,1,0,1.1115310228308472e-05,0.0,1.0
36055,jkbbsb@naver.com/Email,1,1,0,1.1115310228308472e-05,0.0,1.0
36056,Unrated/Alpha,1,1,0,1.1115310228308472e-05,0.0,1.0
36057,뽕빨물/Noun,1,0,1,0.0,1.1106915165381966e-05,1.0
36058,솓는/Noun,1,1,0,1.1115310228308472e-05,0.0,1.0
36059,방바닥/Noun,1,0,1,0.0,1.1106915165381966e-05,1.0
36060,페즈/Noun,1,1,0,1.1115310228308472e-05,0.0,1.0
36061,586/Number,1,1,0,1.1115310228308472e-05,0.0,1.0
36062,세진컴퓨터/Noun,1,1,0,1.1115310228308472e-05,0.0,1.0
36063,뜩박임/Noun,1,1,0,1.1115310228308472e-05,0.0,1.0
36064,아까웠던게/Foreign,1,0,1,0.0,1.1106915165381966e-05,1.0
36065,1천원/Number,1,0,1,0.0,1.1106915165381966e-05,1.0
36066,정빈/Noun,1,0,1,0.0,1.1106915165381966e-05,1.0
36067,도레미/Noun,1,0,1,0.0,1.1106915165381966e-05,1.0
36068,쓰레긴줄/Noun,1,0,1,0.0,1.1106915165381966e-05,1.0
36069,발킬머형/Noun,1,1,0,1.1115310228308472e-05,0.0,1.0
36070,격높/Noun,1,1,0,1.1115310228308472e-05,0.0,1.0
36071,에봐도/Foreign,1,1,0,1.1115310228308472e-05,0.0,1.0
36072,입장면/Noun,1,1,0,1.1115310228308472e-05,0.0,1.0
36073,............!!/Punctuation,1,1,0,1.1115310228308472e-05,0.0,1.0
36074,단종/Noun,1,0,1,0.0,1.1106915165381966e-05,1.0
36075,아랐음/Noun,1,0,1,0.0,1.1106915165381966e-05,1.0
36076,최부/Noun,1,1,0,1.1115310228308472e-05,0.0,1.0
36077,쪼들리다/Verb,1,1,0,1.1115310228308472e-05,0.0,1.0
36078,감정씬/Noun,1,1,0,1.1115310228308472e-05,0.0,1.0
36079,흝으러진건/Noun,1,0,1,0.0,1.1106915165381966e-05,1.0
36080,수재/Noun,1,0,1,0.0,1.1106915165381966e-05,1.0
36081,육교/Noun,1,0,1,0.0,1.1106915165381966e-05,1.0
36082,라이네/Noun,1,0,1,0.0,1.1106915165381966e-05,1.0
36083,카다르/Noun,1,1,0,1.1115310228308472e-05,0.0,1.0
36084,성적표/Noun,1,0,1,0.0,1.1106915165381966e-05,1.0
36085,뎌/Noun,1,0,1,0.0,1.1106915165381966e-05,1.0
36086,1.9/Number,1,0,1,0.0,1.1106915165381966e-05,1.0
36087,급진/Noun,1,1,0,1.1115310228308472e-05,0.0,1.0
36088,생들/Foreign,1,0,1,0.0,1.1106915165381966e-05,1.0
36089,렌느/Noun,1,1,0,1.1115310228308472e-05,0.0,1.0
36090,Actually/Alpha,1,1,0,1.1115310228308472e-05,0.0,1.0
36091,6197/Number,1,0,1,0.0,1.1106915165381966e-05,1.0
36092,고영상/Noun,1,0,1,0.0,1.1106915165381966e-05,1.0
36093,렉카/Noun,1,0,1,0.0,1.1106915165381966e-05,1.0
36094,",/Foreign",1,1,0,1.1115310228308472e-05,0.0,1.0
36095,90210/Number,1,0,1,0.0,1.1106915165381966e-05,1.0
36096,베버리힐스/Noun,1,0,1,0.0,1.1106915165381966e-05,1.0
36097,재간/Noun,1,0,1,0.0,1.1106915165381966e-05,1.0
36098,욕조씬/Noun,1,1,0,1.1115310228308472e-05,0.0,1.0
36099,찡기/Noun,1,1,0,1.1115310228308472e-05,0.0,1.0
36100,case/Alpha,1,1,0,1.1115310228308472e-05,0.0,1.0
36101,cold/Alpha,1,1,0,1.1115310228308472e-05,0.0,1.0
36102,턴입업/Noun,1,1,0,1.1115310228308472e-05,0.0,1.0
36103,몽키매직/Noun,1,1,0,1.1115310228308472e-05,0.0,1.0
36104,눈뚜고/Noun,1,1,0,1.1115310228308472e-05,0.0,1.0
36105,찟어놓/Noun,1,1,0,1.1115310228308472e-05,0.0,1.0
36106,쓰레기봉지/Noun,1,1,0,1.1115310228308472e-05,0.0,1.0
36107,쪼꼬님/Noun,1,0,1,0.0,1.1106915165381966e-05,1.0
36108,아러야/Noun,1,0,1,0.0,1.1106915165381966e-05,1.0
36109,국문/Noun,1,1,0,1.1115310228308472e-05,0.0,1.0
36110,살짞/Noun,1,1,0,1.1115310228308472e-05,0.0,1.0
36111,!!!!....!!!!..../Punctuation,1,1,0,1.1115310228308472e-05,0.0,1.0
36112,어덜트비디오/Noun,1,0,1,0.0,1.1106915165381966e-05,1.0
36113,날인/Noun,1,0,1,0.0,1.1106915165381966e-05,1.0
36114,dsadsdasdasdasd/Alpha,1,1,0,1.1115310228308472e-05,0.0,1.0
36115,0.0000000/Number,1,0,1,0.0,1.1106915165381966e-05,1.0
36116,한복삘/Noun,1,1,0,1.1115310228308472e-05,0.0,1.0
36117,쟈져/Noun,1,1,0,1.1115310228308472e-05,0.0,1.0
36118,자저/Noun,1,1,0,1.1115310228308472e-05,0.0,1.0
36119,으릐/Noun,1,1,0,1.1115310228308472e-05,0.0,1.0
36120,축출/Noun,1,1,0,1.1115310228308472e-05,0.0,1.0
36121,내딛다/Verb,1,1,0,1.1115310228308472e-05,0.0,1.0
36122,행정/Noun,1,1,0,1.1115310228308472e-05,0.0,1.0
36123,전제군주제/Noun,1,1,0,1.1115310228308472e-05,0.0,1.0
36124,맹공/Noun,1,0,1,0.0,1.1106915165381966e-05,1.0
36125,것때매/Noun,1,0,1,0.0,1.1106915165381966e-05,1.0
36126,으허헝/Adverb,1,1,0,1.1115310228308472e-05,0.0,1.0
36127,비츄/Noun,1,0,1,0.0,1.1106915165381966e-05,1.0
36128,스타차일드/Noun,1,1,0,1.1115310228308472e-05,0.0,1.0
36129,비가역/Noun,1,1,0,1.1115310228308472e-05,0.0,1.0
36130,시픈/Noun,1,1,0,1.1115310228308472e-05,0.0,1.0
36131,타분/Noun,1,0,1,0.0,1.1106915165381966e-05,1.0
36132,숙종/Noun,1,1,0,1.1115310228308472e-05,0.0,1.0
36133,치수/Noun,1,1,0,1.1115310228308472e-05,0.0,1.0
36134,옥정/Noun,1,1,0,1.1115310228308472e-05,0.0,1.0
36135,gooooooooood/Alpha,1,1,0,1.1115310228308472e-05,0.0,1.0
36136,kinase/Alpha,1,0,1,0.0,1.1106915165381966e-05,1.0
36137,requiring/Alpha,1,0,1,0.0,1.1106915165381966e-05,1.0
36138,inositol/Alpha,1,0,1,0.0,1.1106915165381966e-05,1.0
36139,UPR/Alpha,1,0,1,0.0,1.1106915165381966e-05,1.0
36140,세포생물학/Noun,1,0,1,0.0,1.1106915165381966e-05,1.0
36141,"~,./Punctuation",1,1,0,1.1115310228308472e-05,0.0,1.0
36142,조력/Noun,1,1,0,1.1115310228308472e-05,0.0,1.0
36143,뎀팬/Noun,1,0,1,0.0,1.1106915165381966e-05,1.0
36144,있쟎아/Noun,1,0,1,0.0,1.1106915165381966e-05,1.0
36145,무릅꿇/Noun,1,0,1,0.0,1.1106915165381966e-05,1.0
36146,브리타니아/Noun,1,0,1,0.0,1.1106915165381966e-05,1.0
36147,존심/Noun,1,0,1,0.0,1.1106915165381966e-05,1.0
36148,어무/Noun,1,0,1,0.0,1.1106915165381966e-05,1.0
36149,블론테/Noun,1,1,0,1.1115310228308472e-05,0.0,1.0
36150,최싱/Noun,1,1,0,1.1115310228308472e-05,0.0,1.0
36151,국색/Noun,1,0,1,0.0,1.1106915165381966e-05,1.0
36152,백광현/Noun,1,1,0,1.1115310228308472e-05,0.0,1.0
36153,봄비처럼/Noun,1,1,0,1.1115310228308472e-05,0.0,1.0
36154,출몰/Noun,1,0,1,0.0,1.1106915165381966e-05,1.0
36155,델구와/Noun,1,0,1,0.0,1.1106915165381966e-05,1.0
36156,팽긴/Noun,1,1,0,1.1115310228308472e-05,0.0,1.0
36157,lolita/Alpha,1,1,0,1.1115310228308472e-05,0.0,1.0
36158,빨림/Noun,1,0,1,0.0,1.1106915165381966e-05,1.0
36159,평양성/Noun,1,1,0,1.1115310228308472e-05,0.0,1.0
36160,breast/Alpha,1,0,1,0.0,1.1106915165381966e-05,1.0
36161,cheap/Alpha,1,0,1,0.0,1.1106915165381966e-05,1.0
36162,화무십일홍/Noun,1,1,0,1.1115310228308472e-05,0.0,1.0
36163,한전/Noun,1,0,1,0.0,1.1106915165381966e-05,1.0
36164,도에나온/Foreign,1,0,1,0.0,1.1106915165381966e-05,1.0
36165,".,.-_-;/Punctuation",1,0,1,0.0,1.1106915165381966e-05,1.0
36166,음그져그레/Noun,1,0,1,0.0,1.1106915165381966e-05,1.0
36167,멋쪙/Noun,1,1,0,1.1115310228308472e-05,0.0,1.0
36168,America/Alpha,1,1,0,1.1115310228308472e-05,0.0,1.0
36169,....^^;/Punctuation,1,0,1,0.0,1.1106915165381966e-05,1.0
36170,2063/Number,1,0,1,0.0,1.1106915165381966e-05,1.0
36171,epilogue/Alpha,1,0,1,0.0,1.1106915165381966e-05,1.0
36172,괜찬은거/Noun,1,0,1,0.0,1.1106915165381966e-05,1.0
36173,흉상/Noun,1,1,0,1.1115310228308472e-05,0.0,1.0
36174,미네소타/Noun,1,0,1,0.0,1.1106915165381966e-05,1.0
36175,솔비/Noun,1,0,1,0.0,1.1106915165381966e-05,1.0
36176,벤제마/Noun,1,1,0,1.1115310228308472e-05,0.0,1.0
36177,조스/Noun,1,0,1,0.0,1.1106915165381966e-05,1.0
36178,벌떡벌떡/Adverb,1,1,0,1.1115310228308472e-05,0.0,1.0
36179,openskies/Alpha,1,1,0,1.1115310228308472e-05,0.0,1.0
36180,reamonn/Alpha,1,1,0,1.1115310228308472e-05,0.0,1.0
36181,유민상/Noun,1,0,1,0.0,1.1106915165381966e-05,1.0
36182,차디차다/Adjective,1,1,0,1.1115310228308472e-05,0.0,1.0
36183,lately/Alpha,1,1,0,1.1115310228308472e-05,0.0,1.0
36184,done/Alpha,1,1,0,1.1115310228308472e-05,0.0,1.0
36185,11시간/Number,1,0,1,0.0,1.1106915165381966e-05,1.0
36186,짜리라/Foreign,1,0,1,0.0,1.1106915165381966e-05,1.0
36187,유혜진/Noun,1,1,0,1.1115310228308472e-05,0.0,1.0
36188,??/Foreign,1,0,1,0.0,1.1106915165381966e-05,1.0
36189,POP/Alpha,1,0,1,0.0,1.1106915165381966e-05,1.0
36190,돼넹/Noun,1,1,0,1.1115310228308472e-05,0.0,1.0
36191,증상만/Noun,1,0,1,0.0,1.1106915165381966e-05,1.0
36192,콤럼/Noun,1,0,1,0.0,1.1106915165381966e-05,1.0
36193,헛돈/Noun,1,0,1,0.0,1.1106915165381966e-05,1.0
36194,체육회/Noun,1,0,1,0.0,1.1106915165381966e-05,1.0
36195,도작품이/Foreign,1,1,0,1.1115310228308472e-05,0.0,1.0
36196,마전/Noun,1,0,1,0.0,1.1106915165381966e-05,1.0
36197,몰겠넹/Noun,1,0,1,0.0,1.1106915165381966e-05,1.0
36198,이영돈/Noun,1,0,1,0.0,1.1106915165381966e-05,1.0
36199,머스트/Noun,1,0,1,0.0,1.1106915165381966e-05,1.0
36200,데메/Noun,1,0,1,0.0,1.1106915165381966e-05,1.0
36201,DEVIL/Alpha,1,0,1,0.0,1.1106915165381966e-05,1.0
36202,주왕/Noun,1,0,1,0.0,1.1106915165381966e-05,1.0
36203,걸왕/Noun,1,0,1,0.0,1.1106915165381966e-05,1.0
36204,전용기/Noun,1,0,1,0.0,1.1106915165381966e-05,1.0
36205,오제/Noun,1,0,1,0.0,1.1106915165381966e-05,1.0
36206,삼황오제/Noun,1,0,1,0.0,1.1106915165381966e-05,1.0
36207,씨저/Noun,1,0,1,0.0,1.1106915165381966e-05,1.0
36208,MUST/Alpha,1,0,1,0.0,1.1106915165381966e-05,1.0
36209,CAESAR/Alpha,1,0,1,0.0,1.1106915165381966e-05,1.0
36210,꼬꼮꼭/Noun,1,1,0,1.1115310228308472e-05,0.0,1.0
36211,던스/Noun,1,0,1,0.0,1.1106915165381966e-05,1.0
36212,반의어/Noun,1,0,1,0.0,1.1106915165381966e-05,1.0
36213,born/Alpha,1,0,1,0.0,1.1106915165381966e-05,1.0
36214,unborn/Alpha,1,0,1,0.0,1.1106915165381966e-05,1.0
36215,투합/Noun,1,0,1,0.0,1.1106915165381966e-05,1.0
36216,십오야/Noun,1,0,1,0.0,1.1106915165381966e-05,1.0
36217,pta/Alpha,1,1,0,1.1115310228308472e-05,0.0,1.0
36218,방초/Noun,1,0,1,0.0,1.1106915165381966e-05,1.0
36219,brought/Alpha,1,1,0,1.1115310228308472e-05,0.0,1.0
36220,술상/Noun,1,0,1,0.0,1.1106915165381966e-05,1.0
36221,피좀/Noun,1,0,1,0.0,1.1106915165381966e-05,1.0
36222,때뮨/Noun,1,1,0,1.1115310228308472e-05,0.0,1.0
36223,번키/Noun,1,1,0,1.1115310228308472e-05,0.0,1.0
36224,134분/Number,1,1,0,1.1115310228308472e-05,0.0,1.0
36225,완비/Noun,1,1,0,1.1115310228308472e-05,0.0,1.0
36226,정한영/Noun,1,1,0,1.1115310228308472e-05,0.0,1.0
36227,스카우트/Noun,1,0,1,0.0,1.1106915165381966e-05,1.0
36228,해상전/Noun,1,0,1,0.0,1.1106915165381966e-05,1.0
36229,를좀웃습/Noun,1,0,1,0.0,1.1106915165381966e-05,1.0
36230,라미레스/Noun,1,1,0,1.1115310228308472e-05,0.0,1.0
36231,아레스/Noun,1,1,0,1.1115310228308472e-05,0.0,1.0
36232,이나이드라마를한지됬는데아직까지기억남네요/Foreign,1,1,0,1.1115310228308472e-05,0.0,1.0
36233,루너/Noun,1,1,0,1.1115310228308472e-05,0.0,1.0
36234,ncis/Alpha,1,1,0,1.1115310228308472e-05,0.0,1.0
36235,밑애/Noun,1,1,0,1.1115310228308472e-05,0.0,1.0
36236,핫챠/Noun,1,0,1,0.0,1.1106915165381966e-05,1.0
36237,베인스/Noun,1,1,0,1.1115310228308472e-05,0.0,1.0
36238,도지난작품이라/Foreign,1,0,1,0.0,1.1106915165381966e-05,1.0
36239,2015/6/Number,1,0,1,0.0,1.1106915165381966e-05,1.0
36240,정도면/Foreign,1,0,1,0.0,1.1106915165381966e-05,1.0
36241,222/Number,1,0,1,0.0,1.1106915165381966e-05,1.0
36242,덴젤이/Noun,1,1,0,1.1115310228308472e-05,0.0,1.0
36243,랜드마크/Noun,1,0,1,0.0,1.1106915165381966e-05,1.0
36244,Days/Alpha,1,0,1,0.0,1.1106915165381966e-05,1.0
36245,연천/Noun,1,0,1,0.0,1.1106915165381966e-05,1.0
36246,포천/Noun,1,0,1,0.0,1.1106915165381966e-05,1.0
36247,대수준이야/Foreign,1,0,1,0.0,1.1106915165381966e-05,1.0
36248,.....///Punctuation,1,0,1,0.0,1.1106915165381966e-05,1.0
36249,평지풍파/Noun,1,1,0,1.1115310228308472e-05,0.0,1.0
36250,레전설/Noun,1,1,0,1.1115310228308472e-05,0.0,1.0
36251,김태평/Noun,1,0,1,0.0,1.1106915165381966e-05,1.0
36252,박철/Noun,1,0,1,0.0,1.1106915165381966e-05,1.0
36253,화예/Noun,1,1,0,1.1115310228308472e-05,0.0,1.0
36254,먾/Noun,1,1,0,1.1115310228308472e-05,0.0,1.0
36255,불하/Noun,1,0,1,0.0,1.1106915165381966e-05,1.0
36256,30~50분/Number,1,0,1,0.0,1.1106915165381966e-05,1.0
36257,질럿들/Noun,1,0,1,0.0,1.1106915165381966e-05,1.0
36258,ㅎㅇ/KoreanParticle,1,0,1,0.0,1.1106915165381966e-05,1.0
36259,자궁암/Noun,1,0,1,0.0,1.1106915165381966e-05,1.0
36260,박격포/Noun,1,1,0,1.1115310228308472e-05,0.0,1.0
36261,단우/Noun,1,0,1,0.0,1.1106915165381966e-05,1.0
36262,탁재/Noun,1,0,1,0.0,1.1106915165381966e-05,1.0
36263,과학동아/Noun,1,1,0,1.1115310228308472e-05,0.0,1.0
36264,방광암/Noun,1,1,0,1.1115310228308472e-05,0.0,1.0
36265,남몰래/Adverb,1,1,0,1.1115310228308472e-05,0.0,1.0
36266,홍련같/Noun,1,1,0,1.1115310228308472e-05,0.0,1.0
36267,이닝/Noun,1,1,0,1.1115310228308472e-05,0.0,1.0
36268,터테/Noun,1,1,0,1.1115310228308472e-05,0.0,1.0
36269,겨패/Noun,1,0,1,0.0,1.1106915165381966e-05,1.0
36270,글레이/Noun,1,0,1,0.0,1.1106915165381966e-05,1.0
36271,극심/Noun,1,0,1,0.0,1.1106915165381966e-05,1.0
36272,비릿함/Noun,1,0,1,0.0,1.1106915165381966e-05,1.0
36273,kiss/Alpha,1,0,1,0.0,1.1106915165381966e-05,1.0
36274,운터강/Noun,1,0,1,0.0,1.1106915165381966e-05,1.0
36275,문승원/Noun,1,0,1,0.0,1.1106915165381966e-05,1.0
36276,죽겄다/Noun,1,0,1,0.0,1.1106915165381966e-05,1.0
36277,메두사/Noun,1,0,1,0.0,1.1106915165381966e-05,1.0
36278,때목/Noun,1,1,0,1.1115310228308472e-05,0.0,1.0
36279,딱따구리/Noun,1,0,1,0.0,1.1106915165381966e-05,1.0
36280,기장/Noun,1,0,1,0.0,1.1106915165381966e-05,1.0
36281,애브넛/Noun,1,0,1,0.0,1.1106915165381966e-05,1.0
36282,휘청거리다/Verb,1,0,1,0.0,1.1106915165381966e-05,1.0
36283,햤던/Noun,1,0,1,0.0,1.1106915165381966e-05,1.0
36284,재계/Noun,1,0,1,0.0,1.1106915165381966e-05,1.0
36285,퉤이/Noun,1,0,1,0.0,1.1106915165381966e-05,1.0
36286,레퍼런스급/Noun,1,0,1,0.0,1.1106915165381966e-05,1.0
36287,체기/Noun,1,0,1,0.0,1.1106915165381966e-05,1.0
36288,거번/Noun,1,0,1,0.0,1.1106915165381966e-05,1.0
36289,흘터보/Noun,1,0,1,0.0,1.1106915165381966e-05,1.0
36290,baboo/Alpha,1,0,1,0.0,1.1106915165381966e-05,1.0
36291,닥극사/Noun,1,1,0,1.1115310228308472e-05,0.0,1.0
36292,정도보고/Foreign,1,0,1,0.0,1.1106915165381966e-05,1.0
36293,금실/Noun,1,0,1,0.0,1.1106915165381966e-05,1.0
36294,한희준/Noun,1,0,1,0.0,1.1106915165381966e-05,1.0
36295,이순/Noun,1,1,0,1.1115310228308472e-05,0.0,1.0
36296,쌀롱/Noun,1,1,0,1.1115310228308472e-05,0.0,1.0
36297,좋아엲/Noun,1,1,0,1.1115310228308472e-05,0.0,1.0
36298,난시/Noun,1,0,1,0.0,1.1106915165381966e-05,1.0
36299,색약/Noun,1,0,1,0.0,1.1106915165381966e-05,1.0
36300,색맹/Noun,1,0,1,0.0,1.1106915165381966e-05,1.0
36301,물돌/Noun,1,1,0,1.1115310228308472e-05,0.0,1.0
36302,옛말/Noun,1,1,0,1.1115310228308472e-05,0.0,1.0
36303,ㅆㅆㅆ/KoreanParticle,1,0,1,0.0,1.1106915165381966e-05,1.0
36304,촌녀/Noun,1,1,0,1.1115310228308472e-05,0.0,1.0
36305,심폐소생/Noun,1,1,0,1.1115310228308472e-05,0.0,1.0
36306,두드림/Noun,1,1,0,1.1115310228308472e-05,0.0,1.0
36307,띵동/Noun,1,0,1,0.0,1.1106915165381966e-05,1.0
36308,깨금독/Noun,1,1,0,1.1115310228308472e-05,0.0,1.0
36309,타이즈/Noun,1,0,1,0.0,1.1106915165381966e-05,1.0
36310,존부/Noun,1,0,1,0.0,1.1106915165381966e-05,1.0
36311,Apocalypse/Alpha,1,1,0,1.1115310228308472e-05,0.0,1.0
36312,Filmmaker/Alpha,1,1,0,1.1115310228308472e-05,0.0,1.0
36313,Darkness/Alpha,1,1,0,1.1115310228308472e-05,0.0,1.0
36314,Hearts/Alpha,1,1,0,1.1115310228308472e-05,0.0,1.0
36315,치받다/Verb,1,0,1,0.0,1.1106915165381966e-05,1.0
36316,제브디/Noun,1,1,0,1.1115310228308472e-05,0.0,1.0
36317,맥켈런/Noun,1,1,0,1.1115310228308472e-05,0.0,1.0
36318,삿다/Noun,1,1,0,1.1115310228308472e-05,0.0,1.0
36319,ㅓㅓㅠ/KoreanParticle,1,1,0,1.1115310228308472e-05,0.0,1.0
36320,쨔흐/Noun,1,1,0,1.1115310228308472e-05,0.0,1.0
36321,나룻/Noun,1,1,0,1.1115310228308472e-05,0.0,1.0
36322,만판/Noun,1,0,1,0.0,1.1106915165381966e-05,1.0
36323,핸들/Noun,1,0,1,0.0,1.1106915165381966e-05,1.0
36324,퀴즈왕/Noun,1,0,1,0.0,1.1106915165381966e-05,1.0
36325,할할/Adverb,1,0,1,0.0,1.1106915165381966e-05,1.0
36326,봣던상관/Noun,1,0,1,0.0,1.1106915165381966e-05,1.0
36327,만드삼/Noun,1,0,1,0.0,1.1106915165381966e-05,1.0
36328,팥빙수/Noun,1,0,1,0.0,1.1106915165381966e-05,1.0
36329,시바스리갈/Noun,1,0,1,0.0,1.1106915165381966e-05,1.0
36330,송연우/Noun,1,0,1,0.0,1.1106915165381966e-05,1.0
36331,전이구나/Foreign,1,0,1,0.0,1.1106915165381966e-05,1.0
36332,데쓰노트/Noun,1,0,1,0.0,1.1106915165381966e-05,1.0
36333,에델/Noun,1,1,0,1.1115310228308472e-05,0.0,1.0
36334,통기타/Noun,1,0,1,0.0,1.1106915165381966e-05,1.0
36335,사식/Noun,1,1,0,1.1115310228308472e-05,0.0,1.0
36336,filmography/Alpha,1,0,1,0.0,1.1106915165381966e-05,1.0
36337,병용/Noun,1,0,1,0.0,1.1106915165381966e-05,1.0
36338,-_-..;;;/Punctuation,1,1,0,1.1115310228308472e-05,0.0,1.0
36339,했으면했는거지그거갔고잘난척좀그만해라니보다잘하는놈많으니까/Foreign,1,0,1,0.0,1.1106915165381966e-05,1.0
36340,힙팝/Noun,1,0,1,0.0,1.1106915165381966e-05,1.0
36341,방터/Noun,1,0,1,0.0,1.1106915165381966e-05,1.0
36342,회태/Noun,1,0,1,0.0,1.1106915165381966e-05,1.0
36343,왜봣을까/Noun,1,0,1,0.0,1.1106915165381966e-05,1.0
36344,++!/Punctuation,1,1,0,1.1115310228308472e-05,0.0,1.0
36345,SSibal/Alpha,1,0,1,0.0,1.1106915165381966e-05,1.0
36346,ㅉㅣ/KoreanParticle,1,0,1,0.0,1.1106915165381966e-05,1.0
36347,매가리/Noun,1,0,1,0.0,1.1106915165381966e-05,1.0
36348,6.47/Number,1,1,0,1.1115310228308472e-05,0.0,1.0
36349,이사도/Noun,1,1,0,1.1115310228308472e-05,0.0,1.0
36350,해영/Noun,1,1,0,1.1115310228308472e-05,0.0,1.0
36351,상효/Noun,1,1,0,1.1115310228308472e-05,0.0,1.0
36352,쇄끼/Noun,1,1,0,1.1115310228308472e-05,0.0,1.0
36353,블랑섹/Noun,1,1,0,1.1115310228308472e-05,0.0,1.0
36354,김준배/Noun,1,0,1,0.0,1.1106915165381966e-05,1.0
36355,이호재/Noun,1,1,0,1.1115310228308472e-05,0.0,1.0
36356,려신/Noun,1,1,0,1.1115310228308472e-05,0.0,1.0
36357,용진/Noun,1,1,0,1.1115310228308472e-05,0.0,1.0
36358,surprise/Alpha,1,1,0,1.1115310228308472e-05,0.0,1.0
36359,티져/Noun,1,0,1,0.0,1.1106915165381966e-05,1.0
36360,지나면/Foreign,1,0,1,0.0,1.1106915165381966e-05,1.0
36361,갖다주러가죠/Foreign,1,0,1,0.0,1.1106915165381966e-05,1.0
36362,^^*;;/Punctuation,1,1,0,1.1115310228308472e-05,0.0,1.0
36363,움츠리다/Verb,1,1,0,1.1115310228308472e-05,0.0,1.0
36364,사십/Noun,1,1,0,1.1115310228308472e-05,0.0,1.0
36365,유민규/Noun,1,0,1,0.0,1.1106915165381966e-05,1.0
36366,~~~~~~~~~~~~~~~~~~~~/Punctuation,1,0,1,0.0,1.1106915165381966e-05,1.0
36367,어캐봐/Noun,1,0,1,0.0,1.1106915165381966e-05,1.0
36368,뭉실/Noun,1,0,1,0.0,1.1106915165381966e-05,1.0
36369,아덴만/Noun,1,1,0,1.1115310228308472e-05,0.0,1.0
36370,신선조/Noun,1,0,1,0.0,1.1106915165381966e-05,1.0
36371,군사분계선/Noun,1,0,1,0.0,1.1106915165381966e-05,1.0
36372,롱리/Noun,1,1,0,1.1115310228308472e-05,0.0,1.0
36373,",,->/Punctuation",1,1,0,1.1115310228308472e-05,0.0,1.0
36374,만이다/Foreign,1,0,1,0.0,1.1106915165381966e-05,1.0
36375,공립/Noun,1,0,1,0.0,1.1106915165381966e-05,1.0
36376,사립/Noun,1,0,1,0.0,1.1106915165381966e-05,1.0
36377,맟/Noun,1,0,1,0.0,1.1106915165381966e-05,1.0
36378,김종훈/Noun,1,0,1,0.0,1.1106915165381966e-05,1.0
36379,김중훈/Noun,1,0,1,0.0,1.1106915165381966e-05,1.0
36380,상주고/Noun,1,1,0,1.1115310228308472e-05,0.0,1.0
36381,비스/Noun,1,1,0,1.1115310228308472e-05,0.0,1.0
36382,늙은힌색/Noun,1,0,1,0.0,1.1106915165381966e-05,1.0
36383,ㅍㄷㅇㅇ/KoreanParticle,1,0,1,0.0,1.1106915165381966e-05,1.0
36384,ㄱㅈㄴ/KoreanParticle,1,0,1,0.0,1.1106915165381966e-05,1.0
36385,몬쥬/Noun,1,1,0,1.1115310228308472e-05,0.0,1.0
36386,밈굳긔니긛느/Noun,1,0,1,0.0,1.1106915165381966e-05,1.0
36387,페르마/Noun,1,1,0,1.1115310228308472e-05,0.0,1.0
36388,/./././/Punctuation,1,0,1,0.0,1.1106915165381966e-05,1.0
36389,훌터보/Noun,1,1,0,1.1115310228308472e-05,0.0,1.0
36390,4.25/Number,1,0,1,0.0,1.1106915165381966e-05,1.0
36391,김진수/Noun,1,0,1,0.0,1.1106915165381966e-05,1.0
36392,즁/Noun,1,0,1,0.0,1.1106915165381966e-05,1.0
36393,있냐/Foreign,1,1,0,1.1115310228308472e-05,0.0,1.0
36394,베볼/Noun,1,0,1,0.0,1.1106915165381966e-05,1.0
36395,포카/Noun,1,1,0,1.1115310228308472e-05,0.0,1.0
36396,男/Foreign,1,1,0,1.1115310228308472e-05,0.0,1.0
36397,"..-,.-;/Punctuation",1,1,0,1.1115310228308472e-05,0.0,1.0
36398,.............;;/Punctuation,1,0,1,0.0,1.1106915165381966e-05,1.0
36399,읊더/Noun,1,0,1,0.0,1.1106915165381966e-05,1.0
36400,임전/Noun,1,0,1,0.0,1.1106915165381966e-05,1.0
36401,콩생콩사/Noun,1,0,1,0.0,1.1106915165381966e-05,1.0
36402,갈락티코/Noun,1,0,1,0.0,1.1106915165381966e-05,1.0
36403,bajj/Alpha,1,0,1,0.0,1.1106915165381966e-05,1.0
36404,현관문/Noun,1,1,0,1.1115310228308472e-05,0.0,1.0
36405,..;?/Punctuation,1,1,0,1.1115310228308472e-05,0.0,1.0
36406,모래주머니/Noun,1,1,0,1.1115310228308472e-05,0.0,1.0
36407,취존/Noun,1,1,0,1.1115310228308472e-05,0.0,1.0
36408,잘불르다/Verb,1,0,1,0.0,1.1106915165381966e-05,1.0
36409,울고싶어라/Noun,1,0,1,0.0,1.1106915165381966e-05,1.0
36410,코로나/Noun,1,0,1,0.0,1.1106915165381966e-05,1.0
36411,후니/Noun,1,1,0,1.1115310228308472e-05,0.0,1.0
36412,SAMSUN/Alpha,1,1,0,1.1115310228308472e-05,0.0,1.0
36413,familiar/Alpha,1,1,0,1.1115310228308472e-05,0.0,1.0
36414,싶어랏/Noun,1,1,0,1.1115310228308472e-05,0.0,1.0
36415,부세/Noun,1,1,0,1.1115310228308472e-05,0.0,1.0
36416,필수요소/Noun,1,0,1,0.0,1.1106915165381966e-05,1.0
36417,느꼐지/Noun,1,0,1,0.0,1.1106915165381966e-05,1.0
36418,왜리렇/Noun,1,0,1,0.0,1.1106915165381966e-05,1.0
36419,문초/Noun,1,0,1,0.0,1.1106915165381966e-05,1.0
36420,나니요/Noun,1,1,0,1.1115310228308472e-05,0.0,1.0
36421,♥★♥★♥★♡☆♡☆♡☆/Foreign,1,1,0,1.1115310228308472e-05,0.0,1.0
36422,검사관/Noun,1,1,0,1.1115310228308472e-05,0.0,1.0
36423,애색긔들/Noun,1,0,1,0.0,1.1106915165381966e-05,1.0
36424,##잘봤어요/Hashtag,1,1,0,1.1115310228308472e-05,0.0,1.0
36425,"4,000원/Number",1,0,1,0.0,1.1106915165381966e-05,1.0
36426,에게다/Josa,1,1,0,1.1115310228308472e-05,0.0,1.0
36427,보넨/Noun,1,1,0,1.1115310228308472e-05,0.0,1.0
36428,게맘/Noun,1,1,0,1.1115310228308472e-05,0.0,1.0
36429,떡뽁/Noun,1,1,0,1.1115310228308472e-05,0.0,1.0
36430,풍파/Noun,1,1,0,1.1115310228308472e-05,0.0,1.0
36431,지율/Noun,1,0,1,0.0,1.1106915165381966e-05,1.0
36432,애국지사/Noun,1,1,0,1.1115310228308472e-05,0.0,1.0
36433,PINK/Alpha,1,1,0,1.1115310228308472e-05,0.0,1.0
36434,잉글리시/Noun,1,0,1,0.0,1.1106915165381966e-05,1.0
36435,볼맘/Noun,1,1,0,1.1115310228308472e-05,0.0,1.0
36436,분할수/Noun,1,0,1,0.0,1.1106915165381966e-05,1.0
36437,Skype/Alpha,1,1,0,1.1115310228308472e-05,0.0,1.0
36438,김창훈/Noun,1,1,0,1.1115310228308472e-05,0.0,1.0
36439,윈작이책/Noun,1,1,0,1.1115310228308472e-05,0.0,1.0
36440,왁싱좀/Noun,1,0,1,0.0,1.1106915165381966e-05,1.0
36441,윤미래/Noun,1,1,0,1.1115310228308472e-05,0.0,1.0
36442,탁윌/Noun,1,1,0,1.1115310228308472e-05,0.0,1.0
36443,Wei/Alpha,1,1,0,1.1115310228308472e-05,0.0,1.0
36444,Tang/Alpha,1,1,0,1.1115310228308472e-05,0.0,1.0
36445,헥헥거리/Noun,1,0,1,0.0,1.1106915165381966e-05,1.0
36446,주라기/Noun,1,1,0,1.1115310228308472e-05,0.0,1.0
36447,believe/Alpha,1,1,0,1.1115310228308472e-05,0.0,1.0
36448,주고봤네요/Foreign,1,0,1,0.0,1.1106915165381966e-05,1.0
36449,만에이런쓰레기를/Foreign,1,0,1,0.0,1.1106915165381966e-05,1.0
36450,머얌/Noun,1,0,1,0.0,1.1106915165381966e-05,1.0
36451,bbbbbbbbb/Alpha,1,1,0,1.1115310228308472e-05,0.0,1.0
36452,smoke/Alpha,1,1,0,1.1115310228308472e-05,0.0,1.0
36453,가준웅/Noun,1,1,0,1.1115310228308472e-05,0.0,1.0
36454,오반/Noun,1,1,0,1.1115310228308472e-05,0.0,1.0
36455,믹서/Noun,1,0,1,0.0,1.1106915165381966e-05,1.0
36456,⌒☆/Foreign,1,0,1,0.0,1.1106915165381966e-05,1.0
36457,～/Foreign,1,0,1,0.0,1.1106915165381966e-05,1.0
36458,っ/Foreign,1,0,1,0.0,1.1106915165381966e-05,1.0
36459,나을떄/Noun,1,1,0,1.1115310228308472e-05,0.0,1.0
36460,돤디/Noun,1,0,1,0.0,1.1106915165381966e-05,1.0
36461,액숑마/Noun,1,0,1,0.0,1.1106915165381966e-05,1.0
36462,불쌍햇/Noun,1,1,0,1.1115310228308472e-05,0.0,1.0
36463,켤레/Noun,1,1,0,1.1115310228308472e-05,0.0,1.0
36464,샹송/Noun,1,1,0,1.1115310228308472e-05,0.0,1.0
36465,짜리인줄도/Foreign,1,1,0,1.1115310228308472e-05,0.0,1.0
36466,1.8/Number,1,0,1,0.0,1.1106915165381966e-05,1.0
36467,아홉/Modifier,1,1,0,1.1115310228308472e-05,0.0,1.0
36468,성아/Noun,1,1,0,1.1115310228308472e-05,0.0,1.0
36469,운치/Noun,1,0,1,0.0,1.1106915165381966e-05,1.0
36470,척움/Noun,1,0,1,0.0,1.1106915165381966e-05,1.0
36471,질좀/Noun,1,0,1,0.0,1.1106915165381966e-05,1.0
36472,자귀모/Noun,1,0,1,0.0,1.1106915165381966e-05,1.0
36473,천년호/Noun,1,0,1,0.0,1.1106915165381966e-05,1.0
36474,선후/Noun,1,0,1,0.0,1.1106915165381966e-05,1.0
36475,관복/Noun,1,0,1,0.0,1.1106915165381966e-05,1.0
36476,관모/Noun,1,0,1,0.0,1.1106915165381966e-05,1.0
36477,품계/Noun,1,0,1,0.0,1.1106915165381966e-05,1.0
36478,장난감병정/Noun,1,1,0,1.1115310228308472e-05,0.0,1.0
36479,면개/Noun,1,0,1,0.0,1.1106915165381966e-05,1.0
36480,환승/Noun,1,0,1,0.0,1.1106915165381966e-05,1.0
36481,남심여심/Noun,1,0,1,0.0,1.1106915165381966e-05,1.0
36482,Origin/Alpha,1,1,0,1.1115310228308472e-05,0.0,1.0
36483,푸대접/Noun,1,1,0,1.1115310228308472e-05,0.0,1.0
36484,Wolverine/Alpha,1,1,0,1.1115310228308472e-05,0.0,1.0
36485,Origins/Alpha,1,1,0,1.1115310228308472e-05,0.0,1.0
36486,Men/Alpha,1,1,0,1.1115310228308472e-05,0.0,1.0
36487,이윤석/Noun,1,0,1,0.0,1.1106915165381966e-05,1.0
36488,Brides/Alpha,1,1,0,1.1115310228308472e-05,0.0,1.0
36489,Barbie/Alpha,1,1,0,1.1115310228308472e-05,0.0,1.0
36490,스트라이샌드/Noun,1,1,0,1.1115310228308472e-05,0.0,1.0
36491,쉐비/Noun,1,1,0,1.1115310228308472e-05,0.0,1.0
36492,묵자/Noun,1,0,1,0.0,1.1106915165381966e-05,1.0
36493,번질번질하다/Adjective,1,0,1,0.0,1.1106915165381966e-05,1.0
36494,느니라/Noun,1,0,1,0.0,1.1106915165381966e-05,1.0
36495,대껏같이/Foreign,1,0,1,0.0,1.1106915165381966e-05,1.0
36496,1970~80년/Number,1,0,1,0.0,1.1106915165381966e-05,1.0
36497,김택진/Noun,1,1,0,1.1115310228308472e-05,0.0,1.0
36498,simply/Alpha,1,0,1,0.0,1.1106915165381966e-05,1.0
36499,이천원/Noun,1,0,1,0.0,1.1106915165381966e-05,1.0
36500,우하히헤하홍/Noun,1,0,1,0.0,1.1106915165381966e-05,1.0
36501,맹숭하/Noun,1,0,1,0.0,1.1106915165381966e-05,1.0
36502,!!!></Punctuation,1,1,0,1.1115310228308472e-05,0.0,1.0
36503,븐거/Noun,1,0,1,0.0,1.1106915165381966e-05,1.0
36504,촐/Noun,1,0,1,0.0,1.1106915165381966e-05,1.0
36505,뻥임/Noun,1,1,0,1.1115310228308472e-05,0.0,1.0
36506,수익금/Noun,1,0,1,0.0,1.1106915165381966e-05,1.0
36507,미쓰에이/Noun,1,1,0,1.1115310228308472e-05,0.0,1.0
36508,트란안훙꺼/Noun,1,0,1,0.0,1.1106915165381966e-05,1.0
36509,줄뻔/Noun,1,1,0,1.1115310228308472e-05,0.0,1.0
36510,슬금슬금/Noun,1,1,0,1.1115310228308472e-05,0.0,1.0
36511,쥐젖/Noun,1,0,1,0.0,1.1106915165381966e-05,1.0
36512,대기층/Noun,1,0,1,0.0,1.1106915165381966e-05,1.0
36513,친부/Noun,1,1,0,1.1115310228308472e-05,0.0,1.0
36514,ang/Alpha,1,1,0,1.1115310228308472e-05,0.0,1.0
36515,8-10/Number,1,0,1,0.0,1.1106915165381966e-05,1.0
36516,햇금오/Noun,1,1,0,1.1115310228308472e-05,0.0,1.0
36517,풋함/Noun,1,1,0,1.1115310228308472e-05,0.0,1.0
36518,봤늗/Noun,1,0,1,0.0,1.1106915165381966e-05,1.0
36519,사중에/Foreign,1,1,0,1.1115310228308472e-05,0.0,1.0
36520,그리하여/Conjunction,1,0,1,0.0,1.1106915165381966e-05,1.0
36521,외과의/Noun,1,0,1,0.0,1.1106915165381966e-05,1.0
36522,이우진/Noun,1,0,1,0.0,1.1106915165381966e-05,1.0
36523,????????????????????????????????????????????????????/Punctuation,1,0,1,0.0,1.1106915165381966e-05,1.0
36524,앙심/Noun,1,0,1,0.0,1.1106915165381966e-05,1.0
36525,캬핰하하하핰/Noun,1,1,0,1.1115310228308472e-05,0.0,1.0
36526,거젆/Noun,1,0,1,0.0,1.1106915165381966e-05,1.0
36527,쥭/Noun,1,0,1,0.0,1.1106915165381966e-05,1.0
36528,몸무/Noun,1,0,1,0.0,1.1106915165381966e-05,1.0
36529,부과/Noun,1,0,1,0.0,1.1106915165381966e-05,1.0
36530,렌탈/Noun,1,0,1,0.0,1.1106915165381966e-05,1.0
36531,유조선/Noun,1,1,0,1.1115310228308472e-05,0.0,1.0
36532,컬처/Noun,1,0,1,0.0,1.1106915165381966e-05,1.0
36533,번창/Noun,1,0,1,0.0,1.1106915165381966e-05,1.0
36534,열대어/Noun,1,0,1,0.0,1.1106915165381966e-05,1.0
36535,시민권/Noun,1,0,1,0.0,1.1106915165381966e-05,1.0
36536,송두율/Noun,1,0,1,0.0,1.1106915165381966e-05,1.0
36537,무러칠/Noun,1,0,1,0.0,1.1106915165381966e-05,1.0
36538,무시무시/Adverb,1,1,0,1.1115310228308472e-05,0.0,1.0
36539,■/Foreign,1,0,1,0.0,1.1106915165381966e-05,1.0
36540,백봉기/Noun,1,1,0,1.1115310228308472e-05,0.0,1.0
36541,어술/Noun,1,0,1,0.0,1.1106915165381966e-05,1.0
36542,리어커/Noun,1,1,0,1.1115310228308472e-05,0.0,1.0
36543,묘현/Noun,1,1,0,1.1115310228308472e-05,0.0,1.0
36544,메카시즘/Noun,1,1,0,1.1115310228308472e-05,0.0,1.0
36545,전화선/Noun,1,1,0,1.1115310228308472e-05,0.0,1.0
36546,데카당스/Noun,1,0,1,0.0,1.1106915165381966e-05,1.0
36547,2~40/Number,1,1,0,1.1115310228308472e-05,0.0,1.0
36548,.-_-;;;/Punctuation,1,0,1,0.0,1.1106915165381966e-05,1.0
36549,학식/Noun,1,1,0,1.1115310228308472e-05,0.0,1.0
36550,생뚱맞다/Noun,1,0,1,0.0,1.1106915165381966e-05,1.0
36551,안떳을까/Noun,1,1,0,1.1115310228308472e-05,0.0,1.0
36552,꿩/Noun,1,1,0,1.1115310228308472e-05,0.0,1.0
36553,빠방/Noun,1,0,1,0.0,1.1106915165381966e-05,1.0
36554,느겨본/Noun,1,1,0,1.1115310228308472e-05,0.0,1.0
36555,내진/Noun,1,1,0,1.1115310228308472e-05,0.0,1.0
36556,폴라로이드/Noun,1,1,0,1.1115310228308472e-05,0.0,1.0
36557,유강/Noun,1,1,0,1.1115310228308472e-05,0.0,1.0
36558,안태영/Noun,1,1,0,1.1115310228308472e-05,0.0,1.0
36559,다고는/Eomi,1,0,1,0.0,1.1106915165381966e-05,1.0
36560,작풍/Noun,1,1,0,1.1115310228308472e-05,0.0,1.0
36561,대만사람/Noun,1,0,1,0.0,1.1106915165381966e-05,1.0
36562,둿/Noun,1,0,1,0.0,1.1106915165381966e-05,1.0
36563,주유/Noun,1,0,1,0.0,1.1106915165381966e-05,1.0
36564,♥♩♪♬☞☜♡/Foreign,1,1,0,1.1115310228308472e-05,0.0,1.0
36565,우렁/Noun,1,0,1,0.0,1.1106915165381966e-05,1.0
36566,냇던/Noun,1,1,0,1.1115310228308472e-05,0.0,1.0
36567,천장화/Noun,1,1,0,1.1115310228308472e-05,0.0,1.0
36568,곶아샷/Noun,1,0,1,0.0,1.1106915165381966e-05,1.0
36569,참고봣/Noun,1,0,1,0.0,1.1106915165381966e-05,1.0
36570,능청능청/Adverb,1,1,0,1.1115310228308472e-05,0.0,1.0
36571,지드레곤/Noun,1,0,1,0.0,1.1106915165381966e-05,1.0
36572,다리꼬/Noun,1,1,0,1.1115310228308472e-05,0.0,1.0
36573,ㅊㄱ/KoreanParticle,1,1,0,1.1115310228308472e-05,0.0,1.0
36574,인민공화국/Noun,1,0,1,0.0,1.1106915165381966e-05,1.0
36575,...^/Punctuation,1,1,0,1.1115310228308472e-05,0.0,1.0
36576,정류장/Noun,1,0,1,0.0,1.1106915165381966e-05,1.0
36577,찻아볼/Noun,1,0,1,0.0,1.1106915165381966e-05,1.0
36578,....//?/Punctuation,1,0,1,0.0,1.1106915165381966e-05,1.0
36579,자기껄/Noun,1,1,0,1.1115310228308472e-05,0.0,1.0
36580,나원진/Noun,1,0,1,0.0,1.1106915165381966e-05,1.0
36581,개빙닭/Noun,1,0,1,0.0,1.1106915165381966e-05,1.0
36582,이상용/Noun,1,0,1,0.0,1.1106915165381966e-05,1.0
36583,샤콘느/Noun,1,1,0,1.1115310228308472e-05,0.0,1.0
36584,사각형/Noun,1,0,1,0.0,1.1106915165381966e-05,1.0
36585,빌보드/Noun,1,1,0,1.1115310228308472e-05,0.0,1.0
36586,꼭볼/Noun,1,1,0,1.1115310228308472e-05,0.0,1.0
36587,쇠고기/Noun,1,1,0,1.1115310228308472e-05,0.0,1.0
36588,무도리/Noun,1,0,1,0.0,1.1106915165381966e-05,1.0
36589,팾버/Noun,1,1,0,1.1115310228308472e-05,0.0,1.0
36590,히히허롷/Noun,1,1,0,1.1115310228308472e-05,0.0,1.0
36591,ㄱㅈㅇ/KoreanParticle,1,1,0,1.1115310228308472e-05,0.0,1.0
36592,브더릅/Noun,1,0,1,0.0,1.1106915165381966e-05,1.0
36593,만꼭/Noun,1,1,0,1.1115310228308472e-05,0.0,1.0
36594,아이키도/Noun,1,0,1,0.0,1.1106915165381966e-05,1.0
36595,내염/Noun,1,1,0,1.1115310228308472e-05,0.0,1.0
36596,새드무비/Noun,1,1,0,1.1115310228308472e-05,0.0,1.0
36597,에도말/Noun,1,0,1,0.0,1.1106915165381966e-05,1.0
36598,모두하나/Noun,1,1,0,1.1115310228308472e-05,0.0,1.0
36599,햇겟/Noun,1,0,1,0.0,1.1106915165381966e-05,1.0
36600,김아현/Noun,1,0,1,0.0,1.1106915165381966e-05,1.0
36601,피똥쌈/Noun,1,1,0,1.1115310228308472e-05,0.0,1.0
36602,!!???.!!?/Punctuation,1,0,1,0.0,1.1106915165381966e-05,1.0
36603,기모찌/Noun,1,0,1,0.0,1.1106915165381966e-05,1.0
36604,앵/Noun,1,1,0,1.1115310228308472e-05,0.0,1.0
36605,NHK/Alpha,1,1,0,1.1115310228308472e-05,0.0,1.0
36606,켓다/Noun,1,1,0,1.1115310228308472e-05,0.0,1.0
36607,흐어어/Exclamation,1,1,0,1.1115310228308472e-05,0.0,1.0
36608,남중생/Noun,1,0,1,0.0,1.1106915165381966e-05,1.0
36609,드릅게/Noun,1,0,1,0.0,1.1106915165381966e-05,1.0
36610,구비/Noun,1,1,0,1.1115310228308472e-05,0.0,1.0
36611,친절해지다/Adjective,1,1,0,1.1115310228308472e-05,0.0,1.0
36612,껄끄런/Noun,1,1,0,1.1115310228308472e-05,0.0,1.0
36613,온상/Noun,1,0,1,0.0,1.1106915165381966e-05,1.0
36614,뒤엔/Foreign,1,1,0,1.1115310228308472e-05,0.0,1.0
36615,배경미/Noun,1,1,0,1.1115310228308472e-05,0.0,1.0
36616,suck/Alpha,1,0,1,0.0,1.1106915165381966e-05,1.0
36617,/``!!/Punctuation,1,1,0,1.1115310228308472e-05,0.0,1.0
36618,딱보면/Foreign,1,0,1,0.0,1.1106915165381966e-05,1.0
36619,개똥퀄리티/Noun,1,0,1,0.0,1.1106915165381966e-05,1.0
36620,http://iamking.me/OoKeEZ/URL,1,1,0,1.1115310228308472e-05,0.0,1.0
36621,그루폰/Noun,1,1,0,1.1115310228308472e-05,0.0,1.0
36622,김정현/Noun,1,1,0,1.1115310228308472e-05,0.0,1.0
36623,confession/Alpha,1,1,0,1.1115310228308472e-05,0.0,1.0
36624,습얼/Noun,1,0,1,0.0,1.1106915165381966e-05,1.0
36625,똥통처학/Noun,1,0,1,0.0,1.1106915165381966e-05,1.0
36626,지쯔/Noun,1,1,0,1.1115310228308472e-05,0.0,1.0
36627,2억만/Number,1,0,1,0.0,1.1106915165381966e-05,1.0
36628,이통/Noun,1,0,1,0.0,1.1106915165381966e-05,1.0
36629,요열/Noun,1,0,1,0.0,1.1106915165381966e-05,1.0
36630,일것/Foreign,1,0,1,0.0,1.1106915165381966e-05,1.0
36631,김미려/Noun,1,0,1,0.0,1.1106915165381966e-05,1.0
36632,강유미/Noun,1,0,1,0.0,1.1106915165381966e-05,1.0
36633,안영미/Noun,1,0,1,0.0,1.1106915165381966e-05,1.0
36634,김충수/Noun,1,0,1,0.0,1.1106915165381966e-05,1.0
36635,박충수/Noun,1,0,1,0.0,1.1106915165381966e-05,1.0
36636,이브이/Noun,1,1,0,1.1115310228308472e-05,0.0,1.0
36637,안봐스까/Noun,1,1,0,1.1115310228308472e-05,0.0,1.0
36638,뭣때문/Noun,1,0,1,0.0,1.1106915165381966e-05,1.0
36639,더럽덴다/Noun,1,0,1,0.0,1.1106915165381966e-05,1.0
36640,젓갈/Noun,1,1,0,1.1115310228308472e-05,0.0,1.0
36641,브런치/Noun,1,1,0,1.1115310228308472e-05,0.0,1.0
36642,토핑된/Noun,1,1,0,1.1115310228308472e-05,0.0,1.0
36643,유딩용/Noun,1,0,1,0.0,1.1106915165381966e-05,1.0
36644,뻐더렁니/Noun,1,0,1,0.0,1.1106915165381966e-05,1.0
36645,ㅜㅌ/KoreanParticle,1,1,0,1.1115310228308472e-05,0.0,1.0
36646,북스/Noun,1,0,1,0.0,1.1106915165381966e-05,1.0
36647,더낫/Noun,1,0,1,0.0,1.1106915165381966e-05,1.0
36648,은얻는거네/Foreign,1,0,1,0.0,1.1106915165381966e-05,1.0
36649,asfgsdlgkbjsjvb/Alpha,1,0,1,0.0,1.1106915165381966e-05,1.0
36650,ylmcrulae/Alpha,1,0,1,0.0,1.1106915165381966e-05,1.0
36651,사우디아라비아/Noun,1,1,0,1.1115310228308472e-05,0.0,1.0
36652,대졸/Noun,1,1,0,1.1115310228308472e-05,0.0,1.0
36653,저련/Noun,1,0,1,0.0,1.1106915165381966e-05,1.0
36654,드네용/Noun,1,1,0,1.1115310228308472e-05,0.0,1.0
36655,폐루편/Noun,1,1,0,1.1115310228308472e-05,0.0,1.0
36656,행함/Noun,1,1,0,1.1115310228308472e-05,0.0,1.0
36657,갓뎀갓뎀/Noun,1,0,1,0.0,1.1106915165381966e-05,1.0
36658,디브디로본/Noun,1,0,1,0.0,1.1106915165381966e-05,1.0
36659,잔류/Noun,1,0,1,0.0,1.1106915165381966e-05,1.0
36660,키륙케룩냐륭데헤/Noun,1,0,1,0.0,1.1106915165381966e-05,1.0
36661,랍스타/Noun,1,0,1,0.0,1.1106915165381966e-05,1.0
36662,걷히다/Verb,1,1,0,1.1115310228308472e-05,0.0,1.0
36663,미스틱리버/Noun,1,1,0,1.1115310228308472e-05,0.0,1.0
36664,**!!/Punctuation,1,0,1,0.0,1.1106915165381966e-05,1.0
36665,강소영/Noun,1,1,0,1.1115310228308472e-05,0.0,1.0
36666,이은비/Noun,1,1,0,1.1115310228308472e-05,0.0,1.0
36667,족햇/Noun,1,0,1,0.0,1.1106915165381966e-05,1.0
36668,놰/Noun,1,1,0,1.1115310228308472e-05,0.0,1.0
36669,쩁/Noun,1,0,1,0.0,1.1106915165381966e-05,1.0
36670,체인질링/Noun,1,1,0,1.1115310228308472e-05,0.0,1.0
36671,흰자/Noun,1,0,1,0.0,1.1106915165381966e-05,1.0
36672,해조/Noun,1,1,0,1.1115310228308472e-05,0.0,1.0
36673,점때엿을듯/Noun,1,1,0,1.1115310228308472e-05,0.0,1.0
36674,역사학자/Noun,1,0,1,0.0,1.1106915165381966e-05,1.0
36675,카버했다/Noun,1,1,0,1.1115310228308472e-05,0.0,1.0
36676,버렸넹/Noun,1,0,1,0.0,1.1106915165381966e-05,1.0
36677,피자헛/Noun,1,0,1,0.0,1.1106915165381966e-05,1.0
36678,전쟁범죄/Noun,1,1,0,1.1115310228308472e-05,0.0,1.0
36679,이지난지금도나한테가장재밌었던영화로기억남는/Foreign,1,1,0,1.1115310228308472e-05,0.0,1.0
36680,뺵없는/Noun,1,1,0,1.1115310228308472e-05,0.0,1.0
36681,짭짤하다/Adjective,1,1,0,1.1115310228308472e-05,0.0,1.0
36682,테렌스멜릭/Noun,1,1,0,1.1115310228308472e-05,0.0,1.0
36683,쩌넹/Noun,1,1,0,1.1115310228308472e-05,0.0,1.0
36684,王/Foreign,1,0,1,0.0,1.1106915165381966e-05,1.0
36685,전이야/Foreign,1,1,0,1.1115310228308472e-05,0.0,1.0
36686,아드라/Noun,1,1,0,1.1115310228308472e-05,0.0,1.0
36687,통구이/Noun,1,0,1,0.0,1.1106915165381966e-05,1.0
36688,美人/Foreign,1,1,0,1.1115310228308472e-05,0.0,1.0
36689,舒淇/Foreign,1,1,0,1.1115310228308472e-05,0.0,1.0
36690,범우/Noun,1,0,1,0.0,1.1106915165381966e-05,1.0
36691,버무려냄/Noun,1,0,1,0.0,1.1106915165381966e-05,1.0
36692,풍토/Noun,1,0,1,0.0,1.1106915165381966e-05,1.0
36693,롸벗니/Noun,1,1,0,1.1115310228308472e-05,0.0,1.0
36694,머냑/Noun,1,1,0,1.1115310228308472e-05,0.0,1.0
36695,말레피센트/Noun,1,1,0,1.1115310228308472e-05,0.0,1.0
36696,SAT/Alpha,1,0,1,0.0,1.1106915165381966e-05,1.0
36697,머싰따능/Noun,1,1,0,1.1115310228308472e-05,0.0,1.0
36698,마루이/Noun,1,1,0,1.1115310228308472e-05,0.0,1.0
36699,내캉/Noun,1,1,0,1.1115310228308472e-05,0.0,1.0
36700,작이면/Foreign,1,1,0,1.1115310228308472e-05,0.0,1.0
36701,싱겨운/Noun,1,0,1,0.0,1.1106915165381966e-05,1.0
36702,개화/Noun,1,0,1,0.0,1.1106915165381966e-05,1.0
36703,뽄진/Noun,1,0,1,0.0,1.1106915165381966e-05,1.0
36704,은합/Noun,1,0,1,0.0,1.1106915165381966e-05,1.0
36705,거피/Noun,1,0,1,0.0,1.1106915165381966e-05,1.0
36706,장볼/Noun,1,0,1,0.0,1.1106915165381966e-05,1.0
36707,다희/Noun,1,1,0,1.1115310228308472e-05,0.0,1.0
36708,낚엿네/Noun,1,0,1,0.0,1.1106915165381966e-05,1.0
36709,좌익사범/Noun,1,0,1,0.0,1.1106915165381966e-05,1.0
36710,씨트콤/Noun,1,1,0,1.1115310228308472e-05,0.0,1.0
36711,‰/Foreign,1,1,0,1.1115310228308472e-05,0.0,1.0
36712,욕햇엇다/Noun,1,0,1,0.0,1.1106915165381966e-05,1.0
36713,츨/Noun,1,1,0,1.1115310228308472e-05,0.0,1.0
36714,주고봤다/Foreign,1,0,1,0.0,1.1106915165381966e-05,1.0
36715,유플/Noun,1,0,1,0.0,1.1106915165381966e-05,1.0
36716,화닥질/Noun,1,0,1,0.0,1.1106915165381966e-05,1.0
36717,골방/Noun,1,1,0,1.1115310228308472e-05,0.0,1.0
36718,빼면/Foreign,1,0,1,0.0,1.1106915165381966e-05,1.0
36719,대작이라고는/Foreign,1,1,0,1.1115310228308472e-05,0.0,1.0
36720,처발처/Noun,1,0,1,0.0,1.1106915165381966e-05,1.0
36721,판드라마/Foreign,1,0,1,0.0,1.1106915165381966e-05,1.0
36722,시부야/Noun,1,1,0,1.1115310228308472e-05,0.0,1.0
36723,영상편지/Noun,1,0,1,0.0,1.1106915165381966e-05,1.0
36724,전에보고/Foreign,1,1,0,1.1115310228308472e-05,0.0,1.0
36725,간드러지다/Adjective,1,1,0,1.1115310228308472e-05,0.0,1.0
36726,처럼은/Josa,1,1,0,1.1115310228308472e-05,0.0,1.0
36727,^^;./Punctuation,1,0,1,0.0,1.1106915165381966e-05,1.0
36728,이진실/Noun,1,0,1,0.0,1.1106915165381966e-05,1.0
36729,시장님/Noun,1,1,0,1.1115310228308472e-05,0.0,1.0
36730,안주시/Noun,1,1,0,1.1115310228308472e-05,0.0,1.0
36731,도고/Noun,1,1,0,1.1115310228308472e-05,0.0,1.0
36732,프론대/Noun,1,0,1,0.0,1.1106915165381966e-05,1.0
36733,정선흳댐/Noun,1,0,1,0.0,1.1106915165381966e-05,1.0
36734,역정/Noun,1,0,1,0.0,1.1106915165381966e-05,1.0
36735,이비자/Noun,1,0,1,0.0,1.1106915165381966e-05,1.0
36736,역새/Noun,1,0,1,0.0,1.1106915165381966e-05,1.0
36737,드링크/Noun,1,0,1,0.0,1.1106915165381966e-05,1.0
36738,꽃다웠/Noun,1,1,0,1.1115310228308472e-05,0.0,1.0
36739,띱때/Noun,1,0,1,0.0,1.1106915165381966e-05,1.0
36740,가벼이/Adverb,1,1,0,1.1115310228308472e-05,0.0,1.0
36741,~!!!!!!!!!!!/Punctuation,1,1,0,1.1115310228308472e-05,0.0,1.0
36742,화운/Noun,1,1,0,1.1115310228308472e-05,0.0,1.0
36743,차르륵/Adverb,1,1,0,1.1115310228308472e-05,0.0,1.0
36744,텔링능력/Noun,1,0,1,0.0,1.1106915165381966e-05,1.0
36745,경아/Noun,1,1,0,1.1115310228308472e-05,0.0,1.0
36746,벋다/Verb,1,0,1,0.0,1.1106915165381966e-05,1.0
36747,외래/Noun,1,0,1,0.0,1.1106915165381966e-05,1.0
36748,김기종/Noun,1,0,1,0.0,1.1106915165381966e-05,1.0
36749,성공회대/Noun,1,0,1,0.0,1.1106915165381966e-05,1.0
36750,꼬락/Noun,1,0,1,0.0,1.1106915165381966e-05,1.0
36751,에문/Modifier,1,0,1,0.0,1.1106915165381966e-05,1.0
36752,개나리/Noun,1,0,1,0.0,1.1106915165381966e-05,1.0
36753,페로스/Noun,1,1,0,1.1115310228308472e-05,0.0,1.0
36754,9.35/Number,1,0,1,0.0,1.1106915165381966e-05,1.0
36755,똘똘뭉치/Noun,1,0,1,0.0,1.1106915165381966e-05,1.0
36756,놈애/Noun,1,0,1,0.0,1.1106915165381966e-05,1.0
36757,김현우/Noun,1,0,1,0.0,1.1106915165381966e-05,1.0
36758,볼만핟/Noun,1,0,1,0.0,1.1106915165381966e-05,1.0
36759,베낭/Noun,1,1,0,1.1115310228308472e-05,0.0,1.0
36760,갠전/Noun,1,0,1,0.0,1.1106915165381966e-05,1.0
36761,젠체/Noun,1,0,1,0.0,1.1106915165381966e-05,1.0
36762,깍으러/Noun,1,0,1,0.0,1.1106915165381966e-05,1.0
36763,스켈리톤/Noun,1,1,0,1.1115310228308472e-05,0.0,1.0
36764,션물/Noun,1,0,1,0.0,1.1106915165381966e-05,1.0
36765,약속의땅/Noun,1,0,1,0.0,1.1106915165381966e-05,1.0
36766,뇌교육/Noun,1,0,1,0.0,1.1106915165381966e-05,1.0
36767,들할껄/Noun,1,0,1,0.0,1.1106915165381966e-05,1.0
36768,GR/Alpha,1,0,1,0.0,1.1106915165381966e-05,1.0
36769,상쇄되어/Noun,1,1,0,1.1115310228308472e-05,0.0,1.0
36770,홙줄/Noun,1,0,1,0.0,1.1106915165381966e-05,1.0
36771,뒤흔듬/Noun,1,0,1,0.0,1.1106915165381966e-05,1.0
36772,31분/Number,1,0,1,0.0,1.1106915165381966e-05,1.0
36773,이라크전/Noun,1,0,1,0.0,1.1106915165381966e-05,1.0
36774,망중/Noun,1,0,1,0.0,1.1106915165381966e-05,1.0
36775,YDG/Alpha,1,1,0,1.1115310228308472e-05,0.0,1.0
36776,英/Foreign,1,1,0,1.1115310228308472e-05,0.0,1.0
36777,ㅓㅇㅁ/KoreanParticle,1,0,1,0.0,1.1106915165381966e-05,1.0
36778,중범죄/Noun,1,0,1,0.0,1.1106915165381966e-05,1.0
36779,물구나무/Noun,1,0,1,0.0,1.1106915165381966e-05,1.0
36780,물구나무서기/Noun,1,0,1,0.0,1.1106915165381966e-05,1.0
36781,슌땜/Noun,1,0,1,0.0,1.1106915165381966e-05,1.0
36782,사실관계/Noun,1,0,1,0.0,1.1106915165381966e-05,1.0
36783,울엇/Noun,1,1,0,1.1115310228308472e-05,0.0,1.0
36784,졸랏던/Noun,1,1,0,1.1115310228308472e-05,0.0,1.0
36785,이라니까/Foreign,1,0,1,0.0,1.1106915165381966e-05,1.0
36786,7천만원/Number,1,0,1,0.0,1.1106915165381966e-05,1.0
36787,33억/Number,1,0,1,0.0,1.1106915165381966e-05,1.0
36788,0310/Number,1,0,1,0.0,1.1106915165381966e-05,1.0
36789,mcj/Alpha,1,0,1,0.0,1.1106915165381966e-05,1.0
36790,gamdongB/Alpha,1,0,1,0.0,1.1106915165381966e-05,1.0
36791,프란때문/Noun,1,1,0,1.1115310228308472e-05,0.0,1.0
36792,슈슈슈슛/Noun,1,0,1,0.0,1.1106915165381966e-05,1.0
36793,버벌진트/Noun,1,1,0,1.1115310228308472e-05,0.0,1.0
36794,­/Foreign,1,0,1,0.0,1.1106915165381966e-05,1.0
36795,오뚝이/Noun,1,0,1,0.0,1.1106915165381966e-05,1.0
36796,감각기관/Noun,1,1,0,1.1115310228308472e-05,0.0,1.0
36797,얀토/Noun,1,1,0,1.1115310228308472e-05,0.0,1.0
36798,리빌드/Noun,1,1,0,1.1115310228308472e-05,0.0,1.0
36799,의딸/Noun,1,1,0,1.1115310228308472e-05,0.0,1.0
36800,...^^:;/Punctuation,1,1,0,1.1115310228308472e-05,0.0,1.0
36801,임완/Noun,1,0,1,0.0,1.1106915165381966e-05,1.0
36802,멘사/Noun,1,1,0,1.1115310228308472e-05,0.0,1.0
36803,아괄쳐닫/Noun,1,1,0,1.1115310228308472e-05,0.0,1.0
36804,콧구녕/Noun,1,1,0,1.1115310228308472e-05,0.0,1.0
36805,씁슬했던적/Noun,1,1,0,1.1115310228308472e-05,0.0,1.0
36806,쯥즙/Noun,1,0,1,0.0,1.1106915165381966e-05,1.0
36807,디배/Noun,1,0,1,0.0,1.1106915165381966e-05,1.0
36808,빨랑멈처/Noun,1,0,1,0.0,1.1106915165381966e-05,1.0
36809,표지판/Noun,1,0,1,0.0,1.1106915165381966e-05,1.0
36810,쌍껍/Noun,1,0,1,0.0,1.1106915165381966e-05,1.0
36811,ten/Alpha,1,1,0,1.1115310228308472e-05,0.0,1.0
36812,전담/Noun,1,1,0,1.1115310228308472e-05,0.0,1.0
36813,푸컄캬캬캬컄컄컄/Noun,1,0,1,0.0,1.1106915165381966e-05,1.0
36814,망항/Noun,1,0,1,0.0,1.1106915165381966e-05,1.0
36815,늬뮈롤/Noun,1,1,0,1.1115310228308472e-05,0.0,1.0
36816,행영/Noun,1,1,0,1.1115310228308472e-05,0.0,1.0
36817,을지로/Noun,1,1,0,1.1115310228308472e-05,0.0,1.0
36818,넉넉하다/Adjective,1,0,1,0.0,1.1106915165381966e-05,1.0
36819,바궈/Noun,1,0,1,0.0,1.1106915165381966e-05,1.0
36820,말쭉/Noun,1,0,1,0.0,1.1106915165381966e-05,1.0
36821,MD/Alpha,1,1,0,1.1115310228308472e-05,0.0,1.0
36822,못밌겠/Noun,1,0,1,0.0,1.1106915165381966e-05,1.0
36823,베니스영화제/Noun,1,0,1,0.0,1.1106915165381966e-05,1.0
36824,휠러/Noun,1,1,0,1.1115310228308472e-05,0.0,1.0
36825,TVf/Alpha,1,1,0,1.1115310228308472e-05,0.0,1.0
36826,.~~!!!/Punctuation,1,1,0,1.1115310228308472e-05,0.0,1.0
36827,모닥불/Noun,1,1,0,1.1115310228308472e-05,0.0,1.0
36828,도밍/Noun,1,1,0,1.1115310228308472e-05,0.0,1.0
36829,늠늠/Noun,1,1,0,1.1115310228308472e-05,0.0,1.0
36830,............-_-/Punctuation,1,0,1,0.0,1.1106915165381966e-05,1.0
36831,맹글겠다/Noun,1,0,1,0.0,1.1106915165381966e-05,1.0
36832,원자/Noun,1,1,0,1.1115310228308472e-05,0.0,1.0
36833,피꺼솟/Noun,1,0,1,0.0,1.1106915165381966e-05,1.0
36834,이종필/Noun,1,1,0,1.1115310228308472e-05,0.0,1.0
36835,".,...--/Punctuation",1,0,1,0.0,1.1106915165381966e-05,1.0
36836,피그/Noun,1,0,1,0.0,1.1106915165381966e-05,1.0
36837,있넜는데/Noun,1,1,0,1.1115310228308472e-05,0.0,1.0
36838,트윈/Noun,1,0,1,0.0,1.1106915165381966e-05,1.0
36839,자긍심/Noun,1,1,0,1.1115310228308472e-05,0.0,1.0
36840,~~!!!!!/Punctuation,1,1,0,1.1115310228308472e-05,0.0,1.0
36841,~~~~~!!/Punctuation,1,1,0,1.1115310228308472e-05,0.0,1.0
36842,153/Number,1,0,1,0.0,1.1106915165381966e-05,1.0
36843,박경원/Noun,1,1,0,1.1115310228308472e-05,0.0,1.0
36844,므훗함/Noun,1,0,1,0.0,1.1106915165381966e-05,1.0
36845,설마하니/Adverb,1,0,1,0.0,1.1106915165381966e-05,1.0
36846,..-.-/Punctuation,1,0,1,0.0,1.1106915165381966e-05,1.0
36847,~^^;;/Punctuation,1,1,0,1.1115310228308472e-05,0.0,1.0
36848,몽골어/Noun,1,0,1,0.0,1.1106915165381966e-05,1.0
36849,해충/Noun,1,0,1,0.0,1.1106915165381966e-05,1.0
36850,레니/Noun,1,1,0,1.1115310228308472e-05,0.0,1.0
36851,송원/Noun,1,0,1,0.0,1.1106915165381966e-05,1.0
36852,윳음/Noun,1,0,1,0.0,1.1106915165381966e-05,1.0
36853,편리/Noun,1,1,0,1.1115310228308472e-05,0.0,1.0
36854,자유당/Noun,1,1,0,1.1115310228308472e-05,0.0,1.0
36855,사다꼬/Noun,1,0,1,0.0,1.1106915165381966e-05,1.0
36856,boulvard/Alpha,1,1,0,1.1115310228308472e-05,0.0,1.0
36857,무을/Noun,1,0,1,0.0,1.1106915165381966e-05,1.0
36858,뷔작/Noun,1,1,0,1.1115310228308472e-05,0.0,1.0
36859,형펀없는/Noun,1,0,1,0.0,1.1106915165381966e-05,1.0
36860,YooHoo/Alpha,1,1,0,1.1115310228308472e-05,0.0,1.0
36861,개스트맘에듬/Noun,1,1,0,1.1115310228308472e-05,0.0,1.0
36862,sucksuck/Alpha,1,0,1,0.0,1.1106915165381966e-05,1.0
36863,무삭/Noun,1,1,0,1.1115310228308472e-05,0.0,1.0
36864,존쿠삭연기/Noun,1,0,1,0.0,1.1106915165381966e-05,1.0
36865,존쿠삭나온/Noun,1,0,1,0.0,1.1106915165381966e-05,1.0
36866,엔보그/Noun,1,1,0,1.1115310228308472e-05,0.0,1.0
36867,접수/Noun,1,0,1,0.0,1.1106915165381966e-05,1.0
36868,특소/Noun,1,1,0,1.1115310228308472e-05,0.0,1.0
36869,대에나온/Foreign,1,0,1,0.0,1.1106915165381966e-05,1.0
36870,사과나무/Noun,1,0,1,0.0,1.1106915165381966e-05,1.0
36871,컷나/Noun,1,0,1,0.0,1.1106915165381966e-05,1.0
36872,칼럼/Noun,1,1,0,1.1115310228308472e-05,0.0,1.0
36873,여거/Noun,1,0,1,0.0,1.1106915165381966e-05,1.0
36874,알레르기/Noun,1,0,1,0.0,1.1106915165381966e-05,1.0
36875,쿠삭땀/Noun,1,0,1,0.0,1.1106915165381966e-05,1.0
36876,쿠삭땜/Noun,1,0,1,0.0,1.1106915165381966e-05,1.0
36877,사셧/Noun,1,1,0,1.1115310228308472e-05,0.0,1.0
36878,남겻다/Noun,1,0,1,0.0,1.1106915165381966e-05,1.0
36879,누벨/Noun,1,1,0,1.1115310228308472e-05,0.0,1.0
36880,지났는데/Foreign,1,1,0,1.1115310228308472e-05,0.0,1.0
36881,해양소년단/Noun,1,1,0,1.1115310228308472e-05,0.0,1.0
36882,하이브/Noun,1,1,0,1.1115310228308472e-05,0.0,1.0
36883,쑈생크/Noun,1,1,0,1.1115310228308472e-05,0.0,1.0
36884,젠슨보/Noun,1,1,0,1.1115310228308472e-05,0.0,1.0
36885,교육인/Noun,1,0,1,0.0,1.1106915165381966e-05,1.0
36886,반대말/Noun,1,0,1,0.0,1.1106915165381966e-05,1.0
36887,놈위/Noun,1,1,0,1.1115310228308472e-05,0.0,1.0
36888,선교단체/Noun,1,0,1,0.0,1.1106915165381966e-05,1.0
36889,립니/Noun,1,1,0,1.1115310228308472e-05,0.0,1.0
36890,원님/Noun,1,0,1,0.0,1.1106915165381966e-05,1.0
36891,겹침/Noun,1,0,1,0.0,1.1106915165381966e-05,1.0
36892,데쟈뷰/Noun,1,0,1,0.0,1.1106915165381966e-05,1.0
36893,단펀/Noun,1,1,0,1.1115310228308472e-05,0.0,1.0
36894,확깨드/Noun,1,0,1,0.0,1.1106915165381966e-05,1.0
36895,"~~~""~~~/Punctuation",1,1,0,1.1115310228308472e-05,0.0,1.0
36896,구록/Noun,1,0,1,0.0,1.1106915165381966e-05,1.0
36897,뜨뜻하다/Adjective,1,0,1,0.0,1.1106915165381966e-05,1.0
36898,즐겹/Noun,1,1,0,1.1115310228308472e-05,0.0,1.0
36899,103:26/Number,1,0,1,0.0,1.1106915165381966e-05,1.0
36900,102:49/Number,1,0,1,0.0,1.1106915165381966e-05,1.0
36901,91:10/Number,1,0,1,0.0,1.1106915165381966e-05,1.0
36902,89:47/Number,1,0,1,0.0,1.1106915165381966e-05,1.0
36903,74:23/Number,1,0,1,0.0,1.1106915165381966e-05,1.0
36904,72:39/Number,1,0,1,0.0,1.1106915165381966e-05,1.0
36905,19:50/Number,1,0,1,0.0,1.1106915165381966e-05,1.0
36906,18:34/Number,1,0,1,0.0,1.1106915165381966e-05,1.0
36907,ㅈㄴㅈㄴ/KoreanParticle,1,1,0,1.1115310228308472e-05,0.0,1.0
36908,터트려야할/Noun,1,0,1,0.0,1.1106915165381966e-05,1.0
36909,초코/Noun,1,1,0,1.1115310228308472e-05,0.0,1.0
36910,쌍쌍바/Noun,1,0,1,0.0,1.1106915165381966e-05,1.0
36911,스크류바/Noun,1,0,1,0.0,1.1106915165381966e-05,1.0
36912,엘마/Noun,1,0,1,0.0,1.1106915165381966e-05,1.0
36913,카서스/Noun,1,0,1,0.0,1.1106915165381966e-05,1.0
36914,힘자랑/Noun,1,0,1,0.0,1.1106915165381966e-05,1.0
36915,리빙데드/Noun,1,1,0,1.1115310228308472e-05,0.0,1.0
36916,바탈/Noun,1,1,0,1.1115310228308472e-05,0.0,1.0
36917,꼴깍/Noun,1,1,0,1.1115310228308472e-05,0.0,1.0
36918,우둘투둘하다/Adjective,1,1,0,1.1115310228308472e-05,0.0,1.0
36919,직격/Noun,1,1,0,1.1115310228308472e-05,0.0,1.0
36920,동행인/Noun,1,0,1,0.0,1.1106915165381966e-05,1.0
36921,무브/Noun,1,1,0,1.1115310228308472e-05,0.0,1.0
36922,4.35/Number,1,0,1,0.0,1.1106915165381966e-05,1.0
36923,쭈우욱/Noun,1,1,0,1.1115310228308472e-05,0.0,1.0
36924,명훈이/Noun,1,0,1,0.0,1.1106915165381966e-05,1.0
36925,places/Alpha,1,1,0,1.1115310228308472e-05,0.0,1.0
36926,unusual/Alpha,1,1,0,1.1115310228308472e-05,0.0,1.0
36927,joy/Alpha,1,1,0,1.1115310228308472e-05,0.0,1.0
36928,find/Alpha,1,1,0,1.1115310228308472e-05,0.0,1.0
36929,lips/Alpha,1,1,0,1.1115310228308472e-05,0.0,1.0
36930,Forgive/Alpha,1,1,0,1.1115310228308472e-05,0.0,1.0
36931,격덩저/Noun,1,0,1,0.0,1.1106915165381966e-05,1.0
36932,웁스/Noun,1,0,1,0.0,1.1106915165381966e-05,1.0
36933,니쫌/Noun,1,1,0,1.1115310228308472e-05,0.0,1.0
36934,용단/Noun,1,0,1,0.0,1.1106915165381966e-05,1.0
36935,性/Foreign,1,0,1,0.0,1.1106915165381966e-05,1.0
36936,할리데이/Noun,1,1,0,1.1115310228308472e-05,0.0,1.0
36937,어프/Noun,1,1,0,1.1115310228308472e-05,0.0,1.0
36938,이어트/Noun,1,1,0,1.1115310228308472e-05,0.0,1.0
36939,anyways/Alpha,1,1,0,1.1115310228308472e-05,0.0,1.0
36940,Lawrence/Alpha,1,1,0,1.1115310228308472e-05,0.0,1.0
36941,신윤복/Noun,1,1,0,1.1115310228308472e-05,0.0,1.0
36942,정미/Noun,1,1,0,1.1115310228308472e-05,0.0,1.0
36943,라이징선/Noun,1,0,1,0.0,1.1106915165381966e-05,1.0
36944,재봉사/Noun,1,1,0,1.1115310228308472e-05,0.0,1.0
36945,글로스터/Noun,1,1,0,1.1115310228308472e-05,0.0,1.0
36946,임빠들/Noun,1,1,0,1.1115310228308472e-05,0.0,1.0
36947,핸드백/Noun,1,1,0,1.1115310228308472e-05,0.0,1.0
36948,핸펀/Noun,1,0,1,0.0,1.1106915165381966e-05,1.0
36949,애달/Noun,1,1,0,1.1115310228308472e-05,0.0,1.0
36950,얼마만큼/Noun,1,1,0,1.1115310228308472e-05,0.0,1.0
36951,뒈체/Noun,1,0,1,0.0,1.1106915165381966e-05,1.0
36952,위문공/Noun,1,0,1,0.0,1.1106915165381966e-05,1.0
36953,리샹란/Noun,1,0,1,0.0,1.1106915165381966e-05,1.0
36954,악착같다/Adjective,1,1,0,1.1115310228308472e-05,0.0,1.0
36955,행위예술/Noun,1,0,1,0.0,1.1106915165381966e-05,1.0
36956,돌때/Noun,1,1,0,1.1115310228308472e-05,0.0,1.0
36957,까르맨/Noun,1,1,0,1.1115310228308472e-05,0.0,1.0
36958,OVER/Alpha,1,1,0,1.1115310228308472e-05,0.0,1.0
36959,GAME/Alpha,1,1,0,1.1115310228308472e-05,0.0,1.0
36960,뭐세/Noun,1,0,1,0.0,1.1106915165381966e-05,1.0
36961,카노/Noun,1,0,1,0.0,1.1106915165381966e-05,1.0
36962,어트/Noun,1,0,1,0.0,1.1106915165381966e-05,1.0
36963,셈등/Noun,1,1,0,1.1115310228308472e-05,0.0,1.0
36964,아브라함/Noun,1,1,0,1.1115310228308472e-05,0.0,1.0
36965,라지요/Josa,1,1,0,1.1115310228308472e-05,0.0,1.0
36966,통첩/Noun,1,0,1,0.0,1.1106915165381966e-05,1.0
36967,비천/Noun,1,0,1,0.0,1.1106915165381966e-05,1.0
36968,성탄/Noun,1,1,0,1.1115310228308472e-05,0.0,1.0
36969,굿와이프/Noun,1,1,0,1.1115310228308472e-05,0.0,1.0
36970,Sehr/Alpha,1,1,0,1.1115310228308472e-05,0.0,1.0
36971,감식/Noun,1,0,1,0.0,1.1106915165381966e-05,1.0
36972,리스스/Noun,1,0,1,0.0,1.1106915165381966e-05,1.0
36973,철도공사/Noun,1,0,1,0.0,1.1106915165381966e-05,1.0
36974,띵르/Noun,1,0,1,0.0,1.1106915165381966e-05,1.0
36975,등등하다/Adjective,1,1,0,1.1115310228308472e-05,0.0,1.0
36976,얼뜨기/Noun,1,1,0,1.1115310228308472e-05,0.0,1.0
36977,memory/Alpha,1,1,0,1.1115310228308472e-05,0.0,1.0
36978,닙/Noun,1,0,1,0.0,1.1106915165381966e-05,1.0
36979,꿰찬것/Noun,1,0,1,0.0,1.1106915165381966e-05,1.0
36980,디스턴스/Noun,1,0,1,0.0,1.1106915165381966e-05,1.0
36981,휴게실/Noun,1,1,0,1.1115310228308472e-05,0.0,1.0
36982,텍/Noun,1,1,0,1.1115310228308472e-05,0.0,1.0
36983,Wang/Alpha,1,0,1,0.0,1.1106915165381966e-05,1.0
36984,Daniella/Alpha,1,0,1,0.0,1.1106915165381966e-05,1.0
36985,282828/Number,1,1,0,1.1115310228308472e-05,0.0,1.0
36986,Hell/Alpha,1,0,1,0.0,1.1106915165381966e-05,1.0
36987,흘럿음/Noun,1,1,0,1.1115310228308472e-05,0.0,1.0
36988,^_^......;;;/Punctuation,1,0,1,0.0,1.1106915165381966e-05,1.0
36989,낚겻다/Noun,1,0,1,0.0,1.1106915165381966e-05,1.0
36990,갮같/Noun,1,0,1,0.0,1.1106915165381966e-05,1.0
36991,진보당/Noun,1,0,1,0.0,1.1106915165381966e-05,1.0
36992,사이버수사대/Noun,1,0,1,0.0,1.1106915165381966e-05,1.0
36993,찐득하다/Adjective,1,0,1,0.0,1.1106915165381966e-05,1.0
36994,mpeg/Alpha,1,1,0,1.1115310228308472e-05,0.0,1.0
36995,vga/Alpha,1,1,0,1.1115310228308472e-05,0.0,1.0
36996,...????!!!/Punctuation,1,0,1,0.0,1.1106915165381966e-05,1.0
36997,똥똥/Adverb,1,0,1,0.0,1.1106915165381966e-05,1.0
36998,똥또/Noun,1,0,1,0.0,1.1106915165381966e-05,1.0
36999,치밈/Noun,1,1,0,1.1115310228308472e-05,0.0,1.0
37000,main/Alpha,1,1,0,1.1115310228308472e-05,0.0,1.0
37001,밤꼬/Noun,1,1,0,1.1115310228308472e-05,0.0,1.0
37002,저떻다/Noun,1,1,0,1.1115310228308472e-05,0.0,1.0
37003,안썻다/Noun,1,1,0,1.1115310228308472e-05,0.0,1.0
37004,안됫다/Noun,1,0,1,0.0,1.1106915165381966e-05,1.0
37005,친밀해지다/Adjective,1,1,0,1.1115310228308472e-05,0.0,1.0
37006,햇볕/Noun,1,1,0,1.1115310228308472e-05,0.0,1.0
37007,히카루/Noun,1,1,0,1.1115310228308472e-05,0.0,1.0
37008,안지/Noun,1,1,0,1.1115310228308472e-05,0.0,1.0
37009,건전지/Noun,1,0,1,0.0,1.1106915165381966e-05,1.0
37010,물량적/Noun,1,0,1,0.0,1.1106915165381966e-05,1.0
37011,봉선/Noun,1,1,0,1.1115310228308472e-05,0.0,1.0
37012,생체/Noun,1,1,0,1.1115310228308472e-05,0.0,1.0
37013,띄넹/Noun,1,1,0,1.1115310228308472e-05,0.0,1.0
37014,2~3회/Number,1,1,0,1.1115310228308472e-05,0.0,1.0
37015,씰데없/Noun,1,1,0,1.1115310228308472e-05,0.0,1.0
37016,깍이다/Verb,1,1,0,1.1115310228308472e-05,0.0,1.0
37017,우후후/Adverb,1,1,0,1.1115310228308472e-05,0.0,1.0
37018,후르/Noun,1,1,0,1.1115310228308472e-05,0.0,1.0
37019,cG/Alpha,1,1,0,1.1115310228308472e-05,0.0,1.0
37020,암스트롱/Noun,1,1,0,1.1115310228308472e-05,0.0,1.0
37021,권최/Noun,1,1,0,1.1115310228308472e-05,0.0,1.0
37022,스타카토/Noun,1,1,0,1.1115310228308472e-05,0.0,1.0
37023,레슨/Noun,1,1,0,1.1115310228308472e-05,0.0,1.0
37024,연꽃/Noun,1,1,0,1.1115310228308472e-05,0.0,1.0
37025,~^^(/Punctuation,1,1,0,1.1115310228308472e-05,0.0,1.0
37026,존빡임/Noun,1,0,1,0.0,1.1106915165381966e-05,1.0
37027,메꿀/Noun,1,0,1,0.0,1.1106915165381966e-05,1.0
37028,헬륨/Noun,1,1,0,1.1115310228308472e-05,0.0,1.0
37029,정종철/Noun,1,0,1,0.0,1.1106915165381966e-05,1.0
37030,후쿠하/Noun,1,1,0,1.1115310228308472e-05,0.0,1.0
37031,아끄버/Noun,1,0,1,0.0,1.1106915165381966e-05,1.0
37032,경찰국가/Noun,1,1,0,1.1115310228308472e-05,0.0,1.0
37033,스페츠나츠/Noun,1,1,0,1.1115310228308472e-05,0.0,1.0
37034,돈돈/Noun,1,0,1,0.0,1.1106915165381966e-05,1.0
37035,錢生錢死/Foreign,1,0,1,0.0,1.1106915165381966e-05,1.0
37036,파워포인트/Noun,1,0,1,0.0,1.1106915165381966e-05,1.0
37037,맹글/Noun,1,0,1,0.0,1.1106915165381966e-05,1.0
37038,디리/Noun,1,1,0,1.1115310228308472e-05,0.0,1.0
37039,홀릭임/Noun,1,1,0,1.1115310228308472e-05,0.0,1.0
37040,모르겄/Noun,1,0,1,0.0,1.1106915165381966e-05,1.0
37041,흐스흐흐그흐흫/Noun,1,0,1,0.0,1.1106915165381966e-05,1.0
37042,글단/Noun,1,0,1,0.0,1.1106915165381966e-05,1.0
37043,글달/Noun,1,0,1,0.0,1.1106915165381966e-05,1.0
37044,ELSE/Alpha,1,1,0,1.1115310228308472e-05,0.0,1.0
37045,WHAT/Alpha,1,1,0,1.1115310228308472e-05,0.0,1.0
37046,랜디스/Noun,1,0,1,0.0,1.1106915165381966e-05,1.0
37047,물논/Noun,1,1,0,1.1115310228308472e-05,0.0,1.0
37048,4.14/Number,1,0,1,0.0,1.1106915165381966e-05,1.0
37049,0-8/Number,1,0,1,0.0,1.1106915165381966e-05,1.0
37050,그롷듯/Noun,1,1,0,1.1115310228308472e-05,0.0,1.0
37051,이박사/Noun,1,0,1,0.0,1.1106915165381966e-05,1.0
37052,~~^^;/Punctuation,1,0,1,0.0,1.1106915165381966e-05,1.0
37053,급유/Noun,1,0,1,0.0,1.1106915165381966e-05,1.0
37054,엔절/Noun,1,1,0,1.1115310228308472e-05,0.0,1.0
37055,늪지/Noun,1,1,0,1.1115310228308472e-05,0.0,1.0
37056,덩치값/Noun,1,0,1,0.0,1.1106915165381966e-05,1.0
37057,자나깨나/Noun,1,0,1,0.0,1.1106915165381966e-05,1.0
37058,마씨/Noun,1,1,0,1.1115310228308472e-05,0.0,1.0
37059,떽뗵거리/Noun,1,0,1,0.0,1.1106915165381966e-05,1.0
37060,보드게임/Noun,1,0,1,0.0,1.1106915165381966e-05,1.0
37061,엘롯기/Noun,1,1,0,1.1115310228308472e-05,0.0,1.0
37062,엘쥐/Noun,1,1,0,1.1115310228308472e-05,0.0,1.0
37063,이준호/Noun,1,1,0,1.1115310228308472e-05,0.0,1.0
37064,장우영/Noun,1,1,0,1.1115310228308472e-05,0.0,1.0
37065,점은/Foreign,1,1,0,1.1115310228308472e-05,0.0,1.0
37066,식수난/Noun,1,0,1,0.0,1.1106915165381966e-05,1.0
37067,뺒/Noun,1,0,1,0.0,1.1106915165381966e-05,1.0
37068,잘됫어/Noun,1,1,0,1.1115310228308472e-05,0.0,1.0
37069,주물럭거리다/Verb,1,0,1,0.0,1.1106915165381966e-05,1.0
37070,우쭐/Adverb,1,0,1,0.0,1.1106915165381966e-05,1.0
37071,.~~~~~~~~~~/Punctuation,1,1,0,1.1115310228308472e-05,0.0,1.0
37072,쌩둥맞/Noun,1,0,1,0.0,1.1106915165381966e-05,1.0
37073,홉시/Noun,1,1,0,1.1115310228308472e-05,0.0,1.0
37074,구식이다/Verb,1,1,0,1.1115310228308472e-05,0.0,1.0
37075,혜나/Noun,1,0,1,0.0,1.1106915165381966e-05,1.0
37076,ㅘㅣ/KoreanParticle,1,1,0,1.1115310228308472e-05,0.0,1.0
37077,백보람/Noun,1,0,1,0.0,1.1106915165381966e-05,1.0
37078,출발점/Noun,1,1,0,1.1115310228308472e-05,0.0,1.0
37079,정보통/Noun,1,1,0,1.1115310228308472e-05,0.0,1.0
37080,산밍/Noun,1,1,0,1.1115310228308472e-05,0.0,1.0
37081,광부/Noun,1,1,0,1.1115310228308472e-05,0.0,1.0
37082,천주정/Noun,1,1,0,1.1115310228308472e-05,0.0,1.0
37083,스틸라이프/Noun,1,1,0,1.1115310228308472e-05,0.0,1.0
37084,IOVE/Alpha,1,1,0,1.1115310228308472e-05,0.0,1.0
37085,오정희/Noun,1,1,0,1.1115310228308472e-05,0.0,1.0
37086,쿠아론/Noun,1,1,0,1.1115310228308472e-05,0.0,1.0
37087,알폰소/Noun,1,1,0,1.1115310228308472e-05,0.0,1.0
37088,난김흥/Noun,1,1,0,1.1115310228308472e-05,0.0,1.0
37089,dkssud/Alpha,1,1,0,1.1115310228308472e-05,0.0,1.0
37090,ce/Alpha,1,1,0,1.1115310228308472e-05,0.0,1.0
37091,adore/Alpha,1,1,0,1.1115310228308472e-05,0.0,1.0
37092,nial/Alpha,1,1,0,1.1115310228308472e-05,0.0,1.0
37093,^…^/Punctuation,1,0,1,0.0,1.1106915165381966e-05,1.0
37094,학생운동/Noun,1,0,1,0.0,1.1106915165381966e-05,1.0
37095,반뜻하다/Adjective,1,0,1,0.0,1.1106915165381966e-05,1.0
37096,방농국/Noun,1,0,1,0.0,1.1106915165381966e-05,1.0
37097,임꼬/Noun,1,0,1,0.0,1.1106915165381966e-05,1.0
37098,신림/Noun,1,1,0,1.1115310228308472e-05,0.0,1.0
37099,어딧는데/Noun,1,1,0,1.1115310228308472e-05,0.0,1.0
37100,~~'/Punctuation,1,1,0,1.1115310228308472e-05,0.0,1.0
37101,괨찮/Noun,1,0,1,0.0,1.1106915165381966e-05,1.0
37102,불나방/Noun,1,0,1,0.0,1.1106915165381966e-05,1.0
37103,엄상현/Noun,1,1,0,1.1115310228308472e-05,0.0,1.0
37104,킬타용/Noun,1,1,0,1.1115310228308472e-05,0.0,1.0
37105,재시/Noun,1,1,0,1.1115310228308472e-05,0.0,1.0
37106,백곰/Noun,1,1,0,1.1115310228308472e-05,0.0,1.0
37107,해님/Noun,1,1,0,1.1115310228308472e-05,0.0,1.0
37108,복식호흡/Noun,1,0,1,0.0,1.1106915165381966e-05,1.0
37109,텐/PreEomi,1,1,0,1.1115310228308472e-05,0.0,1.0
37110,좌담/Noun,1,0,1,0.0,1.1106915165381966e-05,1.0
37111,샘쉐/Noun,1,1,0,1.1115310228308472e-05,0.0,1.0
37112,빔덴더스/Noun,1,1,0,1.1115310228308472e-05,0.0,1.0
37113,큰물/Noun,1,0,1,0.0,1.1106915165381966e-05,1.0
37114,강이석/Noun,1,0,1,0.0,1.1106915165381966e-05,1.0
37115,itself/Alpha,1,1,0,1.1115310228308472e-05,0.0,1.0
37116,<///Punctuation,1,1,0,1.1115310228308472e-05,0.0,1.0
37117,박주영/Noun,1,0,1,0.0,1.1106915165381966e-05,1.0
37118,부평/Noun,1,1,0,1.1115310228308472e-05,0.0,1.0
37119,도였나/Foreign,1,1,0,1.1115310228308472e-05,0.0,1.0
37120,미열/Noun,1,1,0,1.1115310228308472e-05,0.0,1.0
37121,무착/Noun,1,0,1,0.0,1.1106915165381966e-05,1.0
37122,바라바/Noun,1,1,0,1.1115310228308472e-05,0.0,1.0
37123,개꾸르잼임/Noun,1,1,0,1.1115310228308472e-05,0.0,1.0
37124,볼만했슴/Noun,1,1,0,1.1115310228308472e-05,0.0,1.0
37125,알앚/Noun,1,0,1,0.0,1.1106915165381966e-05,1.0
37126,물춤/Noun,1,1,0,1.1115310228308472e-05,0.0,1.0
37127,뭄바이/Noun,1,0,1,0.0,1.1106915165381966e-05,1.0
37128,따개/Noun,1,1,0,1.1115310228308472e-05,0.0,1.0
37129,응남/Noun,1,1,0,1.1115310228308472e-05,0.0,1.0
37130,핛핛핛/Noun,1,1,0,1.1115310228308472e-05,0.0,1.0
37131,힘일/Noun,1,1,0,1.1115310228308472e-05,0.0,1.0
37132,베이비페이스/Noun,1,0,1,0.0,1.1106915165381966e-05,1.0
37133,스포티지/Noun,1,0,1,0.0,1.1106915165381966e-05,1.0
37134,개찜찜/Noun,1,0,1,0.0,1.1106915165381966e-05,1.0
37135,서북청년회/Noun,1,0,1,0.0,1.1106915165381966e-05,1.0
37136,★★★☆/Foreign,1,1,0,1.1115310228308472e-05,0.0,1.0
37137,사렷/Noun,1,1,0,1.1115310228308472e-05,0.0,1.0
37138,영화라는게/Foreign,1,1,0,1.1115310228308472e-05,0.0,1.0
37139,꼴봬기싫다/Noun,1,0,1,0.0,1.1106915165381966e-05,1.0
37140,된거/Foreign,1,0,1,0.0,1.1106915165381966e-05,1.0
37141,명더/Noun,1,0,1,0.0,1.1106915165381966e-05,1.0
37142,게무/Noun,1,0,1,0.0,1.1106915165381966e-05,1.0
37143,리즈보단/Foreign,1,0,1,0.0,1.1106915165381966e-05,1.0
37144,블랙딜/Noun,1,1,0,1.1115310228308472e-05,0.0,1.0
37145,○○○○/Foreign,1,0,1,0.0,1.1106915165381966e-05,1.0
37146,127시간/Number,1,1,0,1.1115310228308472e-05,0.0,1.0
37147,벚김/Noun,1,0,1,0.0,1.1106915165381966e-05,1.0
37148,생뚱맞아/Noun,1,0,1,0.0,1.1106915165381966e-05,1.0
37149,수호이/Noun,1,0,1,0.0,1.1106915165381966e-05,1.0
37150,유력하다/Adjective,1,0,1,0.0,1.1106915165381966e-05,1.0
37151,리뉴/Noun,1,0,1,0.0,1.1106915165381966e-05,1.0
37152,콧방귀끼/Noun,1,0,1,0.0,1.1106915165381966e-05,1.0
37153,자색/Noun,1,0,1,0.0,1.1106915165381966e-05,1.0
37154,아기돼지삼형제/Noun,1,0,1,0.0,1.1106915165381966e-05,1.0
37155,1000%/Number,1,0,1,0.0,1.1106915165381966e-05,1.0
37156,설민석/Noun,1,0,1,0.0,1.1106915165381966e-05,1.0
37157,폐셜/Noun,1,0,1,0.0,1.1106915165381966e-05,1.0
37158,가여웠다/Noun,1,1,0,1.1115310228308472e-05,0.0,1.0
37159,비잉/Noun,1,1,0,1.1115310228308472e-05,0.0,1.0
37160,gun/Alpha,1,1,0,1.1115310228308472e-05,0.0,1.0
37161,이어졋으/Noun,1,1,0,1.1115310228308472e-05,0.0,1.0
37162,괜찬긴하/Noun,1,1,0,1.1115310228308472e-05,0.0,1.0
37163,다봣으/Noun,1,1,0,1.1115310228308472e-05,0.0,1.0
37164,안봣던/Noun,1,1,0,1.1115310228308472e-05,0.0,1.0
37165,티일/Noun,1,1,0,1.1115310228308472e-05,0.0,1.0
37166,명되겠다/Foreign,1,0,1,0.0,1.1106915165381966e-05,1.0
37167,자각시키다/Verb,1,1,0,1.1115310228308472e-05,0.0,1.0
37168,쥐뢀/Noun,1,0,1,0.0,1.1106915165381966e-05,1.0
37169,햐달라햐/Noun,1,0,1,0.0,1.1106915165381966e-05,1.0
37170,총몽/Noun,1,0,1,0.0,1.1106915165381966e-05,1.0
37171,합병증/Noun,1,1,0,1.1115310228308472e-05,0.0,1.0
37172,당뇨/Noun,1,1,0,1.1115310228308472e-05,0.0,1.0
37173,도야/Noun,1,0,1,0.0,1.1106915165381966e-05,1.0
37174,소영이/Noun,1,0,1,0.0,1.1106915165381966e-05,1.0
37175,허시/Noun,1,1,0,1.1115310228308472e-05,0.0,1.0
37176,46/Number,1,0,1,0.0,1.1106915165381966e-05,1.0
37177,낚였자/Noun,1,0,1,0.0,1.1106915165381966e-05,1.0
37178,계좌/Noun,1,0,1,0.0,1.1106915165381966e-05,1.0
37179,최저임금/Noun,1,0,1,0.0,1.1106915165381966e-05,1.0
37180,경품/Noun,1,1,0,1.1115310228308472e-05,0.0,1.0
37181,강회/Noun,1,0,1,0.0,1.1106915165381966e-05,1.0
37182,ㄱㅆㄹ/KoreanParticle,1,0,1,0.0,1.1106915165381966e-05,1.0
37183,눈척/Noun,1,0,1,0.0,1.1106915165381966e-05,1.0
37184,좋압습니/Noun,1,1,0,1.1115310228308472e-05,0.0,1.0
37185,안전보장/Noun,1,1,0,1.1115310228308472e-05,0.0,1.0
37186,유혈극/Noun,1,0,1,0.0,1.1106915165381966e-05,1.0
37187,반구/Noun,1,0,1,0.0,1.1106915165381966e-05,1.0
37188,젤웃갸거/Noun,1,1,0,1.1115310228308472e-05,0.0,1.0
37189,......--/Punctuation,1,0,1,0.0,1.1106915165381966e-05,1.0
37190,핵공/Noun,1,0,1,0.0,1.1106915165381966e-05,1.0
37191,담편/Noun,1,1,0,1.1115310228308472e-05,0.0,1.0
37192,단팥빵/Noun,1,0,1,0.0,1.1106915165381966e-05,1.0
37193,반겔리스/Noun,1,1,0,1.1115310228308472e-05,0.0,1.0
37194,준듯/Noun,1,0,1,0.0,1.1106915165381966e-05,1.0
37195,표나/Noun,1,0,1,0.0,1.1106915165381966e-05,1.0
37196,타마마/Noun,1,1,0,1.1115310228308472e-05,0.0,1.0
37197,굽신굽신/Adverb,1,1,0,1.1115310228308472e-05,0.0,1.0
37198,수민/Noun,1,1,0,1.1115310228308472e-05,0.0,1.0
37199,진숙언/Noun,1,1,0,1.1115310228308472e-05,0.0,1.0
37200,슛돌이/Noun,1,1,0,1.1115310228308472e-05,0.0,1.0
37201,색스/Noun,1,0,1,0.0,1.1106915165381966e-05,1.0
37202,경창/Noun,1,1,0,1.1115310228308472e-05,0.0,1.0
37203,도촌/Noun,1,1,0,1.1115310228308472e-05,0.0,1.0
37204,forget/Alpha,1,1,0,1.1115310228308472e-05,0.0,1.0
37205,Never/Alpha,1,1,0,1.1115310228308472e-05,0.0,1.0
37206,쉐키들/Noun,1,0,1,0.0,1.1106915165381966e-05,1.0
37207,후랴/Noun,1,0,1,0.0,1.1106915165381966e-05,1.0
37208,윌싱엄/Noun,1,1,0,1.1115310228308472e-05,0.0,1.0
37209,이너무짧앗다/Foreign,1,1,0,1.1115310228308472e-05,0.0,1.0
37210,조명등/Noun,1,1,0,1.1115310228308472e-05,0.0,1.0
37211,미야비/Noun,1,0,1,0.0,1.1106915165381966e-05,1.0
37212,그루브/Noun,1,1,0,1.1115310228308472e-05,0.0,1.0
37213,전세홍/Noun,1,0,1,0.0,1.1106915165381966e-05,1.0
37214,뺘놨/Noun,1,0,1,0.0,1.1106915165381966e-05,1.0
37215,부터마지막까지본드라마난생처음입니다/Foreign,1,1,0,1.1115310228308472e-05,0.0,1.0
37216,좀스럽다/Adjective,1,1,0,1.1115310228308472e-05,0.0,1.0
37217,팀킬/Noun,1,0,1,0.0,1.1106915165381966e-05,1.0
37218,포제/Noun,1,0,1,0.0,1.1106915165381966e-05,1.0
37219,칠칠/Noun,1,1,0,1.1115310228308472e-05,0.0,1.0
37220,쥴리엣/Noun,1,1,0,1.1115310228308472e-05,0.0,1.0
37221,명망/Noun,1,1,0,1.1115310228308472e-05,0.0,1.0
37222,딜란/Noun,1,0,1,0.0,1.1106915165381966e-05,1.0
37223,도에봤는영화인데/Foreign,1,1,0,1.1115310228308472e-05,0.0,1.0
37224,뿡뿡크크/Noun,1,0,1,0.0,1.1106915165381966e-05,1.0
37225,7.90/Number,1,0,1,0.0,1.1106915165381966e-05,1.0
37226,폐혜/Noun,1,1,0,1.1115310228308472e-05,0.0,1.0
37227,챠트/Noun,1,1,0,1.1115310228308472e-05,0.0,1.0
37228,격은/Noun,1,0,1,0.0,1.1106915165381966e-05,1.0
37229,망할스멜/Noun,1,0,1,0.0,1.1106915165381966e-05,1.0
37230,…^^/Punctuation,1,1,0,1.1115310228308472e-05,0.0,1.0
37231,쓰러트려/Noun,1,0,1,0.0,1.1106915165381966e-05,1.0
37232,Lies/Alpha,1,1,0,1.1115310228308472e-05,0.0,1.0
37233,Secrets/Alpha,1,1,0,1.1115310228308472e-05,0.0,1.0
37234,http://www.4shared.com/file/nF7zWsvJ/___Split_Second_1992_.html/URL,1,0,1,0.0,1.1106915165381966e-05,1.0
37235,머릴/Noun,1,1,0,1.1115310228308472e-05,0.0,1.0
37236,어스시/Noun,1,1,0,1.1115310228308472e-05,0.0,1.0
37237,헌재/Noun,1,1,0,1.1115310228308472e-05,0.0,1.0
37238,뒤안길/Noun,1,0,1,0.0,1.1106915165381966e-05,1.0
37239,말꼬투리/Noun,1,0,1,0.0,1.1106915165381966e-05,1.0
37240,쏠땐/Noun,1,0,1,0.0,1.1106915165381966e-05,1.0
37241,포탑/Noun,1,0,1,0.0,1.1106915165381966e-05,1.0
37242,팔도/Noun,1,0,1,0.0,1.1106915165381966e-05,1.0
37243,퍼온/Noun,1,0,1,0.0,1.1106915165381966e-05,1.0
37244,포격/Noun,1,0,1,0.0,1.1106915165381966e-05,1.0
37245,대청도/Noun,1,0,1,0.0,1.1106915165381966e-05,1.0
37246,장채리/Noun,1,0,1,0.0,1.1106915165381966e-05,1.0
37247,김집/Noun,1,0,1,0.0,1.1106915165381966e-05,1.0
37248,exhausted/Alpha,1,0,1,0.0,1.1106915165381966e-05,1.0
37249,책상씬/Noun,1,1,0,1.1115310228308472e-05,0.0,1.0
37250,extraordinary/Alpha,1,1,0,1.1115310228308472e-05,0.0,1.0
37251,Make/Alpha,1,1,0,1.1115310228308472e-05,0.0,1.0
37252,Sieze/Alpha,1,1,0,1.1115310228308472e-05,0.0,1.0
37253,Diem/Alpha,1,1,0,1.1115310228308472e-05,0.0,1.0
37254,7.74/Number,1,1,0,1.1115310228308472e-05,0.0,1.0
37255,콜미/Noun,1,1,0,1.1115310228308472e-05,0.0,1.0
37256,블론디/Noun,1,1,0,1.1115310228308472e-05,0.0,1.0
37257,슈퍼모델/Noun,1,1,0,1.1115310228308472e-05,0.0,1.0
37258,칠공주/Noun,1,0,1,0.0,1.1106915165381966e-05,1.0
37259,나티/Noun,1,1,0,1.1115310228308472e-05,0.0,1.0
37260,악심/Noun,1,0,1,0.0,1.1106915165381966e-05,1.0
37261,스므살짜리/Noun,1,0,1,0.0,1.1106915165381966e-05,1.0
37262,피디바꼇/Noun,1,0,1,0.0,1.1106915165381966e-05,1.0
37263,카요/Noun,1,1,0,1.1115310228308472e-05,0.0,1.0
37264,골드미스/Noun,1,0,1,0.0,1.1106915165381966e-05,1.0
37265,건안/Noun,1,1,0,1.1115310228308472e-05,0.0,1.0
37266,남씨/Noun,1,0,1,0.0,1.1106915165381966e-05,1.0
37267,2012.04/Number,1,1,0,1.1115310228308472e-05,0.0,1.0
37268,'';/Punctuation,1,1,0,1.1115310228308472e-05,0.0,1.0
37269,누라리횬/Noun,1,1,0,1.1115310228308472e-05,0.0,1.0
37270,문단속/Noun,1,1,0,1.1115310228308472e-05,0.0,1.0
37271,행간/Noun,1,0,1,0.0,1.1106915165381966e-05,1.0
37272,그랭/Noun,1,0,1,0.0,1.1106915165381966e-05,1.0
37273,설수진/Noun,1,1,0,1.1115310228308472e-05,0.0,1.0
37274,の低力。幸せだよ。/Foreign,1,1,0,1.1115310228308472e-05,0.0,1.0
37275,日本映/Foreign,1,1,0,1.1115310228308472e-05,0.0,1.0
37276,락원/Noun,1,0,1,0.0,1.1106915165381966e-05,1.0
37277,굼뜰/Noun,1,1,0,1.1115310228308472e-05,0.0,1.0
37278,흑의/Noun,1,1,0,1.1115310228308472e-05,0.0,1.0
37279,우리둘/Noun,1,1,0,1.1115310228308472e-05,0.0,1.0
37280,뮁미/Noun,1,0,1,0.0,1.1106915165381966e-05,1.0
37281,중탕/Noun,1,0,1,0.0,1.1106915165381966e-05,1.0
37282,웃경/Noun,1,1,0,1.1115310228308472e-05,0.0,1.0
37283,고사성어/Noun,1,0,1,0.0,1.1106915165381966e-05,1.0
37284,쌜줄/Noun,1,0,1,0.0,1.1106915165381966e-05,1.0
37285,철갑탄/Noun,1,0,1,0.0,1.1106915165381966e-05,1.0
37286,추렸다/Noun,1,0,1,0.0,1.1106915165381966e-05,1.0
37287,Bardem/Alpha,1,0,1,0.0,1.1106915165381966e-05,1.0
37288,Javier/Alpha,1,0,1,0.0,1.1106915165381966e-05,1.0
37289,Cruz/Alpha,1,0,1,0.0,1.1106915165381966e-05,1.0
37290,Penelope/Alpha,1,0,1,0.0,1.1106915165381966e-05,1.0
37291,外道/Foreign,1,0,1,0.0,1.1106915165381966e-05,1.0
37292,터널씬/Noun,1,1,0,1.1115310228308472e-05,0.0,1.0
37293,사볍부/Noun,1,1,0,1.1115310228308472e-05,0.0,1.0
37294,".,,.,.,.,.,,./Punctuation",1,1,0,1.1115310228308472e-05,0.0,1.0
37295,훼인/Noun,1,0,1,0.0,1.1106915165381966e-05,1.0
37296,테사/Noun,1,1,0,1.1115310228308472e-05,0.0,1.0
37297,far/Alpha,1,1,0,1.1115310228308472e-05,0.0,1.0
37298,힘들엇네/Noun,1,1,0,1.1115310228308472e-05,0.0,1.0
37299,한서/Noun,1,1,0,1.1115310228308472e-05,0.0,1.0
37300,머쉬/Noun,1,1,0,1.1115310228308472e-05,0.0,1.0
37301,이곡/Noun,1,0,1,0.0,1.1106915165381966e-05,1.0
37302,Wilson/Alpha,1,1,0,1.1115310228308472e-05,0.0,1.0
37303,빠뜻/Noun,1,0,1,0.0,1.1106915165381966e-05,1.0
37304,의정원/Noun,1,0,1,0.0,1.1106915165381966e-05,1.0
37305,칠십/Modifier,1,0,1,0.0,1.1106915165381966e-05,1.0
37306,괴물씬/Noun,1,1,0,1.1115310228308472e-05,0.0,1.0
37307,퇴물냔/Noun,1,0,1,0.0,1.1106915165381966e-05,1.0
37308,김성경/Noun,1,1,0,1.1115310228308472e-05,0.0,1.0
37309,리쿠/Noun,1,1,0,1.1115310228308472e-05,0.0,1.0
37310,.........-_-/Punctuation,1,0,1,0.0,1.1106915165381966e-05,1.0
37311,잔위/Noun,1,1,0,1.1115310228308472e-05,0.0,1.0
37312,300원/Number,1,1,0,1.1115310228308472e-05,0.0,1.0
37313,도한국영화랑중국영화차이/Foreign,1,1,0,1.1115310228308472e-05,0.0,1.0
37314,반도체/Noun,1,1,0,1.1115310228308472e-05,0.0,1.0
37315,뿜었습니/Noun,1,0,1,0.0,1.1106915165381966e-05,1.0
37316,머거다/Verb,1,1,0,1.1115310228308472e-05,0.0,1.0
37317,의가정/Foreign,1,1,0,1.1115310228308472e-05,0.0,1.0
37318,데드걸/Noun,1,1,0,1.1115310228308472e-05,0.0,1.0
37319,레이시즘/Noun,1,1,0,1.1115310228308472e-05,0.0,1.0
37320,",-_-;/Punctuation",1,0,1,0.0,1.1106915165381966e-05,1.0
37321,퍼주/Noun,1,0,1,0.0,1.1106915165381966e-05,1.0
37322,ㅉㅏㅡㅡ/KoreanParticle,1,0,1,0.0,1.1106915165381966e-05,1.0
37323,나온닼/Noun,1,0,1,0.0,1.1106915165381966e-05,1.0
37324,더팬/Noun,1,1,0,1.1115310228308472e-05,0.0,1.0
37325,왕모/Noun,1,1,0,1.1115310228308472e-05,0.0,1.0
37326,그루트/Noun,1,1,0,1.1115310228308472e-05,0.0,1.0
37327,101분/Number,1,0,1,0.0,1.1106915165381966e-05,1.0
37328,쇠퇴하다/Adjective,1,1,0,1.1115310228308472e-05,0.0,1.0
37329,방청/Noun,1,0,1,0.0,1.1106915165381966e-05,1.0
37330,칠보/Noun,1,1,0,1.1115310228308472e-05,0.0,1.0
37331,플로리다/Noun,1,1,0,1.1115310228308472e-05,0.0,1.0
37332,딸라/Noun,1,0,1,0.0,1.1106915165381966e-05,1.0
37333,★♥♥/Foreign,1,1,0,1.1115310228308472e-05,0.0,1.0
37334,빅꿀잼/Noun,1,1,0,1.1115310228308472e-05,0.0,1.0
37335,표범/Noun,1,1,0,1.1115310228308472e-05,0.0,1.0
37336,토토가/Noun,1,0,1,0.0,1.1106915165381966e-05,1.0
37337,데프니/Noun,1,1,0,1.1115310228308472e-05,0.0,1.0
37338,버트레이놀즈/Noun,1,1,0,1.1115310228308472e-05,0.0,1.0
37339,도작리메이크입니다/Foreign,1,1,0,1.1115310228308472e-05,0.0,1.0
37340,정산/Noun,1,0,1,0.0,1.1106915165381966e-05,1.0
37341,겔라/Noun,1,1,0,1.1115310228308472e-05,0.0,1.0
37342,랫다/Noun,1,0,1,0.0,1.1106915165381966e-05,1.0
37343,한정우/Noun,1,0,1,0.0,1.1106915165381966e-05,1.0
37344,ㅎㅌㅊ/KoreanParticle,1,0,1,0.0,1.1106915165381966e-05,1.0
37345,광란/Noun,1,0,1,0.0,1.1106915165381966e-05,1.0
37346,십이야/Noun,1,0,1,0.0,1.1106915165381966e-05,1.0
37347,의지력/Noun,1,0,1,0.0,1.1106915165381966e-05,1.0
37348,틀일/Noun,1,1,0,1.1115310228308472e-05,0.0,1.0
37349,용답/Noun,1,0,1,0.0,1.1106915165381966e-05,1.0
37350,전을/Foreign,1,0,1,0.0,1.1106915165381966e-05,1.0
37351,lay/Alpha,1,1,0,1.1115310228308472e-05,0.0,1.0
37352,디유/Noun,1,1,0,1.1115310228308472e-05,0.0,1.0
37353,2.256879343/Number,1,0,1,0.0,1.1106915165381966e-05,1.0
37354,다반사/Noun,1,0,1,0.0,1.1106915165381966e-05,1.0
37355,설강/Noun,1,1,0,1.1115310228308472e-05,0.0,1.0
37356,……../Punctuation,1,0,1,0.0,1.1106915165381966e-05,1.0
37357,장호일/Noun,1,0,1,0.0,1.1106915165381966e-05,1.0
37358,백지연/Noun,1,0,1,0.0,1.1106915165381966e-05,1.0
37359,왜퍼/Noun,1,0,1,0.0,1.1106915165381966e-05,1.0
37360,우웩임/Noun,1,1,0,1.1115310228308472e-05,0.0,1.0
37361,혜선/Noun,1,0,1,0.0,1.1106915165381966e-05,1.0
37362,구슬리다/Verb,1,0,1,0.0,1.1106915165381966e-05,1.0
37363,뭉근하/Noun,1,1,0,1.1115310228308472e-05,0.0,1.0
37364,김영인/Noun,1,1,0,1.1115310228308472e-05,0.0,1.0
37365,환커/Noun,1,0,1,0.0,1.1106915165381966e-05,1.0
37366,를르슈/Noun,1,0,1,0.0,1.1106915165381966e-05,1.0
37367,",.,.,.,../Punctuation",1,0,1,0.0,1.1106915165381966e-05,1.0
37368,스마일/Noun,1,1,0,1.1115310228308472e-05,0.0,1.0
37369,헤밍씨/Noun,1,1,0,1.1115310228308472e-05,0.0,1.0
37370,평행/Noun,1,0,1,0.0,1.1106915165381966e-05,1.0
37371,",^^*/Punctuation",1,1,0,1.1115310228308472e-05,0.0,1.0
37372,수산시장/Noun,1,0,1,0.0,1.1106915165381966e-05,1.0
37373,김동원/Noun,1,1,0,1.1115310228308472e-05,0.0,1.0
37374,끄트머리/Noun,1,1,0,1.1115310228308472e-05,0.0,1.0
37375,싐취해/Noun,1,1,0,1.1115310228308472e-05,0.0,1.0
37376,포임/Noun,1,0,1,0.0,1.1106915165381966e-05,1.0
37377,씨엔흥해랏/Noun,1,1,0,1.1115310228308472e-05,0.0,1.0
37378,가불/Noun,1,0,1,0.0,1.1106915165381966e-05,1.0
37379,2498987/Number,1,1,0,1.1115310228308472e-05,0.0,1.0
37380,섯명/Noun,1,0,1,0.0,1.1106915165381966e-05,1.0
37381,안문숙/Noun,1,0,1,0.0,1.1106915165381966e-05,1.0
37382,......?/Punctuation,1,0,1,0.0,1.1106915165381966e-05,1.0
37383,화주/Noun,1,0,1,0.0,1.1106915165381966e-05,1.0
37384,헤인즈/Noun,1,1,0,1.1115310228308472e-05,0.0,1.0
37385,허졉했/Noun,1,0,1,0.0,1.1106915165381966e-05,1.0
37386,태준/Noun,1,1,0,1.1115310228308472e-05,0.0,1.0
37387,절연/Noun,1,0,1,0.0,1.1106915165381966e-05,1.0
37388,shoes/Alpha,1,1,0,1.1115310228308472e-05,0.0,1.0
37389,Watch/Alpha,1,1,0,1.1115310228308472e-05,0.0,1.0
37390,동안자기전에봤습니다/Foreign,1,0,1,0.0,1.1106915165381966e-05,1.0
37391,ㅓㅋㅋㅋ/KoreanParticle,1,1,0,1.1115310228308472e-05,0.0,1.0
37392,나제/Noun,1,1,0,1.1115310228308472e-05,0.0,1.0
37393,종합병원/Noun,1,0,1,0.0,1.1106915165381966e-05,1.0
37394,가슴웅클/Noun,1,1,0,1.1115310228308472e-05,0.0,1.0
37395,브러더스/Noun,1,1,0,1.1115310228308472e-05,0.0,1.0
37396,카페트/Noun,1,0,1,0.0,1.1106915165381966e-05,1.0
37397,택현/Noun,1,0,1,0.0,1.1106915165381966e-05,1.0
37398,Gooooooooooooooooooooooooooooooood/Alpha,1,1,0,1.1115310228308472e-05,0.0,1.0
37399,laptop/Alpha,1,1,0,1.1115310228308472e-05,0.0,1.0
37400,enough/Alpha,1,1,0,1.1115310228308472e-05,0.0,1.0
37401,발표회/Noun,1,0,1,0.0,1.1106915165381966e-05,1.0
37402,Human/Alpha,1,1,0,1.1115310228308472e-05,0.0,1.0
37403,금순/Noun,1,1,0,1.1115310228308472e-05,0.0,1.0
37404,악정/Noun,1,0,1,0.0,1.1106915165381966e-05,1.0
37405,괜잖아/Noun,1,0,1,0.0,1.1106915165381966e-05,1.0
37406,왜볼때/Noun,1,1,0,1.1115310228308472e-05,0.0,1.0
37407,쫘르륵/Noun,1,1,0,1.1115310228308472e-05,0.0,1.0
37408,통괘했던/Noun,1,1,0,1.1115310228308472e-05,0.0,1.0
37409,우물우물/Adverb,1,0,1,0.0,1.1106915165381966e-05,1.0
37410,촐삭대/Noun,1,0,1,0.0,1.1106915165381966e-05,1.0
37411,~...!!/Punctuation,1,0,1,0.0,1.1106915165381966e-05,1.0
37412,팽씨/Noun,1,0,1,0.0,1.1106915165381966e-05,1.0
37413,심씨/Noun,1,1,0,1.1115310228308472e-05,0.0,1.0
37414,2014.3/Number,1,1,0,1.1115310228308472e-05,0.0,1.0
37415,못줄/Noun,1,0,1,0.0,1.1106915165381966e-05,1.0
37416,뿌쥐/Noun,1,0,1,0.0,1.1106915165381966e-05,1.0
37417,씝/Noun,1,0,1,0.0,1.1106915165381966e-05,1.0
37418,냥반/Noun,1,0,1,0.0,1.1106915165381966e-05,1.0
37419,도쯤이면/Foreign,1,0,1,0.0,1.1106915165381966e-05,1.0
37420,선출/Noun,1,0,1,0.0,1.1106915165381966e-05,1.0
37421,꼴보견/Noun,1,0,1,0.0,1.1106915165381966e-05,1.0
37422,류승점/Noun,1,0,1,0.0,1.1106915165381966e-05,1.0
37423,츠츠/Noun,1,0,1,0.0,1.1106915165381966e-05,1.0
37424,봤드만영/Noun,1,0,1,0.0,1.1106915165381966e-05,1.0
37425,Pop/Alpha,1,1,0,1.1115310228308472e-05,0.0,1.0
37426,集。。。/Foreign,1,1,0,1.1115310228308472e-05,0.0,1.0
37427,期待/Foreign,1,1,0,1.1115310228308472e-05,0.0,1.0
37428,、里面的歌曲都/Foreign,1,1,0,1.1115310228308472e-05,0.0,1.0
37429,部/Foreign,1,1,0,1.1115310228308472e-05,0.0,1.0
37430,!//Punctuation,1,1,0,1.1115310228308472e-05,0.0,1.0
37431,왜쾌/Noun,1,0,1,0.0,1.1106915165381966e-05,1.0
37432,렌할/Noun,1,1,0,1.1115310228308472e-05,0.0,1.0
37433,실밥/Noun,1,0,1,0.0,1.1106915165381966e-05,1.0
37434,병자호란/Noun,1,0,1,0.0,1.1106915165381966e-05,1.0
37435,활쏘기/Noun,1,0,1,0.0,1.1106915165381966e-05,1.0
37436,비핵화/Noun,1,0,1,0.0,1.1106915165381966e-05,1.0
37437,후쿠시마/Noun,1,0,1,0.0,1.1106915165381966e-05,1.0
37438,쥬엘에대/Noun,1,0,1,0.0,1.1106915165381966e-05,1.0
37439,미디움/Noun,1,0,1,0.0,1.1106915165381966e-05,1.0
37440,웰던/Noun,1,0,1,0.0,1.1106915165381966e-05,1.0
37441,레어/Noun,1,0,1,0.0,1.1106915165381966e-05,1.0
37442,MSX/Alpha,1,1,0,1.1115310228308472e-05,0.0,1.0
37443,만천하/Noun,1,1,0,1.1115310228308472e-05,0.0,1.0
37444,답답답/Noun,1,0,1,0.0,1.1106915165381966e-05,1.0
37445,차증/Noun,1,0,1,0.0,1.1106915165381966e-05,1.0
37446,뼉/Noun,1,0,1,0.0,1.1106915165381966e-05,1.0
37447,친오빠/Noun,1,0,1,0.0,1.1106915165381966e-05,1.0
37448,"""????""/Punctuation",1,0,1,0.0,1.1106915165381966e-05,1.0
37449,"""???""/Punctuation",1,0,1,0.0,1.1106915165381966e-05,1.0
37450,detective/Alpha,1,1,0,1.1115310228308472e-05,0.0,1.0
37451,Monk/Alpha,1,1,0,1.1115310228308472e-05,0.0,1.0
37452,국철/Noun,1,0,1,0.0,1.1106915165381966e-05,1.0
37453,팔구/Noun,1,0,1,0.0,1.1106915165381966e-05,1.0
37454,색경/Noun,1,0,1,0.0,1.1106915165381966e-05,1.0
37455,듀/Noun,1,1,0,1.1115310228308472e-05,0.0,1.0
37456,아니쟎/Noun,1,0,1,0.0,1.1106915165381966e-05,1.0
37457,각주/Noun,1,1,0,1.1115310228308472e-05,0.0,1.0
37458,떠돌이/Noun,1,1,0,1.1115310228308472e-05,0.0,1.0
37459,야빠들/Noun,1,0,1,0.0,1.1106915165381966e-05,1.0
37460,도영화라/Foreign,1,1,0,1.1115310228308472e-05,0.0,1.0
37461,서희원/Noun,1,0,1,0.0,1.1106915165381966e-05,1.0
37462,총통/Noun,1,1,0,1.1115310228308472e-05,0.0,1.0
37463,바그너/Noun,1,1,0,1.1115310228308472e-05,0.0,1.0
37464,램프/Noun,1,0,1,0.0,1.1106915165381966e-05,1.0
37465,초치/Noun,1,1,0,1.1115310228308472e-05,0.0,1.0
37466,발레댄서/Noun,1,1,0,1.1115310228308472e-05,0.0,1.0
37467,베르메르/Noun,1,0,1,0.0,1.1106915165381966e-05,1.0
37468,제동/Noun,1,1,0,1.1115310228308472e-05,0.0,1.0
37469,모라토리엄/Noun,1,1,0,1.1115310228308472e-05,0.0,1.0
37470,엮으/Noun,1,1,0,1.1115310228308472e-05,0.0,1.0
37471,반즈/Noun,1,1,0,1.1115310228308472e-05,0.0,1.0
37472,김진평/Noun,1,1,0,1.1115310228308472e-05,0.0,1.0
37473,보았더랬/Noun,1,0,1,0.0,1.1106915165381966e-05,1.0
37474,자기연출/Noun,1,0,1,0.0,1.1106915165381966e-05,1.0
37475,팬빨/Noun,1,0,1,0.0,1.1106915165381966e-05,1.0
37476,위폐/Noun,1,0,1,0.0,1.1106915165381966e-05,1.0
37477,덴마/Noun,1,0,1,0.0,1.1106915165381966e-05,1.0
37478,토너/Noun,1,1,0,1.1115310228308472e-05,0.0,1.0
37479,쩌는것/Noun,1,0,1,0.0,1.1106915165381966e-05,1.0
37480,미비/Noun,1,0,1,0.0,1.1106915165381966e-05,1.0
37481,안근/Noun,1,1,0,1.1115310228308472e-05,0.0,1.0
37482,좋/Noun,1,1,0,1.1115310228308472e-05,0.0,1.0
37483,uh/Alpha,1,0,1,0.0,1.1106915165381966e-05,1.0
37484,}:/Punctuation,1,1,0,1.1115310228308472e-05,0.0,1.0
37485,{/Punctuation,1,1,0,1.1115310228308472e-05,0.0,1.0
37486,tmfrlaltnr/Alpha,1,1,0,1.1115310228308472e-05,0.0,1.0
37487,2185/Number,1,0,1,0.0,1.1106915165381966e-05,1.0
37488,살리에르/Noun,1,1,0,1.1115310228308472e-05,0.0,1.0
37489,?.?.?/Punctuation,1,0,1,0.0,1.1106915165381966e-05,1.0
37490,선대/Noun,1,1,0,1.1115310228308472e-05,0.0,1.0
37491,살찌웠음/Noun,1,0,1,0.0,1.1106915165381966e-05,1.0
37492,촉망/Noun,1,0,1,0.0,1.1106915165381966e-05,1.0
37493,위에님/Noun,1,0,1,0.0,1.1106915165381966e-05,1.0
37494,밋밋햇/Noun,1,1,0,1.1115310228308472e-05,0.0,1.0
37495,레올/Noun,1,1,0,1.1115310228308472e-05,0.0,1.0
37496,쟈응/Noun,1,1,0,1.1115310228308472e-05,0.0,1.0
37497,창조설/Noun,1,0,1,0.0,1.1106915165381966e-05,1.0
37498,좀떨떠름/Noun,1,1,0,1.1115310228308472e-05,0.0,1.0
37499,분출구/Noun,1,0,1,0.0,1.1106915165381966e-05,1.0
37500,심응/Noun,1,1,0,1.1115310228308472e-05,0.0,1.0
37501,블론드/Noun,1,1,0,1.1115310228308472e-05,0.0,1.0
37502,약물중독/Noun,1,0,1,0.0,1.1106915165381966e-05,1.0
37503,풍기면/Noun,1,0,1,0.0,1.1106915165381966e-05,1.0
37504,늬양스/Noun,1,0,1,0.0,1.1106915165381966e-05,1.0
37505,입싹/Noun,1,0,1,0.0,1.1106915165381966e-05,1.0
37506,배드걸/Noun,1,0,1,0.0,1.1106915165381966e-05,1.0
37507,유감스럽게/Noun,1,0,1,0.0,1.1106915165381966e-05,1.0
37508,작이었네/Foreign,1,1,0,1.1115310228308472e-05,0.0,1.0
37509,굉장회/Noun,1,1,0,1.1115310228308472e-05,0.0,1.0
37510,따끈하다/Adjective,1,1,0,1.1115310228308472e-05,0.0,1.0
37511,파친코/Noun,1,0,1,0.0,1.1106915165381966e-05,1.0
37512,쫄따구들/Noun,1,1,0,1.1115310228308472e-05,0.0,1.0
37513,자공/Noun,1,0,1,0.0,1.1106915165381966e-05,1.0
37514,정비공/Noun,1,0,1,0.0,1.1106915165381966e-05,1.0
37515,lacking/Alpha,1,0,1,0.0,1.1106915165381966e-05,1.0
37516,퓨퓨퓨/Noun,1,0,1,0.0,1.1106915165381966e-05,1.0
37517,앤피/Noun,1,1,0,1.1115310228308472e-05,0.0,1.0
37518,근심/Noun,1,1,0,1.1115310228308472e-05,0.0,1.0
37519,GD/Alpha,1,1,0,1.1115310228308472e-05,0.0,1.0
37520,브래너/Noun,1,1,0,1.1115310228308472e-05,0.0,1.0
37521,와타시/Noun,1,1,0,1.1115310228308472e-05,0.0,1.0
37522,장손/Noun,1,0,1,0.0,1.1106915165381966e-05,1.0
37523,수묵화/Noun,1,1,0,1.1115310228308472e-05,0.0,1.0
37524,",,,;;;;/Punctuation",1,0,1,0.0,1.1106915165381966e-05,1.0
37525,ㄱㅊㅎ/KoreanParticle,1,1,0,1.1115310228308472e-05,0.0,1.0
37526,북좃선/Noun,1,1,0,1.1115310228308472e-05,0.0,1.0
37527,보직/Noun,1,1,0,1.1115310228308472e-05,0.0,1.0
37528,구뤠/Noun,1,1,0,1.1115310228308472e-05,0.0,1.0
37529,미디어법/Noun,1,1,0,1.1115310228308472e-05,0.0,1.0
37530,잼없드/Noun,1,0,1,0.0,1.1106915165381966e-05,1.0
37531,손튼/Noun,1,1,0,1.1115310228308472e-05,0.0,1.0
37532,맵시/Noun,1,0,1,0.0,1.1106915165381966e-05,1.0
37533,중절모/Noun,1,1,0,1.1115310228308472e-05,0.0,1.0
37534,잼핵잼잼잼/Noun,1,1,0,1.1115310228308472e-05,0.0,1.0
37535,잼잼꿀잼/Noun,1,1,0,1.1115310228308472e-05,0.0,1.0
37536,어이/Exclamation,1,0,1,0.0,1.1106915165381966e-05,1.0
37537,돈가쓰/Noun,1,1,0,1.1115310228308472e-05,0.0,1.0
37538,둥글둥글하다/Adjective,1,0,1,0.0,1.1106915165381966e-05,1.0
37539,이란시간이흘렀네요/Foreign,1,1,0,1.1115310228308472e-05,0.0,1.0
37540,아랫쪽/Noun,1,1,0,1.1115310228308472e-05,0.0,1.0
37541,에이전시/Noun,1,0,1,0.0,1.1106915165381966e-05,1.0
37542,맞됴/Noun,1,1,0,1.1115310228308472e-05,0.0,1.0
37543,??????????????????/Punctuation,1,1,0,1.1115310228308472e-05,0.0,1.0
37544,카즈마/Noun,1,1,0,1.1115310228308472e-05,0.0,1.0
37545,차애/Noun,1,1,0,1.1115310228308472e-05,0.0,1.0
37546,리박사/Noun,1,1,0,1.1115310228308472e-05,0.0,1.0
37547,철민/Noun,1,1,0,1.1115310228308472e-05,0.0,1.0
37548,드라머/Noun,1,1,0,1.1115310228308472e-05,0.0,1.0
37549,육씨/Noun,1,0,1,0.0,1.1106915165381966e-05,1.0
37550,쓔봙/Noun,1,0,1,0.0,1.1106915165381966e-05,1.0
37551,색갸/Noun,1,0,1,0.0,1.1106915165381966e-05,1.0
37552,왜왕/Noun,1,0,1,0.0,1.1106915165381966e-05,1.0
37553,이나단/Noun,1,1,0,1.1115310228308472e-05,0.0,1.0
37554,레드라인/Noun,1,1,0,1.1115310228308472e-05,0.0,1.0
37555,똥팔/Noun,1,1,0,1.1115310228308472e-05,0.0,1.0
37556,hokicc/Alpha,1,1,0,1.1115310228308472e-05,0.0,1.0
37557,볻/Noun,1,0,1,0.0,1.1106915165381966e-05,1.0
37558,"""^""/Punctuation",1,1,0,1.1115310228308472e-05,0.0,1.0
37559,루엿/Noun,1,1,0,1.1115310228308472e-05,0.0,1.0
37560,다량/Noun,1,0,1,0.0,1.1106915165381966e-05,1.0
37561,개웃겻음/Noun,1,0,1,0.0,1.1106915165381966e-05,1.0
37562,모년/Noun,1,0,1,0.0,1.1106915165381966e-05,1.0
37563,어퍼컷/Noun,1,1,0,1.1115310228308472e-05,0.0,1.0
37564,왓음조켓댜/Noun,1,1,0,1.1115310228308472e-05,0.0,1.0
37565,애글/Noun,1,1,0,1.1115310228308472e-05,0.0,1.0
37566,안장/Noun,1,1,0,1.1115310228308472e-05,0.0,1.0
37567,야스쿠니신사/Noun,1,1,0,1.1115310228308472e-05,0.0,1.0
37568,특진/Noun,1,1,0,1.1115310228308472e-05,0.0,1.0
37569,사천/Noun,1,1,0,1.1115310228308472e-05,0.0,1.0
37570,↑↑/Foreign,1,0,1,0.0,1.1106915165381966e-05,1.0
37571,ⁿⁿ/Foreign,1,1,0,1.1115310228308472e-05,0.0,1.0
37572,부터재밌어서/Foreign,1,1,0,1.1115310228308472e-05,0.0,1.0
37573,개슈레귀/Noun,1,0,1,0.0,1.1106915165381966e-05,1.0
37574,수무/Noun,1,1,0,1.1115310228308472e-05,0.0,1.0
37575,쿠얼리티/Noun,1,0,1,0.0,1.1106915165381966e-05,1.0
37576,릿/Noun,1,1,0,1.1115310228308472e-05,0.0,1.0
37577,카나/Noun,1,1,0,1.1115310228308472e-05,0.0,1.0
37578,딮식스/Noun,1,0,1,0.0,1.1106915165381966e-05,1.0
37579,팬더스/Noun,1,0,1,0.0,1.1106915165381966e-05,1.0
37580,솔저/Noun,1,0,1,0.0,1.1106915165381966e-05,1.0
37581,위워/Noun,1,0,1,0.0,1.1106915165381966e-05,1.0
37582,첨보네욬/Noun,1,0,1,0.0,1.1106915165381966e-05,1.0
37583,장현우/Noun,1,1,0,1.1115310228308472e-05,0.0,1.0
37584,명우/Noun,1,0,1,0.0,1.1106915165381966e-05,1.0
37585,암도/Noun,1,0,1,0.0,1.1106915165381966e-05,1.0
37586,퍼먹는씬/Noun,1,0,1,0.0,1.1106915165381966e-05,1.0
37587,드리스/Noun,1,1,0,1.1115310228308472e-05,0.0,1.0
37588,ㄴㄹ/KoreanParticle,1,0,1,0.0,1.1106915165381966e-05,1.0
37589,호옷/Noun,1,1,0,1.1115310228308472e-05,0.0,1.0
37590,dsa/Alpha,1,1,0,1.1115310228308472e-05,0.0,1.0
37591,리철/Noun,1,1,0,1.1115310228308472e-05,0.0,1.0
37592,~!!!!'/Punctuation,1,0,1,0.0,1.1106915165381966e-05,1.0
37593,미네/Noun,1,1,0,1.1115310228308472e-05,0.0,1.0
37594,쪽방/Noun,1,0,1,0.0,1.1106915165381966e-05,1.0
37595,봐왓는데/Noun,1,0,1,0.0,1.1106915165381966e-05,1.0
37596,73년/Number,1,0,1,0.0,1.1106915165381966e-05,1.0
37597,151/Number,1,0,1,0.0,1.1106915165381966e-05,1.0
37598,개월후/Noun,1,0,1,0.0,1.1106915165381966e-05,1.0
37599,츄레기/Noun,1,0,1,0.0,1.1106915165381966e-05,1.0
37600,무었일까/Noun,1,0,1,0.0,1.1106915165381966e-05,1.0
37601,3500만달러/Number,1,0,1,0.0,1.1106915165381966e-05,1.0
37602,조잘조잘/Noun,1,1,0,1.1115310228308472e-05,0.0,1.0
37603,드거/Noun,1,1,0,1.1115310228308472e-05,0.0,1.0
37604,hack/Alpha,1,0,1,0.0,1.1106915165381966e-05,1.0
37605,죄파/Noun,1,1,0,1.1115310228308472e-05,0.0,1.0
37606,피어싱/Noun,1,0,1,0.0,1.1106915165381966e-05,1.0
37607,순정녀/Noun,1,0,1,0.0,1.1106915165381966e-05,1.0
37608,쫗아/Noun,1,1,0,1.1115310228308472e-05,0.0,1.0
37609,오윤아/Noun,1,0,1,0.0,1.1106915165381966e-05,1.0
37610,singing/Alpha,1,1,0,1.1115310228308472e-05,0.0,1.0
37611,애고/Exclamation,1,1,0,1.1115310228308472e-05,0.0,1.0
37612,박찬옥/Noun,1,0,1,0.0,1.1106915165381966e-05,1.0
37613,황태/Noun,1,0,1,0.0,1.1106915165381966e-05,1.0
37614,쪼굼/Noun,1,1,0,1.1115310228308472e-05,0.0,1.0
37615,드리블/Noun,1,1,0,1.1115310228308472e-05,0.0,1.0
37616,씨날/Noun,1,1,0,1.1115310228308472e-05,0.0,1.0
37617,포루투갈영화/Noun,1,1,0,1.1115310228308472e-05,0.0,1.0
37618,진주햄/Noun,1,1,0,1.1115310228308472e-05,0.0,1.0
37619,이일웅/Noun,1,1,0,1.1115310228308472e-05,0.0,1.0
37620,방자하다/Adjective,1,0,1,0.0,1.1106915165381966e-05,1.0
37621,안선영/Noun,1,0,1,0.0,1.1106915165381966e-05,1.0
37622,보탰/Noun,1,0,1,0.0,1.1106915165381966e-05,1.0
37623,고모부/Noun,1,0,1,0.0,1.1106915165381966e-05,1.0
37624,정신증/Noun,1,1,0,1.1115310228308472e-05,0.0,1.0
37625,시월드/Noun,1,0,1,0.0,1.1106915165381966e-05,1.0
37626,ghjghjgjuj/Alpha,1,1,0,1.1115310228308472e-05,0.0,1.0
37627,퓌향/Noun,1,0,1,0.0,1.1106915165381966e-05,1.0
37628,콧물찍/Noun,1,1,0,1.1115310228308472e-05,0.0,1.0
37629,여훈/Noun,1,1,0,1.1115310228308472e-05,0.0,1.0
37630,낸시랭/Noun,1,0,1,0.0,1.1106915165381966e-05,1.0
37631,대기권/Noun,1,0,1,0.0,1.1106915165381966e-05,1.0
37632,눌림/Noun,1,0,1,0.0,1.1106915165381966e-05,1.0
37633,스테레오타입/Noun,1,0,1,0.0,1.1106915165381966e-05,1.0
37634,주서/Noun,1,1,0,1.1115310228308472e-05,0.0,1.0
37635,론거/Noun,1,0,1,0.0,1.1106915165381966e-05,1.0
37636,티자/Noun,1,1,0,1.1115310228308472e-05,0.0,1.0
37637,gtA/Alpha,1,1,0,1.1115310228308472e-05,0.0,1.0
37638,톰펠튼/Noun,1,1,0,1.1115310228308472e-05,0.0,1.0
37639,팔레스타인인/Noun,1,1,0,1.1115310228308472e-05,0.0,1.0
37640,도껀줄/Foreign,1,0,1,0.0,1.1106915165381966e-05,1.0
37641,서지고/Noun,1,0,1,0.0,1.1106915165381966e-05,1.0
37642,깜동/Noun,1,1,0,1.1115310228308472e-05,0.0,1.0
37643,이해명/Noun,1,1,0,1.1115310228308472e-05,0.0,1.0
37644,갑바/Noun,1,0,1,0.0,1.1106915165381966e-05,1.0
37645,중간치/Noun,1,0,1,0.0,1.1106915165381966e-05,1.0
37646,야만스럽다/Adjective,1,0,1,0.0,1.1106915165381966e-05,1.0
37647,tkffuTek/Alpha,1,1,0,1.1115310228308472e-05,0.0,1.0
37648,dudghkfmf/Alpha,1,1,0,1.1115310228308472e-05,0.0,1.0
37649,dksthslghqzlsttmrk/Alpha,1,1,0,1.1115310228308472e-05,0.0,1.0
37650,..??;;;/Punctuation,1,0,1,0.0,1.1106915165381966e-05,1.0
37651,계쏙/Noun,1,1,0,1.1115310228308472e-05,0.0,1.0
37652,경외감/Noun,1,1,0,1.1115310228308472e-05,0.0,1.0
37653,촌장/Noun,1,0,1,0.0,1.1106915165381966e-05,1.0
37654,자능/Noun,1,0,1,0.0,1.1106915165381966e-05,1.0
37655,가리봉동/Noun,1,1,0,1.1115310228308472e-05,0.0,1.0
37656,활강/Noun,1,1,0,1.1115310228308472e-05,0.0,1.0
37657,의녀/Noun,1,1,0,1.1115310228308472e-05,0.0,1.0
37658,짜샤/Noun,1,0,1,0.0,1.1106915165381966e-05,1.0
37659,브레야/Noun,1,1,0,1.1115310228308472e-05,0.0,1.0
37660,콧뺴기/Noun,1,0,1,0.0,1.1106915165381966e-05,1.0
37661,알앗슴/Noun,1,1,0,1.1115310228308472e-05,0.0,1.0
37662,실어증/Noun,1,0,1,0.0,1.1106915165381966e-05,1.0
37663,샤갈/Noun,1,1,0,1.1115310228308472e-05,0.0,1.0
37664,tree/Alpha,1,0,1,0.0,1.1106915165381966e-05,1.0
37665,oak/Alpha,1,0,1,0.0,1.1106915165381966e-05,1.0
37666,ribbon/Alpha,1,0,1,0.0,1.1106915165381966e-05,1.0
37667,yellow/Alpha,1,0,1,0.0,1.1106915165381966e-05,1.0
37668,Tie/Alpha,1,0,1,0.0,1.1106915165381966e-05,1.0
37669,청량하다/Adjective,1,1,0,1.1115310228308472e-05,0.0,1.0
37670,추운/Noun,1,1,0,1.1115310228308472e-05,0.0,1.0
37671,말라야/Noun,1,1,0,1.1115310228308472e-05,0.0,1.0
37672,뗴/Noun,1,0,1,0.0,1.1106915165381966e-05,1.0
37673,심성은/Noun,1,0,1,0.0,1.1106915165381966e-05,1.0
37674,.~../Punctuation,1,1,0,1.1115310228308472e-05,0.0,1.0
37675,트레비앙/Noun,1,1,0,1.1115310228308472e-05,0.0,1.0
37676,염라대왕/Noun,1,0,1,0.0,1.1106915165381966e-05,1.0
37677,상권/Noun,1,0,1,0.0,1.1106915165381966e-05,1.0
37678,다봤을껄/Noun,1,1,0,1.1115310228308472e-05,0.0,1.0
37679,박창진/Noun,1,0,1,0.0,1.1106915165381966e-05,1.0
37680,뭣하/Noun,1,0,1,0.0,1.1106915165381966e-05,1.0
37681,조리법/Noun,1,1,0,1.1115310228308472e-05,0.0,1.0
37682,원티드/Noun,1,0,1,0.0,1.1106915165381966e-05,1.0
37683,이강준/Noun,1,1,0,1.1115310228308472e-05,0.0,1.0
37684,뀰잼으루/Noun,1,1,0,1.1115310228308472e-05,0.0,1.0
37685,영시/Noun,1,1,0,1.1115310228308472e-05,0.0,1.0
37686,산아/Noun,1,1,0,1.1115310228308472e-05,0.0,1.0
37687,박창/Noun,1,1,0,1.1115310228308472e-05,0.0,1.0
37688,동예/Noun,1,1,0,1.1115310228308472e-05,0.0,1.0
37689,한일전/Noun,1,1,0,1.1115310228308472e-05,0.0,1.0
37690,티켓팅/Noun,1,1,0,1.1115310228308472e-05,0.0,1.0
37691,케토/Noun,1,0,1,0.0,1.1106915165381966e-05,1.0
37692,수박도/Noun,1,0,1,0.0,1.1106915165381966e-05,1.0
37693,부곡/Noun,1,1,0,1.1115310228308472e-05,0.0,1.0
37694,솔직담백하다/Adjective,1,1,0,1.1115310228308472e-05,0.0,1.0
37695,탕점/Noun,1,1,0,1.1115310228308472e-05,0.0,1.0
37696,각성제/Noun,1,0,1,0.0,1.1106915165381966e-05,1.0
37697,주연서/Noun,1,0,1,0.0,1.1106915165381966e-05,1.0
37698,푸로뎍숀/Noun,1,0,1,0.0,1.1106915165381966e-05,1.0
37699,스투핏/Noun,1,0,1,0.0,1.1106915165381966e-05,1.0
37700,짱궈란/Noun,1,0,1,0.0,1.1106915165381966e-05,1.0
37701,뱔로엿는데/Noun,1,0,1,0.0,1.1106915165381966e-05,1.0
37702,Nolan/Alpha,1,1,0,1.1115310228308472e-05,0.0,1.0
37703,Christopher/Alpha,1,1,0,1.1115310228308472e-05,0.0,1.0
37704,produced/Alpha,1,1,0,1.1115310228308472e-05,0.0,1.0
37705,죽이삘/Noun,1,1,0,1.1115310228308472e-05,0.0,1.0
37706,나르샤/Noun,1,1,0,1.1115310228308472e-05,0.0,1.0
37707,):/Punctuation,1,1,0,1.1115310228308472e-05,0.0,1.0
37708,줄리어스/Noun,1,1,0,1.1115310228308472e-05,0.0,1.0
37709,날다람쥐/Noun,1,1,0,1.1115310228308472e-05,0.0,1.0
37710,우겔겔겔/Noun,1,0,1,0.0,1.1106915165381966e-05,1.0
37711,일뚱/Noun,1,0,1,0.0,1.1106915165381966e-05,1.0
37712,흐하아/Noun,1,1,0,1.1115310228308472e-05,0.0,1.0
37713,1984/Number,1,0,1,0.0,1.1106915165381966e-05,1.0
37714,연속한다고써있었는데/Foreign,1,0,1,0.0,1.1106915165381966e-05,1.0
37715,잼핵/Noun,1,0,1,0.0,1.1106915165381966e-05,1.0
37716,법리/Noun,1,0,1,0.0,1.1106915165381966e-05,1.0
37717,훈시규정/Noun,1,0,1,0.0,1.1106915165381966e-05,1.0
37718,효력규정/Noun,1,0,1,0.0,1.1106915165381966e-05,1.0
37719,도과/Noun,1,0,1,0.0,1.1106915165381966e-05,1.0
37720,드높아지다/Verb,1,1,0,1.1115310228308472e-05,0.0,1.0
37721,민병대/Noun,1,1,0,1.1115310228308472e-05,0.0,1.0
37722,val/Alpha,1,0,1,0.0,1.1106915165381966e-05,1.0
37723,초반레/Noun,1,0,1,0.0,1.1106915165381966e-05,1.0
37724,구만배/Noun,1,1,0,1.1115310228308472e-05,0.0,1.0
37725,봇보/Noun,1,1,0,1.1115310228308472e-05,0.0,1.0
37726,ㄴㅂㅁ/KoreanParticle,1,1,0,1.1115310228308472e-05,0.0,1.0
37727,ㅂㄷㅇ/KoreanParticle,1,1,0,1.1115310228308472e-05,0.0,1.0
37728,시슬리/Noun,1,1,0,1.1115310228308472e-05,0.0,1.0
37729,토머/Noun,1,1,0,1.1115310228308472e-05,0.0,1.0
37730,져지/Noun,1,1,0,1.1115310228308472e-05,0.0,1.0
37731,그닥임/Noun,1,0,1,0.0,1.1106915165381966e-05,1.0
37732,호반/Noun,1,1,0,1.1115310228308472e-05,0.0,1.0
37733,오비/Noun,1,1,0,1.1115310228308472e-05,0.0,1.0
37734,카민/Noun,1,1,0,1.1115310228308472e-05,0.0,1.0
37735,낭비벽/Noun,1,0,1,0.0,1.1106915165381966e-05,1.0
37736,후나/Noun,1,0,1,0.0,1.1106915165381966e-05,1.0
37737,Biff/Alpha,1,0,1,0.0,1.1106915165381966e-05,1.0
37738,이내로죽여서좋군/Foreign,1,0,1,0.0,1.1106915165381966e-05,1.0
37739,1313/Number,1,1,0,1.1115310228308472e-05,0.0,1.0
37740,skss/Alpha,1,1,0,1.1115310228308472e-05,0.0,1.0
37741,10~15/Number,1,0,1,0.0,1.1106915165381966e-05,1.0
37742,양아들/Noun,1,0,1,0.0,1.1106915165381966e-05,1.0
37743,우비소녀/Noun,1,1,0,1.1115310228308472e-05,0.0,1.0
37744,뭐햇/Noun,1,0,1,0.0,1.1106915165381966e-05,1.0
37745,1.9%/Number,1,1,0,1.1115310228308472e-05,0.0,1.0
37746,이뿐덴/Noun,1,0,1,0.0,1.1106915165381966e-05,1.0
37747,적화통일/Noun,1,0,1,0.0,1.1106915165381966e-05,1.0
37748,소릴해/Noun,1,0,1,0.0,1.1106915165381966e-05,1.0
37749,달샤벳/Noun,1,0,1,0.0,1.1106915165381966e-05,1.0
37750,요행/Noun,1,1,0,1.1115310228308472e-05,0.0,1.0
37751,",;'/Punctuation",1,1,0,1.1115310228308472e-05,0.0,1.0
37752,몬대/Noun,1,1,0,1.1115310228308472e-05,0.0,1.0
37753,몬주/Noun,1,1,0,1.1115310228308472e-05,0.0,1.0
37754,여성호르몬/Noun,1,1,0,1.1115310228308472e-05,0.0,1.0
37755,공선/Noun,1,0,1,0.0,1.1106915165381966e-05,1.0
37756,떳다/Noun,1,0,1,0.0,1.1106915165381966e-05,1.0
37757,텍스쳐/Noun,1,1,0,1.1115310228308472e-05,0.0,1.0
37758,멘델/Noun,1,1,0,1.1115310228308472e-05,0.0,1.0
37759,국정/Noun,1,0,1,0.0,1.1106915165381966e-05,1.0
37760,캭캬캬/Noun,1,0,1,0.0,1.1106915165381966e-05,1.0
37761,crisis/Alpha,1,1,0,1.1115310228308472e-05,0.0,1.0
37762,portrait/Alpha,1,1,0,1.1115310228308472e-05,0.0,1.0
37763,애애애앰/Noun,1,0,1,0.0,1.1106915165381966e-05,1.0
37764,아오하라이드/Noun,1,1,0,1.1115310228308472e-05,0.0,1.0
37765,lhlshlsifhow/Alpha,1,1,0,1.1115310228308472e-05,0.0,1.0
37766,wjehdlhs/Alpha,1,1,0,1.1115310228308472e-05,0.0,1.0
37767,ㅋㅋㄱㅋㄱㄱㅋㄱㄱㄱ/KoreanParticle,1,0,1,0.0,1.1106915165381966e-05,1.0
37768,민석/Noun,1,0,1,0.0,1.1106915165381966e-05,1.0
37769,이상기/Noun,1,1,0,1.1115310228308472e-05,0.0,1.0
37770,흐느낌/Noun,1,1,0,1.1115310228308472e-05,0.0,1.0
37771,이라기엔/Foreign,1,0,1,0.0,1.1106915165381966e-05,1.0
37772,킬릴타윔/Noun,1,0,1,0.0,1.1106915165381966e-05,1.0
37773,나방/Noun,1,0,1,0.0,1.1106915165381966e-05,1.0
37774,범죄현장/Noun,1,1,0,1.1115310228308472e-05,0.0,1.0
37775,완던/Noun,1,0,1,0.0,1.1106915165381966e-05,1.0
37776,우루과이/Noun,1,1,0,1.1115310228308472e-05,0.0,1.0
37777,감정노동자/Noun,1,0,1,0.0,1.1106915165381966e-05,1.0
37778,고호경/Noun,1,0,1,0.0,1.1106915165381966e-05,1.0
37779,왜르케/Noun,1,1,0,1.1115310228308472e-05,0.0,1.0
37780,정진/Noun,1,0,1,0.0,1.1106915165381966e-05,1.0
37781,짜리인데/Foreign,1,0,1,0.0,1.1106915165381966e-05,1.0
37782,&&/Punctuation,1,0,1,0.0,1.1106915165381966e-05,1.0
37783,##들/Hashtag,1,0,1,0.0,1.1106915165381966e-05,1.0
37784,서빠/Noun,1,0,1,0.0,1.1106915165381966e-05,1.0
37785,아방궁/Noun,1,1,0,1.1115310228308472e-05,0.0,1.0
37786,과다복용/Noun,1,0,1,0.0,1.1106915165381966e-05,1.0
37787,초대권/Noun,1,0,1,0.0,1.1106915165381966e-05,1.0
37788,물통씬/Noun,1,1,0,1.1115310228308472e-05,0.0,1.0
37789,성학/Noun,1,0,1,0.0,1.1106915165381966e-05,1.0
37790,진골/Noun,1,1,0,1.1115310228308472e-05,0.0,1.0
37791,크흐/Noun,1,1,0,1.1115310228308472e-05,0.0,1.0
37792,트렌센던스/Noun,1,0,1,0.0,1.1106915165381966e-05,1.0
37793,흔녀/Noun,1,1,0,1.1115310228308472e-05,0.0,1.0
37794,Queer/Alpha,1,1,0,1.1115310228308472e-05,0.0,1.0
37795,스보리/Noun,1,0,1,0.0,1.1106915165381966e-05,1.0
37796,RED/Alpha,1,0,1,0.0,1.1106915165381966e-05,1.0
37797,에보는/Foreign,1,0,1,0.0,1.1106915165381966e-05,1.0
37798,광열/Noun,1,1,0,1.1115310228308472e-05,0.0,1.0
37799,세느강/Noun,1,1,0,1.1115310228308472e-05,0.0,1.0
37800,인서트/Noun,1,0,1,0.0,1.1106915165381966e-05,1.0
37801,충공깽/Noun,1,0,1,0.0,1.1106915165381966e-05,1.0
37802,레오니다스/Noun,1,1,0,1.1115310228308472e-05,0.0,1.0
37803,알렉산드로스/Noun,1,1,0,1.1115310228308472e-05,0.0,1.0
37804,근질거렸음/Noun,1,1,0,1.1115310228308472e-05,0.0,1.0
37805,심상군/Noun,1,1,0,1.1115310228308472e-05,0.0,1.0
37806,클럽씬/Noun,1,0,1,0.0,1.1106915165381966e-05,1.0
37807,퀘스트/Noun,1,0,1,0.0,1.1106915165381966e-05,1.0
37808,465437/Number,1,0,1,0.0,1.1106915165381966e-05,1.0
37809,Peace/Alpha,1,0,1,0.0,1.1106915165381966e-05,1.0
37810,Quest/Alpha,1,0,1,0.0,1.1106915165381966e-05,1.0
37811,거슨내/Noun,1,0,1,0.0,1.1106915165381966e-05,1.0
37812,국외/Noun,1,1,0,1.1115310228308472e-05,0.0,1.0
37813,죈송하/Noun,1,1,0,1.1115310228308472e-05,0.0,1.0
37814,미쳔/Noun,1,0,1,0.0,1.1106915165381966e-05,1.0
37815,밀루유떼/Noun,1,1,0,1.1115310228308472e-05,0.0,1.0
37816,이시고/Josa,1,0,1,0.0,1.1106915165381966e-05,1.0
37817,장한위/Noun,1,0,1,0.0,1.1106915165381966e-05,1.0
37818,대같은/Foreign,1,0,1,0.0,1.1106915165381966e-05,1.0
37819,박빠들/Noun,1,0,1,0.0,1.1106915165381966e-05,1.0
37820,무르익었/Noun,1,1,0,1.1115310228308472e-05,0.0,1.0
37821,역때/Noun,1,1,0,1.1115310228308472e-05,0.0,1.0
37822,Journey/Alpha,1,1,0,1.1115310228308472e-05,0.0,1.0
37823,Unexpected/Alpha,1,1,0,1.1115310228308472e-05,0.0,1.0
37824,Hobbit/Alpha,1,1,0,1.1115310228308472e-05,0.0,1.0
37825,설씨떄문/Noun,1,0,1,0.0,1.1106915165381966e-05,1.0
37826,상또/Noun,1,0,1,0.0,1.1106915165381966e-05,1.0
37827,이럴떄/Noun,1,1,0,1.1115310228308472e-05,0.0,1.0
37828,극지/Noun,1,1,0,1.1115310228308472e-05,0.0,1.0
37829,귀수/Noun,1,1,0,1.1115310228308472e-05,0.0,1.0
37830,래핑/Noun,1,1,0,1.1115310228308472e-05,0.0,1.0
37831,trouble/Alpha,1,0,1,0.0,1.1106915165381966e-05,1.0
37832,독립전쟁/Noun,1,0,1,0.0,1.1106915165381966e-05,1.0
37833,캴캴캴/Noun,1,0,1,0.0,1.1106915165381966e-05,1.0
37834,머리글/Noun,1,1,0,1.1115310228308472e-05,0.0,1.0
37835,성균관/Noun,1,1,0,1.1115310228308472e-05,0.0,1.0
37836,류시/Noun,1,1,0,1.1115310228308472e-05,0.0,1.0
37837,융단/Noun,1,1,0,1.1115310228308472e-05,0.0,1.0
37838,긔엽긔/Noun,1,1,0,1.1115310228308472e-05,0.0,1.0
37839,길티/Noun,1,1,0,1.1115310228308472e-05,0.0,1.0
37840,터트렸는/Noun,1,1,0,1.1115310228308472e-05,0.0,1.0
37841,외디푸스/Noun,1,0,1,0.0,1.1106915165381966e-05,1.0
37842,창동/Noun,1,1,0,1.1115310228308472e-05,0.0,1.0
37843,캄탄/Noun,1,1,0,1.1115310228308472e-05,0.0,1.0
37844,몬해/Noun,1,0,1,0.0,1.1106915165381966e-05,1.0
37845,수달/Noun,1,1,0,1.1115310228308472e-05,0.0,1.0
37846,손주/Noun,1,1,0,1.1115310228308472e-05,0.0,1.0
37847,수렴/Noun,1,0,1,0.0,1.1106915165381966e-05,1.0
37848,반두비/Noun,1,0,1,0.0,1.1106915165381966e-05,1.0
37849,question/Alpha,1,0,1,0.0,1.1106915165381966e-05,1.0
37850,웃겄는데/Noun,1,0,1,0.0,1.1106915165381966e-05,1.0
37851,겝봣/Noun,1,1,0,1.1115310228308472e-05,0.0,1.0
37852,2820/Number,1,0,1,0.0,1.1106915165381966e-05,1.0
37853,tmddn/Alpha,1,0,1,0.0,1.1106915165381966e-05,1.0
37854,뎋/Noun,1,1,0,1.1115310228308472e-05,0.0,1.0
37855,해놈/Noun,1,0,1,0.0,1.1106915165381966e-05,1.0
37856,현이/Noun,1,0,1,0.0,1.1106915165381966e-05,1.0
37857,다죽었넹/Noun,1,0,1,0.0,1.1106915165381966e-05,1.0
37858,서로서로/Adverb,1,1,0,1.1115310228308472e-05,0.0,1.0
37859,흐흘거허엏헑/Noun,1,1,0,1.1115310228308472e-05,0.0,1.0
37860,러브액추얼리/Noun,1,1,0,1.1115310228308472e-05,0.0,1.0
37861,때가지/Foreign,1,0,1,0.0,1.1106915165381966e-05,1.0
37862,잘엮/Noun,1,0,1,0.0,1.1106915165381966e-05,1.0
37863,드뭄감독/Noun,1,1,0,1.1115310228308472e-05,0.0,1.0
37864,엄꾸/Noun,1,0,1,0.0,1.1106915165381966e-05,1.0
37865,쌩뚱맞진/Noun,1,1,0,1.1115310228308472e-05,0.0,1.0
37866,!_!/Punctuation,1,1,0,1.1115310228308472e-05,0.0,1.0
37867,스르륵/Adverb,1,1,0,1.1115310228308472e-05,0.0,1.0
37868,가츠/Noun,1,1,0,1.1115310228308472e-05,0.0,1.0
37869,쏫았다/Noun,1,1,0,1.1115310228308472e-05,0.0,1.0
37870,남은영/Noun,1,1,0,1.1115310228308472e-05,0.0,1.0
37871,여성시대/Noun,1,1,0,1.1115310228308472e-05,0.0,1.0
37872,저릿저릿/Adverb,1,1,0,1.1115310228308472e-05,0.0,1.0
37873,누너/Noun,1,0,1,0.0,1.1106915165381966e-05,1.0
37874,딕션/Noun,1,0,1,0.0,1.1106915165381966e-05,1.0
37875,?...(/Punctuation,1,0,1,0.0,1.1106915165381966e-05,1.0
37876,살아오면서/Foreign,1,1,0,1.1115310228308472e-05,0.0,1.0
37877,갗/Noun,1,1,0,1.1115310228308472e-05,0.0,1.0
37878,귝/Noun,1,0,1,0.0,1.1106915165381966e-05,1.0
37879,한재/Noun,1,1,0,1.1115310228308472e-05,0.0,1.0
37880,북두/Noun,1,0,1,0.0,1.1106915165381966e-05,1.0
37881,암툰/Noun,1,0,1,0.0,1.1106915165381966e-05,1.0
37882,패신져/Noun,1,0,1,0.0,1.1106915165381966e-05,1.0
37883,떡잎/Noun,1,1,0,1.1115310228308472e-05,0.0,1.0
37884,씅/Noun,1,1,0,1.1115310228308472e-05,0.0,1.0
37885,....)/Punctuation,1,1,0,1.1115310228308472e-05,0.0,1.0
37886,ㅇㄴㄹㄴㅇㄹ/KoreanParticle,1,1,0,1.1115310228308472e-05,0.0,1.0
37887,안은정/Noun,1,1,0,1.1115310228308472e-05,0.0,1.0
37888,요시와라/Noun,1,0,1,0.0,1.1106915165381966e-05,1.0
37889,썬댄스/Noun,1,1,0,1.1115310228308472e-05,0.0,1.0
37890,아키타현/Noun,1,1,0,1.1115310228308472e-05,0.0,1.0
37891,스텁업/Noun,1,1,0,1.1115310228308472e-05,0.0,1.0
37892,angeles/Alpha,1,1,0,1.1115310228308472e-05,0.0,1.0
37893,좋소잉/Noun,1,1,0,1.1115310228308472e-05,0.0,1.0
37894,브이넥/Noun,1,1,0,1.1115310228308472e-05,0.0,1.0
37895,분질/Noun,1,1,0,1.1115310228308472e-05,0.0,1.0
37896,맹글라/Noun,1,0,1,0.0,1.1106915165381966e-05,1.0
37897,",,..../Punctuation",1,0,1,0.0,1.1106915165381966e-05,1.0
37898,Was/Alpha,1,1,0,1.1115310228308472e-05,0.0,1.0
37899,quiet/Alpha,1,1,0,1.1115310228308472e-05,0.0,1.0
37900,He/Alpha,1,1,0,1.1115310228308472e-05,0.0,1.0
37901,Asdlflfpspspspspwowkwhwgfkcp/Alpha,1,0,1,0.0,1.1106915165381966e-05,1.0
37902,0.04/Number,1,0,1,0.0,1.1106915165381966e-05,1.0
37903,악악거리다/Verb,1,0,1,0.0,1.1106915165381966e-05,1.0
37904,추입/Noun,1,0,1,0.0,1.1106915165381966e-05,1.0
37905,필림/Noun,1,0,1,0.0,1.1106915165381966e-05,1.0
37906,완존헐/Noun,1,0,1,0.0,1.1106915165381966e-05,1.0
37907,영화봔/Noun,1,1,0,1.1115310228308472e-05,0.0,1.0
37908,morning/Alpha,1,1,0,1.1115310228308472e-05,0.0,1.0
37909,갇동/Noun,1,1,0,1.1115310228308472e-05,0.0,1.0
37910,미스터초밥왕/Noun,1,1,0,1.1115310228308472e-05,0.0,1.0
37911,페인터/Noun,1,0,1,0.0,1.1106915165381966e-05,1.0
37912,녿/Noun,1,1,0,1.1115310228308472e-05,0.0,1.0
37913,ㅡㅈ/KoreanParticle,1,1,0,1.1115310228308472e-05,0.0,1.0
37914,갅/Noun,1,1,0,1.1115310228308472e-05,0.0,1.0
37915,봄직/Noun,1,0,1,0.0,1.1106915165381966e-05,1.0
37916,친놈/Noun,1,0,1,0.0,1.1106915165381966e-05,1.0
37917,때부턴가/Foreign,1,1,0,1.1115310228308472e-05,0.0,1.0
37918,때부터못봐사/Foreign,1,1,0,1.1115310228308472e-05,0.0,1.0
37919,햤었/Noun,1,1,0,1.1115310228308472e-05,0.0,1.0
37920,슬펴욥/Noun,1,1,0,1.1115310228308472e-05,0.0,1.0
37921,Sauvage/Alpha,1,1,0,1.1115310228308472e-05,0.0,1.0
37922,Planete/Alpha,1,1,0,1.1115310228308472e-05,0.0,1.0
37923,괴작랄까/Noun,1,1,0,1.1115310228308472e-05,0.0,1.0
37924,heros/Alpha,1,1,0,1.1115310228308472e-05,0.0,1.0
37925,프라이멀피어/Noun,1,0,1,0.0,1.1106915165381966e-05,1.0
37926,병화/Noun,1,0,1,0.0,1.1106915165381966e-05,1.0
37927,꼴링꼴링/Noun,1,1,0,1.1115310228308472e-05,0.0,1.0
37928,경빈박씨/Noun,1,1,0,1.1115310228308472e-05,0.0,1.0
37929,무릅쏴/Noun,1,0,1,0.0,1.1106915165381966e-05,1.0
37930,밑밑밑/Noun,1,1,0,1.1115310228308472e-05,0.0,1.0
37931,슛뎀업/Noun,1,1,0,1.1115310228308472e-05,0.0,1.0
37932,힌편/Noun,1,1,0,1.1115310228308472e-05,0.0,1.0
37933,재환/Noun,1,0,1,0.0,1.1106915165381966e-05,1.0
37934,아모/Noun,1,0,1,0.0,1.1106915165381966e-05,1.0
37935,35%/Number,1,0,1,0.0,1.1106915165381966e-05,1.0
37936,온리유/Noun,1,1,0,1.1115310228308472e-05,0.0,1.0
37937,청력/Noun,1,0,1,0.0,1.1106915165381966e-05,1.0
37938,꼽씹어/Noun,1,1,0,1.1115310228308472e-05,0.0,1.0
37939,대항도/Noun,1,1,0,1.1115310228308472e-05,0.0,1.0
37940,젤잼슴/Noun,1,1,0,1.1115310228308472e-05,0.0,1.0
37941,이랑이게/Foreign,1,1,0,1.1115310228308472e-05,0.0,1.0
37942,능새/Noun,1,1,0,1.1115310228308472e-05,0.0,1.0
37943,졸때/Noun,1,0,1,0.0,1.1106915165381966e-05,1.0
37944,혼미/Noun,1,1,0,1.1115310228308472e-05,0.0,1.0
37945,포안트/Noun,1,0,1,0.0,1.1106915165381966e-05,1.0
37946,안격는거/Noun,1,1,0,1.1115310228308472e-05,0.0,1.0
37947,엑스페리먼트/Noun,1,1,0,1.1115310228308472e-05,0.0,1.0
37948,케케묵었/Noun,1,0,1,0.0,1.1106915165381966e-05,1.0
37949,일복/Noun,1,0,1,0.0,1.1106915165381966e-05,1.0
37950,여행자/Noun,1,1,0,1.1115310228308472e-05,0.0,1.0
37951,요금인상/Noun,1,1,0,1.1115310228308472e-05,0.0,1.0
37952,부도덕하다/Adjective,1,1,0,1.1115310228308472e-05,0.0,1.0
37953,빅딜/Noun,1,1,0,1.1115310228308472e-05,0.0,1.0
37954,로테/Noun,1,1,0,1.1115310228308472e-05,0.0,1.0
37955,구문/Noun,1,1,0,1.1115310228308472e-05,0.0,1.0
37956,포유류/Noun,1,0,1,0.0,1.1106915165381966e-05,1.0
37957,까지영화중에/Foreign,1,1,0,1.1115310228308472e-05,0.0,1.0
37958,배득/Noun,1,0,1,0.0,1.1106915165381966e-05,1.0
37959,06/Number,1,0,1,0.0,1.1106915165381966e-05,1.0
37960,쟈스민/Noun,1,1,0,1.1115310228308472e-05,0.0,1.0
37961,건더기/Noun,1,0,1,0.0,1.1106915165381966e-05,1.0
37962,명량해전/Noun,1,0,1,0.0,1.1106915165381966e-05,1.0
37963,조송/Noun,1,1,0,1.1115310228308472e-05,0.0,1.0
37964,아흔/Noun,1,1,0,1.1115310228308472e-05,0.0,1.0
37965,마리앙바드/Noun,1,1,0,1.1115310228308472e-05,0.0,1.0
37966,............;;;/Punctuation,1,1,0,1.1115310228308472e-05,0.0,1.0
37967,bests/Alpha,1,1,0,1.1115310228308472e-05,0.0,1.0
37968,천치/Noun,1,0,1,0.0,1.1106915165381966e-05,1.0
37969,스포츠맨/Noun,1,0,1,0.0,1.1106915165381966e-05,1.0
37970,때돈/Noun,1,0,1,0.0,1.1106915165381966e-05,1.0
37971,콘도/Noun,1,1,0,1.1115310228308472e-05,0.0,1.0
37972,엇습니/Noun,1,1,0,1.1115310228308472e-05,0.0,1.0
37973,박학기/Noun,1,1,0,1.1115310228308472e-05,0.0,1.0
37974,욕안/Noun,1,0,1,0.0,1.1106915165381966e-05,1.0
37975,벨루/Noun,1,1,0,1.1115310228308472e-05,0.0,1.0
37976,포위전/Noun,1,0,1,0.0,1.1106915165381966e-05,1.0
37977,1083년/Number,1,0,1,0.0,1.1106915165381966e-05,1.0
37978,타이트/Noun,1,1,0,1.1115310228308472e-05,0.0,1.0
37979,??……/Punctuation,1,1,0,1.1115310228308472e-05,0.0,1.0
37980,?……(*^__^*)/Punctuation,1,1,0,1.1115310228308472e-05,0.0,1.0
37981,候/Foreign,1,1,0,1.1115310228308472e-05,0.0,1.0
37982,念小/Foreign,1,1,0,1.1115310228308472e-05,0.0,1.0
37983,！好/Foreign,1,1,0,1.1115310228308472e-05,0.0,1.0
37984,候看的/Foreign,1,1,0,1.1115310228308472e-05,0.0,1.0
37985,！小/Foreign,1,1,0,1.1115310228308472e-05,0.0,1.0
37986,蜀山/Foreign,1,1,0,1.1115310228308472e-05,0.0,1.0
37987,철도원/Noun,1,1,0,1.1115310228308472e-05,0.0,1.0
37988,Vijay/Alpha,1,1,0,1.1115310228308472e-05,0.0,1.0
37989,삼삼하다/Adjective,1,1,0,1.1115310228308472e-05,0.0,1.0
37990,지상전/Noun,1,1,0,1.1115310228308472e-05,0.0,1.0
37991,롤롤/Noun,1,1,0,1.1115310228308472e-05,0.0,1.0
37992,으로밖에/Foreign,1,1,0,1.1115310228308472e-05,0.0,1.0
37993,마담밍/Noun,1,1,0,1.1115310228308472e-05,0.0,1.0
37994,약선/Noun,1,1,0,1.1115310228308472e-05,0.0,1.0
37995,asdfgasdfg/Alpha,1,1,0,1.1115310228308472e-05,0.0,1.0
37996,특별방송/Noun,1,0,1,0.0,1.1106915165381966e-05,1.0
37997,에게야/Josa,1,0,1,0.0,1.1106915165381966e-05,1.0
37998,ㅅㅞㅅ/KoreanParticle,1,0,1,0.0,1.1106915165381966e-05,1.0
37999,장삿/Noun,1,0,1,0.0,1.1106915165381966e-05,1.0
38000,얘전/Noun,1,1,0,1.1115310228308472e-05,0.0,1.0
38001,왕지/Noun,1,1,0,1.1115310228308472e-05,0.0,1.0
38002,전속력/Noun,1,1,0,1.1115310228308472e-05,0.0,1.0
38003,호인/Noun,1,0,1,0.0,1.1106915165381966e-05,1.0
38004,미쳣군/Noun,1,0,1,0.0,1.1106915165381966e-05,1.0
38005,^-----^/Punctuation,1,1,0,1.1115310228308472e-05,0.0,1.0
38006,yong/Alpha,1,1,0,1.1115310228308472e-05,0.0,1.0
38007,캠패/Noun,1,1,0,1.1115310228308472e-05,0.0,1.0
38008,사십분/Noun,1,1,0,1.1115310228308472e-05,0.0,1.0
38009,0000000000000000/Number,1,0,1,0.0,1.1106915165381966e-05,1.0
38010,판검사/Noun,1,1,0,1.1115310228308472e-05,0.0,1.0
38011,암기/Noun,1,1,0,1.1115310228308472e-05,0.0,1.0
38012,샤밀란/Noun,1,0,1,0.0,1.1106915165381966e-05,1.0
38013,킬링시즌/Noun,1,1,0,1.1115310228308472e-05,0.0,1.0
38014,더럽혓다/Noun,1,0,1,0.0,1.1106915165381966e-05,1.0
38015,6.56/Number,1,0,1,0.0,1.1106915165381966e-05,1.0
38016,별똥/Noun,1,1,0,1.1115310228308472e-05,0.0,1.0
38017,understand/Alpha,1,0,1,0.0,1.1106915165381966e-05,1.0
38018,acs/Alpha,1,0,1,0.0,1.1106915165381966e-05,1.0
38019,꽃봉오리/Noun,1,0,1,0.0,1.1106915165381966e-05,1.0
38020,승민/Noun,1,1,0,1.1115310228308472e-05,0.0,1.0
38021,날렷/Noun,1,0,1,0.0,1.1106915165381966e-05,1.0
38022,개똥벌레/Noun,1,0,1,0.0,1.1106915165381966e-05,1.0
38023,잌/Noun,1,0,1,0.0,1.1106915165381966e-05,1.0
38024,즐비/Noun,1,0,1,0.0,1.1106915165381966e-05,1.0
38025,해유/Noun,1,1,0,1.1115310228308472e-05,0.0,1.0
38026,류야옵빠/Noun,1,1,0,1.1115310228308472e-05,0.0,1.0
38027,쯔럽/Noun,1,0,1,0.0,1.1106915165381966e-05,1.0
38028,부꾸럽다/Noun,1,0,1,0.0,1.1106915165381966e-05,1.0
38029,업슫/Noun,1,0,1,0.0,1.1106915165381966e-05,1.0
38030,주고보다니/Foreign,1,0,1,0.0,1.1106915165381966e-05,1.0
38031,욕울/Noun,1,0,1,0.0,1.1106915165381966e-05,1.0
38032,개스비/Noun,1,0,1,0.0,1.1106915165381966e-05,1.0
38033,만남았네요/Foreign,1,1,0,1.1115310228308472e-05,0.0,1.0
38034,bacause/Alpha,1,1,0,1.1115310228308472e-05,0.0,1.0
38035,FPS/Alpha,1,1,0,1.1115310228308472e-05,0.0,1.0
38036,쯔레/Noun,1,0,1,0.0,1.1106915165381966e-05,1.0
38037,원금/Noun,1,0,1,0.0,1.1106915165381966e-05,1.0
38038,낫더/Noun,1,0,1,0.0,1.1106915165381966e-05,1.0
38039,정성화/Noun,1,1,0,1.1115310228308472e-05,0.0,1.0
38040,사이더/Noun,1,1,0,1.1115310228308472e-05,0.0,1.0
38041,수거/Noun,1,1,0,1.1115310228308472e-05,0.0,1.0
38042,시지에비/Noun,1,0,1,0.0,1.1106915165381966e-05,1.0
38043,몰두/Noun,1,0,1,0.0,1.1106915165381966e-05,1.0
38044,!!/Foreign,1,1,0,1.1115310228308472e-05,0.0,1.0
38045,평펑/Noun,1,1,0,1.1115310228308472e-05,0.0,1.0
38046,좆문/Noun,1,0,1,0.0,1.1106915165381966e-05,1.0
38047,장혀기/Noun,1,1,0,1.1115310228308472e-05,0.0,1.0
38048,삘이랄까/Noun,1,1,0,1.1115310228308472e-05,0.0,1.0
38049,주오/Noun,1,0,1,0.0,1.1106915165381966e-05,1.0
38050,'_^/Punctuation,1,1,0,1.1115310228308472e-05,0.0,1.0
38051,커스터/Noun,1,1,0,1.1115310228308472e-05,0.0,1.0
38052,워랜/Noun,1,1,0,1.1115310228308472e-05,0.0,1.0
38053,스눕/Noun,1,1,0,1.1115310228308472e-05,0.0,1.0
38054,뽀나수/Noun,1,1,0,1.1115310228308472e-05,0.0,1.0
38055,쪼릿/Noun,1,1,0,1.1115310228308472e-05,0.0,1.0
38056,알콩달/Noun,1,1,0,1.1115310228308472e-05,0.0,1.0
38057,압니다제/Noun,1,1,0,1.1115310228308472e-05,0.0,1.0
38058,두드러기/Noun,1,1,0,1.1115310228308472e-05,0.0,1.0
38059,택했던/Noun,1,1,0,1.1115310228308472e-05,0.0,1.0
38060,정죄감/Noun,1,1,0,1.1115310228308472e-05,0.0,1.0
38061,사령/Noun,1,1,0,1.1115310228308472e-05,0.0,1.0
38062,대반/Noun,1,0,1,0.0,1.1106915165381966e-05,1.0
38063,스톡/Noun,1,0,1,0.0,1.1106915165381966e-05,1.0
38064,뿌뜻함/Noun,1,1,0,1.1115310228308472e-05,0.0,1.0
38065,♥♥♥♥♥♥♥♥♥♥♥♥♥♥♥/Foreign,1,1,0,1.1115310228308472e-05,0.0,1.0
38066,헌혈/Noun,1,0,1,0.0,1.1106915165381966e-05,1.0
38067,수혈/Noun,1,0,1,0.0,1.1106915165381966e-05,1.0
38068,토니콜렛/Noun,1,0,1,0.0,1.1106915165381966e-05,1.0
38069,ppp784512@naver.com/Email,1,1,0,1.1115310228308472e-05,0.0,1.0
38070,낚시터/Noun,1,0,1,0.0,1.1106915165381966e-05,1.0
38071,훌룡해/Noun,1,1,0,1.1115310228308472e-05,0.0,1.0
38072,khkk/Alpha,1,0,1,0.0,1.1106915165381966e-05,1.0
38073,도인데/Foreign,1,0,1,0.0,1.1106915165381966e-05,1.0
38074,게이코/Noun,1,1,0,1.1115310228308472e-05,0.0,1.0
38075,용일/Noun,1,0,1,0.0,1.1106915165381966e-05,1.0
38076,ㄷㄸ/KoreanParticle,1,1,0,1.1115310228308472e-05,0.0,1.0
38077,성작/Noun,1,0,1,0.0,1.1106915165381966e-05,1.0
38078,양적/Noun,1,0,1,0.0,1.1106915165381966e-05,1.0
38079,레임/Noun,1,0,1,0.0,1.1106915165381966e-05,1.0
38080,만에왔습네다/Foreign,1,0,1,0.0,1.1106915165381966e-05,1.0
38081,경선/Noun,1,1,0,1.1115310228308472e-05,0.0,1.0
38082,진중/Noun,1,0,1,0.0,1.1106915165381966e-05,1.0
38083,도생/Noun,1,0,1,0.0,1.1106915165381966e-05,1.0
38084,나넬/Noun,1,1,0,1.1115310228308472e-05,0.0,1.0
38085,목불/Noun,1,0,1,0.0,1.1106915165381966e-05,1.0
38086,9.14/Number,1,0,1,0.0,1.1106915165381966e-05,1.0
38087,우웩우웩/Noun,1,0,1,0.0,1.1106915165381966e-05,1.0
38088,차피/Noun,1,1,0,1.1115310228308472e-05,0.0,1.0
38089,미술선생님/Noun,1,1,0,1.1115310228308472e-05,0.0,1.0
38090,물욕/Noun,1,1,0,1.1115310228308472e-05,0.0,1.0
38091,돈앞/Noun,1,1,0,1.1115310228308472e-05,0.0,1.0
38092,정닥할/Noun,1,1,0,1.1115310228308472e-05,0.0,1.0
38093,28500/Number,1,0,1,0.0,1.1106915165381966e-05,1.0
38094,넨트/Noun,1,1,0,1.1115310228308472e-05,0.0,1.0
38095,긍극적/Noun,1,0,1,0.0,1.1106915165381966e-05,1.0
38096,비누방울/Noun,1,1,0,1.1115310228308472e-05,0.0,1.0
38097,요르단/Noun,1,0,1,0.0,1.1106915165381966e-05,1.0
38098,소비재/Noun,1,0,1,0.0,1.1106915165381966e-05,1.0
38099,ㅂㅅㄷㅇ/KoreanParticle,1,0,1,0.0,1.1106915165381966e-05,1.0
38100,....^_^/Punctuation,1,1,0,1.1115310228308472e-05,0.0,1.0
38101,꿀잼졸잼/Noun,1,1,0,1.1115310228308472e-05,0.0,1.0
38102,볼뽀뽀/Noun,1,1,0,1.1115310228308472e-05,0.0,1.0
38103,싸움개/Noun,1,0,1,0.0,1.1106915165381966e-05,1.0
38104,전꺼라서/Foreign,1,0,1,0.0,1.1106915165381966e-05,1.0
38105,craziest/Alpha,1,1,0,1.1115310228308472e-05,0.0,1.0
38106,wildest/Alpha,1,1,0,1.1115310228308472e-05,0.0,1.0
38107,badass/Alpha,1,1,0,1.1115310228308472e-05,0.0,1.0
38108,goddamn/Alpha,1,1,0,1.1115310228308472e-05,0.0,1.0
38109,완젼완젼/Noun,1,1,0,1.1115310228308472e-05,0.0,1.0
38110,난치성질환/Noun,1,0,1,0.0,1.1106915165381966e-05,1.0
38111,shiva/Alpha,1,0,1,0.0,1.1106915165381966e-05,1.0
38112,히히힛히힛/Noun,1,0,1,0.0,1.1106915165381966e-05,1.0
38113,막발/Noun,1,1,0,1.1115310228308472e-05,0.0,1.0
38114,에테르/Noun,1,0,1,0.0,1.1106915165381966e-05,1.0
38115,프리랜서/Noun,1,1,0,1.1115310228308472e-05,0.0,1.0
38116,ㄴㅁ/KoreanParticle,1,0,1,0.0,1.1106915165381966e-05,1.0
38117,zone/Alpha,1,0,1,0.0,1.1106915165381966e-05,1.0
38118,twilight/Alpha,1,0,1,0.0,1.1106915165381966e-05,1.0
38119,베릴/Noun,1,0,1,0.0,1.1106915165381966e-05,1.0
38120,아양/Noun,1,1,0,1.1115310228308472e-05,0.0,1.0
38121,싱하횽/Noun,1,1,0,1.1115310228308472e-05,0.0,1.0
38122,limitation/Alpha,1,1,0,1.1115310228308472e-05,0.0,1.0
38123,should/Alpha,1,1,0,1.1115310228308472e-05,0.0,1.0
38124,요재지이/Noun,1,1,0,1.1115310228308472e-05,0.0,1.0
38125,포송령/Noun,1,1,0,1.1115310228308472e-05,0.0,1.0
38126,화벽/Noun,1,1,0,1.1115310228308472e-05,0.0,1.0
38127,삼지/Noun,1,0,1,0.0,1.1106915165381966e-05,1.0
38128,교문/Noun,1,0,1,0.0,1.1106915165381966e-05,1.0
38129,달뒤/Noun,1,1,0,1.1115310228308472e-05,0.0,1.0
38130,벅찬드/Noun,1,0,1,0.0,1.1106915165381966e-05,1.0
38131,막글/Noun,1,1,0,1.1115310228308472e-05,0.0,1.0
38132,Miracle/Alpha,1,1,0,1.1115310228308472e-05,0.0,1.0
38133,스키조/Noun,1,1,0,1.1115310228308472e-05,0.0,1.0
38134,봐야햐/Noun,1,1,0,1.1115310228308472e-05,0.0,1.0
38135,랜즈/Noun,1,0,1,0.0,1.1106915165381966e-05,1.0
38136,6500원/Number,1,1,0,1.1115310228308472e-05,0.0,1.0
38137,96분/Number,1,1,0,1.1115310228308472e-05,0.0,1.0
38138,움추림/Noun,1,1,0,1.1115310228308472e-05,0.0,1.0
38139,발칸반도/Noun,1,1,0,1.1115310228308472e-05,0.0,1.0
38140,어쩌니마/Noun,1,1,0,1.1115310228308472e-05,0.0,1.0
38141,짜져/Noun,1,0,1,0.0,1.1106915165381966e-05,1.0
38142,프리지아/Noun,1,1,0,1.1115310228308472e-05,0.0,1.0
38143,준군/Noun,1,1,0,1.1115310228308472e-05,0.0,1.0
38144,명동역/Noun,1,1,0,1.1115310228308472e-05,0.0,1.0
38145,버나뎃/Noun,1,1,0,1.1115310228308472e-05,0.0,1.0
38146,loser/Alpha,1,0,1,0.0,1.1106915165381966e-05,1.0
38147,무고죄/Noun,1,0,1,0.0,1.1106915165381966e-05,1.0
38148,뱀술/Noun,1,0,1,0.0,1.1106915165381966e-05,1.0
38149,광분/Noun,1,1,0,1.1115310228308472e-05,0.0,1.0
38150,Technicolor/Alpha,1,1,0,1.1115310228308472e-05,0.0,1.0
38151,coldplay/Alpha,1,1,0,1.1115310228308472e-05,0.0,1.0
38152,청중/Noun,1,0,1,0.0,1.1106915165381966e-05,1.0
38153,스트래스/Noun,1,0,1,0.0,1.1106915165381966e-05,1.0
38154,차칸남자/Noun,1,0,1,0.0,1.1106915165381966e-05,1.0
38155,1~2회/Number,1,0,1,0.0,1.1106915165381966e-05,1.0
38156,01410/Number,1,1,0,1.1115310228308472e-05,0.0,1.0
38157,바야흐로/Noun,1,1,0,1.1115310228308472e-05,0.0,1.0
38158,꽃힌다/Noun,1,1,0,1.1115310228308472e-05,0.0,1.0
38159,정착/Noun,1,1,0,1.1115310228308472e-05,0.0,1.0
38160,와쓰/Noun,1,0,1,0.0,1.1106915165381966e-05,1.0
38161,알레스/Noun,1,1,0,1.1115310228308472e-05,0.0,1.0
38162,이첨/Noun,1,1,0,1.1115310228308472e-05,0.0,1.0
38163,왕쒸레기/Noun,1,0,1,0.0,1.1106915165381966e-05,1.0
38164,쒸레기삘/Noun,1,0,1,0.0,1.1106915165381966e-05,1.0
38165,야마모토/Noun,1,1,0,1.1115310228308472e-05,0.0,1.0
38166,도쿄타워/Noun,1,0,1,0.0,1.1106915165381966e-05,1.0
38167,때타/Noun,1,0,1,0.0,1.1106915165381966e-05,1.0
38168,작이라는/Foreign,1,1,0,1.1115310228308472e-05,0.0,1.0
38169,1921년/Number,1,1,0,1.1115310228308472e-05,0.0,1.0
38170,배아픔/Noun,1,1,0,1.1115310228308472e-05,0.0,1.0
38171,44분/Number,1,0,1,0.0,1.1106915165381966e-05,1.0
38172,"....,....,/Punctuation",1,0,1,0.0,1.1106915165381966e-05,1.0
38173,사소/Noun,1,0,1,0.0,1.1106915165381966e-05,1.0
38174,겄다/Noun,1,0,1,0.0,1.1106915165381966e-05,1.0
38175,옆반/Noun,1,1,0,1.1115310228308472e-05,0.0,1.0
38176,김희연/Noun,1,1,0,1.1115310228308472e-05,0.0,1.0
38177,민병훈/Noun,1,1,0,1.1115310228308472e-05,0.0,1.0
38178,michin/Alpha,1,0,1,0.0,1.1106915165381966e-05,1.0
38179,녀란거/Noun,1,0,1,0.0,1.1106915165381966e-05,1.0
38180,나수윤/Noun,1,0,1,0.0,1.1106915165381966e-05,1.0
38181,회색도시/Noun,1,1,0,1.1115310228308472e-05,0.0,1.0
38182,앙앙/Adverb,1,1,0,1.1115310228308472e-05,0.0,1.0
38183,反/Foreign,1,0,1,0.0,1.1106915165381966e-05,1.0
38184,전치/Noun,1,0,1,0.0,1.1106915165381966e-05,1.0
38185,황상/Noun,1,0,1,0.0,1.1106915165381966e-05,1.0
38186,선주/Noun,1,0,1,0.0,1.1106915165381966e-05,1.0
38187,키애누/Noun,1,1,0,1.1115310228308472e-05,0.0,1.0
38188,불은/Foreign,1,0,1,0.0,1.1106915165381966e-05,1.0
38189,점피/Noun,1,0,1,0.0,1.1106915165381966e-05,1.0
38190,"-,-?/Punctuation",1,0,1,0.0,1.1106915165381966e-05,1.0
38191,뻐나/Noun,1,0,1,0.0,1.1106915165381966e-05,1.0
38192,ㅛㄴ/KoreanParticle,1,1,0,1.1115310228308472e-05,0.0,1.0
38193,르바쉐르/Noun,1,0,1,0.0,1.1106915165381966e-05,1.0
38194,아츠시/Noun,1,1,0,1.1115310228308472e-05,0.0,1.0
38195,욷랒루달너쥬핮/Noun,1,0,1,0.0,1.1106915165381966e-05,1.0
38196,정밓/Noun,1,0,1,0.0,1.1106915165381966e-05,1.0
38197,^^;;;;;/Punctuation,1,0,1,0.0,1.1106915165381966e-05,1.0
38198,....(>_/Punctuation,1,0,1,0.0,1.1106915165381966e-05,1.0
38199,무조음악/Noun,1,0,1,0.0,1.1106915165381966e-05,1.0
38200,2억달러/Number,1,1,0,1.1115310228308472e-05,0.0,1.0
38201,천운/Noun,1,1,0,1.1115310228308472e-05,0.0,1.0
38202,징집/Noun,1,1,0,1.1115310228308472e-05,0.0,1.0
38203,실몽/Noun,1,0,1,0.0,1.1106915165381966e-05,1.0
38204,부좀/Noun,1,0,1,0.0,1.1106915165381966e-05,1.0
38205,club/Alpha,1,0,1,0.0,1.1106915165381966e-05,1.0
38206,Glee/Alpha,1,0,1,0.0,1.1106915165381966e-05,1.0
38207,방출/Noun,1,0,1,0.0,1.1106915165381966e-05,1.0
38208,dlwhdrnjs/Alpha,1,1,0,1.1115310228308472e-05,0.0,1.0
38209,햇엇능데/Noun,1,0,1,0.0,1.1106915165381966e-05,1.0
38210,다음해/Noun,1,1,0,1.1115310228308472e-05,0.0,1.0
38211,파티원/Noun,1,1,0,1.1115310228308472e-05,0.0,1.0
38212,장외룡/Noun,1,1,0,1.1115310228308472e-05,0.0,1.0
38213,허정무/Noun,1,1,0,1.1115310228308472e-05,0.0,1.0
38214,정의당/Noun,1,1,0,1.1115310228308472e-05,0.0,1.0
38215,통진당/Noun,1,1,0,1.1115310228308472e-05,0.0,1.0
38216,폭렬하/Noun,1,0,1,0.0,1.1106915165381966e-05,1.0
38217,폭렬/Noun,1,0,1,0.0,1.1106915165381966e-05,1.0
38218,비축/Noun,1,1,0,1.1115310228308472e-05,0.0,1.0
38219,다크월드/Noun,1,0,1,0.0,1.1106915165381966e-05,1.0
38220,창조경제/Noun,1,0,1,0.0,1.1106915165381966e-05,1.0
38221,리창/Noun,1,0,1,0.0,1.1106915165381966e-05,1.0
38222,일자/Noun,1,0,1,0.0,1.1106915165381966e-05,1.0
38223,홈런왕/Noun,1,1,0,1.1115310228308472e-05,0.0,1.0
38224,Fhjkkdrybb/Alpha,1,1,0,1.1115310228308472e-05,0.0,1.0
38225,까지만이라도/Josa,1,1,0,1.1115310228308472e-05,0.0,1.0
38226,샌안드레아스/Noun,1,1,0,1.1115310228308472e-05,0.0,1.0
38227,woaldlTek/Alpha,1,1,0,1.1115310228308472e-05,0.0,1.0
38228,sja/Alpha,1,1,0,1.1115310228308472e-05,0.0,1.0
38229,이주하/Noun,1,0,1,0.0,1.1106915165381966e-05,1.0
38230,1025/Number,1,1,0,1.1115310228308472e-05,0.0,1.0
38231,shock/Alpha,1,1,0,1.1115310228308472e-05,0.0,1.0
38232,무소/Noun,1,1,0,1.1115310228308472e-05,0.0,1.0
38233,라이투미/Noun,1,0,1,0.0,1.1106915165381966e-05,1.0
38234,솔져스/Noun,1,0,1,0.0,1.1106915165381966e-05,1.0
38235,빛낼/Noun,1,1,0,1.1115310228308472e-05,0.0,1.0
38236,봑/Noun,1,1,0,1.1115310228308472e-05,0.0,1.0
38237,더괜/Noun,1,1,0,1.1115310228308472e-05,0.0,1.0
38238,달랏/Noun,1,1,0,1.1115310228308472e-05,0.0,1.0
38239,하랬/Noun,1,0,1,0.0,1.1106915165381966e-05,1.0
38240,재난씬/Noun,1,1,0,1.1115310228308472e-05,0.0,1.0
38241,보지므/Noun,1,0,1,0.0,1.1106915165381966e-05,1.0
38242,교미/Noun,1,1,0,1.1115310228308472e-05,0.0,1.0
38243,리쳐드/Noun,1,1,0,1.1115310228308472e-05,0.0,1.0
38244,때전/Noun,1,1,0,1.1115310228308472e-05,0.0,1.0
38245,....?!!!!/Punctuation,1,0,1,0.0,1.1106915165381966e-05,1.0
38246,준렐루/Noun,1,1,0,1.1115310228308472e-05,0.0,1.0
38247,봤나/Foreign,1,0,1,0.0,1.1106915165381966e-05,1.0
38248,스웨인/Noun,1,1,0,1.1115310228308472e-05,0.0,1.0
38249,도미니카/Noun,1,1,0,1.1115310228308472e-05,0.0,1.0
38250,이나끌고앉았음/Foreign,1,0,1,0.0,1.1106915165381966e-05,1.0
38251,입관/Noun,1,1,0,1.1115310228308472e-05,0.0,1.0
38252,렘버트/Noun,1,0,1,0.0,1.1106915165381966e-05,1.0
38253,거볼돈/Noun,1,0,1,0.0,1.1106915165381966e-05,1.0
38254,"450,000원/Number",1,1,0,1.1115310228308472e-05,0.0,1.0
38255,카즈/Noun,1,1,0,1.1115310228308472e-05,0.0,1.0
38256,드라마/Foreign,1,0,1,0.0,1.1106915165381966e-05,1.0
38257,방직/Noun,1,1,0,1.1115310228308472e-05,0.0,1.0
38258,=++/Punctuation,1,0,1,0.0,1.1106915165381966e-05,1.0
38259,..=/Punctuation,1,0,1,0.0,1.1106915165381966e-05,1.0
38260,줌질/Noun,1,0,1,0.0,1.1106915165381966e-05,1.0
38261,뉴논/Noun,1,1,0,1.1115310228308472e-05,0.0,1.0
38262,대말/Foreign,1,0,1,0.0,1.1106915165381966e-05,1.0
38263,의족/Noun,1,0,1,0.0,1.1106915165381966e-05,1.0
38264,가로수길/Noun,1,0,1,0.0,1.1106915165381966e-05,1.0
38265,강남구/Noun,1,0,1,0.0,1.1106915165381966e-05,1.0
38266,파두콘/Noun,1,1,0,1.1115310228308472e-05,0.0,1.0
38267,소랍/Noun,1,1,0,1.1115310228308472e-05,0.0,1.0
38268,왕자웨이/Noun,1,0,1,0.0,1.1106915165381966e-05,1.0
38269,6-6/Number,1,1,0,1.1115310228308472e-05,0.0,1.0
38270,초반에/Foreign,1,0,1,0.0,1.1106915165381966e-05,1.0
38271,Jot/Alpha,1,1,0,1.1115310228308472e-05,0.0,1.0
38272,꼴라쥬/Noun,1,0,1,0.0,1.1106915165381966e-05,1.0
38273,꺠닫/Noun,1,1,0,1.1115310228308472e-05,0.0,1.0
38274,심등/Noun,1,1,0,1.1115310228308472e-05,0.0,1.0
38275,왓다갓다하/Noun,1,0,1,0.0,1.1106915165381966e-05,1.0
38276,찟저/Noun,1,0,1,0.0,1.1106915165381966e-05,1.0
38277,.........................................................../Punctuation,1,0,1,0.0,1.1106915165381966e-05,1.0
38278,Away/Alpha,1,1,0,1.1115310228308472e-05,0.0,1.0
38279,크리딧/Noun,1,1,0,1.1115310228308472e-05,0.0,1.0
38280,하얘지다/Verb,1,1,0,1.1115310228308472e-05,0.0,1.0
38281,http://m.blog.naver.com/g0ng_system/220085705967/URL,1,0,1,0.0,1.1106915165381966e-05,1.0
38282,석류/Noun,1,1,0,1.1115310228308472e-05,0.0,1.0
38283,그닥있/Noun,1,0,1,0.0,1.1106915165381966e-05,1.0
38284,?&/Punctuation,1,1,0,1.1115310228308472e-05,0.0,1.0
38285,빅쇼/Noun,1,1,0,1.1115310228308472e-05,0.0,1.0
38286,맥시멈/Noun,1,1,0,1.1115310228308472e-05,0.0,1.0
38287,차승민/Noun,1,1,0,1.1115310228308472e-05,0.0,1.0
38288,롸져/Noun,1,0,1,0.0,1.1106915165381966e-05,1.0
38289,나몀/Noun,1,1,0,1.1115310228308472e-05,0.0,1.0
38290,수준별/Noun,1,0,1,0.0,1.1106915165381966e-05,1.0
38291,줬슴/Noun,1,0,1,0.0,1.1106915165381966e-05,1.0
38292,날렷어/Noun,1,0,1,0.0,1.1106915165381966e-05,1.0
38293,리처드슨/Noun,1,1,0,1.1115310228308472e-05,0.0,1.0
38294,Walker/Alpha,1,1,0,1.1115310228308472e-05,0.0,1.0
38295,Paul/Alpha,1,1,0,1.1115310228308472e-05,0.0,1.0
38296,See/Alpha,1,1,0,1.1115310228308472e-05,0.0,1.0
38297,점술/Noun,1,0,1,0.0,1.1106915165381966e-05,1.0
38298,몆년쉬다/Noun,1,0,1,0.0,1.1106915165381966e-05,1.0
38299,오마이갇/Noun,1,1,0,1.1115310228308472e-05,0.0,1.0
38300,녈/Noun,1,1,0,1.1115310228308472e-05,0.0,1.0
38301,최제우/Noun,1,1,0,1.1115310228308472e-05,0.0,1.0
38302,수운/Noun,1,1,0,1.1115310228308472e-05,0.0,1.0
38303,1709/Number,1,1,0,1.1115310228308472e-05,0.0,1.0
38304,소임/Noun,1,0,1,0.0,1.1106915165381966e-05,1.0
38305,도늘/Noun,1,0,1,0.0,1.1106915165381966e-05,1.0
38306,코레일/Noun,1,0,1,0.0,1.1106915165381966e-05,1.0
38307,왜결제했냐고/Foreign,1,0,1,0.0,1.1106915165381966e-05,1.0
38308,무화과나무/Noun,1,1,0,1.1115310228308472e-05,0.0,1.0
38309,황유정/Noun,1,1,0,1.1115310228308472e-05,0.0,1.0
38310,당계례/Noun,1,1,0,1.1115310228308472e-05,0.0,1.0
38311,롸우/Noun,1,1,0,1.1115310228308472e-05,0.0,1.0
38312,양녕대군/Noun,1,1,0,1.1115310228308472e-05,0.0,1.0
38313,부남자/Noun,1,1,0,1.1115310228308472e-05,0.0,1.0
38314,버켓/Noun,1,1,0,1.1115310228308472e-05,0.0,1.0
38315,부터는얘기도겉돌고잼없다는소리만있는데작가만모르시나/Foreign,1,0,1,0.0,1.1106915165381966e-05,1.0
38316,은평점도좋고재밌다는말이많은데/Foreign,1,0,1,0.0,1.1106915165381966e-05,1.0
38317,롤러브레이드/Noun,1,0,1,0.0,1.1106915165381966e-05,1.0
38318,rfdsfdsfsdfdsf/Alpha,1,0,1,0.0,1.1106915165381966e-05,1.0
38319,켄타/Noun,1,1,0,1.1115310228308472e-05,0.0,1.0
38320,드로곤볼/Noun,1,0,1,0.0,1.1106915165381966e-05,1.0
38321,뻐히/Noun,1,0,1,0.0,1.1106915165381966e-05,1.0
38322,뭐길레/Noun,1,0,1,0.0,1.1106915165381966e-05,1.0
38323,파펙트/Noun,1,1,0,1.1115310228308472e-05,0.0,1.0
38324,왕석현/Noun,1,1,0,1.1115310228308472e-05,0.0,1.0
38325,아리까리/Adverb,1,0,1,0.0,1.1106915165381966e-05,1.0
38326,역할극/Noun,1,1,0,1.1115310228308472e-05,0.0,1.0
38327,ddd/Alpha,1,0,1,0.0,1.1106915165381966e-05,1.0
38328,재미읎/Noun,1,0,1,0.0,1.1106915165381966e-05,1.0
38329,붕괴하다/Adjective,1,0,1,0.0,1.1106915165381966e-05,1.0
38330,서강대/Noun,1,1,0,1.1115310228308472e-05,0.0,1.0
38331,이현주/Noun,1,0,1,0.0,1.1106915165381966e-05,1.0
38332,곽진영/Noun,1,0,1,0.0,1.1106915165381966e-05,1.0
38333,정보화/Noun,1,0,1,0.0,1.1106915165381966e-05,1.0
38334,못햇던/Noun,1,1,0,1.1115310228308472e-05,0.0,1.0
38335,랍니다/Eomi,1,0,1,0.0,1.1106915165381966e-05,1.0
38336,뭣할/Noun,1,0,1,0.0,1.1106915165381966e-05,1.0
38337,권악징선/Noun,1,0,1,0.0,1.1106915165381966e-05,1.0
38338,개작/Noun,1,0,1,0.0,1.1106915165381966e-05,1.0
38339,맺힌/Noun,1,1,0,1.1115310228308472e-05,0.0,1.0
38340,디바이드/Noun,1,1,0,1.1115310228308472e-05,0.0,1.0
38341,필추/Noun,1,1,0,1.1115310228308472e-05,0.0,1.0
38342,중효/Noun,1,1,0,1.1115310228308472e-05,0.0,1.0
38343,축배/Noun,1,1,0,1.1115310228308472e-05,0.0,1.0
38344,!!^.^/Punctuation,1,1,0,1.1115310228308472e-05,0.0,1.0
38345,선반/Noun,1,0,1,0.0,1.1106915165381966e-05,1.0
38346,찍니/Foreign,1,0,1,0.0,1.1106915165381966e-05,1.0
38347,물겄/Noun,1,0,1,0.0,1.1106915165381966e-05,1.0
38348,짯다/Noun,1,1,0,1.1115310228308472e-05,0.0,1.0
38349,좊아/Noun,1,0,1,0.0,1.1106915165381966e-05,1.0
38350,완재/Noun,1,1,0,1.1115310228308472e-05,0.0,1.0
38351,횽아/Noun,1,1,0,1.1115310228308472e-05,0.0,1.0
38352,송주호/Noun,1,1,0,1.1115310228308472e-05,0.0,1.0
38353,신성현/Noun,1,1,0,1.1115310228308472e-05,0.0,1.0
38354,ㅅㅂㅅㅋ/KoreanParticle,1,1,0,1.1115310228308472e-05,0.0,1.0
38355,점핑/Noun,1,1,0,1.1115310228308472e-05,0.0,1.0
38356,;;............................/Punctuation,1,0,1,0.0,1.1106915165381966e-05,1.0
38357,?;;;;;/Punctuation,1,0,1,0.0,1.1106915165381966e-05,1.0
38358,만든느/Noun,1,0,1,0.0,1.1106915165381966e-05,1.0
38359,유전체/Noun,1,1,0,1.1115310228308472e-05,0.0,1.0
38360,7.52/Number,1,1,0,1.1115310228308472e-05,0.0,1.0
38361,수바/Noun,1,0,1,0.0,1.1106915165381966e-05,1.0
38362,기뻣다/Noun,1,0,1,0.0,1.1106915165381966e-05,1.0
38363,오데사/Noun,1,0,1,0.0,1.1106915165381966e-05,1.0
38364,닥터프로스트/Noun,1,1,0,1.1115310228308472e-05,0.0,1.0
38365,단방/Noun,1,1,0,1.1115310228308472e-05,0.0,1.0
38366,쭁/Noun,1,1,0,1.1115310228308472e-05,0.0,1.0
38367,게스트하우스/Noun,1,0,1,0.0,1.1106915165381966e-05,1.0
38368,청과/Noun,1,1,0,1.1115310228308472e-05,0.0,1.0
38369,26.4%/Number,1,1,0,1.1115310228308472e-05,0.0,1.0
38370,독재정치/Noun,1,0,1,0.0,1.1106915165381966e-05,1.0
38371,7.70/Number,1,0,1,0.0,1.1106915165381966e-05,1.0
38372,waltz/Alpha,1,1,0,1.1115310228308472e-05,0.0,1.0
38373,psychedelico/Alpha,1,1,0,1.1115310228308472e-05,0.0,1.0
38374,개떼/Noun,1,1,0,1.1115310228308472e-05,0.0,1.0
38375,내니맥피/Noun,1,1,0,1.1115310228308472e-05,0.0,1.0
38376,곽씨/Noun,1,0,1,0.0,1.1106915165381966e-05,1.0
38377,0.33/Number,1,0,1,0.0,1.1106915165381966e-05,1.0
38378,더문/Noun,1,0,1,0.0,1.1106915165381966e-05,1.0
38379,짅자/Noun,1,1,0,1.1115310228308472e-05,0.0,1.0
38380,이누이트/Noun,1,1,0,1.1115310228308472e-05,0.0,1.0
38381,맹글었/Noun,1,0,1,0.0,1.1106915165381966e-05,1.0
38382,BESTOFBEST/Alpha,1,1,0,1.1115310228308472e-05,0.0,1.0
38383,맹맛/Noun,1,0,1,0.0,1.1106915165381966e-05,1.0
38384,괜사/Noun,1,1,0,1.1115310228308472e-05,0.0,1.0
38385,환복/Noun,1,1,0,1.1115310228308472e-05,0.0,1.0
38386,김규남/Noun,1,1,0,1.1115310228308472e-05,0.0,1.0
38387,아빠뻘/Noun,1,0,1,0.0,1.1106915165381966e-05,1.0
38388,함의/Noun,1,1,0,1.1115310228308472e-05,0.0,1.0
38389,IF/Alpha,1,1,0,1.1115310228308472e-05,0.0,1.0
38390,반까지/Foreign,1,1,0,1.1115310228308472e-05,0.0,1.0
38391,어섬/Noun,1,0,1,0.0,1.1106915165381966e-05,1.0
38392,링스/Noun,1,0,1,0.0,1.1106915165381966e-05,1.0
38393,라디에이터/Noun,1,0,1,0.0,1.1106915165381966e-05,1.0
38394,베네룩스/Noun,1,0,1,0.0,1.1106915165381966e-05,1.0
38395,파푸아뉴기니/Noun,1,0,1,0.0,1.1106915165381966e-05,1.0
38396,2~30%/Number,1,1,0,1.1115310228308472e-05,0.0,1.0
38397,천사처럼/Noun,1,1,0,1.1115310228308472e-05,0.0,1.0
38398,석판/Noun,1,1,0,1.1115310228308472e-05,0.0,1.0
38399,ㅈㄷㄹ/KoreanParticle,1,0,1,0.0,1.1106915165381966e-05,1.0
38400,대급/Foreign,1,0,1,0.0,1.1106915165381966e-05,1.0
38401,ㅆㄷㄱ/KoreanParticle,1,0,1,0.0,1.1106915165381966e-05,1.0
38402,김국환/Noun,1,1,0,1.1115310228308472e-05,0.0,1.0
38403,젠장맞을/Noun,1,0,1,0.0,1.1106915165381966e-05,1.0
38404,의병/Noun,1,0,1,0.0,1.1106915165381966e-05,1.0
38405,의기양양하다/Adjective,1,0,1,0.0,1.1106915165381966e-05,1.0
38406,구원파/Noun,1,1,0,1.1115310228308472e-05,0.0,1.0
38407,ㅛㅜㅅ/KoreanParticle,1,1,0,1.1115310228308472e-05,0.0,1.0
38408,ㅛㅜ/KoreanParticle,1,1,0,1.1115310228308472e-05,0.0,1.0
38409,남캐/Noun,1,1,0,1.1115310228308472e-05,0.0,1.0
38410,송수/Noun,1,1,0,1.1115310228308472e-05,0.0,1.0
38411,완자/Noun,1,1,0,1.1115310228308472e-05,0.0,1.0
38412,이별여행/Noun,1,0,1,0.0,1.1106915165381966e-05,1.0
38413,리두/Noun,1,0,1,0.0,1.1106915165381966e-05,1.0
38414,롤리타/Noun,1,1,0,1.1115310228308472e-05,0.0,1.0
38415,만이라/Foreign,1,1,0,1.1115310228308472e-05,0.0,1.0
38416,스타특랙/Noun,1,0,1,0.0,1.1106915165381966e-05,1.0
38417,도오/Noun,1,0,1,0.0,1.1106915165381966e-05,1.0
38418,라임스/Noun,1,0,1,0.0,1.1106915165381966e-05,1.0
38419,뫁/Noun,1,1,0,1.1115310228308472e-05,0.0,1.0
38420,또머/Noun,1,1,0,1.1115310228308472e-05,0.0,1.0
38421,캐더/Noun,1,0,1,0.0,1.1106915165381966e-05,1.0
38422,!-_-/Punctuation,1,0,1,0.0,1.1106915165381966e-05,1.0
38423,슈발름/Noun,1,0,1,0.0,1.1106915165381966e-05,1.0
38424,중호/Noun,1,1,0,1.1115310228308472e-05,0.0,1.0
38425,쩜니/Noun,1,0,1,0.0,1.1106915165381966e-05,1.0
38426,김민지/Noun,1,1,0,1.1115310228308472e-05,0.0,1.0
38427,레얼/Noun,1,0,1,0.0,1.1106915165381966e-05,1.0
38428,:@!?./Punctuation,1,1,0,1.1115310228308472e-05,0.0,1.0
38429,VHS/Alpha,1,1,0,1.1115310228308472e-05,0.0,1.0
38430,조고/Noun,1,1,0,1.1115310228308472e-05,0.0,1.0
38431,반니/Noun,1,1,0,1.1115310228308472e-05,0.0,1.0
38432,섵/Noun,1,0,1,0.0,1.1106915165381966e-05,1.0
38433,전영화란걸/Foreign,1,1,0,1.1115310228308472e-05,0.0,1.0
38434,고차/Noun,1,1,0,1.1115310228308472e-05,0.0,1.0
38435,첨이엇음/Noun,1,1,0,1.1115310228308472e-05,0.0,1.0
38436,갠소/Noun,1,1,0,1.1115310228308472e-05,0.0,1.0
38437,케랑/Noun,1,1,0,1.1115310228308472e-05,0.0,1.0
38438,"...,...,/Punctuation",1,1,0,1.1115310228308472e-05,0.0,1.0
38439,`~!!!/Punctuation,1,1,0,1.1115310228308472e-05,0.0,1.0
38440,표절논란/Noun,1,0,1,0.0,1.1106915165381966e-05,1.0
38441,"~~~!!!,/Punctuation",1,1,0,1.1115310228308472e-05,0.0,1.0
38442,겨누던/Noun,1,1,0,1.1115310228308472e-05,0.0,1.0
38443,빰치냉/Noun,1,1,0,1.1115310228308472e-05,0.0,1.0
38444,폴바/Noun,1,0,1,0.0,1.1106915165381966e-05,1.0
38445,교우/Noun,1,1,0,1.1115310228308472e-05,0.0,1.0
38446,일욜날/Noun,1,1,0,1.1115310228308472e-05,0.0,1.0
38447,배배꼬았다/Noun,1,0,1,0.0,1.1106915165381966e-05,1.0
38448,전이래/Foreign,1,0,1,0.0,1.1106915165381966e-05,1.0
38449,분녀/Noun,1,0,1,0.0,1.1106915165381966e-05,1.0
38450,양갈래/Noun,1,0,1,0.0,1.1106915165381966e-05,1.0
38451,크드/Noun,1,0,1,0.0,1.1106915165381966e-05,1.0
38452,퍼펙/Noun,1,1,0,1.1115310228308472e-05,0.0,1.0
38453,직역/Noun,1,0,1,0.0,1.1106915165381966e-05,1.0
38454,김규태/Noun,1,1,0,1.1115310228308472e-05,0.0,1.0
38455,아카기/Noun,1,1,0,1.1115310228308472e-05,0.0,1.0
38456,62/Number,1,0,1,0.0,1.1106915165381966e-05,1.0
38457,훨배더/Noun,1,0,1,0.0,1.1106915165381966e-05,1.0
38458,노땅녀/Noun,1,0,1,0.0,1.1106915165381966e-05,1.0
38459,방산/Noun,1,1,0,1.1115310228308472e-05,0.0,1.0
38460,구소련/Noun,1,1,0,1.1115310228308472e-05,0.0,1.0
38461,구명/Noun,1,0,1,0.0,1.1106915165381966e-05,1.0
38462,항살/Noun,1,1,0,1.1115310228308472e-05,0.0,1.0
38463,비엔날레/Noun,1,1,0,1.1115310228308472e-05,0.0,1.0
38464,고결/Noun,1,1,0,1.1115310228308472e-05,0.0,1.0
38465,젖히다/Verb,1,0,1,0.0,1.1106915165381966e-05,1.0
38466,승준/Noun,1,0,1,0.0,1.1106915165381966e-05,1.0
38467,가봣어/Noun,1,1,0,1.1115310228308472e-05,0.0,1.0
38468,나체씬/Noun,1,0,1,0.0,1.1106915165381966e-05,1.0
38469,완젅/Noun,1,0,1,0.0,1.1106915165381966e-05,1.0
38470,ㅜㅋㅋ/KoreanParticle,1,1,0,1.1115310228308472e-05,0.0,1.0
38471,........................................./Punctuation,1,0,1,0.0,1.1106915165381966e-05,1.0
38472,자알생겻/Noun,1,1,0,1.1115310228308472e-05,0.0,1.0
38473,삼색시/Noun,1,1,0,1.1115310228308472e-05,0.0,1.0
38474,요람/Noun,1,1,0,1.1115310228308472e-05,0.0,1.0
38475,꼭봄/Noun,1,1,0,1.1115310228308472e-05,0.0,1.0
38476,색녀로/Noun,1,0,1,0.0,1.1106915165381966e-05,1.0
38477,르곘/Noun,1,1,0,1.1115310228308472e-05,0.0,1.0
38478,긑/Noun,1,0,1,0.0,1.1106915165381966e-05,1.0
38479,-;;;;;;;/Punctuation,1,0,1,0.0,1.1106915165381966e-05,1.0
38480,브는중/Noun,1,1,0,1.1115310228308472e-05,0.0,1.0
38481,2009.04/Number,1,1,0,1.1115310228308472e-05,0.0,1.0
38482,꺄아아/Noun,1,1,0,1.1115310228308472e-05,0.0,1.0
38483,1.72/Number,1,0,1,0.0,1.1106915165381966e-05,1.0
38484,천해/Noun,1,0,1,0.0,1.1106915165381966e-05,1.0
38485,꿀젬/Noun,1,1,0,1.1115310228308472e-05,0.0,1.0
38486,바꿧음/Noun,1,1,0,1.1115310228308472e-05,0.0,1.0
38487,63회/Number,1,1,0,1.1115310228308472e-05,0.0,1.0
38488,못밑/Noun,1,0,1,0.0,1.1106915165381966e-05,1.0
38489,사마리아인/Noun,1,1,0,1.1115310228308472e-05,0.0,1.0
38490,향돈/Noun,1,0,1,0.0,1.1106915165381966e-05,1.0
38491,쇠뇌/Noun,1,0,1,0.0,1.1106915165381966e-05,1.0
38492,제습기/Noun,1,0,1,0.0,1.1106915165381966e-05,1.0
38493,칸칸이/Noun,1,0,1,0.0,1.1106915165381966e-05,1.0
38494,스스펙트/Noun,1,1,0,1.1115310228308472e-05,0.0,1.0
38495,테렛/Noun,1,0,1,0.0,1.1106915165381966e-05,1.0
38496,크리스타/Noun,1,0,1,0.0,1.1106915165381966e-05,1.0
38497,뽀삿다/Noun,1,0,1,0.0,1.1106915165381966e-05,1.0
38498,생인듯/Foreign,1,0,1,0.0,1.1106915165381966e-05,1.0
38499,1724년/Number,1,0,1,0.0,1.1106915165381966e-05,1.0
38500,영화공주/Noun,1,0,1,0.0,1.1106915165381966e-05,1.0
38501,휘둘/Noun,1,0,1,0.0,1.1106915165381966e-05,1.0
38502,♥♡♥♡♥♡♥♡♥♡♥/Foreign,1,0,1,0.0,1.1106915165381966e-05,1.0
38503,횽님/Noun,1,1,0,1.1115310228308472e-05,0.0,1.0
38504,age/Alpha,1,1,0,1.1115310228308472e-05,0.0,1.0
38505,한코/Noun,1,1,0,1.1115310228308472e-05,0.0,1.0
38506,드엔드/Noun,1,0,1,0.0,1.1106915165381966e-05,1.0
38507,엔드란/Noun,1,0,1,0.0,1.1106915165381966e-05,1.0
38508,신성우/Noun,1,0,1,0.0,1.1106915165381966e-05,1.0
38509,랜트/Noun,1,0,1,0.0,1.1106915165381966e-05,1.0
38510,재닛/Noun,1,1,0,1.1115310228308472e-05,0.0,1.0
38511,때마/Noun,1,1,0,1.1115310228308472e-05,0.0,1.0
38512,이넹/Noun,1,0,1,0.0,1.1106915165381966e-05,1.0
38513,복음서/Noun,1,0,1,0.0,1.1106915165381966e-05,1.0
38514,성흔/Noun,1,0,1,0.0,1.1106915165381966e-05,1.0
38515,헤드락/Noun,1,0,1,0.0,1.1106915165381966e-05,1.0
38516,거북선/Noun,1,0,1,0.0,1.1106915165381966e-05,1.0
38517,DK/Alpha,1,1,0,1.1115310228308472e-05,0.0,1.0
38518,케이캐쉬/Noun,1,0,1,0.0,1.1106915165381966e-05,1.0
38519,YUI/Alpha,1,0,1,0.0,1.1106915165381966e-05,1.0
38520,死死/Foreign,1,0,1,0.0,1.1106915165381966e-05,1.0
38521,콰트로/Noun,1,1,0,1.1115310228308472e-05,0.0,1.0
38522,뜨레스/Noun,1,1,0,1.1115310228308472e-05,0.0,1.0
38523,유관/Noun,1,0,1,0.0,1.1106915165381966e-05,1.0
38524,촉나라/Noun,1,0,1,0.0,1.1106915165381966e-05,1.0
38525,파우스트/Noun,1,1,0,1.1115310228308472e-05,0.0,1.0
38526,즉빵/Noun,1,0,1,0.0,1.1106915165381966e-05,1.0
38527,ㅋㅋㅠㅜ/KoreanParticle,1,1,0,1.1115310228308472e-05,0.0,1.0
38528,엄처/Noun,1,1,0,1.1115310228308472e-05,0.0,1.0
38529,노욕/Noun,1,0,1,0.0,1.1106915165381966e-05,1.0
38530,새마을운동/Noun,1,0,1,0.0,1.1106915165381966e-05,1.0
38531,히토리시즈카/Noun,1,0,1,0.0,1.1106915165381966e-05,1.0
38532,잠복근무/Noun,1,0,1,0.0,1.1106915165381966e-05,1.0
38533,자몽/Noun,1,0,1,0.0,1.1106915165381966e-05,1.0
38534,쫄깃했던/Noun,1,1,0,1.1115310228308472e-05,0.0,1.0
38535,마미야/Noun,1,1,0,1.1115310228308472e-05,0.0,1.0
38536,군마/Noun,1,1,0,1.1115310228308472e-05,0.0,1.0
38537,여흥/Noun,1,0,1,0.0,1.1106915165381966e-05,1.0
38538,사골곰탕/Noun,1,0,1,0.0,1.1106915165381966e-05,1.0
38539,괴뢰국/Noun,1,0,1,0.0,1.1106915165381966e-05,1.0
38540,기황/Noun,1,0,1,0.0,1.1106915165381966e-05,1.0
38541,조상기/Noun,1,1,0,1.1115310228308472e-05,0.0,1.0
38542,AOS/Alpha,1,0,1,0.0,1.1106915165381966e-05,1.0
38543,5:5/Number,1,0,1,0.0,1.1106915165381966e-05,1.0
38544,불임/Noun,1,1,0,1.1115310228308472e-05,0.0,1.0
38545,거왜청/Noun,1,1,0,1.1115310228308472e-05,0.0,1.0
38546,@^.^@/Punctuation,1,1,0,1.1115310228308472e-05,0.0,1.0
38547,범띠/Noun,1,1,0,1.1115310228308472e-05,0.0,1.0
38548,ㅉㅓㄱ/KoreanParticle,1,1,0,1.1115310228308472e-05,0.0,1.0
38549,누데왜/Noun,1,1,0,1.1115310228308472e-05,0.0,1.0
38550,편왕재밓다/Noun,1,1,0,1.1115310228308472e-05,0.0,1.0
38551,박혓/Noun,1,1,0,1.1115310228308472e-05,0.0,1.0
38552,점준새/Noun,1,1,0,1.1115310228308472e-05,0.0,1.0
38553,볼론/Noun,1,1,0,1.1115310228308472e-05,0.0,1.0
38554,...</Punctuation,1,1,0,1.1115310228308472e-05,0.0,1.0
38555,번트/Noun,1,1,0,1.1115310228308472e-05,0.0,1.0
38556,만루/Noun,1,1,0,1.1115310228308472e-05,0.0,1.0
38557,코리안시리즈/Noun,1,1,0,1.1115310228308472e-05,0.0,1.0
38558,신데랠/Noun,1,1,0,1.1115310228308472e-05,0.0,1.0
38559,차체/Noun,1,0,1,0.0,1.1106915165381966e-05,1.0
38560,항구/Noun,1,0,1,0.0,1.1106915165381966e-05,1.0
38561,프리저/Noun,1,1,0,1.1115310228308472e-05,0.0,1.0
38562,283828383392919102/Number,1,1,0,1.1115310228308472e-05,0.0,1.0
38563,곤드레만드레/Noun,1,0,1,0.0,1.1106915165381966e-05,1.0
38564,공화/Noun,1,0,1,0.0,1.1106915165381966e-05,1.0
38565,쵝오여/Noun,1,1,0,1.1115310228308472e-05,0.0,1.0
38566,못습/Noun,1,1,0,1.1115310228308472e-05,0.0,1.0
38567,헬스키친/Noun,1,0,1,0.0,1.1106915165381966e-05,1.0
38568,고퀄릿/Noun,1,1,0,1.1115310228308472e-05,0.0,1.0
38569,음식남녀/Noun,1,0,1,0.0,1.1106915165381966e-05,1.0
38570,2.09/Number,1,0,1,0.0,1.1106915165381966e-05,1.0
38571,아즈나블/Noun,1,0,1,0.0,1.1106915165381966e-05,1.0
38572,데이타베이스/Noun,1,0,1,0.0,1.1106915165381966e-05,1.0
38573,베날/Noun,1,1,0,1.1115310228308472e-05,0.0,1.0
38574,왜착/Noun,1,1,0,1.1115310228308472e-05,0.0,1.0
38575,브흐/Noun,1,1,0,1.1115310228308472e-05,0.0,1.0
38576,웃끼/Noun,1,1,0,1.1115310228308472e-05,0.0,1.0
38577,Dude/Alpha,1,1,0,1.1115310228308472e-05,0.0,1.0
38578,넝넘/Noun,1,1,0,1.1115310228308472e-05,0.0,1.0
38579,battle/Alpha,1,1,0,1.1115310228308472e-05,0.0,1.0
38580,만에봤당/Foreign,1,0,1,0.0,1.1106915165381966e-05,1.0
38581,MU/Alpha,1,1,0,1.1115310228308472e-05,0.0,1.0
38582,분들껜/Noun,1,0,1,0.0,1.1106915165381966e-05,1.0
38583,티즘/Noun,1,0,1,0.0,1.1106915165381966e-05,1.0
38584,갓스짐머/Noun,1,1,0,1.1115310228308472e-05,0.0,1.0
38585,두싱/Noun,1,0,1,0.0,1.1106915165381966e-05,1.0
38586,와싱와호/Noun,1,0,1,0.0,1.1106915165381966e-05,1.0
38587,몬태나/Noun,1,1,0,1.1115310228308472e-05,0.0,1.0
38588,킬리안/Noun,1,1,0,1.1115310228308472e-05,0.0,1.0
38589,시범/Noun,1,0,1,0.0,1.1106915165381966e-05,1.0
38590,짯을까/Noun,1,0,1,0.0,1.1106915165381966e-05,1.0
38591,페러디/Noun,1,1,0,1.1115310228308472e-05,0.0,1.0
38592,쏘루/Noun,1,1,0,1.1115310228308472e-05,0.0,1.0
38593,11등/Number,1,0,1,0.0,1.1106915165381966e-05,1.0
38594,조석/Noun,1,0,1,0.0,1.1106915165381966e-05,1.0
38595,상처리/Noun,1,0,1,0.0,1.1106915165381966e-05,1.0
38596,롤플레잉/Noun,1,0,1,0.0,1.1106915165381966e-05,1.0
38597,뒷말/Noun,1,1,0,1.1115310228308472e-05,0.0,1.0
38598,파산/Noun,1,0,1,0.0,1.1106915165381966e-05,1.0
38599,손동작/Noun,1,1,0,1.1115310228308472e-05,0.0,1.0
38600,수야/Noun,1,0,1,0.0,1.1106915165381966e-05,1.0
38601,초순/Noun,1,0,1,0.0,1.1106915165381966e-05,1.0
38602,새키/Noun,1,0,1,0.0,1.1106915165381966e-05,1.0
38603,존빡/Noun,1,0,1,0.0,1.1106915165381966e-05,1.0
38604,nimi/Alpha,1,0,1,0.0,1.1106915165381966e-05,1.0
38605,산악씬/Noun,1,0,1,0.0,1.1106915165381966e-05,1.0
38606,슈이치/Noun,1,0,1,0.0,1.1106915165381966e-05,1.0
38607,때쌩/Noun,1,1,0,1.1115310228308472e-05,0.0,1.0
38608,마가리타/Noun,1,1,0,1.1115310228308472e-05,0.0,1.0
38609,드럼통/Noun,1,1,0,1.1115310228308472e-05,0.0,1.0
38610,살사/Noun,1,1,0,1.1115310228308472e-05,0.0,1.0
38611,옐로/Noun,1,1,0,1.1115310228308472e-05,0.0,1.0
38612,불록/Noun,1,1,0,1.1115310228308472e-05,0.0,1.0
38613,징챠/Noun,1,0,1,0.0,1.1106915165381966e-05,1.0
38614,딕펑스/Noun,1,0,1,0.0,1.1106915165381966e-05,1.0
38615,송송/Noun,1,1,0,1.1115310228308472e-05,0.0,1.0
38616,총탄/Noun,1,1,0,1.1115310228308472e-05,0.0,1.0
38617,왔슴돠/Noun,1,0,1,0.0,1.1106915165381966e-05,1.0
38618,선사로/Noun,1,0,1,0.0,1.1106915165381966e-05,1.0
38619,로열티/Noun,1,0,1,0.0,1.1106915165381966e-05,1.0
38620,Tmfprresrserfser/Alpha,1,0,1,0.0,1.1106915165381966e-05,1.0
38621,루쿠/Noun,1,1,0,1.1115310228308472e-05,0.0,1.0
38622,카네기/Noun,1,1,0,1.1115310228308472e-05,0.0,1.0
38623,컬렁/Noun,1,0,1,0.0,1.1106915165381966e-05,1.0
38624,쌍수/Noun,1,0,1,0.0,1.1106915165381966e-05,1.0
38625,hhhhjhjyjghjlyyrty/Alpha,1,1,0,1.1115310228308472e-05,0.0,1.0
38626,2000억/Number,1,1,0,1.1115310228308472e-05,0.0,1.0
38627,제스/Noun,1,1,0,1.1115310228308472e-05,0.0,1.0
38628,ㅓㅆ/KoreanParticle,1,0,1,0.0,1.1106915165381966e-05,1.0
38629,알려쥬/Noun,1,0,1,0.0,1.1106915165381966e-05,1.0
38630,이갸기/Noun,1,0,1,0.0,1.1106915165381966e-05,1.0
38631,ㅣㅎㅎ/KoreanParticle,1,1,0,1.1115310228308472e-05,0.0,1.0
38632,기세계/Noun,1,1,0,1.1115310228308472e-05,0.0,1.0
38633,비상하다/Adjective,1,0,1,0.0,1.1106915165381966e-05,1.0
38634,우즈마키/Noun,1,0,1,0.0,1.1106915165381966e-05,1.0
38635,힌놈/Noun,1,0,1,0.0,1.1106915165381966e-05,1.0
38636,고갱/Noun,1,0,1,0.0,1.1106915165381966e-05,1.0
38637,예명/Noun,1,1,0,1.1115310228308472e-05,0.0,1.0
38638,김지은/Noun,1,1,0,1.1115310228308472e-05,0.0,1.0
38639,깝죽/Noun,1,0,1,0.0,1.1106915165381966e-05,1.0
38640,논보릿/Noun,1,0,1,0.0,1.1106915165381966e-05,1.0
38641,러워/Noun,1,0,1,0.0,1.1106915165381966e-05,1.0
38642,>_!!/Punctuation,1,1,0,1.1115310228308472e-05,0.0,1.0
38643,함더/Noun,1,1,0,1.1115310228308472e-05,0.0,1.0
38644,조약/Noun,1,0,1,0.0,1.1106915165381966e-05,1.0
38645,쿵덕/Noun,1,1,0,1.1115310228308472e-05,0.0,1.0
38646,스자/Noun,1,0,1,0.0,1.1106915165381966e-05,1.0
38647,우주여행/Noun,1,1,0,1.1115310228308472e-05,0.0,1.0
38648,산수화/Noun,1,1,0,1.1115310228308472e-05,0.0,1.0
38649,한글날/Noun,1,0,1,0.0,1.1106915165381966e-05,1.0
38650,김진호/Noun,1,1,0,1.1115310228308472e-05,0.0,1.0
38651,ㅋㅋㅋㅅ/KoreanParticle,1,0,1,0.0,1.1106915165381966e-05,1.0
38652,이지나고이제서야이영화를봤지만대박임/Foreign,1,1,0,1.1115310228308472e-05,0.0,1.0
38653,퍼셀/Noun,1,0,1,0.0,1.1106915165381966e-05,1.0
38654,ts/Alpha,1,0,1,0.0,1.1106915165381966e-05,1.0
38655,괸찮다/Noun,1,0,1,0.0,1.1106915165381966e-05,1.0
38656,보데/Noun,1,1,0,1.1115310228308472e-05,0.0,1.0
38657,ㄱㅁ/KoreanParticle,1,1,0,1.1115310228308472e-05,0.0,1.0
38658,련/Eomi,1,1,0,1.1115310228308472e-05,0.0,1.0
38659,전관예우/Noun,1,0,1,0.0,1.1106915165381966e-05,1.0
38660,최빈국/Noun,1,0,1,0.0,1.1106915165381966e-05,1.0
38661,87~9년/Number,1,0,1,0.0,1.1106915165381966e-05,1.0
38662,대초반이나/Foreign,1,0,1,0.0,1.1106915165381966e-05,1.0
38663,딥임팩트/Noun,1,0,1,0.0,1.1106915165381966e-05,1.0
38664,교합/Noun,1,1,0,1.1115310228308472e-05,0.0,1.0
38665,화음/Noun,1,1,0,1.1115310228308472e-05,0.0,1.0
38666,이지나도다시볼거같애/Foreign,1,1,0,1.1115310228308472e-05,0.0,1.0
38667,개뼉다귀/Noun,1,1,0,1.1115310228308472e-05,0.0,1.0
38668,쉐이크/Noun,1,1,0,1.1115310228308472e-05,0.0,1.0
38669,헨스트리지/Noun,1,0,1,0.0,1.1106915165381966e-05,1.0
38670,자드/Noun,1,0,1,0.0,1.1106915165381966e-05,1.0
38671,+-+!!/Punctuation,1,1,0,1.1115310228308472e-05,0.0,1.0
38672,필기/Noun,1,1,0,1.1115310228308472e-05,0.0,1.0
38673,연탄가스/Noun,1,1,0,1.1115310228308472e-05,0.0,1.0
38674,성스/Noun,1,1,0,1.1115310228308472e-05,0.0,1.0
38675,아카디아/Noun,1,0,1,0.0,1.1106915165381966e-05,1.0
38676,개졷쓰레/Noun,1,0,1,0.0,1.1106915165381966e-05,1.0
38677,스페타클/Noun,1,1,0,1.1115310228308472e-05,0.0,1.0
38678,셀레니아/Noun,1,1,0,1.1115310228308472e-05,0.0,1.0
38679,철심/Noun,1,0,1,0.0,1.1106915165381966e-05,1.0
38680,nipples/Alpha,1,0,1,0.0,1.1106915165381966e-05,1.0
38681,becauf/Alpha,1,0,1,0.0,1.1106915165381966e-05,1.0
38682,minimum/Alpha,1,0,1,0.0,1.1106915165381966e-05,1.0
38683,terribly/Alpha,1,0,1,0.0,1.1106915165381966e-05,1.0
38684,jeongparkwo/Alpha,1,1,0,1.1115310228308472e-05,0.0,1.0
38685,독끼/Noun,1,1,0,1.1115310228308472e-05,0.0,1.0
38686,톰조심/Noun,1,1,0,1.1115310228308472e-05,0.0,1.0
38687,저체온증/Noun,1,0,1,0.0,1.1106915165381966e-05,1.0
38688,어쩌겟/Noun,1,0,1,0.0,1.1106915165381966e-05,1.0
38689,꺼를/Foreign,1,0,1,0.0,1.1106915165381966e-05,1.0
38690,배영/Noun,1,0,1,0.0,1.1106915165381966e-05,1.0
38691,남성은/Noun,1,0,1,0.0,1.1106915165381966e-05,1.0
38692,log/Alpha,1,0,1,0.0,1.1106915165381966e-05,1.0
38693,경제대공황/Noun,1,1,0,1.1115310228308472e-05,0.0,1.0
38694,치맥/Noun,1,0,1,0.0,1.1106915165381966e-05,1.0
38695,정신장애인/Noun,1,0,1,0.0,1.1106915165381966e-05,1.0
38696,입버릇/Noun,1,1,0,1.1115310228308472e-05,0.0,1.0
38697,백파이프/Noun,1,1,0,1.1115310228308472e-05,0.0,1.0
38698,윌버포스/Noun,1,1,0,1.1115310228308472e-05,0.0,1.0
38699,쉐이킷/Noun,1,0,1,0.0,1.1106915165381966e-05,1.0
38700,알츠/Noun,1,0,1,0.0,1.1106915165381966e-05,1.0
38701,지크/Noun,1,0,1,0.0,1.1106915165381966e-05,1.0
38702,보터/Noun,1,0,1,0.0,1.1106915165381966e-05,1.0
38703,봣기/Noun,1,0,1,0.0,1.1106915165381966e-05,1.0
38704,3~40년/Number,1,1,0,1.1115310228308472e-05,0.0,1.0
38705,드나드나/Noun,1,0,1,0.0,1.1106915165381966e-05,1.0
38706,복덕방/Noun,1,0,1,0.0,1.1106915165381966e-05,1.0
38707,흑횽/Noun,1,0,1,0.0,1.1106915165381966e-05,1.0
38708,화련/Noun,1,0,1,0.0,1.1106915165381966e-05,1.0
38709,절케/Noun,1,0,1,0.0,1.1106915165381966e-05,1.0
38710,어나니머스/Noun,1,0,1,0.0,1.1106915165381966e-05,1.0
38711,헐씬/Noun,1,0,1,0.0,1.1106915165381966e-05,1.0
38712,moon/Alpha,1,1,0,1.1115310228308472e-05,0.0,1.0
38713,아쿠아/Noun,1,1,0,1.1115310228308472e-05,0.0,1.0
38714,이지시/Noun,1,1,0,1.1115310228308472e-05,0.0,1.0
38715,진솔/Noun,1,1,0,1.1115310228308472e-05,0.0,1.0
38716,에이은/Foreign,1,0,1,0.0,1.1106915165381966e-05,1.0
38717,무익하다/Adjective,1,0,1,0.0,1.1106915165381966e-05,1.0
38718,큭큭큭/Noun,1,1,0,1.1115310228308472e-05,0.0,1.0
38719,미고/Noun,1,1,0,1.1115310228308472e-05,0.0,1.0
38720,머스킷총/Noun,1,1,0,1.1115310228308472e-05,0.0,1.0
38721,합연/Noun,1,1,0,1.1115310228308472e-05,0.0,1.0
38722,먼훗날/Noun,1,0,1,0.0,1.1106915165381966e-05,1.0
38723,잔디밭/Noun,1,1,0,1.1115310228308472e-05,0.0,1.0
38724,블린인드/Noun,1,1,0,1.1115310228308472e-05,0.0,1.0
38725,ㅉㄴㅉㄴ/KoreanParticle,1,0,1,0.0,1.1106915165381966e-05,1.0
38726,둘위/Noun,1,1,0,1.1115310228308472e-05,0.0,1.0
38727,타고/Foreign,1,0,1,0.0,1.1106915165381966e-05,1.0
38728,GDNTOPCLASSINTHECLUB/Alpha,1,0,1,0.0,1.1106915165381966e-05,1.0
38729,야머/Noun,1,0,1,0.0,1.1106915165381966e-05,1.0
38730,입터/Noun,1,1,0,1.1115310228308472e-05,0.0,1.0
38731,알프스산맥/Noun,1,1,0,1.1115310228308472e-05,0.0,1.0
38732,했엌/Noun,1,0,1,0.0,1.1106915165381966e-05,1.0
38733,한태민/Noun,1,0,1,0.0,1.1106915165381966e-05,1.0
38734,홍철/Noun,1,1,0,1.1115310228308472e-05,0.0,1.0
38735,외처/Noun,1,1,0,1.1115310228308472e-05,0.0,1.0
38736,장정초/Noun,1,0,1,0.0,1.1106915165381966e-05,1.0
38737,최승현/Noun,1,1,0,1.1115310228308472e-05,0.0,1.0
38738,뻥카/Noun,1,0,1,0.0,1.1106915165381966e-05,1.0
38739,팝핀제이/Noun,1,0,1,0.0,1.1106915165381966e-05,1.0
38740,이용우/Noun,1,0,1,0.0,1.1106915165381966e-05,1.0
38741,이준용/Noun,1,0,1,0.0,1.1106915165381966e-05,1.0
38742,^-^;;/Punctuation,1,0,1,0.0,1.1106915165381966e-05,1.0
38743,배필/Noun,1,1,0,1.1115310228308472e-05,0.0,1.0
38744,핑도네/Noun,1,1,0,1.1115310228308472e-05,0.0,1.0
38745,프라이드/Noun,1,0,1,0.0,1.1106915165381966e-05,1.0
38746,쩌들어/Noun,1,0,1,0.0,1.1106915165381966e-05,1.0
38747,호의호식/Noun,1,0,1,0.0,1.1106915165381966e-05,1.0
38748,건카/Noun,1,1,0,1.1115310228308472e-05,0.0,1.0
38749,데코/Noun,1,0,1,0.0,1.1106915165381966e-05,1.0
38750,기소유예/Noun,1,0,1,0.0,1.1106915165381966e-05,1.0
38751,♫♬♪/Foreign,1,1,0,1.1115310228308472e-05,0.0,1.0
38752,식대/Noun,1,1,0,1.1115310228308472e-05,0.0,1.0
38753,람바다/Noun,1,0,1,0.0,1.1106915165381966e-05,1.0
38754,에이특공대/Noun,1,0,1,0.0,1.1106915165381966e-05,1.0
38755,차븟/Noun,1,0,1,0.0,1.1106915165381966e-05,1.0
38756,위츠/Noun,1,0,1,0.0,1.1106915165381966e-05,1.0
38757,달동네/Noun,1,1,0,1.1115310228308472e-05,0.0,1.0
38758,유영철/Noun,1,0,1,0.0,1.1106915165381966e-05,1.0
38759,新/Foreign,1,1,0,1.1115310228308472e-05,0.0,1.0
38760,재건/Noun,1,1,0,1.1115310228308472e-05,0.0,1.0
38761,파렴치/Noun,1,1,0,1.1115310228308472e-05,0.0,1.0
38762,에도피해자들은죄지은듯평생씻을수없는삶에서고통받고살아갑니다/Foreign,1,1,0,1.1115310228308472e-05,0.0,1.0
38763,최동원/Noun,1,1,0,1.1115310228308472e-05,0.0,1.0
38764,urge/Alpha,1,0,1,0.0,1.1106915165381966e-05,1.0
38765,최전선/Noun,1,1,0,1.1115310228308472e-05,0.0,1.0
38766,1942년/Number,1,1,0,1.1115310228308472e-05,0.0,1.0
38767,쪼매날때/Noun,1,0,1,0.0,1.1106915165381966e-05,1.0
38768,차주옥/Noun,1,0,1,0.0,1.1106915165381966e-05,1.0
38769,비상계엄/Noun,1,1,0,1.1115310228308472e-05,0.0,1.0
38770,기러기아빠/Noun,1,1,0,1.1115310228308472e-05,0.0,1.0
38771,댜운/Noun,1,0,1,0.0,1.1106915165381966e-05,1.0
38772,슬렌더/Noun,1,0,1,0.0,1.1106915165381966e-05,1.0
38773,ㅓㅗ/KoreanParticle,1,1,0,1.1115310228308472e-05,0.0,1.0
38774,ㅐㅈ/KoreanParticle,1,1,0,1.1115310228308472e-05,0.0,1.0
38775,듀투/Noun,1,1,0,1.1115310228308472e-05,0.0,1.0
38776,특별법/Noun,1,0,1,0.0,1.1106915165381966e-05,1.0
38777,이상이면/Foreign,1,0,1,0.0,1.1106915165381966e-05,1.0
38778,하드웨어/Noun,1,0,1,0.0,1.1106915165381966e-05,1.0
38779,Jdjdjjchchchehdyeyw/Alpha,1,1,0,1.1115310228308472e-05,0.0,1.0
38780,빅마마/Noun,1,1,0,1.1115310228308472e-05,0.0,1.0
38781,됬긔/Noun,1,1,0,1.1115310228308472e-05,0.0,1.0
38782,슈러더/Noun,1,1,0,1.1115310228308472e-05,0.0,1.0
38783,lg/Alpha,1,0,1,0.0,1.1106915165381966e-05,1.0
38784,일엽/Noun,1,1,0,1.1115310228308472e-05,0.0,1.0
38785,택한걸/Noun,1,0,1,0.0,1.1106915165381966e-05,1.0
38786,알곘음/Noun,1,1,0,1.1115310228308472e-05,0.0,1.0
38787,대머리독수리/Noun,1,0,1,0.0,1.1106915165381966e-05,1.0
38788,San/Alpha,1,1,0,1.1115310228308472e-05,0.0,1.0
38789,9.41/Number,1,0,1,0.0,1.1106915165381966e-05,1.0
38790,예거/Noun,1,1,0,1.1115310228308472e-05,0.0,1.0
38791,",,//../Punctuation",1,0,1,0.0,1.1106915165381966e-05,1.0
38792,챙피함/Noun,1,0,1,0.0,1.1106915165381966e-05,1.0
38793,21초/Number,1,0,1,0.0,1.1106915165381966e-05,1.0
38794,wall/Alpha,1,1,0,1.1115310228308472e-05,0.0,1.0
38795,남만/Noun,1,0,1,0.0,1.1106915165381966e-05,1.0
38796,괜차네/Noun,1,1,0,1.1115310228308472e-05,0.0,1.0
38797,치팅/Noun,1,0,1,0.0,1.1106915165381966e-05,1.0
38798,빰빰빠빠빱빠/Noun,1,0,1,0.0,1.1106915165381966e-05,1.0
38799,탐나는도다/Noun,1,0,1,0.0,1.1106915165381966e-05,1.0
38800,유복하다/Adjective,1,1,0,1.1115310228308472e-05,0.0,1.0
38801,도탄/Noun,1,0,1,0.0,1.1106915165381966e-05,1.0
38802,셔면/Noun,1,0,1,0.0,1.1106915165381966e-05,1.0
38803,애해/Exclamation,1,0,1,0.0,1.1106915165381966e-05,1.0
38804,레이자/Noun,1,0,1,0.0,1.1106915165381966e-05,1.0
38805,김동화/Noun,1,0,1,0.0,1.1106915165381966e-05,1.0
38806,캐빈인더우즈/Noun,1,0,1,0.0,1.1106915165381966e-05,1.0
38807,묵주/Noun,1,0,1,0.0,1.1106915165381966e-05,1.0
38808,치는데/Foreign,1,0,1,0.0,1.1106915165381966e-05,1.0
38809,나먼/Noun,1,1,0,1.1115310228308472e-05,0.0,1.0
38810,파일공유/Noun,1,0,1,0.0,1.1106915165381966e-05,1.0
38811,더봣는대/Noun,1,1,0,1.1115310228308472e-05,0.0,1.0
38812,알겄소/Noun,1,1,0,1.1115310228308472e-05,0.0,1.0
38813,"~~""""/Punctuation",1,0,1,0.0,1.1106915165381966e-05,1.0
38814,운명론/Noun,1,1,0,1.1115310228308472e-05,0.0,1.0
38815,은동/Noun,1,1,0,1.1115310228308472e-05,0.0,1.0
38816,짜리야/Foreign,1,0,1,0.0,1.1106915165381966e-05,1.0
38817,64363/Number,1,0,1,0.0,1.1106915165381966e-05,1.0
38818,ㅎㄴㅁ/KoreanParticle,1,0,1,0.0,1.1106915165381966e-05,1.0
38819,ㅑㅈ/KoreanParticle,1,0,1,0.0,1.1106915165381966e-05,1.0
38820,헨릳/Noun,1,0,1,0.0,1.1106915165381966e-05,1.0
38821,한민구/Noun,1,0,1,0.0,1.1106915165381966e-05,1.0
38822,ckdg/Alpha,1,0,1,0.0,1.1106915165381966e-05,1.0
38823,2-3회/Number,1,1,0,1.1115310228308472e-05,0.0,1.0
38824,웃흥/Noun,1,0,1,0.0,1.1106915165381966e-05,1.0
38825,평생토록/Noun,1,1,0,1.1115310228308472e-05,0.0,1.0
38826,"24,454/Number",1,1,0,1.1115310228308472e-05,0.0,1.0
38827,순덕/Noun,1,0,1,0.0,1.1106915165381966e-05,1.0
38828,알파카/Noun,1,1,0,1.1115310228308472e-05,0.0,1.0
38829,웨스트로/Noun,1,1,0,1.1115310228308472e-05,0.0,1.0
38830,카밀/Noun,1,1,0,1.1115310228308472e-05,0.0,1.0
38831,협곡/Noun,1,1,0,1.1115310228308472e-05,0.0,1.0
38832,헬름/Noun,1,1,0,1.1115310228308472e-05,0.0,1.0
38833,kimh/Alpha,1,1,0,1.1115310228308472e-05,0.0,1.0
38834,nameNMLcygni/Alpha,1,1,0,1.1115310228308472e-05,0.0,1.0
38835,깡패쉐/Noun,1,0,1,0.0,1.1106915165381966e-05,1.0
38836,맹종하/Noun,1,1,0,1.1115310228308472e-05,0.0,1.0
38837,밓었/Noun,1,0,1,0.0,1.1106915165381966e-05,1.0
38838,전씨/Noun,1,1,0,1.1115310228308472e-05,0.0,1.0
38839,---;;;/Punctuation,1,0,1,0.0,1.1106915165381966e-05,1.0
38840,@.@!/Punctuation,1,1,0,1.1115310228308472e-05,0.0,1.0
38841,윌프/Noun,1,1,0,1.1115310228308472e-05,0.0,1.0
38842,드륵드륵/Adverb,1,0,1,0.0,1.1106915165381966e-05,1.0
38843,해쥬길/Noun,1,1,0,1.1115310228308472e-05,0.0,1.0
38844,김명준/Noun,1,1,0,1.1115310228308472e-05,0.0,1.0
38845,sktl/Alpha,1,0,1,0.0,1.1106915165381966e-05,1.0
38846,마랏/Noun,1,0,1,0.0,1.1106915165381966e-05,1.0
38847,흐트려/Noun,1,1,0,1.1115310228308472e-05,0.0,1.0
38848,대재/Noun,1,0,1,0.0,1.1106915165381966e-05,1.0
38849,탈수증/Noun,1,0,1,0.0,1.1106915165381966e-05,1.0
38850,염분/Noun,1,0,1,0.0,1.1106915165381966e-05,1.0
38851,바둥댈/Noun,1,0,1,0.0,1.1106915165381966e-05,1.0
38852,거동/Noun,1,0,1,0.0,1.1106915165381966e-05,1.0
38853,우헤헤헤/Noun,1,0,1,0.0,1.1106915165381966e-05,1.0
38854,&~@*^.^*@~&/Punctuation,1,1,0,1.1115310228308472e-05,0.0,1.0
38855,욱껴/Noun,1,1,0,1.1115310228308472e-05,0.0,1.0
38856,전체샷/Noun,1,0,1,0.0,1.1106915165381966e-05,1.0
38857,carter/Alpha,1,1,0,1.1115310228308472e-05,0.0,1.0
38858,낭심/Noun,1,0,1,0.0,1.1106915165381966e-05,1.0
38859,부스럼/Noun,1,1,0,1.1115310228308472e-05,0.0,1.0
38860,괴현상/Noun,1,0,1,0.0,1.1106915165381966e-05,1.0
38861,로란/Noun,1,0,1,0.0,1.1106915165381966e-05,1.0
38862,윤으헤/Noun,1,0,1,0.0,1.1106915165381966e-05,1.0
38863,김종선/Noun,1,0,1,0.0,1.1106915165381966e-05,1.0
38864,MLC/Alpha,1,1,0,1.1115310228308472e-05,0.0,1.0
38865,between/Alpha,1,0,1,0.0,1.1106915165381966e-05,1.0
38866,고복수/Noun,1,0,1,0.0,1.1106915165381966e-05,1.0
38867,한정임/Noun,1,0,1,0.0,1.1106915165381966e-05,1.0
38868,하는섹기/Noun,1,1,0,1.1115310228308472e-05,0.0,1.0
38869,sweet/Alpha,1,1,0,1.1115310228308472e-05,0.0,1.0
38870,revenge/Alpha,1,1,0,1.1115310228308472e-05,0.0,1.0
38871,파일량/Noun,1,0,1,0.0,1.1106915165381966e-05,1.0
38872,됫는뎁/Noun,1,1,0,1.1115310228308472e-05,0.0,1.0
38873,님불쌍/Noun,1,1,0,1.1115310228308472e-05,0.0,1.0
38874,글밑/Noun,1,1,0,1.1115310228308472e-05,0.0,1.0
38875,정화조/Noun,1,0,1,0.0,1.1106915165381966e-05,1.0
38876,슈투/Noun,1,0,1,0.0,1.1106915165381966e-05,1.0
38877,찢겨죽엇어/Noun,1,0,1,0.0,1.1106915165381966e-05,1.0
38878,우체국/Noun,1,1,0,1.1115310228308472e-05,0.0,1.0
38879,hhhh/Alpha,1,1,0,1.1115310228308472e-05,0.0,1.0
38880,뭐드래/Noun,1,0,1,0.0,1.1106915165381966e-05,1.0
38881,자년/Noun,1,0,1,0.0,1.1106915165381966e-05,1.0
38882,술취해/Noun,1,0,1,0.0,1.1106915165381966e-05,1.0
38883,버물러짐/Noun,1,1,0,1.1115310228308472e-05,0.0,1.0
38884,의찬/Noun,1,0,1,0.0,1.1106915165381966e-05,1.0
38885,배랑/Noun,1,0,1,0.0,1.1106915165381966e-05,1.0
38886,100만원/Number,1,0,1,0.0,1.1106915165381966e-05,1.0
38887,며더/Noun,1,0,1,0.0,1.1106915165381966e-05,1.0
38888,그랫쪄/Noun,1,0,1,0.0,1.1106915165381966e-05,1.0
38889,잘끝냇구/Noun,1,1,0,1.1115310228308472e-05,0.0,1.0
38890,두리번거리다/Verb,1,0,1,0.0,1.1106915165381966e-05,1.0
38891,협잡/Noun,1,0,1,0.0,1.1106915165381966e-05,1.0
38892,노로/Noun,1,0,1,0.0,1.1106915165381966e-05,1.0
38893,회하/Noun,1,1,0,1.1115310228308472e-05,0.0,1.0
38894,가마니/Noun,1,1,0,1.1115310228308472e-05,0.0,1.0
38895,문지/Noun,1,1,0,1.1115310228308472e-05,0.0,1.0
38896,화폐/Noun,1,0,1,0.0,1.1106915165381966e-05,1.0
38897,99엔/Number,1,0,1,0.0,1.1106915165381966e-05,1.0
38898,심슨가족/Noun,1,1,0,1.1115310228308472e-05,0.0,1.0
38899,디때/Noun,1,1,0,1.1115310228308472e-05,0.0,1.0
38900,노략/Noun,1,1,0,1.1115310228308472e-05,0.0,1.0
38901,서은아/Noun,1,0,1,0.0,1.1106915165381966e-05,1.0
38902,물자/Noun,1,1,0,1.1115310228308472e-05,0.0,1.0
38903,조선반도/Noun,1,1,0,1.1115310228308472e-05,0.0,1.0
38904,한자어/Noun,1,1,0,1.1115310228308472e-05,0.0,1.0
38905,AG/Alpha,1,1,0,1.1115310228308472e-05,0.0,1.0
38906,셋케/Noun,1,0,1,0.0,1.1106915165381966e-05,1.0
38907,별별/Modifier,1,1,0,1.1115310228308472e-05,0.0,1.0
38908,원화평/Noun,1,1,0,1.1115310228308472e-05,0.0,1.0
38909,채드/Noun,1,0,1,0.0,1.1106915165381966e-05,1.0
38910,댓츠/Noun,1,0,1,0.0,1.1106915165381966e-05,1.0
38911,스톨/Noun,1,0,1,0.0,1.1106915165381966e-05,1.0
38912,여조/Noun,1,0,1,0.0,1.1106915165381966e-05,1.0
38913,빗자루/Noun,1,1,0,1.1115310228308472e-05,0.0,1.0
38914,http://movie.naver.com/movie/bi/mi/point.nhn?code=79554#reviewTab/URL,1,1,0,1.1115310228308472e-05,0.0,1.0
38915,それからいつでも頑張らなきゃ。/Foreign,1,1,0,1.1115310228308472e-05,0.0,1.0
38916,지큐/Noun,1,1,0,1.1115310228308472e-05,0.0,1.0
38917,퀄리티왜/Noun,1,1,0,1.1115310228308472e-05,0.0,1.0
38918,년새/Noun,1,1,0,1.1115310228308472e-05,0.0,1.0
38919,46초/Number,1,0,1,0.0,1.1106915165381966e-05,1.0
38920,수나라/Noun,1,0,1,0.0,1.1106915165381966e-05,1.0
38921,수양제/Noun,1,0,1,0.0,1.1106915165381966e-05,1.0
38922,☆★☆★☆★☆/Foreign,1,1,0,1.1115310228308472e-05,0.0,1.0
38923,베키역/Noun,1,0,1,0.0,1.1106915165381966e-05,1.0
38924,선리/Noun,1,1,0,1.1115310228308472e-05,0.0,1.0
38925,홍공/Noun,1,1,0,1.1115310228308472e-05,0.0,1.0
38926,쉑/Noun,1,0,1,0.0,1.1106915165381966e-05,1.0
38927,대상해/Noun,1,0,1,0.0,1.1106915165381966e-05,1.0
38928,깃감/Noun,1,0,1,0.0,1.1106915165381966e-05,1.0
38929,Italia/Alpha,1,1,0,1.1115310228308472e-05,0.0,1.0
38930,manca/Alpha,1,1,0,1.1115310228308472e-05,0.0,1.0
38931,웬트워스/Noun,1,1,0,1.1115310228308472e-05,0.0,1.0
38932,류정/Noun,1,0,1,0.0,1.1106915165381966e-05,1.0
38933,헬런/Noun,1,1,0,1.1115310228308472e-05,0.0,1.0
38934,뷰뷴/Noun,1,1,0,1.1115310228308472e-05,0.0,1.0
38935,싯발/Noun,1,0,1,0.0,1.1106915165381966e-05,1.0
38936,붇/Noun,1,0,1,0.0,1.1106915165381966e-05,1.0
38937,끌뜻/Noun,1,1,0,1.1115310228308472e-05,0.0,1.0
38938,짬뿡/Noun,1,0,1,0.0,1.1106915165381966e-05,1.0
38939,첸카/Noun,1,1,0,1.1115310228308472e-05,0.0,1.0
38940,브레싱/Noun,1,0,1,0.0,1.1106915165381966e-05,1.0
38941,노브리딩/Noun,1,0,1,0.0,1.1106915165381966e-05,1.0
38942,단란주점/Noun,1,0,1,0.0,1.1106915165381966e-05,1.0
38943,nn/Alpha,1,1,0,1.1115310228308472e-05,0.0,1.0
38944,청룡영화제/Noun,1,1,0,1.1115310228308472e-05,0.0,1.0
38945,규안/Noun,1,1,0,1.1115310228308472e-05,0.0,1.0
38946,췃습/Noun,1,0,1,0.0,1.1106915165381966e-05,1.0
38947,김석/Noun,1,0,1,0.0,1.1106915165381966e-05,1.0
38948,네드같/Noun,1,1,0,1.1115310228308472e-05,0.0,1.0
38949,슘/Noun,1,0,1,0.0,1.1106915165381966e-05,1.0
38950,".-,.-/Punctuation",1,0,1,0.0,1.1106915165381966e-05,1.0
38951,111111/Number,1,1,0,1.1115310228308472e-05,0.0,1.0
38952,아이코/Exclamation,1,0,1,0.0,1.1106915165381966e-05,1.0
38953,강추아닥/Noun,1,1,0,1.1115310228308472e-05,0.0,1.0
38954,ㄱㄱㅣ/KoreanParticle,1,1,0,1.1115310228308472e-05,0.0,1.0
38955,찬드라/Noun,1,1,0,1.1115310228308472e-05,0.0,1.0
38956,수저/Noun,1,1,0,1.1115310228308472e-05,0.0,1.0
38957,피가로/Noun,1,1,0,1.1115310228308472e-05,0.0,1.0
38958,태규/Noun,1,1,0,1.1115310228308472e-05,0.0,1.0
38959,브랜다/Noun,1,0,1,0.0,1.1106915165381966e-05,1.0
38960,bitchs/Alpha,1,0,1,0.0,1.1106915165381966e-05,1.0
38961,panic/Alpha,1,0,1,0.0,1.1106915165381966e-05,1.0
38962,이화선/Noun,1,0,1,0.0,1.1106915165381966e-05,1.0
38963,american/Alpha,1,1,0,1.1115310228308472e-05,0.0,1.0
38964,휘드르/Noun,1,1,0,1.1115310228308472e-05,0.0,1.0
38965,미스타손/Noun,1,1,0,1.1115310228308472e-05,0.0,1.0
38966,환단고기/Noun,1,0,1,0.0,1.1106915165381966e-05,1.0
38967,그렁그렁/Adverb,1,1,0,1.1115310228308472e-05,0.0,1.0
38968,리가떠올랐지만/Foreign,1,1,0,1.1115310228308472e-05,0.0,1.0
38969,굿이옰시/Noun,1,1,0,1.1115310228308472e-05,0.0,1.0
38970,ㅅㅂㅠ/KoreanParticle,1,1,0,1.1115310228308472e-05,0.0,1.0
38971,개굴개굴/Noun,1,1,0,1.1115310228308472e-05,0.0,1.0
38972,은넘을거다/Foreign,1,1,0,1.1115310228308472e-05,0.0,1.0
38973,전꺼네/Foreign,1,1,0,1.1115310228308472e-05,0.0,1.0
38974,면류/Noun,1,0,1,0.0,1.1106915165381966e-05,1.0
38975,겹치기/Noun,1,1,0,1.1115310228308472e-05,0.0,1.0
38976,프론탈/Noun,1,1,0,1.1115310228308472e-05,0.0,1.0
38977,재래/Noun,1,1,0,1.1115310228308472e-05,0.0,1.0
38978,여상/Noun,1,1,0,1.1115310228308472e-05,0.0,1.0
38979,이지난영화지만/Foreign,1,1,0,1.1115310228308472e-05,0.0,1.0
38980,...--;;)/Punctuation,1,1,0,1.1115310228308472e-05,0.0,1.0
38981,death/Alpha,1,1,0,1.1115310228308472e-05,0.0,1.0
38982,카리나/Noun,1,0,1,0.0,1.1106915165381966e-05,1.0
38983,9분/Number,1,1,0,1.1115310228308472e-05,0.0,1.0
38984,졎/Noun,1,1,0,1.1115310228308472e-05,0.0,1.0
38985,베어울프/Noun,1,1,0,1.1115310228308472e-05,0.0,1.0
38986,김치찌개/Noun,1,0,1,0.0,1.1106915165381966e-05,1.0
38987,혓/Noun,1,0,1,0.0,1.1106915165381966e-05,1.0
38988,경은/Noun,1,0,1,0.0,1.1106915165381966e-05,1.0
38989,싱기/Noun,1,1,0,1.1115310228308472e-05,0.0,1.0
38990,띀/Noun,1,1,0,1.1115310228308472e-05,0.0,1.0
38991,쟁장/Noun,1,0,1,0.0,1.1106915165381966e-05,1.0
38992,대봑/Noun,1,0,1,0.0,1.1106915165381966e-05,1.0
38993,차정도로/Foreign,1,1,0,1.1115310228308472e-05,0.0,1.0
38994,30회/Number,1,1,0,1.1115310228308472e-05,0.0,1.0
38995,살징/Noun,1,1,0,1.1115310228308472e-05,0.0,1.0
38996,마인크래프트/Noun,1,0,1,0.0,1.1106915165381966e-05,1.0
38997,".,...../Punctuation",1,1,0,1.1115310228308472e-05,0.0,1.0
38998,보글보글/Adverb,1,0,1,0.0,1.1106915165381966e-05,1.0
38999,정확성/Noun,1,0,1,0.0,1.1106915165381966e-05,1.0
39000,기자회견/Noun,1,0,1,0.0,1.1106915165381966e-05,1.0
39001,콧배기/Noun,1,0,1,0.0,1.1106915165381966e-05,1.0
39002,꺆/Noun,1,1,0,1.1115310228308472e-05,0.0,1.0
39003,한동화/Noun,1,1,0,1.1115310228308472e-05,0.0,1.0
39004,Old/Alpha,1,1,0,1.1115310228308472e-05,0.0,1.0
39005,Grumpy/Alpha,1,1,0,1.1115310228308472e-05,0.0,1.0
39006,Hollywood/Alpha,1,1,0,1.1115310228308472e-05,0.0,1.0
39007,~!~~~!~~~/Punctuation,1,0,1,0.0,1.1106915165381966e-05,1.0
39008,댄스배틀/Noun,1,1,0,1.1115310228308472e-05,0.0,1.0
39009,어쳐구/Noun,1,0,1,0.0,1.1106915165381966e-05,1.0
39010,존제/Noun,1,0,1,0.0,1.1106915165381966e-05,1.0
39011,실언/Noun,1,0,1,0.0,1.1106915165381966e-05,1.0
39012,툼스톤/Noun,1,1,0,1.1115310228308472e-05,0.0,1.0
39013,유키스/Noun,1,0,1,0.0,1.1106915165381966e-05,1.0
39014,~~~~~~~~~~~~~~~~~~/Punctuation,1,0,1,0.0,1.1106915165381966e-05,1.0
39015,전별/Noun,1,0,1,0.0,1.1106915165381966e-05,1.0
39016,구완/Noun,1,0,1,0.0,1.1106915165381966e-05,1.0
39017,윌트/Noun,1,1,0,1.1115310228308472e-05,0.0,1.0
39018,시대유감/Noun,1,1,0,1.1115310228308472e-05,0.0,1.0
39019,리샤/Noun,1,1,0,1.1115310228308472e-05,0.0,1.0
39020,틈틈하다/Adjective,1,1,0,1.1115310228308472e-05,0.0,1.0
39021,냅킨/Noun,1,0,1,0.0,1.1106915165381966e-05,1.0
39022,다닌느거/Noun,1,0,1,0.0,1.1106915165381966e-05,1.0
39023,샘락엘/Noun,1,1,0,1.1115310228308472e-05,0.0,1.0
39024,데카/Noun,1,1,0,1.1115310228308472e-05,0.0,1.0
39025,도포/Noun,1,0,1,0.0,1.1106915165381966e-05,1.0
39026,크립/Noun,1,0,1,0.0,1.1106915165381966e-05,1.0
39027,..(>_/Punctuation,1,0,1,0.0,1.1106915165381966e-05,1.0
39028,뒤에죽고/Foreign,1,1,0,1.1115310228308472e-05,0.0,1.0
39029,5.49/Number,1,1,0,1.1115310228308472e-05,0.0,1.0
39030,낚엮어/Noun,1,0,1,0.0,1.1106915165381966e-05,1.0
39031,ㄲㅇ/KoreanParticle,1,0,1,0.0,1.1106915165381966e-05,1.0
39032,입봉/Noun,1,0,1,0.0,1.1106915165381966e-05,1.0
39033,들먹대다/Verb,1,0,1,0.0,1.1106915165381966e-05,1.0
39034,황도/Noun,1,0,1,0.0,1.1106915165381966e-05,1.0
39035,참위/Noun,1,1,0,1.1115310228308472e-05,0.0,1.0
39036,엑시노스/Noun,1,1,0,1.1115310228308472e-05,0.0,1.0
39037,탠/Noun,1,0,1,0.0,1.1106915165381966e-05,1.0
39038,바이슨/Noun,1,1,0,1.1115310228308472e-05,0.0,1.0
39039,르드/Noun,1,1,0,1.1115310228308472e-05,0.0,1.0
39040,스트릿/Noun,1,1,0,1.1115310228308472e-05,0.0,1.0
39041,201/Number,1,1,0,1.1115310228308472e-05,0.0,1.0
39042,랭크급/Noun,1,1,0,1.1115310228308472e-05,0.0,1.0
39043,!!!?????/Punctuation,1,1,0,1.1115310228308472e-05,0.0,1.0
39044,하지맙시/Noun,1,1,0,1.1115310228308472e-05,0.0,1.0
39045,헸는데/Noun,1,0,1,0.0,1.1106915165381966e-05,1.0
39046,헤저드/Noun,1,0,1,0.0,1.1106915165381966e-05,1.0
39047,생손/Noun,1,0,1,0.0,1.1106915165381966e-05,1.0
39048,내인/Noun,1,0,1,0.0,1.1106915165381966e-05,1.0
39049,글삭/Noun,1,0,1,0.0,1.1106915165381966e-05,1.0
39050,종놈/Noun,1,0,1,0.0,1.1106915165381966e-05,1.0
39051,얘넨/Noun,1,0,1,0.0,1.1106915165381966e-05,1.0
39052,PR/Alpha,1,0,1,0.0,1.1106915165381966e-05,1.0
39053,빡센/Noun,1,0,1,0.0,1.1106915165381966e-05,1.0
39054,게티즈버그/Noun,1,1,0,1.1115310228308472e-05,0.0,1.0
39055,류현상/Noun,1,1,0,1.1115310228308472e-05,0.0,1.0
39056,대중매체/Noun,1,1,0,1.1115310228308472e-05,0.0,1.0
39057,티풀/Noun,1,1,0,1.1115310228308472e-05,0.0,1.0
39058,재판관/Noun,1,1,0,1.1115310228308472e-05,0.0,1.0
39059,프록터/Noun,1,1,0,1.1115310228308472e-05,0.0,1.0
39060,눈보라/Noun,1,1,0,1.1115310228308472e-05,0.0,1.0
39061,헛슨/Noun,1,0,1,0.0,1.1106915165381966e-05,1.0
39062,노빠일테/Noun,1,0,1,0.0,1.1106915165381966e-05,1.0
39063,간본영화중에/Foreign,1,0,1,0.0,1.1106915165381966e-05,1.0
39064,헀/Noun,1,0,1,0.0,1.1106915165381966e-05,1.0
39065,농밀/Noun,1,1,0,1.1115310228308472e-05,0.0,1.0
39066,대동/Noun,1,0,1,0.0,1.1106915165381966e-05,1.0
39067,감퇴/Noun,1,0,1,0.0,1.1106915165381966e-05,1.0
39068,킬힐/Noun,1,1,0,1.1115310228308472e-05,0.0,1.0
39069,로얄패밀리/Noun,1,1,0,1.1115310228308472e-05,0.0,1.0
39070,김종민/Noun,1,0,1,0.0,1.1106915165381966e-05,1.0
39071,병석/Noun,1,0,1,0.0,1.1106915165381966e-05,1.0
39072,짓뭉게/Noun,1,0,1,0.0,1.1106915165381966e-05,1.0
39073,네버엔딩스토리/Noun,1,1,0,1.1115310228308472e-05,0.0,1.0
39074,연두색/Noun,1,0,1,0.0,1.1106915165381966e-05,1.0
39075,왕거미/Noun,1,0,1,0.0,1.1106915165381966e-05,1.0
39076,72년/Number,1,0,1,0.0,1.1106915165381966e-05,1.0
39077,ㅈㅂㅅ/KoreanParticle,1,0,1,0.0,1.1106915165381966e-05,1.0
39078,듬푹/Noun,1,1,0,1.1115310228308472e-05,0.0,1.0
39079,엄한년/Noun,1,0,1,0.0,1.1106915165381966e-05,1.0
39080,중국사/Noun,1,0,1,0.0,1.1106915165381966e-05,1.0
39081,패도여협/Noun,1,1,0,1.1115310228308472e-05,0.0,1.0
39082,이빨몽/Noun,1,1,0,1.1115310228308472e-05,0.0,1.0
39083,눈배/Noun,1,0,1,0.0,1.1106915165381966e-05,1.0
39084,챔피언십/Noun,1,0,1,0.0,1.1106915165381966e-05,1.0
39085,겻가/Noun,1,0,1,0.0,1.1106915165381966e-05,1.0
39086,포복/Noun,1,1,0,1.1115310228308472e-05,0.0,1.0
39087,록킨대/Noun,1,1,0,1.1115310228308472e-05,0.0,1.0
39088,"..`-,.-;/Punctuation",1,0,1,0.0,1.1106915165381966e-05,1.0
39089,폴링스카이/Noun,1,0,1,0.0,1.1106915165381966e-05,1.0
39090,은규/Noun,1,1,0,1.1115310228308472e-05,0.0,1.0
39091,윤현민/Noun,1,1,0,1.1115310228308472e-05,0.0,1.0
39092,따/Noun,1,1,0,1.1115310228308472e-05,0.0,1.0
39093,tj/Alpha,1,1,0,1.1115310228308472e-05,0.0,1.0
39094,//.///Punctuation,1,1,0,1.1115310228308472e-05,0.0,1.0
39095,스타제국/Noun,1,1,0,1.1115310228308472e-05,0.0,1.0
39096,헤니보/Noun,1,0,1,0.0,1.1106915165381966e-05,1.0
39097,뭐저/Noun,1,0,1,0.0,1.1106915165381966e-05,1.0
39098,욕덜/Noun,1,0,1,0.0,1.1106915165381966e-05,1.0
39099,낞/Noun,1,0,1,0.0,1.1106915165381966e-05,1.0
39100,살감/Noun,1,1,0,1.1115310228308472e-05,0.0,1.0
39101,큐레무/Noun,1,0,1,0.0,1.1106915165381966e-05,1.0
39102,깝쭉/Noun,1,0,1,0.0,1.1106915165381966e-05,1.0
39103,이태권/Noun,1,0,1,0.0,1.1106915165381966e-05,1.0
39104,백청강/Noun,1,0,1,0.0,1.1106915165381966e-05,1.0
39105,졸속/Noun,1,0,1,0.0,1.1106915165381966e-05,1.0
39106,~!!!!!>/Punctuation,1,1,0,1.1115310228308472e-05,0.0,1.0
39107,무플/Noun,1,1,0,1.1115310228308472e-05,0.0,1.0
39108,라잉/Noun,1,1,0,1.1115310228308472e-05,0.0,1.0
39109,캌카카캌/Noun,1,1,0,1.1115310228308472e-05,0.0,1.0
39110,잼카/Noun,1,1,0,1.1115310228308472e-05,0.0,1.0
39111,..;;./Punctuation,1,1,0,1.1115310228308472e-05,0.0,1.0
39112,...~!/Punctuation,1,0,1,0.0,1.1106915165381966e-05,1.0
39113,대드/Noun,1,0,1,0.0,1.1106915165381966e-05,1.0
39114,형이상학적/Noun,1,1,0,1.1115310228308472e-05,0.0,1.0
39115,상그레/Noun,1,1,0,1.1115310228308472e-05,0.0,1.0
39116,투팍/Noun,1,0,1,0.0,1.1106915165381966e-05,1.0
39117,regulus/Alpha,1,1,0,1.1115310228308472e-05,0.0,1.0
39118,MAX/Alpha,1,0,1,0.0,1.1106915165381966e-05,1.0
39119,쯔쯔쯧/Noun,1,0,1,0.0,1.1106915165381966e-05,1.0
39120,느들/Noun,1,0,1,0.0,1.1106915165381966e-05,1.0
39121,향토/Noun,1,1,0,1.1115310228308472e-05,0.0,1.0
39122,냔줄/Noun,1,1,0,1.1115310228308472e-05,0.0,1.0
39123,허탕/Noun,1,0,1,0.0,1.1106915165381966e-05,1.0
39124,꼬시는/Noun,1,0,1,0.0,1.1106915165381966e-05,1.0
39125,이미덕/Noun,1,1,0,1.1115310228308472e-05,0.0,1.0
39126,개봉인데/Foreign,1,0,1,0.0,1.1106915165381966e-05,1.0
39127,장은중/Noun,1,1,0,1.1115310228308472e-05,0.0,1.0
39128,6.75/Number,1,1,0,1.1115310228308472e-05,0.0,1.0
39129,애닌데/Noun,1,1,0,1.1115310228308472e-05,0.0,1.0
39130,평의/Noun,1,1,0,1.1115310228308472e-05,0.0,1.0
39131,외딴섬/Noun,1,0,1,0.0,1.1106915165381966e-05,1.0
39132,쩔름/Noun,1,1,0,1.1115310228308472e-05,0.0,1.0
39133,화백/Noun,1,0,1,0.0,1.1106915165381966e-05,1.0
39134,쿄교/Noun,1,0,1,0.0,1.1106915165381966e-05,1.0
39135,만들냔/Noun,1,0,1,0.0,1.1106915165381966e-05,1.0
39136,부총/Noun,1,0,1,0.0,1.1106915165381966e-05,1.0
39137,잼있을까하다가어설픈/Foreign,1,0,1,0.0,1.1106915165381966e-05,1.0
39138,치앙마이/Noun,1,1,0,1.1115310228308472e-05,0.0,1.0
39139,온점/Noun,1,1,0,1.1115310228308472e-05,0.0,1.0
39140,쇠발개쉐기/Noun,1,0,1,0.0,1.1106915165381966e-05,1.0
39141,슈가/Noun,1,0,1,0.0,1.1106915165381966e-05,1.0
39142,10~20/Number,1,0,1,0.0,1.1106915165381966e-05,1.0
39143,스트래던/Noun,1,1,0,1.1115310228308472e-05,0.0,1.0
39144,눈누난나/Adverb,1,1,0,1.1115310228308472e-05,0.0,1.0
39145,콥터/Noun,1,0,1,0.0,1.1106915165381966e-05,1.0
39146,개똥망임/Noun,1,0,1,0.0,1.1106915165381966e-05,1.0
39147,여행가이드/Noun,1,0,1,0.0,1.1106915165381966e-05,1.0
39148,쩄/Noun,1,1,0,1.1115310228308472e-05,0.0,1.0
39149,이넘는닥터지바고도/Foreign,1,0,1,0.0,1.1106915165381966e-05,1.0
39150,녀/Foreign,1,1,0,1.1115310228308472e-05,0.0,1.0
39151,6초/Number,1,1,0,1.1115310228308472e-05,0.0,1.0
39152,ㅅㅂㅈㄱㅅㅈㄱㅊ/KoreanParticle,1,1,0,1.1115310228308472e-05,0.0,1.0
39153,레온/Noun,1,1,0,1.1115310228308472e-05,0.0,1.0
39154,four/Alpha,1,1,0,1.1115310228308472e-05,0.0,1.0
39155,퀜틴영화/Noun,1,0,1,0.0,1.1106915165381966e-05,1.0
39156,ㅅㅅㅡㄹㅔㄱㅣ/KoreanParticle,1,0,1,0.0,1.1106915165381966e-05,1.0
39157,휴양/Noun,1,0,1,0.0,1.1106915165381966e-05,1.0
39158,김태윤/Noun,1,1,0,1.1115310228308472e-05,0.0,1.0
39159,과용/Noun,1,0,1,0.0,1.1106915165381966e-05,1.0
39160,깉아서/Noun,1,0,1,0.0,1.1106915165381966e-05,1.0
39161,!!!!:/Punctuation,1,1,0,1.1115310228308472e-05,0.0,1.0
39162,지려부렷소/Noun,1,1,0,1.1115310228308472e-05,0.0,1.0
39163,"....,,,,...,,/Punctuation",1,0,1,0.0,1.1106915165381966e-05,1.0
39164,윌버그/Noun,1,1,0,1.1115310228308472e-05,0.0,1.0
39165,구창/Noun,1,1,0,1.1115310228308472e-05,0.0,1.0
39166,할때쯤부터/Foreign,1,1,0,1.1115310228308472e-05,0.0,1.0
39167,헨드헬즈/Noun,1,1,0,1.1115310228308472e-05,0.0,1.0
39168,철남/Noun,1,0,1,0.0,1.1106915165381966e-05,1.0
39169,박인기/Noun,1,0,1,0.0,1.1106915165381966e-05,1.0
39170,건희/Noun,1,0,1,0.0,1.1106915165381966e-05,1.0
39171,능디/Noun,1,1,0,1.1115310228308472e-05,0.0,1.0
39172,들었으면/Foreign,1,1,0,1.1115310228308472e-05,0.0,1.0
39173,형사소송/Noun,1,0,1,0.0,1.1106915165381966e-05,1.0
39174,판례/Noun,1,0,1,0.0,1.1106915165381966e-05,1.0
39175,대법원/Noun,1,0,1,0.0,1.1106915165381966e-05,1.0
39176,늘뭐/Noun,1,0,1,0.0,1.1106915165381966e-05,1.0
39177,구간/Noun,1,1,0,1.1115310228308472e-05,0.0,1.0
39178,소윤/Noun,1,1,0,1.1115310228308472e-05,0.0,1.0
39179,ㅉㅈ/KoreanParticle,1,0,1,0.0,1.1106915165381966e-05,1.0
39180,액스트라/Noun,1,1,0,1.1115310228308472e-05,0.0,1.0
39181,알바트로스/Noun,1,1,0,1.1115310228308472e-05,0.0,1.0
39182,ㅡㄷㄹ/KoreanParticle,1,0,1,0.0,1.1106915165381966e-05,1.0
39183,ㄴㅌㅊ/KoreanParticle,1,0,1,0.0,1.1106915165381966e-05,1.0
39184,MIB/Alpha,1,0,1,0.0,1.1106915165381966e-05,1.0
39185,눈싰/Noun,1,0,1,0.0,1.1106915165381966e-05,1.0
39186,표어/Noun,1,0,1,0.0,1.1106915165381966e-05,1.0
39187,KMRC/Alpha,1,0,1,0.0,1.1106915165381966e-05,1.0
39188,뭐밍/Noun,1,0,1,0.0,1.1106915165381966e-05,1.0
39189,린거/Noun,1,1,0,1.1115310228308472e-05,0.0,1.0
39190,존속/Noun,1,1,0,1.1115310228308472e-05,0.0,1.0
39191,젓통/Noun,1,0,1,0.0,1.1106915165381966e-05,1.0
39192,ECC/Alpha,1,1,0,1.1115310228308472e-05,0.0,1.0
39193,이화여대/Noun,1,1,0,1.1115310228308472e-05,0.0,1.0
39194,죽겄/Noun,1,0,1,0.0,1.1106915165381966e-05,1.0
39195,임돈/Noun,1,0,1,0.0,1.1106915165381966e-05,1.0
39196,부술수/Noun,1,0,1,0.0,1.1106915165381966e-05,1.0
39197,탬포럴/Noun,1,1,0,1.1115310228308472e-05,0.0,1.0
39198,치사량/Noun,1,0,1,0.0,1.1106915165381966e-05,1.0
39199,딧노/Noun,1,0,1,0.0,1.1106915165381966e-05,1.0
39200,쌔리/Noun,1,0,1,0.0,1.1106915165381966e-05,1.0
39201,diem/Alpha,1,1,0,1.1115310228308472e-05,0.0,1.0
39202,토랭이/Noun,1,1,0,1.1115310228308472e-05,0.0,1.0
39203,~~~~~~~~!/Punctuation,1,1,0,1.1115310228308472e-05,0.0,1.0
39204,직급/Noun,1,0,1,0.0,1.1106915165381966e-05,1.0
39205,전철협/Noun,1,0,1,0.0,1.1106915165381966e-05,1.0
39206,얼키/Noun,1,1,0,1.1115310228308472e-05,0.0,1.0
39207,섹쉬도/Noun,1,1,0,1.1115310228308472e-05,0.0,1.0
39208,least/Alpha,1,1,0,1.1115310228308472e-05,0.0,1.0
39209,Goddamnit/Alpha,1,1,0,1.1115310228308472e-05,0.0,1.0
39210,tried/Alpha,1,1,0,1.1115310228308472e-05,0.0,1.0
39211,OOin/Alpha,1,0,1,0.0,1.1106915165381966e-05,1.0
39212,꽈놨/Noun,1,0,1,0.0,1.1106915165381966e-05,1.0
39213,느므머싯음/Noun,1,1,0,1.1115310228308472e-05,0.0,1.0
39214,이태현/Noun,1,1,0,1.1115310228308472e-05,0.0,1.0
39215,게머람/Noun,1,0,1,0.0,1.1106915165381966e-05,1.0
39216,흐허/Noun,1,1,0,1.1115310228308472e-05,0.0,1.0
39217,륵규/Noun,1,1,0,1.1115310228308472e-05,0.0,1.0
39218,흐륵/Noun,1,1,0,1.1115310228308472e-05,0.0,1.0
39219,이훌러덩/Foreign,1,1,0,1.1115310228308472e-05,0.0,1.0
39220,만돌린/Noun,1,1,0,1.1115310228308472e-05,0.0,1.0
39221,세계문학/Noun,1,1,0,1.1115310228308472e-05,0.0,1.0
39222,전즘/Foreign,1,0,1,0.0,1.1106915165381966e-05,1.0
39223,봣다햇더니/Noun,1,0,1,0.0,1.1106915165381966e-05,1.0
39224,빡구/Noun,1,1,0,1.1115310228308472e-05,0.0,1.0
39225,에찍은거라니/Foreign,1,0,1,0.0,1.1106915165381966e-05,1.0
39226,오프라인/Noun,1,1,0,1.1115310228308472e-05,0.0,1.0
39227,거취/Noun,1,0,1,0.0,1.1106915165381966e-05,1.0
39228,오혜정/Noun,1,0,1,0.0,1.1106915165381966e-05,1.0
39229,콜때/Noun,1,1,0,1.1115310228308472e-05,0.0,1.0
39230,개뻑다구/Noun,1,0,1,0.0,1.1106915165381966e-05,1.0
39231,마쉐티/Noun,1,0,1,0.0,1.1106915165381966e-05,1.0
39232,승제/Noun,1,0,1,0.0,1.1106915165381966e-05,1.0
39233,?????!!!!!!!!!!!/Punctuation,1,1,0,1.1115310228308472e-05,0.0,1.0
39234,급선무/Noun,1,0,1,0.0,1.1106915165381966e-05,1.0
39235,똥떵똥떵똥/Noun,1,0,1,0.0,1.1106915165381966e-05,1.0
39236,안짐/Noun,1,0,1,0.0,1.1106915165381966e-05,1.0
39237,임신중절/Noun,1,0,1,0.0,1.1106915165381966e-05,1.0
39238,급판/Noun,1,0,1,0.0,1.1106915165381966e-05,1.0
39239,Sucks/Alpha,1,0,1,0.0,1.1106915165381966e-05,1.0
39240,월채/Noun,1,0,1,0.0,1.1106915165381966e-05,1.0
39241,몬보게따/Noun,1,0,1,0.0,1.1106915165381966e-05,1.0
39242,마베/Noun,1,1,0,1.1115310228308472e-05,0.0,1.0
39243,소름끼쳣/Noun,1,1,0,1.1115310228308472e-05,0.0,1.0
39244,아쒸/Noun,1,1,0,1.1115310228308472e-05,0.0,1.0
39245,지퍼/Noun,1,0,1,0.0,1.1106915165381966e-05,1.0
39246,gpgpgp/Alpha,1,1,0,1.1115310228308472e-05,0.0,1.0
39247,톡특/Noun,1,1,0,1.1115310228308472e-05,0.0,1.0
39248,이길레/Noun,1,0,1,0.0,1.1106915165381966e-05,1.0
39249,마산/Noun,1,1,0,1.1115310228308472e-05,0.0,1.0
39250,허문/Noun,1,1,0,1.1115310228308472e-05,0.0,1.0
39251,",~/Punctuation",1,0,1,0.0,1.1106915165381966e-05,1.0
39252,슬푸답/Noun,1,1,0,1.1115310228308472e-05,0.0,1.0
39253,cjs/Alpha,1,1,0,1.1115310228308472e-05,0.0,1.0
39254,시리아/Noun,1,1,0,1.1115310228308472e-05,0.0,1.0
39255,빠팅/Noun,1,1,0,1.1115310228308472e-05,0.0,1.0
39256,실홥/Noun,1,0,1,0.0,1.1106915165381966e-05,1.0
39257,또니몬따/Noun,1,1,0,1.1115310228308472e-05,0.0,1.0
39258,띠방/Noun,1,0,1,0.0,1.1106915165381966e-05,1.0
39259,련넌/Noun,1,0,1,0.0,1.1106915165381966e-05,1.0
39260,잼있닥/Noun,1,1,0,1.1115310228308472e-05,0.0,1.0
39261,플룻/Noun,1,0,1,0.0,1.1106915165381966e-05,1.0
39262,적음/Noun,1,1,0,1.1115310228308472e-05,0.0,1.0
39263,재원/Noun,1,1,0,1.1115310228308472e-05,0.0,1.0
39264,김정남/Noun,1,0,1,0.0,1.1106915165381966e-05,1.0
39265,카타리나/Noun,1,1,0,1.1115310228308472e-05,0.0,1.0
39266,씨풋/Noun,1,0,1,0.0,1.1106915165381966e-05,1.0
39267,철옹성/Noun,1,1,0,1.1115310228308472e-05,0.0,1.0
39268,러블리본즈/Noun,1,0,1,0.0,1.1106915165381966e-05,1.0
39269,러블리임/Noun,1,1,0,1.1115310228308472e-05,0.0,1.0
39270,언론외압/Noun,1,0,1,0.0,1.1106915165381966e-05,1.0
39271,극우파/Noun,1,0,1,0.0,1.1106915165381966e-05,1.0
39272,맹견/Noun,1,0,1,0.0,1.1106915165381966e-05,1.0
39273,5.99/Number,1,0,1,0.0,1.1106915165381966e-05,1.0
39274,정준일/Noun,1,1,0,1.1115310228308472e-05,0.0,1.0
39275,환청/Noun,1,0,1,0.0,1.1106915165381966e-05,1.0
39276,眞味/Foreign,1,1,0,1.1115310228308472e-05,0.0,1.0
39277,똘볼수/Noun,1,1,0,1.1115310228308472e-05,0.0,1.0
39278,失緣/Foreign,1,1,0,1.1115310228308472e-05,0.0,1.0
39279,이은선/Noun,1,1,0,1.1115310228308472e-05,0.0,1.0
39280,!!!!:-))/Punctuation,1,1,0,1.1115310228308472e-05,0.0,1.0
39281,체게바라/Noun,1,0,1,0.0,1.1106915165381966e-05,1.0
39282,졉/Noun,1,0,1,0.0,1.1106915165381966e-05,1.0
39283,알도/Noun,1,1,0,1.1115310228308472e-05,0.0,1.0
39284,이정문/Noun,1,1,0,1.1115310228308472e-05,0.0,1.0
39285,정태수/Noun,1,1,0,1.1115310228308472e-05,0.0,1.0
39286,청부맨/Noun,1,1,0,1.1115310228308472e-05,0.0,1.0
39287,박웅/Noun,1,1,0,1.1115310228308472e-05,0.0,1.0
39288,백족/Noun,1,1,0,1.1115310228308472e-05,0.0,1.0
39289,구탁/Noun,1,1,0,1.1115310228308472e-05,0.0,1.0
39290,췬/Noun,1,1,0,1.1115310228308472e-05,0.0,1.0
39291,§/Foreign,1,1,0,1.1115310228308472e-05,0.0,1.0
39292,♥₂§/Foreign,1,1,0,1.1115310228308472e-05,0.0,1.0
39293,홍빵/Noun,1,1,0,1.1115310228308472e-05,0.0,1.0
39294,3602/Number,1,1,0,1.1115310228308472e-05,0.0,1.0
39295,모의/Noun,1,1,0,1.1115310228308472e-05,0.0,1.0
39296,겉노/Noun,1,0,1,0.0,1.1106915165381966e-05,1.0
39297,3190/Number,1,0,1,0.0,1.1106915165381966e-05,1.0
39298,198/Number,1,0,1,0.0,1.1106915165381966e-05,1.0
39299,우걱우걱/Adverb,1,0,1,0.0,1.1106915165381966e-05,1.0
39300,VGA/Alpha,1,0,1,0.0,1.1106915165381966e-05,1.0
39301,크로스파이어/Noun,1,0,1,0.0,1.1106915165381966e-05,1.0
39302,아니랠까봐/Noun,1,0,1,0.0,1.1106915165381966e-05,1.0
39303,북핵/Noun,1,0,1,0.0,1.1106915165381966e-05,1.0
39304,어쩌니할때/Noun,1,0,1,0.0,1.1106915165381966e-05,1.0
39305,개찡/Noun,1,0,1,0.0,1.1106915165381966e-05,1.0
39306,...(?)/Punctuation,1,0,1,0.0,1.1106915165381966e-05,1.0
39307,빠졔/Noun,1,0,1,0.0,1.1106915165381966e-05,1.0
39308,KIM/Alpha,1,0,1,0.0,1.1106915165381966e-05,1.0
39309,JEON/Alpha,1,0,1,0.0,1.1106915165381966e-05,1.0
39310,LEE/Alpha,1,0,1,0.0,1.1106915165381966e-05,1.0
39311,15%/Number,1,1,0,1.1115310228308472e-05,0.0,1.0
39312,스콜피온/Noun,1,0,1,0.0,1.1106915165381966e-05,1.0
39313,egle/Alpha,1,0,1,0.0,1.1106915165381966e-05,1.0
39314,...=_=;/Punctuation,1,0,1,0.0,1.1106915165381966e-05,1.0
39315,370/Number,1,0,1,0.0,1.1106915165381966e-05,1.0
39316,....!!~~~~/Punctuation,1,0,1,0.0,1.1106915165381966e-05,1.0
39317,LOVEEEEEEEEEE/Alpha,1,1,0,1.1115310228308472e-05,0.0,1.0
39318,수녀복/Noun,1,0,1,0.0,1.1106915165381966e-05,1.0
39319,................;;/Punctuation,1,0,1,0.0,1.1106915165381966e-05,1.0
39320,멌었엇/Noun,1,1,0,1.1115310228308472e-05,0.0,1.0
39321,모역/Noun,1,1,0,1.1115310228308472e-05,0.0,1.0
39322,.......^^;/Punctuation,1,0,1,0.0,1.1106915165381966e-05,1.0
39323,박변/Noun,1,1,0,1.1115310228308472e-05,0.0,1.0
39324,커팅/Noun,1,0,1,0.0,1.1106915165381966e-05,1.0
39325,반젤리스/Noun,1,1,0,1.1115310228308472e-05,0.0,1.0
39326,"...,../Punctuation",1,0,1,0.0,1.1106915165381966e-05,1.0
39327,",.,.,./Punctuation",1,0,1,0.0,1.1106915165381966e-05,1.0
39328,".,.,.,../Punctuation",1,0,1,0.0,1.1106915165381966e-05,1.0
39329,썰렁유머/Noun,1,0,1,0.0,1.1106915165381966e-05,1.0
39330,놜려잉/Noun,1,1,0,1.1115310228308472e-05,0.0,1.0
39331,개굿굿굿/Noun,1,1,0,1.1115310228308472e-05,0.0,1.0
39332,빌리헤링턴/Noun,1,0,1,0.0,1.1106915165381966e-05,1.0
39333,정도밖/Foreign,1,1,0,1.1115310228308472e-05,0.0,1.0
39334,짱잼/Noun,1,1,0,1.1115310228308472e-05,0.0,1.0
39335,BEL/Alpha,1,0,1,0.0,1.1106915165381966e-05,1.0
39336,SI/Alpha,1,0,1,0.0,1.1106915165381966e-05,1.0
39337,힌극/Noun,1,1,0,1.1115310228308472e-05,0.0,1.0
39338,슈어/Noun,1,0,1,0.0,1.1106915165381966e-05,1.0
39339,어쩔꺼/Foreign,1,0,1,0.0,1.1106915165381966e-05,1.0
39340,북미판/Noun,1,1,0,1.1115310228308472e-05,0.0,1.0
39341,롸마/Noun,1,1,0,1.1115310228308472e-05,0.0,1.0
39342,개신교도/Noun,1,0,1,0.0,1.1106915165381966e-05,1.0
39343,무슴/Noun,1,0,1,0.0,1.1106915165381966e-05,1.0
39344,gghdhfksdhgkdsg/Alpha,1,1,0,1.1115310228308472e-05,0.0,1.0
39345,체커/Noun,1,0,1,0.0,1.1106915165381966e-05,1.0
39346,미니쿠퍼/Noun,1,0,1,0.0,1.1106915165381966e-05,1.0
39347,해논/Noun,1,1,0,1.1115310228308472e-05,0.0,1.0
39348,래시/Noun,1,0,1,0.0,1.1106915165381966e-05,1.0
39349,엎히기/Noun,1,0,1,0.0,1.1106915165381966e-05,1.0
39350,망둥이/Noun,1,1,0,1.1115310228308472e-05,0.0,1.0
39351,꼴뚜기/Noun,1,1,0,1.1115310228308472e-05,0.0,1.0
39352,접대/Noun,1,0,1,0.0,1.1106915165381966e-05,1.0
39353,달향/Noun,1,1,0,1.1115310228308472e-05,0.0,1.0
39354,체지방률/Noun,1,0,1,0.0,1.1106915165381966e-05,1.0
39355,디바이스/Noun,1,0,1,0.0,1.1106915165381966e-05,1.0
39356,몰개/Noun,1,0,1,0.0,1.1106915165381966e-05,1.0
39357,이승신/Noun,1,0,1,0.0,1.1106915165381966e-05,1.0
39358,물토/Noun,1,0,1,0.0,1.1106915165381966e-05,1.0
39359,레자/Noun,1,1,0,1.1115310228308472e-05,0.0,1.0
39360,담봉/Noun,1,0,1,0.0,1.1106915165381966e-05,1.0
39361,양조/Noun,1,0,1,0.0,1.1106915165381966e-05,1.0
39362,호부/Noun,1,0,1,0.0,1.1106915165381966e-05,1.0
39363,춫천/Noun,1,1,0,1.1115310228308472e-05,0.0,1.0
39364,보셧으/Noun,1,1,0,1.1115310228308472e-05,0.0,1.0
39365,";;,/Punctuation",1,0,1,0.0,1.1106915165381966e-05,1.0
39366,피질/Noun,1,0,1,0.0,1.1106915165381966e-05,1.0
39367,steady/Alpha,1,1,0,1.1115310228308472e-05,0.0,1.0
39368,realistic/Alpha,1,1,0,1.1115310228308472e-05,0.0,1.0
39369,총총/Noun,1,1,0,1.1115310228308472e-05,0.0,1.0
39370,놨두/Noun,1,0,1,0.0,1.1106915165381966e-05,1.0
39371,킬리만자로/Noun,1,1,0,1.1115310228308472e-05,0.0,1.0
39372,길목/Noun,1,1,0,1.1115310228308472e-05,0.0,1.0
39373,님그강/Noun,1,1,0,1.1115310228308472e-05,0.0,1.0
39374,윽수/Noun,1,1,0,1.1115310228308472e-05,0.0,1.0
39375,이모저모/Noun,1,1,0,1.1115310228308472e-05,0.0,1.0
39376,마심/Noun,1,0,1,0.0,1.1106915165381966e-05,1.0
39377,Gooood/Alpha,1,1,0,1.1115310228308472e-05,0.0,1.0
39378,재털/Noun,1,0,1,0.0,1.1106915165381966e-05,1.0
39379,훼이보릿/Noun,1,1,0,1.1115310228308472e-05,0.0,1.0
39380,부에노스아이레스/Noun,1,1,0,1.1115310228308472e-05,0.0,1.0
39381,maincharacter/Alpha,1,1,0,1.1115310228308472e-05,0.0,1.0
39382,alba/Alpha,1,1,0,1.1115310228308472e-05,0.0,1.0
39383,introduction/Alpha,1,1,0,1.1115310228308472e-05,0.0,1.0
39384,undertand/Alpha,1,1,0,1.1115310228308472e-05,0.0,1.0
39385,두번봣다/Noun,1,1,0,1.1115310228308472e-05,0.0,1.0
39386,자제력/Noun,1,1,0,1.1115310228308472e-05,0.0,1.0
39387,~~~~~~~~~~~~~~~~~~~~~~~~~~`/Punctuation,1,0,1,0.0,1.1106915165381966e-05,1.0
39388,시판/Noun,1,0,1,0.0,1.1106915165381966e-05,1.0
39389,휑/Noun,1,0,1,0.0,1.1106915165381966e-05,1.0
39390,"-'""'""'""'""'""/Punctuation",1,1,0,1.1115310228308472e-05,0.0,1.0
39391,쎠/Noun,1,0,1,0.0,1.1106915165381966e-05,1.0
39392,???.........../Punctuation,1,1,0,1.1115310228308472e-05,0.0,1.0
39393,발퀄/Noun,1,0,1,0.0,1.1106915165381966e-05,1.0
39394,차럼/Noun,1,0,1,0.0,1.1106915165381966e-05,1.0
39395,딥답/Noun,1,0,1,0.0,1.1106915165381966e-05,1.0
39396,요제프/Noun,1,1,0,1.1115310228308472e-05,0.0,1.0
39397,불보듯/Noun,1,0,1,0.0,1.1106915165381966e-05,1.0
39398,싸움판/Noun,1,0,1,0.0,1.1106915165381966e-05,1.0
39399,구경이/Noun,1,0,1,0.0,1.1106915165381966e-05,1.0
39400,자잼슴/Noun,1,1,0,1.1115310228308472e-05,0.0,1.0
39401,불모/Noun,1,1,0,1.1115310228308472e-05,0.0,1.0
39402,보르/Noun,1,0,1,0.0,1.1106915165381966e-05,1.0
39403,닐패/Noun,1,1,0,1.1115310228308472e-05,0.0,1.0
39404,올챙이/Noun,1,0,1,0.0,1.1106915165381966e-05,1.0
39405,읎어/Noun,1,0,1,0.0,1.1106915165381966e-05,1.0
39406,대야/Foreign,1,0,1,0.0,1.1106915165381966e-05,1.0
39407,isn/Alpha,1,1,0,1.1115310228308472e-05,0.0,1.0
39408,strange/Alpha,1,1,0,1.1115310228308472e-05,0.0,1.0
39409,겟더훡/Noun,1,0,1,0.0,1.1106915165381966e-05,1.0
39410,봣어듀/Noun,1,0,1,0.0,1.1106915165381966e-05,1.0
39411,messy/Alpha,1,0,1,0.0,1.1106915165381966e-05,1.0
39412,구이/Noun,1,0,1,0.0,1.1106915165381966e-05,1.0
39413,시민케인/Noun,1,1,0,1.1115310228308472e-05,0.0,1.0
39414,리비도/Noun,1,1,0,1.1115310228308472e-05,0.0,1.0
39415,experiment/Alpha,1,0,1,0.0,1.1106915165381966e-05,1.0
39416,das/Alpha,1,0,1,0.0,1.1106915165381966e-05,1.0
39417,먹엇엇음/Noun,1,1,0,1.1115310228308472e-05,0.0,1.0
39418,망작됫/Noun,1,0,1,0.0,1.1106915165381966e-05,1.0
39419,아퀘트/Noun,1,1,0,1.1115310228308472e-05,0.0,1.0
39420,패트리샤/Noun,1,1,0,1.1115310228308472e-05,0.0,1.0
39421,직샷보/Noun,1,0,1,0.0,1.1106915165381966e-05,1.0
39422,선돈/Noun,1,0,1,0.0,1.1106915165381966e-05,1.0
39423,오보에/Noun,1,1,0,1.1115310228308472e-05,0.0,1.0
39424,미구엘/Noun,1,1,0,1.1115310228308472e-05,0.0,1.0
39425,잘봣는데굿/Noun,1,1,0,1.1115310228308472e-05,0.0,1.0
39426,트와이라잇/Noun,1,0,1,0.0,1.1106915165381966e-05,1.0
39427,심음/Noun,1,0,1,0.0,1.1106915165381966e-05,1.0
39428,을생각하며/Foreign,1,1,0,1.1115310228308472e-05,0.0,1.0
39429,무념/Noun,1,0,1,0.0,1.1106915165381966e-05,1.0
39430,이켠/Noun,1,0,1,0.0,1.1106915165381966e-05,1.0
39431,jo/Alpha,1,1,0,1.1115310228308472e-05,0.0,1.0
39432,덩크/Noun,1,1,0,1.1115310228308472e-05,0.0,1.0
39433,삼발이/Noun,1,0,1,0.0,1.1106915165381966e-05,1.0
39434,VVIP/Alpha,1,0,1,0.0,1.1106915165381966e-05,1.0
39435,초입/Noun,1,0,1,0.0,1.1106915165381966e-05,1.0
39436,marvelous/Alpha,1,1,0,1.1115310228308472e-05,0.0,1.0
39437,GARBAGE/Alpha,1,0,1,0.0,1.1106915165381966e-05,1.0
39438,.......?/Punctuation,1,0,1,0.0,1.1106915165381966e-05,1.0
39439,진실게임/Noun,1,1,0,1.1115310228308472e-05,0.0,1.0
39440,수군/Noun,1,0,1,0.0,1.1106915165381966e-05,1.0
39441,삼도/Noun,1,0,1,0.0,1.1106915165381966e-05,1.0
39442,좌수사/Noun,1,0,1,0.0,1.1106915165381966e-05,1.0
39443,살아듵/Noun,1,0,1,0.0,1.1106915165381966e-05,1.0
39444,이란희/Noun,1,1,0,1.1115310228308472e-05,0.0,1.0
39445,영석/Noun,1,1,0,1.1115310228308472e-05,0.0,1.0
39446,마라도/Noun,1,0,1,0.0,1.1106915165381966e-05,1.0
39447,골렘/Noun,1,0,1,0.0,1.1106915165381966e-05,1.0
39448,혁리/Noun,1,0,1,0.0,1.1106915165381966e-05,1.0
39449,선봉/Noun,1,0,1,0.0,1.1106915165381966e-05,1.0
39450,952/Number,1,0,1,0.0,1.1106915165381966e-05,1.0
39451,김진성/Noun,1,0,1,0.0,1.1106915165381966e-05,1.0
39452,유신고/Noun,1,0,1,0.0,1.1106915165381966e-05,1.0
39453,도에나오나/Foreign,1,1,0,1.1115310228308472e-05,0.0,1.0
39454,2019년/Number,1,1,0,1.1115310228308472e-05,0.0,1.0
39455,노만디러스때매/Noun,1,1,0,1.1115310228308472e-05,0.0,1.0
39456,~~;;;;/Punctuation,1,0,1,0.0,1.1106915165381966e-05,1.0
39457,"""""""""''''""'/Punctuation",1,1,0,1.1115310228308472e-05,0.0,1.0
39458,프로필사진/Noun,1,1,0,1.1115310228308472e-05,0.0,1.0
39459,서모/Noun,1,1,0,1.1115310228308472e-05,0.0,1.0
39460,까지봐도/Foreign,1,0,1,0.0,1.1106915165381966e-05,1.0
39461,cobe/Alpha,1,0,1,0.0,1.1106915165381966e-05,1.0
39462,마스카니/Noun,1,1,0,1.1115310228308472e-05,0.0,1.0
39463,situation/Alpha,1,0,1,0.0,1.1106915165381966e-05,1.0
39464,장망/Noun,1,1,0,1.1115310228308472e-05,0.0,1.0
39465,빠의힘/Noun,1,0,1,0.0,1.1106915165381966e-05,1.0
39466,깤/Noun,1,0,1,0.0,1.1106915165381966e-05,1.0
39467,가츠마타/Noun,1,1,0,1.1115310228308472e-05,0.0,1.0
39468,핫토리/Noun,1,1,0,1.1115310228308472e-05,0.0,1.0
39469,촌것/Noun,1,0,1,0.0,1.1106915165381966e-05,1.0
39470,프로메슘/Noun,1,1,0,1.1115310228308472e-05,0.0,1.0
39471,태미/Noun,1,0,1,0.0,1.1106915165381966e-05,1.0
39472,셍략/Noun,1,0,1,0.0,1.1106915165381966e-05,1.0
39473,인선/Noun,1,1,0,1.1115310228308472e-05,0.0,1.0
39474,드넒/Noun,1,0,1,0.0,1.1106915165381966e-05,1.0
39475,왜세/Noun,1,0,1,0.0,1.1106915165381966e-05,1.0
39476,8.67/Number,1,0,1,0.0,1.1106915165381966e-05,1.0
39477,셨습닏/Noun,1,1,0,1.1115310228308472e-05,0.0,1.0
39478,하네욤/Noun,1,0,1,0.0,1.1106915165381966e-05,1.0
39479,뻣다/Noun,1,0,1,0.0,1.1106915165381966e-05,1.0
39480,재섭/Noun,1,1,0,1.1115310228308472e-05,0.0,1.0
39481,초폭/Noun,1,0,1,0.0,1.1106915165381966e-05,1.0
39482,의종/Noun,1,0,1,0.0,1.1106915165381966e-05,1.0
39483,성삼위/Noun,1,0,1,0.0,1.1106915165381966e-05,1.0
39484,안성훈/Noun,1,0,1,0.0,1.1106915165381966e-05,1.0
39485,!??????????????/Punctuation,1,1,0,1.1115310228308472e-05,0.0,1.0
39486,쪼아/Noun,1,1,0,1.1115310228308472e-05,0.0,1.0
39487,엄친아/Noun,1,1,0,1.1115310228308472e-05,0.0,1.0
39488,이승복/Noun,1,0,1,0.0,1.1106915165381966e-05,1.0
39489,탐색/Noun,1,1,0,1.1115310228308472e-05,0.0,1.0
39490,깨뿔/Noun,1,0,1,0.0,1.1106915165381966e-05,1.0
39491,觸法/Foreign,1,0,1,0.0,1.1106915165381966e-05,1.0
39492,촉법/Noun,1,0,1,0.0,1.1106915165381966e-05,1.0
39493,골빈애/Noun,1,0,1,0.0,1.1106915165381966e-05,1.0
39494,총열/Noun,1,1,0,1.1115310228308472e-05,0.0,1.0
39495,hanjimin/Alpha,1,1,0,1.1115310228308472e-05,0.0,1.0
39496,들자/Foreign,1,0,1,0.0,1.1106915165381966e-05,1.0
39497,디브이/Noun,1,0,1,0.0,1.1106915165381966e-05,1.0
39498,현주엽/Noun,1,0,1,0.0,1.1106915165381966e-05,1.0
39499,명일/Noun,1,1,0,1.1115310228308472e-05,0.0,1.0
39500,억원/Noun,1,0,1,0.0,1.1106915165381966e-05,1.0
39501,수조/Noun,1,0,1,0.0,1.1106915165381966e-05,1.0
39502,뒷트임/Noun,1,0,1,0.0,1.1106915165381966e-05,1.0
39503,살렵니/Noun,1,1,0,1.1115310228308472e-05,0.0,1.0
39504,황보관/Noun,1,0,1,0.0,1.1106915165381966e-05,1.0
39505,수아레즈/Noun,1,0,1,0.0,1.1106915165381966e-05,1.0
39506,은의자/Noun,1,1,0,1.1115310228308472e-05,0.0,1.0
39507,Out/Alpha,1,0,1,0.0,1.1106915165381966e-05,1.0
39508,Heart/Alpha,1,0,1,0.0,1.1106915165381966e-05,1.0
39509,Your/Alpha,1,0,1,0.0,1.1106915165381966e-05,1.0
39510,Crying/Alpha,1,0,1,0.0,1.1106915165381966e-05,1.0
39511,Stop/Alpha,1,0,1,0.0,1.1106915165381966e-05,1.0
39512,펩샵/Noun,1,0,1,0.0,1.1106915165381966e-05,1.0
39513,메트로폴리탄/Noun,1,1,0,1.1115310228308472e-05,0.0,1.0
39514,봉착/Noun,1,1,0,1.1115310228308472e-05,0.0,1.0
39515,심타/Noun,1,0,1,0.0,1.1106915165381966e-05,1.0
39516,예식장/Noun,1,0,1,0.0,1.1106915165381966e-05,1.0
39517,사거리/Noun,1,0,1,0.0,1.1106915165381966e-05,1.0
39518,저러케/Noun,1,1,0,1.1115310228308472e-05,0.0,1.0
39519,가솔/Noun,1,1,0,1.1115310228308472e-05,0.0,1.0
39520,뵨태적/Noun,1,0,1,0.0,1.1106915165381966e-05,1.0
39521,sibar/Alpha,1,0,1,0.0,1.1106915165381966e-05,1.0
39522,사랍/Noun,1,0,1,0.0,1.1106915165381966e-05,1.0
39523,?~!@/Punctuation,1,1,0,1.1115310228308472e-05,0.0,1.0
39524,2.28/Number,1,0,1,0.0,1.1106915165381966e-05,1.0
39525,번/Foreign,1,0,1,0.0,1.1106915165381966e-05,1.0
39526,BDSM/Alpha,1,0,1,0.0,1.1106915165381966e-05,1.0
39527,즉결심판/Noun,1,1,0,1.1115310228308472e-05,0.0,1.0
39528,슴돵/Noun,1,1,0,1.1115310228308472e-05,0.0,1.0
39529,풍념/Noun,1,0,1,0.0,1.1106915165381966e-05,1.0
39530,Gr/Alpha,1,0,1,0.0,1.1106915165381966e-05,1.0
39531,10~20년/Number,1,0,1,0.0,1.1106915165381966e-05,1.0
39532,ㅓㅁㅈ/KoreanParticle,1,0,1,0.0,1.1106915165381966e-05,1.0
39533,ㅓㅜ/KoreanParticle,1,0,1,0.0,1.1106915165381966e-05,1.0
39534,ㅋㅋㅋㅠㅠ/KoreanParticle,1,0,1,0.0,1.1106915165381966e-05,1.0
39535,엄수/Noun,1,0,1,0.0,1.1106915165381966e-05,1.0
39536,이성호/Noun,1,0,1,0.0,1.1106915165381966e-05,1.0
39537,일이구/Noun,1,1,0,1.1115310228308472e-05,0.0,1.0
39538,어럼풋/Noun,1,0,1,0.0,1.1106915165381966e-05,1.0
39539,미켈/Noun,1,1,0,1.1115310228308472e-05,0.0,1.0
39540,…;;/Punctuation,1,0,1,0.0,1.1106915165381966e-05,1.0
39541,핑크돌즈/Noun,1,0,1,0.0,1.1106915165381966e-05,1.0
39542,Duvet/Alpha,1,1,0,1.1115310228308472e-05,0.0,1.0
39543,Lain/Alpha,1,1,0,1.1115310228308472e-05,0.0,1.0
39544,부라리다/Verb,1,1,0,1.1115310228308472e-05,0.0,1.0
39545,골깜/Noun,1,1,0,1.1115310228308472e-05,0.0,1.0
39546,양축/Noun,1,1,0,1.1115310228308472e-05,0.0,1.0
39547,빙고게임/Noun,1,1,0,1.1115310228308472e-05,0.0,1.0
39548,탑스페샬쇼/Noun,1,0,1,0.0,1.1106915165381966e-05,1.0
39549,유미주/Noun,1,1,0,1.1115310228308472e-05,0.0,1.0
39550,수전/Noun,1,1,0,1.1115310228308472e-05,0.0,1.0
39551,급식/Noun,1,0,1,0.0,1.1106915165381966e-05,1.0
39552,이지났지만/Foreign,1,1,0,1.1115310228308472e-05,0.0,1.0
39553,또힌/Noun,1,1,0,1.1115310228308472e-05,0.0,1.0
39554,로버트패틴슨/Noun,1,0,1,0.0,1.1106915165381966e-05,1.0
39555,해뜸/Noun,1,0,1,0.0,1.1106915165381966e-05,1.0
39556,닥터슬럼프/Noun,1,1,0,1.1115310228308472e-05,0.0,1.0
39557,땍땍/Noun,1,0,1,0.0,1.1106915165381966e-05,1.0
39558,공학자/Noun,1,1,0,1.1115310228308472e-05,0.0,1.0
39559,현중/Noun,1,0,1,0.0,1.1106915165381966e-05,1.0
39560,7만/Number,1,0,1,0.0,1.1106915165381966e-05,1.0
39561,120만/Number,1,0,1,0.0,1.1106915165381966e-05,1.0
39562,아프리카물소/Noun,1,0,1,0.0,1.1106915165381966e-05,1.0
39563,농부가/Noun,1,0,1,0.0,1.1106915165381966e-05,1.0
39564,Dmz/Alpha,1,0,1,0.0,1.1106915165381966e-05,1.0
39565,예우/Noun,1,0,1,0.0,1.1106915165381966e-05,1.0
39566,티바/Noun,1,1,0,1.1115310228308472e-05,0.0,1.0
39567,8.97/Number,1,0,1,0.0,1.1106915165381966e-05,1.0
39568,더부살이/Noun,1,1,0,1.1115310228308472e-05,0.0,1.0
39569,이광기/Noun,1,1,0,1.1115310228308472e-05,0.0,1.0
39570,다시봣/Noun,1,1,0,1.1115310228308472e-05,0.0,1.0
39571,김병조/Noun,1,1,0,1.1115310228308472e-05,0.0,1.0
39572,씨엡/Noun,1,1,0,1.1115310228308472e-05,0.0,1.0
39573,하게타카/Noun,1,0,1,0.0,1.1106915165381966e-05,1.0
39574,하랴/Noun,1,0,1,0.0,1.1106915165381966e-05,1.0
39575,texas/Alpha,1,1,0,1.1115310228308472e-05,0.0,1.0
39576,평절/Noun,1,0,1,0.0,1.1106915165381966e-05,1.0
39577,롤코/Noun,1,0,1,0.0,1.1106915165381966e-05,1.0
39578,베끼삼/Noun,1,1,0,1.1115310228308472e-05,0.0,1.0
39579,다비/Noun,1,0,1,0.0,1.1106915165381966e-05,1.0
39580,최림/Noun,1,1,0,1.1115310228308472e-05,0.0,1.0
39581,?_?/Punctuation,1,0,1,0.0,1.1106915165381966e-05,1.0
39582,오버플로우/Noun,1,0,1,0.0,1.1106915165381966e-05,1.0
39583,9.04/Number,1,0,1,0.0,1.1106915165381966e-05,1.0
39584,닥리/Noun,1,1,0,1.1115310228308472e-05,0.0,1.0
39585,쫑났군/Noun,1,0,1,0.0,1.1106915165381966e-05,1.0
39586,야츠/Noun,1,0,1,0.0,1.1106915165381966e-05,1.0
39587,송민호/Noun,1,0,1,0.0,1.1106915165381966e-05,1.0
39588,깨금/Noun,1,1,0,1.1115310228308472e-05,0.0,1.0
39589,카네기홀/Noun,1,1,0,1.1115310228308472e-05,0.0,1.0
39590,의분/Noun,1,0,1,0.0,1.1106915165381966e-05,1.0
39591,)]/Punctuation,1,1,0,1.1115310228308472e-05,0.0,1.0
39592,문맥/Noun,1,1,0,1.1115310228308472e-05,0.0,1.0
39593,야채부락리/Noun,1,1,0,1.1115310228308472e-05,0.0,1.0
39594,럴맞/Noun,1,0,1,0.0,1.1106915165381966e-05,1.0
39595,수채/Noun,1,0,1,0.0,1.1106915165381966e-05,1.0
39596,홀란드/Noun,1,1,0,1.1115310228308472e-05,0.0,1.0
39597,zzzzzzzzzzzzzzz/Alpha,1,0,1,0.0,1.1106915165381966e-05,1.0
39598,옜/Noun,1,1,0,1.1115310228308472e-05,0.0,1.0
39599,곤지암/Noun,1,0,1,0.0,1.1106915165381966e-05,1.0
39600,마게/Noun,1,0,1,0.0,1.1106915165381966e-05,1.0
39601,뾰루퉁/Noun,1,1,0,1.1115310228308472e-05,0.0,1.0
39602,좋구랴/Noun,1,0,1,0.0,1.1106915165381966e-05,1.0
39603,앖/Noun,1,0,1,0.0,1.1106915165381966e-05,1.0
39604,뻔데기/Noun,1,1,0,1.1115310228308472e-05,0.0,1.0
39605,뭍힐때/Noun,1,1,0,1.1115310228308472e-05,0.0,1.0
39606,형용사/Noun,1,1,0,1.1115310228308472e-05,0.0,1.0
39607,콘트라/Noun,1,0,1,0.0,1.1106915165381966e-05,1.0
39608,옷고름/Noun,1,1,0,1.1115310228308472e-05,0.0,1.0
39609,슬론/Noun,1,0,1,0.0,1.1106915165381966e-05,1.0
39610,마에노/Noun,1,0,1,0.0,1.1106915165381966e-05,1.0
39611,하중/Noun,1,0,1,0.0,1.1106915165381966e-05,1.0
39612,찌아/Noun,1,0,1,0.0,1.1106915165381966e-05,1.0
39613,밍쿠/Noun,1,0,1,0.0,1.1106915165381966e-05,1.0
39614,주늑/Noun,1,1,0,1.1115310228308472e-05,0.0,1.0
39615,거덩/Noun,1,0,1,0.0,1.1106915165381966e-05,1.0
39616,마니괜찬슴/Noun,1,1,0,1.1115310228308472e-05,0.0,1.0
39617,채권자/Noun,1,0,1,0.0,1.1106915165381966e-05,1.0
39618,채무자/Noun,1,0,1,0.0,1.1106915165381966e-05,1.0
39619,에리오/Noun,1,1,0,1.1115310228308472e-05,0.0,1.0
39620,테그/Noun,1,0,1,0.0,1.1106915165381966e-05,1.0
39621,입막음/Noun,1,0,1,0.0,1.1106915165381966e-05,1.0
39622,뀨뀨뀨/Noun,1,0,1,0.0,1.1106915165381966e-05,1.0
39623,오백/Noun,1,0,1,0.0,1.1106915165381966e-05,1.0
39624,하모하모/Noun,1,0,1,0.0,1.1106915165381966e-05,1.0
39625,ㅋㅋㅋㅈㅅ/KoreanParticle,1,1,0,1.1115310228308472e-05,0.0,1.0
39626,어드벤처영화/Noun,1,1,0,1.1115310228308472e-05,0.0,1.0
39627,딸뇬때문/Noun,1,0,1,0.0,1.1106915165381966e-05,1.0
39628,쟈규/Noun,1,0,1,0.0,1.1106915165381966e-05,1.0
39629,굴굼/Noun,1,0,1,0.0,1.1106915165381966e-05,1.0
39630,????./Punctuation,1,0,1,0.0,1.1106915165381966e-05,1.0
39631,스윙/Noun,1,0,1,0.0,1.1106915165381966e-05,1.0
39632,希望/Foreign,1,1,0,1.1115310228308472e-05,0.0,1.0
39633,終末/Foreign,1,1,0,1.1115310228308472e-05,0.0,1.0
39634,惡/Foreign,1,1,0,1.1115310228308472e-05,0.0,1.0
39635,롤케이크/Noun,1,0,1,0.0,1.1106915165381966e-05,1.0
39636,베르나/Noun,1,0,1,0.0,1.1106915165381966e-05,1.0
39637,마법천자문/Noun,1,1,0,1.1115310228308472e-05,0.0,1.0
39638,헸/Noun,1,0,1,0.0,1.1106915165381966e-05,1.0
39639,ed/Alpha,1,0,1,0.0,1.1106915165381966e-05,1.0
39640,쒰더/Noun,1,0,1,0.0,1.1106915165381966e-05,1.0
39641,야웅/Noun,1,1,0,1.1115310228308472e-05,0.0,1.0
39642,팅탄입니/Noun,1,1,0,1.1115310228308472e-05,0.0,1.0
39643,ㄱㄴㄱㄹㅇ/KoreanParticle,1,0,1,0.0,1.1106915165381966e-05,1.0
39644,괺찮았/Noun,1,0,1,0.0,1.1106915165381966e-05,1.0
39645,도깨비불/Noun,1,1,0,1.1115310228308472e-05,0.0,1.0
39646,대중국영화에빠져본사람이라면/Foreign,1,1,0,1.1115310228308472e-05,0.0,1.0
39647,자가용/Noun,1,1,0,1.1115310228308472e-05,0.0,1.0
39648,위험천만/Noun,1,1,0,1.1115310228308472e-05,0.0,1.0
39649,매시간/Adverb,1,1,0,1.1115310228308472e-05,0.0,1.0
39650,뵹헌리/Noun,1,0,1,0.0,1.1106915165381966e-05,1.0
39651,훻/Noun,1,0,1,0.0,1.1106915165381966e-05,1.0
39652,리뵹헌/Noun,1,0,1,0.0,1.1106915165381966e-05,1.0
39653,즌으로빨리/Foreign,1,1,0,1.1115310228308472e-05,0.0,1.0
39654,가울/Noun,1,1,0,1.1115310228308472e-05,0.0,1.0
39655,발함/Noun,1,1,0,1.1115310228308472e-05,0.0,1.0
39656,랜선/Noun,1,0,1,0.0,1.1106915165381966e-05,1.0
39657,밴쿠버/Noun,1,1,0,1.1115310228308472e-05,0.0,1.0
39658,혜결이/Noun,1,1,0,1.1115310228308472e-05,0.0,1.0
39659,삼유/Noun,1,0,1,0.0,1.1106915165381966e-05,1.0
39660,여자꼬셔/Noun,1,0,1,0.0,1.1106915165381966e-05,1.0
39661,아쿠아마린/Noun,1,1,0,1.1115310228308472e-05,0.0,1.0
39662,수진/Noun,1,1,0,1.1115310228308472e-05,0.0,1.0
39663,락형/Noun,1,1,0,1.1115310228308472e-05,0.0,1.0
39664,탯껏/Noun,1,1,0,1.1115310228308472e-05,0.0,1.0
39665,벼렸/Noun,1,0,1,0.0,1.1106915165381966e-05,1.0
39666,정채봉/Noun,1,1,0,1.1115310228308472e-05,0.0,1.0
39667,괴시/Noun,1,1,0,1.1115310228308472e-05,0.0,1.0
39668,땅속/Noun,1,1,0,1.1115310228308472e-05,0.0,1.0
39669,방궄/Noun,1,0,1,0.0,1.1106915165381966e-05,1.0
39670,동동/Noun,1,0,1,0.0,1.1106915165381966e-05,1.0
39671,곀곀겨겨겨뎌겨됻/Noun,1,1,0,1.1115310228308472e-05,0.0,1.0
39672,조루증/Noun,1,0,1,0.0,1.1106915165381966e-05,1.0
39673,기성/Noun,1,0,1,0.0,1.1106915165381966e-05,1.0
39674,파티쉐/Noun,1,0,1,0.0,1.1106915165381966e-05,1.0
39675,bo/Alpha,1,0,1,0.0,1.1106915165381966e-05,1.0
39676,jam/Alpha,1,0,1,0.0,1.1106915165381966e-05,1.0
39677,ssip/Alpha,1,0,1,0.0,1.1106915165381966e-05,1.0
39678,기스난/Noun,1,0,1,0.0,1.1106915165381966e-05,1.0
39679,어른거리다/Verb,1,1,0,1.1115310228308472e-05,0.0,1.0
39680,깡영/Noun,1,1,0,1.1115310228308472e-05,0.0,1.0
39681,폭염/Noun,1,1,0,1.1115310228308472e-05,0.0,1.0
39682,차트/Noun,1,0,1,0.0,1.1106915165381966e-05,1.0
39683,禪家/Foreign,1,1,0,1.1115310228308472e-05,0.0,1.0
39684,사람떄문/Noun,1,0,1,0.0,1.1106915165381966e-05,1.0
39685,어떄/Noun,1,0,1,0.0,1.1106915165381966e-05,1.0
39686,씨야/Noun,1,1,0,1.1115310228308472e-05,0.0,1.0
39687,엄천/Noun,1,0,1,0.0,1.1106915165381966e-05,1.0
39688,인씨/Noun,1,1,0,1.1115310228308472e-05,0.0,1.0
39689,카헤/Noun,1,1,0,1.1115310228308472e-05,0.0,1.0
39690,섬찟/Noun,1,1,0,1.1115310228308472e-05,0.0,1.0
39691,물속씬/Noun,1,0,1,0.0,1.1106915165381966e-05,1.0
39692,못마/Noun,1,0,1,0.0,1.1106915165381966e-05,1.0
39693,찌끄레기들/Noun,1,1,0,1.1115310228308472e-05,0.0,1.0
39694,..!!^^/Punctuation,1,1,0,1.1115310228308472e-05,0.0,1.0
39695,마그렛/Noun,1,1,0,1.1115310228308472e-05,0.0,1.0
39696,"1,000,000,000,000/Number",1,1,0,1.1115310228308472e-05,0.0,1.0
39697,종씨/Noun,1,0,1,0.0,1.1106915165381966e-05,1.0
39698,패쌈/Noun,1,0,1,0.0,1.1106915165381966e-05,1.0
39699,목덜미/Noun,1,0,1,0.0,1.1106915165381966e-05,1.0
39700,175/Number,1,1,0,1.1115310228308472e-05,0.0,1.0
39701,잉켄/Noun,1,1,0,1.1115310228308472e-05,0.0,1.0
39702,첩뇬/Noun,1,1,0,1.1115310228308472e-05,0.0,1.0
39703,편꼭/Noun,1,1,0,1.1115310228308472e-05,0.0,1.0
39704,Bomb/Alpha,1,0,1,0.0,1.1106915165381966e-05,1.0
39705,건방/Noun,1,0,1,0.0,1.1106915165381966e-05,1.0
39706,7.58/Number,1,0,1,0.0,1.1106915165381966e-05,1.0
39707,벽성대/Noun,1,0,1,0.0,1.1106915165381966e-05,1.0
39708,평화조약/Noun,1,1,0,1.1115310228308472e-05,0.0,1.0
39709,글러먹었/Noun,1,0,1,0.0,1.1106915165381966e-05,1.0
39710,...(-_-)/Punctuation,1,0,1,0.0,1.1106915165381966e-05,1.0
39711,폴란/Noun,1,1,0,1.1115310228308472e-05,0.0,1.0
39712,혔는데/Noun,1,1,0,1.1115310228308472e-05,0.0,1.0
39713,넑/Noun,1,1,0,1.1115310228308472e-05,0.0,1.0
39714,ㅕㅏㅂ/KoreanParticle,1,0,1,0.0,1.1106915165381966e-05,1.0
39715,감농/Noun,1,0,1,0.0,1.1106915165381966e-05,1.0
39716,뭐뭐뭐/Noun,1,0,1,0.0,1.1106915165381966e-05,1.0
39717,어톤먼트/Noun,1,0,1,0.0,1.1106915165381966e-05,1.0
39718,건뭐/Noun,1,0,1,0.0,1.1106915165381966e-05,1.0
39719,특전사/Noun,1,0,1,0.0,1.1106915165381966e-05,1.0
39720,가량막나왔던/Foreign,1,0,1,0.0,1.1106915165381966e-05,1.0
39721,복은/Noun,1,1,0,1.1115310228308472e-05,0.0,1.0
39722,빈정대다/Verb,1,1,0,1.1115310228308472e-05,0.0,1.0
39723,천재지변/Noun,1,1,0,1.1115310228308472e-05,0.0,1.0
39724,금융위기/Noun,1,1,0,1.1115310228308472e-05,0.0,1.0
39725,김인영/Noun,1,0,1,0.0,1.1106915165381966e-05,1.0
39726,쌩뚱맞기/Noun,1,1,0,1.1115310228308472e-05,0.0,1.0
39727,샥/Noun,1,1,0,1.1115310228308472e-05,0.0,1.0
39728,포신/Noun,1,0,1,0.0,1.1106915165381966e-05,1.0
39729,듨숙날숙/Noun,1,0,1,0.0,1.1106915165381966e-05,1.0
39730,롱태/Noun,1,0,1,0.0,1.1106915165381966e-05,1.0
39731,쓰렉이얌/Noun,1,0,1,0.0,1.1106915165381966e-05,1.0
39732,레보비츠/Noun,1,1,0,1.1115310228308472e-05,0.0,1.0
39733,;;'/Punctuation,1,0,1,0.0,1.1106915165381966e-05,1.0
39734,24%/Number,1,0,1,0.0,1.1106915165381966e-05,1.0
39735,은헤/Noun,1,1,0,1.1115310228308472e-05,0.0,1.0
39736,임윤아/Noun,1,1,0,1.1115310228308472e-05,0.0,1.0
39737,떡씬/Noun,1,0,1,0.0,1.1106915165381966e-05,1.0
39738,라스푸틴/Noun,1,1,0,1.1115310228308472e-05,0.0,1.0
39739,캢영화/Noun,1,0,1,0.0,1.1106915165381966e-05,1.0
39740,독맆된/Noun,1,0,1,0.0,1.1106915165381966e-05,1.0
39741,행패/Noun,1,0,1,0.0,1.1106915165381966e-05,1.0
39742,지영은/Noun,1,0,1,0.0,1.1106915165381966e-05,1.0
39743,뿡뿡/Noun,1,0,1,0.0,1.1106915165381966e-05,1.0
39744,파이데이/Noun,1,1,0,1.1115310228308472e-05,0.0,1.0
39745,이나이레/Noun,1,1,0,1.1115310228308472e-05,0.0,1.0
39746,거짓말쟁이/Noun,1,0,1,0.0,1.1106915165381966e-05,1.0
39747,쇼킹함/Noun,1,1,0,1.1115310228308472e-05,0.0,1.0
39748,음울/Noun,1,1,0,1.1115310228308472e-05,0.0,1.0
39749,힘좀/Noun,1,0,1,0.0,1.1106915165381966e-05,1.0
39750,비백/Noun,1,1,0,1.1115310228308472e-05,0.0,1.0
39751,아윌/Noun,1,1,0,1.1115310228308472e-05,0.0,1.0
39752,몬생긴/Noun,1,0,1,0.0,1.1106915165381966e-05,1.0
39753,미술감독/Noun,1,0,1,0.0,1.1106915165381966e-05,1.0
39754,계륵/Noun,1,0,1,0.0,1.1106915165381966e-05,1.0
39755,기고만장하다/Adjective,1,0,1,0.0,1.1106915165381966e-05,1.0
39756,반회/Noun,1,0,1,0.0,1.1106915165381966e-05,1.0
39757,설상가상/Noun,1,0,1,0.0,1.1106915165381966e-05,1.0
39758,리미터/Noun,1,0,1,0.0,1.1106915165381966e-05,1.0
39759,피카레스크/Noun,1,0,1,0.0,1.1106915165381966e-05,1.0
39760,이윤지/Noun,1,0,1,0.0,1.1106915165381966e-05,1.0
39761,ㅋㅌㅌ/KoreanParticle,1,1,0,1.1115310228308472e-05,0.0,1.0
39762,쩜미/Noun,1,0,1,0.0,1.1106915165381966e-05,1.0
39763,봣는뎅/Noun,1,1,0,1.1115310228308472e-05,0.0,1.0
39764,이지용/Noun,1,0,1,0.0,1.1106915165381966e-05,1.0
39765,븡/Noun,1,0,1,0.0,1.1106915165381966e-05,1.0
39766,ほんとうに面白かったよ。彼女もかわいいし。/Foreign,1,1,0,1.1115310228308472e-05,0.0,1.0
39767,아팟던/Noun,1,1,0,1.1115310228308472e-05,0.0,1.0
39768,캬악퉤/Noun,1,0,1,0.0,1.1106915165381966e-05,1.0
39769,꿀잼잼잼/Noun,1,1,0,1.1115310228308472e-05,0.0,1.0
39770,해야/Foreign,1,1,0,1.1115310228308472e-05,0.0,1.0
39771,함/Foreign,1,1,0,1.1115310228308472e-05,0.0,1.0
39772,더파이브/Noun,1,1,0,1.1115310228308472e-05,0.0,1.0
39773,한진희/Noun,1,1,0,1.1115310228308472e-05,0.0,1.0
39774,송별/Noun,1,0,1,0.0,1.1106915165381966e-05,1.0
39775,킬드/Noun,1,1,0,1.1115310228308472e-05,0.0,1.0
39776,트랜스픽션/Noun,1,1,0,1.1115310228308472e-05,0.0,1.0
39777,큰소리치다/Verb,1,0,1,0.0,1.1106915165381966e-05,1.0
39778,중졸/Noun,1,0,1,0.0,1.1106915165381966e-05,1.0
39779,삼인팟/Noun,1,1,0,1.1115310228308472e-05,0.0,1.0
39780,쫙깔렷/Noun,1,0,1,0.0,1.1106915165381966e-05,1.0
39781,드라마보다/Foreign,1,1,0,1.1115310228308472e-05,0.0,1.0
39782,신애라/Noun,1,0,1,0.0,1.1106915165381966e-05,1.0
39783,증조/Noun,1,0,1,0.0,1.1106915165381966e-05,1.0
39784,아쉅/Noun,1,0,1,0.0,1.1106915165381966e-05,1.0
39785,;;;....;;;;/Punctuation,1,0,1,0.0,1.1106915165381966e-05,1.0
39786,뻡/Noun,1,0,1,0.0,1.1106915165381966e-05,1.0
39787,100000000/1/Number,1,0,1,0.0,1.1106915165381966e-05,1.0
39788,도못하다/Foreign,1,0,1,0.0,1.1106915165381966e-05,1.0
39789,10000000/1만/Number,1,0,1,0.0,1.1106915165381966e-05,1.0
39790,똘마/Noun,1,0,1,0.0,1.1106915165381966e-05,1.0
39791,옷땜/Noun,1,0,1,0.0,1.1106915165381966e-05,1.0
39792,란것/Noun,1,1,0,1.1115310228308472e-05,0.0,1.0
39793,하속/Noun,1,0,1,0.0,1.1106915165381966e-05,1.0
39794,혜외/Noun,1,0,1,0.0,1.1106915165381966e-05,1.0
39795,경시청/Noun,1,1,0,1.1115310228308472e-05,0.0,1.0
39796,기업인/Noun,1,0,1,0.0,1.1106915165381966e-05,1.0
39797,강수호/Noun,1,1,0,1.1115310228308472e-05,0.0,1.0
39798,사대강/Noun,1,0,1,0.0,1.1106915165381966e-05,1.0
39799,완죤슬퍼/Noun,1,1,0,1.1115310228308472e-05,0.0,1.0
39800,리덕스판/Noun,1,1,0,1.1115310228308472e-05,0.0,1.0
39801,신동/Noun,1,1,0,1.1115310228308472e-05,0.0,1.0
39802,ㅋㄱㄲㄱ/KoreanParticle,1,0,1,0.0,1.1106915165381966e-05,1.0
39803,50000/Number,1,0,1,0.0,1.1106915165381966e-05,1.0
39804,삐익/Noun,1,1,0,1.1115310228308472e-05,0.0,1.0
39805,뽀옹/Noun,1,1,0,1.1115310228308472e-05,0.0,1.0
39806,그러자/Conjunction,1,0,1,0.0,1.1106915165381966e-05,1.0
39807,빼애애/Noun,1,0,1,0.0,1.1106915165381966e-05,1.0
39808,촌스/Noun,1,1,0,1.1115310228308472e-05,0.0,1.0
39809,아청/Noun,1,0,1,0.0,1.1106915165381966e-05,1.0
39810,세배/Noun,1,1,0,1.1115310228308472e-05,0.0,1.0
39811,"..--;""/Punctuation",1,0,1,0.0,1.1106915165381966e-05,1.0
39812,버러/Noun,1,1,0,1.1115310228308472e-05,0.0,1.0
39813,투표/Foreign,1,0,1,0.0,1.1106915165381966e-05,1.0
39814,80만/Number,1,0,1,0.0,1.1106915165381966e-05,1.0
39815,응디/Noun,1,0,1,0.0,1.1106915165381966e-05,1.0
39816,못땠네/Noun,1,1,0,1.1115310228308472e-05,0.0,1.0
39817,구즈만/Noun,1,1,0,1.1115310228308472e-05,0.0,1.0
39818,놀때/Noun,1,1,0,1.1115310228308472e-05,0.0,1.0
39819,전교/Noun,1,1,0,1.1115310228308472e-05,0.0,1.0
39820,무술가/Noun,1,0,1,0.0,1.1106915165381966e-05,1.0
39821,꼬는듯/Noun,1,1,0,1.1115310228308472e-05,0.0,1.0
39822,박산/Noun,1,0,1,0.0,1.1106915165381966e-05,1.0
39823,이풍/Noun,1,0,1,0.0,1.1106915165381966e-05,1.0
39824,ㅅㄴㅍㅈ/KoreanParticle,1,0,1,0.0,1.1106915165381966e-05,1.0
39825,나을껄/Noun,1,0,1,0.0,1.1106915165381966e-05,1.0
39826,한측/Noun,1,0,1,0.0,1.1106915165381966e-05,1.0
39827,마르스/Noun,1,1,0,1.1115310228308472e-05,0.0,1.0
39828,랬더/Noun,1,1,0,1.1115310228308472e-05,0.0,1.0
39829,쯪쯔/Noun,1,0,1,0.0,1.1106915165381966e-05,1.0
39830,끈임/Noun,1,1,0,1.1115310228308472e-05,0.0,1.0
39831,갑자/Noun,1,0,1,0.0,1.1106915165381966e-05,1.0
39832,이러냔/Noun,1,1,0,1.1115310228308472e-05,0.0,1.0
39833,브니엘/Noun,1,1,0,1.1115310228308472e-05,0.0,1.0
39834,보르헤스/Noun,1,1,0,1.1115310228308472e-05,0.0,1.0
39835,순록/Noun,1,0,1,0.0,1.1106915165381966e-05,1.0
39836,설기/Noun,1,1,0,1.1115310228308472e-05,0.0,1.0
39837,숄/Noun,1,1,0,1.1115310228308472e-05,0.0,1.0
39838,시월/Noun,1,1,0,1.1115310228308472e-05,0.0,1.0
39839,긍휼/Noun,1,1,0,1.1115310228308472e-05,0.0,1.0
39840,리움/Noun,1,1,0,1.1115310228308472e-05,0.0,1.0
39841,카빈/Noun,1,0,1,0.0,1.1106915165381966e-05,1.0
39842,왜레/Noun,1,0,1,0.0,1.1106915165381966e-05,1.0
39843,까프/Noun,1,1,0,1.1115310228308472e-05,0.0,1.0
39844,앙각/Noun,1,1,0,1.1115310228308472e-05,0.0,1.0
39845,>=</Punctuation,1,1,0,1.1115310228308472e-05,0.0,1.0
39846,셧음/Noun,1,0,1,0.0,1.1106915165381966e-05,1.0
39847,임처/Noun,1,1,0,1.1115310228308472e-05,0.0,1.0
39848,손병호게임/Noun,1,0,1,0.0,1.1106915165381966e-05,1.0
39849,유트브/Noun,1,0,1,0.0,1.1106915165381966e-05,1.0
39850,waits/Alpha,1,1,0,1.1115310228308472e-05,0.0,1.0
39851,Big/Alpha,1,1,0,1.1115310228308472e-05,0.0,1.0
39852,모테키/Noun,1,1,0,1.1115310228308472e-05,0.0,1.0
39853,치과씬/Noun,1,1,0,1.1115310228308472e-05,0.0,1.0
39854,공실이/Noun,1,1,0,1.1115310228308472e-05,0.0,1.0
39855,ㅠㅍ/KoreanParticle,1,1,0,1.1115310228308472e-05,0.0,1.0
39856,졋데/Noun,1,1,0,1.1115310228308472e-05,0.0,1.0
39857,공안/Noun,1,1,0,1.1115310228308472e-05,0.0,1.0
39858,세월의/Foreign,1,0,1,0.0,1.1106915165381966e-05,1.0
39859,툴툴되/Noun,1,0,1,0.0,1.1106915165381966e-05,1.0
39860,걸욕/Noun,1,1,0,1.1115310228308472e-05,0.0,1.0
39861,만들랬/Noun,1,0,1,0.0,1.1106915165381966e-05,1.0
39862,일펀/Noun,1,1,0,1.1115310228308472e-05,0.0,1.0
39863,이숙이/Noun,1,1,0,1.1115310228308472e-05,0.0,1.0
39864,삐쩍/Noun,1,0,1,0.0,1.1106915165381966e-05,1.0
39865,얼릉얼릉/Noun,1,1,0,1.1115310228308472e-05,0.0,1.0
39866,GJ/Alpha,1,1,0,1.1115310228308472e-05,0.0,1.0
39867,이로하/Noun,1,1,0,1.1115310228308472e-05,0.0,1.0
39868,갓난/Noun,1,0,1,0.0,1.1106915165381966e-05,1.0
39869,엄청썻/Noun,1,0,1,0.0,1.1106915165381966e-05,1.0
39870,꼽긴하/Noun,1,0,1,0.0,1.1106915165381966e-05,1.0
39871,갑날/Noun,1,0,1,0.0,1.1106915165381966e-05,1.0
39872,굴렁쇠/Noun,1,0,1,0.0,1.1106915165381966e-05,1.0
39873,평점낚엿/Noun,1,0,1,0.0,1.1106915165381966e-05,1.0
39874,락바텀/Noun,1,0,1,0.0,1.1106915165381966e-05,1.0
39875,리릴/Noun,1,0,1,0.0,1.1106915165381966e-05,1.0
39876,제판/Noun,1,1,0,1.1115310228308472e-05,0.0,1.0
39877,"..,,!!!!!@#@@/Punctuation",1,1,0,1.1115310228308472e-05,0.0,1.0
39878,다이고/Noun,1,0,1,0.0,1.1106915165381966e-05,1.0
39879,맏겨/Noun,1,1,0,1.1115310228308472e-05,0.0,1.0
39880,짦다/Noun,1,0,1,0.0,1.1106915165381966e-05,1.0
39881,HN/Alpha,1,0,1,0.0,1.1106915165381966e-05,1.0
39882,임동진/Noun,1,1,0,1.1115310228308472e-05,0.0,1.0
39883,웅데/Noun,1,0,1,0.0,1.1106915165381966e-05,1.0
39884,sp/Alpha,1,1,0,1.1115310228308472e-05,0.0,1.0
39885,16:46분/Number,1,0,1,0.0,1.1106915165381966e-05,1.0
39886,16:40/Number,1,0,1,0.0,1.1106915165381966e-05,1.0
39887,훼방/Noun,1,1,0,1.1115310228308472e-05,0.0,1.0
39888,시페르/Noun,1,0,1,0.0,1.1106915165381966e-05,1.0
39889,썪어가/Noun,1,0,1,0.0,1.1106915165381966e-05,1.0
39890,가깝드/Noun,1,0,1,0.0,1.1106915165381966e-05,1.0
39891,아워스/Noun,1,0,1,0.0,1.1106915165381966e-05,1.0
39892,추잔/Noun,1,0,1,0.0,1.1106915165381966e-05,1.0
39893,아잔/Noun,1,0,1,0.0,1.1106915165381966e-05,1.0
39894,전에낮에보고밤에잘때남몰래눈물흘게했던영화/Foreign,1,1,0,1.1115310228308472e-05,0.0,1.0
39895,투어리스트/Noun,1,0,1,0.0,1.1106915165381966e-05,1.0
39896,재욱/Noun,1,0,1,0.0,1.1106915165381966e-05,1.0
39897,릴수/Noun,1,0,1,0.0,1.1106915165381966e-05,1.0
39898,건국대/Noun,1,0,1,0.0,1.1106915165381966e-05,1.0
39899,belive/Alpha,1,1,0,1.1115310228308472e-05,0.0,1.0
39900,근위병/Noun,1,0,1,0.0,1.1106915165381966e-05,1.0
39901,Guardsman/Alpha,1,0,1,0.0,1.1106915165381966e-05,1.0
39902,.:)/Punctuation,1,1,0,1.1115310228308472e-05,0.0,1.0
39903,굼뜬/Noun,1,0,1,0.0,1.1106915165381966e-05,1.0
39904,어흌/Noun,1,0,1,0.0,1.1106915165381966e-05,1.0
39905,개졎소리/Noun,1,0,1,0.0,1.1106915165381966e-05,1.0
39906,핫팩/Noun,1,1,0,1.1115310228308472e-05,0.0,1.0
39907,밀려왓음/Noun,1,0,1,0.0,1.1106915165381966e-05,1.0
39908,완전수/Noun,1,0,1,0.0,1.1106915165381966e-05,1.0
39909,태일/Noun,1,0,1,0.0,1.1106915165381966e-05,1.0
39910,선유도/Noun,1,0,1,0.0,1.1106915165381966e-05,1.0
39911,지희/Noun,1,0,1,0.0,1.1106915165381966e-05,1.0
39912,선유/Noun,1,0,1,0.0,1.1106915165381966e-05,1.0
39913,묵읏다/Noun,1,1,0,1.1115310228308472e-05,0.0,1.0
39914,것해/Noun,1,0,1,0.0,1.1106915165381966e-05,1.0
39915,바하마/Noun,1,0,1,0.0,1.1106915165381966e-05,1.0
39916,-...../Punctuation,1,0,1,0.0,1.1106915165381966e-05,1.0
39917,선입견일/Noun,1,1,0,1.1115310228308472e-05,0.0,1.0
39918,메부/Noun,1,1,0,1.1115310228308472e-05,0.0,1.0
39919,김윤헤/Noun,1,1,0,1.1115310228308472e-05,0.0,1.0
39920,딲는거/Noun,1,1,0,1.1115310228308472e-05,0.0,1.0
39921,거손/Noun,1,0,1,0.0,1.1106915165381966e-05,1.0
39922,뛰레기/Noun,1,0,1,0.0,1.1106915165381966e-05,1.0
39923,많쩜이므니/Noun,1,1,0,1.1115310228308472e-05,0.0,1.0
39924,햇으므니/Noun,1,1,0,1.1115310228308472e-05,0.0,1.0
39925,도랑/Noun,1,0,1,0.0,1.1106915165381966e-05,1.0
39926,수레바퀴/Noun,1,0,1,0.0,1.1106915165381966e-05,1.0
39927,퇴비/Noun,1,0,1,0.0,1.1106915165381966e-05,1.0
39928,오픈워터/Noun,1,0,1,0.0,1.1106915165381966e-05,1.0
39929,8천만/Number,1,0,1,0.0,1.1106915165381966e-05,1.0
39930,"...-,-/Punctuation",1,0,1,0.0,1.1106915165381966e-05,1.0
39931,수니파/Noun,1,1,0,1.1115310228308472e-05,0.0,1.0
39932,엿같애/Noun,1,0,1,0.0,1.1106915165381966e-05,1.0
39933,후크선장/Noun,1,0,1,0.0,1.1106915165381966e-05,1.0
39934,이동해/Noun,1,0,1,0.0,1.1106915165381966e-05,1.0
39935,드웨인/Noun,1,0,1,0.0,1.1106915165381966e-05,1.0
39936,`~~~~~~/Punctuation,1,1,0,1.1115310228308472e-05,0.0,1.0
39937,톱밥/Noun,1,1,0,1.1115310228308472e-05,0.0,1.0
39938,그란돈/Noun,1,1,0,1.1115310228308472e-05,0.0,1.0
39939,뾰족/Adverb,1,0,1,0.0,1.1106915165381966e-05,1.0
39940,밀랍인형/Noun,1,1,0,1.1115310228308472e-05,0.0,1.0
39941,꽁지머리/Noun,1,0,1,0.0,1.1106915165381966e-05,1.0
39942,쿠오/Noun,1,1,0,1.1115310228308472e-05,0.0,1.0
39943,.......;;/Punctuation,1,0,1,0.0,1.1106915165381966e-05,1.0
39944,어다/Eomi,1,0,1,0.0,1.1106915165381966e-05,1.0
39945,어김없다/Adjective,1,0,1,0.0,1.1106915165381966e-05,1.0
39946,개끼/Noun,1,0,1,0.0,1.1106915165381966e-05,1.0
39947,연옌/Noun,1,0,1,0.0,1.1106915165381966e-05,1.0
39948,배그린/Noun,1,0,1,0.0,1.1106915165381966e-05,1.0
39949,뽀영이/Noun,1,1,0,1.1115310228308472e-05,0.0,1.0
39950,방목/Noun,1,1,0,1.1115310228308472e-05,0.0,1.0
39951,복부/Noun,1,0,1,0.0,1.1106915165381966e-05,1.0
39952,ㅠㅠㅠㅡ/KoreanParticle,1,1,0,1.1115310228308472e-05,0.0,1.0
39953,꼬미/Noun,1,1,0,1.1115310228308472e-05,0.0,1.0
39954,;;;;;......./Punctuation,1,0,1,0.0,1.1106915165381966e-05,1.0
39955,후사르/Noun,1,0,1,0.0,1.1106915165381966e-05,1.0
39956,윙드/Noun,1,0,1,0.0,1.1106915165381966e-05,1.0
39957,퐌따/Noun,1,0,1,0.0,1.1106915165381966e-05,1.0
39958,gtLittle/Alpha,1,1,0,1.1115310228308472e-05,0.0,1.0
39959,Much/Alpha,1,1,0,1.1115310228308472e-05,0.0,1.0
39960,때굿/Noun,1,1,0,1.1115310228308472e-05,0.0,1.0
39961,한어/Noun,1,1,0,1.1115310228308472e-05,0.0,1.0
39962,만대/Noun,1,1,0,1.1115310228308472e-05,0.0,1.0
39963,레보/Noun,1,0,1,0.0,1.1106915165381966e-05,1.0
39964,cibal/Alpha,1,1,0,1.1115310228308472e-05,0.0,1.0
39965,ksylord/Alpha,1,1,0,1.1115310228308472e-05,0.0,1.0
39966,로마사/Noun,1,0,1,0.0,1.1106915165381966e-05,1.0
39967,게봣습/Noun,1,1,0,1.1115310228308472e-05,0.0,1.0
39968,푸른소금/Noun,1,0,1,0.0,1.1106915165381966e-05,1.0
39969,워크래프트/Noun,1,1,0,1.1115310228308472e-05,0.0,1.0
39970,마영/Noun,1,0,1,0.0,1.1106915165381966e-05,1.0
39971,그랙픽/Noun,1,0,1,0.0,1.1106915165381966e-05,1.0
39972,헷어/Noun,1,0,1,0.0,1.1106915165381966e-05,1.0
39973,구대/Noun,1,1,0,1.1115310228308472e-05,0.0,1.0
39974,이거보먄/Noun,1,1,0,1.1115310228308472e-05,0.0,1.0
39975,할마/Noun,1,0,1,0.0,1.1106915165381966e-05,1.0
39976,어쩌느/Noun,1,0,1,0.0,1.1106915165381966e-05,1.0
39977,unfunny/Alpha,1,0,1,0.0,1.1106915165381966e-05,1.0
39978,Vs/Alpha,1,0,1,0.0,1.1106915165381966e-05,1.0
39979,괴도키드/Noun,1,1,0,1.1115310228308472e-05,0.0,1.0
39980,이정섭/Noun,1,1,0,1.1115310228308472e-05,0.0,1.0
39981,써커펀치/Noun,1,0,1,0.0,1.1106915165381966e-05,1.0
39982,Altitude/Alpha,1,0,1,0.0,1.1106915165381966e-05,1.0
39983,디렉팅을하/Noun,1,0,1,0.0,1.1106915165381966e-05,1.0
39984,코칭/Noun,1,0,1,0.0,1.1106915165381966e-05,1.0
39985,이니미/Noun,1,1,0,1.1115310228308472e-05,0.0,1.0
39986,흘쩍/Noun,1,1,0,1.1115310228308472e-05,0.0,1.0
39987,다라니/Noun,1,1,0,1.1115310228308472e-05,0.0,1.0
39988,헐떡이다/Verb,1,0,1,0.0,1.1106915165381966e-05,1.0
39989,명안/Noun,1,1,0,1.1115310228308472e-05,0.0,1.0
39990,타임지/Noun,1,1,0,1.1115310228308472e-05,0.0,1.0
39991,alice/Alpha,1,0,1,0.0,1.1106915165381966e-05,1.0
39992,spencer/Alpha,1,0,1,0.0,1.1106915165381966e-05,1.0
39993,천카이거/Noun,1,1,0,1.1115310228308472e-05,0.0,1.0
39994,진개/Noun,1,1,0,1.1115310228308472e-05,0.0,1.0
39995,찌그리다/Verb,1,0,1,0.0,1.1106915165381966e-05,1.0
39996,졎같/Noun,1,0,1,0.0,1.1106915165381966e-05,1.0
39997,효란/Noun,1,0,1,0.0,1.1106915165381966e-05,1.0
39998,도못채운게/Foreign,1,0,1,0.0,1.1106915165381966e-05,1.0
39999,전결혼했다가/Foreign,1,0,1,0.0,1.1106915165381966e-05,1.0
40000,쫄닥/Noun,1,0,1,0.0,1.1106915165381966e-05,1.0
40001,잠수함전/Noun,1,0,1,0.0,1.1106915165381966e-05,1.0
40002,샤오시/Noun,1,1,0,1.1115310228308472e-05,0.0,1.0
40003,박정환/Noun,1,1,0,1.1115310228308472e-05,0.0,1.0
40004,여자형제/Noun,1,1,0,1.1115310228308472e-05,0.0,1.0
40005,literally/Alpha,1,1,0,1.1115310228308472e-05,0.0,1.0
40006,어리어리/Adverb,1,1,0,1.1115310228308472e-05,0.0,1.0
40007,긴급하다/Adjective,1,0,1,0.0,1.1106915165381966e-05,1.0
40008,점알/Noun,1,0,1,0.0,1.1106915165381966e-05,1.0
40009,lim/Alpha,1,0,1,0.0,1.1106915165381966e-05,1.0
40010,트윗/Noun,1,1,0,1.1115310228308472e-05,0.0,1.0
40011,로그아웃/Noun,1,1,0,1.1115310228308472e-05,0.0,1.0
40012,31일/Number,1,1,0,1.1115310228308472e-05,0.0,1.0
40013,.http://mostfamousperson.net//URL,1,1,0,1.1115310228308472e-05,0.0,1.0
40014,마잭팬/Noun,1,1,0,1.1115310228308472e-05,0.0,1.0
40015,Run/Alpha,1,1,0,1.1115310228308472e-05,0.0,1.0
40016,River/Alpha,1,1,0,1.1115310228308472e-05,0.0,1.0
40017,기두/Noun,1,1,0,1.1115310228308472e-05,0.0,1.0
40018,적색/Noun,1,1,0,1.1115310228308472e-05,0.0,1.0
40019,지났지만/Foreign,1,1,0,1.1115310228308472e-05,0.0,1.0
40020,muzic/Alpha,1,1,0,1.1115310228308472e-05,0.0,1.0
40021,perpect/Alpha,1,1,0,1.1115310228308472e-05,0.0,1.0
40022,Borm/Alpha,1,1,0,1.1115310228308472e-05,0.0,1.0
40023,Child/Alpha,1,1,0,1.1115310228308472e-05,0.0,1.0
40024,이아까운영화/Foreign,1,0,1,0.0,1.1106915165381966e-05,1.0
40025,반전성/Noun,1,1,0,1.1115310228308472e-05,0.0,1.0
40026,300회/Number,1,1,0,1.1115310228308472e-05,0.0,1.0
40027,병서/Noun,1,1,0,1.1115310228308472e-05,0.0,1.0
40028,여치/Noun,1,1,0,1.1115310228308472e-05,0.0,1.0
40029,장초/Noun,1,1,0,1.1115310228308472e-05,0.0,1.0
40030,완실/Noun,1,0,1,0.0,1.1106915165381966e-05,1.0
40031,투야/Noun,1,1,0,1.1115310228308472e-05,0.0,1.0
40032,뭘뜻/Noun,1,0,1,0.0,1.1106915165381966e-05,1.0
40033,재섯슴/Noun,1,1,0,1.1115310228308472e-05,0.0,1.0
40034,만강/Noun,1,0,1,0.0,1.1106915165381966e-05,1.0
40035,태오/Noun,1,1,0,1.1115310228308472e-05,0.0,1.0
40036,청룡/Noun,1,1,0,1.1115310228308472e-05,0.0,1.0
40037,거소/Noun,1,1,0,1.1115310228308472e-05,0.0,1.0
40038,몬가모/Noun,1,1,0,1.1115310228308472e-05,0.0,1.0
40039,휘태거/Noun,1,1,0,1.1115310228308472e-05,0.0,1.0
40040,트럴/Noun,1,0,1,0.0,1.1106915165381966e-05,1.0
40041,홍색/Noun,1,1,0,1.1115310228308472e-05,0.0,1.0
40042,따로따로/Noun,1,0,1,0.0,1.1106915165381966e-05,1.0
40043,경제력/Noun,1,1,0,1.1115310228308472e-05,0.0,1.0
40044,쫌비/Noun,1,0,1,0.0,1.1106915165381966e-05,1.0
40045,뢉/Noun,1,0,1,0.0,1.1106915165381966e-05,1.0
40046,fbs/Alpha,1,0,1,0.0,1.1106915165381966e-05,1.0
40047,교항곡/Noun,1,1,0,1.1115310228308472e-05,0.0,1.0
40048,종간/Noun,1,1,0,1.1115310228308472e-05,0.0,1.0
40049,hoye/Alpha,1,1,0,1.1115310228308472e-05,0.0,1.0
40050,"!""""/Punctuation",1,1,0,1.1115310228308472e-05,0.0,1.0
40051,오경의/Noun,1,1,0,1.1115310228308472e-05,0.0,1.0
40052,조아영/Noun,1,1,0,1.1115310228308472e-05,0.0,1.0
40053,태범역/Noun,1,0,1,0.0,1.1106915165381966e-05,1.0
40054,승아/Noun,1,0,1,0.0,1.1106915165381966e-05,1.0
40055,야채/Noun,1,0,1,0.0,1.1106915165381966e-05,1.0
40056,박선욱/Noun,1,0,1,0.0,1.1106915165381966e-05,1.0
40057,중금속/Noun,1,1,0,1.1115310228308472e-05,0.0,1.0
40058,슬릴러/Noun,1,0,1,0.0,1.1106915165381966e-05,1.0
40059,최인/Noun,1,1,0,1.1115310228308472e-05,0.0,1.0
40060,룽/Noun,1,1,0,1.1115310228308472e-05,0.0,1.0
40061,잉아/Noun,1,1,0,1.1115310228308472e-05,0.0,1.0
40062,근대성/Noun,1,1,0,1.1115310228308472e-05,0.0,1.0
40063,깽깽/Noun,1,1,0,1.1115310228308472e-05,0.0,1.0
40064,태조왕/Noun,1,1,0,1.1115310228308472e-05,0.0,1.0
40065,~~*^^*/Punctuation,1,1,0,1.1115310228308472e-05,0.0,1.0
40066,명훈/Noun,1,0,1,0.0,1.1106915165381966e-05,1.0
40067,오도방정/Noun,1,0,1,0.0,1.1106915165381966e-05,1.0
40068,사이공/Noun,1,0,1,0.0,1.1106915165381966e-05,1.0
40069,덕일/Noun,1,1,0,1.1115310228308472e-05,0.0,1.0
40070,반댓말/Noun,1,1,0,1.1115310228308472e-05,0.0,1.0
40071,소진하/Noun,1,1,0,1.1115310228308472e-05,0.0,1.0
40072,하얀거짓말/Noun,1,0,1,0.0,1.1106915165381966e-05,1.0
40073,킨다/Noun,1,0,1,0.0,1.1106915165381966e-05,1.0
40074,더악/Noun,1,0,1,0.0,1.1106915165381966e-05,1.0
40075,신민/Noun,1,0,1,0.0,1.1106915165381966e-05,1.0
40076,핵좀/Noun,1,0,1,0.0,1.1106915165381966e-05,1.0
40077,안올껄/Noun,1,0,1,0.0,1.1106915165381966e-05,1.0
40078,욀케들/Noun,1,1,0,1.1115310228308472e-05,0.0,1.0
40079,ㅕㅓㅓㅜ/KoreanParticle,1,0,1,0.0,1.1106915165381966e-05,1.0
40080,셑기/Noun,1,0,1,0.0,1.1106915165381966e-05,1.0
40081,..:;;;/Punctuation,1,0,1,0.0,1.1106915165381966e-05,1.0
40082,1:46분/Number,1,0,1,0.0,1.1106915165381966e-05,1.0
40083,※/Foreign,1,1,0,1.1115310228308472e-05,0.0,1.0
40084,수정과/Noun,1,1,0,1.1115310228308472e-05,0.0,1.0
40085,QPR/Alpha,1,0,1,0.0,1.1106915165381966e-05,1.0
40086,메트릭스/Noun,1,0,1,0.0,1.1106915165381966e-05,1.0
40087,~~^.^*/Punctuation,1,1,0,1.1115310228308472e-05,0.0,1.0
40088,!~!~~/Punctuation,1,1,0,1.1115310228308472e-05,0.0,1.0
40089,중산층/Noun,1,1,0,1.1115310228308472e-05,0.0,1.0
40090,걸삼/Noun,1,0,1,0.0,1.1106915165381966e-05,1.0
40091,이거살빠/Noun,1,0,1,0.0,1.1106915165381966e-05,1.0
40092,행해지다/Verb,1,1,0,1.1115310228308472e-05,0.0,1.0
40093,종교재판/Noun,1,1,0,1.1115310228308472e-05,0.0,1.0
40094,후새드/Noun,1,0,1,0.0,1.1106915165381966e-05,1.0
40095,꼭지점댄스/Noun,1,1,0,1.1115310228308472e-05,0.0,1.0
40096,프리츠/Noun,1,0,1,0.0,1.1106915165381966e-05,1.0
40097,아시모프/Noun,1,0,1,0.0,1.1106915165381966e-05,1.0
40098,다카하시/Noun,1,0,1,0.0,1.1106915165381966e-05,1.0
40099,유키나/Noun,1,0,1,0.0,1.1106915165381966e-05,1.0
40100,대후반/Foreign,1,1,0,1.1115310228308472e-05,0.0,1.0
40101,핼로/Noun,1,1,0,1.1115310228308472e-05,0.0,1.0
40102,9%/Number,1,0,1,0.0,1.1106915165381966e-05,1.0
40103,옘뵹/Noun,1,0,1,0.0,1.1106915165381966e-05,1.0
40104,베르바토프/Noun,1,0,1,0.0,1.1106915165381966e-05,1.0
40105,삼류스멜/Noun,1,0,1,0.0,1.1106915165381966e-05,1.0
40106,식지/Noun,1,1,0,1.1115310228308472e-05,0.0,1.0
40107,사진관/Noun,1,1,0,1.1115310228308472e-05,0.0,1.0
40108,치룬/Noun,1,1,0,1.1115310228308472e-05,0.0,1.0
40109,단순공포/Noun,1,1,0,1.1115310228308472e-05,0.0,1.0
40110,다우트/Noun,1,1,0,1.1115310228308472e-05,0.0,1.0
40111,Perfect/Alpha,1,1,0,1.1115310228308472e-05,0.0,1.0
40112,쯥/Noun,1,0,1,0.0,1.1106915165381966e-05,1.0
40113,17000/Number,1,1,0,1.1115310228308472e-05,0.0,1.0
40114,웰매/Noun,1,1,0,1.1115310228308472e-05,0.0,1.0
40115,혹세/Noun,1,0,1,0.0,1.1106915165381966e-05,1.0
40116,못떳다/Noun,1,1,0,1.1115310228308472e-05,0.0,1.0
40117,리암햄스워스/Noun,1,0,1,0.0,1.1106915165381966e-05,1.0
40118,카이사르/Noun,1,0,1,0.0,1.1106915165381966e-05,1.0
40119,`-'/Punctuation,1,1,0,1.1115310228308472e-05,0.0,1.0
40120,홀씨/Noun,1,1,0,1.1115310228308472e-05,0.0,1.0
40121,생모/Noun,1,1,0,1.1115310228308472e-05,0.0,1.0
40122,김현희/Noun,1,0,1,0.0,1.1106915165381966e-05,1.0
40123,강적/Noun,1,0,1,0.0,1.1106915165381966e-05,1.0
40124,깨트린듯/Noun,1,0,1,0.0,1.1106915165381966e-05,1.0
40125,1973/Number,1,0,1,0.0,1.1106915165381966e-05,1.0
40126,빨파/Noun,1,0,1,0.0,1.1106915165381966e-05,1.0
40127,플라이미투더문/Noun,1,0,1,0.0,1.1106915165381966e-05,1.0
40128,gilles/Alpha,1,1,0,1.1115310228308472e-05,0.0,1.0
40129,et/Alpha,1,1,0,1.1115310228308472e-05,0.0,1.0
40130,pierre/Alpha,1,1,0,1.1115310228308472e-05,0.0,1.0
40131,톨게이트/Noun,1,1,0,1.1115310228308472e-05,0.0,1.0
40132,생불/Noun,1,0,1,0.0,1.1106915165381966e-05,1.0
40133,경혐해/Noun,1,0,1,0.0,1.1106915165381966e-05,1.0
40134,딕스/Noun,1,1,0,1.1115310228308472e-05,0.0,1.0
40135,만두라/Noun,1,0,1,0.0,1.1106915165381966e-05,1.0
40136,전인가/Foreign,1,0,1,0.0,1.1106915165381966e-05,1.0
40137,작가라서/Foreign,1,1,0,1.1115310228308472e-05,0.0,1.0
40138,:=_=/Punctuation,1,0,1,0.0,1.1106915165381966e-05,1.0
40139,ㅗㅎㄹㅇ/KoreanParticle,1,0,1,0.0,1.1106915165381966e-05,1.0
40140,빨딱/Noun,1,1,0,1.1115310228308472e-05,0.0,1.0
40141,ㅃㅌ/KoreanParticle,1,1,0,1.1115310228308472e-05,0.0,1.0
40142,성은채/Noun,1,1,0,1.1115310228308472e-05,0.0,1.0
40143,장위안/Noun,1,0,1,0.0,1.1106915165381966e-05,1.0
40144,동철/Noun,1,1,0,1.1115310228308472e-05,0.0,1.0
40145,실직/Noun,1,0,1,0.0,1.1106915165381966e-05,1.0
40146,을사조약/Noun,1,0,1,0.0,1.1106915165381966e-05,1.0
40147,낚일뻔/Noun,1,0,1,0.0,1.1106915165381966e-05,1.0
40148,네이버웹툰/Noun,1,1,0,1.1115310228308472e-05,0.0,1.0
40149,exiting/Alpha,1,1,0,1.1115310228308472e-05,0.0,1.0
40150,".,.,.,.,.,.,.,./Punctuation",1,0,1,0.0,1.1106915165381966e-05,1.0
40151,ㅋㄷㅋ/KoreanParticle,1,1,0,1.1115310228308472e-05,0.0,1.0
40152,혁혁하다/Adjective,1,0,1,0.0,1.1106915165381966e-05,1.0
40153,나또/Noun,1,0,1,0.0,1.1106915165381966e-05,1.0
40154,피드백/Noun,1,0,1,0.0,1.1106915165381966e-05,1.0
40155,비행청소년/Noun,1,0,1,0.0,1.1106915165381966e-05,1.0
40156,한유진/Noun,1,0,1,0.0,1.1106915165381966e-05,1.0
40157,초딩떄/Noun,1,0,1,0.0,1.1106915165381966e-05,1.0
40158,연날리기/Noun,1,1,0,1.1115310228308472e-05,0.0,1.0
40159,책이훨잼/Noun,1,0,1,0.0,1.1106915165381966e-05,1.0
40160,주고보고했는데/Foreign,1,1,0,1.1115310228308472e-05,0.0,1.0
40161,레리/Noun,1,1,0,1.1115310228308472e-05,0.0,1.0
40162,리꼴/Noun,1,1,0,1.1115310228308472e-05,0.0,1.0
40163,얼레/Noun,1,1,0,1.1115310228308472e-05,0.0,1.0
40164,맍/Noun,1,1,0,1.1115310228308472e-05,0.0,1.0
40165,빠잊잘생겻/Noun,1,1,0,1.1115310228308472e-05,0.0,1.0
40166,헨더슨/Noun,1,1,0,1.1115310228308472e-05,0.0,1.0
40167,복되다/Adjective,1,1,0,1.1115310228308472e-05,0.0,1.0
40168,과평/Noun,1,0,1,0.0,1.1106915165381966e-05,1.0
40169,막버무리/Noun,1,0,1,0.0,1.1106915165381966e-05,1.0
40170,생각드/Noun,1,0,1,0.0,1.1106915165381966e-05,1.0
40171,거슬러오/Noun,1,1,0,1.1115310228308472e-05,0.0,1.0
40172,것이므/Noun,1,1,0,1.1115310228308472e-05,0.0,1.0
40173,폭스채널/Noun,1,1,0,1.1115310228308472e-05,0.0,1.0
40174,zzzzffgdfgdfgdf/Alpha,1,0,1,0.0,1.1106915165381966e-05,1.0
40175,다린/Noun,1,1,0,1.1115310228308472e-05,0.0,1.0
40176,근데쪼매/Noun,1,1,0,1.1115310228308472e-05,0.0,1.0
40177,디지털화/Noun,1,0,1,0.0,1.1106915165381966e-05,1.0
40178,컨빅션/Noun,1,1,0,1.1115310228308472e-05,0.0,1.0
40179,성교/Noun,1,0,1,0.0,1.1106915165381966e-05,1.0
40180,4.8/Number,1,0,1,0.0,1.1106915165381966e-05,1.0
40181,뒷쪽/Noun,1,0,1,0.0,1.1106915165381966e-05,1.0
40182,젹셔/Noun,1,1,0,1.1115310228308472e-05,0.0,1.0
40183,거적/Noun,1,0,1,0.0,1.1106915165381966e-05,1.0
40184,야옹/Adverb,1,1,0,1.1115310228308472e-05,0.0,1.0
40185,방더/Noun,1,1,0,1.1115310228308472e-05,0.0,1.0
40186,붅/Noun,1,1,0,1.1115310228308472e-05,0.0,1.0
40187,망처논/Noun,1,0,1,0.0,1.1106915165381966e-05,1.0
40188,쿳/Noun,1,1,0,1.1115310228308472e-05,0.0,1.0
40189,박건/Noun,1,1,0,1.1115310228308472e-05,0.0,1.0
40190,방희/Noun,1,1,0,1.1115310228308472e-05,0.0,1.0
40191,Digger/Alpha,1,0,1,0.0,1.1106915165381966e-05,1.0
40192,냔대/Noun,1,1,0,1.1115310228308472e-05,0.0,1.0
40193,섀키/Noun,1,0,1,0.0,1.1106915165381966e-05,1.0
40194,인임/Noun,1,0,1,0.0,1.1106915165381966e-05,1.0
40195,데드링거/Noun,1,1,0,1.1115310228308472e-05,0.0,1.0
40196,호락호락하다/Adjective,1,1,0,1.1115310228308472e-05,0.0,1.0
40197,몰랐넹/Noun,1,1,0,1.1115310228308472e-05,0.0,1.0
40198,http://blog.naver.com/s2powers1/URL,1,1,0,1.1115310228308472e-05,0.0,1.0
40199,유방암/Noun,1,0,1,0.0,1.1106915165381966e-05,1.0
40200,햇는데/Foreign,1,1,0,1.1115310228308472e-05,0.0,1.0
40201,대딩때/Noun,1,1,0,1.1115310228308472e-05,0.0,1.0
40202,풀뉴/Noun,1,1,0,1.1115310228308472e-05,0.0,1.0
40203,개똥칠/Noun,1,0,1,0.0,1.1106915165381966e-05,1.0
40204,컬투쇼/Noun,1,0,1,0.0,1.1106915165381966e-05,1.0
40205,"....,,.../Punctuation",1,0,1,0.0,1.1106915165381966e-05,1.0
40206,살아오면서내인생에/Foreign,1,1,0,1.1115310228308472e-05,0.0,1.0
40207,체내/Noun,1,0,1,0.0,1.1106915165381966e-05,1.0
40208,삼판/Noun,1,1,0,1.1115310228308472e-05,0.0,1.0
40209,스키너/Noun,1,1,0,1.1115310228308472e-05,0.0,1.0
40210,~-_-;/Punctuation,1,0,1,0.0,1.1106915165381966e-05,1.0
40211,점이길레/Noun,1,0,1,0.0,1.1106915165381966e-05,1.0
40212,옥석/Noun,1,1,0,1.1115310228308472e-05,0.0,1.0
40213,로마왕/Noun,1,0,1,0.0,1.1106915165381966e-05,1.0
40214,사무관/Noun,1,0,1,0.0,1.1106915165381966e-05,1.0
40215,연진/Noun,1,1,0,1.1115310228308472e-05,0.0,1.0
40216,어쭈구/Noun,1,1,0,1.1115310228308472e-05,0.0,1.0
40217,떳던/Noun,1,1,0,1.1115310228308472e-05,0.0,1.0
40218,빠빠/Noun,1,0,1,0.0,1.1106915165381966e-05,1.0
40219,민환/Noun,1,1,0,1.1115310228308472e-05,0.0,1.0
40220,FTIsland/Alpha,1,1,0,1.1115310228308472e-05,0.0,1.0
40221,핵자/Noun,1,0,1,0.0,1.1106915165381966e-05,1.0
40222,주제넘다/Adjective,1,0,1,0.0,1.1106915165381966e-05,1.0
40223,신스/Noun,1,1,0,1.1115310228308472e-05,0.0,1.0
40224,~^~^/Punctuation,1,1,0,1.1115310228308472e-05,0.0,1.0
40225,태기/Noun,1,1,0,1.1115310228308472e-05,0.0,1.0
40226,애꿋/Noun,1,0,1,0.0,1.1106915165381966e-05,1.0
40227,후휘/Noun,1,0,1,0.0,1.1106915165381966e-05,1.0
40228,머람/Noun,1,0,1,0.0,1.1106915165381966e-05,1.0
40229,졸잼꿀잼/Noun,1,1,0,1.1115310228308472e-05,0.0,1.0
40230,원거리/Noun,1,1,0,1.1115310228308472e-05,0.0,1.0
40231,멜번/Noun,1,1,0,1.1115310228308472e-05,0.0,1.0
40232,최교/Noun,1,1,0,1.1115310228308472e-05,0.0,1.0
40233,끌껄/Noun,1,0,1,0.0,1.1106915165381966e-05,1.0
40234,창간/Noun,1,0,1,0.0,1.1106915165381966e-05,1.0
40235,로이펠드/Noun,1,0,1,0.0,1.1106915165381966e-05,1.0
40236,결굴/Noun,1,0,1,0.0,1.1106915165381966e-05,1.0
40237,좀비랜드/Noun,1,1,0,1.1115310228308472e-05,0.0,1.0
40238,펑가/Noun,1,0,1,0.0,1.1106915165381966e-05,1.0
40239,.).../Punctuation,1,1,0,1.1115310228308472e-05,0.0,1.0
40240,닭싸움/Noun,1,0,1,0.0,1.1106915165381966e-05,1.0
40241,신문사/Noun,1,0,1,0.0,1.1106915165381966e-05,1.0
40242,에트리/Noun,1,0,1,0.0,1.1106915165381966e-05,1.0
40243,개만꼽으라/Noun,1,1,0,1.1115310228308472e-05,0.0,1.0
40244,쫑처/Noun,1,0,1,0.0,1.1106915165381966e-05,1.0
40245,죵내/Noun,1,0,1,0.0,1.1106915165381966e-05,1.0
40246,셋음/Noun,1,1,0,1.1115310228308472e-05,0.0,1.0
40247,굿굿잼/Noun,1,1,0,1.1115310228308472e-05,0.0,1.0
40248,싱됨/Noun,1,0,1,0.0,1.1106915165381966e-05,1.0
40249,반의/Foreign,1,0,1,0.0,1.1106915165381966e-05,1.0
40250,선악과/Noun,1,0,1,0.0,1.1106915165381966e-05,1.0
40251,뒤지금집에서봤는데그감동그전율그대로다/Foreign,1,1,0,1.1115310228308472e-05,0.0,1.0
40252,못냉겨/Noun,1,0,1,0.0,1.1106915165381966e-05,1.0
40253,알흠다웠다/Noun,1,0,1,0.0,1.1106915165381966e-05,1.0
40254,노인도/Noun,1,0,1,0.0,1.1106915165381966e-05,1.0
40255,송장/Noun,1,0,1,0.0,1.1106915165381966e-05,1.0
40256,널렸/Noun,1,1,0,1.1115310228308472e-05,0.0,1.0
40257,아트리/Noun,1,1,0,1.1115310228308472e-05,0.0,1.0
40258,보닌깐/Noun,1,1,0,1.1115310228308472e-05,0.0,1.0
40259,찻물/Noun,1,1,0,1.1115310228308472e-05,0.0,1.0
40260,千萬/Foreign,1,1,0,1.1115310228308472e-05,0.0,1.0
40261,끝편/Noun,1,0,1,0.0,1.1106915165381966e-05,1.0
40262,칭얼거리다/Verb,1,0,1,0.0,1.1106915165381966e-05,1.0
40263,듯낚/Noun,1,0,1,0.0,1.1106915165381966e-05,1.0
40264,potter/Alpha,1,1,0,1.1115310228308472e-05,0.0,1.0
40265,harry/Alpha,1,1,0,1.1115310228308472e-05,0.0,1.0
40266,노찌/Noun,1,0,1,0.0,1.1106915165381966e-05,1.0
40267,무엄하다/Adjective,1,0,1,0.0,1.1106915165381966e-05,1.0
40268,케구/Noun,1,1,0,1.1115310228308472e-05,0.0,1.0
40269,척사/Noun,1,0,1,0.0,1.1106915165381966e-05,1.0
40270,쉐기/Noun,1,0,1,0.0,1.1106915165381966e-05,1.0
40271,소현세자/Noun,1,1,0,1.1115310228308472e-05,0.0,1.0
40272,왜썻을까/Noun,1,0,1,0.0,1.1106915165381966e-05,1.0
40273,베이징/Noun,1,0,1,0.0,1.1106915165381966e-05,1.0
40274,호신/Noun,1,1,0,1.1115310228308472e-05,0.0,1.0
40275,4.58/Number,1,1,0,1.1115310228308472e-05,0.0,1.0
40276,김소진/Noun,1,1,0,1.1115310228308472e-05,0.0,1.0
40277,chained/Alpha,1,0,1,0.0,1.1106915165381966e-05,1.0
40278,어엿하다/Adjective,1,0,1,0.0,1.1106915165381966e-05,1.0
40279,퇘/Noun,1,0,1,0.0,1.1106915165381966e-05,1.0
40280,나왓네/Noun,1,1,0,1.1115310228308472e-05,0.0,1.0
40281,겉멋용/Noun,1,0,1,0.0,1.1106915165381966e-05,1.0
40282,toccma/Alpha,1,1,0,1.1115310228308472e-05,0.0,1.0
40283,쇠똥/Noun,1,1,0,1.1115310228308472e-05,0.0,1.0
40284,애정만만세/Noun,1,1,0,1.1115310228308472e-05,0.0,1.0
40285,로투닌/Noun,1,1,0,1.1115310228308472e-05,0.0,1.0
40286,~!!~/Punctuation,1,0,1,0.0,1.1106915165381966e-05,1.0
40287,윤성일좀/Noun,1,0,1,0.0,1.1106915165381966e-05,1.0
40288,축하공연/Noun,1,0,1,0.0,1.1106915165381966e-05,1.0
40289,주침/Noun,1,0,1,0.0,1.1106915165381966e-05,1.0
40290,강하나/Noun,1,0,1,0.0,1.1106915165381966e-05,1.0
40291,에비타/Noun,1,1,0,1.1115310228308472e-05,0.0,1.0
40292,적극성/Noun,1,0,1,0.0,1.1106915165381966e-05,1.0
40293,논의/Noun,1,0,1,0.0,1.1106915165381966e-05,1.0
40294,Highway/Alpha,1,0,1,0.0,1.1106915165381966e-05,1.0
40295,Lost/Alpha,1,0,1,0.0,1.1106915165381966e-05,1.0
40296,호히행호홓/Noun,1,0,1,0.0,1.1106915165381966e-05,1.0
40297,".!.~,??/Punctuation",1,1,0,1.1115310228308472e-05,0.0,1.0
40298,스페이스잼/Noun,1,1,0,1.1115310228308472e-05,0.0,1.0
40299,앤트/Noun,1,0,1,0.0,1.1106915165381966e-05,1.0
40300,키메라/Noun,1,0,1,0.0,1.1106915165381966e-05,1.0
40301,리메/Noun,1,0,1,0.0,1.1106915165381966e-05,1.0
40302,....~~/Punctuation,1,0,1,0.0,1.1106915165381966e-05,1.0
40303,유가휘/Noun,1,1,0,1.1115310228308472e-05,0.0,1.0
40304,패악/Noun,1,0,1,0.0,1.1106915165381966e-05,1.0
40305,젋군/Noun,1,1,0,1.1115310228308472e-05,0.0,1.0
40306,FIN/Alpha,1,1,0,1.1115310228308472e-05,0.0,1.0
40307,깜바테/Noun,1,0,1,0.0,1.1106915165381966e-05,1.0
40308,뭘루/Noun,1,0,1,0.0,1.1106915165381966e-05,1.0
40309,앰블런스소리/Noun,1,0,1,0.0,1.1106915165381966e-05,1.0
40310,성괴맛/Noun,1,0,1,0.0,1.1106915165381966e-05,1.0
40311,모크슈/Noun,1,1,0,1.1115310228308472e-05,0.0,1.0
40312,겹결/Noun,1,0,1,0.0,1.1106915165381966e-05,1.0
40313,탯줄/Noun,1,0,1,0.0,1.1106915165381966e-05,1.0
40314,덜피폐/Noun,1,1,0,1.1115310228308472e-05,0.0,1.0
40315,1-2시/Number,1,1,0,1.1115310228308472e-05,0.0,1.0
40316,츤루기/Noun,1,1,0,1.1115310228308472e-05,0.0,1.0
40317,소라빵/Noun,1,1,0,1.1115310228308472e-05,0.0,1.0
40318,김재효/Noun,1,1,0,1.1115310228308472e-05,0.0,1.0
40319,1700/Number,1,1,0,1.1115310228308472e-05,0.0,1.0
40320,^-^;/Punctuation,1,1,0,1.1115310228308472e-05,0.0,1.0
40321,2774/Number,1,1,0,1.1115310228308472e-05,0.0,1.0
40322,4427/Number,1,1,0,1.1115310228308472e-05,0.0,1.0
40323,창렬스러움/Noun,1,0,1,0.0,1.1106915165381966e-05,1.0
40324,냐/Noun,1,0,1,0.0,1.1106915165381966e-05,1.0
40325,한국껀/Noun,1,1,0,1.1115310228308472e-05,0.0,1.0
40326,여깄/Noun,1,1,0,1.1115310228308472e-05,0.0,1.0
40327,므훗해염/Noun,1,1,0,1.1115310228308472e-05,0.0,1.0
40328,꺼밖에/Foreign,1,0,1,0.0,1.1106915165381966e-05,1.0
40329,전자기유도/Noun,1,0,1,0.0,1.1106915165381966e-05,1.0
40330,대상자/Noun,1,0,1,0.0,1.1106915165381966e-05,1.0
40331,기동대/Noun,1,0,1,0.0,1.1106915165381966e-05,1.0
40332,runningmania/Alpha,1,0,1,0.0,1.1106915165381966e-05,1.0
40333,칼펜/Noun,1,1,0,1.1115310228308472e-05,0.0,1.0
40334,5.2%/Number,1,0,1,0.0,1.1106915165381966e-05,1.0
40335,얼압/Noun,1,1,0,1.1115310228308472e-05,0.0,1.0
40336,개생/Noun,1,0,1,0.0,1.1106915165381966e-05,1.0
40337,치트키/Noun,1,0,1,0.0,1.1106915165381966e-05,1.0
40338,이광호/Noun,1,0,1,0.0,1.1106915165381966e-05,1.0
40339,누운채/Noun,1,1,0,1.1115310228308472e-05,0.0,1.0
40340,13분/Number,1,0,1,0.0,1.1106915165381966e-05,1.0
40341,지밀/Noun,1,1,0,1.1115310228308472e-05,0.0,1.0
40342,칭할수/Noun,1,1,0,1.1115310228308472e-05,0.0,1.0
40343,코델/Noun,1,1,0,1.1115310228308472e-05,0.0,1.0
40344,폴롯/Noun,1,1,0,1.1115310228308472e-05,0.0,1.0
40345,제패/Noun,1,1,0,1.1115310228308472e-05,0.0,1.0
40346,TRISTAR/Alpha,1,0,1,0.0,1.1106915165381966e-05,1.0
40347,해삤제/Noun,1,1,0,1.1115310228308472e-05,0.0,1.0
40348,포도나무/Noun,1,0,1,0.0,1.1106915165381966e-05,1.0
40349,GREAT/Alpha,1,1,0,1.1115310228308472e-05,0.0,1.0
40350,디딤돌/Noun,1,1,0,1.1115310228308472e-05,0.0,1.0
40351,섹리/Noun,1,0,1,0.0,1.1106915165381966e-05,1.0
40352,사이판/Noun,1,1,0,1.1115310228308472e-05,0.0,1.0
40353,괴랄함/Noun,1,1,0,1.1115310228308472e-05,0.0,1.0
40354,..^^^^/Punctuation,1,0,1,0.0,1.1106915165381966e-05,1.0
40355,무소속/Noun,1,1,0,1.1115310228308472e-05,0.0,1.0
40356,왹/Noun,1,0,1,0.0,1.1106915165381966e-05,1.0
40357,목감겨/Noun,1,0,1,0.0,1.1106915165381966e-05,1.0
40358,오대규/Noun,1,1,0,1.1115310228308472e-05,0.0,1.0
40359,넌니/Noun,1,0,1,0.0,1.1106915165381966e-05,1.0
40360,memento/Alpha,1,1,0,1.1115310228308472e-05,0.0,1.0
40361,하혈/Noun,1,0,1,0.0,1.1106915165381966e-05,1.0
40362,텅빔/Noun,1,0,1,0.0,1.1106915165381966e-05,1.0
40363,선학/Noun,1,1,0,1.1115310228308472e-05,0.0,1.0
40364,!@!!/Punctuation,1,0,1,0.0,1.1106915165381966e-05,1.0
40365,되었드/Noun,1,0,1,0.0,1.1106915165381966e-05,1.0
40366,예언가/Noun,1,0,1,0.0,1.1106915165381966e-05,1.0
40367,된영화치고/Foreign,1,1,0,1.1115310228308472e-05,0.0,1.0
40368,간고/Noun,1,1,0,1.1115310228308472e-05,0.0,1.0
40369,랩갓/Noun,1,1,0,1.1115310228308472e-05,0.0,1.0
40370,뛰엄뛰엄/Noun,1,0,1,0.0,1.1106915165381966e-05,1.0
40371,^_/Punctuation,1,1,0,1.1115310228308472e-05,0.0,1.0
40372,자숙좀/Noun,1,0,1,0.0,1.1106915165381966e-05,1.0
40373,코콩/Noun,1,0,1,0.0,1.1106915165381966e-05,1.0
40374,키케카/Noun,1,0,1,0.0,1.1106915165381966e-05,1.0
40375,페데리코역/Noun,1,1,0,1.1115310228308472e-05,0.0,1.0
40376,됫어/Noun,1,1,0,1.1115310228308472e-05,0.0,1.0
40377,첬다/Noun,1,0,1,0.0,1.1106915165381966e-05,1.0
40378,홍인규/Noun,1,0,1,0.0,1.1106915165381966e-05,1.0
40379,안동/Noun,1,0,1,0.0,1.1106915165381966e-05,1.0
40380,안듭니/Noun,1,0,1,0.0,1.1106915165381966e-05,1.0
40381,8888577/Number,1,0,1,0.0,1.1106915165381966e-05,1.0
40382,이였는데/Foreign,1,1,0,1.1115310228308472e-05,0.0,1.0
40383,2.27/Number,1,0,1,0.0,1.1106915165381966e-05,1.0
40384,↓↓↓/Foreign,1,1,0,1.1115310228308472e-05,0.0,1.0
40385,리우데자네이로/Noun,1,1,0,1.1115310228308472e-05,0.0,1.0
40386,안나푸르나/Noun,1,0,1,0.0,1.1106915165381966e-05,1.0
40387,coment/Alpha,1,0,1,0.0,1.1106915165381966e-05,1.0
40388,조경/Noun,1,0,1,0.0,1.1106915165381966e-05,1.0
40389,술작/Noun,1,1,0,1.1115310228308472e-05,0.0,1.0
40390,2007.11/Number,1,1,0,1.1115310228308472e-05,0.0,1.0
40391,공률/Noun,1,0,1,0.0,1.1106915165381966e-05,1.0
40392,고퍼/Noun,1,0,1,0.0,1.1106915165381966e-05,1.0
40393,초콜릿공장/Noun,1,1,0,1.1115310228308472e-05,0.0,1.0
40394,아다리/Noun,1,0,1,0.0,1.1106915165381966e-05,1.0
40395,후생/Noun,1,0,1,0.0,1.1106915165381966e-05,1.0
40396,fc/Alpha,1,1,0,1.1115310228308472e-05,0.0,1.0
40397,프랭키/Noun,1,1,0,1.1115310228308472e-05,0.0,1.0
40398,못데/Noun,1,1,0,1.1115310228308472e-05,0.0,1.0
40399,blindtongu/Alpha,1,1,0,1.1115310228308472e-05,0.0,1.0
40400,않떳는/Noun,1,1,0,1.1115310228308472e-05,0.0,1.0
40401,꼬르/Noun,1,1,0,1.1115310228308472e-05,0.0,1.0
40402,토르타/Noun,1,1,0,1.1115310228308472e-05,0.0,1.0
40403,민정은/Noun,1,1,0,1.1115310228308472e-05,0.0,1.0
40404,슬렙/Noun,1,0,1,0.0,1.1106915165381966e-05,1.0
40405,곱창전골/Noun,1,0,1,0.0,1.1106915165381966e-05,1.0
40406,노슬람교/Noun,1,0,1,0.0,1.1106915165381966e-05,1.0
40407,서해안/Noun,1,0,1,0.0,1.1106915165381966e-05,1.0
40408,::::/Punctuation,1,1,0,1.1115310228308472e-05,0.0,1.0
40409,빠징꼬/Noun,1,0,1,0.0,1.1106915165381966e-05,1.0
40410,사이언스/Noun,1,0,1,0.0,1.1106915165381966e-05,1.0
40411,병병/Noun,1,0,1,0.0,1.1106915165381966e-05,1.0
40412,중개인/Noun,1,1,0,1.1115310228308472e-05,0.0,1.0
40413,유태/Noun,1,0,1,0.0,1.1106915165381966e-05,1.0
40414,잿더미/Noun,1,0,1,0.0,1.1106915165381966e-05,1.0
40415,피싱/Noun,1,1,0,1.1115310228308472e-05,0.0,1.0
40416,송유정/Noun,1,1,0,1.1115310228308472e-05,0.0,1.0
40417,물위/Noun,1,1,0,1.1115310228308472e-05,0.0,1.0
40418,어나더/Noun,1,1,0,1.1115310228308472e-05,0.0,1.0
40419,효심/Noun,1,1,0,1.1115310228308472e-05,0.0,1.0
40420,금가루/Noun,1,1,0,1.1115310228308472e-05,0.0,1.0
40421,카페베네/Noun,1,1,0,1.1115310228308472e-05,0.0,1.0
40422,협심증/Noun,1,0,1,0.0,1.1106915165381966e-05,1.0
40423,이륙씬/Noun,1,1,0,1.1115310228308472e-05,0.0,1.0
40424,메가패스/Noun,1,1,0,1.1115310228308472e-05,0.0,1.0
40425,썩이다/Verb,1,1,0,1.1115310228308472e-05,0.0,1.0
40426,털업/Noun,1,1,0,1.1115310228308472e-05,0.0,1.0
40427,글로벌/Noun,1,0,1,0.0,1.1106915165381966e-05,1.0
40428,만에는/Foreign,1,0,1,0.0,1.1106915165381966e-05,1.0
40429,북어/Noun,1,0,1,0.0,1.1106915165381966e-05,1.0
40430,장면을위해/Foreign,1,0,1,0.0,1.1106915165381966e-05,1.0
40431,모리노/Noun,1,0,1,0.0,1.1106915165381966e-05,1.0
40432,~~.../Punctuation,1,1,0,1.1115310228308472e-05,0.0,1.0
40433,굴비/Noun,1,0,1,0.0,1.1106915165381966e-05,1.0
40434,파헤/Noun,1,0,1,0.0,1.1106915165381966e-05,1.0
40435,후송/Noun,1,0,1,0.0,1.1106915165381966e-05,1.0
40436,챔피온/Noun,1,1,0,1.1115310228308472e-05,0.0,1.0
40437,던전앤드래곤/Noun,1,0,1,0.0,1.1106915165381966e-05,1.0
40438,",,,,,,,,,,,,,,,,,,,,,,,,,,,,,,,,,,,,,,,,,,,,,,,,/Punctuation",1,0,1,0.0,1.1106915165381966e-05,1.0
40439,손노리/Noun,1,1,0,1.1115310228308472e-05,0.0,1.0
40440,종이학/Noun,1,1,0,1.1115310228308472e-05,0.0,1.0
40441,굉음/Noun,1,1,0,1.1115310228308472e-05,0.0,1.0
40442,하가경/Noun,1,1,0,1.1115310228308472e-05,0.0,1.0
40443,광동어/Noun,1,0,1,0.0,1.1106915165381966e-05,1.0
40444,운전사/Noun,1,1,0,1.1115310228308472e-05,0.0,1.0
40445,덴장/Noun,1,0,1,0.0,1.1106915165381966e-05,1.0
40446,김여정/Noun,1,0,1,0.0,1.1106915165381966e-05,1.0
40447,유/Foreign,1,0,1,0.0,1.1106915165381966e-05,1.0
40448,감로/Noun,1,1,0,1.1115310228308472e-05,0.0,1.0
40449,-_-??/Punctuation,1,1,0,1.1115310228308472e-05,0.0,1.0
40450,델다놨는/Noun,1,0,1,0.0,1.1106915165381966e-05,1.0
40451,ㅔㅔㅇ/KoreanParticle,1,1,0,1.1115310228308472e-05,0.0,1.0
40452,빈애/Noun,1,0,1,0.0,1.1106915165381966e-05,1.0
40453,dancer/Alpha,1,1,0,1.1115310228308472e-05,0.0,1.0
40454,cosmic/Alpha,1,1,0,1.1115310228308472e-05,0.0,1.0
40455,테일로/Noun,1,1,0,1.1115310228308472e-05,0.0,1.0
40456,된장국/Noun,1,0,1,0.0,1.1106915165381966e-05,1.0
40457,바르다/Adjective,1,0,1,0.0,1.1106915165381966e-05,1.0
40458,초록색/Noun,1,0,1,0.0,1.1106915165381966e-05,1.0
40459,짜잉나첨/Noun,1,0,1,0.0,1.1106915165381966e-05,1.0
40460,골퍼/Noun,1,0,1,0.0,1.1106915165381966e-05,1.0
40461,함유/Noun,1,0,1,0.0,1.1106915165381966e-05,1.0
40462,턴데/Noun,1,1,0,1.1115310228308472e-05,0.0,1.0
40463,자톡/Noun,1,1,0,1.1115310228308472e-05,0.0,1.0
40464,다음팟/Noun,1,1,0,1.1115310228308472e-05,0.0,1.0
40465,슲픈/Noun,1,1,0,1.1115310228308472e-05,0.0,1.0
40466,맷돼/Noun,1,0,1,0.0,1.1106915165381966e-05,1.0
40467,허저/Noun,1,0,1,0.0,1.1106915165381966e-05,1.0
40468,나장/Noun,1,0,1,0.0,1.1106915165381966e-05,1.0
40469,횟차/Noun,1,0,1,0.0,1.1106915165381966e-05,1.0
40470,hcn/Alpha,1,0,1,0.0,1.1106915165381966e-05,1.0
40471,추친/Noun,1,1,0,1.1115310228308472e-05,0.0,1.0
40472,중국문학/Noun,1,1,0,1.1115310228308472e-05,0.0,1.0
40473,가지예들중의하나일뿐/Foreign,1,0,1,0.0,1.1106915165381966e-05,1.0
40474,챔피언스/Noun,1,0,1,0.0,1.1106915165381966e-05,1.0
40475,ㄴㅋㅋ/KoreanParticle,1,1,0,1.1115310228308472e-05,0.0,1.0
40476,윽익악익옥욱/Noun,1,0,1,0.0,1.1106915165381966e-05,1.0
40477,근육남/Noun,1,0,1,0.0,1.1106915165381966e-05,1.0
40478,실더/Noun,1,0,1,0.0,1.1106915165381966e-05,1.0
40479,부그그/Adverb,1,1,0,1.1115310228308472e-05,0.0,1.0
40480,오스트레일리아인/Noun,1,1,0,1.1115310228308472e-05,0.0,1.0
40481,힛처/Noun,1,1,0,1.1115310228308472e-05,0.0,1.0
40482,映畵/Foreign,1,1,0,1.1115310228308472e-05,0.0,1.0
40483,돌리도/Foreign,1,0,1,0.0,1.1106915165381966e-05,1.0
40484,을축/Noun,1,0,1,0.0,1.1106915165381966e-05,1.0
40485,라선/Noun,1,1,0,1.1115310228308472e-05,0.0,1.0
40486,옿/Noun,1,0,1,0.0,1.1106915165381966e-05,1.0
40487,엄노엄노어몬/Noun,1,0,1,0.0,1.1106915165381966e-05,1.0
40488,흠흥/Noun,1,0,1,0.0,1.1106915165381966e-05,1.0
40489,도화상/Noun,1,0,1,0.0,1.1106915165381966e-05,1.0
40490,데이비슨/Noun,1,0,1,0.0,1.1106915165381966e-05,1.0
40491,이히히/Adverb,1,1,0,1.1115310228308472e-05,0.0,1.0
40492,--+/Punctuation,1,1,0,1.1115310228308472e-05,0.0,1.0
40493,~~(/Punctuation,1,1,0,1.1115310228308472e-05,0.0,1.0
40494,2.31/Number,1,0,1,0.0,1.1106915165381966e-05,1.0
40495,둗둗/Noun,1,1,0,1.1115310228308472e-05,0.0,1.0
40496,둗/Noun,1,1,0,1.1115310228308472e-05,0.0,1.0
40497,모무멈/Noun,1,1,0,1.1115310228308472e-05,0.0,1.0
40498,푸리/Noun,1,1,0,1.1115310228308472e-05,0.0,1.0
40499,헤어쇼/Noun,1,0,1,0.0,1.1106915165381966e-05,1.0
40500,insight/Alpha,1,1,0,1.1115310228308472e-05,0.0,1.0
40501,gold/Alpha,1,1,0,1.1115310228308472e-05,0.0,1.0
40502,black/Alpha,1,1,0,1.1115310228308472e-05,0.0,1.0
40503,무서웜/Noun,1,1,0,1.1115310228308472e-05,0.0,1.0
40504,욬황시욬황시욬/Noun,1,0,1,0.0,1.1106915165381966e-05,1.0
40505,멀쭘했다/Noun,1,0,1,0.0,1.1106915165381966e-05,1.0
40506,꼬부/Noun,1,1,0,1.1115310228308472e-05,0.0,1.0
40507,잉핑닝틍/Noun,1,1,0,1.1115310228308472e-05,0.0,1.0
40508,상랑/Noun,1,1,0,1.1115310228308472e-05,0.0,1.0
40509,놀랏던/Noun,1,0,1,0.0,1.1106915165381966e-05,1.0
40510,윰/Noun,1,1,0,1.1115310228308472e-05,0.0,1.0
40511,애선/Noun,1,1,0,1.1115310228308472e-05,0.0,1.0
40512,마르커스/Noun,1,1,0,1.1115310228308472e-05,0.0,1.0
40513,끝잼/Noun,1,0,1,0.0,1.1106915165381966e-05,1.0
40514,뿔사/Noun,1,0,1,0.0,1.1106915165381966e-05,1.0
40515,愛/Foreign,1,0,1,0.0,1.1106915165381966e-05,1.0
40516,광택/Noun,1,0,1,0.0,1.1106915165381966e-05,1.0
40517,흰자위/Noun,1,0,1,0.0,1.1106915165381966e-05,1.0
40518,쿵품/Noun,1,0,1,0.0,1.1106915165381966e-05,1.0
40519,rpg/Alpha,1,0,1,0.0,1.1106915165381966e-05,1.0
40520,꽝꽈/Noun,1,0,1,0.0,1.1106915165381966e-05,1.0
40521,!@#$%^/Punctuation,1,1,0,1.1115310228308472e-05,0.0,1.0
40522,슈타이너/Noun,1,1,0,1.1115310228308472e-05,0.0,1.0
40523,팰것임/Noun,1,0,1,0.0,1.1106915165381966e-05,1.0
40524,쵴오/Noun,1,1,0,1.1115310228308472e-05,0.0,1.0
40525,바좀/Noun,1,0,1,0.0,1.1106915165381966e-05,1.0
40526,소독/Noun,1,1,0,1.1115310228308472e-05,0.0,1.0
40527,미귝/Noun,1,0,1,0.0,1.1106915165381966e-05,1.0
40528,6000만원/Number,1,0,1,0.0,1.1106915165381966e-05,1.0
40529,옶다/Noun,1,0,1,0.0,1.1106915165381966e-05,1.0
40530,증강/Noun,1,1,0,1.1115310228308472e-05,0.0,1.0
40531,호빗호빗/Adverb,1,1,0,1.1115310228308472e-05,0.0,1.0
40532,김어준/Noun,1,1,0,1.1115310228308472e-05,0.0,1.0
40533,철모/Noun,1,0,1,0.0,1.1106915165381966e-05,1.0
40534,변덕쟁이/Noun,1,0,1,0.0,1.1106915165381966e-05,1.0
40535,바턴/Noun,1,1,0,1.1115310228308472e-05,0.0,1.0
40536,";""/Punctuation",1,1,0,1.1115310228308472e-05,0.0,1.0
40537,훨잼나/Noun,1,1,0,1.1115310228308472e-05,0.0,1.0
40538,마사이족/Noun,1,0,1,0.0,1.1106915165381966e-05,1.0
40539,마사이/Noun,1,0,1,0.0,1.1106915165381966e-05,1.0
40540,낚는것/Noun,1,0,1,0.0,1.1106915165381966e-05,1.0
40541,룩고스/Noun,1,0,1,0.0,1.1106915165381966e-05,1.0
40542,말/Foreign,1,0,1,0.0,1.1106915165381966e-05,1.0
40543,녀임/Noun,1,1,0,1.1115310228308472e-05,0.0,1.0
40544,님답변/Noun,1,1,0,1.1115310228308472e-05,0.0,1.0
40545,윤학/Noun,1,1,0,1.1115310228308472e-05,0.0,1.0
40546,눈발/Noun,1,1,0,1.1115310228308472e-05,0.0,1.0
40547,안도현/Noun,1,1,0,1.1115310228308472e-05,0.0,1.0
40548,강정은/Noun,1,0,1,0.0,1.1106915165381966e-05,1.0
40549,씬봐/Noun,1,1,0,1.1115310228308472e-05,0.0,1.0
40550,시시각각/Noun,1,0,1,0.0,1.1106915165381966e-05,1.0
40551,포자/Noun,1,1,0,1.1115310228308472e-05,0.0,1.0
40552,10.0/Number,1,1,0,1.1115310228308472e-05,0.0,1.0
40553,끼기긱/Noun,1,1,0,1.1115310228308472e-05,0.0,1.0
40554,1000000%/Number,1,0,1,0.0,1.1106915165381966e-05,1.0
40555,'(/Punctuation,1,1,0,1.1115310228308472e-05,0.0,1.0
40556,우랴우랴/Noun,1,1,0,1.1115310228308472e-05,0.0,1.0
40557,우갸우갸/Noun,1,1,0,1.1115310228308472e-05,0.0,1.0
40558,띠디띠/Noun,1,0,1,0.0,1.1106915165381966e-05,1.0
40559,삼초/Noun,1,0,1,0.0,1.1106915165381966e-05,1.0
40560,개략/Noun,1,0,1,0.0,1.1106915165381966e-05,1.0
40561,무인시대/Noun,1,1,0,1.1115310228308472e-05,0.0,1.0
40562,댝/Noun,1,0,1,0.0,1.1106915165381966e-05,1.0
40563,꼬앗는/Noun,1,1,0,1.1115310228308472e-05,0.0,1.0
40564,겟습/Noun,1,1,0,1.1115310228308472e-05,0.0,1.0
40565,넘낮넹/Noun,1,1,0,1.1115310228308472e-05,0.0,1.0
40566,애슬리/Noun,1,1,0,1.1115310228308472e-05,0.0,1.0
40567,말벌/Noun,1,0,1,0.0,1.1106915165381966e-05,1.0
40568,윤리경영/Noun,1,1,0,1.1115310228308472e-05,0.0,1.0
40569,16:56/Number,1,0,1,0.0,1.1106915165381966e-05,1.0
40570,2013.09/Number,1,0,1,0.0,1.1106915165381966e-05,1.0
40571,apsa/Alpha,1,0,1,0.0,1.1106915165381966e-05,1.0
40572,메이코/Noun,1,0,1,0.0,1.1106915165381966e-05,1.0
40573,혼마/Noun,1,0,1,0.0,1.1106915165381966e-05,1.0
40574,꾸몃으/Noun,1,0,1,0.0,1.1106915165381966e-05,1.0
40575,♥♥♥♥★★★★/Foreign,1,1,0,1.1115310228308472e-05,0.0,1.0
40576,혼줄/Noun,1,1,0,1.1115310228308472e-05,0.0,1.0
40577,들소리/Noun,1,0,1,0.0,1.1106915165381966e-05,1.0
40578,운동신경/Noun,1,1,0,1.1115310228308472e-05,0.0,1.0
40579,난척/Noun,1,0,1,0.0,1.1106915165381966e-05,1.0
40580,꺇/Noun,1,1,0,1.1115310228308472e-05,0.0,1.0
40581,개나살껄/Noun,1,0,1,0.0,1.1106915165381966e-05,1.0
40582,",.;;/Punctuation",1,0,1,0.0,1.1106915165381966e-05,1.0
40583,asshole/Alpha,1,0,1,0.0,1.1106915165381966e-05,1.0
40584,씩나눠서이야기를이어가는/Foreign,1,1,0,1.1115310228308472e-05,0.0,1.0
40585,도부터뮤지컬을하고있습니다/Foreign,1,1,0,1.1115310228308472e-05,0.0,1.0
40586,비공식/Noun,1,1,0,1.1115310228308472e-05,0.0,1.0
40587,띠껍다/Noun,1,0,1,0.0,1.1106915165381966e-05,1.0
40588,피부병/Noun,1,0,1,0.0,1.1106915165381966e-05,1.0
40589,라야/Noun,1,0,1,0.0,1.1106915165381966e-05,1.0
40590,치킨너겟/Noun,1,0,1,0.0,1.1106915165381966e-05,1.0
40591,끝나넹/Noun,1,0,1,0.0,1.1106915165381966e-05,1.0
40592,진위/Noun,1,1,0,1.1115310228308472e-05,0.0,1.0
40593,링컨차/Noun,1,0,1,0.0,1.1106915165381966e-05,1.0
40594,알권리/Noun,1,0,1,0.0,1.1106915165381966e-05,1.0
40595,일문/Noun,1,0,1,0.0,1.1106915165381966e-05,1.0
40596,고매/Noun,1,0,1,0.0,1.1106915165381966e-05,1.0
40597,아디다스/Noun,1,1,0,1.1115310228308472e-05,0.0,1.0
40598,에츠코/Noun,1,1,0,1.1115310228308472e-05,0.0,1.0
40599,제이스/Noun,1,0,1,0.0,1.1106915165381966e-05,1.0
40600,11123123123/Number,1,1,0,1.1115310228308472e-05,0.0,1.0
40601,realistically/Alpha,1,1,0,1.1115310228308472e-05,0.0,1.0
40602,shown/Alpha,1,1,0,1.1115310228308472e-05,0.0,1.0
40603,wanted/Alpha,1,1,0,1.1115310228308472e-05,0.0,1.0
40604,rather/Alpha,1,1,0,1.1115310228308472e-05,0.0,1.0
40605,Hardest/Alpha,1,1,0,1.1115310228308472e-05,0.0,1.0
40606,에게서도/Josa,1,1,0,1.1115310228308472e-05,0.0,1.0
40607,프리티걸/Noun,1,0,1,0.0,1.1106915165381966e-05,1.0
40608,보는게/Foreign,1,0,1,0.0,1.1106915165381966e-05,1.0
40609,레기임/Noun,1,0,1,0.0,1.1106915165381966e-05,1.0
40610,투루/Noun,1,0,1,0.0,1.1106915165381966e-05,1.0
40611,미리엄/Noun,1,1,0,1.1115310228308472e-05,0.0,1.0
40612,엇긔/Noun,1,1,0,1.1115310228308472e-05,0.0,1.0
40613,뿍빠졋다/Noun,1,1,0,1.1115310228308472e-05,0.0,1.0
40614,영진/Noun,1,0,1,0.0,1.1106915165381966e-05,1.0
40615,hmm/Alpha,1,0,1,0.0,1.1106915165381966e-05,1.0
40616,점용/Noun,1,1,0,1.1115310228308472e-05,0.0,1.0
40617,룡팔부/Foreign,1,1,0,1.1115310228308472e-05,0.0,1.0
40618,2003천/Number,1,1,0,1.1115310228308472e-05,0.0,1.0
40619,로디/Noun,1,1,0,1.1115310228308472e-05,0.0,1.0
40620,이나봤내/Foreign,1,0,1,0.0,1.1106915165381966e-05,1.0
40621,damm/Alpha,1,0,1,0.0,1.1106915165381966e-05,1.0
40622,dear/Alpha,1,0,1,0.0,1.1106915165381966e-05,1.0
40623,frankely/Alpha,1,0,1,0.0,1.1106915165381966e-05,1.0
40624,배기량/Noun,1,0,1,0.0,1.1106915165381966e-05,1.0
40625,suv/Alpha,1,0,1,0.0,1.1106915165381966e-05,1.0
40626,탑코/Noun,1,0,1,0.0,1.1106915165381966e-05,1.0
40627,퀀텀오브솔러스/Noun,1,0,1,0.0,1.1106915165381966e-05,1.0
40628,대층/Noun,1,0,1,0.0,1.1106915165381966e-05,1.0
40629,3000원/Number,1,0,1,0.0,1.1106915165381966e-05,1.0
40630,General/Alpha,1,0,1,0.0,1.1106915165381966e-05,1.0
40631,베쯔/Noun,1,0,1,0.0,1.1106915165381966e-05,1.0
40632,ㅄㄷ/KoreanParticle,1,0,1,0.0,1.1106915165381966e-05,1.0
40633,가행/Noun,1,0,1,0.0,1.1106915165381966e-05,1.0
40634,예은/Noun,1,0,1,0.0,1.1106915165381966e-05,1.0
40635,신지수/Noun,1,1,0,1.1115310228308472e-05,0.0,1.0
40636,♥♥♥♥♥♡♡♡♡♡♡♡/Foreign,1,1,0,1.1115310228308472e-05,0.0,1.0
40637,Jhc/Alpha,1,1,0,1.1115310228308472e-05,0.0,1.0
40638,밷/Noun,1,0,1,0.0,1.1106915165381966e-05,1.0
40639,강퇴/Noun,1,0,1,0.0,1.1106915165381966e-05,1.0
40640,loyalty/Alpha,1,1,0,1.1115310228308472e-05,0.0,1.0
40641,퍼펑/Noun,1,1,0,1.1115310228308472e-05,0.0,1.0
40642,오마에/Noun,1,1,0,1.1115310228308472e-05,0.0,1.0
40643,;;)/Punctuation,1,0,1,0.0,1.1106915165381966e-05,1.0
40644,후퍼/Noun,1,0,1,0.0,1.1106915165381966e-05,1.0
40645,쇼와시대/Noun,1,0,1,0.0,1.1106915165381966e-05,1.0
40646,빈곤층/Noun,1,0,1,0.0,1.1106915165381966e-05,1.0
40647,별빛/Noun,1,1,0,1.1115310228308472e-05,0.0,1.0
40648,피부색/Noun,1,0,1,0.0,1.1106915165381966e-05,1.0
40649,진언/Noun,1,1,0,1.1115310228308472e-05,0.0,1.0
40650,만선/Noun,1,1,0,1.1115310228308472e-05,0.0,1.0
40651,포경선/Noun,1,1,0,1.1115310228308472e-05,0.0,1.0
40652,몇씬/Noun,1,1,0,1.1115310228308472e-05,0.0,1.0
40653,...;.???/Punctuation,1,0,1,0.0,1.1106915165381966e-05,1.0
40654,둘쨰/Noun,1,0,1,0.0,1.1106915165381966e-05,1.0
40655,사과받다/Verb,1,1,0,1.1115310228308472e-05,0.0,1.0
40656,고독고독/Adverb,1,1,0,1.1115310228308472e-05,0.0,1.0
40657,깨금깨금/Noun,1,1,0,1.1115310228308472e-05,0.0,1.0
40658,속셈/Noun,1,0,1,0.0,1.1106915165381966e-05,1.0
40659,포유/Noun,1,0,1,0.0,1.1106915165381966e-05,1.0
40660,심재명/Noun,1,0,1,0.0,1.1106915165381966e-05,1.0
40661,우나기/Noun,1,1,0,1.1115310228308472e-05,0.0,1.0
40662,다슬/Noun,1,1,0,1.1115310228308472e-05,0.0,1.0
40663,쌤썽/Noun,1,1,0,1.1115310228308472e-05,0.0,1.0
40664,넘어왓엇음/Noun,1,1,0,1.1115310228308472e-05,0.0,1.0
40665,가씨/Noun,1,0,1,0.0,1.1106915165381966e-05,1.0
40666,탸찰/Noun,1,0,1,0.0,1.1106915165381966e-05,1.0
40667,월경/Noun,1,0,1,0.0,1.1106915165381966e-05,1.0
40668,;;??/Punctuation,1,0,1,0.0,1.1106915165381966e-05,1.0
40669,에이드리언/Noun,1,1,0,1.1115310228308472e-05,0.0,1.0
40670,몰르겄/Noun,1,0,1,0.0,1.1106915165381966e-05,1.0
40671,걸론/Noun,1,0,1,0.0,1.1106915165381966e-05,1.0
40672,몬가좀/Noun,1,0,1,0.0,1.1106915165381966e-05,1.0
40673,루이종/Noun,1,1,0,1.1115310228308472e-05,0.0,1.0
40674,588/Number,1,0,1,0.0,1.1106915165381966e-05,1.0
40675,청량리/Noun,1,0,1,0.0,1.1106915165381966e-05,1.0
40676,막굴린/Noun,1,0,1,0.0,1.1106915165381966e-05,1.0
40677,................!?/Punctuation,1,0,1,0.0,1.1106915165381966e-05,1.0
40678,붕터/Noun,1,0,1,0.0,1.1106915165381966e-05,1.0
40679,유루유리/Noun,1,0,1,0.0,1.1106915165381966e-05,1.0
40680,')///Punctuation,1,1,0,1.1115310228308472e-05,0.0,1.0
40681,좆선/Noun,1,1,0,1.1115310228308472e-05,0.0,1.0
40682,얻어먹다/Verb,1,0,1,0.0,1.1106915165381966e-05,1.0
40683,51.8%/Number,1,1,0,1.1115310228308472e-05,0.0,1.0
40684,장충단/Noun,1,1,0,1.1115310228308472e-05,0.0,1.0
40685,SD/Alpha,1,0,1,0.0,1.1106915165381966e-05,1.0
40686,시댜/Noun,1,0,1,0.0,1.1106915165381966e-05,1.0
40687,유득/Noun,1,1,0,1.1115310228308472e-05,0.0,1.0
40688,음악학/Noun,1,0,1,0.0,1.1106915165381966e-05,1.0
40689,헬기씬/Noun,1,1,0,1.1115310228308472e-05,0.0,1.0
40690,내숭녀/Noun,1,0,1,0.0,1.1106915165381966e-05,1.0
40691,이재황/Noun,1,1,0,1.1115310228308472e-05,0.0,1.0
40692,격해/Noun,1,0,1,0.0,1.1106915165381966e-05,1.0
40693,라이너/Noun,1,1,0,1.1115310228308472e-05,0.0,1.0
40694,페놀/Noun,1,0,1,0.0,1.1106915165381966e-05,1.0
40695,분홍색/Noun,1,1,0,1.1115310228308472e-05,0.0,1.0
40696,365/Number,1,1,0,1.1115310228308472e-05,0.0,1.0
40697,할리우드영화/Noun,1,1,0,1.1115310228308472e-05,0.0,1.0
40698,Shields/Alpha,1,1,0,1.1115310228308472e-05,0.0,1.0
40699,Brooke/Alpha,1,1,0,1.1115310228308472e-05,0.0,1.0
40700,광원/Noun,1,0,1,0.0,1.1106915165381966e-05,1.0
40701,hr/Alpha,1,1,0,1.1115310228308472e-05,0.0,1.0
40702,파월/Noun,1,1,0,1.1115310228308472e-05,0.0,1.0
40703,투라/Noun,1,1,0,1.1115310228308472e-05,0.0,1.0
40704,폐쇄하/Noun,1,0,1,0.0,1.1106915165381966e-05,1.0
40705,죽창/Noun,1,0,1,0.0,1.1106915165381966e-05,1.0
40706,젛겠어/Noun,1,1,0,1.1115310228308472e-05,0.0,1.0
40707,회담/Noun,1,0,1,0.0,1.1106915165381966e-05,1.0
40708,리플렛/Noun,1,1,0,1.1115310228308472e-05,0.0,1.0
40709,효느/Noun,1,1,0,1.1115310228308472e-05,0.0,1.0
40710,탐지/Noun,1,0,1,0.0,1.1106915165381966e-05,1.0
40711,적외선/Noun,1,0,1,0.0,1.1106915165381966e-05,1.0
40712,보마/Noun,1,0,1,0.0,1.1106915165381966e-05,1.0
40713,어쩄/Noun,1,1,0,1.1115310228308472e-05,0.0,1.0
40714,쵝오구/Noun,1,1,0,1.1115310228308472e-05,0.0,1.0
40715,퓨어/Noun,1,1,0,1.1115310228308472e-05,0.0,1.0
40716,심미성/Noun,1,0,1,0.0,1.1106915165381966e-05,1.0
40717,잼썻는뎅/Noun,1,1,0,1.1115310228308472e-05,0.0,1.0
40718,이뻣구/Noun,1,1,0,1.1115310228308472e-05,0.0,1.0
40719,타살/Noun,1,1,0,1.1115310228308472e-05,0.0,1.0
40720,렉시/Noun,1,1,0,1.1115310228308472e-05,0.0,1.0
40721,낙차/Noun,1,1,0,1.1115310228308472e-05,0.0,1.0
40722,까락/Noun,1,0,1,0.0,1.1106915165381966e-05,1.0
40723,엄지손/Noun,1,0,1,0.0,1.1106915165381966e-05,1.0
40724,흉기/Noun,1,0,1,0.0,1.1106915165381966e-05,1.0
40725,패트병/Noun,1,0,1,0.0,1.1106915165381966e-05,1.0
40726,롤플레이/Noun,1,1,0,1.1115310228308472e-05,0.0,1.0
40727,적소/Noun,1,1,0,1.1115310228308472e-05,0.0,1.0
40728,잘꼬시/Noun,1,1,0,1.1115310228308472e-05,0.0,1.0
40729,힌유/Noun,1,1,0,1.1115310228308472e-05,0.0,1.0
40730,우에다/Noun,1,1,0,1.1115310228308472e-05,0.0,1.0
40731,어거/Noun,1,1,0,1.1115310228308472e-05,0.0,1.0
40732,1318/Number,1,1,0,1.1115310228308472e-05,0.0,1.0
40733,jou/Alpha,1,1,0,1.1115310228308472e-05,0.0,1.0
40734,檢/Foreign,1,0,1,0.0,1.1106915165381966e-05,1.0
40735,dmadkdmadkdma/Alpha,1,0,1,0.0,1.1106915165381966e-05,1.0
40736,dma/Alpha,1,0,1,0.0,1.1106915165381966e-05,1.0
40737,Thums/Alpha,1,1,0,1.1115310228308472e-05,0.0,1.0
40738,귀신이산다/Noun,1,1,0,1.1115310228308472e-05,0.0,1.0
40739,".^^""/Punctuation",1,0,1,0.0,1.1106915165381966e-05,1.0
40740,꼬듯/Noun,1,0,1,0.0,1.1106915165381966e-05,1.0
40741,"...^^""""""/Punctuation",1,0,1,0.0,1.1106915165381966e-05,1.0
40742,JTBC/Alpha,1,1,0,1.1115310228308472e-05,0.0,1.0
40743,오월/Noun,1,1,0,1.1115310228308472e-05,0.0,1.0
40744,ehdnaehla/Alpha,1,1,0,1.1115310228308472e-05,0.0,1.0
40745,tkghlrhdqndp/Alpha,1,1,0,1.1115310228308472e-05,0.0,1.0
40746,qhkTsmsep/Alpha,1,1,0,1.1115310228308472e-05,0.0,1.0
40747,dlrj/Alpha,1,1,0,1.1115310228308472e-05,0.0,1.0
40748,tlrksdp/Alpha,1,1,0,1.1115310228308472e-05,0.0,1.0
40749,tkghl/Alpha,1,1,0,1.1115310228308472e-05,0.0,1.0
40750,코갤러/Noun,1,1,0,1.1115310228308472e-05,0.0,1.0
40751,)-(/Punctuation,1,0,1,0.0,1.1106915165381966e-05,1.0
40752,+(/Punctuation,1,0,1,0.0,1.1106915165381966e-05,1.0
40753,)+(/Punctuation,1,0,1,0.0,1.1106915165381966e-05,1.0
40754,CGx/Alpha,1,0,1,0.0,1.1106915165381966e-05,1.0
40755,댜큐/Noun,1,1,0,1.1115310228308472e-05,0.0,1.0
40756,01:17/Number,1,0,1,0.0,1.1106915165381966e-05,1.0
40757,2013.12/Number,1,0,1,0.0,1.1106915165381966e-05,1.0
40758,"''''""""""""**/Punctuation",1,1,0,1.1115310228308472e-05,0.0,1.0
40759,더꿀잼/Noun,1,0,1,0.0,1.1106915165381966e-05,1.0
40760,분화/Noun,1,0,1,0.0,1.1106915165381966e-05,1.0
40761,*-_-*/Punctuation,1,1,0,1.1115310228308472e-05,0.0,1.0
40762,이슬람국/Noun,1,0,1,0.0,1.1106915165381966e-05,1.0
40763,툴/Noun,1,0,1,0.0,1.1106915165381966e-05,1.0
40764,느김/Noun,1,1,0,1.1115310228308472e-05,0.0,1.0
40765,평좀좀/Noun,1,0,1,0.0,1.1106915165381966e-05,1.0
40766,모르갯슴/Noun,1,0,1,0.0,1.1106915165381966e-05,1.0
40767,갸륵한데/Noun,1,0,1,0.0,1.1106915165381966e-05,1.0
40768,텝덴스/Noun,1,0,1,0.0,1.1106915165381966e-05,1.0
40769,파릇하다/Adjective,1,1,0,1.1115310228308472e-05,0.0,1.0
40770,기륭/Noun,1,1,0,1.1115310228308472e-05,0.0,1.0
40771,닥패/Noun,1,1,0,1.1115310228308472e-05,0.0,1.0
40772,Yui/Alpha,1,1,0,1.1115310228308472e-05,0.0,1.0
40773,레툰/Noun,1,1,0,1.1115310228308472e-05,0.0,1.0
40774,킹흥해/Noun,1,1,0,1.1115310228308472e-05,0.0,1.0
40775,멀리뛰기/Noun,1,0,1,0.0,1.1106915165381966e-05,1.0
40776,낚자/Noun,1,0,1,0.0,1.1106915165381966e-05,1.0
40777,아랏던/Noun,1,0,1,0.0,1.1106915165381966e-05,1.0
40778,중압감/Noun,1,0,1,0.0,1.1106915165381966e-05,1.0
40779,군소리/Noun,1,1,0,1.1115310228308472e-05,0.0,1.0
40780,낚았네/Noun,1,0,1,0.0,1.1106915165381966e-05,1.0
40781,반중력/Noun,1,1,0,1.1115310228308472e-05,0.0,1.0
40782,식단/Noun,1,0,1,0.0,1.1106915165381966e-05,1.0
40783,arrow/Alpha,1,1,0,1.1115310228308472e-05,0.0,1.0
40784,클라리스/Noun,1,1,0,1.1115310228308472e-05,0.0,1.0
40785,리세/Noun,1,1,0,1.1115310228308472e-05,0.0,1.0
40786,법규/Noun,1,0,1,0.0,1.1106915165381966e-05,1.0
40787,뉘규/Noun,1,0,1,0.0,1.1106915165381966e-05,1.0
40788,젠듯/Noun,1,0,1,0.0,1.1106915165381966e-05,1.0
40789,수도사/Noun,1,0,1,0.0,1.1106915165381966e-05,1.0
40790,깐느영화제/Noun,1,1,0,1.1115310228308472e-05,0.0,1.0
40791,어늘한듯/Noun,1,1,0,1.1115310228308472e-05,0.0,1.0
40792,팼음/Noun,1,0,1,0.0,1.1106915165381966e-05,1.0
40793,1000000000/Number,1,0,1,0.0,1.1106915165381966e-05,1.0
40794,일원/Noun,1,1,0,1.1115310228308472e-05,0.0,1.0
40795,...!..!.../Punctuation,1,0,1,0.0,1.1106915165381966e-05,1.0
40796,밖힌/Noun,1,0,1,0.0,1.1106915165381966e-05,1.0
40797,말속/Noun,1,1,0,1.1115310228308472e-05,0.0,1.0
40798,타랑/Adverb,1,1,0,1.1115310228308472e-05,0.0,1.0
40799,믹아뇨/Noun,1,1,0,1.1115310228308472e-05,0.0,1.0
40800,금구/Noun,1,1,0,1.1115310228308472e-05,0.0,1.0
40801,목창/Noun,1,0,1,0.0,1.1106915165381966e-05,1.0
40802,0.1초/Number,1,0,1,0.0,1.1106915165381966e-05,1.0
40803,한번봣으/Noun,1,1,0,1.1115310228308472e-05,0.0,1.0
40804,역동/Noun,1,1,0,1.1115310228308472e-05,0.0,1.0
40805,fockrers/Alpha,1,1,0,1.1115310228308472e-05,0.0,1.0
40806,"....,.../Punctuation",1,0,1,0.0,1.1106915165381966e-05,1.0
40807,좋턴데/Noun,1,1,0,1.1115310228308472e-05,0.0,1.0
40808,무릎팍도사/Noun,1,1,0,1.1115310228308472e-05,0.0,1.0
40809,싸눅/Noun,1,1,0,1.1115310228308472e-05,0.0,1.0
40810,벙벙/Noun,1,0,1,0.0,1.1106915165381966e-05,1.0
40811,어안/Noun,1,0,1,0.0,1.1106915165381966e-05,1.0
40812,폼생폼사/Noun,1,0,1,0.0,1.1106915165381966e-05,1.0
40813,3.23/Number,1,1,0,1.1115310228308472e-05,0.0,1.0
40814,텐뎅/Noun,1,1,0,1.1115310228308472e-05,0.0,1.0
40815,일용/Noun,1,0,1,0.0,1.1106915165381966e-05,1.0
40816,ㅡㅁ/KoreanParticle,1,0,1,0.0,1.1106915165381966e-05,1.0
40817,였죵/Noun,1,0,1,0.0,1.1106915165381966e-05,1.0
40818,NSA/Alpha,1,0,1,0.0,1.1106915165381966e-05,1.0
40819,낚인것/Noun,1,0,1,0.0,1.1106915165381966e-05,1.0
40820,Goood/Alpha,1,1,0,1.1115310228308472e-05,0.0,1.0
40821,으리다/Eomi,1,1,0,1.1115310228308472e-05,0.0,1.0
40822,너뭄/Noun,1,1,0,1.1115310228308472e-05,0.0,1.0
40823,동점/Noun,1,0,1,0.0,1.1106915165381966e-05,1.0
40824,왕잼/Noun,1,1,0,1.1115310228308472e-05,0.0,1.0
40825,대량생산/Noun,1,0,1,0.0,1.1106915165381966e-05,1.0
40826,게리굿릿/Noun,1,0,1,0.0,1.1106915165381966e-05,1.0
40827,연변말/Noun,1,0,1,0.0,1.1106915165381966e-05,1.0
40828,ㅋㅋㅋㅅㅂㅡㅡ/KoreanParticle,1,0,1,0.0,1.1106915165381966e-05,1.0
40829,siwon/Alpha,1,1,0,1.1115310228308472e-05,0.0,1.0
40830,",........../Punctuation",1,1,0,1.1115310228308472e-05,0.0,1.0
40831,공고/Noun,1,1,0,1.1115310228308472e-05,0.0,1.0
40832,핑돌게/Noun,1,1,0,1.1115310228308472e-05,0.0,1.0
40833,쥑입니/Noun,1,1,0,1.1115310228308472e-05,0.0,1.0
40834,부앙/Noun,1,1,0,1.1115310228308472e-05,0.0,1.0
40835,러샤애/Noun,1,0,1,0.0,1.1106915165381966e-05,1.0
40836,~?)/Punctuation,1,0,1,0.0,1.1106915165381966e-05,1.0
40837,Jodelle/Alpha,1,1,0,1.1115310228308472e-05,0.0,1.0
40838,원론/Noun,1,1,0,1.1115310228308472e-05,0.0,1.0
40839,점빵문/Noun,1,0,1,0.0,1.1106915165381966e-05,1.0
40840,체육복/Noun,1,1,0,1.1115310228308472e-05,0.0,1.0
40841,)!!/Punctuation,1,1,0,1.1115310228308472e-05,0.0,1.0
40842,Steep/Alpha,1,1,0,1.1115310228308472e-05,0.0,1.0
40843,Meryl/Alpha,1,1,0,1.1115310228308472e-05,0.0,1.0
40844,응보/Noun,1,0,1,0.0,1.1106915165381966e-05,1.0
40845,loved/Alpha,1,1,0,1.1115310228308472e-05,0.0,1.0
40846,흉악하다/Adjective,1,1,0,1.1115310228308472e-05,0.0,1.0
40847,senyora/Alpha,1,0,1,0.0,1.1106915165381966e-05,1.0
40848,senora/Alpha,1,0,1,0.0,1.1106915165381966e-05,1.0
40849,박신우/Noun,1,1,0,1.1115310228308472e-05,0.0,1.0
40850,아마게돈/Noun,1,1,0,1.1115310228308472e-05,0.0,1.0
40851,SOLO/Alpha,1,1,0,1.1115310228308472e-05,0.0,1.0
40852,--./Punctuation,1,1,0,1.1115310228308472e-05,0.0,1.0
40853,투우사/Noun,1,1,0,1.1115310228308472e-05,0.0,1.0
40854,정성룡/Noun,1,0,1,0.0,1.1106915165381966e-05,1.0
40855,땔래/Noun,1,1,0,1.1115310228308472e-05,0.0,1.0
40856,버르장머리/Noun,1,0,1,0.0,1.1106915165381966e-05,1.0
40857,플랜카드/Noun,1,0,1,0.0,1.1106915165381966e-05,1.0
40858,짜쯩나/Noun,1,0,1,0.0,1.1106915165381966e-05,1.0
40859,온종일/Noun,1,0,1,0.0,1.1106915165381966e-05,1.0
40860,짤릴때/Noun,1,1,0,1.1115310228308472e-05,0.0,1.0
40861,임펙트있/Noun,1,1,0,1.1115310228308472e-05,0.0,1.0
40862,108만/Number,1,0,1,0.0,1.1106915165381966e-05,1.0
40863,Tangent/Alpha,1,0,1,0.0,1.1106915165381966e-05,1.0
40864,Primary/Alpha,1,0,1,0.0,1.1106915165381966e-05,1.0
40865,유장/Noun,1,0,1,0.0,1.1106915165381966e-05,1.0
40866,빰빰/Noun,1,1,0,1.1115310228308472e-05,0.0,1.0
40867,셔플/Noun,1,1,0,1.1115310228308472e-05,0.0,1.0
40868,베암/Noun,1,1,0,1.1115310228308472e-05,0.0,1.0
40869,혁필/Noun,1,0,1,0.0,1.1106915165381966e-05,1.0
40870,다래/Noun,1,0,1,0.0,1.1106915165381966e-05,1.0
40871,때놈/Noun,1,0,1,0.0,1.1106915165381966e-05,1.0
40872,꼬아놓은/Noun,1,0,1,0.0,1.1106915165381966e-05,1.0
40873,말입니댜/Noun,1,0,1,0.0,1.1106915165381966e-05,1.0
40874,성항/Noun,1,0,1,0.0,1.1106915165381966e-05,1.0
40875,나오넥/Noun,1,0,1,0.0,1.1106915165381966e-05,1.0
40876,썸뭐/Noun,1,1,0,1.1115310228308472e-05,0.0,1.0
40877,메슥꺼림/Noun,1,0,1,0.0,1.1106915165381966e-05,1.0
40878,피피티/Noun,1,0,1,0.0,1.1106915165381966e-05,1.0
40879,WILL/Alpha,1,1,0,1.1115310228308472e-05,0.0,1.0
40880,HEADS/Alpha,1,1,0,1.1115310228308472e-05,0.0,1.0
40881,gggfdgfgfdggdgfdgfdg/Alpha,1,0,1,0.0,1.1106915165381966e-05,1.0
40882,these/Alpha,1,1,0,1.1115310228308472e-05,0.0,1.0
40883,찾는다고/Foreign,1,0,1,0.0,1.1106915165381966e-05,1.0
40884,깻다/Noun,1,0,1,0.0,1.1106915165381966e-05,1.0
40885,스패니쉬/Noun,1,0,1,0.0,1.1106915165381966e-05,1.0
40886,타나토스/Noun,1,0,1,0.0,1.1106915165381966e-05,1.0
40887,구자체/Noun,1,0,1,0.0,1.1106915165381966e-05,1.0
40888,TB/Alpha,1,0,1,0.0,1.1106915165381966e-05,1.0
40889,점줄랫는데/Noun,1,1,0,1.1115310228308472e-05,0.0,1.0
40890,미화쩌/Noun,1,0,1,0.0,1.1106915165381966e-05,1.0
40891,???!!/Punctuation,1,1,0,1.1115310228308472e-05,0.0,1.0
40892,ㅁㅃㅃ/KoreanParticle,1,0,1,0.0,1.1106915165381966e-05,1.0
40893,뇌쇄미/Noun,1,0,1,0.0,1.1106915165381966e-05,1.0
40894,쇼군/Noun,1,1,0,1.1115310228308472e-05,0.0,1.0
40895,도쿠가/Noun,1,1,0,1.1115310228308472e-05,0.0,1.0
40896,사쓰마/Noun,1,1,0,1.1115310228308472e-05,0.0,1.0
40897,죠슈/Noun,1,1,0,1.1115310228308472e-05,0.0,1.0
40898,DoA/Alpha,1,0,1,0.0,1.1106915165381966e-05,1.0
40899,다펑/Noun,1,1,0,1.1115310228308472e-05,0.0,1.0
40900,슬레이트/Noun,1,0,1,0.0,1.1106915165381966e-05,1.0
40901,깝다/Noun,1,0,1,0.0,1.1106915165381966e-05,1.0
40902,?!?!!?!!/Punctuation,1,1,0,1.1115310228308472e-05,0.0,1.0
40903,?!?!?!!/Punctuation,1,1,0,1.1115310228308472e-05,0.0,1.0
40904,태영/Noun,1,1,0,1.1115310228308472e-05,0.0,1.0
40905,방칼/Noun,1,0,1,0.0,1.1106915165381966e-05,1.0
40906,델다/Noun,1,0,1,0.0,1.1106915165381966e-05,1.0
40907,마구간/Noun,1,1,0,1.1115310228308472e-05,0.0,1.0
40908,-_;/Punctuation,1,1,0,1.1115310228308472e-05,0.0,1.0
40909,직복/Noun,1,0,1,0.0,1.1106915165381966e-05,1.0
40910,어카/Noun,1,0,1,0.0,1.1106915165381966e-05,1.0
40911,독교/Noun,1,0,1,0.0,1.1106915165381966e-05,1.0
40912,치란/Noun,1,1,0,1.1115310228308472e-05,0.0,1.0
40913,웁/Noun,1,0,1,0.0,1.1106915165381966e-05,1.0
40914,난널/Noun,1,1,0,1.1115310228308472e-05,0.0,1.0
40915,종횡무진/Noun,1,1,0,1.1115310228308472e-05,0.0,1.0
40916,♥♥♥♥♥♥♥♥♥♥♥♥♥♥/Foreign,1,1,0,1.1115310228308472e-05,0.0,1.0
40917,쒸레귀/Noun,1,0,1,0.0,1.1106915165381966e-05,1.0
40918,무술씬/Noun,1,0,1,0.0,1.1106915165381966e-05,1.0
40919,헛쳐먹/Noun,1,0,1,0.0,1.1106915165381966e-05,1.0
40920,감및/Noun,1,0,1,0.0,1.1106915165381966e-05,1.0
40921,상두/Noun,1,1,0,1.1115310228308472e-05,0.0,1.0
40922,타코야키/Noun,1,0,1,0.0,1.1106915165381966e-05,1.0
40923,~~~~~~~~~~~!/Punctuation,1,1,0,1.1115310228308472e-05,0.0,1.0
40924,사창/Noun,1,0,1,0.0,1.1106915165381966e-05,1.0
40925,~~?/Punctuation,1,1,0,1.1115310228308472e-05,0.0,1.0
40926,상추/Noun,1,0,1,0.0,1.1106915165381966e-05,1.0
40927,이사고/Noun,1,0,1,0.0,1.1106915165381966e-05,1.0
40928,동완/Noun,1,1,0,1.1115310228308472e-05,0.0,1.0
40929,!!@#!$!%!@!/Punctuation,1,0,1,0.0,1.1106915165381966e-05,1.0
40930,석탄/Noun,1,0,1,0.0,1.1106915165381966e-05,1.0
40931,나신/Noun,1,0,1,0.0,1.1106915165381966e-05,1.0
40932,따닥/Noun,1,0,1,0.0,1.1106915165381966e-05,1.0
40933,경동맥/Noun,1,0,1,0.0,1.1106915165381966e-05,1.0
40934,ziru/Alpha,1,0,1,0.0,1.1106915165381966e-05,1.0
40935,관가/Noun,1,0,1,0.0,1.1106915165381966e-05,1.0
40936,옘/Noun,1,1,0,1.1115310228308472e-05,0.0,1.0
40937,그샛키/Noun,1,0,1,0.0,1.1106915165381966e-05,1.0
40938,76/Number,1,0,1,0.0,1.1106915165381966e-05,1.0
40939,계산법/Noun,1,1,0,1.1115310228308472e-05,0.0,1.0
40940,느글거림/Noun,1,0,1,0.0,1.1106915165381966e-05,1.0
40941,"!!"",/Punctuation",1,0,1,0.0,1.1106915165381966e-05,1.0
40942,죄란/Noun,1,0,1,0.0,1.1106915165381966e-05,1.0
40943,박소연/Noun,1,1,0,1.1115310228308472e-05,0.0,1.0
40944,사우디/Noun,1,0,1,0.0,1.1106915165381966e-05,1.0
40945,개스뤠기/Noun,1,0,1,0.0,1.1106915165381966e-05,1.0
40946,대광고/Noun,1,1,0,1.1115310228308472e-05,0.0,1.0
40947,김상진/Noun,1,1,0,1.1115310228308472e-05,0.0,1.0
40948,김태정/Noun,1,1,0,1.1115310228308472e-05,0.0,1.0
40949,원더/Noun,1,0,1,0.0,1.1106915165381966e-05,1.0
40950,인간문화재/Noun,1,1,0,1.1115310228308472e-05,0.0,1.0
40951,즈윅/Noun,1,1,0,1.1115310228308472e-05,0.0,1.0
40952,idm/Alpha,1,1,0,1.1115310228308472e-05,0.0,1.0
40953,드삼/Noun,1,0,1,0.0,1.1106915165381966e-05,1.0
40954,있넹/Noun,1,0,1,0.0,1.1106915165381966e-05,1.0
40955,lastmanstanding/Alpha,1,0,1,0.0,1.1106915165381966e-05,1.0
40956,Bruce/Alpha,1,0,1,0.0,1.1106915165381966e-05,1.0
40957,세카츄/Noun,1,0,1,0.0,1.1106915165381966e-05,1.0
40958,!.'/Punctuation,1,0,1,0.0,1.1106915165381966e-05,1.0
40959,작일줄은/Foreign,1,1,0,1.1115310228308472e-05,0.0,1.0
40960,아이린/Noun,1,1,0,1.1115310228308472e-05,0.0,1.0
40961,박기준/Noun,1,1,0,1.1115310228308472e-05,0.0,1.0
40962,210/Number,1,1,0,1.1115310228308472e-05,0.0,1.0
40963,망사/Noun,1,1,0,1.1115310228308472e-05,0.0,1.0
40964,껀디/Noun,1,1,0,1.1115310228308472e-05,0.0,1.0
40965,쪼리/Noun,1,1,0,1.1115310228308472e-05,0.0,1.0
40966,사생팬/Noun,1,1,0,1.1115310228308472e-05,0.0,1.0
40967,투덜거리다/Verb,1,0,1,0.0,1.1106915165381966e-05,1.0
40968,볼껄그/Noun,1,1,0,1.1115310228308472e-05,0.0,1.0
40969,례/Noun,1,1,0,1.1115310228308472e-05,0.0,1.0
40970,랄깤/Noun,1,1,0,1.1115310228308472e-05,0.0,1.0
40971,임상옥/Noun,1,1,0,1.1115310228308472e-05,0.0,1.0
40972,오른발/Noun,1,0,1,0.0,1.1106915165381966e-05,1.0
40973,긱스/Noun,1,0,1,0.0,1.1106915165381966e-05,1.0
40974,stf/Alpha,1,1,0,1.1115310228308472e-05,0.0,1.0
40975,고라파덕/Noun,1,0,1,0.0,1.1106915165381966e-05,1.0
40976,코다케/Noun,1,1,0,1.1115310228308472e-05,0.0,1.0
40977,무쟈게잼남/Noun,1,1,0,1.1115310228308472e-05,0.0,1.0
40978,딥빡/Noun,1,0,1,0.0,1.1106915165381966e-05,1.0
40979,연감/Noun,1,0,1,0.0,1.1106915165381966e-05,1.0
40980,빠즈/Noun,1,1,0,1.1115310228308472e-05,0.0,1.0
40981,의군/Noun,1,1,0,1.1115310228308472e-05,0.0,1.0
40982,강비/Noun,1,0,1,0.0,1.1106915165381966e-05,1.0
40983,착착하다/Adjective,1,1,0,1.1115310228308472e-05,0.0,1.0
40984,ㅆㅅ/KoreanParticle,1,0,1,0.0,1.1106915165381966e-05,1.0
40985,코오롱/Noun,1,0,1,0.0,1.1106915165381966e-05,1.0
40986,딘케/Noun,1,1,0,1.1115310228308472e-05,0.0,1.0
40987,뭍혔다/Noun,1,1,0,1.1115310228308472e-05,0.0,1.0
40988,복슴때/Noun,1,1,0,1.1115310228308472e-05,0.0,1.0
40989,에수입하는지/Foreign,1,0,1,0.0,1.1106915165381966e-05,1.0
40990,죄수복/Noun,1,0,1,0.0,1.1106915165381966e-05,1.0
40991,명았작/Noun,1,0,1,0.0,1.1106915165381966e-05,1.0
40992,",,=/Punctuation",1,0,1,0.0,1.1106915165381966e-05,1.0
40993,느글느글/Adverb,1,0,1,0.0,1.1106915165381966e-05,1.0
40994,박봄이/Noun,1,0,1,0.0,1.1106915165381966e-05,1.0
40995,3.83/Number,1,1,0,1.1115310228308472e-05,0.0,1.0
40996,전이네/Foreign,1,1,0,1.1115310228308472e-05,0.0,1.0
40997,퉤잇/Noun,1,0,1,0.0,1.1106915165381966e-05,1.0
40998,쥐락펴락했던/Noun,1,1,0,1.1115310228308472e-05,0.0,1.0
40999,둥가둥/Noun,1,0,1,0.0,1.1106915165381966e-05,1.0
41000,휴거/Noun,1,1,0,1.1115310228308472e-05,0.0,1.0
41001,김주호/Noun,1,1,0,1.1115310228308472e-05,0.0,1.0
41002,행랑/Noun,1,0,1,0.0,1.1106915165381966e-05,1.0
41003,뎅굿굿/Noun,1,1,0,1.1115310228308472e-05,0.0,1.0
41004,밌슴/Noun,1,1,0,1.1115310228308472e-05,0.0,1.0
41005,앖음/Noun,1,0,1,0.0,1.1106915165381966e-05,1.0
41006,야마토/Noun,1,0,1,0.0,1.1106915165381966e-05,1.0
41007,스칸/Noun,1,0,1,0.0,1.1106915165381966e-05,1.0
41008,탈레스/Noun,1,0,1,0.0,1.1106915165381966e-05,1.0
41009,대기오염/Noun,1,0,1,0.0,1.1106915165381966e-05,1.0
41010,지하도/Noun,1,0,1,0.0,1.1106915165381966e-05,1.0
41011,습기/Noun,1,1,0,1.1115310228308472e-05,0.0,1.0
41012,뭘또/Noun,1,1,0,1.1115310228308472e-05,0.0,1.0
41013,구모/Noun,1,1,0,1.1115310228308472e-05,0.0,1.0
41014,BIGFOOT/Alpha,1,0,1,0.0,1.1106915165381966e-05,1.0
41015,무너뜨릴/Noun,1,1,0,1.1115310228308472e-05,0.0,1.0
41016,과학의날/Noun,1,1,0,1.1115310228308472e-05,0.0,1.0
41017,빌라도/Noun,1,1,0,1.1115310228308472e-05,0.0,1.0
41018,취양/Noun,1,0,1,0.0,1.1106915165381966e-05,1.0
41019,꼴갑/Noun,1,0,1,0.0,1.1106915165381966e-05,1.0
41020,게리모드/Noun,1,0,1,0.0,1.1106915165381966e-05,1.0
41021,도작임을/Foreign,1,1,0,1.1115310228308472e-05,0.0,1.0
41022,김일성화/Noun,1,1,0,1.1115310228308472e-05,0.0,1.0
41023,저뇽/Noun,1,0,1,0.0,1.1106915165381966e-05,1.0
41024,문선명/Noun,1,0,1,0.0,1.1106915165381966e-05,1.0
41025,통일교/Noun,1,0,1,0.0,1.1106915165381966e-05,1.0
41026,에일/Noun,1,0,1,0.0,1.1106915165381966e-05,1.0
41027,김희로/Noun,1,1,0,1.1115310228308472e-05,0.0,1.0
41028,필홍/Noun,1,1,0,1.1115310228308472e-05,0.0,1.0
41029,ㄹㅁ/KoreanParticle,1,0,1,0.0,1.1106915165381966e-05,1.0
41030,~!~!~/Punctuation,1,1,0,1.1115310228308472e-05,0.0,1.0
41031,2-3일/Number,1,1,0,1.1115310228308472e-05,0.0,1.0
41032,우오오/Exclamation,1,1,0,1.1115310228308472e-05,0.0,1.0
41033,점쥼/Noun,1,0,1,0.0,1.1106915165381966e-05,1.0
41034,느김이/Noun,1,1,0,1.1115310228308472e-05,0.0,1.0
41035,장온/Noun,1,1,0,1.1115310228308472e-05,0.0,1.0
41036,보는쥴/Noun,1,0,1,0.0,1.1106915165381966e-05,1.0
41037,===/Punctuation,1,1,0,1.1115310228308472e-05,0.0,1.0
41038,★★★÷÷÷/Foreign,1,1,0,1.1115310228308472e-05,0.0,1.0
41039,^^^^%%%/Punctuation,1,1,0,1.1115310228308472e-05,0.0,1.0
41040,윤혜/Noun,1,0,1,0.0,1.1106915165381966e-05,1.0
41041,청원/Noun,1,0,1,0.0,1.1106915165381966e-05,1.0
41042,개평/Noun,1,1,0,1.1115310228308472e-05,0.0,1.0
41043,윤정우/Noun,1,0,1,0.0,1.1106915165381966e-05,1.0
41044,FTISLAND/Alpha,1,1,0,1.1115310228308472e-05,0.0,1.0
41045,라비올리/Noun,1,1,0,1.1115310228308472e-05,0.0,1.0
41046,바이런/Noun,1,1,0,1.1115310228308472e-05,0.0,1.0
41047,잔뜩뀌/Noun,1,0,1,0.0,1.1106915165381966e-05,1.0
41048,방귀만/Noun,1,0,1,0.0,1.1106915165381966e-05,1.0
41049,흐릿하/Noun,1,0,1,0.0,1.1106915165381966e-05,1.0
41050,난독증/Noun,1,0,1,0.0,1.1106915165381966e-05,1.0
41051,풀륜업/Noun,1,0,1,0.0,1.1106915165381966e-05,1.0
41052,헤드폰/Noun,1,0,1,0.0,1.1106915165381966e-05,1.0
41053,김도균/Noun,1,1,0,1.1115310228308472e-05,0.0,1.0
41054,발연/Noun,1,0,1,0.0,1.1106915165381966e-05,1.0
41055,더울버린/Noun,1,0,1,0.0,1.1106915165381966e-05,1.0
41056,안줄탠데/Noun,1,0,1,0.0,1.1106915165381966e-05,1.0
41057,어캐할거임/Noun,1,0,1,0.0,1.1106915165381966e-05,1.0
41058,8000천원/Number,1,0,1,0.0,1.1106915165381966e-05,1.0
41059,걸인/Noun,1,0,1,0.0,1.1106915165381966e-05,1.0
41060,3.2%/Number,1,0,1,0.0,1.1106915165381966e-05,1.0
41061,알선/Noun,1,0,1,0.0,1.1106915165381966e-05,1.0
41062,앙코르와트/Noun,1,1,0,1.1115310228308472e-05,0.0,1.0
41063,.http://www.hsep.com/Board/NoticeDetail.aspx?BoardType=2&BoardId=50&no=3/URL,1,0,1,0.0,1.1106915165381966e-05,1.0
41064,url/Alpha,1,0,1,0.0,1.1106915165381966e-05,1.0
41065,원산지/Noun,1,0,1,0.0,1.1106915165381966e-05,1.0
41066,가공품/Noun,1,0,1,0.0,1.1106915165381966e-05,1.0
41067,어육/Noun,1,0,1,0.0,1.1106915165381966e-05,1.0
41068,게재/Noun,1,0,1,0.0,1.1106915165381966e-05,1.0
41069,9/17일/Number,1,0,1,0.0,1.1106915165381966e-05,1.0
41070,한성기업/Noun,1,0,1,0.0,1.1106915165381966e-05,1.0
41071,![/Punctuation,1,0,1,0.0,1.1106915165381966e-05,1.0
41072,한성은/Noun,1,0,1,0.0,1.1106915165381966e-05,1.0
41073,깜딱/Noun,1,1,0,1.1115310228308472e-05,0.0,1.0
41074,잘버무러/Noun,1,1,0,1.1115310228308472e-05,0.0,1.0
41075,유태계/Noun,1,1,0,1.1115310228308472e-05,0.0,1.0
41076,끝낼떄/Noun,1,0,1,0.0,1.1106915165381966e-05,1.0
41077,아쉬웁/Noun,1,0,1,0.0,1.1106915165381966e-05,1.0
41078,사모곡/Noun,1,0,1,0.0,1.1106915165381966e-05,1.0
41079,노심/Noun,1,0,1,0.0,1.1106915165381966e-05,1.0
41080,+_=/Punctuation,1,0,1,0.0,1.1106915165381966e-05,1.0
41081,펑소/Noun,1,0,1,0.0,1.1106915165381966e-05,1.0
41082,응칠/Noun,1,0,1,0.0,1.1106915165381966e-05,1.0
41083,주요한/Noun,1,0,1,0.0,1.1106915165381966e-05,1.0
41084,김정균/Noun,1,1,0,1.1115310228308472e-05,0.0,1.0
41085,진웅/Noun,1,1,0,1.1115310228308472e-05,0.0,1.0
41086,~^&/Punctuation,1,1,0,1.1115310228308472e-05,0.0,1.0
41087,우대신/Noun,1,0,1,0.0,1.1106915165381966e-05,1.0
41088,훨잼잇다/Noun,1,0,1,0.0,1.1106915165381966e-05,1.0
41089,단풍/Noun,1,1,0,1.1115310228308472e-05,0.0,1.0
41090,뉴잉글랜드/Noun,1,1,0,1.1115310228308472e-05,0.0,1.0
41091,덩쿨/Noun,1,1,0,1.1115310228308472e-05,0.0,1.0
41092,내껀/Noun,1,0,1,0.0,1.1106915165381966e-05,1.0
41093,손칼/Noun,1,1,0,1.1115310228308472e-05,0.0,1.0
41094,멕스폐인/Noun,1,0,1,0.0,1.1106915165381966e-05,1.0
41095,나왓습니/Noun,1,0,1,0.0,1.1106915165381966e-05,1.0
41096,혐덕들/Noun,1,1,0,1.1115310228308472e-05,0.0,1.0
41097,혐덕/Noun,1,1,0,1.1115310228308472e-05,0.0,1.0
41098,도시정벌/Noun,1,1,0,1.1115310228308472e-05,0.0,1.0
41099,월맹군/Noun,1,1,0,1.1115310228308472e-05,0.0,1.0
41100,도프/Noun,1,1,0,1.1115310228308472e-05,0.0,1.0
41101,스서방/Noun,1,1,0,1.1115310228308472e-05,0.0,1.0
41102,TRUE/Alpha,1,0,1,0.0,1.1106915165381966e-05,1.0
41103,COME/Alpha,1,0,1,0.0,1.1106915165381966e-05,1.0
41104,DREAMS/Alpha,1,0,1,0.0,1.1106915165381966e-05,1.0
41105,지엇/Noun,1,0,1,0.0,1.1106915165381966e-05,1.0
41106,졓/Noun,1,1,0,1.1115310228308472e-05,0.0,1.0
41107,실랑이/Noun,1,0,1,0.0,1.1106915165381966e-05,1.0
41108,어거스터스/Noun,1,1,0,1.1115310228308472e-05,0.0,1.0
41109,디자인상/Noun,1,1,0,1.1115310228308472e-05,0.0,1.0
41110,미술상/Noun,1,1,0,1.1115310228308472e-05,0.0,1.0
41111,OFF/Alpha,1,0,1,0.0,1.1106915165381966e-05,1.0
41112,깜짝등장/Noun,1,0,1,0.0,1.1106915165381966e-05,1.0
41113,내내아무것도안나오고/Foreign,1,0,1,0.0,1.1106915165381966e-05,1.0
41114,침략전쟁/Noun,1,0,1,0.0,1.1106915165381966e-05,1.0
41115,일감/Noun,1,1,0,1.1115310228308472e-05,0.0,1.0
41116,값좀/Noun,1,0,1,0.0,1.1106915165381966e-05,1.0
41117,나훈아/Noun,1,1,0,1.1115310228308472e-05,0.0,1.0
41118,너훈아/Noun,1,1,0,1.1115310228308472e-05,0.0,1.0
41119,개량/Noun,1,1,0,1.1115310228308472e-05,0.0,1.0
41120,노건평/Noun,1,0,1,0.0,1.1106915165381966e-05,1.0
41121,난하/Noun,1,1,0,1.1115310228308472e-05,0.0,1.0
41122,사막씬/Noun,1,0,1,0.0,1.1106915165381966e-05,1.0
41123,핵탄두/Noun,1,1,0,1.1115310228308472e-05,0.0,1.0
41124,뎀쉣/Noun,1,0,1,0.0,1.1106915165381966e-05,1.0
41125,좀햇/Noun,1,0,1,0.0,1.1106915165381966e-05,1.0
41126,Reilly/Alpha,1,0,1,0.0,1.1106915165381966e-05,1.0
41127,David/Alpha,1,0,1,0.0,1.1106915165381966e-05,1.0
41128,Possession/Alpha,1,0,1,0.0,1.1106915165381966e-05,1.0
41129,영화특급/Noun,1,1,0,1.1115310228308472e-05,0.0,1.0
41130,꺠우침을주/Noun,1,1,0,1.1115310228308472e-05,0.0,1.0
41131,볼륜인것/Noun,1,1,0,1.1115310228308472e-05,0.0,1.0
41132,Holy/Alpha,1,0,1,0.0,1.1106915165381966e-05,1.0
41133,wasting/Alpha,1,0,1,0.0,1.1106915165381966e-05,1.0
41134,extincted/Alpha,1,0,1,0.0,1.1106915165381966e-05,1.0
41135,needs/Alpha,1,0,1,0.0,1.1106915165381966e-05,1.0
41136,director/Alpha,1,0,1,0.0,1.1106915165381966e-05,1.0
41137,앰프/Noun,1,1,0,1.1115310228308472e-05,0.0,1.0
41138,-_-......./Punctuation,1,0,1,0.0,1.1106915165381966e-05,1.0
41139,오죽힌/Noun,1,0,1,0.0,1.1106915165381966e-05,1.0
41140,족도/Noun,1,0,1,0.0,1.1106915165381966e-05,1.0
41141,정통하다/Adjective,1,0,1,0.0,1.1106915165381966e-05,1.0
41142,안으로다봄처음부터재미없음/Foreign,1,0,1,0.0,1.1106915165381966e-05,1.0
41143,모노/Noun,1,1,0,1.1115310228308472e-05,0.0,1.0
41144,효우/Noun,1,1,0,1.1115310228308472e-05,0.0,1.0
41145,직수출/Noun,1,0,1,0.0,1.1106915165381966e-05,1.0
41146,왜이렇케/Noun,1,0,1,0.0,1.1106915165381966e-05,1.0
41147,의꿈/Noun,1,1,0,1.1115310228308472e-05,0.0,1.0
41148,중국군/Noun,1,0,1,0.0,1.1106915165381966e-05,1.0
41149,어쨰/Noun,1,0,1,0.0,1.1106915165381966e-05,1.0
41150,올려놧/Noun,1,0,1,0.0,1.1106915165381966e-05,1.0
41151,..!~~~!!!~~~~/Punctuation,1,1,0,1.1115310228308472e-05,0.0,1.0
41152,멌있다/Noun,1,1,0,1.1115310228308472e-05,0.0,1.0
41153,싼마이/Noun,1,0,1,0.0,1.1106915165381966e-05,1.0
41154,빅장씬/Noun,1,0,1,0.0,1.1106915165381966e-05,1.0
41155,물탱크/Noun,1,0,1,0.0,1.1106915165381966e-05,1.0
41156,비엔나/Noun,1,1,0,1.1115310228308472e-05,0.0,1.0
41157,방화벽/Noun,1,0,1,0.0,1.1106915165381966e-05,1.0
41158,닉임/Noun,1,0,1,0.0,1.1106915165381966e-05,1.0
41159,방방/Adverb,1,0,1,0.0,1.1106915165381966e-05,1.0
41160,7~8분/Number,1,0,1,0.0,1.1106915165381966e-05,1.0
41161,남겨둘껄/Noun,1,0,1,0.0,1.1106915165381966e-05,1.0
41162,베린/Noun,1,1,0,1.1115310228308472e-05,0.0,1.0
41163,망설힘/Noun,1,1,0,1.1115310228308472e-05,0.0,1.0
41164,핫핫핫/Noun,1,0,1,0.0,1.1106915165381966e-05,1.0
41165,다현/Noun,1,1,0,1.1115310228308472e-05,0.0,1.0
41166,"..,....,../Punctuation",1,0,1,0.0,1.1106915165381966e-05,1.0
41167,광관/Noun,1,0,1,0.0,1.1106915165381966e-05,1.0
41168,죽엇을까/Noun,1,0,1,0.0,1.1106915165381966e-05,1.0
41169,직막/Noun,1,0,1,0.0,1.1106915165381966e-05,1.0
41170,콮/Noun,1,1,0,1.1115310228308472e-05,0.0,1.0
41171,아울리다/Verb,1,1,0,1.1115310228308472e-05,0.0,1.0
41172,깝깝함/Noun,1,0,1,0.0,1.1106915165381966e-05,1.0
41173,벌스/Noun,1,0,1,0.0,1.1106915165381966e-05,1.0
41174,벚나무/Noun,1,1,0,1.1115310228308472e-05,0.0,1.0
41175,술법/Noun,1,0,1,0.0,1.1106915165381966e-05,1.0
41176,★●♥/Foreign,1,1,0,1.1115310228308472e-05,0.0,1.0
41177,물좀/Noun,1,1,0,1.1115310228308472e-05,0.0,1.0
41178,콩고기/Noun,1,1,0,1.1115310228308472e-05,0.0,1.0
41179,글루텐/Noun,1,1,0,1.1115310228308472e-05,0.0,1.0
41180,육류/Noun,1,1,0,1.1115310228308472e-05,0.0,1.0
41181,도썅/Noun,1,0,1,0.0,1.1106915165381966e-05,1.0
41182,들썩/Adverb,1,1,0,1.1115310228308472e-05,0.0,1.0
41183,전횡/Noun,1,0,1,0.0,1.1106915165381966e-05,1.0
41184,정치철학/Noun,1,0,1,0.0,1.1106915165381966e-05,1.0
41185,배틀크루저/Noun,1,0,1,0.0,1.1106915165381966e-05,1.0
41186,같아욘/Noun,1,1,0,1.1115310228308472e-05,0.0,1.0
41187,제럴딘/Noun,1,0,1,0.0,1.1106915165381966e-05,1.0
41188,얼꽝/Noun,1,0,1,0.0,1.1106915165381966e-05,1.0
41189,티격태격해/Noun,1,1,0,1.1115310228308472e-05,0.0,1.0
41190,머싰어용/Noun,1,1,0,1.1115310228308472e-05,0.0,1.0
41191,건전성/Noun,1,0,1,0.0,1.1106915165381966e-05,1.0
41192,운반자/Noun,1,1,0,1.1115310228308472e-05,0.0,1.0
41193,물상/Noun,1,1,0,1.1115310228308472e-05,0.0,1.0
41194,빈방/Noun,1,1,0,1.1115310228308472e-05,0.0,1.0
41195,로민/Noun,1,0,1,0.0,1.1106915165381966e-05,1.0
41196,어올림/Noun,1,1,0,1.1115310228308472e-05,0.0,1.0
41197,투모로/Noun,1,0,1,0.0,1.1106915165381966e-05,1.0
41198,돈존/Noun,1,0,1,0.0,1.1106915165381966e-05,1.0
41199,엉클다/Verb,1,1,0,1.1115310228308472e-05,0.0,1.0
41200,초로/Noun,1,1,0,1.1115310228308472e-05,0.0,1.0
41201,경수진/Noun,1,1,0,1.1115310228308472e-05,0.0,1.0
41202,명농/Noun,1,1,0,1.1115310228308472e-05,0.0,1.0
41203,간곡/Noun,1,0,1,0.0,1.1106915165381966e-05,1.0
41204,흥동/Noun,1,0,1,0.0,1.1106915165381966e-05,1.0
41205,오늘내일/Noun,1,1,0,1.1115310228308472e-05,0.0,1.0
41206,레드드래곤/Noun,1,0,1,0.0,1.1106915165381966e-05,1.0
41207,신세기/Noun,1,1,0,1.1115310228308472e-05,0.0,1.0
41208,☆★/Foreign,1,1,0,1.1115310228308472e-05,0.0,1.0
41209,막중/Noun,1,1,0,1.1115310228308472e-05,0.0,1.0
41210,ㅏㄹ/KoreanParticle,1,0,1,0.0,1.1106915165381966e-05,1.0
41211,쳥룡/Noun,1,1,0,1.1115310228308472e-05,0.0,1.0
41212,안때/Noun,1,0,1,0.0,1.1106915165381966e-05,1.0
41213,뭐말입/Noun,1,0,1,0.0,1.1106915165381966e-05,1.0
41214,20~30년/Number,1,0,1,0.0,1.1106915165381966e-05,1.0
41215,걸륜팬/Noun,1,0,1,0.0,1.1106915165381966e-05,1.0
41216,코봉/Noun,1,0,1,0.0,1.1106915165381966e-05,1.0
41217,비올라/Noun,1,1,0,1.1115310228308472e-05,0.0,1.0
41218,기말고사/Noun,1,1,0,1.1115310228308472e-05,0.0,1.0
41219,듀우윙/Noun,1,1,0,1.1115310228308472e-05,0.0,1.0
41220,룯데베뱌/Noun,1,1,0,1.1115310228308472e-05,0.0,1.0
41221,뉴유/Noun,1,1,0,1.1115310228308472e-05,0.0,1.0
41222,정영숙/Noun,1,1,0,1.1115310228308472e-05,0.0,1.0
41223,면사무소/Noun,1,0,1,0.0,1.1106915165381966e-05,1.0
41224,결함/Noun,1,0,1,0.0,1.1106915165381966e-05,1.0
41225,!~~~~~~~~~/Punctuation,1,0,1,0.0,1.1106915165381966e-05,1.0
41226,!^^;/Punctuation,1,0,1,0.0,1.1106915165381966e-05,1.0
41227,@@!/Punctuation,1,0,1,0.0,1.1106915165381966e-05,1.0
41228,외놈/Noun,1,0,1,0.0,1.1106915165381966e-05,1.0
41229,떠듬/Adverb,1,0,1,0.0,1.1106915165381966e-05,1.0
41230,부엉부엉/Noun,1,0,1,0.0,1.1106915165381966e-05,1.0
41231,재배/Noun,1,1,0,1.1115310228308472e-05,0.0,1.0
41232,벨제바브/Noun,1,1,0,1.1115310228308472e-05,0.0,1.0
41233,안티팬/Noun,1,0,1,0.0,1.1106915165381966e-05,1.0
41234,장오/Noun,1,1,0,1.1115310228308472e-05,0.0,1.0
41235,도빠짐없이긴장감놓치지않고보게되고각인물들의사연이현실처럼와닿네요/Foreign,1,1,0,1.1115310228308472e-05,0.0,1.0
41236,Threggy/Alpha,1,0,1,0.0,1.1106915165381966e-05,1.0
41237,Sheep/Alpha,1,0,1,0.0,1.1106915165381966e-05,1.0
41238,만든겅/Noun,1,0,1,0.0,1.1106915165381966e-05,1.0
41239,애더/Noun,1,0,1,0.0,1.1106915165381966e-05,1.0
41240,입센/Noun,1,0,1,0.0,1.1106915165381966e-05,1.0
41241,바라봄/Noun,1,1,0,1.1115310228308472e-05,0.0,1.0
41242,모르고스/Noun,1,1,0,1.1115310228308472e-05,0.0,1.0
41243,..>.</Punctuation,1,1,0,1.1115310228308472e-05,0.0,1.0
41244,어쩌겠다/Noun,1,0,1,0.0,1.1106915165381966e-05,1.0
41245,한대수/Noun,1,1,0,1.1115310228308472e-05,0.0,1.0
41246,",.@;/Punctuation",1,0,1,0.0,1.1106915165381966e-05,1.0
41247,해숙씨/Noun,1,0,1,0.0,1.1106915165381966e-05,1.0
41248,갤러리/Noun,1,1,0,1.1115310228308472e-05,0.0,1.0
41249,Art/Alpha,1,1,0,1.1115310228308472e-05,0.0,1.0
41250,결판/Noun,1,1,0,1.1115310228308472e-05,0.0,1.0
41251,성중독/Noun,1,1,0,1.1115310228308472e-05,0.0,1.0
41252,케타/Noun,1,1,0,1.1115310228308472e-05,0.0,1.0
41253,수댕이/Noun,1,1,0,1.1115310228308472e-05,0.0,1.0
41254,허영심쩌/Noun,1,0,1,0.0,1.1106915165381966e-05,1.0
41255,~^.^/Punctuation,1,1,0,1.1115310228308472e-05,0.0,1.0
41256,황송/Noun,1,1,0,1.1115310228308472e-05,0.0,1.0
41257,도맘/Noun,1,1,0,1.1115310228308472e-05,0.0,1.0
41258,읹줄/Noun,1,1,0,1.1115310228308472e-05,0.0,1.0
41259,핑크팬더/Noun,1,1,0,1.1115310228308472e-05,0.0,1.0
41260,초반영화인줄/Foreign,1,0,1,0.0,1.1106915165381966e-05,1.0
41261,슬임스/Noun,1,1,0,1.1115310228308472e-05,0.0,1.0
41262,슬옹/Noun,1,1,0,1.1115310228308472e-05,0.0,1.0
41263,스롱스롱/Noun,1,1,0,1.1115310228308472e-05,0.0,1.0
41264,폭압적/Noun,1,1,0,1.1115310228308472e-05,0.0,1.0
41265,포럼/Noun,1,1,0,1.1115310228308472e-05,0.0,1.0
41266,원룸/Noun,1,1,0,1.1115310228308472e-05,0.0,1.0
41267,랭크되어/Noun,1,0,1,0.0,1.1106915165381966e-05,1.0
41268,문걸/Noun,1,1,0,1.1115310228308472e-05,0.0,1.0
41269,루게릭/Noun,1,0,1,0.0,1.1106915165381966e-05,1.0
41270,변백현/Noun,1,1,0,1.1115310228308472e-05,0.0,1.0
41271,다죽어썽/Noun,1,0,1,0.0,1.1106915165381966e-05,1.0
41272,강동원왈/Foreign,1,0,1,0.0,1.1106915165381966e-05,1.0
41273,58초/Number,1,0,1,0.0,1.1106915165381966e-05,1.0
41274,59초/Number,1,0,1,0.0,1.1106915165381966e-05,1.0
41275,걸리니까/Foreign,1,0,1,0.0,1.1106915165381966e-05,1.0
41276,불찰/Noun,1,0,1,0.0,1.1106915165381966e-05,1.0
41277,과천/Noun,1,1,0,1.1115310228308472e-05,0.0,1.0
41278,멋저/Noun,1,1,0,1.1115310228308472e-05,0.0,1.0
41279,리드미컬하다/Adjective,1,1,0,1.1115310228308472e-05,0.0,1.0
41280,스즈랑/Noun,1,0,1,0.0,1.1106915165381966e-05,1.0
41281,영란/Noun,1,1,0,1.1115310228308472e-05,0.0,1.0
41282,박종국/Noun,1,1,0,1.1115310228308472e-05,0.0,1.0
41283,주강/Noun,1,1,0,1.1115310228308472e-05,0.0,1.0
41284,김영오/Noun,1,1,0,1.1115310228308472e-05,0.0,1.0
41285,방중술/Noun,1,0,1,0.0,1.1106915165381966e-05,1.0
41286,(....)/Punctuation,1,1,0,1.1115310228308472e-05,0.0,1.0
41287,액스터시/Noun,1,1,0,1.1115310228308472e-05,0.0,1.0
41288,ㅃㅅ/KoreanParticle,1,0,1,0.0,1.1106915165381966e-05,1.0
41289,봉임/Noun,1,1,0,1.1115310228308472e-05,0.0,1.0
41290,루마니아어/Noun,1,1,0,1.1115310228308472e-05,0.0,1.0
41291,영규/Noun,1,1,0,1.1115310228308472e-05,0.0,1.0
41292,초희/Noun,1,1,0,1.1115310228308472e-05,0.0,1.0
41293,칠천원/Noun,1,0,1,0.0,1.1106915165381966e-05,1.0
41294,팝핑/Noun,1,0,1,0.0,1.1106915165381966e-05,1.0
41295,june/Alpha,1,1,0,1.1115310228308472e-05,0.0,1.0
41296,newyork/Alpha,1,1,0,1.1115310228308472e-05,0.0,1.0
41297,忍/Foreign,1,0,1,0.0,1.1106915165381966e-05,1.0
41298,팽우안/Noun,1,1,0,1.1115310228308472e-05,0.0,1.0
41299,슬푸당/Noun,1,1,0,1.1115310228308472e-05,0.0,1.0
41300,초월체/Noun,1,1,0,1.1115310228308472e-05,0.0,1.0
41301,쉐린이짱/Noun,1,1,0,1.1115310228308472e-05,0.0,1.0
41302,뚱돼/Noun,1,0,1,0.0,1.1106915165381966e-05,1.0
41303,피갑/Noun,1,0,1,0.0,1.1106915165381966e-05,1.0
41304,She/Alpha,1,1,0,1.1115310228308472e-05,0.0,1.0
41305,Costello/Alpha,1,1,0,1.1115310228308472e-05,0.0,1.0
41306,지부/Noun,1,0,1,0.0,1.1106915165381966e-05,1.0
41307,괜츈함/Noun,1,1,0,1.1115310228308472e-05,0.0,1.0
41308,최진영/Noun,1,1,0,1.1115310228308472e-05,0.0,1.0
41309,Cinema/Alpha,1,0,1,0.0,1.1106915165381966e-05,1.0
41310,준뒤/Noun,1,0,1,0.0,1.1106915165381966e-05,1.0
41311,통괘함/Noun,1,1,0,1.1115310228308472e-05,0.0,1.0
41312,초안/Noun,1,1,0,1.1115310228308472e-05,0.0,1.0
41313,5000만/Number,1,1,0,1.1115310228308472e-05,0.0,1.0
41314,봄버/Noun,1,1,0,1.1115310228308472e-05,0.0,1.0
41315,하얼빈/Noun,1,0,1,0.0,1.1106915165381966e-05,1.0
41316,지쟈쓰/Noun,1,0,1,0.0,1.1106915165381966e-05,1.0
41317,~!!../Punctuation,1,1,0,1.1115310228308472e-05,0.0,1.0
41318,17.18/Number,1,0,1,0.0,1.1106915165381966e-05,1.0
41319,카우치/Noun,1,1,0,1.1115310228308472e-05,0.0,1.0
41320,가이무/Noun,1,0,1,0.0,1.1106915165381966e-05,1.0
41321,과학지식/Noun,1,0,1,0.0,1.1106915165381966e-05,1.0
41322,.....!!!!/Punctuation,1,1,0,1.1115310228308472e-05,0.0,1.0
41323,정은표/Noun,1,1,0,1.1115310228308472e-05,0.0,1.0
41324,가슴앓이/Noun,1,1,0,1.1115310228308472e-05,0.0,1.0
41325,ㅆㅍ/KoreanParticle,1,0,1,0.0,1.1106915165381966e-05,1.0
41326,확닥질/Noun,1,0,1,0.0,1.1106915165381966e-05,1.0
41327,!@~~@/Punctuation,1,1,0,1.1115310228308472e-05,0.0,1.0
41328,대군이/Foreign,1,1,0,1.1115310228308472e-05,0.0,1.0
41329,12만/Number,1,1,0,1.1115310228308472e-05,0.0,1.0
41330,파발/Noun,1,1,0,1.1115310228308472e-05,0.0,1.0
41331,물총/Noun,1,0,1,0.0,1.1106915165381966e-05,1.0
41332,어랑/Noun,1,0,1,0.0,1.1106915165381966e-05,1.0
41333,chhy/Alpha,1,1,0,1.1115310228308472e-05,0.0,1.0
41334,BEARS/Alpha,1,1,0,1.1115310228308472e-05,0.0,1.0
41335,CROWN/Alpha,1,1,0,1.1115310228308472e-05,0.0,1.0
41336,WEAR/Alpha,1,1,0,1.1115310228308472e-05,0.0,1.0
41337,WANTS/Alpha,1,1,0,1.1115310228308472e-05,0.0,1.0
41338,ONE/Alpha,1,1,0,1.1115310228308472e-05,0.0,1.0
41339,러닝타임/Foreign,1,0,1,0.0,1.1106915165381966e-05,1.0
41340,NS/Alpha,1,0,1,0.0,1.1106915165381966e-05,1.0
41341,바운더리/Noun,1,0,1,0.0,1.1106915165381966e-05,1.0
41342,비특/Noun,1,0,1,0.0,1.1106915165381966e-05,1.0
41343,쌩뚱마져/Noun,1,0,1,0.0,1.1106915165381966e-05,1.0
41344,책자/Noun,1,0,1,0.0,1.1106915165381966e-05,1.0
41345,있엌/Noun,1,1,0,1.1115310228308472e-05,0.0,1.0
41346,지져스/Noun,1,0,1,0.0,1.1106915165381966e-05,1.0
41347,도판과/Foreign,1,0,1,0.0,1.1106915165381966e-05,1.0
41348,센텀시티/Noun,1,1,0,1.1115310228308472e-05,0.0,1.0
41349,가스렌지/Noun,1,0,1,0.0,1.1106915165381966e-05,1.0
41350,맹드러/Noun,1,0,1,0.0,1.1106915165381966e-05,1.0
41351,화랑/Noun,1,0,1,0.0,1.1106915165381966e-05,1.0
41352,추억쩌/Noun,1,0,1,0.0,1.1106915165381966e-05,1.0
41353,DHR/Alpha,1,0,1,0.0,1.1106915165381966e-05,1.0
41354,백담/Noun,1,1,0,1.1115310228308472e-05,0.0,1.0
41355,노랜좋음/Noun,1,0,1,0.0,1.1106915165381966e-05,1.0
41356,회기/Noun,1,1,0,1.1115310228308472e-05,0.0,1.0
41357,맑시즘/Noun,1,1,0,1.1115310228308472e-05,0.0,1.0
41358,",,;/Punctuation",1,0,1,0.0,1.1106915165381966e-05,1.0
41359,Cliche/Alpha,1,0,1,0.0,1.1106915165381966e-05,1.0
41360,괞찬네/Noun,1,1,0,1.1115310228308472e-05,0.0,1.0
41361,요벽아/Noun,1,1,0,1.1115310228308472e-05,0.0,1.0
41362,소전/Noun,1,1,0,1.1115310228308472e-05,0.0,1.0
41363,국내선/Noun,1,0,1,0.0,1.1106915165381966e-05,1.0
41364,쿠딩/Noun,1,0,1,0.0,1.1106915165381966e-05,1.0
41365,퍼뭐/Noun,1,0,1,0.0,1.1106915165381966e-05,1.0
41366,▷/Foreign,1,0,1,0.0,1.1106915165381966e-05,1.0
41367,쩜쩜쩜/Noun,1,0,1,0.0,1.1106915165381966e-05,1.0
41368,볽덧/Noun,1,1,0,1.1115310228308472e-05,0.0,1.0
41369,청운/Noun,1,1,0,1.1115310228308472e-05,0.0,1.0
41370,던가/Eomi,1,1,0,1.1115310228308472e-05,0.0,1.0
41371,처함/Noun,1,0,1,0.0,1.1106915165381966e-05,1.0
41372,돈땜/Noun,1,0,1,0.0,1.1106915165381966e-05,1.0
41373,독심술/Noun,1,0,1,0.0,1.1106915165381966e-05,1.0
41374,돌리뿟다/Noun,1,0,1,0.0,1.1106915165381966e-05,1.0
41375,선입견들/Noun,1,0,1,0.0,1.1106915165381966e-05,1.0
41376,';;;/Punctuation,1,0,1,0.0,1.1106915165381966e-05,1.0
41377,112233445555/Number,1,0,1,0.0,1.1106915165381966e-05,1.0
41378,비행장/Noun,1,1,0,1.1115310228308472e-05,0.0,1.0
41379,75%/Number,1,0,1,0.0,1.1106915165381966e-05,1.0
41380,남경주/Noun,1,1,0,1.1115310228308472e-05,0.0,1.0
41381,...?)/Punctuation,1,0,1,0.0,1.1106915165381966e-05,1.0
41382,평화헌법/Noun,1,0,1,0.0,1.1106915165381966e-05,1.0
41383,시빌라/Noun,1,0,1,0.0,1.1106915165381966e-05,1.0
41384,전건/Noun,1,0,1,0.0,1.1106915165381966e-05,1.0
41385,스케치북/Noun,1,0,1,0.0,1.1106915165381966e-05,1.0
41386,최윤희/Noun,1,1,0,1.1115310228308472e-05,0.0,1.0
41387,전도사/Noun,1,1,0,1.1115310228308472e-05,0.0,1.0
41388,"...""""/Punctuation",1,0,1,0.0,1.1106915165381966e-05,1.0
41389,보화/Noun,1,1,0,1.1115310228308472e-05,0.0,1.0
41390,오정/Noun,1,0,1,0.0,1.1106915165381966e-05,1.0
41391,6000/Number,1,1,0,1.1115310228308472e-05,0.0,1.0
41392,뎁따/Noun,1,1,0,1.1115310228308472e-05,0.0,1.0
41393,²/Foreign,1,1,0,1.1115310228308472e-05,0.0,1.0
41394,게닝중/Noun,1,1,0,1.1115310228308472e-05,0.0,1.0
41395,쁀/Noun,1,1,0,1.1115310228308472e-05,0.0,1.0
41396,애바/Noun,1,1,0,1.1115310228308472e-05,0.0,1.0
41397,남뒤/Noun,1,0,1,0.0,1.1106915165381966e-05,1.0
41398,알은체/Noun,1,1,0,1.1115310228308472e-05,0.0,1.0
41399,산고/Noun,1,1,0,1.1115310228308472e-05,0.0,1.0
41400,판화/Noun,1,1,0,1.1115310228308472e-05,0.0,1.0
41401,얼덕/Noun,1,1,0,1.1115310228308472e-05,0.0,1.0
41402,도노반/Noun,1,1,0,1.1115310228308472e-05,0.0,1.0
41403,괞찮네/Noun,1,1,0,1.1115310228308472e-05,0.0,1.0
41404,헸을것/Noun,1,1,0,1.1115310228308472e-05,0.0,1.0
41405,쉐보레/Noun,1,0,1,0.0,1.1106915165381966e-05,1.0
41406,고리타/Noun,1,0,1,0.0,1.1106915165381966e-05,1.0
41407,정취/Noun,1,0,1,0.0,1.1106915165381966e-05,1.0
41408,토포/Noun,1,0,1,0.0,1.1106915165381966e-05,1.0
41409,무른/Noun,1,0,1,0.0,1.1106915165381966e-05,1.0
41410,탄력/Noun,1,0,1,0.0,1.1106915165381966e-05,1.0
41411,나늬겟/Noun,1,0,1,0.0,1.1106915165381966e-05,1.0
41412,서지후/Noun,1,1,0,1.1115310228308472e-05,0.0,1.0
41413,트려/Noun,1,0,1,0.0,1.1106915165381966e-05,1.0
41414,코다/Noun,1,1,0,1.1115310228308472e-05,0.0,1.0
41415,김필숙/Noun,1,0,1,0.0,1.1106915165381966e-05,1.0
41416,2005/Number,1,1,0,1.1115310228308472e-05,0.0,1.0
41417,푸훗/Noun,1,0,1,0.0,1.1106915165381966e-05,1.0
41418,낚일뻔했/Noun,1,1,0,1.1115310228308472e-05,0.0,1.0
41419,줄랍/Noun,1,1,0,1.1115310228308472e-05,0.0,1.0
41420,(????)/Punctuation,1,0,1,0.0,1.1106915165381966e-05,1.0
41421,유머러스/Noun,1,1,0,1.1115310228308472e-05,0.0,1.0
41422,불키/Noun,1,1,0,1.1115310228308472e-05,0.0,1.0
41423,아홉/Noun,1,1,0,1.1115310228308472e-05,0.0,1.0
41424,Jisub/Alpha,1,1,0,1.1115310228308472e-05,0.0,1.0
41425,Hyojin/Alpha,1,1,0,1.1115310228308472e-05,0.0,1.0
41426,Kong/Alpha,1,1,0,1.1115310228308472e-05,0.0,1.0
41427,9000원/Number,1,0,1,0.0,1.1106915165381966e-05,1.0
41428,어지럼증/Noun,1,0,1,0.0,1.1106915165381966e-05,1.0
41429,못하겟음/Noun,1,0,1,0.0,1.1106915165381966e-05,1.0
41430,이쒸/Noun,1,0,1,0.0,1.1106915165381966e-05,1.0
41431,이쁘굼/Noun,1,1,0,1.1115310228308472e-05,0.0,1.0
41432,러시안블루/Noun,1,1,0,1.1115310228308472e-05,0.0,1.0
41433,MP/Alpha,1,1,0,1.1115310228308472e-05,0.0,1.0
41434,쭈리/Noun,1,0,1,0.0,1.1106915165381966e-05,1.0
41435,포텐터/Noun,1,1,0,1.1115310228308472e-05,0.0,1.0
41436,사교육/Noun,1,0,1,0.0,1.1106915165381966e-05,1.0
41437,유데/Noun,1,0,1,0.0,1.1106915165381966e-05,1.0
41438,공중씬/Noun,1,0,1,0.0,1.1106915165381966e-05,1.0
41439,거굿/Noun,1,1,0,1.1115310228308472e-05,0.0,1.0
41440,*-.-*/Punctuation,1,1,0,1.1115310228308472e-05,0.0,1.0
41441,마샤/Noun,1,0,1,0.0,1.1106915165381966e-05,1.0
41442,4.55/Number,1,1,0,1.1115310228308472e-05,0.0,1.0
41443,쵁오/Noun,1,1,0,1.1115310228308472e-05,0.0,1.0
41444,종려/Noun,1,1,0,1.1115310228308472e-05,0.0,1.0
41445,오승욱/Noun,1,1,0,1.1115310228308472e-05,0.0,1.0
41446,스렇다/Noun,1,0,1,0.0,1.1106915165381966e-05,1.0
41447,리또갱스/Noun,1,0,1,0.0,1.1106915165381966e-05,1.0
41448,먼개쯔래기/Noun,1,0,1,0.0,1.1106915165381966e-05,1.0
41449,32억/Number,1,0,1,0.0,1.1106915165381966e-05,1.0
41450,1940~60년/Number,1,0,1,0.0,1.1106915165381966e-05,1.0
41451,앞일/Noun,1,1,0,1.1115310228308472e-05,0.0,1.0
41452,이원화/Noun,1,1,0,1.1115310228308472e-05,0.0,1.0
41453,끈금/Noun,1,0,1,0.0,1.1106915165381966e-05,1.0
41454,한버/Noun,1,1,0,1.1115310228308472e-05,0.0,1.0
41455,상엽/Noun,1,0,1,0.0,1.1106915165381966e-05,1.0
41456,적응력/Noun,1,1,0,1.1115310228308472e-05,0.0,1.0
41457,영우/Noun,1,1,0,1.1115310228308472e-05,0.0,1.0
41458,체재/Noun,1,0,1,0.0,1.1106915165381966e-05,1.0
41459,주법/Noun,1,0,1,0.0,1.1106915165381966e-05,1.0
41460,허류루류/Noun,1,1,0,1.1115310228308472e-05,0.0,1.0
41461,용티/Noun,1,0,1,0.0,1.1106915165381966e-05,1.0
41462,"""!/Punctuation",1,1,0,1.1115310228308472e-05,0.0,1.0
41463,라식수술/Noun,1,0,1,0.0,1.1106915165381966e-05,1.0
41464,천문학/Noun,1,1,0,1.1115310228308472e-05,0.0,1.0
41465,일평생/Noun,1,1,0,1.1115310228308472e-05,0.0,1.0
41466,회눙/Noun,1,1,0,1.1115310228308472e-05,0.0,1.0
41467,훈훈햇슴/Noun,1,1,0,1.1115310228308472e-05,0.0,1.0
41468,터피/Noun,1,1,0,1.1115310228308472e-05,0.0,1.0
41469,죽갓/Noun,1,1,0,1.1115310228308472e-05,0.0,1.0
41470,블루칩/Noun,1,1,0,1.1115310228308472e-05,0.0,1.0
41471,몬내용/Noun,1,0,1,0.0,1.1106915165381966e-05,1.0
41472,조쿠/Noun,1,1,0,1.1115310228308472e-05,0.0,1.0
41473,지웅/Noun,1,1,0,1.1115310228308472e-05,0.0,1.0
41474,졸라버/Noun,1,0,1,0.0,1.1106915165381966e-05,1.0
41475,셀리/Noun,1,1,0,1.1115310228308472e-05,0.0,1.0
41476,대릭/Noun,1,0,1,0.0,1.1106915165381966e-05,1.0
41477,평법/Noun,1,0,1,0.0,1.1106915165381966e-05,1.0
41478,슬라이/Noun,1,0,1,0.0,1.1106915165381966e-05,1.0
41479,등보/Noun,1,0,1,0.0,1.1106915165381966e-05,1.0
41480,을닌텐도했다는/Foreign,1,0,1,0.0,1.1106915165381966e-05,1.0
41481,여즘/Noun,1,0,1,0.0,1.1106915165381966e-05,1.0
41482,bitchheartasshole/Alpha,1,0,1,0.0,1.1106915165381966e-05,1.0
41483,슈볼랔/Noun,1,0,1,0.0,1.1106915165381966e-05,1.0
41484,교생실습/Noun,1,1,0,1.1115310228308472e-05,0.0,1.0
41485,달짝지근하다/Adjective,1,0,1,0.0,1.1106915165381966e-05,1.0
41486,아까웡/Noun,1,0,1,0.0,1.1106915165381966e-05,1.0
41487,신봉/Noun,1,0,1,0.0,1.1106915165381966e-05,1.0
41488,불속/Noun,1,0,1,0.0,1.1106915165381966e-05,1.0
41489,틈나다/Verb,1,1,0,1.1115310228308472e-05,0.0,1.0
41490,기저/Noun,1,0,1,0.0,1.1106915165381966e-05,1.0
41491,혼하/Noun,1,0,1,0.0,1.1106915165381966e-05,1.0
41492,격거봣/Noun,1,0,1,0.0,1.1106915165381966e-05,1.0
41493,.////////Punctuation,1,0,1,0.0,1.1106915165381966e-05,1.0
41494,발쩍/Noun,1,0,1,0.0,1.1106915165381966e-05,1.0
41495,:</Punctuation,1,0,1,0.0,1.1106915165381966e-05,1.0
41496,투유/Noun,1,1,0,1.1115310228308472e-05,0.0,1.0
41497,ㅋㅋㅌ/KoreanParticle,1,0,1,0.0,1.1106915165381966e-05,1.0
41498,창밖/Noun,1,0,1,0.0,1.1106915165381966e-05,1.0
41499,왕기대/Noun,1,0,1,0.0,1.1106915165381966e-05,1.0
41500,어슬픔/Noun,1,1,0,1.1115310228308472e-05,0.0,1.0
41501,선망/Noun,1,0,1,0.0,1.1106915165381966e-05,1.0
41502,DP/Alpha,1,0,1,0.0,1.1106915165381966e-05,1.0
41503,분나/Noun,1,1,0,1.1115310228308472e-05,0.0,1.0
41504,송창식/Noun,1,1,0,1.1115310228308472e-05,0.0,1.0
41505,김민기/Noun,1,1,0,1.1115310228308472e-05,0.0,1.0
41506,만에다시봐도재밌음/Foreign,1,1,0,1.1115310228308472e-05,0.0,1.0
41507,터틀타웁/Noun,1,1,0,1.1115310228308472e-05,0.0,1.0
41508,앗능데/Noun,1,1,0,1.1115310228308472e-05,0.0,1.0
41509,하늘만/Noun,1,0,1,0.0,1.1106915165381966e-05,1.0
41510,검지/Noun,1,1,0,1.1115310228308472e-05,0.0,1.0
41511,낚였따/Noun,1,0,1,0.0,1.1106915165381966e-05,1.0
41512,틈틈/Noun,1,0,1,0.0,1.1106915165381966e-05,1.0
41513,빠꾸해/Noun,1,1,0,1.1115310228308472e-05,0.0,1.0
41514,버피/Noun,1,1,0,1.1115310228308472e-05,0.0,1.0
41515,유성영화/Noun,1,1,0,1.1115310228308472e-05,0.0,1.0
41516,부도수표/Noun,1,0,1,0.0,1.1106915165381966e-05,1.0
41517,뭉태기/Noun,1,1,0,1.1115310228308472e-05,0.0,1.0
41518,둑흔둑흔/Noun,1,1,0,1.1115310228308472e-05,0.0,1.0
41519,방모/Noun,1,1,0,1.1115310228308472e-05,0.0,1.0
41520,보덕/Noun,1,1,0,1.1115310228308472e-05,0.0,1.0
41521,와닿지앟는/Noun,1,0,1,0.0,1.1106915165381966e-05,1.0
41522,방편/Noun,1,1,0,1.1115310228308472e-05,0.0,1.0
41523,8.83/Number,1,1,0,1.1115310228308472e-05,0.0,1.0
41524,뎟글들/Noun,1,1,0,1.1115310228308472e-05,0.0,1.0
41525,7.77/Number,1,0,1,0.0,1.1106915165381966e-05,1.0
41526,4:1/Number,1,0,1,0.0,1.1106915165381966e-05,1.0
41527,바람의나라/Noun,1,1,0,1.1115310228308472e-05,0.0,1.0
41528,ㅣㄷㅇ/KoreanParticle,1,0,1,0.0,1.1106915165381966e-05,1.0
41529,못봐섳/Noun,1,0,1,0.0,1.1106915165381966e-05,1.0
41530,Wanna/Alpha,1,1,0,1.1115310228308472e-05,0.0,1.0
41531,먼이렁/Noun,1,0,1,0.0,1.1106915165381966e-05,1.0
41532,까뜨린느/Noun,1,1,0,1.1115310228308472e-05,0.0,1.0
41533,대모/Noun,1,0,1,0.0,1.1106915165381966e-05,1.0
41534,또모/Noun,1,0,1,0.0,1.1106915165381966e-05,1.0
41535,돌겨/Noun,1,1,0,1.1115310228308472e-05,0.0,1.0
41536,마춤/Noun,1,0,1,0.0,1.1106915165381966e-05,1.0
41537,투닥거리/Noun,1,0,1,0.0,1.1106915165381966e-05,1.0
41538,웃는걸/Noun,1,1,0,1.1115310228308472e-05,0.0,1.0
41539,해우/Noun,1,1,0,1.1115310228308472e-05,0.0,1.0
41540,놀랏음/Noun,1,1,0,1.1115310228308472e-05,0.0,1.0
41541,스매쉬/Noun,1,1,0,1.1115310228308472e-05,0.0,1.0
41542,~~~~~~~~~~~~~~~~~~~~~~~~~~~/Punctuation,1,1,0,1.1115310228308472e-05,0.0,1.0
41543,station/Alpha,1,1,0,1.1115310228308472e-05,0.0,1.0
41544,train/Alpha,1,1,0,1.1115310228308472e-05,0.0,1.0
41545,포사이스/Noun,1,0,1,0.0,1.1106915165381966e-05,1.0
41546,영성/Noun,1,0,1,0.0,1.1106915165381966e-05,1.0
41547,덕수궁/Noun,1,1,0,1.1115310228308472e-05,0.0,1.0
41548,삑삑/Noun,1,0,1,0.0,1.1106915165381966e-05,1.0
41549,으헤/Noun,1,1,0,1.1115310228308472e-05,0.0,1.0
41550,밌닼/Noun,1,0,1,0.0,1.1106915165381966e-05,1.0
41551,!!!!~~~/Punctuation,1,1,0,1.1115310228308472e-05,0.0,1.0
41552,비대/Noun,1,1,0,1.1115310228308472e-05,0.0,1.0
41553,bbbbeeee/Alpha,1,1,0,1.1115310228308472e-05,0.0,1.0
41554,ㅎㅡㅎ/KoreanParticle,1,1,0,1.1115310228308472e-05,0.0,1.0
41555,careful/Alpha,1,0,1,0.0,1.1106915165381966e-05,1.0
41556,배료/Noun,1,0,1,0.0,1.1106915165381966e-05,1.0
41557,민강욱/Noun,1,0,1,0.0,1.1106915165381966e-05,1.0
41558,덮다/Noun,1,1,0,1.1115310228308472e-05,0.0,1.0
41559,옾/Noun,1,1,0,1.1115310228308472e-05,0.0,1.0
41560,점이다/Foreign,1,1,0,1.1115310228308472e-05,0.0,1.0
41561,두우/Noun,1,1,0,1.1115310228308472e-05,0.0,1.0
41562,헛갯잎차/Noun,1,0,1,0.0,1.1106915165381966e-05,1.0
41563,광동/Noun,1,0,1,0.0,1.1106915165381966e-05,1.0
41564,베베꼬/Noun,1,1,0,1.1115310228308472e-05,0.0,1.0
41565,1927년/Number,1,0,1,0.0,1.1106915165381966e-05,1.0
41566,곶휴/Noun,1,0,1,0.0,1.1106915165381966e-05,1.0
41567,gay/Alpha,1,0,1,0.0,1.1106915165381966e-05,1.0
41568,느껴졋다/Noun,1,1,0,1.1115310228308472e-05,0.0,1.0
41569,5.74/Number,1,0,1,0.0,1.1106915165381966e-05,1.0
41570,유지나/Noun,1,1,0,1.1115310228308472e-05,0.0,1.0
41571,행불/Noun,1,1,0,1.1115310228308472e-05,0.0,1.0
41572,꼽을듯/Noun,1,1,0,1.1115310228308472e-05,0.0,1.0
41573,뽜이팅/Noun,1,1,0,1.1115310228308472e-05,0.0,1.0
41574,원나라/Noun,1,0,1,0.0,1.1106915165381966e-05,1.0
41575,창시/Noun,1,1,0,1.1115310228308472e-05,0.0,1.0
41576,스폰광고/Noun,1,0,1,0.0,1.1106915165381966e-05,1.0
41577,도처/Noun,1,0,1,0.0,1.1106915165381966e-05,1.0
41578,활주로/Noun,1,0,1,0.0,1.1106915165381966e-05,1.0
41579,껌벅/Adverb,1,0,1,0.0,1.1106915165381966e-05,1.0
41580,이공주/Noun,1,0,1,0.0,1.1106915165381966e-05,1.0
41581,토데/Noun,1,0,1,0.0,1.1106915165381966e-05,1.0
41582,극장전/Noun,1,1,0,1.1115310228308472e-05,0.0,1.0
41583,보물상자/Noun,1,1,0,1.1115310228308472e-05,0.0,1.0
41584,도호쿠지방/Noun,1,1,0,1.1115310228308472e-05,0.0,1.0
41585,앨리어스/Noun,1,0,1,0.0,1.1106915165381966e-05,1.0
41586,"),~/Punctuation",1,1,0,1.1115310228308472e-05,0.0,1.0
41587,)~/Punctuation,1,1,0,1.1115310228308472e-05,0.0,1.0
41588,문모/Noun,1,0,1,0.0,1.1106915165381966e-05,1.0
41589,선덕/Noun,1,0,1,0.0,1.1106915165381966e-05,1.0
41590,괜츈탕/Noun,1,1,0,1.1115310228308472e-05,0.0,1.0
41591,도라서/Foreign,1,1,0,1.1115310228308472e-05,0.0,1.0
41592,티벳인/Noun,1,1,0,1.1115310228308472e-05,0.0,1.0
41593,뽈레뜨/Noun,1,1,0,1.1115310228308472e-05,0.0,1.0
41594,꽤잼/Noun,1,1,0,1.1115310228308472e-05,0.0,1.0
41595,안볼랫다/Noun,1,1,0,1.1115310228308472e-05,0.0,1.0
41596,1/19일/Number,1,1,0,1.1115310228308472e-05,0.0,1.0
41597,휴혹숙/Noun,1,0,1,0.0,1.1106915165381966e-05,1.0
41598,윤일봉/Noun,1,1,0,1.1115310228308472e-05,0.0,1.0
41599,예뼛/Noun,1,1,0,1.1115310228308472e-05,0.0,1.0
41600,가꼬/Noun,1,0,1,0.0,1.1106915165381966e-05,1.0
41601,클래시/Noun,1,1,0,1.1115310228308472e-05,0.0,1.0
41602,중훈/Noun,1,0,1,0.0,1.1106915165381966e-05,1.0
41603,르자/Noun,1,1,0,1.1115310228308472e-05,0.0,1.0
41604,돌프룬드그랜를/Noun,1,0,1,0.0,1.1106915165381966e-05,1.0
41605,관곅/Noun,1,0,1,0.0,1.1106915165381966e-05,1.0
41606,객체/Noun,1,0,1,0.0,1.1106915165381966e-05,1.0
41607,ㅜㅜㅡ/KoreanParticle,1,1,0,1.1115310228308472e-05,0.0,1.0
41608,아팟/Noun,1,1,0,1.1115310228308472e-05,0.0,1.0
41609,으어어/Exclamation,1,1,0,1.1115310228308472e-05,0.0,1.0
41610,안상수/Noun,1,0,1,0.0,1.1106915165381966e-05,1.0
41611,안녕하십니까/Noun,1,0,1,0.0,1.1106915165381966e-05,1.0
41612,ZZZ/Alpha,1,0,1,0.0,1.1106915165381966e-05,1.0
41613,팰튼/Noun,1,1,0,1.1115310228308472e-05,0.0,1.0
41614,금단비/Noun,1,0,1,0.0,1.1106915165381966e-05,1.0
41615,조리기구/Noun,1,0,1,0.0,1.1106915165381966e-05,1.0
41616,후즐/Noun,1,0,1,0.0,1.1106915165381966e-05,1.0
41617,듕궈/Noun,1,0,1,0.0,1.1106915165381966e-05,1.0
41618,네/Foreign,1,1,0,1.1115310228308472e-05,0.0,1.0
41619,완젼짱이던뎃/Noun,1,1,0,1.1115310228308472e-05,0.0,1.0
41620,락매냐들/Noun,1,0,1,0.0,1.1106915165381966e-05,1.0
41621,다만드/Noun,1,0,1,0.0,1.1106915165381966e-05,1.0
41622,때뭄/Noun,1,0,1,0.0,1.1106915165381966e-05,1.0
41623,훌률합니/Noun,1,1,0,1.1115310228308472e-05,0.0,1.0
41624,하와/Noun,1,1,0,1.1115310228308472e-05,0.0,1.0
41625,FOEVER/Alpha,1,1,0,1.1115310228308472e-05,0.0,1.0
41626,Omega/Alpha,1,1,0,1.1115310228308472e-05,0.0,1.0
41627,Alpha/Alpha,1,1,0,1.1115310228308472e-05,0.0,1.0
41628,씹어드심/Noun,1,0,1,0.0,1.1106915165381966e-05,1.0
41629,뺴앗/Noun,1,0,1,0.0,1.1106915165381966e-05,1.0
41630,klux/Alpha,1,1,0,1.1115310228308472e-05,0.0,1.0
41631,양리칭/Noun,1,1,0,1.1115310228308472e-05,0.0,1.0
41632,알현/Noun,1,0,1,0.0,1.1106915165381966e-05,1.0
41633,!!@_@/Punctuation,1,1,0,1.1115310228308472e-05,0.0,1.0
41634,이거뭐얌/Noun,1,0,1,0.0,1.1106915165381966e-05,1.0
41635,후끝/Foreign,1,0,1,0.0,1.1106915165381966e-05,1.0
41636,크크크킄/Noun,1,0,1,0.0,1.1106915165381966e-05,1.0
41637,광철/Noun,1,0,1,0.0,1.1106915165381966e-05,1.0
41638,될껀/Noun,1,0,1,0.0,1.1106915165381966e-05,1.0
41639,태평소/Noun,1,1,0,1.1115310228308472e-05,0.0,1.0
41640,단소/Noun,1,1,0,1.1115310228308472e-05,0.0,1.0
41641,장터/Noun,1,1,0,1.1115310228308472e-05,0.0,1.0
41642,가황/Noun,1,1,0,1.1115310228308472e-05,0.0,1.0
41643,번우려먹엇스/Noun,1,0,1,0.0,1.1106915165381966e-05,1.0
41644,국딩/Noun,1,0,1,0.0,1.1106915165381966e-05,1.0
41645,홈쇼핑/Noun,1,0,1,0.0,1.1106915165381966e-05,1.0
41646,김승수/Noun,1,0,1,0.0,1.1106915165381966e-05,1.0
41647,흥햇으/Noun,1,1,0,1.1115310228308472e-05,0.0,1.0
41648,내후년/Noun,1,1,0,1.1115310228308472e-05,0.0,1.0
41649,안뇽/Noun,1,0,1,0.0,1.1106915165381966e-05,1.0
41650,우릉/Adverb,1,0,1,0.0,1.1106915165381966e-05,1.0
41651,형기/Noun,1,0,1,0.0,1.1106915165381966e-05,1.0
41652,손편/Noun,1,0,1,0.0,1.1106915165381966e-05,1.0
41653,부드러움/Noun,1,1,0,1.1115310228308472e-05,0.0,1.0
41654,락오페라/Noun,1,0,1,0.0,1.1106915165381966e-05,1.0
41655,봤을껄/Noun,1,1,0,1.1115310228308472e-05,0.0,1.0
41656,악천후/Noun,1,0,1,0.0,1.1106915165381966e-05,1.0
41657,허스트/Noun,1,0,1,0.0,1.1106915165381966e-05,1.0
41658,침수/Noun,1,0,1,0.0,1.1106915165381966e-05,1.0
41659,surprised/Alpha,1,1,0,1.1115310228308472e-05,0.0,1.0
41660,Plan/Alpha,1,1,0,1.1115310228308472e-05,0.0,1.0
41661,훙내낼순없/Noun,1,0,1,0.0,1.1106915165381966e-05,1.0
41662,complicated/Alpha,1,1,0,1.1115310228308472e-05,0.0,1.0
41663,부랍다/Noun,1,1,0,1.1115310228308472e-05,0.0,1.0
41664,거단/Noun,1,1,0,1.1115310228308472e-05,0.0,1.0
41665,뿌시/Noun,1,0,1,0.0,1.1106915165381966e-05,1.0
41666,jjun/Alpha,1,1,0,1.1115310228308472e-05,0.0,1.0
41667,리벨룽겐/Noun,1,1,0,1.1115310228308472e-05,0.0,1.0
41668,연도로/Noun,1,0,1,0.0,1.1106915165381966e-05,1.0
41669,확바/Noun,1,0,1,0.0,1.1106915165381966e-05,1.0
41670,투비컨티뉴네/Noun,1,0,1,0.0,1.1106915165381966e-05,1.0
41671,무뇌종/Noun,1,1,0,1.1115310228308472e-05,0.0,1.0
41672,섹셉션/Noun,1,0,1,0.0,1.1106915165381966e-05,1.0
41673,칼베/Noun,1,1,0,1.1115310228308472e-05,0.0,1.0
41674,블랙맘바/Noun,1,1,0,1.1115310228308472e-05,0.0,1.0
41675,Dankbarkeit/Alpha,1,1,0,1.1115310228308472e-05,0.0,1.0
41676,gewidmet/Alpha,1,1,0,1.1115310228308472e-05,0.0,1.0
41677,HGW/Alpha,1,1,0,1.1115310228308472e-05,0.0,1.0
41678,덴데/Noun,1,0,1,0.0,1.1106915165381966e-05,1.0
41679,필때/Noun,1,1,0,1.1115310228308472e-05,0.0,1.0
41680,하영/Adverb,1,1,0,1.1115310228308472e-05,0.0,1.0
41681,찬승/Noun,1,1,0,1.1115310228308472e-05,0.0,1.0
41682,좠는데/Noun,1,0,1,0.0,1.1106915165381966e-05,1.0
41683,셔스/Noun,1,1,0,1.1115310228308472e-05,0.0,1.0
41684,엑스피/Noun,1,1,0,1.1115310228308472e-05,0.0,1.0
41685,칼리프/Noun,1,1,0,1.1115310228308472e-05,0.0,1.0
41686,들만/Foreign,1,0,1,0.0,1.1106915165381966e-05,1.0
41687,슥들/Noun,1,0,1,0.0,1.1106915165381966e-05,1.0
41688,모뉴먼트밸리/Noun,1,1,0,1.1115310228308472e-05,0.0,1.0
41689,대의감성만을자극하는복고물이아니라사랑가족애우정등을모두아루르는걸작/Foreign,1,1,0,1.1115310228308472e-05,0.0,1.0
41690,호홓/Noun,1,1,0,1.1115310228308472e-05,0.0,1.0
41691,덩텅/Noun,1,1,0,1.1115310228308472e-05,0.0,1.0
41692,레스터/Noun,1,1,0,1.1115310228308472e-05,0.0,1.0
41693,독터/Noun,1,1,0,1.1115310228308472e-05,0.0,1.0
41694,",.,../Punctuation",1,0,1,0.0,1.1106915165381966e-05,1.0
41695,hadn/Alpha,1,1,0,1.1115310228308472e-05,0.0,1.0
41696,Althought/Alpha,1,1,0,1.1115310228308472e-05,0.0,1.0
41697,내적인/Noun,1,0,1,0.0,1.1106915165381966e-05,1.0
41698,쩌렁쩌렁/Noun,1,1,0,1.1115310228308472e-05,0.0,1.0
41699,또머임/Noun,1,0,1,0.0,1.1106915165381966e-05,1.0
41700,출중/Noun,1,1,0,1.1115310228308472e-05,0.0,1.0
41701,미세먼지/Noun,1,0,1,0.0,1.1106915165381966e-05,1.0
41702,대영화수준보다못함/Foreign,1,0,1,0.0,1.1106915165381966e-05,1.0
41703,달심/Noun,1,0,1,0.0,1.1106915165381966e-05,1.0
41704,그루밋때/Noun,1,0,1,0.0,1.1106915165381966e-05,1.0
41705,재소/Noun,1,1,0,1.1115310228308472e-05,0.0,1.0
41706,살인범이다/Noun,1,1,0,1.1115310228308472e-05,0.0,1.0
41707,Tq/Alpha,1,0,1,0.0,1.1106915165381966e-05,1.0
41708,짜린줄/Foreign,1,1,0,1.1115310228308472e-05,0.0,1.0
41709,이라그래서/Foreign,1,1,0,1.1115310228308472e-05,0.0,1.0
41710,평전/Noun,1,1,0,1.1115310228308472e-05,0.0,1.0
41711,법의학/Noun,1,1,0,1.1115310228308472e-05,0.0,1.0
41712,법의학자/Noun,1,1,0,1.1115310228308472e-05,0.0,1.0
41713,구글플레이/Noun,1,1,0,1.1115310228308472e-05,0.0,1.0
41714,불열/Noun,1,1,0,1.1115310228308472e-05,0.0,1.0
41715,그랬더니/Conjunction,1,0,1,0.0,1.1106915165381966e-05,1.0
41716,친입/Noun,1,0,1,0.0,1.1106915165381966e-05,1.0
41717,섹정/Noun,1,0,1,0.0,1.1106915165381966e-05,1.0
41718,덴티스트/Noun,1,0,1,0.0,1.1106915165381966e-05,1.0
41719,http://news.naver.com/main/read.nhn?mode=LSD&mid=sec&sid1=106&oid=047&aid=0002027146/URL,1,0,1,0.0,1.1106915165381966e-05,1.0
41720,쇼지/Noun,1,1,0,1.1115310228308472e-05,0.0,1.0
41721,잼엄다/Noun,1,0,1,0.0,1.1106915165381966e-05,1.0
41722,편도있었으면좋겠네요/Foreign,1,1,0,1.1115310228308472e-05,0.0,1.0
41723,쌩판/Noun,1,0,1,0.0,1.1106915165381966e-05,1.0
41724,"""?/Punctuation",1,0,1,0.0,1.1106915165381966e-05,1.0
41725,쫄림/Noun,1,1,0,1.1115310228308472e-05,0.0,1.0
41726,처러리/Noun,1,0,1,0.0,1.1106915165381966e-05,1.0
41727,~!@!/Punctuation,1,1,0,1.1115310228308472e-05,0.0,1.0
41728,휘쇼/Noun,1,1,0,1.1115310228308472e-05,0.0,1.0
41729,환포/Noun,1,0,1,0.0,1.1106915165381966e-05,1.0
41730,":-),/Punctuation",1,1,0,1.1115310228308472e-05,0.0,1.0
41731,박동수/Noun,1,1,0,1.1115310228308472e-05,0.0,1.0
41732,은닉/Noun,1,0,1,0.0,1.1106915165381966e-05,1.0
41733,".>,/Punctuation",1,1,0,1.1115310228308472e-05,0.0,1.0
41734,몇킬/Noun,1,0,1,0.0,1.1106915165381966e-05,1.0
41735,meer/Alpha,1,1,0,1.1115310228308472e-05,0.0,1.0
41736,Vincent/Alpha,1,1,0,1.1115310228308472e-05,0.0,1.0
41737,궁굼한데/Noun,1,1,0,1.1115310228308472e-05,0.0,1.0
41738,입애/Noun,1,0,1,0.0,1.1106915165381966e-05,1.0
41739,Iggy/Alpha,1,0,1,0.0,1.1106915165381966e-05,1.0
41740,!>_</Punctuation,1,1,0,1.1115310228308472e-05,0.0,1.0
41741,던칸/Noun,1,1,0,1.1115310228308472e-05,0.0,1.0
41742,때볾/Noun,1,1,0,1.1115310228308472e-05,0.0,1.0
41743,!!!!..../Punctuation,1,1,0,1.1115310228308472e-05,0.0,1.0
41744,벽속/Noun,1,1,0,1.1115310228308472e-05,0.0,1.0
41745,가압류/Noun,1,1,0,1.1115310228308472e-05,0.0,1.0
41746,손배/Noun,1,1,0,1.1115310228308472e-05,0.0,1.0
41747,뷃/Noun,1,0,1,0.0,1.1106915165381966e-05,1.0
41748,Underneath/Alpha,1,1,0,1.1115310228308472e-05,0.0,1.0
41749,Beauty/Alpha,1,1,0,1.1115310228308472e-05,0.0,1.0
41750,삼중/Noun,1,1,0,1.1115310228308472e-05,0.0,1.0
41751,확립/Noun,1,0,1,0.0,1.1106915165381966e-05,1.0
41752,♥♥♥★★★★/Foreign,1,0,1,0.0,1.1106915165381966e-05,1.0
41753,평단/Noun,1,0,1,0.0,1.1106915165381966e-05,1.0
41754,지적도/Noun,1,1,0,1.1115310228308472e-05,0.0,1.0
41755,낚곃네/Noun,1,0,1,0.0,1.1106915165381966e-05,1.0
41756,폴쉐/Noun,1,0,1,0.0,1.1106915165381966e-05,1.0
41757,탈수/Noun,1,0,1,0.0,1.1106915165381966e-05,1.0
41758,효림/Noun,1,1,0,1.1115310228308472e-05,0.0,1.0
41759,感/Foreign,1,0,1,0.0,1.1106915165381966e-05,1.0
41760,1955년/Number,1,1,0,1.1115310228308472e-05,0.0,1.0
41761,컬럼니스트/Noun,1,0,1,0.0,1.1106915165381966e-05,1.0
41762,doctor/Alpha,1,1,0,1.1115310228308472e-05,0.0,1.0
41763,개허세씬/Noun,1,0,1,0.0,1.1106915165381966e-05,1.0
41764,쥬얼/Noun,1,0,1,0.0,1.1106915165381966e-05,1.0
41765,뽕작/Noun,1,0,1,0.0,1.1106915165381966e-05,1.0
41766,대에시도된이명세감독의도전과감성에박수/Foreign,1,1,0,1.1115310228308472e-05,0.0,1.0
41767,110원/Number,1,0,1,0.0,1.1106915165381966e-05,1.0
41768,적정가격/Noun,1,0,1,0.0,1.1106915165381966e-05,1.0
41769,도법/Noun,1,1,0,1.1115310228308472e-05,0.0,1.0
41770,공쿠르상/Noun,1,1,0,1.1115310228308472e-05,0.0,1.0
41771,style/Alpha,1,1,0,1.1115310228308472e-05,0.0,1.0
41772,스콜피/Noun,1,0,1,0.0,1.1106915165381966e-05,1.0
41773,화징/Noun,1,1,0,1.1115310228308472e-05,0.0,1.0
41774,호랄/Noun,1,1,0,1.1115310228308472e-05,0.0,1.0
41775,ㄱㅔ/KoreanParticle,1,1,0,1.1115310228308472e-05,0.0,1.0
41776,인게/Foreign,1,1,0,1.1115310228308472e-05,0.0,1.0
41777,홍기/Noun,1,1,0,1.1115310228308472e-05,0.0,1.0
41778,귀상어/Noun,1,0,1,0.0,1.1106915165381966e-05,1.0
41779,작대기/Noun,1,0,1,0.0,1.1106915165381966e-05,1.0
41780,물주/Noun,1,0,1,0.0,1.1106915165381966e-05,1.0
41781,번오글토글/Noun,1,0,1,0.0,1.1106915165381966e-05,1.0
41782,중용/Noun,1,0,1,0.0,1.1106915165381966e-05,1.0
41783,진등/Noun,1,0,1,0.0,1.1106915165381966e-05,1.0
41784,아무개/Noun,1,0,1,0.0,1.1106915165381966e-05,1.0
41785,치토스/Noun,1,0,1,0.0,1.1106915165381966e-05,1.0
41786,치통/Noun,1,0,1,0.0,1.1106915165381966e-05,1.0
41787,코카/Noun,1,0,1,0.0,1.1106915165381966e-05,1.0
41788,코카인/Noun,1,0,1,0.0,1.1106915165381966e-05,1.0
41789,홀즈/Noun,1,0,1,0.0,1.1106915165381966e-05,1.0
41790,아낙네/Noun,1,0,1,0.0,1.1106915165381966e-05,1.0
41791,눈쌀찌/Noun,1,0,1,0.0,1.1106915165381966e-05,1.0
41792,낚엮슴/Noun,1,0,1,0.0,1.1106915165381966e-05,1.0
41793,징리/Noun,1,1,0,1.1115310228308472e-05,0.0,1.0
41794,안빋긴다/Noun,1,1,0,1.1115310228308472e-05,0.0,1.0
41795,은로/Noun,1,1,0,1.1115310228308472e-05,0.0,1.0
41796,600년/Number,1,1,0,1.1115310228308472e-05,0.0,1.0
41797,국어사전/Noun,1,1,0,1.1115310228308472e-05,0.0,1.0
41798,표효/Noun,1,1,0,1.1115310228308472e-05,0.0,1.0
41799,천연/Noun,1,1,0,1.1115310228308472e-05,0.0,1.0
41800,럼펄/Noun,1,0,1,0.0,1.1106915165381966e-05,1.0
41801,cinecube/Alpha,1,1,0,1.1115310228308472e-05,0.0,1.0
41802,5001/Number,1,1,0,1.1115310228308472e-05,0.0,1.0
41803,ㅋㅜ/KoreanParticle,1,1,0,1.1115310228308472e-05,0.0,1.0
41804,짜릿짜릿/Adverb,1,1,0,1.1115310228308472e-05,0.0,1.0
41805,damage/Alpha,1,0,1,0.0,1.1106915165381966e-05,1.0
41806,collateral/Alpha,1,0,1,0.0,1.1106915165381966e-05,1.0
41807,Front/Alpha,1,0,1,0.0,1.1106915165381966e-05,1.0
41808,Storm/Alpha,1,0,1,0.0,1.1106915165381966e-05,1.0
41809,트렉/Noun,1,0,1,0.0,1.1106915165381966e-05,1.0
41810,살균/Noun,1,0,1,0.0,1.1106915165381966e-05,1.0
41811,꼬는것/Noun,1,0,1,0.0,1.1106915165381966e-05,1.0
41812,필생/Noun,1,0,1,0.0,1.1106915165381966e-05,1.0
41813,ㄴㅇㄻ/KoreanParticle,1,1,0,1.1115310228308472e-05,0.0,1.0
41814,rules/Alpha,1,0,1,0.0,1.1106915165381966e-05,1.0
41815,OC/Alpha,1,0,1,0.0,1.1106915165381966e-05,1.0
41816,craps/Alpha,1,0,1,0.0,1.1106915165381966e-05,1.0
41817,단편/Foreign,1,0,1,0.0,1.1106915165381966e-05,1.0
41818,도영화이정도면정말괜찬은겁니다감동없지만진짜재밌음/Foreign,1,1,0,1.1115310228308472e-05,0.0,1.0
41819,출처/Noun,1,1,0,1.1115310228308472e-05,0.0,1.0
41820,현악/Noun,1,1,0,1.1115310228308472e-05,0.0,1.0
41821,막줌/Noun,1,0,1,0.0,1.1106915165381966e-05,1.0
41822,수숩/Noun,1,0,1,0.0,1.1106915165381966e-05,1.0
41823,??';;/Punctuation,1,0,1,0.0,1.1106915165381966e-05,1.0
41824,인어대해전/Noun,1,1,0,1.1115310228308472e-05,0.0,1.0
41825,좉타/Noun,1,1,0,1.1115310228308472e-05,0.0,1.0
41826,playground/Alpha,1,1,0,1.1115310228308472e-05,0.0,1.0
41827,used/Alpha,1,1,0,1.1115310228308472e-05,0.0,1.0
41828,밀렵/Noun,1,1,0,1.1115310228308472e-05,0.0,1.0
41829,샅/Noun,1,1,0,1.1115310228308472e-05,0.0,1.0
41830,난쏘공/Noun,1,1,0,1.1115310228308472e-05,0.0,1.0
41831,킬리언/Noun,1,1,0,1.1115310228308472e-05,0.0,1.0
41832,삼사/Modifier,1,0,1,0.0,1.1106915165381966e-05,1.0
41833,！宋慧/Foreign,1,1,0,1.1115310228308472e-05,0.0,1.0
41834,非常好看！喜/Foreign,1,1,0,1.1115310228308472e-05,0.0,1.0
41835,혓소리/Noun,1,1,0,1.1115310228308472e-05,0.0,1.0
41836,꼬부라지다/Verb,1,1,0,1.1115310228308472e-05,0.0,1.0
41837,뛰엄뛰엄봄/Noun,1,0,1,0.0,1.1106915165381966e-05,1.0
41838,팔정도/Noun,1,1,0,1.1115310228308472e-05,0.0,1.0
41839,폼페이/Noun,1,0,1,0.0,1.1106915165381966e-05,1.0
41840,케안습/Noun,1,0,1,0.0,1.1106915165381966e-05,1.0
41841,마법소녀/Noun,1,1,0,1.1115310228308472e-05,0.0,1.0
41842,괴괴작/Noun,1,0,1,0.0,1.1106915165381966e-05,1.0
41843,루삐잉/Noun,1,1,0,1.1115310228308472e-05,0.0,1.0
41844,샨샨/Noun,1,1,0,1.1115310228308472e-05,0.0,1.0
41845,샹치/Noun,1,1,0,1.1115310228308472e-05,0.0,1.0
41846,..?'/Punctuation,1,1,0,1.1115310228308472e-05,0.0,1.0
41847,ㄹㅔ/KoreanParticle,1,0,1,0.0,1.1106915165381966e-05,1.0
41848,****///Punctuation,1,1,0,1.1115310228308472e-05,0.0,1.0
41849,tlad/Alpha,1,1,0,1.1115310228308472e-05,0.0,1.0
41850,꺠끗하/Noun,1,1,0,1.1115310228308472e-05,0.0,1.0
41851,스페이더/Noun,1,1,0,1.1115310228308472e-05,0.0,1.0
41852,폭풍성/Noun,1,0,1,0.0,1.1106915165381966e-05,1.0
41853,제임슨스타뎀/Noun,1,0,1,0.0,1.1106915165381966e-05,1.0
41854,제임슨/Noun,1,0,1,0.0,1.1106915165381966e-05,1.0
41855,열뻐치/Noun,1,0,1,0.0,1.1106915165381966e-05,1.0
41856,자유로이/Adverb,1,0,1,0.0,1.1106915165381966e-05,1.0
41857,냉탕/Noun,1,0,1,0.0,1.1106915165381966e-05,1.0
41858,핵노젬/Noun,1,0,1,0.0,1.1106915165381966e-05,1.0
41859,놀래킨다/Noun,1,0,1,0.0,1.1106915165381966e-05,1.0
41860,짤린거/Noun,1,0,1,0.0,1.1106915165381966e-05,1.0
41861,①/Foreign,1,0,1,0.0,1.1106915165381966e-05,1.0
41862,샤우팅할때/Noun,1,1,0,1.1115310228308472e-05,0.0,1.0
41863,말똥말똥하다/Adjective,1,1,0,1.1115310228308472e-05,0.0,1.0
41864,~~~@*@/Punctuation,1,1,0,1.1115310228308472e-05,0.0,1.0
41865,위암/Noun,1,1,0,1.1115310228308472e-05,0.0,1.0
41866,릴라/Noun,1,1,0,1.1115310228308472e-05,0.0,1.0
41867,어쭙잖다/Adjective,1,1,0,1.1115310228308472e-05,0.0,1.0
41868,..??!!/Punctuation,1,0,1,0.0,1.1106915165381966e-05,1.0
41869,스턴트/Noun,1,0,1,0.0,1.1106915165381966e-05,1.0
41870,능금/Noun,1,1,0,1.1115310228308472e-05,0.0,1.0
41871,마너/Noun,1,1,0,1.1115310228308472e-05,0.0,1.0
41872,요사이/Noun,1,1,0,1.1115310228308472e-05,0.0,1.0
41873,젤젤/Noun,1,0,1,0.0,1.1106915165381966e-05,1.0
41874,정도라는/Foreign,1,0,1,0.0,1.1106915165381966e-05,1.0
41875,찌랭/Noun,1,0,1,0.0,1.1106915165381966e-05,1.0
41876,왓치/Noun,1,1,0,1.1115310228308472e-05,0.0,1.0
41877,kimd/Alpha,1,1,0,1.1115310228308472e-05,0.0,1.0
41878,얼굴샷/Noun,1,0,1,0.0,1.1106915165381966e-05,1.0
41879,부계/Noun,1,0,1,0.0,1.1106915165381966e-05,1.0
41880,터젼/Noun,1,1,0,1.1115310228308472e-05,0.0,1.0
41881,주체사상/Noun,1,0,1,0.0,1.1106915165381966e-05,1.0
41882,쳐핸섭/Noun,1,0,1,0.0,1.1106915165381966e-05,1.0
41883,록큰롤/Noun,1,1,0,1.1115310228308472e-05,0.0,1.0
41884,불륨/Noun,1,0,1,0.0,1.1106915165381966e-05,1.0
41885,리플릿/Noun,1,0,1,0.0,1.1106915165381966e-05,1.0
41886,삼지창/Noun,1,0,1,0.0,1.1106915165381966e-05,1.0
41887,란제리/Noun,1,0,1,0.0,1.1106915165381966e-05,1.0
41888,??????????(/Punctuation,1,0,1,0.0,1.1106915165381966e-05,1.0
41889,잉뭐/Noun,1,0,1,0.0,1.1106915165381966e-05,1.0
41890,미에트/Noun,1,1,0,1.1115310228308472e-05,0.0,1.0
41891,당레/Noun,1,1,0,1.1115310228308472e-05,0.0,1.0
41892,개훈/Noun,1,1,0,1.1115310228308472e-05,0.0,1.0
41893,잘봣으/Noun,1,1,0,1.1115310228308472e-05,0.0,1.0
41894,샛기들/Noun,1,1,0,1.1115310228308472e-05,0.0,1.0
41895,점단/Noun,1,1,0,1.1115310228308472e-05,0.0,1.0
41896,첨으루/Noun,1,1,0,1.1115310228308472e-05,0.0,1.0
41897,쩌재미쩌/Noun,1,1,0,1.1115310228308472e-05,0.0,1.0
41898,규홍/Noun,1,0,1,0.0,1.1106915165381966e-05,1.0
41899,김영빈/Noun,1,1,0,1.1115310228308472e-05,0.0,1.0
41900,아랐네보/Noun,1,0,1,0.0,1.1106915165381966e-05,1.0
41901,매스껍/Noun,1,0,1,0.0,1.1106915165381966e-05,1.0
41902,반향/Noun,1,1,0,1.1115310228308472e-05,0.0,1.0
41903,1997-2015/Number,1,1,0,1.1115310228308472e-05,0.0,1.0
41904,입봉해/Noun,1,0,1,0.0,1.1106915165381966e-05,1.0
41905,쭝쿠러/Noun,1,0,1,0.0,1.1106915165381966e-05,1.0
41906,버레스크등/Noun,1,0,1,0.0,1.1106915165381966e-05,1.0
41907,캠프락/Noun,1,0,1,0.0,1.1106915165381966e-05,1.0
41908,스피어스/Noun,1,0,1,0.0,1.1106915165381966e-05,1.0
41909,해짐/Noun,1,1,0,1.1115310228308472e-05,0.0,1.0
41910,혹쏙/Noun,1,0,1,0.0,1.1106915165381966e-05,1.0
41911,옮은듯/Noun,1,0,1,0.0,1.1106915165381966e-05,1.0
41912,비응/Noun,1,1,0,1.1115310228308472e-05,0.0,1.0
41913,죽겠넹/Noun,1,0,1,0.0,1.1106915165381966e-05,1.0
41914,육갑/Noun,1,0,1,0.0,1.1106915165381966e-05,1.0
41915,삼십/Modifier,1,0,1,0.0,1.1106915165381966e-05,1.0
41916,나용/Noun,1,1,0,1.1115310228308472e-05,0.0,1.0
41917,2013.10/Number,1,1,0,1.1115310228308472e-05,0.0,1.0
41918,무타/Noun,1,1,0,1.1115310228308472e-05,0.0,1.0
41919,겨눌/Noun,1,1,0,1.1115310228308472e-05,0.0,1.0
41920,;./Punctuation,1,1,0,1.1115310228308472e-05,0.0,1.0
41921,정봉/Noun,1,0,1,0.0,1.1106915165381966e-05,1.0
41922,봤댜/Noun,1,0,1,0.0,1.1106915165381966e-05,1.0
41923,쫌잇음/Noun,1,1,0,1.1115310228308472e-05,0.0,1.0
41924,Missing/Alpha,1,1,0,1.1115310228308472e-05,0.0,1.0
41925,Always/Alpha,1,1,0,1.1115310228308472e-05,0.0,1.0
41926,샤진/Noun,1,0,1,0.0,1.1106915165381966e-05,1.0
41927,1.36%/Number,1,1,0,1.1115310228308472e-05,0.0,1.0
41928,6.76/Number,1,0,1,0.0,1.1106915165381966e-05,1.0
41929,복통/Noun,1,1,0,1.1115310228308472e-05,0.0,1.0
41930,데키/Noun,1,1,0,1.1115310228308472e-05,0.0,1.0
41931,히데아키/Noun,1,1,0,1.1115310228308472e-05,0.0,1.0
41932,제스처/Noun,1,1,0,1.1115310228308472e-05,0.0,1.0
41933,.?.../Punctuation,1,0,1,0.0,1.1106915165381966e-05,1.0
41934,국립현충원/Noun,1,0,1,0.0,1.1106915165381966e-05,1.0
41935,중선생/Noun,1,0,1,0.0,1.1106915165381966e-05,1.0
41936,다이쥬일/Noun,1,0,1,0.0,1.1106915165381966e-05,1.0
41937,페미니스트/Noun,1,0,1,0.0,1.1106915165381966e-05,1.0
41938,언떤놈/Noun,1,0,1,0.0,1.1106915165381966e-05,1.0
41939,급기야/Adverb,1,1,0,1.1115310228308472e-05,0.0,1.0
41940,정치범/Noun,1,0,1,0.0,1.1106915165381966e-05,1.0
41941,shffoTs/Alpha,1,1,0,1.1115310228308472e-05,0.0,1.0
41942,vudwjaqhrh/Alpha,1,1,0,1.1115310228308472e-05,0.0,1.0
41943,렌턴/Noun,1,1,0,1.1115310228308472e-05,0.0,1.0
41944,다르케/Noun,1,1,0,1.1115310228308472e-05,0.0,1.0
41945,.....-_-;;/Punctuation,1,0,1,0.0,1.1106915165381966e-05,1.0
41946,진실횽/Noun,1,1,0,1.1115310228308472e-05,0.0,1.0
41947,류예/Noun,1,1,0,1.1115310228308472e-05,0.0,1.0
41948,잘버/Noun,1,1,0,1.1115310228308472e-05,0.0,1.0
41949,문화원/Noun,1,1,0,1.1115310228308472e-05,0.0,1.0
41950,색꺄/Noun,1,1,0,1.1115310228308472e-05,0.0,1.0
41951,너거/Modifier,1,0,1,0.0,1.1106915165381966e-05,1.0
41952,겁낙/Noun,1,1,0,1.1115310228308472e-05,0.0,1.0
41953,소사/Noun,1,0,1,0.0,1.1106915165381966e-05,1.0
41954,462/Number,1,0,1,0.0,1.1106915165381966e-05,1.0
41955,完/Foreign,1,0,1,0.0,1.1106915165381966e-05,1.0
41956,박찬/Noun,1,0,1,0.0,1.1106915165381966e-05,1.0
41957,닥밀/Noun,1,0,1,0.0,1.1106915165381966e-05,1.0
41958,속독/Noun,1,0,1,0.0,1.1106915165381966e-05,1.0
41959,ending/Alpha,1,1,0,1.1115310228308472e-05,0.0,1.0
41960,strong/Alpha,1,1,0,1.1115310228308472e-05,0.0,1.0
41961,きもかった/Foreign,1,0,1,0.0,1.1106915165381966e-05,1.0
41962,피난/Noun,1,0,1,0.0,1.1106915165381966e-05,1.0
41963,~~~~~~~^^/Punctuation,1,1,0,1.1115310228308472e-05,0.0,1.0
41964,준서기/Noun,1,0,1,0.0,1.1106915165381966e-05,1.0
41965,을봣다/Noun,1,0,1,0.0,1.1106915165381966e-05,1.0
41966,gets/Alpha,1,1,0,1.1115310228308472e-05,0.0,1.0
41967,Miller/Alpha,1,1,0,1.1115310228308472e-05,0.0,1.0
41968,Sienna/Alpha,1,1,0,1.1115310228308472e-05,0.0,1.0
41969,Sedgwick/Alpha,1,1,0,1.1115310228308472e-05,0.0,1.0
41970,Edie/Alpha,1,1,0,1.1115310228308472e-05,0.0,1.0
41971,예정일/Noun,1,1,0,1.1115310228308472e-05,0.0,1.0
41972,시청각교육/Noun,1,0,1,0.0,1.1106915165381966e-05,1.0
41973,PAUL/Alpha,1,1,0,1.1115310228308472e-05,0.0,1.0
41974,FOR/Alpha,1,1,0,1.1115310228308472e-05,0.0,1.0
41975,영어대사/Noun,1,0,1,0.0,1.1106915165381966e-05,1.0
41976,틴울프/Noun,1,0,1,0.0,1.1106915165381966e-05,1.0
41977,4조/Number,1,1,0,1.1115310228308472e-05,0.0,1.0
41978,9.50/Number,1,0,1,0.0,1.1106915165381966e-05,1.0
41979,북한주민/Noun,1,1,0,1.1115310228308472e-05,0.0,1.0
41980,잼쏭/Noun,1,1,0,1.1115310228308472e-05,0.0,1.0
41981,츠마부키/Noun,1,1,0,1.1115310228308472e-05,0.0,1.0
41982,차림표/Noun,1,0,1,0.0,1.1106915165381966e-05,1.0
41983,상형/Noun,1,1,0,1.1115310228308472e-05,0.0,1.0
41984,총대/Noun,1,1,0,1.1115310228308472e-05,0.0,1.0
41985,판지/Noun,1,0,1,0.0,1.1106915165381966e-05,1.0
41986,썸톡/Noun,1,1,0,1.1115310228308472e-05,0.0,1.0
41987,이광필/Noun,1,1,0,1.1115310228308472e-05,0.0,1.0
41988,랩소디/Noun,1,1,0,1.1115310228308472e-05,0.0,1.0
41989,ggggddhdhghsghfdhfh/Alpha,1,1,0,1.1115310228308472e-05,0.0,1.0
41990,전노민/Noun,1,1,0,1.1115310228308472e-05,0.0,1.0
41991,흑자/Noun,1,1,0,1.1115310228308472e-05,0.0,1.0
41992,딜로/Noun,1,1,0,1.1115310228308472e-05,0.0,1.0
41993,일꾼/Noun,1,1,0,1.1115310228308472e-05,0.0,1.0
41994,세상만사/Noun,1,0,1,0.0,1.1106915165381966e-05,1.0
41995,라따/Noun,1,0,1,0.0,1.1106915165381966e-05,1.0
41996,푸우/Noun,1,1,0,1.1115310228308472e-05,0.0,1.0
41997,막짱삘/Noun,1,0,1,0.0,1.1106915165381966e-05,1.0
41998,~--;;/Punctuation,1,0,1,0.0,1.1106915165381966e-05,1.0
41999,암흑시대/Noun,1,1,0,1.1115310228308472e-05,0.0,1.0
42000,쫄깃햇음/Noun,1,1,0,1.1115310228308472e-05,0.0,1.0
42001,speed/Alpha,1,0,1,0.0,1.1106915165381966e-05,1.0
42002,찬욱/Noun,1,1,0,1.1115310228308472e-05,0.0,1.0
42003,무왕/Noun,1,1,0,1.1115310228308472e-05,0.0,1.0
42004,하선/Noun,1,0,1,0.0,1.1106915165381966e-05,1.0
42005,…………?/Punctuation,1,0,1,0.0,1.1106915165381966e-05,1.0
42006,법내/Noun,1,1,0,1.1115310228308472e-05,0.0,1.0
42007,빠옴/Noun,1,1,0,1.1115310228308472e-05,0.0,1.0
42008,슈파슈파/Noun,1,1,0,1.1115310228308472e-05,0.0,1.0
42009,달구지/Noun,1,1,0,1.1115310228308472e-05,0.0,1.0
42010,4500만/Number,1,0,1,0.0,1.1106915165381966e-05,1.0
42011,밌음/Noun,1,1,0,1.1115310228308472e-05,0.0,1.0
42012,팰트로우/Noun,1,0,1,0.0,1.1106915165381966e-05,1.0
42013,껄호롤류루/Noun,1,1,0,1.1115310228308472e-05,0.0,1.0
42014,뀨잇/Noun,1,0,1,0.0,1.1106915165381966e-05,1.0
42015,everybody/Alpha,1,1,0,1.1115310228308472e-05,0.0,1.0
42016,everywhere/Alpha,1,1,0,1.1115310228308472e-05,0.0,1.0
42017,everytime/Alpha,1,1,0,1.1115310228308472e-05,0.0,1.0
42018,조민기/Noun,1,1,0,1.1115310228308472e-05,0.0,1.0
42019,기스/Noun,1,0,1,0.0,1.1106915165381966e-05,1.0
42020,234/Number,1,0,1,0.0,1.1106915165381966e-05,1.0
42021,?^^;/Punctuation,1,0,1,0.0,1.1106915165381966e-05,1.0
42022,시어/Noun,1,0,1,0.0,1.1106915165381966e-05,1.0
42023,괴소문/Noun,1,0,1,0.0,1.1106915165381966e-05,1.0
42024,Find/Alpha,1,1,0,1.1115310228308472e-05,0.0,1.0
42025,투시/Noun,1,0,1,0.0,1.1106915165381966e-05,1.0
42026,스파이앱/Noun,1,0,1,0.0,1.1106915165381966e-05,1.0
42027,단독제/Noun,1,0,1,0.0,1.1106915165381966e-05,1.0
42028,포식/Noun,1,1,0,1.1115310228308472e-05,0.0,1.0
42029,파나비전/Noun,1,0,1,0.0,1.1106915165381966e-05,1.0
42030,잔디/Noun,1,0,1,0.0,1.1106915165381966e-05,1.0
42031,계주/Noun,1,0,1,0.0,1.1106915165381966e-05,1.0
42032,에만들어진/Foreign,1,1,0,1.1115310228308472e-05,0.0,1.0
42033,이뿌넹/Noun,1,1,0,1.1115310228308472e-05,0.0,1.0
42034,형역/Noun,1,1,0,1.1115310228308472e-05,0.0,1.0
42035,duel/Alpha,1,1,0,1.1115310228308472e-05,0.0,1.0
42036,8.26/Number,1,0,1,0.0,1.1106915165381966e-05,1.0
42037,패러글라이딩/Noun,1,0,1,0.0,1.1106915165381966e-05,1.0
42038,괘찮다/Noun,1,0,1,0.0,1.1106915165381966e-05,1.0
42039,아미타불/Noun,1,0,1,0.0,1.1106915165381966e-05,1.0
42040,박현빈/Noun,1,0,1,0.0,1.1106915165381966e-05,1.0
42041,꼬띨/Noun,1,0,1,0.0,1.1106915165381966e-05,1.0
42042,뚬양꿈/Noun,1,0,1,0.0,1.1106915165381966e-05,1.0
42043,화석/Noun,1,1,0,1.1115310228308472e-05,0.0,1.0
42044,..-..-/Punctuation,1,0,1,0.0,1.1106915165381966e-05,1.0
42045,윤주희/Noun,1,1,0,1.1115310228308472e-05,0.0,1.0
42046,개주고싶네요/Foreign,1,0,1,0.0,1.1106915165381966e-05,1.0
42047,1000000000만/Number,1,0,1,0.0,1.1106915165381966e-05,1.0
42048,병남/Noun,1,1,0,1.1115310228308472e-05,0.0,1.0
42049,황자/Noun,1,1,0,1.1115310228308472e-05,0.0,1.0
42050,9.85/Number,1,0,1,0.0,1.1106915165381966e-05,1.0
42051,없어졋써/Noun,1,0,1,0.0,1.1106915165381966e-05,1.0
42052,""",""/Punctuation",1,0,1,0.0,1.1106915165381966e-05,1.0
42053,fot/Alpha,1,1,0,1.1115310228308472e-05,0.0,1.0
42054,whatcha/Alpha,1,1,0,1.1115310228308472e-05,0.0,1.0
42055,슨발/Noun,1,0,1,0.0,1.1106915165381966e-05,1.0
42056,콴이유/Noun,1,0,1,0.0,1.1106915165381966e-05,1.0
42057,차오/Noun,1,0,1,0.0,1.1106915165381966e-05,1.0
42058,ㅋㅋㄱㅋㅋㅋ/KoreanParticle,1,0,1,0.0,1.1106915165381966e-05,1.0
42059,놀랏습니/Noun,1,0,1,0.0,1.1106915165381966e-05,1.0
42060,걱/Noun,1,0,1,0.0,1.1106915165381966e-05,1.0
42061,찐득찐득/Adverb,1,0,1,0.0,1.1106915165381966e-05,1.0
42062,.~(/Punctuation,1,0,1,0.0,1.1106915165381966e-05,1.0
42063,번득/Noun,1,0,1,0.0,1.1106915165381966e-05,1.0
42064,어찌어찌/Adverb,1,0,1,0.0,1.1106915165381966e-05,1.0
42065,빗장/Noun,1,1,0,1.1115310228308472e-05,0.0,1.0
42066,Bbb/Alpha,1,1,0,1.1115310228308472e-05,0.0,1.0
42067,혜윤이/Noun,1,1,0,1.1115310228308472e-05,0.0,1.0
42068,털좀/Noun,1,1,0,1.1115310228308472e-05,0.0,1.0
42069,터닝포/Noun,1,1,0,1.1115310228308472e-05,0.0,1.0
42070,삭았음/Noun,1,0,1,0.0,1.1106915165381966e-05,1.0
42071,별기/Noun,1,1,0,1.1115310228308472e-05,0.0,1.0
42072,방글/Adverb,1,0,1,0.0,1.1106915165381966e-05,1.0
42073,파키/Noun,1,0,1,0.0,1.1106915165381966e-05,1.0
42074,서남아시아/Noun,1,0,1,0.0,1.1106915165381966e-05,1.0
42075,땋/Noun,1,1,0,1.1115310228308472e-05,0.0,1.0
42076,세이크/Noun,1,0,1,0.0,1.1106915165381966e-05,1.0
42077,영어사전/Noun,1,0,1,0.0,1.1106915165381966e-05,1.0
42078,새크/Noun,1,0,1,0.0,1.1106915165381966e-05,1.0
42079,왓습니담/Noun,1,1,0,1.1115310228308472e-05,0.0,1.0
42080,음소거/Noun,1,0,1,0.0,1.1106915165381966e-05,1.0
42081,바다씬/Noun,1,0,1,0.0,1.1106915165381966e-05,1.0
42082,.....-_-;;;;;/Punctuation,1,0,1,0.0,1.1106915165381966e-05,1.0
42083,츄쳐/Noun,1,1,0,1.1115310228308472e-05,0.0,1.0
42084,개뚜/Noun,1,0,1,0.0,1.1106915165381966e-05,1.0
42085,즉슨/Noun,1,0,1,0.0,1.1106915165381966e-05,1.0
42086,투도/Noun,1,0,1,0.0,1.1106915165381966e-05,1.0
42087,!!!!!!></Punctuation,1,1,0,1.1115310228308472e-05,0.0,1.0
42088,Vv/Alpha,1,1,0,1.1115310228308472e-05,0.0,1.0
42089,!!!!!!!!!!!!!!!!!!!!!!!!!!!!!!!!!!!!/Punctuation,1,1,0,1.1115310228308472e-05,0.0,1.0
42090,카잔/Noun,1,1,0,1.1115310228308472e-05,0.0,1.0
42091,와닺는면/Noun,1,0,1,0.0,1.1106915165381966e-05,1.0
42092,뛰놀다/Verb,1,0,1,0.0,1.1106915165381966e-05,1.0
42093,절약/Noun,1,0,1,0.0,1.1106915165381966e-05,1.0
42094,과학사/Noun,1,1,0,1.1115310228308472e-05,0.0,1.0
42095,shocked/Alpha,1,1,0,1.1115310228308472e-05,0.0,1.0
42096,wowed/Alpha,1,1,0,1.1115310228308472e-05,0.0,1.0
42097,놨단/Noun,1,0,1,0.0,1.1106915165381966e-05,1.0
42098,superb/Alpha,1,1,0,1.1115310228308472e-05,0.0,1.0
42099,comparison/Alpha,1,1,0,1.1115310228308472e-05,0.0,1.0
42100,달콤씁슬함/Noun,1,1,0,1.1115310228308472e-05,0.0,1.0
42101,1925년/Number,1,1,0,1.1115310228308472e-05,0.0,1.0
42102,청첩장/Noun,1,0,1,0.0,1.1106915165381966e-05,1.0
42103,켐/Noun,1,0,1,0.0,1.1106915165381966e-05,1.0
42104,똥꾸뇽/Noun,1,0,1,0.0,1.1106915165381966e-05,1.0
42105,체인드/Noun,1,1,0,1.1115310228308472e-05,0.0,1.0
42106,렙/Noun,1,0,1,0.0,1.1106915165381966e-05,1.0
42107,오레/Noun,1,1,0,1.1115310228308472e-05,0.0,1.0
42108,대만/Foreign,1,1,0,1.1115310228308472e-05,0.0,1.0
42109,맥베스/Noun,1,0,1,0.0,1.1106915165381966e-05,1.0
42110,이화/Noun,1,0,1,0.0,1.1106915165381966e-05,1.0
42111,펀드/Noun,1,0,1,0.0,1.1106915165381966e-05,1.0
42112,강지은/Noun,1,0,1,0.0,1.1106915165381966e-05,1.0
42113,1016/Number,1,0,1,0.0,1.1106915165381966e-05,1.0
42114,불닭/Noun,1,1,0,1.1115310228308472e-05,0.0,1.0
42115,?)?/Punctuation,1,1,0,1.1115310228308472e-05,0.0,1.0
42116,´∇｀/Foreign,1,1,0,1.1115310228308472e-05,0.0,1.0
42117,?(?/Punctuation,1,1,0,1.1115310228308472e-05,0.0,1.0
42118,릴리슈슈/Noun,1,0,1,0.0,1.1106915165381966e-05,1.0
42119,등식/Noun,1,0,1,0.0,1.1106915165381966e-05,1.0
42120,과달카날/Noun,1,1,0,1.1115310228308472e-05,0.0,1.0
42121,마유미/Noun,1,1,0,1.1115310228308472e-05,0.0,1.0
42122,19분/Number,1,0,1,0.0,1.1106915165381966e-05,1.0
42123,쿠르드/Noun,1,1,0,1.1115310228308472e-05,0.0,1.0
42124,실로폰/Noun,1,0,1,0.0,1.1106915165381966e-05,1.0
42125,인촌/Noun,1,1,0,1.1115310228308472e-05,0.0,1.0
42126,철폐/Noun,1,1,0,1.1115310228308472e-05,0.0,1.0
42127,바빌론/Noun,1,1,0,1.1115310228308472e-05,0.0,1.0
42128,굿판/Noun,1,1,0,1.1115310228308472e-05,0.0,1.0
42129,피족/Noun,1,1,0,1.1115310228308472e-05,0.0,1.0
42130,삼손/Noun,1,1,0,1.1115310228308472e-05,0.0,1.0
42131,블리트/Noun,1,1,0,1.1115310228308472e-05,0.0,1.0
42132,개빵터졋/Noun,1,1,0,1.1115310228308472e-05,0.0,1.0
42133,똴/Noun,1,1,0,1.1115310228308472e-05,0.0,1.0
42134,데강/Noun,1,0,1,0.0,1.1106915165381966e-05,1.0
42135,미드나/Noun,1,0,1,0.0,1.1106915165381966e-05,1.0
42136,나봄/Noun,1,0,1,0.0,1.1106915165381966e-05,1.0
42137,특검/Noun,1,0,1,0.0,1.1106915165381966e-05,1.0
42138,연극인/Noun,1,0,1,0.0,1.1106915165381966e-05,1.0
42139,..........................\/Punctuation,1,0,1,0.0,1.1106915165381966e-05,1.0
42140,벵상뻬레/Noun,1,1,0,1.1115310228308472e-05,0.0,1.0
42141,TVB/Alpha,1,1,0,1.1115310228308472e-05,0.0,1.0
42142,숍/Noun,1,1,0,1.1115310228308472e-05,0.0,1.0
42143,응거/Noun,1,1,0,1.1115310228308472e-05,0.0,1.0
42144,송증현/Noun,1,0,1,0.0,1.1106915165381966e-05,1.0
42145,총명하다/Adjective,1,0,1,0.0,1.1106915165381966e-05,1.0
42146,꿀빵/Noun,1,0,1,0.0,1.1106915165381966e-05,1.0
42147,쪼잔/Noun,1,1,0,1.1115310228308472e-05,0.0,1.0
42148,류영환/Noun,1,0,1,0.0,1.1106915165381966e-05,1.0
42149,킹카/Noun,1,0,1,0.0,1.1106915165381966e-05,1.0
42150,터녔다/Noun,1,1,0,1.1115310228308472e-05,0.0,1.0
42151,찔레꽃/Noun,1,1,0,1.1115310228308472e-05,0.0,1.0
42152,213123/Number,1,1,0,1.1115310228308472e-05,0.0,1.0
42153,easier/Alpha,1,1,0,1.1115310228308472e-05,0.0,1.0
42154,things/Alpha,1,1,0,1.1115310228308472e-05,0.0,1.0
42155,child/Alpha,1,1,0,1.1115310228308472e-05,0.0,1.0
42156,ooh/Alpha,1,1,0,1.1115310228308472e-05,0.0,1.0
42157,너커르/Noun,1,1,0,1.1115310228308472e-05,0.0,1.0
42158,에본건데/Foreign,1,1,0,1.1115310228308472e-05,0.0,1.0
42159,feat/Alpha,1,0,1,0.0,1.1106915165381966e-05,1.0
42160,현해탄/Noun,1,0,1,0.0,1.1106915165381966e-05,1.0
42161,ㅇㄷㄱㅎ/KoreanParticle,1,0,1,0.0,1.1106915165381966e-05,1.0
42162,썀/Noun,1,0,1,0.0,1.1106915165381966e-05,1.0
42163,대학입시/Noun,1,0,1,0.0,1.1106915165381966e-05,1.0
42164,외래어/Noun,1,0,1,0.0,1.1106915165381966e-05,1.0
42165,쥐어박다/Verb,1,0,1,0.0,1.1106915165381966e-05,1.0
42166,올렛/Noun,1,0,1,0.0,1.1106915165381966e-05,1.0
42167,즛/Noun,1,0,1,0.0,1.1106915165381966e-05,1.0
42168,썸딩/Noun,1,0,1,0.0,1.1106915165381966e-05,1.0
42169,><></Punctuation,1,1,0,1.1115310228308472e-05,0.0,1.0
42170,잼존잼/Noun,1,1,0,1.1115310228308472e-05,0.0,1.0
42171,굿잼꿀잼/Noun,1,1,0,1.1115310228308472e-05,0.0,1.0
42172,이넘었지만/Foreign,1,1,0,1.1115310228308472e-05,0.0,1.0
42173,wjdjkel/Alpha,1,1,0,1.1115310228308472e-05,0.0,1.0
42174,윤강/Noun,1,1,0,1.1115310228308472e-05,0.0,1.0
42175,할덴/Noun,1,0,1,0.0,1.1106915165381966e-05,1.0
42176,.......-_-/Punctuation,1,0,1,0.0,1.1106915165381966e-05,1.0
42177,잘생겻는데/Noun,1,0,1,0.0,1.1106915165381966e-05,1.0
42178,다훈/Noun,1,0,1,0.0,1.1106915165381966e-05,1.0
42179,헤이츠/Noun,1,1,0,1.1115310228308472e-05,0.0,1.0
42180,))<</Punctuation,1,1,0,1.1115310228308472e-05,0.0,1.0
42181,))((/Punctuation,1,1,0,1.1115310228308472e-05,0.0,1.0
42182,김범수/Noun,1,0,1,0.0,1.1106915165381966e-05,1.0
42183,"1,492/Number",1,0,1,0.0,1.1106915165381966e-05,1.0
42184,마츠켄/Noun,1,0,1,0.0,1.1106915165381966e-05,1.0
42185,~!~~!/Punctuation,1,1,0,1.1115310228308472e-05,0.0,1.0
42186,조쿤/Noun,1,1,0,1.1115310228308472e-05,0.0,1.0
42187,탁자/Noun,1,0,1,0.0,1.1106915165381966e-05,1.0
42188,유리컵/Noun,1,0,1,0.0,1.1106915165381966e-05,1.0
42189,처선/Noun,1,0,1,0.0,1.1106915165381966e-05,1.0
42190,오소/Noun,1,0,1,0.0,1.1106915165381966e-05,1.0
42191,꼬질꼬질/Noun,1,0,1,0.0,1.1106915165381966e-05,1.0
42192,쿠보즈카/Noun,1,1,0,1.1115310228308472e-05,0.0,1.0
42193,~~~~\(^/Punctuation,1,1,0,1.1115310228308472e-05,0.0,1.0
42194,나시/Noun,1,1,0,1.1115310228308472e-05,0.0,1.0
42195,과만/Josa,1,1,0,1.1115310228308472e-05,0.0,1.0
42196,리고동/Noun,1,1,0,1.1115310228308472e-05,0.0,1.0
42197,생로병사/Noun,1,1,0,1.1115310228308472e-05,0.0,1.0
42198,더셀/Noun,1,0,1,0.0,1.1106915165381966e-05,1.0
42199,더준/Noun,1,0,1,0.0,1.1106915165381966e-05,1.0
42200,"1,000/Number",1,0,1,0.0,1.1106915165381966e-05,1.0
42201,김철/Noun,1,0,1,0.0,1.1106915165381966e-05,1.0
42202,スカンピン/Foreign,1,1,0,1.1115310228308472e-05,0.0,1.0
42203,鈴木慶一/Foreign,1,1,0,1.1115310228308472e-05,0.0,1.0
42204,천직/Noun,1,1,0,1.1115310228308472e-05,0.0,1.0
42205,여민주/Noun,1,1,0,1.1115310228308472e-05,0.0,1.0
42206,김학/Noun,1,1,0,1.1115310228308472e-05,0.0,1.0
42207,김동영/Noun,1,1,0,1.1115310228308472e-05,0.0,1.0
42208,졸롸/Noun,1,0,1,0.0,1.1106915165381966e-05,1.0
42209,리프킨/Noun,1,0,1,0.0,1.1106915165381966e-05,1.0
42210,홫팅/Noun,1,1,0,1.1115310228308472e-05,0.0,1.0
42211,흐느껴/Noun,1,1,0,1.1115310228308472e-05,0.0,1.0
42212,한뭉큼/Noun,1,1,0,1.1115310228308472e-05,0.0,1.0
42213,야드를/Adverb,1,0,1,0.0,1.1106915165381966e-05,1.0
42214,27시간/Number,1,0,1,0.0,1.1106915165381966e-05,1.0
42215,흐헉/Noun,1,1,0,1.1115310228308472e-05,0.0,1.0
42216,지탄/Noun,1,0,1,0.0,1.1106915165381966e-05,1.0
42217,향우/Noun,1,0,1,0.0,1.1106915165381966e-05,1.0
42218,3800/Number,1,0,1,0.0,1.1106915165381966e-05,1.0
42219,수억/Modifier,1,0,1,0.0,1.1106915165381966e-05,1.0
42220,들장미소녀/Noun,1,0,1,0.0,1.1106915165381966e-05,1.0
42221,셀위/Noun,1,0,1,0.0,1.1106915165381966e-05,1.0
42222,-</Punctuation,1,0,1,0.0,1.1106915165381966e-05,1.0
42223,한성/Noun,1,1,0,1.1115310228308472e-05,0.0,1.0
42224,덜레이/Noun,1,1,0,1.1115310228308472e-05,0.0,1.0
42225,랭고/Noun,1,0,1,0.0,1.1106915165381966e-05,1.0
42226,루니툰/Noun,1,0,1,0.0,1.1106915165381966e-05,1.0
42227,대같아/Foreign,1,0,1,0.0,1.1106915165381966e-05,1.0
42228,않됫을듯/Noun,1,1,0,1.1115310228308472e-05,0.0,1.0
42229,셤기간떄/Noun,1,1,0,1.1115310228308472e-05,0.0,1.0
42230,Case/Alpha,1,1,0,1.1115310228308472e-05,0.0,1.0
42231,서플먼트/Noun,1,1,0,1.1115310228308472e-05,0.0,1.0
42232,우야/Adverb,1,0,1,0.0,1.1106915165381966e-05,1.0
42233,맞장씬/Noun,1,1,0,1.1115310228308472e-05,0.0,1.0
42234,arco/Alpha,1,1,0,1.1115310228308472e-05,0.0,1.0
42235,안되넴/Noun,1,0,1,0.0,1.1106915165381966e-05,1.0
42236,짓해/Noun,1,0,1,0.0,1.1106915165381966e-05,1.0
42237,카밀리아/Noun,1,1,0,1.1115310228308472e-05,0.0,1.0
42238,2013.6/Number,1,1,0,1.1115310228308472e-05,0.0,1.0
42239,정니콜/Noun,1,1,0,1.1115310228308472e-05,0.0,1.0
42240,하맘/Noun,1,0,1,0.0,1.1106915165381966e-05,1.0
42241,그리폰/Noun,1,1,0,1.1115310228308472e-05,0.0,1.0
42242,~~~>/Punctuation,1,1,0,1.1115310228308472e-05,0.0,1.0
42243,favorites/Alpha,1,1,0,1.1115310228308472e-05,0.0,1.0
42244,ㄷㄷㅋㅋ/KoreanParticle,1,1,0,1.1115310228308472e-05,0.0,1.0
42245,`.`/Punctuation,1,0,1,0.0,1.1106915165381966e-05,1.0
42246,왜둑/Noun,1,0,1,0.0,1.1106915165381966e-05,1.0
42247,살자잉/Noun,1,1,0,1.1115310228308472e-05,0.0,1.0
42248,악세다/Adjective,1,0,1,0.0,1.1106915165381966e-05,1.0
42249,도거라곤/Foreign,1,1,0,1.1115310228308472e-05,0.0,1.0
42250,티티티/Noun,1,0,1,0.0,1.1106915165381966e-05,1.0
42251,http://blog.naver.com/freeasabird8/220449245122/URL,1,1,0,1.1115310228308472e-05,0.0,1.0
42252,예끼/Noun,1,1,0,1.1115310228308472e-05,0.0,1.0
42253,괞챦더군/Noun,1,1,0,1.1115310228308472e-05,0.0,1.0
42254,임은주/Noun,1,1,0,1.1115310228308472e-05,0.0,1.0
42255,로봇트/Noun,1,1,0,1.1115310228308472e-05,0.0,1.0
42256,메트로놈/Noun,1,1,0,1.1115310228308472e-05,0.0,1.0
42257,.___/Punctuation,1,1,0,1.1115310228308472e-05,0.0,1.0
42258,뎃/Noun,1,1,0,1.1115310228308472e-05,0.0,1.0
42259,JOHN/Alpha,1,1,0,1.1115310228308472e-05,0.0,1.0
42260,EXTINGUISH/Alpha,1,1,0,1.1115310228308472e-05,0.0,1.0
42261,NEVER/Alpha,1,1,0,1.1115310228308472e-05,0.0,1.0
42262,CAN/Alpha,1,1,0,1.1115310228308472e-05,0.0,1.0
42263,DARKNESS/Alpha,1,1,0,1.1115310228308472e-05,0.0,1.0
42264,DARKNESSAND/Alpha,1,1,0,1.1115310228308472e-05,0.0,1.0
42265,SHINES/Alpha,1,1,0,1.1115310228308472e-05,0.0,1.0
42266,LIGHT/Alpha,1,1,0,1.1115310228308472e-05,0.0,1.0
42267,자안/Noun,1,0,1,0.0,1.1106915165381966e-05,1.0
42268,들기기아/Foreign,1,0,1,0.0,1.1106915165381966e-05,1.0
42269,이떻/Noun,1,0,1,0.0,1.1106915165381966e-05,1.0
42270,정발/Noun,1,0,1,0.0,1.1106915165381966e-05,1.0
42271,。。？/Foreign,1,1,0,1.1115310228308472e-05,0.0,1.0
42272,피파온라인/Noun,1,0,1,0.0,1.1106915165381966e-05,1.0
42273,돈텔/Noun,1,0,1,0.0,1.1106915165381966e-05,1.0
42274,야쿠시마/Noun,1,1,0,1.1115310228308472e-05,0.0,1.0
42275,셈돈/Noun,1,0,1,0.0,1.1106915165381966e-05,1.0
42276,-_-;;;;;;;;;;;;;;;;;;/Punctuation,1,0,1,0.0,1.1106915165381966e-05,1.0
42277,배부/Noun,1,0,1,0.0,1.1106915165381966e-05,1.0
42278,힘들겄다/Noun,1,0,1,0.0,1.1106915165381966e-05,1.0
42279,캄탄할/Noun,1,1,0,1.1115310228308472e-05,0.0,1.0
42280,살다/Adjective,1,0,1,0.0,1.1106915165381966e-05,1.0
42281,개업/Noun,1,0,1,0.0,1.1106915165381966e-05,1.0
42282,서식/Noun,1,0,1,0.0,1.1106915165381966e-05,1.0
42283,샤릉훼/Noun,1,1,0,1.1115310228308472e-05,0.0,1.0
42284,아미스타드/Noun,1,1,0,1.1115310228308472e-05,0.0,1.0
42285,편재/Noun,1,0,1,0.0,1.1106915165381966e-05,1.0
42286,부지역/Noun,1,0,1,0.0,1.1106915165381966e-05,1.0
42287,벡비/Noun,1,1,0,1.1115310228308472e-05,0.0,1.0
42288,컬리지/Noun,1,1,0,1.1115310228308472e-05,0.0,1.0
42289,딸링/Noun,1,0,1,0.0,1.1106915165381966e-05,1.0
42290,공채/Noun,1,0,1,0.0,1.1106915165381966e-05,1.0
42291,재방볼땐뒤/Noun,1,0,1,0.0,1.1106915165381966e-05,1.0
42292,때젤루잼/Noun,1,0,1,0.0,1.1106915165381966e-05,1.0
42293,sports/Alpha,1,1,0,1.1115310228308472e-05,0.0,1.0
42294,엄호/Noun,1,0,1,0.0,1.1106915165381966e-05,1.0
42295,공격헬기/Noun,1,0,1,0.0,1.1106915165381966e-05,1.0
42296,새마을금고/Noun,1,0,1,0.0,1.1106915165381966e-05,1.0
42297,설량/Noun,1,1,0,1.1115310228308472e-05,0.0,1.0
42298,넢어/Noun,1,0,1,0.0,1.1106915165381966e-05,1.0
42299,펠츠/Noun,1,0,1,0.0,1.1106915165381966e-05,1.0
42300,투하트/Noun,1,1,0,1.1115310228308472e-05,0.0,1.0
42301,바랫다/Noun,1,0,1,0.0,1.1106915165381966e-05,1.0
42302,스릉합니/Noun,1,1,0,1.1115310228308472e-05,0.0,1.0
42303,하들리/Noun,1,1,0,1.1115310228308472e-05,0.0,1.0
42304,또하나의약속/Noun,1,0,1,0.0,1.1106915165381966e-05,1.0
42305,쨘/Noun,1,0,1,0.0,1.1106915165381966e-05,1.0
42306,;;;;;;;;;;;;;;;;/Punctuation,1,0,1,0.0,1.1106915165381966e-05,1.0
42307,시험이군/Foreign,1,0,1,0.0,1.1106915165381966e-05,1.0
42308,TRPG/Alpha,1,0,1,0.0,1.1106915165381966e-05,1.0
42309,작이라면/Foreign,1,0,1,0.0,1.1106915165381966e-05,1.0
42310,10/9/Number,1,0,1,0.0,1.1106915165381966e-05,1.0
42311,엮시코/Noun,1,1,0,1.1115310228308472e-05,0.0,1.0
42312,정재은/Noun,1,0,1,0.0,1.1106915165381966e-05,1.0
42313,우유부단/Noun,1,0,1,0.0,1.1106915165381966e-05,1.0
42314,변소/Noun,1,0,1,0.0,1.1106915165381966e-05,1.0
42315,곁눈질끝/Noun,1,0,1,0.0,1.1106915165381966e-05,1.0
42316,연규성/Noun,1,0,1,0.0,1.1106915165381966e-05,1.0
42317,쓔/Noun,1,0,1,0.0,1.1106915165381966e-05,1.0
42318,워머신/Noun,1,1,0,1.1115310228308472e-05,0.0,1.0
42319,므고이/Noun,1,0,1,0.0,1.1106915165381966e-05,1.0
42320,다져지다/Verb,1,1,0,1.1115310228308472e-05,0.0,1.0
42321,얼밑/Noun,1,1,0,1.1115310228308472e-05,0.0,1.0
42322,..+/Punctuation,1,1,0,1.1115310228308472e-05,0.0,1.0
42323,jin/Alpha,1,1,0,1.1115310228308472e-05,0.0,1.0
42324,맘보/Noun,1,1,0,1.1115310228308472e-05,0.0,1.0
42325,03분/Number,1,0,1,0.0,1.1106915165381966e-05,1.0
42326,쿠엔텐/Noun,1,1,0,1.1115310228308472e-05,0.0,1.0
42327,446/Number,1,1,0,1.1115310228308472e-05,0.0,1.0
42328,똘기가있/Noun,1,0,1,0.0,1.1106915165381966e-05,1.0
42329,헛날/Noun,1,0,1,0.0,1.1106915165381966e-05,1.0
42330,옯다/Noun,1,0,1,0.0,1.1106915165381966e-05,1.0
42331,씨븅/Noun,1,0,1,0.0,1.1106915165381966e-05,1.0
42332,초음/Noun,1,0,1,0.0,1.1106915165381966e-05,1.0
42333,9/10/Number,1,0,1,0.0,1.1106915165381966e-05,1.0
42334,봉헌/Noun,1,1,0,1.1115310228308472e-05,0.0,1.0
42335,EAT/Alpha,1,1,0,1.1115310228308472e-05,0.0,1.0
42336,;;;.../Punctuation,1,0,1,0.0,1.1106915165381966e-05,1.0
42337,니까/Foreign,1,0,1,0.0,1.1106915165381966e-05,1.0
42338,비트쩌/Noun,1,1,0,1.1115310228308472e-05,0.0,1.0
42339,쏟아붇/Noun,1,1,0,1.1115310228308472e-05,0.0,1.0
42340,외말/Noun,1,1,0,1.1115310228308472e-05,0.0,1.0
42341,페션영상/Noun,1,1,0,1.1115310228308472e-05,0.0,1.0
42342,소크라테스/Noun,1,1,0,1.1115310228308472e-05,0.0,1.0
42343,버틴/Foreign,1,0,1,0.0,1.1106915165381966e-05,1.0
42344,?*/Punctuation,1,1,0,1.1115310228308472e-05,0.0,1.0
42345,신지아/Noun,1,1,0,1.1115310228308472e-05,0.0,1.0
42346,도안돼서/Foreign,1,0,1,0.0,1.1106915165381966e-05,1.0
42347,개객/Noun,1,1,0,1.1115310228308472e-05,0.0,1.0
42348,객객/Noun,1,1,0,1.1115310228308472e-05,0.0,1.0
42349,왕과나/Noun,1,0,1,0.0,1.1106915165381966e-05,1.0
42350,율브린너/Noun,1,0,1,0.0,1.1106915165381966e-05,1.0
42351,예쁘닼/Noun,1,1,0,1.1115310228308472e-05,0.0,1.0
42352,샤방샤방/Noun,1,1,0,1.1115310228308472e-05,0.0,1.0
42353,잉태/Noun,1,0,1,0.0,1.1106915165381966e-05,1.0
42354,소쟈/Noun,1,1,0,1.1115310228308472e-05,0.0,1.0
42355,뿜었/Noun,1,0,1,0.0,1.1106915165381966e-05,1.0
42356,걸세/Noun,1,1,0,1.1115310228308472e-05,0.0,1.0
42357,.]/Punctuation,1,1,0,1.1115310228308472e-05,0.0,1.0
42358,",,,)/Punctuation",1,1,0,1.1115310228308472e-05,0.0,1.0
42359,such/Alpha,1,1,0,1.1115310228308472e-05,0.0,1.0
42360,?^_^*/Punctuation,1,1,0,1.1115310228308472e-05,0.0,1.0
42361,쬬/Noun,1,1,0,1.1115310228308472e-05,0.0,1.0
42362,어젠다/Noun,1,0,1,0.0,1.1106915165381966e-05,1.0
42363,홍정희/Noun,1,0,1,0.0,1.1106915165381966e-05,1.0
42364,완전채/Noun,1,0,1,0.0,1.1106915165381966e-05,1.0
42365,괴성괴/Noun,1,0,1,0.0,1.1106915165381966e-05,1.0
42366,새털/Noun,1,0,1,0.0,1.1106915165381966e-05,1.0
42367,통념/Noun,1,0,1,0.0,1.1106915165381966e-05,1.0
42368,이칸희/Noun,1,0,1,0.0,1.1106915165381966e-05,1.0
42369,주필/Noun,1,1,0,1.1115310228308472e-05,0.0,1.0
42370,번거롭다/Adjective,1,1,0,1.1115310228308472e-05,0.0,1.0
42371,해산/Noun,1,0,1,0.0,1.1106915165381966e-05,1.0
42372,앗차/Noun,1,1,0,1.1115310228308472e-05,0.0,1.0
42373,GLOCK/Alpha,1,1,0,1.1115310228308472e-05,0.0,1.0
42374,옥살이/Noun,1,1,0,1.1115310228308472e-05,0.0,1.0
42375,했었더랬다/Noun,1,1,0,1.1115310228308472e-05,0.0,1.0
42376,자동소총/Noun,1,0,1,0.0,1.1106915165381966e-05,1.0
42377,포로수용소/Noun,1,0,1,0.0,1.1106915165381966e-05,1.0
42378,이클립스/Noun,1,1,0,1.1115310228308472e-05,0.0,1.0
42379,'/;'/Punctuation,1,0,1,0.0,1.1106915165381966e-05,1.0
42380,병일/Noun,1,1,0,1.1115310228308472e-05,0.0,1.0
42381,알쯔/Noun,1,1,0,1.1115310228308472e-05,0.0,1.0
42382,.....…/Punctuation,1,0,1,0.0,1.1106915165381966e-05,1.0
42383,마이키/Noun,1,1,0,1.1115310228308472e-05,0.0,1.0
42384,fxxxck/Alpha,1,0,1,0.0,1.1106915165381966e-05,1.0
42385,티애/Noun,1,0,1,0.0,1.1106915165381966e-05,1.0
42386,배빗/Noun,1,1,0,1.1115310228308472e-05,0.0,1.0
42387,헛수고/Noun,1,0,1,0.0,1.1106915165381966e-05,1.0
42388,..&&&/Punctuation,1,1,0,1.1115310228308472e-05,0.0,1.0
42389,!!!^&^/Punctuation,1,1,0,1.1115310228308472e-05,0.0,1.0
42390,475/Number,1,0,1,0.0,1.1106915165381966e-05,1.0
42391,헛봤군/Noun,1,1,0,1.1115310228308472e-05,0.0,1.0
42392,잘봤슴/Noun,1,1,0,1.1115310228308472e-05,0.0,1.0
42393,힐스/Noun,1,1,0,1.1115310228308472e-05,0.0,1.0
42394,베벌리/Noun,1,1,0,1.1115310228308472e-05,0.0,1.0
42395,줭/Noun,1,0,1,0.0,1.1106915165381966e-05,1.0
42396,18%/Number,1,1,0,1.1115310228308472e-05,0.0,1.0
42397,!~!~!/Punctuation,1,1,0,1.1115310228308472e-05,0.0,1.0
42398,!~!~/Punctuation,1,1,0,1.1115310228308472e-05,0.0,1.0
42399,재밌엇엉/Noun,1,1,0,1.1115310228308472e-05,0.0,1.0
42400,빈대/Noun,1,0,1,0.0,1.1106915165381966e-05,1.0
42401,카자흐/Noun,1,0,1,0.0,1.1106915165381966e-05,1.0
42402,.^__^//Punctuation,1,1,0,1.1115310228308472e-05,0.0,1.0
42403,표절킴/Noun,1,0,1,0.0,1.1106915165381966e-05,1.0
42404,괘안쿠/Noun,1,1,0,1.1115310228308472e-05,0.0,1.0
42405,Romance/Alpha,1,1,0,1.1115310228308472e-05,0.0,1.0
42406,체험판/Noun,1,0,1,0.0,1.1106915165381966e-05,1.0
42407,동안본/Foreign,1,0,1,0.0,1.1106915165381966e-05,1.0
42408,바람결/Noun,1,1,0,1.1115310228308472e-05,0.0,1.0
42409,힘들엇구/Noun,1,1,0,1.1115310228308472e-05,0.0,1.0
42410,위계/Noun,1,0,1,0.0,1.1106915165381966e-05,1.0
42411,적위/Noun,1,1,0,1.1115310228308472e-05,0.0,1.0
42412,헠헠/Exclamation,1,1,0,1.1115310228308472e-05,0.0,1.0
42413,우악스럽다/Adjective,1,1,0,1.1115310228308472e-05,0.0,1.0
42414,안광/Noun,1,1,0,1.1115310228308472e-05,0.0,1.0
42415,비루/Noun,1,1,0,1.1115310228308472e-05,0.0,1.0
42416,",................/Punctuation",1,1,0,1.1115310228308472e-05,0.0,1.0
42417,앨련/Noun,1,0,1,0.0,1.1106915165381966e-05,1.0
42418,~^^~/Punctuation,1,1,0,1.1115310228308472e-05,0.0,1.0
42419,단치/Noun,1,0,1,0.0,1.1106915165381966e-05,1.0
42420,asdasdasdasd/Alpha,1,0,1,0.0,1.1106915165381966e-05,1.0
42421,유토좀/Noun,1,1,0,1.1115310228308472e-05,0.0,1.0
42422,지온/Noun,1,1,0,1.1115310228308472e-05,0.0,1.0
42423,51회/Number,1,1,0,1.1115310228308472e-05,0.0,1.0
42424,맥주잔/Noun,1,0,1,0.0,1.1106915165381966e-05,1.0
42425,보옴/Noun,1,0,1,0.0,1.1106915165381966e-05,1.0
42426,감시자/Noun,1,1,0,1.1115310228308472e-05,0.0,1.0
42427,스테파낙/Noun,1,1,0,1.1115310228308472e-05,0.0,1.0
42428,썻었을거/Noun,1,0,1,0.0,1.1106915165381966e-05,1.0
42429,가옥/Noun,1,0,1,0.0,1.1106915165381966e-05,1.0
42430,헷갈렷/Noun,1,1,0,1.1115310228308472e-05,0.0,1.0
42431,설호/Noun,1,0,1,0.0,1.1106915165381966e-05,1.0
42432,묘술/Noun,1,0,1,0.0,1.1106915165381966e-05,1.0
42433,태닝/Noun,1,0,1,0.0,1.1106915165381966e-05,1.0
42434,씀/Foreign,1,0,1,0.0,1.1106915165381966e-05,1.0
42435,수인/Noun,1,1,0,1.1115310228308472e-05,0.0,1.0
42436,능빔/Noun,1,0,1,0.0,1.1106915165381966e-05,1.0
42437,차이밍량/Noun,1,0,1,0.0,1.1106915165381966e-05,1.0
42438,나빼썅/Noun,1,0,1,0.0,1.1106915165381966e-05,1.0
42439,먹는모습/Noun,1,1,0,1.1115310228308472e-05,0.0,1.0
42440,개걸/Noun,1,1,0,1.1115310228308472e-05,0.0,1.0
42441,민방위/Noun,1,0,1,0.0,1.1106915165381966e-05,1.0
42442,왕씨/Noun,1,0,1,0.0,1.1106915165381966e-05,1.0
42443,안봣을껄/Noun,1,0,1,0.0,1.1106915165381966e-05,1.0
42444,게임방/Noun,1,0,1,0.0,1.1106915165381966e-05,1.0
42445,무음/Noun,1,0,1,0.0,1.1106915165381966e-05,1.0
42446,촟같/Noun,1,0,1,0.0,1.1106915165381966e-05,1.0
42447,못생겻다/Noun,1,0,1,0.0,1.1106915165381966e-05,1.0
42448,토글/Noun,1,0,1,0.0,1.1106915165381966e-05,1.0
42449,을듯/Noun,1,1,0,1.1115310228308472e-05,0.0,1.0
42450,목서/Noun,1,0,1,0.0,1.1106915165381966e-05,1.0
42451,1436만/Number,1,1,0,1.1115310228308472e-05,0.0,1.0
42452,껄끄럽다/Noun,1,0,1,0.0,1.1106915165381966e-05,1.0
42453,롹앤롤/Noun,1,1,0,1.1115310228308472e-05,0.0,1.0
42454,감리교/Noun,1,1,0,1.1115310228308472e-05,0.0,1.0
42455,장로교/Noun,1,1,0,1.1115310228308472e-05,0.0,1.0
42456,박정식/Noun,1,1,0,1.1115310228308472e-05,0.0,1.0
42457,용과/Noun,1,0,1,0.0,1.1106915165381966e-05,1.0
42458,폭류/Noun,1,1,0,1.1115310228308472e-05,0.0,1.0
42459,난덨/Noun,1,1,0,1.1115310228308472e-05,0.0,1.0
42460,대인지뢰/Noun,1,1,0,1.1115310228308472e-05,0.0,1.0
42461,58분/Number,1,0,1,0.0,1.1106915165381966e-05,1.0
42462,젠거/Noun,1,0,1,0.0,1.1106915165381966e-05,1.0
42463,졈/Noun,1,1,0,1.1115310228308472e-05,0.0,1.0
42464,스편/Noun,1,1,0,1.1115310228308472e-05,0.0,1.0
42465,일대종사/Noun,1,0,1,0.0,1.1106915165381966e-05,1.0
42466,장체/Noun,1,0,1,0.0,1.1106915165381966e-05,1.0
42467,프리버즈/Noun,1,0,1,0.0,1.1106915165381966e-05,1.0
42468,노래씬/Noun,1,0,1,0.0,1.1106915165381966e-05,1.0
42469,손아섭/Noun,1,1,0,1.1115310228308472e-05,0.0,1.0
42470,전껀데/Foreign,1,1,0,1.1115310228308472e-05,0.0,1.0
42471,거릴때/Noun,1,0,1,0.0,1.1106915165381966e-05,1.0
42472,9.36/Number,1,0,1,0.0,1.1106915165381966e-05,1.0
42473,중학생시절/Noun,1,1,0,1.1115310228308472e-05,0.0,1.0
42474,Wjfdma/Alpha,1,1,0,1.1115310228308472e-05,0.0,1.0
42475,됭어/Noun,1,0,1,0.0,1.1106915165381966e-05,1.0
42476,ㅡㅂ/KoreanParticle,1,0,1,0.0,1.1106915165381966e-05,1.0
42477,은건/Noun,1,0,1,0.0,1.1106915165381966e-05,1.0
42478,완젼좋아/Noun,1,1,0,1.1115310228308472e-05,0.0,1.0
42479,이옥/Noun,1,1,0,1.1115310228308472e-05,0.0,1.0
42480,5000/Number,1,0,1,0.0,1.1106915165381966e-05,1.0
42481,근거리/Noun,1,0,1,0.0,1.1106915165381966e-05,1.0
42482,았었다/Noun,1,1,0,1.1115310228308472e-05,0.0,1.0
42483,긍금/Noun,1,0,1,0.0,1.1106915165381966e-05,1.0
42484,곤곤/Noun,1,0,1,0.0,1.1106915165381966e-05,1.0
42485,랩터/Noun,1,0,1,0.0,1.1106915165381966e-05,1.0
42486,늘씬/Adverb,1,0,1,0.0,1.1106915165381966e-05,1.0
42487,봄볕/Noun,1,1,0,1.1115310228308472e-05,0.0,1.0
42488,거뭐애/Noun,1,0,1,0.0,1.1106915165381966e-05,1.0
42489,볼려곸/Noun,1,1,0,1.1115310228308472e-05,0.0,1.0
42490,sos/Alpha,1,0,1,0.0,1.1106915165381966e-05,1.0
42491,VTR/Alpha,1,1,0,1.1115310228308472e-05,0.0,1.0
42492,창창하다/Adjective,1,0,1,0.0,1.1106915165381966e-05,1.0
42493,...-_-;;;.../Punctuation,1,0,1,0.0,1.1106915165381966e-05,1.0
42494,제잠스는/Noun,1,0,1,0.0,1.1106915165381966e-05,1.0
42495,smile/Alpha,1,1,0,1.1115310228308472e-05,0.0,1.0
42496,대만도/Foreign,1,0,1,0.0,1.1106915165381966e-05,1.0
42497,혜안/Noun,1,1,0,1.1115310228308472e-05,0.0,1.0
42498,섹하/Noun,1,0,1,0.0,1.1106915165381966e-05,1.0
42499,취할지/Noun,1,0,1,0.0,1.1106915165381966e-05,1.0
42500,ㅗㅅㅎ/KoreanParticle,1,0,1,0.0,1.1106915165381966e-05,1.0
42501,ㅔㅈ/KoreanParticle,1,0,1,0.0,1.1106915165381966e-05,1.0
42502,ㅑㄱ/KoreanParticle,1,0,1,0.0,1.1106915165381966e-05,1.0
42503,홉제/Noun,1,0,1,0.0,1.1106915165381966e-05,1.0
42504,볻제/Noun,1,0,1,0.0,1.1106915165381966e-05,1.0
42505,봊/Noun,1,0,1,0.0,1.1106915165381966e-05,1.0
42506,ㅔㅐㄴㅇ/KoreanParticle,1,0,1,0.0,1.1106915165381966e-05,1.0
42507,샹먀/Noun,1,0,1,0.0,1.1106915165381966e-05,1.0
42508,ㅓㄴ/KoreanParticle,1,0,1,0.0,1.1106915165381966e-05,1.0
42509,Africa/Alpha,1,1,0,1.1115310228308472e-05,0.0,1.0
42510,Nowhere/Alpha,1,1,0,1.1115310228308472e-05,0.0,1.0
42511,전에봤던영화/Foreign,1,1,0,1.1115310228308472e-05,0.0,1.0
42512,겨울나기/Noun,1,0,1,0.0,1.1106915165381966e-05,1.0
42513,패불/Noun,1,1,0,1.1115310228308472e-05,0.0,1.0
42514,몸캠/Noun,1,0,1,0.0,1.1106915165381966e-05,1.0
42515,샵섁기들/Noun,1,1,0,1.1115310228308472e-05,0.0,1.0
42516,"...,,./Punctuation",1,0,1,0.0,1.1106915165381966e-05,1.0
42517,쏱아내/Noun,1,0,1,0.0,1.1106915165381966e-05,1.0
42518,코모/Noun,1,0,1,0.0,1.1106915165381966e-05,1.0
42519,밀짚모자/Noun,1,1,0,1.1115310228308472e-05,0.0,1.0
42520,정신사/Noun,1,0,1,0.0,1.1106915165381966e-05,1.0
42521,도완이/Noun,1,0,1,0.0,1.1106915165381966e-05,1.0
42522,개압되/Noun,1,0,1,0.0,1.1106915165381966e-05,1.0
42523,티뷔/Noun,1,1,0,1.1115310228308472e-05,0.0,1.0
42524,5만유로/Number,1,1,0,1.1115310228308472e-05,0.0,1.0
42525,몬쓰/Noun,1,0,1,0.0,1.1106915165381966e-05,1.0
42526,장택기/Noun,1,0,1,0.0,1.1106915165381966e-05,1.0
42527,프로파일/Noun,1,1,0,1.1115310228308472e-05,0.0,1.0
42528,룸살롱/Noun,1,0,1,0.0,1.1106915165381966e-05,1.0
42529,007-1/Number,1,1,0,1.1115310228308472e-05,0.0,1.0
42530,가우/Noun,1,1,0,1.1115310228308472e-05,0.0,1.0
42531,!!~!!!~~@!!~~!/Punctuation,1,1,0,1.1115310228308472e-05,0.0,1.0
42532,도협/Noun,1,0,1,0.0,1.1106915165381966e-05,1.0
42533,매조키즘/Noun,1,0,1,0.0,1.1106915165381966e-05,1.0
42534,새디즘/Noun,1,0,1,0.0,1.1106915165381966e-05,1.0
42535,혓바늘/Noun,1,0,1,0.0,1.1106915165381966e-05,1.0
42536,부둥키다/Verb,1,1,0,1.1115310228308472e-05,0.0,1.0
42537,뭉칫돈/Noun,1,1,0,1.1115310228308472e-05,0.0,1.0
42538,샬림씨/Noun,1,1,0,1.1115310228308472e-05,0.0,1.0
42539,골칫/Noun,1,0,1,0.0,1.1106915165381966e-05,1.0
42540,구리면/Noun,1,0,1,0.0,1.1106915165381966e-05,1.0
42541,상륙씬/Noun,1,1,0,1.1115310228308472e-05,0.0,1.0
42542,⊙⊙/Foreign,1,0,1,0.0,1.1106915165381966e-05,1.0
42543,축카/Noun,1,0,1,0.0,1.1106915165381966e-05,1.0
42544,슈케/Noun,1,0,1,0.0,1.1106915165381966e-05,1.0
42545,스탭아니/Noun,1,1,0,1.1115310228308472e-05,0.0,1.0
42546,춘향가/Noun,1,1,0,1.1115310228308472e-05,0.0,1.0
42547,콜드/Noun,1,0,1,0.0,1.1106915165381966e-05,1.0
42548,셋업/Noun,1,0,1,0.0,1.1106915165381966e-05,1.0
42549,눈색/Noun,1,0,1,0.0,1.1106915165381966e-05,1.0
42550,초인종/Noun,1,0,1,0.0,1.1106915165381966e-05,1.0
42551,"..,...,../Punctuation",1,1,0,1.1115310228308472e-05,0.0,1.0
42552,박리나/Noun,1,0,1,0.0,1.1106915165381966e-05,1.0
42553,김선혜/Noun,1,0,1,0.0,1.1106915165381966e-05,1.0
42554,..........................!/Punctuation,1,1,0,1.1115310228308472e-05,0.0,1.0
42555,페기/Noun,1,1,0,1.1115310228308472e-05,0.0,1.0
42556,롭좀비/Noun,1,0,1,0.0,1.1106915165381966e-05,1.0
42557,어젠/Noun,1,1,0,1.1115310228308472e-05,0.0,1.0
42558,외임/Noun,1,1,0,1.1115310228308472e-05,0.0,1.0
42559,이동주/Noun,1,1,0,1.1115310228308472e-05,0.0,1.0
42560,^;;/Punctuation,1,0,1,0.0,1.1106915165381966e-05,1.0
42561,영건/Noun,1,0,1,0.0,1.1106915165381966e-05,1.0
42562,햏/Noun,1,0,1,0.0,1.1106915165381966e-05,1.0
42563,선채/Noun,1,1,0,1.1115310228308472e-05,0.0,1.0
42564,늙었슴/Noun,1,0,1,0.0,1.1106915165381966e-05,1.0
42565,이오니/Noun,1,1,0,1.1115310228308472e-05,0.0,1.0
42566,선적/Noun,1,0,1,0.0,1.1106915165381966e-05,1.0
42567,우스갯소리/Noun,1,0,1,0.0,1.1106915165381966e-05,1.0
42568,손도끼/Noun,1,0,1,0.0,1.1106915165381966e-05,1.0
42569,소시/Noun,1,0,1,0.0,1.1106915165381966e-05,1.0
42570,합동/Noun,1,0,1,0.0,1.1106915165381966e-05,1.0
42571,power/Alpha,1,1,0,1.1115310228308472e-05,0.0,1.0
42572,곳피/Noun,1,0,1,0.0,1.1106915165381966e-05,1.0
42573,날려/Noun,1,0,1,0.0,1.1106915165381966e-05,1.0
42574,12121212/Number,1,0,1,0.0,1.1106915165381966e-05,1.0
42575,영화각본/Noun,1,0,1,0.0,1.1106915165381966e-05,1.0
42576,luxury/Alpha,1,0,1,0.0,1.1106915165381966e-05,1.0
42577,보넹/Noun,1,0,1,0.0,1.1106915165381966e-05,1.0
42578,바협/Noun,1,1,0,1.1115310228308472e-05,0.0,1.0
42579,rkaehdwjrdlqslek/Alpha,1,1,0,1.1115310228308472e-05,0.0,1.0
42580,예쉡/Noun,1,1,0,1.1115310228308472e-05,0.0,1.0
42581,왜봐/Noun,1,0,1,0.0,1.1106915165381966e-05,1.0
42582,배씬/Noun,1,0,1,0.0,1.1106915165381966e-05,1.0
42583,whddkdy/Alpha,1,1,0,1.1115310228308472e-05,0.0,1.0
42584,shfodrk/Alpha,1,1,0,1.1115310228308472e-05,0.0,1.0
42585,~~~:)/Punctuation,1,1,0,1.1115310228308472e-05,0.0,1.0
42586,계수/Noun,1,1,0,1.1115310228308472e-05,0.0,1.0
42587,주바/Noun,1,1,0,1.1115310228308472e-05,0.0,1.0
42588,샘잼/Noun,1,1,0,1.1115310228308472e-05,0.0,1.0
42589,이다되어가지만/Foreign,1,1,0,1.1115310228308472e-05,0.0,1.0
42590,nono/Alpha,1,0,1,0.0,1.1106915165381966e-05,1.0
42591,.-_/Punctuation,1,1,0,1.1115310228308472e-05,0.0,1.0
42592,다이지/Noun,1,1,0,1.1115310228308472e-05,0.0,1.0
42593,암모니아/Noun,1,1,0,1.1115310228308472e-05,0.0,1.0
42594,잭바/Noun,1,1,0,1.1115310228308472e-05,0.0,1.0
42595,생방왜함/Noun,1,0,1,0.0,1.1106915165381966e-05,1.0
42596,자꼬/Noun,1,0,1,0.0,1.1106915165381966e-05,1.0
42597,lp/Alpha,1,1,0,1.1115310228308472e-05,0.0,1.0
42598,굿윌헌팅도쩐당/Noun,1,1,0,1.1115310228308472e-05,0.0,1.0
42599,영화봣는/Noun,1,0,1,0.0,1.1106915165381966e-05,1.0
42600,린드/Noun,1,0,1,0.0,1.1106915165381966e-05,1.0
42601,밤새우다/Verb,1,1,0,1.1115310228308472e-05,0.0,1.0
42602,젬없는/Noun,1,0,1,0.0,1.1106915165381966e-05,1.0
42603,신혁/Noun,1,1,0,1.1115310228308472e-05,0.0,1.0
42604,강혁/Noun,1,1,0,1.1115310228308472e-05,0.0,1.0
42605,서하은/Noun,1,1,0,1.1115310228308472e-05,0.0,1.0
42606,ㅋㅋㅋㅎㅎㅎ/KoreanParticle,1,1,0,1.1115310228308472e-05,0.0,1.0
42607,명월/Noun,1,1,0,1.1115310228308472e-05,0.0,1.0
42608,나태주/Noun,1,1,0,1.1115310228308472e-05,0.0,1.0
42609,ver/Alpha,1,1,0,1.1115310228308472e-05,0.0,1.0
42610,호열/Noun,1,0,1,0.0,1.1106915165381966e-05,1.0
42611,격일/Noun,1,0,1,0.0,1.1106915165381966e-05,1.0
42612,부란/Noun,1,0,1,0.0,1.1106915165381966e-05,1.0
42613,2424/Number,1,0,1,0.0,1.1106915165381966e-05,1.0
42614,보다가관둠/Foreign,1,0,1,0.0,1.1106915165381966e-05,1.0
42615,심햇/Noun,1,0,1,0.0,1.1106915165381966e-05,1.0
42616,걍/Noun,1,1,0,1.1115310228308472e-05,0.0,1.0
42617,천연두/Noun,1,0,1,0.0,1.1106915165381966e-05,1.0
42618,Answer/Alpha,1,0,1,0.0,1.1106915165381966e-05,1.0
42619,후륭하군/Noun,1,1,0,1.1115310228308472e-05,0.0,1.0
42620,주감/Noun,1,0,1,0.0,1.1106915165381966e-05,1.0
42621,저만큼/Noun,1,0,1,0.0,1.1106915165381966e-05,1.0
42622,감독닝/Noun,1,0,1,0.0,1.1106915165381966e-05,1.0
42623,쫑파티했/Noun,1,0,1,0.0,1.1106915165381966e-05,1.0
42624,이훨씬지났지만/Foreign,1,1,0,1.1115310228308472e-05,0.0,1.0
42625,홍계훈/Noun,1,1,0,1.1115310228308472e-05,0.0,1.0
42626,접검/Noun,1,0,1,0.0,1.1106915165381966e-05,1.0
42627,유성호/Noun,1,0,1,0.0,1.1106915165381966e-05,1.0
42628,흐읏/Noun,1,1,0,1.1115310228308472e-05,0.0,1.0
42629,!!!!!!!!!!!!!!!!!!!!!!!!!!!!!!!!!!!!!!!!!!!!!!!!!!!!!!!!!!!!/Punctuation,1,1,0,1.1115310228308472e-05,0.0,1.0
42630,떻/Noun,1,1,0,1.1115310228308472e-05,0.0,1.0
42631,앙금/Noun,1,0,1,0.0,1.1106915165381966e-05,1.0
42632,ㅠㅕㄹ/KoreanParticle,1,0,1,0.0,1.1106915165381966e-05,1.0
42633,묘뉴/Noun,1,0,1,0.0,1.1106915165381966e-05,1.0
42634,-_-!/Punctuation,1,1,0,1.1115310228308472e-05,0.0,1.0
42635,프로토스/Noun,1,0,1,0.0,1.1106915165381966e-05,1.0
42636,풀업/Noun,1,0,1,0.0,1.1106915165381966e-05,1.0
42637,노업/Noun,1,0,1,0.0,1.1106915165381966e-05,1.0
42638,흡연량/Noun,1,0,1,0.0,1.1106915165381966e-05,1.0
42639,여짜리/Foreign,1,0,1,0.0,1.1106915165381966e-05,1.0
42640,넓적하다/Adjective,1,0,1,0.0,1.1106915165381966e-05,1.0
42641,읮/Noun,1,1,0,1.1115310228308472e-05,0.0,1.0
42642,대영화가뭐/Foreign,1,1,0,1.1115310228308472e-05,0.0,1.0
42643,후일담/Noun,1,1,0,1.1115310228308472e-05,0.0,1.0
42644,동화작가/Noun,1,0,1,0.0,1.1106915165381966e-05,1.0
42645,존트/Noun,1,0,1,0.0,1.1106915165381966e-05,1.0
42646,BORING/Alpha,1,0,1,0.0,1.1106915165381966e-05,1.0
42647,PEACE/Alpha,1,1,0,1.1115310228308472e-05,0.0,1.0
42648,절대반지/Noun,1,0,1,0.0,1.1106915165381966e-05,1.0
42649,우윀/Noun,1,0,1,0.0,1.1106915165381966e-05,1.0
42650,어렷을떄/Noun,1,1,0,1.1115310228308472e-05,0.0,1.0
42651,개쓹/Noun,1,0,1,0.0,1.1106915165381966e-05,1.0
42652,캐롤송/Noun,1,1,0,1.1115310228308472e-05,0.0,1.0
42653,오두막/Noun,1,0,1,0.0,1.1106915165381966e-05,1.0
42654,엿듣는/Noun,1,1,0,1.1115310228308472e-05,0.0,1.0
42655,슬럼/Noun,1,1,0,1.1115310228308472e-05,0.0,1.0
42656,꼽길/Noun,1,1,0,1.1115310228308472e-05,0.0,1.0
42657,구잘/Noun,1,0,1,0.0,1.1106915165381966e-05,1.0
42658,벸/Noun,1,0,1,0.0,1.1106915165381966e-05,1.0
42659,이나주고본건데/Foreign,1,0,1,0.0,1.1106915165381966e-05,1.0
42660,79분/Number,1,1,0,1.1115310228308472e-05,0.0,1.0
42661,?....?/Punctuation,1,0,1,0.0,1.1106915165381966e-05,1.0
42662,대딘/Noun,1,1,0,1.1115310228308472e-05,0.0,1.0
42663,박민지/Noun,1,1,0,1.1115310228308472e-05,0.0,1.0
42664,스팀펑크/Noun,1,0,1,0.0,1.1106915165381966e-05,1.0
42665,ㅜㄷ/KoreanParticle,1,1,0,1.1115310228308472e-05,0.0,1.0
42666,규구/Noun,1,1,0,1.1115310228308472e-05,0.0,1.0
42667,듀규듀/Noun,1,1,0,1.1115310228308472e-05,0.0,1.0
42668,둣/Noun,1,1,0,1.1115310228308472e-05,0.0,1.0
42669,의학용어/Noun,1,1,0,1.1115310228308472e-05,0.0,1.0
42670,해외관광/Noun,1,1,0,1.1115310228308472e-05,0.0,1.0
42671,··/Punctuation,1,1,0,1.1115310228308472e-05,0.0,1.0
42672,백선엽/Noun,1,0,1,0.0,1.1106915165381966e-05,1.0
42673,어바인/Noun,1,1,0,1.1115310228308472e-05,0.0,1.0
42674,수다씬/Noun,1,0,1,0.0,1.1106915165381966e-05,1.0
42675,표명/Noun,1,1,0,1.1115310228308472e-05,0.0,1.0
42676,귀천도/Noun,1,0,1,0.0,1.1106915165381966e-05,1.0
42677,진절/Noun,1,0,1,0.0,1.1106915165381966e-05,1.0
42678,뮬하레/Noun,1,1,0,1.1115310228308472e-05,0.0,1.0
42679,스톰브레이커/Noun,1,0,1,0.0,1.1106915165381966e-05,1.0
42680,식식/Noun,1,0,1,0.0,1.1106915165381966e-05,1.0
42681,천명훈/Noun,1,0,1,0.0,1.1106915165381966e-05,1.0
42682,笑紅塵/Foreign,1,1,0,1.1115310228308472e-05,0.0,1.0
42683,해명글/Noun,1,0,1,0.0,1.1106915165381966e-05,1.0
42684,번역가/Noun,1,0,1,0.0,1.1106915165381966e-05,1.0
42685,死死死死/Foreign,1,0,1,0.0,1.1106915165381966e-05,1.0
42686,테니뮤/Noun,1,1,0,1.1115310228308472e-05,0.0,1.0
42687,킬로/Suffix,1,1,0,1.1115310228308472e-05,0.0,1.0
42688,진도개/Noun,1,1,0,1.1115310228308472e-05,0.0,1.0
42689,봣건/Noun,1,0,1,0.0,1.1106915165381966e-05,1.0
42690,욕보셨슴/Noun,1,0,1,0.0,1.1106915165381966e-05,1.0
42691,크로스/Noun,1,1,0,1.1115310228308472e-05,0.0,1.0
42692,뇌격/Noun,1,1,0,1.1115310228308472e-05,0.0,1.0
42693,강지원/Noun,1,1,0,1.1115310228308472e-05,0.0,1.0
42694,미키루키/Noun,1,1,0,1.1115310228308472e-05,0.0,1.0
42695,젝슨/Noun,1,1,0,1.1115310228308472e-05,0.0,1.0
42696,궅/Noun,1,1,0,1.1115310228308472e-05,0.0,1.0
42697,북두칠성/Noun,1,1,0,1.1115310228308472e-05,0.0,1.0
42698,~~~~.~~~~/Punctuation,1,1,0,1.1115310228308472e-05,0.0,1.0
42699,이귀/Noun,1,1,0,1.1115310228308472e-05,0.0,1.0
42700,다녀왓습니/Noun,1,1,0,1.1115310228308472e-05,0.0,1.0
42701,치웨텔/Noun,1,1,0,1.1115310228308472e-05,0.0,1.0
42702,왜봣음/Noun,1,0,1,0.0,1.1106915165381966e-05,1.0
42703,셧주엇어/Noun,1,1,0,1.1115310228308472e-05,0.0,1.0
42704,풍금/Noun,1,1,0,1.1115310228308472e-05,0.0,1.0
42705,못띠/Noun,1,1,0,1.1115310228308472e-05,0.0,1.0
42706,뻥친뒤/Noun,1,1,0,1.1115310228308472e-05,0.0,1.0
42707,마르텡/Noun,1,0,1,0.0,1.1106915165381966e-05,1.0
42708,배성우/Noun,1,0,1,0.0,1.1106915165381966e-05,1.0
42709,자갈/Noun,1,0,1,0.0,1.1106915165381966e-05,1.0
42710,잭리처/Noun,1,0,1,0.0,1.1106915165381966e-05,1.0
42711,핓빛/Noun,1,0,1,0.0,1.1106915165381966e-05,1.0
42712,https://youtu.be/ftjlJ-kt_Dw/URL,1,0,1,0.0,1.1106915165381966e-05,1.0
42713,녹취본/Noun,1,0,1,0.0,1.1106915165381966e-05,1.0
42714,홍성민/Noun,1,0,1,0.0,1.1106915165381966e-05,1.0
42715,양택조/Noun,1,0,1,0.0,1.1106915165381966e-05,1.0
42716,동조자/Noun,1,1,0,1.1115310228308472e-05,0.0,1.0
42717,거렁뱅/Noun,1,0,1,0.0,1.1106915165381966e-05,1.0
42718,광시곡/Noun,1,0,1,0.0,1.1106915165381966e-05,1.0
42719,작은새/Noun,1,0,1,0.0,1.1106915165381966e-05,1.0
42720,그흑흑흐그/Noun,1,1,0,1.1115310228308472e-05,0.0,1.0
42721,탑탠들/Noun,1,0,1,0.0,1.1106915165381966e-05,1.0
42722,의중/Noun,1,1,0,1.1115310228308472e-05,0.0,1.0
42723,재섭드/Noun,1,0,1,0.0,1.1106915165381966e-05,1.0
42724,재첩국/Noun,1,0,1,0.0,1.1106915165381966e-05,1.0
42725,원미연/Noun,1,0,1,0.0,1.1106915165381966e-05,1.0
42726,김가연/Noun,1,0,1,0.0,1.1106915165381966e-05,1.0
42727,((?)/Punctuation,1,1,0,1.1115310228308472e-05,0.0,1.0
42728,쟁나/Noun,1,1,0,1.1115310228308472e-05,0.0,1.0
42729,슬비/Noun,1,1,0,1.1115310228308472e-05,0.0,1.0
42730,시에라마드레/Noun,1,1,0,1.1115310228308472e-05,0.0,1.0
42731,삼식이/Noun,1,1,0,1.1115310228308472e-05,0.0,1.0
42732,다담/Noun,1,0,1,0.0,1.1106915165381966e-05,1.0
42733,웃픈영화/Noun,1,1,0,1.1115310228308472e-05,0.0,1.0
42734,ㅎㅋㅋㅎ/KoreanParticle,1,1,0,1.1115310228308472e-05,0.0,1.0
42735,궁금케/Noun,1,1,0,1.1115310228308472e-05,0.0,1.0
42736,냑/Noun,1,0,1,0.0,1.1106915165381966e-05,1.0
42737,전문교육/Noun,1,0,1,0.0,1.1106915165381966e-05,1.0
42738,위압/Noun,1,1,0,1.1115310228308472e-05,0.0,1.0
42739,백색/Noun,1,1,0,1.1115310228308472e-05,0.0,1.0
42740,폭삭/Noun,1,0,1,0.0,1.1106915165381966e-05,1.0
42741,□/Foreign,1,1,0,1.1115310228308472e-05,0.0,1.0
42742,졋다/Noun,1,1,0,1.1115310228308472e-05,0.0,1.0
42743,둔감하다/Adjective,1,0,1,0.0,1.1106915165381966e-05,1.0
42744,분교/Noun,1,0,1,0.0,1.1106915165381966e-05,1.0
42745,...==/Punctuation,1,0,1,0.0,1.1106915165381966e-05,1.0
42746,삐걱/Noun,1,0,1,0.0,1.1106915165381966e-05,1.0
42747,머찌/Noun,1,1,0,1.1115310228308472e-05,0.0,1.0
42748,190분/Number,1,1,0,1.1115310228308472e-05,0.0,1.0
42749,앤볼린/Noun,1,1,0,1.1115310228308472e-05,0.0,1.0
42750,렸츰/Noun,1,1,0,1.1115310228308472e-05,0.0,1.0
42751,밟힙니/Noun,1,1,0,1.1115310228308472e-05,0.0,1.0
42752,원단/Noun,1,0,1,0.0,1.1106915165381966e-05,1.0
42753,돈애/Noun,1,0,1,0.0,1.1106915165381966e-05,1.0
42754,짤릴까봐/Noun,1,0,1,0.0,1.1106915165381966e-05,1.0
42755,됴노흐/Noun,1,0,1,0.0,1.1106915165381966e-05,1.0
42756,뺴앗긴/Noun,1,0,1,0.0,1.1106915165381966e-05,1.0
42757,에플랙/Noun,1,0,1,0.0,1.1106915165381966e-05,1.0
42758,조종간/Noun,1,1,0,1.1115310228308472e-05,0.0,1.0
42759,shgurwo/Alpha,1,1,0,1.1115310228308472e-05,0.0,1.0
42760,짬퐁/Noun,1,0,1,0.0,1.1106915165381966e-05,1.0
42761,시컨스/Noun,1,0,1,0.0,1.1106915165381966e-05,1.0
42762,죽어뿌/Noun,1,0,1,0.0,1.1106915165381966e-05,1.0
42763,논바닥/Noun,1,0,1,0.0,1.1106915165381966e-05,1.0
42764,뻉소/Noun,1,0,1,0.0,1.1106915165381966e-05,1.0
42765,뙁/Noun,1,1,0,1.1115310228308472e-05,0.0,1.0
42766,반산트/Noun,1,1,0,1.1115310228308472e-05,0.0,1.0
42767,`~!/Punctuation,1,1,0,1.1115310228308472e-05,0.0,1.0
42768,싸인회/Noun,1,0,1,0.0,1.1106915165381966e-05,1.0
42769,예보/Noun,1,0,1,0.0,1.1106915165381966e-05,1.0
42770,문고/Noun,1,0,1,0.0,1.1106915165381966e-05,1.0
42771,교보/Noun,1,0,1,0.0,1.1106915165381966e-05,1.0
42772,타임스퀘어/Noun,1,0,1,0.0,1.1106915165381966e-05,1.0
42773,유보트/Noun,1,1,0,1.1115310228308472e-05,0.0,1.0
42774,쓰레깊/Noun,1,0,1,0.0,1.1106915165381966e-05,1.0
42775,gecko/Alpha,1,1,0,1.1115310228308472e-05,0.0,1.0
42776,whoami/Alpha,1,1,0,1.1115310228308472e-05,0.0,1.0
42777,어메이징스파이더맨/Noun,1,0,1,0.0,1.1106915165381966e-05,1.0
42778,>../Punctuation,1,1,0,1.1115310228308472e-05,0.0,1.0
42779,류안/Noun,1,0,1,0.0,1.1106915165381966e-05,1.0
42780,밀린씨즌/Noun,1,1,0,1.1115310228308472e-05,0.0,1.0
42781,연평도/Noun,1,0,1,0.0,1.1106915165381966e-05,1.0
42782,우솝/Noun,1,0,1,0.0,1.1106915165381966e-05,1.0
42783,굿드/Noun,1,1,0,1.1115310228308472e-05,0.0,1.0
42784,추로/Noun,1,0,1,0.0,1.1106915165381966e-05,1.0
42785,부령/Noun,1,0,1,0.0,1.1106915165381966e-05,1.0
42786,졸긔/Noun,1,1,0,1.1115310228308472e-05,0.0,1.0
42787,노면/Noun,1,1,0,1.1115310228308472e-05,0.0,1.0
42788,짜린데스토리진행도를/Foreign,1,1,0,1.1115310228308472e-05,0.0,1.0
42789,동네이장/Noun,1,0,1,0.0,1.1106915165381966e-05,1.0
42790,널려/Noun,1,0,1,0.0,1.1106915165381966e-05,1.0
42791,도국/Noun,1,1,0,1.1115310228308472e-05,0.0,1.0
42792,경환님/Noun,1,1,0,1.1115310228308472e-05,0.0,1.0
42793,세번쨰/Noun,1,0,1,0.0,1.1106915165381966e-05,1.0
42794,완저언/Noun,1,1,0,1.1115310228308472e-05,0.0,1.0
42795,작물/Noun,1,0,1,0.0,1.1106915165381966e-05,1.0
42796,역모/Noun,1,0,1,0.0,1.1106915165381966e-05,1.0
42797,병판/Noun,1,0,1,0.0,1.1106915165381966e-05,1.0
42798,흰곰/Noun,1,0,1,0.0,1.1106915165381966e-05,1.0
42799,진짜뭐햐/Noun,1,0,1,0.0,1.1106915165381966e-05,1.0
42800,고래밥/Noun,1,0,1,0.0,1.1106915165381966e-05,1.0
42801,☆☆☆☆/Foreign,1,1,0,1.1115310228308472e-05,0.0,1.0
42802,삼대/Noun,1,0,1,0.0,1.1106915165381966e-05,1.0
42803,종혁님짱/Noun,1,1,0,1.1115310228308472e-05,0.0,1.0
42804,;;~/Punctuation,1,1,0,1.1115310228308472e-05,0.0,1.0
42805,빡차/Noun,1,0,1,0.0,1.1106915165381966e-05,1.0
42806,용민/Noun,1,1,0,1.1115310228308472e-05,0.0,1.0
42807,웹캠/Noun,1,1,0,1.1115310228308472e-05,0.0,1.0
42808,개쯔레기/Noun,1,0,1,0.0,1.1106915165381966e-05,1.0
42809,븅유/Noun,1,0,1,0.0,1.1106915165381966e-05,1.0
42810,2~300/Number,1,1,0,1.1115310228308472e-05,0.0,1.0
42811,UTIFUL/Alpha,1,1,0,1.1115310228308472e-05,0.0,1.0
42812,전꺼다/Foreign,1,0,1,0.0,1.1106915165381966e-05,1.0
42813,볼리베어/Noun,1,0,1,0.0,1.1106915165381966e-05,1.0
42814,자긍/Noun,1,1,0,1.1115310228308472e-05,0.0,1.0
42815,청직/Noun,1,0,1,0.0,1.1106915165381966e-05,1.0
42816,마포구/Noun,1,0,1,0.0,1.1106915165381966e-05,1.0
42817,싹싹/Noun,1,0,1,0.0,1.1106915165381966e-05,1.0
42818,ㅇㅈㄹ/KoreanParticle,1,0,1,0.0,1.1106915165381966e-05,1.0
42819,accident/Alpha,1,1,0,1.1115310228308472e-05,0.0,1.0
42820,당희/Noun,1,1,0,1.1115310228308472e-05,0.0,1.0
42821,핑돌기/Noun,1,1,0,1.1115310228308472e-05,0.0,1.0
42822,찬홍/Noun,1,1,0,1.1115310228308472e-05,0.0,1.0
42823,박서방/Noun,1,0,1,0.0,1.1106915165381966e-05,1.0
42824,실종자/Noun,1,0,1,0.0,1.1106915165381966e-05,1.0
42825,넷째/Noun,1,0,1,0.0,1.1106915165381966e-05,1.0
42826,중궈쨔응/Noun,1,0,1,0.0,1.1106915165381966e-05,1.0
42827,캉/Noun,1,0,1,0.0,1.1106915165381966e-05,1.0
42828,까무러치/Noun,1,1,0,1.1115310228308472e-05,0.0,1.0
42829,미끄러지다/Verb,1,0,1,0.0,1.1106915165381966e-05,1.0
42830,중략/Noun,1,1,0,1.1115310228308472e-05,0.0,1.0
42831,경포/Noun,1,1,0,1.1115310228308472e-05,0.0,1.0
42832,~~~~~~~~~~~~~~~~~~~~~~~~~~~~~~~~~~~~~~~/Punctuation,1,1,0,1.1115310228308472e-05,0.0,1.0
42833,닯/Noun,1,1,0,1.1115310228308472e-05,0.0,1.0
42834,바넬/Noun,1,1,0,1.1115310228308472e-05,0.0,1.0
42835,결제해서/Foreign,1,0,1,0.0,1.1106915165381966e-05,1.0
42836,생긴앨/Noun,1,0,1,0.0,1.1106915165381966e-05,1.0
42837,수설/Noun,1,0,1,0.0,1.1106915165381966e-05,1.0
42838,횡성/Noun,1,0,1,0.0,1.1106915165381966e-05,1.0
42839,yours/Alpha,1,1,0,1.1115310228308472e-05,0.0,1.0
42840,퍼귓/Noun,1,0,1,0.0,1.1106915165381966e-05,1.0
42841,프런트탓/Noun,1,1,0,1.1115310228308472e-05,0.0,1.0
42842,교단/Noun,1,0,1,0.0,1.1106915165381966e-05,1.0
42843,2.92/Number,1,0,1,0.0,1.1106915165381966e-05,1.0
42844,XEBEC/Alpha,1,1,0,1.1115310228308472e-05,0.0,1.0
42845,자회사/Noun,1,1,0,1.1115310228308472e-05,0.0,1.0
42846,..?..../Punctuation,1,0,1,0.0,1.1106915165381966e-05,1.0
42847,원슬러/Noun,1,1,0,1.1115310228308472e-05,0.0,1.0
42848,황금색/Noun,1,1,0,1.1115310228308472e-05,0.0,1.0
42849,디트로이트/Noun,1,1,0,1.1115310228308472e-05,0.0,1.0
42850,완수/Noun,1,0,1,0.0,1.1106915165381966e-05,1.0
42851,Ｘ/Foreign,1,0,1,0.0,1.1106915165381966e-05,1.0
42852,이탈리아인/Noun,1,1,0,1.1115310228308472e-05,0.0,1.0
42853,비실이/Noun,1,1,0,1.1115310228308472e-05,0.0,1.0
42854,Beyond/Alpha,1,1,0,1.1115310228308472e-05,0.0,1.0
42855,콰/Noun,1,0,1,0.0,1.1106915165381966e-05,1.0
42856,눈탱/Noun,1,0,1,0.0,1.1106915165381966e-05,1.0
42857,뉘뮈/Noun,1,0,1,0.0,1.1106915165381966e-05,1.0
42858,걸렷습/Noun,1,0,1,0.0,1.1106915165381966e-05,1.0
42859,모이라/Noun,1,1,0,1.1115310228308472e-05,0.0,1.0
42860,겔러그/Noun,1,0,1,0.0,1.1106915165381966e-05,1.0
42861,궨찮음/Noun,1,1,0,1.1115310228308472e-05,0.0,1.0
42862,만드렁/Noun,1,0,1,0.0,1.1106915165381966e-05,1.0
42863,롱샷/Noun,1,1,0,1.1115310228308472e-05,0.0,1.0
42864,택할/Noun,1,1,0,1.1115310228308472e-05,0.0,1.0
42865,싄같아/Noun,1,1,0,1.1115310228308472e-05,0.0,1.0
42866,개으른/Noun,1,1,0,1.1115310228308472e-05,0.0,1.0
42867,ENTERTAINING/Alpha,1,1,0,1.1115310228308472e-05,0.0,1.0
42868,EPIC/Alpha,1,1,0,1.1115310228308472e-05,0.0,1.0
42869,SUPERB/Alpha,1,1,0,1.1115310228308472e-05,0.0,1.0
42870,육백만/Noun,1,0,1,0.0,1.1106915165381966e-05,1.0
42871,"&,/Punctuation",1,0,1,0.0,1.1106915165381966e-05,1.0
42872,떌/Noun,1,1,0,1.1115310228308472e-05,0.0,1.0
42873,땅개/Noun,1,0,1,0.0,1.1106915165381966e-05,1.0
42874,빛돌/Noun,1,1,0,1.1115310228308472e-05,0.0,1.0
42875,여객선/Noun,1,0,1,0.0,1.1106915165381966e-05,1.0
42876,아란훼즈/Noun,1,1,0,1.1115310228308472e-05,0.0,1.0
42877,슭/Noun,1,0,1,0.0,1.1106915165381966e-05,1.0
42878,없슭/Noun,1,0,1,0.0,1.1106915165381966e-05,1.0
42879,배슭/Noun,1,0,1,0.0,1.1106915165381966e-05,1.0
42880,플래쉬백/Noun,1,0,1,0.0,1.1106915165381966e-05,1.0
42881,갈아턴다/Noun,1,0,1,0.0,1.1106915165381966e-05,1.0
42882,저팬/Noun,1,1,0,1.1115310228308472e-05,0.0,1.0
42883,래인/Noun,1,1,0,1.1115310228308472e-05,0.0,1.0
42884,브로마이드/Noun,1,1,0,1.1115310228308472e-05,0.0,1.0
42885,???//??///Punctuation,1,0,1,0.0,1.1106915165381966e-05,1.0
42886,않드네/Noun,1,0,1,0.0,1.1106915165381966e-05,1.0
42887,우는씬/Noun,1,1,0,1.1115310228308472e-05,0.0,1.0
42888,8.86/Number,1,0,1,0.0,1.1106915165381966e-05,1.0
42889,점란좀/Noun,1,1,0,1.1115310228308472e-05,0.0,1.0
42890,슈라토/Noun,1,0,1,0.0,1.1106915165381966e-05,1.0
42891,순국/Noun,1,1,0,1.1115310228308472e-05,0.0,1.0
42892,돌려봣던/Noun,1,1,0,1.1115310228308472e-05,0.0,1.0
42893,오태식/Noun,1,0,1,0.0,1.1106915165381966e-05,1.0
42894,안생겻/Noun,1,0,1,0.0,1.1106915165381966e-05,1.0
42895,프뷁/Noun,1,1,0,1.1115310228308472e-05,0.0,1.0
42896,terrible/Alpha,1,0,1,0.0,1.1106915165381966e-05,1.0
42897,변태가면/Noun,1,0,1,0.0,1.1106915165381966e-05,1.0
42898,관갹들/Noun,1,0,1,0.0,1.1106915165381966e-05,1.0
42899,순신/Noun,1,0,1,0.0,1.1106915165381966e-05,1.0
42900,어슬프도/Noun,1,0,1,0.0,1.1106915165381966e-05,1.0
42901,보피/Noun,1,0,1,0.0,1.1106915165381966e-05,1.0
42902,뭐냥/Noun,1,0,1,0.0,1.1106915165381966e-05,1.0
42903,번더봄/Noun,1,1,0,1.1115310228308472e-05,0.0,1.0
42904,아동성학대/Noun,1,0,1,0.0,1.1106915165381966e-05,1.0
42905,건앤로/Noun,1,1,0,1.1115310228308472e-05,0.0,1.0
42906,ㄲㄱ/KoreanParticle,1,1,0,1.1115310228308472e-05,0.0,1.0
42907,핟러/Noun,1,1,0,1.1115310228308472e-05,0.0,1.0
42908,해장국/Noun,1,0,1,0.0,1.1106915165381966e-05,1.0
42909,대작품이라고믿기어렵네요/Foreign,1,1,0,1.1115310228308472e-05,0.0,1.0
42910,~!*^^*/Punctuation,1,1,0,1.1115310228308472e-05,0.0,1.0
42911,국운/Noun,1,1,0,1.1115310228308472e-05,0.0,1.0
42912,잼난/Noun,1,0,1,0.0,1.1106915165381966e-05,1.0
42913,중파/Noun,1,0,1,0.0,1.1106915165381966e-05,1.0
42914,도더전에/Foreign,1,1,0,1.1115310228308472e-05,0.0,1.0
42915,killig/Alpha,1,0,1,0.0,1.1106915165381966e-05,1.0
42916,드가자/Noun,1,1,0,1.1115310228308472e-05,0.0,1.0
42917,수합/Noun,1,1,0,1.1115310228308472e-05,0.0,1.0
42918,훤씬더/Noun,1,0,1,0.0,1.1106915165381966e-05,1.0
42919,아라우/Noun,1,0,1,0.0,1.1106915165381966e-05,1.0
42920,엃/Noun,1,0,1,0.0,1.1106915165381966e-05,1.0
42921,리카르도/Noun,1,0,1,0.0,1.1106915165381966e-05,1.0
42922,어끄제/Noun,1,1,0,1.1115310228308472e-05,0.0,1.0
42923,동안부터/Foreign,1,0,1,0.0,1.1106915165381966e-05,1.0
42924,프훗/Noun,1,0,1,0.0,1.1106915165381966e-05,1.0
42925,쿵작/Noun,1,0,1,0.0,1.1106915165381966e-05,1.0
42926,주씨/Noun,1,1,0,1.1115310228308472e-05,0.0,1.0
42927,List/Alpha,1,0,1,0.0,1.1106915165381966e-05,1.0
42928,Crap/Alpha,1,0,1,0.0,1.1106915165381966e-05,1.0
42929,훠얼/Noun,1,0,1,0.0,1.1106915165381966e-05,1.0
42930,덕혐들/Noun,1,1,0,1.1115310228308472e-05,0.0,1.0
42931,vida/Alpha,1,1,0,1.1115310228308472e-05,0.0,1.0
42932,viva/Alpha,1,1,0,1.1115310228308472e-05,0.0,1.0
42933,사람사람/Noun,1,0,1,0.0,1.1106915165381966e-05,1.0
42934,대스러운/Foreign,1,0,1,0.0,1.1106915165381966e-05,1.0
42935,밋따/Noun,1,1,0,1.1115310228308472e-05,0.0,1.0
42936,독제/Noun,1,0,1,0.0,1.1106915165381966e-05,1.0
42937,만오천원/Noun,1,0,1,0.0,1.1106915165381966e-05,1.0
42938,쉬멜/Noun,1,1,0,1.1115310228308472e-05,0.0,1.0
42939,위저드/Noun,1,0,1,0.0,1.1106915165381966e-05,1.0
42940,키취/Noun,1,1,0,1.1115310228308472e-05,0.0,1.0
42941,스텐바/Noun,1,0,1,0.0,1.1106915165381966e-05,1.0
42942,무등/Noun,1,0,1,0.0,1.1106915165381966e-05,1.0
42943,국희/Noun,1,1,0,1.1115310228308472e-05,0.0,1.0
42944,밌다/Noun,1,1,0,1.1115310228308472e-05,0.0,1.0
42945,전이라니/Foreign,1,1,0,1.1115310228308472e-05,0.0,1.0
42946,사육사/Noun,1,1,0,1.1115310228308472e-05,0.0,1.0
42947,청률/Noun,1,0,1,0.0,1.1106915165381966e-05,1.0
42948,꼴롱브/Noun,1,1,0,1.1115310228308472e-05,0.0,1.0
42949,뒬/Noun,1,1,0,1.1115310228308472e-05,0.0,1.0
42950,칙은/Foreign,1,1,0,1.1115310228308472e-05,0.0,1.0
42951,3원/Number,1,1,0,1.1115310228308472e-05,0.0,1.0
42952,1945/Number,1,1,0,1.1115310228308472e-05,0.0,1.0
42953,중전/Noun,1,0,1,0.0,1.1106915165381966e-05,1.0
42954,일부다처/Noun,1,0,1,0.0,1.1106915165381966e-05,1.0
42955,반좀/Noun,1,0,1,0.0,1.1106915165381966e-05,1.0
42956,지연우/Noun,1,1,0,1.1115310228308472e-05,0.0,1.0
42957,좋겧어/Noun,1,1,0,1.1115310228308472e-05,0.0,1.0
42958,철러/Noun,1,1,0,1.1115310228308472e-05,0.0,1.0
42959,슐레이터/Noun,1,0,1,0.0,1.1106915165381966e-05,1.0
42960,숙적/Noun,1,0,1,0.0,1.1106915165381966e-05,1.0
42961,장뤽/Noun,1,0,1,0.0,1.1106915165381966e-05,1.0
42962,폴른/Noun,1,0,1,0.0,1.1106915165381966e-05,1.0
42963,복제판/Noun,1,0,1,0.0,1.1106915165381966e-05,1.0
42964,disappointed/Alpha,1,0,1,0.0,1.1106915165381966e-05,1.0
42965,픽쳐/Noun,1,1,0,1.1115310228308472e-05,0.0,1.0
42966,소나무/Noun,1,1,0,1.1115310228308472e-05,0.0,1.0
42967,~~!!~~!!/Punctuation,1,1,0,1.1115310228308472e-05,0.0,1.0
42968,쨔앙/Noun,1,1,0,1.1115310228308472e-05,0.0,1.0
42969,다가는/Eomi,1,1,0,1.1115310228308472e-05,0.0,1.0
42970,closer/Alpha,1,1,0,1.1115310228308472e-05,0.0,1.0
42971,못갓엇음/Noun,1,1,0,1.1115310228308472e-05,0.0,1.0
42972,게이버/Noun,1,0,1,0.0,1.1106915165381966e-05,1.0
42973,생색/Noun,1,0,1,0.0,1.1106915165381966e-05,1.0
42974,낫슴/Noun,1,0,1,0.0,1.1106915165381966e-05,1.0
42975,가브/Noun,1,1,0,1.1115310228308472e-05,0.0,1.0
42976,Healer/Alpha,1,1,0,1.1115310228308472e-05,0.0,1.0
42977,킬자/Noun,1,0,1,0.0,1.1106915165381966e-05,1.0
42978,사회학/Noun,1,1,0,1.1115310228308472e-05,0.0,1.0
42979,밌엇/Noun,1,0,1,0.0,1.1106915165381966e-05,1.0
42980,제밋/Noun,1,1,0,1.1115310228308472e-05,0.0,1.0
42981,송환/Noun,1,0,1,0.0,1.1106915165381966e-05,1.0
42982,경유/Noun,1,0,1,0.0,1.1106915165381966e-05,1.0
42983,사할린/Noun,1,0,1,0.0,1.1106915165381966e-05,1.0
42984,카라후토/Noun,1,0,1,0.0,1.1106915165381966e-05,1.0
42985,쿠릴열도/Noun,1,0,1,0.0,1.1106915165381966e-05,1.0
42986,초에/Foreign,1,0,1,0.0,1.1106915165381966e-05,1.0
42987,선견지명/Noun,1,0,1,0.0,1.1106915165381966e-05,1.0
42988,나르시스/Noun,1,0,1,0.0,1.1106915165381966e-05,1.0
42989,유엽/Noun,1,1,0,1.1115310228308472e-05,0.0,1.0
42990,옥토버/Noun,1,1,0,1.1115310228308472e-05,0.0,1.0
42991,내츄럴/Noun,1,1,0,1.1115310228308472e-05,0.0,1.0
42992,못버/Noun,1,0,1,0.0,1.1106915165381966e-05,1.0
42993,ㅎㅈㅁ/KoreanParticle,1,1,0,1.1115310228308472e-05,0.0,1.0
42994,슬었/Noun,1,1,0,1.1115310228308472e-05,0.0,1.0
42995,부두교/Noun,1,1,0,1.1115310228308472e-05,0.0,1.0
42996,질일/Noun,1,0,1,0.0,1.1106915165381966e-05,1.0
42997,물밑/Noun,1,1,0,1.1115310228308472e-05,0.0,1.0
42998,상대성/Noun,1,1,0,1.1115310228308472e-05,0.0,1.0
42999,스탭업/Noun,1,0,1,0.0,1.1106915165381966e-05,1.0
43000,손까략넣/Noun,1,0,1,0.0,1.1106915165381966e-05,1.0
43001,ㅏㅇㅂ/KoreanParticle,1,0,1,0.0,1.1106915165381966e-05,1.0
43002,지났네/Foreign,1,1,0,1.1115310228308472e-05,0.0,1.0
43003,정신지체/Noun,1,0,1,0.0,1.1106915165381966e-05,1.0
43004,점방/Noun,1,1,0,1.1115310228308472e-05,0.0,1.0
43005,지루한거넘기면볼만해요/Foreign,1,1,0,1.1115310228308472e-05,0.0,1.0
43006,노사/Noun,1,1,0,1.1115310228308472e-05,0.0,1.0
43007,멋잇드앙/Noun,1,1,0,1.1115310228308472e-05,0.0,1.0
43008,써/Noun,1,1,0,1.1115310228308472e-05,0.0,1.0
43009,~!!!!!!!!!!!!!!!!!!!!!!!!!!!!!!!!!!!!/Punctuation,1,1,0,1.1115310228308472e-05,0.0,1.0
43010,굼바/Noun,1,1,0,1.1115310228308472e-05,0.0,1.0
43011,흠취할수/Noun,1,0,1,0.0,1.1106915165381966e-05,1.0
43012,종으/Noun,1,0,1,0.0,1.1106915165381966e-05,1.0
43013,머그/Noun,1,0,1,0.0,1.1106915165381966e-05,1.0
43014,비비고/Noun,1,1,0,1.1115310228308472e-05,0.0,1.0
43015,Less/Alpha,1,1,0,1.1115310228308472e-05,0.0,1.0
43016,김종은/Noun,1,1,0,1.1115310228308472e-05,0.0,1.0
43017,복수씬/Noun,1,0,1,0.0,1.1106915165381966e-05,1.0
43018,춘화/Noun,1,1,0,1.1115310228308472e-05,0.0,1.0
43019,일상다반사/Noun,1,1,0,1.1115310228308472e-05,0.0,1.0
43020,말해/Noun,1,0,1,0.0,1.1106915165381966e-05,1.0
43021,.....................-/Punctuation,1,0,1,0.0,1.1106915165381966e-05,1.0
43022,사리면/Noun,1,0,1,0.0,1.1106915165381966e-05,1.0
43023,메디치가/Noun,1,1,0,1.1115310228308472e-05,0.0,1.0
43024,이탈리아사/Noun,1,1,0,1.1115310228308472e-05,0.0,1.0
43025,엄청쌘/Noun,1,0,1,0.0,1.1106915165381966e-05,1.0
43026,집게/Noun,1,0,1,0.0,1.1106915165381966e-05,1.0
43027,11억원/Number,1,0,1,0.0,1.1106915165381966e-05,1.0
43028,600억원/Number,1,0,1,0.0,1.1106915165381966e-05,1.0
43029,@~@/Punctuation,1,1,0,1.1115310228308472e-05,0.0,1.0
43030,연풍/Noun,1,1,0,1.1115310228308472e-05,0.0,1.0
43031,되어랏/Noun,1,0,1,0.0,1.1106915165381966e-05,1.0
43032,쓱쓱/Noun,1,1,0,1.1115310228308472e-05,0.0,1.0
43033,그뤰린즈/Noun,1,1,0,1.1115310228308472e-05,0.0,1.0
43034,곽객/Noun,1,1,0,1.1115310228308472e-05,0.0,1.0
43035,시아/Noun,1,1,0,1.1115310228308472e-05,0.0,1.0
43036,톱줄/Noun,1,1,0,1.1115310228308472e-05,0.0,1.0
43037,즌까지/Foreign,1,1,0,1.1115310228308472e-05,0.0,1.0
43038,탐지기/Noun,1,1,0,1.1115310228308472e-05,0.0,1.0
43039,덴치/Noun,1,1,0,1.1115310228308472e-05,0.0,1.0
43040,잘피/Noun,1,0,1,0.0,1.1106915165381966e-05,1.0
43041,개근/Noun,1,0,1,0.0,1.1106915165381966e-05,1.0
43042,옥보경/Noun,1,0,1,0.0,1.1106915165381966e-05,1.0
43043,동귀비/Noun,1,0,1,0.0,1.1106915165381966e-05,1.0
43044,나왓던내용/Noun,1,1,0,1.1115310228308472e-05,0.0,1.0
43045,정반합/Noun,1,1,0,1.1115310228308472e-05,0.0,1.0
43046,보태노코/Foreign,1,0,1,0.0,1.1106915165381966e-05,1.0
43047,별꼴/Noun,1,0,1,0.0,1.1106915165381966e-05,1.0
43048,갑갑갑/Noun,1,1,0,1.1115310228308472e-05,0.0,1.0
43049,뇌구/Noun,1,1,0,1.1115310228308472e-05,0.0,1.0
43050,어슬렁거리다/Verb,1,0,1,0.0,1.1106915165381966e-05,1.0
43051,스맨/Noun,1,0,1,0.0,1.1106915165381966e-05,1.0
43052,곰국/Noun,1,0,1,0.0,1.1106915165381966e-05,1.0
43053,조민주/Noun,1,0,1,0.0,1.1106915165381966e-05,1.0
43054,한철/Noun,1,0,1,0.0,1.1106915165381966e-05,1.0
43055,의금요일이라고/Foreign,1,0,1,0.0,1.1106915165381966e-05,1.0
43056,있늣/Noun,1,0,1,0.0,1.1106915165381966e-05,1.0
43057,디럽구/Noun,1,0,1,0.0,1.1106915165381966e-05,1.0
43058,기계론/Noun,1,1,0,1.1115310228308472e-05,0.0,1.0
43059,...!!!!!!!!!/Punctuation,1,1,0,1.1115310228308472e-05,0.0,1.0
43060,죽을떄/Noun,1,1,0,1.1115310228308472e-05,0.0,1.0
43061,트리스/Noun,1,1,0,1.1115310228308472e-05,0.0,1.0
43062,템빨/Noun,1,1,0,1.1115310228308472e-05,0.0,1.0
43063,실책/Noun,1,1,0,1.1115310228308472e-05,0.0,1.0
43064,레어템/Noun,1,0,1,0.0,1.1106915165381966e-05,1.0
43065,엘릭군/Noun,1,0,1,0.0,1.1106915165381966e-05,1.0
43066,낚는자/Noun,1,0,1,0.0,1.1106915165381966e-05,1.0
43067,goooooooood/Alpha,1,1,0,1.1115310228308472e-05,0.0,1.0
43068,뽄드빨/Noun,1,0,1,0.0,1.1106915165381966e-05,1.0
43069,모렛/Noun,1,0,1,0.0,1.1106915165381966e-05,1.0
43070,일쩜/Noun,1,0,1,0.0,1.1106915165381966e-05,1.0
43071,우주쓰레기/Noun,1,0,1,0.0,1.1106915165381966e-05,1.0
43072,탄두/Noun,1,0,1,0.0,1.1106915165381966e-05,1.0
43073,plain/Alpha,1,0,1,0.0,1.1106915165381966e-05,1.0
43074,획획/Noun,1,0,1,0.0,1.1106915165381966e-05,1.0
43075,쉣임이/Noun,1,0,1,0.0,1.1106915165381966e-05,1.0
43076,falling/Alpha,1,1,0,1.1115310228308472e-05,0.0,1.0
43077,Raindrops/Alpha,1,1,0,1.1115310228308472e-05,0.0,1.0
43078,네얼간이/Noun,1,0,1,0.0,1.1106915165381966e-05,1.0
43079,",,,,,;;;;/Punctuation",1,0,1,0.0,1.1106915165381966e-05,1.0
43080,라틴어/Noun,1,1,0,1.1115310228308472e-05,0.0,1.0
43081,블루재스민/Noun,1,0,1,0.0,1.1106915165381966e-05,1.0
43082,케텍스/Noun,1,0,1,0.0,1.1106915165381966e-05,1.0
43083,테러리즘/Noun,1,1,0,1.1115310228308472e-05,0.0,1.0
43084,크킄/Noun,1,1,0,1.1115310228308472e-05,0.0,1.0
43085,다봤긔/Noun,1,1,0,1.1115310228308472e-05,0.0,1.0
43086,됐긔/Noun,1,1,0,1.1115310228308472e-05,0.0,1.0
43087,야니/Noun,1,1,0,1.1115310228308472e-05,0.0,1.0
43088,해부학교실/Noun,1,0,1,0.0,1.1106915165381966e-05,1.0
43089,---------------------------/Punctuation,1,0,1,0.0,1.1106915165381966e-05,1.0
43090,찰싹찰싹/Adverb,1,0,1,0.0,1.1106915165381966e-05,1.0
43091,맥피/Noun,1,0,1,0.0,1.1106915165381966e-05,1.0
43092,><><></Punctuation,1,1,0,1.1115310228308472e-05,0.0,1.0
43093,배터/Noun,1,1,0,1.1115310228308472e-05,0.0,1.0
43094,노바디/Noun,1,1,0,1.1115310228308472e-05,0.0,1.0
43095,직성/Noun,1,1,0,1.1115310228308472e-05,0.0,1.0
43096,노서아/Noun,1,1,0,1.1115310228308472e-05,0.0,1.0
43097,김탁환/Noun,1,1,0,1.1115310228308472e-05,0.0,1.0
43098,Husk/Alpha,1,1,0,1.1115310228308472e-05,0.0,1.0
43099,light/Alpha,1,1,0,1.1115310228308472e-05,0.0,1.0
43100,셀티/Noun,1,0,1,0.0,1.1106915165381966e-05,1.0
43101,떙떙/Noun,1,1,0,1.1115310228308472e-05,0.0,1.0
43102,별점깍으러왓음/Noun,1,0,1,0.0,1.1106915165381966e-05,1.0
43103,빢쳐/Noun,1,0,1,0.0,1.1106915165381966e-05,1.0
43104,방뇨/Noun,1,0,1,0.0,1.1106915165381966e-05,1.0
43105,노상/Noun,1,0,1,0.0,1.1106915165381966e-05,1.0
43106,백금/Noun,1,0,1,0.0,1.1106915165381966e-05,1.0
43107,거액/Noun,1,1,0,1.1115310228308472e-05,0.0,1.0
43108,뻔말/Noun,1,1,0,1.1115310228308472e-05,0.0,1.0
43109,좀뒤/Noun,1,1,0,1.1115310228308472e-05,0.0,1.0
43110,씨잼/Noun,1,0,1,0.0,1.1106915165381966e-05,1.0
43111,YG/Alpha,1,0,1,0.0,1.1106915165381966e-05,1.0
43112,목메임/Noun,1,1,0,1.1115310228308472e-05,0.0,1.0
43113,직책/Noun,1,1,0,1.1115310228308472e-05,0.0,1.0
43114,자빠졋/Noun,1,0,1,0.0,1.1106915165381966e-05,1.0
43115,꾸드/Noun,1,1,0,1.1115310228308472e-05,0.0,1.0
43116,부가가치/Noun,1,0,1,0.0,1.1106915165381966e-05,1.0
43117,반달리즘/Noun,1,0,1,0.0,1.1106915165381966e-05,1.0
43118,롯빠/Noun,1,1,0,1.1115310228308472e-05,0.0,1.0
43119,Bjork/Alpha,1,0,1,0.0,1.1106915165381966e-05,1.0
43120,우생순/Noun,1,0,1,0.0,1.1106915165381966e-05,1.0
43121,을찾아다녓다는/Foreign,1,1,0,1.1115310228308472e-05,0.0,1.0
43122,베니싱트윈/Noun,1,0,1,0.0,1.1106915165381966e-05,1.0
43123,트레비스/Noun,1,1,0,1.1115310228308472e-05,0.0,1.0
43124,비행씬/Noun,1,0,1,0.0,1.1106915165381966e-05,1.0
43125,박기형/Noun,1,0,1,0.0,1.1106915165381966e-05,1.0
43126,리즈와/Foreign,1,1,0,1.1115310228308472e-05,0.0,1.0
43127,1.2시/Number,1,1,0,1.1115310228308472e-05,0.0,1.0
43128,ma/Alpha,1,0,1,0.0,1.1106915165381966e-05,1.0
43129,드라쿨/Noun,1,1,0,1.1115310228308472e-05,0.0,1.0
43130,야근/Noun,1,0,1,0.0,1.1106915165381966e-05,1.0
43131,뉴규/Noun,1,0,1,0.0,1.1106915165381966e-05,1.0
43132,가짢/Noun,1,1,0,1.1115310228308472e-05,0.0,1.0
43133,말꼴/Noun,1,0,1,0.0,1.1106915165381966e-05,1.0
43134,560만/Number,1,0,1,0.0,1.1106915165381966e-05,1.0
43135,임박/Noun,1,0,1,0.0,1.1106915165381966e-05,1.0
43136,노래기/Noun,1,1,0,1.1115310228308472e-05,0.0,1.0
43137,xzczcvdf/Alpha,1,1,0,1.1115310228308472e-05,0.0,1.0
43138,맘때/Noun,1,1,0,1.1115310228308472e-05,0.0,1.0
43139,몸또/Noun,1,0,1,0.0,1.1106915165381966e-05,1.0
43140,층층/Noun,1,1,0,1.1115310228308472e-05,0.0,1.0
43141,포장쩌/Noun,1,0,1,0.0,1.1106915165381966e-05,1.0
43142,개장/Noun,1,0,1,0.0,1.1106915165381966e-05,1.0
43143,숨킨/Noun,1,1,0,1.1115310228308472e-05,0.0,1.0
43144,23000/Number,1,1,0,1.1115310228308472e-05,0.0,1.0
43145,울보/Noun,1,1,0,1.1115310228308472e-05,0.0,1.0
43146,건좀/Noun,1,0,1,0.0,1.1106915165381966e-05,1.0
43147,칼꼿/Noun,1,0,1,0.0,1.1106915165381966e-05,1.0
43148,윈조/Noun,1,1,0,1.1115310228308472e-05,0.0,1.0
43149,토퍼/Noun,1,0,1,0.0,1.1106915165381966e-05,1.0
43150,낚겨/Noun,1,0,1,0.0,1.1106915165381966e-05,1.0
43151,"...,.,..,.,./Punctuation",1,1,0,1.1115310228308472e-05,0.0,1.0
43152,겐다니/Noun,1,0,1,0.0,1.1106915165381966e-05,1.0
43153,?!??/Punctuation,1,1,0,1.1115310228308472e-05,0.0,1.0
43154,악키/Noun,1,1,0,1.1115310228308472e-05,0.0,1.0
43155,김현숙/Noun,1,0,1,0.0,1.1106915165381966e-05,1.0
43156,시갈영홪우/Noun,1,0,1,0.0,1.1106915165381966e-05,1.0
43157,8.79/Number,1,0,1,0.0,1.1106915165381966e-05,1.0
43158,이기술/Noun,1,0,1,0.0,1.1106915165381966e-05,1.0
43159,정범균/Noun,1,1,0,1.1115310228308472e-05,0.0,1.0
43160,홀랑/Noun,1,0,1,0.0,1.1106915165381966e-05,1.0
43161,조직폭력/Noun,1,0,1,0.0,1.1106915165381966e-05,1.0
43162,바람의화원/Noun,1,1,0,1.1115310228308472e-05,0.0,1.0
43163,아난다/Noun,1,1,0,1.1115310228308472e-05,0.0,1.0
43164,위즈/Noun,1,0,1,0.0,1.1106915165381966e-05,1.0
43165,울드/Noun,1,1,0,1.1115310228308472e-05,0.0,1.0
43166,도넘었지만/Foreign,1,1,0,1.1115310228308472e-05,0.0,1.0
43167,'_</Punctuation,1,0,1,0.0,1.1106915165381966e-05,1.0
43168,밍듀화/Noun,1,0,1,0.0,1.1106915165381966e-05,1.0
43169,시뻘겋다/Adjective,1,0,1,0.0,1.1106915165381966e-05,1.0
43170,http://bbs2.ruliweb.daum.net/gaia/do/ruliweb/family/1360/read?articleId=1597884&bbsId=G003&itemId=15/URL,1,0,1,0.0,1.1106915165381966e-05,1.0
43171,재믺대/Noun,1,1,0,1.1115310228308472e-05,0.0,1.0
43172,훈륭했다/Noun,1,1,0,1.1115310228308472e-05,0.0,1.0
43173,마음작용/Noun,1,1,0,1.1115310228308472e-05,0.0,1.0
43174,종단/Noun,1,1,0,1.1115310228308472e-05,0.0,1.0
43175,라돈/Noun,1,1,0,1.1115310228308472e-05,0.0,1.0
43176,귀순/Noun,1,0,1,0.0,1.1106915165381966e-05,1.0
43177,포도주스/Noun,1,0,1,0.0,1.1106915165381966e-05,1.0
43178,롸벗/Noun,1,1,0,1.1115310228308472e-05,0.0,1.0
43179,콘드/Noun,1,0,1,0.0,1.1106915165381966e-05,1.0
43180,김나나/Noun,1,1,0,1.1115310228308472e-05,0.0,1.0
43181,김영주/Noun,1,1,0,1.1115310228308472e-05,0.0,1.0
43182,김정운/Noun,1,1,0,1.1115310228308472e-05,0.0,1.0
43183,사현진/Noun,1,1,0,1.1115310228308472e-05,0.0,1.0
43184,명탕정/Noun,1,1,0,1.1115310228308472e-05,0.0,1.0
43185,굴딩/Noun,1,0,1,0.0,1.1106915165381966e-05,1.0
43186,블랙이글스/Noun,1,0,1,0.0,1.1106915165381966e-05,1.0
43187,왓니껴/Noun,1,0,1,0.0,1.1106915165381966e-05,1.0
43188,잼엄음/Noun,1,0,1,0.0,1.1106915165381966e-05,1.0
43189,Cooder/Alpha,1,1,0,1.1115310228308472e-05,0.0,1.0
43190,Ry/Alpha,1,1,0,1.1115310228308472e-05,0.0,1.0
43191,도까지/Foreign,1,0,1,0.0,1.1106915165381966e-05,1.0
43192,홐/Noun,1,0,1,0.0,1.1106915165381966e-05,1.0
43193,계위/Noun,1,1,0,1.1115310228308472e-05,0.0,1.0
43194,얼굴값/Noun,1,0,1,0.0,1.1106915165381966e-05,1.0
43195,하르뎀/Noun,1,1,0,1.1115310228308472e-05,0.0,1.0
43196,준마/Noun,1,0,1,0.0,1.1106915165381966e-05,1.0
43197,콩코드기/Noun,1,1,0,1.1115310228308472e-05,0.0,1.0
43198,봉역/Noun,1,1,0,1.1115310228308472e-05,0.0,1.0
43199,정소/Noun,1,1,0,1.1115310228308472e-05,0.0,1.0
43200,밍쿠찌아/Noun,1,0,1,0.0,1.1106915165381966e-05,1.0
43201,똥송/Noun,1,1,0,1.1115310228308472e-05,0.0,1.0
43202,골르다/Verb,1,1,0,1.1115310228308472e-05,0.0,1.0
43203,북경오리/Noun,1,0,1,0.0,1.1106915165381966e-05,1.0
43204,창세기/Noun,1,0,1,0.0,1.1106915165381966e-05,1.0
43205,존트라블타/Noun,1,0,1,0.0,1.1106915165381966e-05,1.0
43206,내란죄/Noun,1,0,1,0.0,1.1106915165381966e-05,1.0
43207,해들리/Noun,1,1,0,1.1115310228308472e-05,0.0,1.0
43208,라민/Noun,1,1,0,1.1115310228308472e-05,0.0,1.0
43209,대바늘/Noun,1,0,1,0.0,1.1106915165381966e-05,1.0
43210,악대/Noun,1,0,1,0.0,1.1106915165381966e-05,1.0
43211,77/Number,1,1,0,1.1115310228308472e-05,0.0,1.0
43212,Babyface/Alpha,1,1,0,1.1115310228308472e-05,0.0,1.0
43213,이영회/Noun,1,1,0,1.1115310228308472e-05,0.0,1.0
43214,이었다는/Foreign,1,1,0,1.1115310228308472e-05,0.0,1.0
43215,300억원/Number,1,1,0,1.1115310228308472e-05,0.0,1.0
43216,1000억원/Number,1,1,0,1.1115310228308472e-05,0.0,1.0
43217,세인츠/Noun,1,1,0,1.1115310228308472e-05,0.0,1.0
43218,망신살/Noun,1,0,1,0.0,1.1106915165381966e-05,1.0
43219,보대/Noun,1,1,0,1.1115310228308472e-05,0.0,1.0
43220,브랫/Noun,1,1,0,1.1115310228308472e-05,0.0,1.0
43221,아이야/Noun,1,1,0,1.1115310228308472e-05,0.0,1.0
43222,자일리톨/Noun,1,1,0,1.1115310228308472e-05,0.0,1.0
43223,뒤루/Noun,1,0,1,0.0,1.1106915165381966e-05,1.0
43224,코맥/Noun,1,1,0,1.1115310228308472e-05,0.0,1.0
43225,롸/Noun,1,0,1,0.0,1.1106915165381966e-05,1.0
43226,또뭐남/Noun,1,0,1,0.0,1.1106915165381966e-05,1.0
43227,"20,000/Number",1,0,1,0.0,1.1106915165381966e-05,1.0
43228,비비씨/Noun,1,1,0,1.1115310228308472e-05,0.0,1.0
43229,SEX/Alpha,1,0,1,0.0,1.1106915165381966e-05,1.0
43230,착시현상/Noun,1,0,1,0.0,1.1106915165381966e-05,1.0
43231,허진스/Noun,1,0,1,0.0,1.1106915165381966e-05,1.0
43232,썸앤쌈/Noun,1,0,1,0.0,1.1106915165381966e-05,1.0
43233,루벤/Noun,1,1,0,1.1115310228308472e-05,0.0,1.0
43234,교휸적/Noun,1,1,0,1.1115310228308472e-05,0.0,1.0
43235,나우유씨미/Noun,1,0,1,0.0,1.1106915165381966e-05,1.0
43236,재및음/Noun,1,1,0,1.1115310228308472e-05,0.0,1.0
43237,각거리/Noun,1,1,0,1.1115310228308472e-05,0.0,1.0
43238,로벗/Noun,1,0,1,0.0,1.1106915165381966e-05,1.0
43239,파이브/Noun,1,0,1,0.0,1.1106915165381966e-05,1.0
43240,대특영/Noun,1,0,1,0.0,1.1106915165381966e-05,1.0
43241,리렌/Noun,1,0,1,0.0,1.1106915165381966e-05,1.0
43242,밑힌놈들/Noun,1,1,0,1.1115310228308472e-05,0.0,1.0
43243,톰크로즈/Noun,1,1,0,1.1115310228308472e-05,0.0,1.0
43244,퍼펙터/Noun,1,1,0,1.1115310228308472e-05,0.0,1.0
43245,훌룡한류/Noun,1,1,0,1.1115310228308472e-05,0.0,1.0
43246,웅거/Noun,1,1,0,1.1115310228308472e-05,0.0,1.0
43247,물럿거/Noun,1,0,1,0.0,1.1106915165381966e-05,1.0
43248,왜드가/Noun,1,0,1,0.0,1.1106915165381966e-05,1.0
43249,뽐뽀/Noun,1,1,0,1.1115310228308472e-05,0.0,1.0
43250,1236547890/Number,1,1,0,1.1115310228308472e-05,0.0,1.0
43251,고등법원/Noun,1,1,0,1.1115310228308472e-05,0.0,1.0
43252,철처/Noun,1,1,0,1.1115310228308472e-05,0.0,1.0
43253,거리공연/Noun,1,1,0,1.1115310228308472e-05,0.0,1.0
43254,패러다이스/Noun,1,0,1,0.0,1.1106915165381966e-05,1.0
43255,꼭바/Noun,1,1,0,1.1115310228308472e-05,0.0,1.0
43256,편입견/Noun,1,1,0,1.1115310228308472e-05,0.0,1.0
43257,!!!?~/Punctuation,1,0,1,0.0,1.1106915165381966e-05,1.0
43258,허루내용/Noun,1,0,1,0.0,1.1106915165381966e-05,1.0
43259,갉작갉작/Adverb,1,0,1,0.0,1.1106915165381966e-05,1.0
43260,림바/Noun,1,1,0,1.1115310228308472e-05,0.0,1.0
43261,대통/Noun,1,0,1,0.0,1.1106915165381966e-05,1.0
43262,과장스멜/Noun,1,1,0,1.1115310228308472e-05,0.0,1.0
43263,안드내/Noun,1,0,1,0.0,1.1106915165381966e-05,1.0
43264,소나무야/Noun,1,1,0,1.1115310228308472e-05,0.0,1.0
43265,장승/Noun,1,1,0,1.1115310228308472e-05,0.0,1.0
43266,말좀해/Noun,1,0,1,0.0,1.1106915165381966e-05,1.0
43267,~~^^*/Punctuation,1,1,0,1.1115310228308472e-05,0.0,1.0
43268,노숙생활/Noun,1,1,0,1.1115310228308472e-05,0.0,1.0
43269,요시히코/Noun,1,1,0,1.1115310228308472e-05,0.0,1.0
43270,짤릿/Noun,1,0,1,0.0,1.1106915165381966e-05,1.0
43271,소산/Noun,1,0,1,0.0,1.1106915165381966e-05,1.0
43272,가닥/Foreign,1,0,1,0.0,1.1106915165381966e-05,1.0
43273,케리러슬/Noun,1,0,1,0.0,1.1106915165381966e-05,1.0
43274,재밌/Noun,1,0,1,0.0,1.1106915165381966e-05,1.0
43275,합쳣음/Noun,1,0,1,0.0,1.1106915165381966e-05,1.0
43276,유경아/Noun,1,1,0,1.1115310228308472e-05,0.0,1.0
43277,존귀/Noun,1,1,0,1.1115310228308472e-05,0.0,1.0
43278,나왓우/Noun,1,1,0,1.1115310228308472e-05,0.0,1.0
43279,병따개/Noun,1,0,1,0.0,1.1106915165381966e-05,1.0
43280,김미연/Noun,1,0,1,0.0,1.1106915165381966e-05,1.0
43281,개그우먼/Noun,1,0,1,0.0,1.1106915165381966e-05,1.0
43282,madd/Alpha,1,1,0,1.1115310228308472e-05,0.0,1.0
43283,건건/Noun,1,1,0,1.1115310228308472e-05,0.0,1.0
43284,꼴릿/Noun,1,1,0,1.1115310228308472e-05,0.0,1.0
43285,!!!:)/Punctuation,1,1,0,1.1115310228308472e-05,0.0,1.0
43286,싹수/Noun,1,0,1,0.0,1.1106915165381966e-05,1.0
43287,눈코뜰새/Noun,1,1,0,1.1115310228308472e-05,0.0,1.0
43288,뻘쯤/Noun,1,0,1,0.0,1.1106915165381966e-05,1.0
43289,옆방/Noun,1,0,1,0.0,1.1106915165381966e-05,1.0
43290,섬새/Noun,1,1,0,1.1115310228308472e-05,0.0,1.0
43291,이락/Noun,1,0,1,0.0,1.1106915165381966e-05,1.0
43292,자카르타/Noun,1,0,1,0.0,1.1106915165381966e-05,1.0
43293,Both/Alpha,1,1,0,1.1115310228308472e-05,0.0,1.0
43294,완젼조/Noun,1,1,0,1.1115310228308472e-05,0.0,1.0
43295,발렌티나/Noun,1,0,1,0.0,1.1106915165381966e-05,1.0
43296,이병준/Noun,1,0,1,0.0,1.1106915165381966e-05,1.0
43297,이상으로/Foreign,1,0,1,0.0,1.1106915165381966e-05,1.0
43298,턴김/Noun,1,0,1,0.0,1.1106915165381966e-05,1.0
43299,베드로/Noun,1,1,0,1.1115310228308472e-05,0.0,1.0
43300,모래사장/Noun,1,1,0,1.1115310228308472e-05,0.0,1.0
43301,남경/Noun,1,0,1,0.0,1.1106915165381966e-05,1.0
43302,토슈즈/Noun,1,0,1,0.0,1.1106915165381966e-05,1.0
43303,본조비/Noun,1,0,1,0.0,1.1106915165381966e-05,1.0
43304,슬로/Noun,1,0,1,0.0,1.1106915165381966e-05,1.0
43305,탐쿠르즈/Noun,1,0,1,0.0,1.1106915165381966e-05,1.0
43306,심파/Noun,1,0,1,0.0,1.1106915165381966e-05,1.0
43307,끼악끼악/Noun,1,0,1,0.0,1.1106915165381966e-05,1.0
43308,왁왁/Adverb,1,0,1,0.0,1.1106915165381966e-05,1.0
43309,뽈때/Noun,1,0,1,0.0,1.1106915165381966e-05,1.0
43310,우히히히/Noun,1,1,0,1.1115310228308472e-05,0.0,1.0
43311,강진아/Noun,1,1,0,1.1115310228308472e-05,0.0,1.0
43312,당귀/Noun,1,0,1,0.0,1.1106915165381966e-05,1.0
43313,비염/Noun,1,0,1,0.0,1.1106915165381966e-05,1.0
43314,소테츠/Noun,1,0,1,0.0,1.1106915165381966e-05,1.0
43315,소맷동/Noun,1,0,1,0.0,1.1106915165381966e-05,1.0
43316,재단/Noun,1,0,1,0.0,1.1106915165381966e-05,1.0
43317,총력전/Noun,1,0,1,0.0,1.1106915165381966e-05,1.0
43318,의궤/Noun,1,0,1,0.0,1.1106915165381966e-05,1.0
43319,라플라스/Noun,1,0,1,0.0,1.1106915165381966e-05,1.0
43320,볼값/Noun,1,0,1,0.0,1.1106915165381966e-05,1.0
43321,블리다/Noun,1,1,0,1.1115310228308472e-05,0.0,1.0
43322,처맥/Noun,1,1,0,1.1115310228308472e-05,0.0,1.0
43323,가름/Noun,1,1,0,1.1115310228308472e-05,0.0,1.0
43324,!!??!!!!/Punctuation,1,1,0,1.1115310228308472e-05,0.0,1.0
43325,필로/Noun,1,0,1,0.0,1.1106915165381966e-05,1.0
43326,님등른/Noun,1,1,0,1.1115310228308472e-05,0.0,1.0
43327,똑갇/Noun,1,0,1,0.0,1.1106915165381966e-05,1.0
43328,삼포/Noun,1,1,0,1.1115310228308472e-05,0.0,1.0
43329,10617/Number,1,1,0,1.1115310228308472e-05,0.0,1.0
43330,년안/Noun,1,1,0,1.1115310228308472e-05,0.0,1.0
43331,개똥임/Noun,1,1,0,1.1115310228308472e-05,0.0,1.0
43332,마네킨/Noun,1,0,1,0.0,1.1106915165381966e-05,1.0
43333,블리자드/Noun,1,0,1,0.0,1.1106915165381966e-05,1.0
43334,오로치마루/Noun,1,0,1,0.0,1.1106915165381966e-05,1.0
43335,안생겨요/Noun,1,1,0,1.1115310228308472e-05,0.0,1.0
43336,어정/Noun,1,0,1,0.0,1.1106915165381966e-05,1.0
43337,ssaki/Alpha,1,0,1,0.0,1.1106915165381966e-05,1.0
43338,아즘마들/Noun,1,1,0,1.1115310228308472e-05,0.0,1.0
43339,얍삽함/Noun,1,1,0,1.1115310228308472e-05,0.0,1.0
43340,또러이들/Noun,1,0,1,0.0,1.1106915165381966e-05,1.0
43341,맹간/Noun,1,1,0,1.1115310228308472e-05,0.0,1.0
43342,윤재몸/Noun,1,0,1,0.0,1.1106915165381966e-05,1.0
43343,이몸/Noun,1,0,1,0.0,1.1106915165381966e-05,1.0
43344,프로판/Noun,1,1,0,1.1115310228308472e-05,0.0,1.0
43345,페킨파식/Noun,1,1,0,1.1115310228308472e-05,0.0,1.0
43346,편볼때/Noun,1,1,0,1.1115310228308472e-05,0.0,1.0
43347,연료/Noun,1,0,1,0.0,1.1106915165381966e-05,1.0
43348,마츠마/Noun,1,0,1,0.0,1.1106915165381966e-05,1.0
43349,감끝/Noun,1,1,0,1.1115310228308472e-05,0.0,1.0
43350,부딫힌/Noun,1,1,0,1.1115310228308472e-05,0.0,1.0
43351,cscpansa/Alpha,1,1,0,1.1115310228308472e-05,0.0,1.0
43352,원스어폰어타임/Noun,1,0,1,0.0,1.1106915165381966e-05,1.0
43353,재활/Noun,1,0,1,0.0,1.1106915165381966e-05,1.0
43354,왕희지/Noun,1,1,0,1.1115310228308472e-05,0.0,1.0
43355,방종하다/Adjective,1,0,1,0.0,1.1106915165381966e-05,1.0
43356,패쇄/Noun,1,0,1,0.0,1.1106915165381966e-05,1.0
43357,극작가/Noun,1,0,1,0.0,1.1106915165381966e-05,1.0
43358,디옹/Noun,1,1,0,1.1115310228308472e-05,0.0,1.0
43359,뱀장어/Noun,1,1,0,1.1115310228308472e-05,0.0,1.0
43360,치약/Noun,1,0,1,0.0,1.1106915165381966e-05,1.0
43361,2084/Number,1,0,1,0.0,1.1106915165381966e-05,1.0
43362,큐빅스/Noun,1,0,1,0.0,1.1106915165381966e-05,1.0
43363,books/Alpha,1,0,1,0.0,1.1106915165381966e-05,1.0
43364,read/Alpha,1,0,1,0.0,1.1106915165381966e-05,1.0
43365,0.1만/Number,1,0,1,0.0,1.1106915165381966e-05,1.0
43366,스피닝/Noun,1,1,0,1.1115310228308472e-05,0.0,1.0
43367,유앤아이/Noun,1,1,0,1.1115310228308472e-05,0.0,1.0
43368,bbbbbb/Alpha,1,1,0,1.1115310228308472e-05,0.0,1.0
43369,"@*:;""'';;///.../Punctuation",1,1,0,1.1115310228308472e-05,0.0,1.0
43370,미치겄/Noun,1,1,0,1.1115310228308472e-05,0.0,1.0
43371,입질/Noun,1,0,1,0.0,1.1106915165381966e-05,1.0
43372,0.00001/Number,1,0,1,0.0,1.1106915165381966e-05,1.0
43373,졸쟁/Noun,1,1,0,1.1115310228308472e-05,0.0,1.0
43374,1~3위안/Number,1,1,0,1.1115310228308472e-05,0.0,1.0
43375,짜리영화인데여자들이관심을보이는건돈이랑물건크기뿐이네/Foreign,1,0,1,0.0,1.1106915165381966e-05,1.0
43376,십일/Noun,1,0,1,0.0,1.1106915165381966e-05,1.0
43377,20-09/Number,1,0,1,0.0,1.1106915165381966e-05,1.0
43378,스믈스믈/Noun,1,1,0,1.1115310228308472e-05,0.0,1.0
43379,라이프오브파이/Noun,1,1,0,1.1115310228308472e-05,0.0,1.0
43380,잔말/Noun,1,1,0,1.1115310228308472e-05,0.0,1.0
43381,너무옙허/Noun,1,1,0,1.1115310228308472e-05,0.0,1.0
43382,김민수/Noun,1,0,1,0.0,1.1106915165381966e-05,1.0
43383,별보/Noun,1,0,1,0.0,1.1106915165381966e-05,1.0
43384,대보/Noun,1,0,1,0.0,1.1106915165381966e-05,1.0
43385,보라보라/Noun,1,0,1,0.0,1.1106915165381966e-05,1.0
43386,bw/Alpha,1,0,1,0.0,1.1106915165381966e-05,1.0
43387,여전에/Foreign,1,0,1,0.0,1.1106915165381966e-05,1.0
43388,여가량/Foreign,1,0,1,0.0,1.1106915165381966e-05,1.0
43389,8.25/Number,1,0,1,0.0,1.1106915165381966e-05,1.0
43390,등판/Noun,1,1,0,1.1115310228308472e-05,0.0,1.0
43391,무승부/Noun,1,1,0,1.1115310228308472e-05,0.0,1.0
43392,투수/Noun,1,1,0,1.1115310228308472e-05,0.0,1.0
43393,나두/Noun,1,0,1,0.0,1.1106915165381966e-05,1.0
43394,잔꾀/Noun,1,0,1,0.0,1.1106915165381966e-05,1.0
43395,칼물/Noun,1,0,1,0.0,1.1106915165381966e-05,1.0
43396,핑핑/Noun,1,1,0,1.1115310228308472e-05,0.0,1.0
43397,외벽/Noun,1,1,0,1.1115310228308472e-05,0.0,1.0
43398,김혜옥/Noun,1,1,0,1.1115310228308472e-05,0.0,1.0
43399,풍습/Noun,1,1,0,1.1115310228308472e-05,0.0,1.0
43400,염전/Noun,1,1,0,1.1115310228308472e-05,0.0,1.0
43401,~*~/Punctuation,1,1,0,1.1115310228308472e-05,0.0,1.0
43402,스나입스표/Noun,1,0,1,0.0,1.1106915165381966e-05,1.0
43403,12245677/Number,1,1,0,1.1115310228308472e-05,0.0,1.0
43404,fancy/Alpha,1,1,0,1.1115310228308472e-05,0.0,1.0
43405,당빠/Noun,1,1,0,1.1115310228308472e-05,0.0,1.0
43406,한영화니/Noun,1,1,0,1.1115310228308472e-05,0.0,1.0
43407,국악/Noun,1,0,1,0.0,1.1106915165381966e-05,1.0
43408,Ktx/Alpha,1,0,1,0.0,1.1106915165381966e-05,1.0
43409,뽀대/Noun,1,0,1,0.0,1.1106915165381966e-05,1.0
43410,폐륜적/Noun,1,0,1,0.0,1.1106915165381966e-05,1.0
43411,밖에도/Josa,1,0,1,0.0,1.1106915165381966e-05,1.0
43412,집안일/Noun,1,0,1,0.0,1.1106915165381966e-05,1.0
43413,쫄딱바/Noun,1,0,1,0.0,1.1106915165381966e-05,1.0
43414,울거/Foreign,1,1,0,1.1115310228308472e-05,0.0,1.0
43415,컨피덴셜/Noun,1,0,1,0.0,1.1106915165381966e-05,1.0
43416,쨉씩/Noun,1,0,1,0.0,1.1106915165381966e-05,1.0
43417,지론/Noun,1,0,1,0.0,1.1106915165381966e-05,1.0
43418,"...,....,.../Punctuation",1,1,0,1.1115310228308472e-05,0.0,1.0
43419,약과/Noun,1,1,0,1.1115310228308472e-05,0.0,1.0
43420,이렇케/Noun,1,1,0,1.1115310228308472e-05,0.0,1.0
43421,Sam/Alpha,1,0,1,0.0,1.1106915165381966e-05,1.0
43422,97%/Number,1,1,0,1.1115310228308472e-05,0.0,1.0
43423,노부모/Noun,1,1,0,1.1115310228308472e-05,0.0,1.0
43424,...?.?...??..../Punctuation,1,0,1,0.0,1.1106915165381966e-05,1.0
43425,rnernernerne/Alpha,1,1,0,1.1115310228308472e-05,0.0,1.0
43426,알런/Noun,1,0,1,0.0,1.1106915165381966e-05,1.0
43427,cheese/Alpha,1,1,0,1.1115310228308472e-05,0.0,1.0
43428,갓놀드/Noun,1,1,0,1.1115310228308472e-05,0.0,1.0
43429,0.000000000000000001/Number,1,0,1,0.0,1.1106915165381966e-05,1.0
43430,:*)/Punctuation,1,1,0,1.1115310228308472e-05,0.0,1.0
43431,전주곡/Noun,1,0,1,0.0,1.1106915165381966e-05,1.0
43432,츄르릅/Noun,1,0,1,0.0,1.1106915165381966e-05,1.0
43433,막내딸/Noun,1,1,0,1.1115310228308472e-05,0.0,1.0
43434,건형/Noun,1,1,0,1.1115310228308472e-05,0.0,1.0
43435,..;;;;;;;;;;;;;;;;;;/Punctuation,1,0,1,0.0,1.1106915165381966e-05,1.0
43436,뺏겻느/Noun,1,1,0,1.1115310228308472e-05,0.0,1.0
43437,＋/Foreign,1,1,0,1.1115310228308472e-05,0.0,1.0
43438,더치/Noun,1,0,1,0.0,1.1106915165381966e-05,1.0
43439,^^;;;;;;;;;;;/Punctuation,1,0,1,0.0,1.1106915165381966e-05,1.0
43440,도황/Noun,1,1,0,1.1115310228308472e-05,0.0,1.0
43441,낙서장/Noun,1,0,1,0.0,1.1106915165381966e-05,1.0
43442,러브코미디/Noun,1,0,1,0.0,1.1106915165381966e-05,1.0
43443,....;_;/Punctuation,1,1,0,1.1115310228308472e-05,0.0,1.0
43444,"//,,../Punctuation",1,0,1,0.0,1.1106915165381966e-05,1.0
43445,앙꼬/Noun,1,0,1,0.0,1.1106915165381966e-05,1.0
43446,하이든/Noun,1,0,1,0.0,1.1106915165381966e-05,1.0
43447,망덕/Noun,1,0,1,0.0,1.1106915165381966e-05,1.0
43448,줄걸/Noun,1,0,1,0.0,1.1106915165381966e-05,1.0
43449,10403/Number,1,1,0,1.1115310228308472e-05,0.0,1.0
43450,임세령/Noun,1,0,1,0.0,1.1106915165381966e-05,1.0
43451,죽엿는데/Noun,1,0,1,0.0,1.1106915165381966e-05,1.0
43452,오디세이아/Noun,1,1,0,1.1115310228308472e-05,0.0,1.0
43453,영정/Noun,1,1,0,1.1115310228308472e-05,0.0,1.0
43454,용신/Noun,1,0,1,0.0,1.1106915165381966e-05,1.0
43455,보고끔/Foreign,1,0,1,0.0,1.1106915165381966e-05,1.0
43456,♥♥♥♥♥♥♥♥♥♥♥♥♥♥♥♥♥♥♥♥♥♥/Foreign,1,1,0,1.1115310228308472e-05,0.0,1.0
43457,".,.,.,.,.,.,.,.,.,/Punctuation",1,1,0,1.1115310228308472e-05,0.0,1.0
43458,Montana/Alpha,1,1,0,1.1115310228308472e-05,0.0,1.0
43459,Hannah/Alpha,1,1,0,1.1115310228308472e-05,0.0,1.0
43460,밣히는/Noun,1,1,0,1.1115310228308472e-05,0.0,1.0
43461,으로는/Foreign,1,0,1,0.0,1.1106915165381966e-05,1.0
43462,138382763/Number,1,0,1,0.0,1.1106915165381966e-05,1.0
43463,에클닥/Noun,1,1,0,1.1115310228308472e-05,0.0,1.0
43464,맷닥/Noun,1,1,0,1.1115310228308472e-05,0.0,1.0
43465,날꼬/Noun,1,0,1,0.0,1.1106915165381966e-05,1.0
43466,since/Alpha,1,1,0,1.1115310228308472e-05,0.0,1.0
43467,ddong/Alpha,1,0,1,0.0,1.1106915165381966e-05,1.0
43468,처죽/Noun,1,0,1,0.0,1.1106915165381966e-05,1.0
43469,엘레인/Noun,1,0,1,0.0,1.1106915165381966e-05,1.0
43470,악영씨었/Noun,1,1,0,1.1115310228308472e-05,0.0,1.0
43471,쫘/Noun,1,1,0,1.1115310228308472e-05,0.0,1.0
43472,뜨이다/Verb,1,1,0,1.1115310228308472e-05,0.0,1.0
43473,흉보다/Verb,1,0,1,0.0,1.1106915165381966e-05,1.0
43474,승연/Noun,1,0,1,0.0,1.1106915165381966e-05,1.0
43475,안한상탠데/Noun,1,0,1,0.0,1.1106915165381966e-05,1.0
43476,소송도/Noun,1,0,1,0.0,1.1106915165381966e-05,1.0
43477,제조업/Noun,1,0,1,0.0,1.1106915165381966e-05,1.0
43478,가십걸/Noun,1,0,1,0.0,1.1106915165381966e-05,1.0
43479,진유영/Noun,1,1,0,1.1115310228308472e-05,0.0,1.0
43480,.joonpeter@naver.com/Email,1,1,0,1.1115310228308472e-05,0.0,1.0
43481,양백/Noun,1,0,1,0.0,1.1106915165381966e-05,1.0
43482,살렷는데/Noun,1,0,1,0.0,1.1106915165381966e-05,1.0
43483,거품경제/Noun,1,1,0,1.1115310228308472e-05,0.0,1.0
43484,밑겨/Noun,1,1,0,1.1115310228308472e-05,0.0,1.0
43485,눈매/Noun,1,0,1,0.0,1.1106915165381966e-05,1.0
43486,예제/Noun,1,0,1,0.0,1.1106915165381966e-05,1.0
43487,재활용품/Noun,1,1,0,1.1115310228308472e-05,0.0,1.0
43488,카타/Noun,1,1,0,1.1115310228308472e-05,0.0,1.0
43489,티앙/Noun,1,1,0,1.1115310228308472e-05,0.0,1.0
43490,경매/Noun,1,1,0,1.1115310228308472e-05,0.0,1.0
43491,어쩌겠단/Noun,1,0,1,0.0,1.1106915165381966e-05,1.0
43492,대들보/Noun,1,0,1,0.0,1.1106915165381966e-05,1.0
43493,이소정/Noun,1,0,1,0.0,1.1106915165381966e-05,1.0
43494,스파링/Noun,1,1,0,1.1115310228308472e-05,0.0,1.0
43495,뱌쓔니들/Noun,1,0,1,0.0,1.1106915165381966e-05,1.0
43496,난투극/Noun,1,0,1,0.0,1.1106915165381966e-05,1.0
43497,차라며/Foreign,1,0,1,0.0,1.1106915165381966e-05,1.0
43498,소정씨/Noun,1,0,1,0.0,1.1106915165381966e-05,1.0
43499,짜른걸/Noun,1,0,1,0.0,1.1106915165381966e-05,1.0
43500,오상/Noun,1,0,1,0.0,1.1106915165381966e-05,1.0
43501,스티로폼/Noun,1,0,1,0.0,1.1106915165381966e-05,1.0
43502,엔팅/Noun,1,1,0,1.1115310228308472e-05,0.0,1.0
43503,그렜데/Noun,1,0,1,0.0,1.1106915165381966e-05,1.0
43504,opp/Alpha,1,0,1,0.0,1.1106915165381966e-05,1.0
43505,23345678/Number,1,0,1,0.0,1.1106915165381966e-05,1.0
43506,조비/Noun,1,1,0,1.1115310228308472e-05,0.0,1.0
43507,아흥/Noun,1,1,0,1.1115310228308472e-05,0.0,1.0
43508,랜써/Noun,1,1,0,1.1115310228308472e-05,0.0,1.0
43509,RX/Alpha,1,1,0,1.1115310228308472e-05,0.0,1.0
43510,아릇하/Noun,1,1,0,1.1115310228308472e-05,0.0,1.0
43511,뒤덥힌/Noun,1,1,0,1.1115310228308472e-05,0.0,1.0
43512,부도덕/Noun,1,1,0,1.1115310228308472e-05,0.0,1.0
43513,설음/Noun,1,0,1,0.0,1.1106915165381966e-05,1.0
43514,충분조건/Noun,1,1,0,1.1115310228308472e-05,0.0,1.0
43515,필요조건/Noun,1,1,0,1.1115310228308472e-05,0.0,1.0
43516,74분/Number,1,0,1,0.0,1.1106915165381966e-05,1.0
43517,낭독/Noun,1,0,1,0.0,1.1106915165381966e-05,1.0
43518,Living/Alpha,1,1,0,1.1115310228308472e-05,0.0,1.0
43519,Works/Alpha,1,1,0,1.1115310228308472e-05,0.0,1.0
43520,Story/Alpha,1,1,0,1.1115310228308472e-05,0.0,1.0
43521,촤하/Noun,1,0,1,0.0,1.1106915165381966e-05,1.0
43522,표현의자유/Noun,1,0,1,0.0,1.1106915165381966e-05,1.0
43523,쟈밌/Noun,1,0,1,0.0,1.1106915165381966e-05,1.0
43524,칭구들일/Noun,1,1,0,1.1115310228308472e-05,0.0,1.0
43525,울어봣던/Noun,1,1,0,1.1115310228308472e-05,0.0,1.0
43526,로디아/Noun,1,1,0,1.1115310228308472e-05,0.0,1.0
43527,졸재밌엇음/Noun,1,1,0,1.1115310228308472e-05,0.0,1.0
43528,죻타/Noun,1,1,0,1.1115310228308472e-05,0.0,1.0
43529,낚였넹/Noun,1,0,1,0.0,1.1106915165381966e-05,1.0
43530,정명석/Noun,1,0,1,0.0,1.1106915165381966e-05,1.0
43531,뻬/Noun,1,1,0,1.1115310228308472e-05,0.0,1.0
43532,복걸/Noun,1,1,0,1.1115310228308472e-05,0.0,1.0
43533,애걸/Noun,1,1,0,1.1115310228308472e-05,0.0,1.0
43534,댐벼/Noun,1,1,0,1.1115310228308472e-05,0.0,1.0
43535,@@#!@/Punctuation,1,1,0,1.1115310228308472e-05,0.0,1.0
43536,북경역/Noun,1,1,0,1.1115310228308472e-05,0.0,1.0
43537,jh/Alpha,1,0,1,0.0,1.1106915165381966e-05,1.0
43538,aks/Alpha,1,0,1,0.0,1.1106915165381966e-05,1.0
43539,파전/Noun,1,0,1,0.0,1.1106915165381966e-05,1.0
43540,녀녀녀/Noun,1,0,1,0.0,1.1106915165381966e-05,1.0
43541,흥밋/Noun,1,0,1,0.0,1.1106915165381966e-05,1.0
43542,쌍탑/Noun,1,1,0,1.1115310228308472e-05,0.0,1.0
43543,色氣/Foreign,1,0,1,0.0,1.1106915165381966e-05,1.0
43544,이구나/Foreign,1,1,0,1.1115310228308472e-05,0.0,1.0
43545,ㄹㅋ/KoreanParticle,1,0,1,0.0,1.1106915165381966e-05,1.0
43546,연장전/Noun,1,0,1,0.0,1.1106915165381966e-05,1.0
43547,즌은/Foreign,1,1,0,1.1115310228308472e-05,0.0,1.0
43548,언니네/Noun,1,1,0,1.1115310228308472e-05,0.0,1.0
43549,헛발질들/Noun,1,0,1,0.0,1.1106915165381966e-05,1.0
43550,Trilogy/Alpha,1,1,0,1.1115310228308472e-05,0.0,1.0
43551,Godfather/Alpha,1,1,0,1.1115310228308472e-05,0.0,1.0
43552,공생/Noun,1,1,0,1.1115310228308472e-05,0.0,1.0
43553,재인식/Noun,1,1,0,1.1115310228308472e-05,0.0,1.0
43554,상영작/Noun,1,0,1,0.0,1.1106915165381966e-05,1.0
43555,선명/Noun,1,1,0,1.1115310228308472e-05,0.0,1.0
43556,117분/Number,1,0,1,0.0,1.1106915165381966e-05,1.0
43557,나뭇가지/Noun,1,1,0,1.1115310228308472e-05,0.0,1.0
43558,갑갑/Noun,1,0,1,0.0,1.1106915165381966e-05,1.0
43559,スは結論を出すことができない。/Foreign,1,1,0,1.1115310228308472e-05,0.0,1.0
43560,タベ/Foreign,1,1,0,1.1115310228308472e-05,0.0,1.0
43561,デ/Foreign,1,1,0,1.1115310228308472e-05,0.0,1.0
43562,vhs/Alpha,1,0,1,0.0,1.1106915165381966e-05,1.0
43563,ㅋㅌㅌㅋ/KoreanParticle,1,0,1,0.0,1.1106915165381966e-05,1.0
43564,후유/Noun,1,1,0,1.1115310228308472e-05,0.0,1.0
43565,~~^.^/Punctuation,1,1,0,1.1115310228308472e-05,0.0,1.0
43566,우적/Adverb,1,0,1,0.0,1.1106915165381966e-05,1.0
43567,쨰려/Noun,1,0,1,0.0,1.1106915165381966e-05,1.0
43568,라일라/Noun,1,0,1,0.0,1.1106915165381966e-05,1.0
43569,델타/Noun,1,1,0,1.1115310228308472e-05,0.0,1.0
43570,60-70년/Number,1,0,1,0.0,1.1106915165381966e-05,1.0
43571,미겔/Noun,1,0,1,0.0,1.1106915165381966e-05,1.0
43572,근세/Noun,1,0,1,0.0,1.1106915165381966e-05,1.0
43573,이영자/Noun,1,1,0,1.1115310228308472e-05,0.0,1.0
43574,굼벵이/Noun,1,0,1,0.0,1.1106915165381966e-05,1.0
43575,대명천지/Noun,1,1,0,1.1115310228308472e-05,0.0,1.0
43576,펜텀/Noun,1,1,0,1.1115310228308472e-05,0.0,1.0
43577,폐곡선/Noun,1,0,1,0.0,1.1106915165381966e-05,1.0
43578,수일/Noun,1,0,1,0.0,1.1106915165381966e-05,1.0
43579,과찬/Noun,1,1,0,1.1115310228308472e-05,0.0,1.0
43580,대사간/Noun,1,0,1,0.0,1.1106915165381966e-05,1.0
43581,dance/Alpha,1,1,0,1.1115310228308472e-05,0.0,1.0
43582,Shall/Alpha,1,1,0,1.1115310228308472e-05,0.0,1.0
43583,아츠/Noun,1,0,1,0.0,1.1106915165381966e-05,1.0
43584,햇겟음/Noun,1,0,1,0.0,1.1106915165381966e-05,1.0
43585,어쩨/Noun,1,1,0,1.1115310228308472e-05,0.0,1.0
43586,콤모두스/Noun,1,0,1,0.0,1.1106915165381966e-05,1.0
43587,아우렐리우스/Noun,1,0,1,0.0,1.1106915165381966e-05,1.0
43588,마르쿠스/Noun,1,0,1,0.0,1.1106915165381966e-05,1.0
43589,피스토리우스/Noun,1,0,1,0.0,1.1106915165381966e-05,1.0
43590,기다렷/Noun,1,0,1,0.0,1.1106915165381966e-05,1.0
43591,뮌/Noun,1,0,1,0.0,1.1106915165381966e-05,1.0
43592,1932년/Number,1,1,0,1.1115310228308472e-05,0.0,1.0
43593,주전/Noun,1,1,0,1.1115310228308472e-05,0.0,1.0
43594,프리미어리그/Noun,1,1,0,1.1115310228308472e-05,0.0,1.0
43595,이뽈리뜨/Noun,1,1,0,1.1115310228308472e-05,0.0,1.0
43596,이영진/Noun,1,1,0,1.1115310228308472e-05,0.0,1.0
43597,병영/Noun,1,0,1,0.0,1.1106915165381966e-05,1.0
43598,호바/Noun,1,1,0,1.1115310228308472e-05,0.0,1.0
43599,자작나무/Noun,1,0,1,0.0,1.1106915165381966e-05,1.0
43600,았습/Noun,1,0,1,0.0,1.1106915165381966e-05,1.0
43601,501/Number,1,0,1,0.0,1.1106915165381966e-05,1.0
43602,멍믹/Noun,1,0,1,0.0,1.1106915165381966e-05,1.0
43603,그누/Noun,1,1,0,1.1115310228308472e-05,0.0,1.0
43604,전재홍/Noun,1,1,0,1.1115310228308472e-05,0.0,1.0
43605,투자/Foreign,1,1,0,1.1115310228308472e-05,0.0,1.0
43606,)>;/Punctuation,1,1,0,1.1115310228308472e-05,0.0,1.0
43607,부결/Noun,1,0,1,0.0,1.1106915165381966e-05,1.0
43608,갸루상/Noun,1,0,1,0.0,1.1106915165381966e-05,1.0
43609,끓음/Noun,1,0,1,0.0,1.1106915165381966e-05,1.0
43610,홨팅/Noun,1,1,0,1.1115310228308472e-05,0.0,1.0
43611,파블로프/Noun,1,0,1,0.0,1.1106915165381966e-05,1.0
43612,우량/Noun,1,0,1,0.0,1.1106915165381966e-05,1.0
43613,님미/Noun,1,0,1,0.0,1.1106915165381966e-05,1.0
43614,쒜발/Noun,1,0,1,0.0,1.1106915165381966e-05,1.0
43615,앙꼬없는격/Noun,1,0,1,0.0,1.1106915165381966e-05,1.0
43616,이수일/Noun,1,0,1,0.0,1.1106915165381966e-05,1.0
43617,셤/Noun,1,1,0,1.1115310228308472e-05,0.0,1.0
43618,빈민촌/Noun,1,1,0,1.1115310228308472e-05,0.0,1.0
43619,푸르스름/Noun,1,1,0,1.1115310228308472e-05,0.0,1.0
43620,쉐끠들/Noun,1,1,0,1.1115310228308472e-05,0.0,1.0
43621,시브/Noun,1,1,0,1.1115310228308472e-05,0.0,1.0
43622,■■/Foreign,1,1,0,1.1115310228308472e-05,0.0,1.0
43623,91회/Number,1,0,1,0.0,1.1106915165381966e-05,1.0
43624,AB/Alpha,1,1,0,1.1115310228308472e-05,0.0,1.0
43625,목관/Noun,1,0,1,0.0,1.1106915165381966e-05,1.0
43626,음이탈/Noun,1,0,1,0.0,1.1106915165381966e-05,1.0
43627,명콤비/Noun,1,1,0,1.1115310228308472e-05,0.0,1.0
43628,들엇네/Foreign,1,0,1,0.0,1.1106915165381966e-05,1.0
43629,9.5만/Number,1,0,1,0.0,1.1106915165381966e-05,1.0
43630,못봣는데/Noun,1,1,0,1.1115310228308472e-05,0.0,1.0
43631,잼날/Noun,1,0,1,0.0,1.1106915165381966e-05,1.0
43632,동안만/Foreign,1,0,1,0.0,1.1106915165381966e-05,1.0
43633,!^^#/Punctuation,1,1,0,1.1115310228308472e-05,0.0,1.0
43634,에는들어갈영화라고본다/Foreign,1,1,0,1.1115310228308472e-05,0.0,1.0
43635,만오해/Noun,1,0,1,0.0,1.1106915165381966e-05,1.0
43636,라쿠/Noun,1,0,1,0.0,1.1106915165381966e-05,1.0
43637,자품/Noun,1,1,0,1.1115310228308472e-05,0.0,1.0
43638,~~~~`/Punctuation,1,1,0,1.1115310228308472e-05,0.0,1.0
43639,adam/Alpha,1,1,0,1.1115310228308472e-05,0.0,1.0
43640,라는둥/Noun,1,0,1,0.0,1.1106915165381966e-05,1.0
43641,놈년/Noun,1,0,1,0.0,1.1106915165381966e-05,1.0
43642,넙/Noun,1,0,1,0.0,1.1106915165381966e-05,1.0
43643,야아압/Noun,1,0,1,0.0,1.1106915165381966e-05,1.0
43644,오연/Noun,1,1,0,1.1115310228308472e-05,0.0,1.0
43645,쿨릭하/Noun,1,0,1,0.0,1.1106915165381966e-05,1.0
43646,등굣길/Noun,1,1,0,1.1115310228308472e-05,0.0,1.0
43647,experimental/Alpha,1,0,1,0.0,1.1106915165381966e-05,1.0
43648,타이포그래피/Noun,1,0,1,0.0,1.1106915165381966e-05,1.0
43649,!@!@/Punctuation,1,0,1,0.0,1.1106915165381966e-05,1.0
43650,End/Alpha,1,1,0,1.1115310228308472e-05,0.0,1.0
43651,??!?!?!?!?/Punctuation,1,0,1,0.0,1.1106915165381966e-05,1.0
43652,가령/Noun,1,0,1,0.0,1.1106915165381966e-05,1.0
43653,이가운/Noun,1,0,1,0.0,1.1106915165381966e-05,1.0
43654,...~~~^^/Punctuation,1,1,0,1.1115310228308472e-05,0.0,1.0
43655,innocent/Alpha,1,1,0,1.1115310228308472e-05,0.0,1.0
43656,presumed/Alpha,1,1,0,1.1115310228308472e-05,0.0,1.0
43657,엄좋/Noun,1,1,0,1.1115310228308472e-05,0.0,1.0
43658,낔크/Noun,1,0,1,0.0,1.1106915165381966e-05,1.0
43659,끝냌크/Noun,1,0,1,0.0,1.1106915165381966e-05,1.0
43660,경보/Noun,1,1,0,1.1115310228308472e-05,0.0,1.0
43661,손연재/Noun,1,1,0,1.1115310228308472e-05,0.0,1.0
43662,..........^^/Punctuation,1,1,0,1.1115310228308472e-05,0.0,1.0
43663,롯소/Noun,1,1,0,1.1115310228308472e-05,0.0,1.0
43664,금토/Noun,1,1,0,1.1115310228308472e-05,0.0,1.0
43665,졸멋졸귀/Noun,1,0,1,0.0,1.1106915165381966e-05,1.0
43666,forward/Alpha,1,1,0,1.1115310228308472e-05,0.0,1.0
43667,moving/Alpha,1,1,0,1.1115310228308472e-05,0.0,1.0
43668,갯벌/Noun,1,1,0,1.1115310228308472e-05,0.0,1.0
43669,글것/Noun,1,0,1,0.0,1.1106915165381966e-05,1.0
43670,의무소방/Noun,1,0,1,0.0,1.1106915165381966e-05,1.0
43671,쵝저/Noun,1,0,1,0.0,1.1106915165381966e-05,1.0
43672,우리당/Noun,1,0,1,0.0,1.1106915165381966e-05,1.0
43673,정윤회/Noun,1,1,0,1.1115310228308472e-05,0.0,1.0
43674,십상시/Noun,1,1,0,1.1115310228308472e-05,0.0,1.0
43675,슬래싱/Noun,1,0,1,0.0,1.1106915165381966e-05,1.0
43676,컷좀/Noun,1,1,0,1.1115310228308472e-05,0.0,1.0
43677,도성은/Noun,1,0,1,0.0,1.1106915165381966e-05,1.0
43678,엽권/Noun,1,1,0,1.1115310228308472e-05,0.0,1.0
43679,.????/Punctuation,1,0,1,0.0,1.1106915165381966e-05,1.0
43680,화살표/Noun,1,0,1,0.0,1.1106915165381966e-05,1.0
43681,고봄/Noun,1,0,1,0.0,1.1106915165381966e-05,1.0
43682,껑충껑충/Adverb,1,1,0,1.1115310228308472e-05,0.0,1.0
43683,해연/Noun,1,1,0,1.1115310228308472e-05,0.0,1.0
43684,아함/Noun,1,0,1,0.0,1.1106915165381966e-05,1.0
43685,헤라/Noun,1,0,1,0.0,1.1106915165381966e-05,1.0
43686,자퇴/Noun,1,0,1,0.0,1.1106915165381966e-05,1.0
43687,등교거부/Noun,1,0,1,0.0,1.1106915165381966e-05,1.0
43688,당번/Noun,1,0,1,0.0,1.1106915165381966e-05,1.0
43689,사마귀/Noun,1,0,1,0.0,1.1106915165381966e-05,1.0
43690,HELL/Alpha,1,0,1,0.0,1.1106915165381966e-05,1.0
43691,꼬봉/Noun,1,0,1,0.0,1.1106915165381966e-05,1.0
43692,카카롯트/Noun,1,0,1,0.0,1.1106915165381966e-05,1.0
43693,가부장제/Noun,1,0,1,0.0,1.1106915165381966e-05,1.0
43694,최데/Noun,1,0,1,0.0,1.1106915165381966e-05,1.0
43695,gif/Alpha,1,0,1,0.0,1.1106915165381966e-05,1.0
43696,나무숲/Noun,1,1,0,1.1115310228308472e-05,0.0,1.0
43697,굽타/Noun,1,1,0,1.1115310228308472e-05,0.0,1.0
43698,괴협/Noun,1,0,1,0.0,1.1106915165381966e-05,1.0
43699,알게/Noun,1,0,1,0.0,1.1106915165381966e-05,1.0
43700,REMEMBER/Alpha,1,0,1,0.0,1.1106915165381966e-05,1.0
43701,카이텔/Noun,1,1,0,1.1115310228308472e-05,0.0,1.0
43702,820억엔/Number,1,0,1,0.0,1.1106915165381966e-05,1.0
43703,광역시/Noun,1,1,0,1.1115310228308472e-05,0.0,1.0
43704,뉨/Noun,1,1,0,1.1115310228308472e-05,0.0,1.0
43705,쾌거/Noun,1,1,0,1.1115310228308472e-05,0.0,1.0
43706,선댄스영화제/Noun,1,1,0,1.1115310228308472e-05,0.0,1.0
43707,돈아까버레잉/Noun,1,0,1,0.0,1.1106915165381966e-05,1.0
43708,학군/Noun,1,0,1,0.0,1.1106915165381966e-05,1.0
43709,시가지/Noun,1,0,1,0.0,1.1106915165381966e-05,1.0
43710,목동/Noun,1,0,1,0.0,1.1106915165381966e-05,1.0
43711,엘리자/Noun,1,0,1,0.0,1.1106915165381966e-05,1.0
43712,웃엇움/Noun,1,1,0,1.1115310228308472e-05,0.0,1.0
43713,kr/Alpha,1,1,0,1.1115310228308472e-05,0.0,1.0
43714,517/Number,1,1,0,1.1115310228308472e-05,0.0,1.0
43715,osh/Alpha,1,1,0,1.1115310228308472e-05,0.0,1.0
43716,소릭히/Noun,1,0,1,0.0,1.1106915165381966e-05,1.0
43717,풋사랑/Noun,1,0,1,0.0,1.1106915165381966e-05,1.0
43718,난쫌/Noun,1,0,1,0.0,1.1106915165381966e-05,1.0
43719,설전/Noun,1,1,0,1.1115310228308472e-05,0.0,1.0
43720,트톡/Noun,1,1,0,1.1115310228308472e-05,0.0,1.0
43721,도영화인데/Foreign,1,0,1,0.0,1.1106915165381966e-05,1.0
43722,입단/Noun,1,1,0,1.1115310228308472e-05,0.0,1.0
43723,메이저리거/Noun,1,0,1,0.0,1.1106915165381966e-05,1.0
43724,컨트리음악/Noun,1,1,0,1.1115310228308472e-05,0.0,1.0
43725,삐었어/Noun,1,0,1,0.0,1.1106915165381966e-05,1.0
43726,.^^;;;/Punctuation,1,1,0,1.1115310228308472e-05,0.0,1.0
43727,영빈/Noun,1,1,0,1.1115310228308472e-05,0.0,1.0
43728,ㅋㅋㅍ/KoreanParticle,1,0,1,0.0,1.1106915165381966e-05,1.0
43729,말증/Noun,1,1,0,1.1115310228308472e-05,0.0,1.0
43730,7.93/Number,1,0,1,0.0,1.1106915165381966e-05,1.0
43731,촬/Noun,1,1,0,1.1115310228308472e-05,0.0,1.0
43732,라팔/Noun,1,0,1,0.0,1.1106915165381966e-05,1.0
43733,Gate/Alpha,1,1,0,1.1115310228308472e-05,0.0,1.0
43734,Ninth/Alpha,1,1,0,1.1115310228308472e-05,0.0,1.0
43735,쩌시/Noun,1,1,0,1.1115310228308472e-05,0.0,1.0
43736,뒈/Noun,1,1,0,1.1115310228308472e-05,0.0,1.0
43737,이었다고/Foreign,1,1,0,1.1115310228308472e-05,0.0,1.0
43738,08/Number,1,1,0,1.1115310228308472e-05,0.0,1.0
43739,민물고기/Noun,1,0,1,0.0,1.1106915165381966e-05,1.0
43740,살얼음/Noun,1,1,0,1.1115310228308472e-05,0.0,1.0
43741,Innovation/Alpha,1,1,0,1.1115310228308472e-05,0.0,1.0
43742,높임말/Noun,1,0,1,0.0,1.1106915165381966e-05,1.0
43743,갓난아기/Noun,1,0,1,0.0,1.1106915165381966e-05,1.0
43744,슬림/Noun,1,1,0,1.1115310228308472e-05,0.0,1.0
43745,풍취/Noun,1,1,0,1.1115310228308472e-05,0.0,1.0
43746,으로만은/Josa,1,0,1,0.0,1.1106915165381966e-05,1.0
43747,1111/Number,1,0,1,0.0,1.1106915165381966e-05,1.0
43748,조림/Noun,1,1,0,1.1115310228308472e-05,0.0,1.0
43749,읖/Noun,1,1,0,1.1115310228308472e-05,0.0,1.0
43750,몽중/Noun,1,0,1,0.0,1.1106915165381966e-05,1.0
43751,정채/Noun,1,1,0,1.1115310228308472e-05,0.0,1.0
43752,뭘전/Noun,1,0,1,0.0,1.1106915165381966e-05,1.0
43753,델리스파이스/Noun,1,1,0,1.1115310228308472e-05,0.0,1.0
43754,삽화/Noun,1,1,0,1.1115310228308472e-05,0.0,1.0
43755,아서까지/Eomi,1,1,0,1.1115310228308472e-05,0.0,1.0
43756,드믈껴/Noun,1,1,0,1.1115310228308472e-05,0.0,1.0
43757,삼백배/Noun,1,0,1,0.0,1.1106915165381966e-05,1.0
43758,콩그레츄레이숀/Noun,1,1,0,1.1115310228308472e-05,0.0,1.0
43759,챰/Noun,1,1,0,1.1115310228308472e-05,0.0,1.0
43760,에동거한놈나타난후부터/Foreign,1,0,1,0.0,1.1106915165381966e-05,1.0
43761,1026/Number,1,0,1,0.0,1.1106915165381966e-05,1.0
43762,비자/Noun,1,0,1,0.0,1.1106915165381966e-05,1.0
43763,-@/Punctuation,1,0,1,0.0,1.1106915165381966e-05,1.0
43764,우당탕/Adverb,1,0,1,0.0,1.1106915165381966e-05,1.0
43765,리려/Noun,1,0,1,0.0,1.1106915165381966e-05,1.0
43766,외동딸/Noun,1,0,1,0.0,1.1106915165381966e-05,1.0
43767,~~*/Punctuation,1,1,0,1.1115310228308472e-05,0.0,1.0
43768,상상플러스/Noun,1,0,1,0.0,1.1106915165381966e-05,1.0
43769,타케루/Noun,1,1,0,1.1115310228308472e-05,0.0,1.0
43770,점더주껰/Noun,1,0,1,0.0,1.1106915165381966e-05,1.0
43771,♥♥♥♥♥♥♥♥♥♥♥♥♥♥♥♥♥♥♥♥♥♥♥♥/Foreign,1,1,0,1.1115310228308472e-05,0.0,1.0
43772,리눅스/Noun,1,0,1,0.0,1.1106915165381966e-05,1.0
43773,VOICE/Alpha,1,0,1,0.0,1.1106915165381966e-05,1.0
43774,GNOME/Alpha,1,0,1,0.0,1.1106915165381966e-05,1.0
43775,딧다/Noun,1,1,0,1.1115310228308472e-05,0.0,1.0
43776,돌비/Noun,1,1,0,1.1115310228308472e-05,0.0,1.0
43777,교범/Noun,1,1,0,1.1115310228308472e-05,0.0,1.0
43778,칠더스/Noun,1,1,0,1.1115310228308472e-05,0.0,1.0
43779,개맘에안듬/Noun,1,0,1,0.0,1.1106915165381966e-05,1.0
43780,가라테/Noun,1,0,1,0.0,1.1106915165381966e-05,1.0
43781,bodyline/Alpha,1,0,1,0.0,1.1106915165381966e-05,1.0
43782,백프/Noun,1,1,0,1.1115310228308472e-05,0.0,1.0
43783,음문/Noun,1,0,1,0.0,1.1106915165381966e-05,1.0
43784,김솔희/Noun,1,0,1,0.0,1.1106915165381966e-05,1.0
43785,~~!~~!/Punctuation,1,1,0,1.1115310228308472e-05,0.0,1.0
43786,별룬거같애/Noun,1,0,1,0.0,1.1106915165381966e-05,1.0
43787,모독이/Adverb,1,0,1,0.0,1.1106915165381966e-05,1.0
43788,어겐/Noun,1,0,1,0.0,1.1106915165381966e-05,1.0
43789,골든라즈베리상/Noun,1,0,1,0.0,1.1106915165381966e-05,1.0
43790,delete/Alpha,1,0,1,0.0,1.1106915165381966e-05,1.0
43791,shift/Alpha,1,0,1,0.0,1.1106915165381966e-05,1.0
43792,촘촘히/Adverb,1,1,0,1.1115310228308472e-05,0.0,1.0
43793,하록선장/Noun,1,0,1,0.0,1.1106915165381966e-05,1.0
43794,할리퀸/Noun,1,1,0,1.1115310228308472e-05,0.0,1.0
43795,00시/Number,1,1,0,1.1115310228308472e-05,0.0,1.0
43796,국가정보원/Noun,1,1,0,1.1115310228308472e-05,0.0,1.0
43797,좃망/Noun,1,0,1,0.0,1.1106915165381966e-05,1.0
43798,수간/Noun,1,0,1,0.0,1.1106915165381966e-05,1.0
43799,로켓포/Noun,1,0,1,0.0,1.1106915165381966e-05,1.0
43800,불법무기/Noun,1,0,1,0.0,1.1106915165381966e-05,1.0
43801,못갓/Noun,1,1,0,1.1115310228308472e-05,0.0,1.0
43802,각서/Noun,1,0,1,0.0,1.1106915165381966e-05,1.0
43803,젠잭/Noun,1,0,1,0.0,1.1106915165381966e-05,1.0
43804,뿩/Noun,1,0,1,0.0,1.1106915165381966e-05,1.0
43805,@@@@/Punctuation,1,1,0,1.1115310228308472e-05,0.0,1.0
43806,트위스터/Noun,1,1,0,1.1115310228308472e-05,0.0,1.0
43807,왝/Noun,1,0,1,0.0,1.1106915165381966e-05,1.0
43808,...^^;;;/Punctuation,1,1,0,1.1115310228308472e-05,0.0,1.0
43809,웃움/Noun,1,0,1,0.0,1.1106915165381966e-05,1.0
43810,sheo/Alpha,1,1,0,1.1115310228308472e-05,0.0,1.0
43811,--.../Punctuation,1,0,1,0.0,1.1106915165381966e-05,1.0
43812,안후론/Noun,1,1,0,1.1115310228308472e-05,0.0,1.0
43813,빡퉁쳐/Noun,1,1,0,1.1115310228308472e-05,0.0,1.0
43814,실형/Noun,1,0,1,0.0,1.1106915165381966e-05,1.0
43815,이즘/Noun,1,0,1,0.0,1.1106915165381966e-05,1.0
43816,노점상/Noun,1,0,1,0.0,1.1106915165381966e-05,1.0
43817,번성/Noun,1,0,1,0.0,1.1106915165381966e-05,1.0
43818,나땜/Noun,1,0,1,0.0,1.1106915165381966e-05,1.0
43819,낭았/Noun,1,0,1,0.0,1.1106915165381966e-05,1.0
43820,samjungman1@naver.com/Email,1,1,0,1.1115310228308472e-05,0.0,1.0
43821,에측/Noun,1,0,1,0.0,1.1106915165381966e-05,1.0
43822,뗬다/Noun,1,0,1,0.0,1.1106915165381966e-05,1.0
43823,가볼때/Noun,1,1,0,1.1115310228308472e-05,0.0,1.0
43824,록음악/Noun,1,0,1,0.0,1.1106915165381966e-05,1.0
43825,햇었는데/Noun,1,0,1,0.0,1.1106915165381966e-05,1.0
43826,나란데/Noun,1,0,1,0.0,1.1106915165381966e-05,1.0
43827,파고다/Noun,1,0,1,0.0,1.1106915165381966e-05,1.0
43828,손립/Noun,1,1,0,1.1115310228308472e-05,0.0,1.0
43829,손신/Noun,1,1,0,1.1115310228308472e-05,0.0,1.0
43830,도작/Foreign,1,0,1,0.0,1.1106915165381966e-05,1.0
43831,흐규흐/Noun,1,1,0,1.1115310228308472e-05,0.0,1.0
43832,알렉산드르/Noun,1,1,0,1.1115310228308472e-05,0.0,1.0
43833,혼스/Noun,1,1,0,1.1115310228308472e-05,0.0,1.0
43834,fraud/Alpha,1,1,0,1.1115310228308472e-05,0.0,1.0
43835,이훈/Noun,1,0,1,0.0,1.1106915165381966e-05,1.0
43836,~!??/Punctuation,1,0,1,0.0,1.1106915165381966e-05,1.0
43837,스핀/Noun,1,0,1,0.0,1.1106915165381966e-05,1.0
43838,삭스/Noun,1,0,1,0.0,1.1106915165381966e-05,1.0
43839,떵떵/Noun,1,0,1,0.0,1.1106915165381966e-05,1.0
43840,166626663666/Number,1,0,1,0.0,1.1106915165381966e-05,1.0
43841,8.74/Number,1,1,0,1.1115310228308472e-05,0.0,1.0
43842,디시인사이드/Noun,1,1,0,1.1115310228308472e-05,0.0,1.0
43843,라즈베리필드/Noun,1,1,0,1.1115310228308472e-05,0.0,1.0
43844,재밌겓봤/Noun,1,1,0,1.1115310228308472e-05,0.0,1.0
43845,점원/Noun,1,0,1,0.0,1.1106915165381966e-05,1.0
43846,의시간에/Foreign,1,0,1,0.0,1.1106915165381966e-05,1.0
43847,알았쟎우/Noun,1,0,1,0.0,1.1106915165381966e-05,1.0
43848,준겁/Noun,1,0,1,0.0,1.1106915165381966e-05,1.0
43849,보다끔/Foreign,1,0,1,0.0,1.1106915165381966e-05,1.0
43850,보여쥼/Noun,1,1,0,1.1115310228308472e-05,0.0,1.0
43851,케이프/Noun,1,1,0,1.1115310228308472e-05,0.0,1.0
43852,완만/Noun,1,0,1,0.0,1.1106915165381966e-05,1.0
43853,방전/Noun,1,0,1,0.0,1.1106915165381966e-05,1.0
43854,햇볓/Noun,1,0,1,0.0,1.1106915165381966e-05,1.0
43855,채리/Noun,1,0,1,0.0,1.1106915165381966e-05,1.0
43856,핑돈다/Noun,1,1,0,1.1115310228308472e-05,0.0,1.0
43857,꿂잼/Noun,1,1,0,1.1115310228308472e-05,0.0,1.0
43858,분양/Noun,1,1,0,1.1115310228308472e-05,0.0,1.0
43859,루퍼트/Noun,1,0,1,0.0,1.1106915165381966e-05,1.0
43860,뒷일/Noun,1,1,0,1.1115310228308472e-05,0.0,1.0
43861,ㅑㅑ/KoreanParticle,1,0,1,0.0,1.1106915165381966e-05,1.0
43862,44년/Number,1,1,0,1.1115310228308472e-05,0.0,1.0
43863,화땐/Noun,1,1,0,1.1115310228308472e-05,0.0,1.0
43864,foot/Alpha,1,0,1,0.0,1.1106915165381966e-05,1.0
43865,stereotyping/Alpha,1,0,1,0.0,1.1106915165381966e-05,1.0
43866,生/Foreign,1,0,1,0.0,1.1106915165381966e-05,1.0
43867,ㅈㅇㅂㄹ/KoreanParticle,1,0,1,0.0,1.1106915165381966e-05,1.0
43868,도인줄모를정도로/Foreign,1,1,0,1.1115310228308472e-05,0.0,1.0
43869,챦/Noun,1,1,0,1.1115310228308472e-05,0.0,1.0
43870,레코드/Noun,1,0,1,0.0,1.1106915165381966e-05,1.0
43871,침밷/Noun,1,0,1,0.0,1.1106915165381966e-05,1.0
43872,커닝햄/Noun,1,1,0,1.1115310228308472e-05,0.0,1.0
43873,첫빠따/Noun,1,0,1,0.0,1.1106915165381966e-05,1.0
43874,이럴꺼면왜출연시킴/Foreign,1,0,1,0.0,1.1106915165381966e-05,1.0
43875,이닌/Noun,1,0,1,0.0,1.1106915165381966e-05,1.0
43876,월광씬/Noun,1,1,0,1.1115310228308472e-05,0.0,1.0
43877,강납/Noun,1,1,0,1.1115310228308472e-05,0.0,1.0
43878,소프라노스/Noun,1,1,0,1.1115310228308472e-05,0.0,1.0
43879,브레이킹배드/Noun,1,1,0,1.1115310228308472e-05,0.0,1.0
43880,추문/Noun,1,0,1,0.0,1.1106915165381966e-05,1.0
43881,attore/Alpha,1,1,0,1.1115310228308472e-05,0.0,1.0
43882,miglior/Alpha,1,1,0,1.1115310228308472e-05,0.0,1.0
43883,il/Alpha,1,1,0,1.1115310228308472e-05,0.0,1.0
43884,eri/Alpha,1,1,0,1.1115310228308472e-05,0.0,1.0
43885,pace/Alpha,1,1,0,1.1115310228308472e-05,0.0,1.0
43886,riposa/Alpha,1,1,0,1.1115310228308472e-05,0.0,1.0
43887,Trois/Alpha,1,1,0,1.1115310228308472e-05,0.0,1.0
43888,Massimo/Alpha,1,1,0,1.1115310228308472e-05,0.0,1.0
43889,패션계/Noun,1,1,0,1.1115310228308472e-05,0.0,1.0
43890,드롬/Noun,1,1,0,1.1115310228308472e-05,0.0,1.0
43891,하고의/Josa,1,0,1,0.0,1.1106915165381966e-05,1.0
43892,구등/Noun,1,0,1,0.0,1.1106915165381966e-05,1.0
43893,낚이자/Noun,1,0,1,0.0,1.1106915165381966e-05,1.0
43894,청춘예찬/Noun,1,1,0,1.1115310228308472e-05,0.0,1.0
43895,동두천/Noun,1,1,0,1.1115310228308472e-05,0.0,1.0
43896,banks/Alpha,1,1,0,1.1115310228308472e-05,0.0,1.0
43897,mr/Alpha,1,1,0,1.1115310228308472e-05,0.0,1.0
43898,추적추적/Adverb,1,0,1,0.0,1.1106915165381966e-05,1.0
43899,메가톤/Noun,1,0,1,0.0,1.1106915165381966e-05,1.0
43900,쥴리보러/Noun,1,1,0,1.1115310228308472e-05,0.0,1.0
43901,발칵/Noun,1,1,0,1.1115310228308472e-05,0.0,1.0
43902,살존/Noun,1,1,0,1.1115310228308472e-05,0.0,1.0
43903,산출/Noun,1,0,1,0.0,1.1106915165381966e-05,1.0
43904,단테스/Noun,1,1,0,1.1115310228308472e-05,0.0,1.0
43905,바램일/Noun,1,0,1,0.0,1.1106915165381966e-05,1.0
43906,멈츨/Noun,1,1,0,1.1115310228308472e-05,0.0,1.0
43907,모팻/Noun,1,1,0,1.1115310228308472e-05,0.0,1.0
43908,보다말음/Foreign,1,0,1,0.0,1.1106915165381966e-05,1.0
43909,지능범/Noun,1,1,0,1.1115310228308472e-05,0.0,1.0
43910,어쌔씬코드/Noun,1,1,0,1.1115310228308472e-05,0.0,1.0
43911,살라맨더/Noun,1,1,0,1.1115310228308472e-05,0.0,1.0
43912,맞닥뜨려/Noun,1,1,0,1.1115310228308472e-05,0.0,1.0
43913,킨지/Noun,1,0,1,0.0,1.1106915165381966e-05,1.0
43914,향내/Noun,1,1,0,1.1115310228308472e-05,0.0,1.0
43915,날감/Noun,1,1,0,1.1115310228308472e-05,0.0,1.0
43916,마이카/Noun,1,1,0,1.1115310228308472e-05,0.0,1.0
43917,시들시들/Noun,1,0,1,0.0,1.1106915165381966e-05,1.0
43918,물컹물컹하다/Adjective,1,0,1,0.0,1.1106915165381966e-05,1.0
43919,;..../Punctuation,1,0,1,0.0,1.1106915165381966e-05,1.0
43920,포덕/Noun,1,0,1,0.0,1.1106915165381966e-05,1.0
43921,<!/Punctuation,1,1,0,1.1115310228308472e-05,0.0,1.0
43922,계선/Noun,1,0,1,0.0,1.1106915165381966e-05,1.0
43923,못뫘/Noun,1,1,0,1.1115310228308472e-05,0.0,1.0
43924,도작품/Foreign,1,1,0,1.1115310228308472e-05,0.0,1.0
43925,보사/Noun,1,1,0,1.1115310228308472e-05,0.0,1.0
43926,망막/Noun,1,0,1,0.0,1.1106915165381966e-05,1.0
43927,지나서야/Foreign,1,1,0,1.1115310228308472e-05,0.0,1.0
43928,보린/Noun,1,0,1,0.0,1.1106915165381966e-05,1.0
43929,이바지/Noun,1,0,1,0.0,1.1106915165381966e-05,1.0
43930,렐라/Noun,1,1,0,1.1115310228308472e-05,0.0,1.0
43931,좀웃겻음/Noun,1,1,0,1.1115310228308472e-05,0.0,1.0
43932,혁재/Noun,1,1,0,1.1115310228308472e-05,0.0,1.0
43933,가세영/Noun,1,1,0,1.1115310228308472e-05,0.0,1.0
43934,미모포텐/Noun,1,1,0,1.1115310228308472e-05,0.0,1.0
43935,운하/Noun,1,0,1,0.0,1.1106915165381966e-05,1.0
43936,홍형숙/Noun,1,0,1,0.0,1.1106915165381966e-05,1.0
43937,탄씩/Noun,1,0,1,0.0,1.1106915165381966e-05,1.0
43938,바스키아/Noun,1,1,0,1.1115310228308472e-05,0.0,1.0
43939,senza/Alpha,1,1,0,1.1115310228308472e-05,0.0,1.0
43940,ㅜㅠㅜㅡㅠㅜ/KoreanParticle,1,1,0,1.1115310228308472e-05,0.0,1.0
43941,절음발/Noun,1,1,0,1.1115310228308472e-05,0.0,1.0
43942,죈장/Noun,1,0,1,0.0,1.1106915165381966e-05,1.0
43943,뽱/Noun,1,1,0,1.1115310228308472e-05,0.0,1.0
43944,리젠트/Noun,1,1,0,1.1115310228308472e-05,0.0,1.0
43945,밨았/Noun,1,1,0,1.1115310228308472e-05,0.0,1.0
43946,진태현/Noun,1,1,0,1.1115310228308472e-05,0.0,1.0
43947,사경/Noun,1,1,0,1.1115310228308472e-05,0.0,1.0
43948,군법/Noun,1,0,1,0.0,1.1106915165381966e-05,1.0
43949,비밀결혼/Noun,1,0,1,0.0,1.1106915165381966e-05,1.0
43950,갔슴/Noun,1,0,1,0.0,1.1106915165381966e-05,1.0
43951,aworks/Alpha,1,1,0,1.1115310228308472e-05,0.0,1.0
43952,더기버/Noun,1,1,0,1.1115310228308472e-05,0.0,1.0
43953,가스파르/Noun,1,1,0,1.1115310228308472e-05,0.0,1.0
43954,찌릴뻔/Noun,1,1,0,1.1115310228308472e-05,0.0,1.0
43955,씌부럴/Noun,1,1,0,1.1115310228308472e-05,0.0,1.0
43956,믿을늠/Noun,1,1,0,1.1115310228308472e-05,0.0,1.0
43957,트래픽/Noun,1,1,0,1.1115310228308472e-05,0.0,1.0
43958,흘릴껄/Noun,1,1,0,1.1115310228308472e-05,0.0,1.0
43959,"......""/Punctuation",1,0,1,0.0,1.1106915165381966e-05,1.0
43960,박훈정/Noun,1,0,1,0.0,1.1106915165381966e-05,1.0
43961,이재익/Noun,1,0,1,0.0,1.1106915165381966e-05,1.0
43962,함지/Noun,1,1,0,1.1115310228308472e-05,0.0,1.0
43963,김현정/Noun,1,1,0,1.1115310228308472e-05,0.0,1.0
43964,양분/Noun,1,0,1,0.0,1.1106915165381966e-05,1.0
43965,플레이보이지/Noun,1,0,1,0.0,1.1106915165381966e-05,1.0
43966,",,,?/Punctuation",1,1,0,1.1115310228308472e-05,0.0,1.0
43967,뗼수없/Noun,1,1,0,1.1115310228308472e-05,0.0,1.0
43968,김민아/Noun,1,0,1,0.0,1.1106915165381966e-05,1.0
43969,없을껀데/Noun,1,1,0,1.1115310228308472e-05,0.0,1.0
43970,놀랫음/Noun,1,0,1,0.0,1.1106915165381966e-05,1.0
43971,포부/Noun,1,0,1,0.0,1.1106915165381966e-05,1.0
43972,잘뽑다/Verb,1,1,0,1.1115310228308472e-05,0.0,1.0
43973,그레/Noun,1,1,0,1.1115310228308472e-05,0.0,1.0
43974,섭풍/Noun,1,1,0,1.1115310228308472e-05,0.0,1.0
43975,Normal/Alpha,1,1,0,1.1115310228308472e-05,0.0,1.0
43976,졸데/Noun,1,1,0,1.1115310228308472e-05,0.0,1.0
43977,아크엔젤/Noun,1,1,0,1.1115310228308472e-05,0.0,1.0
43978,행식/Noun,1,1,0,1.1115310228308472e-05,0.0,1.0
43979,{}{}{}{}{}/Punctuation,1,0,1,0.0,1.1106915165381966e-05,1.0
43980,무뎌졌다/Noun,1,0,1,0.0,1.1106915165381966e-05,1.0
43981,기언/Noun,1,0,1,0.0,1.1106915165381966e-05,1.0
43982,초늑녁/Noun,1,0,1,0.0,1.1106915165381966e-05,1.0
43983,포우/Noun,1,0,1,0.0,1.1106915165381966e-05,1.0
43984,혐기/Noun,1,1,0,1.1115310228308472e-05,0.0,1.0
43985,춫현/Noun,1,1,0,1.1115310228308472e-05,0.0,1.0
43986,스팩트럼/Noun,1,1,0,1.1115310228308472e-05,0.0,1.0
43987,둥탄/Noun,1,1,0,1.1115310228308472e-05,0.0,1.0
43988,루더/Noun,1,1,0,1.1115310228308472e-05,0.0,1.0
43989,아팟음/Noun,1,1,0,1.1115310228308472e-05,0.0,1.0
43990,공격성/Noun,1,1,0,1.1115310228308472e-05,0.0,1.0
43991,아슬란/Noun,1,0,1,0.0,1.1106915165381966e-05,1.0
43992,츠천/Noun,1,0,1,0.0,1.1106915165381966e-05,1.0
43993,츠가이/Noun,1,0,1,0.0,1.1106915165381966e-05,1.0
43994,닌교/Noun,1,0,1,0.0,1.1106915165381966e-05,1.0
43995,띨띨해/Noun,1,0,1,0.0,1.1106915165381966e-05,1.0
43996,윈윈하/Noun,1,0,1,0.0,1.1106915165381966e-05,1.0
43997,리키김/Noun,1,0,1,0.0,1.1106915165381966e-05,1.0
43998,헛둘헛둘/Noun,1,0,1,0.0,1.1106915165381966e-05,1.0
43999,레이지/Noun,1,0,1,0.0,1.1106915165381966e-05,1.0
44000,불보/Noun,1,0,1,0.0,1.1106915165381966e-05,1.0
44001,기급/Noun,1,0,1,0.0,1.1106915165381966e-05,1.0
44002,구청/Noun,1,1,0,1.1115310228308472e-05,0.0,1.0
44003,느즈막/Noun,1,1,0,1.1115310228308472e-05,0.0,1.0
44004,도민/Noun,1,1,0,1.1115310228308472e-05,0.0,1.0
44005,쌩뚱맞은/Noun,1,0,1,0.0,1.1106915165381966e-05,1.0
44006,초저녁/Noun,1,0,1,0.0,1.1106915165381966e-05,1.0
44007,뿜더군/Noun,1,0,1,0.0,1.1106915165381966e-05,1.0
44008,제임스롤프/Noun,1,0,1,0.0,1.1106915165381966e-05,1.0
44009,"...!!""/Punctuation",1,1,0,1.1115310228308472e-05,0.0,1.0
44010,?!~/Punctuation,1,1,0,1.1115310228308472e-05,0.0,1.0
44011,노틀담/Noun,1,0,1,0.0,1.1106915165381966e-05,1.0
44012,MBOUT/Alpha,1,0,1,0.0,1.1106915165381966e-05,1.0
44013,ㅁㅈ/KoreanParticle,1,1,0,1.1115310228308472e-05,0.0,1.0
44014,호노/Noun,1,1,0,1.1115310228308472e-05,0.0,1.0
44015,에멧/Noun,1,0,1,0.0,1.1106915165381966e-05,1.0
44016,궁궁/Noun,1,0,1,0.0,1.1106915165381966e-05,1.0
44017,법관/Noun,1,0,1,0.0,1.1106915165381966e-05,1.0
44018,-_-....../Punctuation,1,0,1,0.0,1.1106915165381966e-05,1.0
44019,헛헛헛/Noun,1,1,0,1.1115310228308472e-05,0.0,1.0
44020,고딕소설/Noun,1,1,0,1.1115310228308472e-05,0.0,1.0
44021,야말로/Noun,1,0,1,0.0,1.1106915165381966e-05,1.0
44022,캌퉤/Noun,1,0,1,0.0,1.1106915165381966e-05,1.0
44023,트랜센더스/Noun,1,1,0,1.1115310228308472e-05,0.0,1.0
44024,드스/Noun,1,1,0,1.1115310228308472e-05,0.0,1.0
44025,걸프렌드/Noun,1,0,1,0.0,1.1106915165381966e-05,1.0
44026,넌판/Noun,1,1,0,1.1115310228308472e-05,0.0,1.0
44027,만상/Noun,1,0,1,0.0,1.1106915165381966e-05,1.0
44028,녹방/Noun,1,0,1,0.0,1.1106915165381966e-05,1.0
44029,킬제덴급/Noun,1,0,1,0.0,1.1106915165381966e-05,1.0
44030,밴댕이/Noun,1,0,1,0.0,1.1106915165381966e-05,1.0
44031,노라노/Noun,1,1,0,1.1115310228308472e-05,0.0,1.0
44032,일군/Noun,1,1,0,1.1115310228308472e-05,0.0,1.0
44033,군용/Noun,1,0,1,0.0,1.1106915165381966e-05,1.0
44034,팬팬/Noun,1,1,0,1.1115310228308472e-05,0.0,1.0
44035,오들오들/Noun,1,1,0,1.1115310228308472e-05,0.0,1.0
44036,박은주/Noun,1,1,0,1.1115310228308472e-05,0.0,1.0
44037,?!@#/Punctuation,1,0,1,0.0,1.1106915165381966e-05,1.0
44038,게이츠/Noun,1,1,0,1.1115310228308472e-05,0.0,1.0
44039,노작/Noun,1,1,0,1.1115310228308472e-05,0.0,1.0
44040,귀차니즘/Noun,1,0,1,0.0,1.1106915165381966e-05,1.0
44041,200만원/Number,1,1,0,1.1115310228308472e-05,0.0,1.0
44042,허트레터/Noun,1,0,1,0.0,1.1106915165381966e-05,1.0
44043,수어/Noun,1,1,0,1.1115310228308472e-05,0.0,1.0
44044,보다는/Foreign,1,1,0,1.1115310228308472e-05,0.0,1.0
44045,뒤의/Foreign,1,1,0,1.1115310228308472e-05,0.0,1.0
44046,큐프릭/Noun,1,1,0,1.1115310228308472e-05,0.0,1.0
44047,쉬즈/Noun,1,0,1,0.0,1.1106915165381966e-05,1.0
44048,진원/Noun,1,1,0,1.1115310228308472e-05,0.0,1.0
44049,첼론데/Noun,1,0,1,0.0,1.1106915165381966e-05,1.0
44050,앨바/Noun,1,0,1,0.0,1.1106915165381966e-05,1.0
44051,전안/Noun,1,0,1,0.0,1.1106915165381966e-05,1.0
44052,살신성인/Noun,1,1,0,1.1115310228308472e-05,0.0,1.0
44053,주경야독/Noun,1,1,0,1.1115310228308472e-05,0.0,1.0
44054,직병/Noun,1,1,0,1.1115310228308472e-05,0.0,1.0
44055,플래쉬몹/Noun,1,0,1,0.0,1.1106915165381966e-05,1.0
44056,마응/Noun,1,1,0,1.1115310228308472e-05,0.0,1.0
44057,.??..-_-;/Punctuation,1,0,1,0.0,1.1106915165381966e-05,1.0
44058,한겅/Noun,1,0,1,0.0,1.1106915165381966e-05,1.0
44059,"/,./.,/.,/Punctuation",1,0,1,0.0,1.1106915165381966e-05,1.0
44060,안딩/Noun,1,1,0,1.1115310228308472e-05,0.0,1.0
44061,차유/Noun,1,1,0,1.1115310228308472e-05,0.0,1.0
44062,없이꼬우또꼬우/Noun,1,0,1,0.0,1.1106915165381966e-05,1.0
44063,흑조/Noun,1,1,0,1.1115310228308472e-05,0.0,1.0
44064,해모수/Noun,1,0,1,0.0,1.1106915165381966e-05,1.0
44065,스랍/Noun,1,0,1,0.0,1.1106915165381966e-05,1.0
44066,카레라/Noun,1,1,0,1.1115310228308472e-05,0.0,1.0
44067,포르쉐/Noun,1,1,0,1.1115310228308472e-05,0.0,1.0
44068,페라리/Noun,1,1,0,1.1115310228308472e-05,0.0,1.0
44069,엔초/Noun,1,1,0,1.1115310228308472e-05,0.0,1.0
44070,체브라시카/Noun,1,1,0,1.1115310228308472e-05,0.0,1.0
44071,패트/Noun,1,1,0,1.1115310228308472e-05,0.0,1.0
44072,차주/Noun,1,0,1,0.0,1.1106915165381966e-05,1.0
44073,몃번/Noun,1,0,1,0.0,1.1106915165381966e-05,1.0
44074,과심/Noun,1,1,0,1.1115310228308472e-05,0.0,1.0
44075,헤레브란트/Noun,1,1,0,1.1115310228308472e-05,0.0,1.0
44076,침잠/Noun,1,1,0,1.1115310228308472e-05,0.0,1.0
44077,디노/Noun,1,1,0,1.1115310228308472e-05,0.0,1.0
44078,접경/Noun,1,1,0,1.1115310228308472e-05,0.0,1.0
44079,후는/Foreign,1,1,0,1.1115310228308472e-05,0.0,1.0
44080,시나몬/Noun,1,0,1,0.0,1.1106915165381966e-05,1.0
44081,계피/Noun,1,0,1,0.0,1.1106915165381966e-05,1.0
44082,파출부/Noun,1,0,1,0.0,1.1106915165381966e-05,1.0
44083,대출받다/Verb,1,0,1,0.0,1.1106915165381966e-05,1.0
44084,159/Number,1,1,0,1.1115310228308472e-05,0.0,1.0
44085,어쩌실꺼/Noun,1,1,0,1.1115310228308472e-05,0.0,1.0
44086,거때메/Noun,1,1,0,1.1115310228308472e-05,0.0,1.0
44087,CopyCat/Alpha,1,0,1,0.0,1.1106915165381966e-05,1.0
44088,머치/Noun,1,0,1,0.0,1.1106915165381966e-05,1.0
44089,크메르/Noun,1,1,0,1.1115310228308472e-05,0.0,1.0
44090,산정/Noun,1,1,0,1.1115310228308472e-05,0.0,1.0
44091,MGS/Alpha,1,1,0,1.1115310228308472e-05,0.0,1.0
44092,CQC/Alpha,1,1,0,1.1115310228308472e-05,0.0,1.0
44093,죄를/Noun,1,0,1,0.0,1.1106915165381966e-05,1.0
44094,낮네욤/Noun,1,0,1,0.0,1.1106915165381966e-05,1.0
44095,6170/Number,1,0,1,0.0,1.1106915165381966e-05,1.0
44096,fq/Alpha,1,0,1,0.0,1.1106915165381966e-05,1.0
44097,배렸/Noun,1,0,1,0.0,1.1106915165381966e-05,1.0
44098,멋쮜/Noun,1,1,0,1.1115310228308472e-05,0.0,1.0
44099,개쓉/Noun,1,0,1,0.0,1.1106915165381966e-05,1.0
44100,입어보다/Verb,1,1,0,1.1115310228308472e-05,0.0,1.0
44101,포이즌/Noun,1,0,1,0.0,1.1106915165381966e-05,1.0
44102,희영/Noun,1,0,1,0.0,1.1106915165381966e-05,1.0
44103,짓누르다/Verb,1,1,0,1.1115310228308472e-05,0.0,1.0
44104,타이쿤/Noun,1,0,1,0.0,1.1106915165381966e-05,1.0
44105,@!!!!!/Punctuation,1,1,0,1.1115310228308472e-05,0.0,1.0
44106,째밌어/Noun,1,1,0,1.1115310228308472e-05,0.0,1.0
44107,대영화인줄/Foreign,1,0,1,0.0,1.1106915165381966e-05,1.0
44108,인생중/Foreign,1,0,1,0.0,1.1106915165381966e-05,1.0
44109,스이/Noun,1,0,1,0.0,1.1106915165381966e-05,1.0
44110,콤달콤/Noun,1,1,0,1.1115310228308472e-05,0.0,1.0
44111,묘팬임/Noun,1,1,0,1.1115310228308472e-05,0.0,1.0
44112,햄버걸/Noun,1,1,0,1.1115310228308472e-05,0.0,1.0
44113,기묘/Noun,1,0,1,0.0,1.1106915165381966e-05,1.0
44114,알팍/Noun,1,0,1,0.0,1.1106915165381966e-05,1.0
44115,내외/Noun,1,0,1,0.0,1.1106915165381966e-05,1.0
44116,던거/Noun,1,1,0,1.1115310228308472e-05,0.0,1.0
44117,다름없이/Adverb,1,0,1,0.0,1.1106915165381966e-05,1.0
44118,뒤끝쩌/Noun,1,0,1,0.0,1.1106915165381966e-05,1.0
44119,말귀/Noun,1,0,1,0.0,1.1106915165381966e-05,1.0
44120,킥복서/Noun,1,0,1,0.0,1.1106915165381966e-05,1.0
44121,6.49/Number,1,0,1,0.0,1.1106915165381966e-05,1.0
44122,~~~~~`/Punctuation,1,0,1,0.0,1.1106915165381966e-05,1.0
44123,25시간/Number,1,0,1,0.0,1.1106915165381966e-05,1.0
44124,코흘리게/Noun,1,0,1,0.0,1.1106915165381966e-05,1.0
44125,본스타/Noun,1,1,0,1.1115310228308472e-05,0.0,1.0
44126,~^^;;;/Punctuation,1,1,0,1.1115310228308472e-05,0.0,1.0
44127,김소명/Noun,1,1,0,1.1115310228308472e-05,0.0,1.0
44128,은행동/Noun,1,1,0,1.1115310228308472e-05,0.0,1.0
44129,디텔일/Noun,1,1,0,1.1115310228308472e-05,0.0,1.0
44130,윤영/Noun,1,1,0,1.1115310228308472e-05,0.0,1.0
44131,빠수늬들때매/Noun,1,0,1,0.0,1.1106915165381966e-05,1.0
44132,16시/Number,1,1,0,1.1115310228308472e-05,0.0,1.0
44133,위대한탄생/Noun,1,0,1,0.0,1.1106915165381966e-05,1.0
44134,드레데/Noun,1,1,0,1.1115310228308472e-05,0.0,1.0
44135,퍼먹어/Noun,1,0,1,0.0,1.1106915165381966e-05,1.0
44136,월러스/Noun,1,0,1,0.0,1.1106915165381966e-05,1.0
44137,햇찌/Noun,1,0,1,0.0,1.1106915165381966e-05,1.0
44138,1111222/Number,1,0,1,0.0,1.1106915165381966e-05,1.0
44139,부리나케/Noun,1,0,1,0.0,1.1106915165381966e-05,1.0
44140,괞찬응/Noun,1,1,0,1.1115310228308472e-05,0.0,1.0
44141,괞찬/Noun,1,1,0,1.1115310228308472e-05,0.0,1.0
44142,으로서가/Josa,1,1,0,1.1115310228308472e-05,0.0,1.0
44143,로진/Noun,1,1,0,1.1115310228308472e-05,0.0,1.0
44144,아윱/Noun,1,1,0,1.1115310228308472e-05,0.0,1.0
44145,스릉함돠/Noun,1,1,0,1.1115310228308472e-05,0.0,1.0
44146,나라말/Noun,1,0,1,0.0,1.1106915165381966e-05,1.0
44147,가우리/Noun,1,0,1,0.0,1.1106915165381966e-05,1.0
44148,나문/Noun,1,0,1,0.0,1.1106915165381966e-05,1.0
44149,미치코/Noun,1,1,0,1.1115310228308472e-05,0.0,1.0
44150,삤겠다/Noun,1,1,0,1.1115310228308472e-05,0.0,1.0
44151,놀래킨/Noun,1,1,0,1.1115310228308472e-05,0.0,1.0
44152,눈물맺혓/Noun,1,1,0,1.1115310228308472e-05,0.0,1.0
44153,하치쿠/Noun,1,1,0,1.1115310228308472e-05,0.0,1.0
44154,걸임/Noun,1,1,0,1.1115310228308472e-05,0.0,1.0
44155,슈퍼걸/Noun,1,0,1,0.0,1.1106915165381966e-05,1.0
44156,집착쩌/Noun,1,0,1,0.0,1.1106915165381966e-05,1.0
44157,팔로마/Noun,1,1,0,1.1115310228308472e-05,0.0,1.0
44158,빼곤/Noun,1,1,0,1.1115310228308472e-05,0.0,1.0
44159,텔레토비/Noun,1,0,1,0.0,1.1106915165381966e-05,1.0
44160,꿎꿎하/Noun,1,1,0,1.1115310228308472e-05,0.0,1.0
44161,~~~~!!!@@@@/Punctuation,1,0,1,0.0,1.1106915165381966e-05,1.0
44162,!!!@^^@/Punctuation,1,1,0,1.1115310228308472e-05,0.0,1.0
44163,"2,500원/Number",1,1,0,1.1115310228308472e-05,0.0,1.0
44164,나왓습/Noun,1,1,0,1.1115310228308472e-05,0.0,1.0
44165,오인용/Noun,1,1,0,1.1115310228308472e-05,0.0,1.0
44166,무명인/Noun,1,0,1,0.0,1.1106915165381966e-05,1.0
44167,이철하/Noun,1,0,1,0.0,1.1106915165381966e-05,1.0
44168,나왓을떈/Noun,1,0,1,0.0,1.1106915165381966e-05,1.0
44169,싄난당/Noun,1,0,1,0.0,1.1106915165381966e-05,1.0
44170,안준영/Noun,1,0,1,0.0,1.1106915165381966e-05,1.0
44171,큐잭/Noun,1,0,1,0.0,1.1106915165381966e-05,1.0
44172,경상남도/Noun,1,0,1,0.0,1.1106915165381966e-05,1.0
44173,경상북도/Noun,1,0,1,0.0,1.1106915165381966e-05,1.0
44174,햅/Noun,1,1,0,1.1115310228308472e-05,0.0,1.0
44175,하위호환/Noun,1,0,1,0.0,1.1106915165381966e-05,1.0
44176,44%/Number,1,0,1,0.0,1.1106915165381966e-05,1.0
44177,만칠천원/Noun,1,0,1,0.0,1.1106915165381966e-05,1.0
44178,단호박/Noun,1,0,1,0.0,1.1106915165381966e-05,1.0
44179,17분/Number,1,0,1,0.0,1.1106915165381966e-05,1.0
44180,색삼/Noun,1,1,0,1.1115310228308472e-05,0.0,1.0
44181,시초격/Noun,1,0,1,0.0,1.1106915165381966e-05,1.0
44182,책가방/Noun,1,1,0,1.1115310228308472e-05,0.0,1.0
44183,걸상/Noun,1,1,0,1.1115310228308472e-05,0.0,1.0
44184,마징가제트/Noun,1,1,0,1.1115310228308472e-05,0.0,1.0
44185,60~80/Number,1,0,1,0.0,1.1106915165381966e-05,1.0
44186,질퍽질퍽/Noun,1,0,1,0.0,1.1106915165381966e-05,1.0
44187,닁/Noun,1,1,0,1.1115310228308472e-05,0.0,1.0
44188,우주복/Noun,1,1,0,1.1115310228308472e-05,0.0,1.0
44189,한떄/Noun,1,1,0,1.1115310228308472e-05,0.0,1.0
44190,Masterpiece/Alpha,1,1,0,1.1115310228308472e-05,0.0,1.0
44191,프라스/Noun,1,0,1,0.0,1.1106915165381966e-05,1.0
44192,강대하다/Adjective,1,0,1,0.0,1.1106915165381966e-05,1.0
44193,황권/Noun,1,0,1,0.0,1.1106915165381966e-05,1.0
44194,삼국사기/Noun,1,0,1,0.0,1.1106915165381966e-05,1.0
44195,김부식/Noun,1,0,1,0.0,1.1106915165381966e-05,1.0
44196,사마천/Noun,1,0,1,0.0,1.1106915165381966e-05,1.0
44197,테좀/Noun,1,0,1,0.0,1.1106915165381966e-05,1.0
44198,성인용품점/Noun,1,0,1,0.0,1.1106915165381966e-05,1.0
44199,공공장소/Noun,1,0,1,0.0,1.1106915165381966e-05,1.0
44200,뗄레/Noun,1,1,0,1.1115310228308472e-05,0.0,1.0
44201,그게몬/Noun,1,0,1,0.0,1.1106915165381966e-05,1.0
44202,퀭/Noun,1,0,1,0.0,1.1106915165381966e-05,1.0
44203,쌀국/Noun,1,1,0,1.1115310228308472e-05,0.0,1.0
44204,숼틈없이봐/Noun,1,1,0,1.1115310228308472e-05,0.0,1.0
44205,쌕/Noun,1,0,1,0.0,1.1106915165381966e-05,1.0
44206,쎅씨해/Noun,1,0,1,0.0,1.1106915165381966e-05,1.0
44207,어싼/Noun,1,1,0,1.1115310228308472e-05,0.0,1.0
44208,쫌너무슬펏/Noun,1,1,0,1.1115310228308472e-05,0.0,1.0
44209,일몰/Noun,1,1,0,1.1115310228308472e-05,0.0,1.0
44210,안드메/Noun,1,1,0,1.1115310228308472e-05,0.0,1.0
44211,Dull/Alpha,1,0,1,0.0,1.1106915165381966e-05,1.0
44212,집배/Noun,1,1,0,1.1115310228308472e-05,0.0,1.0
44213,등사기/Noun,1,1,0,1.1115310228308472e-05,0.0,1.0
44214,불효/Noun,1,0,1,0.0,1.1106915165381966e-05,1.0
44215,낮넹/Noun,1,1,0,1.1115310228308472e-05,0.0,1.0
44216,콜록콜럭/Noun,1,1,0,1.1115310228308472e-05,0.0,1.0
44217,Fatal/Alpha,1,1,0,1.1115310228308472e-05,0.0,1.0
44218,오페라단/Noun,1,0,1,0.0,1.1106915165381966e-05,1.0
44219,345/Number,1,0,1,0.0,1.1106915165381966e-05,1.0
44220,문츠/Noun,1,1,0,1.1115310228308472e-05,0.0,1.0
44221,범죄심리학자/Noun,1,0,1,0.0,1.1106915165381966e-05,1.0
44222,무섭딘/Noun,1,1,0,1.1115310228308472e-05,0.0,1.0
44223,차현정/Noun,1,0,1,0.0,1.1106915165381966e-05,1.0
44224,수면장애/Noun,1,0,1,0.0,1.1106915165381966e-05,1.0
44225,도딱/Noun,1,0,1,0.0,1.1106915165381966e-05,1.0
44226,외양간/Noun,1,0,1,0.0,1.1106915165381966e-05,1.0
44227,잼나드/Noun,1,0,1,0.0,1.1106915165381966e-05,1.0
44228,어떡케/Noun,1,0,1,0.0,1.1106915165381966e-05,1.0
44229,해산물/Noun,1,0,1,0.0,1.1106915165381966e-05,1.0
44230,재래시장/Noun,1,0,1,0.0,1.1106915165381966e-05,1.0
44231,빌게이츠/Noun,1,0,1,0.0,1.1106915165381966e-05,1.0
44232,귀엽잫/Noun,1,1,0,1.1115310228308472e-05,0.0,1.0
44233,앗줄/Noun,1,0,1,0.0,1.1106915165381966e-05,1.0
44234,실었다/Noun,1,0,1,0.0,1.1106915165381966e-05,1.0
44235,빈말/Noun,1,1,0,1.1115310228308472e-05,0.0,1.0
44236,초중고생/Noun,1,1,0,1.1115310228308472e-05,0.0,1.0
44237,쫄깃쫄깃해/Noun,1,1,0,1.1115310228308472e-05,0.0,1.0
44238,욕처/Noun,1,0,1,0.0,1.1106915165381966e-05,1.0
44239,삼각/Noun,1,0,1,0.0,1.1106915165381966e-05,1.0
44240,장녀/Noun,1,0,1,0.0,1.1106915165381966e-05,1.0
44241,용지/Noun,1,0,1,0.0,1.1106915165381966e-05,1.0
44242,♥▼♥/Foreign,1,1,0,1.1115310228308472e-05,0.0,1.0
44243,ㅋㅌㅋㅌ/KoreanParticle,1,1,0,1.1115310228308472e-05,0.0,1.0
44244,강렬/Noun,1,1,0,1.1115310228308472e-05,0.0,1.0
44245,멋쥐/Noun,1,1,0,1.1115310228308472e-05,0.0,1.0
44246,보겔/Noun,1,0,1,0.0,1.1106915165381966e-05,1.0
44247,NICE/Alpha,1,1,0,1.1115310228308472e-05,0.0,1.0
44248,깨깨/Adverb,1,0,1,0.0,1.1106915165381966e-05,1.0
44249,볼렵니/Noun,1,0,1,0.0,1.1106915165381966e-05,1.0
44250,청양/Noun,1,1,0,1.1115310228308472e-05,0.0,1.0
44251,그라탕/Noun,1,0,1,0.0,1.1106915165381966e-05,1.0
44252,피떡/Noun,1,0,1,0.0,1.1106915165381966e-05,1.0
44253,하옵다/Verb,1,0,1,0.0,1.1106915165381966e-05,1.0
44254,십슈레긔/Noun,1,0,1,0.0,1.1106915165381966e-05,1.0
44255,그닼/Noun,1,0,1,0.0,1.1106915165381966e-05,1.0
44256,장홍/Noun,1,1,0,1.1115310228308472e-05,0.0,1.0
44257,은석/Noun,1,0,1,0.0,1.1106915165381966e-05,1.0
44258,백가/Noun,1,1,0,1.1115310228308472e-05,0.0,1.0
44259,봇듯/Noun,1,1,0,1.1115310228308472e-05,0.0,1.0
44260,주요하다/Adjective,1,1,0,1.1115310228308472e-05,0.0,1.0
44261,이령/Noun,1,1,0,1.1115310228308472e-05,0.0,1.0
44262,치어리더/Noun,1,1,0,1.1115310228308472e-05,0.0,1.0
44263,거또못/Noun,1,1,0,1.1115310228308472e-05,0.0,1.0
44264,당산/Noun,1,1,0,1.1115310228308472e-05,0.0,1.0
44265,궈궈싱/Noun,1,1,0,1.1115310228308472e-05,0.0,1.0
44266,무열/Noun,1,1,0,1.1115310228308472e-05,0.0,1.0
44267,샤리/Noun,1,1,0,1.1115310228308472e-05,0.0,1.0
44268,앙리/Noun,1,1,0,1.1115310228308472e-05,0.0,1.0
44269,본명/Noun,1,1,0,1.1115310228308472e-05,0.0,1.0
44270,감정동/Noun,1,1,0,1.1115310228308472e-05,0.0,1.0
44271,고타/Noun,1,1,0,1.1115310228308472e-05,0.0,1.0
44272,전이라도/Foreign,1,0,1,0.0,1.1106915165381966e-05,1.0
44273,랜서/Noun,1,0,1,0.0,1.1106915165381966e-05,1.0
44274,계통/Noun,1,0,1,0.0,1.1106915165381966e-05,1.0
44275,준위/Noun,1,0,1,0.0,1.1106915165381966e-05,1.0
44276,28만/Number,1,0,1,0.0,1.1106915165381966e-05,1.0
44277,제갈양/Noun,1,0,1,0.0,1.1106915165381966e-05,1.0
44278,문인수/Noun,1,0,1,0.0,1.1106915165381966e-05,1.0
44279,도착하는것까지만/Foreign,1,0,1,0.0,1.1106915165381966e-05,1.0
44280,2030년/Number,1,0,1,0.0,1.1106915165381966e-05,1.0
44281,~*^^*/Punctuation,1,0,1,0.0,1.1106915165381966e-05,1.0
44282,엘시드/Noun,1,0,1,0.0,1.1106915165381966e-05,1.0
44283,개통/Noun,1,1,0,1.1115310228308472e-05,0.0,1.0
44284,쯔요시/Noun,1,1,0,1.1115310228308472e-05,0.0,1.0
44285,유동/Noun,1,1,0,1.1115310228308472e-05,0.0,1.0
44286,롬멜/Noun,1,1,0,1.1115310228308472e-05,0.0,1.0
44287,패망전/Noun,1,1,0,1.1115310228308472e-05,0.0,1.0
44288,때까지만해도/Foreign,1,0,1,0.0,1.1106915165381966e-05,1.0
44289,티에스토/Noun,1,1,0,1.1115310228308472e-05,0.0,1.0
44290,페데/Noun,1,1,0,1.1115310228308472e-05,0.0,1.0
44291,버블경제/Noun,1,1,0,1.1115310228308472e-05,0.0,1.0
44292,널럴하/Noun,1,0,1,0.0,1.1106915165381966e-05,1.0
44293,이되어가는영화네요/Foreign,1,1,0,1.1115310228308472e-05,0.0,1.0
44294,볼테/Noun,1,0,1,0.0,1.1106915165381966e-05,1.0
44295,쒰임/Noun,1,0,1,0.0,1.1106915165381966e-05,1.0
44296,강지석/Noun,1,0,1,0.0,1.1106915165381966e-05,1.0
44297,major/Alpha,1,1,0,1.1115310228308472e-05,0.0,1.0
44298,일계/Noun,1,0,1,0.0,1.1106915165381966e-05,1.0
44299,생리대/Noun,1,0,1,0.0,1.1106915165381966e-05,1.0
44300,막례/Noun,1,0,1,0.0,1.1106915165381966e-05,1.0
44301,어거스트/Noun,1,1,0,1.1115310228308472e-05,0.0,1.0
44302,화물선/Noun,1,0,1,0.0,1.1106915165381966e-05,1.0
44303,멀쩡/Noun,1,0,1,0.0,1.1106915165381966e-05,1.0
44304,샬로/Noun,1,1,0,1.1115310228308472e-05,0.0,1.0
44305,쥬산/Noun,1,1,0,1.1115310228308472e-05,0.0,1.0
44306,오라버님/Noun,1,1,0,1.1115310228308472e-05,0.0,1.0
44307,재완/Noun,1,1,0,1.1115310228308472e-05,0.0,1.0
44308,라영/Noun,1,1,0,1.1115310228308472e-05,0.0,1.0
44309,페라페/Noun,1,1,0,1.1115310228308472e-05,0.0,1.0
44310,파라파라/Noun,1,1,0,1.1115310228308472e-05,0.0,1.0
44311,져드/Noun,1,1,0,1.1115310228308472e-05,0.0,1.0
44312,떡국/Noun,1,1,0,1.1115310228308472e-05,0.0,1.0
44313,니뽄/Noun,1,1,0,1.1115310228308472e-05,0.0,1.0
44314,트라쇠즈들/Noun,1,0,1,0.0,1.1106915165381966e-05,1.0
44315,트라쇠르/Noun,1,0,1,0.0,1.1106915165381966e-05,1.0
44316,유쳥운/Noun,1,1,0,1.1115310228308472e-05,0.0,1.0
44317,6250/Number,1,1,0,1.1115310228308472e-05,0.0,1.0
44318,amy/Alpha,1,1,0,1.1115310228308472e-05,0.0,1.0
44319,레올로/Noun,1,1,0,1.1115310228308472e-05,0.0,1.0
44320,그러나저러나/Adverb,1,0,1,0.0,1.1106915165381966e-05,1.0
44321,차출/Noun,1,1,0,1.1115310228308472e-05,0.0,1.0
44322,칼총/Noun,1,0,1,0.0,1.1106915165381966e-05,1.0
44323,기계사/Noun,1,0,1,0.0,1.1106915165381966e-05,1.0
44324,화떄/Noun,1,0,1,0.0,1.1106915165381966e-05,1.0
44325,안지걸/Noun,1,1,0,1.1115310228308472e-05,0.0,1.0
44326,나카이/Noun,1,1,0,1.1115310228308472e-05,0.0,1.0
44327,사그라지다/Verb,1,1,0,1.1115310228308472e-05,0.0,1.0
44328,긔엽내/Noun,1,1,0,1.1115310228308472e-05,0.0,1.0
44329,책표지/Noun,1,1,0,1.1115310228308472e-05,0.0,1.0
44330,맥아덤스/Noun,1,1,0,1.1115310228308472e-05,0.0,1.0
44331,어렴풋보/Noun,1,1,0,1.1115310228308472e-05,0.0,1.0
44332,역사영화/Noun,1,1,0,1.1115310228308472e-05,0.0,1.0
44333,screw/Alpha,1,0,1,0.0,1.1106915165381966e-05,1.0
44334,이장님/Noun,1,1,0,1.1115310228308472e-05,0.0,1.0
44335,인스피/Noun,1,0,1,0.0,1.1106915165381966e-05,1.0
44336,기풍/Noun,1,0,1,0.0,1.1106915165381966e-05,1.0
44337,평탄/Noun,1,1,0,1.1115310228308472e-05,0.0,1.0
44338,박동/Noun,1,1,0,1.1115310228308472e-05,0.0,1.0
44339,26000원/Number,1,0,1,0.0,1.1106915165381966e-05,1.0
44340,한다연/Noun,1,0,1,0.0,1.1106915165381966e-05,1.0
44341,쮸쮸쮸/Noun,1,1,0,1.1115310228308472e-05,0.0,1.0
44342,받을껀/Noun,1,0,1,0.0,1.1106915165381966e-05,1.0
44343,밌었다/Noun,1,1,0,1.1115310228308472e-05,0.0,1.0
44344,정보원/Noun,1,1,0,1.1115310228308472e-05,0.0,1.0
44345,양국/Noun,1,1,0,1.1115310228308472e-05,0.0,1.0
44346,쥬기다/Noun,1,0,1,0.0,1.1106915165381966e-05,1.0
44347,우주비행/Noun,1,0,1,0.0,1.1106915165381966e-05,1.0
44348,이여도/Foreign,1,0,1,0.0,1.1106915165381966e-05,1.0
44349,주고봤는데/Foreign,1,0,1,0.0,1.1106915165381966e-05,1.0
44350,우문/Noun,1,0,1,0.0,1.1106915165381966e-05,1.0
44351,_~/Punctuation,1,0,1,0.0,1.1106915165381966e-05,1.0
44352,묘연/Noun,1,1,0,1.1115310228308472e-05,0.0,1.0
44353,가무/Noun,1,1,0,1.1115310228308472e-05,0.0,1.0
44354,있는겐/Noun,1,0,1,0.0,1.1106915165381966e-05,1.0
44355,무질서/Noun,1,1,0,1.1115310228308472e-05,0.0,1.0
44356,기괴/Noun,1,1,0,1.1115310228308472e-05,0.0,1.0
44357,팬용/Noun,1,0,1,0.0,1.1106915165381966e-05,1.0
44358,Tokyo/Alpha,1,0,1,0.0,1.1106915165381966e-05,1.0
44359,렌셔/Noun,1,1,0,1.1115310228308472e-05,0.0,1.0
44360,번꼭/Noun,1,1,0,1.1115310228308472e-05,0.0,1.0
44361,~~=^%=/Punctuation,1,0,1,0.0,1.1106915165381966e-05,1.0
44362,마작/Noun,1,1,0,1.1115310228308472e-05,0.0,1.0
44363,000000000/Number,1,1,0,1.1115310228308472e-05,0.0,1.0
44364,ㅎㅇㄹ/KoreanParticle,1,1,0,1.1115310228308472e-05,0.0,1.0
44365,두베/Noun,1,1,0,1.1115310228308472e-05,0.0,1.0
44366,예광탄/Noun,1,0,1,0.0,1.1106915165381966e-05,1.0
44367,근접/Noun,1,0,1,0.0,1.1106915165381966e-05,1.0
44368,신성/Noun,1,1,0,1.1115310228308472e-05,0.0,1.0
44369,좋았듬/Noun,1,0,1,0.0,1.1106915165381966e-05,1.0
44370,급니/Noun,1,1,0,1.1115310228308472e-05,0.0,1.0
44371,이게뭐얌/Noun,1,0,1,0.0,1.1106915165381966e-05,1.0
44372,꽃비/Noun,1,0,1,0.0,1.1106915165381966e-05,1.0
44373,썡얼/Noun,1,1,0,1.1115310228308472e-05,0.0,1.0
44374,40~50분/Number,1,1,0,1.1115310228308472e-05,0.0,1.0
44375,훌라춤/Noun,1,1,0,1.1115310228308472e-05,0.0,1.0
44376,자체발광/Noun,1,1,0,1.1115310228308472e-05,0.0,1.0
44377,가라사대/Noun,1,0,1,0.0,1.1106915165381966e-05,1.0
44378,도촬/Noun,1,0,1,0.0,1.1106915165381966e-05,1.0
44379,ㅋㅋㅊㅋㅋㅋ/KoreanParticle,1,0,1,0.0,1.1106915165381966e-05,1.0
44380,에어플레인/Noun,1,0,1,0.0,1.1106915165381966e-05,1.0
44381,ZAZ/Alpha,1,0,1,0.0,1.1106915165381966e-05,1.0
44382,전에나/Foreign,1,1,0,1.1115310228308472e-05,0.0,1.0
44383,휘둘림/Noun,1,0,1,0.0,1.1106915165381966e-05,1.0
44384,이가야/Noun,1,0,1,0.0,1.1106915165381966e-05,1.0
44385,달믐/Noun,1,1,0,1.1115310228308472e-05,0.0,1.0
44386,재테크/Noun,1,0,1,0.0,1.1106915165381966e-05,1.0
44387,에든다정신없는/Foreign,1,0,1,0.0,1.1106915165381966e-05,1.0
44388,뽕거/Noun,1,0,1,0.0,1.1106915165381966e-05,1.0
44389,한정식/Noun,1,0,1,0.0,1.1106915165381966e-05,1.0
44390,안제/Noun,1,0,1,0.0,1.1106915165381966e-05,1.0
44391,추나/Noun,1,0,1,0.0,1.1106915165381966e-05,1.0
44392,브레이크댄스/Noun,1,0,1,0.0,1.1106915165381966e-05,1.0
44393,비틀때/Noun,1,0,1,0.0,1.1106915165381966e-05,1.0
44394,4444/Number,1,0,1,0.0,1.1106915165381966e-05,1.0
44395,먕/Noun,1,0,1,0.0,1.1106915165381966e-05,1.0
44396,일글런드/Noun,1,0,1,0.0,1.1106915165381966e-05,1.0
44397,주치의/Noun,1,1,0,1.1115310228308472e-05,0.0,1.0
44398,레슬리같/Noun,1,1,0,1.1115310228308472e-05,0.0,1.0
44399,거냑/Noun,1,0,1,0.0,1.1106915165381966e-05,1.0
44400,뻘줌하/Noun,1,1,0,1.1115310228308472e-05,0.0,1.0
44401,우쿨렐레/Noun,1,1,0,1.1115310228308472e-05,0.0,1.0
44402,해핑엔딩/Noun,1,0,1,0.0,1.1106915165381966e-05,1.0
44403,후비안/Noun,1,0,1,0.0,1.1106915165381966e-05,1.0
44404,..-_-...../Punctuation,1,0,1,0.0,1.1106915165381966e-05,1.0
44405,포닉/Noun,1,1,0,1.1115310228308472e-05,0.0,1.0
44406,이재응/Noun,1,1,0,1.1115310228308472e-05,0.0,1.0
44407,믜/Noun,1,1,0,1.1115310228308472e-05,0.0,1.0
44408,니콜스땜/Noun,1,0,1,0.0,1.1106915165381966e-05,1.0
44409,읽어볼껄/Noun,1,0,1,0.0,1.1106915165381966e-05,1.0
44410,랭거/Noun,1,1,0,1.1115310228308472e-05,0.0,1.0
44411,..~~~/Punctuation,1,0,1,0.0,1.1106915165381966e-05,1.0
44412,월욜날/Noun,1,0,1,0.0,1.1106915165381966e-05,1.0
44413,이석/Noun,1,1,0,1.1115310228308472e-05,0.0,1.0
44414,암자/Noun,1,1,0,1.1115310228308472e-05,0.0,1.0
44415,흥암/Noun,1,1,0,1.1115310228308472e-05,0.0,1.0
44416,스텀/Noun,1,1,0,1.1115310228308472e-05,0.0,1.0
44417,헬캣/Noun,1,0,1,0.0,1.1106915165381966e-05,1.0
44418,utjdfms/Alpha,1,0,1,0.0,1.1106915165381966e-05,1.0
44419,dadf/Alpha,1,0,1,0.0,1.1106915165381966e-05,1.0
44420,sikdnasdut/Alpha,1,0,1,0.0,1.1106915165381966e-05,1.0
44421,xsoas/Alpha,1,0,1,0.0,1.1106915165381966e-05,1.0
44422,chsjd/Alpha,1,0,1,0.0,1.1106915165381966e-05,1.0
44423,멜랑콜리아/Noun,1,1,0,1.1115310228308472e-05,0.0,1.0
44424,도급/Noun,1,1,0,1.1115310228308472e-05,0.0,1.0
44425,톰때문/Noun,1,0,1,0.0,1.1106915165381966e-05,1.0
44426,perfection/Alpha,1,1,0,1.1115310228308472e-05,0.0,1.0
44427,이교도/Noun,1,0,1,0.0,1.1106915165381966e-05,1.0
44428,뉴완다/Noun,1,0,1,0.0,1.1106915165381966e-05,1.0
44429,드빌/Noun,1,1,0,1.1115310228308472e-05,0.0,1.0
44430,상선/Noun,1,1,0,1.1115310228308472e-05,0.0,1.0
44431,주천/Noun,1,1,0,1.1115310228308472e-05,0.0,1.0
44432,hero/Alpha,1,1,0,1.1115310228308472e-05,0.0,1.0
44433,오툴/Noun,1,0,1,0.0,1.1106915165381966e-05,1.0
44434,도생/Foreign,1,1,0,1.1115310228308472e-05,0.0,1.0
44435,1889년/Number,1,1,0,1.1115310228308472e-05,0.0,1.0
44436,쳐부슬/Noun,1,0,1,0.0,1.1106915165381966e-05,1.0
44437,그득/Noun,1,1,0,1.1115310228308472e-05,0.0,1.0
44438,옄/Noun,1,1,0,1.1115310228308472e-05,0.0,1.0
44439,차재완/Noun,1,1,0,1.1115310228308472e-05,0.0,1.0
44440,울퉁불퉁/Adverb,1,1,0,1.1115310228308472e-05,0.0,1.0
44441,덜컹덜컹/Adverb,1,1,0,1.1115310228308472e-05,0.0,1.0
44442,불복종/Noun,1,0,1,0.0,1.1106915165381966e-05,1.0
44443,군소/Noun,1,0,1,0.0,1.1106915165381966e-05,1.0
44444,꺽지/Noun,1,0,1,0.0,1.1106915165381966e-05,1.0
44445,근신/Noun,1,0,1,0.0,1.1106915165381966e-05,1.0
44446,입방/Noun,1,0,1,0.0,1.1106915165381966e-05,1.0
44447,ㅡㅐ/KoreanParticle,1,0,1,0.0,1.1106915165381966e-05,1.0
44448,쓰럭/Noun,1,0,1,0.0,1.1106915165381966e-05,1.0
44449,!!!@!/Punctuation,1,1,0,1.1115310228308472e-05,0.0,1.0
44450,말티즈/Noun,1,0,1,0.0,1.1106915165381966e-05,1.0
44451,1200/Number,1,1,0,1.1115310228308472e-05,0.0,1.0
44452,ghdvy/Alpha,1,1,0,1.1115310228308472e-05,0.0,1.0
44453,늨/Noun,1,0,1,0.0,1.1106915165381966e-05,1.0
44454,훈족/Noun,1,0,1,0.0,1.1106915165381966e-05,1.0
44455,여진족/Noun,1,0,1,0.0,1.1106915165381966e-05,1.0
44456,엔별/Noun,1,1,0,1.1115310228308472e-05,0.0,1.0
44457,",...?/Punctuation",1,1,0,1.1115310228308472e-05,0.0,1.0
44458,김복/Noun,1,0,1,0.0,1.1106915165381966e-05,1.0
44459,졔이비흥해/Noun,1,1,0,1.1115310228308472e-05,0.0,1.0
44460,죠앟씀/Noun,1,1,0,1.1115310228308472e-05,0.0,1.0
44461,고잉/Noun,1,1,0,1.1115310228308472e-05,0.0,1.0
44462,능글능글/Adverb,1,1,0,1.1115310228308472e-05,0.0,1.0
44463,아지랑이/Noun,1,1,0,1.1115310228308472e-05,0.0,1.0
44464,이팅/Noun,1,1,0,1.1115310228308472e-05,0.0,1.0
44465,민년/Noun,1,0,1,0.0,1.1106915165381966e-05,1.0
44466,믿지맙시/Noun,1,1,0,1.1115310228308472e-05,0.0,1.0
44467,왜안됫/Noun,1,1,0,1.1115310228308472e-05,0.0,1.0
44468,goodgoodgoodgoodgoodgoodgood/Alpha,1,1,0,1.1115310228308472e-05,0.0,1.0
44469,더넒혀보/Noun,1,0,1,0.0,1.1106915165381966e-05,1.0
44470,느레/Noun,1,0,1,0.0,1.1106915165381966e-05,1.0
44471,도교/Noun,1,0,1,0.0,1.1106915165381966e-05,1.0
44472,이병우/Noun,1,1,0,1.1115310228308472e-05,0.0,1.0
44473,왜바꼇노/Noun,1,1,0,1.1115310228308472e-05,0.0,1.0
44474,통쾌헤/Noun,1,1,0,1.1115310228308472e-05,0.0,1.0
44475,까지참고보다/Foreign,1,0,1,0.0,1.1106915165381966e-05,1.0
44476,2.12/Number,1,0,1,0.0,1.1106915165381966e-05,1.0
44477,소탈/Noun,1,1,0,1.1115310228308472e-05,0.0,1.0
44478,촘/Noun,1,0,1,0.0,1.1106915165381966e-05,1.0
44479,물풍선/Noun,1,0,1,0.0,1.1106915165381966e-05,1.0
44480,친어머니/Noun,1,0,1,0.0,1.1106915165381966e-05,1.0
44481,산보/Noun,1,0,1,0.0,1.1106915165381966e-05,1.0
44482,쉣돈/Noun,1,0,1,0.0,1.1106915165381966e-05,1.0
44483,즐함/Noun,1,0,1,0.0,1.1106915165381966e-05,1.0
44484,흥이나다/Verb,1,0,1,0.0,1.1106915165381966e-05,1.0
44485,담음/Noun,1,0,1,0.0,1.1106915165381966e-05,1.0
44486,악랄/Noun,1,0,1,0.0,1.1106915165381966e-05,1.0
44487,뱍/Noun,1,1,0,1.1115310228308472e-05,0.0,1.0
44488,히즘/Noun,1,0,1,0.0,1.1106915165381966e-05,1.0
44489,메조/Noun,1,0,1,0.0,1.1106915165381966e-05,1.0
44490,베뎃땜/Noun,1,0,1,0.0,1.1106915165381966e-05,1.0
44491,소에서/Foreign,1,1,0,1.1115310228308472e-05,0.0,1.0
44492,:>/Punctuation,1,1,0,1.1115310228308472e-05,0.0,1.0
44493,././././././/Punctuation,1,0,1,0.0,1.1106915165381966e-05,1.0
44494,쨩보는맛/Noun,1,1,0,1.1115310228308472e-05,0.0,1.0
44495,인문학자/Noun,1,0,1,0.0,1.1106915165381966e-05,1.0
44496,헷헷/Noun,1,1,0,1.1115310228308472e-05,0.0,1.0
44497,Delusion/Alpha,1,1,0,1.1115310228308472e-05,0.0,1.0
44498,Dream/Alpha,1,1,0,1.1115310228308472e-05,0.0,1.0
44499,American/Alpha,1,1,0,1.1115310228308472e-05,0.0,1.0
44500,날므/Noun,1,1,0,1.1115310228308472e-05,0.0,1.0
44501,콩쾌/Noun,1,1,0,1.1115310228308472e-05,0.0,1.0
44502,gksw/Alpha,1,1,0,1.1115310228308472e-05,0.0,1.0
44503,100만분/Number,1,0,1,0.0,1.1106915165381966e-05,1.0
44504,야마구치/Noun,1,1,0,1.1115310228308472e-05,0.0,1.0
44505,치루는일/Noun,1,1,0,1.1115310228308472e-05,0.0,1.0
44506,cupid/Alpha,1,0,1,0.0,1.1106915165381966e-05,1.0
44507,Stupid/Alpha,1,0,1,0.0,1.1106915165381966e-05,1.0
44508,쑤레긔/Noun,1,0,1,0.0,1.1106915165381966e-05,1.0
44509,푹잠/Noun,1,0,1,0.0,1.1106915165381966e-05,1.0
44510,고환/Noun,1,0,1,0.0,1.1106915165381966e-05,1.0
44511,음경/Noun,1,0,1,0.0,1.1106915165381966e-05,1.0
44512,유두슨거/Noun,1,0,1,0.0,1.1106915165381966e-05,1.0
44513,객꿀잼/Noun,1,0,1,0.0,1.1106915165381966e-05,1.0
44514,라깡/Noun,1,0,1,0.0,1.1106915165381966e-05,1.0
44515,들뢰즈/Noun,1,0,1,0.0,1.1106915165381966e-05,1.0
44516,스크레치/Noun,1,0,1,0.0,1.1106915165381966e-05,1.0
44517,카탈루니아/Noun,1,1,0,1.1115310228308472e-05,0.0,1.0
44518,이키모노가카리/Noun,1,1,0,1.1115310228308472e-05,0.0,1.0
44519,소인/Noun,1,0,1,0.0,1.1106915165381966e-05,1.0
44520,터졋다/Noun,1,1,0,1.1115310228308472e-05,0.0,1.0
44521,햇더/Noun,1,1,0,1.1115310228308472e-05,0.0,1.0
44522,우주견공/Noun,1,1,0,1.1115310228308472e-05,0.0,1.0
44523,/www.wowtv.co.kr/newscenter/news/view.asp?bcode=T30001000&artid=A201412170703/URL,1,0,1,0.0,1.1106915165381966e-05,1.0
44524,://Foreign,1,0,1,0.0,1.1106915165381966e-05,1.0
44525,거문고/Noun,1,1,0,1.1115310228308472e-05,0.0,1.0
44526,이재우/Noun,1,1,0,1.1115310228308472e-05,0.0,1.0
44527,사발면/Noun,1,0,1,0.0,1.1106915165381966e-05,1.0
44528,이우혁/Noun,1,0,1,0.0,1.1106915165381966e-05,1.0
44529,부셰미/Noun,1,1,0,1.1115310228308472e-05,0.0,1.0
44530,개똥입/Noun,1,1,0,1.1115310228308472e-05,0.0,1.0
44531,^~!!!!!!!!!/Punctuation,1,1,0,1.1115310228308472e-05,0.0,1.0
44532,남선/Noun,1,1,0,1.1115310228308472e-05,0.0,1.0
44533,웃대/Noun,1,1,0,1.1115310228308472e-05,0.0,1.0
44534,줬는데샘물교회/Foreign,1,0,1,0.0,1.1106915165381966e-05,1.0
44535,600억/Number,1,0,1,0.0,1.1106915165381966e-05,1.0
44536,Sir/Alpha,1,1,0,1.1115310228308472e-05,0.0,1.0
44537,Ah/Alpha,1,1,0,1.1115310228308472e-05,0.0,1.0
44538,오억만배/Noun,1,0,1,0.0,1.1106915165381966e-05,1.0
44539,폼생폼/Noun,1,0,1,0.0,1.1106915165381966e-05,1.0
44540,이연서/Noun,1,1,0,1.1115310228308472e-05,0.0,1.0
44541,졸작삘/Noun,1,0,1,0.0,1.1106915165381966e-05,1.0
44542,리얼돌/Noun,1,0,1,0.0,1.1106915165381966e-05,1.0
44543,3096일/Number,1,1,0,1.1115310228308472e-05,0.0,1.0
44544,신혼부부/Noun,1,1,0,1.1115310228308472e-05,0.0,1.0
44545,거렸어/Noun,1,1,0,1.1115310228308472e-05,0.0,1.0
44546,입꼬매/Noun,1,1,0,1.1115310228308472e-05,0.0,1.0
44547,김대호/Noun,1,0,1,0.0,1.1106915165381966e-05,1.0
44548,송시/Noun,1,0,1,0.0,1.1106915165381966e-05,1.0
44549,경추/Noun,1,0,1,0.0,1.1106915165381966e-05,1.0
44550,쒯이/Noun,1,0,1,0.0,1.1106915165381966e-05,1.0
44551,답없을껄/Noun,1,0,1,0.0,1.1106915165381966e-05,1.0
44552,웤스/Noun,1,0,1,0.0,1.1106915165381966e-05,1.0
44553,런다/Noun,1,0,1,0.0,1.1106915165381966e-05,1.0
44554,^^;;+/Punctuation,1,1,0,1.1115310228308472e-05,0.0,1.0
44555,늪속/Noun,1,1,0,1.1115310228308472e-05,0.0,1.0
44556,엽기살인/Noun,1,1,0,1.1115310228308472e-05,0.0,1.0
44557,병문안/Noun,1,0,1,0.0,1.1106915165381966e-05,1.0
44558,+^.^+/Punctuation,1,1,0,1.1115310228308472e-05,0.0,1.0
44559,ticket/Alpha,1,0,1,0.0,1.1106915165381966e-05,1.0
44560,바이럴/Noun,1,0,1,0.0,1.1106915165381966e-05,1.0
44561,!!!!_!/Punctuation,1,1,0,1.1115310228308472e-05,0.0,1.0
44562,썪는줄/Noun,1,0,1,0.0,1.1106915165381966e-05,1.0
44563,징병제/Noun,1,1,0,1.1115310228308472e-05,0.0,1.0
44564,은격/Noun,1,0,1,0.0,1.1106915165381966e-05,1.0
44565,ing/Alpha,1,1,0,1.1115310228308472e-05,0.0,1.0
44566,브리튼/Noun,1,1,0,1.1115310228308472e-05,0.0,1.0
44567,떙큐/Noun,1,1,0,1.1115310228308472e-05,0.0,1.0
44568,얼라이언스/Noun,1,1,0,1.1115310228308472e-05,0.0,1.0
44569,코스튬/Noun,1,0,1,0.0,1.1106915165381966e-05,1.0
44570,널렸으/Noun,1,0,1,0.0,1.1106915165381966e-05,1.0
44571,2009.03/Number,1,1,0,1.1115310228308472e-05,0.0,1.0
44572,잔해/Noun,1,1,0,1.1115310228308472e-05,0.0,1.0
44573,알랴븅/Noun,1,1,0,1.1115310228308472e-05,0.0,1.0
44574,폰곡/Noun,1,1,0,1.1115310228308472e-05,0.0,1.0
44575,텔리/Noun,1,1,0,1.1115310228308472e-05,0.0,1.0
44576,ㅈㄱㄴㅊ/KoreanParticle,1,1,0,1.1115310228308472e-05,0.0,1.0
44577,Saves/Alpha,1,1,0,1.1115310228308472e-05,0.0,1.0
44578,Gonna/Alpha,1,1,0,1.1115310228308472e-05,0.0,1.0
44579,부더/Noun,1,0,1,0.0,1.1106915165381966e-05,1.0
44580,1939-1940/Number,1,1,0,1.1115310228308472e-05,0.0,1.0
44581,보았넹/Noun,1,0,1,0.0,1.1106915165381966e-05,1.0
44582,박기원/Noun,1,1,0,1.1115310228308472e-05,0.0,1.0
44583,집단성폭행/Noun,1,1,0,1.1115310228308472e-05,0.0,1.0
44584,전국환/Noun,1,1,0,1.1115310228308472e-05,0.0,1.0
44585,뭐기/Noun,1,0,1,0.0,1.1106915165381966e-05,1.0
44586,너욱/Noun,1,1,0,1.1115310228308472e-05,0.0,1.0
44587,호타로/Noun,1,1,0,1.1115310228308472e-05,0.0,1.0
44588,빈유/Noun,1,1,0,1.1115310228308472e-05,0.0,1.0
44589,폐품/Noun,1,0,1,0.0,1.1106915165381966e-05,1.0
44590,통채/Noun,1,0,1,0.0,1.1106915165381966e-05,1.0
44591,갈라티아/Noun,1,0,1,0.0,1.1106915165381966e-05,1.0
44592,96%/Number,1,0,1,0.0,1.1106915165381966e-05,1.0
44593,Support/Alpha,1,1,0,1.1115310228308472e-05,0.0,1.0
44594,ShiHou/Alpha,1,1,0,1.1115310228308472e-05,0.0,1.0
44595,warm/Alpha,1,1,0,1.1115310228308472e-05,0.0,1.0
44596,대수준영화/Foreign,1,0,1,0.0,1.1106915165381966e-05,1.0
44597,황금광시대/Noun,1,1,0,1.1115310228308472e-05,0.0,1.0
44598,모던타임즈/Noun,1,1,0,1.1115310228308472e-05,0.0,1.0
44599,student/Alpha,1,0,1,0.0,1.1106915165381966e-05,1.0
44600,school/Alpha,1,0,1,0.0,1.1106915165381966e-05,1.0
44601,elementary/Alpha,1,0,1,0.0,1.1106915165381966e-05,1.0
44602,work/Alpha,1,0,1,0.0,1.1106915165381966e-05,1.0
44603,엮네/Noun,1,0,1,0.0,1.1106915165381966e-05,1.0
44604,자철/Noun,1,1,0,1.1115310228308472e-05,0.0,1.0
44605,슬리퍼/Noun,1,0,1,0.0,1.1106915165381966e-05,1.0
44606,준겨/Noun,1,0,1,0.0,1.1106915165381966e-05,1.0
44607,덕새/Noun,1,0,1,0.0,1.1106915165381966e-05,1.0
44608,??;;;;/Punctuation,1,0,1,0.0,1.1106915165381966e-05,1.0
44609,도안돼서전편과감독이다른가/Foreign,1,0,1,0.0,1.1106915165381966e-05,1.0
44610,9.82/Number,1,0,1,0.0,1.1106915165381966e-05,1.0
44611,Christ/Alpha,1,0,1,0.0,1.1106915165381966e-05,1.0
44612,기피/Noun,1,1,0,1.1115310228308472e-05,0.0,1.0
44613,마저/Foreign,1,0,1,0.0,1.1106915165381966e-05,1.0
44614,뷰http://blog.naver.com/yulexa?Redirect=Log&logNo=70152368837/URL,1,1,0,1.1115310228308472e-05,0.0,1.0
44615,비덕/Noun,1,0,1,0.0,1.1106915165381966e-05,1.0
44616,유역/Noun,1,0,1,0.0,1.1106915165381966e-05,1.0
44617,짤/Foreign,1,0,1,0.0,1.1106915165381966e-05,1.0
44618,EOE/Alpha,1,1,0,1.1115310228308472e-05,0.0,1.0
44619,다카포/Noun,1,1,0,1.1115310228308472e-05,0.0,1.0
44620,터트려왔/Noun,1,1,0,1.1115310228308472e-05,0.0,1.0
44621,이용권/Noun,1,1,0,1.1115310228308472e-05,0.0,1.0
44622,store/Alpha,1,1,0,1.1115310228308472e-05,0.0,1.0
44623,1974/Number,1,0,1,0.0,1.1106915165381966e-05,1.0
44624,Lie/Alpha,1,0,1,0.0,1.1106915165381966e-05,1.0
44625,Corpses/Alpha,1,0,1,0.0,1.1106915165381966e-05,1.0
44626,Sleeping/Alpha,1,0,1,0.0,1.1106915165381966e-05,1.0
44627,돈퍼부어/Noun,1,0,1,0.0,1.1106915165381966e-05,1.0
44628,범임/Noun,1,0,1,0.0,1.1106915165381966e-05,1.0
44629,후버댐/Noun,1,1,0,1.1115310228308472e-05,0.0,1.0
44630,!@^^@/Punctuation,1,1,0,1.1115310228308472e-05,0.0,1.0
44631,까브리머싯씀/Noun,1,1,0,1.1115310228308472e-05,0.0,1.0
44632,황성/Noun,1,0,1,0.0,1.1106915165381966e-05,1.0
44633,peace/Alpha,1,1,0,1.1115310228308472e-05,0.0,1.0
44634,Rest/Alpha,1,1,0,1.1115310228308472e-05,0.0,1.0
44635,명멸/Noun,1,1,0,1.1115310228308472e-05,0.0,1.0
44636,외고/Noun,1,0,1,0.0,1.1106915165381966e-05,1.0
44637,서먹하다/Adjective,1,1,0,1.1115310228308472e-05,0.0,1.0
44638,호도/Noun,1,0,1,0.0,1.1106915165381966e-05,1.0
44639,허청/Noun,1,1,0,1.1115310228308472e-05,0.0,1.0
44640,빛속/Noun,1,1,0,1.1115310228308472e-05,0.0,1.0
44641,유광수/Noun,1,1,0,1.1115310228308472e-05,0.0,1.0
44642,...=/Punctuation,1,1,0,1.1115310228308472e-05,0.0,1.0
44643,햄스워/Noun,1,0,1,0.0,1.1106915165381966e-05,1.0
44644,웨볼/Noun,1,1,0,1.1115310228308472e-05,0.0,1.0
44645,전차남/Noun,1,1,0,1.1115310228308472e-05,0.0,1.0
44646,라마디/Noun,1,1,0,1.1115310228308472e-05,0.0,1.0
44647,디거/Noun,1,1,0,1.1115310228308472e-05,0.0,1.0
44648,?!!?!?/Punctuation,1,0,1,0.0,1.1106915165381966e-05,1.0
44649,-'/Punctuation,1,1,0,1.1115310228308472e-05,0.0,1.0
44650,까오/Noun,1,1,0,1.1115310228308472e-05,0.0,1.0
44651,더킥/Noun,1,1,0,1.1115310228308472e-05,0.0,1.0
44652,의희/Noun,1,1,0,1.1115310228308472e-05,0.0,1.0
44653,부케/Noun,1,0,1,0.0,1.1106915165381966e-05,1.0
44654,스폐/Noun,1,1,0,1.1115310228308472e-05,0.0,1.0
44655,'..../Punctuation,1,1,0,1.1115310228308472e-05,0.0,1.0
44656,frank/Alpha,1,1,0,1.1115310228308472e-05,0.0,1.0
44657,없엇구/Noun,1,0,1,0.0,1.1106915165381966e-05,1.0
44658,반째라/Foreign,1,0,1,0.0,1.1106915165381966e-05,1.0
44659,롱디/Noun,1,0,1,0.0,1.1106915165381966e-05,1.0
44660,"8,000/Number",1,0,1,0.0,1.1106915165381966e-05,1.0
44661,뽀로롱/Noun,1,1,0,1.1115310228308472e-05,0.0,1.0
44662,뽀로뽀/Noun,1,1,0,1.1115310228308472e-05,0.0,1.0
44663,ㅇㅋㅇㅋ/KoreanParticle,1,1,0,1.1115310228308472e-05,0.0,1.0
44664,하일지/Noun,1,1,0,1.1115310228308472e-05,0.0,1.0
44665,moives/Alpha,1,1,0,1.1115310228308472e-05,0.0,1.0
44666,인도차이나/Noun,1,1,0,1.1115310228308472e-05,0.0,1.0
44667,bk/Alpha,1,1,0,1.1115310228308472e-05,0.0,1.0
44668,시어스/Noun,1,0,1,0.0,1.1106915165381966e-05,1.0
44669,그린스크린/Noun,1,0,1,0.0,1.1106915165381966e-05,1.0
44670,잉글런드/Noun,1,0,1,0.0,1.1106915165381966e-05,1.0
44671,느작없어/Noun,1,0,1,0.0,1.1106915165381966e-05,1.0
44672,김종수/Noun,1,1,0,1.1115310228308472e-05,0.0,1.0
44673,쭐쭐이/Noun,1,0,1,0.0,1.1106915165381966e-05,1.0
44674,씬때문/Noun,1,1,0,1.1115310228308472e-05,0.0,1.0
44675,온더로드/Noun,1,0,1,0.0,1.1106915165381966e-05,1.0
44676,대현/Noun,1,0,1,0.0,1.1106915165381966e-05,1.0
44677,메갈로돈/Noun,1,0,1,0.0,1.1106915165381966e-05,1.0
44678,만드셧구/Noun,1,1,0,1.1115310228308472e-05,0.0,1.0
44679,너무슬펏음/Noun,1,1,0,1.1115310228308472e-05,0.0,1.0
44680,기축옥사/Noun,1,1,0,1.1115310228308472e-05,0.0,1.0
44681,허헛/Noun,1,1,0,1.1115310228308472e-05,0.0,1.0
44682,겁보/Noun,1,0,1,0.0,1.1106915165381966e-05,1.0
44683,킬라킬/Noun,1,0,1,0.0,1.1106915165381966e-05,1.0
44684,침체/Noun,1,0,1,0.0,1.1106915165381966e-05,1.0
44685,죽마고우/Noun,1,0,1,0.0,1.1106915165381966e-05,1.0
44686,비레기/Noun,1,0,1,0.0,1.1106915165381966e-05,1.0
44687,르르/Noun,1,0,1,0.0,1.1106915165381966e-05,1.0
44688,할겄/Noun,1,1,0,1.1115310228308472e-05,0.0,1.0
44689,성김/Noun,1,0,1,0.0,1.1106915165381966e-05,1.0
44690,헤셔/Noun,1,0,1,0.0,1.1106915165381966e-05,1.0
44691,비선형/Noun,1,1,0,1.1115310228308472e-05,0.0,1.0
44692,격분/Noun,1,1,0,1.1115310228308472e-05,0.0,1.0
44693,실증/Noun,1,0,1,0.0,1.1106915165381966e-05,1.0
44694,성군/Noun,1,0,1,0.0,1.1106915165381966e-05,1.0
44695,17시/Number,1,0,1,0.0,1.1106915165381966e-05,1.0
44696,라/Foreign,1,0,1,0.0,1.1106915165381966e-05,1.0
44697,채민해/Noun,1,0,1,0.0,1.1106915165381966e-05,1.0
44698,처준/Noun,1,1,0,1.1115310228308472e-05,0.0,1.0
44699,총을드/Noun,1,0,1,0.0,1.1106915165381966e-05,1.0
44700,데데/Noun,1,1,0,1.1115310228308472e-05,0.0,1.0
44701,감덩/Noun,1,1,0,1.1115310228308472e-05,0.0,1.0
44702,9천만/Number,1,0,1,0.0,1.1106915165381966e-05,1.0
44703,러새키/Noun,1,1,0,1.1115310228308472e-05,0.0,1.0
44704,컴컴하다/Adjective,1,0,1,0.0,1.1106915165381966e-05,1.0
44705,얼설픈/Noun,1,0,1,0.0,1.1106915165381966e-05,1.0
44706,퍼거스/Noun,1,1,0,1.1115310228308472e-05,0.0,1.0
44707,주루/Noun,1,1,0,1.1115310228308472e-05,0.0,1.0
44708,블법/Noun,1,0,1,0.0,1.1106915165381966e-05,1.0
44709,갓으/Noun,1,0,1,0.0,1.1106915165381966e-05,1.0
44710,왕권/Noun,1,0,1,0.0,1.1106915165381966e-05,1.0
44711,입사시험/Noun,1,0,1,0.0,1.1106915165381966e-05,1.0
44712,넣으랬/Noun,1,0,1,0.0,1.1106915165381966e-05,1.0
44713,헨타이/Noun,1,0,1,0.0,1.1106915165381966e-05,1.0
44714,뽕놓다/Verb,1,1,0,1.1115310228308472e-05,0.0,1.0
44715,젊은것/Noun,1,1,0,1.1115310228308472e-05,0.0,1.0
44716,스프레이/Noun,1,0,1,0.0,1.1106915165381966e-05,1.0
44717,People/Alpha,1,1,0,1.1115310228308472e-05,0.0,1.0
44718,Sleepy/Alpha,1,1,0,1.1115310228308472e-05,0.0,1.0
44719,삐짝/Noun,1,1,0,1.1115310228308472e-05,0.0,1.0
44720,부탄가스/Noun,1,0,1,0.0,1.1106915165381966e-05,1.0
44721,솔깃하다/Adjective,1,0,1,0.0,1.1106915165381966e-05,1.0
44722,~~~~^.^~~~~/Punctuation,1,1,0,1.1115310228308472e-05,0.0,1.0
44723,멘홀/Noun,1,0,1,0.0,1.1106915165381966e-05,1.0
44724,다쉣/Noun,1,0,1,0.0,1.1106915165381966e-05,1.0
44725,문헌/Noun,1,1,0,1.1115310228308472e-05,0.0,1.0
44726,답임/Noun,1,0,1,0.0,1.1106915165381966e-05,1.0
44727,일부일처제/Noun,1,0,1,0.0,1.1106915165381966e-05,1.0
44728,종종걸음/Noun,1,1,0,1.1115310228308472e-05,0.0,1.0
44729,에쿠스/Noun,1,0,1,0.0,1.1106915165381966e-05,1.0
44730,촬감/Noun,1,0,1,0.0,1.1106915165381966e-05,1.0
44731,늦잠/Noun,1,0,1,0.0,1.1106915165381966e-05,1.0
44732,milllers/Alpha,1,1,0,1.1115310228308472e-05,0.0,1.0
44733,ㅡㄴ/KoreanParticle,1,1,0,1.1115310228308472e-05,0.0,1.0
44734,acting/Alpha,1,1,0,1.1115310228308472e-05,0.0,1.0
44735,Houjun/Alpha,1,1,0,1.1115310228308472e-05,0.0,1.0
44736,Shi/Alpha,1,1,0,1.1115310228308472e-05,0.0,1.0
44737,In/Alpha,1,1,0,1.1115310228308472e-05,0.0,1.0
44738,깨작깨작/Adverb,1,1,0,1.1115310228308472e-05,0.0,1.0
44739,!~!/Punctuation,1,0,1,0.0,1.1106915165381966e-05,1.0
44740,낚으려/Noun,1,0,1,0.0,1.1106915165381966e-05,1.0
44741,똥점/Noun,1,0,1,0.0,1.1106915165381966e-05,1.0
44742,뿌지직/Noun,1,0,1,0.0,1.1106915165381966e-05,1.0
44743,wierdo/Alpha,1,0,1,0.0,1.1106915165381966e-05,1.0
44744,발칸포/Noun,1,1,0,1.1115310228308472e-05,0.0,1.0
44745,고주연/Noun,1,1,0,1.1115310228308472e-05,0.0,1.0
44746,불씩이나/Foreign,1,0,1,0.0,1.1106915165381966e-05,1.0
44747,다잉영/Noun,1,1,0,1.1115310228308472e-05,0.0,1.0
44748,빅리그/Noun,1,0,1,0.0,1.1106915165381966e-05,1.0
44749,코미디빅리그/Noun,1,0,1,0.0,1.1106915165381966e-05,1.0
44750,에극장전체관객이/Foreign,1,0,1,0.0,1.1106915165381966e-05,1.0
44751,강강강/Noun,1,0,1,0.0,1.1106915165381966e-05,1.0
44752,폐습/Noun,1,1,0,1.1115310228308472e-05,0.0,1.0
44753,fks/Alpha,1,0,1,0.0,1.1106915165381966e-05,1.0
44754,sodr/Alpha,1,0,1,0.0,1.1106915165381966e-05,1.0
44755,눈졸/Noun,1,0,1,0.0,1.1106915165381966e-05,1.0
44756,의현/Noun,1,0,1,0.0,1.1106915165381966e-05,1.0
44757,이어져가니까/Foreign,1,0,1,0.0,1.1106915165381966e-05,1.0
44758,김도진/Noun,1,1,0,1.1115310228308472e-05,0.0,1.0
44759,골기퍼/Noun,1,0,1,0.0,1.1106915165381966e-05,1.0
44760,봴수/Noun,1,1,0,1.1115310228308472e-05,0.0,1.0
44761,자량/Noun,1,1,0,1.1115310228308472e-05,0.0,1.0
44762,박상아/Noun,1,0,1,0.0,1.1106915165381966e-05,1.0
44763,뿐인/Foreign,1,0,1,0.0,1.1106915165381966e-05,1.0
44764,여주보/Noun,1,0,1,0.0,1.1106915165381966e-05,1.0
44765,creatures/Alpha,1,1,0,1.1115310228308472e-05,0.0,1.0
44766,제헌절/Noun,1,1,0,1.1115310228308472e-05,0.0,1.0
44767,위핏/Noun,1,1,0,1.1115310228308472e-05,0.0,1.0
44768,Qord/Alpha,1,1,0,1.1115310228308472e-05,0.0,1.0
44769,문화영/Noun,1,1,0,1.1115310228308472e-05,0.0,1.0
44770,쩔쩔매다/Verb,1,0,1,0.0,1.1106915165381966e-05,1.0
44771,파드메/Noun,1,1,0,1.1115310228308472e-05,0.0,1.0
44772,찱흑들/Noun,1,0,1,0.0,1.1106915165381966e-05,1.0
44773,언뜻언뜻/Adverb,1,1,0,1.1115310228308472e-05,0.0,1.0
44774,Jackson/Alpha,1,1,0,1.1115310228308472e-05,0.0,1.0
44775,Lee/Alpha,1,1,0,1.1115310228308472e-05,0.0,1.0
44776,Jimmy/Alpha,1,1,0,1.1115310228308472e-05,0.0,1.0
44777,murdered/Alpha,1,1,0,1.1115310228308472e-05,0.0,1.0
44778,다모아/Noun,1,0,1,0.0,1.1106915165381966e-05,1.0
44779,쫑난거임/Noun,1,0,1,0.0,1.1106915165381966e-05,1.0
44780,강영만/Noun,1,0,1,0.0,1.1106915165381966e-05,1.0
44781,데스크/Noun,1,1,0,1.1115310228308472e-05,0.0,1.0
44782,쟁겨두/Noun,1,0,1,0.0,1.1106915165381966e-05,1.0
44783,식량/Noun,1,0,1,0.0,1.1106915165381966e-05,1.0
44784,불쑥/Noun,1,0,1,0.0,1.1106915165381966e-05,1.0
44785,아닐런지/Noun,1,1,0,1.1115310228308472e-05,0.0,1.0
44786,?=/Punctuation,1,1,0,1.1115310228308472e-05,0.0,1.0
44787,누규/Noun,1,1,0,1.1115310228308472e-05,0.0,1.0
44788,~~-/Punctuation,1,0,1,0.0,1.1106915165381966e-05,1.0
44789,싸잡히다/Verb,1,0,1,0.0,1.1106915165381966e-05,1.0
44790,LBC/Alpha,1,1,0,1.1115310228308472e-05,0.0,1.0
44791,cqn/Alpha,1,0,1,0.0,1.1106915165381966e-05,1.0
44792,포획/Noun,1,1,0,1.1115310228308472e-05,0.0,1.0
44793,물벼락/Noun,1,0,1,0.0,1.1106915165381966e-05,1.0
44794,김빈/Noun,1,0,1,0.0,1.1106915165381966e-05,1.0
44795,ㅇㅠ/KoreanParticle,1,1,0,1.1115310228308472e-05,0.0,1.0
44796,만무방/Noun,1,1,0,1.1115310228308472e-05,0.0,1.0
44797,봤는뎨/Noun,1,1,0,1.1115310228308472e-05,0.0,1.0
44798,보년/Noun,1,1,0,1.1115310228308472e-05,0.0,1.0
44799,analysis/Alpha,1,0,1,0.0,1.1106915165381966e-05,1.0
44800,mathematical/Alpha,1,0,1,0.0,1.1106915165381966e-05,1.0
44801,principles/Alpha,1,0,1,0.0,1.1106915165381966e-05,1.0
44802,rudin/Alpha,1,0,1,0.0,1.1106915165381966e-05,1.0
44803,존잼업/Noun,1,0,1,0.0,1.1106915165381966e-05,1.0
44804,임강/Noun,1,1,0,1.1115310228308472e-05,0.0,1.0
44805,얼스틴/Noun,1,1,0,1.1115310228308472e-05,0.0,1.0
44806,준닷/Noun,1,0,1,0.0,1.1106915165381966e-05,1.0
44807,창겨/Noun,1,1,0,1.1115310228308472e-05,0.0,1.0
44808,꼬바/Noun,1,1,0,1.1115310228308472e-05,0.0,1.0
44809,까/Foreign,1,0,1,0.0,1.1106915165381966e-05,1.0
44810,스하/Noun,1,0,1,0.0,1.1106915165381966e-05,1.0
44811,전수경/Noun,1,1,0,1.1115310228308472e-05,0.0,1.0
44812,무비스/Noun,1,1,0,1.1115310228308472e-05,0.0,1.0
44813,기회비용/Noun,1,0,1,0.0,1.1106915165381966e-05,1.0
44814,방적/Noun,1,0,1,0.0,1.1106915165381966e-05,1.0
44815,수풀/Noun,1,0,1,0.0,1.1106915165381966e-05,1.0
44816,젬씀/Noun,1,1,0,1.1115310228308472e-05,0.0,1.0
44817,인취/Noun,1,0,1,0.0,1.1106915165381966e-05,1.0
44818,헿헿헷/Noun,1,0,1,0.0,1.1106915165381966e-05,1.0
44819,골빈짓/Noun,1,0,1,0.0,1.1106915165381966e-05,1.0
44820,자치기/Noun,1,0,1,0.0,1.1106915165381966e-05,1.0
44821,빠염/Noun,1,1,0,1.1115310228308472e-05,0.0,1.0
44822,상전/Noun,1,0,1,0.0,1.1106915165381966e-05,1.0
44823,...???????!!/Punctuation,1,0,1,0.0,1.1106915165381966e-05,1.0
44824,쿠킨/Noun,1,1,0,1.1115310228308472e-05,0.0,1.0
44825,이되가는데도감동과재미는여전한듯하다/Foreign,1,1,0,1.1115310228308472e-05,0.0,1.0
44826,최괴입니/Noun,1,1,0,1.1115310228308472e-05,0.0,1.0
44827,싼타/Noun,1,0,1,0.0,1.1106915165381966e-05,1.0
44828,보때/Noun,1,1,0,1.1115310228308472e-05,0.0,1.0
44829,Size/Alpha,1,1,0,1.1115310228308472e-05,0.0,1.0
44830,임호/Noun,1,0,1,0.0,1.1106915165381966e-05,1.0
44831,맹맹/Noun,1,1,0,1.1115310228308472e-05,0.0,1.0
44832,추근/Noun,1,1,0,1.1115310228308472e-05,0.0,1.0
44833,낮음/Noun,1,1,0,1.1115310228308472e-05,0.0,1.0
44834,할아범/Noun,1,0,1,0.0,1.1106915165381966e-05,1.0
44835,포루투갈/Noun,1,0,1,0.0,1.1106915165381966e-05,1.0
44836,밀라노/Noun,1,0,1,0.0,1.1106915165381966e-05,1.0
44837,채닝때문/Noun,1,0,1,0.0,1.1106915165381966e-05,1.0
44838,시돈/Noun,1,1,0,1.1115310228308472e-05,0.0,1.0
44839,에봤다가미안해/Foreign,1,0,1,0.0,1.1106915165381966e-05,1.0
44840,살란데르/Noun,1,0,1,0.0,1.1106915165381966e-05,1.0
44841,.http://www.kntv.co.jp/prog/detail/?p=7935/URL,1,1,0,1.1115310228308472e-05,0.0,1.0
44842,",../Foreign",1,1,0,1.1115310228308472e-05,0.0,1.0
44843,연막/Noun,1,1,0,1.1115310228308472e-05,0.0,1.0
44844,4.65/Number,1,1,0,1.1115310228308472e-05,0.0,1.0
44845,TX/Alpha,1,1,0,1.1115310228308472e-05,0.0,1.0
44846,어내스트/Noun,1,1,0,1.1115310228308472e-05,0.0,1.0
44847,자장자장/Adverb,1,0,1,0.0,1.1106915165381966e-05,1.0
44848,대초반영화같은/Foreign,1,0,1,0.0,1.1106915165381966e-05,1.0
44849,뎀시/Noun,1,1,0,1.1115310228308472e-05,0.0,1.0
44850,123445577900/Number,1,1,0,1.1115310228308472e-05,0.0,1.0
44851,맥임/Noun,1,0,1,0.0,1.1106915165381966e-05,1.0
44852,박효민/Noun,1,0,1,0.0,1.1106915165381966e-05,1.0
44853,군입/Noun,1,0,1,0.0,1.1106915165381966e-05,1.0
44854,심시티/Noun,1,0,1,0.0,1.1106915165381966e-05,1.0
44855,발호/Noun,1,0,1,0.0,1.1106915165381966e-05,1.0
44856,대동법/Noun,1,0,1,0.0,1.1106915165381966e-05,1.0
44857,세드릭/Noun,1,0,1,0.0,1.1106915165381966e-05,1.0
44858,관환/Noun,1,0,1,0.0,1.1106915165381966e-05,1.0
44859,계몽사상/Noun,1,0,1,0.0,1.1106915165381966e-05,1.0
44860,─/Foreign,1,0,1,0.0,1.1106915165381966e-05,1.0
44861,뚜렸다/Noun,1,1,0,1.1115310228308472e-05,0.0,1.0
44862,페러디물중/Noun,1,1,0,1.1115310228308472e-05,0.0,1.0
44863,최면술/Noun,1,0,1,0.0,1.1106915165381966e-05,1.0
44864,베르마/Noun,1,1,0,1.1115310228308472e-05,0.0,1.0
44865,백마탄왕자/Noun,1,0,1,0.0,1.1106915165381966e-05,1.0
44866,빼곤/Foreign,1,0,1,0.0,1.1106915165381966e-05,1.0
44867,단잠/Noun,1,0,1,0.0,1.1106915165381966e-05,1.0
44868,배잼남/Noun,1,0,1,0.0,1.1106915165381966e-05,1.0
44869,8.78/Number,1,0,1,0.0,1.1106915165381966e-05,1.0
44870,iMDB/Alpha,1,0,1,0.0,1.1106915165381966e-05,1.0
44871,준세이/Noun,1,1,0,1.1115310228308472e-05,0.0,1.0
44872,가보리/Noun,1,1,0,1.1115310228308472e-05,0.0,1.0
44873,자룰/Noun,1,0,1,0.0,1.1106915165381966e-05,1.0
44874,국가인권위/Noun,1,0,1,0.0,1.1106915165381966e-05,1.0
44875,취할려/Noun,1,0,1,0.0,1.1106915165381966e-05,1.0
44876,라쳇/Noun,1,0,1,0.0,1.1106915165381966e-05,1.0
44877,Insomniac/Alpha,1,0,1,0.0,1.1106915165381966e-05,1.0
44878,욥닷/Noun,1,1,0,1.1115310228308472e-05,0.0,1.0
44879,볼랐는데/Noun,1,1,0,1.1115310228308472e-05,0.0,1.0
44880,물량전/Noun,1,0,1,0.0,1.1106915165381966e-05,1.0
44881,들었뚬/Noun,1,1,0,1.1115310228308472e-05,0.0,1.0
44882,14회/Number,1,1,0,1.1115310228308472e-05,0.0,1.0
44883,멕컬리니컬킨/Noun,1,0,1,0.0,1.1106915165381966e-05,1.0
44884,재밌넴/Noun,1,1,0,1.1115310228308472e-05,0.0,1.0
44885,탐슨/Noun,1,1,0,1.1115310228308472e-05,0.0,1.0
44886,듀발/Noun,1,0,1,0.0,1.1106915165381966e-05,1.0
44887,김실/Noun,1,0,1,0.0,1.1106915165381966e-05,1.0
44888,정역/Noun,1,0,1,0.0,1.1106915165381966e-05,1.0
44889,허튼/Noun,1,0,1,0.0,1.1106915165381966e-05,1.0
44890,앵콜/Noun,1,1,0,1.1115310228308472e-05,0.0,1.0
44891,배삼룡/Noun,1,0,1,0.0,1.1106915165381966e-05,1.0
44892,내추럴/Noun,1,1,0,1.1115310228308472e-05,0.0,1.0
44893,고인돌/Noun,1,0,1,0.0,1.1106915165381966e-05,1.0
44894,피르팬/Noun,1,1,0,1.1115310228308472e-05,0.0,1.0
44895,점드랍니/Noun,1,1,0,1.1115310228308472e-05,0.0,1.0
44896,장영남/Noun,1,1,0,1.1115310228308472e-05,0.0,1.0
44897,브릿땜/Noun,1,1,0,1.1115310228308472e-05,0.0,1.0
44898,전투화/Noun,1,1,0,1.1115310228308472e-05,0.0,1.0
44899,Bus/Alpha,1,1,0,1.1115310228308472e-05,0.0,1.0
44900,전채/Noun,1,0,1,0.0,1.1106915165381966e-05,1.0
44901,죽이삔다/Noun,1,0,1,0.0,1.1106915165381966e-05,1.0
44902,road/Alpha,1,1,0,1.1115310228308472e-05,0.0,1.0
44903,Jack/Alpha,1,1,0,1.1115310228308472e-05,0.0,1.0
44904,Road/Alpha,1,1,0,1.1115310228308472e-05,0.0,1.0
44905,Hit/Alpha,1,1,0,1.1115310228308472e-05,0.0,1.0
44906,.....?????????????????????????????????????/Punctuation,1,0,1,0.0,1.1106915165381966e-05,1.0
44907,파운딩/Noun,1,0,1,0.0,1.1106915165381966e-05,1.0
44908,똗/Noun,1,1,0,1.1115310228308472e-05,0.0,1.0
44909,4345/Number,1,1,0,1.1115310228308472e-05,0.0,1.0
44910,AMG/Alpha,1,1,0,1.1115310228308472e-05,0.0,1.0
44911,SLK/Alpha,1,1,0,1.1115310228308472e-05,0.0,1.0
44912,출생하였습니다/Foreign,1,1,0,1.1115310228308472e-05,0.0,1.0
44913,04월/Number,1,1,0,1.1115310228308472e-05,0.0,1.0
44914,훨잼씀/Noun,1,0,1,0.0,1.1106915165381966e-05,1.0
44915,모피/Noun,1,0,1,0.0,1.1106915165381966e-05,1.0
44916,세바스티앙/Noun,1,1,0,1.1115310228308472e-05,0.0,1.0
44917,패틴슨갑/Noun,1,0,1,0.0,1.1106915165381966e-05,1.0
44918,다데/Noun,1,1,0,1.1115310228308472e-05,0.0,1.0
44919,아렇/Noun,1,0,1,0.0,1.1106915165381966e-05,1.0
44920,장석/Noun,1,0,1,0.0,1.1106915165381966e-05,1.0
44921,레저렉션/Noun,1,1,0,1.1115310228308472e-05,0.0,1.0
44922,땟갈좋/Noun,1,0,1,0.0,1.1106915165381966e-05,1.0
44923,힙찔/Noun,1,0,1,0.0,1.1106915165381966e-05,1.0
44924,전사건이나/Foreign,1,0,1,0.0,1.1106915165381966e-05,1.0
44925,끋/Noun,1,0,1,0.0,1.1106915165381966e-05,1.0
44926,incoming/Alpha,1,1,0,1.1115310228308472e-05,0.0,1.0
44927,련색기들/Noun,1,0,1,0.0,1.1106915165381966e-05,1.0
44928,)??/Punctuation,1,1,0,1.1115310228308472e-05,0.0,1.0
44929,tooth/Alpha,1,1,0,1.1115310228308472e-05,0.0,1.0
44930,뿌뜻하/Noun,1,1,0,1.1115310228308472e-05,0.0,1.0
44931,오스본/Noun,1,0,1,0.0,1.1106915165381966e-05,1.0
44932,afkn/Alpha,1,1,0,1.1115310228308472e-05,0.0,1.0
44933,스타맨/Noun,1,1,0,1.1115310228308472e-05,0.0,1.0
44934,저격총/Noun,1,0,1,0.0,1.1106915165381966e-05,1.0
44935,sdfsdfdsfsdfsd/Alpha,1,1,0,1.1115310228308472e-05,0.0,1.0
44936,기뻣습니/Noun,1,0,1,0.0,1.1106915165381966e-05,1.0
44937,매릴/Noun,1,1,0,1.1115310228308472e-05,0.0,1.0
44938,본부장/Noun,1,0,1,0.0,1.1106915165381966e-05,1.0
44939,개봉에서/Foreign,1,0,1,0.0,1.1106915165381966e-05,1.0
44940,크리스트교/Noun,1,1,0,1.1115310228308472e-05,0.0,1.0
44941,달뜨다/Verb,1,0,1,0.0,1.1106915165381966e-05,1.0
44942,뎈/Noun,1,1,0,1.1115310228308472e-05,0.0,1.0
44943,천둥신/Noun,1,1,0,1.1115310228308472e-05,0.0,1.0
44944,보기위해/Foreign,1,1,0,1.1115310228308472e-05,0.0,1.0
44945,49일/Number,1,1,0,1.1115310228308472e-05,0.0,1.0
44946,먹먹해졋다/Noun,1,1,0,1.1115310228308472e-05,0.0,1.0
44947,규범/Noun,1,1,0,1.1115310228308472e-05,0.0,1.0
44948,질랜드/Noun,1,0,1,0.0,1.1106915165381966e-05,1.0
44949,홈피/Noun,1,0,1,0.0,1.1106915165381966e-05,1.0
44950,건디/Noun,1,0,1,0.0,1.1106915165381966e-05,1.0
44951,오따꾸/Noun,1,0,1,0.0,1.1106915165381966e-05,1.0
44952,채득/Noun,1,1,0,1.1115310228308472e-05,0.0,1.0
44953,왕강추/Noun,1,1,0,1.1115310228308472e-05,0.0,1.0
44954,꼬아놨/Noun,1,0,1,0.0,1.1106915165381966e-05,1.0
44955,꼬맹일때/Noun,1,1,0,1.1115310228308472e-05,0.0,1.0
44956,Creep/Alpha,1,1,0,1.1115310228308472e-05,0.0,1.0
44957,듁는줄/Noun,1,0,1,0.0,1.1106915165381966e-05,1.0
44958,;;;;;;;;;;;;;;;;;;;;;;;;;;;;;;;;;;;;/Punctuation,1,0,1,0.0,1.1106915165381966e-05,1.0
44959,남해안/Noun,1,0,1,0.0,1.1106915165381966e-05,1.0
44960,공공기관/Noun,1,1,0,1.1115310228308472e-05,0.0,1.0
44961,터트려주/Noun,1,0,1,0.0,1.1106915165381966e-05,1.0
44962,시원섭섭하다/Adjective,1,1,0,1.1115310228308472e-05,0.0,1.0
44963,몬잼조냊/Noun,1,0,1,0.0,1.1106915165381966e-05,1.0
44964,수라도/Noun,1,0,1,0.0,1.1106915165381966e-05,1.0
44965,토속신앙/Noun,1,1,0,1.1115310228308472e-05,0.0,1.0
44966,됐는데/Foreign,1,1,0,1.1115310228308472e-05,0.0,1.0
44967,최정/Noun,1,1,0,1.1115310228308472e-05,0.0,1.0
44968,글썻더/Noun,1,1,0,1.1115310228308472e-05,0.0,1.0
44969,flows/Alpha,1,1,0,1.1115310228308472e-05,0.0,1.0
44970,ㅎㅎㅇ/KoreanParticle,1,1,0,1.1115310228308472e-05,0.0,1.0
44971,뻣습/Noun,1,1,0,1.1115310228308472e-05,0.0,1.0
44972,추궁/Noun,1,0,1,0.0,1.1106915165381966e-05,1.0
44973,장릐/Noun,1,0,1,0.0,1.1106915165381966e-05,1.0
44974,죽여뿌노/Noun,1,0,1,0.0,1.1106915165381966e-05,1.0
44975,자르르/Noun,1,0,1,0.0,1.1106915165381966e-05,1.0
44976,윤기/Noun,1,0,1,0.0,1.1106915165381966e-05,1.0
44977,피둥피둥/Noun,1,0,1,0.0,1.1106915165381966e-05,1.0
44978,씼는다/Noun,1,0,1,0.0,1.1106915165381966e-05,1.0
44979,5.20/Number,1,0,1,0.0,1.1106915165381966e-05,1.0
44980,색귀/Noun,1,0,1,0.0,1.1106915165381966e-05,1.0
44981,스셋스/Noun,1,0,1,0.0,1.1106915165381966e-05,1.0
44982,스즈/Noun,1,1,0,1.1115310228308472e-05,0.0,1.0
44983,뒷걸음질/Noun,1,0,1,0.0,1.1106915165381966e-05,1.0
44984,",.,..,/Punctuation",1,0,1,0.0,1.1106915165381966e-05,1.0
44985,좀처/Noun,1,0,1,0.0,1.1106915165381966e-05,1.0
44986,입쫘악/Noun,1,0,1,0.0,1.1106915165381966e-05,1.0
44987,잉거/Noun,1,1,0,1.1115310228308472e-05,0.0,1.0
44988,익싸이팅/Noun,1,0,1,0.0,1.1106915165381966e-05,1.0
44989,구성만/Noun,1,0,1,0.0,1.1106915165381966e-05,1.0
44990,뼈마디/Noun,1,1,0,1.1115310228308472e-05,0.0,1.0
44991,fffd/Alpha,1,0,1,0.0,1.1106915165381966e-05,1.0
44992,이정구/Noun,1,1,0,1.1115310228308472e-05,0.0,1.0
44993,비바람/Noun,1,1,0,1.1115310228308472e-05,0.0,1.0
44994,썸뜩/Noun,1,1,0,1.1115310228308472e-05,0.0,1.0
44995,김의성/Noun,1,1,0,1.1115310228308472e-05,0.0,1.0
44996,쪽발/Noun,1,0,1,0.0,1.1106915165381966e-05,1.0
44997,난제/Noun,1,1,0,1.1115310228308472e-05,0.0,1.0
44998,전자레인지/Noun,1,0,1,0.0,1.1106915165381966e-05,1.0
44999,!'./Punctuation,1,0,1,0.0,1.1106915165381966e-05,1.0
45000,귀였웠음/Noun,1,1,0,1.1115310228308472e-05,0.0,1.0
45001,좋았긔/Noun,1,1,0,1.1115310228308472e-05,0.0,1.0
45002,말춤/Noun,1,1,0,1.1115310228308472e-05,0.0,1.0
45003,쫘르르/Noun,1,1,0,1.1115310228308472e-05,0.0,1.0
45004,사산/Noun,1,0,1,0.0,1.1106915165381966e-05,1.0
45005,탠토/Noun,1,1,0,1.1115310228308472e-05,0.0,1.0
45006,허머/Noun,1,1,0,1.1115310228308472e-05,0.0,1.0
45007,쒸레기임/Noun,1,0,1,0.0,1.1106915165381966e-05,1.0
45008,뭇/Noun,1,0,1,0.0,1.1106915165381966e-05,1.0
45009,절세미인/Noun,1,0,1,0.0,1.1106915165381966e-05,1.0
45010,근방/Noun,1,0,1,0.0,1.1106915165381966e-05,1.0
45011,준인/Noun,1,1,0,1.1115310228308472e-05,0.0,1.0
45012,후관/Noun,1,1,0,1.1115310228308472e-05,0.0,1.0
45013,비엔나소시지/Noun,1,0,1,0.0,1.1106915165381966e-05,1.0
45014,해질녁/Noun,1,0,1,0.0,1.1106915165381966e-05,1.0
45015,제밋다/Noun,1,1,0,1.1115310228308472e-05,0.0,1.0
45016,똠/Noun,1,0,1,0.0,1.1106915165381966e-05,1.0
45017,팔자주름/Noun,1,1,0,1.1115310228308472e-05,0.0,1.0
45018,부터끝나는시간까지어느새내얼굴에미소가지어져있다/Foreign,1,1,0,1.1115310228308472e-05,0.0,1.0
45019,그때/Foreign,1,1,0,1.1115310228308472e-05,0.0,1.0
45020,현피/Noun,1,0,1,0.0,1.1106915165381966e-05,1.0
45021,격갤/Noun,1,0,1,0.0,1.1106915165381966e-05,1.0
45022,육하원칙/Noun,1,0,1,0.0,1.1106915165381966e-05,1.0
45023,괸찮타/Noun,1,0,1,0.0,1.1106915165381966e-05,1.0
45024,작이라는데에/Foreign,1,1,0,1.1115310228308472e-05,0.0,1.0
45025,난폭하다/Adjective,1,0,1,0.0,1.1106915165381966e-05,1.0
45026,핏빛속/Noun,1,1,0,1.1115310228308472e-05,0.0,1.0
45027,정청/Noun,1,1,0,1.1115310228308472e-05,0.0,1.0
45028,무당연기/Noun,1,0,1,0.0,1.1106915165381966e-05,1.0
45029,최준용/Noun,1,0,1,0.0,1.1106915165381966e-05,1.0
45030,곡명/Noun,1,1,0,1.1115310228308472e-05,0.0,1.0
45031,야만족/Noun,1,1,0,1.1115310228308472e-05,0.0,1.0
45032,선우혁/Noun,1,1,0,1.1115310228308472e-05,0.0,1.0
45033,라모스/Noun,1,1,0,1.1115310228308472e-05,0.0,1.0
45034,백사/Noun,1,0,1,0.0,1.1106915165381966e-05,1.0
45035,쩍뚝/Noun,1,0,1,0.0,1.1106915165381966e-05,1.0
45036,대본작가/Noun,1,0,1,0.0,1.1106915165381966e-05,1.0
45037,떨떠름하다/Adjective,1,0,1,0.0,1.1106915165381966e-05,1.0
45038,한슨생/Noun,1,1,0,1.1115310228308472e-05,0.0,1.0
45039,호출/Noun,1,0,1,0.0,1.1106915165381966e-05,1.0
45040,--??/Punctuation,1,0,1,0.0,1.1106915165381966e-05,1.0
45041,kill/Alpha,1,0,1,0.0,1.1106915165381966e-05,1.0
45042,또봣는데/Noun,1,1,0,1.1115310228308472e-05,0.0,1.0
45043,철로/Noun,1,0,1,0.0,1.1106915165381966e-05,1.0
45044,김영/Noun,1,0,1,0.0,1.1106915165381966e-05,1.0
45045,실탄/Noun,1,1,0,1.1115310228308472e-05,0.0,1.0
45046,SEAL/Alpha,1,1,0,1.1115310228308472e-05,0.0,1.0
45047,웨웠/Noun,1,1,0,1.1115310228308472e-05,0.0,1.0
45048,큰작가되셩/Noun,1,0,1,0.0,1.1106915165381966e-05,1.0
45049,실습생/Noun,1,0,1,0.0,1.1106915165381966e-05,1.0
45050,잘봤쉅/Noun,1,0,1,0.0,1.1106915165381966e-05,1.0
45051,네거티브/Noun,1,0,1,0.0,1.1106915165381966e-05,1.0
45052,양상/Noun,1,0,1,0.0,1.1106915165381966e-05,1.0
45053,아넹/Noun,1,1,0,1.1115310228308472e-05,0.0,1.0
45054,뭘좀/Noun,1,1,0,1.1115310228308472e-05,0.0,1.0
45055,어쩌구하/Noun,1,1,0,1.1115310228308472e-05,0.0,1.0
45056,잔혹씬/Noun,1,0,1,0.0,1.1106915165381966e-05,1.0
45057,브랫핏/Noun,1,1,0,1.1115310228308472e-05,0.0,1.0
45058,freak/Alpha,1,0,1,0.0,1.1106915165381966e-05,1.0
45059,재잘거리다/Verb,1,1,0,1.1115310228308472e-05,0.0,1.0
45060,계획성/Noun,1,1,0,1.1115310228308472e-05,0.0,1.0
45061,Ufo/Alpha,1,0,1,0.0,1.1106915165381966e-05,1.0
45062,woaldlTsmsep/Alpha,1,1,0,1.1115310228308472e-05,0.0,1.0
45063,>>>>>>>>>/Punctuation,1,0,1,0.0,1.1106915165381966e-05,1.0
45064,아숩다/Noun,1,0,1,0.0,1.1106915165381966e-05,1.0
45065,꿈햇/Noun,1,0,1,0.0,1.1106915165381966e-05,1.0
45066,싱황/Noun,1,0,1,0.0,1.1106915165381966e-05,1.0
45067,등치/Noun,1,0,1,0.0,1.1106915165381966e-05,1.0
45068,트럭씬/Noun,1,1,0,1.1115310228308472e-05,0.0,1.0
45069,읭스러움/Noun,1,1,0,1.1115310228308472e-05,0.0,1.0
45070,쫑기/Noun,1,1,0,1.1115310228308472e-05,0.0,1.0
45071,쎴다/Noun,1,0,1,0.0,1.1106915165381966e-05,1.0
45072,소비자원/Noun,1,0,1,0.0,1.1106915165381966e-05,1.0
45073,글씨체/Noun,1,0,1,0.0,1.1106915165381966e-05,1.0
45074,남기고급진행하지말길/Foreign,1,0,1,0.0,1.1106915165381966e-05,1.0
45075,ㄴㄷ/KoreanParticle,1,0,1,0.0,1.1106915165381966e-05,1.0
45076,황금나침반/Noun,1,1,0,1.1115310228308472e-05,0.0,1.0
45077,개고기/Noun,1,1,0,1.1115310228308472e-05,0.0,1.0
45078,힣히히헤/Noun,1,1,0,1.1115310228308472e-05,0.0,1.0
45079,구미역/Noun,1,0,1,0.0,1.1106915165381966e-05,1.0
45080,토치우드/Noun,1,1,0,1.1115310228308472e-05,0.0,1.0
45081,고얏케사/Noun,1,1,0,1.1115310228308472e-05,0.0,1.0
45082,쿵꿍/Noun,1,1,0,1.1115310228308472e-05,0.0,1.0
45083,페스/Noun,1,0,1,0.0,1.1106915165381966e-05,1.0
45084,훈육/Noun,1,0,1,0.0,1.1106915165381966e-05,1.0
45085,RASTAFARI/Alpha,1,1,0,1.1115310228308472e-05,0.0,1.0
45086,JAH/Alpha,1,1,0,1.1115310228308472e-05,0.0,1.0
45087,MARLEY/Alpha,1,1,0,1.1115310228308472e-05,0.0,1.0
45088,RESPECT/Alpha,1,1,0,1.1115310228308472e-05,0.0,1.0
45089,Marley/Alpha,1,1,0,1.1115310228308472e-05,0.0,1.0
45090,익음/Noun,1,1,0,1.1115310228308472e-05,0.0,1.0
45091,이어서/Foreign,1,0,1,0.0,1.1106915165381966e-05,1.0
45092,박준석/Noun,1,0,1,0.0,1.1106915165381966e-05,1.0
45093,어둑하다/Adjective,1,1,0,1.1115310228308472e-05,0.0,1.0
45094,ㄷㅃㅅㅊㅎㄱㅅ/KoreanParticle,1,1,0,1.1115310228308472e-05,0.0,1.0
45095,따돌림/Noun,1,1,0,1.1115310228308472e-05,0.0,1.0
45096,콩고/Noun,1,0,1,0.0,1.1106915165381966e-05,1.0
45097,용잼/Noun,1,0,1,0.0,1.1106915165381966e-05,1.0
45098,무국/Noun,1,0,1,0.0,1.1106915165381966e-05,1.0
45099,탑영/Noun,1,1,0,1.1115310228308472e-05,0.0,1.0
45100,등록금/Noun,1,0,1,0.0,1.1106915165381966e-05,1.0
45101,제로니모/Noun,1,0,1,0.0,1.1106915165381966e-05,1.0
45102,널렷/Noun,1,0,1,0.0,1.1106915165381966e-05,1.0
45103,배은망덕/Noun,1,0,1,0.0,1.1106915165381966e-05,1.0
45104,레볼루셔/Noun,1,0,1,0.0,1.1106915165381966e-05,1.0
45105,구태/Noun,1,0,1,0.0,1.1106915165381966e-05,1.0
45106,악다구니/Noun,1,0,1,0.0,1.1106915165381966e-05,1.0
45107,典型的なチョッパリのエロ映画。けらけら＾＾/Foreign,1,0,1,0.0,1.1106915165381966e-05,1.0
45108,보게됫으/Noun,1,0,1,0.0,1.1106915165381966e-05,1.0
45109,차끌/Noun,1,0,1,0.0,1.1106915165381966e-05,1.0
45110,포르/Noun,1,1,0,1.1115310228308472e-05,0.0,1.0
45111,개잼남/Noun,1,1,0,1.1115310228308472e-05,0.0,1.0
45112,갑빠/Noun,1,1,0,1.1115310228308472e-05,0.0,1.0
45113,짓트/Noun,1,1,0,1.1115310228308472e-05,0.0,1.0
45114,간돈/Noun,1,0,1,0.0,1.1106915165381966e-05,1.0
45115,장볼때/Noun,1,0,1,0.0,1.1106915165381966e-05,1.0
45116,멸종위기/Noun,1,0,1,0.0,1.1106915165381966e-05,1.0
45117,게슈타포/Noun,1,0,1,0.0,1.1106915165381966e-05,1.0
45118,르쉬프/Noun,1,1,0,1.1115310228308472e-05,0.0,1.0
45119,.!.!/Punctuation,1,1,0,1.1115310228308472e-05,0.0,1.0
45120,폐쇄공간/Noun,1,0,1,0.0,1.1106915165381966e-05,1.0
45121,부청/Noun,1,0,1,0.0,1.1106915165381966e-05,1.0
45122,매씬/Noun,1,1,0,1.1115310228308472e-05,0.0,1.0
45123,흐트러짐/Noun,1,1,0,1.1115310228308472e-05,0.0,1.0
45124,전편/Foreign,1,1,0,1.1115310228308472e-05,0.0,1.0
45125,주통/Noun,1,0,1,0.0,1.1106915165381966e-05,1.0
45126,흑색/Noun,1,0,1,0.0,1.1106915165381966e-05,1.0
45127,샴퓨/Noun,1,0,1,0.0,1.1106915165381966e-05,1.0
45128,준장/Noun,1,0,1,0.0,1.1106915165381966e-05,1.0
45129,-_-*/Punctuation,1,1,0,1.1115310228308472e-05,0.0,1.0
45130,어리바리/Adverb,1,0,1,0.0,1.1106915165381966e-05,1.0
45131,격었/Noun,1,1,0,1.1115310228308472e-05,0.0,1.0
45132,대공황/Noun,1,1,0,1.1115310228308472e-05,0.0,1.0
45133,랄카/Noun,1,1,0,1.1115310228308472e-05,0.0,1.0
45134,서랜/Noun,1,1,0,1.1115310228308472e-05,0.0,1.0
45135,엘리켐퍼/Noun,1,1,0,1.1115310228308472e-05,0.0,1.0
45136,와이드/Noun,1,1,0,1.1115310228308472e-05,0.0,1.0
45137,탄환/Noun,1,1,0,1.1115310228308472e-05,0.0,1.0
45138,홱홱/Noun,1,0,1,0.0,1.1106915165381966e-05,1.0
45139,엔지니어/Noun,1,1,0,1.1115310228308472e-05,0.0,1.0
45140,김선빈/Noun,1,1,0,1.1115310228308472e-05,0.0,1.0
45141,헬싱/Noun,1,0,1,0.0,1.1106915165381966e-05,1.0
45142,태보/Noun,1,1,0,1.1115310228308472e-05,0.0,1.0
45143,덥석/Noun,1,0,1,0.0,1.1106915165381966e-05,1.0
45144,암거/Noun,1,0,1,0.0,1.1106915165381966e-05,1.0
45145,메디슨/Noun,1,0,1,0.0,1.1106915165381966e-05,1.0
45146,1~4회/Number,1,1,0,1.1115310228308472e-05,0.0,1.0
45147,단죽/Noun,1,0,1,0.0,1.1106915165381966e-05,1.0
45148,심배/Noun,1,1,0,1.1115310228308472e-05,0.0,1.0
45149,밀항/Noun,1,1,0,1.1115310228308472e-05,0.0,1.0
45150,!!!--/Punctuation,1,1,0,1.1115310228308472e-05,0.0,1.0
45151,몽미/Noun,1,0,1,0.0,1.1106915165381966e-05,1.0
45152,아카리/Noun,1,1,0,1.1115310228308472e-05,0.0,1.0
45153,어센딩/Noun,1,1,0,1.1115310228308472e-05,0.0,1.0
45154,편보/Noun,1,1,0,1.1115310228308472e-05,0.0,1.0
45155,테잌/Noun,1,0,1,0.0,1.1106915165381966e-05,1.0
45156,터준/Noun,1,1,0,1.1115310228308472e-05,0.0,1.0
45157,그리스도교/Noun,1,1,0,1.1115310228308472e-05,0.0,1.0
45158,갈껀/Noun,1,0,1,0.0,1.1106915165381966e-05,1.0
45159,바쩌/Noun,1,0,1,0.0,1.1106915165381966e-05,1.0
45160,솔리드/Noun,1,0,1,0.0,1.1106915165381966e-05,1.0
45161,메탈기어/Noun,1,0,1,0.0,1.1106915165381966e-05,1.0
45162,ㅂㅈㄴ/KoreanParticle,1,1,0,1.1115310228308472e-05,0.0,1.0
45163,ㄴㄷㅅ/KoreanParticle,1,1,0,1.1115310228308472e-05,0.0,1.0
45164,시게루/Noun,1,1,0,1.1115310228308472e-05,0.0,1.0
45165,600만/Number,1,0,1,0.0,1.1106915165381966e-05,1.0
45166,마천/Noun,1,0,1,0.0,1.1106915165381966e-05,1.0
45167,엘스/Noun,1,1,0,1.1115310228308472e-05,0.0,1.0
45168,스레이/Noun,1,1,0,1.1115310228308472e-05,0.0,1.0
45169,처멕이/Noun,1,0,1,0.0,1.1106915165381966e-05,1.0
45170,동향/Noun,1,0,1,0.0,1.1106915165381966e-05,1.0
45171,시공초월/Noun,1,0,1,0.0,1.1106915165381966e-05,1.0
45172,굿좝/Noun,1,1,0,1.1115310228308472e-05,0.0,1.0
45173,선빵/Noun,1,0,1,0.0,1.1106915165381966e-05,1.0
45174,PLAY/Alpha,1,0,1,0.0,1.1106915165381966e-05,1.0
45175,RECORD/Alpha,1,0,1,0.0,1.1106915165381966e-05,1.0
45176,살포/Noun,1,0,1,0.0,1.1106915165381966e-05,1.0
45177,마광/Noun,1,0,1,0.0,1.1106915165381966e-05,1.0
45178,에네르기/Noun,1,0,1,0.0,1.1106915165381966e-05,1.0
45179,계왕/Noun,1,0,1,0.0,1.1106915165381966e-05,1.0
45180,섫힌/Noun,1,0,1,0.0,1.1106915165381966e-05,1.0
45181,멋있쪙/Noun,1,1,0,1.1115310228308472e-05,0.0,1.0
45182,화거/Noun,1,1,0,1.1115310228308472e-05,0.0,1.0
45183,낮설/Noun,1,1,0,1.1115310228308472e-05,0.0,1.0
45184,썻나보/Noun,1,0,1,0.0,1.1106915165381966e-05,1.0
45185,아침밥/Noun,1,0,1,0.0,1.1106915165381966e-05,1.0
45186,"?""""/Punctuation",1,0,1,0.0,1.1106915165381966e-05,1.0
45187,약방/Noun,1,0,1,0.0,1.1106915165381966e-05,1.0
45188,스릴잏/Noun,1,1,0,1.1115310228308472e-05,0.0,1.0
45189,캐콘/Noun,1,0,1,0.0,1.1106915165381966e-05,1.0
45190,대초영화심형래가/Foreign,1,1,0,1.1115310228308472e-05,0.0,1.0
45191,12000/Number,1,0,1,0.0,1.1106915165381966e-05,1.0
45192,최영완/Noun,1,1,0,1.1115310228308472e-05,0.0,1.0
45193,양미/Noun,1,0,1,0.0,1.1106915165381966e-05,1.0
45194,굳굳수굿굿둣/Noun,1,1,0,1.1115310228308472e-05,0.0,1.0
45195,TM/Alpha,1,0,1,0.0,1.1106915165381966e-05,1.0
45196,싶었름/Noun,1,0,1,0.0,1.1106915165381966e-05,1.0
45197,꺍/Noun,1,1,0,1.1115310228308472e-05,0.0,1.0
45198,지고는못살아/Noun,1,1,0,1.1115310228308472e-05,0.0,1.0
45199,최현아/Noun,1,0,1,0.0,1.1106915165381966e-05,1.0
45200,송미령/Noun,1,0,1,0.0,1.1106915165381966e-05,1.0
45201,161/Number,1,0,1,0.0,1.1106915165381966e-05,1.0
45202,다다미방/Noun,1,0,1,0.0,1.1106915165381966e-05,1.0
45203,국호/Noun,1,0,1,0.0,1.1106915165381966e-05,1.0
45204,찡끗/Adverb,1,1,0,1.1115310228308472e-05,0.0,1.0
45205,^-'/Punctuation,1,1,0,1.1115310228308472e-05,0.0,1.0
45206,안맛/Noun,1,0,1,0.0,1.1106915165381966e-05,1.0
45207,이재혁/Noun,1,0,1,0.0,1.1106915165381966e-05,1.0
45208,드롭/Noun,1,0,1,0.0,1.1106915165381966e-05,1.0
45209,)/`^^/Punctuation,1,1,0,1.1115310228308472e-05,0.0,1.0
45210,나왓기/Noun,1,1,0,1.1115310228308472e-05,0.0,1.0
45211,션찮/Noun,1,1,0,1.1115310228308472e-05,0.0,1.0
45212,면지/Noun,1,1,0,1.1115310228308472e-05,0.0,1.0
45213,^_^../Punctuation,1,1,0,1.1115310228308472e-05,0.0,1.0
45214,개운/Noun,1,1,0,1.1115310228308472e-05,0.0,1.0
45215,급답/Noun,1,0,1,0.0,1.1106915165381966e-05,1.0
45216,킬엠올/Noun,1,0,1,0.0,1.1106915165381966e-05,1.0
45217,반야심경/Noun,1,0,1,0.0,1.1106915165381966e-05,1.0
45218,feeling/Alpha,1,1,0,1.1115310228308472e-05,0.0,1.0
45219,albert/Alpha,1,1,0,1.1115310228308472e-05,0.0,1.0
45220,morris/Alpha,1,1,0,1.1115310228308472e-05,0.0,1.0
45221,눈썰미/Noun,1,1,0,1.1115310228308472e-05,0.0,1.0
45222,.....(>_/Punctuation,1,0,1,0.0,1.1106915165381966e-05,1.0
45223,도킨스/Noun,1,0,1,0.0,1.1106915165381966e-05,1.0
45224,진땀/Noun,1,1,0,1.1115310228308472e-05,0.0,1.0
45225,ㄸㅗ/KoreanParticle,1,1,0,1.1115310228308472e-05,0.0,1.0
45226,마쉬/Noun,1,0,1,0.0,1.1106915165381966e-05,1.0
45227,임감/Noun,1,0,1,0.0,1.1106915165381966e-05,1.0
45228,삼봉/Noun,1,1,0,1.1115310228308472e-05,0.0,1.0
45229,노미/Noun,1,0,1,0.0,1.1106915165381966e-05,1.0
45230,껄끄롭/Noun,1,0,1,0.0,1.1106915165381966e-05,1.0
45231,ㄲㅋㅋ/KoreanParticle,1,1,0,1.1115310228308472e-05,0.0,1.0
45232,보곰/Noun,1,0,1,0.0,1.1106915165381966e-05,1.0
45233,갬빗/Noun,1,1,0,1.1115310228308472e-05,0.0,1.0
45234,트페/Noun,1,1,0,1.1115310228308472e-05,0.0,1.0
45235,&#/Punctuation,1,1,0,1.1115310228308472e-05,0.0,1.0
45236,있냠/Noun,1,1,0,1.1115310228308472e-05,0.0,1.0
45237,읆는/Noun,1,1,0,1.1115310228308472e-05,0.0,1.0
45238,잘록하다/Adjective,1,1,0,1.1115310228308472e-05,0.0,1.0
45239,모스부호/Noun,1,1,0,1.1115310228308472e-05,0.0,1.0
45240,해독/Noun,1,1,0,1.1115310228308472e-05,0.0,1.0
45241,스턴트씬/Noun,1,1,0,1.1115310228308472e-05,0.0,1.0
45242,동양화/Noun,1,1,0,1.1115310228308472e-05,0.0,1.0
45243,폭바범/Noun,1,1,0,1.1115310228308472e-05,0.0,1.0
45244,램니/Noun,1,0,1,0.0,1.1106915165381966e-05,1.0
45245,컷으/Noun,1,0,1,0.0,1.1106915165381966e-05,1.0
45246,조예/Noun,1,0,1,0.0,1.1106915165381966e-05,1.0
45247,소아온/Noun,1,0,1,0.0,1.1106915165381966e-05,1.0
45248,셀애니메이션/Noun,1,1,0,1.1115310228308472e-05,0.0,1.0
45249,WOMAN/Alpha,1,1,0,1.1115310228308472e-05,0.0,1.0
45250,MOMMA/Alpha,1,1,0,1.1115310228308472e-05,0.0,1.0
45251,BIG/Alpha,1,1,0,1.1115310228308472e-05,0.0,1.0
45252,HAIL/Alpha,1,1,0,1.1115310228308472e-05,0.0,1.0
45253,몾햐/Noun,1,0,1,0.0,1.1106915165381966e-05,1.0
45254,핵대중/Noun,1,0,1,0.0,1.1106915165381966e-05,1.0
45255,괘찮/Noun,1,1,0,1.1115310228308472e-05,0.0,1.0
45256,띄우기/Noun,1,0,1,0.0,1.1106915165381966e-05,1.0
45257,이연재/Noun,1,0,1,0.0,1.1106915165381966e-05,1.0
45258,플레이스테이션/Noun,1,1,0,1.1115310228308472e-05,0.0,1.0
45259,",,,--/Punctuation",1,0,1,0.0,1.1106915165381966e-05,1.0
45260,럾는/Noun,1,0,1,0.0,1.1106915165381966e-05,1.0
45261,매만지다/Verb,1,1,0,1.1115310228308472e-05,0.0,1.0
45262,로맨/Noun,1,0,1,0.0,1.1106915165381966e-05,1.0
45263,볼때옆/Noun,1,1,0,1.1115310228308472e-05,0.0,1.0
45264,내꺼뺴/Noun,1,0,1,0.0,1.1106915165381966e-05,1.0
45265,알골/Noun,1,1,0,1.1115310228308472e-05,0.0,1.0
45266,골족/Noun,1,1,0,1.1115310228308472e-05,0.0,1.0
45267,능선/Noun,1,0,1,0.0,1.1106915165381966e-05,1.0
45268,Gooooooooood/Alpha,1,1,0,1.1115310228308472e-05,0.0,1.0
45269,가로서다/Verb,1,0,1,0.0,1.1106915165381966e-05,1.0
45270,개잼슴/Noun,1,1,0,1.1115310228308472e-05,0.0,1.0
45271,초팅/Noun,1,0,1,0.0,1.1106915165381966e-05,1.0
45272,쟌/Noun,1,0,1,0.0,1.1106915165381966e-05,1.0
45273,드심/Noun,1,0,1,0.0,1.1106915165381966e-05,1.0
45274,아깝땅껭/Noun,1,0,1,0.0,1.1106915165381966e-05,1.0
45275,위니/Noun,1,1,0,1.1115310228308472e-05,0.0,1.0
45276,더재밌슴/Noun,1,1,0,1.1115310228308472e-05,0.0,1.0
45277,블루투스/Noun,1,0,1,0.0,1.1106915165381966e-05,1.0
45278,히프/Noun,1,0,1,0.0,1.1106915165381966e-05,1.0
45279,웃엇을까/Noun,1,0,1,0.0,1.1106915165381966e-05,1.0
45280,거둿드랫/Noun,1,1,0,1.1115310228308472e-05,0.0,1.0
45281,아젛/Noun,1,1,0,1.1115310228308472e-05,0.0,1.0
45282,한식/Noun,1,0,1,0.0,1.1106915165381966e-05,1.0
45283,앙상하다/Adjective,1,0,1,0.0,1.1106915165381966e-05,1.0
45284,들쭉날쭉/Noun,1,0,1,0.0,1.1106915165381966e-05,1.0
45285,840분/Number,1,0,1,0.0,1.1106915165381966e-05,1.0
45286,에르몬넬/Noun,1,1,0,1.1115310228308472e-05,0.0,1.0
45287,황지민/Noun,1,1,0,1.1115310228308472e-05,0.0,1.0
45288,명준/Noun,1,1,0,1.1115310228308472e-05,0.0,1.0
45289,맥심/Noun,1,0,1,0.0,1.1106915165381966e-05,1.0
45290,브룩스/Noun,1,1,0,1.1115310228308472e-05,0.0,1.0
45291,다줄꺼야/Noun,1,1,0,1.1115310228308472e-05,0.0,1.0
45292,"....-!,?/Punctuation",1,0,1,0.0,1.1106915165381966e-05,1.0
45293,니믜/Noun,1,0,1,0.0,1.1106915165381966e-05,1.0
45294,꽃들이/Noun,1,0,1,0.0,1.1106915165381966e-05,1.0
45295,몽따/Noun,1,0,1,0.0,1.1106915165381966e-05,1.0
45296,깊이깊이/Noun,1,1,0,1.1115310228308472e-05,0.0,1.0
45297,팬티스타킹/Noun,1,0,1,0.0,1.1106915165381966e-05,1.0
45298,호그와트/Noun,1,1,0,1.1115310228308472e-05,0.0,1.0
45299,ㅍㅋㅋㅋ/KoreanParticle,1,0,1,0.0,1.1106915165381966e-05,1.0
45300,포스트맨/Noun,1,1,0,1.1115310228308472e-05,0.0,1.0
45301,lv/Alpha,1,1,0,1.1115310228308472e-05,0.0,1.0
45302,ㅣㅠㅠ/KoreanParticle,1,1,0,1.1115310228308472e-05,0.0,1.0
45303,딸애/Noun,1,0,1,0.0,1.1106915165381966e-05,1.0
45304,일본음식/Noun,1,1,0,1.1115310228308472e-05,0.0,1.0
45305,전기요금/Noun,1,0,1,0.0,1.1106915165381966e-05,1.0
45306,…)/Punctuation,1,1,0,1.1115310228308472e-05,0.0,1.0
45307,암드/Noun,1,1,0,1.1115310228308472e-05,0.0,1.0
45308,히노/Noun,1,1,0,1.1115310228308472e-05,0.0,1.0
45309,졸료/Noun,1,0,1,0.0,1.1106915165381966e-05,1.0
45310,좌천/Noun,1,1,0,1.1115310228308472e-05,0.0,1.0
45311,짋/Noun,1,1,0,1.1115310228308472e-05,0.0,1.0
45312,기본권/Noun,1,1,0,1.1115310228308472e-05,0.0,1.0
45313,째째하다/Adjective,1,1,0,1.1115310228308472e-05,0.0,1.0
45314,준점/Noun,1,0,1,0.0,1.1106915165381966e-05,1.0
45315,대비디오를/Foreign,1,0,1,0.0,1.1106915165381966e-05,1.0
45316,성능/Noun,1,0,1,0.0,1.1106915165381966e-05,1.0
45317,ㅋㅡㅋ/KoreanParticle,1,1,0,1.1115310228308472e-05,0.0,1.0
45318,이암/Noun,1,0,1,0.0,1.1106915165381966e-05,1.0
45319,죶나/Noun,1,0,1,0.0,1.1106915165381966e-05,1.0
45320,십오분/Noun,1,0,1,0.0,1.1106915165381966e-05,1.0
45321,엔젤하트/Noun,1,1,0,1.1115310228308472e-05,0.0,1.0
45322,뻐근하다/Adjective,1,1,0,1.1115310228308472e-05,0.0,1.0
45323,레밍턴/Noun,1,1,0,1.1115310228308472e-05,0.0,1.0
45324,욕조/Noun,1,1,0,1.1115310228308472e-05,0.0,1.0
45325,강령술/Noun,1,1,0,1.1115310228308472e-05,0.0,1.0
45326,차림새/Noun,1,1,0,1.1115310228308472e-05,0.0,1.0
45327,절음/Noun,1,1,0,1.1115310228308472e-05,0.0,1.0
45328,헛심/Noun,1,0,1,0.0,1.1106915165381966e-05,1.0
45329,저격씬/Noun,1,0,1,0.0,1.1106915165381966e-05,1.0
45330,이라는짧은상영시간으로인한급하게마무리돼는전개로인해작품의완성도가떨어졌고역사상가장위대한모험소설가쥘베른의걸작/Foreign,1,0,1,0.0,1.1106915165381966e-05,1.0
45331,87분/Number,1,0,1,0.0,1.1106915165381966e-05,1.0
45332,인도주의/Noun,1,1,0,1.1115310228308472e-05,0.0,1.0
45333,체첸/Noun,1,0,1,0.0,1.1106915165381966e-05,1.0
45334,수재민/Noun,1,0,1,0.0,1.1106915165381966e-05,1.0
45335,미투/Noun,1,1,0,1.1115310228308472e-05,0.0,1.0
45336,구원투수/Noun,1,1,0,1.1115310228308472e-05,0.0,1.0
45337,정총/Noun,1,1,0,1.1115310228308472e-05,0.0,1.0
45338,델몬/Noun,1,1,0,1.1115310228308472e-05,0.0,1.0
45339,이강하/Noun,1,1,0,1.1115310228308472e-05,0.0,1.0
45340,대외/Noun,1,1,0,1.1115310228308472e-05,0.0,1.0
45341,에게든/Josa,1,1,0,1.1115310228308472e-05,0.0,1.0
45342,둘러앉다/Verb,1,1,0,1.1115310228308472e-05,0.0,1.0
45343,????/?/Punctuation,1,0,1,0.0,1.1106915165381966e-05,1.0
45344,~!!!!!!!!!^^/Punctuation,1,1,0,1.1115310228308472e-05,0.0,1.0
45345,회유/Noun,1,1,0,1.1115310228308472e-05,0.0,1.0
45346,킴벌리/Noun,1,1,0,1.1115310228308472e-05,0.0,1.0
45347,폭탄머리/Noun,1,0,1,0.0,1.1106915165381966e-05,1.0
45348,억지스레/Adverb,1,0,1,0.0,1.1106915165381966e-05,1.0
45349,음유시인/Noun,1,0,1,0.0,1.1106915165381966e-05,1.0
45350,만드소/Noun,1,0,1,0.0,1.1106915165381966e-05,1.0
45351,복역/Noun,1,0,1,0.0,1.1106915165381966e-05,1.0
45352,시픈건/Noun,1,0,1,0.0,1.1106915165381966e-05,1.0
45353,머머머/Noun,1,0,1,0.0,1.1106915165381966e-05,1.0
45354,액션씬등/Noun,1,1,0,1.1115310228308472e-05,0.0,1.0
45355,JUST/Alpha,1,1,0,1.1115310228308472e-05,0.0,1.0
45356,'//Punctuation,1,1,0,1.1115310228308472e-05,0.0,1.0
45357,7.95/Number,1,0,1,0.0,1.1106915165381966e-05,1.0
45358,셋스/Noun,1,0,1,0.0,1.1106915165381966e-05,1.0
45359,김호정/Noun,1,1,0,1.1115310228308472e-05,0.0,1.0
45360,게타/Noun,1,0,1,0.0,1.1106915165381966e-05,1.0
45361,"~..,/Punctuation",1,0,1,0.0,1.1106915165381966e-05,1.0
45362,티히/Noun,1,0,1,0.0,1.1106915165381966e-05,1.0
45363,자살토끼/Noun,1,1,0,1.1115310228308472e-05,0.0,1.0
45364,까치산역/Noun,1,1,0,1.1115310228308472e-05,0.0,1.0
45365,화곡/Noun,1,1,0,1.1115310228308472e-05,0.0,1.0
45366,반이나/Foreign,1,1,0,1.1115310228308472e-05,0.0,1.0
45367,사고사/Noun,1,1,0,1.1115310228308472e-05,0.0,1.0
45368,Below/Alpha,1,1,0,1.1115310228308472e-05,0.0,1.0
45369,Eight/Alpha,1,1,0,1.1115310228308472e-05,0.0,1.0
45370,수취인불명/Noun,1,1,0,1.1115310228308472e-05,0.0,1.0
45371,값못/Noun,1,0,1,0.0,1.1106915165381966e-05,1.0
45372,삑삑거릴거/Noun,1,0,1,0.0,1.1106915165381966e-05,1.0
45373,성운/Noun,1,0,1,0.0,1.1106915165381966e-05,1.0
45374,막봉/Noun,1,1,0,1.1115310228308472e-05,0.0,1.0
45375,fantasy/Alpha,1,1,0,1.1115310228308472e-05,0.0,1.0
45376,Childhood/Alpha,1,1,0,1.1115310228308472e-05,0.0,1.0
45377,....-_-;/Punctuation,1,0,1,0.0,1.1106915165381966e-05,1.0
45378,011/Number,1,1,0,1.1115310228308472e-05,0.0,1.0
45379,xlo/Alpha,1,1,0,1.1115310228308472e-05,0.0,1.0
45380,따돌리다/Verb,1,0,1,0.0,1.1106915165381966e-05,1.0
45381,서영은/Noun,1,0,1,0.0,1.1106915165381966e-05,1.0
45382,냄쇄/Noun,1,0,1,0.0,1.1106915165381966e-05,1.0
45383,사뢈/Noun,1,0,1,0.0,1.1106915165381966e-05,1.0
45384,느은/Noun,1,0,1,0.0,1.1106915165381966e-05,1.0
45385,tribute/Alpha,1,1,0,1.1115310228308472e-05,0.0,1.0
45386,silent/Alpha,1,1,0,1.1115310228308472e-05,0.0,1.0
45387,chicken/Alpha,1,1,0,1.1115310228308472e-05,0.0,1.0
45388,hit/Alpha,1,1,0,1.1115310228308472e-05,0.0,1.0
45389,휴재/Noun,1,1,0,1.1115310228308472e-05,0.0,1.0
45390,핰핰핰/Noun,1,1,0,1.1115310228308472e-05,0.0,1.0
45391,히르미/Noun,1,1,0,1.1115310228308472e-05,0.0,1.0
45392,나은영/Noun,1,1,0,1.1115310228308472e-05,0.0,1.0
45393,등무/Noun,1,1,0,1.1115310228308472e-05,0.0,1.0
45394,맷집과모/Noun,1,0,1,0.0,1.1106915165381966e-05,1.0
45395,힌번보세/Noun,1,1,0,1.1115310228308472e-05,0.0,1.0
45396,16만원/Number,1,0,1,0.0,1.1106915165381966e-05,1.0
45397,컨택/Noun,1,0,1,0.0,1.1106915165381966e-05,1.0
45398,바꿈/Noun,1,0,1,0.0,1.1106915165381966e-05,1.0
45399,프렌쎄싸/Noun,1,1,0,1.1115310228308472e-05,0.0,1.0
45400,Principessa/Alpha,1,1,0,1.1115310228308472e-05,0.0,1.0
45401,Giorno/Alpha,1,1,0,1.1115310228308472e-05,0.0,1.0
45402,Buon/Alpha,1,1,0,1.1115310228308472e-05,0.0,1.0
45403,..^)^/Punctuation,1,1,0,1.1115310228308472e-05,0.0,1.0
45404,유명진/Noun,1,1,0,1.1115310228308472e-05,0.0,1.0
45405,모슨/Noun,1,0,1,0.0,1.1106915165381966e-05,1.0
45406,낛/Noun,1,0,1,0.0,1.1106915165381966e-05,1.0
45407,남무/Noun,1,0,1,0.0,1.1106915165381966e-05,1.0
45408,힌데/Noun,1,0,1,0.0,1.1106915165381966e-05,1.0
45409,우성은/Noun,1,0,1,0.0,1.1106915165381966e-05,1.0
45410,소영은/Noun,1,0,1,0.0,1.1106915165381966e-05,1.0
45411,쎼뇨리따/Noun,1,1,0,1.1115310228308472e-05,0.0,1.0
45412,몬따/Noun,1,1,0,1.1115310228308472e-05,0.0,1.0
45413,뀌면/Noun,1,1,0,1.1115310228308472e-05,0.0,1.0
45414,뿌시럭/Noun,1,0,1,0.0,1.1106915165381966e-05,1.0
45415,회정/Noun,1,0,1,0.0,1.1106915165381966e-05,1.0
45416,노견/Noun,1,1,0,1.1115310228308472e-05,0.0,1.0
45417,루어/Noun,1,1,0,1.1115310228308472e-05,0.0,1.0
45418,남자형제/Noun,1,1,0,1.1115310228308472e-05,0.0,1.0
45419,가웃/Noun,1,0,1,0.0,1.1106915165381966e-05,1.0
45420,ㅁㄹ/KoreanParticle,1,0,1,0.0,1.1106915165381966e-05,1.0
45421,번거/Noun,1,0,1,0.0,1.1106915165381966e-05,1.0
45422,정도를/Foreign,1,0,1,0.0,1.1106915165381966e-05,1.0
45423,@~~~~~~~~~~@@~@~@~@~@@~@~@@~@@~@~@/Punctuation,1,1,0,1.1115310228308472e-05,0.0,1.0
45424,ㅋㅋㅉㅉ/KoreanParticle,1,0,1,0.0,1.1106915165381966e-05,1.0
45425,보릿고개/Noun,1,1,0,1.1115310228308472e-05,0.0,1.0
45426,골드핑거/Noun,1,1,0,1.1115310228308472e-05,0.0,1.0
45427,감독쉐키/Noun,1,0,1,0.0,1.1106915165381966e-05,1.0
45428,사브리나/Noun,1,1,0,1.1115310228308472e-05,0.0,1.0
45429,Washington/Alpha,1,0,1,0.0,1.1106915165381966e-05,1.0
45430,Denzel/Alpha,1,0,1,0.0,1.1106915165381966e-05,1.0
45431,창조력/Noun,1,1,0,1.1115310228308472e-05,0.0,1.0
45432,장엄/Noun,1,1,0,1.1115310228308472e-05,0.0,1.0
45433,Stunning/Alpha,1,1,0,1.1115310228308472e-05,0.0,1.0
45434,쳅터/Noun,1,0,1,0.0,1.1106915165381966e-05,1.0
45435,깟으/Noun,1,1,0,1.1115310228308472e-05,0.0,1.0
45436,껒여/Noun,1,0,1,0.0,1.1106915165381966e-05,1.0
45437,뒷마당/Noun,1,0,1,0.0,1.1106915165381966e-05,1.0
45438,업삳/Noun,1,0,1,0.0,1.1106915165381966e-05,1.0
45439,김치전/Noun,1,1,0,1.1115310228308472e-05,0.0,1.0
45440,쉬레깁니/Noun,1,0,1,0.0,1.1106915165381966e-05,1.0
45441,XFTM/Alpha,1,1,0,1.1115310228308472e-05,0.0,1.0
45442,산꼭대기/Noun,1,1,0,1.1115310228308472e-05,0.0,1.0
45443,임흥세/Noun,1,1,0,1.1115310228308472e-05,0.0,1.0
45444,브리핑/Noun,1,1,0,1.1115310228308472e-05,0.0,1.0
45445,지젠느/Noun,1,1,0,1.1115310228308472e-05,0.0,1.0
45446,진압작전/Noun,1,1,0,1.1115310228308472e-05,0.0,1.0
45447,도팬/Noun,1,1,0,1.1115310228308472e-05,0.0,1.0
45448,어학/Noun,1,0,1,0.0,1.1106915165381966e-05,1.0
45449,Gggggdgdfds/Alpha,1,1,0,1.1115310228308472e-05,0.0,1.0
45450,Bond/Alpha,1,1,0,1.1115310228308472e-05,0.0,1.0
45451,Justin/Alpha,1,1,0,1.1115310228308472e-05,0.0,1.0
45452,븐모슴/Noun,1,1,0,1.1115310228308472e-05,0.0,1.0
45453,에게가/Josa,1,1,0,1.1115310228308472e-05,0.0,1.0
45454,바꿧으/Noun,1,0,1,0.0,1.1106915165381966e-05,1.0
45455,크리미/Noun,1,0,1,0.0,1.1106915165381966e-05,1.0
45456,돈빨/Noun,1,0,1,0.0,1.1106915165381966e-05,1.0
45457,Alone/Alpha,1,0,1,0.0,1.1106915165381966e-05,1.0
45458,Know/Alpha,1,0,1,0.0,1.1106915165381966e-05,1.0
45459,SweetBox/Alpha,1,0,1,0.0,1.1106915165381966e-05,1.0
45460,퀼리티쩌/Noun,1,0,1,0.0,1.1106915165381966e-05,1.0
45461,bbbbbbbbbbb/Alpha,1,1,0,1.1115310228308472e-05,0.0,1.0
45462,집부북/Noun,1,0,1,0.0,1.1106915165381966e-05,1.0
45463,계념없/Noun,1,1,0,1.1115310228308472e-05,0.0,1.0
45464,족카/Noun,1,0,1,0.0,1.1106915165381966e-05,1.0
45465,ssam/Alpha,1,0,1,0.0,1.1106915165381966e-05,1.0
45466,고생한사람한텐아무것도없어요/Foreign,1,0,1,0.0,1.1106915165381966e-05,1.0
45467,",@)_/Punctuation",1,1,0,1.1115310228308472e-05,0.0,1.0
45468,"_(@,/Punctuation",1,1,0,1.1115310228308472e-05,0.0,1.0
45469,정흥채/Noun,1,0,1,0.0,1.1106915165381966e-05,1.0
45470,벼르한게/Noun,1,0,1,0.0,1.1106915165381966e-05,1.0
45471,번볼때/Noun,1,1,0,1.1115310228308472e-05,0.0,1.0
45472,지난후에/Foreign,1,1,0,1.1115310228308472e-05,0.0,1.0
45473,itsnotfair/Alpha,1,1,0,1.1115310228308472e-05,0.0,1.0
45474,트레스/Noun,1,0,1,0.0,1.1106915165381966e-05,1.0
45475,트레스패스/Noun,1,0,1,0.0,1.1106915165381966e-05,1.0
45476,걸옹/Noun,1,0,1,0.0,1.1106915165381966e-05,1.0
45477,@TB/ScreenName,1,1,0,1.1115310228308472e-05,0.0,1.0
45478,사진빨/Noun,1,1,0,1.1115310228308472e-05,0.0,1.0
45479,doramonz/Alpha,1,0,1,0.0,1.1106915165381966e-05,1.0
45480,쓰례/Noun,1,0,1,0.0,1.1106915165381966e-05,1.0
45481,정동영/Noun,1,0,1,0.0,1.1106915165381966e-05,1.0
45482,리페/Noun,1,1,0,1.1115310228308472e-05,0.0,1.0
45483,낚았었지/Noun,1,0,1,0.0,1.1106915165381966e-05,1.0
45484,쓰레길/Noun,1,0,1,0.0,1.1106915165381966e-05,1.0
45485,..^_^../Punctuation,1,1,0,1.1115310228308472e-05,0.0,1.0
45486,;:;;;;/Punctuation,1,0,1,0.0,1.1106915165381966e-05,1.0
45487,위엔/Noun,1,1,0,1.1115310228308472e-05,0.0,1.0
45488,꽹/Adverb,1,0,1,0.0,1.1106915165381966e-05,1.0
45489,필걸/Noun,1,0,1,0.0,1.1106915165381966e-05,1.0
45490,양철/Noun,1,0,1,0.0,1.1106915165381966e-05,1.0
45491,닺/Noun,1,1,0,1.1115310228308472e-05,0.0,1.0
45492,ㅣㅏㅈ/KoreanParticle,1,1,0,1.1115310228308472e-05,0.0,1.0
45493,애애애/Noun,1,1,0,1.1115310228308472e-05,0.0,1.0
45494,츠아니닟탗/Noun,1,1,0,1.1115310228308472e-05,0.0,1.0
45495,윈도폰/Noun,1,0,1,0.0,1.1106915165381966e-05,1.0
45496,짤린거임/Noun,1,0,1,0.0,1.1106915165381966e-05,1.0
45497,인건데/Noun,1,0,1,0.0,1.1106915165381966e-05,1.0
45498,스걸형님/Noun,1,0,1,0.0,1.1106915165381966e-05,1.0
45499,억척스럽다/Adjective,1,0,1,0.0,1.1106915165381966e-05,1.0
45500,스맛폰/Noun,1,0,1,0.0,1.1106915165381966e-05,1.0
45501,`;;/Punctuation,1,0,1,0.0,1.1106915165381966e-05,1.0
45502,딴지/Noun,1,1,0,1.1115310228308472e-05,0.0,1.0
45503,원주/Noun,1,0,1,0.0,1.1106915165381966e-05,1.0
45504,엔가/Foreign,1,0,1,0.0,1.1106915165381966e-05,1.0
45505,빠짐엄/Noun,1,1,0,1.1115310228308472e-05,0.0,1.0
45506,dlf/Alpha,1,0,1,0.0,1.1106915165381966e-05,1.0
45507,빠놈/Noun,1,0,1,0.0,1.1106915165381966e-05,1.0
45508,전도/Foreign,1,0,1,0.0,1.1106915165381966e-05,1.0
45509,리니/Eomi,1,1,0,1.1115310228308472e-05,0.0,1.0
45510,조코비치/Noun,1,1,0,1.1115310228308472e-05,0.0,1.0
45511,일비/Noun,1,1,0,1.1115310228308472e-05,0.0,1.0
45512,~~^.^**/Punctuation,1,1,0,1.1115310228308472e-05,0.0,1.0
45513,쪼금씩/Noun,1,1,0,1.1115310228308472e-05,0.0,1.0
45514,겂나/Noun,1,1,0,1.1115310228308472e-05,0.0,1.0
45515,Grace/Alpha,1,1,0,1.1115310228308472e-05,0.0,1.0
45516,쫑알/Adverb,1,0,1,0.0,1.1106915165381966e-05,1.0
45517,유탄발사기/Noun,1,0,1,0.0,1.1106915165381966e-05,1.0
45518,있다가/Foreign,1,0,1,0.0,1.1106915165381966e-05,1.0
45519,1~2분/Number,1,0,1,0.0,1.1106915165381966e-05,1.0
45520,"!""./Punctuation",1,0,1,0.0,1.1106915165381966e-05,1.0
45521,스티븡유/Noun,1,0,1,0.0,1.1106915165381966e-05,1.0
45522,돱/Noun,1,0,1,0.0,1.1106915165381966e-05,1.0
45523,기라도/Foreign,1,1,0,1.1115310228308472e-05,0.0,1.0
45524,쿠민/Noun,1,1,0,1.1115310228308472e-05,0.0,1.0
45525,일망타진/Noun,1,1,0,1.1115310228308472e-05,0.0,1.0
45526,주고봐도아깝다는생각이든다/Foreign,1,1,0,1.1115310228308472e-05,0.0,1.0
45527,살면서본영화중가장재미없고스토리도그렇고아역배우발연기에정말/Foreign,1,1,0,1.1115310228308472e-05,0.0,1.0
45528,페페/Noun,1,1,0,1.1115310228308472e-05,0.0,1.0
45529,Virus/Alpha,1,1,0,1.1115310228308472e-05,0.0,1.0
45530,쓸애긔입니/Noun,1,0,1,0.0,1.1106915165381966e-05,1.0
45531,휘황/Noun,1,1,0,1.1115310228308472e-05,0.0,1.0
45532,볹다/Noun,1,0,1,0.0,1.1106915165381966e-05,1.0
45533,븨앞/Noun,1,0,1,0.0,1.1106915165381966e-05,1.0
45534,심플라이프/Noun,1,1,0,1.1115310228308472e-05,0.0,1.0
45535,성리학/Noun,1,0,1,0.0,1.1106915165381966e-05,1.0
45536,방계/Noun,1,1,0,1.1115310228308472e-05,0.0,1.0
45537,짝좀/Noun,1,0,1,0.0,1.1106915165381966e-05,1.0
45538,액션피겨/Noun,1,1,0,1.1115310228308472e-05,0.0,1.0
45539,건프라/Noun,1,1,0,1.1115310228308472e-05,0.0,1.0
45540,뎀벼/Noun,1,1,0,1.1115310228308472e-05,0.0,1.0
45541,였드/Noun,1,0,1,0.0,1.1106915165381966e-05,1.0
45542,;;..../Punctuation,1,0,1,0.0,1.1106915165381966e-05,1.0
45543,ec/Alpha,1,0,1,0.0,1.1106915165381966e-05,1.0
45544,완전낚였/Noun,1,0,1,0.0,1.1106915165381966e-05,1.0
45545,유딩한테/Noun,1,0,1,0.0,1.1106915165381966e-05,1.0
45546,##이야/Hashtag,1,0,1,0.0,1.1106915165381966e-05,1.0
45547,밤톨/Noun,1,1,0,1.1115310228308472e-05,0.0,1.0
45548,흐규/Noun,1,1,0,1.1115310228308472e-05,0.0,1.0
45549,씽씽/Adverb,1,1,0,1.1115310228308472e-05,0.0,1.0
45550,부둣가씬/Noun,1,1,0,1.1115310228308472e-05,0.0,1.0
45551,트램펄린/Noun,1,1,0,1.1115310228308472e-05,0.0,1.0
45552,성년/Noun,1,0,1,0.0,1.1106915165381966e-05,1.0
45553,외향/Noun,1,0,1,0.0,1.1106915165381966e-05,1.0
45554,파퀴토/Noun,1,1,0,1.1115310228308472e-05,0.0,1.0
45555,오르페오/Noun,1,1,0,1.1115310228308472e-05,0.0,1.0
45556,"!!""..../Punctuation",1,1,0,1.1115310228308472e-05,0.0,1.0
45557,미나스/Noun,1,1,0,1.1115310228308472e-05,0.0,1.0
45558,언스토퍼블/Noun,1,1,0,1.1115310228308472e-05,0.0,1.0
45559,채리불권/Noun,1,0,1,0.0,1.1106915165381966e-05,1.0
45560,서폿/Noun,1,0,1,0.0,1.1106915165381966e-05,1.0
45561,뭐시/Noun,1,1,0,1.1115310228308472e-05,0.0,1.0
45562,코판/Noun,1,1,0,1.1115310228308472e-05,0.0,1.0
45563,이센스/Noun,1,0,1,0.0,1.1106915165381966e-05,1.0
45564,컨트랙티드/Noun,1,0,1,0.0,1.1106915165381966e-05,1.0
45565,쩌업/Noun,1,0,1,0.0,1.1106915165381966e-05,1.0
45566,한부모/Noun,1,1,0,1.1115310228308472e-05,0.0,1.0
45567,퓽퓽/Noun,1,1,0,1.1115310228308472e-05,0.0,1.0
45568,폭뢰/Noun,1,1,0,1.1115310228308472e-05,0.0,1.0
45569,맺혔네/Noun,1,1,0,1.1115310228308472e-05,0.0,1.0
45570,래즈/Noun,1,0,1,0.0,1.1106915165381966e-05,1.0
45571,Piaf/Alpha,1,1,0,1.1115310228308472e-05,0.0,1.0
45572,:^)/Punctuation,1,1,0,1.1115310228308472e-05,0.0,1.0
45573,이지났음에도/Foreign,1,1,0,1.1115310228308472e-05,0.0,1.0
45574,삼성동/Noun,1,1,0,1.1115310228308472e-05,0.0,1.0
45575,유요/Noun,1,0,1,0.0,1.1106915165381966e-05,1.0
45576,에쁩니/Noun,1,1,0,1.1115310228308472e-05,0.0,1.0
45577,영상떄문/Noun,1,0,1,0.0,1.1106915165381966e-05,1.0
45578,케이비에스/Noun,1,0,1,0.0,1.1106915165381966e-05,1.0
45579,풀버호벤/Noun,1,1,0,1.1115310228308472e-05,0.0,1.0
45580,;''/Punctuation,1,0,1,0.0,1.1106915165381966e-05,1.0
45581,ㄹㅎㅎㅎ/KoreanParticle,1,1,0,1.1115310228308472e-05,0.0,1.0
45582,입장료/Noun,1,0,1,0.0,1.1106915165381966e-05,1.0
45583,캄파/Noun,1,1,0,1.1115310228308472e-05,0.0,1.0
45584,바보바보/Noun,1,1,0,1.1115310228308472e-05,0.0,1.0
45585,미지왕/Noun,1,1,0,1.1115310228308472e-05,0.0,1.0
45586,잇속/Noun,1,1,0,1.1115310228308472e-05,0.0,1.0
45587,stimulator/Alpha,1,1,0,1.1115310228308472e-05,0.0,1.0
45588,muscle/Alpha,1,1,0,1.1115310228308472e-05,0.0,1.0
45589,52년/Number,1,1,0,1.1115310228308472e-05,0.0,1.0
45590,경기장/Noun,1,1,0,1.1115310228308472e-05,0.0,1.0
45591,스프링스틴/Noun,1,1,0,1.1115310228308472e-05,0.0,1.0
45592,큐땜/Noun,1,0,1,0.0,1.1106915165381966e-05,1.0
45593,빡보/Noun,1,0,1,0.0,1.1106915165381966e-05,1.0
45594,옵빠/Noun,1,0,1,0.0,1.1106915165381966e-05,1.0
45595,송민정/Noun,1,0,1,0.0,1.1106915165381966e-05,1.0
45596,황인뢰/Noun,1,1,0,1.1115310228308472e-05,0.0,1.0
45597,팀힐/Noun,1,0,1,0.0,1.1106915165381966e-05,1.0
45598,얼윈장군/Noun,1,0,1,0.0,1.1106915165381966e-05,1.0
45599,얼윈/Noun,1,0,1,0.0,1.1106915165381966e-05,1.0
45600,대호/Noun,1,1,0,1.1115310228308472e-05,0.0,1.0
45601,수뇌부/Noun,1,1,0,1.1115310228308472e-05,0.0,1.0
45602,일대/Noun,1,0,1,0.0,1.1106915165381966e-05,1.0
45603,보르테/Noun,1,1,0,1.1115310228308472e-05,0.0,1.0
45604,말라가/Noun,1,1,0,1.1115310228308472e-05,0.0,1.0
45605,weight/Alpha,1,1,0,1.1115310228308472e-05,0.0,1.0
45606,carry/Alpha,1,1,0,1.1115310228308472e-05,0.0,1.0
45607,powerful/Alpha,1,1,0,1.1115310228308472e-05,0.0,1.0
45608,용인고/Noun,1,0,1,0.0,1.1106915165381966e-05,1.0
45609,살륙/Noun,1,0,1,0.0,1.1106915165381966e-05,1.0
45610,FRIENDS/Alpha,1,1,0,1.1115310228308472e-05,0.0,1.0
45611,"..,,,,../Punctuation",1,0,1,0.0,1.1106915165381966e-05,1.0
45612,괞히/Noun,1,1,0,1.1115310228308472e-05,0.0,1.0
45613,섹션/Noun,1,1,0,1.1115310228308472e-05,0.0,1.0
45614,국방군/Noun,1,1,0,1.1115310228308472e-05,0.0,1.0
45615,신더/Noun,1,1,0,1.1115310228308472e-05,0.0,1.0
45616,멍덩/Noun,1,0,1,0.0,1.1106915165381966e-05,1.0
45617,금요일인/Foreign,1,0,1,0.0,1.1106915165381966e-05,1.0
45618,송도신도시/Noun,1,0,1,0.0,1.1106915165381966e-05,1.0
45619,최정우/Noun,1,1,0,1.1115310228308472e-05,0.0,1.0
45620,스폰이있/Noun,1,0,1,0.0,1.1106915165381966e-05,1.0
45621,조현아/Noun,1,0,1,0.0,1.1106915165381966e-05,1.0
45622,뭉게짐/Noun,1,0,1,0.0,1.1106915165381966e-05,1.0
45623,미지수/Noun,1,0,1,0.0,1.1106915165381966e-05,1.0
45624,^^(/Punctuation,1,1,0,1.1115310228308472e-05,0.0,1.0
45625,ㅡㄴㅅㄴ/KoreanParticle,1,1,0,1.1115310228308472e-05,0.0,1.0
45626,쟤땜/Noun,1,1,0,1.1115310228308472e-05,0.0,1.0
45627,Japan/Alpha,1,0,1,0.0,1.1106915165381966e-05,1.0
45628,Sea/Alpha,1,0,1,0.0,1.1106915165381966e-05,1.0
45629,칭구들/Noun,1,1,0,1.1115310228308472e-05,0.0,1.0
45630,­­/Foreign,1,0,1,0.0,1.1106915165381966e-05,1.0
45631,Mermaid/Alpha,1,1,0,1.1115310228308472e-05,0.0,1.0
45632,Mother/Alpha,1,1,0,1.1115310228308472e-05,0.0,1.0
45633,베긴스/Noun,1,0,1,0.0,1.1106915165381966e-05,1.0
45634,실오라기/Noun,1,1,0,1.1115310228308472e-05,0.0,1.0
45635,토마슈역/Noun,1,1,0,1.1115310228308472e-05,0.0,1.0
45636,즑거운/Noun,1,1,0,1.1115310228308472e-05,0.0,1.0
45637,꼬고꼬고또꼬/Noun,1,0,1,0.0,1.1106915165381966e-05,1.0
45638,이상주의/Noun,1,1,0,1.1115310228308472e-05,0.0,1.0
45639,~@.@;;/Punctuation,1,0,1,0.0,1.1106915165381966e-05,1.0
45640,820억/Number,1,0,1,0.0,1.1106915165381966e-05,1.0
45641,개쓔레귀/Noun,1,0,1,0.0,1.1106915165381966e-05,1.0
45642,운철/Noun,1,1,0,1.1115310228308472e-05,0.0,1.0
45643,선민/Noun,1,0,1,0.0,1.1106915165381966e-05,1.0
45644,베이비돌/Noun,1,1,0,1.1115310228308472e-05,0.0,1.0
45645,존꿀잼/Noun,1,1,0,1.1115310228308472e-05,0.0,1.0
45646,똥망임/Noun,1,0,1,0.0,1.1106915165381966e-05,1.0
45647,동그라미/Noun,1,1,0,1.1115310228308472e-05,0.0,1.0
45648,제도로/Noun,1,1,0,1.1115310228308472e-05,0.0,1.0
45649,대풍/Noun,1,0,1,0.0,1.1106915165381966e-05,1.0
45650,인줄아나/Foreign,1,0,1,0.0,1.1106915165381966e-05,1.0
45651,반대쪽/Noun,1,0,1,0.0,1.1106915165381966e-05,1.0
45652,태론/Noun,1,1,0,1.1115310228308472e-05,0.0,1.0
45653,)!!!!!!!/Punctuation,1,1,0,1.1115310228308472e-05,0.0,1.0
45654,사이에/Foreign,1,1,0,1.1115310228308472e-05,0.0,1.0
45655,1~2년/Number,1,1,0,1.1115310228308472e-05,0.0,1.0
45656,링고/Noun,1,1,0,1.1115310228308472e-05,0.0,1.0
45657,114/Number,1,0,1,0.0,1.1106915165381966e-05,1.0
45658,정민형/Noun,1,0,1,0.0,1.1106915165381966e-05,1.0
45659,수안/Noun,1,0,1,0.0,1.1106915165381966e-05,1.0
45660,이주나/Noun,1,0,1,0.0,1.1106915165381966e-05,1.0
45661,~~~~~~~~~~~!!!!!!!!!!!!!!/Punctuation,1,1,0,1.1115310228308472e-05,0.0,1.0
45662,ㅋㅎㅋㅎㅋㅋㅎㅋㅎㅎㅋㅋㅎㅎㅋ/KoreanParticle,1,1,0,1.1115310228308472e-05,0.0,1.0
45663,사자상/Noun,1,1,0,1.1115310228308472e-05,0.0,1.0
45664,과반수/Noun,1,0,1,0.0,1.1106915165381966e-05,1.0
45665,평첨/Noun,1,1,0,1.1115310228308472e-05,0.0,1.0
45666,우민/Noun,1,1,0,1.1115310228308472e-05,0.0,1.0
45667,강휘/Noun,1,1,0,1.1115310228308472e-05,0.0,1.0
45668,더욕/Noun,1,0,1,0.0,1.1106915165381966e-05,1.0
45669,와/Foreign,1,1,0,1.1115310228308472e-05,0.0,1.0
45670,20달러/Number,1,1,0,1.1115310228308472e-05,0.0,1.0
45671,~~???/Punctuation,1,0,1,0.0,1.1106915165381966e-05,1.0
45672,규수/Noun,1,0,1,0.0,1.1106915165381966e-05,1.0
45673,네델란드/Noun,1,0,1,0.0,1.1106915165381966e-05,1.0
45674,~~~>.</Punctuation,1,1,0,1.1115310228308472e-05,0.0,1.0
45675,소맥/Noun,1,0,1,0.0,1.1106915165381966e-05,1.0
45676,도아깝네요/Foreign,1,0,1,0.0,1.1106915165381966e-05,1.0
45677,멋있드/Noun,1,1,0,1.1115310228308472e-05,0.0,1.0
45678,몬지/Noun,1,0,1,0.0,1.1106915165381966e-05,1.0
45679,네이팜/Noun,1,1,0,1.1115310228308472e-05,0.0,1.0
45680,0.0/Number,1,0,1,0.0,1.1106915165381966e-05,1.0
45681,쉬원쉬윈/Noun,1,1,0,1.1115310228308472e-05,0.0,1.0
45682,운곽선/Noun,1,0,1,0.0,1.1106915165381966e-05,1.0
45683,쌕시/Noun,1,1,0,1.1115310228308472e-05,0.0,1.0
45684,김서라/Noun,1,1,0,1.1115310228308472e-05,0.0,1.0
45685,!!!?/Punctuation,1,1,0,1.1115310228308472e-05,0.0,1.0
45686,휴식시간/Noun,1,1,0,1.1115310228308472e-05,0.0,1.0
45687,숏버스/Noun,1,0,1,0.0,1.1106915165381966e-05,1.0
45688,부캡/Noun,1,1,0,1.1115310228308472e-05,0.0,1.0
45689,촌스럼/Noun,1,0,1,0.0,1.1106915165381966e-05,1.0
45690,광대역/Noun,1,0,1,0.0,1.1106915165381966e-05,1.0
45691,보물성/Noun,1,1,0,1.1115310228308472e-05,0.0,1.0
45692,취할/Noun,1,1,0,1.1115310228308472e-05,0.0,1.0
45693,무르익/Noun,1,1,0,1.1115310228308472e-05,0.0,1.0
45694,짭스/Noun,1,0,1,0.0,1.1106915165381966e-05,1.0
45695,Eikon/Alpha,1,0,1,0.0,1.1106915165381966e-05,1.0
45696,룸바/Noun,1,1,0,1.1115310228308472e-05,0.0,1.0
45697,군역/Noun,1,0,1,0.0,1.1106915165381966e-05,1.0
45698,설랬습니/Noun,1,1,0,1.1115310228308472e-05,0.0,1.0
45699,류영화니/Noun,1,1,0,1.1115310228308472e-05,0.0,1.0
45700,머릴를/Noun,1,0,1,0.0,1.1106915165381966e-05,1.0
45701,판스/Noun,1,0,1,0.0,1.1106915165381966e-05,1.0
45702,사범/Noun,1,1,0,1.1115310228308472e-05,0.0,1.0
45703,눈마/Noun,1,0,1,0.0,1.1106915165381966e-05,1.0
45704,지로나/Noun,1,0,1,0.0,1.1106915165381966e-05,1.0
45705,욹어먹/Noun,1,0,1,0.0,1.1106915165381966e-05,1.0
45706,팀로빈스/Noun,1,1,0,1.1115310228308472e-05,0.0,1.0
45707,민권/Noun,1,1,0,1.1115310228308472e-05,0.0,1.0
45708,전중/Foreign,1,1,0,1.1115310228308472e-05,0.0,1.0
45709,초크/Noun,1,1,0,1.1115310228308472e-05,0.0,1.0
45710,길로틴/Noun,1,1,0,1.1115310228308472e-05,0.0,1.0
45711,린컨/Noun,1,1,0,1.1115310228308472e-05,0.0,1.0
45712,득실득실/Adverb,1,1,0,1.1115310228308472e-05,0.0,1.0
45713,술렁술렁/Adverb,1,1,0,1.1115310228308472e-05,0.0,1.0
45714,엉성엉성/Adverb,1,0,1,0.0,1.1106915165381966e-05,1.0
45715,창연/Noun,1,0,1,0.0,1.1106915165381966e-05,1.0
45716,고색/Noun,1,0,1,0.0,1.1106915165381966e-05,1.0
45717,-!!!!!!/Punctuation,1,0,1,0.0,1.1106915165381966e-05,1.0
45718,타작/Noun,1,0,1,0.0,1.1106915165381966e-05,1.0
45719,마이사/Noun,1,0,1,0.0,1.1106915165381966e-05,1.0
45720,¡/Foreign,1,1,0,1.1115310228308472e-05,0.0,1.0
45721,싱긋/Noun,1,1,0,1.1115310228308472e-05,0.0,1.0
45722,찌증/Noun,1,1,0,1.1115310228308472e-05,0.0,1.0
45723,임진모/Noun,1,1,0,1.1115310228308472e-05,0.0,1.0
45724,못느꼇/Noun,1,0,1,0.0,1.1106915165381966e-05,1.0
45725,상룡/Noun,1,0,1,0.0,1.1106915165381966e-05,1.0
45726,유재/Noun,1,1,0,1.1115310228308472e-05,0.0,1.0
45727,채우고/Foreign,1,0,1,0.0,1.1106915165381966e-05,1.0
45728,애좀/Noun,1,0,1,0.0,1.1106915165381966e-05,1.0
45729,눈온/Noun,1,1,0,1.1115310228308472e-05,0.0,1.0
45730,비온/Noun,1,1,0,1.1115310228308472e-05,0.0,1.0
45731,평평하다/Adjective,1,1,0,1.1115310228308472e-05,0.0,1.0
45732,빼돌/Noun,1,0,1,0.0,1.1106915165381966e-05,1.0
45733,땅문서/Noun,1,0,1,0.0,1.1106915165381966e-05,1.0
45734,볼기/Noun,1,0,1,0.0,1.1106915165381966e-05,1.0
45735,관램객/Noun,1,1,0,1.1115310228308472e-05,0.0,1.0
45736,씨지/Foreign,1,1,0,1.1115310228308472e-05,0.0,1.0
45737,나아아/Noun,1,0,1,0.0,1.1106915165381966e-05,1.0
45738,나띵/Noun,1,0,1,0.0,1.1106915165381966e-05,1.0
45739,장효전/Noun,1,1,0,1.1115310228308472e-05,0.0,1.0
45740,시계수리공/Noun,1,1,0,1.1115310228308472e-05,0.0,1.0
45741,류시시/Noun,1,1,0,1.1115310228308472e-05,0.0,1.0
45742,엄심/Noun,1,1,0,1.1115310228308472e-05,0.0,1.0
45743,십만/Noun,1,0,1,0.0,1.1106915165381966e-05,1.0
45744,9천/Number,1,0,1,0.0,1.1106915165381966e-05,1.0
45745,위워솔져스/Noun,1,0,1,0.0,1.1106915165381966e-05,1.0
45746,로다쥬/Noun,1,0,1,0.0,1.1106915165381966e-05,1.0
45747,ㅑㅏ/KoreanParticle,1,0,1,0.0,1.1106915165381966e-05,1.0
45748,아쉽드/Noun,1,0,1,0.0,1.1106915165381966e-05,1.0
45749,예부/Noun,1,0,1,0.0,1.1106915165381966e-05,1.0
45750,미국워싱턴주/Foreign,1,1,0,1.1115310228308472e-05,0.0,1.0
45751,돈쥬앙/Noun,1,0,1,0.0,1.1106915165381966e-05,1.0
45752,바락바락/Noun,1,0,1,0.0,1.1106915165381966e-05,1.0
45753,신짱/Noun,1,1,0,1.1115310228308472e-05,0.0,1.0
45754,코미딘/Noun,1,0,1,0.0,1.1106915165381966e-05,1.0
45755,팀입/Noun,1,0,1,0.0,1.1106915165381966e-05,1.0
45756,남의철/Noun,1,0,1,0.0,1.1106915165381966e-05,1.0
45757,홈팀/Noun,1,0,1,0.0,1.1106915165381966e-05,1.0
45758,팀드레곤/Noun,1,0,1,0.0,1.1106915165381966e-05,1.0
45759,굉징히/Noun,1,0,1,0.0,1.1106915165381966e-05,1.0
45760,007년/Number,1,0,1,0.0,1.1106915165381966e-05,1.0
45761,망가뜨릴/Noun,1,0,1,0.0,1.1106915165381966e-05,1.0
45762,칸텔/Noun,1,0,1,0.0,1.1106915165381966e-05,1.0
45763,뒤주/Noun,1,0,1,0.0,1.1106915165381966e-05,1.0
45764,한격/Noun,1,0,1,0.0,1.1106915165381966e-05,1.0
45765,회심/Noun,1,0,1,0.0,1.1106915165381966e-05,1.0
45766,개잣/Noun,1,0,1,0.0,1.1106915165381966e-05,1.0
45767,구글번역기/Noun,1,1,0,1.1115310228308472e-05,0.0,1.0
45768,핵션/Noun,1,1,0,1.1115310228308472e-05,0.0,1.0
45769,권진아/Noun,1,1,0,1.1115310228308472e-05,0.0,1.0
45770,반피블스/Noun,1,0,1,0.0,1.1106915165381966e-05,1.0
45771,서갑숙/Noun,1,0,1,0.0,1.1106915165381966e-05,1.0
45772,셨던/Noun,1,0,1,0.0,1.1106915165381966e-05,1.0
45773,굴속/Noun,1,1,0,1.1115310228308472e-05,0.0,1.0
45774,초유/Noun,1,0,1,0.0,1.1106915165381966e-05,1.0
45775,좊밥/Noun,1,0,1,0.0,1.1106915165381966e-05,1.0
45776,토익스피킹/Noun,1,1,0,1.1115310228308472e-05,0.0,1.0
45777,괴정/Noun,1,0,1,0.0,1.1106915165381966e-05,1.0
45778,버겨/Noun,1,1,0,1.1115310228308472e-05,0.0,1.0
45779,윤영삼/Noun,1,1,0,1.1115310228308472e-05,0.0,1.0
45780,노형욱/Noun,1,1,0,1.1115310228308472e-05,0.0,1.0
45781,드워프/Noun,1,1,0,1.1115310228308472e-05,0.0,1.0
45782,ウングワンヨルシムヒします/Foreign,1,1,0,1.1115310228308472e-05,0.0,1.0
45783,ガンダム見たいですね/Foreign,1,1,0,1.1115310228308472e-05,0.0,1.0
45784,りえ様/Foreign,1,1,0,1.1115310228308472e-05,0.0,1.0
45785,Tanaka/Alpha,1,1,0,1.1115310228308472e-05,0.0,1.0
45786,오르락내리락/Noun,1,1,0,1.1115310228308472e-05,0.0,1.0
45787,득보잡/Noun,1,0,1,0.0,1.1106915165381966e-05,1.0
45788,엘피/Noun,1,1,0,1.1115310228308472e-05,0.0,1.0
45789,??;;-_-/Punctuation,1,0,1,0.0,1.1106915165381966e-05,1.0
45790,謝霆鋒/Foreign,1,1,0,1.1115310228308472e-05,0.0,1.0
45791,사업자/Noun,1,0,1,0.0,1.1106915165381966e-05,1.0
45792,역@JSA/ScreenName,1,0,1,0.0,1.1106915165381966e-05,1.0
45793,공동경비구/Foreign,1,0,1,0.0,1.1106915165381966e-05,1.0
45794,을못보겠다/Foreign,1,0,1,0.0,1.1106915165381966e-05,1.0
45795,양심선언/Noun,1,1,0,1.1115310228308472e-05,0.0,1.0
45796,지스쿼드/Noun,1,1,0,1.1115310228308472e-05,0.0,1.0
45797,달랑이다/Verb,1,0,1,0.0,1.1106915165381966e-05,1.0
45798,성심/Noun,1,1,0,1.1115310228308472e-05,0.0,1.0
45799,충주/Noun,1,1,0,1.1115310228308472e-05,0.0,1.0
45800,맹모씨/Noun,1,0,1,0.0,1.1106915165381966e-05,1.0
45801,선수권대회/Noun,1,0,1,0.0,1.1106915165381966e-05,1.0
45802,알까기/Noun,1,0,1,0.0,1.1106915165381966e-05,1.0
45803,멋지댜/Noun,1,1,0,1.1115310228308472e-05,0.0,1.0
45804,남케/Noun,1,0,1,0.0,1.1106915165381966e-05,1.0
45805,끚/Noun,1,1,0,1.1115310228308472e-05,0.0,1.0
45806,말라보/Noun,1,0,1,0.0,1.1106915165381966e-05,1.0
45807,이주노/Noun,1,0,1,0.0,1.1106915165381966e-05,1.0
45808,미랄레그로/Noun,1,1,0,1.1115310228308472e-05,0.0,1.0
45809,항법/Noun,1,1,0,1.1115310228308472e-05,0.0,1.0
45810,끼등/Noun,1,0,1,0.0,1.1106915165381966e-05,1.0
45811,젖갗/Noun,1,0,1,0.0,1.1106915165381966e-05,1.0
45812,찮을거/Noun,1,0,1,0.0,1.1106915165381966e-05,1.0
45813,아위/Noun,1,0,1,0.0,1.1106915165381966e-05,1.0
45814,던데/Foreign,1,1,0,1.1115310228308472e-05,0.0,1.0
45815,드믄/Noun,1,1,0,1.1115310228308472e-05,0.0,1.0
45816,페렐/Noun,1,1,0,1.1115310228308472e-05,0.0,1.0
45817,프랑코/Noun,1,1,0,1.1115310228308472e-05,0.0,1.0
45818,아깝다정말/Foreign,1,0,1,0.0,1.1106915165381966e-05,1.0
45819,보다가에잇하고끔돈/Foreign,1,0,1,0.0,1.1106915165381966e-05,1.0
45820,;;;;;;;;;;;;;;;;;;;;;;;;;;;;;;;;;;;;;;;;;;;/Punctuation,1,1,0,1.1115310228308472e-05,0.0,1.0
45821,퐈이/Noun,1,1,0,1.1115310228308472e-05,0.0,1.0
45822,팩임돠/Noun,1,1,0,1.1115310228308472e-05,0.0,1.0
45823,9999/Number,1,0,1,0.0,1.1106915165381966e-05,1.0
45824,코파/Noun,1,0,1,0.0,1.1106915165381966e-05,1.0
45825,다뿌수/Noun,1,0,1,0.0,1.1106915165381966e-05,1.0
45826,백설/Noun,1,0,1,0.0,1.1106915165381966e-05,1.0
45827,띰/Noun,1,0,1,0.0,1.1106915165381966e-05,1.0
45828,정글도/Noun,1,0,1,0.0,1.1106915165381966e-05,1.0
45829,항사/Noun,1,1,0,1.1115310228308472e-05,0.0,1.0
45830,김형일/Noun,1,1,0,1.1115310228308472e-05,0.0,1.0
45831,장동휘/Noun,1,1,0,1.1115310228308472e-05,0.0,1.0
45832,혜광/Noun,1,1,0,1.1115310228308472e-05,0.0,1.0
45833,스땜/Noun,1,0,1,0.0,1.1106915165381966e-05,1.0
45834,어지간/Noun,1,1,0,1.1115310228308472e-05,0.0,1.0
45835,포레버/Noun,1,1,0,1.1115310228308472e-05,0.0,1.0
45836,@./Punctuation,1,1,0,1.1115310228308472e-05,0.0,1.0
45837,곽현/Noun,1,0,1,0.0,1.1106915165381966e-05,1.0
45838,아침식사/Noun,1,1,0,1.1115310228308472e-05,0.0,1.0
45839,만찍어서/Foreign,1,1,0,1.1115310228308472e-05,0.0,1.0
45840,쓰랙빠/Noun,1,0,1,0.0,1.1106915165381966e-05,1.0
45841,쑥맥/Noun,1,0,1,0.0,1.1106915165381966e-05,1.0
45842,알록달록/Noun,1,1,0,1.1115310228308472e-05,0.0,1.0
45843,자족/Noun,1,1,0,1.1115310228308472e-05,0.0,1.0
45844,무궁/Noun,1,1,0,1.1115310228308472e-05,0.0,1.0
45845,앰생/Noun,1,0,1,0.0,1.1106915165381966e-05,1.0
45846,오버리엑팅/Noun,1,0,1,0.0,1.1106915165381966e-05,1.0
45847,짜리반전캠페인영화/Foreign,1,0,1,0.0,1.1106915165381966e-05,1.0
45848,라츠/Noun,1,1,0,1.1115310228308472e-05,0.0,1.0
45849,파르비스/Noun,1,1,0,1.1115310228308472e-05,0.0,1.0
45850,허식/Noun,1,0,1,0.0,1.1106915165381966e-05,1.0
45851,포와르/Noun,1,1,0,1.1115310228308472e-05,0.0,1.0
45852,들었다네/Foreign,1,0,1,0.0,1.1106915165381966e-05,1.0
45853,정곡/Noun,1,0,1,0.0,1.1106915165381966e-05,1.0
45854,곱상하다/Adjective,1,0,1,0.0,1.1106915165381966e-05,1.0
45855,브론슨/Noun,1,1,0,1.1115310228308472e-05,0.0,1.0
45856,찰슨/Noun,1,1,0,1.1115310228308472e-05,0.0,1.0
45857,폐교씬/Noun,1,1,0,1.1115310228308472e-05,0.0,1.0
45858,폐교/Noun,1,1,0,1.1115310228308472e-05,0.0,1.0
45859,너므좋/Noun,1,1,0,1.1115310228308472e-05,0.0,1.0
45860,눙/Noun,1,1,0,1.1115310228308472e-05,0.0,1.0
45861,브레스트/Noun,1,1,0,1.1115310228308472e-05,0.0,1.0
45862,물렁하다/Adjective,1,0,1,0.0,1.1106915165381966e-05,1.0
45863,인생역전/Noun,1,0,1,0.0,1.1106915165381966e-05,1.0
45864,톰쿠르즈/Noun,1,1,0,1.1115310228308472e-05,0.0,1.0
45865,잼나넹/Noun,1,1,0,1.1115310228308472e-05,0.0,1.0
45866,효영/Noun,1,1,0,1.1115310228308472e-05,0.0,1.0
45867,[!]/Punctuation,1,1,0,1.1115310228308472e-05,0.0,1.0
45868,파혼/Noun,1,0,1,0.0,1.1106915165381966e-05,1.0
45869,보셔욤/Noun,1,1,0,1.1115310228308472e-05,0.0,1.0
45870,21회/Number,1,0,1,0.0,1.1106915165381966e-05,1.0
45871,피보나치수열/Noun,1,0,1,0.0,1.1106915165381966e-05,1.0
45872,황금비/Noun,1,0,1,0.0,1.1106915165381966e-05,1.0
45873,힐즈/Noun,1,0,1,0.0,1.1106915165381966e-05,1.0
45874,못마땅하다/Adjective,1,0,1,0.0,1.1106915165381966e-05,1.0
45875,왕후/Noun,1,0,1,0.0,1.1106915165381966e-05,1.0
45876,알랍유/Noun,1,1,0,1.1115310228308472e-05,0.0,1.0
45877,류지/Noun,1,1,0,1.1115310228308472e-05,0.0,1.0
45878,칼렙/Noun,1,1,0,1.1115310228308472e-05,0.0,1.0
45879,거운/Noun,1,0,1,0.0,1.1106915165381966e-05,1.0
45880,따끈따끈하다/Adjective,1,0,1,0.0,1.1106915165381966e-05,1.0
45881,배한/Noun,1,0,1,0.0,1.1106915165381966e-05,1.0
45882,시시대다/Verb,1,0,1,0.0,1.1106915165381966e-05,1.0
45883,이지유/Noun,1,0,1,0.0,1.1106915165381966e-05,1.0
45884,슝/Noun,1,0,1,0.0,1.1106915165381966e-05,1.0
45885,밖에못봤지만/Foreign,1,1,0,1.1115310228308472e-05,0.0,1.0
45886,低/Foreign,1,0,1,0.0,1.1106915165381966e-05,1.0
45887,됐슴/Noun,1,0,1,0.0,1.1106915165381966e-05,1.0
45888,거러췌/Noun,1,1,0,1.1115310228308472e-05,0.0,1.0
45889,뭐보징/Noun,1,1,0,1.1115310228308472e-05,0.0,1.0
45890,꼬물거리/Noun,1,1,0,1.1115310228308472e-05,0.0,1.0
45891,스위밍/Noun,1,1,0,1.1115310228308472e-05,0.0,1.0
45892,fiction/Alpha,1,1,0,1.1115310228308472e-05,0.0,1.0
45893,Stranger/Alpha,1,1,0,1.1115310228308472e-05,0.0,1.0
45894,dna/Alpha,1,0,1,0.0,1.1106915165381966e-05,1.0
45895,개꽝/Noun,1,0,1,0.0,1.1106915165381966e-05,1.0
45896,페닝/Noun,1,0,1,0.0,1.1106915165381966e-05,1.0
45897,♂/Foreign,1,1,0,1.1115310228308472e-05,0.0,1.0
45898,^--^/Punctuation,1,0,1,0.0,1.1106915165381966e-05,1.0
45899,?@non/ScreenName,1,1,0,1.1115310228308472e-05,0.0,1.0
45900,재빠르다/Adjective,1,1,0,1.1115310228308472e-05,0.0,1.0
45901,훨덜/Noun,1,1,0,1.1115310228308472e-05,0.0,1.0
45902,짤렸겠/Noun,1,0,1,0.0,1.1106915165381966e-05,1.0
45903,에선가/Foreign,1,1,0,1.1115310228308472e-05,0.0,1.0
45904,헣/Noun,1,0,1,0.0,1.1106915165381966e-05,1.0
45905,헣어허어헣헣/Noun,1,0,1,0.0,1.1106915165381966e-05,1.0
45906,쑈쇼쑈/Noun,1,0,1,0.0,1.1106915165381966e-05,1.0
45907,FOX/Alpha,1,0,1,0.0,1.1106915165381966e-05,1.0
45908,오해해/Noun,1,0,1,0.0,1.1106915165381966e-05,1.0
45909,새엄/Noun,1,0,1,0.0,1.1106915165381966e-05,1.0
45910,예금/Noun,1,1,0,1.1115310228308472e-05,0.0,1.0
45911,횡령죄/Noun,1,1,0,1.1115310228308472e-05,0.0,1.0
45912,잭키/Noun,1,1,0,1.1115310228308472e-05,0.0,1.0
45913,스터디/Noun,1,1,0,1.1115310228308472e-05,0.0,1.0
45914,(?/Punctuation,1,1,0,1.1115310228308472e-05,0.0,1.0
45915,비즈/Noun,1,1,0,1.1115310228308472e-05,0.0,1.0
45916,",..?/Punctuation",1,0,1,0.0,1.1106915165381966e-05,1.0
45917,1200달러/Number,1,0,1,0.0,1.1106915165381966e-05,1.0
45918,몇펀/Noun,1,0,1,0.0,1.1106915165381966e-05,1.0
45919,바둥거릴테/Noun,1,0,1,0.0,1.1106915165381966e-05,1.0
45920,Revolution/Alpha,1,0,1,0.0,1.1106915165381966e-05,1.0
45921,Dinosaur/Alpha,1,0,1,0.0,1.1106915165381966e-05,1.0
45922,월요병/Noun,1,1,0,1.1115310228308472e-05,0.0,1.0
45923,진서/Noun,1,0,1,0.0,1.1106915165381966e-05,1.0
45924,ㅋㅋㅋㅠ/KoreanParticle,1,0,1,0.0,1.1106915165381966e-05,1.0
45925,착산/Noun,1,1,0,1.1115310228308472e-05,0.0,1.0
45926,나후/Noun,1,1,0,1.1115310228308472e-05,0.0,1.0
45927,움속/Noun,1,1,0,1.1115310228308472e-05,0.0,1.0
45928,덕질/Noun,1,1,0,1.1115310228308472e-05,0.0,1.0
45929,5~7/Number,1,0,1,0.0,1.1106915165381966e-05,1.0
45930,정도밖에/Foreign,1,0,1,0.0,1.1106915165381966e-05,1.0
45931,서량/Noun,1,1,0,1.1115310228308472e-05,0.0,1.0
45932,암행어사/Noun,1,1,0,1.1115310228308472e-05,0.0,1.0
45933,권운/Noun,1,0,1,0.0,1.1106915165381966e-05,1.0
45934,누었는데/Noun,1,1,0,1.1115310228308472e-05,0.0,1.0
45935,누울/Noun,1,1,0,1.1115310228308472e-05,0.0,1.0
45936,엣찌/Noun,1,1,0,1.1115310228308472e-05,0.0,1.0
45937,한베/Noun,1,1,0,1.1115310228308472e-05,0.0,1.0
45938,가납/Noun,1,1,0,1.1115310228308472e-05,0.0,1.0
45939,유람/Noun,1,1,0,1.1115310228308472e-05,0.0,1.0
45940,장변/Noun,1,1,0,1.1115310228308472e-05,0.0,1.0
45941,스크는그닥/Noun,1,0,1,0.0,1.1106915165381966e-05,1.0
45942,힙자/Noun,1,0,1,0.0,1.1106915165381966e-05,1.0
45943,문지기/Noun,1,0,1,0.0,1.1106915165381966e-05,1.0
45944,까까머리/Noun,1,0,1,0.0,1.1106915165381966e-05,1.0
45945,클라나드/Noun,1,1,0,1.1115310228308472e-05,0.0,1.0
45946,굿굿쟁/Noun,1,1,0,1.1115310228308472e-05,0.0,1.0
45947,옴티머/Noun,1,0,1,0.0,1.1106915165381966e-05,1.0
45948,......;;;;;;;;;;;;;;;;/Punctuation,1,0,1,0.0,1.1106915165381966e-05,1.0
45949,매실/Noun,1,0,1,0.0,1.1106915165381966e-05,1.0
45950,앜앜/Noun,1,0,1,0.0,1.1106915165381966e-05,1.0
45951,요안/Noun,1,1,0,1.1115310228308472e-05,0.0,1.0
45952,불법복제/Noun,1,0,1,0.0,1.1106915165381966e-05,1.0
45953,베네치아/Noun,1,0,1,0.0,1.1106915165381966e-05,1.0
45954,생식기관/Noun,1,1,0,1.1115310228308472e-05,0.0,1.0
45955,막일/Noun,1,0,1,0.0,1.1106915165381966e-05,1.0
45956,....???>.</Punctuation,1,0,1,0.0,1.1106915165381966e-05,1.0
45957,찌질/Noun,1,0,1,0.0,1.1106915165381966e-05,1.0
45958,똘레랑스/Noun,1,0,1,0.0,1.1106915165381966e-05,1.0
45959,컬쭊/Noun,1,0,1,0.0,1.1106915165381966e-05,1.0
45960,VCR/Alpha,1,1,0,1.1115310228308472e-05,0.0,1.0
45961,~~~~~~~~~~~~~~~~~~~~~~~~``/Punctuation,1,0,1,0.0,1.1106915165381966e-05,1.0
45962,전영화인데도/Foreign,1,1,0,1.1115310228308472e-05,0.0,1.0
45963,ㄷㄹㄱㅂ/KoreanParticle,1,1,0,1.1115310228308472e-05,0.0,1.0
45964,ㄴㅅㅈㅅ/KoreanParticle,1,1,0,1.1115310228308472e-05,0.0,1.0
45965,밤낮/Noun,1,0,1,0.0,1.1106915165381966e-05,1.0
45966,tb/Alpha,1,1,0,1.1115310228308472e-05,0.0,1.0
45967,폭찹/Noun,1,1,0,1.1115310228308472e-05,0.0,1.0
45968,케서린/Noun,1,0,1,0.0,1.1106915165381966e-05,1.0
45969,노빠/Noun,1,0,1,0.0,1.1106915165381966e-05,1.0
45970,샤바/Noun,1,0,1,0.0,1.1106915165381966e-05,1.0
45971,알렝/Noun,1,0,1,0.0,1.1106915165381966e-05,1.0
45972,꼭뽜/Noun,1,1,0,1.1115310228308472e-05,0.0,1.0
45973,안움/Noun,1,1,0,1.1115310228308472e-05,0.0,1.0
45974,ㅋㅑㅡ/KoreanParticle,1,1,0,1.1115310228308472e-05,0.0,1.0
45975,팝음악/Noun,1,1,0,1.1115310228308472e-05,0.0,1.0
45976,이뿌니/Noun,1,1,0,1.1115310228308472e-05,0.0,1.0
45977,밤비노/Noun,1,0,1,0.0,1.1106915165381966e-05,1.0
45978,대또하나의/Foreign,1,1,0,1.1115310228308472e-05,0.0,1.0
45979,엮지/Noun,1,1,0,1.1115310228308472e-05,0.0,1.0
45980,텃밭/Noun,1,1,0,1.1115310228308472e-05,0.0,1.0
45981,왅전/Noun,1,1,0,1.1115310228308472e-05,0.0,1.0
45982,덴마크인/Noun,1,1,0,1.1115310228308472e-05,0.0,1.0
45983,군발/Noun,1,0,1,0.0,1.1106915165381966e-05,1.0
45984,꾸벅/Noun,1,1,0,1.1115310228308472e-05,0.0,1.0
45985,",;,/Punctuation",1,0,1,0.0,1.1106915165381966e-05,1.0
45986,논힐/Noun,1,1,0,1.1115310228308472e-05,0.0,1.0
45987,ㄱㄴㄴㄴ/KoreanParticle,1,0,1,0.0,1.1106915165381966e-05,1.0
45988,짯는/Noun,1,0,1,0.0,1.1106915165381966e-05,1.0
45989,복달/Noun,1,0,1,0.0,1.1106915165381966e-05,1.0
45990,직소/Noun,1,0,1,0.0,1.1106915165381966e-05,1.0
45991,심리학자/Noun,1,0,1,0.0,1.1106915165381966e-05,1.0
45992,람보르기니/Noun,1,0,1,0.0,1.1106915165381966e-05,1.0
45993,재판정/Noun,1,1,0,1.1115310228308472e-05,0.0,1.0
45994,명철하다/Adjective,1,1,0,1.1115310228308472e-05,0.0,1.0
45995,장부/Noun,1,1,0,1.1115310228308472e-05,0.0,1.0
45996,널렸다/Noun,1,1,0,1.1115310228308472e-05,0.0,1.0
45997,영화편집자/Noun,1,0,1,0.0,1.1106915165381966e-05,1.0
45998,~!!!>_///Punctuation,1,1,0,1.1115310228308472e-05,0.0,1.0
45999,중달/Noun,1,1,0,1.1115310228308472e-05,0.0,1.0
46000,이오나/Noun,1,0,1,0.0,1.1106915165381966e-05,1.0
46001,thjgfj/Alpha,1,0,1,0.0,1.1106915165381966e-05,1.0
46002,사석/Noun,1,0,1,0.0,1.1106915165381966e-05,1.0
46003,쩌노/Noun,1,0,1,0.0,1.1106915165381966e-05,1.0
46004,nell/Alpha,1,1,0,1.1115310228308472e-05,0.0,1.0
46005,패컬티/Noun,1,1,0,1.1115310228308472e-05,0.0,1.0
46006,오블리비언/Noun,1,1,0,1.1115310228308472e-05,0.0,1.0
46007,구제불/Noun,1,0,1,0.0,1.1106915165381966e-05,1.0
46008,머뭇머뭇/Adverb,1,0,1,0.0,1.1106915165381966e-05,1.0
46009,갈까말까/Adverb,1,0,1,0.0,1.1106915165381966e-05,1.0
46010,휘둘린/Noun,1,0,1,0.0,1.1106915165381966e-05,1.0
46011,허수경/Noun,1,1,0,1.1115310228308472e-05,0.0,1.0
46012,답글/Noun,1,1,0,1.1115310228308472e-05,0.0,1.0
46013,로즈버드/Noun,1,1,0,1.1115310228308472e-05,0.0,1.0
46014,김시덕/Noun,1,0,1,0.0,1.1106915165381966e-05,1.0
46015,interesting/Alpha,1,1,0,1.1115310228308472e-05,0.0,1.0
46016,피넬/Noun,1,0,1,0.0,1.1106915165381966e-05,1.0
46017,책도둑/Noun,1,0,1,0.0,1.1106915165381966e-05,1.0
46018,roll/Alpha,1,1,0,1.1115310228308472e-05,0.0,1.0
46019,Etude/Alpha,1,1,0,1.1115310228308472e-05,0.0,1.0
46020,청구해야할듯/Foreign,1,0,1,0.0,1.1106915165381966e-05,1.0
46021,ta/Alpha,1,0,1,0.0,1.1106915165381966e-05,1.0
46022,부턱/Noun,1,0,1,0.0,1.1106915165381966e-05,1.0
46023,orz/Alpha,1,1,0,1.1115310228308472e-05,0.0,1.0
46024,밣는/Noun,1,1,0,1.1115310228308472e-05,0.0,1.0
46025,동냥/Noun,1,0,1,0.0,1.1106915165381966e-05,1.0
46026,슴매/Noun,1,1,0,1.1115310228308472e-05,0.0,1.0
46027,...~.~/Punctuation,1,0,1,0.0,1.1106915165381966e-05,1.0
46028,+)/Punctuation,1,1,0,1.1115310228308472e-05,0.0,1.0
46029,용으로/Foreign,1,1,0,1.1115310228308472e-05,0.0,1.0
46030,떨렷어/Noun,1,1,0,1.1115310228308472e-05,0.0,1.0
46031,뚜또/Noun,1,1,0,1.1115310228308472e-05,0.0,1.0
46032,촤화연/Noun,1,1,0,1.1115310228308472e-05,0.0,1.0
46033,이어붙힌/Noun,1,0,1,0.0,1.1106915165381966e-05,1.0
46034,1956년/Number,1,1,0,1.1115310228308472e-05,0.0,1.0
46035,소수집단/Noun,1,1,0,1.1115310228308472e-05,0.0,1.0
46036,성전환자/Noun,1,1,0,1.1115310228308472e-05,0.0,1.0
46037,스겔/Noun,1,1,0,1.1115310228308472e-05,0.0,1.0
46038,짜리가/Foreign,1,1,0,1.1115310228308472e-05,0.0,1.0
46039,볼수잇슴/Noun,1,1,0,1.1115310228308472e-05,0.0,1.0
46040,쫗/Noun,1,0,1,0.0,1.1106915165381966e-05,1.0
46041,인싱/Noun,1,1,0,1.1115310228308472e-05,0.0,1.0
46042,박준하/Noun,1,1,0,1.1115310228308472e-05,0.0,1.0
46043,석호필/Noun,1,0,1,0.0,1.1106915165381966e-05,1.0
46044,우짤꼬/Noun,1,1,0,1.1115310228308472e-05,0.0,1.0
46045,거시/Noun,1,1,0,1.1115310228308472e-05,0.0,1.0
46046,똠양꿍/Noun,1,0,1,0.0,1.1106915165381966e-05,1.0
46047,빅사/Noun,1,0,1,0.0,1.1106915165381966e-05,1.0
46048,별루일걱타/Noun,1,1,0,1.1115310228308472e-05,0.0,1.0
46049,윤주상/Noun,1,1,0,1.1115310228308472e-05,0.0,1.0
46050,앳된모습/Noun,1,0,1,0.0,1.1106915165381966e-05,1.0
46051,프랜치/Noun,1,0,1,0.0,1.1106915165381966e-05,1.0
46052,//?/Punctuation,1,1,0,1.1115310228308472e-05,0.0,1.0
46053,쳔녀유혼/Noun,1,0,1,0.0,1.1106915165381966e-05,1.0
46054,하늘아래/Noun,1,1,0,1.1115310228308472e-05,0.0,1.0
46055,부골/Noun,1,0,1,0.0,1.1106915165381966e-05,1.0
46056,쇅히/Noun,1,0,1,0.0,1.1106915165381966e-05,1.0
46057,이경선/Noun,1,0,1,0.0,1.1106915165381966e-05,1.0
46058,강유리/Noun,1,0,1,0.0,1.1106915165381966e-05,1.0
46059,작성중/Noun,1,0,1,0.0,1.1106915165381966e-05,1.0
46060,초파리/Noun,1,0,1,0.0,1.1106915165381966e-05,1.0
46061,홍문연/Noun,1,0,1,0.0,1.1106915165381966e-05,1.0
46062,뤼/Noun,1,1,0,1.1115310228308472e-05,0.0,1.0
46063,/////////////////////Punctuation,1,0,1,0.0,1.1106915165381966e-05,1.0
46064,''/////Punctuation,1,0,1,0.0,1.1106915165381966e-05,1.0
46065,또끝/Noun,1,0,1,0.0,1.1106915165381966e-05,1.0
46066,햔/Noun,1,1,0,1.1115310228308472e-05,0.0,1.0
46067,의연/Noun,1,1,0,1.1115310228308472e-05,0.0,1.0
46068,노교/Noun,1,1,0,1.1115310228308472e-05,0.0,1.0
46069,우첸롄/Noun,1,1,0,1.1115310228308472e-05,0.0,1.0
46070,회향/Noun,1,1,0,1.1115310228308472e-05,0.0,1.0
46071,두번봣음/Noun,1,1,0,1.1115310228308472e-05,0.0,1.0
46072,마드/Noun,1,0,1,0.0,1.1106915165381966e-05,1.0
46073,장원준/Noun,1,0,1,0.0,1.1106915165381966e-05,1.0
46074,피장파장/Noun,1,0,1,0.0,1.1106915165381966e-05,1.0
46075,이상을소비하고/Foreign,1,0,1,0.0,1.1106915165381966e-05,1.0
46076,재룡/Noun,1,1,0,1.1115310228308472e-05,0.0,1.0
46077,모컨/Noun,1,0,1,0.0,1.1106915165381966e-05,1.0
46078,류더/Noun,1,0,1,0.0,1.1106915165381966e-05,1.0
46079,22초/Number,1,1,0,1.1115310228308472e-05,0.0,1.0
46080,에보고/Foreign,1,1,0,1.1115310228308472e-05,0.0,1.0
46081,비핸덜/Noun,1,1,0,1.1115310228308472e-05,0.0,1.0
46082,퍼기/Noun,1,0,1,0.0,1.1106915165381966e-05,1.0
46083,앨버커키/Noun,1,1,0,1.1115310228308472e-05,0.0,1.0
46084,황정순/Noun,1,1,0,1.1115310228308472e-05,0.0,1.0
46085,차턴/Noun,1,0,1,0.0,1.1106915165381966e-05,1.0
46086,치키다/Verb,1,0,1,0.0,1.1106915165381966e-05,1.0
46087,자우림/Noun,1,0,1,0.0,1.1106915165381966e-05,1.0
46088,잼때/Noun,1,1,0,1.1115310228308472e-05,0.0,1.0
46089,우육/Noun,1,0,1,0.0,1.1106915165381966e-05,1.0
46090,Phantastic/Alpha,1,1,0,1.1115310228308472e-05,0.0,1.0
46091,opera/Alpha,1,1,0,1.1115310228308472e-05,0.0,1.0
46092,Phantom/Alpha,1,1,0,1.1115310228308472e-05,0.0,1.0
46093,쥐떼/Noun,1,0,1,0.0,1.1106915165381966e-05,1.0
46094,깃대/Noun,1,0,1,0.0,1.1106915165381966e-05,1.0
46095,세번째/Foreign,1,1,0,1.1115310228308472e-05,0.0,1.0
46096,beatles/Alpha,1,1,0,1.1115310228308472e-05,0.0,1.0
46097,퐁네프연/Noun,1,1,0,1.1115310228308472e-05,0.0,1.0
46098,復讐無情/Foreign,1,0,1,0.0,1.1106915165381966e-05,1.0
46099,방파/Noun,1,0,1,0.0,1.1106915165381966e-05,1.0
46100,녹림/Noun,1,0,1,0.0,1.1106915165381966e-05,1.0
46101,고고학/Noun,1,0,1,0.0,1.1106915165381966e-05,1.0
46102,江湖/Foreign,1,0,1,0.0,1.1106915165381966e-05,1.0
46103,綠林/Foreign,1,0,1,0.0,1.1106915165381966e-05,1.0
46104,져스/Noun,1,1,0,1.1115310228308472e-05,0.0,1.0
46105,줄겁/Noun,1,0,1,0.0,1.1106915165381966e-05,1.0
46106,.-.-/Punctuation,1,0,1,0.0,1.1106915165381966e-05,1.0
46107,뀨뀨/Noun,1,0,1,0.0,1.1106915165381966e-05,1.0
46108,낚았/Noun,1,0,1,0.0,1.1106915165381966e-05,1.0
46109,.....................???????????/Punctuation,1,0,1,0.0,1.1106915165381966e-05,1.0
46110,형명/Noun,1,1,0,1.1115310228308472e-05,0.0,1.0
46111,ㅂㅋㅋㅋ/KoreanParticle,1,0,1,0.0,1.1106915165381966e-05,1.0
46112,옆모습/Noun,1,1,0,1.1115310228308472e-05,0.0,1.0
46113,탱크탑/Noun,1,0,1,0.0,1.1106915165381966e-05,1.0
46114,파스빈더/Noun,1,1,0,1.1115310228308472e-05,0.0,1.0
46115,영혜/Noun,1,0,1,0.0,1.1106915165381966e-05,1.0
46116,낼일/Noun,1,0,1,0.0,1.1106915165381966e-05,1.0
46117,가열/Noun,1,0,1,0.0,1.1106915165381966e-05,1.0
46118,더열/Noun,1,0,1,0.0,1.1106915165381966e-05,1.0
46119,12345678/Number,1,1,0,1.1115310228308472e-05,0.0,1.0
46120,애니원/Noun,1,0,1,0.0,1.1106915165381966e-05,1.0
46121,실내/Noun,1,1,0,1.1115310228308472e-05,0.0,1.0
46122,반만에/Foreign,1,1,0,1.1115310228308472e-05,0.0,1.0
46123,마춌/Noun,1,0,1,0.0,1.1106915165381966e-05,1.0
46124,뚜르겐/Noun,1,0,1,0.0,1.1106915165381966e-05,1.0
46125,아딸/Noun,1,0,1,0.0,1.1106915165381966e-05,1.0
46126,할로겐/Noun,1,0,1,0.0,1.1106915165381966e-05,1.0
46127,ㅋㅋㅋㅌㅋㅋㅋㅌㅋㅋㅋㅌㅋㅋ/KoreanParticle,1,0,1,0.0,1.1106915165381966e-05,1.0
46128,택한것/Noun,1,0,1,0.0,1.1106915165381966e-05,1.0
46129,소도시/Noun,1,1,0,1.1115310228308472e-05,0.0,1.0
46130,ㅠㅗ/KoreanParticle,1,1,0,1.1115310228308472e-05,0.0,1.0
46131,!!!{>-<}/Punctuation,1,1,0,1.1115310228308472e-05,0.0,1.0
46132,벌컥거리다/Verb,1,1,0,1.1115310228308472e-05,0.0,1.0
46133,점줄랬는데/Noun,1,0,1,0.0,1.1106915165381966e-05,1.0
46134,빠빠라삐/Noun,1,1,0,1.1115310228308472e-05,0.0,1.0
46135,USB/Alpha,1,1,0,1.1115310228308472e-05,0.0,1.0
46136,홧팅홧팅/Noun,1,1,0,1.1115310228308472e-05,0.0,1.0
46137,르키/Noun,1,1,0,1.1115310228308472e-05,0.0,1.0
46138,드감/Noun,1,0,1,0.0,1.1106915165381966e-05,1.0
46139,근로기준법/Noun,1,1,0,1.1115310228308472e-05,0.0,1.0
46140,쿄쿄/Noun,1,1,0,1.1115310228308472e-05,0.0,1.0
46141,최태성/Noun,1,1,0,1.1115310228308472e-05,0.0,1.0
46142,뱃대지잘랏다/Noun,1,1,0,1.1115310228308472e-05,0.0,1.0
46143,식혜/Noun,1,1,0,1.1115310228308472e-05,0.0,1.0
46144,앱티드/Noun,1,0,1,0.0,1.1106915165381966e-05,1.0
46145,양일/Noun,1,1,0,1.1115310228308472e-05,0.0,1.0
46146,또나왓으/Noun,1,1,0,1.1115310228308472e-05,0.0,1.0
46147,동안영화본시간이/Foreign,1,0,1,0.0,1.1106915165381966e-05,1.0
46148,cms/Alpha,1,1,0,1.1115310228308472e-05,0.0,1.0
46149,아릅답네/Noun,1,1,0,1.1115310228308472e-05,0.0,1.0
46150,결단코/Adverb,1,0,1,0.0,1.1106915165381966e-05,1.0
46151,골든라즈베리/Noun,1,0,1,0.0,1.1106915165381966e-05,1.0
46152,토라/Noun,1,1,0,1.1115310228308472e-05,0.0,1.0
46153,카악퉷/Noun,1,0,1,0.0,1.1106915165381966e-05,1.0
46154,건이나/Foreign,1,0,1,0.0,1.1106915165381966e-05,1.0
46155,파색/Noun,1,0,1,0.0,1.1106915165381966e-05,1.0
46156,활영/Noun,1,0,1,0.0,1.1106915165381966e-05,1.0
46157,페널티/Noun,1,0,1,0.0,1.1106915165381966e-05,1.0
46158,^................/Punctuation,1,1,0,1.1115310228308472e-05,0.0,1.0
46159,느한방/Noun,1,0,1,0.0,1.1106915165381966e-05,1.0
46160,이포/Noun,1,1,0,1.1115310228308472e-05,0.0,1.0
46161,wja/Alpha,1,1,0,1.1115310228308472e-05,0.0,1.0
46162,연결안됫으/Noun,1,1,0,1.1115310228308472e-05,0.0,1.0
46163,몸둥아리/Noun,1,1,0,1.1115310228308472e-05,0.0,1.0
46164,record/Alpha,1,1,0,1.1115310228308472e-05,0.0,1.0
46165,새략된/Noun,1,0,1,0.0,1.1106915165381966e-05,1.0
46166,헌법재판소/Noun,1,0,1,0.0,1.1106915165381966e-05,1.0
46167,사라도령/Noun,1,1,0,1.1115310228308472e-05,0.0,1.0
46168,2020년/Number,1,1,0,1.1115310228308472e-05,0.0,1.0
46169,孝/Foreign,1,1,0,1.1115310228308472e-05,0.0,1.0
46170,크로스오버/Noun,1,1,0,1.1115310228308472e-05,0.0,1.0
46171,의시간이걸렸다네요/Foreign,1,1,0,1.1115310228308472e-05,0.0,1.0
46172,('')/Punctuation,1,1,0,1.1115310228308472e-05,0.0,1.0
46173,sibal/Alpha,1,1,0,1.1115310228308472e-05,0.0,1.0
46174,난돈/Noun,1,0,1,0.0,1.1106915165381966e-05,1.0
46175,어둑어둑하다/Adjective,1,0,1,0.0,1.1106915165381966e-05,1.0
46176,빠졌슴/Noun,1,0,1,0.0,1.1106915165381966e-05,1.0
46177,Emmanouella/Alpha,1,0,1,0.0,1.1106915165381966e-05,1.0
46178,Mavri/Alpha,1,0,1,0.0,1.1106915165381966e-05,1.0
46179,멍뮈동/Noun,1,0,1,0.0,1.1106915165381966e-05,1.0
46180,코코넛/Noun,1,1,0,1.1115310228308472e-05,0.0,1.0
46181,명암/Noun,1,1,0,1.1115310228308472e-05,0.0,1.0
46182,퍼팩트/Noun,1,1,0,1.1115310228308472e-05,0.0,1.0
46183,스비/Noun,1,1,0,1.1115310228308472e-05,0.0,1.0
46184,~~~~????/Punctuation,1,1,0,1.1115310228308472e-05,0.0,1.0
46185,4.56/Number,1,0,1,0.0,1.1106915165381966e-05,1.0
46186,문씨/Noun,1,0,1,0.0,1.1106915165381966e-05,1.0
46187,징끗하/Noun,1,1,0,1.1115310228308472e-05,0.0,1.0
46188,앞가림/Noun,1,0,1,0.0,1.1106915165381966e-05,1.0
46189,길쭉/Noun,1,1,0,1.1115310228308472e-05,0.0,1.0
46190,금불/Noun,1,1,0,1.1115310228308472e-05,0.0,1.0
46191,소자/Noun,1,0,1,0.0,1.1106915165381966e-05,1.0
46192,탐정소설/Noun,1,0,1,0.0,1.1106915165381966e-05,1.0
46193,셰/Noun,1,1,0,1.1115310228308472e-05,0.0,1.0
46194,장릉/Noun,1,0,1,0.0,1.1106915165381966e-05,1.0
46195,촏잉보/Noun,1,0,1,0.0,1.1106915165381966e-05,1.0
46196,순찰/Noun,1,0,1,0.0,1.1106915165381966e-05,1.0
46197,황황황/Noun,1,1,0,1.1115310228308472e-05,0.0,1.0
46198,도레미파솔라시도/Noun,1,1,0,1.1115310228308472e-05,0.0,1.0
46199,쌍안경/Noun,1,1,0,1.1115310228308472e-05,0.0,1.0
46200,맹한것/Noun,1,0,1,0.0,1.1106915165381966e-05,1.0
46201,와츠/Noun,1,1,0,1.1115310228308472e-05,0.0,1.0
46202,격자/Noun,1,1,0,1.1115310228308472e-05,0.0,1.0
46203,전원주택/Noun,1,1,0,1.1115310228308472e-05,0.0,1.0
46204,나블나블/Noun,1,0,1,0.0,1.1106915165381966e-05,1.0
46205,대영화답지않게/Foreign,1,1,0,1.1115310228308472e-05,0.0,1.0
46206,코와붕/Noun,1,1,0,1.1115310228308472e-05,0.0,1.0
46207,콜하스/Noun,1,0,1,0.0,1.1106915165381966e-05,1.0
46208,신종플루/Noun,1,1,0,1.1115310228308472e-05,0.0,1.0
46209,기간테스/Noun,1,1,0,1.1115310228308472e-05,0.0,1.0
46210,올림포스가디언/Noun,1,1,0,1.1115310228308472e-05,0.0,1.0
46211,간암/Noun,1,1,0,1.1115310228308472e-05,0.0,1.0
46212,삼수생/Noun,1,0,1,0.0,1.1106915165381966e-05,1.0
46213,디지겄다/Noun,1,0,1,0.0,1.1106915165381966e-05,1.0
46214,천주/Noun,1,0,1,0.0,1.1106915165381966e-05,1.0
46215,엎선다/Noun,1,0,1,0.0,1.1106915165381966e-05,1.0
46216,공룡쭈쮸/Noun,1,0,1,0.0,1.1106915165381966e-05,1.0
46217,탕탕/Adverb,1,1,0,1.1115310228308472e-05,0.0,1.0
46218,허석/Noun,1,0,1,0.0,1.1106915165381966e-05,1.0
46219,영장류/Noun,1,0,1,0.0,1.1106915165381966e-05,1.0
46220,풰도르/Noun,1,0,1,0.0,1.1106915165381966e-05,1.0
46221,솔선/Noun,1,0,1,0.0,1.1106915165381966e-05,1.0
46222,교통법규/Noun,1,0,1,0.0,1.1106915165381966e-05,1.0
46223,>><</Foreign,1,1,0,1.1115310228308472e-05,0.0,1.0
46224,나왓는디/Noun,1,1,0,1.1115310228308472e-05,0.0,1.0
46225,까졍/Noun,1,1,0,1.1115310228308472e-05,0.0,1.0
46226,흘낏보/Noun,1,1,0,1.1115310228308472e-05,0.0,1.0
46227,장완/Noun,1,0,1,0.0,1.1106915165381966e-05,1.0
46228,노오답/Noun,1,0,1,0.0,1.1106915165381966e-05,1.0
46229,귓때가리/Noun,1,0,1,0.0,1.1106915165381966e-05,1.0
46230,나옴/Foreign,1,0,1,0.0,1.1106915165381966e-05,1.0
46231,보수파/Noun,1,0,1,0.0,1.1106915165381966e-05,1.0
46232,이르키/Noun,1,1,0,1.1115310228308472e-05,0.0,1.0
46233,슬수있어/Noun,1,0,1,0.0,1.1106915165381966e-05,1.0
46234,핸드볼/Noun,1,1,0,1.1115310228308472e-05,0.0,1.0
46235,카악퉤/Noun,1,0,1,0.0,1.1106915165381966e-05,1.0
46236,영산강/Noun,1,0,1,0.0,1.1106915165381966e-05,1.0
46237,약골/Noun,1,0,1,0.0,1.1106915165381966e-05,1.0
46238,ㄹㅏ/KoreanParticle,1,0,1,0.0,1.1106915165381966e-05,1.0
46239,까나리/Noun,1,0,1,0.0,1.1106915165381966e-05,1.0
46240,아랬분말/Noun,1,1,0,1.1115310228308472e-05,0.0,1.0
46241,청조/Noun,1,1,0,1.1115310228308472e-05,0.0,1.0
46242,인베이전/Noun,1,0,1,0.0,1.1106915165381966e-05,1.0
46243,쌩쌩하다/Adjective,1,0,1,0.0,1.1106915165381966e-05,1.0
46244,한정수/Noun,1,1,0,1.1115310228308472e-05,0.0,1.0
46245,10시간/Number,1,1,0,1.1115310228308472e-05,0.0,1.0
46246,삿/Noun,1,1,0,1.1115310228308472e-05,0.0,1.0
46247,<=/Punctuation,1,0,1,0.0,1.1106915165381966e-05,1.0
46248,지엄/Noun,1,0,1,0.0,1.1106915165381966e-05,1.0
46249,카시야스/Noun,1,0,1,0.0,1.1106915165381966e-05,1.0
46250,산승/Noun,1,1,0,1.1115310228308472e-05,0.0,1.0
46251,탄허/Noun,1,1,0,1.1115310228308472e-05,0.0,1.0
46252,1914/Number,1,0,1,0.0,1.1106915165381966e-05,1.0
46253,아리사/Noun,1,0,1,0.0,1.1106915165381966e-05,1.0
46254,이정수/Noun,1,0,1,0.0,1.1106915165381966e-05,1.0
46255,뻭/Noun,1,1,0,1.1115310228308472e-05,0.0,1.0
46256,오스먼트/Noun,1,0,1,0.0,1.1106915165381966e-05,1.0
46257,새누리/Noun,1,1,0,1.1115310228308472e-05,0.0,1.0
46258,자쿠이/Noun,1,1,0,1.1115310228308472e-05,0.0,1.0
46259,zfz/Alpha,1,1,0,1.1115310228308472e-05,0.0,1.0
46260,truebsinnig/Alpha,1,1,0,1.1115310228308472e-05,0.0,1.0
46261,mich/Alpha,1,1,0,1.1115310228308472e-05,0.0,1.0
46262,fuehle/Alpha,1,1,0,1.1115310228308472e-05,0.0,1.0
46263,Ich/Alpha,1,1,0,1.1115310228308472e-05,0.0,1.0
46264,거쥐/Noun,1,0,1,0.0,1.1106915165381966e-05,1.0
46265,진력/Noun,1,0,1,0.0,1.1106915165381966e-05,1.0
46266,결영/Noun,1,1,0,1.1115310228308472e-05,0.0,1.0
46267,강호인/Noun,1,1,0,1.1115310228308472e-05,0.0,1.0
46268,풋티/Noun,1,0,1,0.0,1.1106915165381966e-05,1.0
46269,시간이동/Noun,1,0,1,0.0,1.1106915165381966e-05,1.0
46270,????.../Punctuation,1,0,1,0.0,1.1106915165381966e-05,1.0
46271,³￣/Foreign,1,1,0,1.1115310228308472e-05,0.0,1.0
46272,づ￣/Foreign,1,1,0,1.1115310228308472e-05,0.0,1.0
46273,뭐였드/Noun,1,0,1,0.0,1.1106915165381966e-05,1.0
46274,뭣허러/Noun,1,0,1,0.0,1.1106915165381966e-05,1.0
46275,밋저밋/Noun,1,1,0,1.1115310228308472e-05,0.0,1.0
46276,어딧/Noun,1,1,0,1.1115310228308472e-05,0.0,1.0
46277,저껀/Noun,1,1,0,1.1115310228308472e-05,0.0,1.0
46278,~(>_/Punctuation,1,0,1,0.0,1.1106915165381966e-05,1.0
46279,종흐/Noun,1,0,1,0.0,1.1106915165381966e-05,1.0
46280,무사시/Noun,1,1,0,1.1115310228308472e-05,0.0,1.0
46281,좃밥/Noun,1,0,1,0.0,1.1106915165381966e-05,1.0
46282,사겄/Noun,1,0,1,0.0,1.1106915165381966e-05,1.0
46283,이쁘닌깐/Noun,1,1,0,1.1115310228308472e-05,0.0,1.0
46284,께서는/Josa,1,0,1,0.0,1.1106915165381966e-05,1.0
46285,꾀볼/Noun,1,1,0,1.1115310228308472e-05,0.0,1.0
46286,억배/Noun,1,0,1,0.0,1.1106915165381966e-05,1.0
46287,>...(/Punctuation,1,0,1,0.0,1.1106915165381966e-05,1.0
46288,음청/Noun,1,1,0,1.1115310228308472e-05,0.0,1.0
46289,진법/Noun,1,0,1,0.0,1.1106915165381966e-05,1.0
46290,쉩/Noun,1,0,1,0.0,1.1106915165381966e-05,1.0
46291,밖애/Noun,1,0,1,0.0,1.1106915165381966e-05,1.0
46292,셀로브/Noun,1,0,1,0.0,1.1106915165381966e-05,1.0
46293,껒어/Noun,1,0,1,0.0,1.1106915165381966e-05,1.0
46294,맨하탄/Noun,1,1,0,1.1115310228308472e-05,0.0,1.0
46295,더멋/Noun,1,1,0,1.1115310228308472e-05,0.0,1.0
46296,tis/Alpha,1,1,0,1.1115310228308472e-05,0.0,1.0
46297,les/Alpha,1,1,0,1.1115310228308472e-05,0.0,1.0
46298,chez/Alpha,1,1,0,1.1115310228308472e-05,0.0,1.0
46299,Bienvenu/Alpha,1,1,0,1.1115310228308472e-05,0.0,1.0
46300,5.1/Number,1,0,1,0.0,1.1106915165381966e-05,1.0
46301,言葉/Foreign,1,1,0,1.1115310228308472e-05,0.0,1.0
46302,!@$!!##%$%@#/Punctuation,1,0,1,0.0,1.1106915165381966e-05,1.0
46303,크림반도/Noun,1,1,0,1.1115310228308472e-05,0.0,1.0
46304,타만반도가/Foreign,1,1,0,1.1115310228308472e-05,0.0,1.0
46305,1943년/Number,1,1,0,1.1115310228308472e-05,0.0,1.0
46306,Garner/Alpha,1,0,1,0.0,1.1106915165381966e-05,1.0
46307,승구/Noun,1,0,1,0.0,1.1106915165381966e-05,1.0
46308,모르곘/Noun,1,1,0,1.1115310228308472e-05,0.0,1.0
46309,점심시간/Noun,1,1,0,1.1115310228308472e-05,0.0,1.0
46310,ㅜㅅㅜ/KoreanParticle,1,1,0,1.1115310228308472e-05,0.0,1.0
46311,틴데/Noun,1,0,1,0.0,1.1106915165381966e-05,1.0
46312,무장해제/Noun,1,0,1,0.0,1.1106915165381966e-05,1.0
46313,구런/Noun,1,0,1,0.0,1.1106915165381966e-05,1.0
46314,Muse/Alpha,1,0,1,0.0,1.1106915165381966e-05,1.0
46315,캭/Noun,1,1,0,1.1115310228308472e-05,0.0,1.0
46316,2019/Number,1,1,0,1.1115310228308472e-05,0.0,1.0
46317,이지난현재다시한번보는데/Foreign,1,1,0,1.1115310228308472e-05,0.0,1.0
46318,읊을때/Noun,1,1,0,1.1115310228308472e-05,0.0,1.0
46319,하우웰/Noun,1,1,0,1.1115310228308472e-05,0.0,1.0
46320,중추훙/Noun,1,1,0,1.1115310228308472e-05,0.0,1.0
46321,3/1/Number,1,0,1,0.0,1.1106915165381966e-05,1.0
46322,'*/Punctuation,1,1,0,1.1115310228308472e-05,0.0,1.0
46323,*'/Punctuation,1,1,0,1.1115310228308472e-05,0.0,1.0
46324,내밌내/Noun,1,1,0,1.1115310228308472e-05,0.0,1.0
46325,호해/Noun,1,1,0,1.1115310228308472e-05,0.0,1.0
46326,통함/Noun,1,0,1,0.0,1.1106915165381966e-05,1.0
46327,클리프행어/Noun,1,1,0,1.1115310228308472e-05,0.0,1.0
46328,습진/Noun,1,1,0,1.1115310228308472e-05,0.0,1.0
46329,스튜어디스/Noun,1,1,0,1.1115310228308472e-05,0.0,1.0
46330,정승환/Noun,1,1,0,1.1115310228308472e-05,0.0,1.0
46331,넢아짐/Noun,1,1,0,1.1115310228308472e-05,0.0,1.0
46332,타일/Noun,1,1,0,1.1115310228308472e-05,0.0,1.0
46333,내스/Noun,1,1,0,1.1115310228308472e-05,0.0,1.0
46334,peni/Alpha,1,0,1,0.0,1.1106915165381966e-05,1.0
46335,Girls/Alpha,1,0,1,0.0,1.1106915165381966e-05,1.0
46336,보슬비/Noun,1,0,1,0.0,1.1106915165381966e-05,1.0
46337,행시/Noun,1,0,1,0.0,1.1106915165381966e-05,1.0
46338,대홍콩영화가낫다/Foreign,1,0,1,0.0,1.1106915165381966e-05,1.0
46339,포칸/Noun,1,0,1,0.0,1.1106915165381966e-05,1.0
46340,액면/Noun,1,0,1,0.0,1.1106915165381966e-05,1.0
46341,노이로제/Noun,1,0,1,0.0,1.1106915165381966e-05,1.0
46342,프폭/Noun,1,0,1,0.0,1.1106915165381966e-05,1.0
46343,도더됀영화가되어버렸네요/Foreign,1,1,0,1.1115310228308472e-05,0.0,1.0
46344,좀촌/Noun,1,1,0,1.1115310228308472e-05,0.0,1.0
46345,2.35/Number,1,1,0,1.1115310228308472e-05,0.0,1.0
46346,1.85/Number,1,1,0,1.1115310228308472e-05,0.0,1.0
46347,알굴/Noun,1,1,0,1.1115310228308472e-05,0.0,1.0
46348,로댕/Noun,1,1,0,1.1115310228308472e-05,0.0,1.0
46349,WoW/Alpha,1,1,0,1.1115310228308472e-05,0.0,1.0
46350,경제체제/Noun,1,1,0,1.1115310228308472e-05,0.0,1.0
46351,$2/Number,1,0,1,0.0,1.1106915165381966e-05,1.0
46352,@$#/Foreign,1,0,1,0.0,1.1106915165381966e-05,1.0
46353,풀라/Noun,1,1,0,1.1115310228308472e-05,0.0,1.0
46354,신소재/Noun,1,1,0,1.1115310228308472e-05,0.0,1.0
46355,지름/Noun,1,1,0,1.1115310228308472e-05,0.0,1.0
46356,켄유퍽/Noun,1,0,1,0.0,1.1106915165381966e-05,1.0
46357,메메/Noun,1,1,0,1.1115310228308472e-05,0.0,1.0
46358,매매/Noun,1,1,0,1.1115310228308472e-05,0.0,1.0
46359,밌드/Noun,1,1,0,1.1115310228308472e-05,0.0,1.0
46360,두둑하다/Adjective,1,0,1,0.0,1.1106915165381966e-05,1.0
46361,친햐짐/Noun,1,0,1,0.0,1.1106915165381966e-05,1.0
46362,과롭히던/Noun,1,0,1,0.0,1.1106915165381966e-05,1.0
46363,부터지금까지본방사수했는데/Foreign,1,1,0,1.1115310228308472e-05,0.0,1.0
46364,대공/Noun,1,1,0,1.1115310228308472e-05,0.0,1.0
46365,땡중왈/Noun,1,1,0,1.1115310228308472e-05,0.0,1.0
46366,락커/Noun,1,1,0,1.1115310228308472e-05,0.0,1.0
46367,오버더레인보우/Noun,1,0,1,0.0,1.1106915165381966e-05,1.0
46368,김필/Noun,1,0,1,0.0,1.1106915165381966e-05,1.0
46369,박보람/Noun,1,0,1,0.0,1.1106915165381966e-05,1.0
46370,고수현/Noun,1,1,0,1.1115310228308472e-05,0.0,1.0
46371,48초/Number,1,0,1,0.0,1.1106915165381966e-05,1.0
46372,1:43/Number,1,0,1,0.0,1.1106915165381966e-05,1.0
46373,봉태/Noun,1,0,1,0.0,1.1106915165381966e-05,1.0
46374,탕기/Noun,1,1,0,1.1115310228308472e-05,0.0,1.0
46375,메티컬탑팀/Noun,1,1,0,1.1115310228308472e-05,0.0,1.0
46376,사진사/Noun,1,1,0,1.1115310228308472e-05,0.0,1.0
46377,범번/Noun,1,1,0,1.1115310228308472e-05,0.0,1.0
46378,훨났/Noun,1,0,1,0.0,1.1106915165381966e-05,1.0
46379,무림여대생/Noun,1,0,1,0.0,1.1106915165381966e-05,1.0
46380,훼훼훼/Noun,1,0,1,0.0,1.1106915165381966e-05,1.0
46381,훈의초/Noun,1,1,0,1.1115310228308472e-05,0.0,1.0
46382,봉양/Noun,1,0,1,0.0,1.1106915165381966e-05,1.0
46383,호재/Noun,1,0,1,0.0,1.1106915165381966e-05,1.0
46384,창펑쇠/Noun,1,0,1,0.0,1.1106915165381966e-05,1.0
46385,카벙클/Noun,1,1,0,1.1115310228308472e-05,0.0,1.0
46386,누룽지/Noun,1,0,1,0.0,1.1106915165381966e-05,1.0
46387,수욜날/Noun,1,1,0,1.1115310228308472e-05,0.0,1.0
46388,배다리/Noun,1,1,0,1.1115310228308472e-05,0.0,1.0
46389,수원화성/Noun,1,1,0,1.1115310228308472e-05,0.0,1.0
46390,에어쇼/Noun,1,1,0,1.1115310228308472e-05,0.0,1.0
46391,룩앳미/Noun,1,1,0,1.1115310228308472e-05,0.0,1.0
46392,">,/Punctuation",1,1,0,1.1115310228308472e-05,0.0,1.0
46393,ㅇㅇㄴㄴ/KoreanParticle,1,0,1,0.0,1.1106915165381966e-05,1.0
46394,빈둥/Noun,1,0,1,0.0,1.1106915165381966e-05,1.0
46395,노덤/Noun,1,1,0,1.1115310228308472e-05,0.0,1.0
46396,수력/Noun,1,1,0,1.1115310228308472e-05,0.0,1.0
46397,작의/Foreign,1,1,0,1.1115310228308472e-05,0.0,1.0
46398,80.90년/Number,1,1,0,1.1115310228308472e-05,0.0,1.0
46399,ㅁㅎ/KoreanParticle,1,0,1,0.0,1.1106915165381966e-05,1.0
46400,",^/Punctuation",1,1,0,1.1115310228308472e-05,0.0,1.0
46401,해수욕장/Noun,1,1,0,1.1115310228308472e-05,0.0,1.0
46402,대락/Noun,1,0,1,0.0,1.1106915165381966e-05,1.0
46403,햇담/Noun,1,1,0,1.1115310228308472e-05,0.0,1.0
46404,사궈/Noun,1,0,1,0.0,1.1106915165381966e-05,1.0
46405,하숙/Noun,1,0,1,0.0,1.1106915165381966e-05,1.0
46406,들떳/Noun,1,0,1,0.0,1.1106915165381966e-05,1.0
46407,정만호/Noun,1,0,1,0.0,1.1106915165381966e-05,1.0
46408,구석기/Noun,1,0,1,0.0,1.1106915165381966e-05,1.0
46409,달관/Noun,1,1,0,1.1115310228308472e-05,0.0,1.0
46410,교수대/Noun,1,1,0,1.1115310228308472e-05,0.0,1.0
46411,배렷음/Noun,1,0,1,0.0,1.1106915165381966e-05,1.0
46412,룬데/Noun,1,0,1,0.0,1.1106915165381966e-05,1.0
46413,About/Alpha,1,1,0,1.1115310228308472e-05,0.0,1.0
46414,신위/Noun,1,0,1,0.0,1.1106915165381966e-05,1.0
46415,오중/Noun,1,1,0,1.1115310228308472e-05,0.0,1.0
46416,스피어/Noun,1,0,1,0.0,1.1106915165381966e-05,1.0
46417,머틀/Noun,1,1,0,1.1115310228308472e-05,0.0,1.0
46418,Cooper/Alpha,1,0,1,0.0,1.1106915165381966e-05,1.0
46419,Bradley/Alpha,1,0,1,0.0,1.1106915165381966e-05,1.0
46420,valentine/Alpha,1,0,1,0.0,1.1106915165381966e-05,1.0
46421,Eve/Alpha,1,0,1,0.0,1.1106915165381966e-05,1.0
46422,Years/Alpha,1,0,1,0.0,1.1106915165381966e-05,1.0
46423,흑암/Noun,1,1,0,1.1115310228308472e-05,0.0,1.0
46424,발레리노/Noun,1,1,0,1.1115310228308472e-05,0.0,1.0
46425,ᆞ/Foreign,1,1,0,1.1115310228308472e-05,0.0,1.0
46426,슈타지/Noun,1,0,1,0.0,1.1106915165381966e-05,1.0
46427,비밀경찰/Noun,1,0,1,0.0,1.1106915165381966e-05,1.0
46428,"..,,,,,,,/Punctuation",1,1,0,1.1115310228308472e-05,0.0,1.0
46429,썪으셨/Noun,1,1,0,1.1115310228308472e-05,0.0,1.0
46430,꽈도넘꼬/Noun,1,0,1,0.0,1.1106915165381966e-05,1.0
46431,Melanie/Alpha,1,1,0,1.1115310228308472e-05,0.0,1.0
46432,버기카/Noun,1,0,1,0.0,1.1106915165381966e-05,1.0
46433,루리웹/Noun,1,1,0,1.1115310228308472e-05,0.0,1.0
46434,인마/Exclamation,1,0,1,0.0,1.1106915165381966e-05,1.0
46435,힌건/Noun,1,0,1,0.0,1.1106915165381966e-05,1.0
46436,관광버스/Noun,1,0,1,0.0,1.1106915165381966e-05,1.0
46437,퀼티/Noun,1,0,1,0.0,1.1106915165381966e-05,1.0
46438,밀치다/Verb,1,1,0,1.1115310228308472e-05,0.0,1.0
46439,현격/Noun,1,0,1,0.0,1.1106915165381966e-05,1.0
46440,문익점/Noun,1,0,1,0.0,1.1106915165381966e-05,1.0
46441,이혜리/Noun,1,1,0,1.1115310228308472e-05,0.0,1.0
46442,씬사이/Noun,1,0,1,0.0,1.1106915165381966e-05,1.0
46443,주기로/Foreign,1,1,0,1.1115310228308472e-05,0.0,1.0
46444,기밀/Noun,1,0,1,0.0,1.1106915165381966e-05,1.0
46445,케산/Noun,1,0,1,0.0,1.1106915165381966e-05,1.0
46446,한거자/Noun,1,1,0,1.1115310228308472e-05,0.0,1.0
46447,베케/Noun,1,0,1,0.0,1.1106915165381966e-05,1.0
46448,케이타/Noun,1,1,0,1.1115310228308472e-05,0.0,1.0
46449,효승/Noun,1,1,0,1.1115310228308472e-05,0.0,1.0
46450,뜸금포/Noun,1,0,1,0.0,1.1106915165381966e-05,1.0
46451,안티카페/Noun,1,0,1,0.0,1.1106915165381966e-05,1.0
46452,어셔/Noun,1,1,0,1.1115310228308472e-05,0.0,1.0
46453,는다/Eomi,1,1,0,1.1115310228308472e-05,0.0,1.0
46454,해송/Noun,1,1,0,1.1115310228308472e-05,0.0,1.0
46455,어기/Noun,1,1,0,1.1115310228308472e-05,0.0,1.0
46456,잼있네요/Foreign,1,1,0,1.1115310228308472e-05,0.0,1.0
46457,코코모/Noun,1,1,0,1.1115310228308472e-05,0.0,1.0
46458,드래그미투헬/Noun,1,0,1,0.0,1.1106915165381966e-05,1.0
46459,청부/Noun,1,0,1,0.0,1.1106915165381966e-05,1.0
46460,책스오/Noun,1,1,0,1.1115310228308472e-05,0.0,1.0
46461,자정작용/Noun,1,0,1,0.0,1.1106915165381966e-05,1.0
46462,말통/Noun,1,0,1,0.0,1.1106915165381966e-05,1.0
46463,쨔증/Noun,1,0,1,0.0,1.1106915165381966e-05,1.0
46464,다비드/Noun,1,1,0,1.1115310228308472e-05,0.0,1.0
46465,레이븐/Noun,1,0,1,0.0,1.1106915165381966e-05,1.0
46466,가잔/Noun,1,0,1,0.0,1.1106915165381966e-05,1.0
46467,합기도/Noun,1,1,0,1.1115310228308472e-05,0.0,1.0
46468,흑연/Noun,1,1,0,1.1115310228308472e-05,0.0,1.0
46469,코띨라르/Noun,1,0,1,0.0,1.1106915165381966e-05,1.0
46470,비밀리/Noun,1,1,0,1.1115310228308472e-05,0.0,1.0
46471,김금화/Noun,1,0,1,0.0,1.1106915165381966e-05,1.0
46472,-____-/Punctuation,1,0,1,0.0,1.1106915165381966e-05,1.0
46473,영류왕/Noun,1,0,1,0.0,1.1106915165381966e-05,1.0
46474,7080년/Number,1,0,1,0.0,1.1106915165381966e-05,1.0
46475,kokomo/Alpha,1,1,0,1.1115310228308472e-05,0.0,1.0
46476,권격/Noun,1,1,0,1.1115310228308472e-05,0.0,1.0
46477,똥퀄/Noun,1,1,0,1.1115310228308472e-05,0.0,1.0
46478,억하심정/Noun,1,1,0,1.1115310228308472e-05,0.0,1.0
46479,키햐/Noun,1,1,0,1.1115310228308472e-05,0.0,1.0
46480,후나/Foreign,1,1,0,1.1115310228308472e-05,0.0,1.0
46481,좢이큰루/Noun,1,0,1,0.0,1.1106915165381966e-05,1.0
46482,4만달러/Number,1,1,0,1.1115310228308472e-05,0.0,1.0
46483,맞상대/Noun,1,1,0,1.1115310228308472e-05,0.0,1.0
46484,번지럽다/Adjective,1,0,1,0.0,1.1106915165381966e-05,1.0
46485,맛벌때/Noun,1,0,1,0.0,1.1106915165381966e-05,1.0
46486,트리나/Noun,1,0,1,0.0,1.1106915165381966e-05,1.0
46487,한끗차/Noun,1,1,0,1.1115310228308472e-05,0.0,1.0
46488,쪽빡찼음/Noun,1,1,0,1.1115310228308472e-05,0.0,1.0
46489,제씨/Noun,1,1,0,1.1115310228308472e-05,0.0,1.0
46490,bell/Alpha,1,1,0,1.1115310228308472e-05,0.0,1.0
46491,saved/Alpha,1,1,0,1.1115310228308472e-05,0.0,1.0
46492,눊쟈쟞/Noun,1,0,1,0.0,1.1106915165381966e-05,1.0
46493,포퐁/Noun,1,0,1,0.0,1.1106915165381966e-05,1.0
46494,놀드형님/Noun,1,1,0,1.1115310228308472e-05,0.0,1.0
46495,몽샹미셀/Noun,1,1,0,1.1115310228308472e-05,0.0,1.0
46496,명예욕/Noun,1,1,0,1.1115310228308472e-05,0.0,1.0
46497,93/Number,1,1,0,1.1115310228308472e-05,0.0,1.0
46498,달갱/Noun,1,1,0,1.1115310228308472e-05,0.0,1.0
46499,~!!></Punctuation,1,1,0,1.1115310228308472e-05,0.0,1.0
46500,진띰/Noun,1,1,0,1.1115310228308472e-05,0.0,1.0
46501,플래그/Noun,1,0,1,0.0,1.1106915165381966e-05,1.0
46502,송학/Noun,1,0,1,0.0,1.1106915165381966e-05,1.0
46503,김지윤/Noun,1,1,0,1.1115310228308472e-05,0.0,1.0
46504,아흔/Modifier,1,1,0,1.1115310228308472e-05,0.0,1.0
46505,197/Number,1,0,1,0.0,1.1106915165381966e-05,1.0
46506,liked/Alpha,1,1,0,1.1115310228308472e-05,0.0,1.0
46507,럐/Noun,1,0,1,0.0,1.1106915165381966e-05,1.0
46508,ㅣㅅ/KoreanParticle,1,1,0,1.1115310228308472e-05,0.0,1.0
46509,심희/Noun,1,1,0,1.1115310228308472e-05,0.0,1.0
46510,이지나든/Foreign,1,1,0,1.1115310228308472e-05,0.0,1.0
46511,coke/Alpha,1,0,1,0.0,1.1106915165381966e-05,1.0
46512,Having/Alpha,1,0,1,0.0,1.1106915165381966e-05,1.0
46513,ㅈㅅㄱㄷ/KoreanParticle,1,1,0,1.1115310228308472e-05,0.0,1.0
46514,ㄱㄷㅋㄷ/KoreanParticle,1,1,0,1.1115310228308472e-05,0.0,1.0
46515,휘틀휘틀/Noun,1,1,0,1.1115310228308472e-05,0.0,1.0
46516,심드렁/Noun,1,0,1,0.0,1.1106915165381966e-05,1.0
46517,Greed/Alpha,1,1,0,1.1115310228308472e-05,0.0,1.0
46518,안시켯/Noun,1,0,1,0.0,1.1106915165381966e-05,1.0
46519,걘적/Noun,1,1,0,1.1115310228308472e-05,0.0,1.0
46520,)~~!!/Punctuation,1,1,0,1.1115310228308472e-05,0.0,1.0
46521,광고대행사/Noun,1,0,1,0.0,1.1106915165381966e-05,1.0
46522,챠크라/Noun,1,0,1,0.0,1.1106915165381966e-05,1.0
46523,ㄷㅋ/KoreanParticle,1,0,1,0.0,1.1106915165381966e-05,1.0
46524,양질/Noun,1,1,0,1.1115310228308472e-05,0.0,1.0
46525,보다가꺼버림/Foreign,1,0,1,0.0,1.1106915165381966e-05,1.0
46526,터스/Noun,1,0,1,0.0,1.1106915165381966e-05,1.0
46527,최상현/Noun,1,1,0,1.1115310228308472e-05,0.0,1.0
46528,꺠어보/Noun,1,0,1,0.0,1.1106915165381966e-05,1.0
46529,dnstj/Alpha,1,1,0,1.1115310228308472e-05,0.0,1.0
46530,묽다/Adjective,1,0,1,0.0,1.1106915165381966e-05,1.0
46531,못체/Noun,1,0,1,0.0,1.1106915165381966e-05,1.0
46532,혜령/Noun,1,0,1,0.0,1.1106915165381966e-05,1.0
46533,세도정치/Noun,1,0,1,0.0,1.1106915165381966e-05,1.0
46534,외척/Noun,1,0,1,0.0,1.1106915165381966e-05,1.0
46535,씌여/Noun,1,0,1,0.0,1.1106915165381966e-05,1.0
46536,콩깍지/Noun,1,0,1,0.0,1.1106915165381966e-05,1.0
46537,동을봐/Noun,1,0,1,0.0,1.1106915165381966e-05,1.0
46538,록웰/Noun,1,1,0,1.1115310228308472e-05,0.0,1.0
46539,마해/Noun,1,0,1,0.0,1.1106915165381966e-05,1.0
46540,recognized/Alpha,1,1,0,1.1115310228308472e-05,0.0,1.0
46541,easily/Alpha,1,1,0,1.1115310228308472e-05,0.0,1.0
46542,revealing/Alpha,1,1,0,1.1115310228308472e-05,0.0,1.0
46543,documentary/Alpha,1,1,0,1.1115310228308472e-05,0.0,1.0
46544,늙었어/Foreign,1,0,1,0.0,1.1106915165381966e-05,1.0
46545,낚는건/Noun,1,0,1,0.0,1.1106915165381966e-05,1.0
46546,뭇느/Noun,1,0,1,0.0,1.1106915165381966e-05,1.0
46547,봤는대/Foreign,1,0,1,0.0,1.1106915165381966e-05,1.0
46548,철마/Noun,1,0,1,0.0,1.1106915165381966e-05,1.0
46549,엄진동/Noun,1,0,1,0.0,1.1106915165381966e-05,1.0
46550,킬킬/Noun,1,0,1,0.0,1.1106915165381966e-05,1.0
46551,볕/Noun,1,1,0,1.1115310228308472e-05,0.0,1.0
46552,화점/Noun,1,0,1,0.0,1.1106915165381966e-05,1.0
46553,라졸라/Noun,1,1,0,1.1115310228308472e-05,0.0,1.0
46554,나전/Noun,1,1,0,1.1115310228308472e-05,0.0,1.0
46555,졀/Noun,1,1,0,1.1115310228308472e-05,0.0,1.0
46556,미니스커트/Noun,1,0,1,0.0,1.1106915165381966e-05,1.0
46557,서빙/Noun,1,0,1,0.0,1.1106915165381966e-05,1.0
46558,힘빼/Noun,1,0,1,0.0,1.1106915165381966e-05,1.0
46559,셋트메뉴/Noun,1,0,1,0.0,1.1106915165381966e-05,1.0
46560,무해/Noun,1,1,0,1.1115310228308472e-05,0.0,1.0
46561,호무라/Noun,1,1,0,1.1115310228308472e-05,0.0,1.0
46562,이동승/Noun,1,1,0,1.1115310228308472e-05,0.0,1.0
46563,찜통/Noun,1,0,1,0.0,1.1106915165381966e-05,1.0
46564,얼귤/Noun,1,0,1,0.0,1.1106915165381966e-05,1.0
46565,듀시간즁/Noun,1,0,1,0.0,1.1106915165381966e-05,1.0
46566,얌체/Noun,1,0,1,0.0,1.1106915165381966e-05,1.0
46567,밍구스/Noun,1,0,1,0.0,1.1106915165381966e-05,1.0
46568,분륜영화/Noun,1,0,1,0.0,1.1106915165381966e-05,1.0
46569,낙도/Noun,1,1,0,1.1115310228308472e-05,0.0,1.0
46570,볼맛나/Noun,1,1,0,1.1115310228308472e-05,0.0,1.0
46571,도쿄대/Noun,1,1,0,1.1115310228308472e-05,0.0,1.0
46572,",->/Punctuation",1,1,0,1.1115310228308472e-05,0.0,1.0
46573,새어머니/Noun,1,1,0,1.1115310228308472e-05,0.0,1.0
46574,슈퍼윙스/Noun,1,1,0,1.1115310228308472e-05,0.0,1.0
46575,dodadan@naver.com/Email,1,1,0,1.1115310228308472e-05,0.0,1.0
46576,깩/Adverb,1,0,1,0.0,1.1106915165381966e-05,1.0
46577,"""..../Punctuation",1,1,0,1.1115310228308472e-05,0.0,1.0
46578,도는/Foreign,1,1,0,1.1115310228308472e-05,0.0,1.0
46579,삐었/Noun,1,1,0,1.1115310228308472e-05,0.0,1.0
46580,그래그래/Noun,1,1,0,1.1115310228308472e-05,0.0,1.0
46581,아싀/Noun,1,0,1,0.0,1.1106915165381966e-05,1.0
46582,경스작/Noun,1,0,1,0.0,1.1106915165381966e-05,1.0
46583,9.68/Number,1,0,1,0.0,1.1106915165381966e-05,1.0
46584,컷팅/Noun,1,0,1,0.0,1.1106915165381966e-05,1.0
46585,프루/Noun,1,1,0,1.1115310228308472e-05,0.0,1.0
46586,멋졋던/Noun,1,1,0,1.1115310228308472e-05,0.0,1.0
46587,10-20분/Number,1,1,0,1.1115310228308472e-05,0.0,1.0
46588,마은/Noun,1,1,0,1.1115310228308472e-05,0.0,1.0
46589,줗음/Noun,1,1,0,1.1115310228308472e-05,0.0,1.0
46590,멈췃어/Noun,1,0,1,0.0,1.1106915165381966e-05,1.0
46591,접접접/Noun,1,0,1,0.0,1.1106915165381966e-05,1.0
46592,ㅎㅎㅇㅣ/KoreanParticle,1,0,1,0.0,1.1106915165381966e-05,1.0
46593,박치/Noun,1,0,1,0.0,1.1106915165381966e-05,1.0
46594,아이버슨/Noun,1,1,0,1.1115310228308472e-05,0.0,1.0
46595,김혜숙님/Noun,1,1,0,1.1115310228308472e-05,0.0,1.0
46596,잘밨네/Noun,1,1,0,1.1115310228308472e-05,0.0,1.0
46597,명승/Noun,1,0,1,0.0,1.1106915165381966e-05,1.0
46598,청치/Noun,1,0,1,0.0,1.1106915165381966e-05,1.0
46599,좀박/Noun,1,1,0,1.1115310228308472e-05,0.0,1.0
46600,마운/Noun,1,1,0,1.1115310228308472e-05,0.0,1.0
46601,구급차/Noun,1,1,0,1.1115310228308472e-05,0.0,1.0
46602,수교/Noun,1,0,1,0.0,1.1106915165381966e-05,1.0
46603,김동현/Noun,1,0,1,0.0,1.1106915165381966e-05,1.0
46604,왜리런/Noun,1,1,0,1.1115310228308472e-05,0.0,1.0
46605,을거/Noun,1,1,0,1.1115310228308472e-05,0.0,1.0
46606,머길/Noun,1,0,1,0.0,1.1106915165381966e-05,1.0
46607,안준/Noun,1,1,0,1.1115310228308472e-05,0.0,1.0
46608,크리티컬/Noun,1,1,0,1.1115310228308472e-05,0.0,1.0
46609,찾아헤맷/Noun,1,1,0,1.1115310228308472e-05,0.0,1.0
46610,빙닭/Noun,1,0,1,0.0,1.1106915165381966e-05,1.0
46611,천오백원/Noun,1,0,1,0.0,1.1106915165381966e-05,1.0
46612,십센치/Noun,1,0,1,0.0,1.1106915165381966e-05,1.0
46613,ABBA/Alpha,1,1,0,1.1115310228308472e-05,0.0,1.0
46614,안인숙/Noun,1,1,0,1.1115310228308472e-05,0.0,1.0
46615,수빈/Noun,1,1,0,1.1115310228308472e-05,0.0,1.0
46616,우엉/Noun,1,1,0,1.1115310228308472e-05,0.0,1.0
46617,연사/Noun,1,1,0,1.1115310228308472e-05,0.0,1.0
46618,프랜시스/Noun,1,1,0,1.1115310228308472e-05,0.0,1.0
46619,일모/Noun,1,0,1,0.0,1.1106915165381966e-05,1.0
46620,민증/Noun,1,0,1,0.0,1.1106915165381966e-05,1.0
46621,블랏쳇/Noun,1,0,1,0.0,1.1106915165381966e-05,1.0
46622,새끼고양이/Noun,1,0,1,0.0,1.1106915165381966e-05,1.0
46623,저릿/Noun,1,1,0,1.1115310228308472e-05,0.0,1.0
46624,아오자이/Noun,1,1,0,1.1115310228308472e-05,0.0,1.0
46625,빅팬/Noun,1,0,1,0.0,1.1106915165381966e-05,1.0
46626,엿는데/Noun,1,0,1,0.0,1.1106915165381966e-05,1.0
46627,김봉석/Noun,1,1,0,1.1115310228308472e-05,0.0,1.0
46628,쭉빵걸/Noun,1,0,1,0.0,1.1106915165381966e-05,1.0
46629,아야노/Noun,1,0,1,0.0,1.1106915165381966e-05,1.0
46630,전만났었네/Foreign,1,0,1,0.0,1.1106915165381966e-05,1.0
46631,풀로/Foreign,1,1,0,1.1115310228308472e-05,0.0,1.0
46632,양씨/Noun,1,0,1,0.0,1.1106915165381966e-05,1.0
46633,웜작/Noun,1,0,1,0.0,1.1106915165381966e-05,1.0
46634,콜로니/Noun,1,1,0,1.1115310228308472e-05,0.0,1.0
46635,괴벨스/Noun,1,0,1,0.0,1.1106915165381966e-05,1.0
46636,음해/Noun,1,1,0,1.1115310228308472e-05,0.0,1.0
46637,이명/Noun,1,1,0,1.1115310228308472e-05,0.0,1.0
46638,빅브라더/Noun,1,0,1,0.0,1.1106915165381966e-05,1.0
46639,독트/Noun,1,1,0,1.1115310228308472e-05,0.0,1.0
46640,끌구/Noun,1,0,1,0.0,1.1106915165381966e-05,1.0
46641,난다요/Noun,1,0,1,0.0,1.1106915165381966e-05,1.0
46642,맨유/Noun,1,0,1,0.0,1.1106915165381966e-05,1.0
46643,닦았슴/Noun,1,0,1,0.0,1.1106915165381966e-05,1.0
46644,화장지/Noun,1,0,1,0.0,1.1106915165381966e-05,1.0
46645,노우진/Noun,1,0,1,0.0,1.1106915165381966e-05,1.0
46646,관셈보살/Noun,1,0,1,0.0,1.1106915165381966e-05,1.0
46647,삼장/Noun,1,0,1,0.0,1.1106915165381966e-05,1.0
46648,기네스팰트로/Noun,1,0,1,0.0,1.1106915165381966e-05,1.0
46649,로빙/Noun,1,1,0,1.1115310228308472e-05,0.0,1.0
46650,선거운동/Noun,1,0,1,0.0,1.1106915165381966e-05,1.0
46651,65분/Number,1,0,1,0.0,1.1106915165381966e-05,1.0
46652,복실/Noun,1,0,1,0.0,1.1106915165381966e-05,1.0
46653,규동/Noun,1,1,0,1.1115310228308472e-05,0.0,1.0
46654,KJ/Alpha,1,1,0,1.1115310228308472e-05,0.0,1.0
46655,굿굿꼭/Noun,1,1,0,1.1115310228308472e-05,0.0,1.0
46656,소프트볼/Noun,1,0,1,0.0,1.1106915165381966e-05,1.0
46657,싱크로나이즈/Noun,1,0,1,0.0,1.1106915165381966e-05,1.0
46658,찰때/Noun,1,0,1,0.0,1.1106915165381966e-05,1.0
46659,성종/Noun,1,0,1,0.0,1.1106915165381966e-05,1.0
46660,어쩌잔/Noun,1,0,1,0.0,1.1106915165381966e-05,1.0
46661,에론/Noun,1,0,1,0.0,1.1106915165381966e-05,1.0
46662,메롱이/Noun,1,0,1,0.0,1.1106915165381966e-05,1.0
46663,ㄷㄱㄷㄱ/KoreanParticle,1,0,1,0.0,1.1106915165381966e-05,1.0
46664,sg/Alpha,1,1,0,1.1115310228308472e-05,0.0,1.0
46665,작심/Noun,1,0,1,0.0,1.1106915165381966e-05,1.0
46666,애썩/Noun,1,1,0,1.1115310228308472e-05,0.0,1.0
46667,엄한데/Noun,1,0,1,0.0,1.1106915165381966e-05,1.0
46668,성인보/Noun,1,0,1,0.0,1.1106915165381966e-05,1.0
46669,몽타쥬/Noun,1,1,0,1.1115310228308472e-05,0.0,1.0
46670,찌레기/Noun,1,0,1,0.0,1.1106915165381966e-05,1.0
46671,ㅏㅁ/KoreanParticle,1,0,1,0.0,1.1106915165381966e-05,1.0
46672,포만/Noun,1,1,0,1.1115310228308472e-05,0.0,1.0
46673,발본색원/Noun,1,0,1,0.0,1.1106915165381966e-05,1.0
46674,astonishingness/Alpha,1,1,0,1.1115310228308472e-05,0.0,1.0
46675,잘못짚다/Verb,1,1,0,1.1115310228308472e-05,0.0,1.0
46676,개봉작/Foreign,1,1,0,1.1115310228308472e-05,0.0,1.0
46677,됫을듯/Noun,1,1,0,1.1115310228308472e-05,0.0,1.0
46678,래픽/Noun,1,1,0,1.1115310228308472e-05,0.0,1.0
46679,똥송하/Noun,1,1,0,1.1115310228308472e-05,0.0,1.0
46680,후예/Noun,1,1,0,1.1115310228308472e-05,0.0,1.0
46681,ㅇㅇㅋㅋ/KoreanParticle,1,1,0,1.1115310228308472e-05,0.0,1.0
46682,나모/Noun,1,0,1,0.0,1.1106915165381966e-05,1.0
46683,짦은거/Noun,1,1,0,1.1115310228308472e-05,0.0,1.0
46684,보셧/Noun,1,0,1,0.0,1.1106915165381966e-05,1.0
46685,젇/Noun,1,0,1,0.0,1.1106915165381966e-05,1.0
46686,♡♡♡♡♡♡♡♡♡♡/Foreign,1,1,0,1.1115310228308472e-05,0.0,1.0
46687,ㄷㅇ/KoreanParticle,1,0,1,0.0,1.1106915165381966e-05,1.0
46688,요리왕/Noun,1,0,1,0.0,1.1106915165381966e-05,1.0
46689,재미썽/Noun,1,1,0,1.1115310228308472e-05,0.0,1.0
46690,르잼/Noun,1,1,0,1.1115310228308472e-05,0.0,1.0
46691,정먈/Noun,1,1,0,1.1115310228308472e-05,0.0,1.0
46692,책꽂이/Noun,1,1,0,1.1115310228308472e-05,0.0,1.0
46693,띠용/Noun,1,1,0,1.1115310228308472e-05,0.0,1.0
46694,예방/Noun,1,1,0,1.1115310228308472e-05,0.0,1.0
46695,계복/Noun,1,1,0,1.1115310228308472e-05,0.0,1.0
46696,람세스역/Noun,1,1,0,1.1115310228308472e-05,0.0,1.0
46697,스스럼없이/Adverb,1,0,1,0.0,1.1106915165381966e-05,1.0
46698,섹션티비/Noun,1,0,1,0.0,1.1106915165381966e-05,1.0
46699,찬밥/Noun,1,0,1,0.0,1.1106915165381966e-05,1.0
46700,천후/Noun,1,1,0,1.1115310228308472e-05,0.0,1.0
46701,퀼리티도있/Noun,1,1,0,1.1115310228308472e-05,0.0,1.0
46702,유리보/Noun,1,0,1,0.0,1.1106915165381966e-05,1.0
46703,후지이/Noun,1,1,0,1.1115310228308472e-05,0.0,1.0
46704,666/Number,1,1,0,1.1115310228308472e-05,0.0,1.0
46705,등뎅/Noun,1,1,0,1.1115310228308472e-05,0.0,1.0
46706,아라타/Noun,1,1,0,1.1115310228308472e-05,0.0,1.0
46707,놀래킬/Noun,1,0,1,0.0,1.1106915165381966e-05,1.0
46708,파닥거리다/Verb,1,0,1,0.0,1.1106915165381966e-05,1.0
46709,힛쳐/Noun,1,0,1,0.0,1.1106915165381966e-05,1.0
46710,게오/Noun,1,0,1,0.0,1.1106915165381966e-05,1.0
46711,tired/Alpha,1,1,0,1.1115310228308472e-05,0.0,1.0
46712,준후/Noun,1,0,1,0.0,1.1106915165381966e-05,1.0
46713,옴니버스영화/Noun,1,1,0,1.1115310228308472e-05,0.0,1.0
46714,저지드레드/Noun,1,0,1,0.0,1.1106915165381966e-05,1.0
46715,수욱/Noun,1,0,1,0.0,1.1106915165381966e-05,1.0
46716,조빠/Noun,1,0,1,0.0,1.1106915165381966e-05,1.0
46717,문세윤/Noun,1,0,1,0.0,1.1106915165381966e-05,1.0
46718,도시공학/Noun,1,0,1,0.0,1.1106915165381966e-05,1.0
46719,비됴빌려/Noun,1,1,0,1.1115310228308472e-05,0.0,1.0
46720,(^_^)./Punctuation,1,1,0,1.1115310228308472e-05,0.0,1.0
46721,ㅈㅄ/KoreanParticle,1,1,0,1.1115310228308472e-05,0.0,1.0
46722,무함마드/Noun,1,0,1,0.0,1.1106915165381966e-05,1.0
46723,ㅐㅇ/KoreanParticle,1,1,0,1.1115310228308472e-05,0.0,1.0
46724,프루나/Noun,1,0,1,0.0,1.1106915165381966e-05,1.0
46725,point/Alpha,1,0,1,0.0,1.1106915165381966e-05,1.0
46726,abour/Alpha,1,0,1,0.0,1.1106915165381966e-05,1.0
46727,wang/Alpha,1,0,1,0.0,1.1106915165381966e-05,1.0
46728,ㅛㅛ/KoreanParticle,1,1,0,1.1115310228308472e-05,0.0,1.0
46729,번쌋음/Noun,1,0,1,0.0,1.1106915165381966e-05,1.0
46730,포탠/Noun,1,1,0,1.1115310228308472e-05,0.0,1.0
46731,년등/Noun,1,0,1,0.0,1.1106915165381966e-05,1.0
46732,6500만년/Number,1,1,0,1.1115310228308472e-05,0.0,1.0
46733,다낭/Noun,1,1,0,1.1115310228308472e-05,0.0,1.0
46734,공지영/Noun,1,1,0,1.1115310228308472e-05,0.0,1.0
46735,맥가이버칼/Noun,1,1,0,1.1115310228308472e-05,0.0,1.0
46736,괜챦았어/Noun,1,1,0,1.1115310228308472e-05,0.0,1.0
46737,골든글로브/Noun,1,1,0,1.1115310228308472e-05,0.0,1.0
46738,협오/Noun,1,1,0,1.1115310228308472e-05,0.0,1.0
46739,블랭키/Noun,1,0,1,0.0,1.1106915165381966e-05,1.0
46740,셋때메/Noun,1,0,1,0.0,1.1106915165381966e-05,1.0
46741,얌전이/Noun,1,1,0,1.1115310228308472e-05,0.0,1.0
46742,tumor/Alpha,1,1,0,1.1115310228308472e-05,0.0,1.0
46743,carpet/Alpha,1,1,0,1.1115310228308472e-05,0.0,1.0
46744,toy/Alpha,1,1,0,1.1115310228308472e-05,0.0,1.0
46745,Bring/Alpha,1,1,0,1.1115310228308472e-05,0.0,1.0
46746,명민하다/Adjective,1,0,1,0.0,1.1106915165381966e-05,1.0
46747,대희/Noun,1,0,1,0.0,1.1106915165381966e-05,1.0
46748,왜남탓/Noun,1,1,0,1.1115310228308472e-05,0.0,1.0
46749,박지헌/Noun,1,1,0,1.1115310228308472e-05,0.0,1.0
46750,레일리/Noun,1,0,1,0.0,1.1106915165381966e-05,1.0
46751,주기용/Noun,1,0,1,0.0,1.1106915165381966e-05,1.0
46752,통역/Noun,1,0,1,0.0,1.1106915165381966e-05,1.0
46753,외교통상부/Noun,1,0,1,0.0,1.1106915165381966e-05,1.0
46754,문정/Noun,1,0,1,0.0,1.1106915165381966e-05,1.0
46755,푹발/Noun,1,1,0,1.1115310228308472e-05,0.0,1.0
46756,스케이팅/Noun,1,1,0,1.1115310228308472e-05,0.0,1.0
46757,다수결/Noun,1,0,1,0.0,1.1106915165381966e-05,1.0
46758,외쿡/Noun,1,0,1,0.0,1.1106915165381966e-05,1.0
46759,제로다크서티/Noun,1,1,0,1.1115310228308472e-05,0.0,1.0
46760,김상오/Noun,1,0,1,0.0,1.1106915165381966e-05,1.0
46761,씬굿/Noun,1,1,0,1.1115310228308472e-05,0.0,1.0
46762,셔틀콕/Noun,1,1,0,1.1115310228308472e-05,0.0,1.0
46763,임해군/Noun,1,0,1,0.0,1.1106915165381966e-05,1.0
46764,Rose/Alpha,1,1,0,1.1115310228308472e-05,0.0,1.0
46765,앤딩곡/Noun,1,1,0,1.1115310228308472e-05,0.0,1.0
46766,!!!+_+/Punctuation,1,1,0,1.1115310228308472e-05,0.0,1.0
46767,Calling/Alpha,1,1,0,1.1115310228308472e-05,0.0,1.0
46768,보도사진/Noun,1,1,0,1.1115310228308472e-05,0.0,1.0
46769,될껀데/Noun,1,0,1,0.0,1.1106915165381966e-05,1.0
46770,창세기전/Noun,1,1,0,1.1115310228308472e-05,0.0,1.0
46771,전통춤/Noun,1,0,1,0.0,1.1106915165381966e-05,1.0
46772,딱지왕/Noun,1,0,1,0.0,1.1106915165381966e-05,1.0
46773,.......(/Punctuation,1,1,0,1.1115310228308472e-05,0.0,1.0
46774,김승진/Noun,1,1,0,1.1115310228308472e-05,0.0,1.0
46775,特作/Foreign,1,1,0,1.1115310228308472e-05,0.0,1.0
46776,특작/Noun,1,1,0,1.1115310228308472e-05,0.0,1.0
46777,벌거벗기다/Verb,1,1,0,1.1115310228308472e-05,0.0,1.0
46778,형리/Noun,1,1,0,1.1115310228308472e-05,0.0,1.0
46779,뻑가/Noun,1,1,0,1.1115310228308472e-05,0.0,1.0
46780,샤베트/Noun,1,0,1,0.0,1.1106915165381966e-05,1.0
46781,헛헛해/Noun,1,0,1,0.0,1.1106915165381966e-05,1.0
46782,밌었어/Noun,1,1,0,1.1115310228308472e-05,0.0,1.0
46783,스으으읍얼/Noun,1,0,1,0.0,1.1106915165381966e-05,1.0
46784,얘뻐/Noun,1,0,1,0.0,1.1106915165381966e-05,1.0
46785,명문/Noun,1,0,1,0.0,1.1106915165381966e-05,1.0
46786,비양/Noun,1,0,1,0.0,1.1106915165381966e-05,1.0
46787,댄줄알았다/Foreign,1,0,1,0.0,1.1106915165381966e-05,1.0
46788,렌더링/Noun,1,1,0,1.1115310228308472e-05,0.0,1.0
46789,38분/Number,1,0,1,0.0,1.1106915165381966e-05,1.0
46790,누운/Noun,1,1,0,1.1115310228308472e-05,0.0,1.0
46791,겨겨/Noun,1,0,1,0.0,1.1106915165381966e-05,1.0
46792,유흉/Noun,1,1,0,1.1115310228308472e-05,0.0,1.0
46793,eggs/Alpha,1,0,1,0.0,1.1106915165381966e-05,1.0
46794,Easter/Alpha,1,0,1,0.0,1.1106915165381966e-05,1.0
46795,brains/Alpha,1,0,1,0.0,1.1106915165381966e-05,1.0
46796,dust/Alpha,1,0,1,0.0,1.1106915165381966e-05,1.0
46797,Dust/Alpha,1,0,1,0.0,1.1106915165381966e-05,1.0
46798,^^~./Punctuation,1,1,0,1.1115310228308472e-05,0.0,1.0
46799,봣네용/Noun,1,1,0,1.1115310228308472e-05,0.0,1.0
46800,집체/Noun,1,0,1,0.0,1.1106915165381966e-05,1.0
46801,아득해지다/Adjective,1,1,0,1.1115310228308472e-05,0.0,1.0
46802,ㅗㅎㅎ/KoreanParticle,1,1,0,1.1115310228308472e-05,0.0,1.0
46803,ㄱㄶㅅ/KoreanParticle,1,1,0,1.1115310228308472e-05,0.0,1.0
46804,굿굿굿긋그슷/Noun,1,1,0,1.1115310228308472e-05,0.0,1.0
46805,삷/Noun,1,1,0,1.1115310228308472e-05,0.0,1.0
46806,치과의사/Noun,1,1,0,1.1115310228308472e-05,0.0,1.0
46807,꼴갖/Noun,1,0,1,0.0,1.1106915165381966e-05,1.0
46808,5천만원/Number,1,0,1,0.0,1.1106915165381966e-05,1.0
46809,절레절레/Noun,1,0,1,0.0,1.1106915165381966e-05,1.0
46810,셧슴/Noun,1,0,1,0.0,1.1106915165381966e-05,1.0
46811,돈좀버셧/Noun,1,0,1,0.0,1.1106915165381966e-05,1.0
46812,뽀사불/Noun,1,0,1,0.0,1.1106915165381966e-05,1.0
46813,시부렁/Noun,1,0,1,0.0,1.1106915165381966e-05,1.0
46814,개뽕/Noun,1,0,1,0.0,1.1106915165381966e-05,1.0
46815,애드/Noun,1,0,1,0.0,1.1106915165381966e-05,1.0
46816,얼얼/Noun,1,1,0,1.1115310228308472e-05,0.0,1.0
46817,터씬/Noun,1,1,0,1.1115310228308472e-05,0.0,1.0
46818,조규원/Noun,1,0,1,0.0,1.1106915165381966e-05,1.0
46819,EU/Alpha,1,0,1,0.0,1.1106915165381966e-05,1.0
46820,days/Alpha,1,1,0,1.1115310228308472e-05,0.0,1.0
46821,혐동/Noun,1,0,1,0.0,1.1106915165381966e-05,1.0
46822,잼습/Noun,1,1,0,1.1115310228308472e-05,0.0,1.0
46823,吐/Foreign,1,0,1,0.0,1.1106915165381966e-05,1.0
46824,터커님/Noun,1,1,0,1.1115310228308472e-05,0.0,1.0
46825,짯겠/Noun,1,1,0,1.1115310228308472e-05,0.0,1.0
46826,다처/Noun,1,1,0,1.1115310228308472e-05,0.0,1.0
46827,울렁/Noun,1,0,1,0.0,1.1106915165381966e-05,1.0
46828,어으아어/Noun,1,0,1,0.0,1.1106915165381966e-05,1.0
46829,샤코/Noun,1,0,1,0.0,1.1106915165381966e-05,1.0
46830,볼맛안/Noun,1,0,1,0.0,1.1106915165381966e-05,1.0
46831,훨나/Noun,1,1,0,1.1115310228308472e-05,0.0,1.0
46832,감공/Noun,1,1,0,1.1115310228308472e-05,0.0,1.0
46833,알앜음/Noun,1,1,0,1.1115310228308472e-05,0.0,1.0
46834,녀놈/Noun,1,0,1,0.0,1.1106915165381966e-05,1.0
46835,노막/Noun,1,1,0,1.1115310228308472e-05,0.0,1.0
46836,카스트/Noun,1,1,0,1.1115310228308472e-05,0.0,1.0
46837,봣을떄/Noun,1,1,0,1.1115310228308472e-05,0.0,1.0
46838,거치/Noun,1,1,0,1.1115310228308472e-05,0.0,1.0
46839,<----/Punctuation,1,0,1,0.0,1.1106915165381966e-05,1.0
46840,pupp/Alpha,1,0,1,0.0,1.1106915165381966e-05,1.0
46841,4508052/Number,1,0,1,0.0,1.1106915165381966e-05,1.0
46842,때문을/Foreign,1,0,1,0.0,1.1106915165381966e-05,1.0
46843,63년/Number,1,1,0,1.1115310228308472e-05,0.0,1.0
46844,무주/Noun,1,0,1,0.0,1.1106915165381966e-05,1.0
46845,호우/Noun,1,0,1,0.0,1.1106915165381966e-05,1.0
46846,우윳빛/Noun,1,0,1,0.0,1.1106915165381966e-05,1.0
46847,교환일기/Noun,1,0,1,0.0,1.1106915165381966e-05,1.0
46848,로카르노/Noun,1,0,1,0.0,1.1106915165381966e-05,1.0
46849,리즈나/Foreign,1,0,1,0.0,1.1106915165381966e-05,1.0
46850,비포앤/Noun,1,1,0,1.1115310228308472e-05,0.0,1.0
46851,전문직/Noun,1,0,1,0.0,1.1106915165381966e-05,1.0
46852,로무/Noun,1,0,1,0.0,1.1106915165381966e-05,1.0
46853,넘얄입네/Noun,1,1,0,1.1115310228308472e-05,0.0,1.0
46854,변동/Noun,1,1,0,1.1115310228308472e-05,0.0,1.0
46855,박승/Noun,1,0,1,0.0,1.1106915165381966e-05,1.0
46856,SWAT/Alpha,1,0,1,0.0,1.1106915165381966e-05,1.0
46857,쇼코/Noun,1,1,0,1.1115310228308472e-05,0.0,1.0
46858,버치/Noun,1,1,0,1.1115310228308472e-05,0.0,1.0
46859,박인권/Noun,1,0,1,0.0,1.1106915165381966e-05,1.0
46860,속었더/Noun,1,0,1,0.0,1.1106915165381966e-05,1.0
46861,귀여미/Noun,1,1,0,1.1115310228308472e-05,0.0,1.0
46862,이혜련/Noun,1,0,1,0.0,1.1106915165381966e-05,1.0
46863,병원씬/Noun,1,0,1,0.0,1.1106915165381966e-05,1.0
46864,얏잡/Noun,1,0,1,0.0,1.1106915165381966e-05,1.0
46865,헛발/Noun,1,0,1,0.0,1.1106915165381966e-05,1.0
46866,대생/Foreign,1,0,1,0.0,1.1106915165381966e-05,1.0
46867,숙박업소/Noun,1,0,1,0.0,1.1106915165381966e-05,1.0
46868,달턴/Noun,1,0,1,0.0,1.1106915165381966e-05,1.0
46869,장용영/Noun,1,1,0,1.1115310228308472e-05,0.0,1.0
46870,소달구지/Noun,1,0,1,0.0,1.1106915165381966e-05,1.0
46871,",,,,,,,,,,,,,,,,,,,,,/Punctuation",1,1,0,1.1115310228308472e-05,0.0,1.0
46872,Short/Alpha,1,0,1,0.0,1.1106915165381966e-05,1.0
46873,소요/Noun,1,0,1,0.0,1.1106915165381966e-05,1.0
46874,형량/Noun,1,0,1,0.0,1.1106915165381966e-05,1.0
46875,무궁화/Noun,1,1,0,1.1115310228308472e-05,0.0,1.0
46876,DU/Alpha,1,1,0,1.1115310228308472e-05,0.0,1.0
46877,대구대/Noun,1,1,0,1.1115310228308472e-05,0.0,1.0
46878,모진/Noun,1,1,0,1.1115310228308472e-05,0.0,1.0
46879,추꼭/Noun,1,1,0,1.1115310228308472e-05,0.0,1.0
46880,개베/Noun,1,1,0,1.1115310228308472e-05,0.0,1.0
46881,에어로스미스/Noun,1,0,1,0.0,1.1106915165381966e-05,1.0
46882,락땜/Noun,1,0,1,0.0,1.1106915165381966e-05,1.0
46883,융압/Noun,1,1,0,1.1115310228308472e-05,0.0,1.0
46884,BUT/Alpha,1,1,0,1.1115310228308472e-05,0.0,1.0
46885,???/?/Punctuation,1,0,1,0.0,1.1106915165381966e-05,1.0
46886,시립대/Noun,1,1,0,1.1115310228308472e-05,0.0,1.0
46887,똥쿠소/Noun,1,0,1,0.0,1.1106915165381966e-05,1.0
46888,인혜누/Noun,1,0,1,0.0,1.1106915165381966e-05,1.0
46889,작인게/Foreign,1,1,0,1.1115310228308472e-05,0.0,1.0
46890,잼쩌/Noun,1,1,0,1.1115310228308472e-05,0.0,1.0
46891,조수미/Noun,1,1,0,1.1115310228308472e-05,0.0,1.0
46892,카머런/Noun,1,1,0,1.1115310228308472e-05,0.0,1.0
46893,흐지무/Noun,1,0,1,0.0,1.1106915165381966e-05,1.0
46894,후코/Noun,1,0,1,0.0,1.1106915165381966e-05,1.0
46895,때봣기/Noun,1,1,0,1.1115310228308472e-05,0.0,1.0
46896,것봣/Noun,1,1,0,1.1115310228308472e-05,0.0,1.0
46897,모탈컴뱃/Noun,1,0,1,0.0,1.1106915165381966e-05,1.0
46898,팰땐/Noun,1,0,1,0.0,1.1106915165381966e-05,1.0
46899,퍼스트어벤져/Noun,1,1,0,1.1115310228308472e-05,0.0,1.0
46900,폴아웃/Noun,1,1,0,1.1115310228308472e-05,0.0,1.0
46901,가교/Noun,1,1,0,1.1115310228308472e-05,0.0,1.0
46902,롱렁할수/Noun,1,1,0,1.1115310228308472e-05,0.0,1.0
46903,인수대비/Noun,1,0,1,0.0,1.1106915165381966e-05,1.0
46904,씨도둑/Noun,1,0,1,0.0,1.1106915165381966e-05,1.0
46905,ㅎㅂ/KoreanParticle,1,0,1,0.0,1.1106915165381966e-05,1.0
46906,플럿/Noun,1,0,1,0.0,1.1106915165381966e-05,1.0
46907,체크아웃/Noun,1,1,0,1.1115310228308472e-05,0.0,1.0
46908,전시회/Noun,1,1,0,1.1115310228308472e-05,0.0,1.0
46909,로카/Noun,1,1,0,1.1115310228308472e-05,0.0,1.0
46910,letter/Alpha,1,1,0,1.1115310228308472e-05,0.0,1.0
46911,발로만드/Noun,1,0,1,0.0,1.1106915165381966e-05,1.0
46912,이콘/Noun,1,0,1,0.0,1.1106915165381966e-05,1.0
46913,꺠알/Noun,1,1,0,1.1115310228308472e-05,0.0,1.0
46914,"100,000/Number",1,0,1,0.0,1.1106915165381966e-05,1.0
46915,걸깨/Noun,1,0,1,0.0,1.1106915165381966e-05,1.0
46916,107/Number,1,1,0,1.1115310228308472e-05,0.0,1.0
46917,upi/Alpha,1,1,0,1.1115310228308472e-05,0.0,1.0
46918,슬플떄/Noun,1,0,1,0.0,1.1106915165381966e-05,1.0
46919,화날떄/Noun,1,0,1,0.0,1.1106915165381966e-05,1.0
46920,유애/Noun,1,0,1,0.0,1.1106915165381966e-05,1.0
46921,씹히다/Verb,1,1,0,1.1115310228308472e-05,0.0,1.0
46922,잘근잘근/Adverb,1,1,0,1.1115310228308472e-05,0.0,1.0
46923,반대론/Noun,1,0,1,0.0,1.1106915165381966e-05,1.0
46924,창완형님/Noun,1,0,1,0.0,1.1106915165381966e-05,1.0
46925,중국로케/Noun,1,0,1,0.0,1.1106915165381966e-05,1.0
46926,준석/Noun,1,1,0,1.1115310228308472e-05,0.0,1.0
46927,5~20년/Number,1,1,0,1.1115310228308472e-05,0.0,1.0
46928,썩힌/Noun,1,0,1,0.0,1.1106915165381966e-05,1.0
46929,웰즈/Noun,1,1,0,1.1115310228308472e-05,0.0,1.0
46930,오손/Noun,1,1,0,1.1115310228308472e-05,0.0,1.0
46931,holy/Alpha,1,0,1,0.0,1.1106915165381966e-05,1.0
46932,shiT/Alpha,1,0,1,0.0,1.1106915165381966e-05,1.0
46933,yang/Alpha,1,1,0,1.1115310228308472e-05,0.0,1.0
46934,2:2/Number,1,0,1,0.0,1.1106915165381966e-05,1.0
46935,ㅟ/KoreanParticle,1,1,0,1.1115310228308472e-05,0.0,1.0
46936,~~@!~!@/Punctuation,1,0,1,0.0,1.1106915165381966e-05,1.0
46937,때도/Foreign,1,0,1,0.0,1.1106915165381966e-05,1.0
46938,somewhere/Alpha,1,1,0,1.1115310228308472e-05,0.0,1.0
46939,문하/Noun,1,1,0,1.1115310228308472e-05,0.0,1.0
46940,취설/Noun,1,1,0,1.1115310228308472e-05,0.0,1.0
46941,뻑이가/Noun,1,1,0,1.1115310228308472e-05,0.0,1.0
46942,처저/Noun,1,0,1,0.0,1.1106915165381966e-05,1.0
46943,두마/Noun,1,0,1,0.0,1.1106915165381966e-05,1.0
46944,스피노/Noun,1,0,1,0.0,1.1106915165381966e-05,1.0
46945,곱등/Noun,1,0,1,0.0,1.1106915165381966e-05,1.0
46946,쫌만해/Noun,1,0,1,0.0,1.1106915165381966e-05,1.0
46947,담양/Noun,1,0,1,0.0,1.1106915165381966e-05,1.0
46948,이컨셉인데/Foreign,1,0,1,0.0,1.1106915165381966e-05,1.0
46949,문인/Noun,1,0,1,0.0,1.1106915165381966e-05,1.0
46950,오렌/Noun,1,0,1,0.0,1.1106915165381966e-05,1.0
46951,닥찬했으/Noun,1,1,0,1.1115310228308472e-05,0.0,1.0
46952,김작/Noun,1,1,0,1.1115310228308472e-05,0.0,1.0
46953,하재영/Noun,1,0,1,0.0,1.1106915165381966e-05,1.0
46954,장서/Noun,1,1,0,1.1115310228308472e-05,0.0,1.0
46955,아레잇는넘/Noun,1,1,0,1.1115310228308472e-05,0.0,1.0
46956,ㅡㅇ/KoreanParticle,1,0,1,0.0,1.1106915165381966e-05,1.0
46957,누누/Noun,1,0,1,0.0,1.1106915165381966e-05,1.0
46958,바랠걸/Noun,1,0,1,0.0,1.1106915165381966e-05,1.0
46959,-_-'/Punctuation,1,0,1,0.0,1.1106915165381966e-05,1.0
46960,싱금/Noun,1,0,1,0.0,1.1106915165381966e-05,1.0
46961,촌가/Noun,1,0,1,0.0,1.1106915165381966e-05,1.0
46962,명왕성/Noun,1,0,1,0.0,1.1106915165381966e-05,1.0
46963,블루홀/Noun,1,1,0,1.1115310228308472e-05,0.0,1.0
46964,dmdma/Alpha,1,0,1,0.0,1.1106915165381966e-05,1.0
46965,!!!)/Punctuation,1,1,0,1.1115310228308472e-05,0.0,1.0
46966,~!!!(/Punctuation,1,1,0,1.1115310228308472e-05,0.0,1.0
46967,이엠/Noun,1,0,1,0.0,1.1106915165381966e-05,1.0
46968,혼또니/Noun,1,0,1,0.0,1.1106915165381966e-05,1.0
46969,혼또/Noun,1,0,1,0.0,1.1106915165381966e-05,1.0
46970,/????/Punctuation,1,1,0,1.1115310228308472e-05,0.0,1.0
46971,박범훈/Noun,1,1,0,1.1115310228308472e-05,0.0,1.0
46972,에라쒸/Noun,1,0,1,0.0,1.1106915165381966e-05,1.0
46973,견디다가/Foreign,1,0,1,0.0,1.1106915165381966e-05,1.0
46974,51분/Number,1,0,1,0.0,1.1106915165381966e-05,1.0
46975,rocker/Alpha,1,1,0,1.1115310228308472e-05,0.0,1.0
46976,12%/Number,1,1,0,1.1115310228308472e-05,0.0,1.0
46977,눠/Noun,1,0,1,0.0,1.1106915165381966e-05,1.0
46978,????!????!??!????!????!??!????!????!??/Punctuation,1,0,1,0.0,1.1106915165381966e-05,1.0
46979,manga/Alpha,1,0,1,0.0,1.1106915165381966e-05,1.0
46980,들엇음조캐땅/Foreign,1,1,0,1.1115310228308472e-05,0.0,1.0
46981,봣는데진짜웃겻/Noun,1,1,0,1.1115310228308472e-05,0.0,1.0
46982,똥침/Noun,1,1,0,1.1115310228308472e-05,0.0,1.0
46983,붐비다/Verb,1,1,0,1.1115310228308472e-05,0.0,1.0
46984,남눈/Noun,1,1,0,1.1115310228308472e-05,0.0,1.0
46985,크린트/Noun,1,1,0,1.1115310228308472e-05,0.0,1.0
46986,첨벙/Noun,1,0,1,0.0,1.1106915165381966e-05,1.0
46987,바닷/Noun,1,0,1,0.0,1.1106915165381966e-05,1.0
46988,17%/Number,1,1,0,1.1115310228308472e-05,0.0,1.0
46989,불밖에/Foreign,1,1,0,1.1115310228308472e-05,0.0,1.0
46990,불갖고/Foreign,1,1,0,1.1115310228308472e-05,0.0,1.0
46991,촉박/Noun,1,1,0,1.1115310228308472e-05,0.0,1.0
46992,워싱톤/Noun,1,1,0,1.1115310228308472e-05,0.0,1.0
46993,이다되가네요/Foreign,1,1,0,1.1115310228308472e-05,0.0,1.0
46994,이눔/Noun,1,1,0,1.1115310228308472e-05,0.0,1.0
46995,아크바르/Noun,1,1,0,1.1115310228308472e-05,0.0,1.0
46996,믹현/Noun,1,0,1,0.0,1.1106915165381966e-05,1.0
46997,누드씬/Noun,1,0,1,0.0,1.1106915165381966e-05,1.0
46998,뽁큐/Noun,1,1,0,1.1115310228308472e-05,0.0,1.0
46999,세춸호/Noun,1,1,0,1.1115310228308472e-05,0.0,1.0
47000,맥플라이/Noun,1,1,0,1.1115310228308472e-05,0.0,1.0
47001,?!?!?!?!?!?!?/Punctuation,1,1,0,1.1115310228308472e-05,0.0,1.0
47002,!!??/Punctuation,1,0,1,0.0,1.1106915165381966e-05,1.0
47003,hard/Alpha,1,1,0,1.1115310228308472e-05,0.0,1.0
47004,because/Alpha,1,1,0,1.1115310228308472e-05,0.0,1.0
47005,채은/Noun,1,1,0,1.1115310228308472e-05,0.0,1.0
47006,쿠션/Noun,1,1,0,1.1115310228308472e-05,0.0,1.0
47007,퍽퍽퍽/Noun,1,0,1,0.0,1.1106915165381966e-05,1.0
47008,휴스톤/Noun,1,1,0,1.1115310228308472e-05,0.0,1.0
47009,이승엽/Noun,1,1,0,1.1115310228308472e-05,0.0,1.0
47010,편두/Noun,1,1,0,1.1115310228308472e-05,0.0,1.0
47011,3.9/Number,1,1,0,1.1115310228308472e-05,0.0,1.0
47012,다봣네/Noun,1,1,0,1.1115310228308472e-05,0.0,1.0
47013,논놈/Noun,1,0,1,0.0,1.1106915165381966e-05,1.0
47014,눈건/Noun,1,0,1,0.0,1.1106915165381966e-05,1.0
47015,윤두수/Noun,1,1,0,1.1115310228308472e-05,0.0,1.0
47016,점외/Noun,1,0,1,0.0,1.1106915165381966e-05,1.0
47017,간버틸수가있을까/Foreign,1,0,1,0.0,1.1106915165381966e-05,1.0
47018,조됫/Noun,1,0,1,0.0,1.1106915165381966e-05,1.0
47019,뒤면/Foreign,1,0,1,0.0,1.1106915165381966e-05,1.0
47020,대표이사/Noun,1,0,1,0.0,1.1106915165381966e-05,1.0
47021,양유진/Noun,1,0,1,0.0,1.1106915165381966e-05,1.0
47022,음속/Noun,1,1,0,1.1115310228308472e-05,0.0,1.0
47023,디아지오/Noun,1,0,1,0.0,1.1106915165381966e-05,1.0
47024,20~30/Number,1,1,0,1.1115310228308472e-05,0.0,1.0
47025,빠쪄버림/Noun,1,1,0,1.1115310228308472e-05,0.0,1.0
47026,반출/Noun,1,0,1,0.0,1.1106915165381966e-05,1.0
47027,베스티/Noun,1,0,1,0.0,1.1106915165381966e-05,1.0
47028,헬로비너스/Noun,1,0,1,0.0,1.1106915165381966e-05,1.0
47029,뉴이스트/Noun,1,0,1,0.0,1.1106915165381966e-05,1.0
47030,쫄바지/Noun,1,0,1,0.0,1.1106915165381966e-05,1.0
47031,북부/Noun,1,1,0,1.1115310228308472e-05,0.0,1.0
47032,ㅇㅒ/KoreanParticle,1,0,1,0.0,1.1106915165381966e-05,1.0
47033,피더/Noun,1,0,1,0.0,1.1106915165381966e-05,1.0
47034,쩌고/Noun,1,0,1,0.0,1.1106915165381966e-05,1.0
47035,국문학/Noun,1,1,0,1.1115310228308472e-05,0.0,1.0
47036,해를품은달/Noun,1,0,1,0.0,1.1106915165381966e-05,1.0
47037,어린냔/Noun,1,0,1,0.0,1.1106915165381966e-05,1.0
47038,왜만들엇을까/Noun,1,0,1,0.0,1.1106915165381966e-05,1.0
47039,가명/Noun,1,0,1,0.0,1.1106915165381966e-05,1.0
47040,너드/Noun,1,1,0,1.1115310228308472e-05,0.0,1.0
47041,임윤택/Noun,1,1,0,1.1115310228308472e-05,0.0,1.0
47042,성호경/Noun,1,1,0,1.1115310228308472e-05,0.0,1.0
47043,권현상/Noun,1,1,0,1.1115310228308472e-05,0.0,1.0
47044,트랜디/Noun,1,0,1,0.0,1.1106915165381966e-05,1.0
47045,뭉개지/Noun,1,0,1,0.0,1.1106915165381966e-05,1.0
47046,파라오/Noun,1,1,0,1.1115310228308472e-05,0.0,1.0
47047,화채/Noun,1,0,1,0.0,1.1106915165381966e-05,1.0
47048,급/Foreign,1,0,1,0.0,1.1106915165381966e-05,1.0
47049,crying/Alpha,1,1,0,1.1115310228308472e-05,0.0,1.0
47050,``;/Punctuation,1,1,0,1.1115310228308472e-05,0.0,1.0
47051,회망/Noun,1,1,0,1.1115310228308472e-05,0.0,1.0
47052,인이/Foreign,1,1,0,1.1115310228308472e-05,0.0,1.0
47053,썬데이/Noun,1,0,1,0.0,1.1106915165381966e-05,1.0
47054,버살/Noun,1,1,0,1.1115310228308472e-05,0.0,1.0
47055,ㅂㅂㅂㄱ/KoreanParticle,1,0,1,0.0,1.1106915165381966e-05,1.0
47056,애새/Noun,1,0,1,0.0,1.1106915165381966e-05,1.0
47057,mattina/Alpha,1,1,0,1.1115310228308472e-05,0.0,1.0
47058,una/Alpha,1,1,0,1.1115310228308472e-05,0.0,1.0
47059,엑싯/Noun,1,1,0,1.1115310228308472e-05,0.0,1.0
47060,삶의/Noun,1,1,0,1.1115310228308472e-05,0.0,1.0
47061,。！/Foreign,1,1,0,1.1115310228308472e-05,0.0,1.0
47062,봤슴돠/Noun,1,1,0,1.1115310228308472e-05,0.0,1.0
47063,뒺것내/Noun,1,0,1,0.0,1.1106915165381966e-05,1.0
47064,독소/Noun,1,1,0,1.1115310228308472e-05,0.0,1.0
47065,엄습/Noun,1,1,0,1.1115310228308472e-05,0.0,1.0
47066,결선/Noun,1,0,1,0.0,1.1106915165381966e-05,1.0
47067,합의/Noun,1,0,1,0.0,1.1106915165381966e-05,1.0
47068,http://blog.naver.com/esedae/220158013943/URL,1,0,1,0.0,1.1106915165381966e-05,1.0
47069,금문교/Noun,1,1,0,1.1115310228308472e-05,0.0,1.0
47070,정사인/Noun,1,0,1,0.0,1.1106915165381966e-05,1.0
47071,최거/Noun,1,1,0,1.1115310228308472e-05,0.0,1.0
47072,산란하다/Adjective,1,0,1,0.0,1.1106915165381966e-05,1.0
47073,vip/Alpha,1,0,1,0.0,1.1106915165381966e-05,1.0
47074,방탕하다/Adjective,1,0,1,0.0,1.1106915165381966e-05,1.0
47075,매틱/Noun,1,0,1,0.0,1.1106915165381966e-05,1.0
47076,2050년/Number,1,1,0,1.1115310228308472e-05,0.0,1.0
47077,빙벽/Noun,1,1,0,1.1115310228308472e-05,0.0,1.0
47078,영리/Noun,1,1,0,1.1115310228308472e-05,0.0,1.0
47079,코박/Noun,1,0,1,0.0,1.1106915165381966e-05,1.0
47080,빙해/Noun,1,0,1,0.0,1.1106915165381966e-05,1.0
47081,동요/Noun,1,0,1,0.0,1.1106915165381966e-05,1.0
47082,머독/Noun,1,1,0,1.1115310228308472e-05,0.0,1.0
47083,lilyoulil/Alpha,1,1,0,1.1115310228308472e-05,0.0,1.0
47084,꼬매/Noun,1,0,1,0.0,1.1106915165381966e-05,1.0
47085,뒤지겄내/Noun,1,1,0,1.1115310228308472e-05,0.0,1.0
47086,상생/Noun,1,1,0,1.1115310228308472e-05,0.0,1.0
47087,타마코마켓/Noun,1,1,0,1.1115310228308472e-05,0.0,1.0
47088,토쿄/Noun,1,1,0,1.1115310228308472e-05,0.0,1.0
47089,추억의영화/Foreign,1,1,0,1.1115310228308472e-05,0.0,1.0
47090,핵가족/Noun,1,0,1,0.0,1.1106915165381966e-05,1.0
47091,..;;;;;;/Punctuation,1,0,1,0.0,1.1106915165381966e-05,1.0
47092,진로소주/Noun,1,1,0,1.1115310228308472e-05,0.0,1.0
47093,*^^~./Punctuation,1,1,0,1.1115310228308472e-05,0.0,1.0
47094,/?/Punctuation,1,1,0,1.1115310228308472e-05,0.0,1.0
47095,헷징/Noun,1,0,1,0.0,1.1106915165381966e-05,1.0
47096,봣는데/Foreign,1,0,1,0.0,1.1106915165381966e-05,1.0
47097,떙기/Noun,1,0,1,0.0,1.1106915165381966e-05,1.0
47098,유열/Noun,1,0,1,0.0,1.1106915165381966e-05,1.0
47099,모래밭/Noun,1,1,0,1.1115310228308472e-05,0.0,1.0
47100,핫팬츠/Noun,1,0,1,0.0,1.1106915165381966e-05,1.0
47101,~~~^^*/Punctuation,1,1,0,1.1115310228308472e-05,0.0,1.0
47102,예사롭다/Adjective,1,1,0,1.1115310228308472e-05,0.0,1.0
47103,이삼/Noun,1,0,1,0.0,1.1106915165381966e-05,1.0
47104,아웃도어/Noun,1,0,1,0.0,1.1106915165381966e-05,1.0
47105,헤타리아/Noun,1,0,1,0.0,1.1106915165381966e-05,1.0
47106,암벽/Noun,1,0,1,0.0,1.1106915165381966e-05,1.0
47107,과민성/Noun,1,0,1,0.0,1.1106915165381966e-05,1.0
47108,매점/Noun,1,0,1,0.0,1.1106915165381966e-05,1.0
47109,마오쩌둥/Noun,1,1,0,1.1115310228308472e-05,0.0,1.0
47110,숀빈때문/Noun,1,1,0,1.1115310228308472e-05,0.0,1.0
47111,자트/Noun,1,0,1,0.0,1.1106915165381966e-05,1.0
47112,바터/Noun,1,0,1,0.0,1.1106915165381966e-05,1.0
47113,퍽덕/Noun,1,0,1,0.0,1.1106915165381966e-05,1.0
47114,뚜르/Noun,1,0,1,0.0,1.1106915165381966e-05,1.0
47115,파닥/Adverb,1,0,1,0.0,1.1106915165381966e-05,1.0
47116,푸드드/Adverb,1,0,1,0.0,1.1106915165381966e-05,1.0
47117,쿠득/Noun,1,0,1,0.0,1.1106915165381966e-05,1.0
47118,뽀드득/Noun,1,0,1,0.0,1.1106915165381966e-05,1.0
47119,뿌우우웅/Noun,1,0,1,0.0,1.1106915165381966e-05,1.0
47120,욜랭드/Noun,1,1,0,1.1115310228308472e-05,0.0,1.0
47121,똥때/Noun,1,1,0,1.1115310228308472e-05,0.0,1.0
47122,쟈밌어/Noun,1,1,0,1.1115310228308472e-05,0.0,1.0
47123,서쪽/Noun,1,0,1,0.0,1.1106915165381966e-05,1.0
47124,"....,,,/Punctuation",1,0,1,0.0,1.1106915165381966e-05,1.0
47125,유속/Noun,1,1,0,1.1115310228308472e-05,0.0,1.0
47126,퀄리티면/Noun,1,1,0,1.1115310228308472e-05,0.0,1.0
47127,서초동/Noun,1,1,0,1.1115310228308472e-05,0.0,1.0
47128,싖싖/Noun,1,0,1,0.0,1.1106915165381966e-05,1.0
47129,ㄱㄱㄷ/KoreanParticle,1,0,1,0.0,1.1106915165381966e-05,1.0
47130,로잼/Noun,1,0,1,0.0,1.1106915165381966e-05,1.0
47131,뱀독/Noun,1,0,1,0.0,1.1106915165381966e-05,1.0
47132,뻘뻘/Noun,1,1,0,1.1115310228308472e-05,0.0,1.0
47133,캐머론/Noun,1,1,0,1.1115310228308472e-05,0.0,1.0
47134,슬펏네/Noun,1,1,0,1.1115310228308472e-05,0.0,1.0
47135,튜거뇾/Noun,1,0,1,0.0,1.1106915165381966e-05,1.0
47136,청포도/Noun,1,1,0,1.1115310228308472e-05,0.0,1.0
47137,그특유/Noun,1,1,0,1.1115310228308472e-05,0.0,1.0
47138,",,,;;;/Punctuation",1,1,0,1.1115310228308472e-05,0.0,1.0
47139,최재환/Noun,1,0,1,0.0,1.1106915165381966e-05,1.0
47140,불응/Noun,1,0,1,0.0,1.1106915165381966e-05,1.0
47141,피어슨/Noun,1,0,1,0.0,1.1106915165381966e-05,1.0
47142,Galore/Alpha,1,0,1,0.0,1.1106915165381966e-05,1.0
47143,Kitty/Alpha,1,0,1,0.0,1.1106915165381966e-05,1.0
47144,Revenge/Alpha,1,0,1,0.0,1.1106915165381966e-05,1.0
47145,Dogs/Alpha,1,0,1,0.0,1.1106915165381966e-05,1.0
47146,Cats/Alpha,1,0,1,0.0,1.1106915165381966e-05,1.0
47147,쥐치/Noun,1,1,0,1.1115310228308472e-05,0.0,1.0
47148,5/22일/Number,1,0,1,0.0,1.1106915165381966e-05,1.0
47149,ㅎㅎㄹ/KoreanParticle,1,0,1,0.0,1.1106915165381966e-05,1.0
47150,스크린도어/Noun,1,1,0,1.1115310228308472e-05,0.0,1.0
47151,박진주/Noun,1,1,0,1.1115310228308472e-05,0.0,1.0
47152,자유시간/Noun,1,1,0,1.1115310228308472e-05,0.0,1.0
47153,자유여행/Noun,1,1,0,1.1115310228308472e-05,0.0,1.0
47154,bbbbbbbbbbbbbbbbbbbb/Alpha,1,1,0,1.1115310228308472e-05,0.0,1.0
47155,fxxxxk/Alpha,1,0,1,0.0,1.1106915165381966e-05,1.0
47156,뻐겻으/Noun,1,0,1,0.0,1.1106915165381966e-05,1.0
47157,ㅕㅇ/KoreanParticle,1,1,0,1.1115310228308472e-05,0.0,1.0
47158,로예/Noun,1,0,1,0.0,1.1106915165381966e-05,1.0
47159,스페인내전/Noun,1,1,0,1.1115310228308472e-05,0.0,1.0
47160,로르카/Noun,1,0,1,0.0,1.1106915165381966e-05,1.0
47161,낚기위/Noun,1,0,1,0.0,1.1106915165381966e-05,1.0
47162,심장쫄깃해/Noun,1,1,0,1.1115310228308472e-05,0.0,1.0
47163,그리스인/Noun,1,0,1,0.0,1.1106915165381966e-05,1.0
47164,마족/Noun,1,0,1,0.0,1.1106915165381966e-05,1.0
47165,천인사/Noun,1,1,0,1.1115310228308472e-05,0.0,1.0
47166,조어장부/Noun,1,1,0,1.1115310228308472e-05,0.0,1.0
47167,무상사/Noun,1,1,0,1.1115310228308472e-05,0.0,1.0
47168,세간해/Noun,1,1,0,1.1115310228308472e-05,0.0,1.0
47169,선서/Noun,1,1,0,1.1115310228308472e-05,0.0,1.0
47170,명행족/Noun,1,1,0,1.1115310228308472e-05,0.0,1.0
47171,정변지/Noun,1,1,0,1.1115310228308472e-05,0.0,1.0
47172,응공/Noun,1,1,0,1.1115310228308472e-05,0.0,1.0
47173,여래/Noun,1,1,0,1.1115310228308472e-05,0.0,1.0
47174,도영화였던가/Foreign,1,0,1,0.0,1.1106915165381966e-05,1.0
47175,낚였거/Noun,1,0,1,0.0,1.1106915165381966e-05,1.0
47176,쇠뭉둥/Noun,1,0,1,0.0,1.1106915165381966e-05,1.0
47177,인기척/Noun,1,0,1,0.0,1.1106915165381966e-05,1.0
47178,ioi/Alpha,1,1,0,1.1115310228308472e-05,0.0,1.0
47179,Leo/Alpha,1,1,0,1.1115310228308472e-05,0.0,1.0
47180,소진/Noun,1,0,1,0.0,1.1106915165381966e-05,1.0
47181,롯시/Noun,1,0,1,0.0,1.1106915165381966e-05,1.0
47182,캐미쩌네/Noun,1,1,0,1.1115310228308472e-05,0.0,1.0
47183,~!~!~!~!/Punctuation,1,1,0,1.1115310228308472e-05,0.0,1.0
47184,솜방망이/Noun,1,1,0,1.1115310228308472e-05,0.0,1.0
47185,놈현/Noun,1,0,1,0.0,1.1106915165381966e-05,1.0
47186,군발이/Noun,1,1,0,1.1115310228308472e-05,0.0,1.0
47187,번편/Noun,1,1,0,1.1115310228308472e-05,0.0,1.0
47188,어금니/Noun,1,1,0,1.1115310228308472e-05,0.0,1.0
47189,해밋/Noun,1,0,1,0.0,1.1106915165381966e-05,1.0
47190,뚜루뚜루/Noun,1,1,0,1.1115310228308472e-05,0.0,1.0
47191,해이해이/Noun,1,1,0,1.1115310228308472e-05,0.0,1.0
47192,산인거지/Foreign,1,0,1,0.0,1.1106915165381966e-05,1.0
47193,낚아서/Noun,1,0,1,0.0,1.1106915165381966e-05,1.0
47194,그리스신화/Noun,1,0,1,0.0,1.1106915165381966e-05,1.0
47195,갱년기/Noun,1,0,1,0.0,1.1106915165381966e-05,1.0
47196,못건/Noun,1,0,1,0.0,1.1106915165381966e-05,1.0
47197,음심/Noun,1,0,1,0.0,1.1106915165381966e-05,1.0
47198,shoe/Alpha,1,0,1,0.0,1.1106915165381966e-05,1.0
47199,고어무비/Noun,1,0,1,0.0,1.1106915165381966e-05,1.0
47200,잔악/Noun,1,1,0,1.1115310228308472e-05,0.0,1.0
47201,여동안/Foreign,1,0,1,0.0,1.1106915165381966e-05,1.0
47202,ㄷㅋㄷ/KoreanParticle,1,0,1,0.0,1.1106915165381966e-05,1.0
47203,났였넼/Noun,1,0,1,0.0,1.1106915165381966e-05,1.0
47204,용덕/Noun,1,0,1,0.0,1.1106915165381966e-05,1.0
47205,뽀통령/Noun,1,1,0,1.1115310228308472e-05,0.0,1.0
47206,카이바/Noun,1,0,1,0.0,1.1106915165381966e-05,1.0
47207,초키초키/Noun,1,1,0,1.1115310228308472e-05,0.0,1.0
47208,````/Punctuation,1,0,1,0.0,1.1106915165381966e-05,1.0
47209,연예인병/Noun,1,0,1,0.0,1.1106915165381966e-05,1.0
47210,부락/Noun,1,1,0,1.1115310228308472e-05,0.0,1.0
47211,추중/Noun,1,1,0,1.1115310228308472e-05,0.0,1.0
47212,돈더/Noun,1,0,1,0.0,1.1106915165381966e-05,1.0
47213,뻥킹/Noun,1,0,1,0.0,1.1106915165381966e-05,1.0
47214,가마치/Noun,1,0,1,0.0,1.1106915165381966e-05,1.0
47215,등하교/Noun,1,1,0,1.1115310228308472e-05,0.0,1.0
47216,작은방/Noun,1,1,0,1.1115310228308472e-05,0.0,1.0
47217,미칭/Noun,1,1,0,1.1115310228308472e-05,0.0,1.0
47218,학수고대/Noun,1,1,0,1.1115310228308472e-05,0.0,1.0
47219,ㅏㅊ/KoreanParticle,1,0,1,0.0,1.1106915165381966e-05,1.0
47220,카반/Noun,1,1,0,1.1115310228308472e-05,0.0,1.0
47221,심장쫄리/Noun,1,1,0,1.1115310228308472e-05,0.0,1.0
47222,왕치/Noun,1,1,0,1.1115310228308472e-05,0.0,1.0
47223,스턀/Noun,1,0,1,0.0,1.1106915165381966e-05,1.0
47224,호오/Noun,1,1,0,1.1115310228308472e-05,0.0,1.0
47225,읇조리/Noun,1,0,1,0.0,1.1106915165381966e-05,1.0
47226,중경상/Noun,1,0,1,0.0,1.1106915165381966e-05,1.0
47227,OOOOO/Alpha,1,0,1,0.0,1.1106915165381966e-05,1.0
47228,!.?./Punctuation,1,0,1,0.0,1.1106915165381966e-05,1.0
47229,"...@,.@/Punctuation",1,0,1,0.0,1.1106915165381966e-05,1.0
47230,짜잉난다/Noun,1,0,1,0.0,1.1106915165381966e-05,1.0
47231,돌라/Noun,1,1,0,1.1115310228308472e-05,0.0,1.0
47232,빈더/Noun,1,1,0,1.1115310228308472e-05,0.0,1.0
47233,빌렷던/Noun,1,1,0,1.1115310228308472e-05,0.0,1.0
47234,오바쩔긔/Noun,1,0,1,0.0,1.1106915165381966e-05,1.0
47235,츠루/Noun,1,1,0,1.1115310228308472e-05,0.0,1.0
47236,볼게없엇음/Noun,1,0,1,0.0,1.1106915165381966e-05,1.0
47237,생화/Noun,1,0,1,0.0,1.1106915165381966e-05,1.0
47238,겔럭티카/Noun,1,1,0,1.1115310228308472e-05,0.0,1.0
47239,위생/Noun,1,0,1,0.0,1.1106915165381966e-05,1.0
47240,펑점미침/Noun,1,0,1,0.0,1.1106915165381966e-05,1.0
47241,84/Number,1,0,1,0.0,1.1106915165381966e-05,1.0
47242,유원상/Noun,1,1,0,1.1115310228308472e-05,0.0,1.0
47243,문숙/Noun,1,1,0,1.1115310228308472e-05,0.0,1.0
47244,알카포네/Noun,1,1,0,1.1115310228308472e-05,0.0,1.0
47245,미홍/Noun,1,1,0,1.1115310228308472e-05,0.0,1.0
47246,애들립/Noun,1,0,1,0.0,1.1106915165381966e-05,1.0
47247,백수남편/Noun,1,0,1,0.0,1.1106915165381966e-05,1.0
47248,새뮤얼/Noun,1,0,1,0.0,1.1106915165381966e-05,1.0
47249,222222222222/Number,1,0,1,0.0,1.1106915165381966e-05,1.0
47250,남정/Noun,1,0,1,0.0,1.1106915165381966e-05,1.0
47251,。★/Foreign,1,1,0,1.1115310228308472e-05,0.0,1.0
47252,존망/Noun,1,0,1,0.0,1.1106915165381966e-05,1.0
47253,임꼭/Noun,1,1,0,1.1115310228308472e-05,0.0,1.0
47254,김재현/Noun,1,1,0,1.1115310228308472e-05,0.0,1.0
47255,이시언/Noun,1,1,0,1.1115310228308472e-05,0.0,1.0
47256,점투/Noun,1,0,1,0.0,1.1106915165381966e-05,1.0
47257,대초반것들이/Foreign,1,1,0,1.1115310228308472e-05,0.0,1.0
47258,90~2000년/Number,1,1,0,1.1115310228308472e-05,0.0,1.0
47259,합방/Noun,1,0,1,0.0,1.1106915165381966e-05,1.0
47260,청일전쟁/Noun,1,0,1,0.0,1.1106915165381966e-05,1.0
47261,동학혁명/Noun,1,0,1,0.0,1.1106915165381966e-05,1.0
47262,임오군란/Noun,1,0,1,0.0,1.1106915165381966e-05,1.0
47263,웍투/Noun,1,0,1,0.0,1.1106915165381966e-05,1.0
47264,有害無益/Foreign,1,0,1,0.0,1.1106915165381966e-05,1.0
47265,폐물/Noun,1,0,1,0.0,1.1106915165381966e-05,1.0
47266,잔재/Noun,1,0,1,0.0,1.1106915165381966e-05,1.0
47267,챙년/Noun,1,0,1,0.0,1.1106915165381966e-05,1.0
47268,NASA/Alpha,1,0,1,0.0,1.1106915165381966e-05,1.0
47269,이뻐욤/Noun,1,1,0,1.1115310228308472e-05,0.0,1.0
47270,이여름/Noun,1,1,0,1.1115310228308472e-05,0.0,1.0
47271,소모전/Noun,1,0,1,0.0,1.1106915165381966e-05,1.0
47272,ADHF/Alpha,1,0,1,0.0,1.1106915165381966e-05,1.0
47273,프리티우먼/Noun,1,0,1,0.0,1.1106915165381966e-05,1.0
47274,석훈/Noun,1,0,1,0.0,1.1106915165381966e-05,1.0
47275,dogs/Alpha,1,0,1,0.0,1.1106915165381966e-05,1.0
47276,엄한듯/Noun,1,1,0,1.1115310228308472e-05,0.0,1.0
47277,블락비/Noun,1,1,0,1.1115310228308472e-05,0.0,1.0
47278,Block/Alpha,1,1,0,1.1115310228308472e-05,0.0,1.0
47279,wanna/Alpha,1,1,0,1.1115310228308472e-05,0.0,1.0
47280,8.15/Number,1,0,1,0.0,1.1106915165381966e-05,1.0
47281,니뽄류/Noun,1,0,1,0.0,1.1106915165381966e-05,1.0
47282,레어임/Noun,1,1,0,1.1115310228308472e-05,0.0,1.0
47283,퓨마/Noun,1,0,1,0.0,1.1106915165381966e-05,1.0
47284,압니다/Noun,1,0,1,0.0,1.1106915165381966e-05,1.0
47285,베르베르/Noun,1,0,1,0.0,1.1106915165381966e-05,1.0
47286,베르나르/Noun,1,0,1,0.0,1.1106915165381966e-05,1.0
47287,헐랭/Noun,1,0,1,0.0,1.1106915165381966e-05,1.0
47288,이수윤/Noun,1,1,0,1.1115310228308472e-05,0.0,1.0
47289,맹탕이더/Noun,1,0,1,0.0,1.1106915165381966e-05,1.0
47290,웅웅웅/Noun,1,0,1,0.0,1.1106915165381966e-05,1.0
47291,웅치기웅/Noun,1,0,1,0.0,1.1106915165381966e-05,1.0
47292,대륙판/Noun,1,0,1,0.0,1.1106915165381966e-05,1.0
47293,필스/Noun,1,1,0,1.1115310228308472e-05,0.0,1.0
47294,엮겨움/Noun,1,0,1,0.0,1.1106915165381966e-05,1.0
47295,주륜걸/Noun,1,0,1,0.0,1.1106915165381966e-05,1.0
47296,"..^.,^~~/Punctuation",1,1,0,1.1115310228308472e-05,0.0,1.0
47297,떡을치드/Noun,1,0,1,0.0,1.1106915165381966e-05,1.0
47298,훨난듯/Noun,1,0,1,0.0,1.1106915165381966e-05,1.0
47299,?~~~/Punctuation,1,0,1,0.0,1.1106915165381966e-05,1.0
47300,짐승남/Noun,1,0,1,0.0,1.1106915165381966e-05,1.0
47301,꾸몃는데/Noun,1,1,0,1.1115310228308472e-05,0.0,1.0
47302,전두엽/Noun,1,1,0,1.1115310228308472e-05,0.0,1.0
47303,슈거/Noun,1,0,1,0.0,1.1106915165381966e-05,1.0
47304,이앋/Noun,1,1,0,1.1115310228308472e-05,0.0,1.0
47305,제갈공명/Noun,1,1,0,1.1115310228308472e-05,0.0,1.0
47306,시무라/Noun,1,1,0,1.1115310228308472e-05,0.0,1.0
47307,제구/Noun,1,1,0,1.1115310228308472e-05,0.0,1.0
47308,난나/Noun,1,1,0,1.1115310228308472e-05,0.0,1.0
47309,었는/Noun,1,0,1,0.0,1.1106915165381966e-05,1.0
47310,Scene/Alpha,1,0,1,0.0,1.1106915165381966e-05,1.0
47311,황군/Noun,1,0,1,0.0,1.1106915165381966e-05,1.0
47312,꾸르뀨르/Noun,1,0,1,0.0,1.1106915165381966e-05,1.0
47313,피규업/Noun,1,0,1,0.0,1.1106915165381966e-05,1.0
47314,꼼빠뇽/Noun,1,1,0,1.1115310228308472e-05,0.0,1.0
47315,돈좀벌/Noun,1,0,1,0.0,1.1106915165381966e-05,1.0
47316,컨버터블/Noun,1,0,1,0.0,1.1106915165381966e-05,1.0
47317,MG/Alpha,1,0,1,0.0,1.1106915165381966e-05,1.0
47318,재방또햇/Noun,1,1,0,1.1115310228308472e-05,0.0,1.0
47319,붇히다/Noun,1,1,0,1.1115310228308472e-05,0.0,1.0
47320,볍씨/Noun,1,0,1,0.0,1.1106915165381966e-05,1.0
47321,불짜리/Foreign,1,0,1,0.0,1.1106915165381966e-05,1.0
47322,6천/Number,1,0,1,0.0,1.1106915165381966e-05,1.0
47323,스페인영화/Noun,1,0,1,0.0,1.1106915165381966e-05,1.0
47324,컨샘/Noun,1,0,1,0.0,1.1106915165381966e-05,1.0
47325,pack/Alpha,1,1,0,1.1115310228308472e-05,0.0,1.0
47326,wolf/Alpha,1,1,0,1.1115310228308472e-05,0.0,1.0
47327,Such/Alpha,1,1,0,1.1115310228308472e-05,0.0,1.0
47328,mmm/Alpha,1,1,0,1.1115310228308472e-05,0.0,1.0
47329,핑민/Noun,1,1,0,1.1115310228308472e-05,0.0,1.0
47330,않봣는데/Noun,1,1,0,1.1115310228308472e-05,0.0,1.0
47331,잠들엇음/Noun,1,0,1,0.0,1.1106915165381966e-05,1.0
47332,바헌/Noun,1,0,1,0.0,1.1106915165381966e-05,1.0
47333,~~^^^/Punctuation,1,1,0,1.1115310228308472e-05,0.0,1.0
47334,초반의/Foreign,1,0,1,0.0,1.1106915165381966e-05,1.0
47335,또섹섹거리/Noun,1,0,1,0.0,1.1106915165381966e-05,1.0
47336,봐야핦/Noun,1,1,0,1.1115310228308472e-05,0.0,1.0
47337,소같은/Foreign,1,0,1,0.0,1.1106915165381966e-05,1.0
47338,윤대/Noun,1,0,1,0.0,1.1106915165381966e-05,1.0
47339,동의어/Noun,1,0,1,0.0,1.1106915165381966e-05,1.0
47340,발병/Noun,1,1,0,1.1115310228308472e-05,0.0,1.0
47341,콧구녕봐/Noun,1,0,1,0.0,1.1106915165381966e-05,1.0
47342,지현수/Noun,1,0,1,0.0,1.1106915165381966e-05,1.0
47343,크래프트/Noun,1,0,1,0.0,1.1106915165381966e-05,1.0
47344,서당/Noun,1,0,1,0.0,1.1106915165381966e-05,1.0
47345,~!../Punctuation,1,0,1,0.0,1.1106915165381966e-05,1.0
47346,180%/Number,1,1,0,1.1115310228308472e-05,0.0,1.0
47347,인드라망/Noun,1,1,0,1.1115310228308472e-05,0.0,1.0
47348,정도될거다/Foreign,1,1,0,1.1115310228308472e-05,0.0,1.0
47349,이버/Noun,1,0,1,0.0,1.1106915165381966e-05,1.0
47350,새낔/Noun,1,0,1,0.0,1.1106915165381966e-05,1.0
47351,청장/Noun,1,1,0,1.1115310228308472e-05,0.0,1.0
47352,유미영/Noun,1,1,0,1.1115310228308472e-05,0.0,1.0
47353,꼬꾸라지다/Verb,1,0,1,0.0,1.1106915165381966e-05,1.0
47354,이사오/Noun,1,1,0,1.1115310228308472e-05,0.0,1.0
47355,하타/Noun,1,1,0,1.1115310228308472e-05,0.0,1.0
47356,앤딩노/Noun,1,1,0,1.1115310228308472e-05,0.0,1.0
47357,수천수만/Modifier,1,1,0,1.1115310228308472e-05,0.0,1.0
47358,과실치사/Noun,1,1,0,1.1115310228308472e-05,0.0,1.0
47359,"...,,.,,,......./Punctuation",1,0,1,0.0,1.1106915165381966e-05,1.0
47360,수포/Noun,1,0,1,0.0,1.1106915165381966e-05,1.0
47361,일찌/Noun,1,0,1,0.0,1.1106915165381966e-05,1.0
47362,띠껍/Noun,1,0,1,0.0,1.1106915165381966e-05,1.0
47363,장황/Noun,1,0,1,0.0,1.1106915165381966e-05,1.0
47364,웰러/Noun,1,1,0,1.1115310228308472e-05,0.0,1.0
47365,맹숭/Noun,1,0,1,0.0,1.1106915165381966e-05,1.0
47366,싱숭생숭/Noun,1,0,1,0.0,1.1106915165381966e-05,1.0
47367,언하/Noun,1,0,1,0.0,1.1106915165381966e-05,1.0
47368,How/Alpha,1,1,0,1.1115310228308472e-05,0.0,1.0
47369,감잡히다/Verb,1,0,1,0.0,1.1106915165381966e-05,1.0
47370,입견/Noun,1,1,0,1.1115310228308472e-05,0.0,1.0
47371,의선/Noun,1,1,0,1.1115310228308472e-05,0.0,1.0
47372,잠지/Noun,1,0,1,0.0,1.1106915165381966e-05,1.0
47373,핸폰문자/Noun,1,1,0,1.1115310228308472e-05,0.0,1.0
47374,짊어질/Noun,1,1,0,1.1115310228308472e-05,0.0,1.0
47375,쟁재/Noun,1,1,0,1.1115310228308472e-05,0.0,1.0
47376,떌수/Noun,1,1,0,1.1115310228308472e-05,0.0,1.0
47377,소만/Noun,1,0,1,0.0,1.1106915165381966e-05,1.0
47378,치옥/Noun,1,1,0,1.1115310228308472e-05,0.0,1.0
47379,신승수/Noun,1,0,1,0.0,1.1106915165381966e-05,1.0
47380,똥배/Noun,1,1,0,1.1115310228308472e-05,0.0,1.0
47381,하룡/Noun,1,0,1,0.0,1.1106915165381966e-05,1.0
47382,꾹뀩/Noun,1,0,1,0.0,1.1106915165381966e-05,1.0
47383,~!!~!~/Punctuation,1,0,1,0.0,1.1106915165381966e-05,1.0
47384,반짝거리다/Verb,1,0,1,0.0,1.1106915165381966e-05,1.0
47385,콘론/Noun,1,1,0,1.1115310228308472e-05,0.0,1.0
47386,뷰욕/Noun,1,1,0,1.1115310228308472e-05,0.0,1.0
47387,릴해/Noun,1,0,1,0.0,1.1106915165381966e-05,1.0
47388,갘/Noun,1,1,0,1.1115310228308472e-05,0.0,1.0
47389,인명구조/Noun,1,0,1,0.0,1.1106915165381966e-05,1.0
47390,이경기/Noun,1,0,1,0.0,1.1106915165381966e-05,1.0
47391,만뒤쳐져도꼴등인/Foreign,1,0,1,0.0,1.1106915165381966e-05,1.0
47392,앞서가면/Foreign,1,0,1,0.0,1.1106915165381966e-05,1.0
47393,우생학/Noun,1,0,1,0.0,1.1106915165381966e-05,1.0
47394,눈초롱/Noun,1,1,0,1.1115310228308472e-05,0.0,1.0
47395,윔홀/Noun,1,1,0,1.1115310228308472e-05,0.0,1.0
47396,게임광/Noun,1,0,1,0.0,1.1106915165381966e-05,1.0
47397,UK/Alpha,1,1,0,1.1115310228308472e-05,0.0,1.0
47398,baks/Alpha,1,1,0,1.1115310228308472e-05,0.0,1.0
47399,..!!!!!/Punctuation,1,1,0,1.1115310228308472e-05,0.0,1.0
47400,쫄았다/Noun,1,1,0,1.1115310228308472e-05,0.0,1.0
47401,봤습닌/Noun,1,1,0,1.1115310228308472e-05,0.0,1.0
47402,갈건/Noun,1,1,0,1.1115310228308472e-05,0.0,1.0
47403,릴로/Noun,1,1,0,1.1115310228308472e-05,0.0,1.0
47404,정도만보고/Foreign,1,0,1,0.0,1.1106915165381966e-05,1.0
47405,Bella/Alpha,1,1,0,1.1115310228308472e-05,0.0,1.0
47406,Vita/Alpha,1,1,0,1.1115310228308472e-05,0.0,1.0
47407,대이전은/Foreign,1,0,1,0.0,1.1106915165381966e-05,1.0
47408,코놀/Noun,1,1,0,1.1115310228308472e-05,0.0,1.0
47409,이해고/Noun,1,0,1,0.0,1.1106915165381966e-05,1.0
47410,잼썻음굿굿/Noun,1,1,0,1.1115310228308472e-05,0.0,1.0
47411,원우/Noun,1,1,0,1.1115310228308472e-05,0.0,1.0
47412,루치아노/Noun,1,1,0,1.1115310228308472e-05,0.0,1.0
47413,명를/Noun,1,0,1,0.0,1.1106915165381966e-05,1.0
47414,테크니컬/Noun,1,0,1,0.0,1.1106915165381966e-05,1.0
47415,????.????./Punctuation,1,0,1,0.0,1.1106915165381966e-05,1.0
47416,두갈/Noun,1,0,1,0.0,1.1106915165381966e-05,1.0
47417,꿰찬/Noun,1,0,1,0.0,1.1106915165381966e-05,1.0
47418,어려웡/Noun,1,0,1,0.0,1.1106915165381966e-05,1.0
47419,꼬시기/Noun,1,0,1,0.0,1.1106915165381966e-05,1.0
47420,이십/Noun,1,1,0,1.1115310228308472e-05,0.0,1.0
47421,조류독감/Noun,1,0,1,0.0,1.1106915165381966e-05,1.0
47422,승헌/Noun,1,1,0,1.1115310228308472e-05,0.0,1.0
47423,다봣/Noun,1,0,1,0.0,1.1106915165381966e-05,1.0
47424,피기스/Noun,1,0,1,0.0,1.1106915165381966e-05,1.0
47425,제드/Noun,1,0,1,0.0,1.1106915165381966e-05,1.0
47426,맛없슴/Noun,1,0,1,0.0,1.1106915165381966e-05,1.0
47427,되엇어/Noun,1,1,0,1.1115310228308472e-05,0.0,1.0
47428,범죄씬/Noun,1,1,0,1.1115310228308472e-05,0.0,1.0
47429,짝코/Noun,1,0,1,0.0,1.1106915165381966e-05,1.0
47430,드뷔시/Noun,1,1,0,1.1115310228308472e-05,0.0,1.0
47431,몽구스/Noun,1,1,0,1.1115310228308472e-05,0.0,1.0
47432,나빗/Noun,1,1,0,1.1115310228308472e-05,0.0,1.0
47433,븐데/Noun,1,0,1,0.0,1.1106915165381966e-05,1.0
47434,無言/Foreign,1,1,0,1.1115310228308472e-05,0.0,1.0
47435,회포/Noun,1,0,1,0.0,1.1106915165381966e-05,1.0
47436,바이바이/Noun,1,0,1,0.0,1.1106915165381966e-05,1.0
47437,&.&/Punctuation,1,0,1,0.0,1.1106915165381966e-05,1.0
47438,김수정/Noun,1,0,1,0.0,1.1106915165381966e-05,1.0
47439,김성호/Noun,1,0,1,0.0,1.1106915165381966e-05,1.0
47440,햐햐햫/Noun,1,1,0,1.1115310228308472e-05,0.0,1.0
47441,목둘/Noun,1,1,0,1.1115310228308472e-05,0.0,1.0
47442,쫄깃쫄깃하/Noun,1,1,0,1.1115310228308472e-05,0.0,1.0
47443,뽁/Noun,1,1,0,1.1115310228308472e-05,0.0,1.0
47444,미확인비행물체/Noun,1,0,1,0.0,1.1106915165381966e-05,1.0
47445,이속/Noun,1,1,0,1.1115310228308472e-05,0.0,1.0
47446,glad/Alpha,1,1,0,1.1115310228308472e-05,0.0,1.0
47447,anyone/Alpha,1,1,0,1.1115310228308472e-05,0.0,1.0
47448,타츠욘/Noun,1,0,1,0.0,1.1106915165381966e-05,1.0
47449,알츠하이머병/Noun,1,1,0,1.1115310228308472e-05,0.0,1.0
47450,아브라샤/Noun,1,1,0,1.1115310228308472e-05,0.0,1.0
47451,좃병싄/Noun,1,0,1,0.0,1.1106915165381966e-05,1.0
47452,폽/Noun,1,0,1,0.0,1.1106915165381966e-05,1.0
47453,어울렷/Noun,1,0,1,0.0,1.1106915165381966e-05,1.0
47454,맛업잡/Noun,1,1,0,1.1115310228308472e-05,0.0,1.0
47455,데릭지터/Noun,1,0,1,0.0,1.1106915165381966e-05,1.0
47456,지릿지릿/Noun,1,0,1,0.0,1.1106915165381966e-05,1.0
47457,우본/Noun,1,0,1,0.0,1.1106915165381966e-05,1.0
47458,꼬우시/Noun,1,1,0,1.1115310228308472e-05,0.0,1.0
47459,일본열도/Noun,1,0,1,0.0,1.1106915165381966e-05,1.0
47460,깔아뭉갬/Noun,1,0,1,0.0,1.1106915165381966e-05,1.0
47461,앙큼발칙/Noun,1,1,0,1.1115310228308472e-05,0.0,1.0
47462,수산물/Noun,1,0,1,0.0,1.1106915165381966e-05,1.0
47463,세안/Noun,1,1,0,1.1115310228308472e-05,0.0,1.0
47464,넘어뜨리다/Verb,1,0,1,0.0,1.1106915165381966e-05,1.0
47465,BLACK/Alpha,1,1,0,1.1115310228308472e-05,0.0,1.0
47466,육두문자/Noun,1,0,1,0.0,1.1106915165381966e-05,1.0
47467,임수향/Noun,1,0,1,0.0,1.1106915165381966e-05,1.0
47468,이다혜/Noun,1,0,1,0.0,1.1106915165381966e-05,1.0
47469,꿀잼이넹/Noun,1,1,0,1.1115310228308472e-05,0.0,1.0
47470,낮잔/Noun,1,1,0,1.1115310228308472e-05,0.0,1.0
47471,별의별/Modifier,1,0,1,0.0,1.1106915165381966e-05,1.0
47472,480/Number,1,0,1,0.0,1.1106915165381966e-05,1.0
47473,밌네/Noun,1,1,0,1.1115310228308472e-05,0.0,1.0
47474,abandoned/Alpha,1,1,0,1.1115310228308472e-05,0.0,1.0
47475,조윤/Noun,1,0,1,0.0,1.1106915165381966e-05,1.0
47476,비행단/Noun,1,1,0,1.1115310228308472e-05,0.0,1.0
47477,콩닥/Noun,1,1,0,1.1115310228308472e-05,0.0,1.0
47478,광휘/Noun,1,0,1,0.0,1.1106915165381966e-05,1.0
47479,스윽/Noun,1,0,1,0.0,1.1106915165381966e-05,1.0
47480,부츠/Noun,1,1,0,1.1115310228308472e-05,0.0,1.0
47481,포피/Noun,1,1,0,1.1115310228308472e-05,0.0,1.0
47482,불출/Noun,1,0,1,0.0,1.1106915165381966e-05,1.0
47483,금임/Noun,1,1,0,1.1115310228308472e-05,0.0,1.0
47484,망첬/Noun,1,0,1,0.0,1.1106915165381966e-05,1.0
47485,러드/Noun,1,1,0,1.1115310228308472e-05,0.0,1.0
47486,전국구/Noun,1,0,1,0.0,1.1106915165381966e-05,1.0
47487,엔야/Noun,1,1,0,1.1115310228308472e-05,0.0,1.0
47488,샴페인/Noun,1,1,0,1.1115310228308472e-05,0.0,1.0
47489,3.76/Number,1,0,1,0.0,1.1106915165381966e-05,1.0
47490,팝걸/Noun,1,1,0,1.1115310228308472e-05,0.0,1.0
47491,눌렸다/Noun,1,1,0,1.1115310228308472e-05,0.0,1.0
47492,급우/Noun,1,1,0,1.1115310228308472e-05,0.0,1.0
47493,나도초능러/Noun,1,1,0,1.1115310228308472e-05,0.0,1.0
47494,도대사/Noun,1,0,1,0.0,1.1106915165381966e-05,1.0
47495,...!!!!!!!!!!!!!!/Punctuation,1,1,0,1.1115310228308472e-05,0.0,1.0
47496,llti/Alpha,1,1,0,1.1115310228308472e-05,0.0,1.0
47497,흏/Noun,1,1,0,1.1115310228308472e-05,0.0,1.0
47498,ㅠㅠㅠㄹ/KoreanParticle,1,1,0,1.1115310228308472e-05,0.0,1.0
47499,복재/Noun,1,1,0,1.1115310228308472e-05,0.0,1.0
47500,횬실/Noun,1,1,0,1.1115310228308472e-05,0.0,1.0
47501,노영심/Noun,1,1,0,1.1115310228308472e-05,0.0,1.0
47502,나한일/Noun,1,0,1,0.0,1.1106915165381966e-05,1.0
47503,김혜영/Noun,1,0,1,0.0,1.1106915165381966e-05,1.0
47504,아마조니아/Noun,1,1,0,1.1115310228308472e-05,0.0,1.0
47505,이르판/Noun,1,1,0,1.1115310228308472e-05,0.0,1.0
47506,이상화/Noun,1,0,1,0.0,1.1106915165381966e-05,1.0
47507,결속/Noun,1,0,1,0.0,1.1106915165381966e-05,1.0
47508,칠협오/Noun,1,0,1,0.0,1.1106915165381966e-05,1.0
47509,가까이되는거같은데/Foreign,1,1,0,1.1115310228308472e-05,0.0,1.0
47510,오박사/Noun,1,1,0,1.1115310228308472e-05,0.0,1.0
47511,엮을라하/Noun,1,0,1,0.0,1.1106915165381966e-05,1.0
47512,새내기/Noun,1,1,0,1.1115310228308472e-05,0.0,1.0
47513,꽈놨노/Noun,1,0,1,0.0,1.1106915165381966e-05,1.0
47514,～～～/Foreign,1,0,1,0.0,1.1106915165381966e-05,1.0
47515,구리지/Noun,1,1,0,1.1115310228308472e-05,0.0,1.0
47516,논설/Noun,1,0,1,0.0,1.1106915165381966e-05,1.0
47517,훌터/Noun,1,0,1,0.0,1.1106915165381966e-05,1.0
47518,거내/Noun,1,0,1,0.0,1.1106915165381966e-05,1.0
47519,것칻/Noun,1,0,1,0.0,1.1106915165381966e-05,1.0
47520,lte/Alpha,1,0,1,0.0,1.1106915165381966e-05,1.0
47521,껀들/Noun,1,1,0,1.1115310228308472e-05,0.0,1.0
47522,푸릇했던/Noun,1,0,1,0.0,1.1106915165381966e-05,1.0
47523,이라는것은놀라운일/Foreign,1,0,1,0.0,1.1106915165381966e-05,1.0
47524,안됫음/Noun,1,0,1,0.0,1.1106915165381966e-05,1.0
47525,셴/Noun,1,0,1,0.0,1.1106915165381966e-05,1.0
47526,미장/Noun,1,0,1,0.0,1.1106915165381966e-05,1.0
47527,남궁원/Noun,1,1,0,1.1115310228308472e-05,0.0,1.0
47528,신경균/Noun,1,0,1,0.0,1.1106915165381966e-05,1.0
47529,~~~~~~~~~~~~~~~~~~~~~~~~~~~~~~~~~/Punctuation,1,1,0,1.1115310228308472e-05,0.0,1.0
47530,설파/Noun,1,0,1,0.0,1.1106915165381966e-05,1.0
47531,가을로/Noun,1,1,0,1.1115310228308472e-05,0.0,1.0
47532,금창/Noun,1,0,1,0.0,1.1106915165381966e-05,1.0
47533,0.0001%/Number,1,0,1,0.0,1.1106915165381966e-05,1.0
47534,홍혜정/Noun,1,0,1,0.0,1.1106915165381966e-05,1.0
47535,무표/Noun,1,0,1,0.0,1.1106915165381966e-05,1.0
47536,텟페이/Noun,1,1,0,1.1115310228308472e-05,0.0,1.0
47537,조세희/Noun,1,0,1,0.0,1.1106915165381966e-05,1.0
47538,된영화라니/Foreign,1,1,0,1.1115310228308472e-05,0.0,1.0
47539,백사전/Noun,1,0,1,0.0,1.1106915165381966e-05,1.0
47540,얼또/Noun,1,0,1,0.0,1.1106915165381966e-05,1.0
47541,1833/Number,1,1,0,1.1115310228308472e-05,0.0,1.0
47542,polaris/Alpha,1,1,0,1.1115310228308472e-05,0.0,1.0
47543,힌국/Noun,1,1,0,1.1115310228308472e-05,0.0,1.0
47544,국도극장개봉/Foreign,1,1,0,1.1115310228308472e-05,0.0,1.0
47545,176/Number,1,0,1,0.0,1.1106915165381966e-05,1.0
47546,8.12/Number,1,1,0,1.1115310228308472e-05,0.0,1.0
47547,가전/Noun,1,0,1,0.0,1.1106915165381966e-05,1.0
47548,헉헉거리다/Verb,1,0,1,0.0,1.1106915165381966e-05,1.0
47549,흉식호흡/Noun,1,0,1,0.0,1.1106915165381966e-05,1.0
47550,찌그러뜨리다/Verb,1,0,1,0.0,1.1106915165381966e-05,1.0
47551,콤피/Noun,1,1,0,1.1115310228308472e-05,0.0,1.0
47552,융털/Noun,1,0,1,0.0,1.1106915165381966e-05,1.0
47553,어근/Noun,1,1,0,1.1115310228308472e-05,0.0,1.0
47554,농업인/Noun,1,1,0,1.1115310228308472e-05,0.0,1.0
47555,싡/Noun,1,1,0,1.1115310228308472e-05,0.0,1.0
47556,집등/Noun,1,1,0,1.1115310228308472e-05,0.0,1.0
47557,대부터/Foreign,1,1,0,1.1115310228308472e-05,0.0,1.0
47558,난파/Noun,1,0,1,0.0,1.1106915165381966e-05,1.0
47559,리베/Noun,1,1,0,1.1115310228308472e-05,0.0,1.0
47560,~~~~~~~~~~~~~~~~~~~~~~~~~~~~~~~~/Punctuation,1,1,0,1.1115310228308472e-05,0.0,1.0
47561,럤/Noun,1,1,0,1.1115310228308472e-05,0.0,1.0
47562,알려즈/Noun,1,1,0,1.1115310228308472e-05,0.0,1.0
47563,점렴/Noun,1,0,1,0.0,1.1106915165381966e-05,1.0
47564,촌뜨기/Noun,1,0,1,0.0,1.1106915165381966e-05,1.0
47565,aosdf/Alpha,1,0,1,0.0,1.1106915165381966e-05,1.0
47566,flijaseoifj/Alpha,1,0,1,0.0,1.1106915165381966e-05,1.0
47567,adfasdfasd/Alpha,1,0,1,0.0,1.1106915165381966e-05,1.0
47568,좃망스멜/Noun,1,0,1,0.0,1.1106915165381966e-05,1.0
47569,맗이있드/Noun,1,0,1,0.0,1.1106915165381966e-05,1.0
47570,둘순/Noun,1,0,1,0.0,1.1106915165381966e-05,1.0
47571,6.40/Number,1,0,1,0.0,1.1106915165381966e-05,1.0
47572,액쎤신/Noun,1,0,1,0.0,1.1106915165381966e-05,1.0
47573,보탠다/Noun,1,1,0,1.1115310228308472e-05,0.0,1.0
47574,충당/Noun,1,0,1,0.0,1.1106915165381966e-05,1.0
47575,봬/Noun,1,0,1,0.0,1.1106915165381966e-05,1.0
47576,빠순들/Noun,1,0,1,0.0,1.1106915165381966e-05,1.0
47577,설렜댜/Noun,1,1,0,1.1115310228308472e-05,0.0,1.0
47578,뿔뿔이/Noun,1,0,1,0.0,1.1106915165381966e-05,1.0
47579,꼽겠다꼭/Noun,1,1,0,1.1115310228308472e-05,0.0,1.0
47580,란다우/Noun,1,1,0,1.1115310228308472e-05,0.0,1.0
47581,아펏다/Noun,1,1,0,1.1115310228308472e-05,0.0,1.0
47582,알약/Noun,1,1,0,1.1115310228308472e-05,0.0,1.0
47583,판자/Noun,1,1,0,1.1115310228308472e-05,0.0,1.0
47584,수주고/Noun,1,1,0,1.1115310228308472e-05,0.0,1.0
47585,헛될뿐/Noun,1,0,1,0.0,1.1106915165381966e-05,1.0
47586,포경수술/Noun,1,0,1,0.0,1.1106915165381966e-05,1.0
47587,torrent/Alpha,1,1,0,1.1115310228308472e-05,0.0,1.0
47588,...^^^^^^*/Punctuation,1,1,0,1.1115310228308472e-05,0.0,1.0
47589,적심/Noun,1,1,0,1.1115310228308472e-05,0.0,1.0
47590,책꼭/Noun,1,1,0,1.1115310228308472e-05,0.0,1.0
47591,이세나/Noun,1,1,0,1.1115310228308472e-05,0.0,1.0
47592,심즈/Noun,1,1,0,1.1115310228308472e-05,0.0,1.0
47593,http://bit.ly/1dlPlcw/URL,1,1,0,1.1115310228308472e-05,0.0,1.0
47594,식기/Noun,1,1,0,1.1115310228308472e-05,0.0,1.0
47595,르블랑/Noun,1,1,0,1.1115310228308472e-05,0.0,1.0
47596,김별/Noun,1,1,0,1.1115310228308472e-05,0.0,1.0
47597,담벼락/Noun,1,0,1,0.0,1.1106915165381966e-05,1.0
47598,취객/Noun,1,0,1,0.0,1.1106915165381966e-05,1.0
47599,밀봉/Noun,1,0,1,0.0,1.1106915165381966e-05,1.0
47600,코풀/Noun,1,0,1,0.0,1.1106915165381966e-05,1.0
47601,야스오/Noun,1,0,1,0.0,1.1106915165381966e-05,1.0
47602,처울/Noun,1,0,1,0.0,1.1106915165381966e-05,1.0
47603,다부지다/Adjective,1,1,0,1.1115310228308472e-05,0.0,1.0
47604,포레/Noun,1,1,0,1.1115310228308472e-05,0.0,1.0
47605,갤러리아/Noun,1,1,0,1.1115310228308472e-05,0.0,1.0
47606,다난/Noun,1,1,0,1.1115310228308472e-05,0.0,1.0
47607,꿰뚠/Noun,1,1,0,1.1115310228308472e-05,0.0,1.0
47608,이석우/Noun,1,0,1,0.0,1.1106915165381966e-05,1.0
47609,핶음/Noun,1,0,1,0.0,1.1106915165381966e-05,1.0
47610,김순/Noun,1,0,1,0.0,1.1106915165381966e-05,1.0
47611,딸셋/Noun,1,1,0,1.1115310228308472e-05,0.0,1.0
47612,여보세요/Exclamation,1,0,1,0.0,1.1106915165381966e-05,1.0
47613,-_-/../Punctuation,1,0,1,0.0,1.1106915165381966e-05,1.0
47614,낚기/Noun,1,0,1,0.0,1.1106915165381966e-05,1.0
47615,하쥬/Noun,1,0,1,0.0,1.1106915165381966e-05,1.0
47616,거열형/Noun,1,1,0,1.1115310228308472e-05,0.0,1.0
47617,닭장/Noun,1,0,1,0.0,1.1106915165381966e-05,1.0
47618,트래조/Noun,1,0,1,0.0,1.1106915165381966e-05,1.0
47619,미크/Noun,1,0,1,0.0,1.1106915165381966e-05,1.0
47620,윤세주/Noun,1,1,0,1.1115310228308472e-05,0.0,1.0
47621,저널리즘/Noun,1,0,1,0.0,1.1106915165381966e-05,1.0
47622,ㅅㅈㅅ/KoreanParticle,1,1,0,1.1115310228308472e-05,0.0,1.0
47623,mysterious/Alpha,1,1,0,1.1115310228308472e-05,0.0,1.0
47624,난뇽/Noun,1,1,0,1.1115310228308472e-05,0.0,1.0
47625,2~3일/Number,1,0,1,0.0,1.1106915165381966e-05,1.0
47626,"?),/Punctuation",1,0,1,0.0,1.1106915165381966e-05,1.0
47627,중대사/Noun,1,0,1,0.0,1.1106915165381966e-05,1.0
47628,윤길강/Noun,1,0,1,0.0,1.1106915165381966e-05,1.0
47629,또랑또랑하다/Adjective,1,1,0,1.1115310228308472e-05,0.0,1.0
47630,important/Alpha,1,1,0,1.1115310228308472e-05,0.0,1.0
47631,Walshy/Alpha,1,1,0,1.1115310228308472e-05,0.0,1.0
47632,directly/Alpha,1,1,0,1.1115310228308472e-05,0.0,1.0
47633,converste/Alpha,1,1,0,1.1115310228308472e-05,0.0,1.0
47634,whether/Alpha,1,1,0,1.1115310228308472e-05,0.0,1.0
47635,적팀/Noun,1,1,0,1.1115310228308472e-05,0.0,1.0
47636,BD/Alpha,1,1,0,1.1115310228308472e-05,0.0,1.0
47637,매말랏/Noun,1,0,1,0.0,1.1106915165381966e-05,1.0
47638,어쨋는/Noun,1,0,1,0.0,1.1106915165381966e-05,1.0
47639,attackerz/Alpha,1,0,1,0.0,1.1106915165381966e-05,1.0
47640,hh/Alpha,1,1,0,1.1115310228308472e-05,0.0,1.0
47641,틑/Noun,1,1,0,1.1115310228308472e-05,0.0,1.0
47642,설정떄문/Noun,1,0,1,0.0,1.1106915165381966e-05,1.0
47643,승평/Noun,1,0,1,0.0,1.1106915165381966e-05,1.0
47644,살인씬/Noun,1,0,1,0.0,1.1106915165381966e-05,1.0
47645,활려/Noun,1,0,1,0.0,1.1106915165381966e-05,1.0
47646,끅끅끅/Noun,1,1,0,1.1115310228308472e-05,0.0,1.0
47647,일상물/Noun,1,1,0,1.1115310228308472e-05,0.0,1.0
47648,"..?""...../Punctuation",1,1,0,1.1115310228308472e-05,0.0,1.0
47649,카스트로/Noun,1,1,0,1.1115310228308472e-05,0.0,1.0
47650,*-_/Punctuation,1,1,0,1.1115310228308472e-05,0.0,1.0
47651,아읏/Noun,1,1,0,1.1115310228308472e-05,0.0,1.0
47652,몽유/Noun,1,1,0,1.1115310228308472e-05,0.0,1.0
47653,몽희/Noun,1,1,0,1.1115310228308472e-05,0.0,1.0
47654,이헤숙/Noun,1,1,0,1.1115310228308472e-05,0.0,1.0
47655,250년/Number,1,0,1,0.0,1.1106915165381966e-05,1.0
47656,놀러와/Noun,1,1,0,1.1115310228308472e-05,0.0,1.0
47657,휴게소/Noun,1,1,0,1.1115310228308472e-05,0.0,1.0
47658,탄천/Noun,1,1,0,1.1115310228308472e-05,0.0,1.0
47659,패러딘줄/Noun,1,0,1,0.0,1.1106915165381966e-05,1.0
47660,섭땜/Noun,1,0,1,0.0,1.1106915165381966e-05,1.0
47661,요화/Noun,1,0,1,0.0,1.1106915165381966e-05,1.0
47662,김지선/Noun,1,1,0,1.1115310228308472e-05,0.0,1.0
47663,후키/Noun,1,0,1,0.0,1.1106915165381966e-05,1.0
47664,!^^//Punctuation,1,1,0,1.1115310228308472e-05,0.0,1.0
47665,교부/Noun,1,1,0,1.1115310228308472e-05,0.0,1.0
47666,차일피일/Noun,1,1,0,1.1115310228308472e-05,0.0,1.0
47667,힘알/Noun,1,0,1,0.0,1.1106915165381966e-05,1.0
47668,글램락/Noun,1,1,0,1.1115310228308472e-05,0.0,1.0
47669,하늘색/Noun,1,1,0,1.1115310228308472e-05,0.0,1.0
47670,7.98/Number,1,1,0,1.1115310228308472e-05,0.0,1.0
47671,재력/Noun,1,0,1,0.0,1.1106915165381966e-05,1.0
47672,상욱이/Noun,1,0,1,0.0,1.1106915165381966e-05,1.0
47673,첮기/Noun,1,1,0,1.1115310228308472e-05,0.0,1.0
47674,똥골레/Noun,1,0,1,0.0,1.1106915165381966e-05,1.0
47675,국제화/Noun,1,0,1,0.0,1.1106915165381966e-05,1.0
47676,사필귀정/Noun,1,0,1,0.0,1.1106915165381966e-05,1.0
47677,미소천사/Noun,1,1,0,1.1115310228308472e-05,0.0,1.0
47678,5-7/Number,1,1,0,1.1115310228308472e-05,0.0,1.0
47679,anteINCEPTION/Alpha,1,0,1,0.0,1.1106915165381966e-05,1.0
47680,상동/Noun,1,0,1,0.0,1.1106915165381966e-05,1.0
47681,주창/Noun,1,0,1,0.0,1.1106915165381966e-05,1.0
47682,욱겼음/Noun,1,0,1,0.0,1.1106915165381966e-05,1.0
47683,임펙트있어/Noun,1,1,0,1.1115310228308472e-05,0.0,1.0
47684,갈껄/Noun,1,0,1,0.0,1.1106915165381966e-05,1.0
47685,넘이뻣슴/Noun,1,1,0,1.1115310228308472e-05,0.0,1.0
47686,부국/Noun,1,0,1,0.0,1.1106915165381966e-05,1.0
47687,김창숙/Noun,1,0,1,0.0,1.1106915165381966e-05,1.0
47688,셀렉/Noun,1,0,1,0.0,1.1106915165381966e-05,1.0
47689,까지살고싶다/Foreign,1,1,0,1.1115310228308472e-05,0.0,1.0
47690,2259년/Number,1,1,0,1.1115310228308472e-05,0.0,1.0
47691,대빵/Adverb,1,0,1,0.0,1.1106915165381966e-05,1.0
47692,슈프림/Noun,1,1,0,1.1115310228308472e-05,0.0,1.0
47693,주객전도/Noun,1,1,0,1.1115310228308472e-05,0.0,1.0
47694,차일/Noun,1,1,0,1.1115310228308472e-05,0.0,1.0
47695,anonymous/Alpha,1,1,0,1.1115310228308472e-05,0.0,1.0
47696,뛰어오르다/Verb,1,0,1,0.0,1.1106915165381966e-05,1.0
47697,골대/Noun,1,0,1,0.0,1.1106915165381966e-05,1.0
47698,가부토/Noun,1,0,1,0.0,1.1106915165381966e-05,1.0
47699,레볼루션/Noun,1,0,1,0.0,1.1106915165381966e-05,1.0
47700,6.62/Number,1,1,0,1.1115310228308472e-05,0.0,1.0
47701,마르케스/Noun,1,1,0,1.1115310228308472e-05,0.0,1.0
47702,튀튀/Noun,1,0,1,0.0,1.1106915165381966e-05,1.0
47703,염거/Noun,1,0,1,0.0,1.1106915165381966e-05,1.0
47704,임진록/Noun,1,0,1,0.0,1.1106915165381966e-05,1.0
47705,좋게봣습니/Noun,1,1,0,1.1115310228308472e-05,0.0,1.0
47706,천곡/Noun,1,1,0,1.1115310228308472e-05,0.0,1.0
47707,영지/Noun,1,1,0,1.1115310228308472e-05,0.0,1.0
47708,무뇌충일/Noun,1,0,1,0.0,1.1106915165381966e-05,1.0
47709,범프/Noun,1,1,0,1.1115310228308472e-05,0.0,1.0
47710,엮어놓/Noun,1,0,1,0.0,1.1106915165381966e-05,1.0
47711,!!^-^/Punctuation,1,1,0,1.1115310228308472e-05,0.0,1.0
47712,삭재/Noun,1,0,1,0.0,1.1106915165381966e-05,1.0
47713,존르카레/Noun,1,1,0,1.1115310228308472e-05,0.0,1.0
47714,고구/Noun,1,1,0,1.1115310228308472e-05,0.0,1.0
47715,미샹센/Noun,1,1,0,1.1115310228308472e-05,0.0,1.0
47716,어깨부상/Noun,1,1,0,1.1115310228308472e-05,0.0,1.0
47717,스스럼/Noun,1,0,1,0.0,1.1106915165381966e-05,1.0
47718,쉑쉬/Noun,1,1,0,1.1115310228308472e-05,0.0,1.0
47719,높힌/Noun,1,0,1,0.0,1.1106915165381966e-05,1.0
47720,반년대작품인줄알았는데/Foreign,1,0,1,0.0,1.1106915165381966e-05,1.0
47721,90초/Number,1,0,1,0.0,1.1106915165381966e-05,1.0
47722,처절/Noun,1,1,0,1.1115310228308472e-05,0.0,1.0
47723,capguy/Alpha,1,1,0,1.1115310228308472e-05,0.0,1.0
47724,바램유바램유/Noun,1,1,0,1.1115310228308472e-05,0.0,1.0
47725,ksgome/Alpha,1,1,0,1.1115310228308472e-05,0.0,1.0
47726,해임/Noun,1,1,0,1.1115310228308472e-05,0.0,1.0
47727,클레이튼/Noun,1,1,0,1.1115310228308472e-05,0.0,1.0
47728,--//Punctuation,1,0,1,0.0,1.1106915165381966e-05,1.0
47729,유덜/Noun,1,0,1,0.0,1.1106915165381966e-05,1.0
47730,블렉코메디/Noun,1,0,1,0.0,1.1106915165381966e-05,1.0
47731,배읅/Noun,1,1,0,1.1115310228308472e-05,0.0,1.0
47732,drlc/Alpha,1,0,1,0.0,1.1106915165381966e-05,1.0
47733,신저우/Noun,1,1,0,1.1115310228308472e-05,0.0,1.0
47734,안알랴줌/Noun,1,1,0,1.1115310228308472e-05,0.0,1.0
47735,27일/Number,1,0,1,0.0,1.1106915165381966e-05,1.0
47736,명량볼빠/Noun,1,1,0,1.1115310228308472e-05,0.0,1.0
47737,재훈/Noun,1,0,1,0.0,1.1106915165381966e-05,1.0
47738,애묘/Noun,1,0,1,0.0,1.1106915165381966e-05,1.0
47739,츠비/Noun,1,1,0,1.1115310228308472e-05,0.0,1.0
47740,도노번/Noun,1,1,0,1.1115310228308472e-05,0.0,1.0
47741,못찿을꺼/Noun,1,1,0,1.1115310228308472e-05,0.0,1.0
47742,어쩜니들/Noun,1,1,0,1.1115310228308472e-05,0.0,1.0
47743,동진/Noun,1,1,0,1.1115310228308472e-05,0.0,1.0
47744,"!!""""/Punctuation",1,0,1,0.0,1.1106915165381966e-05,1.0
47745,"..""""/Punctuation",1,0,1,0.0,1.1106915165381966e-05,1.0
47746,gu/Alpha,1,0,1,0.0,1.1106915165381966e-05,1.0
47747,원앙/Noun,1,1,0,1.1115310228308472e-05,0.0,1.0
47748,짜그락/Noun,1,0,1,0.0,1.1106915165381966e-05,1.0
47749,찌그락/Noun,1,0,1,0.0,1.1106915165381966e-05,1.0
47750,장욱/Noun,1,1,0,1.1115310228308472e-05,0.0,1.0
47751,옥림/Noun,1,1,0,1.1115310228308472e-05,0.0,1.0
47752,ㄷㅔ/KoreanParticle,1,0,1,0.0,1.1106915165381966e-05,1.0
47753,안나왓/Noun,1,1,0,1.1115310228308472e-05,0.0,1.0
47754,ㅣㅏㅓㅣ/KoreanParticle,1,0,1,0.0,1.1106915165381966e-05,1.0
47755,ㅐㅣㅁ/KoreanParticle,1,0,1,0.0,1.1106915165381966e-05,1.0
47756,모멸/Noun,1,0,1,0.0,1.1106915165381966e-05,1.0
47757,치남/Noun,1,0,1,0.0,1.1106915165381966e-05,1.0
47758,돌앞/Noun,1,0,1,0.0,1.1106915165381966e-05,1.0
47759,꼬깔모/Noun,1,0,1,0.0,1.1106915165381966e-05,1.0
47760,개봉/Foreign,1,0,1,0.0,1.1106915165381966e-05,1.0
47761,폭놃/Noun,1,1,0,1.1115310228308472e-05,0.0,1.0
47762,아일럔드/Noun,1,0,1,0.0,1.1106915165381966e-05,1.0
47763,아이슬란드/Noun,1,0,1,0.0,1.1106915165381966e-05,1.0
47764,!!!!></Punctuation,1,1,0,1.1115310228308472e-05,0.0,1.0
47765,증류/Noun,1,0,1,0.0,1.1106915165381966e-05,1.0
47766,비칸데르/Noun,1,1,0,1.1115310228308472e-05,0.0,1.0
47767,불넘게벌음/Foreign,1,1,0,1.1115310228308472e-05,0.0,1.0
47768,불밖엔/Foreign,1,1,0,1.1115310228308472e-05,0.0,1.0
47769,모델링/Noun,1,0,1,0.0,1.1106915165381966e-05,1.0
47770,재건축/Noun,1,0,1,0.0,1.1106915165381966e-05,1.0
47771,조윤숙/Noun,1,1,0,1.1115310228308472e-05,0.0,1.0
47772,문천식/Noun,1,0,1,0.0,1.1106915165381966e-05,1.0
47773,엇죠/Noun,1,1,0,1.1115310228308472e-05,0.0,1.0
47774,외케/Noun,1,1,0,1.1115310228308472e-05,0.0,1.0
47775,표백제/Noun,1,1,0,1.1115310228308472e-05,0.0,1.0
47776,찍디/Noun,1,0,1,0.0,1.1106915165381966e-05,1.0
47777,스스스/Noun,1,1,0,1.1115310228308472e-05,0.0,1.0
47778,왓더훡/Noun,1,0,1,0.0,1.1106915165381966e-05,1.0
47779,헨드폰/Noun,1,1,0,1.1115310228308472e-05,0.0,1.0
47780,륄리/Noun,1,1,0,1.1115310228308472e-05,0.0,1.0
47781,옛날이야기/Noun,1,1,0,1.1115310228308472e-05,0.0,1.0
47782,unbelievable/Alpha,1,0,1,0.0,1.1106915165381966e-05,1.0
47783,뒹구/Noun,1,0,1,0.0,1.1106915165381966e-05,1.0
47784,어쨋뜬/Noun,1,1,0,1.1115310228308472e-05,0.0,1.0
47785,쭉정이/Noun,1,0,1,0.0,1.1106915165381966e-05,1.0
47786,씬보/Noun,1,1,0,1.1115310228308472e-05,0.0,1.0
47787,핀치/Noun,1,0,1,0.0,1.1106915165381966e-05,1.0
47788,지하드/Noun,1,1,0,1.1115310228308472e-05,0.0,1.0
47789,같았/Noun,1,1,0,1.1115310228308472e-05,0.0,1.0
47790,입궐/Noun,1,1,0,1.1115310228308472e-05,0.0,1.0
47791,제일역/Noun,1,1,0,1.1115310228308472e-05,0.0,1.0
47792,영광의레이서/Noun,1,1,0,1.1115310228308472e-05,0.0,1.0
47793,went/Alpha,1,1,0,1.1115310228308472e-05,0.0,1.0
47794,eveything/Alpha,1,1,0,1.1115310228308472e-05,0.0,1.0
47795,cause/Alpha,1,1,0,1.1115310228308472e-05,0.0,1.0
47796,told/Alpha,1,1,0,1.1115310228308472e-05,0.0,1.0
47797,storie/Alpha,1,1,0,1.1115310228308472e-05,0.0,1.0
47798,commando/Alpha,1,1,0,1.1115310228308472e-05,0.0,1.0
47799,ㅎㄹㄹ/KoreanParticle,1,1,0,1.1115310228308472e-05,0.0,1.0
47800,산모/Noun,1,0,1,0.0,1.1106915165381966e-05,1.0
47801,분에서/Foreign,1,0,1,0.0,1.1106915165381966e-05,1.0
47802,28회/Number,1,0,1,0.0,1.1106915165381966e-05,1.0
47803,슈발슈뤠/Noun,1,0,1,0.0,1.1106915165381966e-05,1.0
47804,조서/Noun,1,0,1,0.0,1.1106915165381966e-05,1.0
47805,★♥/Foreign,1,1,0,1.1115310228308472e-05,0.0,1.0
47806,불루/Noun,1,1,0,1.1115310228308472e-05,0.0,1.0
47807,송능한/Noun,1,0,1,0.0,1.1106915165381966e-05,1.0
47808,껄끄러움/Noun,1,1,0,1.1115310228308472e-05,0.0,1.0
47809,빼뚤/Noun,1,0,1,0.0,1.1106915165381966e-05,1.0
47810,분칠/Noun,1,0,1,0.0,1.1106915165381966e-05,1.0
47811,^----------^/Punctuation,1,1,0,1.1115310228308472e-05,0.0,1.0
47812,";,;,;,/Punctuation",1,0,1,0.0,1.1106915165381966e-05,1.0
47813,dimitri/Alpha,1,1,0,1.1115310228308472e-05,0.0,1.0
47814,흥분제/Noun,1,0,1,0.0,1.1106915165381966e-05,1.0
47815,혈당/Noun,1,0,1,0.0,1.1106915165381966e-05,1.0
47816,!!!!!!!!!!!!!!!!!!!!!!!!!!!!!!!!/Punctuation,1,1,0,1.1115310228308472e-05,0.0,1.0
47817,이도아/Noun,1,0,1,0.0,1.1106915165381966e-05,1.0
47818,김쌤/Noun,1,1,0,1.1115310228308472e-05,0.0,1.0
47819,정쌤/Noun,1,1,0,1.1115310228308472e-05,0.0,1.0
47820,제밌습니/Noun,1,1,0,1.1115310228308472e-05,0.0,1.0
47821,ㅎㅎㅈㅎ/KoreanParticle,1,1,0,1.1115310228308472e-05,0.0,1.0
47822,이선호/Noun,1,1,0,1.1115310228308472e-05,0.0,1.0
47823,창호/Noun,1,1,0,1.1115310228308472e-05,0.0,1.0
47824,하고도/Foreign,1,1,0,1.1115310228308472e-05,0.0,1.0
47825,표헌/Noun,1,1,0,1.1115310228308472e-05,0.0,1.0
47826,월효/Noun,1,1,0,1.1115310228308472e-05,0.0,1.0
47827,작보다/Foreign,1,1,0,1.1115310228308472e-05,0.0,1.0
47828,마린시티/Noun,1,1,0,1.1115310228308472e-05,0.0,1.0
47829,집컴/Noun,1,1,0,1.1115310228308472e-05,0.0,1.0
47830,썰매개/Noun,1,1,0,1.1115310228308472e-05,0.0,1.0
47831,엘더/Noun,1,1,0,1.1115310228308472e-05,0.0,1.0
47832,걸렀는데/Noun,1,0,1,0.0,1.1106915165381966e-05,1.0
47833,만들엇어/Noun,1,0,1,0.0,1.1106915165381966e-05,1.0
47834,addicted/Alpha,1,0,1,0.0,1.1106915165381966e-05,1.0
47835,세수/Noun,1,1,0,1.1115310228308472e-05,0.0,1.0
47836,레드아이/Noun,1,0,1,0.0,1.1106915165381966e-05,1.0
47837,외형/Noun,1,0,1,0.0,1.1106915165381966e-05,1.0
47838,존보이트/Noun,1,1,0,1.1115310228308472e-05,0.0,1.0
47839,혼열/Noun,1,1,0,1.1115310228308472e-05,0.0,1.0
47840,..._(__)_/Punctuation,1,1,0,1.1115310228308472e-05,0.0,1.0
47841,윽지/Noun,1,0,1,0.0,1.1106915165381966e-05,1.0
47842,금포/Noun,1,0,1,0.0,1.1106915165381966e-05,1.0
47843,가족부/Noun,1,1,0,1.1115310228308472e-05,0.0,1.0
47844,셧다운제/Noun,1,1,0,1.1115310228308472e-05,0.0,1.0
47845,신비의법/Noun,1,1,0,1.1115310228308472e-05,0.0,1.0
47846,카타차파/Noun,1,0,1,0.0,1.1106915165381966e-05,1.0
47847,혜화/Noun,1,1,0,1.1115310228308472e-05,0.0,1.0
47848,6.82/Number,1,1,0,1.1115310228308472e-05,0.0,1.0
47849,8.00/Number,1,1,0,1.1115310228308472e-05,0.0,1.0
47850,절하/Noun,1,1,0,1.1115310228308472e-05,0.0,1.0
47851,sibalsiganaggabda/Alpha,1,0,1,0.0,1.1106915165381966e-05,1.0
47852,굿잼굿잼/Noun,1,1,0,1.1115310228308472e-05,0.0,1.0
47853,달곰하다/Adjective,1,1,0,1.1115310228308472e-05,0.0,1.0
47854,임원/Noun,1,0,1,0.0,1.1106915165381966e-05,1.0
47855,옥땅/Noun,1,1,0,1.1115310228308472e-05,0.0,1.0
47856,찻/Noun,1,0,1,0.0,1.1106915165381966e-05,1.0
47857,부터보신분들잇으세요/Foreign,1,0,1,0.0,1.1106915165381966e-05,1.0
47858,sweeti-potato@hanmail.net/Email,1,1,0,1.1115310228308472e-05,0.0,1.0
47859,빈칸/Noun,1,0,1,0.0,1.1106915165381966e-05,1.0
47860,밀덕임/Noun,1,1,0,1.1115310228308472e-05,0.0,1.0
47861,거북목/Noun,1,0,1,0.0,1.1106915165381966e-05,1.0
47862,복임/Noun,1,0,1,0.0,1.1106915165381966e-05,1.0
47863,아이보리코스트/Noun,1,1,0,1.1115310228308472e-05,0.0,1.0
47864,울분/Noun,1,1,0,1.1115310228308472e-05,0.0,1.0
47865,.~~~../Punctuation,1,1,0,1.1115310228308472e-05,0.0,1.0
47866,나왔엇음/Noun,1,0,1,0.0,1.1106915165381966e-05,1.0
47867,황추생/Noun,1,1,0,1.1115310228308472e-05,0.0,1.0
47868,장기영/Noun,1,1,0,1.1115310228308472e-05,0.0,1.0
47869,황학동/Noun,1,1,0,1.1115310228308472e-05,0.0,1.0
47870,르넬/Noun,1,1,0,1.1115310228308472e-05,0.0,1.0
47871,대가족/Noun,1,0,1,0.0,1.1106915165381966e-05,1.0
47872,혼외/Noun,1,0,1,0.0,1.1106915165381966e-05,1.0
47873,라듸오/Noun,1,0,1,0.0,1.1106915165381966e-05,1.0
47874,좌풀/Noun,1,0,1,0.0,1.1106915165381966e-05,1.0
47875,파다/Noun,1,1,0,1.1115310228308472e-05,0.0,1.0
47876,허자/Noun,1,1,0,1.1115310228308472e-05,0.0,1.0
47877,뭉쿠리/Noun,1,1,0,1.1115310228308472e-05,0.0,1.0
47878,뭉크/Noun,1,1,0,1.1115310228308472e-05,0.0,1.0
47879,186분/Number,1,0,1,0.0,1.1106915165381966e-05,1.0
47880,ㅈㅎㅅㅇㅅㅅ/KoreanParticle,1,0,1,0.0,1.1106915165381966e-05,1.0
47881,올해쵝오/Noun,1,1,0,1.1115310228308472e-05,0.0,1.0
47882,인국/Noun,1,1,0,1.1115310228308472e-05,0.0,1.0
47883,~~^^./Punctuation,1,1,0,1.1115310228308472e-05,0.0,1.0
47884,압꿘/Noun,1,1,0,1.1115310228308472e-05,0.0,1.0
47885,굿강추/Noun,1,1,0,1.1115310228308472e-05,0.0,1.0
47886,딥빡입니/Noun,1,0,1,0.0,1.1106915165381966e-05,1.0
47887,su/Alpha,1,0,1,0.0,1.1106915165381966e-05,1.0
47888,대동소이하다/Adjective,1,1,0,1.1115310228308472e-05,0.0,1.0
47889,임혁/Noun,1,1,0,1.1115310228308472e-05,0.0,1.0
47890,김흥기/Noun,1,1,0,1.1115310228308472e-05,0.0,1.0
47891,케옴/Noun,1,0,1,0.0,1.1106915165381966e-05,1.0
47892,줬을껄/Noun,1,1,0,1.1115310228308472e-05,0.0,1.0
47893,못봣으/Noun,1,1,0,1.1115310228308472e-05,0.0,1.0
47894,순서도/Noun,1,0,1,0.0,1.1106915165381966e-05,1.0
47895,버엔팅/Noun,1,0,1,0.0,1.1106915165381966e-05,1.0
47896,말액/Noun,1,0,1,0.0,1.1106915165381966e-05,1.0
47897,파노/Noun,1,0,1,0.0,1.1106915165381966e-05,1.0
47898,케스킹/Noun,1,1,0,1.1115310228308472e-05,0.0,1.0
47899,물껄그랫다/Noun,1,0,1,0.0,1.1106915165381966e-05,1.0
47900,김밥천국/Noun,1,0,1,0.0,1.1106915165381966e-05,1.0
47901,나서스/Noun,1,0,1,0.0,1.1106915165381966e-05,1.0
47902,슈뤠/Noun,1,0,1,0.0,1.1106915165381966e-05,1.0
47903,으로부터/Foreign,1,1,0,1.1115310228308472e-05,0.0,1.0
47904,장함/Noun,1,0,1,0.0,1.1106915165381966e-05,1.0
47905,내란음모/Noun,1,0,1,0.0,1.1106915165381966e-05,1.0
47906,쩌는/Noun,1,0,1,0.0,1.1106915165381966e-05,1.0
47907,1980~90년/Number,1,1,0,1.1115310228308472e-05,0.0,1.0
47908,다이내믹/Noun,1,1,0,1.1115310228308472e-05,0.0,1.0
47909,모럴/Noun,1,0,1,0.0,1.1106915165381966e-05,1.0
47910,내려다보다/Verb,1,0,1,0.0,1.1106915165381966e-05,1.0
47911,5.9/Number,1,0,1,0.0,1.1106915165381966e-05,1.0
47912,가을비/Noun,1,1,0,1.1115310228308472e-05,0.0,1.0
47913,anjel/Alpha,1,1,0,1.1115310228308472e-05,0.0,1.0
47914,꼴통쇠/Noun,1,1,0,1.1115310228308472e-05,0.0,1.0
47915,정관/Noun,1,1,0,1.1115310228308472e-05,0.0,1.0
47916,소수만/Noun,1,0,1,0.0,1.1106915165381966e-05,1.0
47917,는지/Eomi,1,0,1,0.0,1.1106915165381966e-05,1.0
47918,17회/Number,1,1,0,1.1115310228308472e-05,0.0,1.0
47919,.....//Punctuation,1,0,1,0.0,1.1106915165381966e-05,1.0
47920,쌍교/Noun,1,0,1,0.0,1.1106915165381966e-05,1.0
47921,딸때매/Noun,1,0,1,0.0,1.1106915165381966e-05,1.0
47922,핵핵핵/Noun,1,0,1,0.0,1.1106915165381966e-05,1.0
47923,씬도없/Noun,1,0,1,0.0,1.1106915165381966e-05,1.0
47924,Matryoshka/Alpha,1,1,0,1.1115310228308472e-05,0.0,1.0
47925,Zigzag/Alpha,1,1,0,1.1115310228308472e-05,0.0,1.0
47926,쿠시나/Noun,1,1,0,1.1115310228308472e-05,0.0,1.0
47927,english/Alpha,1,0,1,0.0,1.1106915165381966e-05,1.0
47928,learned/Alpha,1,0,1,0.0,1.1106915165381966e-05,1.0
47929,구로동/Noun,1,0,1,0.0,1.1106915165381966e-05,1.0
47930,대포통장/Noun,1,0,1,0.0,1.1106915165381966e-05,1.0
47931,얼룩소/Noun,1,0,1,0.0,1.1106915165381966e-05,1.0
47932,젠젠/Noun,1,0,1,0.0,1.1106915165381966e-05,1.0
47933,110%/Number,1,1,0,1.1115310228308472e-05,0.0,1.0
47934,Ps/Alpha,1,1,0,1.1115310228308472e-05,0.0,1.0
47935,웨컴/Noun,1,0,1,0.0,1.1106915165381966e-05,1.0
47936,수정역/Noun,1,0,1,0.0,1.1106915165381966e-05,1.0
47937,못듬/Noun,1,0,1,0.0,1.1106915165381966e-05,1.0
47938,GPS/Alpha,1,0,1,0.0,1.1106915165381966e-05,1.0
47939,155/Number,1,0,1,0.0,1.1106915165381966e-05,1.0
47940,포병/Noun,1,0,1,0.0,1.1106915165381966e-05,1.0
47941,엔하위키/Noun,1,1,0,1.1115310228308472e-05,0.0,1.0
47942,팼을듯/Noun,1,0,1,0.0,1.1106915165381966e-05,1.0
47943,참담/Noun,1,0,1,0.0,1.1106915165381966e-05,1.0
47944,항간/Noun,1,0,1,0.0,1.1106915165381966e-05,1.0
47945,⊙◎●○▷◁▽△■□】【/Foreign,1,1,0,1.1115310228308472e-05,0.0,1.0
47946,☆★☆★☆★☆★☆★☆★☆★☆★☆★☆★☆★☆★☆★☆★☆★☆★☆★☆★☆★☆★☆★☆★☆★☆★☆★☆★☆★☆★☆★☆★☆★☆★☆★☆★☆★☆★☆★☆★☆★☆★☆★☆★☆★☆★☆★☆★☆★☆★☆☆★☆★☆★☆★☆★☆★☆★☆★☆★☆★☆★☆★☆◐◑※/Foreign,1,1,0,1.1115310228308472e-05,0.0,1.0
47947,사선/Noun,1,1,0,1.1115310228308472e-05,0.0,1.0
47948,둥순둥/Noun,1,0,1,0.0,1.1106915165381966e-05,1.0
47949,~+/Punctuation,1,0,1,0.0,1.1106915165381966e-05,1.0
47950,20억/Number,1,0,1,0.0,1.1106915165381966e-05,1.0
47951,꺼였다니/Foreign,1,1,0,1.1115310228308472e-05,0.0,1.0
47952,???..????...????/Punctuation,1,0,1,0.0,1.1106915165381966e-05,1.0
47953,꺙꾱낑랽룕뷁/Noun,1,1,0,1.1115310228308472e-05,0.0,1.0
47954,을사면서/Foreign,1,0,1,0.0,1.1106915165381966e-05,1.0
47955,퍼클/Noun,1,1,0,1.1115310228308472e-05,0.0,1.0
47956,크림레몬/Noun,1,0,1,0.0,1.1106915165381966e-05,1.0
47957,단헌/Noun,1,0,1,0.0,1.1106915165381966e-05,1.0
47958,저쨋/Noun,1,1,0,1.1115310228308472e-05,0.0,1.0
47959,벗트/Noun,1,0,1,0.0,1.1106915165381966e-05,1.0
47960,모노노케/Noun,1,1,0,1.1115310228308472e-05,0.0,1.0
47961,생갓/Noun,1,1,0,1.1115310228308472e-05,0.0,1.0
47962,잼업/Noun,1,0,1,0.0,1.1106915165381966e-05,1.0
47963,투덜/Noun,1,0,1,0.0,1.1106915165381966e-05,1.0
47964,완전낚/Noun,1,0,1,0.0,1.1106915165381966e-05,1.0
47965,더뜻/Noun,1,1,0,1.1115310228308472e-05,0.0,1.0
47966,해정/Noun,1,1,0,1.1115310228308472e-05,0.0,1.0
47967,풍신수길/Noun,1,0,1,0.0,1.1106915165381966e-05,1.0
47968,가토/Noun,1,0,1,0.0,1.1106915165381966e-05,1.0
47969,웨스트라이프/Noun,1,0,1,0.0,1.1106915165381966e-05,1.0
47970,BSB/Alpha,1,0,1,0.0,1.1106915165381966e-05,1.0
47971,외람/Noun,1,0,1,0.0,1.1106915165381966e-05,1.0
47972,괸찬으/Noun,1,0,1,0.0,1.1106915165381966e-05,1.0
47973,무슬/Noun,1,1,0,1.1115310228308472e-05,0.0,1.0
47974,고압/Noun,1,0,1,0.0,1.1106915165381966e-05,1.0
47975,디박/Noun,1,1,0,1.1115310228308472e-05,0.0,1.0
47976,쓉/Noun,1,0,1,0.0,1.1106915165381966e-05,1.0
47977,앞서나간작품/Foreign,1,1,0,1.1115310228308472e-05,0.0,1.0
47978,차타드/Noun,1,0,1,0.0,1.1106915165381966e-05,1.0
47979,떽떽/Noun,1,0,1,0.0,1.1106915165381966e-05,1.0
47980,코밍쑤운/Noun,1,1,0,1.1115310228308472e-05,0.0,1.0
47981,쪼금나와/Noun,1,1,0,1.1115310228308472e-05,0.0,1.0
47982,9/27/Number,1,0,1,0.0,1.1106915165381966e-05,1.0
47983,넌내게반했어/Noun,1,1,0,1.1115310228308472e-05,0.0,1.0
47984,란스/Noun,1,1,0,1.1115310228308472e-05,0.0,1.0
47985,하핡/Noun,1,0,1,0.0,1.1106915165381966e-05,1.0
47986,점치/Noun,1,0,1,0.0,1.1106915165381966e-05,1.0
47987,송슨헌/Noun,1,0,1,0.0,1.1106915165381966e-05,1.0
47988,동식물/Noun,1,0,1,0.0,1.1106915165381966e-05,1.0
47989,효능/Noun,1,0,1,0.0,1.1106915165381966e-05,1.0
47990,족탈/Noun,1,0,1,0.0,1.1106915165381966e-05,1.0
47991,재격/Noun,1,1,0,1.1115310228308472e-05,0.0,1.0
47992,억만해/Noun,1,1,0,1.1115310228308472e-05,0.0,1.0
47993,로맥/Noun,1,0,1,0.0,1.1106915165381966e-05,1.0
47994,엄여/Noun,1,0,1,0.0,1.1106915165381966e-05,1.0
47995,권땅/Noun,1,0,1,0.0,1.1106915165381966e-05,1.0
47996,쾌유/Noun,1,1,0,1.1115310228308472e-05,0.0,1.0
47997,아토피/Noun,1,1,0,1.1115310228308472e-05,0.0,1.0
47998,Jessica/Alpha,1,1,0,1.1115310228308472e-05,0.0,1.0
47999,나달/Noun,1,0,1,0.0,1.1106915165381966e-05,1.0
48000,영혼씬/Noun,1,0,1,0.0,1.1106915165381966e-05,1.0
48001,나돈데/Noun,1,1,0,1.1115310228308472e-05,0.0,1.0
48002,앳딘/Noun,1,0,1,0.0,1.1106915165381966e-05,1.0
48003,스뤄웠/Noun,1,1,0,1.1115310228308472e-05,0.0,1.0
48004,인물정보/Noun,1,1,0,1.1115310228308472e-05,0.0,1.0
48005,김영옥/Noun,1,1,0,1.1115310228308472e-05,0.0,1.0
48006,흥칫뿡/Noun,1,1,0,1.1115310228308472e-05,0.0,1.0
48007,훸/Noun,1,0,1,0.0,1.1106915165381966e-05,1.0
48008,왃/Noun,1,0,1,0.0,1.1106915165381966e-05,1.0
48009,탐험대/Noun,1,0,1,0.0,1.1106915165381966e-05,1.0
48010,전태수/Noun,1,1,0,1.1115310228308472e-05,0.0,1.0
48011,확마/Noun,1,1,0,1.1115310228308472e-05,0.0,1.0
48012,격식/Noun,1,1,0,1.1115310228308472e-05,0.0,1.0
48013,상주면/Noun,1,1,0,1.1115310228308472e-05,0.0,1.0
48014,Soso/Alpha,1,0,1,0.0,1.1106915165381966e-05,1.0
48015,핱으/Noun,1,1,0,1.1115310228308472e-05,0.0,1.0
48016,할퀴다/Verb,1,1,0,1.1115310228308472e-05,0.0,1.0
48017,쎾쓰/Noun,1,0,1,0.0,1.1106915165381966e-05,1.0
48018,숨지다/Verb,1,1,0,1.1115310228308472e-05,0.0,1.0
48019,기숙/Noun,1,1,0,1.1115310228308472e-05,0.0,1.0
48020,이태수/Noun,1,1,0,1.1115310228308472e-05,0.0,1.0
48021,정읍/Noun,1,1,0,1.1115310228308472e-05,0.0,1.0
48022,때린/Foreign,1,1,0,1.1115310228308472e-05,0.0,1.0
48023,소일/Noun,1,1,0,1.1115310228308472e-05,0.0,1.0
48024,캐캐/Noun,1,0,1,0.0,1.1106915165381966e-05,1.0
48025,배웅/Noun,1,1,0,1.1115310228308472e-05,0.0,1.0
48026,리즈라/Foreign,1,0,1,0.0,1.1106915165381966e-05,1.0
48027,진급/Noun,1,0,1,0.0,1.1106915165381966e-05,1.0
48028,얼빠/Noun,1,0,1,0.0,1.1106915165381966e-05,1.0
48029,이스라엘인/Noun,1,0,1,0.0,1.1106915165381966e-05,1.0
48030,날선/Noun,1,1,0,1.1115310228308472e-05,0.0,1.0
48031,취했다/Noun,1,0,1,0.0,1.1106915165381966e-05,1.0
48032,길은혜/Noun,1,1,0,1.1115310228308472e-05,0.0,1.0
48033,서주영/Noun,1,1,0,1.1115310228308472e-05,0.0,1.0
48034,심하닥/Noun,1,0,1,0.0,1.1106915165381966e-05,1.0
48035,어란/Noun,1,0,1,0.0,1.1106915165381966e-05,1.0
48036,만쿤/Noun,1,0,1,0.0,1.1106915165381966e-05,1.0
48037,동물병원/Noun,1,1,0,1.1115310228308472e-05,0.0,1.0
48038,멋있늬/Noun,1,1,0,1.1115310228308472e-05,0.0,1.0
48039,배떄/Noun,1,0,1,0.0,1.1106915165381966e-05,1.0
48040,적눈/Noun,1,1,0,1.1115310228308472e-05,0.0,1.0
48041,볼만헀음/Noun,1,1,0,1.1115310228308472e-05,0.0,1.0
48042,멜돌춤시킬땨/Noun,1,0,1,0.0,1.1106915165381966e-05,1.0
48043,뽕삘/Noun,1,0,1,0.0,1.1106915165381966e-05,1.0
48044,냉기/Noun,1,1,0,1.1115310228308472e-05,0.0,1.0
48045,키치조지/Noun,1,1,0,1.1115310228308472e-05,0.0,1.0
48046,나츠키/Noun,1,1,0,1.1115310228308472e-05,0.0,1.0
48047,!!..!!!/Punctuation,1,0,1,0.0,1.1106915165381966e-05,1.0
48048,케찹/Noun,1,0,1,0.0,1.1106915165381966e-05,1.0
48049,권민중/Noun,1,0,1,0.0,1.1106915165381966e-05,1.0
48050,말이얌/Noun,1,0,1,0.0,1.1106915165381966e-05,1.0
48051,own/Alpha,1,1,0,1.1115310228308472e-05,0.0,1.0
48052,playing/Alpha,1,1,0,1.1115310228308472e-05,0.0,1.0
48053,Forrester/Alpha,1,1,0,1.1115310228308472e-05,0.0,1.0
48054,William/Alpha,1,1,0,1.1115310228308472e-05,0.0,1.0
48055,2293/Number,1,1,0,1.1115310228308472e-05,0.0,1.0
48056,3227/Number,1,1,0,1.1115310228308472e-05,0.0,1.0
48057,김현/Noun,1,1,0,1.1115310228308472e-05,0.0,1.0
48058,!!!!!!!!!!!!!!!!!!!!!!!!!!!!!!!!!!!/Punctuation,1,1,0,1.1115310228308472e-05,0.0,1.0
48059,촬열/Noun,1,0,1,0.0,1.1106915165381966e-05,1.0
48060,군사시설/Noun,1,0,1,0.0,1.1106915165381966e-05,1.0
48061,맹숭맹숭하/Noun,1,0,1,0.0,1.1106915165381966e-05,1.0
48062,캬약/Noun,1,1,0,1.1115310228308472e-05,0.0,1.0
48063,모친상/Noun,1,0,1,0.0,1.1106915165381966e-05,1.0
48064,경엽/Noun,1,0,1,0.0,1.1106915165381966e-05,1.0
48065,장갑차/Noun,1,0,1,0.0,1.1106915165381966e-05,1.0
48066,전이지만/Foreign,1,0,1,0.0,1.1106915165381966e-05,1.0
48067,백재현/Noun,1,0,1,0.0,1.1106915165381966e-05,1.0
48068,가라앉히다/Verb,1,1,0,1.1115310228308472e-05,0.0,1.0
48069,아이스박스/Noun,1,1,0,1.1115310228308472e-05,0.0,1.0
48070,영사기/Noun,1,0,1,0.0,1.1106915165381966e-05,1.0
48071,우롱차/Noun,1,1,0,1.1115310228308472e-05,0.0,1.0
48072,_.#/Punctuation,1,0,1,0.0,1.1106915165381966e-05,1.0
48073,(^./Punctuation,1,0,1,0.0,1.1106915165381966e-05,1.0
48074,_^:/Punctuation,1,0,1,0.0,1.1106915165381966e-05,1.0
48075,#(^(/Punctuation,1,0,1,0.0,1.1106915165381966e-05,1.0
48076,(^(/Punctuation,1,0,1,0.0,1.1106915165381966e-05,1.0
48077,^_((/Punctuation,1,0,1,0.0,1.1106915165381966e-05,1.0
48078,:#(^(/Punctuation,1,0,1,0.0,1.1106915165381966e-05,1.0
48079,능지/Noun,1,1,0,1.1115310228308472e-05,0.0,1.0
48080,판섭역/Noun,1,1,0,1.1115310228308472e-05,0.0,1.0
48081,맴잼잼잼젬/Noun,1,1,0,1.1115310228308472e-05,0.0,1.0
48082,통코/Noun,1,0,1,0.0,1.1106915165381966e-05,1.0
48083,빙글뱅글/Noun,1,0,1,0.0,1.1106915165381966e-05,1.0
48084,dmx/Alpha,1,1,0,1.1115310228308472e-05,0.0,1.0
48085,jyp/Alpha,1,0,1,0.0,1.1106915165381966e-05,1.0
48086,왜집/Noun,1,0,1,0.0,1.1106915165381966e-05,1.0
48087,엔터테이너/Noun,1,1,0,1.1115310228308472e-05,0.0,1.0
48088,분탕침/Noun,1,0,1,0.0,1.1106915165381966e-05,1.0
48089,넖/Noun,1,0,1,0.0,1.1106915165381966e-05,1.0
48090,뜨레/Noun,1,0,1,0.0,1.1106915165381966e-05,1.0
48091,레기뜨레기뜨레/Noun,1,0,1,0.0,1.1106915165381966e-05,1.0
48092,캐망작/Noun,1,0,1,0.0,1.1106915165381966e-05,1.0
48093,터프하군/Noun,1,1,0,1.1115310228308472e-05,0.0,1.0
48094,쇄신/Noun,1,0,1,0.0,1.1106915165381966e-05,1.0
48095,고수로/Noun,1,1,0,1.1115310228308472e-05,0.0,1.0
48096,상접/Noun,1,0,1,0.0,1.1106915165381966e-05,1.0
48097,피골/Noun,1,0,1,0.0,1.1106915165381966e-05,1.0
48098,앵두/Noun,1,0,1,0.0,1.1106915165381966e-05,1.0
48099,10000000000000/Number,1,0,1,0.0,1.1106915165381966e-05,1.0
48100,노량해전/Noun,1,1,0,1.1115310228308472e-05,0.0,1.0
48101,머리색깔/Noun,1,0,1,0.0,1.1106915165381966e-05,1.0
48102,women/Alpha,1,1,0,1.1115310228308472e-05,0.0,1.0
48103,걘/Noun,1,1,0,1.1115310228308472e-05,0.0,1.0
48104,숭무관/Noun,1,1,0,1.1115310228308472e-05,0.0,1.0
48105,묘령/Noun,1,0,1,0.0,1.1106915165381966e-05,1.0
48106,가극/Noun,1,1,0,1.1115310228308472e-05,0.0,1.0
48107,단영/Noun,1,0,1,0.0,1.1106915165381966e-05,1.0
48108,좃쓰렉이/Noun,1,0,1,0.0,1.1106915165381966e-05,1.0
48109,원자폭탄/Noun,1,0,1,0.0,1.1106915165381966e-05,1.0
48110,앤드/Noun,1,1,0,1.1115310228308472e-05,0.0,1.0
48111,아량/Noun,1,1,0,1.1115310228308472e-05,0.0,1.0
48112,정연식/Noun,1,0,1,0.0,1.1106915165381966e-05,1.0
48113,해해해/Noun,1,0,1,0.0,1.1106915165381966e-05,1.0
48114,끽끽끄끅데/Noun,1,0,1,0.0,1.1106915165381966e-05,1.0
48115,dayb/Alpha,1,0,1,0.0,1.1106915165381966e-05,1.0
48116,아비규환/Noun,1,1,0,1.1115310228308472e-05,0.0,1.0
48117,아깝드/Noun,1,0,1,0.0,1.1106915165381966e-05,1.0
48118,달치/Noun,1,1,0,1.1115310228308472e-05,0.0,1.0
48119,antjqek/Alpha,1,0,1,0.0,1.1106915165381966e-05,1.0
48120,육이/Noun,1,1,0,1.1115310228308472e-05,0.0,1.0
48121,배근/Noun,1,1,0,1.1115310228308472e-05,0.0,1.0
48122,저작권소송/Noun,1,1,0,1.1115310228308472e-05,0.0,1.0
48123,아릅다/Noun,1,1,0,1.1115310228308472e-05,0.0,1.0
48124,슬펏는데/Noun,1,1,0,1.1115310228308472e-05,0.0,1.0
48125,성민/Noun,1,1,0,1.1115310228308472e-05,0.0,1.0
48126,내직/Noun,1,1,0,1.1115310228308472e-05,0.0,1.0
48127,꼬은데다/Noun,1,0,1,0.0,1.1106915165381966e-05,1.0
48128,심건욱/Noun,1,1,0,1.1115310228308472e-05,0.0,1.0
48129,부타/Noun,1,1,0,1.1115310228308472e-05,0.0,1.0
48130,정중하다/Adjective,1,1,0,1.1115310228308472e-05,0.0,1.0
48131,광고주/Noun,1,1,0,1.1115310228308472e-05,0.0,1.0
48132,♥━♥/Foreign,1,1,0,1.1115310228308472e-05,0.0,1.0
48133,일심/Noun,1,0,1,0.0,1.1106915165381966e-05,1.0
48134,짤막하다/Adjective,1,0,1,0.0,1.1106915165381966e-05,1.0
48135,……?/Punctuation,1,1,0,1.1115310228308472e-05,0.0,1.0
48136,신식/Noun,1,0,1,0.0,1.1106915165381966e-05,1.0
48137,파라다이스목장/Noun,1,1,0,1.1115310228308472e-05,0.0,1.0
48138,나홍진/Noun,1,1,0,1.1115310228308472e-05,0.0,1.0
48139,봣엇다/Noun,1,1,0,1.1115310228308472e-05,0.0,1.0
48140,흐유/Noun,1,0,1,0.0,1.1106915165381966e-05,1.0
48141,멋지셧음/Noun,1,1,0,1.1115310228308472e-05,0.0,1.0
48142,회햇/Noun,1,1,0,1.1115310228308472e-05,0.0,1.0
48143,구안/Noun,1,1,0,1.1115310228308472e-05,0.0,1.0
48144,롤러스케이트/Noun,1,1,0,1.1115310228308472e-05,0.0,1.0
48145,낙방/Noun,1,0,1,0.0,1.1106915165381966e-05,1.0
48146,샤샤/Noun,1,1,0,1.1115310228308472e-05,0.0,1.0
48147,뿌듯/Noun,1,1,0,1.1115310228308472e-05,0.0,1.0
48148,구금/Noun,1,1,0,1.1115310228308472e-05,0.0,1.0
48149,웄/Noun,1,1,0,1.1115310228308472e-05,0.0,1.0
48150,레크레이션/Noun,1,0,1,0.0,1.1106915165381966e-05,1.0
48151,이상부터는/Foreign,1,0,1,0.0,1.1106915165381966e-05,1.0
48152,물런/Noun,1,0,1,0.0,1.1106915165381966e-05,1.0
48153,http://blog.naver.com/cjstkrkwn/40207983729/URL,1,1,0,1.1115310228308472e-05,0.0,1.0
48154,용용/Noun,1,1,0,1.1115310228308472e-05,0.0,1.0
48155,볼방업엄/Noun,1,1,0,1.1115310228308472e-05,0.0,1.0
48156,빠킹/Noun,1,0,1,0.0,1.1106915165381966e-05,1.0
48157,마교/Noun,1,1,0,1.1115310228308472e-05,0.0,1.0
48158,뷰리풀/Noun,1,1,0,1.1115310228308472e-05,0.0,1.0
48159,작이라서/Foreign,1,0,1,0.0,1.1106915165381966e-05,1.0
48160,nom/Alpha,1,0,1,0.0,1.1106915165381966e-05,1.0
48161,딩신/Noun,1,0,1,0.0,1.1106915165381966e-05,1.0
48162,칼집/Noun,1,0,1,0.0,1.1106915165381966e-05,1.0
48163,9513578/Number,1,1,0,1.1115310228308472e-05,0.0,1.0
48164,호군/Noun,1,1,0,1.1115310228308472e-05,0.0,1.0
48165,점호/Noun,1,1,0,1.1115310228308472e-05,0.0,1.0
48166,텔레반/Noun,1,0,1,0.0,1.1106915165381966e-05,1.0
48167,잼꿀/Noun,1,1,0,1.1115310228308472e-05,0.0,1.0
48168,ㅇㅎㅎㅎ/KoreanParticle,1,1,0,1.1115310228308472e-05,0.0,1.0
48169,포턴/Noun,1,1,0,1.1115310228308472e-05,0.0,1.0
48170,냥심/Noun,1,1,0,1.1115310228308472e-05,0.0,1.0
48171,바랜/Noun,1,1,0,1.1115310228308472e-05,0.0,1.0
48172,대님/Noun,1,0,1,0.0,1.1106915165381966e-05,1.0
48173,후발/Noun,1,0,1,0.0,1.1106915165381966e-05,1.0
48174,플라이트/Noun,1,0,1,0.0,1.1106915165381966e-05,1.0
48175,어쩌겟수/Noun,1,1,0,1.1115310228308472e-05,0.0,1.0
48176,안봤느넫/Noun,1,0,1,0.0,1.1106915165381966e-05,1.0
48177,플로우/Noun,1,0,1,0.0,1.1106915165381966e-05,1.0
48178,인간실격/Noun,1,0,1,0.0,1.1106915165381966e-05,1.0
48179,^}/Punctuation,1,0,1,0.0,1.1106915165381966e-05,1.0
48180,{^/Punctuation,1,0,1,0.0,1.1106915165381966e-05,1.0
48181,두보/Noun,1,0,1,0.0,1.1106915165381966e-05,1.0
48182,#디워2/Hashtag,1,0,1,0.0,1.1106915165381966e-05,1.0
48183,#셀프디스/Hashtag,1,0,1,0.0,1.1106915165381966e-05,1.0
48184,말차/Noun,1,1,0,1.1115310228308472e-05,0.0,1.0
48185,붸에/Noun,1,1,0,1.1115310228308472e-05,0.0,1.0
48186,와칸/Noun,1,1,0,1.1115310228308472e-05,0.0,1.0
48187,넘어가면/Foreign,1,0,1,0.0,1.1106915165381966e-05,1.0
48188,서정하/Noun,1,0,1,0.0,1.1106915165381966e-05,1.0
48189,뭉게/Noun,1,0,1,0.0,1.1106915165381966e-05,1.0
48190,빂츠갔더/Noun,1,1,0,1.1115310228308472e-05,0.0,1.0
48191,절쌕쒸하/Noun,1,0,1,0.0,1.1106915165381966e-05,1.0
48192,북녀/Noun,1,0,1,0.0,1.1106915165381966e-05,1.0
48193,름답/Noun,1,1,0,1.1115310228308472e-05,0.0,1.0
48194,眠れる美女/Foreign,1,0,1,0.0,1.1106915165381966e-05,1.0
48195,최슨/Noun,1,0,1,0.0,1.1106915165381966e-05,1.0
48196,부전자전/Noun,1,1,0,1.1115310228308472e-05,0.0,1.0
48197,검무/Noun,1,0,1,0.0,1.1106915165381966e-05,1.0
48198,포용/Noun,1,1,0,1.1115310228308472e-05,0.0,1.0
48199,방파제/Noun,1,0,1,0.0,1.1106915165381966e-05,1.0
48200,건기/Noun,1,1,0,1.1115310228308472e-05,0.0,1.0
48201,느겼다/Noun,1,1,0,1.1115310228308472e-05,0.0,1.0
48202,나디아/Noun,1,1,0,1.1115310228308472e-05,0.0,1.0
48203,목도리/Noun,1,0,1,0.0,1.1106915165381966e-05,1.0
48204,구씨/Noun,1,0,1,0.0,1.1106915165381966e-05,1.0
48205,여구/Noun,1,0,1,0.0,1.1106915165381966e-05,1.0
48206,태수/Noun,1,0,1,0.0,1.1106915165381966e-05,1.0
48207,광대도/Noun,1,0,1,0.0,1.1106915165381966e-05,1.0
48208,애렸던/Noun,1,1,0,1.1115310228308472e-05,0.0,1.0
48209,영화로봣는데/Foreign,1,0,1,0.0,1.1106915165381966e-05,1.0
48210,단식/Noun,1,0,1,0.0,1.1106915165381966e-05,1.0
48211,지율스님/Noun,1,0,1,0.0,1.1106915165381966e-05,1.0
48212,업사이드다운/Noun,1,0,1,0.0,1.1106915165381966e-05,1.0
48213,아싑/Noun,1,0,1,0.0,1.1106915165381966e-05,1.0
48214,김희수/Noun,1,1,0,1.1115310228308472e-05,0.0,1.0
48215,리온/Noun,1,1,0,1.1115310228308472e-05,0.0,1.0
48216,파티씬/Noun,1,1,0,1.1115310228308472e-05,0.0,1.0
48217,분필/Noun,1,1,0,1.1115310228308472e-05,0.0,1.0
48218,#^/Punctuation,1,1,0,1.1115310228308472e-05,0.0,1.0
48219,♤/Foreign,1,1,0,1.1115310228308472e-05,0.0,1.0
48220,÷/Foreign,1,1,0,1.1115310228308472e-05,0.0,1.0
48221,#&':@&@(@*/Punctuation,1,1,0,1.1115310228308472e-05,0.0,1.0
48222,ㅇㄷㄴ/KoreanParticle,1,0,1,0.0,1.1106915165381966e-05,1.0
48223,",.,.,/Punctuation",1,0,1,0.0,1.1106915165381966e-05,1.0
48224,창렬/Noun,1,1,0,1.1115310228308472e-05,0.0,1.0
48225,평인/Noun,1,0,1,0.0,1.1106915165381966e-05,1.0
48226,ㅅㅅㅋㅋ/KoreanParticle,1,0,1,0.0,1.1106915165381966e-05,1.0
48227,컨텐더급/Noun,1,0,1,0.0,1.1106915165381966e-05,1.0
48228,좋꼬/Noun,1,1,0,1.1115310228308472e-05,0.0,1.0
48229,엘리게이/Noun,1,0,1,0.0,1.1106915165381966e-05,1.0
48230,개골개골/Adverb,1,1,0,1.1115310228308472e-05,0.0,1.0
48231,암벽타기/Noun,1,0,1,0.0,1.1106915165381966e-05,1.0
48232,",.^^/Punctuation",1,1,0,1.1115310228308472e-05,0.0,1.0
48233,워리/Noun,1,1,0,1.1115310228308472e-05,0.0,1.0
48234,31~34분/Number,1,0,1,0.0,1.1106915165381966e-05,1.0
48235,옥시/Noun,1,0,1,0.0,1.1106915165381966e-05,1.0
48236,짱째밌었오/Noun,1,1,0,1.1115310228308472e-05,0.0,1.0
48237,짯던/Noun,1,1,0,1.1115310228308472e-05,0.0,1.0
48238,파리대왕/Noun,1,1,0,1.1115310228308472e-05,0.0,1.0
48239,코리언/Noun,1,0,1,0.0,1.1106915165381966e-05,1.0
48240,면신/Noun,1,1,0,1.1115310228308472e-05,0.0,1.0
48241,애뎀/Noun,1,0,1,0.0,1.1106915165381966e-05,1.0
48242,Sad/Alpha,1,1,0,1.1115310228308472e-05,0.0,1.0
48243,무방비/Noun,1,0,1,0.0,1.1106915165381966e-05,1.0
48244,토해/Noun,1,1,0,1.1115310228308472e-05,0.0,1.0
48245,目力、/Foreign,1,1,0,1.1115310228308472e-05,0.0,1.0
48246,쿠스코/Noun,1,1,0,1.1115310228308472e-05,0.0,1.0
48247,스타쯔/Noun,1,1,0,1.1115310228308472e-05,0.0,1.0
48248,잘생겻엄/Noun,1,1,0,1.1115310228308472e-05,0.0,1.0
48249,뼈뿌러트리/Noun,1,0,1,0.0,1.1106915165381966e-05,1.0
48250,죠애니/Noun,1,1,0,1.1115310228308472e-05,0.0,1.0
48251,떨어트렸다/Noun,1,0,1,0.0,1.1106915165381966e-05,1.0
48252,倭色/Foreign,1,0,1,0.0,1.1106915165381966e-05,1.0
48253,페라라/Noun,1,1,0,1.1115310228308472e-05,0.0,1.0
48254,아벨/Noun,1,1,0,1.1115310228308472e-05,0.0,1.0
48255,ones/Alpha,1,1,0,1.1115310228308472e-05,0.0,1.0
48256,스웨이드/Noun,1,1,0,1.1115310228308472e-05,0.0,1.0
48257,국국/Noun,1,0,1,0.0,1.1106915165381966e-05,1.0
48258,하네/Foreign,1,0,1,0.0,1.1106915165381966e-05,1.0
48259,잘생겻네/Noun,1,1,0,1.1115310228308472e-05,0.0,1.0
48260,랏다/Noun,1,0,1,0.0,1.1106915165381966e-05,1.0
48261,rr/Alpha,1,1,0,1.1115310228308472e-05,0.0,1.0
48262,3.98/Number,1,0,1,0.0,1.1106915165381966e-05,1.0
48263,덕돌임/Noun,1,1,0,1.1115310228308472e-05,0.0,1.0
48264,에펙/Noun,1,1,0,1.1115310228308472e-05,0.0,1.0
48265,에펙팬되/Noun,1,1,0,1.1115310228308472e-05,0.0,1.0
48266,cin/Alpha,1,1,0,1.1115310228308472e-05,0.0,1.0
48267,9.64/Number,1,1,0,1.1115310228308472e-05,0.0,1.0
48268,반짝임/Noun,1,0,1,0.0,1.1106915165381966e-05,1.0
48269,유명인사/Noun,1,0,1,0.0,1.1106915165381966e-05,1.0
48270,유흥/Noun,1,0,1,0.0,1.1106915165381966e-05,1.0
48271,웠더헬/Noun,1,0,1,0.0,1.1106915165381966e-05,1.0
48272,암프/Noun,1,1,0,1.1115310228308472e-05,0.0,1.0
48273,디아나/Noun,1,1,0,1.1115310228308472e-05,0.0,1.0
48274,~~~~*/Punctuation,1,1,0,1.1115310228308472e-05,0.0,1.0
48275,욮/Noun,1,1,0,1.1115310228308472e-05,0.0,1.0
48276,할렵니/Noun,1,1,0,1.1115310228308472e-05,0.0,1.0
48277,아쉡네/Noun,1,0,1,0.0,1.1106915165381966e-05,1.0
48278,정밍/Noun,1,0,1,0.0,1.1106915165381966e-05,1.0
48279,쉔/Noun,1,1,0,1.1115310228308472e-05,0.0,1.0
48280,전이군/Foreign,1,0,1,0.0,1.1106915165381966e-05,1.0
48281,허비했어도/Foreign,1,1,0,1.1115310228308472e-05,0.0,1.0
48282,인맥쩌/Noun,1,1,0,1.1115310228308472e-05,0.0,1.0
48283,편조/Noun,1,1,0,1.1115310228308472e-05,0.0,1.0
48284,이근안/Noun,1,1,0,1.1115310228308472e-05,0.0,1.0
48285,카렐식/Noun,1,1,0,1.1115310228308472e-05,0.0,1.0
48286,Penny/Alpha,1,1,0,1.1115310228308472e-05,0.0,1.0
48287,큰둥/Noun,1,0,1,0.0,1.1106915165381966e-05,1.0
48288,배배꼬려/Noun,1,0,1,0.0,1.1106915165381966e-05,1.0
48289,블루마운틴/Noun,1,1,0,1.1115310228308472e-05,0.0,1.0
48290,퀵이유/Noun,1,0,1,0.0,1.1106915165381966e-05,1.0
48291,미누스/Noun,1,1,0,1.1115310228308472e-05,0.0,1.0
48292,에먼/Noun,1,0,1,0.0,1.1106915165381966e-05,1.0
48293,빕스/Noun,1,0,1,0.0,1.1106915165381966e-05,1.0
48294,Meet/Alpha,1,0,1,0.0,1.1106915165381966e-05,1.0
48295,Could/Alpha,1,0,1,0.0,1.1106915165381966e-05,1.0
48296,댄포글러/Noun,1,1,0,1.1115310228308472e-05,0.0,1.0
48297,북극권/Noun,1,1,0,1.1115310228308472e-05,0.0,1.0
48298,커쇼/Noun,1,0,1,0.0,1.1106915165381966e-05,1.0
48299,crist/Alpha,1,0,1,0.0,1.1106915165381966e-05,1.0
48300,jesus/Alpha,1,0,1,0.0,1.1106915165381966e-05,1.0
48301,yeah/Alpha,1,0,1,0.0,1.1106915165381966e-05,1.0
48302,pian/Alpha,1,1,0,1.1115310228308472e-05,0.0,1.0
48303,맹자/Noun,1,0,1,0.0,1.1106915165381966e-05,1.0
48304,모성은/Noun,1,0,1,0.0,1.1106915165381966e-05,1.0
48305,없어졋는/Noun,1,0,1,0.0,1.1106915165381966e-05,1.0
48306,눈을땔수/Noun,1,1,0,1.1115310228308472e-05,0.0,1.0
48307,ㅔㄺ/KoreanParticle,1,0,1,0.0,1.1106915165381966e-05,1.0
48308,웰웨웨웨/Noun,1,0,1,0.0,1.1106915165381966e-05,1.0
48309,공민지/Noun,1,0,1,0.0,1.1106915165381966e-05,1.0
48310,KILL/Alpha,1,0,1,0.0,1.1106915165381966e-05,1.0
48311,대만해도/Foreign,1,1,0,1.1115310228308472e-05,0.0,1.0
48312,해야할런/Noun,1,0,1,0.0,1.1106915165381966e-05,1.0
48313,섬숭/Noun,1,0,1,0.0,1.1106915165381966e-05,1.0
48314,령제로/Noun,1,0,1,0.0,1.1106915165381966e-05,1.0
48315,근/Noun,1,0,1,0.0,1.1106915165381966e-05,1.0
48316,우넷/Noun,1,0,1,0.0,1.1106915165381966e-05,1.0
48317,해서/Foreign,1,0,1,0.0,1.1106915165381966e-05,1.0
48318,투여/Noun,1,0,1,0.0,1.1106915165381966e-05,1.0
48319,오랄/Noun,1,0,1,0.0,1.1106915165381966e-05,1.0
48320,구릉/Noun,1,0,1,0.0,1.1106915165381966e-05,1.0
48321,놨구/Noun,1,0,1,0.0,1.1106915165381966e-05,1.0
48322,corp/Alpha,1,1,0,1.1115310228308472e-05,0.0,1.0
48323,marine/Alpha,1,1,0,1.1115310228308472e-05,0.0,1.0
48324,내비게이션/Noun,1,0,1,0.0,1.1106915165381966e-05,1.0
48325,서유럽/Noun,1,1,0,1.1115310228308472e-05,0.0,1.0
48326,.........>/Punctuation,1,0,1,0.0,1.1106915165381966e-05,1.0
48327,hold/Alpha,1,1,0,1.1115310228308472e-05,0.0,1.0
48328,키즈리턴/Noun,1,1,0,1.1115310228308472e-05,0.0,1.0
48329,컷트/Noun,1,0,1,0.0,1.1106915165381966e-05,1.0
48330,-_-;;;;;;;;;;;/Punctuation,1,0,1,0.0,1.1106915165381966e-05,1.0
48331,표준말/Noun,1,0,1,0.0,1.1106915165381966e-05,1.0
48332,닥본할끙/Noun,1,1,0,1.1115310228308472e-05,0.0,1.0
48333,혜결/Noun,1,1,0,1.1115310228308472e-05,0.0,1.0
48334,돋다/Noun,1,1,0,1.1115310228308472e-05,0.0,1.0
48335,..^^///Punctuation,1,1,0,1.1115310228308472e-05,0.0,1.0
48336,core/Alpha,1,1,0,1.1115310228308472e-05,0.0,1.0
48337,바바바/Noun,1,1,0,1.1115310228308472e-05,0.0,1.0
48338,bestofbest/Alpha,1,1,0,1.1115310228308472e-05,0.0,1.0
48339,9.59/Number,1,0,1,0.0,1.1106915165381966e-05,1.0
48340,몆컷/Noun,1,0,1,0.0,1.1106915165381966e-05,1.0
48341,정재민/Noun,1,0,1,0.0,1.1106915165381966e-05,1.0
48342,연년생/Noun,1,0,1,0.0,1.1106915165381966e-05,1.0
48343,야리다/Adjective,1,0,1,0.0,1.1106915165381966e-05,1.0
48344,에이지오브엠파이어/Noun,1,0,1,0.0,1.1106915165381966e-05,1.0
48345,꼬꼭/Noun,1,1,0,1.1115310228308472e-05,0.0,1.0
48346,참기름/Noun,1,0,1,0.0,1.1106915165381966e-05,1.0
48347,이현지/Noun,1,0,1,0.0,1.1106915165381966e-05,1.0
48348,전박/Noun,1,0,1,0.0,1.1106915165381966e-05,1.0
48349,관찮음/Noun,1,0,1,0.0,1.1106915165381966e-05,1.0
48350,테무칸/Noun,1,0,1,0.0,1.1106915165381966e-05,1.0
48351,카르/Noun,1,0,1,0.0,1.1106915165381966e-05,1.0
48352,잘버무린/Noun,1,1,0,1.1115310228308472e-05,0.0,1.0
48353,오늘썜/Noun,1,1,0,1.1115310228308472e-05,0.0,1.0
48354,갓파/Noun,1,1,0,1.1115310228308472e-05,0.0,1.0
48355,폐함/Noun,1,1,0,1.1115310228308472e-05,0.0,1.0
48356,dodl/Alpha,1,1,0,1.1115310228308472e-05,0.0,1.0
48357,ㅅㅂㅡㅡ/KoreanParticle,1,0,1,0.0,1.1106915165381966e-05,1.0
48358,ㅛㅏㅏㅊ/KoreanParticle,1,1,0,1.1115310228308472e-05,0.0,1.0
48359,gomez/Alpha,1,1,0,1.1115310228308472e-05,0.0,1.0
48360,selena/Alpha,1,1,0,1.1115310228308472e-05,0.0,1.0
48361,브레이킹던/Noun,1,1,0,1.1115310228308472e-05,0.0,1.0
48362,평촌/Noun,1,0,1,0.0,1.1106915165381966e-05,1.0
48363,현악기/Noun,1,1,0,1.1115310228308472e-05,0.0,1.0
48364,양치/Noun,1,0,1,0.0,1.1106915165381966e-05,1.0
48365,여명에게/Foreign,1,0,1,0.0,1.1106915165381966e-05,1.0
48366,나왓을땐/Noun,1,1,0,1.1115310228308472e-05,0.0,1.0
48367,不好/Foreign,1,0,1,0.0,1.1106915165381966e-05,1.0
48368,뭘바/Noun,1,1,0,1.1115310228308472e-05,0.0,1.0
48369,홍태경/Noun,1,0,1,0.0,1.1106915165381966e-05,1.0
48370,렷기/Noun,1,1,0,1.1115310228308472e-05,0.0,1.0
48371,따내다/Verb,1,1,0,1.1115310228308472e-05,0.0,1.0
48372,11/22일/Number,1,0,1,0.0,1.1106915165381966e-05,1.0
48373,매각/Noun,1,0,1,0.0,1.1106915165381966e-05,1.0
48374,백지상태/Noun,1,0,1,0.0,1.1106915165381966e-05,1.0
48375,기우뚱/Adverb,1,1,0,1.1115310228308472e-05,0.0,1.0
48376,귀엽닥/Noun,1,1,0,1.1115310228308472e-05,0.0,1.0
48377,기엽/Noun,1,1,0,1.1115310228308472e-05,0.0,1.0
48378,fuuuuuuuuuck/Alpha,1,0,1,0.0,1.1106915165381966e-05,1.0
48379,더뜸/Noun,1,0,1,0.0,1.1106915165381966e-05,1.0
48380,지엽다/Noun,1,0,1,0.0,1.1106915165381966e-05,1.0
48381,상징물/Noun,1,1,0,1.1115310228308472e-05,0.0,1.0
48382,오강/Noun,1,1,0,1.1115310228308472e-05,0.0,1.0
48383,펑샤/Noun,1,1,0,1.1115310228308472e-05,0.0,1.0
48384,8.40/Number,1,1,0,1.1115310228308472e-05,0.0,1.0
48385,9.57/Number,1,1,0,1.1115310228308472e-05,0.0,1.0
48386,5/29일/Number,1,1,0,1.1115310228308472e-05,0.0,1.0
48387,영화비평가/Noun,1,1,0,1.1115310228308472e-05,0.0,1.0
48388,성수/Noun,1,0,1,0.0,1.1106915165381966e-05,1.0
48389,야킨/Noun,1,1,0,1.1115310228308472e-05,0.0,1.0
48390,전어렵게구해서본영화/Foreign,1,1,0,1.1115310228308472e-05,0.0,1.0
48391,논증/Noun,1,0,1,0.0,1.1106915165381966e-05,1.0
48392,낲/Noun,1,0,1,0.0,1.1106915165381966e-05,1.0
48393,flower/Alpha,1,1,0,1.1115310228308472e-05,0.0,1.0
48394,hangl/Alpha,1,1,0,1.1115310228308472e-05,0.0,1.0
48395,push/Alpha,1,1,0,1.1115310228308472e-05,0.0,1.0
48396,진기하다/Adjective,1,0,1,0.0,1.1106915165381966e-05,1.0
48397,맘마/Noun,1,1,0,1.1115310228308472e-05,0.0,1.0
48398,fffffuuuuu/Alpha,1,0,1,0.0,1.1106915165381966e-05,1.0
48399,들어서는/Foreign,1,1,0,1.1115310228308472e-05,0.0,1.0
48400,미카사/Noun,1,0,1,0.0,1.1106915165381966e-05,1.0
48401,무혐/Noun,1,0,1,0.0,1.1106915165381966e-05,1.0
48402,찌이잉/Noun,1,1,0,1.1115310228308472e-05,0.0,1.0
48403,알구/Noun,1,1,0,1.1115310228308472e-05,0.0,1.0
48404,옆뒤/Noun,1,0,1,0.0,1.1106915165381966e-05,1.0
48405,초강대국/Noun,1,1,0,1.1115310228308472e-05,0.0,1.0
48406,톰일/Noun,1,1,0,1.1115310228308472e-05,0.0,1.0
48407,헌책방/Noun,1,0,1,0.0,1.1106915165381966e-05,1.0
48408,윌앤/Noun,1,0,1,0.0,1.1106915165381966e-05,1.0
48409,철도청/Noun,1,0,1,0.0,1.1106915165381966e-05,1.0
48410,ㆍㆍㆍ/Foreign,1,0,1,0.0,1.1106915165381966e-05,1.0
48411,두쿠/Noun,1,1,0,1.1115310228308472e-05,0.0,1.0
48412,상노/Noun,1,1,0,1.1115310228308472e-05,0.0,1.0
48413,뵛스/Noun,1,1,0,1.1115310228308472e-05,0.0,1.0
48414,베송찡/Noun,1,1,0,1.1115310228308472e-05,0.0,1.0
48415,애국마캐팅/Noun,1,0,1,0.0,1.1106915165381966e-05,1.0
48416,패드/Noun,1,1,0,1.1115310228308472e-05,0.0,1.0
48417,킬드레/Noun,1,1,0,1.1115310228308472e-05,0.0,1.0
48418,거릴수/Noun,1,1,0,1.1115310228308472e-05,0.0,1.0
48419,건만/Foreign,1,0,1,0.0,1.1106915165381966e-05,1.0
48420,불규칙하다/Adjective,1,0,1,0.0,1.1106915165381966e-05,1.0
48421,윤민수/Noun,1,0,1,0.0,1.1106915165381966e-05,1.0
48422,이블린/Noun,1,1,0,1.1115310228308472e-05,0.0,1.0
48423,광속구/Noun,1,1,0,1.1115310228308472e-05,0.0,1.0
48424,의젓하다/Adjective,1,0,1,0.0,1.1106915165381966e-05,1.0
48425,전영화거든요데체언제적영활보고지금도연기못하는거마냥애기정말웃기네/Foreign,1,1,0,1.1115310228308472e-05,0.0,1.0
48426,구전/Noun,1,0,1,0.0,1.1106915165381966e-05,1.0
48427,한음/Noun,1,1,0,1.1115310228308472e-05,0.0,1.0
48428,지나고마마죽고임신했는데/Foreign,1,0,1,0.0,1.1106915165381966e-05,1.0
48429,암치료/Noun,1,0,1,0.0,1.1106915165381966e-05,1.0
48430,총씬/Noun,1,0,1,0.0,1.1106915165381966e-05,1.0
48431,보이시/Noun,1,0,1,0.0,1.1106915165381966e-05,1.0
48432,자립하다/Adjective,1,1,0,1.1115310228308472e-05,0.0,1.0
48433,오닌/Noun,1,0,1,0.0,1.1106915165381966e-05,1.0
48434,엠씨더맥스/Noun,1,1,0,1.1115310228308472e-05,0.0,1.0
48435,무릅/Noun,1,1,0,1.1115310228308472e-05,0.0,1.0
48436,오글대다/Verb,1,0,1,0.0,1.1106915165381966e-05,1.0
48437,도드/Noun,1,1,0,1.1115310228308472e-05,0.0,1.0
48438,숫점/Noun,1,0,1,0.0,1.1106915165381966e-05,1.0
48439,나드만/Noun,1,0,1,0.0,1.1106915165381966e-05,1.0
48440,파벌/Noun,1,0,1,0.0,1.1106915165381966e-05,1.0
48441,한지붕세가족/Noun,1,1,0,1.1115310228308472e-05,0.0,1.0
48442,재질/Noun,1,0,1,0.0,1.1106915165381966e-05,1.0
48443,cgi/Alpha,1,0,1,0.0,1.1106915165381966e-05,1.0
48444,액샨/Noun,1,1,0,1.1115310228308472e-05,0.0,1.0
48445,이남주/Noun,1,0,1,0.0,1.1106915165381966e-05,1.0
48446,뒤꿈치/Noun,1,1,0,1.1115310228308472e-05,0.0,1.0
48447,동례/Noun,1,0,1,0.0,1.1106915165381966e-05,1.0
48448,몽뎅/Noun,1,1,0,1.1115310228308472e-05,0.0,1.0
48449,헛물켜기/Noun,1,0,1,0.0,1.1106915165381966e-05,1.0
48450,땡볕/Noun,1,0,1,0.0,1.1106915165381966e-05,1.0
48451,헬스/Noun,1,0,1,0.0,1.1106915165381966e-05,1.0
48452,아령/Noun,1,1,0,1.1115310228308472e-05,0.0,1.0
48453,뺠/Noun,1,1,0,1.1115310228308472e-05,0.0,1.0
48454,김경란/Noun,1,1,0,1.1115310228308472e-05,0.0,1.0
48455,aggressive/Alpha,1,0,1,0.0,1.1106915165381966e-05,1.0
48456,lesbians/Alpha,1,0,1,0.0,1.1106915165381966e-05,1.0
48457,wife/Alpha,1,0,1,0.0,1.1106915165381966e-05,1.0
48458,caucasian/Alpha,1,0,1,0.0,1.1106915165381966e-05,1.0
48459,husband/Alpha,1,0,1,0.0,1.1106915165381966e-05,1.0
48460,afro/Alpha,1,0,1,0.0,1.1106915165381966e-05,1.0
48461,호리/Noun,1,0,1,0.0,1.1106915165381966e-05,1.0
48462,4.00/Number,1,1,0,1.1115310228308472e-05,0.0,1.0
48463,"?,,,,,/Punctuation",1,1,0,1.1115310228308472e-05,0.0,1.0
48464,이탈리아어/Noun,1,1,0,1.1115310228308472e-05,0.0,1.0
48465,율브리너/Noun,1,0,1,0.0,1.1106915165381966e-05,1.0
48466,좆쩜/Noun,1,1,0,1.1115310228308472e-05,0.0,1.0
48467,쓰레기봉투/Noun,1,1,0,1.1115310228308472e-05,0.0,1.0
48468,꿀잼뀰댬/Noun,1,0,1,0.0,1.1106915165381966e-05,1.0
48469,쫄깃합니/Noun,1,1,0,1.1115310228308472e-05,0.0,1.0
48470,초코파이/Noun,1,0,1,0.0,1.1106915165381966e-05,1.0
48471,트롬/Noun,1,1,0,1.1115310228308472e-05,0.0,1.0
48472,할스/Noun,1,1,0,1.1115310228308472e-05,0.0,1.0
48473,쫗아가/Noun,1,1,0,1.1115310228308472e-05,0.0,1.0
48474,달란트/Noun,1,0,1,0.0,1.1106915165381966e-05,1.0
48475,@..@/Punctuation,1,1,0,1.1115310228308472e-05,0.0,1.0
48476,수파/Noun,1,1,0,1.1115310228308472e-05,0.0,1.0
48477,6.59/Number,1,0,1,0.0,1.1106915165381966e-05,1.0
48478,재밎/Noun,1,1,0,1.1115310228308472e-05,0.0,1.0
48479,꿈꾸웠던/Noun,1,1,0,1.1115310228308472e-05,0.0,1.0
48480,임시/Noun,1,1,0,1.1115310228308472e-05,0.0,1.0
48481,난너/Noun,1,1,0,1.1115310228308472e-05,0.0,1.0
48482,쌔련/Noun,1,1,0,1.1115310228308472e-05,0.0,1.0
48483,돈조반니/Noun,1,1,0,1.1115310228308472e-05,0.0,1.0
48484,다삿/Noun,1,1,0,1.1115310228308472e-05,0.0,1.0
48485,0000/Number,1,0,1,0.0,1.1106915165381966e-05,1.0
48486,000/Number,1,0,1,0.0,1.1106915165381966e-05,1.0
48487,엄현경/Noun,1,1,0,1.1115310228308472e-05,0.0,1.0
48488,디킨스/Noun,1,1,0,1.1115310228308472e-05,0.0,1.0
48489,다채롭다/Noun,1,1,0,1.1115310228308472e-05,0.0,1.0
48490,도안보고/Foreign,1,0,1,0.0,1.1106915165381966e-05,1.0
48491,엄머/Noun,1,0,1,0.0,1.1106915165381966e-05,1.0
48492,",,,.../Punctuation",1,1,0,1.1115310228308472e-05,0.0,1.0
48493,연애/Foreign,1,1,0,1.1115310228308472e-05,0.0,1.0
48494,",,,-,-/Punctuation",1,0,1,0.0,1.1106915165381966e-05,1.0
48495,동분서주/Noun,1,0,1,0.0,1.1106915165381966e-05,1.0
48496,단세포생물/Noun,1,0,1,0.0,1.1106915165381966e-05,1.0
48497,죠으/Noun,1,1,0,1.1115310228308472e-05,0.0,1.0
48498,해준둣/Noun,1,1,0,1.1115310228308472e-05,0.0,1.0
48499,생겻는데/Noun,1,0,1,0.0,1.1106915165381966e-05,1.0
48500,논곧논복숙/Noun,1,1,0,1.1115310228308472e-05,0.0,1.0
48501,슨노돋봊솢솢/Noun,1,1,0,1.1115310228308472e-05,0.0,1.0
48502,노두/Noun,1,1,0,1.1115310228308472e-05,0.0,1.0
48503,%.%/Punctuation,1,0,1,0.0,1.1106915165381966e-05,1.0
48504,파딜/Noun,1,0,1,0.0,1.1106915165381966e-05,1.0
48505,개스엠/Noun,1,0,1,0.0,1.1106915165381966e-05,1.0
48506,타산/Noun,1,1,0,1.1115310228308472e-05,0.0,1.0
48507,무용가/Noun,1,1,0,1.1115310228308472e-05,0.0,1.0
48508,송지혀/Noun,1,0,1,0.0,1.1106915165381966e-05,1.0
48509,팔이만/Noun,1,0,1,0.0,1.1106915165381966e-05,1.0
48510,박미현/Noun,1,0,1,0.0,1.1106915165381966e-05,1.0
48511,최수린/Noun,1,1,0,1.1115310228308472e-05,0.0,1.0
48512,유포자/Noun,1,0,1,0.0,1.1106915165381966e-05,1.0
48513,discovery/Alpha,1,1,0,1.1115310228308472e-05,0.0,1.0
48514,봣을뿐/Noun,1,1,0,1.1115310228308472e-05,0.0,1.0
48515,나이트폴/Noun,1,1,0,1.1115310228308472e-05,0.0,1.0
48516,빡이쳐/Noun,1,0,1,0.0,1.1106915165381966e-05,1.0
48517,탈것/Noun,1,0,1,0.0,1.1106915165381966e-05,1.0
48518,ㅋㅇㅋㅋ/KoreanParticle,1,0,1,0.0,1.1106915165381966e-05,1.0
48519,애길/Noun,1,1,0,1.1115310228308472e-05,0.0,1.0
48520,트레버/Noun,1,1,0,1.1115310228308472e-05,0.0,1.0
48521,느꼇을꺼/Noun,1,1,0,1.1115310228308472e-05,0.0,1.0
48522,에서와/Josa,1,1,0,1.1115310228308472e-05,0.0,1.0
48523,헌병대/Noun,1,1,0,1.1115310228308472e-05,0.0,1.0
48524,마적/Noun,1,1,0,1.1115310228308472e-05,0.0,1.0
48525,봉천/Noun,1,1,0,1.1115310228308472e-05,0.0,1.0
48526,뚝섬/Noun,1,1,0,1.1115310228308472e-05,0.0,1.0
48527,투덜맨/Noun,1,0,1,0.0,1.1106915165381966e-05,1.0
48528,땐사/Noun,1,0,1,0.0,1.1106915165381966e-05,1.0
48529,능뎅/Noun,1,1,0,1.1115310228308472e-05,0.0,1.0
48530,너무쫌/Noun,1,0,1,0.0,1.1106915165381966e-05,1.0
48531,금의위/Noun,1,0,1,0.0,1.1106915165381966e-05,1.0
48532,레기스/Noun,1,0,1,0.0,1.1106915165381966e-05,1.0
48533,옹졸하다/Adjective,1,0,1,0.0,1.1106915165381966e-05,1.0
48534,marmalade/Alpha,1,0,1,0.0,1.1106915165381966e-05,1.0
48535,lady/Alpha,1,0,1,0.0,1.1106915165381966e-05,1.0
48536,봣떠/Noun,1,0,1,0.0,1.1106915165381966e-05,1.0
48537,트레인/Noun,1,0,1,0.0,1.1106915165381966e-05,1.0
48538,박헤미/Noun,1,0,1,0.0,1.1106915165381966e-05,1.0
48539,뽠딴/Noun,1,1,0,1.1115310228308472e-05,0.0,1.0
48540,장형윤/Noun,1,1,0,1.1115310228308472e-05,0.0,1.0
48541,베뎃들/Noun,1,0,1,0.0,1.1106915165381966e-05,1.0
48542,전국시대/Noun,1,0,1,0.0,1.1106915165381966e-05,1.0
48543,진나라/Noun,1,0,1,0.0,1.1106915165381966e-05,1.0
48544,오싹오싹/Adverb,1,1,0,1.1115310228308472e-05,0.0,1.0
48545,산체/Noun,1,1,0,1.1115310228308472e-05,0.0,1.0
48546,춤판/Noun,1,1,0,1.1115310228308472e-05,0.0,1.0
48547,윤소희/Noun,1,1,0,1.1115310228308472e-05,0.0,1.0
48548,페넬로/Noun,1,0,1,0.0,1.1106915165381966e-05,1.0
48549,호세아/Noun,1,0,1,0.0,1.1106915165381966e-05,1.0
48550,잼넹/Noun,1,1,0,1.1115310228308472e-05,0.0,1.0
48551,자판기/Noun,1,1,0,1.1115310228308472e-05,0.0,1.0
48552,헐킈/Noun,1,0,1,0.0,1.1106915165381966e-05,1.0
48553,겁탈/Noun,1,0,1,0.0,1.1106915165381966e-05,1.0
48554,호객/Noun,1,0,1,0.0,1.1106915165381966e-05,1.0
48555,음수/Noun,1,0,1,0.0,1.1106915165381966e-05,1.0
48556,자극받다/Verb,1,1,0,1.1115310228308472e-05,0.0,1.0
48557,의미론/Noun,1,0,1,0.0,1.1106915165381966e-05,1.0
48558,BTL/Alpha,1,1,0,1.1115310228308472e-05,0.0,1.0
48559,시상/Noun,1,0,1,0.0,1.1106915165381966e-05,1.0
48560,노블레스/Noun,1,0,1,0.0,1.1106915165381966e-05,1.0
48561,....`/Punctuation,1,1,0,1.1115310228308472e-05,0.0,1.0
48562,유하나/Noun,1,1,0,1.1115310228308472e-05,0.0,1.0
48563,셀렌느/Noun,1,1,0,1.1115310228308472e-05,0.0,1.0
48564,대체에너지/Noun,1,0,1,0.0,1.1106915165381966e-05,1.0
48565,8.58/Number,1,0,1,0.0,1.1106915165381966e-05,1.0
48566,...!!!.../Punctuation,1,1,0,1.1115310228308472e-05,0.0,1.0
48567,아이러브유/Noun,1,1,0,1.1115310228308472e-05,0.0,1.0
48568,불안뿜는/Noun,1,0,1,0.0,1.1106915165381966e-05,1.0
48569,토나옮/Noun,1,0,1,0.0,1.1106915165381966e-05,1.0
48570,개빡나/Noun,1,0,1,0.0,1.1106915165381966e-05,1.0
48571,은밀한가족/Noun,1,0,1,0.0,1.1106915165381966e-05,1.0
48572,케스타/Noun,1,0,1,0.0,1.1106915165381966e-05,1.0
48573,talkin/Alpha,1,1,0,1.1115310228308472e-05,0.0,1.0
48574,before/Alpha,1,1,0,1.1115310228308472e-05,0.0,1.0
48575,named/Alpha,1,1,0,1.1115310228308472e-05,0.0,1.0
48576,poem/Alpha,1,1,0,1.1115310228308472e-05,0.0,1.0
48577,Chinese/Alpha,1,1,0,1.1115310228308472e-05,0.0,1.0
48578,reminding/Alpha,1,1,0,1.1115310228308472e-05,0.0,1.0
48579,temple/Alpha,1,1,0,1.1115310228308472e-05,0.0,1.0
48580,Tell/Alpha,1,1,0,1.1115310228308472e-05,0.0,1.0
48581,어쿠스틱/Noun,1,1,0,1.1115310228308472e-05,0.0,1.0
48582,섬뭐/Noun,1,1,0,1.1115310228308472e-05,0.0,1.0
48583,사냥터/Noun,1,1,0,1.1115310228308472e-05,0.0,1.0
48584,개뽕삘나/Noun,1,0,1,0.0,1.1106915165381966e-05,1.0
48585,원걸/Noun,1,0,1,0.0,1.1106915165381966e-05,1.0
48586,ㄱㅂㅋ/KoreanParticle,1,1,0,1.1115310228308472e-05,0.0,1.0
48587,은너무긴것같고내용이이상한것같아요/Foreign,1,0,1,0.0,1.1106915165381966e-05,1.0
48588,뒤정도해도적당한데/Foreign,1,0,1,0.0,1.1106915165381966e-05,1.0
48589,스임/Noun,1,0,1,0.0,1.1106915165381966e-05,1.0
48590,"-.,^/Punctuation",1,1,0,1.1115310228308472e-05,0.0,1.0
48591,페란/Noun,1,1,0,1.1115310228308472e-05,0.0,1.0
48592,엎어지다/Verb,1,0,1,0.0,1.1106915165381966e-05,1.0
48593,이라니깐/Foreign,1,0,1,0.0,1.1106915165381966e-05,1.0
48594,serious/Alpha,1,1,0,1.1115310228308472e-05,0.0,1.0
48595,볼린/Noun,1,1,0,1.1115310228308472e-05,0.0,1.0
48596,상괸/Noun,1,0,1,0.0,1.1106915165381966e-05,1.0
48597,타레가/Noun,1,1,0,1.1115310228308472e-05,0.0,1.0
48598,비문/Noun,1,0,1,0.0,1.1106915165381966e-05,1.0
48599,안치환/Noun,1,1,0,1.1115310228308472e-05,0.0,1.0
48600,융게/Noun,1,1,0,1.1115310228308472e-05,0.0,1.0
48601,어땟을/Noun,1,1,0,1.1115310228308472e-05,0.0,1.0
48602,민간/Noun,1,1,0,1.1115310228308472e-05,0.0,1.0
48603,bullet/Alpha,1,1,0,1.1115310228308472e-05,0.0,1.0
48604,떙중썌/Noun,1,1,0,1.1115310228308472e-05,0.0,1.0
48605,분란/Noun,1,0,1,0.0,1.1106915165381966e-05,1.0
48606,리틀보이/Noun,1,0,1,0.0,1.1106915165381966e-05,1.0
48607,히로시마/Noun,1,0,1,0.0,1.1106915165381966e-05,1.0
48608,전정/Noun,1,0,1,0.0,1.1106915165381966e-05,1.0
48609,최충헌/Noun,1,1,0,1.1115310228308472e-05,0.0,1.0
48610,원종/Noun,1,1,0,1.1115310228308472e-05,0.0,1.0
48611,살리타/Noun,1,1,0,1.1115310228308472e-05,0.0,1.0
48612,준다/Foreign,1,1,0,1.1115310228308472e-05,0.0,1.0
48613,단위로/Foreign,1,1,0,1.1115310228308472e-05,0.0,1.0
48614,벤애플랙/Noun,1,1,0,1.1115310228308472e-05,0.0,1.0
48615,ㅆㅞㅅ/KoreanParticle,1,0,1,0.0,1.1106915165381966e-05,1.0
48616,팜케/Noun,1,0,1,0.0,1.1106915165381966e-05,1.0
48617,데요/Eomi,1,0,1,0.0,1.1106915165381966e-05,1.0
48618,2116/Number,1,1,0,1.1115310228308472e-05,0.0,1.0
48619,rckwang/Alpha,1,1,0,1.1115310228308472e-05,0.0,1.0
48620,SHILD/Alpha,1,0,1,0.0,1.1106915165381966e-05,1.0
48621,손으러/Noun,1,1,0,1.1115310228308472e-05,0.0,1.0
48622,흑염룡/Noun,1,0,1,0.0,1.1106915165381966e-05,1.0
48623,초딍/Noun,1,1,0,1.1115310228308472e-05,0.0,1.0
48624,줜/Noun,1,0,1,0.0,1.1106915165381966e-05,1.0
48625,겜블러크루/Noun,1,1,0,1.1115310228308472e-05,0.0,1.0
48626,불도저/Noun,1,1,0,1.1115310228308472e-05,0.0,1.0
48627,직스/Noun,1,1,0,1.1115310228308472e-05,0.0,1.0
48628,1990/Number,1,1,0,1.1115310228308472e-05,0.0,1.0
48629,쟈쟈/Noun,1,1,0,1.1115310228308472e-05,0.0,1.0
48630,베이비복스/Noun,1,1,0,1.1115310228308472e-05,0.0,1.0
48631,인유/Noun,1,1,0,1.1115310228308472e-05,0.0,1.0
48632,브릴리언트/Noun,1,1,0,1.1115310228308472e-05,0.0,1.0
48633,너무멋졋음/Noun,1,1,0,1.1115310228308472e-05,0.0,1.0
48634,빙긋이/Adverb,1,1,0,1.1115310228308472e-05,0.0,1.0
48635,옹알옹알/Adverb,1,0,1,0.0,1.1106915165381966e-05,1.0
48636,~!!!!!!!/Punctuation,1,0,1,0.0,1.1106915165381966e-05,1.0
48637,엮은거/Noun,1,1,0,1.1115310228308472e-05,0.0,1.0
48638,뉴트론/Noun,1,1,0,1.1115310228308472e-05,0.0,1.0
48639,린것/Noun,1,1,0,1.1115310228308472e-05,0.0,1.0
48640,얼굴크기/Noun,1,0,1,0.0,1.1106915165381966e-05,1.0
48641,꼬맹들/Noun,1,0,1,0.0,1.1106915165381966e-05,1.0
48642,ㅇㅡㅇ/KoreanParticle,1,0,1,0.0,1.1106915165381966e-05,1.0
48643,전에가/Foreign,1,1,0,1.1115310228308472e-05,0.0,1.0
48644,김청/Noun,1,0,1,0.0,1.1106915165381966e-05,1.0
48645,^^~!/Punctuation,1,1,0,1.1115310228308472e-05,0.0,1.0
48646,재디/Noun,1,0,1,0.0,1.1106915165381966e-05,1.0
48647,널작/Noun,1,0,1,0.0,1.1106915165381966e-05,1.0
48648,담번/Noun,1,1,0,1.1115310228308472e-05,0.0,1.0
48649,가작/Noun,1,0,1,0.0,1.1106915165381966e-05,1.0
48650,지거스/Noun,1,1,0,1.1115310228308472e-05,0.0,1.0
48651,감정노동/Noun,1,1,0,1.1115310228308472e-05,0.0,1.0
48652,type/Alpha,1,1,0,1.1115310228308472e-05,0.0,1.0
48653,귀욤귀욤/Noun,1,1,0,1.1115310228308472e-05,0.0,1.0
48654,씐나네/Noun,1,1,0,1.1115310228308472e-05,0.0,1.0
48655,모팻후/Noun,1,1,0,1.1115310228308472e-05,0.0,1.0
48656,등별/Noun,1,1,0,1.1115310228308472e-05,0.0,1.0
48657,똥멋/Noun,1,0,1,0.0,1.1106915165381966e-05,1.0
48658,반엔/Foreign,1,1,0,1.1115310228308472e-05,0.0,1.0
48659,ooood/Alpha,1,1,0,1.1115310228308472e-05,0.0,1.0
48660,막눈/Noun,1,0,1,0.0,1.1106915165381966e-05,1.0
48661,펄스/Noun,1,0,1,0.0,1.1106915165381966e-05,1.0
48662,쾌적하다/Adjective,1,1,0,1.1115310228308472e-05,0.0,1.0
48663,프로그래머/Noun,1,0,1,0.0,1.1106915165381966e-05,1.0
48664,부판영/Noun,1,0,1,0.0,1.1106915165381966e-05,1.0
48665,어딸련/Noun,1,1,0,1.1115310228308472e-05,0.0,1.0
48666,비개/Noun,1,1,0,1.1115310228308472e-05,0.0,1.0
48667,두상/Noun,1,1,0,1.1115310228308472e-05,0.0,1.0
48668,낭비했다/Foreign,1,0,1,0.0,1.1106915165381966e-05,1.0
48669,스톼/Noun,1,0,1,0.0,1.1106915165381966e-05,1.0
48670,망첬다/Noun,1,1,0,1.1115310228308472e-05,0.0,1.0
48671,무딘것임/Noun,1,1,0,1.1115310228308472e-05,0.0,1.0
48672,즐겨봅쉐/Noun,1,1,0,1.1115310228308472e-05,0.0,1.0
48673,푸에르토리코/Noun,1,0,1,0.0,1.1106915165381966e-05,1.0
48674,리채/Noun,1,0,1,0.0,1.1106915165381966e-05,1.0
48675,기압/Noun,1,0,1,0.0,1.1106915165381966e-05,1.0
48676,주므르/Noun,1,0,1,0.0,1.1106915165381966e-05,1.0
48677,도작이라해도/Foreign,1,0,1,0.0,1.1106915165381966e-05,1.0
48678,느꼇엇돈/Noun,1,1,0,1.1115310228308472e-05,0.0,1.0
48679,어릴때봣던/Noun,1,1,0,1.1115310228308472e-05,0.0,1.0
48680,Heaven/Alpha,1,1,0,1.1115310228308472e-05,0.0,1.0
48681,Above/Alpha,1,1,0,1.1115310228308472e-05,0.0,1.0
48682,Meters/Alpha,1,1,0,1.1115310228308472e-05,0.0,1.0
48683,증류수/Noun,1,0,1,0.0,1.1106915165381966e-05,1.0
48684,전해질/Noun,1,0,1,0.0,1.1106915165381966e-05,1.0
48685,서정희/Noun,1,0,1,0.0,1.1106915165381966e-05,1.0
48686,인큐베이터/Noun,1,0,1,0.0,1.1106915165381966e-05,1.0
48687,조산/Noun,1,0,1,0.0,1.1106915165381966e-05,1.0
48688,머싯다/Noun,1,1,0,1.1115310228308472e-05,0.0,1.0
48689,봉돌/Noun,1,0,1,0.0,1.1106915165381966e-05,1.0
48690,껄끄랏/Noun,1,0,1,0.0,1.1106915165381966e-05,1.0
48691,산사태/Noun,1,0,1,0.0,1.1106915165381966e-05,1.0
48692,전영화임을감안하고라도/Foreign,1,0,1,0.0,1.1106915165381966e-05,1.0
48693,전혜빈/Noun,1,0,1,0.0,1.1106915165381966e-05,1.0
48694,동물의왕국/Noun,1,0,1,0.0,1.1106915165381966e-05,1.0
48695,이준연/Noun,1,1,0,1.1115310228308472e-05,0.0,1.0
48696,졸뻔햇음/Noun,1,0,1,0.0,1.1106915165381966e-05,1.0
48697,산파/Noun,1,0,1,0.0,1.1106915165381966e-05,1.0
48698,scumbag/Alpha,1,0,1,0.0,1.1106915165381966e-05,1.0
48699,unlikable/Alpha,1,0,1,0.0,1.1106915165381966e-05,1.0
48700,맻는/Noun,1,0,1,0.0,1.1106915165381966e-05,1.0
48701,dkajlskgjqlkrjgklqejgkle/Alpha,1,0,1,0.0,1.1106915165381966e-05,1.0
48702,이선장/Noun,1,0,1,0.0,1.1106915165381966e-05,1.0
48703,......!!!!/Punctuation,1,0,1,0.0,1.1106915165381966e-05,1.0
48704,프레스코화/Noun,1,0,1,0.0,1.1106915165381966e-05,1.0
48705,라파엘로/Noun,1,0,1,0.0,1.1106915165381966e-05,1.0
48706,잇빠이/Noun,1,0,1,0.0,1.1106915165381966e-05,1.0
48707,철썩/Noun,1,0,1,0.0,1.1106915165381966e-05,1.0
48708,쇼탈/Noun,1,1,0,1.1115310228308472e-05,0.0,1.0
48709,클레이모어/Noun,1,0,1,0.0,1.1106915165381966e-05,1.0
48710,드라맙니/Noun,1,1,0,1.1115310228308472e-05,0.0,1.0
48711,소몰이/Noun,1,0,1,0.0,1.1106915165381966e-05,1.0
48712,routine/Alpha,1,0,1,0.0,1.1106915165381966e-05,1.0
48713,핵꿀잼졸잼/Noun,1,1,0,1.1115310228308472e-05,0.0,1.0
48714,넥서스/Noun,1,1,0,1.1115310228308472e-05,0.0,1.0
48715,의시간이/Foreign,1,1,0,1.1115310228308472e-05,0.0,1.0
48716,관객밖에/Foreign,1,1,0,1.1115310228308472e-05,0.0,1.0
48717,70만/Number,1,1,0,1.1115310228308472e-05,0.0,1.0
48718,종방좀/Noun,1,0,1,0.0,1.1106915165381966e-05,1.0
48719,좋았댜/Noun,1,1,0,1.1115310228308472e-05,0.0,1.0
48720,괴생명체/Noun,1,0,1,0.0,1.1106915165381966e-05,1.0
48721,스푸너/Noun,1,0,1,0.0,1.1106915165381966e-05,1.0
48722,거안/Noun,1,1,0,1.1115310228308472e-05,0.0,1.0
48723,봅슬레이/Noun,1,1,0,1.1115310228308472e-05,0.0,1.0
48724,우렸어/Noun,1,0,1,0.0,1.1106915165381966e-05,1.0
48725,더테러라이브/Noun,1,1,0,1.1115310228308472e-05,0.0,1.0
48726,전영화인줄암/Foreign,1,0,1,0.0,1.1106915165381966e-05,1.0
48727,무시시/Noun,1,0,1,0.0,1.1106915165381966e-05,1.0
48728,코임/Noun,1,1,0,1.1115310228308472e-05,0.0,1.0
48729,짓말/Noun,1,0,1,0.0,1.1106915165381966e-05,1.0
48730,꼬운/Noun,1,0,1,0.0,1.1106915165381966e-05,1.0
48731,치어리딩/Noun,1,0,1,0.0,1.1106915165381966e-05,1.0
48732,부엉/Noun,1,0,1,0.0,1.1106915165381966e-05,1.0
48733,위군/Noun,1,1,0,1.1115310228308472e-05,0.0,1.0
48734,펄쩍/Adverb,1,0,1,0.0,1.1106915165381966e-05,1.0
48735,개낚였내/Noun,1,0,1,0.0,1.1106915165381966e-05,1.0
48736,뱅크씬/Noun,1,0,1,0.0,1.1106915165381966e-05,1.0
48737,탱탱/Noun,1,0,1,0.0,1.1106915165381966e-05,1.0
48738,꿀릴/Noun,1,1,0,1.1115310228308472e-05,0.0,1.0
48739,심증/Noun,1,0,1,0.0,1.1106915165381966e-05,1.0
48740,민건줄/Noun,1,1,0,1.1115310228308472e-05,0.0,1.0
48741,조지페파드/Noun,1,1,0,1.1115310228308472e-05,0.0,1.0
48742,도시남녀/Noun,1,1,0,1.1115310228308472e-05,0.0,1.0
48743,은행가/Noun,1,1,0,1.1115310228308472e-05,0.0,1.0
48744,",,,,^^/Punctuation",1,1,0,1.1115310228308472e-05,0.0,1.0
48745,인도문/Noun,1,1,0,1.1115310228308472e-05,0.0,1.0
48746,스쿼럴/Noun,1,0,1,0.0,1.1106915165381966e-05,1.0
48747,본즈/Noun,1,1,0,1.1115310228308472e-05,0.0,1.0
48748,......-/Punctuation,1,0,1,0.0,1.1106915165381966e-05,1.0
48749,구경해/Noun,1,0,1,0.0,1.1106915165381966e-05,1.0
48750,NSS/Alpha,1,0,1,0.0,1.1106915165381966e-05,1.0
48751,젓망/Noun,1,0,1,0.0,1.1106915165381966e-05,1.0
48752,형체/Noun,1,1,0,1.1115310228308472e-05,0.0,1.0
48753,럭비월드컵/Noun,1,1,0,1.1115310228308472e-05,0.0,1.0
48754,↓↓/Foreign,1,1,0,1.1115310228308472e-05,0.0,1.0
48755,난발/Noun,1,0,1,0.0,1.1106915165381966e-05,1.0
48756,SCREEN/Alpha,1,0,1,0.0,1.1106915165381966e-05,1.0
48757,한사/Noun,1,1,0,1.1115310228308472e-05,0.0,1.0
48758,뭐거/Noun,1,0,1,0.0,1.1106915165381966e-05,1.0
48759,5.86/Number,1,1,0,1.1115310228308472e-05,0.0,1.0
48760,따딷/Noun,1,0,1,0.0,1.1106915165381966e-05,1.0
48761,감성핀트/Noun,1,0,1,0.0,1.1106915165381966e-05,1.0
48762,샀/Noun,1,1,0,1.1115310228308472e-05,0.0,1.0
48763,에여자혼자서봐도하나도안무서움/Foreign,1,0,1,0.0,1.1106915165381966e-05,1.0
48764,코로만/Noun,1,0,1,0.0,1.1106915165381966e-05,1.0
48765,정주영/Noun,1,0,1,0.0,1.1106915165381966e-05,1.0
48766,아이두/Noun,1,1,0,1.1115310228308472e-05,0.0,1.0
48767,차렷자세/Noun,1,0,1,0.0,1.1106915165381966e-05,1.0
48768,비지터/Noun,1,1,0,1.1115310228308472e-05,0.0,1.0
48769,우윳빛깔/Noun,1,1,0,1.1115310228308472e-05,0.0,1.0
48770,전에만든영화다/Foreign,1,0,1,0.0,1.1106915165381966e-05,1.0
48771,퀀텀/Noun,1,1,0,1.1115310228308472e-05,0.0,1.0
48772,맞을떈/Noun,1,1,0,1.1115310228308472e-05,0.0,1.0
48773,화동/Noun,1,0,1,0.0,1.1106915165381966e-05,1.0
48774,컾컾/Noun,1,1,0,1.1115310228308472e-05,0.0,1.0
48775,재밓쳐/Noun,1,1,0,1.1115310228308472e-05,0.0,1.0
48776,소넨/Noun,1,0,1,0.0,1.1106915165381966e-05,1.0
48777,캬라멜/Noun,1,0,1,0.0,1.1106915165381966e-05,1.0
48778,티스푼/Noun,1,0,1,0.0,1.1106915165381966e-05,1.0
48779,재밑/Noun,1,1,0,1.1115310228308472e-05,0.0,1.0
48780,김뢰하/Noun,1,0,1,0.0,1.1106915165381966e-05,1.0
48781,ip/Alpha,1,0,1,0.0,1.1106915165381966e-05,1.0
48782,너무쎗다/Noun,1,0,1,0.0,1.1106915165381966e-05,1.0
48783,느꼇는데/Noun,1,1,0,1.1115310228308472e-05,0.0,1.0
48784,꼬깃꼬깃/Noun,1,0,1,0.0,1.1106915165381966e-05,1.0
48785,가스레인지/Noun,1,0,1,0.0,1.1106915165381966e-05,1.0
48786,방학기/Noun,1,0,1,0.0,1.1106915165381966e-05,1.0
48787,에흏/Noun,1,0,1,0.0,1.1106915165381966e-05,1.0
48788,망가졋구/Noun,1,0,1,0.0,1.1106915165381966e-05,1.0
48789,햇기/Noun,1,0,1,0.0,1.1106915165381966e-05,1.0
48790,만재밌다/Foreign,1,0,1,0.0,1.1106915165381966e-05,1.0
48791,*^^*~~~/Punctuation,1,1,0,1.1115310228308472e-05,0.0,1.0
48792,엄는데/Noun,1,0,1,0.0,1.1106915165381966e-05,1.0
48793,보호대/Noun,1,0,1,0.0,1.1106915165381966e-05,1.0
48794,어덩/Noun,1,0,1,0.0,1.1106915165381966e-05,1.0
48795,개심사/Noun,1,0,1,0.0,1.1106915165381966e-05,1.0
48796,내분/Noun,1,0,1,0.0,1.1106915165381966e-05,1.0
48797,이라크전쟁/Noun,1,0,1,0.0,1.1106915165381966e-05,1.0
48798,보는중인데/Foreign,1,0,1,0.0,1.1106915165381966e-05,1.0
48799,뿜어/Noun,1,1,0,1.1115310228308472e-05,0.0,1.0
48800,날좀/Noun,1,0,1,0.0,1.1106915165381966e-05,1.0
48801,135/Number,1,1,0,1.1115310228308472e-05,0.0,1.0
48802,홍콩쓰레기영화/Foreign,1,0,1,0.0,1.1106915165381966e-05,1.0
48803,쟙아/Noun,1,0,1,0.0,1.1106915165381966e-05,1.0
48804,경연/Noun,1,0,1,0.0,1.1106915165381966e-05,1.0
48805,솔칙히/Noun,1,0,1,0.0,1.1106915165381966e-05,1.0
48806,Fire/Alpha,1,1,0,1.1115310228308472e-05,0.0,1.0
48807,인구를움직이는/Foreign,1,1,0,1.1115310228308472e-05,0.0,1.0
48808,중간지점/Noun,1,1,0,1.1115310228308472e-05,0.0,1.0
48809,블러/Noun,1,0,1,0.0,1.1106915165381966e-05,1.0
48810,러렁/Noun,1,1,0,1.1115310228308472e-05,0.0,1.0
48811,Cool/Alpha,1,1,0,1.1115310228308472e-05,0.0,1.0
48812,클라리넷/Noun,1,1,0,1.1115310228308472e-05,0.0,1.0
48813,흉물/Noun,1,0,1,0.0,1.1106915165381966e-05,1.0
48814,왜란/Noun,1,0,1,0.0,1.1106915165381966e-05,1.0
48815,ex/Alpha,1,0,1,0.0,1.1106915165381966e-05,1.0
48816,브로드밴드/Noun,1,0,1,0.0,1.1106915165381966e-05,1.0
48817,늠름하다/Adjective,1,1,0,1.1115310228308472e-05,0.0,1.0
48818,업덩/Noun,1,0,1,0.0,1.1106915165381966e-05,1.0
48819,건왜또/Noun,1,0,1,0.0,1.1106915165381966e-05,1.0
48820,개봉할런/Noun,1,0,1,0.0,1.1106915165381966e-05,1.0
48821,무기한/Noun,1,0,1,0.0,1.1106915165381966e-05,1.0
48822,ㅆㄴ/KoreanParticle,1,1,0,1.1115310228308472e-05,0.0,1.0
48823,저렁/Noun,1,1,0,1.1115310228308472e-05,0.0,1.0
48824,반금/Noun,1,1,0,1.1115310228308472e-05,0.0,1.0
48825,이뻣으/Noun,1,1,0,1.1115310228308472e-05,0.0,1.0
48826,초무/Noun,1,0,1,0.0,1.1106915165381966e-05,1.0
48827,김병석/Noun,1,1,0,1.1115310228308472e-05,0.0,1.0
48828,봉건시대/Noun,1,1,0,1.1115310228308472e-05,0.0,1.0
48829,while/Alpha,1,1,0,1.1115310228308472e-05,0.0,1.0
48830,every/Alpha,1,1,0,1.1115310228308472e-05,0.0,1.0
48831,start/Alpha,1,1,0,1.1115310228308472e-05,0.0,1.0
48832,deserves/Alpha,1,1,0,1.1115310228308472e-05,0.0,1.0
48833,Everybody/Alpha,1,1,0,1.1115310228308472e-05,0.0,1.0
48834,컨테니어씬/Noun,1,0,1,0.0,1.1106915165381966e-05,1.0
48835,아쩌씨/Noun,1,1,0,1.1115310228308472e-05,0.0,1.0
48836,경성/Noun,1,1,0,1.1115310228308472e-05,0.0,1.0
48837,만춘/Noun,1,1,0,1.1115310228308472e-05,0.0,1.0
48838,불가피/Noun,1,1,0,1.1115310228308472e-05,0.0,1.0
48839,꼽을수/Noun,1,1,0,1.1115310228308472e-05,0.0,1.0
48840,요보/Noun,1,1,0,1.1115310228308472e-05,0.0,1.0
48841,MIG/Alpha,1,0,1,0.0,1.1106915165381966e-05,1.0
48842,혜선이/Noun,1,0,1,0.0,1.1106915165381966e-05,1.0
48843,색출/Noun,1,1,0,1.1115310228308472e-05,0.0,1.0
48844,사라졋으/Noun,1,1,0,1.1115310228308472e-05,0.0,1.0
48845,불끈/Noun,1,1,0,1.1115310228308472e-05,0.0,1.0
48846,자게이/Noun,1,1,0,1.1115310228308472e-05,0.0,1.0
48847,9.10/Number,1,1,0,1.1115310228308472e-05,0.0,1.0
48848,차르봄바/Noun,1,0,1,0.0,1.1106915165381966e-05,1.0
48849,초자연현상/Noun,1,0,1,0.0,1.1106915165381966e-05,1.0
48850,???.............../Punctuation,1,0,1,0.0,1.1106915165381966e-05,1.0
48851,엮지않/Noun,1,1,0,1.1115310228308472e-05,0.0,1.0
48852,서글퍼지다/Verb,1,1,0,1.1115310228308472e-05,0.0,1.0
48853,60~70/Number,1,1,0,1.1115310228308472e-05,0.0,1.0
48854,흰빤스/Noun,1,0,1,0.0,1.1106915165381966e-05,1.0
48855,성희연/Noun,1,0,1,0.0,1.1106915165381966e-05,1.0
48856,LOVELY/Alpha,1,1,0,1.1115310228308472e-05,0.0,1.0
48857,젬마/Noun,1,1,0,1.1115310228308472e-05,0.0,1.0
48858,폭파씬/Noun,1,1,0,1.1115310228308472e-05,0.0,1.0
48859,2.93/Number,1,0,1,0.0,1.1106915165381966e-05,1.0
48860,???????????????..../Punctuation,1,0,1,0.0,1.1106915165381966e-05,1.0
48861,구내/Noun,1,1,0,1.1115310228308472e-05,0.0,1.0
48862,절을/Foreign,1,1,0,1.1115310228308472e-05,0.0,1.0
48863,김형석/Noun,1,0,1,0.0,1.1106915165381966e-05,1.0
48864,화쇄/Noun,1,1,0,1.1115310228308472e-05,0.0,1.0
48865,괜춘해/Noun,1,1,0,1.1115310228308472e-05,0.0,1.0
48866,꿰뜷/Noun,1,1,0,1.1115310228308472e-05,0.0,1.0
48867,랩신/Noun,1,1,0,1.1115310228308472e-05,0.0,1.0
48868,여행사/Noun,1,0,1,0.0,1.1106915165381966e-05,1.0
48869,뻴/Noun,1,1,0,1.1115310228308472e-05,0.0,1.0
48870,럴레/Noun,1,0,1,0.0,1.1106915165381966e-05,1.0
48871,명세빈/Noun,1,0,1,0.0,1.1106915165381966e-05,1.0
48872,드림걸/Noun,1,1,0,1.1115310228308472e-05,0.0,1.0
48873,톰요크/Noun,1,1,0,1.1115310228308472e-05,0.0,1.0
48874,뷰옥/Noun,1,1,0,1.1115310228308472e-05,0.0,1.0
48875,다리미/Noun,1,1,0,1.1115310228308472e-05,0.0,1.0
48876,http://www.christiantoday.co.kr/view.htm?id=242243/URL,1,0,1,0.0,1.1106915165381966e-05,1.0
48877,http://news.donga.com/3/all/20070518/8443553/1/URL,1,0,1,0.0,1.1106915165381966e-05,1.0
48878,붹/Noun,1,0,1,0.0,1.1106915165381966e-05,1.0
48879,목포/Noun,1,0,1,0.0,1.1106915165381966e-05,1.0
48880,황산/Noun,1,0,1,0.0,1.1106915165381966e-05,1.0
48881,졋을텐/Noun,1,0,1,0.0,1.1106915165381966e-05,1.0
48882,명란/Noun,1,0,1,0.0,1.1106915165381966e-05,1.0
48883,'??/Punctuation,1,0,1,0.0,1.1106915165381966e-05,1.0
48884,face/Alpha,1,1,0,1.1115310228308472e-05,0.0,1.0
48885,앤드루스/Noun,1,1,0,1.1115310228308472e-05,0.0,1.0
48886,에스더/Noun,1,1,0,1.1115310228308472e-05,0.0,1.0
48887,잇쩡/Noun,1,1,0,1.1115310228308472e-05,0.0,1.0
48888,겝니/Noun,1,1,0,1.1115310228308472e-05,0.0,1.0
48889,김미영/Noun,1,1,0,1.1115310228308472e-05,0.0,1.0
48890,변준석/Noun,1,1,0,1.1115310228308472e-05,0.0,1.0
48891,간장게장/Noun,1,0,1,0.0,1.1106915165381966e-05,1.0
48892,갸차폰/Noun,1,0,1,0.0,1.1106915165381966e-05,1.0
48893,재규어/Noun,1,0,1,0.0,1.1106915165381966e-05,1.0
48894,범죄소설/Noun,1,0,1,0.0,1.1106915165381966e-05,1.0
48895,주간지/Noun,1,0,1,0.0,1.1106915165381966e-05,1.0
48896,^*)/Punctuation,1,1,0,1.1115310228308472e-05,0.0,1.0
48897,^)/(*^/Punctuation,1,1,0,1.1115310228308472e-05,0.0,1.0
48898,^)/(/^/Punctuation,1,1,0,1.1115310228308472e-05,0.0,1.0
48899,◇/Foreign,1,1,0,1.1115310228308472e-05,0.0,1.0
48900,^)~/Punctuation,1,1,0,1.1115310228308472e-05,0.0,1.0
48901,)/`(/Punctuation,1,1,0,1.1115310228308472e-05,0.0,1.0
48902,23회/Number,1,0,1,0.0,1.1106915165381966e-05,1.0
48903,PTSD/Alpha,1,1,0,1.1115310228308472e-05,0.0,1.0
48904,789.456/Number,1,0,1,0.0,1.1106915165381966e-05,1.0
48905,박제가/Noun,1,1,0,1.1115310228308472e-05,0.0,1.0
48906,cinespacejuan.com/URL,1,1,0,1.1115310228308472e-05,0.0,1.0
48907,:///Punctuation,1,1,0,1.1115310228308472e-05,0.0,1.0
48908,http/Alpha,1,1,0,1.1115310228308472e-05,0.0,1.0
48909,주안역/Noun,1,1,0,1.1115310228308472e-05,0.0,1.0
48910,지유/Noun,1,1,0,1.1115310228308472e-05,0.0,1.0
48911,길들다/Verb,1,1,0,1.1115310228308472e-05,0.0,1.0
48912,ㅅㅅㅏㄴ/KoreanParticle,1,0,1,0.0,1.1106915165381966e-05,1.0
48913,ㅈㅓ/KoreanParticle,1,0,1,0.0,1.1106915165381966e-05,1.0
48914,낚음/Noun,1,0,1,0.0,1.1106915165381966e-05,1.0
48915,장현/Noun,1,1,0,1.1115310228308472e-05,0.0,1.0
48916,떨어트렸/Noun,1,0,1,0.0,1.1106915165381966e-05,1.0
48917,기죽다/Verb,1,0,1,0.0,1.1106915165381966e-05,1.0
48918,투파더스/Noun,1,0,1,0.0,1.1106915165381966e-05,1.0
48919,콸/Noun,1,1,0,1.1115310228308472e-05,0.0,1.0
48920,박흥숙/Noun,1,0,1,0.0,1.1106915165381966e-05,1.0
48921,무등산/Noun,1,0,1,0.0,1.1106915165381966e-05,1.0
48922,업슈/Noun,1,0,1,0.0,1.1106915165381966e-05,1.0
48923,미물/Noun,1,0,1,0.0,1.1106915165381966e-05,1.0
48924,누드씬외/Noun,1,0,1,0.0,1.1106915165381966e-05,1.0
48925,빠듯했던/Noun,1,1,0,1.1115310228308472e-05,0.0,1.0
48926,~~~~~~~~~~~~!!!!!!!!!!!!!/Punctuation,1,0,1,0.0,1.1106915165381966e-05,1.0
48927,모치/Noun,1,1,0,1.1115310228308472e-05,0.0,1.0
48928,발부/Noun,1,0,1,0.0,1.1106915165381966e-05,1.0
48929,이휘소/Noun,1,0,1,0.0,1.1106915165381966e-05,1.0
48930,밝혀졋음/Noun,1,0,1,0.0,1.1106915165381966e-05,1.0
48931,왕룡/Noun,1,0,1,0.0,1.1106915165381966e-05,1.0
48932,파란눈/Noun,1,1,0,1.1115310228308472e-05,0.0,1.0
48933,스코트랜드/Noun,1,1,0,1.1115310228308472e-05,0.0,1.0
48934,김나운/Noun,1,0,1,0.0,1.1106915165381966e-05,1.0
48935,몹쓸/Noun,1,0,1,0.0,1.1106915165381966e-05,1.0
48936,송옥숙/Noun,1,0,1,0.0,1.1106915165381966e-05,1.0
48937,좠음/Noun,1,1,0,1.1115310228308472e-05,0.0,1.0
48938,추처/Noun,1,0,1,0.0,1.1106915165381966e-05,1.0
48939,ㅣㄹ/KoreanParticle,1,0,1,0.0,1.1106915165381966e-05,1.0
48940,베낌/Noun,1,0,1,0.0,1.1106915165381966e-05,1.0
48941,뤼하/Noun,1,1,0,1.1115310228308472e-05,0.0,1.0
48942,쿠토/Noun,1,1,0,1.1115310228308472e-05,0.0,1.0
48943,부암/Noun,1,0,1,0.0,1.1106915165381966e-05,1.0
48944,후두/Noun,1,0,1,0.0,1.1106915165381966e-05,1.0
48945,！！！/Foreign,1,1,0,1.1115310228308472e-05,0.0,1.0
48946,ㅎㅎㅋㅋㅋ/KoreanParticle,1,1,0,1.1115310228308472e-05,0.0,1.0
48947,쩌번/Noun,1,1,0,1.1115310228308472e-05,0.0,1.0
48948,엄는거임/Noun,1,0,1,0.0,1.1106915165381966e-05,1.0
48949,버킨/Noun,1,1,0,1.1115310228308472e-05,0.0,1.0
48950,애블린역/Noun,1,1,0,1.1115310228308472e-05,0.0,1.0
48951,규리/Noun,1,1,0,1.1115310228308472e-05,0.0,1.0
48952,걸스토리/Noun,1,0,1,0.0,1.1106915165381966e-05,1.0
48953,오이디푸스/Noun,1,1,0,1.1115310228308472e-05,0.0,1.0
48954,사념/Noun,1,0,1,0.0,1.1106915165381966e-05,1.0
48955,쌈장/Noun,1,0,1,0.0,1.1106915165381966e-05,1.0
48956,다썪어/Noun,1,0,1,0.0,1.1106915165381966e-05,1.0
48957,넌꼭/Noun,1,1,0,1.1115310228308472e-05,0.0,1.0
48958,Remake/Alpha,1,1,0,1.1115310228308472e-05,0.0,1.0
48959,아랍권/Noun,1,0,1,0.0,1.1106915165381966e-05,1.0
48960,부스럭/Noun,1,0,1,0.0,1.1106915165381966e-05,1.0
48961,사사사/Noun,1,0,1,0.0,1.1106915165381966e-05,1.0
48962,땡처리/Noun,1,0,1,0.0,1.1106915165381966e-05,1.0
48963,난강/Noun,1,1,0,1.1115310228308472e-05,0.0,1.0
48964,씨디/Noun,1,1,0,1.1115310228308472e-05,0.0,1.0
48965,센슈얼하/Noun,1,0,1,0.0,1.1106915165381966e-05,1.0
48966,캐쩌/Noun,1,1,0,1.1115310228308472e-05,0.0,1.0
48967,뜸금/Noun,1,0,1,0.0,1.1106915165381966e-05,1.0
48968,다음웹툰/Noun,1,0,1,0.0,1.1106915165381966e-05,1.0
48969,변애/Noun,1,1,0,1.1115310228308472e-05,0.0,1.0
48970,쓸엑/Noun,1,0,1,0.0,1.1106915165381966e-05,1.0
48971,미셀로드리게스/Noun,1,0,1,0.0,1.1106915165381966e-05,1.0
48972,기색/Noun,1,1,0,1.1115310228308472e-05,0.0,1.0
48973,아킬레우스/Noun,1,1,0,1.1115310228308472e-05,0.0,1.0
48974,ㅡㅍㄹ/KoreanParticle,1,1,0,1.1115310228308472e-05,0.0,1.0
48975,것보/Noun,1,1,0,1.1115310228308472e-05,0.0,1.0
48976,지젝/Noun,1,0,1,0.0,1.1106915165381966e-05,1.0
48977,블렌더/Noun,1,0,1,0.0,1.1106915165381966e-05,1.0
48978,인생살이/Noun,1,1,0,1.1115310228308472e-05,0.0,1.0
48979,털때/Noun,1,1,0,1.1115310228308472e-05,0.0,1.0
48980,녹음실/Noun,1,1,0,1.1115310228308472e-05,0.0,1.0
48981,징뽕징뽕/Noun,1,1,0,1.1115310228308472e-05,0.0,1.0
48982,?!?!?/Punctuation,1,0,1,0.0,1.1106915165381966e-05,1.0
48983,봐봣더/Noun,1,0,1,0.0,1.1106915165381966e-05,1.0
48984,그로밋/Noun,1,1,0,1.1115310228308472e-05,0.0,1.0
48985,개집/Noun,1,1,0,1.1115310228308472e-05,0.0,1.0
48986,쨘한거/Noun,1,1,0,1.1115310228308472e-05,0.0,1.0
48987,봉은사/Noun,1,0,1,0.0,1.1106915165381966e-05,1.0
48988,신돈/Noun,1,0,1,0.0,1.1106915165381966e-05,1.0
48989,Oddity/Alpha,1,1,0,1.1115310228308472e-05,0.0,1.0
48990,스파이명월/Noun,1,1,0,1.1115310228308472e-05,0.0,1.0
48991,개족/Noun,1,0,1,0.0,1.1106915165381966e-05,1.0
48992,천보로/Noun,1,0,1,0.0,1.1106915165381966e-05,1.0
48993,도라는/Foreign,1,1,0,1.1115310228308472e-05,0.0,1.0
48994,데킬라/Noun,1,1,0,1.1115310228308472e-05,0.0,1.0
48995,해묵/Noun,1,0,1,0.0,1.1106915165381966e-05,1.0
48996,약관/Noun,1,1,0,1.1115310228308472e-05,0.0,1.0
48997,않을껀/Noun,1,0,1,0.0,1.1106915165381966e-05,1.0
48998,구충제/Noun,1,0,1,0.0,1.1106915165381966e-05,1.0
48999,망점/Noun,1,1,0,1.1115310228308472e-05,0.0,1.0
49000,경험치/Noun,1,0,1,0.0,1.1106915165381966e-05,1.0
49001,번요/Noun,1,0,1,0.0,1.1106915165381966e-05,1.0
49002,천하오/Noun,1,1,0,1.1115310228308472e-05,0.0,1.0
49003,동표/Noun,1,1,0,1.1115310228308472e-05,0.0,1.0
49004,이창/Noun,1,1,0,1.1115310228308472e-05,0.0,1.0
49005,벨라로/Noun,1,1,0,1.1115310228308472e-05,0.0,1.0
49006,콧꾸멍/Noun,1,0,1,0.0,1.1106915165381966e-05,1.0
49007,바라밀/Noun,1,0,1,0.0,1.1106915165381966e-05,1.0
49008,마하반야/Noun,1,0,1,0.0,1.1106915165381966e-05,1.0
49009,쓰리콤/Noun,1,1,0,1.1115310228308472e-05,0.0,1.0
49010,임실/Noun,1,1,0,1.1115310228308472e-05,0.0,1.0
49011,리완/Noun,1,0,1,0.0,1.1106915165381966e-05,1.0
49012,16-1/Number,1,1,0,1.1115310228308472e-05,0.0,1.0
49013,응암/Noun,1,1,0,1.1115310228308472e-05,0.0,1.0
49014,은평구/Noun,1,1,0,1.1115310228308472e-05,0.0,1.0
49015,병역기피/Noun,1,1,0,1.1115310228308472e-05,0.0,1.0
49016,펀트/Noun,1,0,1,0.0,1.1106915165381966e-05,1.0
49017,나레티브/Noun,1,0,1,0.0,1.1106915165381966e-05,1.0
49018,">,</Punctuation",1,0,1,0.0,1.1106915165381966e-05,1.0
49019,Alex/Alpha,1,0,1,0.0,1.1106915165381966e-05,1.0
49020,식물인간/Noun,1,0,1,0.0,1.1106915165381966e-05,1.0
49021,걸렷어/Noun,1,0,1,0.0,1.1106915165381966e-05,1.0
49022,기종영시켜주세요/Foreign,1,0,1,0.0,1.1106915165381966e-05,1.0
49023,82조/Number,1,0,1,0.0,1.1106915165381966e-05,1.0
49024,얼등/Noun,1,1,0,1.1115310228308472e-05,0.0,1.0
49025,가디언즈/Noun,1,0,1,0.0,1.1106915165381966e-05,1.0
49026,코구멍/Noun,1,0,1,0.0,1.1106915165381966e-05,1.0
49027,성괴같/Noun,1,0,1,0.0,1.1106915165381966e-05,1.0
49028,존맥/Noun,1,1,0,1.1115310228308472e-05,0.0,1.0
49029,heart/Alpha,1,1,0,1.1115310228308472e-05,0.0,1.0
49030,중요도/Noun,1,0,1,0.0,1.1106915165381966e-05,1.0
49031,호조/Noun,1,1,0,1.1115310228308472e-05,0.0,1.0
49032,물쌍해/Noun,1,0,1,0.0,1.1106915165381966e-05,1.0
49033,저랫/Noun,1,1,0,1.1115310228308472e-05,0.0,1.0
49034,김한규/Noun,1,0,1,0.0,1.1106915165381966e-05,1.0
49035,최란/Noun,1,0,1,0.0,1.1106915165381966e-05,1.0
49036,유정현/Noun,1,1,0,1.1115310228308472e-05,0.0,1.0
49037,Monkey/Alpha,1,0,1,0.0,1.1106915165381966e-05,1.0
49038,애앰/Noun,1,0,1,0.0,1.1106915165381966e-05,1.0
49039,섹함/Noun,1,0,1,0.0,1.1106915165381966e-05,1.0
49040,산란/Noun,1,0,1,0.0,1.1106915165381966e-05,1.0
49041,흙투성이/Noun,1,0,1,0.0,1.1106915165381966e-05,1.0
49042,대동맥/Noun,1,0,1,0.0,1.1106915165381966e-05,1.0
49043,차레/Noun,1,0,1,0.0,1.1106915165381966e-05,1.0
49044,DX/Alpha,1,1,0,1.1115310228308472e-05,0.0,1.0
49045,수결/Noun,1,1,0,1.1115310228308472e-05,0.0,1.0
49046,dkRkdnj/Alpha,1,0,1,0.0,1.1106915165381966e-05,1.0
49047,wjaeh/Alpha,1,0,1,0.0,1.1106915165381966e-05,1.0
49048,qudtlsrkxdms/Alpha,1,0,1,0.0,1.1106915165381966e-05,1.0
49049,Tlqkf/Alpha,1,0,1,0.0,1.1106915165381966e-05,1.0
49050,치졸/Noun,1,0,1,0.0,1.1106915165381966e-05,1.0
49051,둔기/Noun,1,1,0,1.1115310228308472e-05,0.0,1.0
49052,나뉘어지다/Verb,1,1,0,1.1115310228308472e-05,0.0,1.0
49053,빠밥빠/Noun,1,1,0,1.1115310228308472e-05,0.0,1.0
49054,냅둘껄/Noun,1,0,1,0.0,1.1106915165381966e-05,1.0
49055,쿠키런/Noun,1,0,1,0.0,1.1106915165381966e-05,1.0
49056,홀릴수/Noun,1,1,0,1.1115310228308472e-05,0.0,1.0
49057,super/Alpha,1,0,1,0.0,1.1106915165381966e-05,1.0
49058,41/Number,1,1,0,1.1115310228308472e-05,0.0,1.0
49059,응응씬/Noun,1,0,1,0.0,1.1106915165381966e-05,1.0
49060,에스트로겐/Noun,1,0,1,0.0,1.1106915165381966e-05,1.0
49061,Warning/Alpha,1,0,1,0.0,1.1106915165381966e-05,1.0
49062,이영수/Noun,1,1,0,1.1115310228308472e-05,0.0,1.0
49063,..???./Punctuation,1,0,1,0.0,1.1106915165381966e-05,1.0
49064,마강/Noun,1,0,1,0.0,1.1106915165381966e-05,1.0
49065,Bush/Alpha,1,0,1,0.0,1.1106915165381966e-05,1.0
49066,힌거/Noun,1,0,1,0.0,1.1106915165381966e-05,1.0
49067,!!!!!!!!!!!!!!!!!!!!!!!!!!!!!!!!!/Punctuation,1,1,0,1.1115310228308472e-05,0.0,1.0
49068,냉혹/Noun,1,0,1,0.0,1.1106915165381966e-05,1.0
49069,/^^&/Punctuation,1,1,0,1.1115310228308472e-05,0.0,1.0
49070,훌률/Noun,1,1,0,1.1115310228308472e-05,0.0,1.0
49071,02/Number,1,1,0,1.1115310228308472e-05,0.0,1.0
49072,...@./Email,1,0,1,0.0,1.1106915165381966e-05,1.0
49073,신퀴/Noun,1,1,0,1.1115310228308472e-05,0.0,1.0
49074,씩주고그랫음/Foreign,1,1,0,1.1115310228308472e-05,0.0,1.0
49075,페이퍼/Noun,1,1,0,1.1115310228308472e-05,0.0,1.0
49076,업업/Noun,1,1,0,1.1115310228308472e-05,0.0,1.0
49077,블링링/Noun,1,0,1,0.0,1.1106915165381966e-05,1.0
49078,크리에이터/Noun,1,0,1,0.0,1.1106915165381966e-05,1.0
49079,만있는건뭐야/Foreign,1,1,0,1.1115310228308472e-05,0.0,1.0
49080,현암/Noun,1,0,1,0.0,1.1106915165381966e-05,1.0
49081,durtlakwdkdiwl/Alpha,1,1,0,1.1115310228308472e-05,0.0,1.0
49082,방영시기/Noun,1,0,1,0.0,1.1106915165381966e-05,1.0
49083,ㅇㅂㅀ/KoreanParticle,1,0,1,0.0,1.1106915165381966e-05,1.0
49084,건실/Noun,1,1,0,1.1115310228308472e-05,0.0,1.0
49085,레져/Noun,1,1,0,1.1115310228308472e-05,0.0,1.0
49086,13회/Number,1,0,1,0.0,1.1106915165381966e-05,1.0
49087,스트림/Noun,1,0,1,0.0,1.1106915165381966e-05,1.0
49088,갯불/Noun,1,0,1,0.0,1.1106915165381966e-05,1.0
49089,풀함/Noun,1,0,1,0.0,1.1106915165381966e-05,1.0
49090,핀뇬놈/Noun,1,0,1,0.0,1.1106915165381966e-05,1.0
49091,미야케/Noun,1,0,1,0.0,1.1106915165381966e-05,1.0
49092,확찔러삘/Noun,1,0,1,0.0,1.1106915165381966e-05,1.0
49093,이찌끄레기/Noun,1,0,1,0.0,1.1106915165381966e-05,1.0
49094,픽스/Noun,1,0,1,0.0,1.1106915165381966e-05,1.0
49095,제모/Noun,1,1,0,1.1115310228308472e-05,0.0,1.0
49096,빼고/Foreign,1,0,1,0.0,1.1106915165381966e-05,1.0
49097,뽈렌느/Noun,1,1,0,1.1115310228308472e-05,0.0,1.0
49098,듀코브니/Noun,1,1,0,1.1115310228308472e-05,0.0,1.0
49099,군사정권/Noun,1,0,1,0.0,1.1106915165381966e-05,1.0
49100,뽀롱뽀롱/Noun,1,1,0,1.1115310228308472e-05,0.0,1.0
49101,좀파슈/Noun,1,1,0,1.1115310228308472e-05,0.0,1.0
49102,~!^_^*/Punctuation,1,1,0,1.1115310228308472e-05,0.0,1.0
49103,엉님/Noun,1,1,0,1.1115310228308472e-05,0.0,1.0
49104,쭝훈/Noun,1,1,0,1.1115310228308472e-05,0.0,1.0
49105,koon/Alpha,1,1,0,1.1115310228308472e-05,0.0,1.0
49106,wc/Alpha,1,1,0,1.1115310228308472e-05,0.0,1.0
49107,입털놈/Noun,1,1,0,1.1115310228308472e-05,0.0,1.0
49108,더재밌엇을듯/Noun,1,1,0,1.1115310228308472e-05,0.0,1.0
49109,삽시간/Noun,1,0,1,0.0,1.1106915165381966e-05,1.0
49110,exist/Alpha,1,0,1,0.0,1.1106915165381966e-05,1.0
49111,magicians/Alpha,1,0,1,0.0,1.1106915165381966e-05,1.0
49112,9.06/Number,1,1,0,1.1115310228308472e-05,0.0,1.0
49113,뿜어대/Noun,1,1,0,1.1115310228308472e-05,0.0,1.0
49114,게릴라콘서트/Noun,1,1,0,1.1115310228308472e-05,0.0,1.0
49115,옥수/Noun,1,1,0,1.1115310228308472e-05,0.0,1.0
49116,난왜릏/Noun,1,0,1,0.0,1.1106915165381966e-05,1.0
49117,박정학/Noun,1,1,0,1.1115310228308472e-05,0.0,1.0
49118,강동하다/Adjective,1,1,0,1.1115310228308472e-05,0.0,1.0
49119,조로증/Noun,1,1,0,1.1115310228308472e-05,0.0,1.0
49120,서주경/Noun,1,0,1,0.0,1.1106915165381966e-05,1.0
49121,정착할랬더/Noun,1,0,1,0.0,1.1106915165381966e-05,1.0
49122,대수롭다/Adjective,1,1,0,1.1115310228308472e-05,0.0,1.0
49123,좀글/Noun,1,0,1,0.0,1.1106915165381966e-05,1.0
49124,위나라/Noun,1,0,1,0.0,1.1106915165381966e-05,1.0
49125,전투헬기/Noun,1,1,0,1.1115310228308472e-05,0.0,1.0
49126,원데이/Noun,1,1,0,1.1115310228308472e-05,0.0,1.0
49127,김기연/Noun,1,1,0,1.1115310228308472e-05,0.0,1.0
49128,뢱베송/Noun,1,1,0,1.1115310228308472e-05,0.0,1.0
49129,WasteTime/Alpha,1,0,1,0.0,1.1106915165381966e-05,1.0
49130,KillingTime/Alpha,1,0,1,0.0,1.1106915165381966e-05,1.0
49131,Junk/Alpha,1,0,1,0.0,1.1106915165381966e-05,1.0
49132,진임/Noun,1,0,1,0.0,1.1106915165381966e-05,1.0
49133,Camus/Alpha,1,1,0,1.1115310228308472e-05,0.0,1.0
49134,Albert/Alpha,1,1,0,1.1115310228308472e-05,0.0,1.0
49135,국수주의자/Noun,1,1,0,1.1115310228308472e-05,0.0,1.0
49136,울랄라부부/Noun,1,1,0,1.1115310228308472e-05,0.0,1.0
49137,fatb/Alpha,1,1,0,1.1115310228308472e-05,0.0,1.0
49138,남넹/Noun,1,1,0,1.1115310228308472e-05,0.0,1.0
49139,곡임/Noun,1,1,0,1.1115310228308472e-05,0.0,1.0
49140,김재승/Noun,1,0,1,0.0,1.1106915165381966e-05,1.0
49141,2014.08/Number,1,0,1,0.0,1.1106915165381966e-05,1.0
49142,!>_/Punctuation,1,1,0,1.1115310228308472e-05,0.0,1.0
49143,조타/Noun,1,1,0,1.1115310228308472e-05,0.0,1.0
49144,유네스코/Noun,1,1,0,1.1115310228308472e-05,0.0,1.0
49145,붕탁랜드/Noun,1,1,0,1.1115310228308472e-05,0.0,1.0
49146,돈질/Noun,1,0,1,0.0,1.1106915165381966e-05,1.0
49147,락랄/Noun,1,0,1,0.0,1.1106915165381966e-05,1.0
49148,별가/Noun,1,0,1,0.0,1.1106915165381966e-05,1.0
49149,을차지하네요/Foreign,1,0,1,0.0,1.1106915165381966e-05,1.0
49150,♡♥♡♥♡/Foreign,1,1,0,1.1115310228308472e-05,0.0,1.0
49151,보모/Noun,1,1,0,1.1115310228308472e-05,0.0,1.0
49152,건남/Noun,1,1,0,1.1115310228308472e-05,0.0,1.0
49153,흥쾌/Noun,1,0,1,0.0,1.1106915165381966e-05,1.0
49154,http://blog.naver.com/dicasso6/URL,1,1,0,1.1115310228308472e-05,0.0,1.0
49155,appearing/Alpha,1,0,1,0.0,1.1106915165381966e-05,1.0
49156,북아일랜드/Noun,1,0,1,0.0,1.1106915165381966e-05,1.0
49157,썬데이서울/Noun,1,0,1,0.0,1.1106915165381966e-05,1.0
49158,지나도/Foreign,1,0,1,0.0,1.1106915165381966e-05,1.0
49159,핫이슈/Noun,1,1,0,1.1115310228308472e-05,0.0,1.0
49160,좀맛/Noun,1,0,1,0.0,1.1106915165381966e-05,1.0
49161,만이/Foreign,1,1,0,1.1115310228308472e-05,0.0,1.0
49162,禮/Foreign,1,0,1,0.0,1.1106915165381966e-05,1.0
49163,先祖/Foreign,1,0,1,0.0,1.1106915165381966e-05,1.0
49164,ㅁㅁㅁ/KoreanParticle,1,0,1,0.0,1.1106915165381966e-05,1.0
49165,이안사/Noun,1,0,1,0.0,1.1106915165381966e-05,1.0
49166,16시간/Number,1,1,0,1.1115310228308472e-05,0.0,1.0
49167,떠오릴/Noun,1,0,1,0.0,1.1106915165381966e-05,1.0
49168,Shine/Alpha,1,0,1,0.0,1.1106915165381966e-05,1.0
49169,Concerto/Alpha,1,0,1,0.0,1.1106915165381966e-05,1.0
49170,Piano/Alpha,1,0,1,0.0,1.1106915165381966e-05,1.0
49171,Rachmaninoff/Alpha,1,0,1,0.0,1.1106915165381966e-05,1.0
49172,엽총/Noun,1,0,1,0.0,1.1106915165381966e-05,1.0
49173,엽동/Noun,1,0,1,0.0,1.1106915165381966e-05,1.0
49174,바랬을거/Noun,1,0,1,0.0,1.1106915165381966e-05,1.0
49175,최완규/Noun,1,0,1,0.0,1.1106915165381966e-05,1.0
49176,쫄쫄이좀/Noun,1,0,1,0.0,1.1106915165381966e-05,1.0
49177,욕바/Noun,1,0,1,0.0,1.1106915165381966e-05,1.0
49178,원류/Noun,1,1,0,1.1115310228308472e-05,0.0,1.0
49179,623/Number,1,0,1,0.0,1.1106915165381966e-05,1.0
49180,대치곤/Foreign,1,1,0,1.1115310228308472e-05,0.0,1.0
49181,온수/Noun,1,1,0,1.1115310228308472e-05,0.0,1.0
49182,사싯/Noun,1,0,1,0.0,1.1106915165381966e-05,1.0
49183,쌉쓰레/Adverb,1,0,1,0.0,1.1106915165381966e-05,1.0
49184,수복/Noun,1,0,1,0.0,1.1106915165381966e-05,1.0
49185,별나라/Noun,1,0,1,0.0,1.1106915165381966e-05,1.0
49186,ㄴㄷㅎ/KoreanParticle,1,0,1,0.0,1.1106915165381966e-05,1.0
49187,김성규/Noun,1,1,0,1.1115310228308472e-05,0.0,1.0
49188,성규/Noun,1,1,0,1.1115310228308472e-05,0.0,1.0
49189,섀퀴/Noun,1,0,1,0.0,1.1106915165381966e-05,1.0
49190,팀버트/Noun,1,1,0,1.1115310228308472e-05,0.0,1.0
49191,병점/Noun,1,1,0,1.1115310228308472e-05,0.0,1.0
49192,선감도/Noun,1,0,1,0.0,1.1106915165381966e-05,1.0
49193,도끼자국/Noun,1,0,1,0.0,1.1106915165381966e-05,1.0
49194,레기나/Noun,1,1,0,1.1115310228308472e-05,0.0,1.0
49195,예티/Noun,1,1,0,1.1115310228308472e-05,0.0,1.0
49196,리메작임/Noun,1,1,0,1.1115310228308472e-05,0.0,1.0
49197,바셀팬/Noun,1,1,0,1.1115310228308472e-05,0.0,1.0
49198,균등하다/Adjective,1,0,1,0.0,1.1106915165381966e-05,1.0
49199,alone/Alpha,1,1,0,1.1115310228308472e-05,0.0,1.0
49200,leave/Alpha,1,1,0,1.1115310228308472e-05,0.0,1.0
49201,라고만은/Josa,1,1,0,1.1115310228308472e-05,0.0,1.0
49202,함뭐/Noun,1,1,0,1.1115310228308472e-05,0.0,1.0
49203,그냠/Noun,1,0,1,0.0,1.1106915165381966e-05,1.0
49204,FOREVER/Alpha,1,0,1,0.0,1.1106915165381966e-05,1.0
49205,호점떄/Noun,1,1,0,1.1115310228308472e-05,0.0,1.0
49206,까치네/Noun,1,1,0,1.1115310228308472e-05,0.0,1.0
49207,마초맨/Noun,1,1,0,1.1115310228308472e-05,0.0,1.0
49208,콩신/Noun,1,0,1,0.0,1.1106915165381966e-05,1.0
49209,콩콩이다/Verb,1,0,1,0.0,1.1106915165381966e-05,1.0
49210,괄활/Noun,1,1,0,1.1115310228308472e-05,0.0,1.0
49211,황음/Noun,1,1,0,1.1115310228308472e-05,0.0,1.0
49212,캐낚였다/Noun,1,0,1,0.0,1.1106915165381966e-05,1.0
49213,왜캐평/Noun,1,0,1,0.0,1.1106915165381966e-05,1.0
49214,다보고/Foreign,1,0,1,0.0,1.1106915165381966e-05,1.0
49215,이은성/Noun,1,1,0,1.1115310228308472e-05,0.0,1.0
49216,실웃/Noun,1,1,0,1.1115310228308472e-05,0.0,1.0
49217,잔향/Noun,1,1,0,1.1115310228308472e-05,0.0,1.0
49218,페이첵/Noun,1,0,1,0.0,1.1106915165381966e-05,1.0
49219,분포/Noun,1,1,0,1.1115310228308472e-05,0.0,1.0
49220,VFX/Alpha,1,0,1,0.0,1.1106915165381966e-05,1.0
49221,눈꼽만큼/Noun,1,0,1,0.0,1.1106915165381966e-05,1.0
49222,임병/Noun,1,0,1,0.0,1.1106915165381966e-05,1.0
49223,댄/Noun,1,0,1,0.0,1.1106915165381966e-05,1.0
49224,죨짝/Noun,1,0,1,0.0,1.1106915165381966e-05,1.0
49225,EF/Alpha,1,0,1,0.0,1.1106915165381966e-05,1.0
49226,@!/Punctuation,1,0,1,0.0,1.1106915165381966e-05,1.0
49227,강기화/Noun,1,1,0,1.1115310228308472e-05,0.0,1.0
49228,!!!!!!!!!!!!!!!!!!!!!!!!!!!!!!!!!!!!!!!!!!!!!!!!!/Punctuation,1,1,0,1.1115310228308472e-05,0.0,1.0
49229,조드임/Noun,1,0,1,0.0,1.1106915165381966e-05,1.0
49230,키링/Noun,1,1,0,1.1115310228308472e-05,0.0,1.0
49231,뇌관/Noun,1,0,1,0.0,1.1106915165381966e-05,1.0
49232,헛점들/Noun,1,0,1,0.0,1.1106915165381966e-05,1.0
49233,gozu/Alpha,1,1,0,1.1115310228308472e-05,0.0,1.0
49234,미쏘/Noun,1,1,0,1.1115310228308472e-05,0.0,1.0
49235,그랟/Noun,1,1,0,1.1115310228308472e-05,0.0,1.0
49236,엿되/Noun,1,0,1,0.0,1.1106915165381966e-05,1.0
49237,sky/Alpha,1,1,0,1.1115310228308472e-05,0.0,1.0
49238,Glamorous/Alpha,1,1,0,1.1115310228308472e-05,0.0,1.0
49239,곤혹/Noun,1,0,1,0.0,1.1106915165381966e-05,1.0
49240,...!!?/Punctuation,1,0,1,0.0,1.1106915165381966e-05,1.0
49241,고에몽/Noun,1,0,1,0.0,1.1106915165381966e-05,1.0
49242,빠트린/Noun,1,0,1,0.0,1.1106915165381966e-05,1.0
49243,바트/Noun,1,1,0,1.1115310228308472e-05,0.0,1.0
49244,짜리암세포란/Foreign,1,0,1,0.0,1.1106915165381966e-05,1.0
49245,겟섬/Noun,1,0,1,0.0,1.1106915165381966e-05,1.0
49246,Baby/Alpha,1,1,0,1.1115310228308472e-05,0.0,1.0
49247,힘드렀음/Noun,1,1,0,1.1115310228308472e-05,0.0,1.0
49248,giving/Alpha,1,0,1,0.0,1.1106915165381966e-05,1.0
49249,im/Alpha,1,0,1,0.0,1.1106915165381966e-05,1.0
49250,looks/Alpha,1,0,1,0.0,1.1106915165381966e-05,1.0
49251,says/Alpha,1,0,1,0.0,1.1106915165381966e-05,1.0
49252,Helen/Alpha,1,0,1,0.0,1.1106915165381966e-05,1.0
49253,식삭/Noun,1,0,1,0.0,1.1106915165381966e-05,1.0
49254,프라모델/Noun,1,0,1,0.0,1.1106915165381966e-05,1.0
49255,영화만봐도/Foreign,1,1,0,1.1115310228308472e-05,0.0,1.0
49256,2006~7년/Number,1,1,0,1.1115310228308472e-05,0.0,1.0
49257,예비신랑/Noun,1,0,1,0.0,1.1106915165381966e-05,1.0
49258,우스개/Noun,1,0,1,0.0,1.1106915165381966e-05,1.0
49259,이규/Noun,1,0,1,0.0,1.1106915165381966e-05,1.0
49260,토도/Noun,1,1,0,1.1115310228308472e-05,0.0,1.0
49261,가레키/Noun,1,1,0,1.1115310228308472e-05,0.0,1.0
49262,똑바루/Noun,1,0,1,0.0,1.1106915165381966e-05,1.0
49263,폿/Noun,1,0,1,0.0,1.1106915165381966e-05,1.0
49264,말레/Noun,1,0,1,0.0,1.1106915165381966e-05,1.0
49265,김인/Noun,1,0,1,0.0,1.1106915165381966e-05,1.0
49266,하피/Noun,1,0,1,0.0,1.1106915165381966e-05,1.0
49267,꾸르잼잼/Noun,1,1,0,1.1115310228308472e-05,0.0,1.0
49268,엄좋다/Noun,1,1,0,1.1115310228308472e-05,0.0,1.0
49269,에밋/Noun,1,1,0,1.1115310228308472e-05,0.0,1.0
49270,이베리아반도/Noun,1,1,0,1.1115310228308472e-05,0.0,1.0
49271,!!!../Punctuation,1,0,1,0.0,1.1106915165381966e-05,1.0
49272,말랬는데/Noun,1,0,1,0.0,1.1106915165381966e-05,1.0
49273,사투씬/Noun,1,1,0,1.1115310228308472e-05,0.0,1.0
49274,어렷을때봣던/Noun,1,1,0,1.1115310228308472e-05,0.0,1.0
49275,혜숙/Noun,1,1,0,1.1115310228308472e-05,0.0,1.0
49276,사하구/Noun,1,1,0,1.1115310228308472e-05,0.0,1.0
49277,스파이디/Noun,1,1,0,1.1115310228308472e-05,0.0,1.0
49278,높드/Noun,1,0,1,0.0,1.1106915165381966e-05,1.0
49279,워씬/Noun,1,0,1,0.0,1.1106915165381966e-05,1.0
49280,투광/Noun,1,0,1,0.0,1.1106915165381966e-05,1.0
49281,즈음에/Foreign,1,0,1,0.0,1.1106915165381966e-05,1.0
49282,방사능오염/Noun,1,0,1,0.0,1.1106915165381966e-05,1.0
49283,쓴맛/Noun,1,1,0,1.1115310228308472e-05,0.0,1.0
49284,조원석/Noun,1,0,1,0.0,1.1106915165381966e-05,1.0
49285,파르나디/Noun,1,1,0,1.1115310228308472e-05,0.0,1.0
49286,.^_^/Punctuation,1,1,0,1.1115310228308472e-05,0.0,1.0
49287,딥임펙트/Noun,1,1,0,1.1115310228308472e-05,0.0,1.0
49288,296/Number,1,1,0,1.1115310228308472e-05,0.0,1.0
49289,필요시/Noun,1,0,1,0.0,1.1106915165381966e-05,1.0
49290,달레/Noun,1,1,0,1.1115310228308472e-05,0.0,1.0
49291,라캉/Noun,1,1,0,1.1115310228308472e-05,0.0,1.0
49292,개구리소년/Noun,1,0,1,0.0,1.1106915165381966e-05,1.0
49293,납치사건/Noun,1,0,1,0.0,1.1106915165381966e-05,1.0
49294,읊/Noun,1,1,0,1.1115310228308472e-05,0.0,1.0
49295,떄메/Noun,1,0,1,0.0,1.1106915165381966e-05,1.0
49296,넣엇어/Noun,1,0,1,0.0,1.1106915165381966e-05,1.0
49297,첨언하/Noun,1,1,0,1.1115310228308472e-05,0.0,1.0
49298,모노드라마/Noun,1,0,1,0.0,1.1106915165381966e-05,1.0
49299,최애캐/Noun,1,1,0,1.1115310228308472e-05,0.0,1.0
49300,원술랑/Noun,1,1,0,1.1115310228308472e-05,0.0,1.0
49301,과관임/Noun,1,0,1,0.0,1.1106915165381966e-05,1.0
49302,졸개/Noun,1,1,0,1.1115310228308472e-05,0.0,1.0
49303,커미션/Noun,1,0,1,0.0,1.1106915165381966e-05,1.0
49304,LOLOLOLOLOLOLOL/Alpha,1,0,1,0.0,1.1106915165381966e-05,1.0
49305,리지맥과이어/Noun,1,1,0,1.1115310228308472e-05,0.0,1.0
49306,30만원/Number,1,0,1,0.0,1.1106915165381966e-05,1.0
49307,로마노/Noun,1,1,0,1.1115310228308472e-05,0.0,1.0
49308,련아련/Noun,1,1,0,1.1115310228308472e-05,0.0,1.0
49309,로맨스소설/Noun,1,0,1,0.0,1.1106915165381966e-05,1.0
49310,개준/Noun,1,0,1,0.0,1.1106915165381966e-05,1.0
49311,망고스틴/Noun,1,1,0,1.1115310228308472e-05,0.0,1.0
49312,크리스트/Noun,1,1,0,1.1115310228308472e-05,0.0,1.0
49313,안드레아스/Noun,1,1,0,1.1115310228308472e-05,0.0,1.0
49314,놀래킬려/Noun,1,0,1,0.0,1.1106915165381966e-05,1.0
49315,이거뭐긔/Noun,1,0,1,0.0,1.1106915165381966e-05,1.0
49316,루번/Noun,1,0,1,0.0,1.1106915165381966e-05,1.0
49317,샡기/Noun,1,0,1,0.0,1.1106915165381966e-05,1.0
49318,볼뻔/Noun,1,1,0,1.1115310228308472e-05,0.0,1.0
49319,쮯/Noun,1,0,1,0.0,1.1106915165381966e-05,1.0
49320,부익부/Noun,1,1,0,1.1115310228308472e-05,0.0,1.0
49321,빈익빈/Noun,1,1,0,1.1115310228308472e-05,0.0,1.0
49322,보리밥/Noun,1,0,1,0.0,1.1106915165381966e-05,1.0
49323,이쁘넝/Noun,1,1,0,1.1115310228308472e-05,0.0,1.0
49324,쨰/Foreign,1,0,1,0.0,1.1106915165381966e-05,1.0
49325,헤일/Noun,1,1,0,1.1115310228308472e-05,0.0,1.0
49326,브리짓스/Noun,1,1,0,1.1115310228308472e-05,0.0,1.0
49327,망설엿는데/Noun,1,1,0,1.1115310228308472e-05,0.0,1.0
49328,포도아/Noun,1,0,1,0.0,1.1106915165381966e-05,1.0
49329,설욕/Noun,1,0,1,0.0,1.1106915165381966e-05,1.0
49330,도개봉한걸/Foreign,1,0,1,0.0,1.1106915165381966e-05,1.0
49331,위태롭/Noun,1,1,0,1.1115310228308472e-05,0.0,1.0
49332,러팔로/Noun,1,1,0,1.1115310228308472e-05,0.0,1.0
49333,반성만/Noun,1,0,1,0.0,1.1106915165381966e-05,1.0
49334,자뻑하/Noun,1,0,1,0.0,1.1106915165381966e-05,1.0
49335,디었/Noun,1,0,1,0.0,1.1106915165381966e-05,1.0
49336,대왕오징어/Noun,1,0,1,0.0,1.1106915165381966e-05,1.0
49337,양키스/Noun,1,1,0,1.1115310228308472e-05,0.0,1.0
49338,5131/Number,1,0,1,0.0,1.1106915165381966e-05,1.0
49339,okbag/Alpha,1,0,1,0.0,1.1106915165381966e-05,1.0
49340,놨는/Noun,1,0,1,0.0,1.1106915165381966e-05,1.0
49341,오십분/Noun,1,0,1,0.0,1.1106915165381966e-05,1.0
49342,옹녀던/Noun,1,0,1,0.0,1.1106915165381966e-05,1.0
49343,역션/Noun,1,0,1,0.0,1.1106915165381966e-05,1.0
49344,시큰하다/Adjective,1,1,0,1.1115310228308472e-05,0.0,1.0
49345,매경/Noun,1,0,1,0.0,1.1106915165381966e-05,1.0
49346,수도복/Noun,1,0,1,0.0,1.1106915165381966e-05,1.0
49347,천삼백만/Noun,1,1,0,1.1115310228308472e-05,0.0,1.0
49348,총리와/Noun,1,1,0,1.1115310228308472e-05,0.0,1.0
49349,",?,,/Punctuation",1,0,1,0.0,1.1106915165381966e-05,1.0
49350,00000/Number,1,1,0,1.1115310228308472e-05,0.0,1.0
49351,비더/Noun,1,1,0,1.1115310228308472e-05,0.0,1.0
49352,이재석/Noun,1,1,0,1.1115310228308472e-05,0.0,1.0
49353,미생물/Noun,1,1,0,1.1115310228308472e-05,0.0,1.0
49354,171/Number,1,0,1,0.0,1.1106915165381966e-05,1.0
49355,돌핀/Noun,1,1,0,1.1115310228308472e-05,0.0,1.0
49356,옜날껀데/Noun,1,1,0,1.1115310228308472e-05,0.0,1.0
49357,레전/Noun,1,0,1,0.0,1.1106915165381966e-05,1.0
49358,윤색/Noun,1,0,1,0.0,1.1106915165381966e-05,1.0
49359,spears/Alpha,1,1,0,1.1115310228308472e-05,0.0,1.0
49360,britney/Alpha,1,1,0,1.1115310228308472e-05,0.0,1.0
49361,".,.,.,.,.,..,/Punctuation",1,0,1,0.0,1.1106915165381966e-05,1.0
49362,쟈베르/Noun,1,0,1,0.0,1.1106915165381966e-05,1.0
49363,장뱔장/Noun,1,0,1,0.0,1.1106915165381966e-05,1.0
49364,팡틴/Noun,1,0,1,0.0,1.1106915165381966e-05,1.0
49365,맘바/Noun,1,0,1,0.0,1.1106915165381966e-05,1.0
49366,히라이켄/Noun,1,1,0,1.1115310228308472e-05,0.0,1.0
49367,나태/Noun,1,0,1,0.0,1.1106915165381966e-05,1.0
49368,나지막이/Adverb,1,1,0,1.1115310228308472e-05,0.0,1.0
49369,샹돈/Noun,1,0,1,0.0,1.1106915165381966e-05,1.0
49370,사티/Noun,1,1,0,1.1115310228308472e-05,0.0,1.0
49371,피치걸/Noun,1,0,1,0.0,1.1106915165381966e-05,1.0
49372,디절/Noun,1,0,1,0.0,1.1106915165381966e-05,1.0
49373,잼엄써/Noun,1,0,1,0.0,1.1106915165381966e-05,1.0
49374,체척/Noun,1,0,1,0.0,1.1106915165381966e-05,1.0
49375,류성룡/Noun,1,1,0,1.1115310228308472e-05,0.0,1.0
49376,!!!-_-/Punctuation,1,0,1,0.0,1.1106915165381966e-05,1.0
49377,도괴/Noun,1,0,1,0.0,1.1106915165381966e-05,1.0
49378,미니카/Noun,1,1,0,1.1115310228308472e-05,0.0,1.0
49379,괴상망측/Noun,1,0,1,0.0,1.1106915165381966e-05,1.0
49380,창훈/Noun,1,1,0,1.1115310228308472e-05,0.0,1.0
49381,짤때/Noun,1,0,1,0.0,1.1106915165381966e-05,1.0
49382,메모/Noun,1,1,0,1.1115310228308472e-05,0.0,1.0
49383,raw/Alpha,1,1,0,1.1115310228308472e-05,0.0,1.0
49384,핸/Noun,1,1,0,1.1115310228308472e-05,0.0,1.0
49385,배림/Noun,1,0,1,0.0,1.1106915165381966e-05,1.0
49386,한유리/Noun,1,0,1,0.0,1.1106915165381966e-05,1.0
49387,류뚱/Noun,1,0,1,0.0,1.1106915165381966e-05,1.0
49388,요격/Noun,1,1,0,1.1115310228308472e-05,0.0,1.0
49389,알겡/Noun,1,1,0,1.1115310228308472e-05,0.0,1.0
49390,~></Punctuation,1,1,0,1.1115310228308472e-05,0.0,1.0
49391,쫌더/Noun,1,0,1,0.0,1.1106915165381966e-05,1.0
49392,뺨침/Noun,1,0,1,0.0,1.1106915165381966e-05,1.0
49393,8.55/Number,1,0,1,0.0,1.1106915165381966e-05,1.0
49394,맘징창/Noun,1,0,1,0.0,1.1106915165381966e-05,1.0
49395,헛바람/Noun,1,0,1,0.0,1.1106915165381966e-05,1.0
49396,합니/Noun,1,1,0,1.1115310228308472e-05,0.0,1.0
49397,6등/Number,1,1,0,1.1115310228308472e-05,0.0,1.0
49398,보슬영화/Noun,1,0,1,0.0,1.1106915165381966e-05,1.0
49399,3/4/Number,1,0,1,0.0,1.1106915165381966e-05,1.0
49400,헐춋류훃/Noun,1,1,0,1.1115310228308472e-05,0.0,1.0
49401,프랜시즈/Noun,1,0,1,0.0,1.1106915165381966e-05,1.0
49402,일케높/Noun,1,0,1,0.0,1.1106915165381966e-05,1.0
49403,100000000000000000000000%/Number,1,0,1,0.0,1.1106915165381966e-05,1.0
49404,극진/Noun,1,0,1,0.0,1.1106915165381966e-05,1.0
49405,엣헹/Noun,1,0,1,0.0,1.1106915165381966e-05,1.0
49406,남녀공학/Noun,1,0,1,0.0,1.1106915165381966e-05,1.0
49407,아무쪼록/Adverb,1,0,1,0.0,1.1106915165381966e-05,1.0
49408,올케/Noun,1,0,1,0.0,1.1106915165381966e-05,1.0
49409,손위/Noun,1,0,1,0.0,1.1106915165381966e-05,1.0
49410,젤다/Noun,1,0,1,0.0,1.1106915165381966e-05,1.0
49411,IRON/Alpha,1,0,1,0.0,1.1106915165381966e-05,1.0
49412,안소영/Noun,1,0,1,0.0,1.1106915165381966e-05,1.0
49413,새볔녁/Noun,1,1,0,1.1115310228308472e-05,0.0,1.0
49414,MR/Alpha,1,0,1,0.0,1.1106915165381966e-05,1.0
49415,늦봄/Noun,1,1,0,1.1115310228308472e-05,0.0,1.0
49416,통근/Noun,1,0,1,0.0,1.1106915165381966e-05,1.0
49417,날카로워지다/Verb,1,1,0,1.1115310228308472e-05,0.0,1.0
49418,데스몬드/Noun,1,1,0,1.1115310228308472e-05,0.0,1.0
49419,최우수상/Noun,1,1,0,1.1115310228308472e-05,0.0,1.0
49420,...................?/Punctuation,1,0,1,0.0,1.1106915165381966e-05,1.0
49421,넥더키/Noun,1,1,0,1.1115310228308472e-05,0.0,1.0
49422,*^-^*/Punctuation,1,1,0,1.1115310228308472e-05,0.0,1.0
49423,젖절/Noun,1,0,1,0.0,1.1106915165381966e-05,1.0
49424,프레파/Noun,1,0,1,0.0,1.1106915165381966e-05,1.0
49425,나빳음/Noun,1,1,0,1.1115310228308472e-05,0.0,1.0
49426,레스링/Noun,1,0,1,0.0,1.1106915165381966e-05,1.0
49427,지팩/Noun,1,1,0,1.1115310228308472e-05,0.0,1.0
49428,보녀/Noun,1,1,0,1.1115310228308472e-05,0.0,1.0
49429,봉시/Noun,1,0,1,0.0,1.1106915165381966e-05,1.0
49430,댕기땋/Noun,1,1,0,1.1115310228308472e-05,0.0,1.0
49431,fdddddfffd/Alpha,1,1,0,1.1115310228308472e-05,0.0,1.0
49432,97/Number,1,0,1,0.0,1.1106915165381966e-05,1.0
49433,{+}/Punctuation,1,1,0,1.1115310228308472e-05,0.0,1.0
49434,이원승/Noun,1,1,0,1.1115310228308472e-05,0.0,1.0
49435,낚인겨/Noun,1,0,1,0.0,1.1106915165381966e-05,1.0
49436,왕기/Noun,1,1,0,1.1115310228308472e-05,0.0,1.0
49437,유권/Noun,1,1,0,1.1115310228308472e-05,0.0,1.0
49438,척함/Noun,1,0,1,0.0,1.1106915165381966e-05,1.0
49439,ㅋㄱㄲ/KoreanParticle,1,0,1,0.0,1.1106915165381966e-05,1.0
49440,쫄보/Noun,1,0,1,0.0,1.1106915165381966e-05,1.0
49441,튜표할래욧/Noun,1,0,1,0.0,1.1106915165381966e-05,1.0
49442,스케이트장/Noun,1,1,0,1.1115310228308472e-05,0.0,1.0
49443,웨이터/Noun,1,1,0,1.1115310228308472e-05,0.0,1.0
49444,헐퀴/Noun,1,1,0,1.1115310228308472e-05,0.0,1.0
49445,~~~^^;;;/Punctuation,1,0,1,0.0,1.1106915165381966e-05,1.0
49446,마쯔/Noun,1,1,0,1.1115310228308472e-05,0.0,1.0
49447,피혜의식/Noun,1,0,1,0.0,1.1106915165381966e-05,1.0
49448,암암리/Noun,1,0,1,0.0,1.1106915165381966e-05,1.0
49449,즉결/Noun,1,0,1,0.0,1.1106915165381966e-05,1.0
49450,어용/Noun,1,0,1,0.0,1.1106915165381966e-05,1.0
49451,휴대전화/Noun,1,0,1,0.0,1.1106915165381966e-05,1.0
49452,돈만날렷/Noun,1,0,1,0.0,1.1106915165381966e-05,1.0
49453,됭/Noun,1,1,0,1.1115310228308472e-05,0.0,1.0
49454,ㅜㅅ/KoreanParticle,1,1,0,1.1115310228308472e-05,0.0,1.0
49455,구시/Noun,1,1,0,1.1115310228308472e-05,0.0,1.0
49456,웃찿사/Noun,1,0,1,0.0,1.1106915165381966e-05,1.0
49457,피알/Noun,1,0,1,0.0,1.1106915165381966e-05,1.0
49458,주비/Noun,1,0,1,0.0,1.1106915165381966e-05,1.0
49459,woal/Alpha,1,1,0,1.1115310228308472e-05,0.0,1.0
49460,용/Foreign,1,0,1,0.0,1.1106915165381966e-05,1.0
49461,비정규직/Noun,1,1,0,1.1115310228308472e-05,0.0,1.0
49462,photo/Alpha,1,1,0,1.1115310228308472e-05,0.0,1.0
49463,hour/Alpha,1,1,0,1.1115310228308472e-05,0.0,1.0
49464,뚜벅뚜벅/Noun,1,1,0,1.1115310228308472e-05,0.0,1.0
49465,챨리/Noun,1,1,0,1.1115310228308472e-05,0.0,1.0
49466,Introducing/Alpha,1,0,1,0.0,1.1106915165381966e-05,1.0
49467,Yo/Alpha,1,0,1,0.0,1.1106915165381966e-05,1.0
49468,"..-_-;""/Punctuation",1,0,1,0.0,1.1106915165381966e-05,1.0
49469,"^^""../Punctuation",1,0,1,0.0,1.1106915165381966e-05,1.0
49470,사진작가/Noun,1,0,1,0.0,1.1106915165381966e-05,1.0
49471,와이비/Noun,1,1,0,1.1115310228308472e-05,0.0,1.0
49472,굿뚜/Noun,1,1,0,1.1115310228308472e-05,0.0,1.0
49473,기휘/Noun,1,0,1,0.0,1.1106915165381966e-05,1.0
49474,오삼/Noun,1,1,0,1.1115310228308472e-05,0.0,1.0
49475,goqmdl/Alpha,1,1,0,1.1115310228308472e-05,0.0,1.0
49476,柱傑侖/Foreign,1,1,0,1.1115310228308472e-05,0.0,1.0
49477,빠떨/Noun,1,1,0,1.1115310228308472e-05,0.0,1.0
49478,썪씨딩유/Noun,1,1,0,1.1115310228308472e-05,0.0,1.0
49479,INS/Alpha,1,1,0,1.1115310228308472e-05,0.0,1.0
49480,족임/Noun,1,0,1,0.0,1.1106915165381966e-05,1.0
49481,관녀/Noun,1,0,1,0.0,1.1106915165381966e-05,1.0
49482,napping/Alpha,1,0,1,0.0,1.1106915165381966e-05,1.0
49483,병운/Noun,1,1,0,1.1115310228308472e-05,0.0,1.0
49484,이냐/Foreign,1,0,1,0.0,1.1106915165381966e-05,1.0
49485,빙긋/Noun,1,0,1,0.0,1.1106915165381966e-05,1.0
49486,스니/Noun,1,1,0,1.1115310228308472e-05,0.0,1.0
49487,류삘/Noun,1,0,1,0.0,1.1106915165381966e-05,1.0
49488,~~~~~~~~~~~~~~~~/Punctuation,1,0,1,0.0,1.1106915165381966e-05,1.0
49489,툇/Noun,1,0,1,0.0,1.1106915165381966e-05,1.0
49490,이항/Noun,1,0,1,0.0,1.1106915165381966e-05,1.0
49491,용달차/Noun,1,0,1,0.0,1.1106915165381966e-05,1.0
49492,강남길/Noun,1,0,1,0.0,1.1106915165381966e-05,1.0
49493,웅팍/Noun,1,1,0,1.1115310228308472e-05,0.0,1.0
49494,반짜리를/Foreign,1,0,1,0.0,1.1106915165381966e-05,1.0
49495,AJ/Alpha,1,0,1,0.0,1.1106915165381966e-05,1.0
49496,불간/Noun,1,0,1,0.0,1.1106915165381966e-05,1.0
49497,잡티/Noun,1,0,1,0.0,1.1106915165381966e-05,1.0
49498,홍인/Noun,1,0,1,0.0,1.1106915165381966e-05,1.0
49499,!!!...../Punctuation,1,1,0,1.1115310228308472e-05,0.0,1.0
49500,)-_-/Punctuation,1,0,1,0.0,1.1106915165381966e-05,1.0
49501,손손/Noun,1,1,0,1.1115310228308472e-05,0.0,1.0
49502,왓더헬/Noun,1,0,1,0.0,1.1106915165381966e-05,1.0
49503,00000000000000000000000000000/Number,1,0,1,0.0,1.1106915165381966e-05,1.0
49504,피터레빗/Noun,1,1,0,1.1115310228308472e-05,0.0,1.0
49505,^^^^^^/Punctuation,1,1,0,1.1115310228308472e-05,0.0,1.0
49506,씀돠/Noun,1,1,0,1.1115310228308472e-05,0.0,1.0
49507,눈갱/Noun,1,0,1,0.0,1.1106915165381966e-05,1.0
49508,셋별/Noun,1,1,0,1.1115310228308472e-05,0.0,1.0
49509,에게서는/Josa,1,1,0,1.1115310228308472e-05,0.0,1.0
49510,개머싯슴/Noun,1,1,0,1.1115310228308472e-05,0.0,1.0
49511,때로/Foreign,1,1,0,1.1115310228308472e-05,0.0,1.0
49512,술렁이다/Verb,1,1,0,1.1115310228308472e-05,0.0,1.0
49513,Core/Alpha,1,0,1,0.0,1.1106915165381966e-05,1.0
49514,왕때/Noun,1,0,1,0.0,1.1106915165381966e-05,1.0
49515,도오빠들의활약을기대하고응원합니다/Foreign,1,1,0,1.1115310228308472e-05,0.0,1.0
49516,아빅/Noun,1,1,0,1.1115310228308472e-05,0.0,1.0
49517,다우/Noun,1,0,1,0.0,1.1106915165381966e-05,1.0
49518,다우기술/Noun,1,0,1,0.0,1.1106915165381966e-05,1.0
49519,는군/Eomi,1,0,1,0.0,1.1106915165381966e-05,1.0
49520,라즈/Noun,1,1,0,1.1115310228308472e-05,0.0,1.0
49521,데친/Noun,1,0,1,0.0,1.1106915165381966e-05,1.0
49522,놀러왓음/Noun,1,0,1,0.0,1.1106915165381966e-05,1.0
49523,멸망설/Noun,1,1,0,1.1115310228308472e-05,0.0,1.0
49524,10429/Number,1,1,0,1.1115310228308472e-05,0.0,1.0
49525,ㅇㅁㄴㅇㅁㄴㅇㄴㅁㅇ/KoreanParticle,1,0,1,0.0,1.1106915165381966e-05,1.0
49526,주륵/Noun,1,1,0,1.1115310228308472e-05,0.0,1.0
49527,호통/Noun,1,1,0,1.1115310228308472e-05,0.0,1.0
49528,Roh/Alpha,1,0,1,0.0,1.1106915165381966e-05,1.0
49529,게드/Noun,1,1,0,1.1115310228308472e-05,0.0,1.0
49530,에스퍼/Noun,1,1,0,1.1115310228308472e-05,0.0,1.0
49531,bar/Alpha,1,1,0,1.1115310228308472e-05,0.0,1.0
49532,화악/Noun,1,0,1,0.0,1.1106915165381966e-05,1.0
49533,드립커피/Noun,1,0,1,0.0,1.1106915165381966e-05,1.0
49534,불좀키/Noun,1,0,1,0.0,1.1106915165381966e-05,1.0
49535,놀랫/Noun,1,0,1,0.0,1.1106915165381966e-05,1.0
49536,잼깄했눈뎅/Noun,1,1,0,1.1115310228308472e-05,0.0,1.0
49537,박지/Noun,1,1,0,1.1115310228308472e-05,0.0,1.0
49538,회란/Noun,1,1,0,1.1115310228308472e-05,0.0,1.0
49539,열왕기하/Noun,1,0,1,0.0,1.1106915165381966e-05,1.0
49540,초졸/Noun,1,0,1,0.0,1.1106915165381966e-05,1.0
49541,성지인/Noun,1,0,1,0.0,1.1106915165381966e-05,1.0
49542,알바몬/Noun,1,0,1,0.0,1.1106915165381966e-05,1.0
49543,친년/Noun,1,0,1,0.0,1.1106915165381966e-05,1.0
49544,ME/Alpha,1,0,1,0.0,1.1106915165381966e-05,1.0
49545,비신/Noun,1,0,1,0.0,1.1106915165381966e-05,1.0
49546,Body/Alpha,1,0,1,0.0,1.1106915165381966e-05,1.0
49547,훔뻑/Noun,1,1,0,1.1115310228308472e-05,0.0,1.0
49548,~^!!./Punctuation,1,1,0,1.1115310228308472e-05,0.0,1.0
49549,깨닭음/Noun,1,1,0,1.1115310228308472e-05,0.0,1.0
49550,툰/Noun,1,1,0,1.1115310228308472e-05,0.0,1.0
49551,기후/Noun,1,0,1,0.0,1.1106915165381966e-05,1.0
49552,父子/Foreign,1,0,1,0.0,1.1106915165381966e-05,1.0
49553,에바칭/Foreign,1,0,1,0.0,1.1106915165381966e-05,1.0
49554,뀨루뀨/Noun,1,0,1,0.0,1.1106915165381966e-05,1.0
49555,옼옹콩/Noun,1,0,1,0.0,1.1106915165381966e-05,1.0
49556,콯/Noun,1,0,1,0.0,1.1106915165381966e-05,1.0
49557,천생/Noun,1,1,0,1.1115310228308472e-05,0.0,1.0
49558,P.A.Works/URL,1,1,0,1.1115310228308472e-05,0.0,1.0
49559,숙려/Noun,1,1,0,1.1115310228308472e-05,0.0,1.0
49560,유친/Noun,1,0,1,0.0,1.1106915165381966e-05,1.0
49561,접점/Noun,1,1,0,1.1115310228308472e-05,0.0,1.0
49562,Btv/Alpha,1,1,0,1.1115310228308472e-05,0.0,1.0
49563,백서/Noun,1,0,1,0.0,1.1106915165381966e-05,1.0
49564,검뮈/Noun,1,0,1,0.0,1.1106915165381966e-05,1.0
49565,뭥뮈/Noun,1,0,1,0.0,1.1106915165381966e-05,1.0
49566,자초지종/Noun,1,1,0,1.1115310228308472e-05,0.0,1.0
49567,묶이게/Noun,1,1,0,1.1115310228308472e-05,0.0,1.0
49568,55년/Number,1,1,0,1.1115310228308472e-05,0.0,1.0
49569,베키/Noun,1,0,1,0.0,1.1106915165381966e-05,1.0
49570,cnn/Alpha,1,1,0,1.1115310228308472e-05,0.0,1.0
49571,꼭잼/Noun,1,1,0,1.1115310228308472e-05,0.0,1.0
49572,무비타임/Noun,1,1,0,1.1115310228308472e-05,0.0,1.0
49573,애답/Noun,1,0,1,0.0,1.1106915165381966e-05,1.0
49574,~~.~/Punctuation,1,1,0,1.1115310228308472e-05,0.0,1.0
49575,안볼렵니/Noun,1,0,1,0.0,1.1106915165381966e-05,1.0
49576,붕법/Noun,1,0,1,0.0,1.1106915165381966e-05,1.0
49577,이백만원/Noun,1,0,1,0.0,1.1106915165381966e-05,1.0
49578,정비/Noun,1,0,1,0.0,1.1106915165381966e-05,1.0
49579,키쿠치/Noun,1,0,1,0.0,1.1106915165381966e-05,1.0
49580,발털/Noun,1,0,1,0.0,1.1106915165381966e-05,1.0
49581,정도부터/Foreign,1,0,1,0.0,1.1106915165381966e-05,1.0
49582,껄끄럽네/Noun,1,0,1,0.0,1.1106915165381966e-05,1.0
49583,",,,./Punctuation",1,1,0,1.1115310228308472e-05,0.0,1.0
49584,패틴슨표/Noun,1,0,1,0.0,1.1106915165381966e-05,1.0
49585,맨틀/Noun,1,1,0,1.1115310228308472e-05,0.0,1.0
49586,케이시/Noun,1,1,0,1.1115310228308472e-05,0.0,1.0
49587,몰이해하다/Adjective,1,1,0,1.1115310228308472e-05,0.0,1.0
49588,minority/Alpha,1,1,0,1.1115310228308472e-05,0.0,1.0
49589,majority/Alpha,1,1,0,1.1115310228308472e-05,0.0,1.0
49590,라킨/Noun,1,0,1,0.0,1.1106915165381966e-05,1.0
49591,시간제/Noun,1,0,1,0.0,1.1106915165381966e-05,1.0
49592,점자/Noun,1,0,1,0.0,1.1106915165381966e-05,1.0
49593,자랑스레/Adverb,1,1,0,1.1115310228308472e-05,0.0,1.0
49594,로커/Noun,1,1,0,1.1115310228308472e-05,0.0,1.0
49595,씬정도/Noun,1,0,1,0.0,1.1106915165381966e-05,1.0
49596,킁킁킁/Noun,1,1,0,1.1115310228308472e-05,0.0,1.0
49597,랜/Noun,1,1,0,1.1115310228308472e-05,0.0,1.0
49598,솔루션/Noun,1,1,0,1.1115310228308472e-05,0.0,1.0
49599,헀던/Noun,1,1,0,1.1115310228308472e-05,0.0,1.0
49600,헐륫/Noun,1,0,1,0.0,1.1106915165381966e-05,1.0
49601,포니테일/Noun,1,1,0,1.1115310228308472e-05,0.0,1.0
49602,나혼/Noun,1,1,0,1.1115310228308472e-05,0.0,1.0
49603,크리퍼/Noun,1,0,1,0.0,1.1106915165381966e-05,1.0
49604,하네스/Noun,1,1,0,1.1115310228308472e-05,0.0,1.0
49605,마중가/Noun,1,1,0,1.1115310228308472e-05,0.0,1.0
49606,떽땍거리/Noun,1,1,0,1.1115310228308472e-05,0.0,1.0
49607,코알라키드/Noun,1,1,0,1.1115310228308472e-05,0.0,1.0
49608,옷빨/Noun,1,0,1,0.0,1.1106915165381966e-05,1.0
49609,멀어졋던/Noun,1,1,0,1.1115310228308472e-05,0.0,1.0
49610,pretty/Alpha,1,1,0,1.1115310228308472e-05,0.0,1.0
49611,멘카인드/Noun,1,0,1,0.0,1.1106915165381966e-05,1.0
49612,귀화/Noun,1,0,1,0.0,1.1106915165381966e-05,1.0
49613,cheo/Alpha,1,0,1,0.0,1.1106915165381966e-05,1.0
49614,bbak/Alpha,1,0,1,0.0,1.1106915165381966e-05,1.0
49615,트뤼포/Noun,1,0,1,0.0,1.1106915165381966e-05,1.0
49616,자위행위/Noun,1,0,1,0.0,1.1106915165381966e-05,1.0
49617,재심/Noun,1,0,1,0.0,1.1106915165381966e-05,1.0
49618,여창/Noun,1,0,1,0.0,1.1106915165381966e-05,1.0
49619,?^^;;/Punctuation,1,0,1,0.0,1.1106915165381966e-05,1.0
49620,라이너스/Noun,1,0,1,0.0,1.1106915165381966e-05,1.0
49621,달자/Noun,1,0,1,0.0,1.1106915165381966e-05,1.0
49622,외봉/Noun,1,0,1,0.0,1.1106915165381966e-05,1.0
49623,옮았다/Noun,1,1,0,1.1115310228308472e-05,0.0,1.0
49624,마이크로/Noun,1,0,1,0.0,1.1106915165381966e-05,1.0
49625,5~10년/Number,1,1,0,1.1115310228308472e-05,0.0,1.0
49626,!!!!///Punctuation,1,1,0,1.1115310228308472e-05,0.0,1.0
49627,낼떄/Noun,1,1,0,1.1115310228308472e-05,0.0,1.0
49628,낚였눼/Noun,1,0,1,0.0,1.1106915165381966e-05,1.0
49629,맘데/Noun,1,0,1,0.0,1.1106915165381966e-05,1.0
49630,ghghjj/Alpha,1,0,1,0.0,1.1106915165381966e-05,1.0
49631,샤일록/Noun,1,1,0,1.1115310228308472e-05,0.0,1.0
49632,쭈욱쭉/Noun,1,1,0,1.1115310228308472e-05,0.0,1.0
49633,tvN/Alpha,1,0,1,0.0,1.1106915165381966e-05,1.0
49634,상각/Noun,1,1,0,1.1115310228308472e-05,0.0,1.0
49635,함안/Noun,1,0,1,0.0,1.1106915165381966e-05,1.0
49636,킹더/Noun,1,0,1,0.0,1.1106915165381966e-05,1.0
49637,꿈뻑임/Noun,1,0,1,0.0,1.1106915165381966e-05,1.0
49638,오케/Noun,1,1,0,1.1115310228308472e-05,0.0,1.0
49639,aimer/Alpha,1,1,0,1.1115310228308472e-05,0.0,1.0
49640,Sauras/Alpha,1,1,0,1.1115310228308472e-05,0.0,1.0
49641,옥쇄/Noun,1,0,1,0.0,1.1106915165381966e-05,1.0
49642,라텍스/Noun,1,0,1,0.0,1.1106915165381966e-05,1.0
49643,베킨세일/Noun,1,1,0,1.1115310228308472e-05,0.0,1.0
49644,흐흣/Noun,1,1,0,1.1115310228308472e-05,0.0,1.0
49645,좋댜/Noun,1,1,0,1.1115310228308472e-05,0.0,1.0
49646,최재하/Noun,1,0,1,0.0,1.1106915165381966e-05,1.0
49647,리미트리스/Noun,1,1,0,1.1115310228308472e-05,0.0,1.0
49648,성/Foreign,1,0,1,0.0,1.1106915165381966e-05,1.0
49649,처름/Noun,1,1,0,1.1115310228308472e-05,0.0,1.0
49650,널렸는데/Noun,1,0,1,0.0,1.1106915165381966e-05,1.0
49651,게안코/Noun,1,1,0,1.1115310228308472e-05,0.0,1.0
49652,같이도/Josa,1,0,1,0.0,1.1106915165381966e-05,1.0
49653,졑/Noun,1,0,1,0.0,1.1106915165381966e-05,1.0
49654,6.20/Number,1,1,0,1.1115310228308472e-05,0.0,1.0
49655,과녁/Noun,1,0,1,0.0,1.1106915165381966e-05,1.0
49656,잘봣당/Noun,1,1,0,1.1115310228308472e-05,0.0,1.0
49657,sx/Alpha,1,0,1,0.0,1.1106915165381966e-05,1.0
49658,거누/Noun,1,0,1,0.0,1.1106915165381966e-05,1.0
49659,케시베이츠/Noun,1,1,0,1.1115310228308472e-05,0.0,1.0
49660,놀래기/Noun,1,1,0,1.1115310228308472e-05,0.0,1.0
49661,버서커/Noun,1,0,1,0.0,1.1106915165381966e-05,1.0
49662,찰싹/Noun,1,1,0,1.1115310228308472e-05,0.0,1.0
49663,후각/Noun,1,1,0,1.1115310228308472e-05,0.0,1.0
49664,뭉뚝/Noun,1,0,1,0.0,1.1106915165381966e-05,1.0
49665,성층권/Noun,1,1,0,1.1115310228308472e-05,0.0,1.0
49666,수감/Noun,1,0,1,0.0,1.1106915165381966e-05,1.0
49667,우발/Noun,1,0,1,0.0,1.1106915165381966e-05,1.0
49668,*^_^*/Punctuation,1,1,0,1.1115310228308472e-05,0.0,1.0
49669,달밤/Noun,1,0,1,0.0,1.1106915165381966e-05,1.0
49670,비무장지대/Noun,1,0,1,0.0,1.1106915165381966e-05,1.0
49671,잘못됫/Noun,1,0,1,0.0,1.1106915165381966e-05,1.0
49672,아꼇기/Noun,1,1,0,1.1115310228308472e-05,0.0,1.0
49673,"50,500/Number",1,1,0,1.1115310228308472e-05,0.0,1.0
49674,대합실/Noun,1,1,0,1.1115310228308472e-05,0.0,1.0
49675,덩크슛/Noun,1,1,0,1.1115310228308472e-05,0.0,1.0
49676,애수/Noun,1,1,0,1.1115310228308472e-05,0.0,1.0
49677,트렌치코트/Noun,1,1,0,1.1115310228308472e-05,0.0,1.0
49678,형죽/Noun,1,0,1,0.0,1.1106915165381966e-05,1.0
49679,!->/Punctuation,1,0,1,0.0,1.1106915165381966e-05,1.0
49680,잼밌어/Noun,1,1,0,1.1115310228308472e-05,0.0,1.0
49681,이거잼슴/Noun,1,0,1,0.0,1.1106915165381966e-05,1.0
49682,맞죵/Noun,1,1,0,1.1115310228308472e-05,0.0,1.0
49683,설리반/Noun,1,1,0,1.1115310228308472e-05,0.0,1.0
49684,디느로같/Noun,1,0,1,0.0,1.1106915165381966e-05,1.0
49685,여후/Noun,1,0,1,0.0,1.1106915165381966e-05,1.0
49686,석별/Noun,1,1,0,1.1115310228308472e-05,0.0,1.0
49687,리미트/Noun,1,1,0,1.1115310228308472e-05,0.0,1.0
49688,근근히/Noun,1,0,1,0.0,1.1106915165381966e-05,1.0
49689,루마/Noun,1,1,0,1.1115310228308472e-05,0.0,1.0
49690,칭얼되/Noun,1,0,1,0.0,1.1106915165381966e-05,1.0
49691,폇던/Noun,1,0,1,0.0,1.1106915165381966e-05,1.0
49692,무급/Noun,1,0,1,0.0,1.1106915165381966e-05,1.0
49693,룽다/Noun,1,0,1,0.0,1.1106915165381966e-05,1.0
49694,농아인/Noun,1,1,0,1.1115310228308472e-05,0.0,1.0
49695,",,;;;/Punctuation",1,0,1,0.0,1.1106915165381966e-05,1.0
49696,김감/Noun,1,1,0,1.1115310228308472e-05,0.0,1.0
49697,휙귀/Noun,1,1,0,1.1115310228308472e-05,0.0,1.0
49698,휘휘/Adverb,1,1,0,1.1115310228308472e-05,0.0,1.0
49699,거랠/Noun,1,0,1,0.0,1.1106915165381966e-05,1.0
49700,라잌/Noun,1,1,0,1.1115310228308472e-05,0.0,1.0
49701,황소개구리/Noun,1,0,1,0.0,1.1106915165381966e-05,1.0
49702,블루길/Noun,1,0,1,0.0,1.1106915165381966e-05,1.0
49703,뉴트리아/Noun,1,0,1,0.0,1.1106915165381966e-05,1.0
49704,토착화/Noun,1,0,1,0.0,1.1106915165381966e-05,1.0
49705,장기하/Noun,1,0,1,0.0,1.1106915165381966e-05,1.0
49706,꼽는작품/Noun,1,1,0,1.1115310228308472e-05,0.0,1.0
49707,나역쉬/Noun,1,1,0,1.1115310228308472e-05,0.0,1.0
49708,db/Alpha,1,1,0,1.1115310228308472e-05,0.0,1.0
49709,버셜/Noun,1,0,1,0.0,1.1106915165381966e-05,1.0
49710,bjy/Alpha,1,0,1,0.0,1.1106915165381966e-05,1.0
49711,특이점/Noun,1,0,1,0.0,1.1106915165381966e-05,1.0
49712,오구/Noun,1,0,1,0.0,1.1106915165381966e-05,1.0
49713,리샤드/Noun,1,0,1,0.0,1.1106915165381966e-05,1.0
49714,샤를로트/Noun,1,0,1,0.0,1.1106915165381966e-05,1.0
49715,왜년/Noun,1,0,1,0.0,1.1106915165381966e-05,1.0
49716,.:(/Punctuation,1,0,1,0.0,1.1106915165381966e-05,1.0
49717,총쏘는씬/Noun,1,0,1,0.0,1.1106915165381966e-05,1.0
49718,씹밸붕/Noun,1,0,1,0.0,1.1106915165381966e-05,1.0
49719,소자본/Noun,1,0,1,0.0,1.1106915165381966e-05,1.0
49720,위험부담/Noun,1,0,1,0.0,1.1106915165381966e-05,1.0
49721,byebye/Alpha,1,0,1,0.0,1.1106915165381966e-05,1.0
49722,Read/Alpha,1,0,1,0.0,1.1106915165381966e-05,1.0
49723,방비/Noun,1,1,0,1.1115310228308472e-05,0.0,1.0
49724,보니/Foreign,1,1,0,1.1115310228308472e-05,0.0,1.0
49725,에있어/Foreign,1,0,1,0.0,1.1106915165381966e-05,1.0
49726,카포/Noun,1,0,1,0.0,1.1106915165381966e-05,1.0
49727,헤이난코텍/Noun,1,0,1,0.0,1.1106915165381966e-05,1.0
49728,딸뇬/Noun,1,0,1,0.0,1.1106915165381966e-05,1.0
49729,노쇠/Noun,1,0,1,0.0,1.1106915165381966e-05,1.0
49730,무뎌져가/Noun,1,0,1,0.0,1.1106915165381966e-05,1.0
49731,재밓당/Noun,1,1,0,1.1115310228308472e-05,0.0,1.0
49732,까지보다접었다/Foreign,1,0,1,0.0,1.1106915165381966e-05,1.0
49733,스리랑카/Noun,1,0,1,0.0,1.1106915165381966e-05,1.0
49734,훌룽/Noun,1,1,0,1.1115310228308472e-05,0.0,1.0
49735,박희진/Noun,1,0,1,0.0,1.1106915165381966e-05,1.0
49736,스터/Noun,1,0,1,0.0,1.1106915165381966e-05,1.0
49737,것과/Noun,1,1,0,1.1115310228308472e-05,0.0,1.0
49738,블루베리/Noun,1,0,1,0.0,1.1106915165381966e-05,1.0
49739,맨친/Noun,1,0,1,0.0,1.1106915165381966e-05,1.0
49740,장주/Noun,1,0,1,0.0,1.1106915165381966e-05,1.0
49741,떙중/Noun,1,0,1,0.0,1.1106915165381966e-05,1.0
49742,구진/Noun,1,0,1,0.0,1.1106915165381966e-05,1.0
49743,삭시/Noun,1,0,1,0.0,1.1106915165381966e-05,1.0
49744,같다/Foreign,1,1,0,1.1115310228308472e-05,0.0,1.0
49745,나오는/Foreign,1,1,0,1.1115310228308472e-05,0.0,1.0
49746,논현/Noun,1,1,0,1.1115310228308472e-05,0.0,1.0
49747,매초/Adverb,1,1,0,1.1115310228308472e-05,0.0,1.0
49748,개꾸르/Noun,1,1,0,1.1115310228308472e-05,0.0,1.0
49749,잉크/Noun,1,1,0,1.1115310228308472e-05,0.0,1.0
49750,아닝/Noun,1,0,1,0.0,1.1106915165381966e-05,1.0
49751,1972년/Number,1,1,0,1.1115310228308472e-05,0.0,1.0
49752,이납/Noun,1,0,1,0.0,1.1106915165381966e-05,1.0
49753,내몬/Noun,1,1,0,1.1115310228308472e-05,0.0,1.0
49754,조르쥬/Noun,1,1,0,1.1115310228308472e-05,0.0,1.0
49755,파트너쉽/Noun,1,1,0,1.1115310228308472e-05,0.0,1.0
49756,!!!!../Punctuation,1,1,0,1.1115310228308472e-05,0.0,1.0
49757,전예/Noun,1,1,0,1.1115310228308472e-05,0.0,1.0
49758,올드카팬/Noun,1,1,0,1.1115310228308472e-05,0.0,1.0
49759,카브리올레/Noun,1,1,0,1.1115310228308472e-05,0.0,1.0
49760,알파로메오/Noun,1,1,0,1.1115310228308472e-05,0.0,1.0
49761,cp/Alpha,1,1,0,1.1115310228308472e-05,0.0,1.0
49762,경해/Noun,1,0,1,0.0,1.1106915165381966e-05,1.0
49763,태평하다/Adjective,1,0,1,0.0,1.1106915165381966e-05,1.0
49764,어쩡/Noun,1,0,1,0.0,1.1106915165381966e-05,1.0
49765,..?./Punctuation,1,0,1,0.0,1.1106915165381966e-05,1.0
49766,헬레나/Noun,1,1,0,1.1115310228308472e-05,0.0,1.0
49767,graphic/Alpha,1,0,1,0.0,1.1106915165381966e-05,1.0
49768,computer/Alpha,1,0,1,0.0,1.1106915165381966e-05,1.0
49769,도영화냐/Foreign,1,0,1,0.0,1.1106915165381966e-05,1.0
49770,가라엎/Noun,1,0,1,0.0,1.1106915165381966e-05,1.0
49771,햅니/Noun,1,1,0,1.1115310228308472e-05,0.0,1.0
49772,릴린/Noun,1,1,0,1.1115310228308472e-05,0.0,1.0
49773,얼띠기/Noun,1,0,1,0.0,1.1106915165381966e-05,1.0
49774,satc/Alpha,1,0,1,0.0,1.1106915165381966e-05,1.0
49775,슈발슈발/Noun,1,0,1,0.0,1.1106915165381966e-05,1.0
49776,조용기/Noun,1,1,0,1.1115310228308472e-05,0.0,1.0
49777,세한/Noun,1,0,1,0.0,1.1106915165381966e-05,1.0
49778,!!!!!!!!!!!!!!!!!!!!!!!!!!!!!/Punctuation,1,0,1,0.0,1.1106915165381966e-05,1.0
49779,들고파다/Verb,1,1,0,1.1115310228308472e-05,0.0,1.0
49780,투캅/Noun,1,1,0,1.1115310228308472e-05,0.0,1.0
49781,포차/Noun,1,0,1,0.0,1.1106915165381966e-05,1.0
49782,드읃/Noun,1,0,1,0.0,1.1106915165381966e-05,1.0
49783,2014.4/Number,1,0,1,0.0,1.1106915165381966e-05,1.0
49784,괜찬앗/Noun,1,0,1,0.0,1.1106915165381966e-05,1.0
49785,않을런/Noun,1,0,1,0.0,1.1106915165381966e-05,1.0
49786,봣는디/Noun,1,1,0,1.1115310228308472e-05,0.0,1.0
49787,떼씬/Noun,1,1,0,1.1115310228308472e-05,0.0,1.0
49788,봉쿠레/Noun,1,1,0,1.1115310228308472e-05,0.0,1.0
49789,박은영/Noun,1,0,1,0.0,1.1106915165381966e-05,1.0
49790,gross/Alpha,1,0,1,0.0,1.1106915165381966e-05,1.0
49791,최세윤/Noun,1,0,1,0.0,1.1106915165381966e-05,1.0
49792,예뼜/Noun,1,0,1,0.0,1.1106915165381966e-05,1.0
49793,포퓰러/Noun,1,0,1,0.0,1.1106915165381966e-05,1.0
49794,노선도/Noun,1,1,0,1.1115310228308472e-05,0.0,1.0
49795,계쇠/Noun,1,0,1,0.0,1.1106915165381966e-05,1.0
49796,낰였다/Noun,1,0,1,0.0,1.1106915165381966e-05,1.0
49797,분떡/Noun,1,0,1,0.0,1.1106915165381966e-05,1.0
49798,難山/Foreign,1,0,1,0.0,1.1106915165381966e-05,1.0
49799,난산/Noun,1,0,1,0.0,1.1106915165381966e-05,1.0
49800,파자마/Noun,1,1,0,1.1115310228308472e-05,0.0,1.0
49801,줄무늬/Noun,1,1,0,1.1115310228308472e-05,0.0,1.0
49802,섿기/Noun,1,0,1,0.0,1.1106915165381966e-05,1.0
49803,억만/Modifier,1,0,1,0.0,1.1106915165381966e-05,1.0
49804,트렌스포머/Noun,1,0,1,0.0,1.1106915165381966e-05,1.0
49805,!~!!!!!!!!!!!!!!!!!!!!!!!!!/Punctuation,1,1,0,1.1115310228308472e-05,0.0,1.0
49806,교육문제/Noun,1,1,0,1.1115310228308472e-05,0.0,1.0
49807,낭청/Noun,1,1,0,1.1115310228308472e-05,0.0,1.0
49808,´/Foreign,1,0,1,0.0,1.1106915165381966e-05,1.0
49809,皿/Foreign,1,0,1,0.0,1.1106915165381966e-05,1.0
49810,月/Foreign,1,1,0,1.1115310228308472e-05,0.0,1.0
49811,임종/Noun,1,1,0,1.1115310228308472e-05,0.0,1.0
49812,띵힌/Noun,1,0,1,0.0,1.1106915165381966e-05,1.0
49813,발약/Noun,1,0,1,0.0,1.1106915165381966e-05,1.0
49814,Eleniak/Alpha,1,0,1,0.0,1.1106915165381966e-05,1.0
49815,Erika/Alpha,1,0,1,0.0,1.1106915165381966e-05,1.0
49816,분기/Noun,1,0,1,0.0,1.1106915165381966e-05,1.0
49817,호씨/Noun,1,1,0,1.1115310228308472e-05,0.0,1.0
49818,차감/Noun,1,1,0,1.1115310228308472e-05,0.0,1.0
49819,ㄴㅇㅎㄹ/KoreanParticle,1,0,1,0.0,1.1106915165381966e-05,1.0
49820,닻/Noun,1,0,1,0.0,1.1106915165381966e-05,1.0
49821,잔윌/Noun,1,1,0,1.1115310228308472e-05,0.0,1.0
49822,..........;;;/Punctuation,1,0,1,0.0,1.1106915165381966e-05,1.0
49823,니엄/Noun,1,1,0,1.1115310228308472e-05,0.0,1.0
49824,훌룡합니/Noun,1,1,0,1.1115310228308472e-05,0.0,1.0
49825,친송/Noun,1,1,0,1.1115310228308472e-05,0.0,1.0
49826,다케우치/Noun,1,0,1,0.0,1.1106915165381966e-05,1.0
49827,아리땁다/Adjective,1,0,1,0.0,1.1106915165381966e-05,1.0
49828,마다나/Noun,1,0,1,0.0,1.1106915165381966e-05,1.0
49829,助言/Foreign,1,0,1,0.0,1.1106915165381966e-05,1.0
49830,AVP/Alpha,1,0,1,0.0,1.1106915165381966e-05,1.0
49831,=../Punctuation,1,1,0,1.1115310228308472e-05,0.0,1.0
49832,모래톱/Noun,1,1,0,1.1115310228308472e-05,0.0,1.0
49833,너른/Noun,1,1,0,1.1115310228308472e-05,0.0,1.0
49834,상류/Noun,1,1,0,1.1115310228308472e-05,0.0,1.0
49835,자강/Noun,1,1,0,1.1115310228308472e-05,0.0,1.0
49836,휘트니휴스턴/Noun,1,1,0,1.1115310228308472e-05,0.0,1.0
49837,궤도/Noun,1,1,0,1.1115310228308472e-05,0.0,1.0
49838,황우석/Noun,1,1,0,1.1115310228308472e-05,0.0,1.0
49839,bottle/Alpha,1,0,1,0.0,1.1106915165381966e-05,1.0
49840,McCarthy/Alpha,1,1,0,1.1115310228308472e-05,0.0,1.0
49841,Andrew/Alpha,1,1,0,1.1115310228308472e-05,0.0,1.0
49842,걸를/Noun,1,0,1,0.0,1.1106915165381966e-05,1.0
49843,페르/Noun,1,1,0,1.1115310228308472e-05,0.0,1.0
49844,절묘/Noun,1,1,0,1.1115310228308472e-05,0.0,1.0
49845,퍼엉/Noun,1,1,0,1.1115310228308472e-05,0.0,1.0
49846,바심/Noun,1,0,1,0.0,1.1106915165381966e-05,1.0
49847,진단/Noun,1,1,0,1.1115310228308472e-05,0.0,1.0
49848,다이야/Noun,1,1,0,1.1115310228308472e-05,0.0,1.0
49849,>-/Punctuation,1,1,0,1.1115310228308472e-05,0.0,1.0
49850,합필/Noun,1,1,0,1.1115310228308472e-05,0.0,1.0
49851,내스딸/Noun,1,1,0,1.1115310228308472e-05,0.0,1.0
49852,생겻습/Noun,1,1,0,1.1115310228308472e-05,0.0,1.0
49853,느깐다/Noun,1,0,1,0.0,1.1106915165381966e-05,1.0
49854,^^^^^/Punctuation,1,1,0,1.1115310228308472e-05,0.0,1.0
49855,어염/Noun,1,1,0,1.1115310228308472e-05,0.0,1.0
49856,엄뛰엄/Noun,1,0,1,0.0,1.1106915165381966e-05,1.0
49857,뎀발/Noun,1,1,0,1.1115310228308472e-05,0.0,1.0
49858,수상실/Noun,1,1,0,1.1115310228308472e-05,0.0,1.0
49859,DUNK/Alpha,1,0,1,0.0,1.1106915165381966e-05,1.0
49860,SLAM/Alpha,1,0,1,0.0,1.1106915165381966e-05,1.0
49861,help/Alpha,1,1,0,1.1115310228308472e-05,0.0,1.0
49862,개뻔/Noun,1,1,0,1.1115310228308472e-05,0.0,1.0
49863,터보팬/Noun,1,1,0,1.1115310228308472e-05,0.0,1.0
49864,쁘니/Noun,1,1,0,1.1115310228308472e-05,0.0,1.0
49865,킬머형/Noun,1,0,1,0.0,1.1106915165381966e-05,1.0
49866,140322/Number,1,0,1,0.0,1.1106915165381966e-05,1.0
49867,무섭드/Noun,1,1,0,1.1115310228308472e-05,0.0,1.0
49868,호적/Noun,1,0,1,0.0,1.1106915165381966e-05,1.0
49869,looser/Alpha,1,1,0,1.1115310228308472e-05,0.0,1.0
49870,오발/Noun,1,1,0,1.1115310228308472e-05,0.0,1.0
49871,승소/Noun,1,0,1,0.0,1.1106915165381966e-05,1.0
49872,훔처/Noun,1,0,1,0.0,1.1106915165381966e-05,1.0
49873,범준/Noun,1,1,0,1.1115310228308472e-05,0.0,1.0
49874,좀/Foreign,1,0,1,0.0,1.1106915165381966e-05,1.0
49875,북베트남/Noun,1,1,0,1.1115310228308472e-05,0.0,1.0
49876,때볼땐/Noun,1,0,1,0.0,1.1106915165381966e-05,1.0
49877,유진위/Noun,1,1,0,1.1115310228308472e-05,0.0,1.0
49878,Elliott/Alpha,1,1,0,1.1115310228308472e-05,0.0,1.0
49879,Nevins/Alpha,1,1,0,1.1115310228308472e-05,0.0,1.0
49880,Gabe/Alpha,1,1,0,1.1115310228308472e-05,0.0,1.0
49881,무슈/Noun,1,1,0,1.1115310228308472e-05,0.0,1.0
49882,400만달러/Number,1,1,0,1.1115310228308472e-05,0.0,1.0
49883,라이온하트/Noun,1,1,0,1.1115310228308472e-05,0.0,1.0
49884,데드맨워킹/Noun,1,0,1,0.0,1.1106915165381966e-05,1.0
49885,장민철/Noun,1,0,1,0.0,1.1106915165381966e-05,1.0
49886,십억/Noun,1,0,1,0.0,1.1106915165381966e-05,1.0
49887,드림윅스/Noun,1,1,0,1.1115310228308472e-05,0.0,1.0
49888,연출괜찬/Noun,1,1,0,1.1115310228308472e-05,0.0,1.0
49889,칠리/Noun,1,1,0,1.1115310228308472e-05,0.0,1.0
49890,조건반사/Noun,1,1,0,1.1115310228308472e-05,0.0,1.0
49891,3~5/Number,1,1,0,1.1115310228308472e-05,0.0,1.0
49892,····/Punctuation,1,1,0,1.1115310228308472e-05,0.0,1.0
49893,헤헿/Exclamation,1,0,1,0.0,1.1106915165381966e-05,1.0
49894,헤헤/Exclamation,1,0,1,0.0,1.1106915165381966e-05,1.0
49895,피/Exclamation,1,0,1,0.0,1.1106915165381966e-05,1.0
49896,mystery/Alpha,1,1,0,1.1115310228308472e-05,0.0,1.0
49897,정수라/Noun,1,0,1,0.0,1.1106915165381966e-05,1.0
49898,드갈때/Noun,1,0,1,0.0,1.1106915165381966e-05,1.0
49899,고소장/Noun,1,0,1,0.0,1.1106915165381966e-05,1.0
49900,goooooooooooooood/Alpha,1,1,0,1.1115310228308472e-05,0.0,1.0
49901,개떡칠/Noun,1,0,1,0.0,1.1106915165381966e-05,1.0
49902,힐수/Noun,1,1,0,1.1115310228308472e-05,0.0,1.0
49903,dig/Alpha,1,0,1,0.0,1.1106915165381966e-05,1.0
49904,쩝/Noun,1,0,1,0.0,1.1106915165381966e-05,1.0
49905,없으므니/Noun,1,0,1,0.0,1.1106915165381966e-05,1.0
49906,찾아왓으/Noun,1,1,0,1.1115310228308472e-05,0.0,1.0
49907,너무짦다/Noun,1,1,0,1.1115310228308472e-05,0.0,1.0
49908,결식/Noun,1,0,1,0.0,1.1106915165381966e-05,1.0
49909,NLL/Alpha,1,0,1,0.0,1.1106915165381966e-05,1.0
49910,순국선열/Noun,1,0,1,0.0,1.1106915165381966e-05,1.0
49911,못떳는/Noun,1,1,0,1.1115310228308472e-05,0.0,1.0
49912,이래/Foreign,1,1,0,1.1115310228308472e-05,0.0,1.0
49913,7000천원/Number,1,1,0,1.1115310228308472e-05,0.0,1.0
49914,6162/Number,1,1,0,1.1115310228308472e-05,0.0,1.0
49915,paik/Alpha,1,1,0,1.1115310228308472e-05,0.0,1.0
49916,지아비/Noun,1,0,1,0.0,1.1106915165381966e-05,1.0
49917,속정/Noun,1,0,1,0.0,1.1106915165381966e-05,1.0
49918,실과/Noun,1,1,0,1.1115310228308472e-05,0.0,1.0
49919,훨났딘/Noun,1,0,1,0.0,1.1106915165381966e-05,1.0
49920,성형쭈쭈/Noun,1,0,1,0.0,1.1106915165381966e-05,1.0
49921,크로아티아/Noun,1,1,0,1.1115310228308472e-05,0.0,1.0
49922,틸타스윈튼/Noun,1,1,0,1.1115310228308472e-05,0.0,1.0
49923,YOOOOOOOOOOOOOOOOOOOOOOOOOOO/Alpha,1,1,0,1.1115310228308472e-05,0.0,1.0
49924,한주완/Noun,1,1,0,1.1115310228308472e-05,0.0,1.0
49925,cooooooooooooooooooool/Alpha,1,1,0,1.1115310228308472e-05,0.0,1.0
49926,sooooooooooooooooooooooo/Alpha,1,1,0,1.1115310228308472e-05,0.0,1.0
49927,들겟다/Foreign,1,0,1,0.0,1.1106915165381966e-05,1.0
49928,침샘/Noun,1,1,0,1.1115310228308472e-05,0.0,1.0
49929,바베큐/Noun,1,1,0,1.1115310228308472e-05,0.0,1.0
49930,펩시/Noun,1,1,0,1.1115310228308472e-05,0.0,1.0
49931,멈출수없어/Noun,1,1,0,1.1115310228308472e-05,0.0,1.0
49932,사츠키/Noun,1,1,0,1.1115310228308472e-05,0.0,1.0
49933,길롯/Noun,1,1,0,1.1115310228308472e-05,0.0,1.0
49934,뒌장/Noun,1,0,1,0.0,1.1106915165381966e-05,1.0
49935,zoom/Alpha,1,0,1,0.0,1.1106915165381966e-05,1.0
49936,경희대/Noun,1,0,1,0.0,1.1106915165381966e-05,1.0
49937,ㅡㅢ/KoreanParticle,1,0,1,0.0,1.1106915165381966e-05,1.0
49938,너무욱겨/Noun,1,1,0,1.1115310228308472e-05,0.0,1.0
49939,세컨드/Noun,1,0,1,0.0,1.1106915165381966e-05,1.0
49940,남이면/Noun,1,0,1,0.0,1.1106915165381966e-05,1.0
49941,paranoia/Alpha,1,0,1,0.0,1.1106915165381966e-05,1.0
49942,명개/Noun,1,0,1,0.0,1.1106915165381966e-05,1.0
49943,931/Number,1,0,1,0.0,1.1106915165381966e-05,1.0
49944,아랑곳/Noun,1,1,0,1.1115310228308472e-05,0.0,1.0
49945,공순/Noun,1,0,1,0.0,1.1106915165381966e-05,1.0
49946,-__-;;/Punctuation,1,0,1,0.0,1.1106915165381966e-05,1.0
49947,burning/Alpha,1,1,0,1.1115310228308472e-05,0.0,1.0
49948,control/Alpha,1,1,0,1.1115310228308472e-05,0.0,1.0
49949,ニング/Foreign,1,1,0,1.1115310228308472e-05,0.0,1.0
49950,バ/Foreign,1,1,0,1.1115310228308472e-05,0.0,1.0
49951,ル/Foreign,1,1,0,1.1115310228308472e-05,0.0,1.0
49952,コントロ/Foreign,1,1,0,1.1115310228308472e-05,0.0,1.0
49953,352-1/Number,1,1,0,1.1115310228308472e-05,0.0,1.0
49954,Ⅰⅱⅲ/Foreign,1,1,0,1.1115310228308472e-05,0.0,1.0
49955,자누스/Noun,1,1,0,1.1115310228308472e-05,0.0,1.0
49956,롄/Noun,1,0,1,0.0,1.1106915165381966e-05,1.0
49957,이차/Noun,1,0,1,0.0,1.1106915165381966e-05,1.0
49958,거룡/Noun,1,1,0,1.1115310228308472e-05,0.0,1.0
49959,~..../Punctuation,1,0,1,0.0,1.1106915165381966e-05,1.0
49960,삼천리/Noun,1,0,1,0.0,1.1106915165381966e-05,1.0
49961,애벌레/Noun,1,0,1,0.0,1.1106915165381966e-05,1.0
49962,애정도/Noun,1,0,1,0.0,1.1106915165381966e-05,1.0
49963,훨더/Noun,1,0,1,0.0,1.1106915165381966e-05,1.0
49964,부풀리기/Noun,1,0,1,0.0,1.1106915165381966e-05,1.0
49965,평균점/Noun,1,0,1,0.0,1.1106915165381966e-05,1.0
49966,차는/Foreign,1,0,1,0.0,1.1106915165381966e-05,1.0
49967,park/Alpha,1,1,0,1.1115310228308472e-05,0.0,1.0
49968,호블호/Noun,1,0,1,0.0,1.1106915165381966e-05,1.0
49969,통태/Noun,1,0,1,0.0,1.1106915165381966e-05,1.0
49970,남인/Noun,1,0,1,0.0,1.1106915165381966e-05,1.0
49971,광고인/Noun,1,0,1,0.0,1.1106915165381966e-05,1.0
49972,!!!!)!!/Punctuation,1,1,0,1.1115310228308472e-05,0.0,1.0
49973,베를레느/Noun,1,0,1,0.0,1.1106915165381966e-05,1.0
49974,코숏/Noun,1,0,1,0.0,1.1106915165381966e-05,1.0
49975,초명/Noun,1,0,1,0.0,1.1106915165381966e-05,1.0
49976,이온/Noun,1,0,1,0.0,1.1106915165381966e-05,1.0
49977,.==========/Punctuation,1,0,1,0.0,1.1106915165381966e-05,1.0
49978,=========[/Punctuation,1,0,1,0.0,1.1106915165381966e-05,1.0
49979,야리루/Noun,1,1,0,1.1115310228308472e-05,0.0,1.0
49980,무까딜/Noun,1,1,0,1.1115310228308472e-05,0.0,1.0
49981,빠빠킥/Noun,1,1,0,1.1115310228308472e-05,0.0,1.0
49982,알걸/Noun,1,1,0,1.1115310228308472e-05,0.0,1.0
49983,~(^/Punctuation,1,1,0,1.1115310228308472e-05,0.0,1.0
49984,체형/Noun,1,0,1,0.0,1.1106915165381966e-05,1.0
49985,고두림/Noun,1,0,1,0.0,1.1106915165381966e-05,1.0
49986,수퍼주니어/Noun,1,0,1,0.0,1.1106915165381966e-05,1.0
49987,...!!)/Punctuation,1,1,0,1.1115310228308472e-05,0.0,1.0
49988,차범근/Noun,1,0,1,0.0,1.1106915165381966e-05,1.0
49989,주/Foreign,1,0,1,0.0,1.1106915165381966e-05,1.0
49990,명료/Noun,1,1,0,1.1115310228308472e-05,0.0,1.0
49991,도꺼를/Foreign,1,1,0,1.1115310228308472e-05,0.0,1.0
49992,씨댕부럴놈들/Noun,1,0,1,0.0,1.1106915165381966e-05,1.0
49993,망간/Noun,1,1,0,1.1115310228308472e-05,0.0,1.0
49994,따님/Noun,1,0,1,0.0,1.1106915165381966e-05,1.0
49995,팔십만원/Noun,1,0,1,0.0,1.1106915165381966e-05,1.0
49996,일백만원/Noun,1,0,1,0.0,1.1106915165381966e-05,1.0
49997,보일러/Noun,1,0,1,0.0,1.1106915165381966e-05,1.0
49998,감정인/Noun,1,0,1,0.0,1.1106915165381966e-05,1.0
49999,얀해/Noun,1,1,0,1.1115310228308472e-05,0.0,1.0
50000,기동전/Noun,1,0,1,0.0,1.1106915165381966e-05,1.0
50001,★☆♡/Foreign,1,1,0,1.1115310228308472e-05,0.0,1.0
50002,영배/Noun,1,1,0,1.1115310228308472e-05,0.0,1.0
50003,장농밑/Noun,1,1,0,1.1115310228308472e-05,0.0,1.0
50004,코옹/Noun,1,0,1,0.0,1.1106915165381966e-05,1.0
50005,키안/Noun,1,0,1,0.0,1.1106915165381966e-05,1.0
50006,srt/Alpha,1,1,0,1.1115310228308472e-05,0.0,1.0
50007,첼린져/Noun,1,1,0,1.1115310228308472e-05,0.0,1.0
50008,페런트/Noun,1,1,0,1.1115310228308472e-05,0.0,1.0
50009,왜나왓는/Noun,1,0,1,0.0,1.1106915165381966e-05,1.0
50010,헬리/Noun,1,0,1,0.0,1.1106915165381966e-05,1.0
50011,너무넢다/Noun,1,0,1,0.0,1.1106915165381966e-05,1.0
50012,전례/Noun,1,0,1,0.0,1.1106915165381966e-05,1.0
50013,asfafasfafsadfsf/Alpha,1,0,1,0.0,1.1106915165381966e-05,1.0
50014,사천왕/Noun,1,0,1,0.0,1.1106915165381966e-05,1.0
50015,편등/Noun,1,0,1,0.0,1.1106915165381966e-05,1.0
50016,더알/Noun,1,0,1,0.0,1.1106915165381966e-05,1.0
50017,집좀/Noun,1,0,1,0.0,1.1106915165381966e-05,1.0
50018,민규동/Noun,1,1,0,1.1115310228308472e-05,0.0,1.0
50019,Or/Alpha,1,1,0,1.1115310228308472e-05,0.0,1.0
50020,우웩볼/Noun,1,1,0,1.1115310228308472e-05,0.0,1.0
50021,그베프/Noun,1,1,0,1.1115310228308472e-05,0.0,1.0
50022,개막식/Noun,1,0,1,0.0,1.1106915165381966e-05,1.0
50023,영화동/Noun,1,1,0,1.1115310228308472e-05,0.0,1.0
50024,cut/Alpha,1,0,1,0.0,1.1106915165381966e-05,1.0
50025,극에달/Noun,1,1,0,1.1115310228308472e-05,0.0,1.0
50026,요량/Noun,1,0,1,0.0,1.1106915165381966e-05,1.0
50027,창조론/Noun,1,0,1,0.0,1.1106915165381966e-05,1.0
50028,역함/Noun,1,0,1,0.0,1.1106915165381966e-05,1.0
50029,더스타/Noun,1,1,0,1.1115310228308472e-05,0.0,1.0
50030,카바레/Noun,1,1,0,1.1115310228308472e-05,0.0,1.0
50031,Colours/Alpha,1,1,0,1.1115310228308472e-05,0.0,1.0
50032,Bureau/Alpha,1,1,0,1.1115310228308472e-05,0.0,1.0
50033,Wave/Alpha,1,1,0,1.1115310228308472e-05,0.0,1.0
50034,Electric/Alpha,1,1,0,1.1115310228308472e-05,0.0,1.0
50035,어설푸단/Noun,1,0,1,0.0,1.1106915165381966e-05,1.0
50036,프리스타일/Noun,1,0,1,0.0,1.1106915165381966e-05,1.0
50037,그리핀/Noun,1,1,0,1.1115310228308472e-05,0.0,1.0
50038,15:1/Number,1,1,0,1.1115310228308472e-05,0.0,1.0
50039,구태여/Noun,1,0,1,0.0,1.1106915165381966e-05,1.0
50040,안봉/Noun,1,0,1,0.0,1.1106915165381966e-05,1.0
50041,쀨/Noun,1,0,1,0.0,1.1106915165381966e-05,1.0
50042,액트오브밸러/Noun,1,0,1,0.0,1.1106915165381966e-05,1.0
50043,좡/Noun,1,0,1,0.0,1.1106915165381966e-05,1.0
50044,엄포/Noun,1,1,0,1.1115310228308472e-05,0.0,1.0
50045,gghjbjbhj/Alpha,1,1,0,1.1115310228308472e-05,0.0,1.0
50046,슈반/Noun,1,1,0,1.1115310228308472e-05,0.0,1.0
50047,극형/Noun,1,0,1,0.0,1.1106915165381966e-05,1.0
50048,쥐색히/Noun,1,0,1,0.0,1.1106915165381966e-05,1.0
50049,앤딩씬/Noun,1,1,0,1.1115310228308472e-05,0.0,1.0
50050,킨말/Noun,1,1,0,1.1115310228308472e-05,0.0,1.0
50051,쳥춘들/Noun,1,1,0,1.1115310228308472e-05,0.0,1.0
50052,이변/Noun,1,1,0,1.1115310228308472e-05,0.0,1.0
50053,베버/Noun,1,0,1,0.0,1.1106915165381966e-05,1.0
50054,쑹컹/Noun,1,0,1,0.0,1.1106915165381966e-05,1.0
50055,ㅋㅋㅁ/KoreanParticle,1,1,0,1.1115310228308472e-05,0.0,1.0
50056,재밌쪼/Noun,1,1,0,1.1115310228308472e-05,0.0,1.0
50057,엔트립먼트/Noun,1,1,0,1.1115310228308472e-05,0.0,1.0
50058,서은채/Noun,1,1,0,1.1115310228308472e-05,0.0,1.0
50059,전거네/Foreign,1,0,1,0.0,1.1106915165381966e-05,1.0
50060,하인라인/Noun,1,0,1,0.0,1.1106915165381966e-05,1.0
50061,왜줌/Noun,1,0,1,0.0,1.1106915165381966e-05,1.0
50062,rec/Alpha,1,0,1,0.0,1.1106915165381966e-05,1.0
50063,괜자찮/Noun,1,1,0,1.1115310228308472e-05,0.0,1.0
50064,미대/Noun,1,1,0,1.1115310228308472e-05,0.0,1.0
50065,옥택/Noun,1,1,0,1.1115310228308472e-05,0.0,1.0
50066,엮는다/Noun,1,1,0,1.1115310228308472e-05,0.0,1.0
50067,7.73/Number,1,1,0,1.1115310228308472e-05,0.0,1.0
50068,교육부/Noun,1,0,1,0.0,1.1106915165381966e-05,1.0
50069,조슈/Noun,1,0,1,0.0,1.1106915165381966e-05,1.0
50070,영화로/Foreign,1,1,0,1.1115310228308472e-05,0.0,1.0
50071,영화가/Foreign,1,1,0,1.1115310228308472e-05,0.0,1.0
50072,46분/Number,1,1,0,1.1115310228308472e-05,0.0,1.0
50073,큐트/Noun,1,1,0,1.1115310228308472e-05,0.0,1.0
50074,다들벙쪘어/Noun,1,0,1,0.0,1.1106915165381966e-05,1.0
50075,001/Number,1,1,0,1.1115310228308472e-05,0.0,1.0
50076,우홍/Noun,1,1,0,1.1115310228308472e-05,0.0,1.0
50077,애잼/Noun,1,0,1,0.0,1.1106915165381966e-05,1.0
50078,......::/Punctuation,1,1,0,1.1115310228308472e-05,0.0,1.0
50079,뚬/Noun,1,1,0,1.1115310228308472e-05,0.0,1.0
50080,뒤때/Noun,1,0,1,0.0,1.1106915165381966e-05,1.0
50081,?............./Punctuation,1,0,1,0.0,1.1106915165381966e-05,1.0
50082,동안보고싶으면/Foreign,1,0,1,0.0,1.1106915165381966e-05,1.0
50083,윤경/Noun,1,1,0,1.1115310228308472e-05,0.0,1.0
50084,멸절/Noun,1,1,0,1.1115310228308472e-05,0.0,1.0
50085,섬득/Noun,1,1,0,1.1115310228308472e-05,0.0,1.0
50086,슬레이드/Noun,1,1,0,1.1115310228308472e-05,0.0,1.0
50087,뫼산/Noun,1,0,1,0.0,1.1106915165381966e-05,1.0
50088,봉소악/Noun,1,0,1,0.0,1.1106915165381966e-05,1.0
50089,온실효과/Noun,1,0,1,0.0,1.1106915165381966e-05,1.0
50090,문정웅/Noun,1,1,0,1.1115310228308472e-05,0.0,1.0
50091,방세옥/Noun,1,1,0,1.1115310228308472e-05,0.0,1.0
50092,//./Punctuation,1,0,1,0.0,1.1106915165381966e-05,1.0
50093,옥메/Noun,1,0,1,0.0,1.1106915165381966e-05,1.0
50094,프포/Noun,1,1,0,1.1115310228308472e-05,0.0,1.0
50095,17:1/Number,1,1,0,1.1115310228308472e-05,0.0,1.0
50096,프놈펜/Noun,1,1,0,1.1115310228308472e-05,0.0,1.0
50097,에프킬라/Noun,1,0,1,0.0,1.1106915165381966e-05,1.0
50098,잔반/Noun,1,0,1,0.0,1.1106915165381966e-05,1.0
50099,말란법/Noun,1,1,0,1.1115310228308472e-05,0.0,1.0
50100,알랭드롱/Noun,1,1,0,1.1115310228308472e-05,0.0,1.0
50101,엑시던트/Noun,1,1,0,1.1115310228308472e-05,0.0,1.0
50102,1942/Number,1,1,0,1.1115310228308472e-05,0.0,1.0
50103,무드있는/Noun,1,1,0,1.1115310228308472e-05,0.0,1.0
50104,육체파/Noun,1,1,0,1.1115310228308472e-05,0.0,1.0
50105,왕정형/Noun,1,1,0,1.1115310228308472e-05,0.0,1.0
50106,광도/Noun,1,1,0,1.1115310228308472e-05,0.0,1.0
50107,슈팅/Noun,1,1,0,1.1115310228308472e-05,0.0,1.0
50108,괴기하다/Adjective,1,0,1,0.0,1.1106915165381966e-05,1.0
50109,신인화/Noun,1,0,1,0.0,1.1106915165381966e-05,1.0
50110,care/Alpha,1,1,0,1.1115310228308472e-05,0.0,1.0
50111,어렷을쩍/Noun,1,1,0,1.1115310228308472e-05,0.0,1.0
50112,마시멜로우/Noun,1,1,0,1.1115310228308472e-05,0.0,1.0
50113,문영남/Noun,1,1,0,1.1115310228308472e-05,0.0,1.0
50114,신정환/Noun,1,1,0,1.1115310228308472e-05,0.0,1.0
50115,경천/Noun,1,0,1,0.0,1.1106915165381966e-05,1.0
50116,우락부락하다/Adjective,1,0,1,0.0,1.1106915165381966e-05,1.0
50117,노랫소리/Noun,1,1,0,1.1115310228308472e-05,0.0,1.0
50118,임겁/Noun,1,0,1,0.0,1.1106915165381966e-05,1.0
50119,검문소/Noun,1,0,1,0.0,1.1106915165381966e-05,1.0
50120,금요극장/Noun,1,1,0,1.1115310228308472e-05,0.0,1.0
50121,외국로케/Noun,1,0,1,0.0,1.1106915165381966e-05,1.0
50122,것외/Noun,1,0,1,0.0,1.1106915165381966e-05,1.0
50123,할로/Noun,1,0,1,0.0,1.1106915165381966e-05,1.0
50124,오십/Noun,1,1,0,1.1115310228308472e-05,0.0,1.0
50125,편찮다/Adjective,1,0,1,0.0,1.1106915165381966e-05,1.0
50126,MBN/Alpha,1,0,1,0.0,1.1106915165381966e-05,1.0
50127,;--/Punctuation,1,0,1,0.0,1.1106915165381966e-05,1.0
50128,채왜/Noun,1,0,1,0.0,1.1106915165381966e-05,1.0
50129,잼땋/Noun,1,1,0,1.1115310228308472e-05,0.0,1.0
50130,..--;;/Punctuation,1,0,1,0.0,1.1106915165381966e-05,1.0
50131,김동리/Noun,1,1,0,1.1115310228308472e-05,0.0,1.0
50132,몸종/Noun,1,0,1,0.0,1.1106915165381966e-05,1.0
50133,그닥그닥/Noun,1,0,1,0.0,1.1106915165381966e-05,1.0
50134,2~30분/Number,1,0,1,0.0,1.1106915165381966e-05,1.0
50135,특유하다/Adjective,1,1,0,1.1115310228308472e-05,0.0,1.0
50136,커터/Noun,1,1,0,1.1115310228308472e-05,0.0,1.0
50137,Wolces/Alpha,1,1,0,1.1115310228308472e-05,0.0,1.0
50138,딤/Noun,1,1,0,1.1115310228308472e-05,0.0,1.0
50139,잼없슈/Noun,1,0,1,0.0,1.1106915165381966e-05,1.0
50140,무한정/Noun,1,1,0,1.1115310228308472e-05,0.0,1.0
50141,학생용/Noun,1,0,1,0.0,1.1106915165381966e-05,1.0
50142,꼽을만/Noun,1,0,1,0.0,1.1106915165381966e-05,1.0
50143,끅끅대면/Noun,1,1,0,1.1115310228308472e-05,0.0,1.0
50144,핻/Noun,1,0,1,0.0,1.1106915165381966e-05,1.0
50145,선풍/Noun,1,0,1,0.0,1.1106915165381966e-05,1.0
50146,료쿄/Noun,1,1,0,1.1115310228308472e-05,0.0,1.0
50147,울었슴/Noun,1,1,0,1.1115310228308472e-05,0.0,1.0
50148,추연/Noun,1,1,0,1.1115310228308472e-05,0.0,1.0
50149,7.13/Number,1,1,0,1.1115310228308472e-05,0.0,1.0
50150,멸점/Noun,1,1,0,1.1115310228308472e-05,0.0,1.0
50151,싷/Noun,1,0,1,0.0,1.1106915165381966e-05,1.0
50152,걸왜바/Noun,1,0,1,0.0,1.1106915165381966e-05,1.0
50153,밨었는데/Noun,1,1,0,1.1115310228308472e-05,0.0,1.0
50154,오현/Noun,1,0,1,0.0,1.1106915165381966e-05,1.0
50155,법무관/Noun,1,1,0,1.1115310228308472e-05,0.0,1.0
50156,머싯댜/Noun,1,1,0,1.1115310228308472e-05,0.0,1.0
50157,Stay/Alpha,1,1,0,1.1115310228308472e-05,0.0,1.0
50158,대폭소/Noun,1,1,0,1.1115310228308472e-05,0.0,1.0
50159,제트엔진/Noun,1,1,0,1.1115310228308472e-05,0.0,1.0
50160,영기/Noun,1,1,0,1.1115310228308472e-05,0.0,1.0
50161,마황/Noun,1,1,0,1.1115310228308472e-05,0.0,1.0
50162,쭈우우우욱/Noun,1,1,0,1.1115310228308472e-05,0.0,1.0
50163,qwert/Alpha,1,0,1,0.0,1.1106915165381966e-05,1.0
50164,잭횽/Noun,1,0,1,0.0,1.1106915165381966e-05,1.0
50165,독쫑/Noun,1,0,1,0.0,1.1106915165381966e-05,1.0
50166,천상천/Noun,1,0,1,0.0,1.1106915165381966e-05,1.0
50167,그샛기/Noun,1,1,0,1.1115310228308472e-05,0.0,1.0
50168,강정호/Noun,1,1,0,1.1115310228308472e-05,0.0,1.0
50169,클럼프/Noun,1,0,1,0.0,1.1106915165381966e-05,1.0
50170,126억/Number,1,0,1,0.0,1.1106915165381966e-05,1.0
50171,-_-............/Punctuation,1,1,0,1.1115310228308472e-05,0.0,1.0
50172,.-.-;;/Punctuation,1,0,1,0.0,1.1106915165381966e-05,1.0
50173,쏠트/Noun,1,0,1,0.0,1.1106915165381966e-05,1.0
50174,영수증/Noun,1,0,1,0.0,1.1106915165381966e-05,1.0
50175,설거지/Noun,1,0,1,0.0,1.1106915165381966e-05,1.0
50176,다소간/Noun,1,1,0,1.1115310228308472e-05,0.0,1.0
50177,하하홍철/Noun,1,0,1,0.0,1.1106915165381966e-05,1.0
50178,헛도/Noun,1,0,1,0.0,1.1106915165381966e-05,1.0
50179,100000/Number,1,0,1,0.0,1.1106915165381966e-05,1.0
50180,모아이/Noun,1,1,0,1.1115310228308472e-05,0.0,1.0
50181,숀튼/Noun,1,1,0,1.1115310228308472e-05,0.0,1.0
50182,피기/Noun,1,1,0,1.1115310228308472e-05,0.0,1.0
50183,dsadasdddsad/Alpha,1,0,1,0.0,1.1106915165381966e-05,1.0
50184,Night/Alpha,1,0,1,0.0,1.1106915165381966e-05,1.0
50185,Date/Alpha,1,0,1,0.0,1.1106915165381966e-05,1.0
50186,모몽모뭄/Noun,1,1,0,1.1115310228308472e-05,0.0,1.0
50187,봉묨/Noun,1,1,0,1.1115310228308472e-05,0.0,1.0
50188,꺼졍/Noun,1,0,1,0.0,1.1106915165381966e-05,1.0
50189,연습장/Noun,1,0,1,0.0,1.1106915165381966e-05,1.0
50190,장년/Noun,1,0,1,0.0,1.1106915165381966e-05,1.0
50191,이게젧/Noun,1,0,1,0.0,1.1106915165381966e-05,1.0
50192,우비다/Verb,1,0,1,0.0,1.1106915165381966e-05,1.0
50193,덱/Noun,1,1,0,1.1115310228308472e-05,0.0,1.0
50194,루시에나/Noun,1,1,0,1.1115310228308472e-05,0.0,1.0
50195,월등/Noun,1,0,1,0.0,1.1106915165381966e-05,1.0
50196,윙스/Noun,1,0,1,0.0,1.1106915165381966e-05,1.0
50197,팀돈/Noun,1,0,1,0.0,1.1106915165381966e-05,1.0
50198,브리티니/Noun,1,0,1,0.0,1.1106915165381966e-05,1.0
50199,엎어블/Noun,1,0,1,0.0,1.1106915165381966e-05,1.0
50200,pcodream@hanmail.net/Email,1,1,0,1.1115310228308472e-05,0.0,1.0
50201,플레전트빌/Noun,1,1,0,1.1115310228308472e-05,0.0,1.0
50202,하고왔드/Noun,1,1,0,1.1115310228308472e-05,0.0,1.0
50203,다마나/Noun,1,0,1,0.0,1.1106915165381966e-05,1.0
50204,쿠레/Noun,1,0,1,0.0,1.1106915165381966e-05,1.0
50205,정기권/Noun,1,0,1,0.0,1.1106915165381966e-05,1.0
50206,붕탉/Noun,1,0,1,0.0,1.1106915165381966e-05,1.0
50207,욧의/Noun,1,0,1,0.0,1.1106915165381966e-05,1.0
50208,!!$/Punctuation,1,1,0,1.1115310228308472e-05,0.0,1.0
50209,흐믓했/Noun,1,1,0,1.1115310228308472e-05,0.0,1.0
50210,벙찜/Noun,1,0,1,0.0,1.1106915165381966e-05,1.0
50211,배렸잖/Noun,1,0,1,0.0,1.1106915165381966e-05,1.0
50212,고생대/Noun,1,1,0,1.1115310228308472e-05,0.0,1.0
50213,신생대/Noun,1,1,0,1.1115310228308472e-05,0.0,1.0
50214,중생대/Noun,1,1,0,1.1115310228308472e-05,0.0,1.0
50215,愛憎/Foreign,1,0,1,0.0,1.1106915165381966e-05,1.0
50216,"..............-,-;;;/Punctuation",1,0,1,0.0,1.1106915165381966e-05,1.0
50217,이넘길게느껴진다/Foreign,1,0,1,0.0,1.1106915165381966e-05,1.0
50218,53분/Number,1,0,1,0.0,1.1106915165381966e-05,1.0
50219,리때매/Noun,1,1,0,1.1115310228308472e-05,0.0,1.0
50220,셰어/Noun,1,1,0,1.1115310228308472e-05,0.0,1.0
50221,중제/Noun,1,0,1,0.0,1.1106915165381966e-05,1.0
50222,barefoot/Alpha,1,1,0,1.1115310228308472e-05,0.0,1.0
50223,환상여행/Noun,1,0,1,0.0,1.1106915165381966e-05,1.0
50224,무뇌생/Noun,1,0,1,0.0,1.1106915165381966e-05,1.0
50225,산듯/Noun,1,1,0,1.1115310228308472e-05,0.0,1.0
50226,퍼다/Noun,1,0,1,0.0,1.1106915165381966e-05,1.0
50227,쌋음/Noun,1,1,0,1.1115310228308472e-05,0.0,1.0
50228,goodies/Alpha,1,1,0,1.1115310228308472e-05,0.0,1.0
50229,oldies/Alpha,1,1,0,1.1115310228308472e-05,0.0,1.0
50230,의읭/Noun,1,1,0,1.1115310228308472e-05,0.0,1.0
50231,고의사구/Noun,1,0,1,0.0,1.1106915165381966e-05,1.0
50232,죷/Noun,1,0,1,0.0,1.1106915165381966e-05,1.0
50233,범두/Noun,1,0,1,0.0,1.1106915165381966e-05,1.0
50234,독무대/Noun,1,1,0,1.1115310228308472e-05,0.0,1.0
50235,새드앤딩/Noun,1,1,0,1.1115310228308472e-05,0.0,1.0
50236,버논/Noun,1,1,0,1.1115310228308472e-05,0.0,1.0
50237,마운트/Noun,1,1,0,1.1115310228308472e-05,0.0,1.0
50238,소닉붐/Noun,1,0,1,0.0,1.1106915165381966e-05,1.0
50239,릭터/Noun,1,0,1,0.0,1.1106915165381966e-05,1.0
50240,ITF/Alpha,1,0,1,0.0,1.1106915165381966e-05,1.0
50241,순은/Noun,1,1,0,1.1115310228308472e-05,0.0,1.0
50242,작이라며/Foreign,1,1,0,1.1115310228308472e-05,0.0,1.0
50243,1947년/Number,1,1,0,1.1115310228308472e-05,0.0,1.0
50244,".,..;;;/Punctuation",1,1,0,1.1115310228308472e-05,0.0,1.0
50245,!!!!!..../Punctuation,1,0,1,0.0,1.1106915165381966e-05,1.0
50246,이넘도록/Foreign,1,0,1,0.0,1.1106915165381966e-05,1.0
50247,베평/Noun,1,0,1,0.0,1.1106915165381966e-05,1.0
50248,김경희/Noun,1,0,1,0.0,1.1106915165381966e-05,1.0
50249,애킨슨/Noun,1,1,0,1.1115310228308472e-05,0.0,1.0
50250,지미뉴트론/Noun,1,1,0,1.1115310228308472e-05,0.0,1.0
50251,영매/Noun,1,0,1,0.0,1.1106915165381966e-05,1.0
50252,ㄱㅋㅋㅋ/KoreanParticle,1,1,0,1.1115310228308472e-05,0.0,1.0
50253,벌빠/Noun,1,0,1,0.0,1.1106915165381966e-05,1.0
50254,~~**/Punctuation,1,1,0,1.1115310228308472e-05,0.0,1.0
50255,설램/Noun,1,1,0,1.1115310228308472e-05,0.0,1.0
50256,츽오/Noun,1,1,0,1.1115310228308472e-05,0.0,1.0
50257,보템/Noun,1,0,1,0.0,1.1106915165381966e-05,1.0
50258,쳐드/Noun,1,1,0,1.1115310228308472e-05,0.0,1.0
50259,에스빠뇰/Noun,1,1,0,1.1115310228308472e-05,0.0,1.0
50260,픽셀/Noun,1,0,1,0.0,1.1106915165381966e-05,1.0
50261,도에만들어진/Foreign,1,1,0,1.1115310228308472e-05,0.0,1.0
50262,쫭/Noun,1,1,0,1.1115310228308472e-05,0.0,1.0
50263,주격/Noun,1,0,1,0.0,1.1106915165381966e-05,1.0
50264,종헌/Noun,1,0,1,0.0,1.1106915165381966e-05,1.0
50265,강씨/Noun,1,0,1,0.0,1.1106915165381966e-05,1.0
50266,8.39/Number,1,0,1,0.0,1.1106915165381966e-05,1.0
50267,원균/Noun,1,1,0,1.1115310228308472e-05,0.0,1.0
50268,아만/Noun,1,0,1,0.0,1.1106915165381966e-05,1.0
50269,준거임/Noun,1,0,1,0.0,1.1106915165381966e-05,1.0
50270,쥐좆/Noun,1,0,1,0.0,1.1106915165381966e-05,1.0
50271,푸닥거리/Noun,1,0,1,0.0,1.1106915165381966e-05,1.0
50272,분파/Noun,1,0,1,0.0,1.1106915165381966e-05,1.0
50273,굿강/Noun,1,1,0,1.1115310228308472e-05,0.0,1.0
50274,브리지/Noun,1,0,1,0.0,1.1106915165381966e-05,1.0
50275,생강빵/Noun,1,1,0,1.1115310228308472e-05,0.0,1.0
50276,이인기/Noun,1,1,0,1.1115310228308472e-05,0.0,1.0
50277,젬없겠/Noun,1,0,1,0.0,1.1106915165381966e-05,1.0
50278,7.1/Number,1,1,0,1.1115310228308472e-05,0.0,1.0
50279,대자보/Noun,1,0,1,0.0,1.1106915165381966e-05,1.0
50280,김무성/Noun,1,0,1,0.0,1.1106915165381966e-05,1.0
50281,하켄크로이츠/Noun,1,0,1,0.0,1.1106915165381966e-05,1.0
50282,친선/Noun,1,0,1,0.0,1.1106915165381966e-05,1.0
50283,개핵노댐/Noun,1,0,1,0.0,1.1106915165381966e-05,1.0
50284,급습/Noun,1,0,1,0.0,1.1106915165381966e-05,1.0
50285,홀릴만하/Noun,1,0,1,0.0,1.1106915165381966e-05,1.0
50286,쌔끈해/Noun,1,0,1,0.0,1.1106915165381966e-05,1.0
50287,이실/Josa,1,0,1,0.0,1.1106915165381966e-05,1.0
50288,아이티/Noun,1,0,1,0.0,1.1106915165381966e-05,1.0
50289,신관/Noun,1,1,0,1.1115310228308472e-05,0.0,1.0
50290,서슴다/Verb,1,0,1,0.0,1.1106915165381966e-05,1.0
50291,입산/Noun,1,0,1,0.0,1.1106915165381966e-05,1.0
50292,어흐흐흐흑/Noun,1,1,0,1.1115310228308472e-05,0.0,1.0
50293,~~!?/Punctuation,1,0,1,0.0,1.1106915165381966e-05,1.0
50294,의치/Noun,1,1,0,1.1115310228308472e-05,0.0,1.0
50295,보발/Noun,1,1,0,1.1115310228308472e-05,0.0,1.0
50296,공일/Noun,1,0,1,0.0,1.1106915165381966e-05,1.0
50297,대매/Noun,1,1,0,1.1115310228308472e-05,0.0,1.0
50298,!~~!/Punctuation,1,1,0,1.1115310228308472e-05,0.0,1.0
50299,불가분/Noun,1,1,0,1.1115310228308472e-05,0.0,1.0
50300,내용정리/Noun,1,0,1,0.0,1.1106915165381966e-05,1.0
50301,필청/Noun,1,1,0,1.1115310228308472e-05,0.0,1.0
50302,우승상금/Noun,1,0,1,0.0,1.1106915165381966e-05,1.0
50303,유병언/Noun,1,1,0,1.1115310228308472e-05,0.0,1.0
50304,거걸/Noun,1,0,1,0.0,1.1106915165381966e-05,1.0
50305,강민우/Noun,1,0,1,0.0,1.1106915165381966e-05,1.0
50306,처으/Noun,1,1,0,1.1115310228308472e-05,0.0,1.0
50307,신궁/Noun,1,0,1,0.0,1.1106915165381966e-05,1.0
50308,촣/Noun,1,1,0,1.1115310228308472e-05,0.0,1.0
50309,숨긔/Noun,1,1,0,1.1115310228308472e-05,0.0,1.0
50310,도라도/Noun,1,0,1,0.0,1.1106915165381966e-05,1.0
50311,OBC/Alpha,1,1,0,1.1115310228308472e-05,0.0,1.0
50312,팔십분/Noun,1,0,1,0.0,1.1106915165381966e-05,1.0
50313,버벅/Noun,1,0,1,0.0,1.1106915165381966e-05,1.0
50314,생방으루왜바꿧/Noun,1,0,1,0.0,1.1106915165381966e-05,1.0
50315,ㅠㅠㅅㅂ/KoreanParticle,1,1,0,1.1115310228308472e-05,0.0,1.0
50316,첨이넹/Noun,1,0,1,0.0,1.1106915165381966e-05,1.0
50317,영화니/Foreign,1,1,0,1.1115310228308472e-05,0.0,1.0
50318,모를껄/Noun,1,1,0,1.1115310228308472e-05,0.0,1.0
50319,drop/Alpha,1,0,1,0.0,1.1106915165381966e-05,1.0
50320,drag/Alpha,1,0,1,0.0,1.1106915165381966e-05,1.0
50321,풍식/Noun,1,1,0,1.1115310228308472e-05,0.0,1.0
50322,페르시/Noun,1,0,1,0.0,1.1106915165381966e-05,1.0
50323,밸트/Noun,1,0,1,0.0,1.1106915165381966e-05,1.0
50324,++/Punctuation,1,1,0,1.1115310228308472e-05,0.0,1.0
50325,들엿으면/Noun,1,0,1,0.0,1.1106915165381966e-05,1.0
50326,리메이/Noun,1,0,1,0.0,1.1106915165381966e-05,1.0
50327,쳣던거/Noun,1,0,1,0.0,1.1106915165381966e-05,1.0
50328,氣/Foreign,1,0,1,0.0,1.1106915165381966e-05,1.0
50329,김훙국/Noun,1,0,1,0.0,1.1106915165381966e-05,1.0
50330,군복씬/Noun,1,0,1,0.0,1.1106915165381966e-05,1.0
50331,성의껏/Noun,1,0,1,0.0,1.1106915165381966e-05,1.0
50332,정의도/Noun,1,0,1,0.0,1.1106915165381966e-05,1.0
50333,나선형/Noun,1,1,0,1.1115310228308472e-05,0.0,1.0
50334,토함/Noun,1,0,1,0.0,1.1106915165381966e-05,1.0
50335,폴역/Noun,1,1,0,1.1115310228308472e-05,0.0,1.0
50336,진맛/Noun,1,1,0,1.1115310228308472e-05,0.0,1.0
50337,잭더자이언트킬러/Noun,1,1,0,1.1115310228308472e-05,0.0,1.0
50338,으랴/Noun,1,0,1,0.0,1.1106915165381966e-05,1.0
50339,사분/Noun,1,0,1,0.0,1.1106915165381966e-05,1.0
50340,기지역/Noun,1,0,1,0.0,1.1106915165381966e-05,1.0
50341,않느냔/Noun,1,0,1,0.0,1.1106915165381966e-05,1.0
50342,이평/Noun,1,1,0,1.1115310228308472e-05,0.0,1.0
50343,전에봤지만/Foreign,1,1,0,1.1115310228308472e-05,0.0,1.0
50344,김연수/Noun,1,1,0,1.1115310228308472e-05,0.0,1.0
50345,6400만달러/Number,1,1,0,1.1115310228308472e-05,0.0,1.0
50346,수입이/Foreign,1,1,0,1.1115310228308472e-05,0.0,1.0
50347,7500만달러/Number,1,1,0,1.1115310228308472e-05,0.0,1.0
50348,자본론/Noun,1,0,1,0.0,1.1106915165381966e-05,1.0
50349,민디/Noun,1,0,1,0.0,1.1106915165381966e-05,1.0
50350,ㅇㅇㅠㅠ/KoreanParticle,1,1,0,1.1115310228308472e-05,0.0,1.0
50351,앞치마/Noun,1,1,0,1.1115310228308472e-05,0.0,1.0
50352,비천무/Noun,1,0,1,0.0,1.1106915165381966e-05,1.0
50353,견지되/Noun,1,1,0,1.1115310228308472e-05,0.0,1.0
50354,등꼴/Noun,1,0,1,0.0,1.1106915165381966e-05,1.0
50355,젠비/Noun,1,1,0,1.1115310228308472e-05,0.0,1.0
50356,윌러/Noun,1,0,1,0.0,1.1106915165381966e-05,1.0
50357,ㄲㅋ/KoreanParticle,1,1,0,1.1115310228308472e-05,0.0,1.0
50358,입셍/Noun,1,0,1,0.0,1.1106915165381966e-05,1.0
50359,벙크/Noun,1,1,0,1.1115310228308472e-05,0.0,1.0
50360,윤택/Noun,1,1,0,1.1115310228308472e-05,0.0,1.0
50361,띠띠/Noun,1,1,0,1.1115310228308472e-05,0.0,1.0
50362,궈였/Noun,1,1,0,1.1115310228308472e-05,0.0,1.0
50363,이되는/Foreign,1,1,0,1.1115310228308472e-05,0.0,1.0
50364,음/Foreign,1,0,1,0.0,1.1106915165381966e-05,1.0
50365,미레이/Noun,1,1,0,1.1115310228308472e-05,0.0,1.0
50366,아이스하키/Noun,1,1,0,1.1115310228308472e-05,0.0,1.0
50367,..../////Punctuation,1,0,1,0.0,1.1106915165381966e-05,1.0
50368,문정왕후/Noun,1,1,0,1.1115310228308472e-05,0.0,1.0
50369,구동욱/Noun,1,1,0,1.1115310228308472e-05,0.0,1.0
50370,코골/Noun,1,0,1,0.0,1.1106915165381966e-05,1.0
50371,1.01/Number,1,0,1,0.0,1.1106915165381966e-05,1.0
50372,웅얼거리/Noun,1,0,1,0.0,1.1106915165381966e-05,1.0
50373,아깜/Noun,1,0,1,0.0,1.1106915165381966e-05,1.0
50374,항항/Noun,1,1,0,1.1115310228308472e-05,0.0,1.0
50375,전인화/Noun,1,0,1,0.0,1.1106915165381966e-05,1.0
50376,6시간/Number,1,0,1,0.0,1.1106915165381966e-05,1.0
50377,정법사/Noun,1,1,0,1.1115310228308472e-05,0.0,1.0
50378,다음으로/Foreign,1,1,0,1.1115310228308472e-05,0.0,1.0
50379,액숀영화/Noun,1,0,1,0.0,1.1106915165381966e-05,1.0
50380,7-8년/Number,1,0,1,0.0,1.1106915165381966e-05,1.0
50381,응오/Noun,1,0,1,0.0,1.1106915165381966e-05,1.0
50382,토오루/Noun,1,0,1,0.0,1.1106915165381966e-05,1.0
50383,잡근하/Noun,1,0,1,0.0,1.1106915165381966e-05,1.0
50384,눈뎁/Noun,1,1,0,1.1115310228308472e-05,0.0,1.0
50385,전리/Noun,1,0,1,0.0,1.1106915165381966e-05,1.0
50386,껄그랫/Noun,1,0,1,0.0,1.1106915165381966e-05,1.0
50387,황금사자상/Noun,1,0,1,0.0,1.1106915165381966e-05,1.0
50388,배비장전/Noun,1,1,0,1.1115310228308472e-05,0.0,1.0
50389,Nation/Alpha,1,1,0,1.1115310228308472e-05,0.0,1.0
50390,프랑켄위니/Noun,1,1,0,1.1115310228308472e-05,0.0,1.0
50391,http://cafe.naver.com/joonggonara/154723602/URL,1,1,0,1.1115310228308472e-05,0.0,1.0
50392,justice/Alpha,1,1,0,1.1115310228308472e-05,0.0,1.0
50393,dramatic/Alpha,1,1,0,1.1115310228308472e-05,0.0,1.0
50394,명마/Noun,1,0,1,0.0,1.1106915165381966e-05,1.0
50395,10000000000000000/Number,1,0,1,0.0,1.1106915165381966e-05,1.0
50396,밀키스/Noun,1,1,0,1.1115310228308472e-05,0.0,1.0
50397,발탁/Noun,1,1,0,1.1115310228308472e-05,0.0,1.0
50398,언밸러스/Noun,1,0,1,0.0,1.1106915165381966e-05,1.0
50399,도로씬/Noun,1,0,1,0.0,1.1106915165381966e-05,1.0
50400,김태촌/Noun,1,0,1,0.0,1.1106915165381966e-05,1.0
50401,파이어뱃/Noun,1,1,0,1.1115310228308472e-05,0.0,1.0
50402,윤소라/Noun,1,1,0,1.1115310228308472e-05,0.0,1.0
50403,님꺼/Noun,1,0,1,0.0,1.1106915165381966e-05,1.0
50404,푸시업/Noun,1,0,1,0.0,1.1106915165381966e-05,1.0
50405,영양실조/Noun,1,0,1,0.0,1.1106915165381966e-05,1.0
50406,깡마르다/Adjective,1,0,1,0.0,1.1106915165381966e-05,1.0
50407,고왕/Noun,1,0,1,0.0,1.1106915165381966e-05,1.0
50408,안썻는데/Noun,1,0,1,0.0,1.1106915165381966e-05,1.0
50409,게뿔/Noun,1,0,1,0.0,1.1106915165381966e-05,1.0
50410,밨었/Noun,1,1,0,1.1115310228308472e-05,0.0,1.0
50411,ㅓㅎ/KoreanParticle,1,0,1,0.0,1.1106915165381966e-05,1.0
50412,아력/Noun,1,0,1,0.0,1.1106915165381966e-05,1.0
50413,류승/Noun,1,1,0,1.1115310228308472e-05,0.0,1.0
50414,여성화/Noun,1,0,1,0.0,1.1106915165381966e-05,1.0
50415,정땜/Noun,1,0,1,0.0,1.1106915165381966e-05,1.0
50416,bian/Alpha,1,1,0,1.1115310228308472e-05,0.0,1.0
50417,tres/Alpha,1,1,0,1.1115310228308472e-05,0.0,1.0
50418,전입/Noun,1,1,0,1.1115310228308472e-05,0.0,1.0
50419,수자식/Noun,1,0,1,0.0,1.1106915165381966e-05,1.0
50420,짜개다/Verb,1,0,1,0.0,1.1106915165381966e-05,1.0
50421,독려/Noun,1,1,0,1.1115310228308472e-05,0.0,1.0
50422,인하대/Noun,1,1,0,1.1115310228308472e-05,0.0,1.0
50423,어두우/Noun,1,1,0,1.1115310228308472e-05,0.0,1.0
50424,sjco/Alpha,1,1,0,1.1115310228308472e-05,0.0,1.0
50425,콜롬바인/Noun,1,0,1,0.0,1.1106915165381966e-05,1.0
50426,박대동/Noun,1,1,0,1.1115310228308472e-05,0.0,1.0
50427,므니/Noun,1,0,1,0.0,1.1106915165381966e-05,1.0
50428,몬타나/Noun,1,1,0,1.1115310228308472e-05,0.0,1.0
50429,일리지/Noun,1,0,1,0.0,1.1106915165381966e-05,1.0
50430,움마/Noun,1,0,1,0.0,1.1106915165381966e-05,1.0
50431,신혜성/Noun,1,1,0,1.1115310228308472e-05,0.0,1.0
50432,바럤/Noun,1,1,0,1.1115310228308472e-05,0.0,1.0
50433,아라비안/Noun,1,1,0,1.1115310228308472e-05,0.0,1.0
50434,드셧남/Noun,1,0,1,0.0,1.1106915165381966e-05,1.0
50435,밑에님보/Noun,1,0,1,0.0,1.1106915165381966e-05,1.0
50436,울먹울먹/Adverb,1,0,1,0.0,1.1106915165381966e-05,1.0
50437,(^_*)/Punctuation,1,1,0,1.1115310228308472e-05,0.0,1.0
50438,skill/Alpha,1,0,1,0.0,1.1106915165381966e-05,1.0
50439,notable/Alpha,1,0,1,0.0,1.1106915165381966e-05,1.0
50440,LTE/Alpha,1,1,0,1.1115310228308472e-05,0.0,1.0
50441,정론/Noun,1,0,1,0.0,1.1106915165381966e-05,1.0
50442,나꼼수/Noun,1,0,1,0.0,1.1106915165381966e-05,1.0
50443,갈릴레오/Noun,1,1,0,1.1115310228308472e-05,0.0,1.0
50444,헤르미온느/Noun,1,1,0,1.1115310228308472e-05,0.0,1.0
50445,시네필/Noun,1,1,0,1.1115310228308472e-05,0.0,1.0
50446,빡주/Noun,1,0,1,0.0,1.1106915165381966e-05,1.0
50447,멋지넵/Noun,1,1,0,1.1115310228308472e-05,0.0,1.0
50448,송종호/Noun,1,1,0,1.1115310228308472e-05,0.0,1.0
50449,조카딸/Noun,1,1,0,1.1115310228308472e-05,0.0,1.0
50450,왕인/Noun,1,0,1,0.0,1.1106915165381966e-05,1.0
50451,구부리/Noun,1,1,0,1.1115310228308472e-05,0.0,1.0
50452,락커룸/Noun,1,0,1,0.0,1.1106915165381966e-05,1.0
50453,심화영/Noun,1,0,1,0.0,1.1106915165381966e-05,1.0
50454,지깟/Noun,1,0,1,0.0,1.1106915165381966e-05,1.0
50455,사이클링/Noun,1,1,0,1.1115310228308472e-05,0.0,1.0
50456,스트리밍/Noun,1,1,0,1.1115310228308472e-05,0.0,1.0
50457,모레쯔/Noun,1,1,0,1.1115310228308472e-05,0.0,1.0
50458,덴젤와싱턴/Noun,1,1,0,1.1115310228308472e-05,0.0,1.0
50459,오방/Noun,1,0,1,0.0,1.1106915165381966e-05,1.0
50460,KOMBAT/Alpha,1,0,1,0.0,1.1106915165381966e-05,1.0
50461,MORTAL/Alpha,1,0,1,0.0,1.1106915165381966e-05,1.0
50462,큼의/Foreign,1,1,0,1.1115310228308472e-05,0.0,1.0
50463,Hffufguo/Alpha,1,1,0,1.1115310228308472e-05,0.0,1.0
50464,들이마시다/Verb,1,1,0,1.1115310228308472e-05,0.0,1.0
50465,이수빈/Noun,1,0,1,0.0,1.1106915165381966e-05,1.0
50466,어쩌구저쩌구/Noun,1,0,1,0.0,1.1106915165381966e-05,1.0
50467,어줍잫/Noun,1,0,1,0.0,1.1106915165381966e-05,1.0
50468,거함/Noun,1,0,1,0.0,1.1106915165381966e-05,1.0
50469,반으로/Foreign,1,1,0,1.1115310228308472e-05,0.0,1.0
50470,러어엄/Noun,1,1,0,1.1115310228308472e-05,0.0,1.0
50471,비처/Noun,1,1,0,1.1115310228308472e-05,0.0,1.0
50472,매출/Noun,1,0,1,0.0,1.1106915165381966e-05,1.0
50473,신용/Noun,1,1,0,1.1115310228308472e-05,0.0,1.0
50474,더끝/Noun,1,0,1,0.0,1.1106915165381966e-05,1.0
50475,챵/Noun,1,1,0,1.1115310228308472e-05,0.0,1.0
50476,쉘위키스/Noun,1,0,1,0.0,1.1106915165381966e-05,1.0
50477,어그러지다/Verb,1,1,0,1.1115310228308472e-05,0.0,1.0
50478,빠샤빠샤/Noun,1,0,1,0.0,1.1106915165381966e-05,1.0
50479,선머슴/Noun,1,0,1,0.0,1.1106915165381966e-05,1.0
50480,창코/Noun,1,0,1,0.0,1.1106915165381966e-05,1.0
50481,김진선/Noun,1,0,1,0.0,1.1106915165381966e-05,1.0
50482,高岡蒼佑/Foreign,1,0,1,0.0,1.1106915165381966e-05,1.0
50483,僞善者/Foreign,1,0,1,0.0,1.1106915165381966e-05,1.0
50484,反韓派/Foreign,1,0,1,0.0,1.1106915165381966e-05,1.0
50485,한파/Noun,1,0,1,0.0,1.1106915165381966e-05,1.0
50486,생심/Noun,1,0,1,0.0,1.1106915165381966e-05,1.0
50487,리쎌웨폰/Noun,1,0,1,0.0,1.1106915165381966e-05,1.0
50488,언론사/Noun,1,0,1,0.0,1.1106915165381966e-05,1.0
50489,김일중/Noun,1,1,0,1.1115310228308472e-05,0.0,1.0
50490,"18,000,000달러/Number",1,0,1,0.0,1.1106915165381966e-05,1.0
50491,..-_-+/Punctuation,1,0,1,0.0,1.1106915165381966e-05,1.0
50492,왜만들엇어/Noun,1,0,1,0.0,1.1106915165381966e-05,1.0
50493,전진한/Noun,1,1,0,1.1115310228308472e-05,0.0,1.0
50494,극락왕생/Noun,1,0,1,0.0,1.1106915165381966e-05,1.0
50495,깍고싶넹/Noun,1,0,1,0.0,1.1106915165381966e-05,1.0
50496,...;;;;;;/Punctuation,1,0,1,0.0,1.1106915165381966e-05,1.0
50497,팔짱/Noun,1,1,0,1.1115310228308472e-05,0.0,1.0
50498,86%/Number,1,1,0,1.1115310228308472e-05,0.0,1.0
50499,촌년/Noun,1,1,0,1.1115310228308472e-05,0.0,1.0
50500,구요/Eomi,1,0,1,0.0,1.1106915165381966e-05,1.0
50501,놑/Noun,1,1,0,1.1115310228308472e-05,0.0,1.0
50502,타루/Noun,1,1,0,1.1115310228308472e-05,0.0,1.0
50503,수토/Noun,1,1,0,1.1115310228308472e-05,0.0,1.0
50504,없을껄/Noun,1,1,0,1.1115310228308472e-05,0.0,1.0
50505,샷들/Noun,1,0,1,0.0,1.1106915165381966e-05,1.0
50506,방값내/Noun,1,0,1,0.0,1.1106915165381966e-05,1.0
50507,메비우스/Noun,1,1,0,1.1115310228308472e-05,0.0,1.0
50508,:\/Punctuation,1,1,0,1.1115310228308472e-05,0.0,1.0
50509,그걍그렇슴/Noun,1,1,0,1.1115310228308472e-05,0.0,1.0
50510,"""???/Punctuation",1,1,0,1.1115310228308472e-05,0.0,1.0
50511,...;;;;;;;;;;;;;;;;;;;;;;;;;;;;;;;;;;;/Punctuation,1,0,1,0.0,1.1106915165381966e-05,1.0
50512,sense/Alpha,1,1,0,1.1115310228308472e-05,0.0,1.0
50513,some/Alpha,1,1,0,1.1115310228308472e-05,0.0,1.0
50514,늬미/Noun,1,0,1,0.0,1.1106915165381966e-05,1.0
50515,뮐까/Noun,1,0,1,0.0,1.1106915165381966e-05,1.0
50516,낚더/Noun,1,0,1,0.0,1.1106915165381966e-05,1.0
50517,왕소/Noun,1,1,0,1.1115310228308472e-05,0.0,1.0
50518,.......??/Punctuation,1,1,0,1.1115310228308472e-05,0.0,1.0
50519,preparing/Alpha,1,1,0,1.1115310228308472e-05,0.0,1.0
50520,failures/Alpha,1,1,0,1.1115310228308472e-05,0.0,1.0
50521,ovie/Alpha,1,0,1,0.0,1.1106915165381966e-05,1.0
50522,켄터키/Noun,1,0,1,0.0,1.1106915165381966e-05,1.0
50523,원령공주/Noun,1,1,0,1.1115310228308472e-05,0.0,1.0
50524,로크/Noun,1,1,0,1.1115310228308472e-05,0.0,1.0
50525,놀랏/Noun,1,1,0,1.1115310228308472e-05,0.0,1.0
50526,장쾌/Noun,1,1,0,1.1115310228308472e-05,0.0,1.0
50527,하스겔/Noun,1,1,0,1.1115310228308472e-05,0.0,1.0
50528,말문/Noun,1,1,0,1.1115310228308472e-05,0.0,1.0
50529,발년/Noun,1,0,1,0.0,1.1106915165381966e-05,1.0
50530,흥행수익/Noun,1,1,0,1.1115310228308472e-05,0.0,1.0
50531,보링/Noun,1,1,0,1.1115310228308472e-05,0.0,1.0
50532,눈좀/Noun,1,0,1,0.0,1.1106915165381966e-05,1.0
50533,녀등/Noun,1,1,0,1.1115310228308472e-05,0.0,1.0
50534,애닮프/Noun,1,0,1,0.0,1.1106915165381966e-05,1.0
50535,By/Alpha,1,1,0,1.1115310228308472e-05,0.0,1.0
50536,취했네/Noun,1,1,0,1.1115310228308472e-05,0.0,1.0
50537,컴뱃/Noun,1,0,1,0.0,1.1106915165381966e-05,1.0
50538,-_-);;/Punctuation,1,0,1,0.0,1.1106915165381966e-05,1.0
50539,_^^/Punctuation,1,1,0,1.1115310228308472e-05,0.0,1.0
50540,사몽/Noun,1,1,0,1.1115310228308472e-05,0.0,1.0
50541,모색/Noun,1,1,0,1.1115310228308472e-05,0.0,1.0
50542,봫음/Noun,1,1,0,1.1115310228308472e-05,0.0,1.0
50543,안지만/Noun,1,1,0,1.1115310228308472e-05,0.0,1.0
50544,앟/Noun,1,1,0,1.1115310228308472e-05,0.0,1.0
50545,쓰레긴듯/Noun,1,0,1,0.0,1.1106915165381966e-05,1.0
50546,란슬롯/Noun,1,0,1,0.0,1.1106915165381966e-05,1.0
50547,랜슬롯/Noun,1,0,1,0.0,1.1106915165381966e-05,1.0
50548,원탁/Noun,1,0,1,0.0,1.1106915165381966e-05,1.0
50549,당수/Noun,1,0,1,0.0,1.1106915165381966e-05,1.0
50550,접때/Noun,1,0,1,0.0,1.1106915165381966e-05,1.0
50551,퇴원/Noun,1,0,1,0.0,1.1106915165381966e-05,1.0
50552,때밥/Noun,1,0,1,0.0,1.1106915165381966e-05,1.0
50553,쿠처/Noun,1,0,1,0.0,1.1106915165381966e-05,1.0
50554,구승/Noun,1,0,1,0.0,1.1106915165381966e-05,1.0
50555,류허/Noun,1,0,1,0.0,1.1106915165381966e-05,1.0
50556,싱돼/Noun,1,0,1,0.0,1.1106915165381966e-05,1.0
50557,유상/Noun,1,0,1,0.0,1.1106915165381966e-05,1.0
50558,@!!!!!!/Punctuation,1,1,0,1.1115310228308472e-05,0.0,1.0
50559,breath/Alpha,1,1,0,1.1115310228308472e-05,0.0,1.0
50560,Take/Alpha,1,1,0,1.1115310228308472e-05,0.0,1.0
50561,이다윗/Noun,1,0,1,0.0,1.1106915165381966e-05,1.0
50562,뚝도/Noun,1,1,0,1.1115310228308472e-05,0.0,1.0
50563,???????????????????/Punctuation,1,0,1,0.0,1.1106915165381966e-05,1.0
50564,2.42/Number,1,0,1,0.0,1.1106915165381966e-05,1.0
50565,설경/Noun,1,1,0,1.1115310228308472e-05,0.0,1.0
50566,붕떠있/Noun,1,0,1,0.0,1.1106915165381966e-05,1.0
50567,피됴해/Noun,1,0,1,0.0,1.1106915165381966e-05,1.0
50568,ㅅㄳㄱ/KoreanParticle,1,0,1,0.0,1.1106915165381966e-05,1.0
50569,인생/Foreign,1,0,1,0.0,1.1106915165381966e-05,1.0
50570,전단지/Noun,1,0,1,0.0,1.1106915165381966e-05,1.0
50571,설렁탕/Noun,1,1,0,1.1115310228308472e-05,0.0,1.0
50572,난또뭐슨/Noun,1,0,1,0.0,1.1106915165381966e-05,1.0
50573,정글러라/Noun,1,0,1,0.0,1.1106915165381966e-05,1.0
50574,죽는쥴/Noun,1,0,1,0.0,1.1106915165381966e-05,1.0
50575,생때봣/Noun,1,1,0,1.1115310228308472e-05,0.0,1.0
50576,절었다/Noun,1,0,1,0.0,1.1106915165381966e-05,1.0
50577,직거래/Noun,1,0,1,0.0,1.1106915165381966e-05,1.0
50578,다그치다/Verb,1,1,0,1.1115310228308472e-05,0.0,1.0
50579,http://www.ebs.co.kr/space/rookie/audition/thislist/3602/URL,1,1,0,1.1115310228308472e-05,0.0,1.0
50580,toll/Alpha,1,1,0,1.1115310228308472e-05,0.0,1.0
50581,rubylincc/Alpha,1,1,0,1.1115310228308472e-05,0.0,1.0
50582,문죄인/Noun,1,0,1,0.0,1.1106915165381966e-05,1.0
50583,통보/Noun,1,0,1,0.0,1.1106915165381966e-05,1.0
50584,김진근/Noun,1,0,1,0.0,1.1106915165381966e-05,1.0
50585,게것/Noun,1,0,1,0.0,1.1106915165381966e-05,1.0
50586,쿼프/Noun,1,1,0,1.1115310228308472e-05,0.0,1.0
50587,니혼진/Noun,1,0,1,0.0,1.1106915165381966e-05,1.0
50588,빠닼/Noun,1,1,0,1.1115310228308472e-05,0.0,1.0
50589,노드/Noun,1,1,0,1.1115310228308472e-05,0.0,1.0
50590,이색기/Noun,1,0,1,0.0,1.1106915165381966e-05,1.0
50591,最惡/Foreign,1,0,1,0.0,1.1106915165381966e-05,1.0
50592,십일조/Noun,1,0,1,0.0,1.1106915165381966e-05,1.0
50593,dogdog/Alpha,1,0,1,0.0,1.1106915165381966e-05,1.0
50594,공간미/Noun,1,1,0,1.1115310228308472e-05,0.0,1.0
50595,암살씬/Noun,1,1,0,1.1115310228308472e-05,0.0,1.0
50596,개똥철/Noun,1,0,1,0.0,1.1106915165381966e-05,1.0
50597,148시간/Number,1,0,1,0.0,1.1106915165381966e-05,1.0
50598,헤딩/Noun,1,1,0,1.1115310228308472e-05,0.0,1.0
50599,crumbles/Alpha,1,1,0,1.1115310228308472e-05,0.0,1.0
50600,cookie/Alpha,1,1,0,1.1115310228308472e-05,0.0,1.0
50601,yup/Alpha,1,1,0,1.1115310228308472e-05,0.0,1.0
50602,어벤져/Noun,1,1,0,1.1115310228308472e-05,0.0,1.0
50603,맹관/Noun,1,1,0,1.1115310228308472e-05,0.0,1.0
50604,잼버리/Noun,1,1,0,1.1115310228308472e-05,0.0,1.0
50605,이것드/Noun,1,1,0,1.1115310228308472e-05,0.0,1.0
50606,olleh/Alpha,1,0,1,0.0,1.1106915165381966e-05,1.0
50607,국세/Noun,1,0,1,0.0,1.1106915165381966e-05,1.0
50608,종래/Noun,1,1,0,1.1115310228308472e-05,0.0,1.0
50609,일부일/Adverb,1,1,0,1.1115310228308472e-05,0.0,1.0
50610,ㅡㅗ/KoreanParticle,1,0,1,0.0,1.1106915165381966e-05,1.0
50611,ㄴㄹㄴ/KoreanParticle,1,1,0,1.1115310228308472e-05,0.0,1.0
50612,노승/Noun,1,1,0,1.1115310228308472e-05,0.0,1.0
50613,자승/Noun,1,1,0,1.1115310228308472e-05,0.0,1.0
50614,숭늉/Noun,1,1,0,1.1115310228308472e-05,0.0,1.0
50615,우물가/Noun,1,1,0,1.1115310228308472e-05,0.0,1.0
50616,꿀꿐/Noun,1,1,0,1.1115310228308472e-05,0.0,1.0
50617,(?..).../Punctuation,1,1,0,1.1115310228308472e-05,0.0,1.0
50618,"!,,,,,,,/Punctuation",1,1,0,1.1115310228308472e-05,0.0,1.0
50619,법앞/Noun,1,1,0,1.1115310228308472e-05,0.0,1.0
50620,11조/Number,1,1,0,1.1115310228308472e-05,0.0,1.0
50621,감독생퀴/Noun,1,0,1,0.0,1.1106915165381966e-05,1.0
50622,소염기/Noun,1,1,0,1.1115310228308472e-05,0.0,1.0
50623,포상/Noun,1,1,0,1.1115310228308472e-05,0.0,1.0
50624,숖/Noun,1,1,0,1.1115310228308472e-05,0.0,1.0
50625,오형/Noun,1,0,1,0.0,1.1106915165381966e-05,1.0
50626,특유의슬/Noun,1,0,1,0.0,1.1106915165381966e-05,1.0
50627,봣었음/Noun,1,1,0,1.1115310228308472e-05,0.0,1.0
50628,)^^/Punctuation,1,1,0,1.1115310228308472e-05,0.0,1.0
50629,goodgoodgoodgood/Alpha,1,1,0,1.1115310228308472e-05,0.0,1.0
50630,불법행위/Noun,1,0,1,0.0,1.1106915165381966e-05,1.0
50631,"~~....,,,,/Punctuation",1,0,1,0.0,1.1106915165381966e-05,1.0
50632,아요/Eomi,1,0,1,0.0,1.1106915165381966e-05,1.0
50633,.;-/Punctuation,1,0,1,0.0,1.1106915165381966e-05,1.0
50634,엎음/Noun,1,0,1,0.0,1.1106915165381966e-05,1.0
50635,도트락/Noun,1,1,0,1.1115310228308472e-05,0.0,1.0
50636,살밖/Noun,1,0,1,0.0,1.1106915165381966e-05,1.0
50637,말조심해/Noun,1,0,1,0.0,1.1106915165381966e-05,1.0
50638,비릿한데/Noun,1,1,0,1.1115310228308472e-05,0.0,1.0
50639,질척하다/Adjective,1,1,0,1.1115310228308472e-05,0.0,1.0
50640,스튜디어스/Noun,1,1,0,1.1115310228308472e-05,0.0,1.0
50641,뭉개줄/Noun,1,1,0,1.1115310228308472e-05,0.0,1.0
50642,정이안/Noun,1,0,1,0.0,1.1106915165381966e-05,1.0
50643,~~~~~~~~~~~~~~~~~~~~~~~~~~~~~~~~~~~/Punctuation,1,1,0,1.1115310228308472e-05,0.0,1.0
50644,빅픽처/Noun,1,0,1,0.0,1.1106915165381966e-05,1.0
50645,뚱띵게이/Noun,1,0,1,0.0,1.1106915165381966e-05,1.0
50646,뱃새다워/Noun,1,0,1,0.0,1.1106915165381966e-05,1.0
50647,뱃새/Noun,1,0,1,0.0,1.1106915165381966e-05,1.0
50648,소나/Foreign,1,0,1,0.0,1.1106915165381966e-05,1.0
50649,화용/Noun,1,1,0,1.1115310228308472e-05,0.0,1.0
50650,노리타/Noun,1,0,1,0.0,1.1106915165381966e-05,1.0
50651,풍차/Noun,1,0,1,0.0,1.1106915165381966e-05,1.0
50652,빈스본등/Noun,1,0,1,0.0,1.1106915165381966e-05,1.0
50653,헤시/Noun,1,0,1,0.0,1.1106915165381966e-05,1.0
50654,ㄱㄴㄷ/KoreanParticle,1,0,1,0.0,1.1106915165381966e-05,1.0
50655,戰慄/Foreign,1,1,0,1.1115310228308472e-05,0.0,1.0
50656,Preisner/Alpha,1,1,0,1.1115310228308472e-05,0.0,1.0
50657,Zbigniew/Alpha,1,1,0,1.1115310228308472e-05,0.0,1.0
50658,Kieslowski/Alpha,1,1,0,1.1115310228308472e-05,0.0,1.0
50659,Krzysztof/Alpha,1,1,0,1.1115310228308472e-05,0.0,1.0
50660,旋律/Foreign,1,1,0,1.1115310228308472e-05,0.0,1.0
50661,룹/Noun,1,0,1,0.0,1.1106915165381966e-05,1.0
50662,급꼴/Noun,1,0,1,0.0,1.1106915165381966e-05,1.0
50663,low/Alpha,1,0,1,0.0,1.1106915165381966e-05,1.0
50664,인도사람/Noun,1,0,1,0.0,1.1106915165381966e-05,1.0
50665,쨩이/Noun,1,1,0,1.1115310228308472e-05,0.0,1.0
50666,프라이데이/Noun,1,1,0,1.1115310228308472e-05,0.0,1.0
50667,모뇽/Noun,1,1,0,1.1115310228308472e-05,0.0,1.0
50668,맹근/Noun,1,0,1,0.0,1.1106915165381966e-05,1.0
50669,츄리닝/Noun,1,1,0,1.1115310228308472e-05,0.0,1.0
50670,플라자/Noun,1,0,1,0.0,1.1106915165381966e-05,1.0
50671,네잎클로버/Noun,1,0,1,0.0,1.1106915165381966e-05,1.0
50672,쥐키/Noun,1,0,1,0.0,1.1106915165381966e-05,1.0
50673,ASKY/Alpha,1,0,1,0.0,1.1106915165381966e-05,1.0
50674,점이라도/Foreign,1,0,1,0.0,1.1106915165381966e-05,1.0
50675,YWCA/Alpha,1,0,1,0.0,1.1106915165381966e-05,1.0
50676,장농/Noun,1,1,0,1.1115310228308472e-05,0.0,1.0
50677,채터리/Noun,1,0,1,0.0,1.1106915165381966e-05,1.0
50678,오타루/Noun,1,1,0,1.1115310228308472e-05,0.0,1.0
50679,걸데/Noun,1,0,1,0.0,1.1106915165381966e-05,1.0
50680,함속/Noun,1,1,0,1.1115310228308472e-05,0.0,1.0
50681,차하/Noun,1,0,1,0.0,1.1106915165381966e-05,1.0
50682,켄시/Noun,1,0,1,0.0,1.1106915165381966e-05,1.0
50683,펫시/Noun,1,0,1,0.0,1.1106915165381966e-05,1.0
50684,1988/Number,1,1,0,1.1115310228308472e-05,0.0,1.0
50685,해외여행/Noun,1,0,1,0.0,1.1106915165381966e-05,1.0
50686,CP/Alpha,1,0,1,0.0,1.1106915165381966e-05,1.0
50687,테닥짱/Noun,1,1,0,1.1115310228308472e-05,0.0,1.0
50688,우엑/Noun,1,0,1,0.0,1.1106915165381966e-05,1.0
50689,게또뭐/Noun,1,0,1,0.0,1.1106915165381966e-05,1.0
50690,규율/Noun,1,1,0,1.1115310228308472e-05,0.0,1.0
50691,이하영/Noun,1,0,1,0.0,1.1106915165381966e-05,1.0
50692,함남/Noun,1,0,1,0.0,1.1106915165381966e-05,1.0
50693,요홍/Noun,1,0,1,0.0,1.1106915165381966e-05,1.0
50694,어죽어봐/Noun,1,0,1,0.0,1.1106915165381966e-05,1.0
50695,을시/Noun,1,0,1,0.0,1.1106915165381966e-05,1.0
50696,거슬여/Noun,1,0,1,0.0,1.1106915165381966e-05,1.0
50697,샤킬/Noun,1,0,1,0.0,1.1106915165381966e-05,1.0
50698,전애니라니/Foreign,1,1,0,1.1115310228308472e-05,0.0,1.0
50699,못봣구/Noun,1,0,1,0.0,1.1106915165381966e-05,1.0
50700,쾌찬차/Noun,1,0,1,0.0,1.1106915165381966e-05,1.0
50701,정평/Noun,1,1,0,1.1115310228308472e-05,0.0,1.0
50702,디움/Noun,1,1,0,1.1115310228308472e-05,0.0,1.0
50703,형광/Noun,1,1,0,1.1115310228308472e-05,0.0,1.0
50704,헬름협곡/Noun,1,1,0,1.1115310228308472e-05,0.0,1.0
50705,종셋트/Noun,1,0,1,0.0,1.1106915165381966e-05,1.0
50706,옐로저널리즘/Noun,1,0,1,0.0,1.1106915165381966e-05,1.0
50707,abcdefghijk/Alpha,1,0,1,0.0,1.1106915165381966e-05,1.0
50708,Hand/Alpha,1,0,1,0.0,1.1106915165381966e-05,1.0
50709,잼쎠/Noun,1,1,0,1.1115310228308472e-05,0.0,1.0
50710,정종석/Noun,1,0,1,0.0,1.1106915165381966e-05,1.0
50711,란/Foreign,1,0,1,0.0,1.1106915165381966e-05,1.0
50712,혐영/Noun,1,0,1,0.0,1.1106915165381966e-05,1.0
50713,김태영/Noun,1,0,1,0.0,1.1106915165381966e-05,1.0
50714,팻시켄싯/Noun,1,1,0,1.1115310228308472e-05,0.0,1.0
50715,돈버는건/Noun,1,1,0,1.1115310228308472e-05,0.0,1.0
50716,함덕/Noun,1,1,0,1.1115310228308472e-05,0.0,1.0
50717,치달/Noun,1,1,0,1.1115310228308472e-05,0.0,1.0
50718,수혜자/Noun,1,0,1,0.0,1.1106915165381966e-05,1.0
50719,포토저널리스트/Noun,1,1,0,1.1115310228308472e-05,0.0,1.0
50720,규규규/Noun,1,0,1,0.0,1.1106915165381966e-05,1.0
50721,흐규규규흐/Noun,1,0,1,0.0,1.1106915165381966e-05,1.0
50722,규규/Noun,1,0,1,0.0,1.1106915165381966e-05,1.0
50723,혁권/Noun,1,1,0,1.1115310228308472e-05,0.0,1.0
50724,약수터/Noun,1,0,1,0.0,1.1106915165381966e-05,1.0
50725,난날/Noun,1,1,0,1.1115310228308472e-05,0.0,1.0
50726,한껀/Noun,1,1,0,1.1115310228308472e-05,0.0,1.0
50727,",............/Punctuation",1,0,1,0.0,1.1106915165381966e-05,1.0
50728,이재수/Noun,1,0,1,0.0,1.1106915165381966e-05,1.0
50729,웁쓰/Noun,1,0,1,0.0,1.1106915165381966e-05,1.0
50730,2.4/Number,1,0,1,0.0,1.1106915165381966e-05,1.0
50731,ㄲㄲㅑ/KoreanParticle,1,0,1,0.0,1.1106915165381966e-05,1.0
50732,지상의별처럼/Noun,1,1,0,1.1115310228308472e-05,0.0,1.0
50733,잼께봣쪄/Noun,1,1,0,1.1115310228308472e-05,0.0,1.0
50734,찾아듣다/Verb,1,1,0,1.1115310228308472e-05,0.0,1.0
50735,이게뮈/Noun,1,1,0,1.1115310228308472e-05,0.0,1.0
50736,어려워지다/Verb,1,0,1,0.0,1.1106915165381966e-05,1.0
50737,불현듯이/Noun,1,1,0,1.1115310228308472e-05,0.0,1.0
50738,~~.^^/Punctuation,1,1,0,1.1115310228308472e-05,0.0,1.0
50739,얼늘/Noun,1,0,1,0.0,1.1106915165381966e-05,1.0
50740,촐래/Noun,1,0,1,0.0,1.1106915165381966e-05,1.0
50741,싸다/Adjective,1,0,1,0.0,1.1106915165381966e-05,1.0
50742,품종/Noun,1,0,1,0.0,1.1106915165381966e-05,1.0
50743,본바탕/Noun,1,0,1,0.0,1.1106915165381966e-05,1.0
50744,추태해짐/Noun,1,0,1,0.0,1.1106915165381966e-05,1.0
50745,http://bit.ly/Pkorea/URL,1,1,0,1.1115310228308472e-05,0.0,1.0
50746,아이러니컬하다/Adjective,1,1,0,1.1115310228308472e-05,0.0,1.0
50747,재래식/Noun,1,0,1,0.0,1.1106915165381966e-05,1.0
50748,끆/Noun,1,0,1,0.0,1.1106915165381966e-05,1.0
50749,세계보건기구/Noun,1,0,1,0.0,1.1106915165381966e-05,1.0
50750,알러븅/Noun,1,1,0,1.1115310228308472e-05,0.0,1.0
50751,베데스다/Noun,1,0,1,0.0,1.1106915165381966e-05,1.0
50752,오범석/Noun,1,0,1,0.0,1.1106915165381966e-05,1.0
50753,조재진/Noun,1,0,1,0.0,1.1106915165381966e-05,1.0
50754,라돈치치/Noun,1,0,1,0.0,1.1106915165381966e-05,1.0
50755,고무신/Noun,1,0,1,0.0,1.1106915165381966e-05,1.0
50756,293/Number,1,1,0,1.1115310228308472e-05,0.0,1.0
50757,~~~~~~~~~~!~!~!~!/Punctuation,1,1,0,1.1115310228308472e-05,0.0,1.0
50758,팽생/Noun,1,1,0,1.1115310228308472e-05,0.0,1.0
50759,카페씬/Noun,1,1,0,1.1115310228308472e-05,0.0,1.0
50760,슈래기/Noun,1,0,1,0.0,1.1106915165381966e-05,1.0
50761,이활/Noun,1,1,0,1.1115310228308472e-05,0.0,1.0
50762,대초반영환줄알았다배경음악센스꽝/Foreign,1,0,1,0.0,1.1106915165381966e-05,1.0
50763,마놀/Noun,1,1,0,1.1115310228308472e-05,0.0,1.0
50764,미뤄줏메/Noun,1,1,0,1.1115310228308472e-05,0.0,1.0
50765,없다뇨/Noun,1,1,0,1.1115310228308472e-05,0.0,1.0
50766,인혜엄마/Noun,1,0,1,0.0,1.1106915165381966e-05,1.0
50767,수액/Noun,1,1,0,1.1115310228308472e-05,0.0,1.0
50768,당직/Noun,1,1,0,1.1115310228308472e-05,0.0,1.0
50769,삭히다/Verb,1,0,1,0.0,1.1106915165381966e-05,1.0
50770,",&/Punctuation",1,1,0,1.1115310228308472e-05,0.0,1.0
50771,편지함/Noun,1,1,0,1.1115310228308472e-05,0.0,1.0
50772,名演/Foreign,1,1,0,1.1115310228308472e-05,0.0,1.0
50773,팍나/Noun,1,0,1,0.0,1.1106915165381966e-05,1.0
50774,코멩멩/Noun,1,0,1,0.0,1.1106915165381966e-05,1.0
50775,빡첬/Noun,1,1,0,1.1115310228308472e-05,0.0,1.0
50776,덤피/Noun,1,1,0,1.1115310228308472e-05,0.0,1.0
50777,개똥씬/Noun,1,1,0,1.1115310228308472e-05,0.0,1.0
50778,쌍판/Noun,1,0,1,0.0,1.1106915165381966e-05,1.0
50779,Tvn/Alpha,1,0,1,0.0,1.1106915165381966e-05,1.0
50780,헛소릴/Noun,1,1,0,1.1115310228308472e-05,0.0,1.0
50781,WorLd/Alpha,1,1,0,1.1115310228308472e-05,0.0,1.0
50782,Change/Alpha,1,1,0,1.1115310228308472e-05,0.0,1.0
50783,슬혜씨/Noun,1,0,1,0.0,1.1106915165381966e-05,1.0
50784,http://ys1234.com.ne.kr/URL,1,1,0,1.1115310228308472e-05,0.0,1.0
50785,헌츠맨/Noun,1,1,0,1.1115310228308472e-05,0.0,1.0
50786,71년/Number,1,0,1,0.0,1.1106915165381966e-05,1.0
50787,walk/Alpha,1,1,0,1.1115310228308472e-05,0.0,1.0
50788,action/Alpha,1,0,1,0.0,1.1106915165381966e-05,1.0
50789,발좀/Noun,1,0,1,0.0,1.1106915165381966e-05,1.0
50790,ㅉㄸ/KoreanParticle,1,0,1,0.0,1.1106915165381966e-05,1.0
50791,눌물/Noun,1,1,0,1.1115310228308472e-05,0.0,1.0
50792,깜디/Noun,1,0,1,0.0,1.1106915165381966e-05,1.0
50793,짤즈부르크/Noun,1,1,0,1.1115310228308472e-05,0.0,1.0
50794,흡협/Noun,1,0,1,0.0,1.1106915165381966e-05,1.0
50795,만드다/Noun,1,0,1,0.0,1.1106915165381966e-05,1.0
50796,파운데이션/Noun,1,0,1,0.0,1.1106915165381966e-05,1.0
50797,과메기/Noun,1,1,0,1.1115310228308472e-05,0.0,1.0
50798,사빠/Noun,1,0,1,0.0,1.1106915165381966e-05,1.0
50799,형땜/Noun,1,1,0,1.1115310228308472e-05,0.0,1.0
50800,욕괴/Noun,1,1,0,1.1115310228308472e-05,0.0,1.0
50801,주황색/Noun,1,1,0,1.1115310228308472e-05,0.0,1.0
50802,법정스님/Noun,1,1,0,1.1115310228308472e-05,0.0,1.0
50803,슬몃/Noun,1,1,0,1.1115310228308472e-05,0.0,1.0
50804,존재론/Noun,1,1,0,1.1115310228308472e-05,0.0,1.0
50805,4억/Number,1,0,1,0.0,1.1106915165381966e-05,1.0
50806,400회/Number,1,0,1,0.0,1.1106915165381966e-05,1.0
50807,예술사/Noun,1,1,0,1.1115310228308472e-05,0.0,1.0
50808,니뽄도/Noun,1,0,1,0.0,1.1106915165381966e-05,1.0
50809,잘썻/Noun,1,1,0,1.1115310228308472e-05,0.0,1.0
50810,phone/Alpha,1,1,0,1.1115310228308472e-05,0.0,1.0
50811,모느터/Noun,1,1,0,1.1115310228308472e-05,0.0,1.0
50812,트컨/Noun,1,0,1,0.0,1.1106915165381966e-05,1.0
50813,수수/Noun,1,0,1,0.0,1.1106915165381966e-05,1.0
50814,터부/Noun,1,1,0,1.1115310228308472e-05,0.0,1.0
50815,bl/Alpha,1,0,1,0.0,1.1106915165381966e-05,1.0
50816,정락희/Noun,1,0,1,0.0,1.1106915165381966e-05,1.0
50817,한창때/Noun,1,0,1,0.0,1.1106915165381966e-05,1.0
50818,댣/Noun,1,1,0,1.1115310228308472e-05,0.0,1.0
50819,작중인물/Noun,1,1,0,1.1115310228308472e-05,0.0,1.0
50820,슈류탄/Noun,1,0,1,0.0,1.1106915165381966e-05,1.0
50821,벙커버스터/Noun,1,0,1,0.0,1.1106915165381966e-05,1.0
50822,생포/Noun,1,0,1,0.0,1.1106915165381966e-05,1.0
50823,2580/Number,1,0,1,0.0,1.1106915165381966e-05,1.0
50824,환락/Noun,1,1,0,1.1115310228308472e-05,0.0,1.0
50825,깍두기/Noun,1,0,1,0.0,1.1106915165381966e-05,1.0
50826,칸트/Noun,1,0,1,0.0,1.1106915165381966e-05,1.0
50827,밞는다/Noun,1,0,1,0.0,1.1106915165381966e-05,1.0
50828,2.58/Number,1,1,0,1.1115310228308472e-05,0.0,1.0
50829,tell/Alpha,1,0,1,0.0,1.1106915165381966e-05,1.0
50830,을맞이하여/Foreign,1,1,0,1.1115310228308472e-05,0.0,1.0
50831,그랑죠/Noun,1,0,1,0.0,1.1106915165381966e-05,1.0
50832,나침판/Noun,1,1,0,1.1115310228308472e-05,0.0,1.0
50833,독방/Foreign,1,1,0,1.1115310228308472e-05,0.0,1.0
50834,터프함/Noun,1,1,0,1.1115310228308472e-05,0.0,1.0
50835,돌푸님/Noun,1,1,0,1.1115310228308472e-05,0.0,1.0
50836,액숑/Noun,1,0,1,0.0,1.1106915165381966e-05,1.0
50837,삼파전/Noun,1,0,1,0.0,1.1106915165381966e-05,1.0
50838,빠이/Noun,1,0,1,0.0,1.1106915165381966e-05,1.0
50839,사잔/Noun,1,1,0,1.1115310228308472e-05,0.0,1.0
50840,묘함/Noun,1,1,0,1.1115310228308472e-05,0.0,1.0
50841,작야/Noun,1,0,1,0.0,1.1106915165381966e-05,1.0
50842,초행길/Noun,1,0,1,0.0,1.1106915165381966e-05,1.0
50843,제시제이/Noun,1,0,1,0.0,1.1106915165381966e-05,1.0
50844,애꾿/Noun,1,0,1,0.0,1.1106915165381966e-05,1.0
50845,감복/Noun,1,1,0,1.1115310228308472e-05,0.0,1.0
50846,남의사/Noun,1,0,1,0.0,1.1106915165381966e-05,1.0
50847,다홍색/Noun,1,0,1,0.0,1.1106915165381966e-05,1.0
50848,녀자/Noun,1,0,1,0.0,1.1106915165381966e-05,1.0
50849,UFG/Alpha,1,0,1,0.0,1.1106915165381966e-05,1.0
50850,여꼅다/Noun,1,0,1,0.0,1.1106915165381966e-05,1.0
50851,스퀸십하/Noun,1,0,1,0.0,1.1106915165381966e-05,1.0
50852,코롱/Noun,1,0,1,0.0,1.1106915165381966e-05,1.0
50853,~~~~~~~~~~~~~~~~~~~~~/Punctuation,1,0,1,0.0,1.1106915165381966e-05,1.0
50854,npb/Alpha,1,0,1,0.0,1.1106915165381966e-05,1.0
50855,투톱임/Noun,1,0,1,0.0,1.1106915165381966e-05,1.0
50856,돈암동/Noun,1,1,0,1.1115310228308472e-05,0.0,1.0
50857,sdergjkkllirfgjhj/Alpha,1,0,1,0.0,1.1106915165381966e-05,1.0
50858,진영빠/Noun,1,1,0,1.1115310228308472e-05,0.0,1.0
50859,ㅋㅋㅌㅋ/KoreanParticle,1,1,0,1.1115310228308472e-05,0.0,1.0
50860,차엽님/Noun,1,1,0,1.1115310228308472e-05,0.0,1.0
50861,현승/Noun,1,1,0,1.1115310228308472e-05,0.0,1.0
50862,배면/Noun,1,0,1,0.0,1.1106915165381966e-05,1.0
50863,몬얘/Noun,1,0,1,0.0,1.1106915165381966e-05,1.0
50864,변칙/Noun,1,0,1,0.0,1.1106915165381966e-05,1.0
50865,0.9/Number,1,1,0,1.1115310228308472e-05,0.0,1.0
50866,이긴/Foreign,1,1,0,1.1115310228308472e-05,0.0,1.0
50867,시왕/Noun,1,0,1,0.0,1.1106915165381966e-05,1.0
50868,공과/Noun,1,0,1,0.0,1.1106915165381966e-05,1.0
50869,이아니라/Foreign,1,0,1,0.0,1.1106915165381966e-05,1.0
50870,피니쉬/Noun,1,1,0,1.1115310228308472e-05,0.0,1.0
50871,델어윌/Noun,1,1,0,1.1115310228308472e-05,0.0,1.0
50872,태마/Noun,1,0,1,0.0,1.1106915165381966e-05,1.0
50873,전시회장/Noun,1,1,0,1.1115310228308472e-05,0.0,1.0
50874,아리마/Noun,1,0,1,0.0,1.1106915165381966e-05,1.0
50875,신석기/Noun,1,0,1,0.0,1.1106915165381966e-05,1.0
50876,레게머리/Noun,1,0,1,0.0,1.1106915165381966e-05,1.0
50877,박착욱/Noun,1,0,1,0.0,1.1106915165381966e-05,1.0
50878,80억원/Number,1,0,1,0.0,1.1106915165381966e-05,1.0
50879,정도나옴/Foreign,1,0,1,0.0,1.1106915165381966e-05,1.0
50880,용깅/Noun,1,1,0,1.1115310228308472e-05,0.0,1.0
50881,어헠헠헠허/Noun,1,0,1,0.0,1.1106915165381966e-05,1.0
50882,insignificant/Alpha,1,0,1,0.0,1.1106915165381966e-05,1.0
50883,잡배/Noun,1,0,1,0.0,1.1106915165381966e-05,1.0
50884,83/Number,1,1,0,1.1115310228308472e-05,0.0,1.0
50885,슈게이징/Noun,1,1,0,1.1115310228308472e-05,0.0,1.0
50886,차삐/Noun,1,0,1,0.0,1.1106915165381966e-05,1.0
50887,영화비평/Noun,1,0,1,0.0,1.1106915165381966e-05,1.0
50888,장상/Noun,1,0,1,0.0,1.1106915165381966e-05,1.0
50889,ㅏㅓ/KoreanParticle,1,0,1,0.0,1.1106915165381966e-05,1.0
50890,붇였/Noun,1,0,1,0.0,1.1106915165381966e-05,1.0
50891,일식집/Noun,1,0,1,0.0,1.1106915165381966e-05,1.0
50892,굼/Noun,1,1,0,1.1115310228308472e-05,0.0,1.0
50893,벌칙/Noun,1,0,1,0.0,1.1106915165381966e-05,1.0
50894,나왓어/Noun,1,0,1,0.0,1.1106915165381966e-05,1.0
50895,아오씌/Noun,1,0,1,0.0,1.1106915165381966e-05,1.0
50896,빈사/Noun,1,0,1,0.0,1.1106915165381966e-05,1.0
50897,birds/Alpha,1,1,0,1.1115310228308472e-05,0.0,1.0
50898,feed/Alpha,1,1,0,1.1115310228308472e-05,0.0,1.0
50899,상중하/Noun,1,1,0,1.1115310228308472e-05,0.0,1.0
50900,허경영/Noun,1,0,1,0.0,1.1106915165381966e-05,1.0
50901,홍학표/Noun,1,1,0,1.1115310228308472e-05,0.0,1.0
50902,포경/Noun,1,0,1,0.0,1.1106915165381966e-05,1.0
50903,삵쾡이/Noun,1,0,1,0.0,1.1106915165381966e-05,1.0
50904,dbsd/Alpha,1,0,1,0.0,1.1106915165381966e-05,1.0
50905,핟/Noun,1,0,1,0.0,1.1106915165381966e-05,1.0
50906,。。！/Foreign,1,1,0,1.1115310228308472e-05,0.0,1.0
50907,!>.</Punctuation,1,1,0,1.1115310228308472e-05,0.0,1.0
50908,엮겨워/Noun,1,0,1,0.0,1.1106915165381966e-05,1.0
50909,쇼팰/Noun,1,1,0,1.1115310228308472e-05,0.0,1.0
50910,....^.^/Punctuation,1,1,0,1.1115310228308472e-05,0.0,1.0
50911,8초/Number,1,0,1,0.0,1.1106915165381966e-05,1.0
50912,3천원/Number,1,0,1,0.0,1.1106915165381966e-05,1.0
50913,1/9999999999999999999/Number,1,0,1,0.0,1.1106915165381966e-05,1.0
50914,영공/Noun,1,0,1,0.0,1.1106915165381966e-05,1.0
50915,쳥점/Noun,1,1,0,1.1115310228308472e-05,0.0,1.0
50916,캅깝하다잉/Noun,1,1,0,1.1115310228308472e-05,0.0,1.0
50917,야/Noun,1,1,0,1.1115310228308472e-05,0.0,1.0
50918,욕멐어/Noun,1,1,0,1.1115310228308472e-05,0.0,1.0
50919,jsa/Alpha,1,0,1,0.0,1.1106915165381966e-05,1.0
50920,쉬함/Noun,1,1,0,1.1115310228308472e-05,0.0,1.0
50921,한일관계/Noun,1,1,0,1.1115310228308472e-05,0.0,1.0
50922,냉각/Noun,1,1,0,1.1115310228308472e-05,0.0,1.0
50923,항창/Noun,1,1,0,1.1115310228308472e-05,0.0,1.0
50924,ㅡㅡㅗㅋㅋㅋ/KoreanParticle,1,1,0,1.1115310228308472e-05,0.0,1.0
50925,껄/Foreign,1,1,0,1.1115310228308472e-05,0.0,1.0
50926,장품/Noun,1,0,1,0.0,1.1106915165381966e-05,1.0
50927,코마츠/Noun,1,1,0,1.1115310228308472e-05,0.0,1.0
50928,빌보베긴스/Noun,1,1,0,1.1115310228308472e-05,0.0,1.0
50929,홀어머니/Noun,1,1,0,1.1115310228308472e-05,0.0,1.0
50930,~~~~^*^/Punctuation,1,1,0,1.1115310228308472e-05,0.0,1.0
50931,굿굿굿둣둣/Noun,1,0,1,0.0,1.1106915165381966e-05,1.0
50932,왜끝/Noun,1,0,1,0.0,1.1106915165381966e-05,1.0
50933,피츠너/Noun,1,1,0,1.1115310228308472e-05,0.0,1.0
50934,콘체르토/Noun,1,1,0,1.1115310228308472e-05,0.0,1.0
50935,토했슴/Noun,1,0,1,0.0,1.1106915165381966e-05,1.0
50936,꿍짝/Noun,1,0,1,0.0,1.1106915165381966e-05,1.0
50937,둘쨰딸/Noun,1,1,0,1.1115310228308472e-05,0.0,1.0
50938,드르/Noun,1,0,1,0.0,1.1106915165381966e-05,1.0
50939,울었엉드랬/Noun,1,1,0,1.1115310228308472e-05,0.0,1.0
50940,월런스/Noun,1,1,0,1.1115310228308472e-05,0.0,1.0
50941,사랭해/Noun,1,1,0,1.1115310228308472e-05,0.0,1.0
50942,짤린듯/Noun,1,0,1,0.0,1.1106915165381966e-05,1.0
50943,WORST/Alpha,1,0,1,0.0,1.1106915165381966e-05,1.0
50944,아편전쟁/Noun,1,1,0,1.1115310228308472e-05,0.0,1.0
50945,사즌/Noun,1,1,0,1.1115310228308472e-05,0.0,1.0
50946,킷/Noun,1,1,0,1.1115310228308472e-05,0.0,1.0
50947,피스톤/Noun,1,0,1,0.0,1.1106915165381966e-05,1.0
50948,의랑/Noun,1,1,0,1.1115310228308472e-05,0.0,1.0
50949,스렉털/Noun,1,0,1,0.0,1.1106915165381966e-05,1.0
50950,5.51/Number,1,0,1,0.0,1.1106915165381966e-05,1.0
50951,개맛/Noun,1,0,1,0.0,1.1106915165381966e-05,1.0
50952,달라짜리/Foreign,1,0,1,0.0,1.1106915165381966e-05,1.0
50953,시나이반도/Noun,1,1,0,1.1115310228308472e-05,0.0,1.0
50954,훨배낫다/Noun,1,0,1,0.0,1.1106915165381966e-05,1.0
50955,홀딩/Noun,1,0,1,0.0,1.1106915165381966e-05,1.0
50956,아니랠까/Noun,1,0,1,0.0,1.1106915165381966e-05,1.0
50957,자오웨이/Noun,1,1,0,1.1115310228308472e-05,0.0,1.0
50958,하양색/Noun,1,1,0,1.1115310228308472e-05,0.0,1.0
50959,편집됫/Noun,1,1,0,1.1115310228308472e-05,0.0,1.0
50960,내고봣는데/Foreign,1,1,0,1.1115310228308472e-05,0.0,1.0
50961,9759262/Number,1,0,1,0.0,1.1106915165381966e-05,1.0
50962,9269262/Number,1,0,1,0.0,1.1106915165381966e-05,1.0
50963,농기구/Noun,1,1,0,1.1115310228308472e-05,0.0,1.0
50964,버런/Noun,1,0,1,0.0,1.1106915165381966e-05,1.0
50965,린펜/Noun,1,0,1,0.0,1.1106915165381966e-05,1.0
50966,번쩍이다/Verb,1,1,0,1.1115310228308472e-05,0.0,1.0
50967,이얍/Noun,1,0,1,0.0,1.1106915165381966e-05,1.0
50968,자포/Noun,1,1,0,1.1115310228308472e-05,0.0,1.0
50969,중강/Noun,1,0,1,0.0,1.1106915165381966e-05,1.0
50970,짏/Noun,1,1,0,1.1115310228308472e-05,0.0,1.0
50971,조화로움/Noun,1,1,0,1.1115310228308472e-05,0.0,1.0
50972,습도/Noun,1,0,1,0.0,1.1106915165381966e-05,1.0
50973,미래엔/Noun,1,0,1,0.0,1.1106915165381966e-05,1.0
50974,⊙」※●※⊙/Foreign,1,1,0,1.1115310228308472e-05,0.0,1.0
50975,짜라투스트라/Noun,1,1,0,1.1115310228308472e-05,0.0,1.0
50976,쇼잉없/Noun,1,0,1,0.0,1.1106915165381966e-05,1.0
50977,사변/Noun,1,0,1,0.0,1.1106915165381966e-05,1.0
50978,ㅡㅡㅅㅂ/KoreanParticle,1,0,1,0.0,1.1106915165381966e-05,1.0
50979,한수인/Noun,1,1,0,1.1115310228308472e-05,0.0,1.0
50980,동성연애/Noun,1,0,1,0.0,1.1106915165381966e-05,1.0
50981,adventure/Alpha,1,1,0,1.1115310228308472e-05,0.0,1.0
50982,공화영/Noun,1,1,0,1.1115310228308472e-05,0.0,1.0
50983,셐/Noun,1,0,1,0.0,1.1106915165381966e-05,1.0
50984,쩌는군/Noun,1,1,0,1.1115310228308472e-05,0.0,1.0
50985,잘봤숩니/Noun,1,1,0,1.1115310228308472e-05,0.0,1.0
50986,으케켕/Noun,1,0,1,0.0,1.1106915165381966e-05,1.0
50987,크에엨/Noun,1,0,1,0.0,1.1106915165381966e-05,1.0
50988,남자의자격/Noun,1,0,1,0.0,1.1106915165381966e-05,1.0
50989,라그라지/Noun,1,0,1,0.0,1.1106915165381966e-05,1.0
50990,북경어/Noun,1,0,1,0.0,1.1106915165381966e-05,1.0
50991,라키/Noun,1,0,1,0.0,1.1106915165381966e-05,1.0
50992,이비가/Noun,1,1,0,1.1115310228308472e-05,0.0,1.0
50993,없솧/Noun,1,0,1,0.0,1.1106915165381966e-05,1.0
50994,솧/Noun,1,0,1,0.0,1.1106915165381966e-05,1.0
50995,할당/Noun,1,1,0,1.1115310228308472e-05,0.0,1.0
50996,.?(/Punctuation,1,1,0,1.1115310228308472e-05,0.0,1.0
50997,마켓가든/Noun,1,1,0,1.1115310228308472e-05,0.0,1.0
50998,엑시스텐즈/Noun,1,0,1,0.0,1.1106915165381966e-05,1.0
50999,읿음/Noun,1,0,1,0.0,1.1106915165381966e-05,1.0
51000,일정하다/Adjective,1,0,1,0.0,1.1106915165381966e-05,1.0
51001,돈자/Noun,1,1,0,1.1115310228308472e-05,0.0,1.0
51002,sd/Alpha,1,1,0,1.1115310228308472e-05,0.0,1.0
51003,performances/Alpha,1,1,0,1.1115310228308472e-05,0.0,1.0
51004,Interesting/Alpha,1,1,0,1.1115310228308472e-05,0.0,1.0
51005,Greek/Alpha,1,1,0,1.1115310228308472e-05,0.0,1.0
51006,usual/Alpha,1,1,0,1.1115310228308472e-05,0.0,1.0
51007,different/Alpha,1,1,0,1.1115310228308472e-05,0.0,1.0
51008,화끈화끈/Adverb,1,1,0,1.1115310228308472e-05,0.0,1.0
51009,thanks/Alpha,1,1,0,1.1115310228308472e-05,0.0,1.0
51010,lazlo/Alpha,1,1,0,1.1115310228308472e-05,0.0,1.0
51011,appreciate/Alpha,1,1,0,1.1115310228308472e-05,0.0,1.0
51012,Dog/Alpha,1,0,1,0.0,1.1106915165381966e-05,1.0
51013,합병/Noun,1,0,1,0.0,1.1106915165381966e-05,1.0
51014,닉스/Noun,1,0,1,0.0,1.1106915165381966e-05,1.0
51015,음메/Noun,1,0,1,0.0,1.1106915165381966e-05,1.0
51016,전장군/Noun,1,0,1,0.0,1.1106915165381966e-05,1.0
51017,Cars/Alpha,1,0,1,0.0,1.1106915165381966e-05,1.0
51018,".,/,./,./,./,.//Punctuation",1,0,1,0.0,1.1106915165381966e-05,1.0
51019,학부형/Noun,1,0,1,0.0,1.1106915165381966e-05,1.0
51020,카코/Noun,1,1,0,1.1115310228308472e-05,0.0,1.0
51021,도꾜/Noun,1,1,0,1.1115310228308472e-05,0.0,1.0
51022,돌프영화/Noun,1,1,0,1.1115310228308472e-05,0.0,1.0
51023,텐같/Noun,1,1,0,1.1115310228308472e-05,0.0,1.0
51024,2.25/Number,1,0,1,0.0,1.1106915165381966e-05,1.0
51025,돈버는/Noun,1,0,1,0.0,1.1106915165381966e-05,1.0
51026,480억/Number,1,0,1,0.0,1.1106915165381966e-05,1.0
51027,쇼유/Noun,1,1,0,1.1115310228308472e-05,0.0,1.0
51028,아이캔/Noun,1,1,0,1.1115310228308472e-05,0.0,1.0
51029,이그잼/Noun,1,0,1,0.0,1.1106915165381966e-05,1.0
51030,........?/Punctuation,1,0,1,0.0,1.1106915165381966e-05,1.0
51031,이주철/Noun,1,0,1,0.0,1.1106915165381966e-05,1.0
51032,갑오개혁/Noun,1,0,1,0.0,1.1106915165381966e-05,1.0
51033,퍼디션/Noun,1,0,1,0.0,1.1106915165381966e-05,1.0
51034,돌리시/Noun,1,0,1,0.0,1.1106915165381966e-05,1.0
51035,억조/Modifier,1,0,1,0.0,1.1106915165381966e-05,1.0
51036,선크림/Noun,1,0,1,0.0,1.1106915165381966e-05,1.0
51037,xxxx/Alpha,1,0,1,0.0,1.1106915165381966e-05,1.0
51038,응가뿌직뿌직/Noun,1,0,1,0.0,1.1106915165381966e-05,1.0
51039,윈드/Noun,1,1,0,1.1115310228308472e-05,0.0,1.0
51040,곧다/Adjective,1,1,0,1.1115310228308472e-05,0.0,1.0
51041,테켄만보슈/Noun,1,0,1,0.0,1.1106915165381966e-05,1.0
51042,테켄/Noun,1,0,1,0.0,1.1106915165381966e-05,1.0
51043,三峽/Foreign,1,1,0,1.1115310228308472e-05,0.0,1.0
51044,산샤/Noun,1,1,0,1.1115310228308472e-05,0.0,1.0
51045,즐딸/Noun,1,1,0,1.1115310228308472e-05,0.0,1.0
51046,카덴짜/Noun,1,1,0,1.1115310228308472e-05,0.0,1.0
51047,헤르메스/Noun,1,0,1,0.0,1.1106915165381966e-05,1.0
51048,우웡/Noun,1,1,0,1.1115310228308472e-05,0.0,1.0
51049,...?;;;;;;/Punctuation,1,0,1,0.0,1.1106915165381966e-05,1.0
51050,특수기동대/Noun,1,1,0,1.1115310228308472e-05,0.0,1.0
51051,이성룡/Noun,1,1,0,1.1115310228308472e-05,0.0,1.0
51052,등대/Noun,1,1,0,1.1115310228308472e-05,0.0,1.0
51053,針小棒大/Foreign,1,0,1,0.0,1.1106915165381966e-05,1.0
51054,過猶不及/Foreign,1,0,1,0.0,1.1106915165381966e-05,1.0
51055,龍頭蛇尾/Foreign,1,0,1,0.0,1.1106915165381966e-05,1.0
51056,고삼/Noun,1,1,0,1.1115310228308472e-05,0.0,1.0
51057,무었이었/Noun,1,1,0,1.1115310228308472e-05,0.0,1.0
51058,홍상/Noun,1,1,0,1.1115310228308472e-05,0.0,1.0
51059,(-./Punctuation,1,0,1,0.0,1.1106915165381966e-05,1.0
51060,카디자/Noun,1,1,0,1.1115310228308472e-05,0.0,1.0
51061,소화도/Noun,1,0,1,0.0,1.1106915165381966e-05,1.0
51062,이경희/Noun,1,0,1,0.0,1.1106915165381966e-05,1.0
51063,75/Number,1,0,1,0.0,1.1106915165381966e-05,1.0
51064,칸초/Noun,1,0,1,0.0,1.1106915165381966e-05,1.0
51065,조깅/Noun,1,1,0,1.1115310228308472e-05,0.0,1.0
51066,원고료/Noun,1,0,1,0.0,1.1106915165381966e-05,1.0
51067,짦다는/Noun,1,1,0,1.1115310228308472e-05,0.0,1.0
51068,알바눔/Noun,1,0,1,0.0,1.1106915165381966e-05,1.0
51069,그눔/Noun,1,0,1,0.0,1.1106915165381966e-05,1.0
51070,구별법/Noun,1,0,1,0.0,1.1106915165381966e-05,1.0
51071,눔/Noun,1,0,1,0.0,1.1106915165381966e-05,1.0
51072,한이수/Noun,1,1,0,1.1115310228308472e-05,0.0,1.0
51073,후의/Foreign,1,1,0,1.1115310228308472e-05,0.0,1.0
51074,truman/Alpha,1,0,1,0.0,1.1106915165381966e-05,1.0
51075,쉥/Noun,1,0,1,0.0,1.1106915165381966e-05,1.0
51076,졸려웠다/Noun,1,0,1,0.0,1.1106915165381966e-05,1.0
51077,순천/Noun,1,1,0,1.1115310228308472e-05,0.0,1.0
51078,어절/Noun,1,0,1,0.0,1.1106915165381966e-05,1.0
51079,Baltmore/Alpha,1,1,0,1.1115310228308472e-05,0.0,1.0
51080,Morning/Alpha,1,1,0,1.1115310228308472e-05,0.0,1.0
51081,혔/Noun,1,1,0,1.1115310228308472e-05,0.0,1.0
51082,그렇드/Noun,1,0,1,0.0,1.1106915165381966e-05,1.0
51083,칭칭/Noun,1,0,1,0.0,1.1106915165381966e-05,1.0
51084,춘장/Noun,1,0,1,0.0,1.1106915165381966e-05,1.0
51085,.http://radiokwon.wordpress.com/2014/04/14/%EB%A7%88%EC%9D%B4%EB%B3%B4%EC%9D%B4-%EC%A0%84%EA%B7%9C%ED%99%98-%EA%B0%90%EB%8F%85//URL,1,0,1,0.0,1.1106915165381966e-05,1.0
51086,별루다/Noun,1,0,1,0.0,1.1106915165381966e-05,1.0
51087,잠수씬/Noun,1,1,0,1.1115310228308472e-05,0.0,1.0
51088,각광/Noun,1,1,0,1.1115310228308472e-05,0.0,1.0
51089,온당/Noun,1,1,0,1.1115310228308472e-05,0.0,1.0
51090,구디넙/Noun,1,1,0,1.1115310228308472e-05,0.0,1.0
51091,메시아닉쥬/Noun,1,0,1,0.0,1.1106915165381966e-05,1.0
51092,선시/Noun,1,0,1,0.0,1.1106915165381966e-05,1.0
51093,이자/Foreign,1,1,0,1.1115310228308472e-05,0.0,1.0
51094,버무려/Noun,1,0,1,0.0,1.1106915165381966e-05,1.0
51095,롱생/Noun,1,1,0,1.1115310228308472e-05,0.0,1.0
51096,간곡히/Adverb,1,0,1,0.0,1.1106915165381966e-05,1.0
51097,나왜/Noun,1,0,1,0.0,1.1106915165381966e-05,1.0
51098,뿜는/Noun,1,1,0,1.1115310228308472e-05,0.0,1.0
51099,부술뻔/Noun,1,0,1,0.0,1.1106915165381966e-05,1.0
51100,루써/Noun,1,0,1,0.0,1.1106915165381966e-05,1.0
51101,발주/Noun,1,1,0,1.1115310228308472e-05,0.0,1.0
51102,선각자/Noun,1,1,0,1.1115310228308472e-05,0.0,1.0
51103,계엄/Noun,1,0,1,0.0,1.1106915165381966e-05,1.0
51104,스퍼록/Noun,1,1,0,1.1115310228308472e-05,0.0,1.0
51105,♥♡♥♡/Foreign,1,1,0,1.1115310228308472e-05,0.0,1.0
51106,시품/Noun,1,1,0,1.1115310228308472e-05,0.0,1.0
51107,웅박이후/Noun,1,0,1,0.0,1.1106915165381966e-05,1.0
51108,13-14회/Number,1,0,1,0.0,1.1106915165381966e-05,1.0
51109,말줄임표/Noun,1,0,1,0.0,1.1106915165381966e-05,1.0
51110,박주연/Noun,1,1,0,1.1115310228308472e-05,0.0,1.0
51111,Match/Alpha,1,0,1,0.0,1.1106915165381966e-05,1.0
51112,Audio/Alpha,1,0,1,0.0,1.1106915165381966e-05,1.0
51113,",""/Punctuation",1,0,1,0.0,1.1106915165381966e-05,1.0
51114,Errors/Alpha,1,0,1,0.0,1.1106915165381966e-05,1.0
51115,Editing/Alpha,1,0,1,0.0,1.1106915165381966e-05,1.0
51116,Continuity/Alpha,1,0,1,0.0,1.1106915165381966e-05,1.0
51117,디려/Noun,1,0,1,0.0,1.1106915165381966e-05,1.0
51118,청빈/Noun,1,1,0,1.1115310228308472e-05,0.0,1.0
51119,성실/Noun,1,0,1,0.0,1.1106915165381966e-05,1.0
51120,December/Alpha,1,1,0,1.1115310228308472e-05,0.0,1.0
51121,Upon/Alpha,1,1,0,1.1115310228308472e-05,0.0,1.0
51122,Once/Alpha,1,1,0,1.1115310228308472e-05,0.0,1.0
51123,Twilight/Alpha,1,0,1,0.0,1.1106915165381966e-05,1.0
51124,진화론/Noun,1,1,0,1.1115310228308472e-05,0.0,1.0
51125,아직기/Noun,1,1,0,1.1115310228308472e-05,0.0,1.0
51126,전뇌/Noun,1,1,0,1.1115310228308472e-05,0.0,1.0
51127,눌럿건/Noun,1,0,1,0.0,1.1106915165381966e-05,1.0
51128,진표/Noun,1,0,1,0.0,1.1106915165381966e-05,1.0
51129,걸맛/Noun,1,1,0,1.1115310228308472e-05,0.0,1.0
51130,칭얼대다/Verb,1,1,0,1.1115310228308472e-05,0.0,1.0
51131,돋습닌다/Noun,1,1,0,1.1115310228308472e-05,0.0,1.0
51132,혼쭐나겠/Noun,1,0,1,0.0,1.1106915165381966e-05,1.0
51133,웜블/Noun,1,1,0,1.1115310228308472e-05,0.0,1.0
51134,웸블리/Noun,1,1,0,1.1115310228308472e-05,0.0,1.0
51135,한안/Noun,1,1,0,1.1115310228308472e-05,0.0,1.0
51136,엽다/Noun,1,1,0,1.1115310228308472e-05,0.0,1.0
51137,뀨/Noun,1,1,0,1.1115310228308472e-05,0.0,1.0
51138,유기물/Noun,1,0,1,0.0,1.1106915165381966e-05,1.0
51139,뇌쇄적/Noun,1,0,1,0.0,1.1106915165381966e-05,1.0
51140,왦케/Noun,1,1,0,1.1115310228308472e-05,0.0,1.0
51141,루소/Noun,1,1,0,1.1115310228308472e-05,0.0,1.0
51142,육사/Noun,1,1,0,1.1115310228308472e-05,0.0,1.0
51143,나윤권/Noun,1,1,0,1.1115310228308472e-05,0.0,1.0
51144,꼽고싶/Noun,1,1,0,1.1115310228308472e-05,0.0,1.0
51145,글랜/Noun,1,1,0,1.1115310228308472e-05,0.0,1.0
51146,곪기/Noun,1,1,0,1.1115310228308472e-05,0.0,1.0
51147,비줠/Noun,1,0,1,0.0,1.1106915165381966e-05,1.0
51148,스뮤/Noun,1,1,0,1.1115310228308472e-05,0.0,1.0
51149,?).../Punctuation,1,0,1,0.0,1.1106915165381966e-05,1.0
51150,섲/Noun,1,1,0,1.1115310228308472e-05,0.0,1.0
51151,섳/Noun,1,1,0,1.1115310228308472e-05,0.0,1.0
51152,애프터스쿨/Noun,1,1,0,1.1115310228308472e-05,0.0,1.0
51153,닌어/Noun,1,0,1,0.0,1.1106915165381966e-05,1.0
51154,김재욱/Noun,1,1,0,1.1115310228308472e-05,0.0,1.0
51155,사별/Noun,1,0,1,0.0,1.1106915165381966e-05,1.0
51156,sagelord/Alpha,1,1,0,1.1115310228308472e-05,0.0,1.0
51157,!!!(?)/Punctuation,1,1,0,1.1115310228308472e-05,0.0,1.0
51158,도두/Adverb,1,1,0,1.1115310228308472e-05,0.0,1.0
51159,5000년/Number,1,1,0,1.1115310228308472e-05,0.0,1.0
51160,닶없는/Noun,1,1,0,1.1115310228308472e-05,0.0,1.0
51161,라이거/Noun,1,0,1,0.0,1.1106915165381966e-05,1.0
51162,샣/Noun,1,0,1,0.0,1.1106915165381966e-05,1.0
51163,10.20/Number,1,0,1,0.0,1.1106915165381966e-05,1.0
51164,만에처음/Foreign,1,0,1,0.0,1.1106915165381966e-05,1.0
51165,유모차/Noun,1,1,0,1.1115310228308472e-05,0.0,1.0
51166,대치고는꾀잘만들었군요/Foreign,1,1,0,1.1115310228308472e-05,0.0,1.0
51167,48975438975023%/Number,1,0,1,0.0,1.1106915165381966e-05,1.0
51168,뭐말/Noun,1,0,1,0.0,1.1106915165381966e-05,1.0
51169,Brunda/Alpha,1,1,0,1.1115310228308472e-05,0.0,1.0
51170,Jeanette/Alpha,1,1,0,1.1115310228308472e-05,0.0,1.0
51171,Elam/Alpha,1,1,0,1.1115310228308472e-05,0.0,1.0
51172,Hattie/Alpha,1,1,0,1.1115310228308472e-05,0.0,1.0
51173,1952/Number,1,1,0,1.1115310228308472e-05,0.0,1.0
51174,Wilcoxson/Alpha,1,1,0,1.1115310228308472e-05,0.0,1.0
51175,Junetta/Alpha,1,1,0,1.1115310228308472e-05,0.0,1.0
51176,times/Alpha,1,1,0,1.1115310228308472e-05,0.0,1.0
51177,three/Alpha,1,1,0,1.1115310228308472e-05,0.0,1.0
51178,divorced/Alpha,1,1,0,1.1115310228308472e-05,0.0,1.0
51179,married/Alpha,1,1,0,1.1115310228308472e-05,0.0,1.0
51180,Brashear/Alpha,1,1,0,1.1115310228308472e-05,0.0,1.0
51181,위키/Noun,1,1,0,1.1115310228308472e-05,0.0,1.0
51182,160/Number,1,0,1,0.0,1.1106915165381966e-05,1.0
51183,",,^^;;;/Punctuation",1,0,1,0.0,1.1106915165381966e-05,1.0
51184,김영하/Noun,1,1,0,1.1115310228308472e-05,0.0,1.0
51185,앤쫌/Noun,1,0,1,0.0,1.1106915165381966e-05,1.0
51186,전투복/Noun,1,0,1,0.0,1.1106915165381966e-05,1.0
51187,나도슬펏다/Noun,1,1,0,1.1115310228308472e-05,0.0,1.0
51188,유콜/Noun,1,1,0,1.1115310228308472e-05,0.0,1.0
51189,스털링/Noun,1,1,0,1.1115310228308472e-05,0.0,1.0
51190,》/Foreign,1,1,0,1.1115310228308472e-05,0.0,1.0
51191,《/Foreign,1,1,0,1.1115310228308472e-05,0.0,1.0
51192,눌리/Noun,1,0,1,0.0,1.1106915165381966e-05,1.0
51193,말초/Noun,1,1,0,1.1115310228308472e-05,0.0,1.0
51194,24억/Number,1,0,1,0.0,1.1106915165381966e-05,1.0
51195,결연하다/Adjective,1,0,1,0.0,1.1106915165381966e-05,1.0
51196,쥇일/Noun,1,0,1,0.0,1.1106915165381966e-05,1.0
51197,건정/Adverb,1,0,1,0.0,1.1106915165381966e-05,1.0
51198,박은지/Noun,1,0,1,0.0,1.1106915165381966e-05,1.0
51199,결제해서봣다가/Foreign,1,0,1,0.0,1.1106915165381966e-05,1.0
51200,철도사고/Noun,1,0,1,0.0,1.1106915165381966e-05,1.0
51201,채무/Noun,1,0,1,0.0,1.1106915165381966e-05,1.0
51202,5000억/Number,1,0,1,0.0,1.1106915165381966e-05,1.0
51203,JR/Alpha,1,0,1,0.0,1.1106915165381966e-05,1.0
51204,일본국철/Noun,1,0,1,0.0,1.1106915165381966e-05,1.0
51205,마다선전하믄/Foreign,1,0,1,0.0,1.1106915165381966e-05,1.0
51206,또재/Noun,1,0,1,0.0,1.1106915165381966e-05,1.0
51207,아이돌마스터/Noun,1,0,1,0.0,1.1106915165381966e-05,1.0
51208,interrupted/Alpha,1,1,0,1.1115310228308472e-05,0.0,1.0
51209,ㅅㅐㄲ/KoreanParticle,1,0,1,0.0,1.1106915165381966e-05,1.0
51210,됫었겠다/Noun,1,0,1,0.0,1.1106915165381966e-05,1.0
51211,잼꿀잼/Noun,1,1,0,1.1115310228308472e-05,0.0,1.0
51212,초아/Noun,1,0,1,0.0,1.1106915165381966e-05,1.0
51213,곽은진/Noun,1,0,1,0.0,1.1106915165381966e-05,1.0
51214,양서류/Noun,1,1,0,1.1115310228308472e-05,0.0,1.0
51215,요다음/Noun,1,1,0,1.1115310228308472e-05,0.0,1.0
51216,지배구조/Noun,1,1,0,1.1115310228308472e-05,0.0,1.0
51217,일신/Noun,1,1,0,1.1115310228308472e-05,0.0,1.0
51218,버르/Noun,1,0,1,0.0,1.1106915165381966e-05,1.0
51219,오구구/Adverb,1,0,1,0.0,1.1106915165381966e-05,1.0
51220,remember/Alpha,1,1,0,1.1115310228308472e-05,0.0,1.0
51221,브리티시/Noun,1,1,0,1.1115310228308472e-05,0.0,1.0
51222,운혁/Noun,1,1,0,1.1115310228308472e-05,0.0,1.0
51223,첨봣는데/Noun,1,1,0,1.1115310228308472e-05,0.0,1.0
51224,콜래트럴/Noun,1,0,1,0.0,1.1106915165381966e-05,1.0
51225,실핏줄/Noun,1,0,1,0.0,1.1106915165381966e-05,1.0
51226,손뼉/Noun,1,0,1,0.0,1.1106915165381966e-05,1.0
51227,봉사자/Noun,1,1,0,1.1115310228308472e-05,0.0,1.0
51228,차제/Noun,1,0,1,0.0,1.1106915165381966e-05,1.0
51229,얼탱/Noun,1,0,1,0.0,1.1106915165381966e-05,1.0
51230,붕어/Noun,1,0,1,0.0,1.1106915165381966e-05,1.0
51231,퀘퀘/Noun,1,0,1,0.0,1.1106915165381966e-05,1.0
51232,골인/Noun,1,0,1,0.0,1.1106915165381966e-05,1.0
51233,처땜/Noun,1,0,1,0.0,1.1106915165381966e-05,1.0
51234,Everythig/Alpha,1,1,0,1.1115310228308472e-05,0.0,1.0
51235,5~600/Number,1,0,1,0.0,1.1106915165381966e-05,1.0
51236,구티/Noun,1,1,0,1.1115310228308472e-05,0.0,1.0
51237,완패/Noun,1,0,1,0.0,1.1106915165381966e-05,1.0
51238,지표면/Noun,1,0,1,0.0,1.1106915165381966e-05,1.0
51239,플라멩코/Noun,1,1,0,1.1115310228308472e-05,0.0,1.0
51240,윰목민/Noun,1,1,0,1.1115310228308472e-05,0.0,1.0
51241,유목민/Noun,1,1,0,1.1115310228308472e-05,0.0,1.0
51242,툰드라/Noun,1,1,0,1.1115310228308472e-05,0.0,1.0
51243,찌완/Noun,1,1,0,1.1115310228308472e-05,0.0,1.0
51244,♨♨♨♨/Foreign,1,0,1,0.0,1.1106915165381966e-05,1.0
51245,이백만/Noun,1,1,0,1.1115310228308472e-05,0.0,1.0
51246,만송/Noun,1,1,0,1.1115310228308472e-05,0.0,1.0
51247,크리스마스이브/Noun,1,1,0,1.1115310228308472e-05,0.0,1.0
51248,bluray/Alpha,1,0,1,0.0,1.1106915165381966e-05,1.0
51249,1080/Number,1,0,1,0.0,1.1106915165381966e-05,1.0
51250,엑윽엑엑/Noun,1,0,1,0.0,1.1106915165381966e-05,1.0
51251,스탑/Noun,1,0,1,0.0,1.1106915165381966e-05,1.0
51252,프르/Noun,1,0,1,0.0,1.1106915165381966e-05,1.0
51253,.^:/Punctuation,1,1,0,1.1115310228308472e-05,0.0,1.0
51254,매매혼/Noun,1,0,1,0.0,1.1106915165381966e-05,1.0
51255,화양극장/Noun,1,1,0,1.1115310228308472e-05,0.0,1.0
51256,서대문/Noun,1,1,0,1.1115310228308472e-05,0.0,1.0
51257,팜케얀센/Noun,1,0,1,0.0,1.1106915165381966e-05,1.0
51258,확증/Noun,1,1,0,1.1115310228308472e-05,0.0,1.0
51259,주고도/Foreign,1,0,1,0.0,1.1106915165381966e-05,1.0
51260,문제해결/Noun,1,1,0,1.1115310228308472e-05,0.0,1.0
51261,~~~(>_/Punctuation,1,0,1,0.0,1.1106915165381966e-05,1.0
51262,출세가도/Noun,1,0,1,0.0,1.1106915165381966e-05,1.0
51263,어쩌잔건/Noun,1,0,1,0.0,1.1106915165381966e-05,1.0
51264,사학/Noun,1,1,0,1.1115310228308472e-05,0.0,1.0
51265,오권/Noun,1,1,0,1.1115310228308472e-05,0.0,1.0
51266,나무늘보/Noun,1,1,0,1.1115310228308472e-05,0.0,1.0
51267,욕할껄/Noun,1,0,1,0.0,1.1106915165381966e-05,1.0
51268,동기화/Noun,1,0,1,0.0,1.1106915165381966e-05,1.0
51269,박현우/Noun,1,1,0,1.1115310228308472e-05,0.0,1.0
51270,identity/Alpha,1,1,0,1.1115310228308472e-05,0.0,1.0
51271,내무실/Noun,1,1,0,1.1115310228308472e-05,0.0,1.0
51272,town/Alpha,1,1,0,1.1115310228308472e-05,0.0,1.0
51273,앳되/Noun,1,0,1,0.0,1.1106915165381966e-05,1.0
51274,이각/Noun,1,1,0,1.1115310228308472e-05,0.0,1.0
51275,리저/Noun,1,0,1,0.0,1.1106915165381966e-05,1.0
51276,불매운동/Noun,1,0,1,0.0,1.1106915165381966e-05,1.0
51277,ㄱㅏㅁ/KoreanParticle,1,0,1,0.0,1.1106915165381966e-05,1.0
51278,리한나/Noun,1,0,1,0.0,1.1106915165381966e-05,1.0
51279,액션쩌/Noun,1,1,0,1.1115310228308472e-05,0.0,1.0
51280,팬됫는데/Noun,1,1,0,1.1115310228308472e-05,0.0,1.0
51281,컼/Noun,1,1,0,1.1115310228308472e-05,0.0,1.0
51282,코메티/Noun,1,1,0,1.1115310228308472e-05,0.0,1.0
51283,레지블/Noun,1,0,1,0.0,1.1106915165381966e-05,1.0
51284,orientation/Alpha,1,1,0,1.1115310228308472e-05,0.0,1.0
51285,sexual/Alpha,1,1,0,1.1115310228308472e-05,0.0,1.0
51286,religion/Alpha,1,1,0,1.1115310228308472e-05,0.0,1.0
51287,color/Alpha,1,1,0,1.1115310228308472e-05,0.0,1.0
51288,creed/Alpha,1,1,0,1.1115310228308472e-05,0.0,1.0
51289,race/Alpha,1,1,0,1.1115310228308472e-05,0.0,1.0
51290,matters/Alpha,1,1,0,1.1115310228308472e-05,0.0,1.0
51291,blind/Alpha,1,1,0,1.1115310228308472e-05,0.0,1.0
51292,상표권/Noun,1,0,1,0.0,1.1106915165381966e-05,1.0
51293,체로키/Noun,1,1,0,1.1115310228308472e-05,0.0,1.0
51294,재빨리/Adverb,1,1,0,1.1115310228308472e-05,0.0,1.0
51295,대체어/Noun,1,0,1,0.0,1.1106915165381966e-05,1.0
51296,펌하하/Noun,1,1,0,1.1115310228308472e-05,0.0,1.0
51297,디캐프리오/Noun,1,1,0,1.1115310228308472e-05,0.0,1.0
51298,FACE/Alpha,1,1,0,1.1115310228308472e-05,0.0,1.0
51299,SOUTH/Alpha,1,1,0,1.1115310228308472e-05,0.0,1.0
51300,해드윅/Noun,1,1,0,1.1115310228308472e-05,0.0,1.0
51301,호접몽/Noun,1,1,0,1.1115310228308472e-05,0.0,1.0
51302,car/Alpha,1,1,0,1.1115310228308472e-05,0.0,1.0
51303,옿아해/Noun,1,1,0,1.1115310228308472e-05,0.0,1.0
51304,연애경험/Noun,1,1,0,1.1115310228308472e-05,0.0,1.0
51305,급증/Noun,1,0,1,0.0,1.1106915165381966e-05,1.0
51306,쪾/Noun,1,0,1,0.0,1.1106915165381966e-05,1.0
51307,용굿/Noun,1,1,0,1.1115310228308472e-05,0.0,1.0
51308,"...,.,.,.,..,.,/Punctuation",1,1,0,1.1115310228308472e-05,0.0,1.0
51309,방조명/Noun,1,0,1,0.0,1.1106915165381966e-05,1.0
51310,이이경/Noun,1,1,0,1.1115310228308472e-05,0.0,1.0
51311,질섹/Noun,1,0,1,0.0,1.1106915165381966e-05,1.0
51312,조직폭력배/Noun,1,0,1,0.0,1.1106915165381966e-05,1.0
51313,369/Number,1,1,0,1.1115310228308472e-05,0.0,1.0
51314,죽방/Noun,1,0,1,0.0,1.1106915165381966e-05,1.0
51315,드온드/Noun,1,0,1,0.0,1.1106915165381966e-05,1.0
51316,점작/Noun,1,0,1,0.0,1.1106915165381966e-05,1.0
51317,튜닝해/Noun,1,0,1,0.0,1.1106915165381966e-05,1.0
51318,친아버지/Noun,1,0,1,0.0,1.1106915165381966e-05,1.0
51319,작품/Foreign,1,1,0,1.1115310228308472e-05,0.0,1.0
51320,캐시디/Noun,1,1,0,1.1115310228308472e-05,0.0,1.0
51321,발꿈치/Noun,1,0,1,0.0,1.1106915165381966e-05,1.0
51322,안미나/Noun,1,1,0,1.1115310228308472e-05,0.0,1.0
51323,",............./Punctuation",1,1,0,1.1115310228308472e-05,0.0,1.0
51324,헤서웨/Noun,1,0,1,0.0,1.1106915165381966e-05,1.0
51325,",.,.,.,.,.,.,.,./Punctuation",1,0,1,0.0,1.1106915165381966e-05,1.0
51326,11회/Number,1,1,0,1.1115310228308472e-05,0.0,1.0
51327,7.12/Number,1,1,0,1.1115310228308472e-05,0.0,1.0
51328,황재/Noun,1,1,0,1.1115310228308472e-05,0.0,1.0
51329,번드르/Noun,1,0,1,0.0,1.1106915165381966e-05,1.0
51330,1909년/Number,1,0,1,0.0,1.1106915165381966e-05,1.0
51331,!!!/Foreign,1,1,0,1.1115310228308472e-05,0.0,1.0
51332,탄저균/Noun,1,0,1,0.0,1.1106915165381966e-05,1.0
51333,욲껴/Noun,1,1,0,1.1115310228308472e-05,0.0,1.0
51334,안봣은데/Noun,1,1,0,1.1115310228308472e-05,0.0,1.0
51335,러시아혁명/Noun,1,0,1,0.0,1.1106915165381966e-05,1.0
51336,제정러시아/Noun,1,0,1,0.0,1.1106915165381966e-05,1.0
51337,에버레스트/Noun,1,0,1,0.0,1.1106915165381966e-05,1.0
51338,34분/Number,1,0,1,0.0,1.1106915165381966e-05,1.0
51339,슈운/Noun,1,1,0,1.1115310228308472e-05,0.0,1.0
51340,8.50/Number,1,1,0,1.1115310228308472e-05,0.0,1.0
51341,구십여/Modifier,1,1,0,1.1115310228308472e-05,0.0,1.0
51342,틱틱/Noun,1,0,1,0.0,1.1106915165381966e-05,1.0
51343,병규/Noun,1,0,1,0.0,1.1106915165381966e-05,1.0
51344,강병규/Noun,1,0,1,0.0,1.1106915165381966e-05,1.0
51345,피라미/Noun,1,0,1,0.0,1.1106915165381966e-05,1.0
51346,잔챙이/Noun,1,0,1,0.0,1.1106915165381966e-05,1.0
51347,ghlgklgklgkl/Alpha,1,1,0,1.1115310228308472e-05,0.0,1.0
51348,hj/Alpha,1,1,0,1.1115310228308472e-05,0.0,1.0
51349,lh/Alpha,1,1,0,1.1115310228308472e-05,0.0,1.0
51350,컴투/Noun,1,0,1,0.0,1.1106915165381966e-05,1.0
51351,들은/Foreign,1,1,0,1.1115310228308472e-05,0.0,1.0
51352,7080분/Number,1,1,0,1.1115310228308472e-05,0.0,1.0
51353,모터쇼/Noun,1,0,1,0.0,1.1106915165381966e-05,1.0
51354,오윤홍/Noun,1,1,0,1.1115310228308472e-05,0.0,1.0
51355,"..-.,-/Punctuation",1,0,1,0.0,1.1106915165381966e-05,1.0
51356,춘추전국/Noun,1,1,0,1.1115310228308472e-05,0.0,1.0
51357,프시/Noun,1,1,0,1.1115310228308472e-05,0.0,1.0
51358,좋앗엇요/Noun,1,1,0,1.1115310228308472e-05,0.0,1.0
51359,영화떄문/Noun,1,0,1,0.0,1.1106915165381966e-05,1.0
51360,전대사/Noun,1,1,0,1.1115310228308472e-05,0.0,1.0
51361,백색왜성/Noun,1,1,0,1.1115310228308472e-05,0.0,1.0
51362,철학가/Noun,1,1,0,1.1115310228308472e-05,0.0,1.0
51363,힘들떄/Noun,1,1,0,1.1115310228308472e-05,0.0,1.0
51364,욘시/Noun,1,1,0,1.1115310228308472e-05,0.0,1.0
51365,(!?)/Punctuation,1,1,0,1.1115310228308472e-05,0.0,1.0
51366,땜애/Noun,1,0,1,0.0,1.1106915165381966e-05,1.0
51367,http://io9.com/fact-or-fiction-horror-moves-that-claim-to-be-based-o-1597156875/URL,1,0,1,0.0,1.1106915165381966e-05,1.0
51368,LOTTE/Alpha,1,1,0,1.1115310228308472e-05,0.0,1.0
51369,퀄릿/Noun,1,0,1,0.0,1.1106915165381966e-05,1.0
51370,이범학/Noun,1,0,1,0.0,1.1106915165381966e-05,1.0
51371,호곡/Noun,1,0,1,0.0,1.1106915165381966e-05,1.0
51372,진밀/Noun,1,0,1,0.0,1.1106915165381966e-05,1.0
51373,디물/Noun,1,0,1,0.0,1.1106915165381966e-05,1.0
51374,에게와/Josa,1,1,0,1.1115310228308472e-05,0.0,1.0
51375,soul/Alpha,1,1,0,1.1115310228308472e-05,0.0,1.0
51376,얏타맨/Noun,1,1,0,1.1115310228308472e-05,0.0,1.0
51377,도깨비/Noun,1,0,1,0.0,1.1106915165381966e-05,1.0
51378,뻔쩍/Noun,1,0,1,0.0,1.1106915165381966e-05,1.0
51379,ballbuster/Alpha,1,0,1,0.0,1.1106915165381966e-05,1.0
51380,stupid/Alpha,1,0,1,0.0,1.1106915165381966e-05,1.0
51381,brainless/Alpha,1,0,1,0.0,1.1106915165381966e-05,1.0
51382,동류/Noun,1,0,1,0.0,1.1106915165381966e-05,1.0
51383,속단/Noun,1,1,0,1.1115310228308472e-05,0.0,1.0
51384,슬며시/Adverb,1,0,1,0.0,1.1106915165381966e-05,1.0
51385,껄떡/Noun,1,0,1,0.0,1.1106915165381966e-05,1.0
51386,^______^/Punctuation,1,1,0,1.1115310228308472e-05,0.0,1.0
51387,destiny/Alpha,1,1,0,1.1115310228308472e-05,0.0,1.0
51388,￣▽￣/Foreign,1,1,0,1.1115310228308472e-05,0.0,1.0
51389,+-+/Punctuation,1,1,0,1.1115310228308472e-05,0.0,1.0
51390,그러스므/Noun,1,0,1,0.0,1.1106915165381966e-05,1.0
51391,세결여/Noun,1,0,1,0.0,1.1106915165381966e-05,1.0
51392,아이스맨/Noun,1,1,0,1.1115310228308472e-05,0.0,1.0
51393,본스/Noun,1,0,1,0.0,1.1106915165381966e-05,1.0
51394,넓이/Noun,1,0,1,0.0,1.1106915165381966e-05,1.0
51395,화서/Noun,1,0,1,0.0,1.1106915165381966e-05,1.0
51396,의결투/Foreign,1,0,1,0.0,1.1106915165381966e-05,1.0
51397,박강/Noun,1,1,0,1.1115310228308472e-05,0.0,1.0
51398,만에정말재밌게/Foreign,1,1,0,1.1115310228308472e-05,0.0,1.0
51399,컨택트/Noun,1,1,0,1.1115310228308472e-05,0.0,1.0
51400,거람/Noun,1,0,1,0.0,1.1106915165381966e-05,1.0
51401,백김치/Noun,1,0,1,0.0,1.1106915165381966e-05,1.0
51402,流水/Foreign,1,0,1,0.0,1.1106915165381966e-05,1.0
51403,유수/Noun,1,0,1,0.0,1.1106915165381966e-05,1.0
51404,요가씬/Noun,1,0,1,0.0,1.1106915165381966e-05,1.0
51405,노틸러스호/Noun,1,1,0,1.1115310228308472e-05,0.0,1.0
51406,디멘터/Noun,1,0,1,0.0,1.1106915165381966e-05,1.0
51407,굿임돠/Noun,1,1,0,1.1115310228308472e-05,0.0,1.0
51408,대의영화지만/Foreign,1,1,0,1.1115310228308472e-05,0.0,1.0
51409,결핵/Noun,1,1,0,1.1115310228308472e-05,0.0,1.0
51410,끝펀/Noun,1,0,1,0.0,1.1106915165381966e-05,1.0
51411,토를/Noun,1,0,1,0.0,1.1106915165381966e-05,1.0
51412,쿠폰/Noun,1,0,1,0.0,1.1106915165381966e-05,1.0
51413,낚을려/Noun,1,0,1,0.0,1.1106915165381966e-05,1.0
51414,행차/Noun,1,0,1,0.0,1.1106915165381966e-05,1.0
51415,고려말/Noun,1,0,1,0.0,1.1106915165381966e-05,1.0
51416,짱이얌/Noun,1,1,0,1.1115310228308472e-05,0.0,1.0
51417,일리아드/Noun,1,1,0,1.1115310228308472e-05,0.0,1.0
51418,비하치/Noun,1,1,0,1.1115310228308472e-05,0.0,1.0
51419,중매/Noun,1,0,1,0.0,1.1106915165381966e-05,1.0
51420,잎사귀/Noun,1,0,1,0.0,1.1106915165381966e-05,1.0
51421,이힛/Noun,1,1,0,1.1115310228308472e-05,0.0,1.0
51422,걸쳐서/Foreign,1,1,0,1.1115310228308472e-05,0.0,1.0
51423,900년/Number,1,1,0,1.1115310228308472e-05,0.0,1.0
51424,극한환경/Noun,1,1,0,1.1115310228308472e-05,0.0,1.0
51425,촉진/Noun,1,1,0,1.1115310228308472e-05,0.0,1.0
51426,바나나킥/Noun,1,0,1,0.0,1.1106915165381966e-05,1.0
51427,벌엇을정/Noun,1,0,1,0.0,1.1106915165381966e-05,1.0
51428,꼭빵터/Noun,1,1,0,1.1115310228308472e-05,0.0,1.0
51429,김경식/Noun,1,1,0,1.1115310228308472e-05,0.0,1.0
51430,논산훈련소/Noun,1,1,0,1.1115310228308472e-05,0.0,1.0
51431,돟을/Noun,1,1,0,1.1115310228308472e-05,0.0,1.0
51432,두우항/Noun,1,1,0,1.1115310228308472e-05,0.0,1.0
51433,애리뇬/Noun,1,0,1,0.0,1.1106915165381966e-05,1.0
51434,컬렉터/Noun,1,0,1,0.0,1.1106915165381966e-05,1.0
51435,반전에찍은거면/Foreign,1,1,0,1.1115310228308472e-05,0.0,1.0
51436,웃겻기/Noun,1,0,1,0.0,1.1106915165381966e-05,1.0
51437,폐부/Noun,1,1,0,1.1115310228308472e-05,0.0,1.0
51438,WHY/Alpha,1,1,0,1.1115310228308472e-05,0.0,1.0
51439,건덕/Adverb,1,0,1,0.0,1.1106915165381966e-05,1.0
51440,녀전/Noun,1,1,0,1.1115310228308472e-05,0.0,1.0
51441,내밷으/Noun,1,0,1,0.0,1.1106915165381966e-05,1.0
51442,르와느/Noun,1,0,1,0.0,1.1106915165381966e-05,1.0
51443,괘안음/Noun,1,1,0,1.1115310228308472e-05,0.0,1.0
51444,하냔/Noun,1,0,1,0.0,1.1106915165381966e-05,1.0
51445,몬초/Noun,1,1,0,1.1115310228308472e-05,0.0,1.0
51446,꽃미녀/Noun,1,0,1,0.0,1.1106915165381966e-05,1.0
51447,김지숙/Noun,1,1,0,1.1115310228308472e-05,0.0,1.0
51448,12345/Number,1,1,0,1.1115310228308472e-05,0.0,1.0
51449,체감온도/Noun,1,1,0,1.1115310228308472e-05,0.0,1.0
51450,기온/Noun,1,1,0,1.1115310228308472e-05,0.0,1.0
51451,47.2%/Number,1,1,0,1.1115310228308472e-05,0.0,1.0
51452,이규원/Noun,1,1,0,1.1115310228308472e-05,0.0,1.0
51453,혜지/Noun,1,1,0,1.1115310228308472e-05,0.0,1.0
51454,큐알/Noun,1,1,0,1.1115310228308472e-05,0.0,1.0
51455,밍숙맹숙/Noun,1,0,1,0.0,1.1106915165381966e-05,1.0
51456,FILE/Alpha,1,1,0,1.1115310228308472e-05,0.0,1.0
51457,wlsWkfh/Alpha,1,0,1,0.0,1.1106915165381966e-05,1.0
51458,바쿠/Noun,1,1,0,1.1115310228308472e-05,0.0,1.0
51459,점달/Noun,1,1,0,1.1115310228308472e-05,0.0,1.0
51460,........././Punctuation,1,0,1,0.0,1.1106915165381966e-05,1.0
51461,역광/Noun,1,0,1,0.0,1.1106915165381966e-05,1.0
51462,노래들/Foreign,1,1,0,1.1115310228308472e-05,0.0,1.0
51463,절대영도/Noun,1,0,1,0.0,1.1106915165381966e-05,1.0
51464,쫑났어/Noun,1,0,1,0.0,1.1106915165381966e-05,1.0
51465,자연스럼/Noun,1,1,0,1.1115310228308472e-05,0.0,1.0
51466,랜섬/Noun,1,0,1,0.0,1.1106915165381966e-05,1.0
51467,반담횽/Noun,1,1,0,1.1115310228308472e-05,0.0,1.0
51468,거또/Noun,1,0,1,0.0,1.1106915165381966e-05,1.0
51469,브일/Noun,1,0,1,0.0,1.1106915165381966e-05,1.0
51470,선드라록/Noun,1,0,1,0.0,1.1106915165381966e-05,1.0
51471,겡끼/Noun,1,1,0,1.1115310228308472e-05,0.0,1.0
51472,번정/Noun,1,1,0,1.1115310228308472e-05,0.0,1.0
51473,btv/Alpha,1,1,0,1.1115310228308472e-05,0.0,1.0
51474,몬텐슨/Noun,1,1,0,1.1115310228308472e-05,0.0,1.0
51475,때책안/Noun,1,0,1,0.0,1.1106915165381966e-05,1.0
51476,룰라/Noun,1,0,1,0.0,1.1106915165381966e-05,1.0
51477,칫섬칫/Noun,1,0,1,0.0,1.1106915165381966e-05,1.0
51478,노조탄압/Noun,1,1,0,1.1115310228308472e-05,0.0,1.0
51479,삭감/Noun,1,1,0,1.1115310228308472e-05,0.0,1.0
51480,hahahah/Alpha,1,0,1,0.0,1.1106915165381966e-05,1.0
51481,pigs/Alpha,1,0,1,0.0,1.1106915165381966e-05,1.0
51482,wkvud/Alpha,1,1,0,1.1115310228308472e-05,0.0,1.0
51483,샹아차/Noun,1,0,1,0.0,1.1106915165381966e-05,1.0
51484,졷됨/Noun,1,1,0,1.1115310228308472e-05,0.0,1.0
51485,대영화여서/Foreign,1,0,1,0.0,1.1106915165381966e-05,1.0
51486,비빔/Noun,1,0,1,0.0,1.1106915165381966e-05,1.0
51487,영국사람/Noun,1,0,1,0.0,1.1106915165381966e-05,1.0
51488,무쉰/Noun,1,0,1,0.0,1.1106915165381966e-05,1.0
51489,였/Noun,1,1,0,1.1115310228308472e-05,0.0,1.0
51490,깇다/Noun,1,1,0,1.1115310228308472e-05,0.0,1.0
51491,ㅏㅌ/KoreanParticle,1,1,0,1.1115310228308472e-05,0.0,1.0
51492,에개봉한것인데/Foreign,1,1,0,1.1115310228308472e-05,0.0,1.0
51493,이진아/Noun,1,0,1,0.0,1.1106915165381966e-05,1.0
51494,장혜진/Noun,1,0,1,0.0,1.1106915165381966e-05,1.0
51495,이설아/Noun,1,0,1,0.0,1.1106915165381966e-05,1.0
51496,Clayton/Alpha,1,1,0,1.1115310228308472e-05,0.0,1.0
51497,보비/Noun,1,1,0,1.1115310228308472e-05,0.0,1.0
51498,밌었/Noun,1,1,0,1.1115310228308472e-05,0.0,1.0
51499,교태/Noun,1,0,1,0.0,1.1106915165381966e-05,1.0
51500,빙산/Noun,1,1,0,1.1115310228308472e-05,0.0,1.0
51501,춥다/Noun,1,1,0,1.1115310228308472e-05,0.0,1.0
51502,표민수/Noun,1,0,1,0.0,1.1106915165381966e-05,1.0
51503,스플린터/Noun,1,0,1,0.0,1.1106915165381966e-05,1.0
51504,중딍/Noun,1,1,0,1.1115310228308472e-05,0.0,1.0
51505,나레이터/Noun,1,0,1,0.0,1.1106915165381966e-05,1.0
51506,듬니/Noun,1,1,0,1.1115310228308472e-05,0.0,1.0
51507,거땜시/Noun,1,0,1,0.0,1.1106915165381966e-05,1.0
51508,^-^?/Punctuation,1,0,1,0.0,1.1106915165381966e-05,1.0
51509,tenbird/Alpha,1,0,1,0.0,1.1106915165381966e-05,1.0
51510,긍/Noun,1,1,0,1.1115310228308472e-05,0.0,1.0
51511,전초전/Noun,1,0,1,0.0,1.1106915165381966e-05,1.0
51512,헛먹었/Noun,1,0,1,0.0,1.1106915165381966e-05,1.0
51513,말랭이/Noun,1,1,0,1.1115310228308472e-05,0.0,1.0
51514,스고이/Noun,1,0,1,0.0,1.1106915165381966e-05,1.0
51515,어버지/Noun,1,1,0,1.1115310228308472e-05,0.0,1.0
51516,사마라/Noun,1,0,1,0.0,1.1106915165381966e-05,1.0
51517,내력/Noun,1,0,1,0.0,1.1106915165381966e-05,1.0
51518,횡단보도/Noun,1,0,1,0.0,1.1106915165381966e-05,1.0
51519,번돈/Noun,1,0,1,0.0,1.1106915165381966e-05,1.0
51520,뱃가이/Noun,1,1,0,1.1115310228308472e-05,0.0,1.0
51521,흑화/Noun,1,0,1,0.0,1.1106915165381966e-05,1.0
51522,보혐/Noun,1,0,1,0.0,1.1106915165381966e-05,1.0
51523,세츠코/Noun,1,0,1,0.0,1.1106915165381966e-05,1.0
51524,김신재/Noun,1,0,1,0.0,1.1106915165381966e-05,1.0
51525,인코딩/Noun,1,1,0,1.1115310228308472e-05,0.0,1.0
51526,컨버터/Noun,1,1,0,1.1115310228308472e-05,0.0,1.0
51527,쾌함/Noun,1,1,0,1.1115310228308472e-05,0.0,1.0
51528,쌈뽕/Noun,1,1,0,1.1115310228308472e-05,0.0,1.0
51529,치파오/Noun,1,1,0,1.1115310228308472e-05,0.0,1.0
51530,슥같/Noun,1,0,1,0.0,1.1106915165381966e-05,1.0
51531,님위/Noun,1,0,1,0.0,1.1106915165381966e-05,1.0
51532,주효/Noun,1,1,0,1.1115310228308472e-05,0.0,1.0
51533,어히려/Noun,1,1,0,1.1115310228308472e-05,0.0,1.0
51534,50등/Number,1,1,0,1.1115310228308472e-05,0.0,1.0
51535,일구다/Verb,1,0,1,0.0,1.1106915165381966e-05,1.0
51536,본파/Noun,1,0,1,0.0,1.1106915165381966e-05,1.0
51537,훤희/Noun,1,0,1,0.0,1.1106915165381966e-05,1.0
51538,자헤디/Noun,1,1,0,1.1115310228308472e-05,0.0,1.0
51539,버무리/Noun,1,0,1,0.0,1.1106915165381966e-05,1.0
51540,0.46%/Number,1,0,1,0.0,1.1106915165381966e-05,1.0
51541,전당포/Noun,1,1,0,1.1115310228308472e-05,0.0,1.0
51542,상편/Noun,1,1,0,1.1115310228308472e-05,0.0,1.0
51543,플롯팅/Noun,1,0,1,0.0,1.1106915165381966e-05,1.0
51544,8.99/Number,1,1,0,1.1115310228308472e-05,0.0,1.0
51545,최유정/Noun,1,0,1,0.0,1.1106915165381966e-05,1.0
51546,피박/Noun,1,0,1,0.0,1.1106915165381966e-05,1.0
51547,왜그러는데/Noun,1,0,1,0.0,1.1106915165381966e-05,1.0
51548,물밖/Noun,1,0,1,0.0,1.1106915165381966e-05,1.0
51549,kinda/Alpha,1,0,1,0.0,1.1106915165381966e-05,1.0
51550,나폰/Noun,1,0,1,0.0,1.1106915165381966e-05,1.0
51551,성령/Noun,1,1,0,1.1115310228308472e-05,0.0,1.0
51552,프란떠날때/Noun,1,1,0,1.1115310228308472e-05,0.0,1.0
51553,운송/Noun,1,0,1,0.0,1.1106915165381966e-05,1.0
51554,자이시/Noun,1,0,1,0.0,1.1106915165381966e-05,1.0
51555,오동나무/Noun,1,0,1,0.0,1.1106915165381966e-05,1.0
51556,"..,.,.,.,.,.,./Punctuation",1,0,1,0.0,1.1106915165381966e-05,1.0
51557,10432/Number,1,1,0,1.1115310228308472e-05,0.0,1.0
51558,꿓호쇼겨/Noun,1,0,1,0.0,1.1106915165381966e-05,1.0
51559,궁굼증/Noun,1,1,0,1.1115310228308472e-05,0.0,1.0
51560,충신/Noun,1,0,1,0.0,1.1106915165381966e-05,1.0
51561,샤방샤방했던/Noun,1,1,0,1.1115310228308472e-05,0.0,1.0
51562,딘디/Noun,1,1,0,1.1115310228308472e-05,0.0,1.0
51563,워워/Noun,1,0,1,0.0,1.1106915165381966e-05,1.0
51564,잼깨/Noun,1,1,0,1.1115310228308472e-05,0.0,1.0
51565,번다/Noun,1,0,1,0.0,1.1106915165381966e-05,1.0
51566,어줍짢/Noun,1,0,1,0.0,1.1106915165381966e-05,1.0
51567,용준형/Noun,1,1,0,1.1115310228308472e-05,0.0,1.0
51568,지저스/Noun,1,1,0,1.1115310228308472e-05,0.0,1.0
51569,이지나가는/Foreign,1,1,0,1.1115310228308472e-05,0.0,1.0
51570,섹쉬해/Noun,1,1,0,1.1115310228308472e-05,0.0,1.0
51571,나현주/Noun,1,0,1,0.0,1.1106915165381966e-05,1.0
51572,늘때/Noun,1,0,1,0.0,1.1106915165381966e-05,1.0
51573,왓삼/Noun,1,0,1,0.0,1.1106915165381966e-05,1.0
51574,"""(^^)/Punctuation",1,0,1,0.0,1.1106915165381966e-05,1.0
51575,년역/Noun,1,0,1,0.0,1.1106915165381966e-05,1.0
51576,펠리컨/Noun,1,0,1,0.0,1.1106915165381966e-05,1.0
51577,렌다/Noun,1,0,1,0.0,1.1106915165381966e-05,1.0
51578,국민이/Foreign,1,1,0,1.1115310228308472e-05,0.0,1.0
51579,5.75/Number,1,1,0,1.1115310228308472e-05,0.0,1.0
51580,>>>>>>/Punctuation,1,0,1,0.0,1.1106915165381966e-05,1.0
51581,8만/Number,1,1,0,1.1115310228308472e-05,0.0,1.0
51582,재영/Noun,1,1,0,1.1115310228308472e-05,0.0,1.0
51583,완표/Noun,1,1,0,1.1115310228308472e-05,0.0,1.0
51584,요리/Foreign,1,0,1,0.0,1.1106915165381966e-05,1.0
51585,악조건/Noun,1,1,0,1.1115310228308472e-05,0.0,1.0
51586,환풍기/Noun,1,1,0,1.1115310228308472e-05,0.0,1.0
51587,슈야/Noun,1,1,0,1.1115310228308472e-05,0.0,1.0
51588,봉필/Noun,1,1,0,1.1115310228308472e-05,0.0,1.0
51589,면함/Noun,1,1,0,1.1115310228308472e-05,0.0,1.0
51590,임종혁/Noun,1,1,0,1.1115310228308472e-05,0.0,1.0
51591,김명선/Noun,1,1,0,1.1115310228308472e-05,0.0,1.0
51592,즈그/Noun,1,0,1,0.0,1.1106915165381966e-05,1.0
51593,따먹엇어/Noun,1,1,0,1.1115310228308472e-05,0.0,1.0
51594,오근호/Noun,1,1,0,1.1115310228308472e-05,0.0,1.0
51595,ㅅㅅㅁㅅ/KoreanParticle,1,0,1,0.0,1.1106915165381966e-05,1.0
51596,eighteen/Alpha,1,0,1,0.0,1.1106915165381966e-05,1.0
51597,올가을/Noun,1,1,0,1.1115310228308472e-05,0.0,1.0
51598,김명규/Noun,1,0,1,0.0,1.1106915165381966e-05,1.0
51599,이선태/Noun,1,0,1,0.0,1.1106915165381966e-05,1.0
51600,91/Number,1,0,1,0.0,1.1106915165381966e-05,1.0
51601,....--;;/Punctuation,1,0,1,0.0,1.1106915165381966e-05,1.0
51602,애통하다/Adjective,1,0,1,0.0,1.1106915165381966e-05,1.0
51603,증정/Noun,1,0,1,0.0,1.1106915165381966e-05,1.0
51604,나합/Noun,1,1,0,1.1115310228308472e-05,0.0,1.0
51605,스포츠토토/Noun,1,0,1,0.0,1.1106915165381966e-05,1.0
51606,점땜/Noun,1,0,1,0.0,1.1106915165381966e-05,1.0
51607,158분/Number,1,0,1,0.0,1.1106915165381966e-05,1.0
51608,노스탤지아/Noun,1,1,0,1.1115310228308472e-05,0.0,1.0
51609,맞닥뜨리/Noun,1,1,0,1.1115310228308472e-05,0.0,1.0
51610,!!!..!!!/Punctuation,1,1,0,1.1115310228308472e-05,0.0,1.0
51611,하곘어/Noun,1,1,0,1.1115310228308472e-05,0.0,1.0
51612,다마뇨/Noun,1,1,0,1.1115310228308472e-05,0.0,1.0
51613,은감/Noun,1,1,0,1.1115310228308472e-05,0.0,1.0
51614,정해욱/Noun,1,1,0,1.1115310228308472e-05,0.0,1.0
51615,베르/Noun,1,0,1,0.0,1.1106915165381966e-05,1.0
51616,^^;../Punctuation,1,1,0,1.1115310228308472e-05,0.0,1.0
51617,야오녀/Noun,1,1,0,1.1115310228308472e-05,0.0,1.0
51618,였드랬/Noun,1,1,0,1.1115310228308472e-05,0.0,1.0
51619,에쵸티/Noun,1,0,1,0.0,1.1106915165381966e-05,1.0
51620,나앉다/Verb,1,0,1,0.0,1.1106915165381966e-05,1.0
51621,noooooooo/Alpha,1,0,1,0.0,1.1106915165381966e-05,1.0
51622,3739/Number,1,0,1,0.0,1.1106915165381966e-05,1.0
51623,41년/Number,1,1,0,1.1115310228308472e-05,0.0,1.0
51624,3-6년/Number,1,1,0,1.1115310228308472e-05,0.0,1.0
51625,신하/Noun,1,0,1,0.0,1.1106915165381966e-05,1.0
51626,~.'/Punctuation,1,0,1,0.0,1.1106915165381966e-05,1.0
51627,돈안/Noun,1,1,0,1.1115310228308472e-05,0.0,1.0
51628,있스/Noun,1,1,0,1.1115310228308472e-05,0.0,1.0
51629,서지우/Noun,1,0,1,0.0,1.1106915165381966e-05,1.0
51630,씌부뤌/Noun,1,0,1,0.0,1.1106915165381966e-05,1.0
51631,늬긔믜/Noun,1,0,1,0.0,1.1106915165381966e-05,1.0
51632,젠도/Noun,1,0,1,0.0,1.1106915165381966e-05,1.0
51633,?!//Punctuation,1,1,0,1.1115310228308472e-05,0.0,1.0
51634,숫자일/Noun,1,0,1,0.0,1.1106915165381966e-05,1.0
51635,스팸/Noun,1,0,1,0.0,1.1106915165381966e-05,1.0
51636,면안/Noun,1,0,1,0.0,1.1106915165381966e-05,1.0
51637,구단주/Noun,1,0,1,0.0,1.1106915165381966e-05,1.0
51638,레셀/Noun,1,0,1,0.0,1.1106915165381966e-05,1.0
51639,홧병걸려/Noun,1,0,1,0.0,1.1106915165381966e-05,1.0
51640,딲/Noun,1,0,1,0.0,1.1106915165381966e-05,1.0
51641,aut/Alpha,1,0,1,0.0,1.1106915165381966e-05,1.0
51642,가곡/Noun,1,1,0,1.1115310228308472e-05,0.0,1.0
51643,봉테일/Noun,1,1,0,1.1115310228308472e-05,0.0,1.0
51644,장지환/Noun,1,0,1,0.0,1.1106915165381966e-05,1.0
51645,아옌데/Noun,1,0,1,0.0,1.1106915165381966e-05,1.0
51646,미연방/Noun,1,0,1,0.0,1.1106915165381966e-05,1.0
51647,apop/Alpha,1,0,1,0.0,1.1106915165381966e-05,1.0
51648,kpop/Alpha,1,0,1,0.0,1.1106915165381966e-05,1.0
51649,히포크라테스/Noun,1,1,0,1.1115310228308472e-05,0.0,1.0
51650,이라면서/Foreign,1,0,1,0.0,1.1106915165381966e-05,1.0
51651,2707년/Number,1,0,1,0.0,1.1106915165381966e-05,1.0
51652,두가풍/Noun,1,0,1,0.0,1.1106915165381966e-05,1.0
51653,Mark/Alpha,1,0,1,0.0,1.1106915165381966e-05,1.0
51654,소작/Noun,1,0,1,0.0,1.1106915165381966e-05,1.0
51655,나치독일/Noun,1,1,0,1.1115310228308472e-05,0.0,1.0
51656,ㅡㅋㅋ/KoreanParticle,1,1,0,1.1115310228308472e-05,0.0,1.0
51657,준멘루/Noun,1,0,1,0.0,1.1106915165381966e-05,1.0
51658,ㄱㅇㅈㄴㅁㅅㄱㅅ/KoreanParticle,1,0,1,0.0,1.1106915165381966e-05,1.0
51659,레타/Noun,1,1,0,1.1115310228308472e-05,0.0,1.0
51660,꼭찌/Noun,1,0,1,0.0,1.1106915165381966e-05,1.0
51661,물색/Noun,1,0,1,0.0,1.1106915165381966e-05,1.0
51662,Ten/Alpha,1,1,0,1.1115310228308472e-05,0.0,1.0
51663,Silence/Alpha,1,1,0,1.1115310228308472e-05,0.0,1.0
51664,Robinson/Alpha,1,1,0,1.1115310228308472e-05,0.0,1.0
51665,Mrs/Alpha,1,1,0,1.1115310228308472e-05,0.0,1.0
51666,Elaine/Alpha,1,1,0,1.1115310228308472e-05,0.0,1.0
51667,^-----------^/Punctuation,1,1,0,1.1115310228308472e-05,0.0,1.0
51668,카루소/Noun,1,1,0,1.1115310228308472e-05,0.0,1.0
51669,셔핑/Noun,1,1,0,1.1115310228308472e-05,0.0,1.0
51670,나영희/Noun,1,1,0,1.1115310228308472e-05,0.0,1.0
51671,최익현/Noun,1,0,1,0.0,1.1106915165381966e-05,1.0
51672,퀸시/Noun,1,1,0,1.1115310228308472e-05,0.0,1.0
51673,키보/Noun,1,1,0,1.1115310228308472e-05,0.0,1.0
51674,쏙배/Noun,1,1,0,1.1115310228308472e-05,0.0,1.0
51675,짜리내용인듯/Foreign,1,0,1,0.0,1.1106915165381966e-05,1.0
51676,확안/Noun,1,1,0,1.1115310228308472e-05,0.0,1.0
51677,무지기/Noun,1,1,0,1.1115310228308472e-05,0.0,1.0
51678,함박/Noun,1,1,0,1.1115310228308472e-05,0.0,1.0
51679,앙코르/Noun,1,1,0,1.1115310228308472e-05,0.0,1.0
51680,훌룡햇제/Noun,1,0,1,0.0,1.1106915165381966e-05,1.0
51681,메이크유어무브/Noun,1,1,0,1.1115310228308472e-05,0.0,1.0
51682,탄소/Noun,1,1,0,1.1115310228308472e-05,0.0,1.0
51683,최애/Noun,1,0,1,0.0,1.1106915165381966e-05,1.0
51684,요식업/Noun,1,1,0,1.1115310228308472e-05,0.0,1.0
51685,개빡이침/Noun,1,0,1,0.0,1.1106915165381966e-05,1.0
51686,비쭉비쭉/Noun,1,1,0,1.1115310228308472e-05,0.0,1.0
51687,조위/Noun,1,0,1,0.0,1.1106915165381966e-05,1.0
51688,박슈땀시/Noun,1,1,0,1.1115310228308472e-05,0.0,1.0
51689,박슈/Noun,1,1,0,1.1115310228308472e-05,0.0,1.0
51690,MV/Alpha,1,0,1,0.0,1.1106915165381966e-05,1.0
51691,꼬신/Noun,1,1,0,1.1115310228308472e-05,0.0,1.0
51692,http://bluequeen21.blog.me/100187356829/URL,1,1,0,1.1115310228308472e-05,0.0,1.0
51693,전답/Noun,1,0,1,0.0,1.1106915165381966e-05,1.0
51694,***)/Punctuation,1,0,1,0.0,1.1106915165381966e-05,1.0
51695,supe/Alpha,1,0,1,0.0,1.1106915165381966e-05,1.0
51696,청유/Noun,1,0,1,0.0,1.1106915165381966e-05,1.0
51697,견줄건/Noun,1,1,0,1.1115310228308472e-05,0.0,1.0
51698,백지영/Noun,1,0,1,0.0,1.1106915165381966e-05,1.0
51699,페퍼/Noun,1,1,0,1.1115310228308472e-05,0.0,1.0
51700,+_+///Punctuation,1,1,0,1.1115310228308472e-05,0.0,1.0
51701,반어/Noun,1,1,0,1.1115310228308472e-05,0.0,1.0
51702,니케/Noun,1,0,1,0.0,1.1106915165381966e-05,1.0
51703,지략/Noun,1,1,0,1.1115310228308472e-05,0.0,1.0
51704,유순하다/Adjective,1,1,0,1.1115310228308472e-05,0.0,1.0
51705,규용/Noun,1,1,0,1.1115310228308472e-05,0.0,1.0
51706,의막/Noun,1,1,0,1.1115310228308472e-05,0.0,1.0
51707,구고/Noun,1,1,0,1.1115310228308472e-05,0.0,1.0
51708,빨뤼/Noun,1,1,0,1.1115310228308472e-05,0.0,1.0
51709,Adrien/Alpha,1,1,0,1.1115310228308472e-05,0.0,1.0
51710,재밌쿠/Noun,1,1,0,1.1115310228308472e-05,0.0,1.0
51711,풀셋/Noun,1,0,1,0.0,1.1106915165381966e-05,1.0
51712,김진태/Noun,1,0,1,0.0,1.1106915165381966e-05,1.0
51713,전투경찰/Noun,1,0,1,0.0,1.1106915165381966e-05,1.0
51714,태봉/Noun,1,1,0,1.1115310228308472e-05,0.0,1.0
51715,시부모/Noun,1,0,1,0.0,1.1106915165381966e-05,1.0
51716,참되고/Noun,1,1,0,1.1115310228308472e-05,0.0,1.0
51717,한나몬타나/Noun,1,1,0,1.1115310228308472e-05,0.0,1.0
51718,이규화/Noun,1,0,1,0.0,1.1106915165381966e-05,1.0
51719,백순철/Noun,1,0,1,0.0,1.1106915165381966e-05,1.0
51720,"..,?/Punctuation",1,0,1,0.0,1.1106915165381966e-05,1.0
51721,빌나/Noun,1,0,1,0.0,1.1106915165381966e-05,1.0
51722,미끈하다/Adjective,1,0,1,0.0,1.1106915165381966e-05,1.0
51723,도작이라도/Foreign,1,0,1,0.0,1.1106915165381966e-05,1.0
51724,관짐/Noun,1,0,1,0.0,1.1106915165381966e-05,1.0
51725,야구모/Noun,1,1,0,1.1115310228308472e-05,0.0,1.0
51726,굿굿굿답잡/Noun,1,1,0,1.1115310228308472e-05,0.0,1.0
51727,짬짜면/Noun,1,0,1,0.0,1.1106915165381966e-05,1.0
51728,헤드스핀/Noun,1,0,1,0.0,1.1106915165381966e-05,1.0
51729,보들보들하다/Adjective,1,1,0,1.1115310228308472e-05,0.0,1.0
51730,르윈/Noun,1,1,0,1.1115310228308472e-05,0.0,1.0
51731,호넷/Noun,1,1,0,1.1115310228308472e-05,0.0,1.0
51732,~~!!!!!!!!!!/Punctuation,1,1,0,1.1115310228308472e-05,0.0,1.0
51733,뽱당/Noun,1,0,1,0.0,1.1106915165381966e-05,1.0
51734,납량/Noun,1,0,1,0.0,1.1106915165381966e-05,1.0
51735,콜오브듀티/Noun,1,1,0,1.1115310228308472e-05,0.0,1.0
51736,쟁반/Noun,1,1,0,1.1115310228308472e-05,0.0,1.0
51737,..../Foreign,1,0,1,0.0,1.1106915165381966e-05,1.0
51738,천상지희/Noun,1,0,1,0.0,1.1106915165381966e-05,1.0
51739,버트워드/Noun,1,1,0,1.1115310228308472e-05,0.0,1.0
51740,중반인데/Foreign,1,0,1,0.0,1.1106915165381966e-05,1.0
51741,~!~~~/Punctuation,1,1,0,1.1115310228308472e-05,0.0,1.0
51742,아늬아늬/Noun,1,0,1,0.0,1.1106915165381966e-05,1.0
51743,살좀/Noun,1,0,1,0.0,1.1106915165381966e-05,1.0
51744,이상살아있는지/Foreign,1,1,0,1.1115310228308472e-05,0.0,1.0
51745,273/Number,1,1,0,1.1115310228308472e-05,0.0,1.0
51746,절대온도/Noun,1,1,0,1.1115310228308472e-05,0.0,1.0
51747,indi/Alpha,1,1,0,1.1115310228308472e-05,0.0,1.0
51748,리바이어던/Noun,1,0,1,0.0,1.1106915165381966e-05,1.0
51749,해주셧으/Noun,1,1,0,1.1115310228308472e-05,0.0,1.0
51750,민낮/Noun,1,1,0,1.1115310228308472e-05,0.0,1.0
51751,럽송/Noun,1,1,0,1.1115310228308472e-05,0.0,1.0
51752,위병/Noun,1,0,1,0.0,1.1106915165381966e-05,1.0
51753,순전/Noun,1,0,1,0.0,1.1106915165381966e-05,1.0
51754,일꺠워/Noun,1,0,1,0.0,1.1106915165381966e-05,1.0
51755,통곡함/Noun,1,1,0,1.1115310228308472e-05,0.0,1.0
51756,분비/Noun,1,1,0,1.1115310228308472e-05,0.0,1.0
51757,낙하씬/Noun,1,1,0,1.1115310228308472e-05,0.0,1.0
51758,헛폼잡는/Noun,1,0,1,0.0,1.1106915165381966e-05,1.0
51759,육박/Noun,1,0,1,0.0,1.1106915165381966e-05,1.0
51760,아다모/Noun,1,1,0,1.1115310228308472e-05,0.0,1.0
51761,HOT/Alpha,1,1,0,1.1115310228308472e-05,0.0,1.0
51762,덜포/Noun,1,1,0,1.1115310228308472e-05,0.0,1.0
51763,핏대/Noun,1,0,1,0.0,1.1106915165381966e-05,1.0
51764,비잔틴/Noun,1,0,1,0.0,1.1106915165381966e-05,1.0
51765,쪈/Noun,1,1,0,1.1115310228308472e-05,0.0,1.0
51766,청가/Noun,1,1,0,1.1115310228308472e-05,0.0,1.0
51767,하모니카/Noun,1,1,0,1.1115310228308472e-05,0.0,1.0
51768,간놈/Noun,1,1,0,1.1115310228308472e-05,0.0,1.0
51769,유격대/Noun,1,1,0,1.1115310228308472e-05,0.0,1.0
51770,3840/Number,1,1,0,1.1115310228308472e-05,0.0,1.0
51771,딩년/Noun,1,0,1,0.0,1.1106915165381966e-05,1.0
51772,주급/Noun,1,0,1,0.0,1.1106915165381966e-05,1.0
51773,우엨/Noun,1,0,1,0.0,1.1106915165381966e-05,1.0
51774,-()-/Punctuation,1,0,1,0.0,1.1106915165381966e-05,1.0
51775,연예병사/Noun,1,0,1,0.0,1.1106915165381966e-05,1.0
51776,개쪈다/Noun,1,1,0,1.1115310228308472e-05,0.0,1.0
51777,님좀/Noun,1,1,0,1.1115310228308472e-05,0.0,1.0
51778,조드슨/Noun,1,0,1,0.0,1.1106915165381966e-05,1.0
51779,로테이션/Noun,1,0,1,0.0,1.1106915165381966e-05,1.0
51780,찻길/Noun,1,1,0,1.1115310228308472e-05,0.0,1.0
51781,없앳으/Noun,1,0,1,0.0,1.1106915165381966e-05,1.0
51782,리코더/Noun,1,1,0,1.1115310228308472e-05,0.0,1.0
51783,왕눈이/Noun,1,1,0,1.1115310228308472e-05,0.0,1.0
51784,",,(?)/Punctuation",1,0,1,0.0,1.1106915165381966e-05,1.0
51785,안우/Noun,1,0,1,0.0,1.1106915165381966e-05,1.0
51786,개는주어야줘/Foreign,1,1,0,1.1115310228308472e-05,0.0,1.0
51787,탄하/Noun,1,0,1,0.0,1.1106915165381966e-05,1.0
51788,Present/Alpha,1,1,0,1.1115310228308472e-05,0.0,1.0
51789,Last/Alpha,1,1,0,1.1115310228308472e-05,0.0,1.0
51790,훨나음/Noun,1,1,0,1.1115310228308472e-05,0.0,1.0
51791,여문락/Noun,1,0,1,0.0,1.1106915165381966e-05,1.0
51792,!~~~~~~~~~~~~/Punctuation,1,1,0,1.1115310228308472e-05,0.0,1.0
51793,씀씀이/Noun,1,1,0,1.1115310228308472e-05,0.0,1.0
51794,ㄴㅔㅋ/KoreanParticle,1,0,1,0.0,1.1106915165381966e-05,1.0
51795,9.29/Number,1,1,0,1.1115310228308472e-05,0.0,1.0
51796,습디/Noun,1,1,0,1.1115310228308472e-05,0.0,1.0
51797,8.5일/Number,1,0,1,0.0,1.1106915165381966e-05,1.0
51798,241조/Number,1,0,1,0.0,1.1106915165381966e-05,1.0
51799,로달/Noun,1,0,1,0.0,1.1106915165381966e-05,1.0
51800,숴워/Noun,1,1,0,1.1115310228308472e-05,0.0,1.0
51801,묵혔구/Noun,1,0,1,0.0,1.1106915165381966e-05,1.0
51802,이영재/Noun,1,0,1,0.0,1.1106915165381966e-05,1.0
51803,휨쓰려/Noun,1,0,1,0.0,1.1106915165381966e-05,1.0
51804,빠져드/Noun,1,1,0,1.1115310228308472e-05,0.0,1.0
51805,번말/Noun,1,0,1,0.0,1.1106915165381966e-05,1.0
51806,이위/Noun,1,1,0,1.1115310228308472e-05,0.0,1.0
51807,아국/Noun,1,1,0,1.1115310228308472e-05,0.0,1.0
51808,123345677/Number,1,0,1,0.0,1.1106915165381966e-05,1.0
51809,연남동/Noun,1,0,1,0.0,1.1106915165381966e-05,1.0
51810,인간의조건/Noun,1,0,1,0.0,1.1106915165381966e-05,1.0
51811,스스무/Noun,1,0,1,0.0,1.1106915165381966e-05,1.0
51812,세타/Noun,1,0,1,0.0,1.1106915165381966e-05,1.0
51813,메루/Noun,1,0,1,0.0,1.1106915165381966e-05,1.0
51814,타시카/Noun,1,0,1,0.0,1.1106915165381966e-05,1.0
51815,와스/Noun,1,0,1,0.0,1.1106915165381966e-05,1.0
51816,야쿠소쿠/Noun,1,0,1,0.0,1.1106915165381966e-05,1.0
51817,파웰/Noun,1,0,1,0.0,1.1106915165381966e-05,1.0
51818,란함/Noun,1,1,0,1.1115310228308472e-05,0.0,1.0
51819,매립지/Noun,1,0,1,0.0,1.1106915165381966e-05,1.0
51820,정줄/Noun,1,0,1,0.0,1.1106915165381966e-05,1.0
51821,훙미/Noun,1,1,0,1.1115310228308472e-05,0.0,1.0
51822,석탄일/Noun,1,1,0,1.1115310228308472e-05,0.0,1.0
51823,석가탄신일/Noun,1,1,0,1.1115310228308472e-05,0.0,1.0
51824,somebody/Alpha,1,1,0,1.1115310228308472e-05,0.0,1.0
51825,델구/Noun,1,1,0,1.1115310228308472e-05,0.0,1.0
51826,슬펴/Noun,1,1,0,1.1115310228308472e-05,0.0,1.0
51827,ㅠㅜㅠㅍ/KoreanParticle,1,1,0,1.1115310228308472e-05,0.0,1.0
51828,흠씬/Noun,1,1,0,1.1115310228308472e-05,0.0,1.0
51829,보청기/Noun,1,0,1,0.0,1.1106915165381966e-05,1.0
51830,오늘아침/Noun,1,1,0,1.1115310228308472e-05,0.0,1.0
51831,더콜/Noun,1,0,1,0.0,1.1106915165381966e-05,1.0
51832,발짓/Noun,1,1,0,1.1115310228308472e-05,0.0,1.0
51833,캐맄/Noun,1,1,0,1.1115310228308472e-05,0.0,1.0
51834,유튭/Noun,1,1,0,1.1115310228308472e-05,0.0,1.0
51835,간사이/Noun,1,0,1,0.0,1.1106915165381966e-05,1.0
51836,고라니/Noun,1,0,1,0.0,1.1106915165381966e-05,1.0
51837,디셈버/Noun,1,0,1,0.0,1.1106915165381966e-05,1.0
51838,피임/Noun,1,0,1,0.0,1.1106915165381966e-05,1.0
51839,고창식/Noun,1,0,1,0.0,1.1106915165381966e-05,1.0
51840,말고는/Foreign,1,0,1,0.0,1.1106915165381966e-05,1.0
51841,정운/Noun,1,0,1,0.0,1.1106915165381966e-05,1.0
51842,광국/Noun,1,0,1,0.0,1.1106915165381966e-05,1.0
51843,민섭/Noun,1,0,1,0.0,1.1106915165381966e-05,1.0
51844,깝깝해/Noun,1,0,1,0.0,1.1106915165381966e-05,1.0
51845,lulz/Alpha,1,0,1,0.0,1.1106915165381966e-05,1.0
51846,적대시/Noun,1,1,0,1.1115310228308472e-05,0.0,1.0
51847,인디씬/Noun,1,1,0,1.1115310228308472e-05,0.0,1.0
51848,김춘수/Noun,1,1,0,1.1115310228308472e-05,0.0,1.0
51849,오랑우탄/Noun,1,0,1,0.0,1.1106915165381966e-05,1.0
51850,벙쩌하/Noun,1,0,1,0.0,1.1106915165381966e-05,1.0
51851,POSSIBLE/Alpha,1,1,0,1.1115310228308472e-05,0.0,1.0
51852,THINGS/Alpha,1,1,0,1.1115310228308472e-05,0.0,1.0
51853,GOD/Alpha,1,1,0,1.1115310228308472e-05,0.0,1.0
51854,WITH/Alpha,1,1,0,1.1115310228308472e-05,0.0,1.0
51855,잘뵛습니강/Noun,1,1,0,1.1115310228308472e-05,0.0,1.0
51856,개썁/Noun,1,0,1,0.0,1.1106915165381966e-05,1.0
51857,*:^/Punctuation,1,1,0,1.1115310228308472e-05,0.0,1.0
51858,알콩/Noun,1,1,0,1.1115310228308472e-05,0.0,1.0
51859,300등/Number,1,0,1,0.0,1.1106915165381966e-05,1.0
51860,비서실/Noun,1,1,0,1.1115310228308472e-05,0.0,1.0
51861,똘똘뭉친/Noun,1,0,1,0.0,1.1106915165381966e-05,1.0
51862,물살/Noun,1,0,1,0.0,1.1106915165381966e-05,1.0
51863,이규한/Noun,1,0,1,0.0,1.1106915165381966e-05,1.0
51864,걸절/Noun,1,0,1,0.0,1.1106915165381966e-05,1.0
51865,줄스/Noun,1,1,0,1.1115310228308472e-05,0.0,1.0
51866,디아스포라/Noun,1,1,0,1.1115310228308472e-05,0.0,1.0
51867,스크루/Noun,1,1,0,1.1115310228308472e-05,0.0,1.0
51868,해노/Noun,1,1,0,1.1115310228308472e-05,0.0,1.0
51869,훌훌/Noun,1,0,1,0.0,1.1106915165381966e-05,1.0
51870,slim/Alpha,1,0,1,0.0,1.1106915165381966e-05,1.0
51871,평덤/Noun,1,0,1,0.0,1.1106915165381966e-05,1.0
51872,무사도/Noun,1,0,1,0.0,1.1106915165381966e-05,1.0
51873,칵퉷/Noun,1,0,1,0.0,1.1106915165381966e-05,1.0
51874,은둔/Noun,1,0,1,0.0,1.1106915165381966e-05,1.0
51875,굿귯/Noun,1,1,0,1.1115310228308472e-05,0.0,1.0
51876,침침/Noun,1,1,0,1.1115310228308472e-05,0.0,1.0
51877,못생겻어/Noun,1,0,1,0.0,1.1106915165381966e-05,1.0
51878,아자개/Noun,1,1,0,1.1115310228308472e-05,0.0,1.0
51879,아늠/Noun,1,0,1,0.0,1.1106915165381966e-05,1.0
51880,클러버/Noun,1,0,1,0.0,1.1106915165381966e-05,1.0
51881,직장의신/Noun,1,1,0,1.1115310228308472e-05,0.0,1.0
51882,만적/Noun,1,0,1,0.0,1.1106915165381966e-05,1.0
51883,퍼커/Noun,1,0,1,0.0,1.1106915165381966e-05,1.0
51884,내딸서영이/Noun,1,1,0,1.1115310228308472e-05,0.0,1.0
51885,라닥/Noun,1,1,0,1.1115310228308472e-05,0.0,1.0
51886,ㅌㅋㄴㄴ/KoreanParticle,1,0,1,0.0,1.1106915165381966e-05,1.0
51887,히무맹랑/Noun,1,0,1,0.0,1.1106915165381966e-05,1.0
51888,디드로/Noun,1,1,0,1.1115310228308472e-05,0.0,1.0
51889,게임중독/Noun,1,0,1,0.0,1.1106915165381966e-05,1.0
51890,보더타운/Noun,1,0,1,0.0,1.1106915165381966e-05,1.0
51891,실리콘밸리/Noun,1,1,0,1.1115310228308472e-05,0.0,1.0
51892,앱등/Noun,1,1,0,1.1115310228308472e-05,0.0,1.0
51893,해더/Noun,1,0,1,0.0,1.1106915165381966e-05,1.0
51894,란역/Noun,1,0,1,0.0,1.1106915165381966e-05,1.0
51895,동생뇬/Noun,1,0,1,0.0,1.1106915165381966e-05,1.0
51896,이광모/Noun,1,1,0,1.1115310228308472e-05,0.0,1.0
51897,발딱/Adverb,1,1,0,1.1115310228308472e-05,0.0,1.0
51898,이구십삼/Noun,1,0,1,0.0,1.1106915165381966e-05,1.0
51899,십칠/Noun,1,0,1,0.0,1.1106915165381966e-05,1.0
51900,윤뢰안/Noun,1,0,1,0.0,1.1106915165381966e-05,1.0
51901,옥레티/Noun,1,0,1,0.0,1.1106915165381966e-05,1.0
51902,답보/Noun,1,0,1,0.0,1.1106915165381966e-05,1.0
51903,상비/Noun,1,0,1,0.0,1.1106915165381966e-05,1.0
51904,그러닊/Noun,1,0,1,0.0,1.1106915165381966e-05,1.0
51905,ㅛㅏ/KoreanParticle,1,1,0,1.1115310228308472e-05,0.0,1.0
51906,BGT/Alpha,1,0,1,0.0,1.1106915165381966e-05,1.0
51907,좌충웅돌/Noun,1,0,1,0.0,1.1106915165381966e-05,1.0
51908,difficult/Alpha,1,0,1,0.0,1.1106915165381966e-05,1.0
51909,dengerous/Alpha,1,0,1,0.0,1.1106915165381966e-05,1.0
51910,cc/Alpha,1,1,0,1.1115310228308472e-05,0.0,1.0
51911,가릋펴주/Noun,1,0,1,0.0,1.1106915165381966e-05,1.0
51912,게릴라/Noun,1,1,0,1.1115310228308472e-05,0.0,1.0
51913,직교/Noun,1,1,0,1.1115310228308472e-05,0.0,1.0
51914,32일/Number,1,1,0,1.1115310228308472e-05,0.0,1.0
51915,나바/Noun,1,0,1,0.0,1.1106915165381966e-05,1.0
51916,인혜힘들/Noun,1,0,1,0.0,1.1106915165381966e-05,1.0
51917,뭣하랴/Noun,1,0,1,0.0,1.1106915165381966e-05,1.0
51918,의학박사/Noun,1,1,0,1.1115310228308472e-05,0.0,1.0
51919,wonderful/Alpha,1,1,0,1.1115310228308472e-05,0.0,1.0
51920,쿠엔티/Noun,1,1,0,1.1115310228308472e-05,0.0,1.0
51921,Down/Alpha,1,0,1,0.0,1.1106915165381966e-05,1.0
51922,정병국/Noun,1,0,1,0.0,1.1106915165381966e-05,1.0
51923,나츠메/Noun,1,0,1,0.0,1.1106915165381966e-05,1.0
51924,안용준/Noun,1,1,0,1.1115310228308472e-05,0.0,1.0
51925,GAMEOVER/Alpha,1,1,0,1.1115310228308472e-05,0.0,1.0
51926,안내면/Noun,1,0,1,0.0,1.1106915165381966e-05,1.0
51927,서먹해지다/Adjective,1,0,1,0.0,1.1106915165381966e-05,1.0
51928,교만/Noun,1,0,1,0.0,1.1106915165381966e-05,1.0
51929,%^/Punctuation,1,1,0,1.1115310228308472e-05,0.0,1.0
51930,진추하/Noun,1,1,0,1.1115310228308472e-05,0.0,1.0
51931,모자이/Noun,1,0,1,0.0,1.1106915165381966e-05,1.0
51932,잭과콩나무/Noun,1,0,1,0.0,1.1106915165381966e-05,1.0
51933,2110만/Number,1,1,0,1.1115310228308472e-05,0.0,1.0
51934,죄질/Noun,1,0,1,0.0,1.1106915165381966e-05,1.0
51935,패가망신/Noun,1,0,1,0.0,1.1106915165381966e-05,1.0
51936,신의손/Noun,1,0,1,0.0,1.1106915165381966e-05,1.0
51937,샘벨/Noun,1,1,0,1.1115310228308472e-05,0.0,1.0
51938,스트롱월드/Noun,1,0,1,0.0,1.1106915165381966e-05,1.0
51939,최곤듯/Noun,1,1,0,1.1115310228308472e-05,0.0,1.0
51940,도이런특수효과를/Foreign,1,1,0,1.1115310228308472e-05,0.0,1.0
51941,매정/Noun,1,0,1,0.0,1.1106915165381966e-05,1.0
51942,생퀴/Noun,1,0,1,0.0,1.1106915165381966e-05,1.0
51943,1.0/Number,1,0,1,0.0,1.1106915165381966e-05,1.0
51944,수난이대/Noun,1,1,0,1.1115310228308472e-05,0.0,1.0
51945,이쁘긔/Noun,1,0,1,0.0,1.1106915165381966e-05,1.0
51946,求道記/Foreign,1,1,0,1.1115310228308472e-05,0.0,1.0
51947,自立/Foreign,1,1,0,1.1115310228308472e-05,0.0,1.0
51948,independence/Alpha,1,1,0,1.1115310228308472e-05,0.0,1.0
51949,orbison/Alpha,1,1,0,1.1115310228308472e-05,0.0,1.0
51950,roy/Alpha,1,1,0,1.1115310228308472e-05,0.0,1.0
51951,모프/Noun,1,0,1,0.0,1.1106915165381966e-05,1.0
51952,봣고/Noun,1,1,0,1.1115310228308472e-05,0.0,1.0
51953,프론트/Noun,1,1,0,1.1115310228308472e-05,0.0,1.0
51954,1000:1/Number,1,0,1,0.0,1.1106915165381966e-05,1.0
51955,보고나왔을거다/Foreign,1,0,1,0.0,1.1106915165381966e-05,1.0
51956,견훤/Noun,1,0,1,0.0,1.1106915165381966e-05,1.0
51957,lollipop/Alpha,1,1,0,1.1115310228308472e-05,0.0,1.0
51958,lonely/Alpha,1,1,0,1.1115310228308472e-05,0.0,1.0
51959,트판/Noun,1,0,1,0.0,1.1106915165381966e-05,1.0
51960,혜란/Noun,1,1,0,1.1115310228308472e-05,0.0,1.0
51961,건머/Noun,1,0,1,0.0,1.1106915165381966e-05,1.0
51962,업섯/Noun,1,0,1,0.0,1.1106915165381966e-05,1.0
51963,삭련/Noun,1,0,1,0.0,1.1106915165381966e-05,1.0
51964,남엿먹임/Noun,1,0,1,0.0,1.1106915165381966e-05,1.0
51965,ㅉㅈㅇㅅㅂ/KoreanParticle,1,1,0,1.1115310228308472e-05,0.0,1.0
51966,캉캉/Noun,1,0,1,0.0,1.1106915165381966e-05,1.0
51967,자청/Noun,1,1,0,1.1115310228308472e-05,0.0,1.0
51968,피고인/Noun,1,1,0,1.1115310228308472e-05,0.0,1.0
51969,앰뷸런스/Noun,1,0,1,0.0,1.1106915165381966e-05,1.0
51970,미연시/Noun,1,1,0,1.1115310228308472e-05,0.0,1.0
51971,스쿨데이즈/Noun,1,1,0,1.1115310228308472e-05,0.0,1.0
51972,얀데레/Noun,1,1,0,1.1115310228308472e-05,0.0,1.0
51973,낮은/Noun,1,1,0,1.1115310228308472e-05,0.0,1.0
51974,우츠키/Noun,1,1,0,1.1115310228308472e-05,0.0,1.0
51975,큰누나/Noun,1,1,0,1.1115310228308472e-05,0.0,1.0
51976,스플래쉬/Noun,1,0,1,0.0,1.1106915165381966e-05,1.0
51977,DJC/Alpha,1,0,1,0.0,1.1106915165381966e-05,1.0
51978,!...../Punctuation,1,0,1,0.0,1.1106915165381966e-05,1.0
51979,쇠고랑/Noun,1,1,0,1.1115310228308472e-05,0.0,1.0
51980,악전/Noun,1,0,1,0.0,1.1106915165381966e-05,1.0
51981,유철/Noun,1,1,0,1.1115310228308472e-05,0.0,1.0
51982,까딱/Noun,1,0,1,0.0,1.1106915165381966e-05,1.0
51983,쩌심/Noun,1,1,0,1.1115310228308472e-05,0.0,1.0
51984,점머임/Noun,1,1,0,1.1115310228308472e-05,0.0,1.0
51985,짜스하/Noun,1,1,0,1.1115310228308472e-05,0.0,1.0
51986,곤궁/Noun,1,1,0,1.1115310228308472e-05,0.0,1.0
51987,구운몽/Noun,1,0,1,0.0,1.1106915165381966e-05,1.0
51988,난뭘/Noun,1,0,1,0.0,1.1106915165381966e-05,1.0
51989,범학/Noun,1,0,1,0.0,1.1106915165381966e-05,1.0
51990,Ridiculous/Alpha,1,0,1,0.0,1.1106915165381966e-05,1.0
51991,는단/Noun,1,0,1,0.0,1.1106915165381966e-05,1.0
51992,뀨우/Noun,1,0,1,0.0,1.1106915165381966e-05,1.0
51993,실마릴리온/Noun,1,1,0,1.1115310228308472e-05,0.0,1.0
51994,젬날려/Noun,1,0,1,0.0,1.1106915165381966e-05,1.0
51995,쌍봉/Noun,1,1,0,1.1115310228308472e-05,0.0,1.0
51996,오승환/Noun,1,0,1,0.0,1.1106915165381966e-05,1.0
51997,화좀/Noun,1,1,0,1.1115310228308472e-05,0.0,1.0
51998,범입/Noun,1,0,1,0.0,1.1106915165381966e-05,1.0
51999,셀프카메라/Noun,1,0,1,0.0,1.1106915165381966e-05,1.0
52000,으면/Eomi,1,0,1,0.0,1.1106915165381966e-05,1.0
52001,만드섰/Noun,1,0,1,0.0,1.1106915165381966e-05,1.0
52002,껄욕/Noun,1,0,1,0.0,1.1106915165381966e-05,1.0
52003,답달/Noun,1,0,1,0.0,1.1106915165381966e-05,1.0
52004,cuti/Alpha,1,0,1,0.0,1.1106915165381966e-05,1.0
52005,해발/Noun,1,0,1,0.0,1.1106915165381966e-05,1.0
52006,8000/Number,1,0,1,0.0,1.1106915165381966e-05,1.0
52007,tkfalksdmoasdvabaeth/Alpha,1,1,0,1.1115310228308472e-05,0.0,1.0
52008,꼬면/Noun,1,0,1,0.0,1.1106915165381966e-05,1.0
52009,액숀물/Noun,1,0,1,0.0,1.1106915165381966e-05,1.0
52010,160억/Number,1,0,1,0.0,1.1106915165381966e-05,1.0
52011,........;/Punctuation,1,0,1,0.0,1.1106915165381966e-05,1.0
52012,머셜/Noun,1,0,1,0.0,1.1106915165381966e-05,1.0
52013,엎는/Noun,1,1,0,1.1115310228308472e-05,0.0,1.0
52014,숙역/Noun,1,1,0,1.1115310228308472e-05,0.0,1.0
52015,차영/Noun,1,1,0,1.1115310228308472e-05,0.0,1.0
52016,거미인간/Noun,1,0,1,0.0,1.1106915165381966e-05,1.0
52017,이빛나/Noun,1,0,1,0.0,1.1106915165381966e-05,1.0
52018,고추냉이/Noun,1,1,0,1.1115310228308472e-05,0.0,1.0
52019,해구해/Noun,1,0,1,0.0,1.1106915165381966e-05,1.0
52020,걱정거리/Noun,1,1,0,1.1115310228308472e-05,0.0,1.0
52021,칠봉이/Noun,1,1,0,1.1115310228308472e-05,0.0,1.0
52022,양력/Noun,1,1,0,1.1115310228308472e-05,0.0,1.0
52023,1967년/Number,1,1,0,1.1115310228308472e-05,0.0,1.0
52024,삑/Noun,1,1,0,1.1115310228308472e-05,0.0,1.0
52025,버팀목/Noun,1,0,1,0.0,1.1106915165381966e-05,1.0
52026,애섀끼/Noun,1,0,1,0.0,1.1106915165381966e-05,1.0
52027,펜타곤/Noun,1,0,1,0.0,1.1106915165381966e-05,1.0
52028,국무부/Noun,1,0,1,0.0,1.1106915165381966e-05,1.0
52029,로제/Noun,1,1,0,1.1115310228308472e-05,0.0,1.0
52030,삭카/Noun,1,1,0,1.1115310228308472e-05,0.0,1.0
52031,권력투쟁/Noun,1,0,1,0.0,1.1106915165381966e-05,1.0
52032,출자/Noun,1,1,0,1.1115310228308472e-05,0.0,1.0
52033,160만/Number,1,1,0,1.1115310228308472e-05,0.0,1.0
52034,봉기/Noun,1,0,1,0.0,1.1106915165381966e-05,1.0
52035,불부/Noun,1,0,1,0.0,1.1106915165381966e-05,1.0
52036,위조지폐/Noun,1,0,1,0.0,1.1106915165381966e-05,1.0
52037,에야/Foreign,1,0,1,0.0,1.1106915165381966e-05,1.0
52038,소식통/Noun,1,0,1,0.0,1.1106915165381966e-05,1.0
52039,물증/Noun,1,0,1,0.0,1.1106915165381966e-05,1.0
52040,소멸하다/Adjective,1,0,1,0.0,1.1106915165381966e-05,1.0
52041,스판/Noun,1,1,0,1.1115310228308472e-05,0.0,1.0
52042,쪠연/Noun,1,0,1,0.0,1.1106915165381966e-05,1.0
52043,슈퍼내츄럴/Noun,1,1,0,1.1115310228308472e-05,0.0,1.0
52044,로브/Noun,1,0,1,0.0,1.1106915165381966e-05,1.0
52045,\~~/Punctuation,1,1,0,1.1115310228308472e-05,0.0,1.0
52046,까무러/Noun,1,0,1,0.0,1.1106915165381966e-05,1.0
52047,그럤음/Noun,1,0,1,0.0,1.1106915165381966e-05,1.0
52048,휘향/Noun,1,0,1,0.0,1.1106915165381966e-05,1.0
52049,party/Alpha,1,0,1,0.0,1.1106915165381966e-05,1.0
52050,Blood/Alpha,1,0,1,0.0,1.1106915165381966e-05,1.0
52051,맹숭맹숭함/Noun,1,0,1,0.0,1.1106915165381966e-05,1.0
52052,rhadlajtwjdy/Alpha,1,1,0,1.1115310228308472e-05,0.0,1.0
52053,빠친다/Noun,1,0,1,0.0,1.1106915165381966e-05,1.0
52054,왜슬랙스틱/Noun,1,0,1,0.0,1.1106915165381966e-05,1.0
52055,쫄려/Noun,1,1,0,1.1115310228308472e-05,0.0,1.0
52056,담회/Noun,1,1,0,1.1115310228308472e-05,0.0,1.0
52057,핑돌면/Noun,1,1,0,1.1115310228308472e-05,0.0,1.0
52058,설란/Noun,1,1,0,1.1115310228308472e-05,0.0,1.0
52059,ㅓㅓㅓ/KoreanParticle,1,1,0,1.1115310228308472e-05,0.0,1.0
52060,빅씨/Noun,1,1,0,1.1115310228308472e-05,0.0,1.0
52061,혁횽/Noun,1,1,0,1.1115310228308472e-05,0.0,1.0
52062,내열/Noun,1,0,1,0.0,1.1106915165381966e-05,1.0
52063,오심/Noun,1,1,0,1.1115310228308472e-05,0.0,1.0
52064,다굿굿/Noun,1,1,0,1.1115310228308472e-05,0.0,1.0
52065,굿럭/Noun,1,1,0,1.1115310228308472e-05,0.0,1.0
52066,성량/Noun,1,0,1,0.0,1.1106915165381966e-05,1.0
52067,신인상/Noun,1,1,0,1.1115310228308472e-05,0.0,1.0
52068,7등/Number,1,1,0,1.1115310228308472e-05,0.0,1.0
52069,폰겜/Noun,1,1,0,1.1115310228308472e-05,0.0,1.0
52070,사각/Noun,1,0,1,0.0,1.1106915165381966e-05,1.0
52071,쐉/Noun,1,1,0,1.1115310228308472e-05,0.0,1.0
52072,쌍절곤/Noun,1,1,0,1.1115310228308472e-05,0.0,1.0
52073,교련/Noun,1,1,0,1.1115310228308472e-05,0.0,1.0
52074,칼의노래/Noun,1,0,1,0.0,1.1106915165381966e-05,1.0
52075,김훈/Noun,1,0,1,0.0,1.1106915165381966e-05,1.0
52076,와룡생/Noun,1,0,1,0.0,1.1106915165381966e-05,1.0
52077,양우/Noun,1,0,1,0.0,1.1106915165381966e-05,1.0
52078,유붕/Noun,1,1,0,1.1115310228308472e-05,0.0,1.0
52079,적막/Noun,1,1,0,1.1115310228308472e-05,0.0,1.0
52080,슈슉/Noun,1,1,0,1.1115310228308472e-05,0.0,1.0
52081,풍덩풍덩/Adverb,1,1,0,1.1115310228308472e-05,0.0,1.0
52082,않닼/Noun,1,0,1,0.0,1.1106915165381966e-05,1.0
52083,츄천/Noun,1,0,1,0.0,1.1106915165381966e-05,1.0
52084,마츠다류헤이/Noun,1,1,0,1.1115310228308472e-05,0.0,1.0
52085,철저함/Noun,1,1,0,1.1115310228308472e-05,0.0,1.0
52086,세면대/Noun,1,1,0,1.1115310228308472e-05,0.0,1.0
52087,이어령/Noun,1,0,1,0.0,1.1106915165381966e-05,1.0
52088,실성/Noun,1,0,1,0.0,1.1106915165381966e-05,1.0
52089,인두/Noun,1,0,1,0.0,1.1106915165381966e-05,1.0
52090,라스트네임/Noun,1,0,1,0.0,1.1106915165381966e-05,1.0
52091,춴/Noun,1,1,0,1.1115310228308472e-05,0.0,1.0
52092,~~~~~~~~~~!/Punctuation,1,0,1,0.0,1.1106915165381966e-05,1.0
52093,벤킹슬리역/Noun,1,1,0,1.1115310228308472e-05,0.0,1.0
52094,탭태범/Noun,1,0,1,0.0,1.1106915165381966e-05,1.0
52095,ㅎㄹ/KoreanParticle,1,0,1,0.0,1.1106915165381966e-05,1.0
52096,++++++/Punctuation,1,1,0,1.1115310228308472e-05,0.0,1.0
52097,43초/Number,1,1,0,1.1115310228308472e-05,0.0,1.0
52098,신탐/Noun,1,1,0,1.1115310228308472e-05,0.0,1.0
52099,선근/Noun,1,1,0,1.1115310228308472e-05,0.0,1.0
52100,nypd/Alpha,1,0,1,0.0,1.1106915165381966e-05,1.0
52101,보조금/Noun,1,0,1,0.0,1.1106915165381966e-05,1.0
52102,됫나바/Noun,1,1,0,1.1115310228308472e-05,0.0,1.0
52103,힉콕스/Noun,1,1,0,1.1115310228308472e-05,0.0,1.0
52104,이밍크/Noun,1,0,1,0.0,1.1106915165381966e-05,1.0
52105,희극배우/Noun,1,0,1,0.0,1.1106915165381966e-05,1.0
52106,De/Alpha,1,1,0,1.1115310228308472e-05,0.0,1.0
52107,Ballet/Alpha,1,1,0,1.1115310228308472e-05,0.0,1.0
52108,Opera/Alpha,1,1,0,1.1115310228308472e-05,0.0,1.0
52109,Paris/Alpha,1,1,0,1.1115310228308472e-05,0.0,1.0
52110,Danse/Alpha,1,1,0,1.1115310228308472e-05,0.0,1.0
52111,당스/Noun,1,1,0,1.1115310228308472e-05,0.0,1.0
52112,아윌씨유쑨/Noun,1,1,0,1.1115310228308472e-05,0.0,1.0
52113,왓겟/Noun,1,0,1,0.0,1.1106915165381966e-05,1.0
52114,백만조/Noun,1,1,0,1.1115310228308472e-05,0.0,1.0
52115,엠플런스/Noun,1,0,1,0.0,1.1106915165381966e-05,1.0
52116,겻다/Noun,1,0,1,0.0,1.1106915165381966e-05,1.0
52117,낚는거봐/Noun,1,0,1,0.0,1.1106915165381966e-05,1.0
52118,어릴떈/Noun,1,0,1,0.0,1.1106915165381966e-05,1.0
52119,비비디바비디부/Noun,1,0,1,0.0,1.1106915165381966e-05,1.0
52120,대발견/Noun,1,1,0,1.1115310228308472e-05,0.0,1.0
52121,마지못하다/Adjective,1,0,1,0.0,1.1106915165381966e-05,1.0
52122,;;//Punctuation,1,1,0,1.1115310228308472e-05,0.0,1.0
52123,ㅡㅁㅡ/KoreanParticle,1,1,0,1.1115310228308472e-05,0.0,1.0
52124,포워드/Noun,1,1,0,1.1115310228308472e-05,0.0,1.0
52125,킵/Noun,1,1,0,1.1115310228308472e-05,0.0,1.0
52126,뻔햇음/Noun,1,1,0,1.1115310228308472e-05,0.0,1.0
52127,여주대/Noun,1,1,0,1.1115310228308472e-05,0.0,1.0
52128,업샨/Noun,1,1,0,1.1115310228308472e-05,0.0,1.0
52129,19:09/Number,1,1,0,1.1115310228308472e-05,0.0,1.0
52130,2009/04/Number,1,1,0,1.1115310228308472e-05,0.0,1.0
52131,꾸주릐/Noun,1,0,1,0.0,1.1106915165381966e-05,1.0
52132,]]/Punctuation,1,1,0,1.1115310228308472e-05,0.0,1.0
52133,[[/Punctuation,1,1,0,1.1115310228308472e-05,0.0,1.0
52134,빼낌/Noun,1,0,1,0.0,1.1106915165381966e-05,1.0
52135,빼겻/Noun,1,0,1,0.0,1.1106915165381966e-05,1.0
52136,순조/Noun,1,0,1,0.0,1.1106915165381966e-05,1.0
52137,ω/Foreign,1,1,0,1.1115310228308472e-05,0.0,1.0
52138,이게뭐꼬/Noun,1,0,1,0.0,1.1106915165381966e-05,1.0
52139,국정원장/Noun,1,0,1,0.0,1.1106915165381966e-05,1.0
52140,남재준/Noun,1,0,1,0.0,1.1106915165381966e-05,1.0
52141,원세훈/Noun,1,0,1,0.0,1.1106915165381966e-05,1.0
52142,이병기/Noun,1,0,1,0.0,1.1106915165381966e-05,1.0
52143,잇몸/Noun,1,1,0,1.1115310228308472e-05,0.0,1.0
52144,￣/Foreign,1,1,0,1.1115310228308472e-05,0.0,1.0
52145,ㅈㅔ/KoreanParticle,1,1,0,1.1115310228308472e-05,0.0,1.0
52146,김추련/Noun,1,1,0,1.1115310228308472e-05,0.0,1.0
52147,포석/Noun,1,0,1,0.0,1.1106915165381966e-05,1.0
52148,날갯질/Noun,1,0,1,0.0,1.1106915165381966e-05,1.0
52149,가고일/Noun,1,0,1,0.0,1.1106915165381966e-05,1.0
52150,썅내/Noun,1,0,1,0.0,1.1106915165381966e-05,1.0
52151,김푸른/Noun,1,0,1,0.0,1.1106915165381966e-05,1.0
52152,이정우/Noun,1,0,1,0.0,1.1106915165381966e-05,1.0
52153,흐물거리/Noun,1,1,0,1.1115310228308472e-05,0.0,1.0
52154,1천/Number,1,1,0,1.1115310228308472e-05,0.0,1.0
52155,twelve/Alpha,1,0,1,0.0,1.1106915165381966e-05,1.0
52156,ID/Alpha,1,0,1,0.0,1.1106915165381966e-05,1.0
52157,핑클/Noun,1,0,1,0.0,1.1106915165381966e-05,1.0
52158,XXXX/Alpha,1,0,1,0.0,1.1106915165381966e-05,1.0
52159,~@!/Punctuation,1,1,0,1.1115310228308472e-05,0.0,1.0
52160,grace/Alpha,1,1,0,1.1115310228308472e-05,0.0,1.0
52161,savage/Alpha,1,1,0,1.1115310228308472e-05,0.0,1.0
52162,바해/Noun,1,0,1,0.0,1.1106915165381966e-05,1.0
52163,나츠오/Noun,1,1,0,1.1115310228308472e-05,0.0,1.0
52164,잼잏다/Noun,1,1,0,1.1115310228308472e-05,0.0,1.0
52165,ntertainer/Alpha,1,1,0,1.1115310228308472e-05,0.0,1.0
52166,임해/Noun,1,1,0,1.1115310228308472e-05,0.0,1.0
52167,코르/Noun,1,1,0,1.1115310228308472e-05,0.0,1.0
52168,미분/Noun,1,0,1,0.0,1.1106915165381966e-05,1.0
52169,산수/Noun,1,0,1,0.0,1.1106915165381966e-05,1.0
52170,ㅅㅅㄷㄷ/KoreanParticle,1,0,1,0.0,1.1106915165381966e-05,1.0
52171,못하갯/Noun,1,1,0,1.1115310228308472e-05,0.0,1.0
52172,ㅓㅏ/KoreanParticle,1,1,0,1.1115310228308472e-05,0.0,1.0
52173,9.92/Number,1,1,0,1.1115310228308472e-05,0.0,1.0
52174,cant/Alpha,1,1,0,1.1115310228308472e-05,0.0,1.0
52175,닥찬/Noun,1,1,0,1.1115310228308472e-05,0.0,1.0
52176,진대/Noun,1,1,0,1.1115310228308472e-05,0.0,1.0
52177,♥♥♥♥♥♥♥♥♥/Foreign,1,1,0,1.1115310228308472e-05,0.0,1.0
52178,쿠란/Noun,1,1,0,1.1115310228308472e-05,0.0,1.0
52179,슈사쿠/Noun,1,0,1,0.0,1.1106915165381966e-05,1.0
52180,포샤/Noun,1,1,0,1.1115310228308472e-05,0.0,1.0
52181,질햇/Noun,1,1,0,1.1115310228308472e-05,0.0,1.0
52182,조지부시/Noun,1,0,1,0.0,1.1106915165381966e-05,1.0
52183,낯가림/Noun,1,0,1,0.0,1.1106915165381966e-05,1.0
52184,온누리/Noun,1,0,1,0.0,1.1106915165381966e-05,1.0
52185,환기/Noun,1,1,0,1.1115310228308472e-05,0.0,1.0
52186,멀티플렉스/Noun,1,1,0,1.1115310228308472e-05,0.0,1.0
52187,페제/Noun,1,1,0,1.1115310228308472e-05,0.0,1.0
52188,^~*/Punctuation,1,0,1,0.0,1.1106915165381966e-05,1.0
52189,view/Alpha,1,1,0,1.1115310228308472e-05,0.0,1.0
52190,epic/Alpha,1,1,0,1.1115310228308472e-05,0.0,1.0
52191,MDB/Alpha,1,1,0,1.1115310228308472e-05,0.0,1.0
52192,산학/Noun,1,1,0,1.1115310228308472e-05,0.0,1.0
52193,121분/Number,1,0,1,0.0,1.1106915165381966e-05,1.0
52194,3333/Number,1,0,1,0.0,1.1106915165381966e-05,1.0
52195,플래닛테러/Noun,1,0,1,0.0,1.1106915165381966e-05,1.0
52196,accepted/Alpha,1,1,0,1.1115310228308472e-05,0.0,1.0
52197,음산/Noun,1,0,1,0.0,1.1106915165381966e-05,1.0
52198,옭/Noun,1,0,1,0.0,1.1106915165381966e-05,1.0
52199,?-.-;/Punctuation,1,0,1,0.0,1.1106915165381966e-05,1.0
52200,빌어먹을/Modifier,1,0,1,0.0,1.1106915165381966e-05,1.0
52201,부복/Noun,1,0,1,0.0,1.1106915165381966e-05,1.0
52202,징조/Noun,1,0,1,0.0,1.1106915165381966e-05,1.0
52203,존립/Noun,1,0,1,0.0,1.1106915165381966e-05,1.0
52204,있드/Noun,1,1,0,1.1115310228308472e-05,0.0,1.0
52205,뤽베송감독/Noun,1,1,0,1.1115310228308472e-05,0.0,1.0
52206,스탠윅/Noun,1,1,0,1.1115310228308472e-05,0.0,1.0
52207,와일더/Noun,1,1,0,1.1115310228308472e-05,0.0,1.0
52208,시네마테크/Noun,1,1,0,1.1115310228308472e-05,0.0,1.0
52209,9천만달러/Number,1,0,1,0.0,1.1106915165381966e-05,1.0
52210,독존/Noun,1,0,1,0.0,1.1106915165381966e-05,1.0
52211,애니멀/Noun,1,0,1,0.0,1.1106915165381966e-05,1.0
52212,구엽다/Noun,1,0,1,0.0,1.1106915165381966e-05,1.0
52213,~~!!..../Punctuation,1,0,1,0.0,1.1106915165381966e-05,1.0
52214,처온/Noun,1,1,0,1.1115310228308472e-05,0.0,1.0
52215,인투터스똠/Noun,1,1,0,1.1115310228308472e-05,0.0,1.0
52216,떳는/Noun,1,0,1,0.0,1.1106915165381966e-05,1.0
52217,빨간내복/Noun,1,1,0,1.1115310228308472e-05,0.0,1.0
52218,체색/Noun,1,1,0,1.1115310228308472e-05,0.0,1.0
52219,무체색/Noun,1,1,0,1.1115310228308472e-05,0.0,1.0
52220,카를로스/Noun,1,1,0,1.1115310228308472e-05,0.0,1.0
52221,심열/Noun,1,0,1,0.0,1.1106915165381966e-05,1.0
52222,빠샤/Noun,1,1,0,1.1115310228308472e-05,0.0,1.0
52223,브론떼/Noun,1,1,0,1.1115310228308472e-05,0.0,1.0
52224,.--;../Punctuation,1,0,1,0.0,1.1106915165381966e-05,1.0
52225,",,,,,,,,,,,,,,,,,/Punctuation",1,0,1,0.0,1.1106915165381966e-05,1.0
52226,만이구/Noun,1,0,1,0.0,1.1106915165381966e-05,1.0
52227,담금질/Noun,1,0,1,0.0,1.1106915165381966e-05,1.0
52228,욱해/Noun,1,1,0,1.1115310228308472e-05,0.0,1.0
52229,에엨따/Noun,1,0,1,0.0,1.1106915165381966e-05,1.0
52230,쩐아인훙/Noun,1,0,1,0.0,1.1106915165381966e-05,1.0
52231,찎/Noun,1,0,1,0.0,1.1106915165381966e-05,1.0
52232,긔졀/Noun,1,1,0,1.1115310228308472e-05,0.0,1.0
52233,래드/Noun,1,0,1,0.0,1.1106915165381966e-05,1.0
52234,아직못봣/Noun,1,1,0,1.1115310228308472e-05,0.0,1.0
52235,ㅋㄱㅋㅋㅋ/KoreanParticle,1,1,0,1.1115310228308472e-05,0.0,1.0
52236,딘부/Noun,1,0,1,0.0,1.1106915165381966e-05,1.0
52237,잡솨/Noun,1,0,1,0.0,1.1106915165381966e-05,1.0
52238,냠/Noun,1,0,1,0.0,1.1106915165381966e-05,1.0
52239,Aura/Alpha,1,1,0,1.1115310228308472e-05,0.0,1.0
52240,올드함/Noun,1,0,1,0.0,1.1106915165381966e-05,1.0
52241,왕얼/Noun,1,1,0,1.1115310228308472e-05,0.0,1.0
52242,05일/Number,1,1,0,1.1115310228308472e-05,0.0,1.0
52243,김덕/Noun,1,1,0,1.1115310228308472e-05,0.0,1.0
52244,슴살/Noun,1,1,0,1.1115310228308472e-05,0.0,1.0
52245,ㅂㅇㅂㅇ/KoreanParticle,1,0,1,0.0,1.1106915165381966e-05,1.0
52246,맹랭/Noun,1,0,1,0.0,1.1106915165381966e-05,1.0
52247,페터슨/Noun,1,0,1,0.0,1.1106915165381966e-05,1.0
52248,sdfsdfd/Alpha,1,0,1,0.0,1.1106915165381966e-05,1.0
52249,"_-,/Punctuation",1,0,1,0.0,1.1106915165381966e-05,1.0
52250,괜히밨/Noun,1,0,1,0.0,1.1106915165381966e-05,1.0
52251,스코프/Noun,1,1,0,1.1115310228308472e-05,0.0,1.0
52252,코픈데/Noun,1,1,0,1.1115310228308472e-05,0.0,1.0
52253,좋을껀뎅/Noun,1,1,0,1.1115310228308472e-05,0.0,1.0
52254,인데오/Noun,1,1,0,1.1115310228308472e-05,0.0,1.0
52255,파킨/Noun,1,1,0,1.1115310228308472e-05,0.0,1.0
52256,탬/Noun,1,0,1,0.0,1.1106915165381966e-05,1.0
52257,최강길드/Noun,1,0,1,0.0,1.1106915165381966e-05,1.0
52258,186/Number,1,0,1,0.0,1.1106915165381966e-05,1.0
52259,성모마리아/Noun,1,1,0,1.1115310228308472e-05,0.0,1.0
52260,미쯔코/Noun,1,1,0,1.1115310228308472e-05,0.0,1.0
52261,야류/Noun,1,0,1,0.0,1.1106915165381966e-05,1.0
52262,マ/Foreign,1,1,0,1.1115310228308472e-05,0.0,1.0
52263,電車男メインテ/Foreign,1,1,0,1.1115310228308472e-05,0.0,1.0
52264,석탈해/Noun,1,0,1,0.0,1.1106915165381966e-05,1.0
52265,잡입/Noun,1,0,1,0.0,1.1106915165381966e-05,1.0
52266,Marsquerade/Alpha,1,1,0,1.1115310228308472e-05,0.0,1.0
52267,하임/Noun,1,1,0,1.1115310228308472e-05,0.0,1.0
52268,재밌닼/Noun,1,1,0,1.1115310228308472e-05,0.0,1.0
52269,동경이야기/Noun,1,1,0,1.1115310228308472e-05,0.0,1.0
52270,찬티글/Noun,1,1,0,1.1115310228308472e-05,0.0,1.0
52271,개뻘쭘하/Noun,1,0,1,0.0,1.1106915165381966e-05,1.0
52272,더제/Noun,1,1,0,1.1115310228308472e-05,0.0,1.0
52273,때책/Noun,1,1,0,1.1115310228308472e-05,0.0,1.0
52274,驛/Foreign,1,1,0,1.1115310228308472e-05,0.0,1.0
52275,맨뒤/Noun,1,1,0,1.1115310228308472e-05,0.0,1.0
52276,어원/Noun,1,0,1,0.0,1.1106915165381966e-05,1.0
52277,왕궁/Noun,1,0,1,0.0,1.1106915165381966e-05,1.0
52278,당락/Noun,1,0,1,0.0,1.1106915165381966e-05,1.0
52279,삼돌이/Noun,1,0,1,0.0,1.1106915165381966e-05,1.0
52280,와플/Noun,1,1,0,1.1115310228308472e-05,0.0,1.0
52281,넒/Noun,1,1,0,1.1115310228308472e-05,0.0,1.0
52282,노비타/Noun,1,0,1,0.0,1.1106915165381966e-05,1.0
52283,스트래썬/Noun,1,0,1,0.0,1.1106915165381966e-05,1.0
52284,경찰복/Noun,1,0,1,0.0,1.1106915165381966e-05,1.0
52285,85%/Number,1,0,1,0.0,1.1106915165381966e-05,1.0
52286,꺼름찍/Noun,1,1,0,1.1115310228308472e-05,0.0,1.0
52287,물통/Noun,1,1,0,1.1115310228308472e-05,0.0,1.0
52288,벼룩/Noun,1,1,0,1.1115310228308472e-05,0.0,1.0
52289,게장/Noun,1,1,0,1.1115310228308472e-05,0.0,1.0
52290,14:35/Number,1,1,0,1.1115310228308472e-05,0.0,1.0
52291,anee/Alpha,1,1,0,1.1115310228308472e-05,0.0,1.0
52292,Hello/Alpha,1,1,0,1.1115310228308472e-05,0.0,1.0
52293,14:28/Number,1,1,0,1.1115310228308472e-05,0.0,1.0
52294,kw/Alpha,1,1,0,1.1115310228308472e-05,0.0,1.0
52295,14:25/Number,1,1,0,1.1115310228308472e-05,0.0,1.0
52296,dzho/Alpha,1,1,0,1.1115310228308472e-05,0.0,1.0
52297,14:08/Number,1,1,0,1.1115310228308472e-05,0.0,1.0
52298,chzh/Alpha,1,1,0,1.1115310228308472e-05,0.0,1.0
52299,쪼코/Noun,1,1,0,1.1115310228308472e-05,0.0,1.0
52300,초끈이론/Noun,1,0,1,0.0,1.1106915165381966e-05,1.0
52301,기타연주/Noun,1,1,0,1.1115310228308472e-05,0.0,1.0
52302,락락락/Noun,1,1,0,1.1115310228308472e-05,0.0,1.0
52303,둥당/Adverb,1,0,1,0.0,1.1106915165381966e-05,1.0
52304,웍스/Noun,1,0,1,0.0,1.1106915165381966e-05,1.0
52305,언리미티드/Noun,1,0,1,0.0,1.1106915165381966e-05,1.0
52306,이이만/Noun,1,1,0,1.1115310228308472e-05,0.0,1.0
52307,지금동/Noun,1,1,0,1.1115310228308472e-05,0.0,1.0
52308,조현병/Noun,1,0,1,0.0,1.1106915165381966e-05,1.0
52309,두셋/Noun,1,0,1,0.0,1.1106915165381966e-05,1.0
52310,젤린/Noun,1,1,0,1.1115310228308472e-05,0.0,1.0
52311,코리아타운/Noun,1,1,0,1.1115310228308472e-05,0.0,1.0
52312,따블입니/Noun,1,1,0,1.1115310228308472e-05,0.0,1.0
52313,DOA/Alpha,1,0,1,0.0,1.1106915165381966e-05,1.0
52314,~~~!!!./Punctuation,1,1,0,1.1115310228308472e-05,0.0,1.0
52315,완소남/Noun,1,1,0,1.1115310228308472e-05,0.0,1.0
52316,entry/Alpha,1,1,0,1.1115310228308472e-05,0.0,1.0
52317,unlawful/Alpha,1,1,0,1.1115310228308472e-05,0.0,1.0
52318,www.youtube.com/URL,1,1,0,1.1115310228308472e-05,0.0,1.0
52319,라파/Noun,1,0,1,0.0,1.1106915165381966e-05,1.0
52320,유신체제/Noun,1,1,0,1.1115310228308472e-05,0.0,1.0
52321,http://news.naver.com/main/read.nhn?mode=LSD&mid=sec&sid1=103&oid=005&aid=0000643652/URL,1,0,1,0.0,1.1106915165381966e-05,1.0
52322,(~.~)/Punctuation,1,1,0,1.1115310228308472e-05,0.0,1.0
52323,BR/Alpha,1,0,1,0.0,1.1106915165381966e-05,1.0
52324,왕별/Noun,1,1,0,1.1115310228308472e-05,0.0,1.0
52325,헬조선/Noun,1,1,0,1.1115310228308472e-05,0.0,1.0
52326,4.64/Number,1,1,0,1.1115310228308472e-05,0.0,1.0
52327,쒯중/Noun,1,0,1,0.0,1.1106915165381966e-05,1.0
52328,이기홍/Noun,1,1,0,1.1115310228308472e-05,0.0,1.0
52329,들었을까/Foreign,1,0,1,0.0,1.1106915165381966e-05,1.0
52330,유륜/Noun,1,0,1,0.0,1.1106915165381966e-05,1.0
52331,정범/Noun,1,0,1,0.0,1.1106915165381966e-05,1.0
52332,저작가/Noun,1,0,1,0.0,1.1106915165381966e-05,1.0
52333,snail/Alpha,1,1,0,1.1115310228308472e-05,0.0,1.0
52334,EQ/Alpha,1,0,1,0.0,1.1106915165381966e-05,1.0
52335,개정판/Noun,1,0,1,0.0,1.1106915165381966e-05,1.0
52336,러럴/Noun,1,0,1,0.0,1.1106915165381966e-05,1.0
52337,얼자/Noun,1,1,0,1.1115310228308472e-05,0.0,1.0
52338,호그/Noun,1,1,0,1.1115310228308472e-05,0.0,1.0
52339,연약/Noun,1,0,1,0.0,1.1106915165381966e-05,1.0
52340,희선짜릉/Noun,1,0,1,0.0,1.1106915165381966e-05,1.0
52341,스틱맨/Noun,1,1,0,1.1115310228308472e-05,0.0,1.0
52342,후접/Noun,1,0,1,0.0,1.1106915165381966e-05,1.0
52343,양부모/Noun,1,1,0,1.1115310228308472e-05,0.0,1.0
52344,땡글/Noun,1,1,0,1.1115310228308472e-05,0.0,1.0
52345,민좌/Noun,1,1,0,1.1115310228308472e-05,0.0,1.0
52346,골빈뇬들/Noun,1,0,1,0.0,1.1106915165381966e-05,1.0
52347,린줄/Noun,1,0,1,0.0,1.1106915165381966e-05,1.0
52348,yawning/Alpha,1,0,1,0.0,1.1106915165381966e-05,1.0
52349,sleep/Alpha,1,0,1,0.0,1.1106915165381966e-05,1.0
52350,폴스/Noun,1,1,0,1.1115310228308472e-05,0.0,1.0
52351,피버/Noun,1,1,0,1.1115310228308472e-05,0.0,1.0
52352,죄은/Noun,1,0,1,0.0,1.1106915165381966e-05,1.0
52353,test/Alpha,1,0,1,0.0,1.1106915165381966e-05,1.0
52354,!///Punctuation,1,1,0,1.1115310228308472e-05,0.0,1.0
52355,ㅄㄷㅇ/KoreanParticle,1,0,1,0.0,1.1106915165381966e-05,1.0
52356,은곰/Noun,1,1,0,1.1115310228308472e-05,0.0,1.0
52357,강대진/Noun,1,1,0,1.1115310228308472e-05,0.0,1.0
52358,최뭐/Noun,1,0,1,0.0,1.1106915165381966e-05,1.0
52359,박지민/Noun,1,0,1,0.0,1.1106915165381966e-05,1.0
52360,루피야/Noun,1,1,0,1.1115310228308472e-05,0.0,1.0
52361,양진우/Noun,1,1,0,1.1115310228308472e-05,0.0,1.0
52362,..!!!!~~/Punctuation,1,1,0,1.1115310228308472e-05,0.0,1.0
52363,출정/Noun,1,1,0,1.1115310228308472e-05,0.0,1.0
52364,~~;;/Punctuation,1,0,1,0.0,1.1106915165381966e-05,1.0
52365,머스탱/Noun,1,1,0,1.1115310228308472e-05,0.0,1.0
52366,호빠하/Noun,1,1,0,1.1115310228308472e-05,0.0,1.0
52367,센다이로/Noun,1,1,0,1.1115310228308472e-05,0.0,1.0
52368,윈스/Noun,1,1,0,1.1115310228308472e-05,0.0,1.0
52369,압권이었슴/Noun,1,1,0,1.1115310228308472e-05,0.0,1.0
52370,지붕뚫고하이킥/Noun,1,0,1,0.0,1.1106915165381966e-05,1.0
52371,자연미인/Noun,1,1,0,1.1115310228308472e-05,0.0,1.0
52372,SkyLine/Alpha,1,1,0,1.1115310228308472e-05,0.0,1.0
52373,남미영/Noun,1,1,0,1.1115310228308472e-05,0.0,1.0
52374,이맥/Noun,1,0,1,0.0,1.1106915165381966e-05,1.0
52375,눈덥힌산/Noun,1,0,1,0.0,1.1106915165381966e-05,1.0
52376,놀랫다/Noun,1,0,1,0.0,1.1106915165381966e-05,1.0
52377,썩창때매/Noun,1,0,1,0.0,1.1106915165381966e-05,1.0
52378,머저/Noun,1,0,1,0.0,1.1106915165381966e-05,1.0
52379,탈기/Noun,1,0,1,0.0,1.1106915165381966e-05,1.0
52380,쌤때메/Noun,1,0,1,0.0,1.1106915165381966e-05,1.0
52381,쨱/Noun,1,0,1,0.0,1.1106915165381966e-05,1.0
52382,햇을텐데/Noun,1,0,1,0.0,1.1106915165381966e-05,1.0
52383,건조/Noun,1,0,1,0.0,1.1106915165381966e-05,1.0
52384,스크립터/Noun,1,1,0,1.1115310228308472e-05,0.0,1.0
52385,봤어욤/Noun,1,1,0,1.1115310228308472e-05,0.0,1.0
52386,선인장/Noun,1,0,1,0.0,1.1106915165381966e-05,1.0
52387,아리엘/Noun,1,1,0,1.1115310228308472e-05,0.0,1.0
52388,영원불멸/Noun,1,1,0,1.1115310228308472e-05,0.0,1.0
52389,혈중/Noun,1,1,0,1.1115310228308472e-05,0.0,1.0
52390,양주/Noun,1,1,0,1.1115310228308472e-05,0.0,1.0
52391,금술/Noun,1,1,0,1.1115310228308472e-05,0.0,1.0
52392,박상우/Noun,1,0,1,0.0,1.1106915165381966e-05,1.0
52393,스필반/Noun,1,0,1,0.0,1.1106915165381966e-05,1.0
52394,파핫/Noun,1,1,0,1.1115310228308472e-05,0.0,1.0
52395,움켜잡다/Verb,1,0,1,0.0,1.1106915165381966e-05,1.0
52396,99999999999/Number,1,0,1,0.0,1.1106915165381966e-05,1.0
52397,알카에다/Noun,1,1,0,1.1115310228308472e-05,0.0,1.0
52398,만드내/Noun,1,0,1,0.0,1.1106915165381966e-05,1.0
52399,버라이어티쇼/Noun,1,0,1,0.0,1.1106915165381966e-05,1.0
52400,미전/Noun,1,0,1,0.0,1.1106915165381966e-05,1.0
52401,서자/Noun,1,0,1,0.0,1.1106915165381966e-05,1.0
52402,꼰/Noun,1,0,1,0.0,1.1106915165381966e-05,1.0
52403,만드셧음/Noun,1,0,1,0.0,1.1106915165381966e-05,1.0
52404,트랜센던스/Noun,1,1,0,1.1115310228308472e-05,0.0,1.0
52405,전라북도/Noun,1,0,1,0.0,1.1106915165381966e-05,1.0
52406,질제/Noun,1,0,1,0.0,1.1106915165381966e-05,1.0
52407,개죽이/Noun,1,1,0,1.1115310228308472e-05,0.0,1.0
52408,분담/Noun,1,1,0,1.1115310228308472e-05,0.0,1.0
52409,???!!!?/Punctuation,1,0,1,0.0,1.1106915165381966e-05,1.0
52410,까루/Noun,1,1,0,1.1115310228308472e-05,0.0,1.0
52411,구월/Noun,1,1,0,1.1115310228308472e-05,0.0,1.0
52412,프라이팬/Noun,1,1,0,1.1115310228308472e-05,0.0,1.0
52413,인듯/Noun,1,1,0,1.1115310228308472e-05,0.0,1.0
52414,북한삘/Noun,1,1,0,1.1115310228308472e-05,0.0,1.0
52415,"..,.,.,.,.,.,.,,.,.,/Punctuation",1,0,1,0.0,1.1106915165381966e-05,1.0
52416,ehwj/Alpha,1,0,1,0.0,1.1106915165381966e-05,1.0
52417,101010101010/Number,1,1,0,1.1115310228308472e-05,0.0,1.0
52418,버징/Noun,1,1,0,1.1115310228308472e-05,0.0,1.0
52419,할숭/Noun,1,0,1,0.0,1.1106915165381966e-05,1.0
52420,감옥살이/Noun,1,0,1,0.0,1.1106915165381966e-05,1.0
52421,멕뽕/Noun,1,0,1,0.0,1.1106915165381966e-05,1.0
52422,박식하다/Adjective,1,0,1,0.0,1.1106915165381966e-05,1.0
52423,경험론/Noun,1,0,1,0.0,1.1106915165381966e-05,1.0
52424,하이데거/Noun,1,0,1,0.0,1.1106915165381966e-05,1.0
52425,".,.,.,.,.,,.,/Punctuation",1,0,1,0.0,1.1106915165381966e-05,1.0
52426,깞/Noun,1,0,1,0.0,1.1106915165381966e-05,1.0
52427,회초리/Noun,1,0,1,0.0,1.1106915165381966e-05,1.0
52428,소석/Noun,1,0,1,0.0,1.1106915165381966e-05,1.0
52429,"~@""/Punctuation",1,0,1,0.0,1.1106915165381966e-05,1.0
52430,멋져욤/Noun,1,1,0,1.1115310228308472e-05,0.0,1.0
52431,뒤흔드/Noun,1,1,0,1.1115310228308472e-05,0.0,1.0
52432,핱핱핱/Noun,1,1,0,1.1115310228308472e-05,0.0,1.0
52433,solitude/Alpha,1,1,0,1.1115310228308472e-05,0.0,1.0
52434,봉우리/Noun,1,1,0,1.1115310228308472e-05,0.0,1.0
52435,습뉘더/Noun,1,1,0,1.1115310228308472e-05,0.0,1.0
52436,태임/Noun,1,0,1,0.0,1.1106915165381966e-05,1.0
52437,케어/Noun,1,0,1,0.0,1.1106915165381966e-05,1.0
52438,신속/Noun,1,1,0,1.1115310228308472e-05,0.0,1.0
52439,창씨개명/Noun,1,0,1,0.0,1.1106915165381966e-05,1.0
52440,스게/Noun,1,0,1,0.0,1.1106915165381966e-05,1.0
52441,앤더/Noun,1,0,1,0.0,1.1106915165381966e-05,1.0
52442,유머일번지/Noun,1,0,1,0.0,1.1106915165381966e-05,1.0
52443,동시녹음/Noun,1,1,0,1.1115310228308472e-05,0.0,1.0
52444,먹어랏/Noun,1,1,0,1.1115310228308472e-05,0.0,1.0
52445,180만/Number,1,1,0,1.1115310228308472e-05,0.0,1.0
52446,1800만/Number,1,1,0,1.1115310228308472e-05,0.0,1.0
52447,분뭐/Noun,1,1,0,1.1115310228308472e-05,0.0,1.0
52448,토핑/Noun,1,1,0,1.1115310228308472e-05,0.0,1.0
52449,솀/Noun,1,0,1,0.0,1.1106915165381966e-05,1.0
52450,개뼈/Noun,1,0,1,0.0,1.1106915165381966e-05,1.0
52451,부쩍/Noun,1,0,1,0.0,1.1106915165381966e-05,1.0
52452,빨점/Noun,1,0,1,0.0,1.1106915165381966e-05,1.0
52453,차주부인데남편때문에죽/Foreign,1,1,0,1.1115310228308472e-05,0.0,1.0
52454,무쟈비하/Noun,1,1,0,1.1115310228308472e-05,0.0,1.0
52455,샨티/Noun,1,0,1,0.0,1.1106915165381966e-05,1.0
52456,위빙/Noun,1,1,0,1.1115310228308472e-05,0.0,1.0
52457,큐어/Noun,1,0,1,0.0,1.1106915165381966e-05,1.0
52458,미스틱/Noun,1,0,1,0.0,1.1106915165381966e-05,1.0
52459,김찬우/Noun,1,1,0,1.1115310228308472e-05,0.0,1.0
52460,권위자/Noun,1,0,1,0.0,1.1106915165381966e-05,1.0
52461,쾌쾌/Noun,1,0,1,0.0,1.1106915165381966e-05,1.0
52462,망삘/Noun,1,0,1,0.0,1.1106915165381966e-05,1.0
52463,엮었어/Noun,1,1,0,1.1115310228308472e-05,0.0,1.0
52464,"..""^^/Punctuation",1,1,0,1.1115310228308472e-05,0.0,1.0
52465,한철수/Noun,1,1,0,1.1115310228308472e-05,0.0,1.0
52466,RAF/Alpha,1,1,0,1.1115310228308472e-05,0.0,1.0
52467,구세/Noun,1,1,0,1.1115310228308472e-05,0.0,1.0
52468,과로/Noun,1,1,0,1.1115310228308472e-05,0.0,1.0
52469,남하/Noun,1,1,0,1.1115310228308472e-05,0.0,1.0
52470,더맨더/Noun,1,0,1,0.0,1.1106915165381966e-05,1.0
52471,9.22/Number,1,0,1,0.0,1.1106915165381966e-05,1.0
52472,원만/Noun,1,0,1,0.0,1.1106915165381966e-05,1.0
52473,타도/Noun,1,1,0,1.1115310228308472e-05,0.0,1.0
52474,6.63/Number,1,1,0,1.1115310228308472e-05,0.0,1.0
52475,해장/Noun,1,0,1,0.0,1.1106915165381966e-05,1.0
52476,흉작/Noun,1,0,1,0.0,1.1106915165381966e-05,1.0
52477,천명관/Noun,1,0,1,0.0,1.1106915165381966e-05,1.0
52478,SE/Alpha,1,1,0,1.1115310228308472e-05,0.0,1.0
52479,찍을껀데/Noun,1,0,1,0.0,1.1106915165381966e-05,1.0
52480,보스턴/Noun,1,1,0,1.1115310228308472e-05,0.0,1.0
52481,파간/Noun,1,0,1,0.0,1.1106915165381966e-05,1.0
52482,닥정희/Noun,1,0,1,0.0,1.1106915165381966e-05,1.0
52483,ㅍㅍㅍ/KoreanParticle,1,1,0,1.1115310228308472e-05,0.0,1.0
52484,프메/Noun,1,0,1,0.0,1.1106915165381966e-05,1.0
52485,majesty/Alpha,1,1,0,1.1115310228308472e-05,0.0,1.0
52486,싄기/Noun,1,1,0,1.1115310228308472e-05,0.0,1.0
52487,우웨볼감독/Noun,1,0,1,0.0,1.1106915165381966e-05,1.0
52488,러어니잉/Noun,1,1,0,1.1115310228308472e-05,0.0,1.0
52489,쿠우/Noun,1,1,0,1.1115310228308472e-05,0.0,1.0
52490,요철/Noun,1,1,0,1.1115310228308472e-05,0.0,1.0
52491,철호/Noun,1,1,0,1.1115310228308472e-05,0.0,1.0
52492,섹히들/Noun,1,1,0,1.1115310228308472e-05,0.0,1.0
52493,들어야지/Foreign,1,0,1,0.0,1.1106915165381966e-05,1.0
52494,곡목/Noun,1,1,0,1.1115310228308472e-05,0.0,1.0
52495,가훈/Noun,1,1,0,1.1115310228308472e-05,0.0,1.0
52496,이승무/Noun,1,0,1,0.0,1.1106915165381966e-05,1.0
52497,살망/Noun,1,0,1,0.0,1.1106915165381966e-05,1.0
52498,설계도/Noun,1,1,0,1.1115310228308472e-05,0.0,1.0
52499,러프/Noun,1,0,1,0.0,1.1106915165381966e-05,1.0
52500,몃씬/Noun,1,0,1,0.0,1.1106915165381966e-05,1.0
52501,ㅓㅈ/KoreanParticle,1,1,0,1.1115310228308472e-05,0.0,1.0
52502,부칸/Noun,1,1,0,1.1115310228308472e-05,0.0,1.0
52503,원수연/Noun,1,1,0,1.1115310228308472e-05,0.0,1.0
52504,성수대교/Noun,1,1,0,1.1115310228308472e-05,0.0,1.0
52505,삼풍/Noun,1,1,0,1.1115310228308472e-05,0.0,1.0
52506,착거/Noun,1,0,1,0.0,1.1106915165381966e-05,1.0
52507,범증/Noun,1,1,0,1.1115310228308472e-05,0.0,1.0
52508,영화라는/Foreign,1,0,1,0.0,1.1106915165381966e-05,1.0
52509,개라도아깝지않을만큼의/Foreign,1,1,0,1.1115310228308472e-05,0.0,1.0
52510,5.3/Number,1,1,0,1.1115310228308472e-05,0.0,1.0
52511,나즈/Noun,1,1,0,1.1115310228308472e-05,0.0,1.0
52512,어바웃리키/Noun,1,0,1,0.0,1.1106915165381966e-05,1.0
52513,SEGA/Alpha,1,1,0,1.1115310228308472e-05,0.0,1.0
52514,개골/Noun,1,1,0,1.1115310228308472e-05,0.0,1.0
52515,1003950/Number,1,1,0,1.1115310228308472e-05,0.0,1.0
52516,짤릴/Noun,1,0,1,0.0,1.1106915165381966e-05,1.0
52517,남귤북/Noun,1,0,1,0.0,1.1106915165381966e-05,1.0
52518,수질/Noun,1,0,1,0.0,1.1106915165381966e-05,1.0
52519,말던/Noun,1,1,0,1.1115310228308472e-05,0.0,1.0
52520,몰랏네/Noun,1,1,0,1.1115310228308472e-05,0.0,1.0
52521,960억원/Number,1,1,0,1.1115310228308472e-05,0.0,1.0
52522,숯불/Noun,1,1,0,1.1115310228308472e-05,0.0,1.0
52523,도계/Noun,1,1,0,1.1115310228308472e-05,0.0,1.0
52524,김현아/Noun,1,1,0,1.1115310228308472e-05,0.0,1.0
52525,.....-_-../Punctuation,1,0,1,0.0,1.1106915165381966e-05,1.0
52526,삼각대/Noun,1,0,1,0.0,1.1106915165381966e-05,1.0
52527,봤기떄문/Noun,1,0,1,0.0,1.1106915165381966e-05,1.0
52528,Guiness/Alpha,1,1,0,1.1115310228308472e-05,0.0,1.0
52529,헝편없어/Noun,1,0,1,0.0,1.1106915165381966e-05,1.0
52530,마틴릭스/Noun,1,1,0,1.1115310228308472e-05,0.0,1.0
52531,ㄴㅈ/KoreanParticle,1,0,1,0.0,1.1106915165381966e-05,1.0
52532,moonlight/Alpha,1,1,0,1.1115310228308472e-05,0.0,1.0
52533,likes/Alpha,1,1,0,1.1115310228308472e-05,0.0,1.0
52534,memories/Alpha,1,1,0,1.1115310228308472e-05,0.0,1.0
52535,섭씨/Noun,1,0,1,0.0,1.1106915165381966e-05,1.0
52536,슉슉/Noun,1,0,1,0.0,1.1106915165381966e-05,1.0
52537,참수형/Noun,1,1,0,1.1115310228308472e-05,0.0,1.0
52538,피블즈/Noun,1,0,1,0.0,1.1106915165381966e-05,1.0
52539,육도/Noun,1,0,1,0.0,1.1106915165381966e-05,1.0
52540,윤반횽/Noun,1,1,0,1.1115310228308472e-05,0.0,1.0
52541,색깜/Noun,1,1,0,1.1115310228308472e-05,0.0,1.0
52542,.....??;;;;;;;;/Punctuation,1,0,1,0.0,1.1106915165381966e-05,1.0
52543,왕비호/Noun,1,0,1,0.0,1.1106915165381966e-05,1.0
52544,배긴스/Noun,1,0,1,0.0,1.1106915165381966e-05,1.0
52545,설킨듯/Noun,1,1,0,1.1115310228308472e-05,0.0,1.0
52546,워후/Noun,1,1,0,1.1115310228308472e-05,0.0,1.0
52547,죽치다/Verb,1,0,1,0.0,1.1106915165381966e-05,1.0
52548,선오브갓/Noun,1,0,1,0.0,1.1106915165381966e-05,1.0
52549,880/Number,1,0,1,0.0,1.1106915165381966e-05,1.0
52550,곤드레/Adverb,1,1,0,1.1115310228308472e-05,0.0,1.0
52551,본위/Noun,1,0,1,0.0,1.1106915165381966e-05,1.0
52552,23/5/Number,1,0,1,0.0,1.1106915165381966e-05,1.0
52553,테이저/Noun,1,1,0,1.1115310228308472e-05,0.0,1.0
52554,외강/Noun,1,1,0,1.1115310228308472e-05,0.0,1.0
52555,상훈/Noun,1,1,0,1.1115310228308472e-05,0.0,1.0
52556,황색/Noun,1,0,1,0.0,1.1106915165381966e-05,1.0
52557,20000/Number,1,0,1,0.0,1.1106915165381966e-05,1.0
52558,눈꼴/Noun,1,0,1,0.0,1.1106915165381966e-05,1.0
52559,삼이/Noun,1,1,0,1.1115310228308472e-05,0.0,1.0
52560,화잇팅/Noun,1,1,0,1.1115310228308472e-05,0.0,1.0
52561,설렁/Noun,1,0,1,0.0,1.1106915165381966e-05,1.0
52562,최은주/Noun,1,0,1,0.0,1.1106915165381966e-05,1.0
52563,히히힛/Noun,1,0,1,0.0,1.1106915165381966e-05,1.0
52564,팬위/Noun,1,0,1,0.0,1.1106915165381966e-05,1.0
52565,짘/Noun,1,1,0,1.1115310228308472e-05,0.0,1.0
52566,몽당연필/Noun,1,1,0,1.1115310228308472e-05,0.0,1.0
52567,증여/Noun,1,1,0,1.1115310228308472e-05,0.0,1.0
52568,호랑/Noun,1,0,1,0.0,1.1106915165381966e-05,1.0
52569,뻑뻑/Noun,1,0,1,0.0,1.1106915165381966e-05,1.0
52570,이거보닌깐/Noun,1,1,0,1.1115310228308472e-05,0.0,1.0
52571,주고봐도/Foreign,1,0,1,0.0,1.1106915165381966e-05,1.0
52572,맺혖으/Noun,1,0,1,0.0,1.1106915165381966e-05,1.0
52573,선민사상/Noun,1,0,1,0.0,1.1106915165381966e-05,1.0
52574,유대교/Noun,1,0,1,0.0,1.1106915165381966e-05,1.0
52575,초딍들/Noun,1,1,0,1.1115310228308472e-05,0.0,1.0
52576,이청준/Noun,1,1,0,1.1115310228308472e-05,0.0,1.0
52577,론디/Noun,1,0,1,0.0,1.1106915165381966e-05,1.0
52578,짤렸임/Noun,1,1,0,1.1115310228308472e-05,0.0,1.0
52579,2847948684/Number,1,0,1,0.0,1.1106915165381966e-05,1.0
52580,noraism/Alpha,1,0,1,0.0,1.1106915165381966e-05,1.0
52581,렌던/Noun,1,1,0,1.1115310228308472e-05,0.0,1.0
52582,잼났슴/Noun,1,1,0,1.1115310228308472e-05,0.0,1.0
52583,얙션씬/Noun,1,1,0,1.1115310228308472e-05,0.0,1.0
52584,최종환/Noun,1,0,1,0.0,1.1106915165381966e-05,1.0
52585,지하가/Noun,1,1,0,1.1115310228308472e-05,0.0,1.0
52586,npg/Alpha,1,1,0,1.1115310228308472e-05,0.0,1.0
52587,간창/Noun,1,0,1,0.0,1.1106915165381966e-05,1.0
52588,청춘만화/Noun,1,1,0,1.1115310228308472e-05,0.0,1.0
52589,닏/Noun,1,0,1,0.0,1.1106915165381966e-05,1.0
52590,리눌/Noun,1,0,1,0.0,1.1106915165381966e-05,1.0
52591,감응/Noun,1,1,0,1.1115310228308472e-05,0.0,1.0
52592,몃/Noun,1,0,1,0.0,1.1106915165381966e-05,1.0
52593,맹글었네/Noun,1,1,0,1.1115310228308472e-05,0.0,1.0
52594,좃았겠다/Noun,1,0,1,0.0,1.1106915165381966e-05,1.0
52595,따로업슴/Noun,1,0,1,0.0,1.1106915165381966e-05,1.0
52596,청국장/Noun,1,1,0,1.1115310228308472e-05,0.0,1.0
52597,중절/Noun,1,0,1,0.0,1.1106915165381966e-05,1.0
52598,꼴찌/Noun,1,0,1,0.0,1.1106915165381966e-05,1.0
52599,최혁/Noun,1,1,0,1.1115310228308472e-05,0.0,1.0
52600,합성쩌/Noun,1,0,1,0.0,1.1106915165381966e-05,1.0
52601,마눌년/Noun,1,1,0,1.1115310228308472e-05,0.0,1.0
52602,로번/Noun,1,1,0,1.1115310228308472e-05,0.0,1.0
52603,재의/Noun,1,1,0,1.1115310228308472e-05,0.0,1.0
52604,쟈밌는/Noun,1,1,0,1.1115310228308472e-05,0.0,1.0
52605,6.05/Number,1,1,0,1.1115310228308472e-05,0.0,1.0
52606,원슝/Noun,1,1,0,1.1115310228308472e-05,0.0,1.0
52607,농놈놈/Noun,1,0,1,0.0,1.1106915165381966e-05,1.0
52608,샅샅이/Noun,1,1,0,1.1115310228308472e-05,0.0,1.0
52609,일거수일투족/Noun,1,1,0,1.1115310228308472e-05,0.0,1.0
52610,무셥다/Noun,1,1,0,1.1115310228308472e-05,0.0,1.0
52611,휘틀휘/Noun,1,1,0,1.1115310228308472e-05,0.0,1.0
52612,송은이/Noun,1,0,1,0.0,1.1106915165381966e-05,1.0
52613,;;:/Punctuation,1,1,0,1.1115310228308472e-05,0.0,1.0
52614,햣/Noun,1,0,1,0.0,1.1106915165381966e-05,1.0
52615,wtf/Alpha,1,0,1,0.0,1.1106915165381966e-05,1.0
52616,홀몸/Noun,1,0,1,0.0,1.1106915165381966e-05,1.0
52617,개돌/Noun,1,0,1,0.0,1.1106915165381966e-05,1.0
52618,펔킹펀킹/Noun,1,0,1,0.0,1.1106915165381966e-05,1.0
52619,펔킹/Noun,1,0,1,0.0,1.1106915165381966e-05,1.0
52620,꼬은/Noun,1,0,1,0.0,1.1106915165381966e-05,1.0
52621,이지나/Foreign,1,1,0,1.1115310228308472e-05,0.0,1.0
52622,약오르다/Adjective,1,0,1,0.0,1.1106915165381966e-05,1.0
52623,ㅋㅍ/KoreanParticle,1,1,0,1.1115310228308472e-05,0.0,1.0
52624,블룩/Noun,1,1,0,1.1115310228308472e-05,0.0,1.0
52625,채트원/Noun,1,0,1,0.0,1.1106915165381966e-05,1.0
52626,재밌숩니/Noun,1,1,0,1.1115310228308472e-05,0.0,1.0
52627,힙보/Noun,1,0,1,0.0,1.1106915165381966e-05,1.0
52628,안되넹/Noun,1,0,1,0.0,1.1106915165381966e-05,1.0
52629,촉수/Noun,1,0,1,0.0,1.1106915165381966e-05,1.0
52630,가르마/Noun,1,1,0,1.1115310228308472e-05,0.0,1.0
52631,안재훈/Noun,1,1,0,1.1115310228308472e-05,0.0,1.0
52632,체팅/Noun,1,1,0,1.1115310228308472e-05,0.0,1.0
52633,"....^-^""/Punctuation",1,0,1,0.0,1.1106915165381966e-05,1.0
52634,.-_-;/Punctuation,1,0,1,0.0,1.1106915165381966e-05,1.0
52635,뽀르뚜/Noun,1,1,0,1.1115310228308472e-05,0.0,1.0
52636,마르크스/Noun,1,0,1,0.0,1.1106915165381966e-05,1.0
52637,정유경/Noun,1,0,1,0.0,1.1106915165381966e-05,1.0
52638,매킨토시/Noun,1,1,0,1.1115310228308472e-05,0.0,1.0
52639,생난리/Noun,1,0,1,0.0,1.1106915165381966e-05,1.0
52640,엮어주/Noun,1,1,0,1.1115310228308472e-05,0.0,1.0
52641,bingshen/Alpha,1,1,0,1.1115310228308472e-05,0.0,1.0
52642,위만/Noun,1,0,1,0.0,1.1106915165381966e-05,1.0
52643,모은정/Noun,1,0,1,0.0,1.1106915165381966e-05,1.0
52644,화러했다/Noun,1,1,0,1.1115310228308472e-05,0.0,1.0
52645,백상예술대상/Noun,1,1,0,1.1115310228308472e-05,0.0,1.0
52646,랬잔/Noun,1,1,0,1.1115310228308472e-05,0.0,1.0
52647,badge/Alpha,1,1,0,1.1115310228308472e-05,0.0,1.0
52648,soda/Alpha,1,1,0,1.1115310228308472e-05,0.0,1.0
52649,grape/Alpha,1,1,0,1.1115310228308472e-05,0.0,1.0
52650,belongs/Alpha,1,1,0,1.1115310228308472e-05,0.0,1.0
52651,honor/Alpha,1,1,0,1.1115310228308472e-05,0.0,1.0
52652,급속도/Noun,1,1,0,1.1115310228308472e-05,0.0,1.0
52653,Proposal/Alpha,1,1,0,1.1115310228308472e-05,0.0,1.0
52654,현상금/Noun,1,1,0,1.1115310228308472e-05,0.0,1.0
52655,완전돟/Noun,1,1,0,1.1115310228308472e-05,0.0,1.0
52656,거녔다/Noun,1,1,0,1.1115310228308472e-05,0.0,1.0
52657,ㅜㅁ/KoreanParticle,1,0,1,0.0,1.1106915165381966e-05,1.0
52658,적꿈/Noun,1,1,0,1.1115310228308472e-05,0.0,1.0
52659,bill/Alpha,1,1,0,1.1115310228308472e-05,0.0,1.0
52660,잼빅잼/Noun,1,1,0,1.1115310228308472e-05,0.0,1.0
52661,..@#$@#!/Punctuation,1,0,1,0.0,1.1106915165381966e-05,1.0
52662,상표/Noun,1,0,1,0.0,1.1106915165381966e-05,1.0
52663,--------------------------------------/Punctuation,1,1,0,1.1115310228308472e-05,0.0,1.0
52664,들긔/Foreign,1,1,0,1.1115310228308472e-05,0.0,1.0
52665,어떘을까/Noun,1,1,0,1.1115310228308472e-05,0.0,1.0
52666,에이프럴/Noun,1,1,0,1.1115310228308472e-05,0.0,1.0
52667,꽁냥꽁/Noun,1,1,0,1.1115310228308472e-05,0.0,1.0
52668,한다민/Noun,1,0,1,0.0,1.1106915165381966e-05,1.0
52669,저느/Noun,1,0,1,0.0,1.1106915165381966e-05,1.0
52670,버스커버스커/Noun,1,0,1,0.0,1.1106915165381966e-05,1.0
52671,말나/Noun,1,0,1,0.0,1.1106915165381966e-05,1.0
52672,하록/Noun,1,0,1,0.0,1.1106915165381966e-05,1.0
52673,무령왕릉/Noun,1,1,0,1.1115310228308472e-05,0.0,1.0
52674,파안/Noun,1,1,0,1.1115310228308472e-05,0.0,1.0
52675,결산/Noun,1,1,0,1.1115310228308472e-05,0.0,1.0
52676,뻔치/Noun,1,0,1,0.0,1.1106915165381966e-05,1.0
52677,로겟또/Noun,1,0,1,0.0,1.1106915165381966e-05,1.0
52678,엄씀/Noun,1,0,1,0.0,1.1106915165381966e-05,1.0
52679,노튼횽/Noun,1,1,0,1.1115310228308472e-05,0.0,1.0
52680,켜논채/Noun,1,0,1,0.0,1.1106915165381966e-05,1.0
52681,!!!!!!!!!!!!!!!!!!!!!!!!!!!!!!!!!!!!!!!!!!!!!!!!/Punctuation,1,0,1,0.0,1.1106915165381966e-05,1.0
52682,치칙/Noun,1,0,1,0.0,1.1106915165381966e-05,1.0
52683,치직/Noun,1,0,1,0.0,1.1106915165381966e-05,1.0
52684,빠앙/Noun,1,0,1,0.0,1.1106915165381966e-05,1.0
52685,콰쾅콰쾅/Noun,1,0,1,0.0,1.1106915165381966e-05,1.0
52686,외항/Noun,1,0,1,0.0,1.1106915165381966e-05,1.0
52687,테닥존잘흑/Noun,1,1,0,1.1115310228308472e-05,0.0,1.0
52688,133분/Number,1,1,0,1.1115310228308472e-05,0.0,1.0
52689,giveusfree/Alpha,1,0,1,0.0,1.1106915165381966e-05,1.0
52690,일단락/Noun,1,0,1,0.0,1.1106915165381966e-05,1.0
52691,SES/Alpha,1,0,1,0.0,1.1106915165381966e-05,1.0
52692,saaaad/Alpha,1,1,0,1.1115310228308472e-05,0.0,1.0
52693,나지나야/Foreign,1,0,1,0.0,1.1106915165381966e-05,1.0
52694,OOOOOOOOOOOO/Alpha,1,0,1,0.0,1.1106915165381966e-05,1.0
52695,끗나/Noun,1,0,1,0.0,1.1106915165381966e-05,1.0
52696,발새/Noun,1,0,1,0.0,1.1106915165381966e-05,1.0
52697,봣것/Noun,1,0,1,0.0,1.1106915165381966e-05,1.0
52698,ㅉㅉㄱ/KoreanParticle,1,1,0,1.1115310228308472e-05,0.0,1.0
52699,플란다스/Noun,1,0,1,0.0,1.1106915165381966e-05,1.0
52700,마알/Noun,1,0,1,0.0,1.1106915165381966e-05,1.0
52701,팽귄들/Noun,1,0,1,0.0,1.1106915165381966e-05,1.0
52702,파퍼/Noun,1,0,1,0.0,1.1106915165381966e-05,1.0
52703,왓네/Noun,1,0,1,0.0,1.1106915165381966e-05,1.0
52704,광고/Foreign,1,0,1,0.0,1.1106915165381966e-05,1.0
52705,장승업/Noun,1,1,0,1.1115310228308472e-05,0.0,1.0
52706,모교/Noun,1,1,0,1.1115310228308472e-05,0.0,1.0
52707,>>>>>/Punctuation,1,0,1,0.0,1.1106915165381966e-05,1.0
52708,신도안/Noun,1,0,1,0.0,1.1106915165381966e-05,1.0
52709,쩐것같다/Noun,1,0,1,0.0,1.1106915165381966e-05,1.0
52710,거터/Noun,1,0,1,0.0,1.1106915165381966e-05,1.0
52711,스컬/Noun,1,1,0,1.1115310228308472e-05,0.0,1.0
52712,대량학살/Noun,1,1,0,1.1115310228308472e-05,0.0,1.0
52713,!!!!!!!!!!!!!!!!!!!!!!!!!!!!!!!!!!!!!!!!!/Punctuation,1,1,0,1.1115310228308472e-05,0.0,1.0
52714,잭더/Noun,1,1,0,1.1115310228308472e-05,0.0,1.0
52715,조성도/Noun,1,0,1,0.0,1.1106915165381966e-05,1.0
52716,드렵/Noun,1,0,1,0.0,1.1106915165381966e-05,1.0
52717,플랫/Noun,1,1,0,1.1115310228308472e-05,0.0,1.0
52718,오리새/Noun,1,1,0,1.1115310228308472e-05,0.0,1.0
52719,왓킨스/Noun,1,1,0,1.1115310228308472e-05,0.0,1.0
52720,가시꽃/Noun,1,0,1,0.0,1.1106915165381966e-05,1.0
52721,점킥/Noun,1,1,0,1.1115310228308472e-05,0.0,1.0
52722,칼라브리아/Noun,1,1,0,1.1115310228308472e-05,0.0,1.0
52723,윌로비/Noun,1,0,1,0.0,1.1106915165381966e-05,1.0
52724,초조하다/Adjective,1,1,0,1.1115310228308472e-05,0.0,1.0
52725,여욱환/Noun,1,0,1,0.0,1.1106915165381966e-05,1.0
52726,장궤/Noun,1,0,1,0.0,1.1106915165381966e-05,1.0
52727,김부/Noun,1,1,0,1.1115310228308472e-05,0.0,1.0
52728,피아/Noun,1,0,1,0.0,1.1106915165381966e-05,1.0
52729,덷/Noun,1,0,1,0.0,1.1106915165381966e-05,1.0
52730,스틴버겐/Noun,1,0,1,0.0,1.1106915165381966e-05,1.0
52731,!!@@!@!/Punctuation,1,1,0,1.1115310228308472e-05,0.0,1.0
52732,서유진/Noun,1,1,0,1.1115310228308472e-05,0.0,1.0
52733,홧병있는/Noun,1,0,1,0.0,1.1106915165381966e-05,1.0
52734,요모조모/Noun,1,0,1,0.0,1.1106915165381966e-05,1.0
52735,남건/Noun,1,1,0,1.1115310228308472e-05,0.0,1.0
52736,괜찬아/Noun,1,1,0,1.1115310228308472e-05,0.0,1.0
52737,올림포스/Noun,1,0,1,0.0,1.1106915165381966e-05,1.0
52738,양피/Noun,1,0,1,0.0,1.1106915165381966e-05,1.0
52739,키클롭스/Noun,1,0,1,0.0,1.1106915165381966e-05,1.0
52740,연간/Noun,1,0,1,0.0,1.1106915165381966e-05,1.0
52741,겜블러/Noun,1,1,0,1.1115310228308472e-05,0.0,1.0
52742,비건/Noun,1,1,0,1.1115310228308472e-05,0.0,1.0
52743,재방또/Noun,1,1,0,1.1115310228308472e-05,0.0,1.0
52744,?@^^@/Punctuation,1,0,1,0.0,1.1106915165381966e-05,1.0
52745,던건/Noun,1,1,0,1.1115310228308472e-05,0.0,1.0
52746,썡뚱맞/Noun,1,0,1,0.0,1.1106915165381966e-05,1.0
52747,앗킨슨/Noun,1,1,0,1.1115310228308472e-05,0.0,1.0
52748,ㅏㅠ/KoreanParticle,1,1,0,1.1115310228308472e-05,0.0,1.0
52749,질왜/Noun,1,0,1,0.0,1.1106915165381966e-05,1.0
52750,폰타나/Noun,1,1,0,1.1115310228308472e-05,0.0,1.0
52751,어남/Noun,1,1,0,1.1115310228308472e-05,0.0,1.0
52752,뜌/Noun,1,1,0,1.1115310228308472e-05,0.0,1.0
52753,221분/Number,1,1,0,1.1115310228308472e-05,0.0,1.0
52754,사이/Foreign,1,0,1,0.0,1.1106915165381966e-05,1.0
52755,청불인딫모흐갯음/Noun,1,0,1,0.0,1.1106915165381966e-05,1.0
52756,디톡스/Noun,1,1,0,1.1115310228308472e-05,0.0,1.0
52757,스트라이잰드/Noun,1,1,0,1.1115310228308472e-05,0.0,1.0
52758,틈새시장/Noun,1,0,1,0.0,1.1106915165381966e-05,1.0
52759,알씨/Noun,1,0,1,0.0,1.1106915165381966e-05,1.0
52760,개뻘짓/Noun,1,0,1,0.0,1.1106915165381966e-05,1.0
52761,첩년/Noun,1,0,1,0.0,1.1106915165381966e-05,1.0
52762,군수산업체/Noun,1,0,1,0.0,1.1106915165381966e-05,1.0
52763,청량음료/Noun,1,1,0,1.1115310228308472e-05,0.0,1.0
52764,msg/Alpha,1,1,0,1.1115310228308472e-05,0.0,1.0
52765,등살/Noun,1,0,1,0.0,1.1106915165381966e-05,1.0
52766,었습니/Noun,1,1,0,1.1115310228308472e-05,0.0,1.0
52767,가범/Noun,1,0,1,0.0,1.1106915165381966e-05,1.0
52768,벵상페레/Noun,1,0,1,0.0,1.1106915165381966e-05,1.0
52769,임굿/Noun,1,1,0,1.1115310228308472e-05,0.0,1.0
52770,한조/Noun,1,1,0,1.1115310228308472e-05,0.0,1.0
52771,급특유/Noun,1,1,0,1.1115310228308472e-05,0.0,1.0
52772,어쩡쩡/Noun,1,0,1,0.0,1.1106915165381966e-05,1.0
52773,중신/Noun,1,1,0,1.1115310228308472e-05,0.0,1.0
52774,이재훈/Noun,1,1,0,1.1115310228308472e-05,0.0,1.0
52775,브르/Noun,1,0,1,0.0,1.1106915165381966e-05,1.0
52776,김정권/Noun,1,0,1,0.0,1.1106915165381966e-05,1.0
52777,소비자고발/Noun,1,0,1,0.0,1.1106915165381966e-05,1.0
52778,팬시/Noun,1,0,1,0.0,1.1106915165381966e-05,1.0
52779,준얘/Noun,1,0,1,0.0,1.1106915165381966e-05,1.0
52780,만만찮/Noun,1,1,0,1.1115310228308472e-05,0.0,1.0
52781,나성/Noun,1,0,1,0.0,1.1106915165381966e-05,1.0
52782,ddddbbbb/Alpha,1,1,0,1.1115310228308472e-05,0.0,1.0
52783,호프먼/Noun,1,1,0,1.1115310228308472e-05,0.0,1.0
52784,박찬호/Noun,1,0,1,0.0,1.1106915165381966e-05,1.0
52785,레인저스/Noun,1,0,1,0.0,1.1106915165381966e-05,1.0
52786,윤치호/Noun,1,0,1,0.0,1.1106915165381966e-05,1.0
52787,가막/Noun,1,0,1,0.0,1.1106915165381966e-05,1.0
52788,핸슨/Noun,1,1,0,1.1115310228308472e-05,0.0,1.0
52789,커티슨/Noun,1,1,0,1.1115310228308472e-05,0.0,1.0
52790,별탈/Noun,1,0,1,0.0,1.1106915165381966e-05,1.0
52791,허덕거리다/Verb,1,0,1,0.0,1.1106915165381966e-05,1.0
52792,핑돌거/Noun,1,1,0,1.1115310228308472e-05,0.0,1.0
52793,안섹쉬/Noun,1,0,1,0.0,1.1106915165381966e-05,1.0
52794,빡돌게함/Noun,1,0,1,0.0,1.1106915165381966e-05,1.0
52795,~~~~~~!!!!!/Punctuation,1,1,0,1.1115310228308472e-05,0.0,1.0
52796,영화느/Noun,1,0,1,0.0,1.1106915165381966e-05,1.0
52797,채안돼갑자기/Foreign,1,0,1,0.0,1.1106915165381966e-05,1.0
52798,부족전쟁/Noun,1,1,0,1.1115310228308472e-05,0.0,1.0
52799,./././././././/Punctuation,1,0,1,0.0,1.1106915165381966e-05,1.0
52800,연주회/Noun,1,1,0,1.1115310228308472e-05,0.0,1.0
52801,해라/Foreign,1,0,1,0.0,1.1106915165381966e-05,1.0
52802,하긔루/Noun,1,0,1,0.0,1.1106915165381966e-05,1.0
52803,북구/Noun,1,0,1,0.0,1.1106915165381966e-05,1.0
52804,길바/Noun,1,0,1,0.0,1.1106915165381966e-05,1.0
52805,관염/Noun,1,0,1,0.0,1.1106915165381966e-05,1.0
52806,공간활용/Noun,1,0,1,0.0,1.1106915165381966e-05,1.0
52807,김법래/Noun,1,1,0,1.1115310228308472e-05,0.0,1.0
52808,우격다짐/Noun,1,0,1,0.0,1.1106915165381966e-05,1.0
52809,최윤정/Noun,1,0,1,0.0,1.1106915165381966e-05,1.0
52810,부바/Noun,1,0,1,0.0,1.1106915165381966e-05,1.0
52811,IRA/Alpha,1,1,0,1.1115310228308472e-05,0.0,1.0
52812,김우열/Noun,1,1,0,1.1115310228308472e-05,0.0,1.0
52813,OB/Alpha,1,1,0,1.1115310228308472e-05,0.0,1.0
52814,",^-^/Punctuation",1,1,0,1.1115310228308472e-05,0.0,1.0
52815,ㅊㄹㅊㄹ/KoreanParticle,1,0,1,0.0,1.1106915165381966e-05,1.0
52816,신인왕전/Noun,1,0,1,0.0,1.1106915165381966e-05,1.0
52817,프로복싱/Noun,1,0,1,0.0,1.1106915165381966e-05,1.0
52818,변인/Noun,1,0,1,0.0,1.1106915165381966e-05,1.0
52819,돌연/Noun,1,0,1,0.0,1.1106915165381966e-05,1.0
52820,분량으로/Foreign,1,0,1,0.0,1.1106915165381966e-05,1.0
52821,대영화중/Foreign,1,1,0,1.1115310228308472e-05,0.0,1.0
52822,나밖/Noun,1,0,1,0.0,1.1106915165381966e-05,1.0
52823,철광/Noun,1,1,0,1.1115310228308472e-05,0.0,1.0
52824,샤버트/Noun,1,1,0,1.1115310228308472e-05,0.0,1.0
52825,물씬하다/Adjective,1,1,0,1.1115310228308472e-05,0.0,1.0
52826,때꼭/Noun,1,1,0,1.1115310228308472e-05,0.0,1.0
52827,떠붕이들/Noun,1,1,0,1.1115310228308472e-05,0.0,1.0
52828,나온걸루/Noun,1,0,1,0.0,1.1106915165381966e-05,1.0
52829,뭍힌/Noun,1,0,1,0.0,1.1106915165381966e-05,1.0
52830,느덕/Noun,1,1,0,1.1115310228308472e-05,0.0,1.0
52831,Makes/Alpha,1,0,1,0.0,1.1106915165381966e-05,1.0
52832,"-,,.-;;/Punctuation",1,1,0,1.1115310228308472e-05,0.0,1.0
52833,임댜/Noun,1,0,1,0.0,1.1106915165381966e-05,1.0
52834,훌륭햇음/Noun,1,1,0,1.1115310228308472e-05,0.0,1.0
52835,새집/Noun,1,1,0,1.1115310228308472e-05,0.0,1.0
52836,난별루/Noun,1,0,1,0.0,1.1106915165381966e-05,1.0
52837,클로저/Noun,1,1,0,1.1115310228308472e-05,0.0,1.0
52838,기공/Noun,1,1,0,1.1115310228308472e-05,0.0,1.0
52839,오니기리/Noun,1,1,0,1.1115310228308472e-05,0.0,1.0
52840,러빙유/Noun,1,1,0,1.1115310228308472e-05,0.0,1.0
52841,TwoAgainstTheWorld/Alpha,1,1,0,1.1115310228308472e-05,0.0,1.0
52842,함꼭/Noun,1,1,0,1.1115310228308472e-05,0.0,1.0
52843,회비/Noun,1,1,0,1.1115310228308472e-05,0.0,1.0
52844,지바고/Noun,1,0,1,0.0,1.1106915165381966e-05,1.0
52845,서정은/Noun,1,0,1,0.0,1.1106915165381966e-05,1.0
52846,조조만/Noun,1,0,1,0.0,1.1106915165381966e-05,1.0
52847,로마서/Noun,1,1,0,1.1115310228308472e-05,0.0,1.0
52848,광범위하다/Adjective,1,0,1,0.0,1.1106915165381966e-05,1.0
52849,컨버징/Noun,1,0,1,0.0,1.1106915165381966e-05,1.0
52850,익부/Noun,1,0,1,0.0,1.1106915165381966e-05,1.0
52851,빈익/Noun,1,0,1,0.0,1.1106915165381966e-05,1.0
52852,헤크/Noun,1,1,0,1.1115310228308472e-05,0.0,1.0
52853,앨버트/Noun,1,1,0,1.1115310228308472e-05,0.0,1.0
52854,성춘향/Noun,1,0,1,0.0,1.1106915165381966e-05,1.0
52855,룬/Noun,1,1,0,1.1115310228308472e-05,0.0,1.0
52856,점굿/Noun,1,0,1,0.0,1.1106915165381966e-05,1.0
52857,고는/Eomi,1,0,1,0.0,1.1106915165381966e-05,1.0
52858,김도현/Noun,1,1,0,1.1115310228308472e-05,0.0,1.0
52859,살라딘/Noun,1,0,1,0.0,1.1106915165381966e-05,1.0
52860,;;;;;;;;;;;;;;;;;;;;;;;;;;;;;/Punctuation,1,0,1,0.0,1.1106915165381966e-05,1.0
52861,지젼/Noun,1,0,1,0.0,1.1106915165381966e-05,1.0
52862,HELLO/Alpha,1,1,0,1.1115310228308472e-05,0.0,1.0
52863,인신/Noun,1,1,0,1.1115310228308472e-05,0.0,1.0
52864,☆☆☆☆☆/Foreign,1,1,0,1.1115310228308472e-05,0.0,1.0
52865,빡첬다/Noun,1,0,1,0.0,1.1106915165381966e-05,1.0
52866,83분/Number,1,0,1,0.0,1.1106915165381966e-05,1.0
52867,....??..../Punctuation,1,0,1,0.0,1.1106915165381966e-05,1.0
52868,신에쓰/Noun,1,0,1,0.0,1.1106915165381966e-05,1.0
52869,쳐만드삼/Noun,1,0,1,0.0,1.1106915165381966e-05,1.0
52870,돈퍼/Noun,1,0,1,0.0,1.1106915165381966e-05,1.0
52871,사오/Modifier,1,0,1,0.0,1.1106915165381966e-05,1.0
52872,문학가/Noun,1,0,1,0.0,1.1106915165381966e-05,1.0
52873,정육면체/Noun,1,1,0,1.1115310228308472e-05,0.0,1.0
52874,공금/Noun,1,0,1,0.0,1.1106915165381966e-05,1.0
52875,청춘불패/Noun,1,0,1,0.0,1.1106915165381966e-05,1.0
52876,만에그렇게되냐고오/Foreign,1,1,0,1.1115310228308472e-05,0.0,1.0
52877,입침/Noun,1,0,1,0.0,1.1106915165381966e-05,1.0
52878,봇로/Noun,1,0,1,0.0,1.1106915165381966e-05,1.0
52879,습역/Noun,1,0,1,0.0,1.1106915165381966e-05,1.0
52880,파리넬리/Noun,1,1,0,1.1115310228308472e-05,0.0,1.0
52881,조명도/Noun,1,1,0,1.1115310228308472e-05,0.0,1.0
52882,필욘없잖/Noun,1,0,1,0.0,1.1106915165381966e-05,1.0
52883,지령/Noun,1,0,1,0.0,1.1106915165381966e-05,1.0
52884,움베르토/Noun,1,0,1,0.0,1.1106915165381966e-05,1.0
52885,으그/Adverb,1,1,0,1.1115310228308472e-05,0.0,1.0
52886,민낯/Noun,1,1,0,1.1115310228308472e-05,0.0,1.0
52887,못생겻으면/Noun,1,0,1,0.0,1.1106915165381966e-05,1.0
52888,질럿음/Noun,1,0,1,0.0,1.1106915165381966e-05,1.0
52889,아쉿다/Noun,1,1,0,1.1115310228308472e-05,0.0,1.0
52890,seungkuk/Alpha,1,1,0,1.1115310228308472e-05,0.0,1.0
52891,-_-)//Punctuation,1,1,0,1.1115310228308472e-05,0.0,1.0
52892,finished/Alpha,1,1,0,1.1115310228308472e-05,0.0,1.0
52893,hesitate/Alpha,1,1,0,1.1115310228308472e-05,0.0,1.0
52894,moment/Alpha,1,1,0,1.1115310228308472e-05,0.0,1.0
52895,오해만/Noun,1,0,1,0.0,1.1106915165381966e-05,1.0
52896,스파이키즈/Noun,1,1,0,1.1115310228308472e-05,0.0,1.0
52897,혼트/Noun,1,1,0,1.1115310228308472e-05,0.0,1.0
52898,안봄/Noun,1,0,1,0.0,1.1106915165381966e-05,1.0
52899,빠롤/Noun,1,1,0,1.1115310228308472e-05,0.0,1.0
52900,???????????/Punctuation,1,1,0,1.1115310228308472e-05,0.0,1.0
52901,미라지/Noun,1,0,1,0.0,1.1106915165381966e-05,1.0
52902,것때메/Noun,1,0,1,0.0,1.1106915165381966e-05,1.0
52903,전국바사라/Noun,1,1,0,1.1115310228308472e-05,0.0,1.0
52904,부터몰아봤음/Foreign,1,1,0,1.1115310228308472e-05,0.0,1.0
52905,보게됐는데/Foreign,1,1,0,1.1115310228308472e-05,0.0,1.0
52906,쉣무비/Noun,1,0,1,0.0,1.1106915165381966e-05,1.0
52907,barstard/Alpha,1,1,0,1.1115310228308472e-05,0.0,1.0
52908,박기출/Noun,1,0,1,0.0,1.1106915165381966e-05,1.0
52909,마잔/Noun,1,1,0,1.1115310228308472e-05,0.0,1.0
52910,권윤덕/Noun,1,1,0,1.1115310228308472e-05,0.0,1.0
52911,발행/Noun,1,1,0,1.1115310228308472e-05,0.0,1.0
52912,심달연/Noun,1,1,0,1.1115310228308472e-05,0.0,1.0
52913,궁전/Noun,1,1,0,1.1115310228308472e-05,0.0,1.0
52914,숙달/Noun,1,1,0,1.1115310228308472e-05,0.0,1.0
52915,대뷔/Noun,1,1,0,1.1115310228308472e-05,0.0,1.0
52916,꿀꿀이죽/Noun,1,0,1,0.0,1.1106915165381966e-05,1.0
52917,······./Punctuation,1,0,1,0.0,1.1106915165381966e-05,1.0
52918,ACE/Alpha,1,1,0,1.1115310228308472e-05,0.0,1.0
52919,종빈/Noun,1,1,0,1.1115310228308472e-05,0.0,1.0
52920,강태욱/Noun,1,1,0,1.1115310228308472e-05,0.0,1.0
52921,}/Punctuation,1,0,1,0.0,1.1106915165381966e-05,1.0
52922,대면/Foreign,1,0,1,0.0,1.1106915165381966e-05,1.0
52923,느끼므리/Noun,1,0,1,0.0,1.1106915165381966e-05,1.0
52924,///////Punctuation,1,1,0,1.1115310228308472e-05,0.0,1.0
52925,/////////Punctuation,1,1,0,1.1115310228308472e-05,0.0,1.0
52926,월마트/Noun,1,0,1,0.0,1.1106915165381966e-05,1.0
52927,노블/Noun,1,0,1,0.0,1.1106915165381966e-05,1.0
52928,흐믓함/Noun,1,1,0,1.1115310228308472e-05,0.0,1.0
52929,들머리/Noun,1,1,0,1.1115310228308472e-05,0.0,1.0
52930,본보다/Verb,1,1,0,1.1115310228308472e-05,0.0,1.0
52931,은허/Noun,1,1,0,1.1115310228308472e-05,0.0,1.0
52932,킼/Noun,1,0,1,0.0,1.1106915165381966e-05,1.0
52933,학교떄문/Noun,1,1,0,1.1115310228308472e-05,0.0,1.0
52934,견마잡이/Noun,1,1,0,1.1115310228308472e-05,0.0,1.0
52935,서역/Noun,1,1,0,1.1115310228308472e-05,0.0,1.0
52936,나돌다/Verb,1,0,1,0.0,1.1106915165381966e-05,1.0
52937,징병/Noun,1,0,1,0.0,1.1106915165381966e-05,1.0
52938,처럼흘러가는/Foreign,1,1,0,1.1115310228308472e-05,0.0,1.0
52939,금욜날/Noun,1,1,0,1.1115310228308472e-05,0.0,1.0
52940,좀잼/Noun,1,1,0,1.1115310228308472e-05,0.0,1.0
52941,일찍이/Noun,1,1,0,1.1115310228308472e-05,0.0,1.0
52942,나장수/Noun,1,1,0,1.1115310228308472e-05,0.0,1.0
52943,잠구/Noun,1,0,1,0.0,1.1106915165381966e-05,1.0
52944,베른/Noun,1,1,0,1.1115310228308472e-05,0.0,1.0
52945,심비오트/Noun,1,1,0,1.1115310228308472e-05,0.0,1.0
52946,베놈/Noun,1,1,0,1.1115310228308472e-05,0.0,1.0
52947,보셧나/Noun,1,1,0,1.1115310228308472e-05,0.0,1.0
52948,교란/Noun,1,0,1,0.0,1.1106915165381966e-05,1.0
52949,183/Number,1,0,1,0.0,1.1106915165381966e-05,1.0
52950,182/Number,1,0,1,0.0,1.1106915165381966e-05,1.0
52951,ptk/Alpha,1,0,1,0.0,1.1106915165381966e-05,1.0
52952,~~!!>/Punctuation,1,1,0,1.1115310228308472e-05,0.0,1.0
52953,~~!>/Punctuation,1,1,0,1.1115310228308472e-05,0.0,1.0
52954,이쿠/Noun,1,0,1,0.0,1.1106915165381966e-05,1.0
52955,만들꺼면/Foreign,1,0,1,0.0,1.1106915165381966e-05,1.0
52956,중턱/Noun,1,0,1,0.0,1.1106915165381966e-05,1.0
52957,개쩡다/Noun,1,1,0,1.1115310228308472e-05,0.0,1.0
52958,최광희/Noun,1,0,1,0.0,1.1106915165381966e-05,1.0
52959,쭝궈/Noun,1,0,1,0.0,1.1106915165381966e-05,1.0
52960,햇습니/Noun,1,0,1,0.0,1.1106915165381966e-05,1.0
52961,조로아크/Noun,1,1,0,1.1115310228308472e-05,0.0,1.0
52962,개진/Noun,1,1,0,1.1115310228308472e-05,0.0,1.0
52963,수수깡/Noun,1,1,0,1.1115310228308472e-05,0.0,1.0
52964,할슨/Noun,1,0,1,0.0,1.1106915165381966e-05,1.0
52965,딕해/Noun,1,0,1,0.0,1.1106915165381966e-05,1.0
52966,훌룡했다/Noun,1,1,0,1.1115310228308472e-05,0.0,1.0
52967,애론/Noun,1,0,1,0.0,1.1106915165381966e-05,1.0
52968,뎠음/Noun,1,0,1,0.0,1.1106915165381966e-05,1.0
52969,휏/Noun,1,1,0,1.1115310228308472e-05,0.0,1.0
52970,스크롸/Noun,1,1,0,1.1115310228308472e-05,0.0,1.0
52971,국뽕짓/Noun,1,1,0,1.1115310228308472e-05,0.0,1.0
52972,****)//Punctuation,1,1,0,1.1115310228308472e-05,0.0,1.0
52973,outs/Alpha,1,1,0,1.1115310228308472e-05,0.0,1.0
52974,더우기/Noun,1,0,1,0.0,1.1106915165381966e-05,1.0
52975,Nielsen/Alpha,1,0,1,0.0,1.1106915165381966e-05,1.0
52976,Brigitte/Alpha,1,0,1,0.0,1.1106915165381966e-05,1.0
52977,색파/Noun,1,1,0,1.1115310228308472e-05,0.0,1.0
52978,펄떡/Noun,1,0,1,0.0,1.1106915165381966e-05,1.0
52979,왓수/Noun,1,0,1,0.0,1.1106915165381966e-05,1.0
52980,벵상/Noun,1,1,0,1.1115310228308472e-05,0.0,1.0
52981,격찬/Noun,1,1,0,1.1115310228308472e-05,0.0,1.0
52982,스테드/Noun,1,1,0,1.1115310228308472e-05,0.0,1.0
52983,디스커넥트/Noun,1,1,0,1.1115310228308472e-05,0.0,1.0
52984,커넥트/Noun,1,1,0,1.1115310228308472e-05,0.0,1.0
52985,브라운아이즈/Noun,1,0,1,0.0,1.1106915165381966e-05,1.0
52986,방송출연/Noun,1,0,1,0.0,1.1106915165381966e-05,1.0
52987,로펌/Noun,1,0,1,0.0,1.1106915165381966e-05,1.0
52988,제왑/Noun,1,1,0,1.1115310228308472e-05,0.0,1.0
52989,장인상/Noun,1,1,0,1.1115310228308472e-05,0.0,1.0
52990,바앞/Noun,1,1,0,1.1115310228308472e-05,0.0,1.0
52991,beprepared/Alpha,1,1,0,1.1115310228308472e-05,0.0,1.0
52992,밋듯/Noun,1,0,1,0.0,1.1106915165381966e-05,1.0
52993,구부러지다/Verb,1,1,0,1.1115310228308472e-05,0.0,1.0
52994,가운데손가락/Noun,1,1,0,1.1115310228308472e-05,0.0,1.0
52995,리무진/Noun,1,0,1,0.0,1.1106915165381966e-05,1.0
52996,whgdk/Alpha,1,1,0,1.1115310228308472e-05,0.0,1.0
52997,자증/Noun,1,0,1,0.0,1.1106915165381966e-05,1.0
52998,현대차/Noun,1,0,1,0.0,1.1106915165381966e-05,1.0
52999,싸운드/Noun,1,1,0,1.1115310228308472e-05,0.0,1.0
53000,완견/Noun,1,0,1,0.0,1.1106915165381966e-05,1.0
53001,이초/Noun,1,0,1,0.0,1.1106915165381966e-05,1.0
53002,7.18/Number,1,0,1,0.0,1.1106915165381966e-05,1.0
53003,허블/Noun,1,0,1,0.0,1.1106915165381966e-05,1.0
53004,cure/Alpha,1,0,1,0.0,1.1106915165381966e-05,1.0
53005,팬됫/Noun,1,1,0,1.1115310228308472e-05,0.0,1.0
53006,잼새잼/Noun,1,1,0,1.1115310228308472e-05,0.0,1.0
53007,쟄자째댖/Noun,1,1,0,1.1115310228308472e-05,0.0,1.0
53008,강기태/Noun,1,0,1,0.0,1.1106915165381966e-05,1.0
53009,희원/Noun,1,0,1,0.0,1.1106915165381966e-05,1.0
53010,만을/Foreign,1,1,0,1.1115310228308472e-05,0.0,1.0
53011,봉제/Noun,1,0,1,0.0,1.1106915165381966e-05,1.0
53012,plus/Alpha,1,0,1,0.0,1.1106915165381966e-05,1.0
53013,16억/Number,1,0,1,0.0,1.1106915165381966e-05,1.0
53014,"?!.,()??/Punctuation",1,0,1,0.0,1.1106915165381966e-05,1.0
53015,랍스터/Noun,1,0,1,0.0,1.1106915165381966e-05,1.0
53016,송이버섯/Noun,1,0,1,0.0,1.1106915165381966e-05,1.0
53017,소행성/Noun,1,0,1,0.0,1.1106915165381966e-05,1.0
53018,동물보호/Noun,1,1,0,1.1115310228308472e-05,0.0,1.0
53019,테닥로즈/Noun,1,1,0,1.1115310228308472e-05,0.0,1.0
53020,=:/Punctuation,1,0,1,0.0,1.1106915165381966e-05,1.0
53021,사금/Noun,1,1,0,1.1115310228308472e-05,0.0,1.0
53022,견줄만하/Noun,1,0,1,0.0,1.1106915165381966e-05,1.0
53023,동침/Noun,1,0,1,0.0,1.1106915165381966e-05,1.0
53024,스탭업따라함/Noun,1,0,1,0.0,1.1106915165381966e-05,1.0
53025,헠헠헠/Noun,1,0,1,0.0,1.1106915165381966e-05,1.0
53026,평상시/Noun,1,0,1,0.0,1.1106915165381966e-05,1.0
53027,통상/Noun,1,0,1,0.0,1.1106915165381966e-05,1.0
53028,신현지/Noun,1,0,1,0.0,1.1106915165381966e-05,1.0
53029,최소라/Noun,1,0,1,0.0,1.1106915165381966e-05,1.0
53030,진정선/Noun,1,0,1,0.0,1.1106915165381966e-05,1.0
53031,뽯/Noun,1,0,1,0.0,1.1106915165381966e-05,1.0
53032,궈푸청/Noun,1,1,0,1.1115310228308472e-05,0.0,1.0
53033,민주주의자/Noun,1,0,1,0.0,1.1106915165381966e-05,1.0
53034,급영화/Foreign,1,0,1,0.0,1.1106915165381966e-05,1.0
53035,급액숀물/Noun,1,0,1,0.0,1.1106915165381966e-05,1.0
53036,도다리/Noun,1,1,0,1.1115310228308472e-05,0.0,1.0
53037,우럭/Noun,1,1,0,1.1115310228308472e-05,0.0,1.0
53038,복수는나의것/Noun,1,1,0,1.1115310228308472e-05,0.0,1.0
53039,earth/Alpha,1,0,1,0.0,1.1106915165381966e-05,1.0
53040,salt/Alpha,1,0,1,0.0,1.1106915165381966e-05,1.0
53041,심축/Noun,1,1,0,1.1115310228308472e-05,0.0,1.0
53042,메탈슬러그/Noun,1,0,1,0.0,1.1106915165381966e-05,1.0
53043,티르/Noun,1,1,0,1.1115310228308472e-05,0.0,1.0
53044,믹막/Noun,1,1,0,1.1115310228308472e-05,0.0,1.0
53045,Locke/Alpha,1,1,0,1.1115310228308472e-05,0.0,1.0
53046,Joseph/Alpha,1,1,0,1.1115310228308472e-05,0.0,1.0
53047,킬킬대다/Verb,1,1,0,1.1115310228308472e-05,0.0,1.0
53048,나멋쪙/Noun,1,1,0,1.1115310228308472e-05,0.0,1.0
53049,.:-)/Punctuation,1,1,0,1.1115310228308472e-05,0.0,1.0
53050,캐스터/Noun,1,1,0,1.1115310228308472e-05,0.0,1.0
53051,조정린/Noun,1,1,0,1.1115310228308472e-05,0.0,1.0
53052,용치/Noun,1,1,0,1.1115310228308472e-05,0.0,1.0
53053,볼만헀다/Noun,1,1,0,1.1115310228308472e-05,0.0,1.0
53054,찍히고/Foreign,1,0,1,0.0,1.1106915165381966e-05,1.0
53055,달링/Noun,1,1,0,1.1115310228308472e-05,0.0,1.0
53056,웨건/Noun,1,1,0,1.1115310228308472e-05,0.0,1.0
53057,에들껄/Foreign,1,0,1,0.0,1.1106915165381966e-05,1.0
53058,수비대/Noun,1,0,1,0.0,1.1106915165381966e-05,1.0
53059,????..../Punctuation,1,0,1,0.0,1.1106915165381966e-05,1.0
53060,삭해/Noun,1,0,1,0.0,1.1106915165381966e-05,1.0
53061,그히/Noun,1,1,0,1.1115310228308472e-05,0.0,1.0
53062,푸스/Noun,1,0,1,0.0,1.1106915165381966e-05,1.0
53063,썻어야/Noun,1,0,1,0.0,1.1106915165381966e-05,1.0
53064,플라이즈/Noun,1,0,1,0.0,1.1106915165381966e-05,1.0
53065,도보잘거/Foreign,1,0,1,0.0,1.1106915165381966e-05,1.0
53066,ㅡㄴㅡ/KoreanParticle,1,0,1,0.0,1.1106915165381966e-05,1.0
53067,울퉁불퉁하다/Adjective,1,0,1,0.0,1.1106915165381966e-05,1.0
53068,쩌럿/Noun,1,1,0,1.1115310228308472e-05,0.0,1.0
53069,런웨이/Noun,1,1,0,1.1115310228308472e-05,0.0,1.0
53070,쌤썜/Noun,1,0,1,0.0,1.1106915165381966e-05,1.0
53071,괭이/Noun,1,0,1,0.0,1.1106915165381966e-05,1.0
53072,ㅋㅋㅎ/KoreanParticle,1,1,0,1.1115310228308472e-05,0.0,1.0
53073,잉그리쉬/Noun,1,1,0,1.1115310228308472e-05,0.0,1.0
53074,moved/Alpha,1,1,0,1.1115310228308472e-05,0.0,1.0
53075,피식거렸음/Noun,1,0,1,0.0,1.1106915165381966e-05,1.0
53076,요덕수용소/Noun,1,0,1,0.0,1.1106915165381966e-05,1.0
53077,100억달러/Number,1,0,1,0.0,1.1106915165381966e-05,1.0
53078,대식/Noun,1,1,0,1.1115310228308472e-05,0.0,1.0
53079,남방/Noun,1,1,0,1.1115310228308472e-05,0.0,1.0
53080,재문/Noun,1,1,0,1.1115310228308472e-05,0.0,1.0
53081,벌교/Noun,1,1,0,1.1115310228308472e-05,0.0,1.0
53082,2007.02/Number,1,1,0,1.1115310228308472e-05,0.0,1.0
53083,조삼모사/Noun,1,1,0,1.1115310228308472e-05,0.0,1.0
53084,https://t1.search.daumcdn.net/thumb/C110x160.q70/?fname=http%3A%2F%2Fcfile78.uf.daum.net%2FC110x160%2F195D724D50ECD8281116E2Total/URL,1,1,0,1.1115310228308472e-05,0.0,1.0
53085,실성하다/Adjective,1,0,1,0.0,1.1106915165381966e-05,1.0
53086,뻔햇노/Noun,1,0,1,0.0,1.1106915165381966e-05,1.0
53087,레셀웨폰/Noun,1,1,0,1.1115310228308472e-05,0.0,1.0
53088,어땟/Noun,1,1,0,1.1115310228308472e-05,0.0,1.0
53089,뭉테기/Noun,1,0,1,0.0,1.1106915165381966e-05,1.0
53090,우호/Noun,1,1,0,1.1115310228308472e-05,0.0,1.0
53091,초심자/Noun,1,0,1,0.0,1.1106915165381966e-05,1.0
53092,차스테인/Noun,1,0,1,0.0,1.1106915165381966e-05,1.0
53093,편위점/Noun,1,1,0,1.1115310228308472e-05,0.0,1.0
53094,완젼히/Noun,1,0,1,0.0,1.1106915165381966e-05,1.0
53095,데루등모양/Noun,1,1,0,1.1115310228308472e-05,0.0,1.0
53096,대업/Noun,1,0,1,0.0,1.1106915165381966e-05,1.0
53097,구기/Noun,1,1,0,1.1115310228308472e-05,0.0,1.0
53098,엘레베이터/Noun,1,1,0,1.1115310228308472e-05,0.0,1.0
53099,아랫입술/Noun,1,0,1,0.0,1.1106915165381966e-05,1.0
53100,김윤서/Noun,1,0,1,0.0,1.1106915165381966e-05,1.0
53101,Battle/Alpha,1,1,0,1.1115310228308472e-05,0.0,1.0
53102,24분/Number,1,1,0,1.1115310228308472e-05,0.0,1.0
53103,고교입시/Noun,1,0,1,0.0,1.1106915165381966e-05,1.0
53104,좋겠돠/Noun,1,1,0,1.1115310228308472e-05,0.0,1.0
53105,조성규/Noun,1,1,0,1.1115310228308472e-05,0.0,1.0
53106,엷다/Adjective,1,1,0,1.1115310228308472e-05,0.0,1.0
53107,CHCGV/Alpha,1,1,0,1.1115310228308472e-05,0.0,1.0
53108,ACTION/Alpha,1,1,0,1.1115310228308472e-05,0.0,1.0
53109,SUPER/Alpha,1,1,0,1.1115310228308472e-05,0.0,1.0
53110,주준영/Noun,1,1,0,1.1115310228308472e-05,0.0,1.0
53111,레슬린/Noun,1,1,0,1.1115310228308472e-05,0.0,1.0
53112,손현/Noun,1,1,0,1.1115310228308472e-05,0.0,1.0
53113,-----/Punctuation,1,1,0,1.1115310228308472e-05,0.0,1.0
53114,식빵/Noun,1,1,0,1.1115310228308472e-05,0.0,1.0
53115,맙니/Noun,1,0,1,0.0,1.1106915165381966e-05,1.0
53116,Nss/Alpha,1,0,1,0.0,1.1106915165381966e-05,1.0
53117,지명/Noun,1,0,1,0.0,1.1106915165381966e-05,1.0
53118,미숭맹숭함/Noun,1,0,1,0.0,1.1106915165381966e-05,1.0
53119,503/Number,1,1,0,1.1115310228308472e-05,0.0,1.0
53120,테릭/Noun,1,1,0,1.1115310228308472e-05,0.0,1.0
53121,임나/Noun,1,1,0,1.1115310228308472e-05,0.0,1.0
53122,컨대/Noun,1,0,1,0.0,1.1106915165381966e-05,1.0
53123,9999999999999999999999999999999999999/Number,1,1,0,1.1115310228308472e-05,0.0,1.0
53124,무숙자/Noun,1,1,0,1.1115310228308472e-05,0.0,1.0
53125,튜니티/Noun,1,1,0,1.1115310228308472e-05,0.0,1.0
53126,;;;..../Punctuation,1,0,1,0.0,1.1106915165381966e-05,1.0
53127,경망/Noun,1,1,0,1.1115310228308472e-05,0.0,1.0
53128,인편/Noun,1,0,1,0.0,1.1106915165381966e-05,1.0
53129,ㅋㅋㄱㄲ/KoreanParticle,1,0,1,0.0,1.1106915165381966e-05,1.0
53130,2013/9/Number,1,0,1,0.0,1.1106915165381966e-05,1.0
53131,멸하/Noun,1,0,1,0.0,1.1106915165381966e-05,1.0
53132,우렁찬/Noun,1,0,1,0.0,1.1106915165381966e-05,1.0
53133,합뉘돠/Noun,1,0,1,0.0,1.1106915165381966e-05,1.0
53134,뭐더/Noun,1,0,1,0.0,1.1106915165381966e-05,1.0
53135,슬레셔물이어딧/Noun,1,1,0,1.1115310228308472e-05,0.0,1.0
53136,잡아당기다/Verb,1,1,0,1.1115310228308472e-05,0.0,1.0
53137,일석이조/Noun,1,0,1,0.0,1.1106915165381966e-05,1.0
53138,맥쿼리인프라/Noun,1,0,1,0.0,1.1106915165381966e-05,1.0
53139,러러엋로/Noun,1,0,1,0.0,1.1106915165381966e-05,1.0
53140,ㅠㅎㅇㅎ/KoreanParticle,1,0,1,0.0,1.1106915165381966e-05,1.0
53141,전도서/Noun,1,0,1,0.0,1.1106915165381966e-05,1.0
53142,페더킹/Noun,1,0,1,0.0,1.1106915165381966e-05,1.0
53143,아난/Noun,1,1,0,1.1115310228308472e-05,0.0,1.0
53144,broadcasted/Alpha,1,1,0,1.1115310228308472e-05,0.0,1.0
53145,Doctor/Alpha,1,1,0,1.1115310228308472e-05,0.0,1.0
53146,데님/Noun,1,0,1,0.0,1.1106915165381966e-05,1.0
53147,네임레스/Noun,1,0,1,0.0,1.1106915165381966e-05,1.0
53148,갸비/Noun,1,0,1,0.0,1.1106915165381966e-05,1.0
53149,드라만데/Noun,1,0,1,0.0,1.1106915165381966e-05,1.0
53150,짜리영화/Foreign,1,1,0,1.1115310228308472e-05,0.0,1.0
53151,영화였다니/Foreign,1,0,1,0.0,1.1106915165381966e-05,1.0
53152,뚜이츄/Noun,1,1,0,1.1115310228308472e-05,0.0,1.0
53153,홍성진님/Noun,1,1,0,1.1115310228308472e-05,0.0,1.0
53154,Thing/Alpha,1,1,0,1.1115310228308472e-05,0.0,1.0
53155,Wonders/Alpha,1,1,0,1.1115310228308472e-05,0.0,1.0
53156,누르다/Adjective,1,1,0,1.1115310228308472e-05,0.0,1.0
53157,후에만든영화가이따위수준이라니/Foreign,1,0,1,0.0,1.1106915165381966e-05,1.0
53158,뜻일/Noun,1,1,0,1.1115310228308472e-05,0.0,1.0
53159,어밧타임/Noun,1,0,1,0.0,1.1106915165381966e-05,1.0
53160,가정교사/Noun,1,1,0,1.1115310228308472e-05,0.0,1.0
53161,삶임/Noun,1,0,1,0.0,1.1106915165381966e-05,1.0
53162,다합/Noun,1,1,0,1.1115310228308472e-05,0.0,1.0
53163,허기/Noun,1,0,1,0.0,1.1106915165381966e-05,1.0
53164,전달자/Noun,1,0,1,0.0,1.1106915165381966e-05,1.0
53165,무딘/Noun,1,0,1,0.0,1.1106915165381966e-05,1.0
53166,밀집/Noun,1,0,1,0.0,1.1106915165381966e-05,1.0
53167,앞장/Noun,1,0,1,0.0,1.1106915165381966e-05,1.0
53168,도세/Noun,1,1,0,1.1115310228308472e-05,0.0,1.0
53169,괴리속/Noun,1,1,0,1.1115310228308472e-05,0.0,1.0
53170,넘이뻣/Noun,1,1,0,1.1115310228308472e-05,0.0,1.0
53171,라이프스타일/Noun,1,0,1,0.0,1.1106915165381966e-05,1.0
53172,러팔/Noun,1,1,0,1.1115310228308472e-05,0.0,1.0
53173,라르고/Noun,1,1,0,1.1115310228308472e-05,0.0,1.0
53174,은오/Noun,1,1,0,1.1115310228308472e-05,0.0,1.0
53175,각박/Noun,1,1,0,1.1115310228308472e-05,0.0,1.0
53176,룡님/Noun,1,1,0,1.1115310228308472e-05,0.0,1.0
53177,고은님/Noun,1,0,1,0.0,1.1106915165381966e-05,1.0
53178,!!!.!../Punctuation,1,1,0,1.1115310228308472e-05,0.0,1.0
53179,~~..../Punctuation,1,0,1,0.0,1.1106915165381966e-05,1.0
53180,찰영함/Noun,1,0,1,0.0,1.1106915165381966e-05,1.0
53181,영후니/Noun,1,1,0,1.1115310228308472e-05,0.0,1.0
53182,돋넹/Noun,1,1,0,1.1115310228308472e-05,0.0,1.0
53183,판자촌/Noun,1,1,0,1.1115310228308472e-05,0.0,1.0
53184,늗/Noun,1,1,0,1.1115310228308472e-05,0.0,1.0
53185,./.../Punctuation,1,0,1,0.0,1.1106915165381966e-05,1.0
53186,dk/Alpha,1,0,1,0.0,1.1106915165381966e-05,1.0
53187,토너먼트/Noun,1,0,1,0.0,1.1106915165381966e-05,1.0
53188,이종환/Noun,1,0,1,0.0,1.1106915165381966e-05,1.0
53189,+_+!!/Punctuation,1,1,0,1.1115310228308472e-05,0.0,1.0
53190,감전/Noun,1,1,0,1.1115310228308472e-05,0.0,1.0
53191,위용/Noun,1,0,1,0.0,1.1106915165381966e-05,1.0
53192,실퍠/Noun,1,0,1,0.0,1.1106915165381966e-05,1.0
53193,치곻/Noun,1,0,1,0.0,1.1106915165381966e-05,1.0
53194,Hero/Alpha,1,1,0,1.1115310228308472e-05,0.0,1.0
53195,Media/Alpha,1,1,0,1.1115310228308472e-05,0.0,1.0
53196,?''/Punctuation,1,1,0,1.1115310228308472e-05,0.0,1.0
53197,야당/Noun,1,1,0,1.1115310228308472e-05,0.0,1.0
53198,132131432/Number,1,0,1,0.0,1.1106915165381966e-05,1.0
53199,???.??/Punctuation,1,0,1,0.0,1.1106915165381966e-05,1.0
53200,용남/Noun,1,0,1,0.0,1.1106915165381966e-05,1.0
53201,등장에/Foreign,1,0,1,0.0,1.1106915165381966e-05,1.0
53202,된영화인데도/Foreign,1,1,0,1.1115310228308472e-05,0.0,1.0
53203,강력범죄/Noun,1,1,0,1.1115310228308472e-05,0.0,1.0
53204,교권/Noun,1,1,0,1.1115310228308472e-05,0.0,1.0
53205,이걸봣/Noun,1,0,1,0.0,1.1106915165381966e-05,1.0
53206,이게뮌/Noun,1,0,1,0.0,1.1106915165381966e-05,1.0
53207,경판/Noun,1,1,0,1.1115310228308472e-05,0.0,1.0
53208,가전체/Noun,1,0,1,0.0,1.1106915165381966e-05,1.0
53209,같은/Foreign,1,0,1,0.0,1.1106915165381966e-05,1.0
53210,성선설/Noun,1,1,0,1.1115310228308472e-05,0.0,1.0
53211,깨갱/Adverb,1,0,1,0.0,1.1106915165381966e-05,1.0
53212,양부/Noun,1,0,1,0.0,1.1106915165381966e-05,1.0
53213,윤성일/Noun,1,0,1,0.0,1.1106915165381966e-05,1.0
53214,삐링삐링/Noun,1,1,0,1.1115310228308472e-05,0.0,1.0
53215,사라마구/Noun,1,0,1,0.0,1.1106915165381966e-05,1.0
53216,페르세우스/Noun,1,0,1,0.0,1.1106915165381966e-05,1.0
53217,크노소스/Noun,1,0,1,0.0,1.1106915165381966e-05,1.0
53218,의금요일/Foreign,1,1,0,1.1115310228308472e-05,0.0,1.0
53219,로날드/Noun,1,1,0,1.1115310228308472e-05,0.0,1.0
53220,카피캣/Noun,1,0,1,0.0,1.1106915165381966e-05,1.0
53221,로얄티/Noun,1,0,1,0.0,1.1106915165381966e-05,1.0
53222,똥습녀/Noun,1,0,1,0.0,1.1106915165381966e-05,1.0
53223,결벽증/Noun,1,0,1,0.0,1.1106915165381966e-05,1.0
53224,엘비스급/Noun,1,1,0,1.1115310228308472e-05,0.0,1.0
53225,마잭/Noun,1,1,0,1.1115310228308472e-05,0.0,1.0
53226,날치/Noun,1,1,0,1.1115310228308472e-05,0.0,1.0
53227,괜츈타/Noun,1,1,0,1.1115310228308472e-05,0.0,1.0
53228,떨/Noun,1,0,1,0.0,1.1106915165381966e-05,1.0
53229,백일/Noun,1,0,1,0.0,1.1106915165381966e-05,1.0
53230,조해/Noun,1,0,1,0.0,1.1106915165381966e-05,1.0
53231,인간취/Noun,1,0,1,0.0,1.1106915165381966e-05,1.0
53232,성육신/Noun,1,1,0,1.1115310228308472e-05,0.0,1.0
53233,손안/Noun,1,1,0,1.1115310228308472e-05,0.0,1.0
53234,만삭/Noun,1,1,0,1.1115310228308472e-05,0.0,1.0
53235,이충호/Noun,1,0,1,0.0,1.1106915165381966e-05,1.0
53236,장민경/Noun,1,1,0,1.1115310228308472e-05,0.0,1.0
53237,윤미조/Noun,1,1,0,1.1115310228308472e-05,0.0,1.0
53238,6788/Number,1,1,0,1.1115310228308472e-05,0.0,1.0
53239,king/Alpha,1,1,0,1.1115310228308472e-05,0.0,1.0
53240,lsyandeugene@naver.com/Email,1,1,0,1.1115310228308472e-05,0.0,1.0
53241,이기세/Noun,1,1,0,1.1115310228308472e-05,0.0,1.0
53242,이니/Foreign,1,0,1,0.0,1.1106915165381966e-05,1.0
53243,봭/Noun,1,0,1,0.0,1.1106915165381966e-05,1.0
53244,멘특/Noun,1,1,0,1.1115310228308472e-05,0.0,1.0
53245,알았느데/Noun,1,0,1,0.0,1.1106915165381966e-05,1.0
53246,솔짇히/Noun,1,0,1,0.0,1.1106915165381966e-05,1.0
53247,레카/Noun,1,0,1,0.0,1.1106915165381966e-05,1.0
53248,하팅/Noun,1,0,1,0.0,1.1106915165381966e-05,1.0
53249,라흐/Noun,1,0,1,0.0,1.1106915165381966e-05,1.0
53250,아니타/Noun,1,0,1,0.0,1.1106915165381966e-05,1.0
53251,즌에서/Foreign,1,0,1,0.0,1.1106915165381966e-05,1.0
53252,さようなら、永遠に/Foreign,1,0,1,0.0,1.1106915165381966e-05,1.0
53253,옹달샘/Noun,1,1,0,1.1115310228308472e-05,0.0,1.0
53254,피치스/Noun,1,1,0,1.1115310228308472e-05,0.0,1.0
53255,한미/Noun,1,1,0,1.1115310228308472e-05,0.0,1.0
53256,파럴/Noun,1,1,0,1.1115310228308472e-05,0.0,1.0
53257,그리그/Noun,1,1,0,1.1115310228308472e-05,0.0,1.0
53258,밸/Noun,1,1,0,1.1115310228308472e-05,0.0,1.0
53259,대영화마냥/Foreign,1,0,1,0.0,1.1106915165381966e-05,1.0
53260,포근포근하다/Adjective,1,1,0,1.1115310228308472e-05,0.0,1.0
53261,안영화/Noun,1,0,1,0.0,1.1106915165381966e-05,1.0
53262,술래/Noun,1,0,1,0.0,1.1106915165381966e-05,1.0
53263,7.08/Number,1,0,1,0.0,1.1106915165381966e-05,1.0
53264,베르너/Noun,1,0,1,0.0,1.1106915165381966e-05,1.0
53265,안줬다고혼낼때울컥/Foreign,1,1,0,1.1115310228308472e-05,0.0,1.0
53266,브로큰애로우/Noun,1,0,1,0.0,1.1106915165381966e-05,1.0
53267,승낙/Noun,1,0,1,0.0,1.1106915165381966e-05,1.0
53268,극형식/Noun,1,0,1,0.0,1.1106915165381966e-05,1.0
53269,묵묵/Noun,1,0,1,0.0,1.1106915165381966e-05,1.0
53270,박태준/Noun,1,0,1,0.0,1.1106915165381966e-05,1.0
53271,당태종/Noun,1,0,1,0.0,1.1106915165381966e-05,1.0
53272,스트레인저/Noun,1,0,1,0.0,1.1106915165381966e-05,1.0
53273,트웰브/Noun,1,0,1,0.0,1.1106915165381966e-05,1.0
53274,러비쉬/Noun,1,0,1,0.0,1.1106915165381966e-05,1.0
53275,있으느까/Noun,1,1,0,1.1115310228308472e-05,0.0,1.0
53276,cz/Alpha,1,1,0,1.1115310228308472e-05,0.0,1.0
53277,내부고발/Noun,1,1,0,1.1115310228308472e-05,0.0,1.0
53278,특별무대/Noun,1,0,1,0.0,1.1106915165381966e-05,1.0
53279,7.89/Number,1,0,1,0.0,1.1106915165381966e-05,1.0
53280,']/Punctuation,1,1,0,1.1115310228308472e-05,0.0,1.0
53281,['/Punctuation,1,1,0,1.1115310228308472e-05,0.0,1.0
53282,늉/Noun,1,1,0,1.1115310228308472e-05,0.0,1.0
53283,유턴/Noun,1,1,0,1.1115310228308472e-05,0.0,1.0
53284,에헤헹/Noun,1,1,0,1.1115310228308472e-05,0.0,1.0
53285,엔더슨/Noun,1,1,0,1.1115310228308472e-05,0.0,1.0
53286,깨평/Noun,1,1,0,1.1115310228308472e-05,0.0,1.0
53287,이중고/Noun,1,0,1,0.0,1.1106915165381966e-05,1.0
53288,comment/Alpha,1,0,1,0.0,1.1106915165381966e-05,1.0
53289,450만/Number,1,1,0,1.1115310228308472e-05,0.0,1.0
53290,위작/Noun,1,1,0,1.1115310228308472e-05,0.0,1.0
53291,......??????/Punctuation,1,0,1,0.0,1.1106915165381966e-05,1.0
53292,박영서/Noun,1,1,0,1.1115310228308472e-05,0.0,1.0
53293,대표팀/Noun,1,0,1,0.0,1.1106915165381966e-05,1.0
53294,행인/Noun,1,0,1,0.0,1.1106915165381966e-05,1.0
53295,이라서/Foreign,1,0,1,0.0,1.1106915165381966e-05,1.0
53296,정다혜/Noun,1,1,0,1.1115310228308472e-05,0.0,1.0
53297,만자/Noun,1,0,1,0.0,1.1106915165381966e-05,1.0
53298,떨어트려/Noun,1,0,1,0.0,1.1106915165381966e-05,1.0
53299,showbiz/Alpha,1,1,0,1.1115310228308472e-05,0.0,1.0
53300,잉마르/Noun,1,1,0,1.1115310228308472e-05,0.0,1.0
53301,반달/Noun,1,1,0,1.1115310228308472e-05,0.0,1.0
53302,훨배낫/Noun,1,0,1,0.0,1.1106915165381966e-05,1.0
53303,!!:/Punctuation,1,1,0,1.1115310228308472e-05,0.0,1.0
53304,짚라인/Noun,1,0,1,0.0,1.1106915165381966e-05,1.0
53305,젬네염/Noun,1,1,0,1.1115310228308472e-05,0.0,1.0
53306,공경심/Noun,1,1,0,1.1115310228308472e-05,0.0,1.0
53307,이상보는/Foreign,1,0,1,0.0,1.1106915165381966e-05,1.0
53308,동이면/Noun,1,1,0,1.1115310228308472e-05,0.0,1.0
53309,초감/Noun,1,1,0,1.1115310228308472e-05,0.0,1.0
53310,미세스폿트/Noun,1,1,0,1.1115310228308472e-05,0.0,1.0
53311,록스타/Noun,1,1,0,1.1115310228308472e-05,0.0,1.0
53312,엽차/Noun,1,0,1,0.0,1.1106915165381966e-05,1.0
53313,Christine/Alpha,1,1,0,1.1115310228308472e-05,0.0,1.0
53314,ㅋㄲㅋ/KoreanParticle,1,1,0,1.1115310228308472e-05,0.0,1.0
53315,엽당/Noun,1,1,0,1.1115310228308472e-05,0.0,1.0
53316,뜽/Noun,1,1,0,1.1115310228308472e-05,0.0,1.0
53317,과보/Noun,1,1,0,1.1115310228308472e-05,0.0,1.0
53318,콩녀/Noun,1,0,1,0.0,1.1106915165381966e-05,1.0
53319,콩남/Noun,1,0,1,0.0,1.1106915165381966e-05,1.0
53320,윤진킴/Noun,1,0,1,0.0,1.1106915165381966e-05,1.0
53321,Rethink/Alpha,1,1,0,1.1115310228308472e-05,0.0,1.0
53322,평자/Noun,1,1,0,1.1115310228308472e-05,0.0,1.0
53323,웅박/Noun,1,0,1,0.0,1.1106915165381966e-05,1.0
53324,경영/Noun,1,0,1,0.0,1.1106915165381966e-05,1.0
53325,이동국/Noun,1,1,0,1.1115310228308472e-05,0.0,1.0
53326,되돌리기/Noun,1,0,1,0.0,1.1106915165381966e-05,1.0
53327,말않되긍/Noun,1,0,1,0.0,1.1106915165381966e-05,1.0
53328,볼투/Noun,1,1,0,1.1115310228308472e-05,0.0,1.0
53329,슈퍼보이/Noun,1,1,0,1.1115310228308472e-05,0.0,1.0
53330,대에서/Foreign,1,0,1,0.0,1.1106915165381966e-05,1.0
53331,햐하핯/Noun,1,0,1,0.0,1.1106915165381966e-05,1.0
53332,1~50/Number,1,1,0,1.1115310228308472e-05,0.0,1.0
53333,류일/Noun,1,1,0,1.1115310228308472e-05,0.0,1.0
53334,mp/Alpha,1,0,1,0.0,1.1106915165381966e-05,1.0
53335,LC/Alpha,1,0,1,0.0,1.1106915165381966e-05,1.0
53336,해커스/Noun,1,0,1,0.0,1.1106915165381966e-05,1.0
53337,듀이핀/Noun,1,1,0,1.1115310228308472e-05,0.0,1.0
53338,예상힞/Noun,1,1,0,1.1115310228308472e-05,0.0,1.0
53339,뀌었다/Noun,1,1,0,1.1115310228308472e-05,0.0,1.0
53340,.........!/Punctuation,1,1,0,1.1115310228308472e-05,0.0,1.0
53341,더뻑/Adverb,1,0,1,0.0,1.1106915165381966e-05,1.0
53342,거칠마루/Noun,1,0,1,0.0,1.1106915165381966e-05,1.0
53343,IDIOT/Alpha,1,0,1,0.0,1.1106915165381966e-05,1.0
53344,앤마/Noun,1,1,0,1.1115310228308472e-05,0.0,1.0
53345,까닥/Adverb,1,0,1,0.0,1.1106915165381966e-05,1.0
53346,임펙트잇/Noun,1,1,0,1.1115310228308472e-05,0.0,1.0
53347,또해/Noun,1,1,0,1.1115310228308472e-05,0.0,1.0
53348,덮힌/Noun,1,1,0,1.1115310228308472e-05,0.0,1.0
53349,유창하다/Adjective,1,1,0,1.1115310228308472e-05,0.0,1.0
53350,",....?..../Punctuation",1,1,0,1.1115310228308472e-05,0.0,1.0
53351,다중이/Noun,1,0,1,0.0,1.1106915165381966e-05,1.0
53352,우르/Noun,1,0,1,0.0,1.1106915165381966e-05,1.0
53353,모히토/Noun,1,1,0,1.1115310228308472e-05,0.0,1.0
53354,ㅜㅡㅜㅜ/KoreanParticle,1,1,0,1.1115310228308472e-05,0.0,1.0
53355,"..-,.-/Punctuation",1,0,1,0.0,1.1106915165381966e-05,1.0
53356,생태/Noun,1,1,0,1.1115310228308472e-05,0.0,1.0
53357,엠피/Noun,1,1,0,1.1115310228308472e-05,0.0,1.0
53358,또옥/Noun,1,1,0,1.1115310228308472e-05,0.0,1.0
53359,"!,!/Punctuation",1,1,0,1.1115310228308472e-05,0.0,1.0
53360,"!!!,/Punctuation",1,1,0,1.1115310228308472e-05,0.0,1.0
53361,리산드라/Noun,1,0,1,0.0,1.1106915165381966e-05,1.0
53362,톰즈쿠즈/Noun,1,0,1,0.0,1.1106915165381966e-05,1.0
53363,호실/Noun,1,0,1,0.0,1.1106915165381966e-05,1.0
53364,....!!!!!!!!/Punctuation,1,1,0,1.1115310228308472e-05,0.0,1.0
53365,마병/Noun,1,1,0,1.1115310228308472e-05,0.0,1.0
53366,뽀너스/Noun,1,1,0,1.1115310228308472e-05,0.0,1.0
53367,@!!!!!!!!!!!!!!!!!!!!!!!!!!!!!!!!!!!!!!!!/Punctuation,1,0,1,0.0,1.1106915165381966e-05,1.0
53368,김혜은/Noun,1,0,1,0.0,1.1106915165381966e-05,1.0
53369,파편/Noun,1,0,1,0.0,1.1106915165381966e-05,1.0
53370,못생겄다/Noun,1,0,1,0.0,1.1106915165381966e-05,1.0
53371,맹박/Noun,1,0,1,0.0,1.1106915165381966e-05,1.0
53372,ㄷㅐㅏㅇ/KoreanParticle,1,1,0,1.1115310228308472e-05,0.0,1.0
53373,별루내/Noun,1,0,1,0.0,1.1106915165381966e-05,1.0
53374,나퀸/Noun,1,1,0,1.1115310228308472e-05,0.0,1.0
53375,랑귀/Noun,1,1,0,1.1115310228308472e-05,0.0,1.0
53376,심약하다/Adjective,1,1,0,1.1115310228308472e-05,0.0,1.0
53377,구석기시대/Noun,1,0,1,0.0,1.1106915165381966e-05,1.0
53378,카레이싱/Noun,1,0,1,0.0,1.1106915165381966e-05,1.0
53379,쑈할때/Noun,1,0,1,0.0,1.1106915165381966e-05,1.0
53380,윤세/Noun,1,0,1,0.0,1.1106915165381966e-05,1.0
53381,미친드/Noun,1,0,1,0.0,1.1106915165381966e-05,1.0
53382,정치검찰/Noun,1,1,0,1.1115310228308472e-05,0.0,1.0
53383,진아씨/Noun,1,1,0,1.1115310228308472e-05,0.0,1.0
53384,곽정욱/Noun,1,1,0,1.1115310228308472e-05,0.0,1.0
53385,울었더랬다/Noun,1,1,0,1.1115310228308472e-05,0.0,1.0
53386,쪼꼬릿/Noun,1,1,0,1.1115310228308472e-05,0.0,1.0
53387,폭발물/Noun,1,1,0,1.1115310228308472e-05,0.0,1.0
53388,어촌/Noun,1,0,1,0.0,1.1106915165381966e-05,1.0
53389,홀릭함/Noun,1,0,1,0.0,1.1106915165381966e-05,1.0
53390,교황청/Noun,1,0,1,0.0,1.1106915165381966e-05,1.0
53391,파브레가스/Noun,1,1,0,1.1115310228308472e-05,0.0,1.0
53392,업승/Noun,1,0,1,0.0,1.1106915165381966e-05,1.0
53393,빼애/Noun,1,0,1,0.0,1.1106915165381966e-05,1.0
53394,건듯/Adverb,1,0,1,0.0,1.1106915165381966e-05,1.0
53395,???......../Punctuation,1,0,1,0.0,1.1106915165381966e-05,1.0
53396,벵/Noun,1,1,0,1.1115310228308472e-05,0.0,1.0
53397,느보/Noun,1,1,0,1.1115310228308472e-05,0.0,1.0
53398,췌밌는데/Noun,1,1,0,1.1115310228308472e-05,0.0,1.0
53399,년됫/Noun,1,1,0,1.1115310228308472e-05,0.0,1.0
53400,치트/Noun,1,0,1,0.0,1.1106915165381966e-05,1.0
53401,전화번호/Noun,1,1,0,1.1115310228308472e-05,0.0,1.0
53402,양립/Noun,1,0,1,0.0,1.1106915165381966e-05,1.0
53403,재적/Noun,1,1,0,1.1115310228308472e-05,0.0,1.0
53404,짤짤/Noun,1,0,1,0.0,1.1106915165381966e-05,1.0
53405,일러스트/Noun,1,1,0,1.1115310228308472e-05,0.0,1.0
53406,짓밟힌/Noun,1,1,0,1.1115310228308472e-05,0.0,1.0
53407,명차/Noun,1,0,1,0.0,1.1106915165381966e-05,1.0
53408,왜도/Noun,1,1,0,1.1115310228308472e-05,0.0,1.0
53409,박상륭/Noun,1,1,0,1.1115310228308472e-05,0.0,1.0
53410,4.9/Number,1,0,1,0.0,1.1106915165381966e-05,1.0
53411,글리터/Noun,1,1,0,1.1115310228308472e-05,0.0,1.0
53412,천오백/Noun,1,0,1,0.0,1.1106915165381966e-05,1.0
53413,알럽키/Noun,1,1,0,1.1115310228308472e-05,0.0,1.0
53414,러샤/Noun,1,0,1,0.0,1.1106915165381966e-05,1.0
53415,ㅈㄸ/KoreanParticle,1,0,1,0.0,1.1106915165381966e-05,1.0
53416,보기도아깝다/Foreign,1,0,1,0.0,1.1106915165381966e-05,1.0
53417,쇼쇼쇼/Noun,1,0,1,0.0,1.1106915165381966e-05,1.0
53418,오스왈드/Noun,1,1,0,1.1115310228308472e-05,0.0,1.0
53419,스컹크/Noun,1,1,0,1.1115310228308472e-05,0.0,1.0
53420,정박/Noun,1,0,1,0.0,1.1106915165381966e-05,1.0
53421,잔상/Noun,1,1,0,1.1115310228308472e-05,0.0,1.0
53422,톰급/Noun,1,0,1,0.0,1.1106915165381966e-05,1.0
53423,~~~!??/Punctuation,1,0,1,0.0,1.1106915165381966e-05,1.0
53424,여준/Noun,1,0,1,0.0,1.1106915165381966e-05,1.0
53425,조우리/Noun,1,0,1,0.0,1.1106915165381966e-05,1.0
53426,정우식/Noun,1,0,1,0.0,1.1106915165381966e-05,1.0
53427,랜선소통/Noun,1,1,0,1.1115310228308472e-05,0.0,1.0
53428,웹로그/Noun,1,1,0,1.1115310228308472e-05,0.0,1.0
53429,미니홈피/Noun,1,1,0,1.1115310228308472e-05,0.0,1.0
53430,개낚였네그/Noun,1,0,1,0.0,1.1106915165381966e-05,1.0
53431,개잡침/Noun,1,0,1,0.0,1.1106915165381966e-05,1.0
53432,구리구리/Adverb,1,0,1,0.0,1.1106915165381966e-05,1.0
53433,여호와의증인/Noun,1,0,1,0.0,1.1106915165381966e-05,1.0
53434,뭉갠거/Noun,1,0,1,0.0,1.1106915165381966e-05,1.0
53435,흑흑뿌이뿌잉/Noun,1,0,1,0.0,1.1106915165381966e-05,1.0
53436,버버엉/Noun,1,0,1,0.0,1.1106915165381966e-05,1.0
53437,showing/Alpha,1,0,1,0.0,1.1106915165381966e-05,1.0
53438,expect/Alpha,1,0,1,0.0,1.1106915165381966e-05,1.0
53439,modest/Alpha,1,0,1,0.0,1.1106915165381966e-05,1.0
53440,position/Alpha,1,0,1,0.0,1.1106915165381966e-05,1.0
53441,plz/Alpha,1,0,1,0.0,1.1106915165381966e-05,1.0
53442,absen/Alpha,1,0,1,0.0,1.1106915165381966e-05,1.0
53443,안비/Noun,1,0,1,0.0,1.1106915165381966e-05,1.0
53444,헐리욷/Noun,1,1,0,1.1115310228308472e-05,0.0,1.0
53445,Cut/Alpha,1,0,1,0.0,1.1106915165381966e-05,1.0
53446,Jump/Alpha,1,0,1,0.0,1.1106915165381966e-05,1.0
53447,Godard/Alpha,1,0,1,0.0,1.1106915165381966e-05,1.0
53448,헛기침/Noun,1,0,1,0.0,1.1106915165381966e-05,1.0
53449,북촌/Noun,1,1,0,1.1115310228308472e-05,0.0,1.0
53450,염통/Noun,1,1,0,1.1115310228308472e-05,0.0,1.0
53451,무신론/Noun,1,1,0,1.1115310228308472e-05,0.0,1.0
53452,퇴역군인/Noun,1,1,0,1.1115310228308472e-05,0.0,1.0
53453,복무/Noun,1,1,0,1.1115310228308472e-05,0.0,1.0
53454,예정작/Noun,1,0,1,0.0,1.1106915165381966e-05,1.0
53455,만이천원/Noun,1,0,1,0.0,1.1106915165381966e-05,1.0
53456,이쁘넹/Noun,1,0,1,0.0,1.1106915165381966e-05,1.0
53457,꿰차/Noun,1,0,1,0.0,1.1106915165381966e-05,1.0
53458,김은미/Noun,1,1,0,1.1115310228308472e-05,0.0,1.0
53459,같았던/Noun,1,0,1,0.0,1.1106915165381966e-05,1.0
53460,여성인권/Noun,1,1,0,1.1115310228308472e-05,0.0,1.0
53461,소트니코바/Noun,1,0,1,0.0,1.1106915165381966e-05,1.0
53462,전문대/Noun,1,0,1,0.0,1.1106915165381966e-05,1.0
53463,명땜시/Noun,1,0,1,0.0,1.1106915165381966e-05,1.0
53464,턱수염/Noun,1,0,1,0.0,1.1106915165381966e-05,1.0
53465,따끔하다/Adjective,1,1,0,1.1115310228308472e-05,0.0,1.0
53466,겐지/Noun,1,0,1,0.0,1.1106915165381966e-05,1.0
53467,마너무쌔/Noun,1,0,1,0.0,1.1106915165381966e-05,1.0
53468,skfma/Alpha,1,1,0,1.1115310228308472e-05,0.0,1.0
53469,냉담하다/Adjective,1,1,0,1.1115310228308472e-05,0.0,1.0
53470,혈세/Noun,1,0,1,0.0,1.1106915165381966e-05,1.0
53471,ㅋㄴㄱㄹ/KoreanParticle,1,1,0,1.1115310228308472e-05,0.0,1.0
53472,쿠터노어커커텉럴/Noun,1,1,0,1.1115310228308472e-05,0.0,1.0
53473,무비스타/Noun,1,0,1,0.0,1.1106915165381966e-05,1.0
53474,티즈/Noun,1,0,1,0.0,1.1106915165381966e-05,1.0
53475,빰빠밤/Noun,1,1,0,1.1115310228308472e-05,0.0,1.0
53476,젠말/Noun,1,0,1,0.0,1.1106915165381966e-05,1.0
53477,톨킨/Noun,1,1,0,1.1115310228308472e-05,0.0,1.0
53478,만금/Noun,1,1,0,1.1115310228308472e-05,0.0,1.0
53479,":""/Punctuation",1,1,0,1.1115310228308472e-05,0.0,1.0
53480,화승/Noun,1,0,1,0.0,1.1106915165381966e-05,1.0
53481,평임/Noun,1,0,1,0.0,1.1106915165381966e-05,1.0
53482,변정민/Noun,1,0,1,0.0,1.1106915165381966e-05,1.0
53483,헬터/Noun,1,1,0,1.1115310228308472e-05,0.0,1.0
53484,~~~~!!!!!!!!!!!!!!!!!!!!!/Punctuation,1,1,0,1.1115310228308472e-05,0.0,1.0
53485,~~~~~!/Punctuation,1,1,0,1.1115310228308472e-05,0.0,1.0
53486,색시/Noun,1,1,0,1.1115310228308472e-05,0.0,1.0
53487,순천시/Noun,1,1,0,1.1115310228308472e-05,0.0,1.0
53488,전라남도/Noun,1,1,0,1.1115310228308472e-05,0.0,1.0
53489,훌룡함/Noun,1,1,0,1.1115310228308472e-05,0.0,1.0
53490,`^^/Punctuation,1,1,0,1.1115310228308472e-05,0.0,1.0
53491,캐딜락/Noun,1,0,1,0.0,1.1106915165381966e-05,1.0
53492,배경화면/Noun,1,1,0,1.1115310228308472e-05,0.0,1.0
53493,이란거에/Foreign,1,0,1,0.0,1.1106915165381966e-05,1.0
53494,신주/Noun,1,1,0,1.1115310228308472e-05,0.0,1.0
53495,봤늡데/Noun,1,1,0,1.1115310228308472e-05,0.0,1.0
53496,스어드베킷/Noun,1,1,0,1.1115310228308472e-05,0.0,1.0
53497,슈왈/Noun,1,1,0,1.1115310228308472e-05,0.0,1.0
53498,분원/Noun,1,1,0,1.1115310228308472e-05,0.0,1.0
53499,쾡하/Noun,1,1,0,1.1115310228308472e-05,0.0,1.0
53500,원귀/Noun,1,0,1,0.0,1.1106915165381966e-05,1.0
53501,",...;;/Punctuation",1,0,1,0.0,1.1106915165381966e-05,1.0
53502,리뱌/Noun,1,0,1,0.0,1.1106915165381966e-05,1.0
53503,8.1/Number,1,1,0,1.1115310228308472e-05,0.0,1.0
53504,6.3/Number,1,1,0,1.1115310228308472e-05,0.0,1.0
53505,허수/Noun,1,0,1,0.0,1.1106915165381966e-05,1.0
53506,흐엌/Noun,1,0,1,0.0,1.1106915165381966e-05,1.0
53507,내조/Noun,1,1,0,1.1115310228308472e-05,0.0,1.0
53508,썽띵/Noun,1,0,1,0.0,1.1106915165381966e-05,1.0
53509,애킷슨/Noun,1,1,0,1.1115310228308472e-05,0.0,1.0
53510,트라고/Noun,1,0,1,0.0,1.1106915165381966e-05,1.0
53511,보다껐는데/Foreign,1,0,1,0.0,1.1106915165381966e-05,1.0
53512,아뇨/Noun,1,0,1,0.0,1.1106915165381966e-05,1.0
53513,최헌/Noun,1,1,0,1.1115310228308472e-05,0.0,1.0
53514,낚였음그/Noun,1,0,1,0.0,1.1106915165381966e-05,1.0
53515,죙일기분나빳음/Noun,1,0,1,0.0,1.1106915165381966e-05,1.0
53516,앞장세우다/Verb,1,1,0,1.1115310228308472e-05,0.0,1.0
53517,난중일기/Noun,1,0,1,0.0,1.1106915165381966e-05,1.0
53518,메종일각/Noun,1,1,0,1.1115310228308472e-05,0.0,1.0
53519,힐다/Noun,1,1,0,1.1115310228308472e-05,0.0,1.0
53520,하동훈/Noun,1,1,0,1.1115310228308472e-05,0.0,1.0
53521,김준면/Noun,1,1,0,1.1115310228308472e-05,0.0,1.0
53522,후함/Noun,1,0,1,0.0,1.1106915165381966e-05,1.0
53523,뒹구느/Noun,1,0,1,0.0,1.1106915165381966e-05,1.0
53524,홀라당/Noun,1,0,1,0.0,1.1106915165381966e-05,1.0
53525,였어욤/Noun,1,0,1,0.0,1.1106915165381966e-05,1.0
53526,도영화네/Foreign,1,1,0,1.1115310228308472e-05,0.0,1.0
53527,키코/Noun,1,0,1,0.0,1.1106915165381966e-05,1.0
53528,생일도/Noun,1,1,0,1.1115310228308472e-05,0.0,1.0
53529,중거/Noun,1,1,0,1.1115310228308472e-05,0.0,1.0
53530,못하겄내/Noun,1,1,0,1.1115310228308472e-05,0.0,1.0
53531,안드나/Noun,1,0,1,0.0,1.1106915165381966e-05,1.0
53532,서머셋/Noun,1,1,0,1.1115310228308472e-05,0.0,1.0
53533,루도/Noun,1,1,0,1.1115310228308472e-05,0.0,1.0
53534,송경령/Noun,1,1,0,1.1115310228308472e-05,0.0,1.0
53535,새/Foreign,1,0,1,0.0,1.1106915165381966e-05,1.0
53536,규제/Noun,1,0,1,0.0,1.1106915165381966e-05,1.0
53537,페어런츠/Noun,1,0,1,0.0,1.1106915165381966e-05,1.0
53538,파목/Noun,1,1,0,1.1115310228308472e-05,0.0,1.0
53539,진배/Noun,1,0,1,0.0,1.1106915165381966e-05,1.0
53540,도청씬/Noun,1,0,1,0.0,1.1106915165381966e-05,1.0
53541,애션/Noun,1,1,0,1.1115310228308472e-05,0.0,1.0
53542,멈블/Noun,1,1,0,1.1115310228308472e-05,0.0,1.0
53543,Korea/Alpha,1,1,0,1.1115310228308472e-05,0.0,1.0
53544,봣겟/Noun,1,1,0,1.1115310228308472e-05,0.0,1.0
53545,동안허리아프다고거의훈련다빠지고뺑기치는쓰레기맞후임이/Foreign,1,1,0,1.1115310228308472e-05,0.0,1.0
53546,반짝스타/Noun,1,0,1,0.0,1.1106915165381966e-05,1.0
53547,리니/Noun,1,1,0,1.1115310228308472e-05,0.0,1.0
53548,보길도/Noun,1,0,1,0.0,1.1106915165381966e-05,1.0
53549,Into/Alpha,1,1,0,1.1115310228308472e-05,0.0,1.0
53550,Way/Alpha,1,1,0,1.1115310228308472e-05,0.0,1.0
53551,Bennett/Alpha,1,1,0,1.1115310228308472e-05,0.0,1.0
53552,Haley/Alpha,1,1,0,1.1115310228308472e-05,0.0,1.0
53553,Write/Alpha,1,1,0,1.1115310228308472e-05,0.0,1.0
53554,Grant/Alpha,1,1,0,1.1115310228308472e-05,0.0,1.0
53555,Hugh/Alpha,1,1,0,1.1115310228308472e-05,0.0,1.0
53556,호드/Noun,1,1,0,1.1115310228308472e-05,0.0,1.0
53557,......................................./Punctuation,1,1,0,1.1115310228308472e-05,0.0,1.0
53558,명임/Noun,1,0,1,0.0,1.1106915165381966e-05,1.0
53559,천단/Noun,1,0,1,0.0,1.1106915165381966e-05,1.0
53560,티리온/Noun,1,1,0,1.1115310228308472e-05,0.0,1.0
53561,응작/Noun,1,1,0,1.1115310228308472e-05,0.0,1.0
53562,산도/Noun,1,0,1,0.0,1.1106915165381966e-05,1.0
53563,이천/Noun,1,0,1,0.0,1.1106915165381966e-05,1.0
53564,해철/Noun,1,1,0,1.1115310228308472e-05,0.0,1.0
53565,절후/Noun,1,1,0,1.1115310228308472e-05,0.0,1.0
53566,고금/Noun,1,1,0,1.1115310228308472e-05,0.0,1.0
53567,거쟎/Noun,1,1,0,1.1115310228308472e-05,0.0,1.0
53568,묵비권/Noun,1,1,0,1.1115310228308472e-05,0.0,1.0
53569,바다코끼리/Noun,1,0,1,0.0,1.1106915165381966e-05,1.0
53570,증표/Noun,1,0,1,0.0,1.1106915165381966e-05,1.0
53571,꼬았다/Noun,1,0,1,0.0,1.1106915165381966e-05,1.0
53572,디빠/Noun,1,1,0,1.1115310228308472e-05,0.0,1.0
53573,GCV/Alpha,1,0,1,0.0,1.1106915165381966e-05,1.0
53574,볼론트/Noun,1,1,0,1.1115310228308472e-05,0.0,1.0
53575,편퀄리티/Noun,1,1,0,1.1115310228308472e-05,0.0,1.0
53576,ㅅㄹㅎㅇ/KoreanParticle,1,1,0,1.1115310228308472e-05,0.0,1.0
53577,컴플라이언스/Noun,1,0,1,0.0,1.1106915165381966e-05,1.0
53578,긍데/Adverb,1,0,1,0.0,1.1106915165381966e-05,1.0
53579,낚였구/Noun,1,0,1,0.0,1.1106915165381966e-05,1.0
53580,파이크/Noun,1,0,1,0.0,1.1106915165381966e-05,1.0
53581,먼드/Noun,1,0,1,0.0,1.1106915165381966e-05,1.0
53582,로자/Noun,1,0,1,0.0,1.1106915165381966e-05,1.0
53583,윤환/Noun,1,1,0,1.1115310228308472e-05,0.0,1.0
53584,자유도/Noun,1,0,1,0.0,1.1106915165381966e-05,1.0
53585,어벙/Noun,1,0,1,0.0,1.1106915165381966e-05,1.0
53586,대형스끄린/Noun,1,1,0,1.1115310228308472e-05,0.0,1.0
53587,띠리비/Noun,1,1,0,1.1115310228308472e-05,0.0,1.0
53588,NCIS/Alpha,1,1,0,1.1115310228308472e-05,0.0,1.0
53589,으헝어헝/Noun,1,1,0,1.1115310228308472e-05,0.0,1.0
53590,아크/Noun,1,1,0,1.1115310228308472e-05,0.0,1.0
53591,활극영화/Noun,1,0,1,0.0,1.1106915165381966e-05,1.0
53592,세척/Noun,1,0,1,0.0,1.1106915165381966e-05,1.0
53593,할애비/Noun,1,0,1,0.0,1.1106915165381966e-05,1.0
53594,전승/Noun,1,0,1,0.0,1.1106915165381966e-05,1.0
53595,꼬쓰뿌/Noun,1,1,0,1.1115310228308472e-05,0.0,1.0
53596,실험실/Noun,1,0,1,0.0,1.1106915165381966e-05,1.0
53597,놧음/Noun,1,1,0,1.1115310228308472e-05,0.0,1.0
53598,랫음/Noun,1,1,0,1.1115310228308472e-05,0.0,1.0
53599,솔찌/Noun,1,0,1,0.0,1.1106915165381966e-05,1.0
53600,boo/Alpha,1,1,0,1.1115310228308472e-05,0.0,1.0
53601,bobbidi/Alpha,1,1,0,1.1115310228308472e-05,0.0,1.0
53602,bibbidi/Alpha,1,1,0,1.1115310228308472e-05,0.0,1.0
53603,닭뼈/Noun,1,1,0,1.1115310228308472e-05,0.0,1.0
53604,말풍선/Noun,1,0,1,0.0,1.1106915165381966e-05,1.0
53605,더톱/Noun,1,1,0,1.1115310228308472e-05,0.0,1.0
53606,쇠사슬/Noun,1,0,1,0.0,1.1106915165381966e-05,1.0
53607,공무/Noun,1,0,1,0.0,1.1106915165381966e-05,1.0
53608,품평/Noun,1,1,0,1.1115310228308472e-05,0.0,1.0
53609,쩌업쩝/Noun,1,0,1,0.0,1.1106915165381966e-05,1.0
53610,안틴/Noun,1,0,1,0.0,1.1106915165381966e-05,1.0
53611,???????.../Punctuation,1,0,1,0.0,1.1106915165381966e-05,1.0
53612,번봣음/Noun,1,1,0,1.1115310228308472e-05,0.0,1.0
53613,엽혹진/Noun,1,0,1,0.0,1.1106915165381966e-05,1.0
53614,@;;/Foreign,1,1,0,1.1115310228308472e-05,0.0,1.0
53615,신학/Noun,1,0,1,0.0,1.1106915165381966e-05,1.0
53616,중최악/Foreign,1,0,1,0.0,1.1106915165381966e-05,1.0
53617,압바스/Noun,1,1,0,1.1115310228308472e-05,0.0,1.0
53618,승일/Noun,1,0,1,0.0,1.1106915165381966e-05,1.0
53619,윙윙/Noun,1,1,0,1.1115310228308472e-05,0.0,1.0
53620,오럴/Noun,1,1,0,1.1115310228308472e-05,0.0,1.0
53621,옥주현/Noun,1,0,1,0.0,1.1106915165381966e-05,1.0
53622,하고가/Eomi,1,1,0,1.1115310228308472e-05,0.0,1.0
53623,스무고개/Noun,1,1,0,1.1115310228308472e-05,0.0,1.0
53624,춘천/Noun,1,1,0,1.1115310228308472e-05,0.0,1.0
53625,짱앤/Noun,1,1,0,1.1115310228308472e-05,0.0,1.0
53626,꼬끼리/Noun,1,0,1,0.0,1.1106915165381966e-05,1.0
53627,벽파/Noun,1,0,1,0.0,1.1106915165381966e-05,1.0
53628,낚여보/Noun,1,0,1,0.0,1.1106915165381966e-05,1.0
53629,흩날리다/Verb,1,1,0,1.1115310228308472e-05,0.0,1.0
53630,바짓가랑이/Noun,1,1,0,1.1115310228308472e-05,0.0,1.0
53631,순두부/Noun,1,0,1,0.0,1.1106915165381966e-05,1.0
53632,쯤됐겠지/Foreign,1,1,0,1.1115310228308472e-05,0.0,1.0
53633,잣던/Noun,1,0,1,0.0,1.1106915165381966e-05,1.0
53634,더댐드/Noun,1,1,0,1.1115310228308472e-05,0.0,1.0
53635,방서/Noun,1,0,1,0.0,1.1106915165381966e-05,1.0
53636,가치판단/Noun,1,1,0,1.1115310228308472e-05,0.0,1.0
53637,속히/Adverb,1,1,0,1.1115310228308472e-05,0.0,1.0
53638,말론브랜도/Noun,1,1,0,1.1115310228308472e-05,0.0,1.0
53639,연어/Noun,1,0,1,0.0,1.1106915165381966e-05,1.0
53640,굴지/Noun,1,0,1,0.0,1.1106915165381966e-05,1.0
53641,연속본/Foreign,1,1,0,1.1115310228308472e-05,0.0,1.0
53642,찌릿찌릿/Adverb,1,1,0,1.1115310228308472e-05,0.0,1.0
53643,김혜숙/Noun,1,0,1,0.0,1.1106915165381966e-05,1.0
53644,회분/Noun,1,0,1,0.0,1.1106915165381966e-05,1.0
53645,황무지/Noun,1,1,0,1.1115310228308472e-05,0.0,1.0
53646,고세이쟈/Noun,1,1,0,1.1115310228308472e-05,0.0,1.0
53647,신문기자/Noun,1,1,0,1.1115310228308472e-05,0.0,1.0
53648,...!!!!!!!!!!!!!!!/Punctuation,1,1,0,1.1115310228308472e-05,0.0,1.0
53649,123444567890/Number,1,1,0,1.1115310228308472e-05,0.0,1.0
53650,239282/Number,1,1,0,1.1115310228308472e-05,0.0,1.0
53651,_^^_/Punctuation,1,1,0,1.1115310228308472e-05,0.0,1.0
53652,♣/Foreign,1,1,0,1.1115310228308472e-05,0.0,1.0
53653,나날/Noun,1,1,0,1.1115310228308472e-05,0.0,1.0
53654,바랬슴/Noun,1,1,0,1.1115310228308472e-05,0.0,1.0
53655,기념일/Noun,1,0,1,0.0,1.1106915165381966e-05,1.0
53656,견공들/Noun,1,1,0,1.1115310228308472e-05,0.0,1.0
53657,신무협/Noun,1,1,0,1.1115310228308472e-05,0.0,1.0
53658,작이나/Foreign,1,1,0,1.1115310228308472e-05,0.0,1.0
53659,WTH/Alpha,1,0,1,0.0,1.1106915165381966e-05,1.0
53660,잼없슴/Noun,1,0,1,0.0,1.1106915165381966e-05,1.0
53661,plex/Alpha,1,1,0,1.1115310228308472e-05,0.0,1.0
53662,176분/Number,1,0,1,0.0,1.1106915165381966e-05,1.0
53663,프레데터스/Noun,1,1,0,1.1115310228308472e-05,0.0,1.0
53664,서번/Noun,1,1,0,1.1115310228308472e-05,0.0,1.0
53665,리벤지/Noun,1,1,0,1.1115310228308472e-05,0.0,1.0
53666,좋을껄/Noun,1,0,1,0.0,1.1106915165381966e-05,1.0
53667,생인데알고있음/Foreign,1,1,0,1.1115310228308472e-05,0.0,1.0
53668,고지연/Noun,1,1,0,1.1115310228308472e-05,0.0,1.0
53669,핑크플로이드/Noun,1,1,0,1.1115310228308472e-05,0.0,1.0
53670,스타인/Noun,1,1,0,1.1115310228308472e-05,0.0,1.0
53671,~~^/Punctuation,1,0,1,0.0,1.1106915165381966e-05,1.0
53672,몸빼/Noun,1,0,1,0.0,1.1106915165381966e-05,1.0
53673,임정희/Noun,1,1,0,1.1115310228308472e-05,0.0,1.0
53674,쌍방/Noun,1,1,0,1.1115310228308472e-05,0.0,1.0
53675,중궈/Noun,1,0,1,0.0,1.1106915165381966e-05,1.0
53676,랠스톤/Noun,1,1,0,1.1115310228308472e-05,0.0,1.0
53677,위꼴/Noun,1,1,0,1.1115310228308472e-05,0.0,1.0
53678,꼬을/Noun,1,0,1,0.0,1.1106915165381966e-05,1.0
53679,자옥/Noun,1,1,0,1.1115310228308472e-05,0.0,1.0
53680,tksEmt/Alpha,1,1,0,1.1115310228308472e-05,0.0,1.0
53681,wjsrork/Alpha,1,1,0,1.1115310228308472e-05,0.0,1.0
53682,wnfrjfl/Alpha,1,1,0,1.1115310228308472e-05,0.0,1.0
53683,thwosk/Alpha,1,1,0,1.1115310228308472e-05,0.0,1.0
53684,게임중독자/Noun,1,1,0,1.1115310228308472e-05,0.0,1.0
53685,4초/Number,1,0,1,0.0,1.1106915165381966e-05,1.0
53686,블렉/Noun,1,0,1,0.0,1.1106915165381966e-05,1.0
53687,3.9%/Number,1,0,1,0.0,1.1106915165381966e-05,1.0
53688,89%/Number,1,0,1,0.0,1.1106915165381966e-05,1.0
53689,라보엠/Noun,1,1,0,1.1115310228308472e-05,0.0,1.0
53690,Cooooooool/Alpha,1,1,0,1.1115310228308472e-05,0.0,1.0
53691,MEGADETH/Alpha,1,1,0,1.1115310228308472e-05,0.0,1.0
53692,밴드활동/Noun,1,0,1,0.0,1.1106915165381966e-05,1.0
53693,캐버/Noun,1,0,1,0.0,1.1106915165381966e-05,1.0
53694,1227/Number,1,1,0,1.1115310228308472e-05,0.0,1.0
53695,rkdqhtmd/Alpha,1,1,0,1.1115310228308472e-05,0.0,1.0
53696,괭/Noun,1,1,0,1.1115310228308472e-05,0.0,1.0
53697,..)./Punctuation,1,0,1,0.0,1.1106915165381966e-05,1.0
53698,깜방가/Noun,1,0,1,0.0,1.1106915165381966e-05,1.0
53699,잔악하다/Adjective,1,0,1,0.0,1.1106915165381966e-05,1.0
53700,경리/Noun,1,0,1,0.0,1.1106915165381966e-05,1.0
53701,채밌네/Noun,1,1,0,1.1115310228308472e-05,0.0,1.0
53702,게란눈/Noun,1,0,1,0.0,1.1106915165381966e-05,1.0
53703,9999888/Number,1,0,1,0.0,1.1106915165381966e-05,1.0
53704,감명깊엇어/Noun,1,1,0,1.1115310228308472e-05,0.0,1.0
53705,자기혐오/Noun,1,0,1,0.0,1.1106915165381966e-05,1.0
53706,묘소/Noun,1,1,0,1.1115310228308472e-05,0.0,1.0
53707,망우/Noun,1,1,0,1.1115310228308472e-05,0.0,1.0
53708,과민/Noun,1,1,0,1.1115310228308472e-05,0.0,1.0
53709,지욱/Noun,1,0,1,0.0,1.1106915165381966e-05,1.0
53710,개졎걑/Noun,1,1,0,1.1115310228308472e-05,0.0,1.0
53711,무연/Noun,1,1,0,1.1115310228308472e-05,0.0,1.0
53712,압삘럽/Noun,1,1,0,1.1115310228308472e-05,0.0,1.0
53713,http://blog.naver.com/ghskfen87/90151959106/URL,1,1,0,1.1115310228308472e-05,0.0,1.0
53714,불충분하다/Adjective,1,1,0,1.1115310228308472e-05,0.0,1.0
53715,안내서/Noun,1,0,1,0.0,1.1106915165381966e-05,1.0
53716,섹귀들/Noun,1,1,0,1.1115310228308472e-05,0.0,1.0
53717,ㅍㄹㄱ/KoreanParticle,1,1,0,1.1115310228308472e-05,0.0,1.0
53718,"^^~""'//Punctuation",1,1,0,1.1115310228308472e-05,0.0,1.0
53719,손지창/Noun,1,1,0,1.1115310228308472e-05,0.0,1.0
53720,morbidsaint/Alpha,1,1,0,1.1115310228308472e-05,0.0,1.0
53721,엄청웃엇음/Noun,1,1,0,1.1115310228308472e-05,0.0,1.0
53722,에쉬든커쳐떄문/Noun,1,1,0,1.1115310228308472e-05,0.0,1.0
53723,정국/Noun,1,1,0,1.1115310228308472e-05,0.0,1.0
53724,암실/Noun,1,1,0,1.1115310228308472e-05,0.0,1.0
53725,SICKO/Alpha,1,1,0,1.1115310228308472e-05,0.0,1.0
53726,더덛/Noun,1,1,0,1.1115310228308472e-05,0.0,1.0
53727,ㅁㅋㅋㅋ/KoreanParticle,1,1,0,1.1115310228308472e-05,0.0,1.0
53728,타자기/Noun,1,1,0,1.1115310228308472e-05,0.0,1.0
53729,청도/Noun,1,0,1,0.0,1.1106915165381966e-05,1.0
53730,탐탐/Noun,1,0,1,0.0,1.1106915165381966e-05,1.0
53731,퐁쭈/Noun,1,0,1,0.0,1.1106915165381966e-05,1.0
53732,박성근/Noun,1,0,1,0.0,1.1106915165381966e-05,1.0
53733,이삭/Noun,1,0,1,0.0,1.1106915165381966e-05,1.0
53734,인왕산/Noun,1,0,1,0.0,1.1106915165381966e-05,1.0
53735,mVg/Alpha,1,0,1,0.0,1.1106915165381966e-05,1.0
53736,하림각/Noun,1,0,1,0.0,1.1106915165381966e-05,1.0
53737,평창동/Noun,1,0,1,0.0,1.1106915165381966e-05,1.0
53738,부암동/Noun,1,0,1,0.0,1.1106915165381966e-05,1.0
53739,日母/Foreign,1,0,1,0.0,1.1106915165381966e-05,1.0
53740,도편/Noun,1,1,0,1.1115310228308472e-05,0.0,1.0
53741,심뽄/Noun,1,0,1,0.0,1.1106915165381966e-05,1.0
53742,Freedom/Alpha,1,1,0,1.1115310228308472e-05,0.0,1.0
53743,망청/Noun,1,0,1,0.0,1.1106915165381966e-05,1.0
53744,작업실/Noun,1,0,1,0.0,1.1106915165381966e-05,1.0
53745,코메딕하/Noun,1,1,0,1.1115310228308472e-05,0.0,1.0
53746,오호통재/Exclamation,1,0,1,0.0,1.1106915165381966e-05,1.0
53747,공연예술/Noun,1,1,0,1.1115310228308472e-05,0.0,1.0
53748,김은정/Noun,1,1,0,1.1115310228308472e-05,0.0,1.0
53749,신의주/Noun,1,0,1,0.0,1.1106915165381966e-05,1.0
53750,123123/Number,1,1,0,1.1115310228308472e-05,0.0,1.0
53751,힙찔이들/Noun,1,0,1,0.0,1.1106915165381966e-05,1.0
53752,썩집/Noun,1,0,1,0.0,1.1106915165381966e-05,1.0
53753,고딴/Modifier,1,0,1,0.0,1.1106915165381966e-05,1.0
53754,789845776568/Number,1,1,0,1.1115310228308472e-05,0.0,1.0
53755,Enough/Alpha,1,1,0,1.1115310228308472e-05,0.0,1.0
53756,Mountain/Alpha,1,1,0,1.1115310228308472e-05,0.0,1.0
53757,Ain/Alpha,1,1,0,1.1115310228308472e-05,0.0,1.0
53758,관대/Noun,1,0,1,0.0,1.1106915165381966e-05,1.0
53759,혹스/Noun,1,0,1,0.0,1.1106915165381966e-05,1.0
53760,죵교/Noun,1,0,1,0.0,1.1106915165381966e-05,1.0
53761,김준희/Noun,1,1,0,1.1115310228308472e-05,0.0,1.0
53762,재밌슴돠/Noun,1,1,0,1.1115310228308472e-05,0.0,1.0
53763,화천군/Noun,1,0,1,0.0,1.1106915165381966e-05,1.0
53764,밴더스/Noun,1,1,0,1.1115310228308472e-05,0.0,1.0
53765,특출마/Noun,1,1,0,1.1115310228308472e-05,0.0,1.0
53766,안올리냐드라마끝낫는데장사하기실냐/Foreign,1,0,1,0.0,1.1106915165381966e-05,1.0
53767,..?)/Punctuation,1,0,1,0.0,1.1106915165381966e-05,1.0
53768,대영화가/Foreign,1,0,1,0.0,1.1106915165381966e-05,1.0
53769,때보/Noun,1,1,0,1.1115310228308472e-05,0.0,1.0
53770,경작/Noun,1,0,1,0.0,1.1106915165381966e-05,1.0
53771,농지/Noun,1,0,1,0.0,1.1106915165381966e-05,1.0
53772,1900년/Number,1,0,1,0.0,1.1106915165381966e-05,1.0
53773,ㅡㅡㅜㅜ/KoreanParticle,1,0,1,0.0,1.1106915165381966e-05,1.0
53774,답답햇/Noun,1,1,0,1.1115310228308472e-05,0.0,1.0
53775,듯햇/Noun,1,0,1,0.0,1.1106915165381966e-05,1.0
53776,AK/Alpha,1,0,1,0.0,1.1106915165381966e-05,1.0
53777,보들보들/Adverb,1,1,0,1.1115310228308472e-05,0.0,1.0
53778,양군/Noun,1,1,0,1.1115310228308472e-05,0.0,1.0
53779,가로수/Noun,1,1,0,1.1115310228308472e-05,0.0,1.0
53780,에서와는/Josa,1,1,0,1.1115310228308472e-05,0.0,1.0
53781,슈만/Noun,1,1,0,1.1115310228308472e-05,0.0,1.0
53782,나탄/Noun,1,1,0,1.1115310228308472e-05,0.0,1.0
53783,챗팅창/Noun,1,0,1,0.0,1.1106915165381966e-05,1.0
53784,물수제비/Noun,1,1,0,1.1115310228308472e-05,0.0,1.0
53785,짜리의/Foreign,1,0,1,0.0,1.1106915165381966e-05,1.0
53786,암소/Noun,1,0,1,0.0,1.1106915165381966e-05,1.0
53787,mate/Alpha,1,1,0,1.1115310228308472e-05,0.0,1.0
53788,오랏/Noun,1,1,0,1.1115310228308472e-05,0.0,1.0
53789,람쥐/Noun,1,1,0,1.1115310228308472e-05,0.0,1.0
53790,수준좀높힙시/Noun,1,0,1,0.0,1.1106915165381966e-05,1.0
53791,490만/Number,1,0,1,0.0,1.1106915165381966e-05,1.0
53792,갖췃다/Noun,1,1,0,1.1115310228308472e-05,0.0,1.0
53793,닽/Noun,1,1,0,1.1115310228308472e-05,0.0,1.0
53794,속결/Noun,1,0,1,0.0,1.1106915165381966e-05,1.0
53795,...-.-;;;/Punctuation,1,0,1,0.0,1.1106915165381966e-05,1.0
53796,무위자연/Noun,1,1,0,1.1115310228308472e-05,0.0,1.0
53797,윤석/Noun,1,1,0,1.1115310228308472e-05,0.0,1.0
53798,수광/Noun,1,1,0,1.1115310228308472e-05,0.0,1.0
53799,요흥/Noun,1,1,0,1.1115310228308472e-05,0.0,1.0
53800,주최/Noun,1,1,0,1.1115310228308472e-05,0.0,1.0
53801,볼드모트/Noun,1,1,0,1.1115310228308472e-05,0.0,1.0
53802,"!!!!!""/Punctuation",1,0,1,0.0,1.1106915165381966e-05,1.0
53803,뻑치기/Noun,1,0,1,0.0,1.1106915165381966e-05,1.0
53804,설문지/Noun,1,0,1,0.0,1.1106915165381966e-05,1.0
53805,상진/Noun,1,1,0,1.1115310228308472e-05,0.0,1.0
53806,37분/Number,1,0,1,0.0,1.1106915165381966e-05,1.0
53807,득세/Noun,1,0,1,0.0,1.1106915165381966e-05,1.0
53808,진횡/Noun,1,0,1,0.0,1.1106915165381966e-05,1.0
53809,대다/Foreign,1,0,1,0.0,1.1106915165381966e-05,1.0
53810,참이뻣/Noun,1,1,0,1.1115310228308472e-05,0.0,1.0
53811,중때/Noun,1,1,0,1.1115310228308472e-05,0.0,1.0
53812,2.95/Number,1,0,1,0.0,1.1106915165381966e-05,1.0
53813,warfare/Alpha,1,1,0,1.1115310228308472e-05,0.0,1.0
53814,modern/Alpha,1,1,0,1.1115310228308472e-05,0.0,1.0
53815,시프트/Noun,1,0,1,0.0,1.1106915165381966e-05,1.0
53816,가랭/Noun,1,0,1,0.0,1.1106915165381966e-05,1.0
53817,연좌제/Noun,1,1,0,1.1115310228308472e-05,0.0,1.0
53818,공후/Noun,1,1,0,1.1115310228308472e-05,0.0,1.0
53819,햇넹/Noun,1,1,0,1.1115310228308472e-05,0.0,1.0
53820,이닌듯/Noun,1,1,0,1.1115310228308472e-05,0.0,1.0
53821,^~~/Punctuation,1,0,1,0.0,1.1106915165381966e-05,1.0
53822,토닥이다/Verb,1,0,1,0.0,1.1106915165381966e-05,1.0
53823,암수/Noun,1,0,1,0.0,1.1106915165381966e-05,1.0
53824,나짱/Noun,1,1,0,1.1115310228308472e-05,0.0,1.0
53825,퇴짜/Noun,1,0,1,0.0,1.1106915165381966e-05,1.0
53826,게만/Eomi,1,0,1,0.0,1.1106915165381966e-05,1.0
53827,정의철/Noun,1,1,0,1.1115310228308472e-05,0.0,1.0
53828,시행/Foreign,1,0,1,0.0,1.1106915165381966e-05,1.0
53829,과거시험/Noun,1,0,1,0.0,1.1106915165381966e-05,1.0
53830,목격담/Noun,1,0,1,0.0,1.1106915165381966e-05,1.0
53831,선회/Noun,1,0,1,0.0,1.1106915165381966e-05,1.0
53832,직각/Noun,1,0,1,0.0,1.1106915165381966e-05,1.0
53833,엔젤스/Noun,1,1,0,1.1115310228308472e-05,0.0,1.0
53834,5.45/Number,1,0,1,0.0,1.1106915165381966e-05,1.0
53835,얄짤없/Noun,1,1,0,1.1115310228308472e-05,0.0,1.0
53836,씌었/Noun,1,0,1,0.0,1.1106915165381966e-05,1.0
53837,코스츔/Noun,1,0,1,0.0,1.1106915165381966e-05,1.0
53838,질식사/Noun,1,1,0,1.1115310228308472e-05,0.0,1.0
53839,보고샆/Noun,1,1,0,1.1115310228308472e-05,0.0,1.0
53840,서경석/Noun,1,1,0,1.1115310228308472e-05,0.0,1.0
53841,듧/Noun,1,1,0,1.1115310228308472e-05,0.0,1.0
53842,변로/Noun,1,1,0,1.1115310228308472e-05,0.0,1.0
53843,추켜/Noun,1,0,1,0.0,1.1106915165381966e-05,1.0
53844,이야기와/Foreign,1,1,0,1.1115310228308472e-05,0.0,1.0
53845,고사리/Noun,1,1,0,1.1115310228308472e-05,0.0,1.0
53846,잔인무도하다/Adjective,1,0,1,0.0,1.1106915165381966e-05,1.0
53847,잣소/Noun,1,0,1,0.0,1.1106915165381966e-05,1.0
53848,50~60년/Number,1,0,1,0.0,1.1106915165381966e-05,1.0
53849,겐네/Noun,1,0,1,0.0,1.1106915165381966e-05,1.0
53850,오코보/Noun,1,0,1,0.0,1.1106915165381966e-05,1.0
53851,아카시아/Noun,1,1,0,1.1115310228308472e-05,0.0,1.0
53852,괜찬타/Noun,1,1,0,1.1115310228308472e-05,0.0,1.0
53853,엳같/Noun,1,0,1,0.0,1.1106915165381966e-05,1.0
53854,헤세/Noun,1,0,1,0.0,1.1106915165381966e-05,1.0
53855,여쭈다/Verb,1,1,0,1.1115310228308472e-05,0.0,1.0
53856,나유/Noun,1,0,1,0.0,1.1106915165381966e-05,1.0
53857,고레/Noun,1,1,0,1.1115310228308472e-05,0.0,1.0
53858,멀뚱이/Noun,1,0,1,0.0,1.1106915165381966e-05,1.0
53859,2006.00/Number,1,1,0,1.1115310228308472e-05,0.0,1.0
53860,1946년/Number,1,1,0,1.1115310228308472e-05,0.0,1.0
53861,케팝/Noun,1,0,1,0.0,1.1106915165381966e-05,1.0
53862,재믺는데/Noun,1,0,1,0.0,1.1106915165381966e-05,1.0
53863,점좀/Noun,1,1,0,1.1115310228308472e-05,0.0,1.0
53864,선주아/Noun,1,1,0,1.1115310228308472e-05,0.0,1.0
53865,유딩때였/Noun,1,1,0,1.1115310228308472e-05,0.0,1.0
53866,독신남/Noun,1,0,1,0.0,1.1106915165381966e-05,1.0
53867,스쯔/Noun,1,1,0,1.1115310228308472e-05,0.0,1.0
53868,메피스/Noun,1,1,0,1.1115310228308472e-05,0.0,1.0
53869,마검/Noun,1,1,0,1.1115310228308472e-05,0.0,1.0
53870,이즈모/Noun,1,1,0,1.1115310228308472e-05,0.0,1.0
53871,쿠무/Noun,1,1,0,1.1115310228308472e-05,0.0,1.0
53872,스위트/Noun,1,1,0,1.1115310228308472e-05,0.0,1.0
53873,분개/Noun,1,0,1,0.0,1.1106915165381966e-05,1.0
53874,소찬/Noun,1,1,0,1.1115310228308472e-05,0.0,1.0
53875,라모/Noun,1,1,0,1.1115310228308472e-05,0.0,1.0
53876,중드중/Noun,1,1,0,1.1115310228308472e-05,0.0,1.0
53877,쿠릴렌코/Noun,1,0,1,0.0,1.1106915165381966e-05,1.0
53878,;;;;;;;;;;;;;;;;;;;;;;;;;;;;;;;;;;;;;;;;;;;;;;;;;;/Punctuation,1,0,1,0.0,1.1106915165381966e-05,1.0
53879,임현제/Noun,1,0,1,0.0,1.1106915165381966e-05,1.0
53880,안번/Noun,1,1,0,1.1115310228308472e-05,0.0,1.0
53881,현채/Noun,1,0,1,0.0,1.1106915165381966e-05,1.0
53882,짱임/Noun,1,1,0,1.1115310228308472e-05,0.0,1.0
53883,루돌프/Noun,1,1,0,1.1115310228308472e-05,0.0,1.0
53884,멕시코시티/Noun,1,1,0,1.1115310228308472e-05,0.0,1.0
53885,충븐했다/Noun,1,1,0,1.1115310228308472e-05,0.0,1.0
53886,왈왈거림/Noun,1,1,0,1.1115310228308472e-05,0.0,1.0
53887,앤지/Noun,1,1,0,1.1115310228308472e-05,0.0,1.0
53888,븬/Noun,1,0,1,0.0,1.1106915165381966e-05,1.0
53889,도충/Noun,1,0,1,0.0,1.1106915165381966e-05,1.0
53890,이우재/Noun,1,0,1,0.0,1.1106915165381966e-05,1.0
53891,명땜/Noun,1,1,0,1.1115310228308472e-05,0.0,1.0
53892,ㅆㅣ/KoreanParticle,1,1,0,1.1115310228308472e-05,0.0,1.0
53893,수수방관/Noun,1,0,1,0.0,1.1106915165381966e-05,1.0
53894,중오/Noun,1,0,1,0.0,1.1106915165381966e-05,1.0
53895,엠피쓰리/Noun,1,1,0,1.1115310228308472e-05,0.0,1.0
53896,핫초코/Noun,1,1,0,1.1115310228308472e-05,0.0,1.0
53897,레일라/Noun,1,1,0,1.1115310228308472e-05,0.0,1.0
53898,프러포즈/Noun,1,1,0,1.1115310228308472e-05,0.0,1.0
53899,사라예보/Noun,1,1,0,1.1115310228308472e-05,0.0,1.0
53900,어후처음/Noun,1,1,0,1.1115310228308472e-05,0.0,1.0
53901,어벤젼/Noun,1,1,0,1.1115310228308472e-05,0.0,1.0
53902,내가졋소/Noun,1,0,1,0.0,1.1106915165381966e-05,1.0
53903,쩜내/Noun,1,0,1,0.0,1.1106915165381966e-05,1.0
53904,점찍/Noun,1,0,1,0.0,1.1106915165381966e-05,1.0
53905,야행성/Noun,1,0,1,0.0,1.1106915165381966e-05,1.0
53906,..;_;/Punctuation,1,1,0,1.1115310228308472e-05,0.0,1.0
53907,Tourbillion/Alpha,1,1,0,1.1115310228308472e-05,0.0,1.0
53908,ㅇㅋㅋㅋ/KoreanParticle,1,1,0,1.1115310228308472e-05,0.0,1.0
53909,굿작/Noun,1,1,0,1.1115310228308472e-05,0.0,1.0
53910,밓/Noun,1,1,0,1.1115310228308472e-05,0.0,1.0
53911,MADDUX/Alpha,1,1,0,1.1115310228308472e-05,0.0,1.0
53912,쩌른다/Noun,1,1,0,1.1115310228308472e-05,0.0,1.0
53913,베트/Noun,1,1,0,1.1115310228308472e-05,0.0,1.0
53914,한기대/Noun,1,1,0,1.1115310228308472e-05,0.0,1.0
53915,뎀비/Noun,1,0,1,0.0,1.1106915165381966e-05,1.0
53916,알파벳/Noun,1,0,1,0.0,1.1106915165381966e-05,1.0
53917,친딸임/Noun,1,0,1,0.0,1.1106915165381966e-05,1.0
53918,!!!..../Punctuation,1,0,1,0.0,1.1106915165381966e-05,1.0
53919,양민수/Noun,1,1,0,1.1115310228308472e-05,0.0,1.0
53920,直腸/Foreign,1,0,1,0.0,1.1106915165381966e-05,1.0
53921,둘러스다/Verb,1,0,1,0.0,1.1106915165381966e-05,1.0
53922,?????????????????????????????????????????????????????????/Punctuation,1,0,1,0.0,1.1106915165381966e-05,1.0
53923,포멜로/Noun,1,0,1,0.0,1.1106915165381966e-05,1.0
53924,데볼/Noun,1,1,0,1.1115310228308472e-05,0.0,1.0
53925,소극/Noun,1,1,0,1.1115310228308472e-05,0.0,1.0
53926,나우딩요/Noun,1,0,1,0.0,1.1106915165381966e-05,1.0
53927,거좀/Noun,1,0,1,0.0,1.1106915165381966e-05,1.0
53928,~~~~~~~~~!!!!/Punctuation,1,1,0,1.1115310228308472e-05,0.0,1.0
53929,Shut/Alpha,1,1,0,1.1115310228308472e-05,0.0,1.0
53930,무속신앙/Noun,1,0,1,0.0,1.1106915165381966e-05,1.0
53931,!!@!@!/Punctuation,1,1,0,1.1115310228308472e-05,0.0,1.0
53932,봏았던/Noun,1,1,0,1.1115310228308472e-05,0.0,1.0
53933,쪼앗/Noun,1,1,0,1.1115310228308472e-05,0.0,1.0
53934,유세/Modifier,1,1,0,1.1115310228308472e-05,0.0,1.0
53935,아부다비/Noun,1,0,1,0.0,1.1106915165381966e-05,1.0
53936,&-/Punctuation,1,1,0,1.1115310228308472e-05,0.0,1.0
53937,*//Punctuation,1,1,0,1.1115310228308472e-05,0.0,1.0
53938,므흣합니/Noun,1,1,0,1.1115310228308472e-05,0.0,1.0
53939,성노예/Noun,1,1,0,1.1115310228308472e-05,0.0,1.0
53940,이해만이/Noun,1,1,0,1.1115310228308472e-05,0.0,1.0
53941,박복하다/Adjective,1,1,0,1.1115310228308472e-05,0.0,1.0
53942,거뜰/Noun,1,1,0,1.1115310228308472e-05,0.0,1.0
53943,파르디유/Noun,1,0,1,0.0,1.1106915165381966e-05,1.0
53944,butan/Alpha,1,1,0,1.1115310228308472e-05,0.0,1.0
53945,>_<)//Punctuation,1,1,0,1.1115310228308472e-05,0.0,1.0
53946,야생동물/Noun,1,1,0,1.1115310228308472e-05,0.0,1.0
53947,홍산/Noun,1,1,0,1.1115310228308472e-05,0.0,1.0
53948,청해/Noun,1,1,0,1.1115310228308472e-05,0.0,1.0
53949,8.69/Number,1,0,1,0.0,1.1106915165381966e-05,1.0
53950,씨끄럽다/Noun,1,1,0,1.1115310228308472e-05,0.0,1.0
53951,한눈팔다/Verb,1,1,0,1.1115310228308472e-05,0.0,1.0
53952,무섶/Noun,1,1,0,1.1115310228308472e-05,0.0,1.0
53953,허구삘/Noun,1,0,1,0.0,1.1106915165381966e-05,1.0
53954,슈퍼쥬니어/Noun,1,0,1,0.0,1.1106915165381966e-05,1.0
53955,먀차/Noun,1,0,1,0.0,1.1106915165381966e-05,1.0
53956,반이란/Foreign,1,1,0,1.1115310228308472e-05,0.0,1.0
53957,박경수/Noun,1,1,0,1.1115310228308472e-05,0.0,1.0
53958,요욕/Noun,1,0,1,0.0,1.1106915165381966e-05,1.0
53959,이다되가네/Foreign,1,1,0,1.1115310228308472e-05,0.0,1.0
53960,위도/Noun,1,1,0,1.1115310228308472e-05,0.0,1.0
53961,성혁/Noun,1,1,0,1.1115310228308472e-05,0.0,1.0
53962,사에코/Noun,1,0,1,0.0,1.1106915165381966e-05,1.0
53963,크로싱/Noun,1,0,1,0.0,1.1106915165381966e-05,1.0
53964,지석진/Noun,1,1,0,1.1115310228308472e-05,0.0,1.0
53965,연배/Noun,1,1,0,1.1115310228308472e-05,0.0,1.0
53966,dldkejdooljsdflkaef/Alpha,1,1,0,1.1115310228308472e-05,0.0,1.0
53967,점깜/Noun,1,0,1,0.0,1.1106915165381966e-05,1.0
53968,웃엇어/Noun,1,1,0,1.1115310228308472e-05,0.0,1.0
53969,자카/Noun,1,0,1,0.0,1.1106915165381966e-05,1.0
53970,갯수뤠기/Noun,1,0,1,0.0,1.1106915165381966e-05,1.0
53971,웨딩싱어/Noun,1,1,0,1.1115310228308472e-05,0.0,1.0
53972,..''/Punctuation,1,0,1,0.0,1.1106915165381966e-05,1.0
53973,gimme/Alpha,1,1,0,1.1115310228308472e-05,0.0,1.0
53974,존잼엄/Noun,1,0,1,0.0,1.1106915165381966e-05,1.0
53975,엄존잼엄존잼엄/Noun,1,0,1,0.0,1.1106915165381966e-05,1.0
53976,별세계/Noun,1,0,1,0.0,1.1106915165381966e-05,1.0
53977,화설/Noun,1,0,1,0.0,1.1106915165381966e-05,1.0
53978,뭘케/Noun,1,1,0,1.1115310228308472e-05,0.0,1.0
53979,Andersen/Alpha,1,1,0,1.1115310228308472e-05,0.0,1.0
53980,Wes/Alpha,1,1,0,1.1115310228308472e-05,0.0,1.0
53981,1010/Number,1,1,0,1.1115310228308472e-05,0.0,1.0
53982,나늘/Noun,1,1,0,1.1115310228308472e-05,0.0,1.0
53983,뺏을껀다뺏/Noun,1,0,1,0.0,1.1106915165381966e-05,1.0
53984,덱스/Noun,1,0,1,0.0,1.1106915165381966e-05,1.0
53985,dsad/Alpha,1,0,1,0.0,1.1106915165381966e-05,1.0
53986,완전욱겨/Noun,1,1,0,1.1115310228308472e-05,0.0,1.0
53987,FC/Alpha,1,1,0,1.1115310228308472e-05,0.0,1.0
53988,지났는데아직도기억나는드라마/Foreign,1,1,0,1.1115310228308472e-05,0.0,1.0
53989,괜츈하/Noun,1,1,0,1.1115310228308472e-05,0.0,1.0
53990,몽마/Noun,1,1,0,1.1115310228308472e-05,0.0,1.0
53991,자유몽/Noun,1,1,0,1.1115310228308472e-05,0.0,1.0
53992,일렉트라/Noun,1,1,0,1.1115310228308472e-05,0.0,1.0
53993,게임기/Noun,1,1,0,1.1115310228308472e-05,0.0,1.0
53994,홍코/Noun,1,0,1,0.0,1.1106915165381966e-05,1.0
53995,테터/Noun,1,0,1,0.0,1.1106915165381966e-05,1.0
53996,자연히/Adverb,1,1,0,1.1115310228308472e-05,0.0,1.0
53997,좋읏듯/Noun,1,1,0,1.1115310228308472e-05,0.0,1.0
53998,3~4회/Number,1,1,0,1.1115310228308472e-05,0.0,1.0
53999,게쵝오/Noun,1,0,1,0.0,1.1106915165381966e-05,1.0
54000,예담/Noun,1,0,1,0.0,1.1106915165381966e-05,1.0
54001,레스타/Noun,1,0,1,0.0,1.1106915165381966e-05,1.0
54002,와치맨/Noun,1,1,0,1.1115310228308472e-05,0.0,1.0
54003,!!!!!!!!!!!!!!!!!!!!!!!!!!!!/Punctuation,1,1,0,1.1115310228308472e-05,0.0,1.0
54004,이상꼬름/Noun,1,0,1,0.0,1.1106915165381966e-05,1.0
54005,본얼티메이텀/Noun,1,0,1,0.0,1.1106915165381966e-05,1.0
54006,rim/Alpha,1,1,0,1.1115310228308472e-05,0.0,1.0
54007,보등/Noun,1,0,1,0.0,1.1106915165381966e-05,1.0
54008,완젼별루/Noun,1,0,1,0.0,1.1106915165381966e-05,1.0
54009,절러잼써/Noun,1,1,0,1.1115310228308472e-05,0.0,1.0
54010,출전/Noun,1,1,0,1.1115310228308472e-05,0.0,1.0
54011,맥박/Noun,1,1,0,1.1115310228308472e-05,0.0,1.0
54012,꽈당/Adverb,1,0,1,0.0,1.1106915165381966e-05,1.0
54013,귄터/Noun,1,1,0,1.1115310228308472e-05,0.0,1.0
54014,르카레/Noun,1,1,0,1.1115310228308472e-05,0.0,1.0
54015,클리어/Noun,1,1,0,1.1115310228308472e-05,0.0,1.0
54016,틀기/Noun,1,0,1,0.0,1.1106915165381966e-05,1.0
54017,합치기/Noun,1,0,1,0.0,1.1106915165381966e-05,1.0
54018,",,,,,,,,,,,,,,,,,,,,,,,,,,,,,/Punctuation",1,0,1,0.0,1.1106915165381966e-05,1.0
54019,일흔/Noun,1,0,1,0.0,1.1106915165381966e-05,1.0
54020,힌번씩/Noun,1,1,0,1.1115310228308472e-05,0.0,1.0
54021,무효/Noun,1,0,1,0.0,1.1106915165381966e-05,1.0
54022,처녀성/Noun,1,0,1,0.0,1.1106915165381966e-05,1.0
54023,염산/Noun,1,0,1,0.0,1.1106915165381966e-05,1.0
54024,짜리였구나/Foreign,1,1,0,1.1115310228308472e-05,0.0,1.0
54025,75분/Number,1,1,0,1.1115310228308472e-05,0.0,1.0
54026,쉬움/Noun,1,1,0,1.1115310228308472e-05,0.0,1.0
54027,겟쇼티/Noun,1,1,0,1.1115310228308472e-05,0.0,1.0
54028,광선검/Noun,1,0,1,0.0,1.1106915165381966e-05,1.0
54029,slept/Alpha,1,0,1,0.0,1.1106915165381966e-05,1.0
54030,쏠솔/Noun,1,1,0,1.1115310228308472e-05,0.0,1.0
54031,4~5시간/Number,1,1,0,1.1115310228308472e-05,0.0,1.0
54032,잠자코/Noun,1,1,0,1.1115310228308472e-05,0.0,1.0
54033,파더스/Noun,1,0,1,0.0,1.1106915165381966e-05,1.0
54034,저녓/Noun,1,0,1,0.0,1.1106915165381966e-05,1.0
54035,백로/Noun,1,0,1,0.0,1.1106915165381966e-05,1.0
54036,재밓게봄/Noun,1,1,0,1.1115310228308472e-05,0.0,1.0
54037,테메레르/Noun,1,0,1,0.0,1.1106915165381966e-05,1.0
54038,연구실/Noun,1,0,1,0.0,1.1106915165381966e-05,1.0
54039,세레/Noun,1,0,1,0.0,1.1106915165381966e-05,1.0
54040,션택/Noun,1,1,0,1.1115310228308472e-05,0.0,1.0
54041,광석/Noun,1,0,1,0.0,1.1106915165381966e-05,1.0
54042,음험/Noun,1,0,1,0.0,1.1106915165381966e-05,1.0
54043,교의/Noun,1,0,1,0.0,1.1106915165381966e-05,1.0
54044,개봄/Noun,1,0,1,0.0,1.1106915165381966e-05,1.0
54045,칼레/Noun,1,1,0,1.1115310228308472e-05,0.0,1.0
54046,비지니스석/Noun,1,0,1,0.0,1.1106915165381966e-05,1.0
54047,수락/Noun,1,0,1,0.0,1.1106915165381966e-05,1.0
54048,넌왜/Noun,1,0,1,0.0,1.1106915165381966e-05,1.0
54049,회벽/Noun,1,1,0,1.1115310228308472e-05,0.0,1.0
54050,찬호/Noun,1,0,1,0.0,1.1106915165381966e-05,1.0
54051,판별/Noun,1,1,0,1.1115310228308472e-05,0.0,1.0
54052,개없넹/Noun,1,0,1,0.0,1.1106915165381966e-05,1.0
54053,꽁트나/Noun,1,0,1,0.0,1.1106915165381966e-05,1.0
54054,뿌까/Noun,1,0,1,0.0,1.1106915165381966e-05,1.0
54055,잼업슴/Noun,1,0,1,0.0,1.1106915165381966e-05,1.0
54056,로현우/Noun,1,0,1,0.0,1.1106915165381966e-05,1.0
54057,ㅈㄱㅇㅌㅇ/KoreanParticle,1,1,0,1.1115310228308472e-05,0.0,1.0
54058,_+/Punctuation,1,1,0,1.1115310228308472e-05,0.0,1.0
54059,바랬는/Noun,1,0,1,0.0,1.1106915165381966e-05,1.0
54060,셸비/Noun,1,1,0,1.1115310228308472e-05,0.0,1.0
54061,스패로우/Noun,1,1,0,1.1115310228308472e-05,0.0,1.0
54062,쌓이네/Noun,1,0,1,0.0,1.1106915165381966e-05,1.0
54063,빼끼/Noun,1,0,1,0.0,1.1106915165381966e-05,1.0
54064,zd/Alpha,1,0,1,0.0,1.1106915165381966e-05,1.0
54065,메쓰꺼웠다/Noun,1,0,1,0.0,1.1106915165381966e-05,1.0
54066,몇몃/Noun,1,0,1,0.0,1.1106915165381966e-05,1.0
54067,다급하다/Adjective,1,1,0,1.1115310228308472e-05,0.0,1.0
54068,6277/Number,1,1,0,1.1115310228308472e-05,0.0,1.0
54069,경제사/Noun,1,1,0,1.1115310228308472e-05,0.0,1.0
54070,영차/Noun,1,0,1,0.0,1.1106915165381966e-05,1.0
54071,51초/Number,1,0,1,0.0,1.1106915165381966e-05,1.0
54072,새꺄/Noun,1,1,0,1.1115310228308472e-05,0.0,1.0
54073,회복기/Noun,1,0,1,0.0,1.1106915165381966e-05,1.0
54074,Aniston/Alpha,1,0,1,0.0,1.1106915165381966e-05,1.0
54075,격진/Noun,1,1,0,1.1115310228308472e-05,0.0,1.0
54076,왜돈/Noun,1,0,1,0.0,1.1106915165381966e-05,1.0
54077,죽엿다/Noun,1,1,0,1.1115310228308472e-05,0.0,1.0
54078,통독/Noun,1,0,1,0.0,1.1106915165381966e-05,1.0
54079,영쿡/Noun,1,1,0,1.1115310228308472e-05,0.0,1.0
54080,진담/Noun,1,0,1,0.0,1.1106915165381966e-05,1.0
54081,VERA/Alpha,1,1,0,1.1115310228308472e-05,0.0,1.0
54082,이노센스/Noun,1,0,1,0.0,1.1106915165381966e-05,1.0
54083,김선우/Noun,1,1,0,1.1115310228308472e-05,0.0,1.0
54084,ㅍㅍ/KoreanParticle,1,0,1,0.0,1.1106915165381966e-05,1.0
54085,갘구/Noun,1,0,1,0.0,1.1106915165381966e-05,1.0
54086,알겨/Noun,1,0,1,0.0,1.1106915165381966e-05,1.0
54087,전에순금이한테상처줘으면돼지또그렇러고한나요순금의땅결말은어떻게돼나요금긍해요/Foreign,1,0,1,0.0,1.1106915165381966e-05,1.0
54088,던전/Noun,1,1,0,1.1115310228308472e-05,0.0,1.0
54089,멍에/Noun,1,0,1,0.0,1.1106915165381966e-05,1.0
54090,버는군/Noun,1,0,1,0.0,1.1106915165381966e-05,1.0
54091,군사작전/Noun,1,1,0,1.1115310228308472e-05,0.0,1.0
54092,민수만/Noun,1,0,1,0.0,1.1106915165381966e-05,1.0
54093,탕생/Noun,1,0,1,0.0,1.1106915165381966e-05,1.0
54094,대초의/Foreign,1,0,1,0.0,1.1106915165381966e-05,1.0
54095,강북/Noun,1,1,0,1.1115310228308472e-05,0.0,1.0
54096,디보/Noun,1,1,0,1.1115310228308472e-05,0.0,1.0
54097,면면/Noun,1,1,0,1.1115310228308472e-05,0.0,1.0
54098,고돌고/Noun,1,0,1,0.0,1.1106915165381966e-05,1.0
54099,한풀/Adverb,1,0,1,0.0,1.1106915165381966e-05,1.0
54100,왓는데/Noun,1,1,0,1.1115310228308472e-05,0.0,1.0
54101,Yoooo/Alpha,1,1,0,1.1115310228308472e-05,0.0,1.0
54102,179분/Number,1,1,0,1.1115310228308472e-05,0.0,1.0
54103,한태경/Noun,1,1,0,1.1115310228308472e-05,0.0,1.0
54104,잼썻는데/Noun,1,1,0,1.1115310228308472e-05,0.0,1.0
54105,season/Alpha,1,1,0,1.1115310228308472e-05,0.0,1.0
54106,혁피/Noun,1,1,0,1.1115310228308472e-05,0.0,1.0
54107,그제야/Adverb,1,1,0,1.1115310228308472e-05,0.0,1.0
54108,1914년/Number,1,0,1,0.0,1.1106915165381966e-05,1.0
54109,붤/Noun,1,0,1,0.0,1.1106915165381966e-05,1.0
54110,다땔부수/Noun,1,1,0,1.1115310228308472e-05,0.0,1.0
54111,번이엇음/Noun,1,0,1,0.0,1.1106915165381966e-05,1.0
54112,마즐레/Noun,1,0,1,0.0,1.1106915165381966e-05,1.0
54113,마들렌/Noun,1,0,1,0.0,1.1106915165381966e-05,1.0
54114,트위티/Noun,1,1,0,1.1115310228308472e-05,0.0,1.0
54115,다룸/Noun,1,0,1,0.0,1.1106915165381966e-05,1.0
54116,엮구/Noun,1,0,1,0.0,1.1106915165381966e-05,1.0
54117,자유형/Noun,1,0,1,0.0,1.1106915165381966e-05,1.0
54118,보머/Noun,1,0,1,0.0,1.1106915165381966e-05,1.0
54119,섭찟했던/Noun,1,1,0,1.1115310228308472e-05,0.0,1.0
54120,괞찮/Noun,1,0,1,0.0,1.1106915165381966e-05,1.0
54121,단장/Noun,1,1,0,1.1115310228308472e-05,0.0,1.0
54122,매란방/Noun,1,0,1,0.0,1.1106915165381966e-05,1.0
54123,리셀웨폰/Noun,1,1,0,1.1115310228308472e-05,0.0,1.0
54124,미/Noun,1,0,1,0.0,1.1106915165381966e-05,1.0
54125,정윤호/Noun,1,0,1,0.0,1.1106915165381966e-05,1.0
54126,만리장성/Noun,1,0,1,0.0,1.1106915165381966e-05,1.0
54127,양단간/Noun,1,0,1,0.0,1.1106915165381966e-05,1.0
54128,쫓아내다/Verb,1,0,1,0.0,1.1106915165381966e-05,1.0
54129,투잡/Noun,1,0,1,0.0,1.1106915165381966e-05,1.0
54130,쳐잘껄/Noun,1,0,1,0.0,1.1106915165381966e-05,1.0
54131,휴전협정/Noun,1,1,0,1.1115310228308472e-05,0.0,1.0
54132,부쉈다/Noun,1,0,1,0.0,1.1106915165381966e-05,1.0
54133,오벨리스크/Noun,1,0,1,0.0,1.1106915165381966e-05,1.0
54134,샤우리/Noun,1,1,0,1.1115310228308472e-05,0.0,1.0
54135,노바/Noun,1,0,1,0.0,1.1106915165381966e-05,1.0
54136,3억년/Number,1,0,1,0.0,1.1106915165381966e-05,1.0
54137,ohters/Alpha,1,0,1,0.0,1.1106915165381966e-05,1.0
54138,ㄱㅈㄱ/KoreanParticle,1,0,1,0.0,1.1106915165381966e-05,1.0
54139,롭히/Noun,1,0,1,0.0,1.1106915165381966e-05,1.0
54140,힘쌘척/Noun,1,0,1,0.0,1.1106915165381966e-05,1.0
54141,김재흥/Noun,1,1,0,1.1115310228308472e-05,0.0,1.0
54142,발존/Noun,1,0,1,0.0,1.1106915165381966e-05,1.0
54143,루시엔/Noun,1,1,0,1.1115310228308472e-05,0.0,1.0
54144,되면/Foreign,1,1,0,1.1115310228308472e-05,0.0,1.0
54145,윤설아/Noun,1,0,1,0.0,1.1106915165381966e-05,1.0
54146,눈이될런/Noun,1,0,1,0.0,1.1106915165381966e-05,1.0
54147,과환/Noun,1,1,0,1.1115310228308472e-05,0.0,1.0
54148,안전모/Noun,1,1,0,1.1115310228308472e-05,0.0,1.0
54149,위윌락유/Noun,1,1,0,1.1115310228308472e-05,0.0,1.0
54150,쎅스신/Noun,1,0,1,0.0,1.1106915165381966e-05,1.0
54151,중국요리/Noun,1,0,1,0.0,1.1106915165381966e-05,1.0
54152,도꺼라/Foreign,1,1,0,1.1115310228308472e-05,0.0,1.0
54153,캐스트어웨이/Noun,1,1,0,1.1115310228308472e-05,0.0,1.0
54154,걸식/Noun,1,0,1,0.0,1.1106915165381966e-05,1.0
54155,사흘/Noun,1,0,1,0.0,1.1106915165381966e-05,1.0
54156,찿아온/Noun,1,0,1,0.0,1.1106915165381966e-05,1.0
54157,버고/Noun,1,0,1,0.0,1.1106915165381966e-05,1.0
54158,료쨔응/Noun,1,1,0,1.1115310228308472e-05,0.0,1.0
54159,슈슈슉/Noun,1,0,1,0.0,1.1106915165381966e-05,1.0
54160,슉/Noun,1,0,1,0.0,1.1106915165381966e-05,1.0
54161,시걸횽떄문/Noun,1,0,1,0.0,1.1106915165381966e-05,1.0
54162,시걸횽/Noun,1,0,1,0.0,1.1106915165381966e-05,1.0
54163,샘맨/Noun,1,1,0,1.1115310228308472e-05,0.0,1.0
54164,이카로스/Noun,1,1,0,1.1115310228308472e-05,0.0,1.0
54165,탐정물/Noun,1,0,1,0.0,1.1106915165381966e-05,1.0
54166,이을껀/Noun,1,1,0,1.1115310228308472e-05,0.0,1.0
54167,부응/Noun,1,1,0,1.1115310228308472e-05,0.0,1.0
54168,탕녀/Noun,1,1,0,1.1115310228308472e-05,0.0,1.0
54169,데이라이트/Noun,1,1,0,1.1115310228308472e-05,0.0,1.0
54170,리빙/Noun,1,1,0,1.1115310228308472e-05,0.0,1.0
54171,리즈들/Foreign,1,1,0,1.1115310228308472e-05,0.0,1.0
54172,미반/Noun,1,1,0,1.1115310228308472e-05,0.0,1.0
54173,이구만/Noun,1,0,1,0.0,1.1106915165381966e-05,1.0
54174,망쪼/Noun,1,0,1,0.0,1.1106915165381966e-05,1.0
54175,껏다/Noun,1,0,1,0.0,1.1106915165381966e-05,1.0
54176,합목/Noun,1,1,0,1.1115310228308472e-05,0.0,1.0
54177,의안/Noun,1,1,0,1.1115310228308472e-05,0.0,1.0
54178,파인딩/Noun,1,1,0,1.1115310228308472e-05,0.0,1.0
54179,"~~~""/Punctuation",1,0,1,0.0,1.1106915165381966e-05,1.0
54180,".....""/Punctuation",1,0,1,0.0,1.1106915165381966e-05,1.0
54181,잘봤듭니/Noun,1,1,0,1.1115310228308472e-05,0.0,1.0
54182,에라스무스/Noun,1,1,0,1.1115310228308472e-05,0.0,1.0
54183,어땟나봐/Noun,1,1,0,1.1115310228308472e-05,0.0,1.0
54184,제밌나/Noun,1,1,0,1.1115310228308472e-05,0.0,1.0
54185,",..,/Punctuation",1,0,1,0.0,1.1106915165381966e-05,1.0
54186,라덴/Noun,1,0,1,0.0,1.1106915165381966e-05,1.0
54187,7.16/Number,1,1,0,1.1115310228308472e-05,0.0,1.0
54188,체체/Noun,1,0,1,0.0,1.1106915165381966e-05,1.0
54189,반명/Noun,1,0,1,0.0,1.1106915165381966e-05,1.0
54190,논변/Noun,1,0,1,0.0,1.1106915165381966e-05,1.0
54191,동기유발/Noun,1,1,0,1.1115310228308472e-05,0.0,1.0
54192,이아깝다/Foreign,1,0,1,0.0,1.1106915165381966e-05,1.0
54193,엮어지/Noun,1,0,1,0.0,1.1106915165381966e-05,1.0
54194,병마/Noun,1,1,0,1.1115310228308472e-05,0.0,1.0
54195,활봘하/Noun,1,0,1,0.0,1.1106915165381966e-05,1.0
54196,썻다는/Noun,1,0,1,0.0,1.1106915165381966e-05,1.0
54197,예능인/Noun,1,0,1,0.0,1.1106915165381966e-05,1.0
54198,뭘/Exclamation,1,0,1,0.0,1.1106915165381966e-05,1.0
54199,푸르른/Noun,1,1,0,1.1115310228308472e-05,0.0,1.0
54200,후뢰쉬맨/Noun,1,0,1,0.0,1.1106915165381966e-05,1.0
54201,부숩니/Noun,1,1,0,1.1115310228308472e-05,0.0,1.0
54202,댄싱히어로/Noun,1,1,0,1.1115310228308472e-05,0.0,1.0
54203,악성종양/Noun,1,0,1,0.0,1.1106915165381966e-05,1.0
54204,중대장/Noun,1,1,0,1.1115310228308472e-05,0.0,1.0
54205,짧은머리/Noun,1,1,0,1.1115310228308472e-05,0.0,1.0
54206,ㅋㄷㄱ/KoreanParticle,1,0,1,0.0,1.1106915165381966e-05,1.0
54207,슬거/Noun,1,1,0,1.1115310228308472e-05,0.0,1.0
54208,vedd/Alpha,1,1,0,1.1115310228308472e-05,0.0,1.0
54209,총수/Noun,1,0,1,0.0,1.1106915165381966e-05,1.0
54210,친걸/Noun,1,0,1,0.0,1.1106915165381966e-05,1.0
54211,글남겻는데/Noun,1,0,1,0.0,1.1106915165381966e-05,1.0
54212,절마/Noun,1,1,0,1.1115310228308472e-05,0.0,1.0
54213,이덕재/Noun,1,1,0,1.1115310228308472e-05,0.0,1.0
54214,시립/Noun,1,1,0,1.1115310228308472e-05,0.0,1.0
54215,낚였다잉/Noun,1,0,1,0.0,1.1106915165381966e-05,1.0
54216,장지영/Noun,1,1,0,1.1115310228308472e-05,0.0,1.0
54217,달전/Noun,1,1,0,1.1115310228308472e-05,0.0,1.0
54218,대독/Noun,1,0,1,0.0,1.1106915165381966e-05,1.0
54219,프라챠/Noun,1,0,1,0.0,1.1106915165381966e-05,1.0
54220,'~/Punctuation,1,0,1,0.0,1.1106915165381966e-05,1.0
54221,손땟어야/Noun,1,0,1,0.0,1.1106915165381966e-05,1.0
54222,작이란것을/Foreign,1,1,0,1.1115310228308472e-05,0.0,1.0
54223,해운/Noun,1,1,0,1.1115310228308472e-05,0.0,1.0
54224,얼핏듣/Noun,1,1,0,1.1115310228308472e-05,0.0,1.0
54225,락큰롤/Noun,1,1,0,1.1115310228308472e-05,0.0,1.0
54226,kkw1120@naver.com/Email,1,1,0,1.1115310228308472e-05,0.0,1.0
54227,3.0/Number,1,0,1,0.0,1.1106915165381966e-05,1.0
54228,함자/Noun,1,0,1,0.0,1.1106915165381966e-05,1.0
54229,스왓/Noun,1,1,0,1.1115310228308472e-05,0.0,1.0
54230,드르렁/Adverb,1,0,1,0.0,1.1106915165381966e-05,1.0
54231,이얌이얌/Noun,1,1,0,1.1115310228308472e-05,0.0,1.0
54232,....^^?/Punctuation,1,1,0,1.1115310228308472e-05,0.0,1.0
54233,나가사키/Noun,1,0,1,0.0,1.1106915165381966e-05,1.0
54234,점랃한다/Noun,1,1,0,1.1115310228308472e-05,0.0,1.0
54235,GENERATION/Alpha,1,1,0,1.1115310228308472e-05,0.0,1.0
54236,간당간당/Adverb,1,0,1,0.0,1.1106915165381966e-05,1.0
54237,은울면서봄/Foreign,1,1,0,1.1115310228308472e-05,0.0,1.0
54238,러닝타임동안/Foreign,1,1,0,1.1115310228308472e-05,0.0,1.0
54239,GON/Alpha,1,0,1,0.0,1.1106915165381966e-05,1.0
54240,엎어/Noun,1,0,1,0.0,1.1106915165381966e-05,1.0
54241,진재영/Noun,1,0,1,0.0,1.1106915165381966e-05,1.0
54242,랭건캠프/Noun,1,0,1,0.0,1.1106915165381966e-05,1.0
54243,진짜놀렜/Noun,1,1,0,1.1115310228308472e-05,0.0,1.0
54244,재떨이/Noun,1,0,1,0.0,1.1106915165381966e-05,1.0
54245,전만/Noun,1,0,1,0.0,1.1106915165381966e-05,1.0
54246,일부종사/Noun,1,0,1,0.0,1.1106915165381966e-05,1.0
54247,현모양처/Noun,1,0,1,0.0,1.1106915165381966e-05,1.0
54248,섻쉬/Noun,1,1,0,1.1115310228308472e-05,0.0,1.0
54249,pq/Alpha,1,0,1,0.0,1.1106915165381966e-05,1.0
54250,마슈/Noun,1,0,1,0.0,1.1106915165381966e-05,1.0
54251,쩌넼/Noun,1,1,0,1.1115310228308472e-05,0.0,1.0
54252,잔디깍기/Noun,1,1,0,1.1115310228308472e-05,0.0,1.0
54253,번햇음/Noun,1,1,0,1.1115310228308472e-05,0.0,1.0
54254,손재주/Noun,1,0,1,0.0,1.1106915165381966e-05,1.0
54255,으헝헝엉헝헝/Noun,1,1,0,1.1115310228308472e-05,0.0,1.0
54256,조앤/Noun,1,1,0,1.1115310228308472e-05,0.0,1.0
54257,크크큭/Noun,1,1,0,1.1115310228308472e-05,0.0,1.0
54258,스노우보더/Noun,1,0,1,0.0,1.1106915165381966e-05,1.0
54259,에끼/Noun,1,0,1,0.0,1.1106915165381966e-05,1.0
54260,신시대/Noun,1,0,1,0.0,1.1106915165381966e-05,1.0
54261,GATE/Alpha,1,0,1,0.0,1.1106915165381966e-05,1.0
54262,해독제/Noun,1,0,1,0.0,1.1106915165381966e-05,1.0
54263,.....????/Punctuation,1,0,1,0.0,1.1106915165381966e-05,1.0
54264,옂/Noun,1,1,0,1.1115310228308472e-05,0.0,1.0
54265,theory/Alpha,1,0,1,0.0,1.1106915165381966e-05,1.0
54266,정태성/Noun,1,1,0,1.1115310228308472e-05,0.0,1.0
54267,선예/Noun,1,0,1,0.0,1.1106915165381966e-05,1.0
54268,사람이름/Noun,1,0,1,0.0,1.1106915165381966e-05,1.0
54269,뭐짘/Noun,1,0,1,0.0,1.1106915165381966e-05,1.0
54270,해운대로/Noun,1,1,0,1.1115310228308472e-05,0.0,1.0
54271,뻐꺼/Noun,1,1,0,1.1115310228308472e-05,0.0,1.0
54272,머더/Noun,1,1,0,1.1115310228308472e-05,0.0,1.0
54273,패밀리맨/Noun,1,0,1,0.0,1.1106915165381966e-05,1.0
54274,논터/Noun,1,1,0,1.1115310228308472e-05,0.0,1.0
54275,dspl/Alpha,1,1,0,1.1115310228308472e-05,0.0,1.0
54276,100000000000000000000000000000000000000000000000000000/Number,1,1,0,1.1115310228308472e-05,0.0,1.0
54277,애슐리쥬드/Noun,1,0,1,0.0,1.1106915165381966e-05,1.0
54278,유명무실/Noun,1,0,1,0.0,1.1106915165381966e-05,1.0
54279,신현빈/Noun,1,0,1,0.0,1.1106915165381966e-05,1.0
54280,"...,,,,;;;;/Punctuation",1,0,1,0.0,1.1106915165381966e-05,1.0
54281,관고/Noun,1,0,1,0.0,1.1106915165381966e-05,1.0
54282,니브/Noun,1,0,1,0.0,1.1106915165381966e-05,1.0
54283,채/Foreign,1,1,0,1.1115310228308472e-05,0.0,1.0
54284,!!!!^*^/Punctuation,1,1,0,1.1115310228308472e-05,0.0,1.0
54285,반이/Foreign,1,0,1,0.0,1.1106915165381966e-05,1.0
54286,했을껄/Noun,1,0,1,0.0,1.1106915165381966e-05,1.0
54287,김종철/Noun,1,0,1,0.0,1.1106915165381966e-05,1.0
54288,카닉/Noun,1,0,1,0.0,1.1106915165381966e-05,1.0
54289,엑센트/Noun,1,0,1,0.0,1.1106915165381966e-05,1.0
54290,뭉개져선/Noun,1,0,1,0.0,1.1106915165381966e-05,1.0
54291,퉁퉁이/Noun,1,0,1,0.0,1.1106915165381966e-05,1.0
54292,번식/Noun,1,0,1,0.0,1.1106915165381966e-05,1.0
54293,후비다/Verb,1,1,0,1.1115310228308472e-05,0.0,1.0
54294,모퉁이/Noun,1,1,0,1.1115310228308472e-05,0.0,1.0
54295,설악산/Noun,1,1,0,1.1115310228308472e-05,0.0,1.0
54296,새털구름/Noun,1,1,0,1.1115310228308472e-05,0.0,1.0
54297,뭉게구름/Noun,1,1,0,1.1115310228308472e-05,0.0,1.0
54298,:::/Punctuation,1,1,0,1.1115310228308472e-05,0.0,1.0
54299,자감/Noun,1,0,1,0.0,1.1106915165381966e-05,1.0
54300,로프트/Noun,1,0,1,0.0,1.1106915165381966e-05,1.0
54301,맴버쉽/Noun,1,0,1,0.0,1.1106915165381966e-05,1.0
54302,통신사/Noun,1,0,1,0.0,1.1106915165381966e-05,1.0
54303,강석/Noun,1,0,1,0.0,1.1106915165381966e-05,1.0
54304,콧소리/Noun,1,1,0,1.1115310228308472e-05,0.0,1.0
54305,관철/Noun,1,1,0,1.1115310228308472e-05,0.0,1.0
54306,커플링/Noun,1,0,1,0.0,1.1106915165381966e-05,1.0
54307,물었더랬음/Noun,1,1,0,1.1115310228308472e-05,0.0,1.0
54308,얼결/Noun,1,1,0,1.1115310228308472e-05,0.0,1.0
54309,1~7회/Number,1,0,1,0.0,1.1106915165381966e-05,1.0
54310,에서나마/Josa,1,1,0,1.1115310228308472e-05,0.0,1.0
54311,궁민/Noun,1,1,0,1.1115310228308472e-05,0.0,1.0
54312,삼중주/Noun,1,1,0,1.1115310228308472e-05,0.0,1.0
54313,21분/Number,1,1,0,1.1115310228308472e-05,0.0,1.0
54314,최주봉/Noun,1,1,0,1.1115310228308472e-05,0.0,1.0
54315,소블/Noun,1,1,0,1.1115310228308472e-05,0.0,1.0
54316,불화살빈/Noun,1,0,1,0.0,1.1106915165381966e-05,1.0
54317,핫삼/Noun,1,0,1,0.0,1.1106915165381966e-05,1.0
54318,목붕/Noun,1,0,1,0.0,1.1106915165381966e-05,1.0
54319,맛스타/Noun,1,1,0,1.1115310228308472e-05,0.0,1.0
54320,물꼬기/Noun,1,1,0,1.1115310228308472e-05,0.0,1.0
54321,슬라이드쇼/Noun,1,0,1,0.0,1.1106915165381966e-05,1.0
54322,"..,,..,,../Punctuation",1,0,1,0.0,1.1106915165381966e-05,1.0
54323,셔틀버스/Noun,1,0,1,0.0,1.1106915165381966e-05,1.0
54324,괴소리/Noun,1,0,1,0.0,1.1106915165381966e-05,1.0
54325,1989/Number,1,0,1,0.0,1.1106915165381966e-05,1.0
54326,블라끄레/Noun,1,0,1,0.0,1.1106915165381966e-05,1.0
54327,콘에어/Noun,1,0,1,0.0,1.1106915165381966e-05,1.0
54328,5.58/Number,1,0,1,0.0,1.1106915165381966e-05,1.0
54329,점뭐/Noun,1,1,0,1.1115310228308472e-05,0.0,1.0
54330,명은/Noun,1,1,0,1.1115310228308472e-05,0.0,1.0
54331,뭉클뭉쿨/Noun,1,1,0,1.1115310228308472e-05,0.0,1.0
54332,불충분/Noun,1,1,0,1.1115310228308472e-05,0.0,1.0
54333,랐다/Noun,1,1,0,1.1115310228308472e-05,0.0,1.0
54334,>(/Punctuation,1,1,0,1.1115310228308472e-05,0.0,1.0
54335,블랙아웃/Noun,1,0,1,0.0,1.1106915165381966e-05,1.0
54336,픈웃/Noun,1,1,0,1.1115310228308472e-05,0.0,1.0
54337,쿼리/Noun,1,1,0,1.1115310228308472e-05,0.0,1.0
54338,인디아/Noun,1,0,1,0.0,1.1106915165381966e-05,1.0
54339,왁자지껄/Adverb,1,0,1,0.0,1.1106915165381966e-05,1.0
54340,다음쥬/Noun,1,1,0,1.1115310228308472e-05,0.0,1.0
54341,이진짜/Foreign,1,1,0,1.1115310228308472e-05,0.0,1.0
54342,더뱅뱅/Noun,1,1,0,1.1115310228308472e-05,0.0,1.0
54343,졏같/Noun,1,0,1,0.0,1.1106915165381966e-05,1.0
54344,생겻습니/Noun,1,1,0,1.1115310228308472e-05,0.0,1.0
54345,영화스태프/Noun,1,1,0,1.1115310228308472e-05,0.0,1.0
54346,ㅅㄹㄱ/KoreanParticle,1,0,1,0.0,1.1106915165381966e-05,1.0
54347,쩌는거임/Noun,1,1,0,1.1115310228308472e-05,0.0,1.0
54348,식샤/Noun,1,1,0,1.1115310228308472e-05,0.0,1.0
54349,이당/Foreign,1,1,0,1.1115310228308472e-05,0.0,1.0
54350,쓰루/Noun,1,0,1,0.0,1.1106915165381966e-05,1.0
54351,볼랬/Noun,1,0,1,0.0,1.1106915165381966e-05,1.0
54352,plants/Alpha,1,0,1,0.0,1.1106915165381966e-05,1.0
54353,trees/Alpha,1,0,1,0.0,1.1106915165381966e-05,1.0
54354,낙상/Noun,1,1,0,1.1115310228308472e-05,0.0,1.0
54355,ㅂㄴ/KoreanParticle,1,1,0,1.1115310228308472e-05,0.0,1.0
54356,ㅇㅈㄱ/KoreanParticle,1,1,0,1.1115310228308472e-05,0.0,1.0
54357,씨빠/Noun,1,1,0,1.1115310228308472e-05,0.0,1.0
54358,아실런/Noun,1,0,1,0.0,1.1106915165381966e-05,1.0
54359,유색/Noun,1,0,1,0.0,1.1106915165381966e-05,1.0
54360,이까짓/Noun,1,0,1,0.0,1.1106915165381966e-05,1.0
54361,빢치/Noun,1,1,0,1.1115310228308472e-05,0.0,1.0
54362,4.500원/Number,1,0,1,0.0,1.1106915165381966e-05,1.0
54363,우무/Noun,1,1,0,1.1115310228308472e-05,0.0,1.0
54364,네셔널/Noun,1,0,1,0.0,1.1106915165381966e-05,1.0
54365,깝다훈/Noun,1,0,1,0.0,1.1106915165381966e-05,1.0
54366,좌우간/Noun,1,1,0,1.1115310228308472e-05,0.0,1.0
54367,토욜밤/Noun,1,0,1,0.0,1.1106915165381966e-05,1.0
54368,잔달/Noun,1,0,1,0.0,1.1106915165381966e-05,1.0
54369,꼴릿할정/Noun,1,1,0,1.1115310228308472e-05,0.0,1.0
54370,mkk/Alpha,1,1,0,1.1115310228308472e-05,0.0,1.0
54371,호시탐탐/Noun,1,0,1,0.0,1.1106915165381966e-05,1.0
54372,장성택/Noun,1,0,1,0.0,1.1106915165381966e-05,1.0
