,Unnamed: 0,parameter,counts,counts_H,counts_NH,p_from_H,p_from_NH,priority
0,3,의/Josa,29457,17487,11970,0.19437342996243026,0.13294977452962214,0.593644974029942
1,8,.../Punctuation,22073,9139,12934,0.10158282017651113,0.14365684074905036,0.5859647533185339
2,9,은/Josa,19690,7739,11951,0.08602138585687928,0.13273874314147988,0.6069578466226511
3,10,도/Josa,18990,7903,11087,0.08784429673432186,0.12314236843858985,0.5838335966298052
4,12,는/Josa,18035,7669,10366,0.08524331414089767,0.11513428260434945,0.5747712780704186
5,15,이/Determiner,12373,4495,7878,0.04996331947624658,0.08750027767287913,0.6367089630647378
6,17,?/Punctuation,11319,3302,8017,0.036702754373874574,0.08904413888086722,0.7082781164413817
7,18,정말/Noun,10702,7082,3620,0.0787186270368806,0.04020703289868272,0.6617454681367969
8,19,것/Noun,10293,4088,6205,0.045439388213325035,0.06891840860119511,0.6028368794326241
9,22,적/Suffix,9003,5486,3517,0.060978591912500275,0.039063020636648384,0.6093524380761969
10,24,!/Punctuation,8565,6415,2150,0.07130471511459885,0.023879867605571228,0.7489784004670169
11,25,로/Josa,7951,3351,4600,0.03724740457506169,0.05109180976075705,0.5785435794239718
12,27,점/Noun,7843,3227,4616,0.03586910610675144,0.051269520403403164,0.5885502996302435
13,28,만/Josa,7745,2412,5333,0.026810128270680036,0.05923317857698202,0.6885732730794061
14,29,연기/Noun,7089,4106,2983,0.04563946379743459,0.033131927938334416,0.5792072224573283
15,30,평점/Noun,7068,2994,4074,0.03327923882355557,0.04524957238376613,0.5764006791171478
16,31,과/Josa,6768,4231,2537,0.04702887757597315,0.02817824377457405,0.6251477541371159
17,32,최고/Noun,6671,6143,528,0.06828135073249894,0.005864451207321679,0.9208514465597362
18,34,왜/Noun,6247,2241,4006,0.024909410221639287,0.04449430215252016,0.6412678085481031
19,35,스토리/Noun,6075,2176,3899,0.02418691505679924,0.043305862229824285,0.6418106995884774
20,37,생각/Noun,6005,3771,2234,0.04191583487095125,0.024812848479463315,0.6279766860949209
21,38,~/Punctuation,6003,4016,1987,0.04463908587688682,0.02206944043361397,0.6689988339163752
22,40,다/Adverb,5790,2454,3336,0.02727697130026899,0.037052668991714235,0.5761658031088083
23,42,감동/Noun,5597,4442,1155,0.04937420803414623,0.012828487016016172,0.7936394497051992
24,43,..../Punctuation,5580,2218,3362,0.02465375808638819,0.03734144878601417,0.6025089605734767
25,45,1/Number,5284,1409,3875,0.015661472111686642,0.04303929626585512,0.7333459500378501
26,47,보고/Noun,5209,3038,2171,0.03376831247360114,0.02411311282404425,0.5832213476674986
27,50,드라마/Noun,5005,3017,1988,0.033534890958806664,0.02208054734877935,0.6027972027972028
28,52,때/Noun,4940,3220,1720,0.03579129893515328,0.019103894084456983,0.6518218623481782
29,55,거/Noun,4783,1959,2824,0.021774892737256298,0.03136592842703868,0.5904244198201966
30,56,와/Josa,4779,2774,2005,0.0308338705733277,0.022269364906590844,0.5804561623770663
31,57,감독/Noun,4688,1515,3173,0.016839694995887337,0.03524224181975698,0.6768344709897611
32,58,ㅋㅋ/KoreanParticle,4594,2777,1817,0.030867216504012626,0.020181264855499037,0.6044841097083152
33,59,재미/Noun,4538,1752,2786,0.019474023519996442,0.030943865650754163,0.6139268400176289
34,60,내용/Noun,4529,1407,3122,0.01563924149123002,0.0346757891463225,0.6893353941267388
35,61,뭐/Noun,4491,831,3660,0.009236822799724341,0.040651309505298,0.8149632598530394
36,62,못/VerbPrefix,4418,1474,2944,0.016383967276526686,0.032698758246884514,0.666364870982345
37,63,그냥/Noun,4406,1187,3219,0.013193873241002156,0.03575315991736455,0.7305946436677259
38,64,고/Josa,4377,1761,2616,0.01957406131205122,0.029055690072639227,0.5976696367374914
39,66,게/Josa,4340,1723,2617,0.019151679523375497,0.029066796987804608,0.6029953917050691
40,67,안/VerbPrefix,4262,1318,2944,0.014649978880910566,0.032698758246884514,0.6907555138432661
41,68,이런/Adjective,4141,1740,2401,0.019340639797256743,0.0266677033120821,0.5798116397005554
42,69,좀/Noun,4111,1455,2656,0.016172776382188826,0.029499966679254506,0.6460715154463634
43,70,그/Noun,4099,2400,1699,0.02667674454794033,0.01887064886598396,0.5855086606489388
44,71,없는/Adjective,4090,1373,2717,0.015261320943467532,0.0301774885043428,0.6643031784841076
45,73,!!/Punctuation,4005,3088,917,0.03432407798501656,0.010185041206655265,0.7710362047440699
46,74,시간/Noun,3956,1077,2879,0.011971189115888223,0.03197680876113468,0.7277553083923155
47,75,한/Determiner,3920,1604,2316,0.01782895760620679,0.02572361552302464,0.5908163265306122
48,76,쓰레기/Noun,3739,209,3530,0.002323099837716471,0.03920741053379834,0.9441027012570206
49,77,봤는데/Verb,3708,2141,1567,0.02379787919880844,0.017404536064153542,0.5774002157497303
50,78,수/Noun,3698,2475,1223,0.02751039281506347,0.013583757247262143,0.6692806922660898
51,80,아/Exclamation,3469,1327,2142,0.014750016672965344,0.02379101228424817,0.6174690112424329
52,83,없다/Adjective,3324,873,2451,0.009703665829313295,0.0272230490703512,0.7373646209386282
53,84,작품/Noun,3308,2050,1258,0.02278638596803237,0.013972499278050514,0.6197097944377267
54,85,다시/Noun,3289,2763,526,0.030711602160816313,0.005842237376990914,0.8400729705077531
55,86,잘/Verb,3274,2363,911,0.02626547806949292,0.010118399715662972,0.7217470983506414
56,87,10/Number,3248,2158,1090,0.023986839472689682,0.012106537530266344,0.6644088669950738
57,88,마지막/Noun,3201,2151,1050,0.023909032301091523,0.011662260923651064,0.6719775070290535
58,90,사랑/Noun,3190,2523,667,0.028043927706022275,0.007408312415309772,0.7909090909090909
59,91,잘/VerbPrefix,3151,2150,1001,0.023897916990863216,0.011118022080547348,0.682323072040622
60,92,본/Verb,3099,1949,1150,0.02166373963497321,0.012772952440189262,0.6289125524362698
61,93,하나/Noun,3087,1267,1820,0.014083098059266837,0.02021458560099518,0.5895691609977324
62,94,이렇게/Adverb,3042,1309,1733,0.014549941088855791,0.01924828398160695,0.5696909927679158
63,95,요/Josa,3013,1950,1063,0.021674854945201518,0.011806650820801031,0.6471954862263525
64,96,좋은/Adjective,3009,2156,853,0.023964608852233067,0.009474198636070815,0.7165171153207045
65,98,같은/Adjective,2957,1277,1680,0.014194251161549919,0.018659617477841704,0.5681433885694961
66,99,나/Josa,2916,1029,1887,0.011437654224929416,0.02095874891707577,0.647119341563786
67,101,있는/Adjective,2899,2055,844,0.02284196251917391,0.00937423639958238,0.7088651259054847
68,102,입니다/Adjective,2888,2167,721,0.02408687726474446,0.008008085834240399,0.7503462603878116
69,103,2/Number,2878,1225,1653,0.013616255029677879,0.01835973076837639,0.5743571924947879
70,105,ㅋ/KoreanParticle,2712,1574,1138,0.017495498299357534,0.012639669458204678,0.5803834808259587
71,106,주인공/Noun,2708,1083,1625,0.012037880977258077,0.01804873714374569,0.6000738552437223
72,111,중/Suffix,2597,1568,1029,0.017428806437987686,0.011429015705178043,0.6037735849056604
73,112,지금/Noun,2596,1843,753,0.020485516750772512,0.00836350711953262,0.7099383667180277
74,113,ㅠㅠ/KoreanParticle,2589,1842,747,0.0204744014405442,0.00829686562854033,0.7114716106604867
75,114,최악/Noun,2549,32,2517,0.00035568992730587116,0.02795610547126641,0.9874460572773636
76,115,지/Josa,2511,993,1518,0.011037503056710312,0.016860297221049824,0.6045400238948626
77,116,임/Noun,2511,1059,1452,0.011771113531778671,0.016127240820134614,0.5782556750298686
78,117,재밌게/Adjective,2508,2195,313,0.024398105951137096,0.0034764644467645558,0.8751993620414673
79,118,걸/Noun,2493,777,1716,0.008636596047395683,0.019059466423795454,0.6883273164861613
80,119,3/Number,2481,918,1563,0.010203854789587177,0.017360108403492013,0.6299879081015719
81,121,연출/Noun,2454,975,1479,0.010837427472600759,0.01642712752959993,0.6026894865525673
82,122,별로/Noun,2438,320,2118,0.003556899273058711,0.02352444632027901,0.8687448728465955
83,123,끝/Noun,2438,862,1576,0.009581397416801902,0.01750449830064198,0.6464315012305168
84,124,돈/Noun,2433,279,2154,0.003101171553698064,0.02392429526623276,0.8853267570900123
85,128,라/Josa,2373,987,1386,0.01097081119534046,0.015394184419219406,0.584070796460177
86,129,그리고/Conjunction,2339,1419,920,0.015772625213969722,0.010218361952151409,0.6066695168875588
87,130,역시/Noun,2323,1623,700,0.01804014850054465,0.007774840615767376,0.6986655187257856
88,131,봐도/Verb,2322,1795,527,0.01995198185981371,0.0058533442921562965,0.773040482342808
89,132,개/Noun,2277,671,1606,0.007458373163194984,0.01783770575560344,0.7053140096618358
90,133,명작/Noun,2259,1976,283,0.02196385301113754,0.0031432569918030968,0.8747233289065959
91,134,이런/Modifier,2201,819,1382,0.00910343907698464,0.01534975675855788,0.6278964107223989
92,136,이해/Noun,2164,866,1298,0.009625858657715135,0.01441677588466579,0.5998151571164511
93,137,^^/Punctuation,2162,1921,241,0.021352510948580573,0.002676766554857054,0.8885291396854764
94,138,라고/Josa,2147,777,1370,0.008636596047395683,0.015216473776573296,0.6380996739636703
95,139,ㅡㅡ/KoreanParticle,2128,211,1917,0.002345330458173088,0.02129195637203723,0.9008458646616542
96,140,없고/Adjective,2122,205,1917,0.002278638596803237,0.02129195637203723,0.9033930254476908
97,142,안/Noun,2100,842,1258,0.009359091212235734,0.013972499278050514,0.599047619047619
98,145,때문/Noun,2060,810,1250,0.009003401284929862,0.013883643956727459,0.6067961165048543
99,146,!!!/Punctuation,2038,1392,646,0.01547251183780539,0.00717506719683675,0.6830225711481845
100,147,또/Noun,2013,1348,665,0.014983438187759818,0.007386098584979008,0.6696472925981123
101,149,중/Noun,1957,1139,818,0.01266033835004335,0.00908545660528245,0.5820132856412877
102,150,아깝다/Adjective,1949,47,1902,0.0005224195807304982,0.021125352644556502,0.9758850692662904
103,151,여자/Noun,1944,757,1187,0.008414289842829513,0.013183908301308394,0.61059670781893
104,152,난/Noun,1928,1196,732,0.01329391103305693,0.0081302619010596,0.6203319502074689
105,153,꼭/Noun,1920,1594,326,0.0177178045039237,0.003620854343914521,0.8302083333333333
106,154,내/Determiner,1911,839,1072,0.009325745281550809,0.011906613057289468,0.5609628466771324
107,155,에게/Josa,1907,1144,763,0.012715914901184892,0.00847457627118644,0.5998951232302046
108,157,된/Verb,1902,1103,799,0.012260187181824244,0.008874425217140191,0.5799158780231335
109,158,하/Suffix,1862,787,1075,0.008747749149678767,0.011939933802785614,0.5773361976369495
110,160,같다/Adjective,1822,1030,792,0.011448769535157726,0.008796676810982517,0.5653128430296378
111,161,마음/Noun,1810,1497,313,0.016639619411777783,0.0034764644467645558,0.8270718232044199
112,162,인생/Noun,1810,1304,506,0.014494364537714247,0.0056200990736832756,0.7204419889502762
113,165,기억/Noun,1794,1237,557,0.01374963875241758,0.006186551747117756,0.6895206243032329
114,166,부터/Josa,1791,743,1048,0.008258675499633194,0.011640047093320302,0.5851479620323842
115,167,결말/Noun,1777,729,1048,0.008103061156436877,0.011640047093320302,0.5897580191333709
116,169,ㅎㅎ/KoreanParticle,1744,1498,246,0.01665073472200609,0.002732301130683964,0.8589449541284404
117,170,랑/Josa,1721,744,977,0.008269790809861503,0.010851456116578182,0.5676932016269611
118,171,못/Noun,1720,544,1176,0.00604672876419981,0.013061732234489191,0.6837209302325581
119,173,소재/Noun,1714,594,1120,0.0066024942756152324,0.012439744985227805,0.6534422403733956
120,174,이나/Josa,1704,527,1177,0.005857768490318565,0.013072839149654573,0.6907276995305164
121,176,애/Noun,1670,576,1094,0.00640241869150568,0.012150965190927872,0.6550898203592814
122,178,수준/Noun,1658,273,1385,0.003034479692328213,0.015383077504054024,0.8353437876960192
123,179,한번/Noun,1640,1136,504,0.012626992419358423,0.005597885243352511,0.6926829268292682
124,181,네/Josa,1608,469,1139,0.0052130804970766725,0.01265077637337006,0.7083333333333334
125,182,넘/Verb,1591,1126,465,0.01251583931707534,0.005164715551902614,0.7077309868007542
126,184,현실/Noun,1587,1041,546,0.01157103794766912,0.006064375680298554,0.6559546313799622
127,185,전개/Noun,1586,418,1168,0.004646199675432942,0.012972876913166138,0.7364438839848676
128,186,매력/Noun,1586,1153,433,0.012815952693239669,0.00480929426661039,0.7269861286254728
129,187,와/Verb,1577,898,679,0.009981548585021007,0.007541595397294354,0.5694356372859859
130,188,가슴/Noun,1575,1376,199,0.015294666874152455,0.0022102761179110114,0.8736507936507937
131,189,하게/Verb,1574,1130,444,0.012560300557988574,0.004931470333429593,0.7179161372299873
132,190,되는/Verb,1569,977,592,0.010859658093057377,0.006575293777906124,0.6226896112173359
133,191,~~/Punctuation,1556,1038,518,0.011537692016984194,0.00575338205566786,0.6670951156812339
134,192,야/Josa,1543,373,1170,0.00414601071515906,0.012995090743496902,0.7582631237848347
135,194,님/Suffix,1536,948,588,0.010537314096436429,0.006530866117244597,0.6171875
136,195,알/Noun,1535,886,649,0.009848164862281308,0.007208387942332897,0.5771986970684039
137,196,가장/Noun,1534,1006,528,0.011182002089678324,0.005864451207321679,0.6558018252933507
138,197,;;/Punctuation,1523,373,1150,0.00414601071515906,0.012772952440189262,0.7550886408404465
139,198,저/Noun,1522,907,615,0.010081586377075784,0.00683075282670991,0.5959264126149802
140,199,??/Punctuation,1503,455,1048,0.005057466153880355,0.011640047093320302,0.697272122421823
141,202,아/Josa,1457,606,851,0.006735877998354935,0.009451984805740056,0.5840768702814001
142,204,음악/Noun,1452,1077,375,0.011971189115888223,0.0041650931870182385,0.7417355371900827
143,206,성/Suffix,1445,496,949,0.0055131938732410025,0.010540462491947487,0.6567474048442906
144,207,만든/Verb,1445,521,924,0.005791076628948714,0.010262789612812935,0.6394463667820071
145,208,아이/Noun,1436,944,492,0.010492852855523198,0.005464602261367928,0.6573816155988857
146,211,봤다/Verb,1414,872,542,0.009692550519084988,0.006019948019637026,0.6166902404526167
147,212,줄/Noun,1411,605,806,0.006724762688126626,0.008952173623297865,0.5712260807937632
148,213,무슨/Noun,1408,215,1193,0.002389791699086321,0.013250549792300687,0.8473011363636364
149,214,추천/Noun,1403,1037,366,0.011526576706755885,0.0040651309505298,0.7391304347826086
150,215,만/Noun,1401,947,454,0.010526198786208123,0.005042539485083413,0.6759457530335474
151,216,냐/Josa,1392,169,1223,0.001878487428584132,0.013583757247262143,0.8785919540229885
152,217,인지/Josa,1383,425,958,0.004724006847031101,0.010640424728435923,0.6926970354302241
153,218,게/Noun,1380,485,895,0.005390925460729609,0.009940689073016859,0.6485507246376812
154,219,눈물/Noun,1378,1156,222,0.012849298623924595,0.002465735166714797,0.8388969521044993
155,220,인가/Josa,1378,446,932,0.004957428361825579,0.010351644934135993,0.6763425253991292
156,222,번/Noun,1370,945,425,0.010503968165751507,0.004720438945287336,0.6897810218978102
157,223,ㅠ/KoreanParticle,1361,899,462,0.009992663895249316,0.005131394806406469,0.6605437178545187
158,224,합니다/Verb,1360,1010,350,0.011226463330591557,0.003887420307883689,0.7426470588235294
159,225,자체/Noun,1360,582,778,0.006469110552875531,0.00864117999866717,0.5720588235294117
160,226,저/Determiner,1355,471,884,0.005235311117533291,0.009818513006197658,0.6523985239852399
161,227,우리/Noun,1346,996,350,0.011070848987395238,0.003887420307883689,0.7399702823179792
162,228,인간/Noun,1346,839,507,0.009325745281550809,0.005631205988848657,0.6233283803863299
163,229,네/Suffix,1337,913,424,0.010148278238445637,0.004709332030121954,0.6828721017202692
164,231,하지/Verb,1316,568,748,0.0063134962096792115,0.008307972543705711,0.5683890577507599
165,233,지만/Josa,1312,784,528,0.008714403218993843,0.005864451207321679,0.5975609756097561
166,234,속/Noun,1307,819,488,0.00910343907698464,0.005420174600706399,0.6266258607498087
167,237,재밌다/Adjective,1294,1174,120,0.013049374208034144,0.001332829819845836,0.9072642967542504
168,239,원작/Noun,1275,429,846,0.0047684680879443355,0.009396450229913143,0.6635294117647059
169,240,솔직히/Adjective,1253,412,841,0.0045795078140630895,0.009340915654086237,0.6711891460494812
170,241,그래도/Adverb,1246,736,510,0.008180868328035036,0.005664526734344803,0.5906902086677368
171,243,뭔가/Noun,1237,502,735,0.005579885734610853,0.008163582646555746,0.5941794664510913
172,244,좋다/Adjective,1236,1070,166,0.011893381944290064,0.0018437479174534066,0.8656957928802589
173,245,코미디/Noun,1235,485,750,0.005390925460729609,0.008330186374036475,0.6072874493927125
174,248,있다/Adjective,1212,777,435,0.008636596047395683,0.0048315080969411565,0.6410891089108911
175,249,여운/Noun,1210,1139,71,0.01266033835004335,0.0007885909767421196,0.9413223140495868
176,251,움/Noun,1204,432,772,0.00480181401862926,0.00857453850767488,0.6411960132890365
177,252,이네/Josa,1200,505,695,0.005613231665295778,0.007719306039940467,0.5791666666666667
178,253,전혀/Noun,1199,338,861,0.003756974857168264,0.009563053957393873,0.7180984153461217
179,254,기대/Noun,1198,745,453,0.008280906120089812,0.005031432569918031,0.6218697829716193
180,255,모두/Noun,1194,810,384,0.009003401284929862,0.004265055423506675,0.6783919597989949
181,256,대박/Noun,1180,975,205,0.010837427472600759,0.002276917608903303,0.826271186440678
182,257,대한/Noun,1173,715,458,0.007947446813240557,0.005086967145744941,0.6095481670929241
183,259,씨/Suffix,1170,706,464,0.007847409021185782,0.005153608636737233,0.6034188034188034
184,261,별/Noun,1164,304,860,0.003379054309405776,0.009551947042228491,0.7388316151202751
185,262,계속/Noun,1161,707,454,0.007858524331414091,0.005042539485083413,0.6089577950043066
186,263,굿/Noun,1156,1072,84,0.01191561256474668,0.0009329808738920851,0.9273356401384084
187,264,아주/Noun,1152,682,470,0.007580641575706378,0.005220250127729524,0.5920138888888888
188,265,어떻게/Adjective,1149,466,683,0.005179734566391748,0.007586023057955883,0.5944299390774587
189,266,시리즈/Noun,1149,660,489,0.00733610475068359,0.005431281515871782,0.5744125326370757
190,267,모습/Noun,1142,842,300,0.009359091212235734,0.00333207454961459,0.7373029772329247
191,268,별/Modifier,1142,316,826,0.003512438032145477,0.009174311926605505,0.7232924693520141
192,269,개봉/Noun,1138,496,642,0.0055131938732410025,0.007130639536175223,0.5641476274165202
193,271,하면/Verb,1127,461,666,0.005124158015250207,0.007397205500144391,0.5909494232475601
194,272,전/Noun,1126,674,452,0.007491719093879909,0.00502032565475265,0.5985790408525755
195,273,허/Verb,1121,125,996,0.001389413778538559,0.011062487504720437,0.8884924174843889
196,274,실망/Noun,1118,115,1003,0.0012782606762554744,0.011140235910878113,0.8971377459749553
197,275,영상/Noun,1114,626,488,0.006958184202921104,0.005420174600706399,0.5619389587073609
198,277,요/Noun,1099,666,433,0.007402796612053442,0.00480929426661039,0.6060054595086443
199,279,일본/Noun,1098,391,707,0.0043460862992686115,0.00785258902192505,0.6438979963570127
200,280,보지/Noun,1094,324,770,0.0036013605139719454,0.008552324677344115,0.7038391224862889
201,281,진심/Noun,1094,415,679,0.004612853744748016,0.007541595397294354,0.6206581352833638
202,283,화/Suffix,1089,474,615,0.0052686570482182145,0.00683075282670991,0.5647382920110193
203,284,재미있게/Adjective,1086,979,107,0.010881888713513994,0.0011884399226958706,0.9014732965009208
204,287,다른/Noun,1077,615,462,0.006835915790409711,0.005131394806406469,0.5710306406685237
205,288,이랑/Josa,1077,470,607,0.005224195807304982,0.006741897505386854,0.5636025998142989
206,289,일/Modifier,1074,387,687,0.004301625058355379,0.007630450718617411,0.6396648044692738
207,291,제목/Noun,1073,405,668,0.004501700642464931,0.007419419330475155,0.6225535880708295
208,292,였다/Verb,1071,709,362,0.007880754951870706,0.004020703289868272,0.6619981325863679
209,293,없음/Adjective,1069,179,890,0.0019896405308672165,0.00988515449718995,0.8325537885874649
210,294,많은/Adjective,1069,790,279,0.008781095080363692,0.003098829331141569,0.7390084190832554
211,296,몰입/Noun,1061,631,430,0.0070137607540626465,0.004775973521114246,0.5947219604147032
212,298,봤습니다/Verb,1059,961,98,0.010681813129404442,0.001088477686207433,0.9074598677998112
213,299,나오는/Verb,1058,434,624,0.0048240446390858775,0.006930715063198347,0.5897920604914934
214,300,밖에/Josa,1056,430,626,0.004779583398172643,0.0069529288935291115,0.5928030303030303
215,303,뿐/Noun,1051,311,740,0.0034568614810039353,0.008219117222382655,0.7040913415794482
216,306,재밌어요/Adjective,1049,1012,37,0.011248693951048171,0.0004109558611191328,0.9647283126787416
217,307,ㅎ/KoreanParticle,1048,840,208,0.009336860591779116,0.0023102383543994486,0.8015267175572519
218,308,;/Punctuation,1045,287,758,0.0031900940355245318,0.008419041695359529,0.7253588516746412
219,309,보다/Verb,1045,365,680,0.004057088233332592,0.0075527023124597375,0.6507177033492823
220,310,표현/Noun,1042,681,361,0.007569526265478068,0.00400959637470289,0.6535508637236085
221,312,아니다/Adjective,1036,293,743,0.0032567858968943824,0.008252437967878801,0.7171814671814671
222,313,재미없다/Adjective,1035,22,1013,0.00024453682502278637,0.01125130506253193,0.978743961352657
223,314,OO/Alpha,1033,220,813,0.002445368250227864,0.009029922029455541,0.7870280735721199
224,316,가족/Noun,1031,710,321,0.007891870262099015,0.0035653197680876117,0.6886517943743938
225,319,요즘/Noun,1013,643,370,0.007147144476802349,0.004109558611191328,0.6347482724580454
226,321,점도/Noun,1011,91,920,0.001011493230776071,0.010218361952151409,0.9099901088031652
227,324,봐/Verb,1003,601,402,0.006680301447213392,0.004464979896483551,0.5992023928215354
228,326,용/Noun,999,295,704,0.0032790165173509998,0.007819268276428905,0.7047047047047047
229,328,ㅜㅜ/KoreanParticle,996,633,363,0.007035991374519263,0.0040318102050336535,0.6355421686746988
230,329,모든/Noun,986,630,356,0.0070026454438343365,0.003954061798875979,0.6389452332657201
231,330,4/Number,981,333,648,0.003701398306026721,0.0071972810271675155,0.6605504587155964
232,332,급/Noun,974,237,737,0.0026343285241091077,0.00818579647688651,0.7566735112936345
233,334,하다/Verb,970,367,603,0.0040793188537892105,0.0066974698447253254,0.6216494845360825
234,335,조금/Noun,967,582,385,0.006469110552875531,0.004276162338672057,0.6018614270941055
235,336,특히/Adverb,966,665,301,0.007391681301825134,0.003343181464779972,0.6884057971014492
236,337,여/Modifier,966,412,554,0.0045795078140630895,0.006153231001621609,0.5734989648033126
237,340,개인/Noun,957,633,324,0.007035991374519263,0.003598640513583757,0.6614420062695925
238,343,아닌/Adjective,953,398,555,0.004423893470866772,0.0061643379167869924,0.5823714585519413
239,344,공포/Noun,951,319,632,0.0035457839628304025,0.007019570384521403,0.6645636172450052
240,347,건지/Verb,933,160,773,0.0017784496365293556,0.008585645422840259,0.8285101822079314
241,348,건/Noun,932,292,640,0.0032456705866660733,0.007108425705844459,0.6866952789699571
242,349,한테/Josa,931,317,614,0.003523553342373785,0.006819645911544527,0.6595059076262084
243,350,작가/Noun,929,209,720,0.002323099837716471,0.007996978919075016,0.77502691065662
244,351,이유/Noun,928,364,564,0.004045972923104284,0.006264300153275429,0.6077586206896551
245,352,나름/Noun,923,600,323,0.006669186136985084,0.003587533598418375,0.6500541711809318
246,353,잼/Noun,923,524,399,0.005824422559633639,0.004431659150987405,0.5677139761646804
247,355,아까운/Adjective,917,63,854,0.0007002645443834338,0.0094853055512362,0.931297709923664
248,356,아니고/Adjective,914,147,767,0.0016339506035613453,0.008519003931847971,0.8391684901531729
249,357,보다가/Verb,913,186,727,0.0020674477024653763,0.00807472732523269,0.7962760131434831
250,358,욕/Noun,910,166,744,0.0018451414978992067,0.008263544883044184,0.8175824175824176
251,359,차라리/Noun,909,59,850,0.0006558033034701999,0.009440877890574672,0.935093509350935
252,360,노래/Noun,909,604,305,0.006713647377898317,0.0033876091254415,0.6644664466446645
253,361,제대로/Noun,907,366,541,0.0040682035435609006,0.006008841104471644,0.5964718853362734
254,362,짱/Noun,905,842,63,0.009359091212235734,0.0006997356554190639,0.9303867403314916
255,363,중간/Noun,905,328,577,0.0036458217548851783,0.0064086900504253955,0.6375690607734806
256,364,알바/Noun,897,104,793,0.001155992263744081,0.0088077837261479,0.8840579710144928
257,366,아름다운/Adjective,890,799,91,0.008881132872418469,0.001010729280049759,0.8977528089887641
258,367,0/Number,888,77,811,0.0008558788875797522,0.009007708199124777,0.9132882882882885
259,369,삶/Noun,883,770,113,0.008558788875797524,0.0012550814136881624,0.8720271800679502
260,372,...../Punctuation,877,327,550,0.003634706444656871,0.006108803340960082,0.6271379703534777
261,373,제/Noun,874,553,321,0.006146766556254586,0.0035653197680876117,0.6327231121281465
262,374,오랜/Modifier,870,699,171,0.007769601849587622,0.0018992824932803163,0.8034482758620691
263,375,기/Noun,869,240,629,0.002667674454794033,0.006986249639025257,0.7238204833141542
264,376,보게/Verb,865,698,167,0.007758486539359314,0.0018548548326187888,0.8069364161849711
265,377,제일/Noun,865,507,358,0.0056354622857523965,0.003976275629206745,0.5861271676300578
266,378,당시/Noun,862,550,312,0.00611342062556966,0.0034653575315991736,0.6380510440835266
267,379,점수/Noun,857,271,586,0.003012249071871596,0.006508652286913832,0.6837806301050176
268,382,보세요/Verb,847,583,264,0.006480225863103839,0.0029322256036608393,0.6883116883116883
269,384,놈/Noun,846,250,596,0.002778827557077118,0.006619721438567652,0.7044917257683215
270,385,봤어요/Verb,843,794,49,0.008825556321276927,0.0005442388431037163,0.9418742586002372
271,386,아직도/Adverb,841,631,210,0.0070137607540626465,0.002332452184730213,0.7502972651605232
272,387,막장/Noun,834,144,690,0.00160060467287642,0.007663771464113556,0.8273381294964028
273,388,력/Suffix,830,347,483,0.00385701264922304,0.0053646400248794895,0.5819277108433735
274,391,세상/Noun,824,533,291,0.005924460351688416,0.0032321123131261523,0.6468446601941747
275,392,싶다/Verb,821,473,348,0.005257541737989907,0.003865206477552925,0.5761266747868453
276,393,좋고/Adjective,819,740,79,0.008225329568948269,0.0008774462980651753,0.9035409035409036
277,394,는/Verb,817,351,466,0.0039014738901362736,0.005175822467067996,0.5703794369645043
278,395,이지/Josa,815,332,483,0.0036902829957984134,0.0053646400248794895,0.5926380368098161
279,396,이라고/Josa,815,342,473,0.003801436098081498,0.005253570873225671,0.5803680981595092
280,397,공포영화/Noun,809,293,516,0.0032567858968943824,0.005731168225337095,0.6378244746600742
281,399,보니/Verb,808,465,343,0.00516861925616344,0.0038096719017260148,0.5754950495049505
282,400,도대체/Noun,805,101,704,0.0011226463330591557,0.007819268276428905,0.8745341614906832
283,402,앞/Noun,797,485,312,0.005390925460729609,0.0034653575315991736,0.6085319949811794
284,403,재밌음/Adjective,795,735,60,0.008169753017806727,0.000666414909922918,0.9245283018867924
285,404,뻔한/Adjective,795,199,596,0.002211946735433386,0.006619721438567652,0.7496855345911949
286,405,좋아하는/Adjective,792,528,264,0.0058688838005468745,0.0029322256036608393,0.6666666666666666
287,406,류/Noun,790,141,649,0.0015672587421914947,0.007208387942332897,0.8215189873417722
288,407,나도/Verb,790,498,292,0.005535424493697619,0.0032432192282915344,0.6303797468354431
289,408,로/Noun,790,335,455,0.0037236289264833385,0.005053646400248795,0.5759493670886076
290,410,의/Noun,788,444,344,0.0049351977413689616,0.003820778816891397,0.5634517766497462
291,411,있고/Adjective,787,619,168,0.006880377031322943,0.0018659617477841703,0.7865311308767471
292,412,절대/Noun,787,263,524,0.002923326590045128,0.005820023546660151,0.6658195679796697
293,413,뭘/Noun,782,175,607,0.0019451792899539827,0.006741897505386854,0.7762148337595908
294,415,물/Noun,777,295,482,0.0032790165173509998,0.005353533109714108,0.6203346203346203
295,416,제/Modifier,775,314,461,0.00349020741168886,0.0051202878912410855,0.5948387096774194
296,418,보는내내/Verb,771,339,432,0.003768090167396572,0.00479818735144501,0.5603112840466926
297,419,수작/Noun,766,696,70,0.007736255918902695,0.0007774840615767378,0.908616187989556
298,420,엄청/Adverb,766,465,301,0.00516861925616344,0.003343181464779972,0.6070496083550914
299,421,걍/Adverb,765,208,557,0.002311984527488162,0.006186551747117756,0.7281045751633987
300,422,설정/Noun,762,139,623,0.0015450281217348775,0.006919608148032965,0.8175853018372703
301,423,초반/Noun,761,265,496,0.002945557210501745,0.005509029922029457,0.6517739816031537
302,424,된다/Verb,761,462,299,0.005135273325478514,0.0033209676344492078,0.607095926412615
303,427,준다/Verb,748,271,477,0.003012249071871596,0.005297998533887197,0.6377005347593583
304,428,주고/Verb,747,183,564,0.0020341017717804503,0.006264300153275429,0.7550200803212851
305,429,남는/Verb,744,598,146,0.006646955516528465,0.0016216096141457672,0.803763440860215
306,430,시나리오/Noun,742,207,535,0.002300869217259854,0.005942199613479352,0.7210242587601078
307,431,딱/Adverb,742,251,491,0.0027899428673054264,0.005453495346202546,0.6617250673854448
308,432,이란/Josa,742,435,307,0.004835159949314186,0.003409822955772264,0.5862533692722371
309,433,사실/Noun,742,429,313,0.0047684680879443355,0.0034764644467645558,0.578167115902965
310,435,출연/Noun,740,226,514,0.0025120601115977146,0.005708954395006331,0.6945945945945946
311,437,좋았다/Adjective,733,600,133,0.006669186136985084,0.0014772197169958016,0.8185538881309686
312,438,관객/Noun,732,188,544,0.0020896783229219927,0.00604216184996779,0.7431693989071039
313,439,주는/Verb,731,477,254,0.005302002978903141,0.0028211564520070195,0.6525307797537621
314,440,한국영/Noun,731,295,436,0.0032790165173509998,0.004842615012106539,0.5964432284541724
315,441,안되는/Adjective,730,161,569,0.001789564946757664,0.006319834729102339,0.7794520547945205
316,442,이야/Josa,730,298,432,0.003312362448035925,0.00479818735144501,0.5917808219178082
317,443,가지/Noun,725,278,447,0.003090056243469755,0.004964791078925739,0.616551724137931
318,444,노잼/Noun,724,17,707,0.00018896027388124405,0.00785258902192505,0.9765193370165746
319,446,뭔/Modifier,722,104,618,0.001155992263744081,0.006864073572206054,0.8559556786703602
320,447,분위기/Noun,721,443,278,0.004924082431140653,0.0030877224159761873,0.6144244105409153
321,448,시대/Noun,719,474,245,0.0052686570482182145,0.002721194215518582,0.6592489568845619
322,450,장난/Noun,714,182,532,0.002022986461552142,0.005908878867983206,0.7450980392156863
323,451,최고다/Noun,711,679,32,0.007547295645021453,0.00035542128529222287,0.9549929676511956
324,452,봤던/Verb,711,560,151,0.006224573727852744,0.001677144189972677,0.7876230661040787
325,453,명/Noun,711,303,408,0.0033679389991774673,0.004531621387475843,0.5738396624472574
326,454,OOO/Alpha,708,91,617,0.001011493230776071,0.006852966657040674,0.8714689265536724
327,455,같아요/Adjective,708,559,149,0.006213458417624436,0.001654930359641913,0.7895480225988699
328,456,결국/Adverb,708,253,455,0.0028121734877620433,0.005053646400248795,0.6426553672316384
329,457,지루함/Noun,707,100,607,0.0011115310228308473,0.006741897505386854,0.8585572842998586
330,458,추억/Noun,707,576,131,0.00640241869150568,0.0014550058866650375,0.8147100424328148
331,460,소리/Noun,705,202,503,0.0022452926661183114,0.005586778328187129,0.7134751773049646
332,461,니/Josa,705,294,411,0.003267901207122691,0.004564942132971988,0.5829787234042553
333,462,이딴/Modifier,703,26,677,0.00028899806593602026,0.007519381566963592,0.9630156472261736
334,463,지루하고/Adjective,702,38,664,0.000422381788675722,0.0073749916698136265,0.945868945868946
335,465,좋아요/Adjective,696,653,43,0.007258297579085431,0.0004775973521114245,0.9382183908045976
336,466,영화관/Noun,695,298,397,0.003312362448035925,0.004409445320656641,0.5712230215827339
337,467,마다/Josa,694,480,214,0.005335348909588066,0.002376879845391741,0.69164265129683
338,468,살/Noun,690,420,270,0.004668430295889558,0.002998867094653131,0.6086956521739131
339,469,인상/Noun,689,547,142,0.006080074694884734,0.0015771819534842392,0.7939042089985486
340,470,이지만/Josa,687,427,260,0.004746237467487717,0.002887797942999312,0.6215429403202329
341,471,오늘/Noun,685,462,223,0.005135273325478514,0.002476842081880179,0.6744525547445256
342,472,감정/Noun,684,445,239,0.004946313051597271,0.0026545527245262907,0.6505847953216374
343,473,전/Modifier,680,199,481,0.002211946735433386,0.005342426194548726,0.7073529411764706
344,474,정신/Noun,678,183,495,0.0020341017717804503,0.0054979230068640745,0.7300884955752213
345,475,엔딩/Noun,678,431,247,0.004790698708400951,0.0027434080458493453,0.6356932153392331
346,476,될/Verb,678,389,289,0.004323855678811996,0.003209898482795389,0.5737463126843658
347,477,라면/Noun,678,389,289,0.004323855678811996,0.003209898482795389,0.5737463126843658
348,478,접/Noun,676,122,554,0.0013560678478536335,0.006153231001621609,0.8195266272189349
349,480,졸작/Noun,672,34,638,0.0003779205477624881,0.007086211875513696,0.949404761904762
350,481,제발/Noun,671,179,492,0.0019896405308672165,0.005464602261367928,0.7332339791356185
351,482,자신/Noun,671,422,249,0.004690660916346175,0.002765621876180109,0.6289120715350224
352,484,니까/Josa,668,282,386,0.003134517484382989,0.00428726925383744,0.5778443113772455
353,485,아무리/Adverb,666,114,552,0.0012671453660271655,0.006131017171290846,0.8288288288288288
354,486,그저/Adverb,666,221,445,0.0024564835604561725,0.004942577248594975,0.6681681681681682
355,487,코믹/Noun,662,371,291,0.004123780094702443,0.0032321123131261523,0.5604229607250756
356,488,♥/Foreign,660,651,9,0.007236066958628815,9.996223648843771e-05,0.9863636363636364
357,490,킬링타임/Noun,659,186,473,0.0020674477024653763,0.005253570873225671,0.7177541729893778
358,491,어릴/Verb,658,548,110,0.006091190005113043,0.0012217606681920164,0.8328267477203647
359,492,~~~/Punctuation,657,400,257,0.004446124091323389,0.0028544771975031647,0.60882800608828
360,493,함께/Adverb,656,544,112,0.00604672876419981,0.0012439744985227805,0.8292682926829268
361,494,그렇게/Adverb,656,251,405,0.0027899428673054264,0.004498300641979696,0.6173780487804879
362,496,캐스팅/Noun,653,219,434,0.0024342529399995552,0.004820401181775774,0.664624808575804
363,497,8/Number,653,388,265,0.004312740368583687,0.002943332518826221,0.5941807044410413
364,498,대해/Noun,651,506,145,0.0056243469755240865,0.001610502698980385,0.7772657450076805
365,501,재밌는/Adjective,647,549,98,0.006102305315341351,0.001088477686207433,0.848531684698609
366,502,멋진/Adjective,643,560,83,0.006224573727852744,0.0009218739587267033,0.8709175738724728
367,503,괜찮은/Adjective,643,487,156,0.005413156081186226,0.0017326787657995868,0.7573872472783826
368,504,포스터/Noun,642,205,437,0.002278638596803237,0.00485372192727192,0.6806853582554517
369,505,몰입도/Noun,638,412,226,0.0045795078140630895,0.002510162827376325,0.64576802507837
370,507,엉/Exclamation,636,103,533,0.0011448769535157724,0.005919985783148589,0.8380503144654088
371,508,자/Suffix,632,213,419,0.0023675610786297045,0.004653797454295044,0.6629746835443038
372,509,갈수록/Noun,631,192,439,0.0021341395638352265,0.0048759357576026825,0.6957210776545166
373,510,아니/Adjective,631,205,426,0.002278638596803237,0.004731545860452718,0.6751188589540412
374,511,스릴/Noun,631,370,261,0.004112664784474134,0.002898904858164693,0.5863708399366085
375,512,개연/Noun,630,55,575,0.000611342062556966,0.006386476220094631,0.9126984126984128
376,513,애니메이션/Noun,630,418,212,0.004646199675432942,0.002354666015060977,0.6634920634920635
377,514,했던/Verb,627,391,236,0.0043460862992686115,0.002621231979030144,0.6236044657097288
378,516,배경/Noun,625,369,256,0.004101549474245826,0.002843370282337784,0.5904
379,517,같은데/Adjective,624,244,380,0.002712135695707267,0.0042206277628451475,0.6089743589743589
380,518,데/Noun,624,271,353,0.003012249071871596,0.0039207410533798346,0.5657051282051282
381,519,든/Josa,623,361,262,0.004012626992419359,0.0029100117733300754,0.579454253611557
382,520,!!!!/Punctuation,622,460,162,0.005113042705021898,0.0017993202567918784,0.7395498392282959
383,523,문제/Noun,619,201,418,0.0022341773558900027,0.004642690539129663,0.6752827140549273
384,524,이름/Noun,617,239,378,0.002656559144565725,0.004198413932514383,0.6126418152350082
385,525,지/Modifier,617,246,371,0.002734366316163884,0.00412066552635671,0.6012965964343598
386,527,하/Exclamation,614,213,401,0.0023675610786297045,0.0044538729813181676,0.6530944625407166
387,528,ㅠㅠㅠ/KoreanParticle,611,496,115,0.0055131938732410025,0.0012772952440189265,0.8117839607201309
388,529,싶은/Verb,611,359,252,0.00399039637196274,0.002798942621676256,0.5875613747954174
389,530,충격/Noun,610,399,211,0.00443500878109508,0.002343559099895595,0.6540983606557377
390,531,맘/Noun,609,373,236,0.00414601071515906,0.002621231979030144,0.6124794745484401
391,533,머리/Noun,603,235,368,0.002612097903652491,0.004087344780860563,0.6102819237147595
392,535,보단/Josa,600,239,361,0.002656559144565725,0.00400959637470289,0.6016666666666667
393,536,질/Noun,599,104,495,0.001155992263744081,0.0054979230068640745,0.8263772954924875
394,537,여/Josa,598,263,335,0.002923326590045128,0.0037208165804029593,0.560200668896321
395,540,영화인/Noun,596,336,260,0.0037347442367116467,0.002887797942999312,0.5637583892617449
396,544,큰/Verb,594,337,257,0.0037458595469399545,0.0028544771975031647,0.5673400673400674
397,545,적/Noun,593,406,187,0.004512815952693239,0.002076993135926428,0.684654300168634
398,546,예술/Noun,593,258,335,0.0028677500389035857,0.0037208165804029593,0.5649241146711635
399,547,지루한/Adjective,592,100,492,0.0011115310228308473,0.005464602261367928,0.8310810810810809
400,549,기도/Noun,591,342,249,0.003801436098081498,0.002765621876180109,0.5786802030456852
401,550,나온/Verb,591,252,339,0.002801058177533735,0.0037652442410644866,0.5736040609137056
402,551,강추/Noun,590,547,43,0.006080074694884734,0.0004775973521114245,0.9271186440677966
403,552,얘기/Noun,590,217,373,0.0024120223195429388,0.0041428793566874724,0.6322033898305085
404,553,대/Foreign,587,217,370,0.0024120223195429388,0.004109558611191328,0.6303236797274276
405,555,장르/Noun,583,201,382,0.0022341773558900027,0.004242841593175911,0.6552315608919382
406,557,더빙/Noun,582,150,432,0.0016672965342462707,0.00479818735144501,0.7422680412371134
407,558,재밌고/Adjective,581,533,48,0.005924460351688416,0.0005331319279383344,0.9173838209982788
408,559,모르겠다/Verb,581,115,466,0.0012782606762554744,0.005175822467067996,0.8020654044750429
409,561,어디/Noun,579,237,342,0.0026343285241091077,0.0037985649865606326,0.5906735751295337
410,562,주연/Noun,577,225,352,0.0025009448013694068,0.003909634138214452,0.6100519930675911
411,563,얼굴/Noun,576,199,377,0.002211946735433386,0.004187307017349001,0.6545138888888888
412,567,같이/Adverb,572,327,245,0.003634706444656871,0.002721194215518582,0.5716783216783217
413,568,웃기/Noun,571,344,227,0.0038236667185381134,0.0025212697425417065,0.6024518388791593
414,569,머/Noun,570,97,473,0.0010781850921459217,0.005253570873225671,0.8298245614035088
415,571,비/Noun,563,225,338,0.0025009448013694068,0.003754137325899105,0.6003552397868561
416,572,여기/Noun,563,228,335,0.0025342907320543315,0.0037208165804029593,0.5950266429840142
417,573,꽤/Noun,562,441,121,0.004901851810684036,0.001343936735011218,0.7846975088967971
418,574,하는데/Verb,562,199,363,0.002211946735433386,0.0040318102050336535,0.6459074733096085
419,576,짜증/Noun,558,23,535,0.00025565213525109487,0.005942199613479352,0.9587813620071683
420,577,보는데/Verb,558,219,339,0.0024342529399995552,0.0037652442410644866,0.6075268817204301
421,578,9/Number,557,382,175,0.0042460485072138366,0.0019437101539418445,0.6858168761220825
422,579,매우/Noun,557,343,214,0.003812551408309806,0.002376879845391741,0.6157989228007181
423,580,지루하다/Adjective,556,14,542,0.0001556143431963186,0.006019948019637026,0.974820143884892
424,581,ㅡ/KoreanParticle,556,157,399,0.00174510370584443,0.004431659150987405,0.7176258992805755
425,582,날/Noun,556,337,219,0.0037458595469399545,0.0024324144212186506,0.6061151079136691
426,583,ㅎㅎㅎ/KoreanParticle,555,434,121,0.0048240446390858775,0.001343936735011218,0.781981981981982
427,584,너무나/Adverb,552,365,187,0.004057088233332592,0.002076993135926428,0.6612318840579711
428,585,이리/Adverb,552,199,353,0.002211946735433386,0.0039207410533798346,0.6394927536231884
429,586,진/Noun,552,216,336,0.00240090700931463,0.0037319234955683405,0.6086956521739131
430,587,누구/Noun,552,311,241,0.0034568614810039353,0.002676766554857054,0.5634057971014492
431,588,???/Punctuation,551,142,409,0.0015783740524198029,0.004542728302641225,0.7422867513611615
432,589,두/Noun,551,362,189,0.004023742302647667,0.002099206966257192,0.6569872958257713
433,591,전쟁/Noun,549,326,223,0.003623591134428562,0.002476842081880179,0.5938069216757741
434,592,건가/Noun,546,124,422,0.0013782984683102506,0.00468711819979119,0.7728937728937729
435,593,아직/Adverb,546,363,183,0.004034857612875975,0.0020325654752649,0.6648351648351648
436,596,작/Modifier,544,183,361,0.0020341017717804503,0.00400959637470289,0.6636029411764706
437,597,했지만/Verb,544,309,235,0.003434630860547318,0.002610125063864762,0.5680147058823529
438,598,소름/Noun,540,437,103,0.004857390569770802,0.0011440122620343426,0.8092592592592592
439,599,글/Noun,538,195,343,0.002167485494520152,0.0038096719017260148,0.6375464684014871
440,600,않다/Verb,537,191,346,0.0021230242536069183,0.0038429926472221604,0.6443202979515829
441,601,식/Suffix,534,210,324,0.002334215147944779,0.003598640513583757,0.6067415730337079
442,602,재미없음/Adjective,533,9,524,0.00010003779205477625,0.005820023546660151,0.9831144465290806
443,603,걸작/Noun,533,459,74,0.005101927394793589,0.0008219117222382655,0.8611632270168855
444,604,그나마/Adverb,532,40,492,0.0004446124091323389,0.005464602261367928,0.924812030075188
445,605,본다/Verb,529,198,331,0.002200831425205077,0.003676388919741431,0.6257088846880907
446,606,억지/Noun,527,72,455,0.00080030233643821,0.005053646400248795,0.8633776091081594
447,607,대체/Noun,527,89,438,0.000989262610319454,0.004864828842437301,0.8311195445920304
448,608,다큐/Noun,527,223,304,0.002478714180912789,0.003376502210276118,0.5768500948766604
449,609,마세요/Verb,526,73,453,0.0008114176466665183,0.005031432569918031,0.8612167300380228
450,610,시절/Noun,526,397,129,0.004412778160638464,0.0014327920563342734,0.7547528517110266
451,612,존나/Noun,525,122,403,0.0013560678478536335,0.004476086811648933,0.7676190476190476
452,613,약간/Noun,525,357,168,0.003968165751506125,0.0018659617477841703,0.68
453,614,역사/Noun,525,318,207,0.0035346686526020947,0.0022991314392340674,0.6057142857142858
454,615,분들/Suffix,524,307,217,0.003412400240090701,0.002410200590887887,0.5858778625954199
455,619,아님/Adjective,522,147,375,0.0016339506035613453,0.0041650931870182385,0.7183908045977011
456,620,실화/Noun,522,331,191,0.003679167685570104,0.0021214207965879555,0.6340996168582376
457,624,해도/Noun,520,170,350,0.0018896027388124407,0.003887420307883689,0.6730769230769231
458,625,봤음/Verb,519,357,162,0.003968165751506125,0.0017993202567918784,0.6878612716763006
459,626,이었다/Verb,518,357,161,0.003968165751506125,0.001788213341626497,0.6891891891891891
460,627,아무/Modifier,518,169,349,0.001878487428584132,0.0038763133927183055,0.6737451737451737
461,628,극/Modifier,518,220,298,0.002445368250227864,0.003309860719283826,0.5752895752895753
462,630,B/Alpha,514,133,381,0.0014783362603650269,0.00423173467801053,0.7412451361867705
463,631,한마디/Noun,514,156,358,0.0017339883956161216,0.003976275629206745,0.6964980544747081
464,634,휴/Exclamation,506,86,420,0.0009559166796345287,0.004664904369460426,0.8300395256916996
465,635,자기/Noun,506,160,346,0.0017784496365293556,0.0038429926472221604,0.6837944664031621
466,636,하기/Verb,506,196,310,0.0021786008047484607,0.0034431437012684093,0.6126482213438735
467,637,없네/Adjective,504,70,434,0.000778071715981593,0.004820401181775774,0.8611111111111112
468,638,누가/Noun,504,180,324,0.002000755841095525,0.003598640513583757,0.6428571428571429
469,639,급/Suffix,504,211,293,0.002345330458173088,0.003254326143456916,0.5813492063492064
470,640,비교/Noun,504,220,284,0.002445368250227864,0.0031543639069684785,0.5634920634920635
471,641,없어/Adjective,503,126,377,0.0014005290887668675,0.004187307017349001,0.7495029821073559
472,644,보/Noun,502,287,215,0.0031900940355245318,0.002387986760557123,0.5717131474103586
473,645,니/Noun,502,220,282,0.002445368250227864,0.0031321500766377146,0.5617529880478087
474,646,만점/Noun,501,423,78,0.004701776226574484,0.0008663393828997934,0.844311377245509
475,647,초딩/Noun,501,192,309,0.0021341395638352265,0.003432036786103028,0.6167664670658682
476,648,주/Modifier,501,217,284,0.0024120223195429388,0.0031543639069684785,0.5668662674650699
477,652,간만/Noun,496,400,96,0.004446124091323389,0.0010662638558766688,0.8064516129032258
478,656,없었다/Adjective,490,186,304,0.0020674477024653763,0.003376502210276118,0.6204081632653061
479,657,자/Noun,489,199,290,0.002211946735433386,0.00322100539796077,0.5930470347648262
480,658,라도/Josa,488,145,343,0.0016117199831047284,0.0038096719017260148,0.7028688524590164
481,659,~!/Punctuation,487,385,102,0.004279394437898762,0.0011329053468689607,0.7905544147843943
482,660,CG/Alpha,487,126,361,0.0014005290887668675,0.00400959637470289,0.7412731006160165
483,661,재밌네요/Adjective,486,466,20,0.005179734566391748,0.00022213830330763932,0.9588477366255144
484,662,전체/Noun,486,158,328,0.0017562190160727387,0.003643068174245285,0.6748971193415638
485,664,아까/Adjective,484,11,473,0.00012226841251139318,0.005253570873225671,0.9772727272727272
486,665,같음/Adjective,483,193,290,0.002145254874063535,0.00322100539796077,0.6004140786749482
487,666,뿐/Suffix,482,150,332,0.0016672965342462707,0.0036874958349068132,0.6887966804979253
488,667,감성/Noun,482,311,171,0.0034568614810039353,0.0018992824932803163,0.6452282157676349
489,668,다음/Noun,482,299,183,0.0033234777582642327,0.0020325654752649,0.6203319502074689
490,669,사회/Noun,481,337,144,0.0037458595469399545,0.0015993957838150033,0.7006237006237006
491,670,오/Modifier,481,187,294,0.0020785630126936845,0.0032654330586222983,0.6112266112266113
492,671,네이버/Noun,480,179,301,0.0019896405308672165,0.003343181464779972,0.6270833333333333
493,673,발연기/Noun,477,34,443,0.0003779205477624881,0.004920363418264211,0.9287211740041929
494,674,무슨/Modifier,476,124,352,0.0013782984683102506,0.003909634138214452,0.7394957983193278
495,675,그런/Modifier,475,189,286,0.002100793633150301,0.0031765777372992424,0.6021052631578947
496,676,ㅜ/KoreanParticle,474,275,199,0.00305671031278483,0.0022102761179110114,0.5801687763713079
497,677,였습니다/Verb,472,394,78,0.004379432229953538,0.0008663393828997934,0.8347457627118644
498,678,해야/Verb,472,200,272,0.0022230620456616945,0.003021080924983895,0.576271186440678
499,681,판/Noun,468,203,265,0.00225640797634662,0.002943332518826221,0.5662393162393162
500,682,ㅉㅉ/KoreanParticle,466,72,394,0.00080030233643821,0.004376124575160495,0.8454935622317596
501,683,없어서/Adjective,466,135,331,0.0015005668808216438,0.003676388919741431,0.7103004291845494
502,684,여배우/Noun,466,198,268,0.002200831425205077,0.002976653264322367,0.575107296137339
503,685,꿈/Noun,465,353,112,0.003923704510592891,0.0012439744985227805,0.7591397849462366
504,686,재미있어요/Adjective,464,452,12,0.005024120223195429,0.0001332829819845836,0.9741379310344828
505,687,주제/Noun,463,191,272,0.0021230242536069183,0.003021080924983895,0.5874730021598272
506,689,에요/Josa,461,357,104,0.003968165751506125,0.0011551191771997243,0.7744034707158352
507,690,나이/Noun,460,314,146,0.00349020741168886,0.0016216096141457672,0.6826086956521739
508,692,어렸을/Verb,459,394,65,0.004379432229953538,0.0007219494857498278,0.8583877995642701
509,694,이/Foreign,458,326,132,0.003623591134428562,0.0014661128018304194,0.7117903930131004
510,695,하네요/Verb,458,296,162,0.003290131827579308,0.0017993202567918784,0.6462882096069869
511,697,;;;/Punctuation,457,106,351,0.001178222884200698,0.0038985272230490703,0.7680525164113785
512,698,교훈/Noun,454,274,180,0.0030455950025565213,0.001999244729768754,0.6035242290748899
513,700,좋은데/Adjective,453,172,281,0.0019118333592690567,0.0031210431614723325,0.6203090507726269
514,703,소설/Noun,449,173,276,0.0019229486694973656,0.003065508585645423,0.6146993318485523
515,705,이라도/Josa,446,106,340,0.001178222884200698,0.0037763511562298687,0.7623318385650224
516,706,힘/Noun,443,266,177,0.0029566725207300537,0.001965923984272608,0.6004514672686229
517,708,시즌/Noun,442,315,127,0.003501322721917169,0.0014105782260035095,0.7126696832579186
518,709,낸/Verb,442,299,143,0.0033234777582642327,0.0015882888686496212,0.6764705882352942
519,711,너/Noun,438,183,255,0.0020341017717804503,0.0028322633671724017,0.5821917808219178
520,712,어설픈/Adjective,437,36,401,0.000400151168219105,0.0044538729813181676,0.9176201372997712
521,713,빨리/Adverb,437,191,246,0.0021230242536069183,0.002732301130683964,0.562929061784897
522,715,방송/Noun,436,131,305,0.0014561056399084098,0.0033876091254415,0.6995412844036697
523,716,상당히/Adjective,436,259,177,0.0028788653491318944,0.001965923984272608,0.5940366972477065
524,718,모든/Modifier,434,259,175,0.0028788653491318944,0.0019437101539418445,0.5967741935483871
525,719,존재/Noun,434,257,177,0.002856634728675277,0.001965923984272608,0.5921658986175116
526,721,삼류/Noun,433,33,400,0.00036680523753417966,0.004442766066152787,0.9237875288683602
527,722,잔잔한/Adjective,432,371,61,0.004123780094702443,0.0006775218250882999,0.8587962962962963
528,723,몇번/Noun,431,334,97,0.00371251361625503,0.0010773707710420508,0.7749419953596288
529,724,보여주는/Verb,431,260,171,0.002889980659360202,0.0018992824932803163,0.6032482598607889
530,725,말고/Josa,431,182,249,0.002022986461552142,0.002765621876180109,0.5777262180974478
531,726,죽/Noun,428,138,290,0.0015339128115065689,0.00322100539796077,0.677570093457944
532,727,....../Punctuation,427,155,272,0.0017228730853878133,0.003021080924983895,0.6370023419203747
533,728,있지만/Adjective,427,271,156,0.003012249071871596,0.0017326787657995868,0.6346604215456675
534,729,당신/Noun,427,243,184,0.002701020385478959,0.0020436723904302817,0.5690866510538641
535,730,+/Punctuation,426,174,252,0.0019340639797256738,0.002798942621676256,0.5915492957746479
536,731,목소리/Noun,426,184,242,0.002045217082008759,0.002687873470022436,0.5680751173708921
537,732,여주/Noun,424,130,294,0.001444990329680101,0.0032654330586222983,0.6933962264150944
538,733,진정한/Adjective,423,309,114,0.003434630860547318,0.001266188328853544,0.7304964539007093
539,735,질질/Noun,419,72,347,0.00080030233643821,0.003854099562387543,0.8281622911694511
540,736,미친/Adjective,419,132,287,0.0014672209501367186,0.0031876846524646245,0.684964200477327
541,737,지/Verb,418,120,298,0.0013338372273970164,0.003309860719283826,0.7129186602870813
542,738,전부/Noun,418,133,285,0.0014783362603650269,0.003165470822133861,0.6818181818181818
543,739,바/Noun,418,165,253,0.0018340261876708976,0.0028100495368416373,0.6052631578947368
544,740,줄거리/Noun,417,136,281,0.0015116821910499524,0.0031210431614723325,0.6738609112709832
545,742,되고/Verb,416,243,173,0.002701020385478959,0.0019214963236110802,0.5841346153846154
546,743,신/Noun,416,182,234,0.002022986461552142,0.0025990181486993803,0.5625
547,745,점주/Noun,415,98,317,0.0010893004023742304,0.0035208921074260835,0.763855421686747
548,746,실제/Noun,415,250,165,0.002778827557077118,0.0018326410022880247,0.6024096385542169
549,747,답/Noun,413,100,313,0.0011115310228308473,0.0034764644467645558,0.7578692493946732
550,748,재미있다/Adjective,412,357,55,0.003968165751506125,0.0006108803340960082,0.866504854368932
551,749,되어/Verb,411,249,162,0.002767712246848809,0.0017993202567918784,0.6058394160583942
552,751,좋아/Adjective,409,337,72,0.0037458595469399545,0.0007996978919075017,0.8239608801955991
553,753,낭비/Noun,408,8,400,8.892248182646779e-05,0.004442766066152787,0.9803921568627452
554,754,굉장히/Adjective,408,277,131,0.003078940933241447,0.0014550058866650375,0.678921568627451
555,755,버린/Verb,408,133,275,0.0014783362603650269,0.003054401670480041,0.6740196078431373
556,756,으로도/Josa,408,240,168,0.002667674454794033,0.0018659617477841703,0.5882352941176471
557,758,각본/Noun,407,121,286,0.001344952537625325,0.0031765777372992424,0.7027027027027027
558,760,같네요/Adjective,406,244,162,0.002712135695707267,0.0017993202567918784,0.6009852216748769
559,761,먹/Verb,402,321,81,0.0035680145832870194,0.0008996601283959392,0.7985074626865671
560,762,재/Noun,401,255,146,0.002834404108218661,0.0016216096141457672,0.6359102244389028
561,763,필요/Noun,401,226,175,0.0025120601115977146,0.0019437101539418445,0.5635910224438903
562,765,성룡/Noun,398,235,163,0.002612097903652491,0.001810427171957261,0.5904522613065326
563,767,순간/Noun,397,263,134,0.002923326590045128,0.0014883266321611835,0.6624685138539043
564,768,어른/Noun,397,249,148,0.002767712246848809,0.001643823444476531,0.6272040302267002
565,769,평론가/Noun,397,239,158,0.002656559144565725,0.0017548925961303507,0.6020151133501259
566,770,갑자기/Noun,396,103,293,0.0011448769535157724,0.003254326143456916,0.73989898989899
567,771,제작/Noun,396,143,253,0.0015894893626481115,0.0028100495368416373,0.6388888888888888
568,773,이하/Noun,395,34,361,0.0003779205477624881,0.00400959637470289,0.9139240506329114
569,776,쳐/Verb,393,97,296,0.0010781850921459217,0.003287646888953062,0.7531806615776081
570,778,간다/Noun,392,151,241,0.0016784118444745793,0.002676766554857054,0.6147959183673469
571,779,하며/Verb,391,248,143,0.0027565969366205013,0.0015882888686496212,0.6342710997442456
572,780,의도/Noun,390,66,324,0.0007336104750683593,0.003598640513583757,0.8307692307692308
573,781,발/Noun,390,81,309,0.0009003401284929863,0.003432036786103028,0.7923076923076923
574,782,영/Noun,390,107,283,0.0011893381944290064,0.0031432569918030968,0.7256410256410256
575,784,나온다/Verb,389,112,277,0.0012449147455705488,0.003076615500810805,0.7120822622107971
576,785,난다/Verb,389,168,221,0.0018673721183558234,0.0024546282515494145,0.5681233933161953
577,787,밑/Noun,388,119,269,0.0013227219171687082,0.0029877601794877488,0.6932989690721649
578,788,TV/Alpha,388,158,230,0.0017562190160727387,0.002554590488037853,0.5927835051546392
579,789,재미있는/Adjective,387,327,60,0.003634706444656871,0.000666414909922918,0.8449612403100775
580,790,땜/Noun,387,126,261,0.0014005290887668675,0.002898904858164693,0.6744186046511628
581,792,해주는/Verb,386,304,82,0.003379054309405776,0.0009107670435613213,0.7875647668393783
582,793,하네/Verb,385,114,271,0.0012671453660271655,0.003009974009818513,0.7038961038961039
583,794,아버지/Noun,385,261,124,0.0029010959695885113,0.0013772574805073642,0.6779220779220779
584,795,히/Adverb,385,222,163,0.0024675988706844808,0.001810427171957261,0.5766233766233766
585,798,비해/Verb,384,123,261,0.001367183158081942,0.002898904858164693,0.6796875
586,799,한편/Noun,384,232,152,0.0025787519729675657,0.001688251105138059,0.6041666666666666
587,800,피/Noun,384,156,228,0.0017339883956161216,0.0025323766577070887,0.59375
588,802,봤네요/Verb,381,343,38,0.003812551408309806,0.0004220627762845148,0.9002624671916011
589,803,재밌는데/Adjective,381,339,42,0.003768090167396572,0.00046649043694604257,0.8897637795275591
590,804,좋음/Adjective,381,311,70,0.0034568614810039353,0.0007774840615767378,0.8162729658792651
591,806,볼때/Noun,380,276,104,0.0030678256230131378,0.0011551191771997243,0.7263157894736842
592,807,되지/Verb,378,150,228,0.0016672965342462707,0.0025323766577070887,0.6031746031746031
593,809,있어서/Adjective,377,285,92,0.0031678634150679144,0.0010218361952151409,0.7559681697612732
594,810,어린/Verb,377,212,165,0.002356445768401396,0.0018326410022880247,0.5623342175066313
595,812,10년/Number,376,276,100,0.0030678256230131378,0.0011106915165381968,0.7340425531914894
596,813,는데/Verb,376,226,150,0.0025120601115977146,0.001666037274807295,0.6010638297872339
597,814,세계/Noun,376,224,152,0.0024898294911410977,0.001688251105138059,0.5957446808510638
598,815,있을까/Adjective,375,249,126,0.002767712246848809,0.0013994713108381278,0.664
599,817,훌륭한/Adjective,374,295,79,0.0032790165173509998,0.0008774462980651753,0.7887700534759359
600,818,첨/Adverb,374,111,263,0.0012337994353422404,0.002921118688495457,0.7032085561497327
601,819,봐야/Verb,374,262,112,0.0029122112798168195,0.0012439744985227805,0.7005347593582888
602,820,막/Noun,373,133,240,0.0014783362603650269,0.002665659639691672,0.6434316353887399
603,823,모르고/Verb,372,277,95,0.003078940933241447,0.0010551569407112867,0.7446236559139785
604,825,좋네요/Adjective,371,346,25,0.003845897338994731,0.0002776728791345492,0.9326145552560648
605,826,슬픈/Adjective,371,315,56,0.003501322721917169,0.0006219872492613901,0.8490566037735849
606,827,그때/Noun,371,269,102,0.002990018451414979,0.0011329053468689607,0.7250673854447439
607,828,항상/Noun,371,247,124,0.002745481626392193,0.0013772574805073642,0.6657681940700808
608,829,좀비/Noun,370,127,243,0.001411644398995176,0.002698980385187818,0.6567567567567567
609,831,치고/Josa,368,112,256,0.0012449147455705488,0.002843370282337784,0.6956521739130435
610,833,뻔/Noun,367,98,269,0.0010893004023742304,0.0029877601794877488,0.7329700272479565
611,836,거지/Noun,366,99,267,0.0011004157126025386,0.0029655463491569853,0.7295081967213115
612,837,곳/Noun,365,245,120,0.002723251005935576,0.001332829819845836,0.6712328767123288
613,838,원/Modifier,364,158,206,0.0017562190160727387,0.002288024524068685,0.5659340659340659
614,841,없네요/Adjective,362,111,251,0.0012337994353422404,0.002787835706510873,0.6933701657458563
615,843,짱/Suffix,361,320,41,0.003556899273058711,0.00045538352178066063,0.8864265927977839
616,844,성/Modifier,361,130,231,0.001444990329680101,0.0025656974032032343,0.6398891966759003
617,845,진행/Noun,360,97,263,0.0010781850921459217,0.002921118688495457,0.7305555555555555
618,848,동안/Noun,359,206,153,0.0022897539070315448,0.001699358020303441,0.5738161559888579
619,849,이에요/Josa,358,286,72,0.003178978725296223,0.0007996978919075017,0.7988826815642458
620,850,더욱/Noun,358,281,77,0.0031234021741546806,0.0008552324677344116,0.7849162011173184
621,851,tv/Alpha,358,103,255,0.0011448769535157724,0.0028322633671724017,0.7122905027932961
622,852,낫다/Noun,358,124,234,0.0013782984683102506,0.0025990181486993803,0.6536312849162011
623,853,초/Noun,357,148,209,0.0016450659137896538,0.002321345269564831,0.5854341736694678
624,855,더럽게/Adjective,356,17,339,0.00018896027388124405,0.0037652442410644866,0.952247191011236
625,856,어이/Noun,355,29,326,0.0003223439966209457,0.003620854343914521,0.9183098591549296
626,857,상미/Noun,355,237,118,0.0026343285241091077,0.001310615989515072,0.6676056338028169
627,858,래/Josa,355,138,217,0.0015339128115065689,0.002410200590887887,0.6112676056338028
628,859,참고/Noun,354,65,289,0.0007224951648400508,0.003209898482795389,0.8163841807909604
629,860,중국/Noun,354,122,232,0.0013560678478536335,0.0025768043183686164,0.655367231638418
630,861,완성/Noun,354,212,142,0.002356445768401396,0.0015771819534842392,0.5988700564971752
631,863,몇/Noun,353,222,131,0.0024675988706844808,0.0014550058866650375,0.6288951841359773
632,864,그녀/Noun,352,266,86,0.0029566725207300537,0.0009551947042228492,0.7556818181818182
633,869,대단한/Adjective,348,246,102,0.002734366316163884,0.0011329053468689607,0.7068965517241379
634,870,거기/Noun,348,120,228,0.0013338372273970164,0.0025323766577070887,0.6551724137931034
635,871,깊은/Adjective,347,303,44,0.0033679389991774673,0.0004887042672768067,0.8731988472622478
636,872,점점/Noun,347,138,209,0.0015339128115065689,0.002321345269564831,0.6023054755043228
637,873,굳/Adjective,346,330,16,0.003668052375341796,0.00017771064264611146,0.9537572254335259
638,875,이냐/Josa,345,47,298,0.0005224195807304982,0.003309860719283826,0.8637681159420291
639,876,수가/Noun,345,151,194,0.0016784118444745793,0.002154741542084101,0.5623188405797102
640,877,재미없는/Adjective,344,18,326,0.0002000755841095525,0.003620854343914521,0.9476744186046512
641,878,보는게/Verb,344,55,289,0.000611342062556966,0.003209898482795389,0.8401162790697675
642,879,짜리/Verb,344,134,210,0.001489451570593335,0.002332452184730213,0.6104651162790697
643,880,아까워/Adjective,343,16,327,0.00017784496365293558,0.0036319612590799033,0.9533527696793004
644,881,충분히/Adjective,343,272,71,0.003023364382099905,0.0007885909767421196,0.793002915451895
645,882,어디서/Adverb,343,123,220,0.001367183158081942,0.0024435213363840328,0.641399416909621
646,883,관람/Noun,343,149,194,0.0016561812240179624,0.002154741542084101,0.5655976676384841
647,885,술/Noun,342,58,284,0.0006446879932418914,0.0031543639069684785,0.8304093567251462
648,886,전형/Noun,342,64,278,0.0007113798546117423,0.0030877224159761873,0.8128654970760234
649,887,좋겠다/Adjective,342,240,102,0.002667674454794033,0.0011329053468689607,0.7017543859649122
650,888,따뜻한/Adjective,340,312,28,0.003467976791232243,0.000310993624630695,0.9176470588235294
651,889,편집/Noun,340,103,237,0.0011448769535157724,0.0026323388941955268,0.6970588235294117
652,891,잠/Noun,339,82,257,0.0009114554387212947,0.0028544771975031647,0.7581120943952803
653,892,나옴/Verb,339,83,256,0.0009225707489496033,0.002843370282337784,0.7551622418879056
654,895,해준/Verb,337,275,62,0.00305671031278483,0.0006886287402536821,0.8160237388724035
655,896,하는게/Verb,337,103,234,0.0011448769535157724,0.0025990181486993803,0.6943620178041543
656,897,사건/Noun,337,130,207,0.001444990329680101,0.0022991314392340674,0.6142433234421365
657,898,쯤/Suffix,336,199,137,0.002211946735433386,0.0015216473776573296,0.5922619047619048
658,899,였어요/Verb,335,281,54,0.0031234021741546806,0.0005997734189306263,0.8388059701492537
659,900,화보/Noun,335,124,211,0.0013782984683102506,0.002343559099895595,0.6298507462686567
660,901,화이팅/Noun,334,296,38,0.003290131827579308,0.0004220627762845148,0.8862275449101796
661,905,새로운/Adjective,332,247,85,0.002745481626392193,0.0009440877890574672,0.7439759036144579
662,906,안된다/Adjective,331,76,255,0.0008447635773514439,0.0028322633671724017,0.770392749244713
663,907,꿀잼/Noun,330,316,14,0.003512438032145477,0.0001554968123153475,0.9575757575757576
664,908,똥/Noun,330,29,301,0.0003223439966209457,0.003343181464779972,0.912121212121212
665,909,그게/Noun,330,91,239,0.001011493230776071,0.0026545527245262907,0.7242424242424242
666,912,중반/Noun,328,125,203,0.001389413778538559,0.002254703778572539,0.6189024390243902
667,913,취향/Noun,328,127,201,0.001411644398995176,0.0022324899482417753,0.6128048780487805
668,914,나올/Verb,328,141,187,0.0015672587421914947,0.002076993135926428,0.5701219512195121
669,916,-_-/Punctuation,327,38,289,0.000422381788675722,0.003209898482795389,0.8837920489296636
670,917,개그/Noun,327,99,228,0.0011004157126025386,0.0025323766577070887,0.6972477064220184
671,918,감상/Noun,327,185,142,0.002056332392237067,0.0015771819534842392,0.5657492354740061
672,921,엉망/Noun,326,22,304,0.00024453682502278637,0.003376502210276118,0.9325153374233128
673,922,병맛/Noun,326,57,269,0.0006335726830135829,0.0029877601794877488,0.8251533742331288
674,923,티/Noun,325,91,234,0.001011493230776071,0.0025990181486993803,0.72
675,924,복수/Noun,325,128,197,0.0014227597092234846,0.0021880622875802475,0.6061538461538462
676,925,가서/Verb,325,139,186,0.0015450281217348775,0.002065886220761046,0.5723076923076923
677,926,있음/Adjective,325,182,143,0.002022986461552142,0.0015882888686496212,0.56
678,927,대로/Josa,325,143,182,0.0015894893626481115,0.002021458560099518,0.56
679,928,관/Noun,324,221,103,0.0024564835604561725,0.0011440122620343426,0.6820987654320988
680,929,ㄷㄷ/KoreanParticle,324,200,124,0.0022230620456616945,0.0013772574805073642,0.6172839506172839
681,930,액션영화/Noun,324,192,132,0.0021341395638352265,0.0014661128018304194,0.5925925925925926
682,933,미화/Noun,323,44,279,0.0004890736500455726,0.003098829331141569,0.8637770897832817
683,934,~!!/Punctuation,323,253,70,0.0028121734877620433,0.0007774840615767378,0.7832817337461301
684,935,아닌가/Adjective,323,112,211,0.0012449147455705488,0.002343559099895595,0.6532507739938079
685,936,흥미/Noun,323,125,198,0.001389413778538559,0.0021991692027456293,0.6130030959752322
686,937,//Punctuation,323,130,193,0.001444990329680101,0.00214363462691872,0.5975232198142415
687,938,예상/Noun,323,138,185,0.0015339128115065689,0.002054779305595664,0.5727554179566563
688,940,몸/Noun,322,132,190,0.0014672209501367186,0.0021103138814225733,0.5900621118012422
689,941,과/Noun,322,138,184,0.0015339128115065689,0.0020436723904302817,0.5714285714285714
690,944,흥미진진/Noun,321,276,45,0.0030678256230131378,0.0004998111824421885,0.8598130841121495
691,947,있게/Adjective,320,243,77,0.002701020385478959,0.0008552324677344116,0.759375
692,948,알았다/Verb,320,94,226,0.0010448391614609964,0.002510162827376325,0.70625
693,950,여서/Josa,319,132,187,0.0014672209501367186,0.002076993135926428,0.5862068965517241
694,951,잘만/Noun,318,239,79,0.002656559144565725,0.0008774462980651753,0.7515723270440252
695,952,좋았어요/Adjective,317,311,6,0.0034568614810039353,6.66414909922918e-05,0.9810725552050472
696,953,에겐/Josa,317,194,123,0.0021563701842918434,0.001366150565341982,0.61198738170347
697,954,노력/Noun,317,132,185,0.0014672209501367186,0.002054779305595664,0.583596214511041
698,955,재밌었다/Adjective,316,296,20,0.003290131827579308,0.00022213830330763932,0.9367088607594936
699,956,만으로도/Josa,316,285,31,0.0031678634150679144,0.00034431437012684104,0.9018987341772152
700,957,학교/Noun,316,192,124,0.0021341395638352265,0.0013772574805073642,0.6075949367088608
701,958,괜히/Adverb,315,80,235,0.0008892248182646778,0.002610125063864762,0.7460317460317459
702,959,또한/Noun,315,208,107,0.002311984527488162,0.0011884399226958706,0.6603174603174603
703,960,엄청난/Adjective,315,207,108,0.002300869217259854,0.0011995468378612525,0.6571428571428571
704,961,과거/Noun,315,196,119,0.0021786008047484607,0.0013217229046804538,0.6222222222222222
705,962,오/Noun,315,182,133,0.002022986461552142,0.0014772197169958016,0.5777777777777777
706,964,그래픽/Noun,314,78,236,0.0008669941978080608,0.002621231979030144,0.7515923566878981
707,965,ost/Alpha,313,265,48,0.002945557210501745,0.0005331319279383344,0.8466453674121406
708,966,기대하고/Adjective,313,53,260,0.000589111442100349,0.002887797942999312,0.8306709265175719
709,967,그냥/Modifier,313,87,226,0.0009670319898628369,0.002510162827376325,0.7220447284345048
710,968,이라니/Josa,313,116,197,0.0012893759864837828,0.0021880622875802475,0.6293929712460063
711,969,무/Noun,313,127,186,0.001411644398995176,0.002065886220761046,0.5942492012779552
712,970,그만/Adverb,312,21,291,0.00023342151479447792,0.0032321123131261523,0.9326923076923076
713,971,장/Suffix,312,89,223,0.000989262610319454,0.002476842081880179,0.7147435897435898
714,972,20/Number,312,211,101,0.002345330458173088,0.0011217984317035787,0.6762820512820513
715,973,바보/Noun,311,85,226,0.0009448013694062199,0.002510162827376325,0.7266881028938906
716,974,성우/Noun,310,70,240,0.000778071715981593,0.002665659639691672,0.7741935483870968
717,975,헐/Verb,309,87,222,0.0009670319898628369,0.002465735166714797,0.7184466019417476
718,976,봣/Noun,308,207,101,0.002300869217259854,0.0011217984317035787,0.6720779220779219
719,977,나오고/Verb,307,81,226,0.0009003401284929863,0.002510162827376325,0.7361563517915309
720,978,죽음/Noun,307,206,101,0.0022897539070315448,0.0011217984317035787,0.6710097719869706
721,979,대한민국/Noun,307,185,122,0.002056332392237067,0.0013550436501765998,0.6026058631921825
722,981,유치/Noun,306,21,285,0.00023342151479447792,0.003165470822133861,0.931372549019608
723,982,나쁜/Adjective,306,100,206,0.0011115310228308473,0.002288024524068685,0.673202614379085
724,983,해도/Verb,306,100,206,0.0011115310228308473,0.002288024524068685,0.673202614379085
725,985,도저히/Noun,305,26,279,0.00028899806593602026,0.003098829331141569,0.9147540983606556
726,986,식/Noun,305,72,233,0.00080030233643821,0.002587911233533998,0.7639344262295082
727,987,속편/Noun,305,99,206,0.0011004157126025386,0.002288024524068685,0.6754098360655738
728,991,울/Noun,304,228,76,0.0025342907320543315,0.0008441255525690295,0.75
729,992,무조건/Noun,304,193,111,0.002145254874063535,0.0012328675833573985,0.6348684210526315
730,993,야할/Adjective,303,233,70,0.002589867283195874,0.0007774840615767378,0.768976897689769
731,994,전달/Noun,303,115,188,0.0012782606762554744,0.0020881000510918103,0.6204620462046204
732,995,땐/Noun,303,183,120,0.0020341017717804503,0.001332829819845836,0.6039603960396039
733,996,상상/Noun,303,173,130,0.0019229486694973656,0.0014438989714996556,0.570957095709571
734,998,하는지/Verb,302,93,209,0.0010337238512326881,0.002321345269564831,0.6920529801324503
735,999,않음/Verb,302,97,205,0.0010781850921459217,0.002276917608903303,0.6788079470198676
736,1000,보이/Noun,302,130,172,0.001444990329680101,0.0019103894084456985,0.5695364238410596
737,1001,안됨/Adjective,301,50,251,0.0005557655114154236,0.002787835706510873,0.8338870431893688
738,1002,천재/Noun,301,236,65,0.0026232132138807995,0.0007219494857498278,0.7840531561461794
739,1004,억지로/Noun,300,42,258,0.00046684302958895584,0.002865584112668547,0.86
740,1005,우연히/Adverb,300,258,42,0.0028677500389035857,0.00046649043694604257,0.86
741,1006,같습니다/Adjective,300,233,67,0.002589867283195874,0.0007441633160805918,0.7766666666666666
742,1007,심리/Noun,300,207,93,0.002300869217259854,0.001032943110380523,0.69
743,1009,화가/Noun,299,75,224,0.0008336482671231353,0.0024879489970455605,0.7491638795986622
744,1010,드는/Verb,298,178,120,0.001978525220638908,0.001332829819845836,0.5973154362416108
745,1011,댓글/Noun,297,75,222,0.0008336482671231353,0.002465735166714797,0.7474747474747475
746,1012,자꾸/Noun,297,119,178,0.0013227219171687082,0.0019770308994379896,0.5993265993265994
747,1014,완벽한/Adjective,296,254,42,0.002823288797990352,0.00046649043694604257,0.8581081081081081
748,1015,속/Modifier,296,73,223,0.0008114176466665183,0.002476842081880179,0.7533783783783784
749,1016,아무/Noun,296,116,180,0.0012893759864837828,0.001999244729768754,0.6081081081081081
750,1017,되/Verb,296,173,123,0.0019229486694973656,0.001366150565341982,0.5844594594594594
751,1018,타임/Noun,296,130,166,0.001444990329680101,0.0018437479174534066,0.5608108108108109
752,1019,새끼/Noun,295,80,215,0.0008892248182646778,0.002387986760557123,0.7288135593220338
753,1020,재미있고/Adjective,294,272,22,0.003023364382099905,0.00024435213363840333,0.9251700680272108
754,1021,척/Noun,294,58,236,0.0006446879932418914,0.002621231979030144,0.8027210884353742
755,1022,예고편/Noun,294,69,225,0.0007669564057532844,0.002499055912210943,0.7653061224489796
756,1023,미/Adjective,294,127,167,0.001411644398995176,0.0018548548326187888,0.5680272108843537
757,1024,재미없고/Adjective,293,9,284,0.00010003779205477625,0.0031543639069684785,0.969283276450512
758,1025,다가/Noun,293,91,202,0.001011493230776071,0.0022435968634071574,0.6894197952218429
759,1026,최근/Noun,293,195,98,0.002167485494520152,0.001088477686207433,0.6655290102389079
760,1029,현/Modifier,292,181,111,0.0020118711513238334,0.0012328675833573985,0.6198630136986302
761,1030,느끼게/Verb,291,222,69,0.0024675988706844808,0.0007663771464113557,0.7628865979381443
762,1031,good/Alpha,291,213,78,0.0023675610786297045,0.0008663393828997934,0.7319587628865979
763,1032,어느/Modifier,291,104,187,0.001155992263744081,0.002076993135926428,0.6426116838487973
764,1033,그림/Noun,291,164,127,0.0018229108774425891,0.0014105782260035095,0.5635738831615121
765,1034,불륜/Noun,289,75,214,0.0008336482671231353,0.002376879845391741,0.740484429065744
766,1035,젠/Noun,289,80,209,0.0008892248182646778,0.002321345269564831,0.7231833910034602
767,1036,터/Noun,289,126,163,0.0014005290887668675,0.001810427171957261,0.5640138408304498
768,1037,대작/Noun,288,231,57,0.002567636662739257,0.0006330941644267722,0.8020833333333334
769,1038,짐/Noun,288,189,99,0.002100793633150301,0.0010995846013728146,0.65625
770,1039,무비/Noun,288,124,164,0.0013782984683102506,0.0018215340871226425,0.5694444444444444
771,1042,재밌어/Adjective,287,234,53,0.0026009825934241826,0.0005886665037652442,0.8153310104529616
772,1043,봤을/Verb,287,177,110,0.0019674099104106,0.0012217606681920164,0.6167247386759582
773,1044,촬영/Noun,287,121,166,0.001344952537625325,0.0018437479174534066,0.5783972125435539
774,1045,전편/Noun,287,125,162,0.001389413778538559,0.0017993202567918784,0.5644599303135889
775,1046,있었다/Adjective,286,213,73,0.0023675610786297045,0.0008108048070728836,0.7447552447552448
776,1047,열/Noun,286,78,208,0.0008669941978080608,0.0023102383543994486,0.7272727272727273
777,1048,있을/Adjective,286,162,124,0.0018006802569859727,0.0013772574805073642,0.5664335664335665
778,1051,2시간/Number,285,95,190,0.0010559544716893046,0.0021103138814225733,0.6666666666666666
779,1052,표정/Noun,285,161,124,0.001789564946757664,0.0013772574805073642,0.5649122807017544
780,1053,동/Modifier,285,124,161,0.0013782984683102506,0.001788213341626497,0.5649122807017544
781,1055,게임/Noun,284,97,187,0.0010781850921459217,0.002076993135926428,0.6584507042253521
782,1056,행동/Noun,284,103,181,0.0011448769535157724,0.002010351644934136,0.6373239436619719
783,1057,고/Modifier,284,123,161,0.001367183158081942,0.001788213341626497,0.5669014084507042
784,1059,짓/Noun,283,70,213,0.000778071715981593,0.002365772930226359,0.7526501766784452
785,1060,환상/Noun,283,207,76,0.002300869217259854,0.0008441255525690295,0.7314487632508834
786,1061,여/Noun,283,178,105,0.001978525220638908,0.0011662260923651065,0.6289752650176679
787,1063,오래/Adverb,282,230,52,0.002556521352510949,0.0005775595885998622,0.8156028368794326
788,1065,재미없어/Adjective,280,5,275,5.557655114154236e-05,0.003054401670480041,0.9821428571428572
789,1066,그닥/Noun,280,25,255,0.0002778827557077118,0.0028322633671724017,0.9107142857142856
790,1067,귀신/Noun,280,71,209,0.0007891870262099014,0.002321345269564831,0.7464285714285714
791,1068,쓴/Verb,280,75,205,0.0008336482671231353,0.002276917608903303,0.7321428571428571
792,1069,아니면/Adjective,280,78,202,0.0008669941978080608,0.0022435968634071574,0.7214285714285714
793,1070,전설/Noun,280,175,105,0.0019451792899539827,0.0011662260923651065,0.625
794,1071,입/Noun,280,115,165,0.0012782606762554744,0.0018326410022880247,0.5892857142857143
795,1073,산/Noun,279,67,212,0.0007447257852966678,0.002354666015060977,0.7598566308243727
796,1074,볼수/Verb,279,203,76,0.00225640797634662,0.0008441255525690295,0.7275985663082437
797,1075,하는거/Verb,279,78,201,0.0008669941978080608,0.0022324899482417753,0.7204301075268817
798,1076,총/Modifier,279,87,192,0.0009670319898628369,0.0021325277117533376,0.6881720430107527
799,1077,회/Noun,279,177,102,0.0019674099104106,0.0011329053468689607,0.6344086021505376
800,1079,재밌었어요/Adjective,277,268,9,0.00297890314118667,9.996223648843771e-05,0.967509025270758
801,1080,전작/Noun,277,72,205,0.00080030233643821,0.002276917608903303,0.740072202166065
802,1081,총/Noun,277,85,192,0.0009448013694062199,0.0021325277117533376,0.6931407942238267
803,1082,유머/Noun,277,161,116,0.001789564946757664,0.0012884021591843082,0.5812274368231047
804,1083,♡/Foreign,276,264,12,0.0029344419002734373,0.0001332829819845836,0.9565217391304348
805,1085,현재/Noun,275,205,70,0.002278638596803237,0.0007774840615767378,0.7454545454545455
806,1086,극/Suffix,275,114,161,0.0012671453660271655,0.001788213341626497,0.5854545454545454
807,1087,마/Noun,275,119,156,0.0013227219171687082,0.0017326787657995868,0.5672727272727273
808,1088,놔/Verb,274,53,221,0.000589111442100349,0.0024546282515494145,0.8065693430656934
809,1089,울/Modifier,274,178,96,0.001978525220638908,0.0010662638558766688,0.6496350364963503
810,1090,제작비/Noun,273,38,235,0.000422381788675722,0.002610125063864762,0.8608058608058609
811,1091,예요/Josa,273,206,67,0.0022897539070315448,0.0007441633160805918,0.7545787545787546
812,1092,스러운/Josa,273,89,184,0.000989262610319454,0.0020436723904302817,0.6739926739926739
813,1093,다행/Noun,273,104,169,0.001155992263744081,0.0018770686629495524,0.6190476190476191
814,1094,흠/Noun,272,105,167,0.0011671075739723895,0.0018548548326187888,0.6139705882352942
815,1095,아쉬운/Adjective,272,163,109,0.001811795567214281,0.0012106537530266347,0.5992647058823529
816,1098,통해/Noun,271,217,54,0.0024120223195429388,0.0005997734189306263,0.8007380073800738
817,1099,노/Noun,271,96,175,0.0010670697819176133,0.0019437101539418445,0.6457564575645757
818,1100,주의/Noun,271,113,158,0.0012560300557988573,0.0017548925961303507,0.5830258302583026
819,1102,이미/Adverb,270,114,156,0.0012671453660271655,0.0017326787657995868,0.5777777777777777
820,1103,짜/Verb,269,92,177,0.0010226085410043797,0.001965923984272608,0.6579925650557621
821,1104,아쉬움/Noun,269,159,110,0.0017673343263010473,0.0012217606681920164,0.5910780669144982
822,1107,망작/Noun,268,16,252,0.00017784496365293558,0.002798942621676256,0.9402985074626866
823,1108,좋았음/Adjective,268,241,27,0.0026787897650223423,0.0002998867094653131,0.8992537313432836
824,1109,맞는/Verb,268,95,173,0.0010559544716893046,0.0019214963236110802,0.6455223880597015
825,1110,먹고/Verb,268,101,167,0.0011226463330591557,0.0018548548326187888,0.6231343283582089
826,1111,억/Modifier,268,114,154,0.0012671453660271655,0.0017104649354688231,0.5746268656716418
827,1112,소녀/Noun,268,117,151,0.0013004912967120913,0.001677144189972677,0.5634328358208955
828,1114,좋았습니다/Adjective,267,258,9,0.0028677500389035857,9.996223648843771e-05,0.9662921348314608
829,1115,되었다/Verb,267,201,66,0.0022341773558900027,0.0007330564009152097,0.7528089887640449
830,1116,가끔/Noun,267,174,93,0.0019340639797256738,0.001032943110380523,0.651685393258427
831,1117,만의/Josa,267,167,100,0.001856256808127515,0.0011106915165381968,0.6254681647940075
832,1118,안되고/Adjective,266,10,256,0.00011115310228308472,0.002843370282337784,0.962406015037594
833,1119,동화/Noun,266,189,77,0.002100793633150301,0.0008552324677344116,0.7105263157894737
834,1120,80년/Number,266,82,184,0.0009114554387212947,0.0020436723904302817,0.6917293233082706
835,1121,:/Punctuation,266,106,160,0.001178222884200698,0.0017771064264611148,0.6015037593984962
836,1122,먼저/Noun,266,153,113,0.0017006424649311962,0.0012550814136881624,0.575187969924812
837,1123,100/Number,265,171,94,0.001900718049040749,0.0010440500255459052,0.6452830188679245
838,1124,묘사/Noun,265,170,95,0.0018896027388124407,0.0010551569407112867,0.6415094339622641
839,1127,지루하지/Adjective,264,251,13,0.0027899428673054264,0.00014438989714996554,0.9507575757575758
840,1128,예산/Noun,264,65,199,0.0007224951648400508,0.0022102761179110114,0.7537878787878788
841,1129,으/Adverb,263,97,166,0.0010781850921459217,0.0018437479174534066,0.6311787072243346
842,1130,여러/Modifier,263,165,98,0.0018340261876708976,0.001088477686207433,0.6273764258555133
843,1135,채널/Noun,262,82,180,0.0009114554387212947,0.001999244729768754,0.6870229007633588
844,1136,살인/Noun,262,97,165,0.0010781850921459217,0.0018326410022880247,0.6297709923664122
845,1137,긴/Verb,262,161,101,0.001789564946757664,0.0011217984317035787,0.6145038167938931
846,1138,따라/Verb,262,106,156,0.001178222884200698,0.0017326787657995868,0.5954198473282443
847,1139,받아/Verb,262,110,152,0.001222684125113932,0.001688251105138059,0.5801526717557252
848,1142,감사합니다/Verb,260,241,19,0.0026787897650223423,0.00021103138814225735,0.926923076923077
849,1143,유치하고/Adjective,260,21,239,0.00023342151479447792,0.0026545527245262907,0.9192307692307692
850,1144,보고싶다/Verb,260,227,33,0.0025231754218260232,0.00036652820045760486,0.8730769230769231
851,1145,느낄/Verb,260,207,53,0.002300869217259854,0.0005886665037652442,0.7961538461538461
852,1146,강/Noun,260,197,63,0.002189716114976769,0.0006997356554190639,0.7576923076923077
853,1147,만큼/Josa,260,150,110,0.0016672965342462707,0.0012217606681920164,0.5769230769230769
854,1148,리메이크/Noun,260,113,147,0.0012560300557988573,0.0016327165293111491,0.5653846153846154
855,1149,아닐까/Adjective,259,191,68,0.0021230242536069183,0.0007552702312459737,0.7374517374517374
856,1150,특유/Noun,259,151,108,0.0016784118444745793,0.0011995468378612525,0.5830115830115831
857,1154,유치한/Adjective,258,42,216,0.00046684302958895584,0.002399093675722505,0.8372093023255814
858,1155,졸라/Noun,258,75,183,0.0008336482671231353,0.0020325654752649,0.7093023255813954
859,1156,아니지만/Adjective,258,177,81,0.0019674099104106,0.0008996601283959392,0.686046511627907
860,1157,프로그램/Noun,258,102,156,0.0011337616432874642,0.0017326787657995868,0.6046511627906976
861,1159,개/Suffix,257,79,178,0.0008781095080363692,0.0019770308994379896,0.6926070038910506
862,1160,등장/Noun,257,108,149,0.001200453504657315,0.001654930359641913,0.5797665369649806
863,1164,만들/Verb,256,53,203,0.000589111442100349,0.002254703778572539,0.79296875
864,1165,외/Noun,256,70,186,0.000778071715981593,0.002065886220761046,0.7265625
865,1166,서로/Noun,256,161,95,0.001789564946757664,0.0010551569407112867,0.62890625
866,1167,존/Noun,256,111,145,0.0012337994353422404,0.001610502698980385,0.56640625
867,1169,낚/Noun,254,20,234,0.00022230620456616945,0.0025990181486993803,0.9212598425196852
868,1170,진부한/Adjective,254,38,216,0.000422381788675722,0.002399093675722505,0.8503937007874016
869,1171,이상한/Adjective,254,63,191,0.0007002645443834338,0.0021214207965879555,0.7519685039370079
870,1172,경찰/Noun,254,98,156,0.0010893004023742304,0.0017326787657995868,0.6141732283464567
871,1173,아닌데/Adjective,254,108,146,0.001200453504657315,0.0016216096141457672,0.5748031496062992
872,1175,보시길/Verb,253,193,60,0.002145254874063535,0.000666414909922918,0.7628458498023716
873,1176,모/Noun,253,66,187,0.0007336104750683593,0.002076993135926428,0.7391304347826086
874,1177,프로/Noun,253,104,149,0.001155992263744081,0.001654930359641913,0.5889328063241107
875,1180,좋았고/Adjective,252,235,17,0.002612097903652491,0.00018881755781149343,0.9325396825396826
876,1181,해요/Verb,252,204,48,0.0022675232865749283,0.0005331319279383344,0.8095238095238095
877,1182,있나/Adjective,252,68,184,0.0007558410955249762,0.0020436723904302817,0.7301587301587301
878,1183,만들었다/Verb,252,170,82,0.0018896027388124407,0.0009107670435613213,0.6746031746031746
879,1184,런가/Noun,252,97,155,0.0010781850921459217,0.0017215718506342046,0.6150793650793651
880,1185,반개/Noun,251,5,246,5.557655114154236e-05,0.002732301130683964,0.9800796812749004
881,1186,하냐/Verb,251,23,228,0.00025565213525109487,0.0025323766577070887,0.9083665338645418
882,1187,짱/VerbPrefix,251,225,26,0.0025009448013694068,0.00028877979429993113,0.896414342629482
883,1188,필요없다/Adjective,251,214,37,0.0023786763888580128,0.0004109558611191328,0.852589641434263
884,1189,지루/Noun,250,21,229,0.00023342151479447792,0.0025434835728724704,0.9159999999999999
885,1190,싫다/Adjective,250,23,227,0.00025565213525109487,0.0025212697425417065,0.9079999999999999
886,1191,나왔으면/Verb,250,175,75,0.0019451792899539827,0.0008330186374036475,0.7
887,1194,그렇고/Adjective,249,80,169,0.0008892248182646778,0.0018770686629495524,0.678714859437751
888,1196,지루해/Adjective,248,18,230,0.0002000755841095525,0.002554590488037853,0.9274193548387096
889,1197,과정/Noun,248,142,106,0.0015783740524198029,0.0011773330075304884,0.5725806451612904
890,1201,용도/Noun,247,57,190,0.0006335726830135829,0.0021103138814225733,0.7692307692307693
891,1202,이런게/Adjective,247,153,94,0.0017006424649311962,0.0010440500255459052,0.6194331983805668
892,1203,만들지/Verb,246,31,215,0.00034457461707756266,0.002387986760557123,0.8739837398373984
893,1204,희망/Noun,246,210,36,0.002334215147944779,0.00039984894595375083,0.8536585365853658
894,1205,같이/Josa,246,108,138,0.001200453504657315,0.0015327542928227115,0.5609756097560976
895,1206,청춘/Noun,245,172,73,0.0019118333592690567,0.0008108048070728836,0.7020408163265306
896,1207,좋았는데/Adjective,245,74,171,0.0008225329568948269,0.0018992824932803163,0.6979591836734694
897,1208,그리/Verb,245,76,169,0.0008447635773514439,0.0018770686629495524,0.689795918367347
898,1209,......./Punctuation,245,81,164,0.0009003401284929863,0.0018215340871226425,0.6693877551020408
899,1210,다만/Noun,245,160,85,0.0017784496365293556,0.0009440877890574672,0.6530612244897959
900,1211,상상력/Noun,245,158,87,0.0017562190160727387,0.0009663016193882313,0.6448979591836734
901,1212,너무나도/Adverb,245,151,94,0.0016784118444745793,0.0010440500255459052,0.6163265306122448
902,1214,깊이/Noun,244,172,72,0.0019118333592690567,0.0007996978919075017,0.7049180327868853
903,1215,이런거/Adjective,244,85,159,0.0009448013694062199,0.0017659995112957324,0.6516393442622951
904,1216,생애/Noun,244,140,104,0.001556143431963186,0.0011551191771997243,0.5737704918032787
905,1221,cg/Alpha,243,62,181,0.0006891492341551253,0.002010351644934136,0.7448559670781894
906,1222,였는데/Verb,243,156,87,0.0017339883956161216,0.0009663016193882313,0.6419753086419753
907,1223,엇/VerbPrefix,243,144,99,0.00160060467287642,0.0010995846013728146,0.5925925925925926
908,1224,기세/Noun,242,7,235,7.78071715981593e-05,0.002610125063864762,0.9710743801652892
909,1225,없나/Adjective,242,53,189,0.000589111442100349,0.002099206966257192,0.78099173553719
910,1226,어느/Adverb,242,103,139,0.0011448769535157724,0.0015438612079880936,0.5743801652892562
911,1227,생/Noun,242,105,137,0.0011671075739723895,0.0015216473776573296,0.5661157024793388
912,1229,형님/Noun,241,155,86,0.0017228730853878133,0.0009551947042228492,0.6431535269709544
913,1230,이며/Josa,241,142,99,0.0015783740524198029,0.0010995846013728146,0.5892116182572614
914,1231,다소/Noun,241,140,101,0.001556143431963186,0.0011217984317035787,0.5809128630705395
915,1232,께/Josa,241,140,101,0.001556143431963186,0.0011217984317035787,0.5809128630705395
916,1233,재미있음/Adjective,240,217,23,0.0024120223195429388,0.0002554590488037852,0.9041666666666668
917,1234,노출/Noun,240,57,183,0.0006335726830135829,0.0020325654752649,0.7625
918,1235,카메라/Noun,240,73,167,0.0008114176466665183,0.0018548548326187888,0.6958333333333333
919,1237,미래/Noun,239,164,75,0.0018229108774425891,0.0008330186374036475,0.6861924686192469
920,1238,왠지/Adverb,239,138,101,0.0015339128115065689,0.0011217984317035787,0.5774058577405857
921,1239,비추/Verb,238,15,223,0.00016672965342462708,0.002476842081880179,0.9369747899159664
922,1240,슬프다/Adjective,238,211,27,0.002345330458173088,0.0002998867094653131,0.8865546218487395
923,1241,체/Noun,238,92,146,0.0010226085410043797,0.0016216096141457672,0.6134453781512605
924,1244,대안/Noun,237,199,38,0.002211946735433386,0.0004220627762845148,0.8396624472573839
925,1245,빼고/Verb,237,65,172,0.0007224951648400508,0.0019103894084456985,0.7257383966244726
926,1246,볼수록/Verb,237,163,74,0.001811795567214281,0.0008219117222382655,0.6877637130801688
927,1248,나를/Verb,236,188,48,0.0020896783229219927,0.0005331319279383344,0.7966101694915254
928,1249,능력/Noun,236,81,155,0.0009003401284929863,0.0017215718506342046,0.6567796610169492
929,1250,미소/Noun,235,212,23,0.002356445768401396,0.0002554590488037852,0.9021276595744679
930,1251,깊게/Adjective,235,211,24,0.002345330458173088,0.0002665659639691672,0.8978723404255319
931,1252,결론/Noun,235,63,172,0.0007002645443834338,0.0019103894084456985,0.7319148936170212
932,1253,반/Noun,235,83,152,0.0009225707489496033,0.001688251105138059,0.6468085106382979
933,1254,치/Noun,235,90,145,0.0010003779205477628,0.001610502698980385,0.6170212765957447
934,1257,버렸다/Verb,234,65,169,0.0007224951648400508,0.0018770686629495524,0.7222222222222222
935,1258,독립영화/Noun,234,75,159,0.0008336482671231353,0.0017659995112957324,0.6794871794871795
936,1259,든다/Verb,234,143,91,0.0015894893626481115,0.001010729280049759,0.6111111111111112
937,1261,보고싶은/Verb,233,209,24,0.002323099837716471,0.0002665659639691672,0.8969957081545065
938,1262,OST/Alpha,233,191,42,0.0021230242536069183,0.00046649043694604257,0.8197424892703863
939,1263,필요없는/Adjective,233,188,45,0.0020896783229219927,0.0004998111824421885,0.8068669527896996
940,1264,대단하다/Adjective,233,165,68,0.0018340261876708976,0.0007552702312459737,0.7081545064377682
941,1265,잘못/Noun,233,83,150,0.0009225707489496033,0.001666037274807295,0.6437768240343348
942,1266,봤다가/Verb,233,101,132,0.0011226463330591557,0.0014661128018304194,0.5665236051502146
943,1267,확실히/Adjective,233,132,101,0.0014672209501367186,0.0011217984317035787,0.5665236051502146
944,1269,봤었는데/Verb,232,172,60,0.0019118333592690567,0.000666414909922918,0.7413793103448276
945,1270,않게/Verb,231,171,60,0.001900718049040749,0.000666414909922918,0.7402597402597403
946,1271,있다는/Adjective,231,154,77,0.0017117577751595047,0.0008552324677344116,0.6666666666666666
947,1272,돼/Verb,231,83,148,0.0009225707489496033,0.001643823444476531,0.6406926406926406
948,1273,귀/Modifier,231,137,94,0.0015227975012782607,0.0010440500255459052,0.5930735930735931
949,1275,리얼/Noun,230,156,74,0.0017339883956161216,0.0008219117222382655,0.6782608695652174
950,1276,평생/Noun,230,147,83,0.0016339506035613453,0.0009218739587267033,0.6391304347826087
951,1277,요/Modifier,230,129,101,0.0014338750194517929,0.0011217984317035787,0.5608695652173913
952,1279,유쾌한/Adjective,229,211,18,0.002345330458173088,0.00019992447297687542,0.9213973799126638
953,1280,멋/Noun,228,174,54,0.0019340639797256738,0.0005997734189306263,0.7631578947368421
954,1281,마라/Adjective,228,55,173,0.000611342062556966,0.0019214963236110802,0.7587719298245614
955,1282,범인/Noun,228,62,166,0.0006891492341551253,0.0018437479174534066,0.7280701754385965
956,1283,웃김/Verb,228,165,63,0.0018340261876708976,0.0006997356554190639,0.7236842105263158
957,1284,없지만/Adjective,228,146,82,0.0016228352933330367,0.0009107670435613213,0.6403508771929824
958,1285,재밌습니다/Adjective,227,214,13,0.0023786763888580128,0.00014438989714996554,0.9427312775330396
959,1286,남는다/Verb,227,184,43,0.002045217082008759,0.0004775973521114245,0.8105726872246696
960,1287,되게/Adverb,227,149,78,0.0016561812240179624,0.0008663393828997934,0.6563876651982379
961,1288,어린이/Noun,227,87,140,0.0009670319898628369,0.0015549681231534756,0.6167400881057269
962,1291,박수/Noun,226,151,75,0.0016784118444745793,0.0008330186374036475,0.668141592920354
963,1292,나와/Verb,226,85,141,0.0009448013694062199,0.0015660750383188573,0.6238938053097345
964,1293,고민/Noun,226,128,98,0.0014227597092234846,0.001088477686207433,0.5663716814159292
965,1294,얼/Noun,226,99,127,0.0011004157126025386,0.0014105782260035095,0.5619469026548672
966,1296,손발/Noun,225,22,203,0.00024453682502278637,0.002254703778572539,0.9022222222222224
967,1297,그래/Adjective,225,82,143,0.0009114554387212947,0.0015882888686496212,0.6355555555555555
968,1298,고생/Noun,225,87,138,0.0009670319898628369,0.0015327542928227115,0.6133333333333333
969,1299,재밌었는데/Adjective,224,159,65,0.0017673343263010473,0.0007219494857498278,0.7098214285714286
970,1302,재밌었음/Adjective,223,213,10,0.0023675610786297045,0.00011106915165381967,0.9551569506726456
971,1303,굳이/Noun,223,45,178,0.0005001889602738814,0.0019770308994379896,0.7982062780269058
972,1304,부족한/Adjective,223,69,154,0.0007669564057532844,0.0017104649354688231,0.6905829596412556
973,1305,로맨틱/Noun,223,141,82,0.0015672587421914947,0.0009107670435613213,0.6322869955156951
974,1311,밤/Noun,222,158,64,0.0017562190160727387,0.0007108425705844457,0.7117117117117117
975,1312,어이없는/Adjective,221,8,213,8.892248182646779e-05,0.002365772930226359,0.9638009049773756
976,1313,메디/Verb,221,96,125,0.0010670697819176133,0.001388364395672746,0.5656108597285068
977,1316,별루/Noun,220,12,208,0.00013338372273970166,0.0023102383543994486,0.9454545454545454
978,1317,슬픔/Noun,220,192,28,0.0021341395638352265,0.000310993624630695,0.8727272727272727
979,1318,보여준/Verb,220,166,54,0.0018451414978992067,0.0005997734189306263,0.7545454545454545
980,1319,용이/Noun,220,69,151,0.0007669564057532844,0.001677144189972677,0.6863636363636364
981,1320,차/Noun,220,84,136,0.0009336860591779117,0.0015105404624919474,0.6181818181818182
982,1321,스/Noun,220,131,89,0.0014561056399084098,0.0009885154497189948,0.5954545454545455
983,1322,저렇게/Adverb,220,91,129,0.001011493230776071,0.0014327920563342734,0.5863636363636363
984,1323,포장/Noun,219,20,199,0.00022230620456616945,0.0022102761179110114,0.9086757990867579
985,1324,있습니다/Adjective,219,181,38,0.0020118711513238334,0.0004220627762845148,0.8264840182648402
986,1325,주기/Noun,219,40,179,0.0004446124091323389,0.001988137814603372,0.817351598173516
987,1326,스럽다/Adjective,219,51,168,0.0005668808216437321,0.0018659617477841703,0.7671232876712328
988,1327,시도/Noun,219,57,162,0.0006335726830135829,0.0017993202567918784,0.7397260273972602
989,1328,ㅅㅂ/KoreanParticle,218,20,198,0.00022230620456616945,0.0021991692027456293,0.908256880733945
990,1329,순수한/Adjective,218,193,25,0.002145254874063535,0.0002776728791345492,0.8853211009174312
991,1330,있었던/Adjective,218,165,53,0.0018340261876708976,0.0005886665037652442,0.7568807339449541
992,1331,아침/Noun,218,56,162,0.0006224573727852744,0.0017993202567918784,0.7431192660550459
993,1332,인기/Noun,218,90,128,0.0010003779205477628,0.0014216851411688915,0.5871559633027523
994,1334,재밌네/Adjective,217,204,13,0.0022675232865749283,0.00014438989714996554,0.9400921658986175
995,1335,있다면/Adjective,217,139,78,0.0015450281217348775,0.0008663393828997934,0.6405529953917051
996,1336,함/Verb,217,78,139,0.0008669941978080608,0.0015438612079880936,0.6405529953917051
997,1337,봅니다/Verb,217,133,84,0.0014783362603650269,0.0009329808738920851,0.6129032258064516
998,1338,줌/Noun,217,87,130,0.0009670319898628369,0.0014438989714996556,0.5990783410138248
999,1339,덕분/Noun,217,122,95,0.0013560678478536335,0.0010551569407112867,0.5622119815668203
1000,1342,귀여운/Adjective,216,173,43,0.0019229486694973656,0.0004775973521114245,0.8009259259259259
1001,1343,광고/Noun,216,47,169,0.0005224195807304982,0.0018770686629495524,0.7824074074074074
1002,1344,그럼/Adjective,216,69,147,0.0007669564057532844,0.0016327165293111491,0.6805555555555556
1003,1345,할까/Verb,216,95,121,0.0010559544716893046,0.001343936735011218,0.5601851851851852
1004,1347,재밌/Adjective,215,184,31,0.002045217082008759,0.00034431437012684104,0.8558139534883721
1005,1348,어색한/Adjective,215,32,183,0.00035568992730587116,0.0020325654752649,0.8511627906976744
1006,1349,짱/Modifier,215,181,34,0.0020118711513238334,0.00037763511562298685,0.8418604651162791
1007,1350,진실/Noun,215,142,73,0.0015783740524198029,0.0008108048070728836,0.6604651162790698
1008,1351,해라/Verb,215,81,134,0.0009003401284929863,0.0014883266321611835,0.6232558139534884
1009,1355,암/Noun,214,59,155,0.0006558033034701999,0.0017215718506342046,0.7242990654205608
1010,1356,흐름/Noun,214,83,131,0.0009225707489496033,0.0014550058866650375,0.6121495327102804
1011,1359,됩니다/Verb,213,150,63,0.0016672965342462707,0.0006997356554190639,0.7042253521126759
1012,1360,같고/Adjective,213,84,129,0.0009336860591779117,0.0014327920563342734,0.6056338028169014
1013,1361,젤/Noun,213,123,90,0.001367183158081942,0.000999622364884377,0.5774647887323944
1014,1363,성도/Noun,212,25,187,0.0002778827557077118,0.002076993135926428,0.8820754716981132
1015,1364,한계/Noun,212,38,174,0.000422381788675722,0.0019326032387764625,0.8207547169811321
1016,1365,그럭저럭/Adverb,212,52,160,0.0005779961318720405,0.0017771064264611148,0.7547169811320755
1017,1366,아닌듯/Adjective,212,52,160,0.0005779961318720405,0.0017771064264611148,0.7547169811320755
1018,1367,전/Foreign,212,157,55,0.00174510370584443,0.0006108803340960082,0.7405660377358491
1019,1368,조차/Josa,212,56,156,0.0006224573727852744,0.0017326787657995868,0.7358490566037735
1020,1369,심/Noun,212,73,139,0.0008114176466665183,0.0015438612079880936,0.6556603773584906
1021,1370,써/Verb,212,79,133,0.0008781095080363692,0.0014772197169958016,0.6273584905660378
1022,1371,사이/Noun,212,119,93,0.0013227219171687082,0.001032943110380523,0.5613207547169812
1023,1373,~^^/Punctuation,211,202,9,0.0022452926661183114,9.996223648843771e-05,0.957345971563981
1024,1374,귀엽고/Adjective,211,194,17,0.0021563701842918434,0.00018881755781149343,0.919431279620853
1025,1375,여전히/Adjective,211,153,58,0.0017006424649311962,0.0006442010795921541,0.7251184834123223
1026,1376,느껴지는/Verb,211,152,59,0.0016895271547028878,0.000655307994757536,0.7203791469194313
1027,1377,독특한/Adjective,211,151,60,0.0016784118444745793,0.000666414909922918,0.7156398104265402
1028,1378,진정/Noun,211,146,65,0.0016228352933330367,0.0007219494857498278,0.6919431279620853
1029,1379,..?/Punctuation,211,82,129,0.0009114554387212947,0.0014327920563342734,0.6113744075829384
1030,1382,아름답고/Adjective,210,198,12,0.002200831425205077,0.0001332829819845836,0.9428571428571428
1031,1383,만들어진/Verb,210,148,62,0.0016450659137896538,0.0006886287402536821,0.7047619047619048
1032,1384,살짝/Noun,210,140,70,0.001556143431963186,0.0007774840615767378,0.6666666666666666
1033,1385,있지/Adjective,210,72,138,0.00080030233643821,0.0015327542928227115,0.6571428571428571
1034,1388,발견/Noun,209,175,34,0.0019451792899539827,0.00037763511562298685,0.8373205741626795
1035,1389,리뷰/Noun,209,80,129,0.0008892248182646778,0.0014327920563342734,0.6172248803827751
1036,1394,재미없네/Adjective,208,2,206,2.2230620456616947e-05,0.002288024524068685,0.9903846153846154
1037,1395,짜증나는/Adjective,208,9,199,0.00010003779205477625,0.0022102761179110114,0.9567307692307692
1038,1396,개도/Noun,208,25,183,0.0002778827557077118,0.0020325654752649,0.8798076923076923
1039,1397,않을/Verb,208,152,56,0.0016895271547028878,0.0006219872492613901,0.7307692307692307
1040,1398,쩐다/Noun,208,145,63,0.0016117199831047284,0.0006997356554190639,0.6971153846153846
1041,1399,범죄/Noun,208,72,136,0.00080030233643821,0.0015105404624919474,0.6538461538461539
1042,1400,뜻/Noun,208,122,86,0.0013560678478536335,0.0009551947042228492,0.5865384615384616
1043,1402,짱짱/Noun,207,199,8,0.002211946735433386,8.885532132305573e-05,0.961352657004831
1044,1403,부족/Noun,207,29,178,0.0003223439966209457,0.0019770308994379896,0.8599033816425121
1045,1404,지난/Noun,207,159,48,0.0017673343263010473,0.0005331319279383344,0.7681159420289855
1046,1405,있네/Adjective,207,53,154,0.000589111442100349,0.0017104649354688231,0.7439613526570048
1047,1406,20년/Number,207,142,65,0.0015783740524198029,0.0007219494857498278,0.6859903381642513
1048,1407,야/Exclamation,207,66,141,0.0007336104750683593,0.0015660750383188573,0.6811594202898551
1049,1408,받고/Verb,207,76,131,0.0008447635773514439,0.0014550058866650375,0.6328502415458938
1050,1409,오락/Noun,207,125,82,0.001389413778538559,0.0009107670435613213,0.6038647342995169
1051,1410,와는/Josa,207,118,89,0.0013116066069403995,0.0009885154497189948,0.5700483091787439
1052,1411,대충/Noun,206,37,169,0.00041126647844741344,0.0018770686629495524,0.8203883495145631
1053,1412,영환/Noun,206,64,142,0.0007113798546117423,0.0015771819534842392,0.6893203883495146
1054,1413,~~~~/Punctuation,206,123,83,0.001367183158081942,0.0009218739587267033,0.5970873786407767
1055,1414,로서/Noun,206,116,90,0.0012893759864837828,0.000999622364884377,0.5631067961165048
1056,1418,감탄/Noun,205,177,28,0.0019674099104106,0.000310993624630695,0.8634146341463415
1057,1419,잼있게/Verb,205,174,31,0.0019340639797256738,0.00034431437012684104,0.8487804878048779
1058,1420,빨/Noun,205,54,151,0.0006002267523286575,0.001677144189972677,0.7365853658536585
1059,1421,자연/Noun,205,142,63,0.0015783740524198029,0.0006997356554190639,0.6926829268292682
1060,1422,커플/Noun,205,141,64,0.0015672587421914947,0.0007108425705844457,0.6878048780487804
1061,1423,시선/Noun,205,141,64,0.0015672587421914947,0.0007108425705844457,0.6878048780487804
1062,1424,정서/Noun,205,76,129,0.0008447635773514439,0.0014327920563342734,0.6292682926829268
1063,1425,정말로/Adverb,205,125,80,0.001389413778538559,0.0008885532132305574,0.6097560975609756
1064,1428,시청자/Noun,204,41,163,0.00045572771936064734,0.001810427171957261,0.7990196078431373
1065,1429,홍보/Noun,204,43,161,0.00047795833981726434,0.001788213341626497,0.7892156862745098
1066,1430,쓰/Verb,204,46,158,0.0005113042705021896,0.0017548925961303507,0.7745098039215687
1067,1431,하세요/Verb,204,65,139,0.0007224951648400508,0.0015438612079880936,0.6813725490196079
1068,1432,몸매/Noun,204,67,137,0.0007447257852966678,0.0015216473776573296,0.6715686274509803
1069,1435,아오/Exclamation,203,29,174,0.0003223439966209457,0.0019326032387764625,0.8571428571428571
1070,1436,되네요/Verb,203,150,53,0.0016672965342462707,0.0005886665037652442,0.7389162561576355
1071,1441,했어요/Verb,201,156,45,0.0017339883956161216,0.0004998111824421885,0.7761194029850746
1072,1442,일상/Noun,201,154,47,0.0017117577751595047,0.0005220250127729526,0.7661691542288557
1073,1443,않나/Verb,201,54,147,0.0006002267523286575,0.0016327165293111491,0.7313432835820896
1074,1444,포기/Noun,201,56,145,0.0006224573727852744,0.001610502698980385,0.7213930348258707
1075,1445,사는/Verb,201,132,69,0.0014672209501367186,0.0007663771464113557,0.6567164179104478
1076,1446,코드/Noun,201,76,125,0.0008447635773514439,0.001388364395672746,0.6218905472636815
1077,1447,첨/Noun,201,77,124,0.0008558788875797522,0.0013772574805073642,0.6169154228855721
1078,1448,없는데/Adjective,201,78,123,0.0008669941978080608,0.001366150565341982,0.6119402985074627
1079,1449,나서/Verb,201,86,115,0.0009559166796345287,0.0012772952440189265,0.572139303482587
1080,1450,들이/Verb,201,88,113,0.0009781473000911457,0.0012550814136881624,0.5621890547263682
1081,1451,떨어지는/Verb,200,34,166,0.0003779205477624881,0.0018437479174534066,0.83
1082,1452,하다가/Verb,200,61,139,0.0006780339239268168,0.0015438612079880936,0.695
1083,1453,30분/Number,199,51,148,0.0005668808216437321,0.001643823444476531,0.7437185929648241
1084,1454,에서의/Josa,199,143,56,0.0015894893626481115,0.0006219872492613901,0.7185929648241206
1085,1455,일이/Noun,199,115,84,0.0012782606762554744,0.0009329808738920851,0.5778894472361809
1086,1456,용서/Noun,199,85,114,0.0009448013694062199,0.001266188328853544,0.5728643216080402
1087,1457,이따위/Modifier,198,8,190,8.892248182646779e-05,0.0021103138814225733,0.9595959595959596
1088,1458,낮아서/Adjective,198,179,19,0.0019896405308672165,0.00021103138814225735,0.904040404040404
1089,1459,눈빛/Noun,198,175,23,0.0019451792899539827,0.0002554590488037852,0.8838383838383839
1090,1460,10분/Number,198,36,162,0.000400151168219105,0.0017993202567918784,0.8181818181818182
1091,1461,보라/Noun,198,64,134,0.0007113798546117423,0.0014883266321611835,0.6767676767676768
1092,1462,끼리/Noun,198,71,127,0.0007891870262099014,0.0014105782260035095,0.6414141414141414
1093,1463,사극/Noun,198,123,75,0.001367183158081942,0.0008330186374036475,0.6212121212121212
1094,1466,말로/Noun,197,140,57,0.001556143431963186,0.0006330941644267722,0.7106598984771574
1095,1468,뜬금/Noun,196,17,179,0.00018896027388124405,0.001988137814603372,0.9132653061224488
1096,1469,핵/Noun,196,37,159,0.00041126647844741344,0.0017659995112957324,0.8112244897959183
1097,1470,보긴/Verb,196,49,147,0.0005446502011871152,0.0016327165293111491,0.75
1098,1471,상처/Noun,196,143,53,0.0015894893626481115,0.0005886665037652442,0.7295918367346939
1099,1472,풀어/Verb,196,137,59,0.0015227975012782607,0.000655307994757536,0.6989795918367347
1100,1473,가진/Verb,196,131,65,0.0014561056399084098,0.0007219494857498278,0.6683673469387755
1101,1474,웃겨/Verb,196,128,68,0.0014227597092234846,0.0007552702312459737,0.6530612244897959
1102,1475,실감/Noun,196,128,68,0.0014227597092234846,0.0007552702312459737,0.6530612244897959
1103,1476,괴물/Noun,196,81,115,0.0009003401284929863,0.0012772952440189265,0.5867346938775511
1104,1481,지루해서/Adjective,195,11,184,0.00012226841251139318,0.0020436723904302817,0.9435897435897436
1105,1482,끌/Noun,195,22,173,0.00024453682502278637,0.0019214963236110802,0.8871794871794871
1106,1483,힐링/Noun,195,171,24,0.001900718049040749,0.0002665659639691672,0.8769230769230769
1107,1484,혹시/Noun,195,48,147,0.0005335348909588066,0.0016327165293111491,0.7538461538461538
1108,1485,신선한/Adjective,195,145,50,0.0016117199831047284,0.0005553457582690984,0.7435897435897436
1109,1486,막판/Noun,195,58,137,0.0006446879932418914,0.0015216473776573296,0.7025641025641025
1110,1487,빛/Noun,195,127,68,0.001411644398995176,0.0007552702312459737,0.6512820512820513
1111,1488,먼/Adjective,195,72,123,0.00080030233643821,0.001366150565341982,0.6307692307692307
1112,1489,몰라도/Verb,195,81,114,0.0009003401284929863,0.001266188328853544,0.5846153846153846
1113,1492,아깝지/Adjective,194,160,34,0.0017784496365293556,0.00037763511562298685,0.8247422680412371
1114,1493,우정/Noun,194,143,51,0.0015894893626481115,0.0005664526734344802,0.7371134020618557
1115,1494,해피엔딩/Noun,194,138,56,0.0015339128115065689,0.0006219872492613901,0.711340206185567
1116,1495,죄/Noun,194,67,127,0.0007447257852966678,0.0014105782260035095,0.6546391752577321
1117,1496,하루/Noun,194,110,84,0.001222684125113932,0.0009329808738920851,0.5670103092783505
1118,1497,표/Noun,194,109,85,0.0012115688148856235,0.0009440877890574672,0.5618556701030928
1119,1501,슬프고/Adjective,193,182,11,0.002022986461552142,0.00012217606681920164,0.9430051813471504
1120,1502,아름답다/Adjective,193,177,16,0.0019674099104106,0.00017771064264611146,0.917098445595855
1121,1503,으론/Josa,193,112,81,0.0012449147455705488,0.0008996601283959392,0.5803108808290155
1122,1504,남녀/Noun,193,111,82,0.0012337994353422404,0.0009107670435613213,0.5751295336787565
1123,1505,정치/Noun,193,109,84,0.0012115688148856235,0.0009329808738920851,0.5647668393782384
1124,1507,버리고/Verb,192,47,145,0.0005224195807304982,0.001610502698980385,0.7552083333333334
1125,1508,했습니다/Verb,192,132,60,0.0014672209501367186,0.000666414909922918,0.6875
1126,1510,있네요/Adjective,191,150,41,0.0016672965342462707,0.00045538352178066063,0.7853403141361257
1127,1511,가볍게/Adjective,191,141,50,0.0015672587421914947,0.0005553457582690984,0.7382198952879581
1128,1512,보아/Noun,191,134,57,0.001489451570593335,0.0006330941644267722,0.7015706806282722
1129,1513,게다가/Noun,191,58,133,0.0006446879932418914,0.0014772197169958016,0.6963350785340314
1130,1514,만큼/Noun,191,115,76,0.0012782606762554744,0.0008441255525690295,0.6020942408376964
1131,1515,어제/Noun,191,112,79,0.0012449147455705488,0.0008774462980651753,0.5863874345549738
1132,1516,개판/Noun,190,8,182,8.892248182646779e-05,0.002021458560099518,0.9578947368421052
1133,1517,뭐임/Noun,190,15,175,0.00016672965342462708,0.0019437101539418445,0.9210526315789472
1134,1518,있어요/Adjective,190,170,20,0.0018896027388124407,0.00022213830330763932,0.8947368421052632
1135,1519,좋습니다/Adjective,190,169,21,0.001878487428584132,0.00023324521847302128,0.8894736842105263
1136,1520,나머지/Noun,190,38,152,0.000422381788675722,0.001688251105138059,0.8
1137,1521,벌써/Noun,190,146,44,0.0016228352933330367,0.0004887042672768067,0.7684210526315789
1138,1522,조폭/Noun,190,58,132,0.0006446879932418914,0.0014661128018304194,0.6947368421052632
1139,1523,많다/Adjective,190,61,129,0.0006780339239268168,0.0014327920563342734,0.6789473684210526
1140,1524,간/Noun,190,72,118,0.00080030233643821,0.001310615989515072,0.6210526315789474
1141,1525,이기/Noun,190,114,76,0.0012671453660271655,0.0008441255525690295,0.6
1142,1526,만으로/Josa,190,112,78,0.0012449147455705488,0.0008663393828997934,0.5894736842105263
1143,1528,재미있네요/Adjective,189,181,8,0.0020118711513238334,8.885532132305573e-05,0.9576719576719576
1144,1529,소장/Noun,189,173,16,0.0019229486694973656,0.00017771064264611146,0.9153439153439152
1145,1530,서야/Verb,189,154,35,0.0017117577751595047,0.0003887420307883688,0.8148148148148148
1146,1531,비극/Noun,189,143,46,0.0015894893626481115,0.0005109180976075704,0.7566137566137566
1147,1532,까지는/Josa,189,51,138,0.0005668808216437321,0.0015327542928227115,0.7301587301587301
1148,1533,주/Noun,189,73,116,0.0008114176466665183,0.0012884021591843082,0.6137566137566137
1149,1537,짜증나/Adjective,188,9,179,0.00010003779205477625,0.001988137814603372,0.952127659574468
1150,1538,이쁘고/Adjective,188,157,31,0.00174510370584443,0.00034431437012684104,0.8351063829787234
1151,1539,섹스/Noun,188,51,137,0.0005668808216437321,0.0015216473776573296,0.7287234042553191
1152,1540,만들고/Verb,188,53,135,0.000589111442100349,0.0014994335473265655,0.7180851063829787
1153,1541,등장인물/Noun,188,69,119,0.0007669564057532844,0.0013217229046804538,0.6329787234042553
1154,1544,형편/Noun,187,18,169,0.0002000755841095525,0.0018770686629495524,0.9037433155080212
1155,1545,본방/Noun,187,166,21,0.0018451414978992067,0.00023324521847302128,0.8877005347593583
1156,1546,감명/Noun,187,164,23,0.0018229108774425891,0.0002554590488037852,0.8770053475935828
1157,1547,하다니/Verb,187,53,134,0.000589111442100349,0.0014883266321611835,0.7165775401069518
1158,1548,뮤지컬/Noun,187,117,70,0.0013004912967120913,0.0007774840615767378,0.6256684491978609
1159,1549,올해/Noun,187,111,76,0.0012337994353422404,0.0008441255525690295,0.5935828877005348
1160,1551,펑펑/Noun,186,179,7,0.0019896405308672165,7.774840615767377e-05,0.9623655913978496
1161,1552,예쁜/Adjective,186,129,57,0.0014338750194517929,0.0006330941644267722,0.6935483870967742
1162,1553,의문/Noun,186,67,119,0.0007447257852966678,0.0013217229046804538,0.6397849462365591
1163,1554,이연걸/Noun,186,117,69,0.0013004912967120913,0.0007663771464113557,0.6290322580645161
1164,1555,국민/Noun,186,106,80,0.001178222884200698,0.0008885532132305574,0.5698924731182796
1165,1556,둘다/Verb,186,105,81,0.0011671075739723895,0.0008996601283959392,0.5645161290322581
1166,1561,그다지/Noun,185,18,167,0.0002000755841095525,0.0018548548326187888,0.9027027027027028
1167,1562,빼고는/Verb,185,41,144,0.00045572771936064734,0.0015993957838150033,0.7783783783783784
1168,1563,토/Noun,185,44,141,0.0004890736500455726,0.0015660750383188573,0.7621621621621621
1169,1564,인가요/Josa,185,57,128,0.0006335726830135829,0.0014216851411688915,0.6918918918918919
1170,1565,결과/Noun,185,64,121,0.0007113798546117423,0.001343936735011218,0.6540540540540539
1171,1566,쉽게/Verb,185,81,104,0.0009003401284929863,0.0011551191771997243,0.5621621621621622
1172,1567,넘치는/Adjective,184,148,36,0.0016450659137896538,0.00039984894595375083,0.8043478260869565
1173,1568,불가/Noun,184,41,143,0.00045572771936064734,0.0015882888686496212,0.7771739130434783
1174,1569,죽는줄/Verb,184,48,136,0.0005335348909588066,0.0015105404624919474,0.7391304347826086
1175,1570,자유/Noun,184,128,56,0.0014227597092234846,0.0006219872492613901,0.6956521739130435
1176,1571,암튼/Adverb,184,123,61,0.001367183158081942,0.0006775218250882999,0.6684782608695652
1177,1572,새벽/Noun,184,122,62,0.0013560678478536335,0.0006886287402536821,0.6630434782608695
1178,1574,꼴/Noun,183,23,160,0.00025565213525109487,0.0017771064264611148,0.8743169398907104
1179,1575,표절/Noun,183,24,159,0.0002667674454794033,0.0017659995112957324,0.8688524590163934
1180,1576,아픈/Adjective,183,153,30,0.0017006424649311962,0.000333207454961459,0.8360655737704918
1181,1577,행복/Noun,183,153,30,0.0017006424649311962,0.000333207454961459,0.8360655737704918
1182,1578,지도/Noun,183,60,123,0.0006669186136985082,0.001366150565341982,0.6721311475409836
1183,1579,느와르/Noun,183,123,60,0.001367183158081942,0.000666414909922918,0.6721311475409836
1184,1580,않/Verb,183,67,116,0.0007447257852966678,0.0012884021591843082,0.6338797814207651
1185,1581,기적/Noun,183,104,79,0.001155992263744081,0.0008774462980651753,0.5683060109289617
1186,1582,글쎄/Noun,182,21,161,0.00023342151479447792,0.001788213341626497,0.8846153846153846
1187,1583,기본/Noun,182,50,132,0.0005557655114154236,0.0014661128018304194,0.7252747252747253
1188,1584,오버/Noun,182,51,131,0.0005668808216437321,0.0014550058866650375,0.7197802197802198
1189,1585,차이/Noun,182,68,114,0.0007558410955249762,0.001266188328853544,0.6263736263736264
1190,1590,에만/Josa,181,44,137,0.0004890736500455726,0.0015216473776573296,0.7569060773480663
1191,1591,보인다/Verb,181,58,123,0.0006446879932418914,0.001366150565341982,0.6795580110497238
1192,1592,에게는/Josa,181,120,61,0.0013338372273970164,0.0006775218250882999,0.6629834254143646
1193,1593,따위/Noun,181,63,118,0.0007002645443834338,0.001310615989515072,0.6519337016574586
1194,1594,가면/Noun,181,65,116,0.0007224951648400508,0.0012884021591843082,0.6408839779005525
1195,1599,멋지다/Adjective,180,171,9,0.001900718049040749,9.996223648843771e-05,0.95
1196,1600,쓰래/Noun,180,10,170,0.00011115310228308472,0.0018881755781149344,0.9444444444444444
1197,1601,까진/Josa,180,62,118,0.0006891492341551253,0.001310615989515072,0.6555555555555556
1198,1602,악당/Noun,180,65,115,0.0007224951648400508,0.0012772952440189265,0.6388888888888888
1199,1603,드럽게/Adjective,179,7,172,7.78071715981593e-05,0.0019103894084456985,0.9608938547486032
1200,1604,보지마/Verb,179,13,166,0.00014449903296801013,0.0018437479174534066,0.9273743016759776
1201,1605,뻔하고/Adjective,179,18,161,0.0002000755841095525,0.001788213341626497,0.8994413407821229
1202,1606,높다/Adjective,179,20,159,0.00022230620456616945,0.0017659995112957324,0.888268156424581
1203,1607,않지만/Verb,179,133,46,0.0014783362603650269,0.0005109180976075704,0.7430167597765364
1204,1608,갑니다/Verb,179,119,60,0.0013227219171687082,0.000666414909922918,0.6648044692737429
1205,1609,모/Modifier,179,67,112,0.0007447257852966678,0.0012439744985227805,0.6256983240223464
1206,1616,그렇다고/Conjunction,178,34,144,0.0003779205477624881,0.0015993957838150033,0.8089887640449438
1207,1617,모르게/Verb,178,134,44,0.001489451570593335,0.0004887042672768067,0.7528089887640449
1208,1618,그걸/Adverb,178,70,108,0.000778071715981593,0.0011995468378612525,0.6067415730337079
1209,1619,기술/Noun,178,72,106,0.00080030233643821,0.0011773330075304884,0.5955056179775281
1210,1620,새/Modifier,178,74,104,0.0008225329568948269,0.0011551191771997243,0.5842696629213483
1211,1621,무시/Noun,178,74,104,0.0008225329568948269,0.0011551191771997243,0.5842696629213483
1212,1622,잊혀지지/Verb,177,165,12,0.0018340261876708976,0.0001332829819845836,0.9322033898305084
1213,1623,이제야/Noun,177,157,20,0.00174510370584443,0.00022213830330763932,0.8870056497175142
1214,1624,반복/Noun,177,68,109,0.0007558410955249762,0.0012106537530266347,0.615819209039548
1215,1625,공/Modifier,177,70,107,0.000778071715981593,0.0011884399226958706,0.6045197740112994
1216,1626,나오면/Verb,177,76,101,0.0008447635773514439,0.0011217984317035787,0.5706214689265536
1217,1630,긴장/Noun,176,134,42,0.001489451570593335,0.00046649043694604257,0.7613636363636364
1218,1631,게이/Noun,176,47,129,0.0005224195807304982,0.0014327920563342734,0.7329545454545454
1219,1632,어쩔/Adverb,176,57,119,0.0006335726830135829,0.0013217229046804538,0.6761363636363636
1220,1633,외국/Noun,176,57,119,0.0006335726830135829,0.0013217229046804538,0.6761363636363636
1221,1636,재미있었다/Adjective,175,158,17,0.0017562190160727387,0.00018881755781149343,0.9028571428571428
1222,1637,좋겠어요/Adjective,175,142,33,0.0015783740524198029,0.00036652820045760486,0.8114285714285714
1223,1638,언제나/Adverb,175,128,47,0.0014227597092234846,0.0005220250127729526,0.7314285714285714
1224,1639,쓰고/Verb,175,50,125,0.0005557655114154236,0.001388364395672746,0.7142857142857143
1225,1640,북한/Noun,175,65,110,0.0007224951648400508,0.0012217606681920164,0.6285714285714286
1226,1641,과는/Josa,175,101,74,0.0011226463330591557,0.0008219117222382655,0.5771428571428572
1227,1644,열정/Noun,174,148,26,0.0016450659137896538,0.00028877979429993113,0.8505747126436781
1228,1647,아픔/Noun,173,146,27,0.0016228352933330367,0.0002998867094653131,0.8439306358381503
1229,1648,창/Noun,173,31,142,0.00034457461707756266,0.0015771819534842392,0.8208092485549133
1230,1649,하려는/Verb,173,43,130,0.00047795833981726434,0.0014438989714996556,0.7514450867052023
1231,1650,선생님/Noun,173,129,44,0.0014338750194517929,0.0004887042672768067,0.7456647398843931
1232,1651,병/Noun,173,51,122,0.0005668808216437321,0.0013550436501765998,0.7052023121387283
1233,1652,쇼/Noun,173,55,118,0.000611342062556966,0.001310615989515072,0.6820809248554913
1234,1655,짝/Noun,172,34,138,0.0003779205477624881,0.0015327542928227115,0.8023255813953488
1235,1656,양/Modifier,172,52,120,0.0005779961318720405,0.001332829819845836,0.6976744186046512
1236,1657,디즈니/Noun,172,114,58,0.0012671453660271655,0.0006442010795921541,0.6627906976744186
1237,1658,보길/Verb,172,108,64,0.001200453504657315,0.0007108425705844457,0.627906976744186
1238,1659,늘/Noun,172,101,71,0.0011226463330591557,0.0007885909767421196,0.5872093023255814
1239,1664,재미있었어요/Adjective,171,171,0,0.001900718049040749,0.0,1.0
1240,1665,질리/Noun,171,160,11,0.0017784496365293556,0.00012217606681920164,0.935672514619883
1241,1666,쩝/Adverb,171,28,143,0.0003112286863926372,0.0015882888686496212,0.8362573099415205
1242,1667,극치/Noun,171,28,143,0.0003112286863926372,0.0015882888686496212,0.8362573099415205
1243,1668,까지도/Josa,171,135,36,0.0015005668808216438,0.00039984894595375083,0.7894736842105263
1244,1669,밥/Noun,171,47,124,0.0005224195807304982,0.0013772574805073642,0.7251461988304093
1245,1670,좋/Adjective,171,121,50,0.001344952537625325,0.0005553457582690984,0.7076023391812866
1246,1671,걸까/Verb,171,52,119,0.0005779961318720405,0.0013217229046804538,0.6959064327485379
1247,1672,희생/Noun,171,112,59,0.0012449147455705488,0.000655307994757536,0.6549707602339181
1248,1675,무섭지도/Adjective,170,5,165,5.557655114154236e-05,0.0018326410022880247,0.9705882352941176
1249,1676,주기도/Noun,170,6,164,6.669186136985083e-05,0.0018215340871226425,0.9647058823529412
1250,1677,노답/Noun,170,14,156,0.0001556143431963186,0.0017326787657995868,0.9176470588235294
1251,1678,이었습니다/Verb,170,144,26,0.00160060467287642,0.00028877979429993113,0.8470588235294118
1252,1679,남편/Noun,170,55,115,0.000611342062556966,0.0012772952440189265,0.6764705882352942
1253,1680,한다고/Verb,170,61,109,0.0006780339239268168,0.0012106537530266347,0.6411764705882353
1254,1681,분노/Noun,170,67,103,0.0007447257852966678,0.0011440122620343426,0.6058823529411764
1255,1685,가는줄/Verb,169,165,4,0.0018340261876708976,4.4427660661527865e-05,0.9763313609467456
1256,1686,죄다/Adverb,169,19,150,0.00021119089433786097,0.001666037274807295,0.8875739644970414
1257,1687,싸구려/Noun,169,21,148,0.00023342151479447792,0.001643823444476531,0.8757396449704142
1258,1688,할말이/Verb,169,28,141,0.0003112286863926372,0.0015660750383188573,0.8343195266272192
1259,1689,에로/Josa,169,39,130,0.0004334970989040304,0.0014438989714996556,0.7692307692307693
1260,1690,마저/Josa,169,51,118,0.0005668808216437321,0.001310615989515072,0.6982248520710059
1261,1691,헐리우드/Noun,169,52,117,0.0005779961318720405,0.0012995090743496902,0.6923076923076923
1262,1692,되서/Verb,169,109,60,0.0012115688148856235,0.000666414909922918,0.6449704142011834
1263,1693,작은/Adjective,169,106,63,0.001178222884200698,0.0006997356554190639,0.6272189349112426
1264,1694,춤/Noun,169,96,73,0.0010670697819176133,0.0008108048070728836,0.5680473372781065
1265,1696,짜증난다/Adjective,168,6,162,6.669186136985083e-05,0.0017993202567918784,0.9642857142857144
1266,1697,어머니/Noun,168,123,45,0.001367183158081942,0.0004998111824421885,0.7321428571428571
1267,1698,=/Punctuation,168,55,113,0.000611342062556966,0.0012550814136881624,0.6726190476190477
1268,1699,청소년/Noun,168,62,106,0.0006891492341551253,0.0011773330075304884,0.6309523809523809
1269,1700,시각/Noun,168,102,66,0.0011337616432874642,0.0007330564009152097,0.6071428571428571
1270,1705,제로/Noun,167,16,151,0.00017784496365293558,0.001677144189972677,0.9041916167664672
1271,1706,유발/Noun,167,21,146,0.00023342151479447792,0.0016216096141457672,0.8742514970059879
1272,1707,보지마라/Verb,167,21,146,0.00023342151479447792,0.0016216096141457672,0.8742514970059879
1273,1708,딱히/Adjective,167,27,140,0.0003001133761643288,0.0015549681231534756,0.8383233532934131
1274,1709,필름/Noun,167,34,133,0.0003779205477624881,0.0014772197169958016,0.7964071856287425
1275,1710,조절/Noun,167,40,127,0.0004446124091323389,0.0014105782260035095,0.7604790419161677
1276,1711,본인/Noun,167,56,111,0.0006224573727852744,0.0012328675833573985,0.6646706586826348
1277,1712,_/Punctuation,167,106,61,0.001178222884200698,0.0006775218250882999,0.6347305389221557
1278,1713,떠나서/Verb,167,63,104,0.0007002645443834338,0.0011551191771997243,0.6227544910179641
1279,1714,싸움/Noun,167,66,101,0.0007336104750683593,0.0011217984317035787,0.6047904191616766
1280,1715,가고/Verb,167,70,97,0.000778071715981593,0.0010773707710420508,0.5808383233532934
1281,1716,이미지/Noun,167,71,96,0.0007891870262099014,0.0010662638558766688,0.5748502994011976
1282,1717,이나/Noun,167,72,95,0.00080030233643821,0.0010551569407112867,0.5688622754491018
1283,1720,재미없어요/Adjective,166,2,164,2.2230620456616947e-05,0.0018215340871226425,0.9879518072289156
1284,1721,사랑스러운/Adjective,166,162,4,0.0018006802569859727,4.4427660661527865e-05,0.9759036144578314
1285,1722,꺼/Verb,166,12,154,0.00013338372273970166,0.0017104649354688231,0.927710843373494
1286,1723,미드/Noun,166,111,55,0.0012337994353422404,0.0006108803340960082,0.6686746987951807
1287,1724,실력/Noun,166,57,109,0.0006335726830135829,0.0012106537530266347,0.6566265060240963
1288,1725,그렇지/Adjective,166,69,97,0.0007669564057532844,0.0010773707710420508,0.5843373493975904
1289,1726,학생/Noun,166,95,71,0.0010559544716893046,0.0007885909767421196,0.572289156626506
1290,1728,좋았던/Adjective,165,156,9,0.0017339883956161216,9.996223648843771e-05,0.9454545454545454
1291,1729,기대했는데/Adjective,165,11,154,0.00012226841251139318,0.0017104649354688231,0.9333333333333332
1292,1730,호러/Noun,165,58,107,0.0006446879932418914,0.0011884399226958706,0.6484848484848484
1293,1731,방금/Noun,165,104,61,0.001155992263744081,0.0006775218250882999,0.6303030303030303
1294,1732,금/Noun,165,61,104,0.0006780339239268168,0.0011551191771997243,0.6303030303030303
1295,1733,라인/Noun,165,63,102,0.0007002645443834338,0.0011329053468689607,0.6181818181818182
1296,1734,비판/Noun,165,94,71,0.0010448391614609964,0.0007885909767421196,0.5696969696969697
1297,1737,굿굿/Noun,164,161,3,0.001789564946757664,3.33207454961459e-05,0.9817073170731708
1298,1738,없어요/Adjective,164,44,120,0.0004890736500455726,0.001332829819845836,0.7317073170731707
1299,1739,젊은/Adjective,164,111,53,0.0012337994353422404,0.0005886665037652442,0.6768292682926829
1300,1740,맨날/Adverb,164,58,106,0.0006446879932418914,0.0011773330075304884,0.6463414634146342
1301,1741,쫌/Noun,164,59,105,0.0006558033034701999,0.0011662260923651065,0.6402439024390244
1302,1742,과의/Josa,164,92,72,0.0010226085410043797,0.0007996978919075017,0.5609756097560976
1303,1747,어휴/Exclamation,163,21,142,0.00023342151479447792,0.0015771819534842392,0.8711656441717791
1304,1748,실패/Noun,163,27,136,0.0003001133761643288,0.0015105404624919474,0.8343558282208589
1305,1749,뛰어난/Adjective,163,124,39,0.0013782984683102506,0.0004331696914498967,0.7607361963190185
1306,1750,아줌마/Noun,163,46,117,0.0005113042705021896,0.0012995090743496902,0.7177914110429447
1307,1751,싶네요/Verb,163,113,50,0.0012560300557988573,0.0005553457582690984,0.6932515337423313
1308,1752,동안/Foreign,163,70,93,0.000778071715981593,0.001032943110380523,0.5705521472392638
1309,1753,동물/Noun,163,92,71,0.0010226085410043797,0.0007885909767421196,0.5644171779141104
1310,1757,하고자/Verb,162,33,129,0.00036680523753417966,0.0014327920563342734,0.7962962962962963
1311,1758,은근/Noun,162,127,35,0.001411644398995176,0.0003887420307883688,0.7839506172839507
1312,1759,심장/Noun,162,126,36,0.0014005290887668675,0.00039984894595375083,0.7777777777777778
1313,1760,조합/Noun,162,98,64,0.0010893004023742304,0.0007108425705844457,0.6049382716049383
1314,1762,탄탄한/Adjective,161,146,15,0.0016228352933330367,0.0001666037274807295,0.906832298136646
1315,1763,나오네/Verb,161,32,129,0.00035568992730587116,0.0014327920563342734,0.8012422360248447
1316,1764,빠진/Verb,161,51,110,0.0005668808216437321,0.0012217606681920164,0.6832298136645962
1317,1765,아쉽네요/Adjective,161,106,55,0.001178222884200698,0.0006108803340960082,0.6583850931677019
1318,1766,인해/Adjective,161,102,59,0.0011337616432874642,0.000655307994757536,0.6335403726708074
1319,1767,ㄷㄷㄷ/KoreanParticle,161,96,65,0.0010670697819176133,0.0007219494857498278,0.5962732919254659
1320,1768,즈/Modifier,161,92,69,0.0010226085410043797,0.0007663771464113557,0.5714285714285714
1321,1769,인/Suffix,161,70,91,0.000778071715981593,0.001010729280049759,0.5652173913043478
1322,1770,1시간/Number,160,35,125,0.0003890358579907965,0.001388364395672746,0.78125
1323,1771,아이돌/Noun,160,54,106,0.0006002267523286575,0.0011773330075304884,0.6625
1324,1772,한국인/Noun,160,57,103,0.0006335726830135829,0.0011440122620343426,0.64375
1325,1773,히어로/Noun,160,97,63,0.0010781850921459217,0.0006997356554190639,0.60625
1326,1776,잔잔하고/Adjective,159,148,11,0.0016450659137896538,0.00012217606681920164,0.9308176100628932
1327,1777,명품/Noun,159,135,24,0.0015005668808216438,0.0002665659639691672,0.8490566037735849
1328,1778,존경/Noun,159,126,33,0.0014005290887668675,0.00036652820045760486,0.7924528301886793
1329,1779,찍은/Verb,159,45,114,0.0005001889602738814,0.001266188328853544,0.7169811320754716
1330,1780,본다면/Verb,159,99,60,0.0011004157126025386,0.000666414909922918,0.6226415094339622
1331,1781,따뜻해지는/Adjective,158,156,2,0.0017339883956161216,2.2213830330763933e-05,0.9873417721518988
1332,1782,시트콤/Noun,158,109,49,0.0012115688148856235,0.0005442388431037163,0.689873417721519
1333,1783,어쩔/Modifier,158,50,108,0.0005557655114154236,0.0011995468378612525,0.6835443037974683
1334,1784,성/Noun,158,56,102,0.0006224573727852744,0.0011329053468689607,0.6455696202531646
1335,1785,대부분/Noun,158,60,98,0.0006669186136985082,0.001088477686207433,0.620253164556962
1336,1786,좋지만/Adjective,158,63,95,0.0007002645443834338,0.0010551569407112867,0.6012658227848101
1337,1788,생각나는/Verb,157,138,19,0.0015339128115065689,0.00021103138814225735,0.8789808917197452
1338,1789,푹/Noun,157,137,20,0.0015227975012782607,0.00022213830330763932,0.8726114649681529
1339,1790,신선하고/Adjective,157,137,20,0.0015227975012782607,0.00022213830330763932,0.8726114649681529
1340,1791,만족/Noun,157,113,44,0.0012560300557988573,0.0004887042672768067,0.7197452229299363
1341,1792,이니/Josa,157,56,101,0.0006224573727852744,0.0011217984317035787,0.643312101910828
1342,1793,주말/Noun,157,99,58,0.0011004157126025386,0.0006442010795921541,0.6305732484076433
1343,1794,신분/Noun,157,99,58,0.0011004157126025386,0.0006442010795921541,0.6305732484076433
1344,1795,겁니다/Verb,157,92,65,0.0010226085410043797,0.0007219494857498278,0.5859872611464968
1345,1796,들었다/Verb,157,92,65,0.0010226085410043797,0.0007219494857498278,0.5859872611464968
1346,1799,웃기지도/Verb,156,3,153,3.334593068492541e-05,0.001699358020303441,0.9807692307692308
1347,1800,쵝오/Noun,156,151,5,0.0016784118444745793,5.5534575826909837e-05,0.9679487179487181
1348,1801,성한/Adjective,156,10,146,0.00011115310228308472,0.0016216096141457672,0.935897435897436
1349,1802,봤더니/Verb,156,46,110,0.0005113042705021896,0.0012217606681920164,0.7051282051282052
1350,1803,보고나면/Verb,156,97,59,0.0010781850921459217,0.000655307994757536,0.6217948717948718
1351,1804,해주세요/Verb,156,92,64,0.0010226085410043797,0.0007108425705844457,0.5897435897435898
1352,1805,세기/Noun,156,90,66,0.0010003779205477628,0.0007330564009152097,0.5769230769230769
1353,1806,받는/Verb,156,68,88,0.0007558410955249762,0.000977408534553613,0.5641025641025641
1354,1809,즐겁게/Adjective,155,143,12,0.0015894893626481115,0.0001332829819845836,0.9225806451612903
1355,1810,아름다/Adjective,155,128,27,0.0014227597092234846,0.0002998867094653131,0.8258064516129032
1356,1811,전개도/Noun,155,54,101,0.0006002267523286575,0.0011217984317035787,0.6516129032258065
1357,1812,30/Number,155,98,57,0.0010893004023742304,0.0006330941644267722,0.6322580645161291
1358,1813,의리/Noun,155,89,66,0.000989262610319454,0.0007330564009152097,0.5741935483870968
1359,1814,미모/Noun,155,88,67,0.0009781473000911457,0.0007441633160805918,0.567741935483871
1360,1817,짝퉁/Noun,154,7,147,7.78071715981593e-05,0.0016327165293111491,0.9545454545454546
1361,1818,개뿔/Noun,154,7,147,7.78071715981593e-05,0.0016327165293111491,0.9545454545454546
1362,1819,왠만하면/Adjective,154,11,143,0.00012226841251139318,0.0015882888686496212,0.9285714285714286
1363,1820,보겠다/Verb,154,12,142,0.00013338372273970166,0.0015771819534842392,0.9220779220779219
1364,1821,양심/Noun,154,28,126,0.0003112286863926372,0.0013994713108381278,0.8181818181818182
1365,1822,챙겨/Verb,154,122,32,0.0013560678478536335,0.00035542128529222287,0.7922077922077922
1366,1823,????/Punctuation,154,36,118,0.000400151168219105,0.001310615989515072,0.7662337662337663
1367,1824,누군가/Noun,154,118,36,0.0013116066069403995,0.00039984894595375083,0.7662337662337663
1368,1825,보았다/Verb,154,114,40,0.0012671453660271655,0.0004442766066152787,0.7402597402597403
1369,1826,그거/Noun,154,45,109,0.0005001889602738814,0.0012106537530266347,0.7077922077922078
1370,1827,개념/Noun,154,49,105,0.0005446502011871152,0.0011662260923651065,0.6818181818181818
1371,1828,이자/Noun,154,103,51,0.0011448769535157724,0.0005664526734344802,0.6688311688311688
1372,1829,으로만/Josa,154,55,99,0.000611342062556966,0.0010995846013728146,0.6428571428571429
1373,1830,끼/Noun,154,58,96,0.0006446879932418914,0.0010662638558766688,0.6233766233766234
1374,1832,망/Noun,153,19,134,0.00021119089433786097,0.0014883266321611835,0.8758169934640523
1375,1833,연예인/Noun,153,27,126,0.0003001133761643288,0.0013994713108381278,0.8235294117647058
1376,1834,도안/Noun,153,38,115,0.000422381788675722,0.0012772952440189265,0.7516339869281046
1377,1835,가요/Noun,153,39,114,0.0004334970989040304,0.001266188328853544,0.7450980392156863
1378,1836,했는지/Verb,153,40,113,0.0004446124091323389,0.0012550814136881624,0.7385620915032679
1379,1837,전반/Noun,153,49,104,0.0005446502011871152,0.0011551191771997243,0.6797385620915033
1380,1838,진리/Noun,153,101,52,0.0011226463330591557,0.0005775595885998622,0.6601307189542484
1381,1839,이정/Noun,153,60,93,0.0006669186136985082,0.001032943110380523,0.6078431372549019
1382,1840,이란/Noun,153,91,62,0.001011493230776071,0.0006886287402536821,0.5947712418300654
1383,1843,잼있어요/Verb,152,144,8,0.00160060467287642,8.885532132305573e-05,0.9473684210526316
1384,1844,내고/Verb,152,19,133,0.00021119089433786097,0.0014772197169958016,0.875
1385,1845,의외로/Adverb,152,129,23,0.0014338750194517929,0.0002554590488037852,0.8486842105263158
1386,1846,여행/Noun,152,104,48,0.001155992263744081,0.0005331319279383344,0.6842105263157895
1387,1847,향/Noun,152,100,52,0.0011115310228308473,0.0005775595885998622,0.6578947368421053
1388,1848,19/Number,152,56,96,0.0006224573727852744,0.0010662638558766688,0.631578947368421
1389,1849,레알/Noun,152,63,89,0.0007002645443834338,0.0009885154497189948,0.5855263157894737
1390,1850,생활/Noun,152,87,65,0.0009670319898628369,0.0007219494857498278,0.5723684210526315
1391,1851,지루했다/Adjective,151,7,144,7.78071715981593e-05,0.0015993957838150033,0.9536423841059604
1392,1852,사기/Noun,151,33,118,0.00036680523753417966,0.001310615989515072,0.7814569536423841
1393,1853,과장/Noun,151,51,100,0.0005668808216437321,0.0011106915165381968,0.6622516556291391
1394,1854,보려고/Verb,151,59,92,0.0006558033034701999,0.0010218361952151409,0.6092715231788081
1395,1855,스스로/Noun,151,86,65,0.0009559166796345287,0.0007219494857498278,0.5695364238410596
1396,1862,라지/Noun,150,18,132,0.0002000755841095525,0.0014661128018304194,0.88
1397,1863,그렇다/Adjective,150,25,125,0.0002778827557077118,0.001388364395672746,0.8333333333333334
1398,1864,보며/Verb,150,116,34,0.0012893759864837828,0.00037763511562298685,0.7733333333333333
1399,1865,더불어/Verb,150,111,39,0.0012337994353422404,0.0004331696914498967,0.74
