,Unnamed: 0,parameter,counts,counts_H,counts_NH,p_from_H,p_from_NH,priority
0,15,이/Determiner,12373,4495,7878,0.04996331947624658,0.08750027767287913,0.6367089630647378
1,17,?/Punctuation,11319,3302,8017,0.036702754373874574,0.08904413888086722,0.7082781164413817
2,18,정말/Noun,10702,7082,3620,0.0787186270368806,0.04020703289868272,0.6617454681367969
3,24,!/Punctuation,8565,6415,2150,0.07130471511459885,0.023879867605571228,0.7489784004670169
4,28,만/Josa,7745,2412,5333,0.026810128270680036,0.05923317857698202,0.6885732730794061
5,31,과/Josa,6768,4231,2537,0.04702887757597315,0.02817824377457405,0.6251477541371159
6,32,최고/Noun,6671,6143,528,0.06828135073249894,0.005864451207321679,0.9208514465597362
7,34,왜/Noun,6247,2241,4006,0.024909410221639287,0.04449430215252016,0.6412678085481031
8,35,스토리/Noun,6075,2176,3899,0.02418691505679924,0.043305862229824285,0.6418106995884774
9,37,생각/Noun,6005,3771,2234,0.04191583487095125,0.024812848479463315,0.6279766860949209
10,38,~/Punctuation,6003,4016,1987,0.04463908587688682,0.02206944043361397,0.6689988339163752
11,42,감동/Noun,5597,4442,1155,0.04937420803414623,0.012828487016016172,0.7936394497051992
12,45,1/Number,5284,1409,3875,0.015661472111686642,0.04303929626585512,0.7333459500378501
13,52,때/Noun,4940,3220,1720,0.03579129893515328,0.019103894084456983,0.6518218623481782
14,57,감독/Noun,4688,1515,3173,0.016839694995887337,0.03524224181975698,0.6768344709897611
15,59,재미/Noun,4538,1752,2786,0.019474023519996442,0.030943865650754163,0.6139268400176289
16,60,내용/Noun,4529,1407,3122,0.01563924149123002,0.0346757891463225,0.6893353941267388
17,61,뭐/Noun,4491,831,3660,0.009236822799724341,0.040651309505298,0.8149632598530394
18,62,못/VerbPrefix,4418,1474,2944,0.016383967276526686,0.032698758246884514,0.666364870982345
19,63,그냥/Noun,4406,1187,3219,0.013193873241002156,0.03575315991736455,0.7305946436677259
20,67,안/VerbPrefix,4262,1318,2944,0.014649978880910566,0.032698758246884514,0.6907555138432661
21,69,좀/Noun,4111,1455,2656,0.016172776382188826,0.029499966679254506,0.6460715154463634
22,71,없는/Adjective,4090,1373,2717,0.015261320943467532,0.0301774885043428,0.6643031784841076
23,73,!!/Punctuation,4005,3088,917,0.03432407798501656,0.010185041206655265,0.7710362047440699
24,74,시간/Noun,3956,1077,2879,0.011971189115888223,0.03197680876113468,0.7277553083923155
25,76,쓰레기/Noun,3739,209,3530,0.002323099837716471,0.03920741053379834,0.9441027012570206
26,78,수/Noun,3698,2475,1223,0.02751039281506347,0.013583757247262143,0.6692806922660898
27,80,아/Exclamation,3469,1327,2142,0.014750016672965344,0.02379101228424817,0.6174690112424329
28,83,없다/Adjective,3324,873,2451,0.009703665829313295,0.0272230490703512,0.7373646209386282
29,84,작품/Noun,3308,2050,1258,0.02278638596803237,0.013972499278050514,0.6197097944377267
30,85,다시/Noun,3289,2763,526,0.030711602160816313,0.005842237376990914,0.8400729705077531
31,86,잘/Verb,3274,2363,911,0.02626547806949292,0.010118399715662972,0.7217470983506414
32,87,10/Number,3248,2158,1090,0.023986839472689682,0.012106537530266344,0.6644088669950738
33,88,마지막/Noun,3201,2151,1050,0.023909032301091523,0.011662260923651064,0.6719775070290535
34,90,사랑/Noun,3190,2523,667,0.028043927706022275,0.007408312415309772,0.7909090909090909
35,91,잘/VerbPrefix,3151,2150,1001,0.023897916990863216,0.011118022080547348,0.682323072040622
36,92,본/Verb,3099,1949,1150,0.02166373963497321,0.012772952440189262,0.6289125524362698
37,95,요/Josa,3013,1950,1063,0.021674854945201518,0.011806650820801031,0.6471954862263525
38,96,좋은/Adjective,3009,2156,853,0.023964608852233067,0.009474198636070815,0.7165171153207045
39,99,나/Josa,2916,1029,1887,0.011437654224929416,0.02095874891707577,0.647119341563786
40,101,있는/Adjective,2899,2055,844,0.02284196251917391,0.00937423639958238,0.7088651259054847
41,102,입니다/Adjective,2888,2167,721,0.02408687726474446,0.008008085834240399,0.7503462603878116
42,112,지금/Noun,2596,1843,753,0.020485516750772512,0.00836350711953262,0.7099383667180277
43,113,ㅠㅠ/KoreanParticle,2589,1842,747,0.0204744014405442,0.00829686562854033,0.7114716106604867
44,114,최악/Noun,2549,32,2517,0.00035568992730587116,0.02795610547126641,0.9874460572773636
45,117,재밌게/Adjective,2508,2195,313,0.024398105951137096,0.0034764644467645558,0.8751993620414673
46,118,걸/Noun,2493,777,1716,0.008636596047395683,0.019059466423795454,0.6883273164861613
47,119,3/Number,2481,918,1563,0.010203854789587177,0.017360108403492013,0.6299879081015719
48,122,별로/Noun,2438,320,2118,0.003556899273058711,0.02352444632027901,0.8687448728465955
49,123,끝/Noun,2438,862,1576,0.009581397416801902,0.01750449830064198,0.6464315012305168
50,124,돈/Noun,2433,279,2154,0.003101171553698064,0.02392429526623276,0.8853267570900123
51,130,역시/Noun,2323,1623,700,0.01804014850054465,0.007774840615767376,0.6986655187257856
52,131,봐도/Verb,2322,1795,527,0.01995198185981371,0.0058533442921562965,0.773040482342808
53,132,개/Noun,2277,671,1606,0.007458373163194984,0.01783770575560344,0.7053140096618358
54,133,명작/Noun,2259,1976,283,0.02196385301113754,0.0031432569918030968,0.8747233289065959
55,134,이런/Modifier,2201,819,1382,0.00910343907698464,0.01534975675855788,0.6278964107223989
56,137,^^/Punctuation,2162,1921,241,0.021352510948580573,0.002676766554857054,0.8885291396854764
57,138,라고/Josa,2147,777,1370,0.008636596047395683,0.015216473776573296,0.6380996739636703
58,139,ㅡㅡ/KoreanParticle,2128,211,1917,0.002345330458173088,0.02129195637203723,0.9008458646616542
59,140,없고/Adjective,2122,205,1917,0.002278638596803237,0.02129195637203723,0.9033930254476908
60,146,!!!/Punctuation,2038,1392,646,0.01547251183780539,0.00717506719683675,0.6830225711481845
61,147,또/Noun,2013,1348,665,0.014983438187759818,0.007386098584979008,0.6696472925981123
62,150,아깝다/Adjective,1949,47,1902,0.0005224195807304982,0.021125352644556502,0.9758850692662904
63,151,여자/Noun,1944,757,1187,0.008414289842829513,0.013183908301308394,0.61059670781893
64,152,난/Noun,1928,1196,732,0.01329391103305693,0.0081302619010596,0.6203319502074689
65,153,꼭/Noun,1920,1594,326,0.0177178045039237,0.003620854343914521,0.8302083333333333
66,161,마음/Noun,1810,1497,313,0.016639619411777783,0.0034764644467645558,0.8270718232044199
67,162,인생/Noun,1810,1304,506,0.014494364537714247,0.0056200990736832756,0.7204419889502762
68,165,기억/Noun,1794,1237,557,0.01374963875241758,0.006186551747117756,0.6895206243032329
69,169,ㅎㅎ/KoreanParticle,1744,1498,246,0.01665073472200609,0.002732301130683964,0.8589449541284404
70,171,못/Noun,1720,544,1176,0.00604672876419981,0.013061732234489191,0.6837209302325581
71,173,소재/Noun,1714,594,1120,0.0066024942756152324,0.012439744985227805,0.6534422403733956
72,174,이나/Josa,1704,527,1177,0.005857768490318565,0.013072839149654573,0.6907276995305164
73,176,애/Noun,1670,576,1094,0.00640241869150568,0.012150965190927872,0.6550898203592814
74,178,수준/Noun,1658,273,1385,0.003034479692328213,0.015383077504054024,0.8353437876960192
75,179,한번/Noun,1640,1136,504,0.012626992419358423,0.005597885243352511,0.6926829268292682
76,181,네/Josa,1608,469,1139,0.0052130804970766725,0.01265077637337006,0.7083333333333334
77,182,넘/Verb,1591,1126,465,0.01251583931707534,0.005164715551902614,0.7077309868007542
78,184,현실/Noun,1587,1041,546,0.01157103794766912,0.006064375680298554,0.6559546313799622
79,185,전개/Noun,1586,418,1168,0.004646199675432942,0.012972876913166138,0.7364438839848676
80,186,매력/Noun,1586,1153,433,0.012815952693239669,0.00480929426661039,0.7269861286254728
81,188,가슴/Noun,1575,1376,199,0.015294666874152455,0.0022102761179110114,0.8736507936507937
82,189,하게/Verb,1574,1130,444,0.012560300557988574,0.004931470333429593,0.7179161372299873
83,190,되는/Verb,1569,977,592,0.010859658093057377,0.006575293777906124,0.6226896112173359
84,191,~~/Punctuation,1556,1038,518,0.011537692016984194,0.00575338205566786,0.6670951156812339
85,192,야/Josa,1543,373,1170,0.00414601071515906,0.012995090743496902,0.7582631237848347
86,194,님/Suffix,1536,948,588,0.010537314096436429,0.006530866117244597,0.6171875
87,196,가장/Noun,1534,1006,528,0.011182002089678324,0.005864451207321679,0.6558018252933507
88,197,;;/Punctuation,1523,373,1150,0.00414601071515906,0.012772952440189262,0.7550886408404465
89,199,??/Punctuation,1503,455,1048,0.005057466153880355,0.011640047093320302,0.697272122421823
90,204,음악/Noun,1452,1077,375,0.011971189115888223,0.0041650931870182385,0.7417355371900827
91,206,성/Suffix,1445,496,949,0.0055131938732410025,0.010540462491947487,0.6567474048442906
92,207,만든/Verb,1445,521,924,0.005791076628948714,0.010262789612812935,0.6394463667820071
93,208,아이/Noun,1436,944,492,0.010492852855523198,0.005464602261367928,0.6573816155988857
94,211,봤다/Verb,1414,872,542,0.009692550519084988,0.006019948019637026,0.6166902404526167
95,213,무슨/Noun,1408,215,1193,0.002389791699086321,0.013250549792300687,0.8473011363636364
96,214,추천/Noun,1403,1037,366,0.011526576706755885,0.0040651309505298,0.7391304347826086
97,215,만/Noun,1401,947,454,0.010526198786208123,0.005042539485083413,0.6759457530335474
98,216,냐/Josa,1392,169,1223,0.001878487428584132,0.013583757247262143,0.8785919540229885
99,217,인지/Josa,1383,425,958,0.004724006847031101,0.010640424728435923,0.6926970354302241
100,218,게/Noun,1380,485,895,0.005390925460729609,0.009940689073016859,0.6485507246376812
101,219,눈물/Noun,1378,1156,222,0.012849298623924595,0.002465735166714797,0.8388969521044993
102,220,인가/Josa,1378,446,932,0.004957428361825579,0.010351644934135993,0.6763425253991292
103,222,번/Noun,1370,945,425,0.010503968165751507,0.004720438945287336,0.6897810218978102
104,223,ㅠ/KoreanParticle,1361,899,462,0.009992663895249316,0.005131394806406469,0.6605437178545187
105,224,합니다/Verb,1360,1010,350,0.011226463330591557,0.003887420307883689,0.7426470588235294
106,226,저/Determiner,1355,471,884,0.005235311117533291,0.009818513006197658,0.6523985239852399
107,227,우리/Noun,1346,996,350,0.011070848987395238,0.003887420307883689,0.7399702823179792
108,228,인간/Noun,1346,839,507,0.009325745281550809,0.005631205988848657,0.6233283803863299
109,229,네/Suffix,1337,913,424,0.010148278238445637,0.004709332030121954,0.6828721017202692
110,234,속/Noun,1307,819,488,0.00910343907698464,0.005420174600706399,0.6266258607498087
111,237,재밌다/Adjective,1294,1174,120,0.013049374208034144,0.001332829819845836,0.9072642967542504
112,239,원작/Noun,1275,429,846,0.0047684680879443355,0.009396450229913143,0.6635294117647059
113,240,솔직히/Adjective,1253,412,841,0.0045795078140630895,0.009340915654086237,0.6711891460494812
114,244,좋다/Adjective,1236,1070,166,0.011893381944290064,0.0018437479174534066,0.8656957928802589
115,248,있다/Adjective,1212,777,435,0.008636596047395683,0.0048315080969411565,0.6410891089108911
116,249,여운/Noun,1210,1139,71,0.01266033835004335,0.0007885909767421196,0.9413223140495868
117,251,움/Noun,1204,432,772,0.00480181401862926,0.00857453850767488,0.6411960132890365
118,253,전혀/Noun,1199,338,861,0.003756974857168264,0.009563053957393873,0.7180984153461217
119,254,기대/Noun,1198,745,453,0.008280906120089812,0.005031432569918031,0.6218697829716193
120,255,모두/Noun,1194,810,384,0.009003401284929862,0.004265055423506675,0.6783919597989949
121,256,대박/Noun,1180,975,205,0.010837427472600759,0.002276917608903303,0.826271186440678
122,261,별/Noun,1164,304,860,0.003379054309405776,0.009551947042228491,0.7388316151202751
123,263,굿/Noun,1156,1072,84,0.01191561256474668,0.0009329808738920851,0.9273356401384084
124,267,모습/Noun,1142,842,300,0.009359091212235734,0.00333207454961459,0.7373029772329247
125,268,별/Modifier,1142,316,826,0.003512438032145477,0.009174311926605505,0.7232924693520141
126,273,허/Verb,1121,125,996,0.001389413778538559,0.011062487504720437,0.8884924174843889
127,274,실망/Noun,1118,115,1003,0.0012782606762554744,0.011140235910878113,0.8971377459749553
128,279,일본/Noun,1098,391,707,0.0043460862992686115,0.00785258902192505,0.6438979963570127
129,280,보지/Noun,1094,324,770,0.0036013605139719454,0.008552324677344115,0.7038391224862889
130,281,진심/Noun,1094,415,679,0.004612853744748016,0.007541595397294354,0.6206581352833638
131,284,재미있게/Adjective,1086,979,107,0.010881888713513994,0.0011884399226958706,0.9014732965009208
132,289,일/Modifier,1074,387,687,0.004301625058355379,0.007630450718617411,0.6396648044692738
133,291,제목/Noun,1073,405,668,0.004501700642464931,0.007419419330475155,0.6225535880708295
134,292,였다/Verb,1071,709,362,0.007880754951870706,0.004020703289868272,0.6619981325863679
135,293,없음/Adjective,1069,179,890,0.0019896405308672165,0.00988515449718995,0.8325537885874649
136,294,많은/Adjective,1069,790,279,0.008781095080363692,0.003098829331141569,0.7390084190832554
137,298,봤습니다/Verb,1059,961,98,0.010681813129404442,0.001088477686207433,0.9074598677998112
138,303,뿐/Noun,1051,311,740,0.0034568614810039353,0.008219117222382655,0.7040913415794482
139,306,재밌어요/Adjective,1049,1012,37,0.011248693951048171,0.0004109558611191328,0.9647283126787416
140,307,ㅎ/KoreanParticle,1048,840,208,0.009336860591779116,0.0023102383543994486,0.8015267175572519
141,308,;/Punctuation,1045,287,758,0.0031900940355245318,0.008419041695359529,0.7253588516746412
142,309,보다/Verb,1045,365,680,0.004057088233332592,0.0075527023124597375,0.6507177033492823
143,310,표현/Noun,1042,681,361,0.007569526265478068,0.00400959637470289,0.6535508637236085
144,312,아니다/Adjective,1036,293,743,0.0032567858968943824,0.008252437967878801,0.7171814671814671
145,313,재미없다/Adjective,1035,22,1013,0.00024453682502278637,0.01125130506253193,0.978743961352657
146,314,OO/Alpha,1033,220,813,0.002445368250227864,0.009029922029455541,0.7870280735721199
147,316,가족/Noun,1031,710,321,0.007891870262099015,0.0035653197680876117,0.6886517943743938
148,319,요즘/Noun,1013,643,370,0.007147144476802349,0.004109558611191328,0.6347482724580454
149,321,점도/Noun,1011,91,920,0.001011493230776071,0.010218361952151409,0.9099901088031652
150,326,용/Noun,999,295,704,0.0032790165173509998,0.007819268276428905,0.7047047047047047
151,328,ㅜㅜ/KoreanParticle,996,633,363,0.007035991374519263,0.0040318102050336535,0.6355421686746988
152,329,모든/Noun,986,630,356,0.0070026454438343365,0.003954061798875979,0.6389452332657201
153,330,4/Number,981,333,648,0.003701398306026721,0.0071972810271675155,0.6605504587155964
154,332,급/Noun,974,237,737,0.0026343285241091077,0.00818579647688651,0.7566735112936345
155,334,하다/Verb,970,367,603,0.0040793188537892105,0.0066974698447253254,0.6216494845360825
156,336,특히/Adverb,966,665,301,0.007391681301825134,0.003343181464779972,0.6884057971014492
157,340,개인/Noun,957,633,324,0.007035991374519263,0.003598640513583757,0.6614420062695925
158,344,공포/Noun,951,319,632,0.0035457839628304025,0.007019570384521403,0.6645636172450052
159,347,건지/Verb,933,160,773,0.0017784496365293556,0.008585645422840259,0.8285101822079314
160,348,건/Noun,932,292,640,0.0032456705866660733,0.007108425705844459,0.6866952789699571
161,349,한테/Josa,931,317,614,0.003523553342373785,0.006819645911544527,0.6595059076262084
162,350,작가/Noun,929,209,720,0.002323099837716471,0.007996978919075016,0.77502691065662
163,352,나름/Noun,923,600,323,0.006669186136985084,0.003587533598418375,0.6500541711809318
164,355,아까운/Adjective,917,63,854,0.0007002645443834338,0.0094853055512362,0.931297709923664
165,356,아니고/Adjective,914,147,767,0.0016339506035613453,0.008519003931847971,0.8391684901531729
166,357,보다가/Verb,913,186,727,0.0020674477024653763,0.00807472732523269,0.7962760131434831
167,358,욕/Noun,910,166,744,0.0018451414978992067,0.008263544883044184,0.8175824175824176
168,359,차라리/Noun,909,59,850,0.0006558033034701999,0.009440877890574672,0.935093509350935
169,360,노래/Noun,909,604,305,0.006713647377898317,0.0033876091254415,0.6644664466446645
170,362,짱/Noun,905,842,63,0.009359091212235734,0.0006997356554190639,0.9303867403314916
171,363,중간/Noun,905,328,577,0.0036458217548851783,0.0064086900504253955,0.6375690607734806
172,364,알바/Noun,897,104,793,0.001155992263744081,0.0088077837261479,0.8840579710144928
173,366,아름다운/Adjective,890,799,91,0.008881132872418469,0.001010729280049759,0.8977528089887641
174,367,0/Number,888,77,811,0.0008558788875797522,0.009007708199124777,0.9132882882882885
175,369,삶/Noun,883,770,113,0.008558788875797524,0.0012550814136881624,0.8720271800679502
176,372,...../Punctuation,877,327,550,0.003634706444656871,0.006108803340960082,0.6271379703534777
177,373,제/Noun,874,553,321,0.006146766556254586,0.0035653197680876117,0.6327231121281465
178,374,오랜/Modifier,870,699,171,0.007769601849587622,0.0018992824932803163,0.8034482758620691
179,375,기/Noun,869,240,629,0.002667674454794033,0.006986249639025257,0.7238204833141542
180,376,보게/Verb,865,698,167,0.007758486539359314,0.0018548548326187888,0.8069364161849711
181,378,당시/Noun,862,550,312,0.00611342062556966,0.0034653575315991736,0.6380510440835266
182,379,점수/Noun,857,271,586,0.003012249071871596,0.006508652286913832,0.6837806301050176
183,382,보세요/Verb,847,583,264,0.006480225863103839,0.0029322256036608393,0.6883116883116883
184,384,놈/Noun,846,250,596,0.002778827557077118,0.006619721438567652,0.7044917257683215
185,385,봤어요/Verb,843,794,49,0.008825556321276927,0.0005442388431037163,0.9418742586002372
186,386,아직도/Adverb,841,631,210,0.0070137607540626465,0.002332452184730213,0.7502972651605232
187,387,막장/Noun,834,144,690,0.00160060467287642,0.007663771464113556,0.8273381294964028
188,391,세상/Noun,824,533,291,0.005924460351688416,0.0032321123131261523,0.6468446601941747
189,393,좋고/Adjective,819,740,79,0.008225329568948269,0.0008774462980651753,0.9035409035409036
190,397,공포영화/Noun,809,293,516,0.0032567858968943824,0.005731168225337095,0.6378244746600742
191,400,도대체/Noun,805,101,704,0.0011226463330591557,0.007819268276428905,0.8745341614906832
192,403,재밌음/Adjective,795,735,60,0.008169753017806727,0.000666414909922918,0.9245283018867924
193,404,뻔한/Adjective,795,199,596,0.002211946735433386,0.006619721438567652,0.7496855345911949
194,405,좋아하는/Adjective,792,528,264,0.0058688838005468745,0.0029322256036608393,0.6666666666666666
195,406,류/Noun,790,141,649,0.0015672587421914947,0.007208387942332897,0.8215189873417722
196,407,나도/Verb,790,498,292,0.005535424493697619,0.0032432192282915344,0.6303797468354431
197,411,있고/Adjective,787,619,168,0.006880377031322943,0.0018659617477841703,0.7865311308767471
198,412,절대/Noun,787,263,524,0.002923326590045128,0.005820023546660151,0.6658195679796697
199,413,뭘/Noun,782,175,607,0.0019451792899539827,0.006741897505386854,0.7762148337595908
200,415,물/Noun,777,295,482,0.0032790165173509998,0.005353533109714108,0.6203346203346203
201,419,수작/Noun,766,696,70,0.007736255918902695,0.0007774840615767378,0.908616187989556
202,421,걍/Adverb,765,208,557,0.002311984527488162,0.006186551747117756,0.7281045751633987
203,422,설정/Noun,762,139,623,0.0015450281217348775,0.006919608148032965,0.8175853018372703
204,423,초반/Noun,761,265,496,0.002945557210501745,0.005509029922029457,0.6517739816031537
205,427,준다/Verb,748,271,477,0.003012249071871596,0.005297998533887197,0.6377005347593583
206,428,주고/Verb,747,183,564,0.0020341017717804503,0.006264300153275429,0.7550200803212851
207,429,남는/Verb,744,598,146,0.006646955516528465,0.0016216096141457672,0.803763440860215
208,430,시나리오/Noun,742,207,535,0.002300869217259854,0.005942199613479352,0.7210242587601078
209,431,딱/Adverb,742,251,491,0.0027899428673054264,0.005453495346202546,0.6617250673854448
210,435,출연/Noun,740,226,514,0.0025120601115977146,0.005708954395006331,0.6945945945945946
211,437,좋았다/Adjective,733,600,133,0.006669186136985084,0.0014772197169958016,0.8185538881309686
212,438,관객/Noun,732,188,544,0.0020896783229219927,0.00604216184996779,0.7431693989071039
213,439,주는/Verb,731,477,254,0.005302002978903141,0.0028211564520070195,0.6525307797537621
214,441,안되는/Adjective,730,161,569,0.001789564946757664,0.006319834729102339,0.7794520547945205
215,443,가지/Noun,725,278,447,0.003090056243469755,0.004964791078925739,0.616551724137931
216,444,노잼/Noun,724,17,707,0.00018896027388124405,0.00785258902192505,0.9765193370165746
217,446,뭔/Modifier,722,104,618,0.001155992263744081,0.006864073572206054,0.8559556786703602
218,447,분위기/Noun,721,443,278,0.004924082431140653,0.0030877224159761873,0.6144244105409153
219,448,시대/Noun,719,474,245,0.0052686570482182145,0.002721194215518582,0.6592489568845619
220,450,장난/Noun,714,182,532,0.002022986461552142,0.005908878867983206,0.7450980392156863
221,451,최고다/Noun,711,679,32,0.007547295645021453,0.00035542128529222287,0.9549929676511956
222,452,봤던/Verb,711,560,151,0.006224573727852744,0.001677144189972677,0.7876230661040787
223,454,OOO/Alpha,708,91,617,0.001011493230776071,0.006852966657040674,0.8714689265536724
224,455,같아요/Adjective,708,559,149,0.006213458417624436,0.001654930359641913,0.7895480225988699
225,456,결국/Adverb,708,253,455,0.0028121734877620433,0.005053646400248795,0.6426553672316384
226,457,지루함/Noun,707,100,607,0.0011115310228308473,0.006741897505386854,0.8585572842998586
227,458,추억/Noun,707,576,131,0.00640241869150568,0.0014550058866650375,0.8147100424328148
228,460,소리/Noun,705,202,503,0.0022452926661183114,0.005586778328187129,0.7134751773049646
229,462,이딴/Modifier,703,26,677,0.00028899806593602026,0.007519381566963592,0.9630156472261736
230,463,지루하고/Adjective,702,38,664,0.000422381788675722,0.0073749916698136265,0.945868945868946
231,465,좋아요/Adjective,696,653,43,0.007258297579085431,0.0004775973521114245,0.9382183908045976
232,467,마다/Josa,694,480,214,0.005335348909588066,0.002376879845391741,0.69164265129683
233,469,인상/Noun,689,547,142,0.006080074694884734,0.0015771819534842392,0.7939042089985486
234,470,이지만/Josa,687,427,260,0.004746237467487717,0.002887797942999312,0.6215429403202329
235,471,오늘/Noun,685,462,223,0.005135273325478514,0.002476842081880179,0.6744525547445256
236,472,감정/Noun,684,445,239,0.004946313051597271,0.0026545527245262907,0.6505847953216374
237,473,전/Modifier,680,199,481,0.002211946735433386,0.005342426194548726,0.7073529411764706
238,474,정신/Noun,678,183,495,0.0020341017717804503,0.0054979230068640745,0.7300884955752213
239,475,엔딩/Noun,678,431,247,0.004790698708400951,0.0027434080458493453,0.6356932153392331
240,478,접/Noun,676,122,554,0.0013560678478536335,0.006153231001621609,0.8195266272189349
241,480,졸작/Noun,672,34,638,0.0003779205477624881,0.007086211875513696,0.949404761904762
242,481,제발/Noun,671,179,492,0.0019896405308672165,0.005464602261367928,0.7332339791356185
243,482,자신/Noun,671,422,249,0.004690660916346175,0.002765621876180109,0.6289120715350224
244,485,아무리/Adverb,666,114,552,0.0012671453660271655,0.006131017171290846,0.8288288288288288
245,486,그저/Adverb,666,221,445,0.0024564835604561725,0.004942577248594975,0.6681681681681682
246,488,♥/Foreign,660,651,9,0.007236066958628815,9.996223648843771e-05,0.9863636363636364
247,490,킬링타임/Noun,659,186,473,0.0020674477024653763,0.005253570873225671,0.7177541729893778
248,491,어릴/Verb,658,548,110,0.006091190005113043,0.0012217606681920164,0.8328267477203647
249,493,함께/Adverb,656,544,112,0.00604672876419981,0.0012439744985227805,0.8292682926829268
250,494,그렇게/Adverb,656,251,405,0.0027899428673054264,0.004498300641979696,0.6173780487804879
251,496,캐스팅/Noun,653,219,434,0.0024342529399995552,0.004820401181775774,0.664624808575804
252,498,대해/Noun,651,506,145,0.0056243469755240865,0.001610502698980385,0.7772657450076805
253,501,재밌는/Adjective,647,549,98,0.006102305315341351,0.001088477686207433,0.848531684698609
254,502,멋진/Adjective,643,560,83,0.006224573727852744,0.0009218739587267033,0.8709175738724728
255,503,괜찮은/Adjective,643,487,156,0.005413156081186226,0.0017326787657995868,0.7573872472783826
256,504,포스터/Noun,642,205,437,0.002278638596803237,0.00485372192727192,0.6806853582554517
257,505,몰입도/Noun,638,412,226,0.0045795078140630895,0.002510162827376325,0.64576802507837
258,507,엉/Exclamation,636,103,533,0.0011448769535157724,0.005919985783148589,0.8380503144654088
259,508,자/Suffix,632,213,419,0.0023675610786297045,0.004653797454295044,0.6629746835443038
260,509,갈수록/Noun,631,192,439,0.0021341395638352265,0.0048759357576026825,0.6957210776545166
261,510,아니/Adjective,631,205,426,0.002278638596803237,0.004731545860452718,0.6751188589540412
262,512,개연/Noun,630,55,575,0.000611342062556966,0.006386476220094631,0.9126984126984128
263,513,애니메이션/Noun,630,418,212,0.004646199675432942,0.002354666015060977,0.6634920634920635
264,514,했던/Verb,627,391,236,0.0043460862992686115,0.002621231979030144,0.6236044657097288
265,520,!!!!/Punctuation,622,460,162,0.005113042705021898,0.0017993202567918784,0.7395498392282959
266,523,문제/Noun,619,201,418,0.0022341773558900027,0.004642690539129663,0.6752827140549273
267,524,이름/Noun,617,239,378,0.002656559144565725,0.004198413932514383,0.6126418152350082
268,527,하/Exclamation,614,213,401,0.0023675610786297045,0.0044538729813181676,0.6530944625407166
269,528,ㅠㅠㅠ/KoreanParticle,611,496,115,0.0055131938732410025,0.0012772952440189265,0.8117839607201309
270,530,충격/Noun,610,399,211,0.00443500878109508,0.002343559099895595,0.6540983606557377
271,531,맘/Noun,609,373,236,0.00414601071515906,0.002621231979030144,0.6124794745484401
272,533,머리/Noun,603,235,368,0.002612097903652491,0.004087344780860563,0.6102819237147595
273,536,질/Noun,599,104,495,0.001155992263744081,0.0054979230068640745,0.8263772954924875
274,545,적/Noun,593,406,187,0.004512815952693239,0.002076993135926428,0.684654300168634
275,547,지루한/Adjective,592,100,492,0.0011115310228308473,0.005464602261367928,0.8310810810810809
276,551,강추/Noun,590,547,43,0.006080074694884734,0.0004775973521114245,0.9271186440677966
277,552,얘기/Noun,590,217,373,0.0024120223195429388,0.0041428793566874724,0.6322033898305085
278,553,대/Foreign,587,217,370,0.0024120223195429388,0.004109558611191328,0.6303236797274276
279,555,장르/Noun,583,201,382,0.0022341773558900027,0.004242841593175911,0.6552315608919382
280,557,더빙/Noun,582,150,432,0.0016672965342462707,0.00479818735144501,0.7422680412371134
281,558,재밌고/Adjective,581,533,48,0.005924460351688416,0.0005331319279383344,0.9173838209982788
282,559,모르겠다/Verb,581,115,466,0.0012782606762554744,0.005175822467067996,0.8020654044750429
283,562,주연/Noun,577,225,352,0.0025009448013694068,0.003909634138214452,0.6100519930675911
284,563,얼굴/Noun,576,199,377,0.002211946735433386,0.004187307017349001,0.6545138888888888
285,569,머/Noun,570,97,473,0.0010781850921459217,0.005253570873225671,0.8298245614035088
286,573,꽤/Noun,562,441,121,0.004901851810684036,0.001343936735011218,0.7846975088967971
287,574,하는데/Verb,562,199,363,0.002211946735433386,0.0040318102050336535,0.6459074733096085
288,576,짜증/Noun,558,23,535,0.00025565213525109487,0.005942199613479352,0.9587813620071683
289,578,9/Number,557,382,175,0.0042460485072138366,0.0019437101539418445,0.6858168761220825
290,579,매우/Noun,557,343,214,0.003812551408309806,0.002376879845391741,0.6157989228007181
291,580,지루하다/Adjective,556,14,542,0.0001556143431963186,0.006019948019637026,0.974820143884892
292,581,ㅡ/KoreanParticle,556,157,399,0.00174510370584443,0.004431659150987405,0.7176258992805755
293,583,ㅎㅎㅎ/KoreanParticle,555,434,121,0.0048240446390858775,0.001343936735011218,0.781981981981982
294,584,너무나/Adverb,552,365,187,0.004057088233332592,0.002076993135926428,0.6612318840579711
295,585,이리/Adverb,552,199,353,0.002211946735433386,0.0039207410533798346,0.6394927536231884
296,588,???/Punctuation,551,142,409,0.0015783740524198029,0.004542728302641225,0.7422867513611615
297,589,두/Noun,551,362,189,0.004023742302647667,0.002099206966257192,0.6569872958257713
298,592,건가/Noun,546,124,422,0.0013782984683102506,0.00468711819979119,0.7728937728937729
299,593,아직/Adverb,546,363,183,0.004034857612875975,0.0020325654752649,0.6648351648351648
300,596,작/Modifier,544,183,361,0.0020341017717804503,0.00400959637470289,0.6636029411764706
301,598,소름/Noun,540,437,103,0.004857390569770802,0.0011440122620343426,0.8092592592592592
302,599,글/Noun,538,195,343,0.002167485494520152,0.0038096719017260148,0.6375464684014871
303,600,않다/Verb,537,191,346,0.0021230242536069183,0.0038429926472221604,0.6443202979515829
304,602,재미없음/Adjective,533,9,524,0.00010003779205477625,0.005820023546660151,0.9831144465290806
305,603,걸작/Noun,533,459,74,0.005101927394793589,0.0008219117222382655,0.8611632270168855
306,604,그나마/Adverb,532,40,492,0.0004446124091323389,0.005464602261367928,0.924812030075188
307,605,본다/Verb,529,198,331,0.002200831425205077,0.003676388919741431,0.6257088846880907
308,606,억지/Noun,527,72,455,0.00080030233643821,0.005053646400248795,0.8633776091081594
309,607,대체/Noun,527,89,438,0.000989262610319454,0.004864828842437301,0.8311195445920304
310,609,마세요/Verb,526,73,453,0.0008114176466665183,0.005031432569918031,0.8612167300380228
311,610,시절/Noun,526,397,129,0.004412778160638464,0.0014327920563342734,0.7547528517110266
312,612,존나/Noun,525,122,403,0.0013560678478536335,0.004476086811648933,0.7676190476190476
313,613,약간/Noun,525,357,168,0.003968165751506125,0.0018659617477841703,0.68
314,619,아님/Adjective,522,147,375,0.0016339506035613453,0.0041650931870182385,0.7183908045977011
315,620,실화/Noun,522,331,191,0.003679167685570104,0.0021214207965879555,0.6340996168582376
316,624,해도/Noun,520,170,350,0.0018896027388124407,0.003887420307883689,0.6730769230769231
317,625,봤음/Verb,519,357,162,0.003968165751506125,0.0017993202567918784,0.6878612716763006
318,626,이었다/Verb,518,357,161,0.003968165751506125,0.001788213341626497,0.6891891891891891
319,627,아무/Modifier,518,169,349,0.001878487428584132,0.0038763133927183055,0.6737451737451737
320,630,B/Alpha,514,133,381,0.0014783362603650269,0.00423173467801053,0.7412451361867705
321,631,한마디/Noun,514,156,358,0.0017339883956161216,0.003976275629206745,0.6964980544747081
322,634,휴/Exclamation,506,86,420,0.0009559166796345287,0.004664904369460426,0.8300395256916996
323,635,자기/Noun,506,160,346,0.0017784496365293556,0.0038429926472221604,0.6837944664031621
324,636,하기/Verb,506,196,310,0.0021786008047484607,0.0034431437012684093,0.6126482213438735
325,637,없네/Adjective,504,70,434,0.000778071715981593,0.004820401181775774,0.8611111111111112
326,638,누가/Noun,504,180,324,0.002000755841095525,0.003598640513583757,0.6428571428571429
327,641,없어/Adjective,503,126,377,0.0014005290887668675,0.004187307017349001,0.7495029821073559
328,646,만점/Noun,501,423,78,0.004701776226574484,0.0008663393828997934,0.844311377245509
329,647,초딩/Noun,501,192,309,0.0021341395638352265,0.003432036786103028,0.6167664670658682
330,652,간만/Noun,496,400,96,0.004446124091323389,0.0010662638558766688,0.8064516129032258
331,656,없었다/Adjective,490,186,304,0.0020674477024653763,0.003376502210276118,0.6204081632653061
332,658,라도/Josa,488,145,343,0.0016117199831047284,0.0038096719017260148,0.7028688524590164
333,659,~!/Punctuation,487,385,102,0.004279394437898762,0.0011329053468689607,0.7905544147843943
334,660,CG/Alpha,487,126,361,0.0014005290887668675,0.00400959637470289,0.7412731006160165
335,661,재밌네요/Adjective,486,466,20,0.005179734566391748,0.00022213830330763932,0.9588477366255144
336,662,전체/Noun,486,158,328,0.0017562190160727387,0.003643068174245285,0.6748971193415638
337,664,아까/Adjective,484,11,473,0.00012226841251139318,0.005253570873225671,0.9772727272727272
338,666,뿐/Suffix,482,150,332,0.0016672965342462707,0.0036874958349068132,0.6887966804979253
339,667,감성/Noun,482,311,171,0.0034568614810039353,0.0018992824932803163,0.6452282157676349
340,668,다음/Noun,482,299,183,0.0033234777582642327,0.0020325654752649,0.6203319502074689
341,669,사회/Noun,481,337,144,0.0037458595469399545,0.0015993957838150033,0.7006237006237006
342,670,오/Modifier,481,187,294,0.0020785630126936845,0.0032654330586222983,0.6112266112266113
343,671,네이버/Noun,480,179,301,0.0019896405308672165,0.003343181464779972,0.6270833333333333
344,673,발연기/Noun,477,34,443,0.0003779205477624881,0.004920363418264211,0.9287211740041929
345,674,무슨/Modifier,476,124,352,0.0013782984683102506,0.003909634138214452,0.7394957983193278
346,677,였습니다/Verb,472,394,78,0.004379432229953538,0.0008663393828997934,0.8347457627118644
347,682,ㅉㅉ/KoreanParticle,466,72,394,0.00080030233643821,0.004376124575160495,0.8454935622317596
348,683,없어서/Adjective,466,135,331,0.0015005668808216438,0.003676388919741431,0.7103004291845494
349,685,꿈/Noun,465,353,112,0.003923704510592891,0.0012439744985227805,0.7591397849462366
350,686,재미있어요/Adjective,464,452,12,0.005024120223195429,0.0001332829819845836,0.9741379310344828
351,689,에요/Josa,461,357,104,0.003968165751506125,0.0011551191771997243,0.7744034707158352
352,690,나이/Noun,460,314,146,0.00349020741168886,0.0016216096141457672,0.6826086956521739
353,692,어렸을/Verb,459,394,65,0.004379432229953538,0.0007219494857498278,0.8583877995642701
354,694,이/Foreign,458,326,132,0.003623591134428562,0.0014661128018304194,0.7117903930131004
355,695,하네요/Verb,458,296,162,0.003290131827579308,0.0017993202567918784,0.6462882096069869
356,697,;;;/Punctuation,457,106,351,0.001178222884200698,0.0038985272230490703,0.7680525164113785
357,700,좋은데/Adjective,453,172,281,0.0019118333592690567,0.0031210431614723325,0.6203090507726269
358,703,소설/Noun,449,173,276,0.0019229486694973656,0.003065508585645423,0.6146993318485523
359,705,이라도/Josa,446,106,340,0.001178222884200698,0.0037763511562298687,0.7623318385650224
360,708,시즌/Noun,442,315,127,0.003501322721917169,0.0014105782260035095,0.7126696832579186
361,709,낸/Verb,442,299,143,0.0033234777582642327,0.0015882888686496212,0.6764705882352942
362,712,어설픈/Adjective,437,36,401,0.000400151168219105,0.0044538729813181676,0.9176201372997712
363,715,방송/Noun,436,131,305,0.0014561056399084098,0.0033876091254415,0.6995412844036697
364,721,삼류/Noun,433,33,400,0.00036680523753417966,0.004442766066152787,0.9237875288683602
365,722,잔잔한/Adjective,432,371,61,0.004123780094702443,0.0006775218250882999,0.8587962962962963
366,723,몇번/Noun,431,334,97,0.00371251361625503,0.0010773707710420508,0.7749419953596288
367,726,죽/Noun,428,138,290,0.0015339128115065689,0.00322100539796077,0.677570093457944
368,727,....../Punctuation,427,155,272,0.0017228730853878133,0.003021080924983895,0.6370023419203747
369,728,있지만/Adjective,427,271,156,0.003012249071871596,0.0017326787657995868,0.6346604215456675
370,732,여주/Noun,424,130,294,0.001444990329680101,0.0032654330586222983,0.6933962264150944
371,733,진정한/Adjective,423,309,114,0.003434630860547318,0.001266188328853544,0.7304964539007093
372,735,질질/Noun,419,72,347,0.00080030233643821,0.003854099562387543,0.8281622911694511
373,736,미친/Adjective,419,132,287,0.0014672209501367186,0.0031876846524646245,0.684964200477327
374,737,지/Verb,418,120,298,0.0013338372273970164,0.003309860719283826,0.7129186602870813
375,738,전부/Noun,418,133,285,0.0014783362603650269,0.003165470822133861,0.6818181818181818
376,740,줄거리/Noun,417,136,281,0.0015116821910499524,0.0031210431614723325,0.6738609112709832
377,745,점주/Noun,415,98,317,0.0010893004023742304,0.0035208921074260835,0.763855421686747
378,747,답/Noun,413,100,313,0.0011115310228308473,0.0034764644467645558,0.7578692493946732
379,748,재미있다/Adjective,412,357,55,0.003968165751506125,0.0006108803340960082,0.866504854368932
380,751,좋아/Adjective,409,337,72,0.0037458595469399545,0.0007996978919075017,0.8239608801955991
381,753,낭비/Noun,408,8,400,8.892248182646779e-05,0.004442766066152787,0.9803921568627452
382,754,굉장히/Adjective,408,277,131,0.003078940933241447,0.0014550058866650375,0.678921568627451
383,755,버린/Verb,408,133,275,0.0014783362603650269,0.003054401670480041,0.6740196078431373
384,758,각본/Noun,407,121,286,0.001344952537625325,0.0031765777372992424,0.7027027027027027
385,761,먹/Verb,402,321,81,0.0035680145832870194,0.0008996601283959392,0.7985074626865671
386,762,재/Noun,401,255,146,0.002834404108218661,0.0016216096141457672,0.6359102244389028
387,767,순간/Noun,397,263,134,0.002923326590045128,0.0014883266321611835,0.6624685138539043
388,768,어른/Noun,397,249,148,0.002767712246848809,0.001643823444476531,0.6272040302267002
389,770,갑자기/Noun,396,103,293,0.0011448769535157724,0.003254326143456916,0.73989898989899
390,771,제작/Noun,396,143,253,0.0015894893626481115,0.0028100495368416373,0.6388888888888888
391,773,이하/Noun,395,34,361,0.0003779205477624881,0.00400959637470289,0.9139240506329114
392,776,쳐/Verb,393,97,296,0.0010781850921459217,0.003287646888953062,0.7531806615776081
393,778,간다/Noun,392,151,241,0.0016784118444745793,0.002676766554857054,0.6147959183673469
394,779,하며/Verb,391,248,143,0.0027565969366205013,0.0015882888686496212,0.6342710997442456
395,780,의도/Noun,390,66,324,0.0007336104750683593,0.003598640513583757,0.8307692307692308
396,781,발/Noun,390,81,309,0.0009003401284929863,0.003432036786103028,0.7923076923076923
397,782,영/Noun,390,107,283,0.0011893381944290064,0.0031432569918030968,0.7256410256410256
398,784,나온다/Verb,389,112,277,0.0012449147455705488,0.003076615500810805,0.7120822622107971
399,787,밑/Noun,388,119,269,0.0013227219171687082,0.0029877601794877488,0.6932989690721649
400,789,재미있는/Adjective,387,327,60,0.003634706444656871,0.000666414909922918,0.8449612403100775
401,790,땜/Noun,387,126,261,0.0014005290887668675,0.002898904858164693,0.6744186046511628
402,792,해주는/Verb,386,304,82,0.003379054309405776,0.0009107670435613213,0.7875647668393783
403,793,하네/Verb,385,114,271,0.0012671453660271655,0.003009974009818513,0.7038961038961039
404,794,아버지/Noun,385,261,124,0.0029010959695885113,0.0013772574805073642,0.6779220779220779
405,798,비해/Verb,384,123,261,0.001367183158081942,0.002898904858164693,0.6796875
406,802,봤네요/Verb,381,343,38,0.003812551408309806,0.0004220627762845148,0.9002624671916011
407,803,재밌는데/Adjective,381,339,42,0.003768090167396572,0.00046649043694604257,0.8897637795275591
408,804,좋음/Adjective,381,311,70,0.0034568614810039353,0.0007774840615767378,0.8162729658792651
409,806,볼때/Noun,380,276,104,0.0030678256230131378,0.0011551191771997243,0.7263157894736842
410,809,있어서/Adjective,377,285,92,0.0031678634150679144,0.0010218361952151409,0.7559681697612732
411,812,10년/Number,376,276,100,0.0030678256230131378,0.0011106915165381968,0.7340425531914894
412,815,있을까/Adjective,375,249,126,0.002767712246848809,0.0013994713108381278,0.664
413,817,훌륭한/Adjective,374,295,79,0.0032790165173509998,0.0008774462980651753,0.7887700534759359
414,818,첨/Adverb,374,111,263,0.0012337994353422404,0.002921118688495457,0.7032085561497327
415,819,봐야/Verb,374,262,112,0.0029122112798168195,0.0012439744985227805,0.7005347593582888
416,820,막/Noun,373,133,240,0.0014783362603650269,0.002665659639691672,0.6434316353887399
417,823,모르고/Verb,372,277,95,0.003078940933241447,0.0010551569407112867,0.7446236559139785
418,825,좋네요/Adjective,371,346,25,0.003845897338994731,0.0002776728791345492,0.9326145552560648
419,826,슬픈/Adjective,371,315,56,0.003501322721917169,0.0006219872492613901,0.8490566037735849
420,827,그때/Noun,371,269,102,0.002990018451414979,0.0011329053468689607,0.7250673854447439
421,828,항상/Noun,371,247,124,0.002745481626392193,0.0013772574805073642,0.6657681940700808
422,829,좀비/Noun,370,127,243,0.001411644398995176,0.002698980385187818,0.6567567567567567
423,831,치고/Josa,368,112,256,0.0012449147455705488,0.002843370282337784,0.6956521739130435
424,833,뻔/Noun,367,98,269,0.0010893004023742304,0.0029877601794877488,0.7329700272479565
425,836,거지/Noun,366,99,267,0.0011004157126025386,0.0029655463491569853,0.7295081967213115
426,837,곳/Noun,365,245,120,0.002723251005935576,0.001332829819845836,0.6712328767123288
427,841,없네요/Adjective,362,111,251,0.0012337994353422404,0.002787835706510873,0.6933701657458563
428,843,짱/Suffix,361,320,41,0.003556899273058711,0.00045538352178066063,0.8864265927977839
429,844,성/Modifier,361,130,231,0.001444990329680101,0.0025656974032032343,0.6398891966759003
430,845,진행/Noun,360,97,263,0.0010781850921459217,0.002921118688495457,0.7305555555555555
431,849,이에요/Josa,358,286,72,0.003178978725296223,0.0007996978919075017,0.7988826815642458
432,850,더욱/Noun,358,281,77,0.0031234021741546806,0.0008552324677344116,0.7849162011173184
433,851,tv/Alpha,358,103,255,0.0011448769535157724,0.0028322633671724017,0.7122905027932961
434,852,낫다/Noun,358,124,234,0.0013782984683102506,0.0025990181486993803,0.6536312849162011
435,855,더럽게/Adjective,356,17,339,0.00018896027388124405,0.0037652442410644866,0.952247191011236
436,856,어이/Noun,355,29,326,0.0003223439966209457,0.003620854343914521,0.9183098591549296
437,857,상미/Noun,355,237,118,0.0026343285241091077,0.001310615989515072,0.6676056338028169
438,858,래/Josa,355,138,217,0.0015339128115065689,0.002410200590887887,0.6112676056338028
439,859,참고/Noun,354,65,289,0.0007224951648400508,0.003209898482795389,0.8163841807909604
440,860,중국/Noun,354,122,232,0.0013560678478536335,0.0025768043183686164,0.655367231638418
441,863,몇/Noun,353,222,131,0.0024675988706844808,0.0014550058866650375,0.6288951841359773
442,864,그녀/Noun,352,266,86,0.0029566725207300537,0.0009551947042228492,0.7556818181818182
443,869,대단한/Adjective,348,246,102,0.002734366316163884,0.0011329053468689607,0.7068965517241379
444,870,거기/Noun,348,120,228,0.0013338372273970164,0.0025323766577070887,0.6551724137931034
445,871,깊은/Adjective,347,303,44,0.0033679389991774673,0.0004887042672768067,0.8731988472622478
446,873,굳/Adjective,346,330,16,0.003668052375341796,0.00017771064264611146,0.9537572254335259
447,875,이냐/Josa,345,47,298,0.0005224195807304982,0.003309860719283826,0.8637681159420291
448,877,재미없는/Adjective,344,18,326,0.0002000755841095525,0.003620854343914521,0.9476744186046512
449,878,보는게/Verb,344,55,289,0.000611342062556966,0.003209898482795389,0.8401162790697675
450,879,짜리/Verb,344,134,210,0.001489451570593335,0.002332452184730213,0.6104651162790697
451,880,아까워/Adjective,343,16,327,0.00017784496365293558,0.0036319612590799033,0.9533527696793004
452,881,충분히/Adjective,343,272,71,0.003023364382099905,0.0007885909767421196,0.793002915451895
453,882,어디서/Adverb,343,123,220,0.001367183158081942,0.0024435213363840328,0.641399416909621
454,885,술/Noun,342,58,284,0.0006446879932418914,0.0031543639069684785,0.8304093567251462
455,886,전형/Noun,342,64,278,0.0007113798546117423,0.0030877224159761873,0.8128654970760234
456,887,좋겠다/Adjective,342,240,102,0.002667674454794033,0.0011329053468689607,0.7017543859649122
457,888,따뜻한/Adjective,340,312,28,0.003467976791232243,0.000310993624630695,0.9176470588235294
458,889,편집/Noun,340,103,237,0.0011448769535157724,0.0026323388941955268,0.6970588235294117
459,891,잠/Noun,339,82,257,0.0009114554387212947,0.0028544771975031647,0.7581120943952803
460,892,나옴/Verb,339,83,256,0.0009225707489496033,0.002843370282337784,0.7551622418879056
461,895,해준/Verb,337,275,62,0.00305671031278483,0.0006886287402536821,0.8160237388724035
462,896,하는게/Verb,337,103,234,0.0011448769535157724,0.0025990181486993803,0.6943620178041543
463,897,사건/Noun,337,130,207,0.001444990329680101,0.0022991314392340674,0.6142433234421365
464,899,였어요/Verb,335,281,54,0.0031234021741546806,0.0005997734189306263,0.8388059701492537
465,900,화보/Noun,335,124,211,0.0013782984683102506,0.002343559099895595,0.6298507462686567
466,901,화이팅/Noun,334,296,38,0.003290131827579308,0.0004220627762845148,0.8862275449101796
467,905,새로운/Adjective,332,247,85,0.002745481626392193,0.0009440877890574672,0.7439759036144579
468,906,안된다/Adjective,331,76,255,0.0008447635773514439,0.0028322633671724017,0.770392749244713
469,907,꿀잼/Noun,330,316,14,0.003512438032145477,0.0001554968123153475,0.9575757575757576
470,908,똥/Noun,330,29,301,0.0003223439966209457,0.003343181464779972,0.912121212121212
471,909,그게/Noun,330,91,239,0.001011493230776071,0.0026545527245262907,0.7242424242424242
472,912,중반/Noun,328,125,203,0.001389413778538559,0.002254703778572539,0.6189024390243902
473,913,취향/Noun,328,127,201,0.001411644398995176,0.0022324899482417753,0.6128048780487805
474,916,-_-/Punctuation,327,38,289,0.000422381788675722,0.003209898482795389,0.8837920489296636
475,917,개그/Noun,327,99,228,0.0011004157126025386,0.0025323766577070887,0.6972477064220184
476,921,엉망/Noun,326,22,304,0.00024453682502278637,0.003376502210276118,0.9325153374233128
477,922,병맛/Noun,326,57,269,0.0006335726830135829,0.0029877601794877488,0.8251533742331288
478,923,티/Noun,325,91,234,0.001011493230776071,0.0025990181486993803,0.72
479,928,관/Noun,324,221,103,0.0024564835604561725,0.0011440122620343426,0.6820987654320988
480,929,ㄷㄷ/KoreanParticle,324,200,124,0.0022230620456616945,0.0013772574805073642,0.6172839506172839
481,933,미화/Noun,323,44,279,0.0004890736500455726,0.003098829331141569,0.8637770897832817
482,934,~!!/Punctuation,323,253,70,0.0028121734877620433,0.0007774840615767378,0.7832817337461301
483,935,아닌가/Adjective,323,112,211,0.0012449147455705488,0.002343559099895595,0.6532507739938079
484,936,흥미/Noun,323,125,198,0.001389413778538559,0.0021991692027456293,0.6130030959752322
485,944,흥미진진/Noun,321,276,45,0.0030678256230131378,0.0004998111824421885,0.8598130841121495
486,947,있게/Adjective,320,243,77,0.002701020385478959,0.0008552324677344116,0.759375
487,948,알았다/Verb,320,94,226,0.0010448391614609964,0.002510162827376325,0.70625
488,951,잘만/Noun,318,239,79,0.002656559144565725,0.0008774462980651753,0.7515723270440252
489,952,좋았어요/Adjective,317,311,6,0.0034568614810039353,6.66414909922918e-05,0.9810725552050472
490,953,에겐/Josa,317,194,123,0.0021563701842918434,0.001366150565341982,0.61198738170347
491,955,재밌었다/Adjective,316,296,20,0.003290131827579308,0.00022213830330763932,0.9367088607594936
492,956,만으로도/Josa,316,285,31,0.0031678634150679144,0.00034431437012684104,0.9018987341772152
493,958,괜히/Adverb,315,80,235,0.0008892248182646778,0.002610125063864762,0.7460317460317459
494,959,또한/Noun,315,208,107,0.002311984527488162,0.0011884399226958706,0.6603174603174603
495,960,엄청난/Adjective,315,207,108,0.002300869217259854,0.0011995468378612525,0.6571428571428571
496,961,과거/Noun,315,196,119,0.0021786008047484607,0.0013217229046804538,0.6222222222222222
497,964,그래픽/Noun,314,78,236,0.0008669941978080608,0.002621231979030144,0.7515923566878981
498,965,ost/Alpha,313,265,48,0.002945557210501745,0.0005331319279383344,0.8466453674121406
499,966,기대하고/Adjective,313,53,260,0.000589111442100349,0.002887797942999312,0.8306709265175719
500,967,그냥/Modifier,313,87,226,0.0009670319898628369,0.002510162827376325,0.7220447284345048
501,968,이라니/Josa,313,116,197,0.0012893759864837828,0.0021880622875802475,0.6293929712460063
502,970,그만/Adverb,312,21,291,0.00023342151479447792,0.0032321123131261523,0.9326923076923076
503,971,장/Suffix,312,89,223,0.000989262610319454,0.002476842081880179,0.7147435897435898
504,972,20/Number,312,211,101,0.002345330458173088,0.0011217984317035787,0.6762820512820513
505,973,바보/Noun,311,85,226,0.0009448013694062199,0.002510162827376325,0.7266881028938906
506,974,성우/Noun,310,70,240,0.000778071715981593,0.002665659639691672,0.7741935483870968
507,975,헐/Verb,309,87,222,0.0009670319898628369,0.002465735166714797,0.7184466019417476
508,976,봣/Noun,308,207,101,0.002300869217259854,0.0011217984317035787,0.6720779220779219
509,977,나오고/Verb,307,81,226,0.0009003401284929863,0.002510162827376325,0.7361563517915309
510,978,죽음/Noun,307,206,101,0.0022897539070315448,0.0011217984317035787,0.6710097719869706
511,981,유치/Noun,306,21,285,0.00023342151479447792,0.003165470822133861,0.931372549019608
512,982,나쁜/Adjective,306,100,206,0.0011115310228308473,0.002288024524068685,0.673202614379085
513,983,해도/Verb,306,100,206,0.0011115310228308473,0.002288024524068685,0.673202614379085
514,985,도저히/Noun,305,26,279,0.00028899806593602026,0.003098829331141569,0.9147540983606556
515,986,식/Noun,305,72,233,0.00080030233643821,0.002587911233533998,0.7639344262295082
516,987,속편/Noun,305,99,206,0.0011004157126025386,0.002288024524068685,0.6754098360655738
517,991,울/Noun,304,228,76,0.0025342907320543315,0.0008441255525690295,0.75
518,992,무조건/Noun,304,193,111,0.002145254874063535,0.0012328675833573985,0.6348684210526315
519,993,야할/Adjective,303,233,70,0.002589867283195874,0.0007774840615767378,0.768976897689769
520,994,전달/Noun,303,115,188,0.0012782606762554744,0.0020881000510918103,0.6204620462046204
521,998,하는지/Verb,302,93,209,0.0010337238512326881,0.002321345269564831,0.6920529801324503
522,999,않음/Verb,302,97,205,0.0010781850921459217,0.002276917608903303,0.6788079470198676
523,1001,안됨/Adjective,301,50,251,0.0005557655114154236,0.002787835706510873,0.8338870431893688
524,1002,천재/Noun,301,236,65,0.0026232132138807995,0.0007219494857498278,0.7840531561461794
525,1004,억지로/Noun,300,42,258,0.00046684302958895584,0.002865584112668547,0.86
526,1005,우연히/Adverb,300,258,42,0.0028677500389035857,0.00046649043694604257,0.86
527,1006,같습니다/Adjective,300,233,67,0.002589867283195874,0.0007441633160805918,0.7766666666666666
528,1007,심리/Noun,300,207,93,0.002300869217259854,0.001032943110380523,0.69
529,1009,화가/Noun,299,75,224,0.0008336482671231353,0.0024879489970455605,0.7491638795986622
530,1011,댓글/Noun,297,75,222,0.0008336482671231353,0.002465735166714797,0.7474747474747475
531,1014,완벽한/Adjective,296,254,42,0.002823288797990352,0.00046649043694604257,0.8581081081081081
532,1015,속/Modifier,296,73,223,0.0008114176466665183,0.002476842081880179,0.7533783783783784
533,1019,새끼/Noun,295,80,215,0.0008892248182646778,0.002387986760557123,0.7288135593220338
534,1020,재미있고/Adjective,294,272,22,0.003023364382099905,0.00024435213363840333,0.9251700680272108
535,1021,척/Noun,294,58,236,0.0006446879932418914,0.002621231979030144,0.8027210884353742
536,1022,예고편/Noun,294,69,225,0.0007669564057532844,0.002499055912210943,0.7653061224489796
537,1024,재미없고/Adjective,293,9,284,0.00010003779205477625,0.0031543639069684785,0.969283276450512
538,1025,다가/Noun,293,91,202,0.001011493230776071,0.0022435968634071574,0.6894197952218429
539,1026,최근/Noun,293,195,98,0.002167485494520152,0.001088477686207433,0.6655290102389079
540,1029,현/Modifier,292,181,111,0.0020118711513238334,0.0012328675833573985,0.6198630136986302
541,1030,느끼게/Verb,291,222,69,0.0024675988706844808,0.0007663771464113557,0.7628865979381443
542,1031,good/Alpha,291,213,78,0.0023675610786297045,0.0008663393828997934,0.7319587628865979
543,1032,어느/Modifier,291,104,187,0.001155992263744081,0.002076993135926428,0.6426116838487973
544,1034,불륜/Noun,289,75,214,0.0008336482671231353,0.002376879845391741,0.740484429065744
545,1035,젠/Noun,289,80,209,0.0008892248182646778,0.002321345269564831,0.7231833910034602
546,1037,대작/Noun,288,231,57,0.002567636662739257,0.0006330941644267722,0.8020833333333334
547,1038,짐/Noun,288,189,99,0.002100793633150301,0.0010995846013728146,0.65625
548,1042,재밌어/Adjective,287,234,53,0.0026009825934241826,0.0005886665037652442,0.8153310104529616
549,1043,봤을/Verb,287,177,110,0.0019674099104106,0.0012217606681920164,0.6167247386759582
550,1046,있었다/Adjective,286,213,73,0.0023675610786297045,0.0008108048070728836,0.7447552447552448
551,1047,열/Noun,286,78,208,0.0008669941978080608,0.0023102383543994486,0.7272727272727273
552,1051,2시간/Number,285,95,190,0.0010559544716893046,0.0021103138814225733,0.6666666666666666
553,1055,게임/Noun,284,97,187,0.0010781850921459217,0.002076993135926428,0.6584507042253521
554,1056,행동/Noun,284,103,181,0.0011448769535157724,0.002010351644934136,0.6373239436619719
555,1059,짓/Noun,283,70,213,0.000778071715981593,0.002365772930226359,0.7526501766784452
556,1060,환상/Noun,283,207,76,0.002300869217259854,0.0008441255525690295,0.7314487632508834
557,1061,여/Noun,283,178,105,0.001978525220638908,0.0011662260923651065,0.6289752650176679
558,1063,오래/Adverb,282,230,52,0.002556521352510949,0.0005775595885998622,0.8156028368794326
559,1065,재미없어/Adjective,280,5,275,5.557655114154236e-05,0.003054401670480041,0.9821428571428572
560,1066,그닥/Noun,280,25,255,0.0002778827557077118,0.0028322633671724017,0.9107142857142856
561,1067,귀신/Noun,280,71,209,0.0007891870262099014,0.002321345269564831,0.7464285714285714
562,1068,쓴/Verb,280,75,205,0.0008336482671231353,0.002276917608903303,0.7321428571428571
563,1069,아니면/Adjective,280,78,202,0.0008669941978080608,0.0022435968634071574,0.7214285714285714
564,1070,전설/Noun,280,175,105,0.0019451792899539827,0.0011662260923651065,0.625
565,1073,산/Noun,279,67,212,0.0007447257852966678,0.002354666015060977,0.7598566308243727
566,1074,볼수/Verb,279,203,76,0.00225640797634662,0.0008441255525690295,0.7275985663082437
567,1075,하는거/Verb,279,78,201,0.0008669941978080608,0.0022324899482417753,0.7204301075268817
568,1076,총/Modifier,279,87,192,0.0009670319898628369,0.0021325277117533376,0.6881720430107527
569,1077,회/Noun,279,177,102,0.0019674099104106,0.0011329053468689607,0.6344086021505376
570,1079,재밌었어요/Adjective,277,268,9,0.00297890314118667,9.996223648843771e-05,0.967509025270758
571,1080,전작/Noun,277,72,205,0.00080030233643821,0.002276917608903303,0.740072202166065
572,1081,총/Noun,277,85,192,0.0009448013694062199,0.0021325277117533376,0.6931407942238267
573,1083,♡/Foreign,276,264,12,0.0029344419002734373,0.0001332829819845836,0.9565217391304348
574,1085,현재/Noun,275,205,70,0.002278638596803237,0.0007774840615767378,0.7454545454545455
575,1088,놔/Verb,274,53,221,0.000589111442100349,0.0024546282515494145,0.8065693430656934
576,1089,울/Modifier,274,178,96,0.001978525220638908,0.0010662638558766688,0.6496350364963503
577,1090,제작비/Noun,273,38,235,0.000422381788675722,0.002610125063864762,0.8608058608058609
578,1091,예요/Josa,273,206,67,0.0022897539070315448,0.0007441633160805918,0.7545787545787546
579,1092,스러운/Josa,273,89,184,0.000989262610319454,0.0020436723904302817,0.6739926739926739
580,1093,다행/Noun,273,104,169,0.001155992263744081,0.0018770686629495524,0.6190476190476191
581,1094,흠/Noun,272,105,167,0.0011671075739723895,0.0018548548326187888,0.6139705882352942
582,1098,통해/Noun,271,217,54,0.0024120223195429388,0.0005997734189306263,0.8007380073800738
583,1099,노/Noun,271,96,175,0.0010670697819176133,0.0019437101539418445,0.6457564575645757
584,1103,짜/Verb,269,92,177,0.0010226085410043797,0.001965923984272608,0.6579925650557621
585,1107,망작/Noun,268,16,252,0.00017784496365293558,0.002798942621676256,0.9402985074626866
586,1108,좋았음/Adjective,268,241,27,0.0026787897650223423,0.0002998867094653131,0.8992537313432836
587,1109,맞는/Verb,268,95,173,0.0010559544716893046,0.0019214963236110802,0.6455223880597015
588,1110,먹고/Verb,268,101,167,0.0011226463330591557,0.0018548548326187888,0.6231343283582089
589,1114,좋았습니다/Adjective,267,258,9,0.0028677500389035857,9.996223648843771e-05,0.9662921348314608
590,1115,되었다/Verb,267,201,66,0.0022341773558900027,0.0007330564009152097,0.7528089887640449
591,1116,가끔/Noun,267,174,93,0.0019340639797256738,0.001032943110380523,0.651685393258427
592,1117,만의/Josa,267,167,100,0.001856256808127515,0.0011106915165381968,0.6254681647940075
593,1118,안되고/Adjective,266,10,256,0.00011115310228308472,0.002843370282337784,0.962406015037594
594,1119,동화/Noun,266,189,77,0.002100793633150301,0.0008552324677344116,0.7105263157894737
595,1120,80년/Number,266,82,184,0.0009114554387212947,0.0020436723904302817,0.6917293233082706
596,1123,100/Number,265,171,94,0.001900718049040749,0.0010440500255459052,0.6452830188679245
597,1124,묘사/Noun,265,170,95,0.0018896027388124407,0.0010551569407112867,0.6415094339622641
598,1127,지루하지/Adjective,264,251,13,0.0027899428673054264,0.00014438989714996554,0.9507575757575758
599,1128,예산/Noun,264,65,199,0.0007224951648400508,0.0022102761179110114,0.7537878787878788
600,1129,으/Adverb,263,97,166,0.0010781850921459217,0.0018437479174534066,0.6311787072243346
601,1130,여러/Modifier,263,165,98,0.0018340261876708976,0.001088477686207433,0.6273764258555133
602,1135,채널/Noun,262,82,180,0.0009114554387212947,0.001999244729768754,0.6870229007633588
603,1136,살인/Noun,262,97,165,0.0010781850921459217,0.0018326410022880247,0.6297709923664122
604,1137,긴/Verb,262,161,101,0.001789564946757664,0.0011217984317035787,0.6145038167938931
605,1142,감사합니다/Verb,260,241,19,0.0026787897650223423,0.00021103138814225735,0.926923076923077
606,1143,유치하고/Adjective,260,21,239,0.00023342151479447792,0.0026545527245262907,0.9192307692307692
607,1144,보고싶다/Verb,260,227,33,0.0025231754218260232,0.00036652820045760486,0.8730769230769231
608,1145,느낄/Verb,260,207,53,0.002300869217259854,0.0005886665037652442,0.7961538461538461
609,1146,강/Noun,260,197,63,0.002189716114976769,0.0006997356554190639,0.7576923076923077
610,1149,아닐까/Adjective,259,191,68,0.0021230242536069183,0.0007552702312459737,0.7374517374517374
611,1154,유치한/Adjective,258,42,216,0.00046684302958895584,0.002399093675722505,0.8372093023255814
612,1155,졸라/Noun,258,75,183,0.0008336482671231353,0.0020325654752649,0.7093023255813954
613,1156,아니지만/Adjective,258,177,81,0.0019674099104106,0.0008996601283959392,0.686046511627907
614,1159,개/Suffix,257,79,178,0.0008781095080363692,0.0019770308994379896,0.6926070038910506
615,1164,만들/Verb,256,53,203,0.000589111442100349,0.002254703778572539,0.79296875
616,1165,외/Noun,256,70,186,0.000778071715981593,0.002065886220761046,0.7265625
617,1166,서로/Noun,256,161,95,0.001789564946757664,0.0010551569407112867,0.62890625
618,1169,낚/Noun,254,20,234,0.00022230620456616945,0.0025990181486993803,0.9212598425196852
619,1170,진부한/Adjective,254,38,216,0.000422381788675722,0.002399093675722505,0.8503937007874016
620,1171,이상한/Adjective,254,63,191,0.0007002645443834338,0.0021214207965879555,0.7519685039370079
621,1172,경찰/Noun,254,98,156,0.0010893004023742304,0.0017326787657995868,0.6141732283464567
622,1175,보시길/Verb,253,193,60,0.002145254874063535,0.000666414909922918,0.7628458498023716
623,1176,모/Noun,253,66,187,0.0007336104750683593,0.002076993135926428,0.7391304347826086
624,1180,좋았고/Adjective,252,235,17,0.002612097903652491,0.00018881755781149343,0.9325396825396826
625,1181,해요/Verb,252,204,48,0.0022675232865749283,0.0005331319279383344,0.8095238095238095
626,1182,있나/Adjective,252,68,184,0.0007558410955249762,0.0020436723904302817,0.7301587301587301
627,1183,만들었다/Verb,252,170,82,0.0018896027388124407,0.0009107670435613213,0.6746031746031746
628,1184,런가/Noun,252,97,155,0.0010781850921459217,0.0017215718506342046,0.6150793650793651
629,1185,반개/Noun,251,5,246,5.557655114154236e-05,0.002732301130683964,0.9800796812749004
630,1186,하냐/Verb,251,23,228,0.00025565213525109487,0.0025323766577070887,0.9083665338645418
631,1187,짱/VerbPrefix,251,225,26,0.0025009448013694068,0.00028877979429993113,0.896414342629482
632,1188,필요없다/Adjective,251,214,37,0.0023786763888580128,0.0004109558611191328,0.852589641434263
633,1189,지루/Noun,250,21,229,0.00023342151479447792,0.0025434835728724704,0.9159999999999999
634,1190,싫다/Adjective,250,23,227,0.00025565213525109487,0.0025212697425417065,0.9079999999999999
635,1191,나왔으면/Verb,250,175,75,0.0019451792899539827,0.0008330186374036475,0.7
