,Unnamed: 0,parameter,counts,counts_H,counts_NH,p_from_H,p_from_NH,priority
0,9,은/Josa,19690,7739,11951,0.08602138585687928,0.13273874314147988,0.6069578466226511
1,15,이/Determiner,12373,4495,7878,0.04996331947624658,0.08750027767287913,0.6367089630647378
2,17,?/Punctuation,11319,3302,8017,0.036702754373874574,0.08904413888086722,0.7082781164413817
3,18,정말/Noun,10702,7082,3620,0.0787186270368806,0.04020703289868272,0.6617454681367969
4,19,것/Noun,10293,4088,6205,0.045439388213325035,0.06891840860119511,0.6028368794326241
5,22,적/Suffix,9003,5486,3517,0.060978591912500275,0.039063020636648384,0.6093524380761969
6,24,!/Punctuation,8565,6415,2150,0.07130471511459885,0.023879867605571228,0.7489784004670169
7,28,만/Josa,7745,2412,5333,0.026810128270680036,0.05923317857698202,0.6885732730794061
8,31,과/Josa,6768,4231,2537,0.04702887757597315,0.02817824377457405,0.6251477541371159
9,32,최고/Noun,6671,6143,528,0.06828135073249894,0.005864451207321679,0.9208514465597362
10,34,왜/Noun,6247,2241,4006,0.024909410221639287,0.04449430215252016,0.6412678085481031
11,35,스토리/Noun,6075,2176,3899,0.02418691505679924,0.043305862229824285,0.6418106995884774
12,37,생각/Noun,6005,3771,2234,0.04191583487095125,0.024812848479463315,0.6279766860949209
13,38,~/Punctuation,6003,4016,1987,0.04463908587688682,0.02206944043361397,0.6689988339163752
14,42,감동/Noun,5597,4442,1155,0.04937420803414623,0.012828487016016172,0.7936394497051992
15,43,..../Punctuation,5580,2218,3362,0.02465375808638819,0.03734144878601417,0.6025089605734767
16,45,1/Number,5284,1409,3875,0.015661472111686642,0.04303929626585512,0.7333459500378501
17,50,드라마/Noun,5005,3017,1988,0.033534890958806664,0.02208054734877935,0.6027972027972028
18,52,때/Noun,4940,3220,1720,0.03579129893515328,0.019103894084456983,0.6518218623481782
19,57,감독/Noun,4688,1515,3173,0.016839694995887337,0.03524224181975698,0.6768344709897611
20,58,ㅋㅋ/KoreanParticle,4594,2777,1817,0.030867216504012626,0.020181264855499037,0.6044841097083152
21,59,재미/Noun,4538,1752,2786,0.019474023519996442,0.030943865650754163,0.6139268400176289
22,60,내용/Noun,4529,1407,3122,0.01563924149123002,0.0346757891463225,0.6893353941267388
23,61,뭐/Noun,4491,831,3660,0.009236822799724341,0.040651309505298,0.8149632598530394
24,62,못/VerbPrefix,4418,1474,2944,0.016383967276526686,0.032698758246884514,0.666364870982345
25,63,그냥/Noun,4406,1187,3219,0.013193873241002156,0.03575315991736455,0.7305946436677259
26,66,게/Josa,4340,1723,2617,0.019151679523375497,0.029066796987804608,0.6029953917050691
27,67,안/VerbPrefix,4262,1318,2944,0.014649978880910566,0.032698758246884514,0.6907555138432661
28,69,좀/Noun,4111,1455,2656,0.016172776382188826,0.029499966679254506,0.6460715154463634
29,71,없는/Adjective,4090,1373,2717,0.015261320943467532,0.0301774885043428,0.6643031784841076
30,73,!!/Punctuation,4005,3088,917,0.03432407798501656,0.010185041206655265,0.7710362047440699
31,74,시간/Noun,3956,1077,2879,0.011971189115888223,0.03197680876113468,0.7277553083923155
32,76,쓰레기/Noun,3739,209,3530,0.002323099837716471,0.03920741053379834,0.9441027012570206
33,78,수/Noun,3698,2475,1223,0.02751039281506347,0.013583757247262143,0.6692806922660898
34,80,아/Exclamation,3469,1327,2142,0.014750016672965344,0.02379101228424817,0.6174690112424329
35,83,없다/Adjective,3324,873,2451,0.009703665829313295,0.0272230490703512,0.7373646209386282
36,84,작품/Noun,3308,2050,1258,0.02278638596803237,0.013972499278050514,0.6197097944377267
37,85,다시/Noun,3289,2763,526,0.030711602160816313,0.005842237376990914,0.8400729705077531
38,86,잘/Verb,3274,2363,911,0.02626547806949292,0.010118399715662972,0.7217470983506414
39,87,10/Number,3248,2158,1090,0.023986839472689682,0.012106537530266344,0.6644088669950738
40,88,마지막/Noun,3201,2151,1050,0.023909032301091523,0.011662260923651064,0.6719775070290535
41,90,사랑/Noun,3190,2523,667,0.028043927706022275,0.007408312415309772,0.7909090909090909
42,91,잘/VerbPrefix,3151,2150,1001,0.023897916990863216,0.011118022080547348,0.682323072040622
43,92,본/Verb,3099,1949,1150,0.02166373963497321,0.012772952440189262,0.6289125524362698
44,95,요/Josa,3013,1950,1063,0.021674854945201518,0.011806650820801031,0.6471954862263525
45,96,좋은/Adjective,3009,2156,853,0.023964608852233067,0.009474198636070815,0.7165171153207045
46,99,나/Josa,2916,1029,1887,0.011437654224929416,0.02095874891707577,0.647119341563786
47,101,있는/Adjective,2899,2055,844,0.02284196251917391,0.00937423639958238,0.7088651259054847
48,102,입니다/Adjective,2888,2167,721,0.02408687726474446,0.008008085834240399,0.7503462603878116
49,106,주인공/Noun,2708,1083,1625,0.012037880977258077,0.01804873714374569,0.6000738552437223
50,111,중/Suffix,2597,1568,1029,0.017428806437987686,0.011429015705178043,0.6037735849056604
51,112,지금/Noun,2596,1843,753,0.020485516750772512,0.00836350711953262,0.7099383667180277
52,113,ㅠㅠ/KoreanParticle,2589,1842,747,0.0204744014405442,0.00829686562854033,0.7114716106604867
53,114,최악/Noun,2549,32,2517,0.00035568992730587116,0.02795610547126641,0.9874460572773636
54,115,지/Josa,2511,993,1518,0.011037503056710312,0.016860297221049824,0.6045400238948626
55,117,재밌게/Adjective,2508,2195,313,0.024398105951137096,0.0034764644467645558,0.8751993620414673
56,118,걸/Noun,2493,777,1716,0.008636596047395683,0.019059466423795454,0.6883273164861613
57,119,3/Number,2481,918,1563,0.010203854789587177,0.017360108403492013,0.6299879081015719
58,121,연출/Noun,2454,975,1479,0.010837427472600759,0.01642712752959993,0.6026894865525673
59,122,별로/Noun,2438,320,2118,0.003556899273058711,0.02352444632027901,0.8687448728465955
60,123,끝/Noun,2438,862,1576,0.009581397416801902,0.01750449830064198,0.6464315012305168
61,124,돈/Noun,2433,279,2154,0.003101171553698064,0.02392429526623276,0.8853267570900123
62,129,그리고/Conjunction,2339,1419,920,0.015772625213969722,0.010218361952151409,0.6066695168875588
63,130,역시/Noun,2323,1623,700,0.01804014850054465,0.007774840615767376,0.6986655187257856
64,131,봐도/Verb,2322,1795,527,0.01995198185981371,0.0058533442921562965,0.773040482342808
65,132,개/Noun,2277,671,1606,0.007458373163194984,0.01783770575560344,0.7053140096618358
66,133,명작/Noun,2259,1976,283,0.02196385301113754,0.0031432569918030968,0.8747233289065959
67,134,이런/Modifier,2201,819,1382,0.00910343907698464,0.01534975675855788,0.6278964107223989
68,137,^^/Punctuation,2162,1921,241,0.021352510948580573,0.002676766554857054,0.8885291396854764
69,138,라고/Josa,2147,777,1370,0.008636596047395683,0.015216473776573296,0.6380996739636703
70,139,ㅡㅡ/KoreanParticle,2128,211,1917,0.002345330458173088,0.02129195637203723,0.9008458646616542
71,140,없고/Adjective,2122,205,1917,0.002278638596803237,0.02129195637203723,0.9033930254476908
72,145,때문/Noun,2060,810,1250,0.009003401284929862,0.013883643956727459,0.6067961165048543
73,146,!!!/Punctuation,2038,1392,646,0.01547251183780539,0.00717506719683675,0.6830225711481845
74,147,또/Noun,2013,1348,665,0.014983438187759818,0.007386098584979008,0.6696472925981123
75,150,아깝다/Adjective,1949,47,1902,0.0005224195807304982,0.021125352644556502,0.9758850692662904
76,151,여자/Noun,1944,757,1187,0.008414289842829513,0.013183908301308394,0.61059670781893
77,152,난/Noun,1928,1196,732,0.01329391103305693,0.0081302619010596,0.6203319502074689
78,153,꼭/Noun,1920,1594,326,0.0177178045039237,0.003620854343914521,0.8302083333333333
79,161,마음/Noun,1810,1497,313,0.016639619411777783,0.0034764644467645558,0.8270718232044199
80,162,인생/Noun,1810,1304,506,0.014494364537714247,0.0056200990736832756,0.7204419889502762
81,165,기억/Noun,1794,1237,557,0.01374963875241758,0.006186551747117756,0.6895206243032329
82,169,ㅎㅎ/KoreanParticle,1744,1498,246,0.01665073472200609,0.002732301130683964,0.8589449541284404
83,171,못/Noun,1720,544,1176,0.00604672876419981,0.013061732234489191,0.6837209302325581
84,173,소재/Noun,1714,594,1120,0.0066024942756152324,0.012439744985227805,0.6534422403733956
85,174,이나/Josa,1704,527,1177,0.005857768490318565,0.013072839149654573,0.6907276995305164
86,176,애/Noun,1670,576,1094,0.00640241869150568,0.012150965190927872,0.6550898203592814
87,178,수준/Noun,1658,273,1385,0.003034479692328213,0.015383077504054024,0.8353437876960192
88,179,한번/Noun,1640,1136,504,0.012626992419358423,0.005597885243352511,0.6926829268292682
89,181,네/Josa,1608,469,1139,0.0052130804970766725,0.01265077637337006,0.7083333333333334
90,182,넘/Verb,1591,1126,465,0.01251583931707534,0.005164715551902614,0.7077309868007542
91,184,현실/Noun,1587,1041,546,0.01157103794766912,0.006064375680298554,0.6559546313799622
92,185,전개/Noun,1586,418,1168,0.004646199675432942,0.012972876913166138,0.7364438839848676
93,186,매력/Noun,1586,1153,433,0.012815952693239669,0.00480929426661039,0.7269861286254728
94,188,가슴/Noun,1575,1376,199,0.015294666874152455,0.0022102761179110114,0.8736507936507937
95,189,하게/Verb,1574,1130,444,0.012560300557988574,0.004931470333429593,0.7179161372299873
96,190,되는/Verb,1569,977,592,0.010859658093057377,0.006575293777906124,0.6226896112173359
97,191,~~/Punctuation,1556,1038,518,0.011537692016984194,0.00575338205566786,0.6670951156812339
98,192,야/Josa,1543,373,1170,0.00414601071515906,0.012995090743496902,0.7582631237848347
99,194,님/Suffix,1536,948,588,0.010537314096436429,0.006530866117244597,0.6171875
100,196,가장/Noun,1534,1006,528,0.011182002089678324,0.005864451207321679,0.6558018252933507
101,197,;;/Punctuation,1523,373,1150,0.00414601071515906,0.012772952440189262,0.7550886408404465
102,199,??/Punctuation,1503,455,1048,0.005057466153880355,0.011640047093320302,0.697272122421823
103,204,음악/Noun,1452,1077,375,0.011971189115888223,0.0041650931870182385,0.7417355371900827
104,206,성/Suffix,1445,496,949,0.0055131938732410025,0.010540462491947487,0.6567474048442906
105,207,만든/Verb,1445,521,924,0.005791076628948714,0.010262789612812935,0.6394463667820071
106,208,아이/Noun,1436,944,492,0.010492852855523198,0.005464602261367928,0.6573816155988857
107,211,봤다/Verb,1414,872,542,0.009692550519084988,0.006019948019637026,0.6166902404526167
108,213,무슨/Noun,1408,215,1193,0.002389791699086321,0.013250549792300687,0.8473011363636364
109,214,추천/Noun,1403,1037,366,0.011526576706755885,0.0040651309505298,0.7391304347826086
110,215,만/Noun,1401,947,454,0.010526198786208123,0.005042539485083413,0.6759457530335474
111,216,냐/Josa,1392,169,1223,0.001878487428584132,0.013583757247262143,0.8785919540229885
112,217,인지/Josa,1383,425,958,0.004724006847031101,0.010640424728435923,0.6926970354302241
113,218,게/Noun,1380,485,895,0.005390925460729609,0.009940689073016859,0.6485507246376812
114,219,눈물/Noun,1378,1156,222,0.012849298623924595,0.002465735166714797,0.8388969521044993
115,220,인가/Josa,1378,446,932,0.004957428361825579,0.010351644934135993,0.6763425253991292
116,222,번/Noun,1370,945,425,0.010503968165751507,0.004720438945287336,0.6897810218978102
117,223,ㅠ/KoreanParticle,1361,899,462,0.009992663895249316,0.005131394806406469,0.6605437178545187
118,224,합니다/Verb,1360,1010,350,0.011226463330591557,0.003887420307883689,0.7426470588235294
119,226,저/Determiner,1355,471,884,0.005235311117533291,0.009818513006197658,0.6523985239852399
120,227,우리/Noun,1346,996,350,0.011070848987395238,0.003887420307883689,0.7399702823179792
121,228,인간/Noun,1346,839,507,0.009325745281550809,0.005631205988848657,0.6233283803863299
122,229,네/Suffix,1337,913,424,0.010148278238445637,0.004709332030121954,0.6828721017202692
123,234,속/Noun,1307,819,488,0.00910343907698464,0.005420174600706399,0.6266258607498087
124,237,재밌다/Adjective,1294,1174,120,0.013049374208034144,0.001332829819845836,0.9072642967542504
125,239,원작/Noun,1275,429,846,0.0047684680879443355,0.009396450229913143,0.6635294117647059
126,240,솔직히/Adjective,1253,412,841,0.0045795078140630895,0.009340915654086237,0.6711891460494812
127,244,좋다/Adjective,1236,1070,166,0.011893381944290064,0.0018437479174534066,0.8656957928802589
128,245,코미디/Noun,1235,485,750,0.005390925460729609,0.008330186374036475,0.6072874493927125
129,248,있다/Adjective,1212,777,435,0.008636596047395683,0.0048315080969411565,0.6410891089108911
130,249,여운/Noun,1210,1139,71,0.01266033835004335,0.0007885909767421196,0.9413223140495868
131,251,움/Noun,1204,432,772,0.00480181401862926,0.00857453850767488,0.6411960132890365
132,253,전혀/Noun,1199,338,861,0.003756974857168264,0.009563053957393873,0.7180984153461217
133,254,기대/Noun,1198,745,453,0.008280906120089812,0.005031432569918031,0.6218697829716193
134,255,모두/Noun,1194,810,384,0.009003401284929862,0.004265055423506675,0.6783919597989949
135,256,대박/Noun,1180,975,205,0.010837427472600759,0.002276917608903303,0.826271186440678
136,257,대한/Noun,1173,715,458,0.007947446813240557,0.005086967145744941,0.6095481670929241
137,259,씨/Suffix,1170,706,464,0.007847409021185782,0.005153608636737233,0.6034188034188034
138,261,별/Noun,1164,304,860,0.003379054309405776,0.009551947042228491,0.7388316151202751
139,262,계속/Noun,1161,707,454,0.007858524331414091,0.005042539485083413,0.6089577950043066
140,263,굿/Noun,1156,1072,84,0.01191561256474668,0.0009329808738920851,0.9273356401384084
141,267,모습/Noun,1142,842,300,0.009359091212235734,0.00333207454961459,0.7373029772329247
142,268,별/Modifier,1142,316,826,0.003512438032145477,0.009174311926605505,0.7232924693520141
143,273,허/Verb,1121,125,996,0.001389413778538559,0.011062487504720437,0.8884924174843889
144,274,실망/Noun,1118,115,1003,0.0012782606762554744,0.011140235910878113,0.8971377459749553
145,277,요/Noun,1099,666,433,0.007402796612053442,0.00480929426661039,0.6060054595086443
146,279,일본/Noun,1098,391,707,0.0043460862992686115,0.00785258902192505,0.6438979963570127
147,280,보지/Noun,1094,324,770,0.0036013605139719454,0.008552324677344115,0.7038391224862889
148,281,진심/Noun,1094,415,679,0.004612853744748016,0.007541595397294354,0.6206581352833638
149,284,재미있게/Adjective,1086,979,107,0.010881888713513994,0.0011884399226958706,0.9014732965009208
150,289,일/Modifier,1074,387,687,0.004301625058355379,0.007630450718617411,0.6396648044692738
151,291,제목/Noun,1073,405,668,0.004501700642464931,0.007419419330475155,0.6225535880708295
152,292,였다/Verb,1071,709,362,0.007880754951870706,0.004020703289868272,0.6619981325863679
153,293,없음/Adjective,1069,179,890,0.0019896405308672165,0.00988515449718995,0.8325537885874649
154,294,많은/Adjective,1069,790,279,0.008781095080363692,0.003098829331141569,0.7390084190832554
155,298,봤습니다/Verb,1059,961,98,0.010681813129404442,0.001088477686207433,0.9074598677998112
156,303,뿐/Noun,1051,311,740,0.0034568614810039353,0.008219117222382655,0.7040913415794482
157,306,재밌어요/Adjective,1049,1012,37,0.011248693951048171,0.0004109558611191328,0.9647283126787416
158,307,ㅎ/KoreanParticle,1048,840,208,0.009336860591779116,0.0023102383543994486,0.8015267175572519
159,308,;/Punctuation,1045,287,758,0.0031900940355245318,0.008419041695359529,0.7253588516746412
160,309,보다/Verb,1045,365,680,0.004057088233332592,0.0075527023124597375,0.6507177033492823
161,310,표현/Noun,1042,681,361,0.007569526265478068,0.00400959637470289,0.6535508637236085
162,312,아니다/Adjective,1036,293,743,0.0032567858968943824,0.008252437967878801,0.7171814671814671
163,313,재미없다/Adjective,1035,22,1013,0.00024453682502278637,0.01125130506253193,0.978743961352657
164,314,OO/Alpha,1033,220,813,0.002445368250227864,0.009029922029455541,0.7870280735721199
165,316,가족/Noun,1031,710,321,0.007891870262099015,0.0035653197680876117,0.6886517943743938
166,319,요즘/Noun,1013,643,370,0.007147144476802349,0.004109558611191328,0.6347482724580454
167,321,점도/Noun,1011,91,920,0.001011493230776071,0.010218361952151409,0.9099901088031652
168,326,용/Noun,999,295,704,0.0032790165173509998,0.007819268276428905,0.7047047047047047
169,328,ㅜㅜ/KoreanParticle,996,633,363,0.007035991374519263,0.0040318102050336535,0.6355421686746988
170,329,모든/Noun,986,630,356,0.0070026454438343365,0.003954061798875979,0.6389452332657201
171,330,4/Number,981,333,648,0.003701398306026721,0.0071972810271675155,0.6605504587155964
172,332,급/Noun,974,237,737,0.0026343285241091077,0.00818579647688651,0.7566735112936345
173,334,하다/Verb,970,367,603,0.0040793188537892105,0.0066974698447253254,0.6216494845360825
174,335,조금/Noun,967,582,385,0.006469110552875531,0.004276162338672057,0.6018614270941055
175,336,특히/Adverb,966,665,301,0.007391681301825134,0.003343181464779972,0.6884057971014492
176,340,개인/Noun,957,633,324,0.007035991374519263,0.003598640513583757,0.6614420062695925
177,344,공포/Noun,951,319,632,0.0035457839628304025,0.007019570384521403,0.6645636172450052
178,347,건지/Verb,933,160,773,0.0017784496365293556,0.008585645422840259,0.8285101822079314
179,348,건/Noun,932,292,640,0.0032456705866660733,0.007108425705844459,0.6866952789699571
180,349,한테/Josa,931,317,614,0.003523553342373785,0.006819645911544527,0.6595059076262084
181,350,작가/Noun,929,209,720,0.002323099837716471,0.007996978919075016,0.77502691065662
182,351,이유/Noun,928,364,564,0.004045972923104284,0.006264300153275429,0.6077586206896551
183,352,나름/Noun,923,600,323,0.006669186136985084,0.003587533598418375,0.6500541711809318
184,355,아까운/Adjective,917,63,854,0.0007002645443834338,0.0094853055512362,0.931297709923664
185,356,아니고/Adjective,914,147,767,0.0016339506035613453,0.008519003931847971,0.8391684901531729
186,357,보다가/Verb,913,186,727,0.0020674477024653763,0.00807472732523269,0.7962760131434831
187,358,욕/Noun,910,166,744,0.0018451414978992067,0.008263544883044184,0.8175824175824176
188,359,차라리/Noun,909,59,850,0.0006558033034701999,0.009440877890574672,0.935093509350935
189,360,노래/Noun,909,604,305,0.006713647377898317,0.0033876091254415,0.6644664466446645
190,362,짱/Noun,905,842,63,0.009359091212235734,0.0006997356554190639,0.9303867403314916
191,363,중간/Noun,905,328,577,0.0036458217548851783,0.0064086900504253955,0.6375690607734806
192,364,알바/Noun,897,104,793,0.001155992263744081,0.0088077837261479,0.8840579710144928
193,366,아름다운/Adjective,890,799,91,0.008881132872418469,0.001010729280049759,0.8977528089887641
194,367,0/Number,888,77,811,0.0008558788875797522,0.009007708199124777,0.9132882882882885
195,369,삶/Noun,883,770,113,0.008558788875797524,0.0012550814136881624,0.8720271800679502
196,372,...../Punctuation,877,327,550,0.003634706444656871,0.006108803340960082,0.6271379703534777
197,373,제/Noun,874,553,321,0.006146766556254586,0.0035653197680876117,0.6327231121281465
198,374,오랜/Modifier,870,699,171,0.007769601849587622,0.0018992824932803163,0.8034482758620691
199,375,기/Noun,869,240,629,0.002667674454794033,0.006986249639025257,0.7238204833141542
200,376,보게/Verb,865,698,167,0.007758486539359314,0.0018548548326187888,0.8069364161849711
201,378,당시/Noun,862,550,312,0.00611342062556966,0.0034653575315991736,0.6380510440835266
202,379,점수/Noun,857,271,586,0.003012249071871596,0.006508652286913832,0.6837806301050176
203,382,보세요/Verb,847,583,264,0.006480225863103839,0.0029322256036608393,0.6883116883116883
204,384,놈/Noun,846,250,596,0.002778827557077118,0.006619721438567652,0.7044917257683215
205,385,봤어요/Verb,843,794,49,0.008825556321276927,0.0005442388431037163,0.9418742586002372
206,386,아직도/Adverb,841,631,210,0.0070137607540626465,0.002332452184730213,0.7502972651605232
207,387,막장/Noun,834,144,690,0.00160060467287642,0.007663771464113556,0.8273381294964028
208,391,세상/Noun,824,533,291,0.005924460351688416,0.0032321123131261523,0.6468446601941747
209,393,좋고/Adjective,819,740,79,0.008225329568948269,0.0008774462980651753,0.9035409035409036
210,397,공포영화/Noun,809,293,516,0.0032567858968943824,0.005731168225337095,0.6378244746600742
211,400,도대체/Noun,805,101,704,0.0011226463330591557,0.007819268276428905,0.8745341614906832
212,402,앞/Noun,797,485,312,0.005390925460729609,0.0034653575315991736,0.6085319949811794
213,403,재밌음/Adjective,795,735,60,0.008169753017806727,0.000666414909922918,0.9245283018867924
214,404,뻔한/Adjective,795,199,596,0.002211946735433386,0.006619721438567652,0.7496855345911949
215,405,좋아하는/Adjective,792,528,264,0.0058688838005468745,0.0029322256036608393,0.6666666666666666
216,406,류/Noun,790,141,649,0.0015672587421914947,0.007208387942332897,0.8215189873417722
217,407,나도/Verb,790,498,292,0.005535424493697619,0.0032432192282915344,0.6303797468354431
218,411,있고/Adjective,787,619,168,0.006880377031322943,0.0018659617477841703,0.7865311308767471
219,412,절대/Noun,787,263,524,0.002923326590045128,0.005820023546660151,0.6658195679796697
220,413,뭘/Noun,782,175,607,0.0019451792899539827,0.006741897505386854,0.7762148337595908
221,415,물/Noun,777,295,482,0.0032790165173509998,0.005353533109714108,0.6203346203346203
222,419,수작/Noun,766,696,70,0.007736255918902695,0.0007774840615767378,0.908616187989556
223,420,엄청/Adverb,766,465,301,0.00516861925616344,0.003343181464779972,0.6070496083550914
224,421,걍/Adverb,765,208,557,0.002311984527488162,0.006186551747117756,0.7281045751633987
225,422,설정/Noun,762,139,623,0.0015450281217348775,0.006919608148032965,0.8175853018372703
226,423,초반/Noun,761,265,496,0.002945557210501745,0.005509029922029457,0.6517739816031537
227,424,된다/Verb,761,462,299,0.005135273325478514,0.0033209676344492078,0.607095926412615
228,427,준다/Verb,748,271,477,0.003012249071871596,0.005297998533887197,0.6377005347593583
229,428,주고/Verb,747,183,564,0.0020341017717804503,0.006264300153275429,0.7550200803212851
230,429,남는/Verb,744,598,146,0.006646955516528465,0.0016216096141457672,0.803763440860215
231,430,시나리오/Noun,742,207,535,0.002300869217259854,0.005942199613479352,0.7210242587601078
232,431,딱/Adverb,742,251,491,0.0027899428673054264,0.005453495346202546,0.6617250673854448
233,435,출연/Noun,740,226,514,0.0025120601115977146,0.005708954395006331,0.6945945945945946
234,437,좋았다/Adjective,733,600,133,0.006669186136985084,0.0014772197169958016,0.8185538881309686
235,438,관객/Noun,732,188,544,0.0020896783229219927,0.00604216184996779,0.7431693989071039
236,439,주는/Verb,731,477,254,0.005302002978903141,0.0028211564520070195,0.6525307797537621
237,441,안되는/Adjective,730,161,569,0.001789564946757664,0.006319834729102339,0.7794520547945205
238,443,가지/Noun,725,278,447,0.003090056243469755,0.004964791078925739,0.616551724137931
239,444,노잼/Noun,724,17,707,0.00018896027388124405,0.00785258902192505,0.9765193370165746
240,446,뭔/Modifier,722,104,618,0.001155992263744081,0.006864073572206054,0.8559556786703602
241,447,분위기/Noun,721,443,278,0.004924082431140653,0.0030877224159761873,0.6144244105409153
242,448,시대/Noun,719,474,245,0.0052686570482182145,0.002721194215518582,0.6592489568845619
243,450,장난/Noun,714,182,532,0.002022986461552142,0.005908878867983206,0.7450980392156863
244,451,최고다/Noun,711,679,32,0.007547295645021453,0.00035542128529222287,0.9549929676511956
245,452,봤던/Verb,711,560,151,0.006224573727852744,0.001677144189972677,0.7876230661040787
246,454,OOO/Alpha,708,91,617,0.001011493230776071,0.006852966657040674,0.8714689265536724
247,455,같아요/Adjective,708,559,149,0.006213458417624436,0.001654930359641913,0.7895480225988699
248,456,결국/Adverb,708,253,455,0.0028121734877620433,0.005053646400248795,0.6426553672316384
249,457,지루함/Noun,707,100,607,0.0011115310228308473,0.006741897505386854,0.8585572842998586
250,458,추억/Noun,707,576,131,0.00640241869150568,0.0014550058866650375,0.8147100424328148
251,460,소리/Noun,705,202,503,0.0022452926661183114,0.005586778328187129,0.7134751773049646
252,462,이딴/Modifier,703,26,677,0.00028899806593602026,0.007519381566963592,0.9630156472261736
253,463,지루하고/Adjective,702,38,664,0.000422381788675722,0.0073749916698136265,0.945868945868946
254,465,좋아요/Adjective,696,653,43,0.007258297579085431,0.0004775973521114245,0.9382183908045976
255,467,마다/Josa,694,480,214,0.005335348909588066,0.002376879845391741,0.69164265129683
256,468,살/Noun,690,420,270,0.004668430295889558,0.002998867094653131,0.6086956521739131
257,469,인상/Noun,689,547,142,0.006080074694884734,0.0015771819534842392,0.7939042089985486
258,470,이지만/Josa,687,427,260,0.004746237467487717,0.002887797942999312,0.6215429403202329
259,471,오늘/Noun,685,462,223,0.005135273325478514,0.002476842081880179,0.6744525547445256
260,472,감정/Noun,684,445,239,0.004946313051597271,0.0026545527245262907,0.6505847953216374
261,473,전/Modifier,680,199,481,0.002211946735433386,0.005342426194548726,0.7073529411764706
262,474,정신/Noun,678,183,495,0.0020341017717804503,0.0054979230068640745,0.7300884955752213
263,475,엔딩/Noun,678,431,247,0.004790698708400951,0.0027434080458493453,0.6356932153392331
264,478,접/Noun,676,122,554,0.0013560678478536335,0.006153231001621609,0.8195266272189349
265,480,졸작/Noun,672,34,638,0.0003779205477624881,0.007086211875513696,0.949404761904762
266,481,제발/Noun,671,179,492,0.0019896405308672165,0.005464602261367928,0.7332339791356185
267,482,자신/Noun,671,422,249,0.004690660916346175,0.002765621876180109,0.6289120715350224
268,485,아무리/Adverb,666,114,552,0.0012671453660271655,0.006131017171290846,0.8288288288288288
269,486,그저/Adverb,666,221,445,0.0024564835604561725,0.004942577248594975,0.6681681681681682
270,488,♥/Foreign,660,651,9,0.007236066958628815,9.996223648843771e-05,0.9863636363636364
271,490,킬링타임/Noun,659,186,473,0.0020674477024653763,0.005253570873225671,0.7177541729893778
272,491,어릴/Verb,658,548,110,0.006091190005113043,0.0012217606681920164,0.8328267477203647
273,492,~~~/Punctuation,657,400,257,0.004446124091323389,0.0028544771975031647,0.60882800608828
274,493,함께/Adverb,656,544,112,0.00604672876419981,0.0012439744985227805,0.8292682926829268
275,494,그렇게/Adverb,656,251,405,0.0027899428673054264,0.004498300641979696,0.6173780487804879
276,496,캐스팅/Noun,653,219,434,0.0024342529399995552,0.004820401181775774,0.664624808575804
277,498,대해/Noun,651,506,145,0.0056243469755240865,0.001610502698980385,0.7772657450076805
278,501,재밌는/Adjective,647,549,98,0.006102305315341351,0.001088477686207433,0.848531684698609
279,502,멋진/Adjective,643,560,83,0.006224573727852744,0.0009218739587267033,0.8709175738724728
280,503,괜찮은/Adjective,643,487,156,0.005413156081186226,0.0017326787657995868,0.7573872472783826
281,504,포스터/Noun,642,205,437,0.002278638596803237,0.00485372192727192,0.6806853582554517
282,505,몰입도/Noun,638,412,226,0.0045795078140630895,0.002510162827376325,0.64576802507837
283,507,엉/Exclamation,636,103,533,0.0011448769535157724,0.005919985783148589,0.8380503144654088
284,508,자/Suffix,632,213,419,0.0023675610786297045,0.004653797454295044,0.6629746835443038
285,509,갈수록/Noun,631,192,439,0.0021341395638352265,0.0048759357576026825,0.6957210776545166
286,510,아니/Adjective,631,205,426,0.002278638596803237,0.004731545860452718,0.6751188589540412
287,512,개연/Noun,630,55,575,0.000611342062556966,0.006386476220094631,0.9126984126984128
288,513,애니메이션/Noun,630,418,212,0.004646199675432942,0.002354666015060977,0.6634920634920635
289,514,했던/Verb,627,391,236,0.0043460862992686115,0.002621231979030144,0.6236044657097288
290,517,같은데/Adjective,624,244,380,0.002712135695707267,0.0042206277628451475,0.6089743589743589
291,520,!!!!/Punctuation,622,460,162,0.005113042705021898,0.0017993202567918784,0.7395498392282959
292,523,문제/Noun,619,201,418,0.0022341773558900027,0.004642690539129663,0.6752827140549273
293,524,이름/Noun,617,239,378,0.002656559144565725,0.004198413932514383,0.6126418152350082
294,525,지/Modifier,617,246,371,0.002734366316163884,0.00412066552635671,0.6012965964343598
295,527,하/Exclamation,614,213,401,0.0023675610786297045,0.0044538729813181676,0.6530944625407166
296,528,ㅠㅠㅠ/KoreanParticle,611,496,115,0.0055131938732410025,0.0012772952440189265,0.8117839607201309
297,530,충격/Noun,610,399,211,0.00443500878109508,0.002343559099895595,0.6540983606557377
298,531,맘/Noun,609,373,236,0.00414601071515906,0.002621231979030144,0.6124794745484401
299,533,머리/Noun,603,235,368,0.002612097903652491,0.004087344780860563,0.6102819237147595
300,535,보단/Josa,600,239,361,0.002656559144565725,0.00400959637470289,0.6016666666666667
301,536,질/Noun,599,104,495,0.001155992263744081,0.0054979230068640745,0.8263772954924875
302,545,적/Noun,593,406,187,0.004512815952693239,0.002076993135926428,0.684654300168634
303,547,지루한/Adjective,592,100,492,0.0011115310228308473,0.005464602261367928,0.8310810810810809
304,551,강추/Noun,590,547,43,0.006080074694884734,0.0004775973521114245,0.9271186440677966
305,552,얘기/Noun,590,217,373,0.0024120223195429388,0.0041428793566874724,0.6322033898305085
306,553,대/Foreign,587,217,370,0.0024120223195429388,0.004109558611191328,0.6303236797274276
307,555,장르/Noun,583,201,382,0.0022341773558900027,0.004242841593175911,0.6552315608919382
308,557,더빙/Noun,582,150,432,0.0016672965342462707,0.00479818735144501,0.7422680412371134
309,558,재밌고/Adjective,581,533,48,0.005924460351688416,0.0005331319279383344,0.9173838209982788
310,559,모르겠다/Verb,581,115,466,0.0012782606762554744,0.005175822467067996,0.8020654044750429
311,562,주연/Noun,577,225,352,0.0025009448013694068,0.003909634138214452,0.6100519930675911
312,563,얼굴/Noun,576,199,377,0.002211946735433386,0.004187307017349001,0.6545138888888888
313,568,웃기/Noun,571,344,227,0.0038236667185381134,0.0025212697425417065,0.6024518388791593
314,569,머/Noun,570,97,473,0.0010781850921459217,0.005253570873225671,0.8298245614035088
315,571,비/Noun,563,225,338,0.0025009448013694068,0.003754137325899105,0.6003552397868561
316,573,꽤/Noun,562,441,121,0.004901851810684036,0.001343936735011218,0.7846975088967971
317,574,하는데/Verb,562,199,363,0.002211946735433386,0.0040318102050336535,0.6459074733096085
318,576,짜증/Noun,558,23,535,0.00025565213525109487,0.005942199613479352,0.9587813620071683
319,577,보는데/Verb,558,219,339,0.0024342529399995552,0.0037652442410644866,0.6075268817204301
320,578,9/Number,557,382,175,0.0042460485072138366,0.0019437101539418445,0.6858168761220825
321,579,매우/Noun,557,343,214,0.003812551408309806,0.002376879845391741,0.6157989228007181
322,580,지루하다/Adjective,556,14,542,0.0001556143431963186,0.006019948019637026,0.974820143884892
323,581,ㅡ/KoreanParticle,556,157,399,0.00174510370584443,0.004431659150987405,0.7176258992805755
324,582,날/Noun,556,337,219,0.0037458595469399545,0.0024324144212186506,0.6061151079136691
325,583,ㅎㅎㅎ/KoreanParticle,555,434,121,0.0048240446390858775,0.001343936735011218,0.781981981981982
326,584,너무나/Adverb,552,365,187,0.004057088233332592,0.002076993135926428,0.6612318840579711
327,585,이리/Adverb,552,199,353,0.002211946735433386,0.0039207410533798346,0.6394927536231884
328,586,진/Noun,552,216,336,0.00240090700931463,0.0037319234955683405,0.6086956521739131
329,588,???/Punctuation,551,142,409,0.0015783740524198029,0.004542728302641225,0.7422867513611615
330,589,두/Noun,551,362,189,0.004023742302647667,0.002099206966257192,0.6569872958257713
331,592,건가/Noun,546,124,422,0.0013782984683102506,0.00468711819979119,0.7728937728937729
332,593,아직/Adverb,546,363,183,0.004034857612875975,0.0020325654752649,0.6648351648351648
333,596,작/Modifier,544,183,361,0.0020341017717804503,0.00400959637470289,0.6636029411764706
334,598,소름/Noun,540,437,103,0.004857390569770802,0.0011440122620343426,0.8092592592592592
335,599,글/Noun,538,195,343,0.002167485494520152,0.0038096719017260148,0.6375464684014871
336,600,않다/Verb,537,191,346,0.0021230242536069183,0.0038429926472221604,0.6443202979515829
337,601,식/Suffix,534,210,324,0.002334215147944779,0.003598640513583757,0.6067415730337079
338,602,재미없음/Adjective,533,9,524,0.00010003779205477625,0.005820023546660151,0.9831144465290806
339,603,걸작/Noun,533,459,74,0.005101927394793589,0.0008219117222382655,0.8611632270168855
340,604,그나마/Adverb,532,40,492,0.0004446124091323389,0.005464602261367928,0.924812030075188
341,605,본다/Verb,529,198,331,0.002200831425205077,0.003676388919741431,0.6257088846880907
342,606,억지/Noun,527,72,455,0.00080030233643821,0.005053646400248795,0.8633776091081594
343,607,대체/Noun,527,89,438,0.000989262610319454,0.004864828842437301,0.8311195445920304
344,609,마세요/Verb,526,73,453,0.0008114176466665183,0.005031432569918031,0.8612167300380228
345,610,시절/Noun,526,397,129,0.004412778160638464,0.0014327920563342734,0.7547528517110266
346,612,존나/Noun,525,122,403,0.0013560678478536335,0.004476086811648933,0.7676190476190476
347,613,약간/Noun,525,357,168,0.003968165751506125,0.0018659617477841703,0.68
348,614,역사/Noun,525,318,207,0.0035346686526020947,0.0022991314392340674,0.6057142857142858
349,619,아님/Adjective,522,147,375,0.0016339506035613453,0.0041650931870182385,0.7183908045977011
350,620,실화/Noun,522,331,191,0.003679167685570104,0.0021214207965879555,0.6340996168582376
351,624,해도/Noun,520,170,350,0.0018896027388124407,0.003887420307883689,0.6730769230769231
352,625,봤음/Verb,519,357,162,0.003968165751506125,0.0017993202567918784,0.6878612716763006
353,626,이었다/Verb,518,357,161,0.003968165751506125,0.001788213341626497,0.6891891891891891
354,627,아무/Modifier,518,169,349,0.001878487428584132,0.0038763133927183055,0.6737451737451737
355,630,B/Alpha,514,133,381,0.0014783362603650269,0.00423173467801053,0.7412451361867705
356,631,한마디/Noun,514,156,358,0.0017339883956161216,0.003976275629206745,0.6964980544747081
357,634,휴/Exclamation,506,86,420,0.0009559166796345287,0.004664904369460426,0.8300395256916996
358,635,자기/Noun,506,160,346,0.0017784496365293556,0.0038429926472221604,0.6837944664031621
359,636,하기/Verb,506,196,310,0.0021786008047484607,0.0034431437012684093,0.6126482213438735
360,637,없네/Adjective,504,70,434,0.000778071715981593,0.004820401181775774,0.8611111111111112
361,638,누가/Noun,504,180,324,0.002000755841095525,0.003598640513583757,0.6428571428571429
362,641,없어/Adjective,503,126,377,0.0014005290887668675,0.004187307017349001,0.7495029821073559
363,646,만점/Noun,501,423,78,0.004701776226574484,0.0008663393828997934,0.844311377245509
364,647,초딩/Noun,501,192,309,0.0021341395638352265,0.003432036786103028,0.6167664670658682
365,652,간만/Noun,496,400,96,0.004446124091323389,0.0010662638558766688,0.8064516129032258
366,656,없었다/Adjective,490,186,304,0.0020674477024653763,0.003376502210276118,0.6204081632653061
367,658,라도/Josa,488,145,343,0.0016117199831047284,0.0038096719017260148,0.7028688524590164
368,659,~!/Punctuation,487,385,102,0.004279394437898762,0.0011329053468689607,0.7905544147843943
369,660,CG/Alpha,487,126,361,0.0014005290887668675,0.00400959637470289,0.7412731006160165
370,661,재밌네요/Adjective,486,466,20,0.005179734566391748,0.00022213830330763932,0.9588477366255144
371,662,전체/Noun,486,158,328,0.0017562190160727387,0.003643068174245285,0.6748971193415638
372,664,아까/Adjective,484,11,473,0.00012226841251139318,0.005253570873225671,0.9772727272727272
373,665,같음/Adjective,483,193,290,0.002145254874063535,0.00322100539796077,0.6004140786749482
374,666,뿐/Suffix,482,150,332,0.0016672965342462707,0.0036874958349068132,0.6887966804979253
375,667,감성/Noun,482,311,171,0.0034568614810039353,0.0018992824932803163,0.6452282157676349
376,668,다음/Noun,482,299,183,0.0033234777582642327,0.0020325654752649,0.6203319502074689
377,669,사회/Noun,481,337,144,0.0037458595469399545,0.0015993957838150033,0.7006237006237006
378,670,오/Modifier,481,187,294,0.0020785630126936845,0.0032654330586222983,0.6112266112266113
379,671,네이버/Noun,480,179,301,0.0019896405308672165,0.003343181464779972,0.6270833333333333
380,673,발연기/Noun,477,34,443,0.0003779205477624881,0.004920363418264211,0.9287211740041929
381,674,무슨/Modifier,476,124,352,0.0013782984683102506,0.003909634138214452,0.7394957983193278
382,675,그런/Modifier,475,189,286,0.002100793633150301,0.0031765777372992424,0.6021052631578947
383,677,였습니다/Verb,472,394,78,0.004379432229953538,0.0008663393828997934,0.8347457627118644
384,682,ㅉㅉ/KoreanParticle,466,72,394,0.00080030233643821,0.004376124575160495,0.8454935622317596
385,683,없어서/Adjective,466,135,331,0.0015005668808216438,0.003676388919741431,0.7103004291845494
386,685,꿈/Noun,465,353,112,0.003923704510592891,0.0012439744985227805,0.7591397849462366
387,686,재미있어요/Adjective,464,452,12,0.005024120223195429,0.0001332829819845836,0.9741379310344828
388,689,에요/Josa,461,357,104,0.003968165751506125,0.0011551191771997243,0.7744034707158352
389,690,나이/Noun,460,314,146,0.00349020741168886,0.0016216096141457672,0.6826086956521739
390,692,어렸을/Verb,459,394,65,0.004379432229953538,0.0007219494857498278,0.8583877995642701
391,694,이/Foreign,458,326,132,0.003623591134428562,0.0014661128018304194,0.7117903930131004
392,695,하네요/Verb,458,296,162,0.003290131827579308,0.0017993202567918784,0.6462882096069869
393,697,;;;/Punctuation,457,106,351,0.001178222884200698,0.0038985272230490703,0.7680525164113785
394,698,교훈/Noun,454,274,180,0.0030455950025565213,0.001999244729768754,0.6035242290748899
395,700,좋은데/Adjective,453,172,281,0.0019118333592690567,0.0031210431614723325,0.6203090507726269
396,703,소설/Noun,449,173,276,0.0019229486694973656,0.003065508585645423,0.6146993318485523
397,705,이라도/Josa,446,106,340,0.001178222884200698,0.0037763511562298687,0.7623318385650224
398,706,힘/Noun,443,266,177,0.0029566725207300537,0.001965923984272608,0.6004514672686229
399,708,시즌/Noun,442,315,127,0.003501322721917169,0.0014105782260035095,0.7126696832579186
400,709,낸/Verb,442,299,143,0.0033234777582642327,0.0015882888686496212,0.6764705882352942
401,712,어설픈/Adjective,437,36,401,0.000400151168219105,0.0044538729813181676,0.9176201372997712
402,715,방송/Noun,436,131,305,0.0014561056399084098,0.0033876091254415,0.6995412844036697
403,721,삼류/Noun,433,33,400,0.00036680523753417966,0.004442766066152787,0.9237875288683602
404,722,잔잔한/Adjective,432,371,61,0.004123780094702443,0.0006775218250882999,0.8587962962962963
405,723,몇번/Noun,431,334,97,0.00371251361625503,0.0010773707710420508,0.7749419953596288
406,724,보여주는/Verb,431,260,171,0.002889980659360202,0.0018992824932803163,0.6032482598607889
407,726,죽/Noun,428,138,290,0.0015339128115065689,0.00322100539796077,0.677570093457944
408,727,....../Punctuation,427,155,272,0.0017228730853878133,0.003021080924983895,0.6370023419203747
409,728,있지만/Adjective,427,271,156,0.003012249071871596,0.0017326787657995868,0.6346604215456675
410,732,여주/Noun,424,130,294,0.001444990329680101,0.0032654330586222983,0.6933962264150944
411,733,진정한/Adjective,423,309,114,0.003434630860547318,0.001266188328853544,0.7304964539007093
412,735,질질/Noun,419,72,347,0.00080030233643821,0.003854099562387543,0.8281622911694511
413,736,미친/Adjective,419,132,287,0.0014672209501367186,0.0031876846524646245,0.684964200477327
414,737,지/Verb,418,120,298,0.0013338372273970164,0.003309860719283826,0.7129186602870813
415,738,전부/Noun,418,133,285,0.0014783362603650269,0.003165470822133861,0.6818181818181818
416,739,바/Noun,418,165,253,0.0018340261876708976,0.0028100495368416373,0.6052631578947368
417,740,줄거리/Noun,417,136,281,0.0015116821910499524,0.0031210431614723325,0.6738609112709832
418,745,점주/Noun,415,98,317,0.0010893004023742304,0.0035208921074260835,0.763855421686747
419,746,실제/Noun,415,250,165,0.002778827557077118,0.0018326410022880247,0.6024096385542169
420,747,답/Noun,413,100,313,0.0011115310228308473,0.0034764644467645558,0.7578692493946732
421,748,재미있다/Adjective,412,357,55,0.003968165751506125,0.0006108803340960082,0.866504854368932
422,749,되어/Verb,411,249,162,0.002767712246848809,0.0017993202567918784,0.6058394160583942
423,751,좋아/Adjective,409,337,72,0.0037458595469399545,0.0007996978919075017,0.8239608801955991
424,753,낭비/Noun,408,8,400,8.892248182646779e-05,0.004442766066152787,0.9803921568627452
425,754,굉장히/Adjective,408,277,131,0.003078940933241447,0.0014550058866650375,0.678921568627451
426,755,버린/Verb,408,133,275,0.0014783362603650269,0.003054401670480041,0.6740196078431373
427,758,각본/Noun,407,121,286,0.001344952537625325,0.0031765777372992424,0.7027027027027027
428,760,같네요/Adjective,406,244,162,0.002712135695707267,0.0017993202567918784,0.6009852216748769
429,761,먹/Verb,402,321,81,0.0035680145832870194,0.0008996601283959392,0.7985074626865671
430,762,재/Noun,401,255,146,0.002834404108218661,0.0016216096141457672,0.6359102244389028
431,767,순간/Noun,397,263,134,0.002923326590045128,0.0014883266321611835,0.6624685138539043
432,768,어른/Noun,397,249,148,0.002767712246848809,0.001643823444476531,0.6272040302267002
433,769,평론가/Noun,397,239,158,0.002656559144565725,0.0017548925961303507,0.6020151133501259
434,770,갑자기/Noun,396,103,293,0.0011448769535157724,0.003254326143456916,0.73989898989899
435,771,제작/Noun,396,143,253,0.0015894893626481115,0.0028100495368416373,0.6388888888888888
436,773,이하/Noun,395,34,361,0.0003779205477624881,0.00400959637470289,0.9139240506329114
437,776,쳐/Verb,393,97,296,0.0010781850921459217,0.003287646888953062,0.7531806615776081
438,778,간다/Noun,392,151,241,0.0016784118444745793,0.002676766554857054,0.6147959183673469
439,779,하며/Verb,391,248,143,0.0027565969366205013,0.0015882888686496212,0.6342710997442456
440,780,의도/Noun,390,66,324,0.0007336104750683593,0.003598640513583757,0.8307692307692308
441,781,발/Noun,390,81,309,0.0009003401284929863,0.003432036786103028,0.7923076923076923
442,782,영/Noun,390,107,283,0.0011893381944290064,0.0031432569918030968,0.7256410256410256
443,784,나온다/Verb,389,112,277,0.0012449147455705488,0.003076615500810805,0.7120822622107971
444,787,밑/Noun,388,119,269,0.0013227219171687082,0.0029877601794877488,0.6932989690721649
445,789,재미있는/Adjective,387,327,60,0.003634706444656871,0.000666414909922918,0.8449612403100775
446,790,땜/Noun,387,126,261,0.0014005290887668675,0.002898904858164693,0.6744186046511628
447,792,해주는/Verb,386,304,82,0.003379054309405776,0.0009107670435613213,0.7875647668393783
448,793,하네/Verb,385,114,271,0.0012671453660271655,0.003009974009818513,0.7038961038961039
449,794,아버지/Noun,385,261,124,0.0029010959695885113,0.0013772574805073642,0.6779220779220779
450,798,비해/Verb,384,123,261,0.001367183158081942,0.002898904858164693,0.6796875
451,799,한편/Noun,384,232,152,0.0025787519729675657,0.001688251105138059,0.6041666666666666
452,802,봤네요/Verb,381,343,38,0.003812551408309806,0.0004220627762845148,0.9002624671916011
453,803,재밌는데/Adjective,381,339,42,0.003768090167396572,0.00046649043694604257,0.8897637795275591
454,804,좋음/Adjective,381,311,70,0.0034568614810039353,0.0007774840615767378,0.8162729658792651
455,806,볼때/Noun,380,276,104,0.0030678256230131378,0.0011551191771997243,0.7263157894736842
456,807,되지/Verb,378,150,228,0.0016672965342462707,0.0025323766577070887,0.6031746031746031
457,809,있어서/Adjective,377,285,92,0.0031678634150679144,0.0010218361952151409,0.7559681697612732
458,812,10년/Number,376,276,100,0.0030678256230131378,0.0011106915165381968,0.7340425531914894
459,813,는데/Verb,376,226,150,0.0025120601115977146,0.001666037274807295,0.6010638297872339
460,815,있을까/Adjective,375,249,126,0.002767712246848809,0.0013994713108381278,0.664
461,817,훌륭한/Adjective,374,295,79,0.0032790165173509998,0.0008774462980651753,0.7887700534759359
462,818,첨/Adverb,374,111,263,0.0012337994353422404,0.002921118688495457,0.7032085561497327
463,819,봐야/Verb,374,262,112,0.0029122112798168195,0.0012439744985227805,0.7005347593582888
464,820,막/Noun,373,133,240,0.0014783362603650269,0.002665659639691672,0.6434316353887399
465,823,모르고/Verb,372,277,95,0.003078940933241447,0.0010551569407112867,0.7446236559139785
466,825,좋네요/Adjective,371,346,25,0.003845897338994731,0.0002776728791345492,0.9326145552560648
467,826,슬픈/Adjective,371,315,56,0.003501322721917169,0.0006219872492613901,0.8490566037735849
468,827,그때/Noun,371,269,102,0.002990018451414979,0.0011329053468689607,0.7250673854447439
469,828,항상/Noun,371,247,124,0.002745481626392193,0.0013772574805073642,0.6657681940700808
470,829,좀비/Noun,370,127,243,0.001411644398995176,0.002698980385187818,0.6567567567567567
471,831,치고/Josa,368,112,256,0.0012449147455705488,0.002843370282337784,0.6956521739130435
472,833,뻔/Noun,367,98,269,0.0010893004023742304,0.0029877601794877488,0.7329700272479565
473,836,거지/Noun,366,99,267,0.0011004157126025386,0.0029655463491569853,0.7295081967213115
474,837,곳/Noun,365,245,120,0.002723251005935576,0.001332829819845836,0.6712328767123288
475,841,없네요/Adjective,362,111,251,0.0012337994353422404,0.002787835706510873,0.6933701657458563
476,843,짱/Suffix,361,320,41,0.003556899273058711,0.00045538352178066063,0.8864265927977839
477,844,성/Modifier,361,130,231,0.001444990329680101,0.0025656974032032343,0.6398891966759003
478,845,진행/Noun,360,97,263,0.0010781850921459217,0.002921118688495457,0.7305555555555555
479,849,이에요/Josa,358,286,72,0.003178978725296223,0.0007996978919075017,0.7988826815642458
480,850,더욱/Noun,358,281,77,0.0031234021741546806,0.0008552324677344116,0.7849162011173184
481,851,tv/Alpha,358,103,255,0.0011448769535157724,0.0028322633671724017,0.7122905027932961
482,852,낫다/Noun,358,124,234,0.0013782984683102506,0.0025990181486993803,0.6536312849162011
483,855,더럽게/Adjective,356,17,339,0.00018896027388124405,0.0037652442410644866,0.952247191011236
484,856,어이/Noun,355,29,326,0.0003223439966209457,0.003620854343914521,0.9183098591549296
485,857,상미/Noun,355,237,118,0.0026343285241091077,0.001310615989515072,0.6676056338028169
486,858,래/Josa,355,138,217,0.0015339128115065689,0.002410200590887887,0.6112676056338028
487,859,참고/Noun,354,65,289,0.0007224951648400508,0.003209898482795389,0.8163841807909604
488,860,중국/Noun,354,122,232,0.0013560678478536335,0.0025768043183686164,0.655367231638418
489,863,몇/Noun,353,222,131,0.0024675988706844808,0.0014550058866650375,0.6288951841359773
490,864,그녀/Noun,352,266,86,0.0029566725207300537,0.0009551947042228492,0.7556818181818182
491,869,대단한/Adjective,348,246,102,0.002734366316163884,0.0011329053468689607,0.7068965517241379
492,870,거기/Noun,348,120,228,0.0013338372273970164,0.0025323766577070887,0.6551724137931034
493,871,깊은/Adjective,347,303,44,0.0033679389991774673,0.0004887042672768067,0.8731988472622478
494,872,점점/Noun,347,138,209,0.0015339128115065689,0.002321345269564831,0.6023054755043228
495,873,굳/Adjective,346,330,16,0.003668052375341796,0.00017771064264611146,0.9537572254335259
496,875,이냐/Josa,345,47,298,0.0005224195807304982,0.003309860719283826,0.8637681159420291
497,877,재미없는/Adjective,344,18,326,0.0002000755841095525,0.003620854343914521,0.9476744186046512
498,878,보는게/Verb,344,55,289,0.000611342062556966,0.003209898482795389,0.8401162790697675
499,879,짜리/Verb,344,134,210,0.001489451570593335,0.002332452184730213,0.6104651162790697
500,880,아까워/Adjective,343,16,327,0.00017784496365293558,0.0036319612590799033,0.9533527696793004
501,881,충분히/Adjective,343,272,71,0.003023364382099905,0.0007885909767421196,0.793002915451895
502,882,어디서/Adverb,343,123,220,0.001367183158081942,0.0024435213363840328,0.641399416909621
503,885,술/Noun,342,58,284,0.0006446879932418914,0.0031543639069684785,0.8304093567251462
504,886,전형/Noun,342,64,278,0.0007113798546117423,0.0030877224159761873,0.8128654970760234
505,887,좋겠다/Adjective,342,240,102,0.002667674454794033,0.0011329053468689607,0.7017543859649122
506,888,따뜻한/Adjective,340,312,28,0.003467976791232243,0.000310993624630695,0.9176470588235294
507,889,편집/Noun,340,103,237,0.0011448769535157724,0.0026323388941955268,0.6970588235294117
508,891,잠/Noun,339,82,257,0.0009114554387212947,0.0028544771975031647,0.7581120943952803
509,892,나옴/Verb,339,83,256,0.0009225707489496033,0.002843370282337784,0.7551622418879056
510,895,해준/Verb,337,275,62,0.00305671031278483,0.0006886287402536821,0.8160237388724035
511,896,하는게/Verb,337,103,234,0.0011448769535157724,0.0025990181486993803,0.6943620178041543
512,897,사건/Noun,337,130,207,0.001444990329680101,0.0022991314392340674,0.6142433234421365
513,899,였어요/Verb,335,281,54,0.0031234021741546806,0.0005997734189306263,0.8388059701492537
514,900,화보/Noun,335,124,211,0.0013782984683102506,0.002343559099895595,0.6298507462686567
515,901,화이팅/Noun,334,296,38,0.003290131827579308,0.0004220627762845148,0.8862275449101796
516,905,새로운/Adjective,332,247,85,0.002745481626392193,0.0009440877890574672,0.7439759036144579
517,906,안된다/Adjective,331,76,255,0.0008447635773514439,0.0028322633671724017,0.770392749244713
518,907,꿀잼/Noun,330,316,14,0.003512438032145477,0.0001554968123153475,0.9575757575757576
519,908,똥/Noun,330,29,301,0.0003223439966209457,0.003343181464779972,0.912121212121212
520,909,그게/Noun,330,91,239,0.001011493230776071,0.0026545527245262907,0.7242424242424242
521,912,중반/Noun,328,125,203,0.001389413778538559,0.002254703778572539,0.6189024390243902
522,913,취향/Noun,328,127,201,0.001411644398995176,0.0022324899482417753,0.6128048780487805
523,916,-_-/Punctuation,327,38,289,0.000422381788675722,0.003209898482795389,0.8837920489296636
524,917,개그/Noun,327,99,228,0.0011004157126025386,0.0025323766577070887,0.6972477064220184
525,921,엉망/Noun,326,22,304,0.00024453682502278637,0.003376502210276118,0.9325153374233128
526,922,병맛/Noun,326,57,269,0.0006335726830135829,0.0029877601794877488,0.8251533742331288
527,923,티/Noun,325,91,234,0.001011493230776071,0.0025990181486993803,0.72
528,924,복수/Noun,325,128,197,0.0014227597092234846,0.0021880622875802475,0.6061538461538462
529,928,관/Noun,324,221,103,0.0024564835604561725,0.0011440122620343426,0.6820987654320988
530,929,ㄷㄷ/KoreanParticle,324,200,124,0.0022230620456616945,0.0013772574805073642,0.6172839506172839
531,933,미화/Noun,323,44,279,0.0004890736500455726,0.003098829331141569,0.8637770897832817
532,934,~!!/Punctuation,323,253,70,0.0028121734877620433,0.0007774840615767378,0.7832817337461301
533,935,아닌가/Adjective,323,112,211,0.0012449147455705488,0.002343559099895595,0.6532507739938079
534,936,흥미/Noun,323,125,198,0.001389413778538559,0.0021991692027456293,0.6130030959752322
535,944,흥미진진/Noun,321,276,45,0.0030678256230131378,0.0004998111824421885,0.8598130841121495
536,947,있게/Adjective,320,243,77,0.002701020385478959,0.0008552324677344116,0.759375
537,948,알았다/Verb,320,94,226,0.0010448391614609964,0.002510162827376325,0.70625
538,951,잘만/Noun,318,239,79,0.002656559144565725,0.0008774462980651753,0.7515723270440252
539,952,좋았어요/Adjective,317,311,6,0.0034568614810039353,6.66414909922918e-05,0.9810725552050472
540,953,에겐/Josa,317,194,123,0.0021563701842918434,0.001366150565341982,0.61198738170347
541,955,재밌었다/Adjective,316,296,20,0.003290131827579308,0.00022213830330763932,0.9367088607594936
542,956,만으로도/Josa,316,285,31,0.0031678634150679144,0.00034431437012684104,0.9018987341772152
543,957,학교/Noun,316,192,124,0.0021341395638352265,0.0013772574805073642,0.6075949367088608
544,958,괜히/Adverb,315,80,235,0.0008892248182646778,0.002610125063864762,0.7460317460317459
545,959,또한/Noun,315,208,107,0.002311984527488162,0.0011884399226958706,0.6603174603174603
546,960,엄청난/Adjective,315,207,108,0.002300869217259854,0.0011995468378612525,0.6571428571428571
547,961,과거/Noun,315,196,119,0.0021786008047484607,0.0013217229046804538,0.6222222222222222
548,964,그래픽/Noun,314,78,236,0.0008669941978080608,0.002621231979030144,0.7515923566878981
549,965,ost/Alpha,313,265,48,0.002945557210501745,0.0005331319279383344,0.8466453674121406
550,966,기대하고/Adjective,313,53,260,0.000589111442100349,0.002887797942999312,0.8306709265175719
551,967,그냥/Modifier,313,87,226,0.0009670319898628369,0.002510162827376325,0.7220447284345048
552,968,이라니/Josa,313,116,197,0.0012893759864837828,0.0021880622875802475,0.6293929712460063
553,970,그만/Adverb,312,21,291,0.00023342151479447792,0.0032321123131261523,0.9326923076923076
554,971,장/Suffix,312,89,223,0.000989262610319454,0.002476842081880179,0.7147435897435898
555,972,20/Number,312,211,101,0.002345330458173088,0.0011217984317035787,0.6762820512820513
556,973,바보/Noun,311,85,226,0.0009448013694062199,0.002510162827376325,0.7266881028938906
557,974,성우/Noun,310,70,240,0.000778071715981593,0.002665659639691672,0.7741935483870968
558,975,헐/Verb,309,87,222,0.0009670319898628369,0.002465735166714797,0.7184466019417476
559,976,봣/Noun,308,207,101,0.002300869217259854,0.0011217984317035787,0.6720779220779219
560,977,나오고/Verb,307,81,226,0.0009003401284929863,0.002510162827376325,0.7361563517915309
561,978,죽음/Noun,307,206,101,0.0022897539070315448,0.0011217984317035787,0.6710097719869706
562,979,대한민국/Noun,307,185,122,0.002056332392237067,0.0013550436501765998,0.6026058631921825
563,981,유치/Noun,306,21,285,0.00023342151479447792,0.003165470822133861,0.931372549019608
564,982,나쁜/Adjective,306,100,206,0.0011115310228308473,0.002288024524068685,0.673202614379085
565,983,해도/Verb,306,100,206,0.0011115310228308473,0.002288024524068685,0.673202614379085
566,985,도저히/Noun,305,26,279,0.00028899806593602026,0.003098829331141569,0.9147540983606556
567,986,식/Noun,305,72,233,0.00080030233643821,0.002587911233533998,0.7639344262295082
568,987,속편/Noun,305,99,206,0.0011004157126025386,0.002288024524068685,0.6754098360655738
569,991,울/Noun,304,228,76,0.0025342907320543315,0.0008441255525690295,0.75
570,992,무조건/Noun,304,193,111,0.002145254874063535,0.0012328675833573985,0.6348684210526315
571,993,야할/Adjective,303,233,70,0.002589867283195874,0.0007774840615767378,0.768976897689769
572,994,전달/Noun,303,115,188,0.0012782606762554744,0.0020881000510918103,0.6204620462046204
573,995,땐/Noun,303,183,120,0.0020341017717804503,0.001332829819845836,0.6039603960396039
574,998,하는지/Verb,302,93,209,0.0010337238512326881,0.002321345269564831,0.6920529801324503
575,999,않음/Verb,302,97,205,0.0010781850921459217,0.002276917608903303,0.6788079470198676
576,1001,안됨/Adjective,301,50,251,0.0005557655114154236,0.002787835706510873,0.8338870431893688
577,1002,천재/Noun,301,236,65,0.0026232132138807995,0.0007219494857498278,0.7840531561461794
578,1004,억지로/Noun,300,42,258,0.00046684302958895584,0.002865584112668547,0.86
579,1005,우연히/Adverb,300,258,42,0.0028677500389035857,0.00046649043694604257,0.86
580,1006,같습니다/Adjective,300,233,67,0.002589867283195874,0.0007441633160805918,0.7766666666666666
581,1007,심리/Noun,300,207,93,0.002300869217259854,0.001032943110380523,0.69
582,1009,화가/Noun,299,75,224,0.0008336482671231353,0.0024879489970455605,0.7491638795986622
583,1011,댓글/Noun,297,75,222,0.0008336482671231353,0.002465735166714797,0.7474747474747475
584,1014,완벽한/Adjective,296,254,42,0.002823288797990352,0.00046649043694604257,0.8581081081081081
585,1015,속/Modifier,296,73,223,0.0008114176466665183,0.002476842081880179,0.7533783783783784
586,1016,아무/Noun,296,116,180,0.0012893759864837828,0.001999244729768754,0.6081081081081081
587,1019,새끼/Noun,295,80,215,0.0008892248182646778,0.002387986760557123,0.7288135593220338
588,1020,재미있고/Adjective,294,272,22,0.003023364382099905,0.00024435213363840333,0.9251700680272108
589,1021,척/Noun,294,58,236,0.0006446879932418914,0.002621231979030144,0.8027210884353742
590,1022,예고편/Noun,294,69,225,0.0007669564057532844,0.002499055912210943,0.7653061224489796
591,1024,재미없고/Adjective,293,9,284,0.00010003779205477625,0.0031543639069684785,0.969283276450512
592,1025,다가/Noun,293,91,202,0.001011493230776071,0.0022435968634071574,0.6894197952218429
593,1026,최근/Noun,293,195,98,0.002167485494520152,0.001088477686207433,0.6655290102389079
594,1029,현/Modifier,292,181,111,0.0020118711513238334,0.0012328675833573985,0.6198630136986302
595,1030,느끼게/Verb,291,222,69,0.0024675988706844808,0.0007663771464113557,0.7628865979381443
596,1031,good/Alpha,291,213,78,0.0023675610786297045,0.0008663393828997934,0.7319587628865979
597,1032,어느/Modifier,291,104,187,0.001155992263744081,0.002076993135926428,0.6426116838487973
598,1034,불륜/Noun,289,75,214,0.0008336482671231353,0.002376879845391741,0.740484429065744
599,1035,젠/Noun,289,80,209,0.0008892248182646778,0.002321345269564831,0.7231833910034602
600,1037,대작/Noun,288,231,57,0.002567636662739257,0.0006330941644267722,0.8020833333333334
601,1038,짐/Noun,288,189,99,0.002100793633150301,0.0010995846013728146,0.65625
602,1042,재밌어/Adjective,287,234,53,0.0026009825934241826,0.0005886665037652442,0.8153310104529616
603,1043,봤을/Verb,287,177,110,0.0019674099104106,0.0012217606681920164,0.6167247386759582
604,1046,있었다/Adjective,286,213,73,0.0023675610786297045,0.0008108048070728836,0.7447552447552448
605,1047,열/Noun,286,78,208,0.0008669941978080608,0.0023102383543994486,0.7272727272727273
606,1051,2시간/Number,285,95,190,0.0010559544716893046,0.0021103138814225733,0.6666666666666666
607,1055,게임/Noun,284,97,187,0.0010781850921459217,0.002076993135926428,0.6584507042253521
608,1056,행동/Noun,284,103,181,0.0011448769535157724,0.002010351644934136,0.6373239436619719
609,1059,짓/Noun,283,70,213,0.000778071715981593,0.002365772930226359,0.7526501766784452
610,1060,환상/Noun,283,207,76,0.002300869217259854,0.0008441255525690295,0.7314487632508834
611,1061,여/Noun,283,178,105,0.001978525220638908,0.0011662260923651065,0.6289752650176679
612,1063,오래/Adverb,282,230,52,0.002556521352510949,0.0005775595885998622,0.8156028368794326
613,1065,재미없어/Adjective,280,5,275,5.557655114154236e-05,0.003054401670480041,0.9821428571428572
614,1066,그닥/Noun,280,25,255,0.0002778827557077118,0.0028322633671724017,0.9107142857142856
615,1067,귀신/Noun,280,71,209,0.0007891870262099014,0.002321345269564831,0.7464285714285714
616,1068,쓴/Verb,280,75,205,0.0008336482671231353,0.002276917608903303,0.7321428571428571
617,1069,아니면/Adjective,280,78,202,0.0008669941978080608,0.0022435968634071574,0.7214285714285714
618,1070,전설/Noun,280,175,105,0.0019451792899539827,0.0011662260923651065,0.625
619,1073,산/Noun,279,67,212,0.0007447257852966678,0.002354666015060977,0.7598566308243727
620,1074,볼수/Verb,279,203,76,0.00225640797634662,0.0008441255525690295,0.7275985663082437
621,1075,하는거/Verb,279,78,201,0.0008669941978080608,0.0022324899482417753,0.7204301075268817
622,1076,총/Modifier,279,87,192,0.0009670319898628369,0.0021325277117533376,0.6881720430107527
623,1077,회/Noun,279,177,102,0.0019674099104106,0.0011329053468689607,0.6344086021505376
624,1079,재밌었어요/Adjective,277,268,9,0.00297890314118667,9.996223648843771e-05,0.967509025270758
625,1080,전작/Noun,277,72,205,0.00080030233643821,0.002276917608903303,0.740072202166065
626,1081,총/Noun,277,85,192,0.0009448013694062199,0.0021325277117533376,0.6931407942238267
627,1083,♡/Foreign,276,264,12,0.0029344419002734373,0.0001332829819845836,0.9565217391304348
628,1085,현재/Noun,275,205,70,0.002278638596803237,0.0007774840615767378,0.7454545454545455
629,1088,놔/Verb,274,53,221,0.000589111442100349,0.0024546282515494145,0.8065693430656934
630,1089,울/Modifier,274,178,96,0.001978525220638908,0.0010662638558766688,0.6496350364963503
631,1090,제작비/Noun,273,38,235,0.000422381788675722,0.002610125063864762,0.8608058608058609
632,1091,예요/Josa,273,206,67,0.0022897539070315448,0.0007441633160805918,0.7545787545787546
633,1092,스러운/Josa,273,89,184,0.000989262610319454,0.0020436723904302817,0.6739926739926739
634,1093,다행/Noun,273,104,169,0.001155992263744081,0.0018770686629495524,0.6190476190476191
635,1094,흠/Noun,272,105,167,0.0011671075739723895,0.0018548548326187888,0.6139705882352942
636,1098,통해/Noun,271,217,54,0.0024120223195429388,0.0005997734189306263,0.8007380073800738
637,1099,노/Noun,271,96,175,0.0010670697819176133,0.0019437101539418445,0.6457564575645757
638,1103,짜/Verb,269,92,177,0.0010226085410043797,0.001965923984272608,0.6579925650557621
639,1107,망작/Noun,268,16,252,0.00017784496365293558,0.002798942621676256,0.9402985074626866
640,1108,좋았음/Adjective,268,241,27,0.0026787897650223423,0.0002998867094653131,0.8992537313432836
641,1109,맞는/Verb,268,95,173,0.0010559544716893046,0.0019214963236110802,0.6455223880597015
642,1110,먹고/Verb,268,101,167,0.0011226463330591557,0.0018548548326187888,0.6231343283582089
643,1114,좋았습니다/Adjective,267,258,9,0.0028677500389035857,9.996223648843771e-05,0.9662921348314608
644,1115,되었다/Verb,267,201,66,0.0022341773558900027,0.0007330564009152097,0.7528089887640449
645,1116,가끔/Noun,267,174,93,0.0019340639797256738,0.001032943110380523,0.651685393258427
646,1117,만의/Josa,267,167,100,0.001856256808127515,0.0011106915165381968,0.6254681647940075
647,1118,안되고/Adjective,266,10,256,0.00011115310228308472,0.002843370282337784,0.962406015037594
648,1119,동화/Noun,266,189,77,0.002100793633150301,0.0008552324677344116,0.7105263157894737
649,1120,80년/Number,266,82,184,0.0009114554387212947,0.0020436723904302817,0.6917293233082706
650,1121,:/Punctuation,266,106,160,0.001178222884200698,0.0017771064264611148,0.6015037593984962
651,1123,100/Number,265,171,94,0.001900718049040749,0.0010440500255459052,0.6452830188679245
652,1124,묘사/Noun,265,170,95,0.0018896027388124407,0.0010551569407112867,0.6415094339622641
653,1127,지루하지/Adjective,264,251,13,0.0027899428673054264,0.00014438989714996554,0.9507575757575758
654,1128,예산/Noun,264,65,199,0.0007224951648400508,0.0022102761179110114,0.7537878787878788
655,1129,으/Adverb,263,97,166,0.0010781850921459217,0.0018437479174534066,0.6311787072243346
656,1130,여러/Modifier,263,165,98,0.0018340261876708976,0.001088477686207433,0.6273764258555133
657,1135,채널/Noun,262,82,180,0.0009114554387212947,0.001999244729768754,0.6870229007633588
658,1136,살인/Noun,262,97,165,0.0010781850921459217,0.0018326410022880247,0.6297709923664122
659,1137,긴/Verb,262,161,101,0.001789564946757664,0.0011217984317035787,0.6145038167938931
660,1142,감사합니다/Verb,260,241,19,0.0026787897650223423,0.00021103138814225735,0.926923076923077
661,1143,유치하고/Adjective,260,21,239,0.00023342151479447792,0.0026545527245262907,0.9192307692307692
662,1144,보고싶다/Verb,260,227,33,0.0025231754218260232,0.00036652820045760486,0.8730769230769231
663,1145,느낄/Verb,260,207,53,0.002300869217259854,0.0005886665037652442,0.7961538461538461
664,1146,강/Noun,260,197,63,0.002189716114976769,0.0006997356554190639,0.7576923076923077
665,1149,아닐까/Adjective,259,191,68,0.0021230242536069183,0.0007552702312459737,0.7374517374517374
666,1154,유치한/Adjective,258,42,216,0.00046684302958895584,0.002399093675722505,0.8372093023255814
667,1155,졸라/Noun,258,75,183,0.0008336482671231353,0.0020325654752649,0.7093023255813954
668,1156,아니지만/Adjective,258,177,81,0.0019674099104106,0.0008996601283959392,0.686046511627907
669,1157,프로그램/Noun,258,102,156,0.0011337616432874642,0.0017326787657995868,0.6046511627906976
670,1159,개/Suffix,257,79,178,0.0008781095080363692,0.0019770308994379896,0.6926070038910506
671,1164,만들/Verb,256,53,203,0.000589111442100349,0.002254703778572539,0.79296875
672,1165,외/Noun,256,70,186,0.000778071715981593,0.002065886220761046,0.7265625
673,1166,서로/Noun,256,161,95,0.001789564946757664,0.0010551569407112867,0.62890625
674,1169,낚/Noun,254,20,234,0.00022230620456616945,0.0025990181486993803,0.9212598425196852
675,1170,진부한/Adjective,254,38,216,0.000422381788675722,0.002399093675722505,0.8503937007874016
676,1171,이상한/Adjective,254,63,191,0.0007002645443834338,0.0021214207965879555,0.7519685039370079
677,1172,경찰/Noun,254,98,156,0.0010893004023742304,0.0017326787657995868,0.6141732283464567
678,1175,보시길/Verb,253,193,60,0.002145254874063535,0.000666414909922918,0.7628458498023716
679,1176,모/Noun,253,66,187,0.0007336104750683593,0.002076993135926428,0.7391304347826086
680,1180,좋았고/Adjective,252,235,17,0.002612097903652491,0.00018881755781149343,0.9325396825396826
681,1181,해요/Verb,252,204,48,0.0022675232865749283,0.0005331319279383344,0.8095238095238095
682,1182,있나/Adjective,252,68,184,0.0007558410955249762,0.0020436723904302817,0.7301587301587301
683,1183,만들었다/Verb,252,170,82,0.0018896027388124407,0.0009107670435613213,0.6746031746031746
684,1184,런가/Noun,252,97,155,0.0010781850921459217,0.0017215718506342046,0.6150793650793651
685,1185,반개/Noun,251,5,246,5.557655114154236e-05,0.002732301130683964,0.9800796812749004
686,1186,하냐/Verb,251,23,228,0.00025565213525109487,0.0025323766577070887,0.9083665338645418
687,1187,짱/VerbPrefix,251,225,26,0.0025009448013694068,0.00028877979429993113,0.896414342629482
688,1188,필요없다/Adjective,251,214,37,0.0023786763888580128,0.0004109558611191328,0.852589641434263
689,1189,지루/Noun,250,21,229,0.00023342151479447792,0.0025434835728724704,0.9159999999999999
690,1190,싫다/Adjective,250,23,227,0.00025565213525109487,0.0025212697425417065,0.9079999999999999
691,1191,나왔으면/Verb,250,175,75,0.0019451792899539827,0.0008330186374036475,0.7
692,1194,그렇고/Adjective,249,80,169,0.0008892248182646778,0.0018770686629495524,0.678714859437751
693,1196,지루해/Adjective,248,18,230,0.0002000755841095525,0.002554590488037853,0.9274193548387096
694,1201,용도/Noun,247,57,190,0.0006335726830135829,0.0021103138814225733,0.7692307692307693
695,1202,이런게/Adjective,247,153,94,0.0017006424649311962,0.0010440500255459052,0.6194331983805668
696,1203,만들지/Verb,246,31,215,0.00034457461707756266,0.002387986760557123,0.8739837398373984
697,1204,희망/Noun,246,210,36,0.002334215147944779,0.00039984894595375083,0.8536585365853658
698,1206,청춘/Noun,245,172,73,0.0019118333592690567,0.0008108048070728836,0.7020408163265306
699,1207,좋았는데/Adjective,245,74,171,0.0008225329568948269,0.0018992824932803163,0.6979591836734694
700,1208,그리/Verb,245,76,169,0.0008447635773514439,0.0018770686629495524,0.689795918367347
701,1209,......./Punctuation,245,81,164,0.0009003401284929863,0.0018215340871226425,0.6693877551020408
702,1210,다만/Noun,245,160,85,0.0017784496365293556,0.0009440877890574672,0.6530612244897959
703,1211,상상력/Noun,245,158,87,0.0017562190160727387,0.0009663016193882313,0.6448979591836734
704,1212,너무나도/Adverb,245,151,94,0.0016784118444745793,0.0010440500255459052,0.6163265306122448
705,1214,깊이/Noun,244,172,72,0.0019118333592690567,0.0007996978919075017,0.7049180327868853
706,1215,이런거/Adjective,244,85,159,0.0009448013694062199,0.0017659995112957324,0.6516393442622951
707,1221,cg/Alpha,243,62,181,0.0006891492341551253,0.002010351644934136,0.7448559670781894
708,1222,였는데/Verb,243,156,87,0.0017339883956161216,0.0009663016193882313,0.6419753086419753
709,1224,기세/Noun,242,7,235,7.78071715981593e-05,0.002610125063864762,0.9710743801652892
710,1225,없나/Adjective,242,53,189,0.000589111442100349,0.002099206966257192,0.78099173553719
711,1229,형님/Noun,241,155,86,0.0017228730853878133,0.0009551947042228492,0.6431535269709544
712,1233,재미있음/Adjective,240,217,23,0.0024120223195429388,0.0002554590488037852,0.9041666666666668
713,1234,노출/Noun,240,57,183,0.0006335726830135829,0.0020325654752649,0.7625
714,1235,카메라/Noun,240,73,167,0.0008114176466665183,0.0018548548326187888,0.6958333333333333
715,1237,미래/Noun,239,164,75,0.0018229108774425891,0.0008330186374036475,0.6861924686192469
716,1239,비추/Verb,238,15,223,0.00016672965342462708,0.002476842081880179,0.9369747899159664
717,1240,슬프다/Adjective,238,211,27,0.002345330458173088,0.0002998867094653131,0.8865546218487395
718,1241,체/Noun,238,92,146,0.0010226085410043797,0.0016216096141457672,0.6134453781512605
719,1244,대안/Noun,237,199,38,0.002211946735433386,0.0004220627762845148,0.8396624472573839
720,1245,빼고/Verb,237,65,172,0.0007224951648400508,0.0019103894084456985,0.7257383966244726
721,1246,볼수록/Verb,237,163,74,0.001811795567214281,0.0008219117222382655,0.6877637130801688
722,1248,나를/Verb,236,188,48,0.0020896783229219927,0.0005331319279383344,0.7966101694915254
723,1249,능력/Noun,236,81,155,0.0009003401284929863,0.0017215718506342046,0.6567796610169492
724,1250,미소/Noun,235,212,23,0.002356445768401396,0.0002554590488037852,0.9021276595744679
725,1251,깊게/Adjective,235,211,24,0.002345330458173088,0.0002665659639691672,0.8978723404255319
726,1252,결론/Noun,235,63,172,0.0007002645443834338,0.0019103894084456985,0.7319148936170212
727,1253,반/Noun,235,83,152,0.0009225707489496033,0.001688251105138059,0.6468085106382979
728,1254,치/Noun,235,90,145,0.0010003779205477628,0.001610502698980385,0.6170212765957447
729,1257,버렸다/Verb,234,65,169,0.0007224951648400508,0.0018770686629495524,0.7222222222222222
730,1258,독립영화/Noun,234,75,159,0.0008336482671231353,0.0017659995112957324,0.6794871794871795
731,1259,든다/Verb,234,143,91,0.0015894893626481115,0.001010729280049759,0.6111111111111112
732,1261,보고싶은/Verb,233,209,24,0.002323099837716471,0.0002665659639691672,0.8969957081545065
733,1262,OST/Alpha,233,191,42,0.0021230242536069183,0.00046649043694604257,0.8197424892703863
734,1263,필요없는/Adjective,233,188,45,0.0020896783229219927,0.0004998111824421885,0.8068669527896996
735,1264,대단하다/Adjective,233,165,68,0.0018340261876708976,0.0007552702312459737,0.7081545064377682
736,1265,잘못/Noun,233,83,150,0.0009225707489496033,0.001666037274807295,0.6437768240343348
737,1269,봤었는데/Verb,232,172,60,0.0019118333592690567,0.000666414909922918,0.7413793103448276
738,1270,않게/Verb,231,171,60,0.001900718049040749,0.000666414909922918,0.7402597402597403
739,1271,있다는/Adjective,231,154,77,0.0017117577751595047,0.0008552324677344116,0.6666666666666666
740,1272,돼/Verb,231,83,148,0.0009225707489496033,0.001643823444476531,0.6406926406926406
741,1275,리얼/Noun,230,156,74,0.0017339883956161216,0.0008219117222382655,0.6782608695652174
742,1276,평생/Noun,230,147,83,0.0016339506035613453,0.0009218739587267033,0.6391304347826087
743,1279,유쾌한/Adjective,229,211,18,0.002345330458173088,0.00019992447297687542,0.9213973799126638
744,1280,멋/Noun,228,174,54,0.0019340639797256738,0.0005997734189306263,0.7631578947368421
745,1281,마라/Adjective,228,55,173,0.000611342062556966,0.0019214963236110802,0.7587719298245614
746,1282,범인/Noun,228,62,166,0.0006891492341551253,0.0018437479174534066,0.7280701754385965
747,1283,웃김/Verb,228,165,63,0.0018340261876708976,0.0006997356554190639,0.7236842105263158
748,1284,없지만/Adjective,228,146,82,0.0016228352933330367,0.0009107670435613213,0.6403508771929824
749,1285,재밌습니다/Adjective,227,214,13,0.0023786763888580128,0.00014438989714996554,0.9427312775330396
750,1286,남는다/Verb,227,184,43,0.002045217082008759,0.0004775973521114245,0.8105726872246696
751,1287,되게/Adverb,227,149,78,0.0016561812240179624,0.0008663393828997934,0.6563876651982379
752,1288,어린이/Noun,227,87,140,0.0009670319898628369,0.0015549681231534756,0.6167400881057269
753,1291,박수/Noun,226,151,75,0.0016784118444745793,0.0008330186374036475,0.668141592920354
754,1292,나와/Verb,226,85,141,0.0009448013694062199,0.0015660750383188573,0.6238938053097345
755,1296,손발/Noun,225,22,203,0.00024453682502278637,0.002254703778572539,0.9022222222222224
756,1297,그래/Adjective,225,82,143,0.0009114554387212947,0.0015882888686496212,0.6355555555555555
757,1298,고생/Noun,225,87,138,0.0009670319898628369,0.0015327542928227115,0.6133333333333333
758,1299,재밌었는데/Adjective,224,159,65,0.0017673343263010473,0.0007219494857498278,0.7098214285714286
759,1302,재밌었음/Adjective,223,213,10,0.0023675610786297045,0.00011106915165381967,0.9551569506726456
760,1303,굳이/Noun,223,45,178,0.0005001889602738814,0.0019770308994379896,0.7982062780269058
761,1304,부족한/Adjective,223,69,154,0.0007669564057532844,0.0017104649354688231,0.6905829596412556
762,1305,로맨틱/Noun,223,141,82,0.0015672587421914947,0.0009107670435613213,0.6322869955156951
763,1311,밤/Noun,222,158,64,0.0017562190160727387,0.0007108425705844457,0.7117117117117117
764,1312,어이없는/Adjective,221,8,213,8.892248182646779e-05,0.002365772930226359,0.9638009049773756
765,1316,별루/Noun,220,12,208,0.00013338372273970166,0.0023102383543994486,0.9454545454545454
766,1317,슬픔/Noun,220,192,28,0.0021341395638352265,0.000310993624630695,0.8727272727272727
767,1318,보여준/Verb,220,166,54,0.0018451414978992067,0.0005997734189306263,0.7545454545454545
768,1319,용이/Noun,220,69,151,0.0007669564057532844,0.001677144189972677,0.6863636363636364
769,1320,차/Noun,220,84,136,0.0009336860591779117,0.0015105404624919474,0.6181818181818182
770,1323,포장/Noun,219,20,199,0.00022230620456616945,0.0022102761179110114,0.9086757990867579
771,1324,있습니다/Adjective,219,181,38,0.0020118711513238334,0.0004220627762845148,0.8264840182648402
772,1325,주기/Noun,219,40,179,0.0004446124091323389,0.001988137814603372,0.817351598173516
773,1326,스럽다/Adjective,219,51,168,0.0005668808216437321,0.0018659617477841703,0.7671232876712328
774,1327,시도/Noun,219,57,162,0.0006335726830135829,0.0017993202567918784,0.7397260273972602
775,1328,ㅅㅂ/KoreanParticle,218,20,198,0.00022230620456616945,0.0021991692027456293,0.908256880733945
776,1329,순수한/Adjective,218,193,25,0.002145254874063535,0.0002776728791345492,0.8853211009174312
777,1330,있었던/Adjective,218,165,53,0.0018340261876708976,0.0005886665037652442,0.7568807339449541
778,1331,아침/Noun,218,56,162,0.0006224573727852744,0.0017993202567918784,0.7431192660550459
779,1334,재밌네/Adjective,217,204,13,0.0022675232865749283,0.00014438989714996554,0.9400921658986175
780,1335,있다면/Adjective,217,139,78,0.0015450281217348775,0.0008663393828997934,0.6405529953917051
781,1336,함/Verb,217,78,139,0.0008669941978080608,0.0015438612079880936,0.6405529953917051
782,1337,봅니다/Verb,217,133,84,0.0014783362603650269,0.0009329808738920851,0.6129032258064516
783,1342,귀여운/Adjective,216,173,43,0.0019229486694973656,0.0004775973521114245,0.8009259259259259
784,1343,광고/Noun,216,47,169,0.0005224195807304982,0.0018770686629495524,0.7824074074074074
785,1344,그럼/Adjective,216,69,147,0.0007669564057532844,0.0016327165293111491,0.6805555555555556
786,1347,재밌/Adjective,215,184,31,0.002045217082008759,0.00034431437012684104,0.8558139534883721
787,1348,어색한/Adjective,215,32,183,0.00035568992730587116,0.0020325654752649,0.8511627906976744
788,1349,짱/Modifier,215,181,34,0.0020118711513238334,0.00037763511562298685,0.8418604651162791
789,1350,진실/Noun,215,142,73,0.0015783740524198029,0.0008108048070728836,0.6604651162790698
790,1351,해라/Verb,215,81,134,0.0009003401284929863,0.0014883266321611835,0.6232558139534884
791,1355,암/Noun,214,59,155,0.0006558033034701999,0.0017215718506342046,0.7242990654205608
792,1356,흐름/Noun,214,83,131,0.0009225707489496033,0.0014550058866650375,0.6121495327102804
793,1359,됩니다/Verb,213,150,63,0.0016672965342462707,0.0006997356554190639,0.7042253521126759
794,1360,같고/Adjective,213,84,129,0.0009336860591779117,0.0014327920563342734,0.6056338028169014
795,1363,성도/Noun,212,25,187,0.0002778827557077118,0.002076993135926428,0.8820754716981132
796,1364,한계/Noun,212,38,174,0.000422381788675722,0.0019326032387764625,0.8207547169811321
797,1365,그럭저럭/Adverb,212,52,160,0.0005779961318720405,0.0017771064264611148,0.7547169811320755
798,1366,아닌듯/Adjective,212,52,160,0.0005779961318720405,0.0017771064264611148,0.7547169811320755
799,1367,전/Foreign,212,157,55,0.00174510370584443,0.0006108803340960082,0.7405660377358491
800,1368,조차/Josa,212,56,156,0.0006224573727852744,0.0017326787657995868,0.7358490566037735
801,1369,심/Noun,212,73,139,0.0008114176466665183,0.0015438612079880936,0.6556603773584906
802,1370,써/Verb,212,79,133,0.0008781095080363692,0.0014772197169958016,0.6273584905660378
803,1373,~^^/Punctuation,211,202,9,0.0022452926661183114,9.996223648843771e-05,0.957345971563981
804,1374,귀엽고/Adjective,211,194,17,0.0021563701842918434,0.00018881755781149343,0.919431279620853
805,1375,여전히/Adjective,211,153,58,0.0017006424649311962,0.0006442010795921541,0.7251184834123223
806,1376,느껴지는/Verb,211,152,59,0.0016895271547028878,0.000655307994757536,0.7203791469194313
807,1377,독특한/Adjective,211,151,60,0.0016784118444745793,0.000666414909922918,0.7156398104265402
808,1378,진정/Noun,211,146,65,0.0016228352933330367,0.0007219494857498278,0.6919431279620853
809,1379,..?/Punctuation,211,82,129,0.0009114554387212947,0.0014327920563342734,0.6113744075829384
810,1382,아름답고/Adjective,210,198,12,0.002200831425205077,0.0001332829819845836,0.9428571428571428
811,1383,만들어진/Verb,210,148,62,0.0016450659137896538,0.0006886287402536821,0.7047619047619048
812,1384,살짝/Noun,210,140,70,0.001556143431963186,0.0007774840615767378,0.6666666666666666
813,1385,있지/Adjective,210,72,138,0.00080030233643821,0.0015327542928227115,0.6571428571428571
814,1388,발견/Noun,209,175,34,0.0019451792899539827,0.00037763511562298685,0.8373205741626795
815,1389,리뷰/Noun,209,80,129,0.0008892248182646778,0.0014327920563342734,0.6172248803827751
816,1394,재미없네/Adjective,208,2,206,2.2230620456616947e-05,0.002288024524068685,0.9903846153846154
817,1395,짜증나는/Adjective,208,9,199,0.00010003779205477625,0.0022102761179110114,0.9567307692307692
818,1396,개도/Noun,208,25,183,0.0002778827557077118,0.0020325654752649,0.8798076923076923
819,1397,않을/Verb,208,152,56,0.0016895271547028878,0.0006219872492613901,0.7307692307692307
820,1398,쩐다/Noun,208,145,63,0.0016117199831047284,0.0006997356554190639,0.6971153846153846
821,1399,범죄/Noun,208,72,136,0.00080030233643821,0.0015105404624919474,0.6538461538461539
822,1402,짱짱/Noun,207,199,8,0.002211946735433386,8.885532132305573e-05,0.961352657004831
823,1403,부족/Noun,207,29,178,0.0003223439966209457,0.0019770308994379896,0.8599033816425121
824,1404,지난/Noun,207,159,48,0.0017673343263010473,0.0005331319279383344,0.7681159420289855
825,1405,있네/Adjective,207,53,154,0.000589111442100349,0.0017104649354688231,0.7439613526570048
826,1406,20년/Number,207,142,65,0.0015783740524198029,0.0007219494857498278,0.6859903381642513
827,1407,야/Exclamation,207,66,141,0.0007336104750683593,0.0015660750383188573,0.6811594202898551
828,1408,받고/Verb,207,76,131,0.0008447635773514439,0.0014550058866650375,0.6328502415458938
829,1409,오락/Noun,207,125,82,0.001389413778538559,0.0009107670435613213,0.6038647342995169
830,1411,대충/Noun,206,37,169,0.00041126647844741344,0.0018770686629495524,0.8203883495145631
831,1412,영환/Noun,206,64,142,0.0007113798546117423,0.0015771819534842392,0.6893203883495146
832,1418,감탄/Noun,205,177,28,0.0019674099104106,0.000310993624630695,0.8634146341463415
833,1419,잼있게/Verb,205,174,31,0.0019340639797256738,0.00034431437012684104,0.8487804878048779
834,1420,빨/Noun,205,54,151,0.0006002267523286575,0.001677144189972677,0.7365853658536585
835,1421,자연/Noun,205,142,63,0.0015783740524198029,0.0006997356554190639,0.6926829268292682
836,1422,커플/Noun,205,141,64,0.0015672587421914947,0.0007108425705844457,0.6878048780487804
837,1423,시선/Noun,205,141,64,0.0015672587421914947,0.0007108425705844457,0.6878048780487804
838,1424,정서/Noun,205,76,129,0.0008447635773514439,0.0014327920563342734,0.6292682926829268
839,1425,정말로/Adverb,205,125,80,0.001389413778538559,0.0008885532132305574,0.6097560975609756
840,1428,시청자/Noun,204,41,163,0.00045572771936064734,0.001810427171957261,0.7990196078431373
841,1429,홍보/Noun,204,43,161,0.00047795833981726434,0.001788213341626497,0.7892156862745098
842,1430,쓰/Verb,204,46,158,0.0005113042705021896,0.0017548925961303507,0.7745098039215687
843,1431,하세요/Verb,204,65,139,0.0007224951648400508,0.0015438612079880936,0.6813725490196079
844,1432,몸매/Noun,204,67,137,0.0007447257852966678,0.0015216473776573296,0.6715686274509803
845,1435,아오/Exclamation,203,29,174,0.0003223439966209457,0.0019326032387764625,0.8571428571428571
846,1436,되네요/Verb,203,150,53,0.0016672965342462707,0.0005886665037652442,0.7389162561576355
847,1441,했어요/Verb,201,156,45,0.0017339883956161216,0.0004998111824421885,0.7761194029850746
848,1442,일상/Noun,201,154,47,0.0017117577751595047,0.0005220250127729526,0.7661691542288557
849,1443,않나/Verb,201,54,147,0.0006002267523286575,0.0016327165293111491,0.7313432835820896
850,1444,포기/Noun,201,56,145,0.0006224573727852744,0.001610502698980385,0.7213930348258707
851,1445,사는/Verb,201,132,69,0.0014672209501367186,0.0007663771464113557,0.6567164179104478
852,1446,코드/Noun,201,76,125,0.0008447635773514439,0.001388364395672746,0.6218905472636815
853,1447,첨/Noun,201,77,124,0.0008558788875797522,0.0013772574805073642,0.6169154228855721
854,1448,없는데/Adjective,201,78,123,0.0008669941978080608,0.001366150565341982,0.6119402985074627
855,1451,떨어지는/Verb,200,34,166,0.0003779205477624881,0.0018437479174534066,0.83
856,1452,하다가/Verb,200,61,139,0.0006780339239268168,0.0015438612079880936,0.695
857,1453,30분/Number,199,51,148,0.0005668808216437321,0.001643823444476531,0.7437185929648241
858,1454,에서의/Josa,199,143,56,0.0015894893626481115,0.0006219872492613901,0.7185929648241206
859,1457,이따위/Modifier,198,8,190,8.892248182646779e-05,0.0021103138814225733,0.9595959595959596
860,1458,낮아서/Adjective,198,179,19,0.0019896405308672165,0.00021103138814225735,0.904040404040404
861,1459,눈빛/Noun,198,175,23,0.0019451792899539827,0.0002554590488037852,0.8838383838383839
862,1460,10분/Number,198,36,162,0.000400151168219105,0.0017993202567918784,0.8181818181818182
863,1461,보라/Noun,198,64,134,0.0007113798546117423,0.0014883266321611835,0.6767676767676768
864,1462,끼리/Noun,198,71,127,0.0007891870262099014,0.0014105782260035095,0.6414141414141414
865,1463,사극/Noun,198,123,75,0.001367183158081942,0.0008330186374036475,0.6212121212121212
866,1466,말로/Noun,197,140,57,0.001556143431963186,0.0006330941644267722,0.7106598984771574
867,1468,뜬금/Noun,196,17,179,0.00018896027388124405,0.001988137814603372,0.9132653061224488
868,1469,핵/Noun,196,37,159,0.00041126647844741344,0.0017659995112957324,0.8112244897959183
869,1470,보긴/Verb,196,49,147,0.0005446502011871152,0.0016327165293111491,0.75
870,1471,상처/Noun,196,143,53,0.0015894893626481115,0.0005886665037652442,0.7295918367346939
871,1472,풀어/Verb,196,137,59,0.0015227975012782607,0.000655307994757536,0.6989795918367347
872,1473,가진/Verb,196,131,65,0.0014561056399084098,0.0007219494857498278,0.6683673469387755
873,1474,웃겨/Verb,196,128,68,0.0014227597092234846,0.0007552702312459737,0.6530612244897959
874,1475,실감/Noun,196,128,68,0.0014227597092234846,0.0007552702312459737,0.6530612244897959
875,1481,지루해서/Adjective,195,11,184,0.00012226841251139318,0.0020436723904302817,0.9435897435897436
876,1482,끌/Noun,195,22,173,0.00024453682502278637,0.0019214963236110802,0.8871794871794871
877,1483,힐링/Noun,195,171,24,0.001900718049040749,0.0002665659639691672,0.8769230769230769
878,1484,혹시/Noun,195,48,147,0.0005335348909588066,0.0016327165293111491,0.7538461538461538
879,1485,신선한/Adjective,195,145,50,0.0016117199831047284,0.0005553457582690984,0.7435897435897436
880,1486,막판/Noun,195,58,137,0.0006446879932418914,0.0015216473776573296,0.7025641025641025
881,1487,빛/Noun,195,127,68,0.001411644398995176,0.0007552702312459737,0.6512820512820513
882,1488,먼/Adjective,195,72,123,0.00080030233643821,0.001366150565341982,0.6307692307692307
883,1492,아깝지/Adjective,194,160,34,0.0017784496365293556,0.00037763511562298685,0.8247422680412371
884,1493,우정/Noun,194,143,51,0.0015894893626481115,0.0005664526734344802,0.7371134020618557
885,1494,해피엔딩/Noun,194,138,56,0.0015339128115065689,0.0006219872492613901,0.711340206185567
886,1495,죄/Noun,194,67,127,0.0007447257852966678,0.0014105782260035095,0.6546391752577321
887,1501,슬프고/Adjective,193,182,11,0.002022986461552142,0.00012217606681920164,0.9430051813471504
888,1502,아름답다/Adjective,193,177,16,0.0019674099104106,0.00017771064264611146,0.917098445595855
889,1507,버리고/Verb,192,47,145,0.0005224195807304982,0.001610502698980385,0.7552083333333334
890,1508,했습니다/Verb,192,132,60,0.0014672209501367186,0.000666414909922918,0.6875
891,1510,있네요/Adjective,191,150,41,0.0016672965342462707,0.00045538352178066063,0.7853403141361257
892,1511,가볍게/Adjective,191,141,50,0.0015672587421914947,0.0005553457582690984,0.7382198952879581
893,1512,보아/Noun,191,134,57,0.001489451570593335,0.0006330941644267722,0.7015706806282722
894,1513,게다가/Noun,191,58,133,0.0006446879932418914,0.0014772197169958016,0.6963350785340314
895,1514,만큼/Noun,191,115,76,0.0012782606762554744,0.0008441255525690295,0.6020942408376964
896,1516,개판/Noun,190,8,182,8.892248182646779e-05,0.002021458560099518,0.9578947368421052
897,1517,뭐임/Noun,190,15,175,0.00016672965342462708,0.0019437101539418445,0.9210526315789472
898,1518,있어요/Adjective,190,170,20,0.0018896027388124407,0.00022213830330763932,0.8947368421052632
899,1519,좋습니다/Adjective,190,169,21,0.001878487428584132,0.00023324521847302128,0.8894736842105263
900,1520,나머지/Noun,190,38,152,0.000422381788675722,0.001688251105138059,0.8
901,1521,벌써/Noun,190,146,44,0.0016228352933330367,0.0004887042672768067,0.7684210526315789
902,1522,조폭/Noun,190,58,132,0.0006446879932418914,0.0014661128018304194,0.6947368421052632
903,1523,많다/Adjective,190,61,129,0.0006780339239268168,0.0014327920563342734,0.6789473684210526
904,1524,간/Noun,190,72,118,0.00080030233643821,0.001310615989515072,0.6210526315789474
905,1525,이기/Noun,190,114,76,0.0012671453660271655,0.0008441255525690295,0.6
906,1528,재미있네요/Adjective,189,181,8,0.0020118711513238334,8.885532132305573e-05,0.9576719576719576
907,1529,소장/Noun,189,173,16,0.0019229486694973656,0.00017771064264611146,0.9153439153439152
908,1530,서야/Verb,189,154,35,0.0017117577751595047,0.0003887420307883688,0.8148148148148148
909,1531,비극/Noun,189,143,46,0.0015894893626481115,0.0005109180976075704,0.7566137566137566
910,1532,까지는/Josa,189,51,138,0.0005668808216437321,0.0015327542928227115,0.7301587301587301
911,1533,주/Noun,189,73,116,0.0008114176466665183,0.0012884021591843082,0.6137566137566137
912,1537,짜증나/Adjective,188,9,179,0.00010003779205477625,0.001988137814603372,0.952127659574468
913,1538,이쁘고/Adjective,188,157,31,0.00174510370584443,0.00034431437012684104,0.8351063829787234
914,1539,섹스/Noun,188,51,137,0.0005668808216437321,0.0015216473776573296,0.7287234042553191
915,1540,만들고/Verb,188,53,135,0.000589111442100349,0.0014994335473265655,0.7180851063829787
916,1541,등장인물/Noun,188,69,119,0.0007669564057532844,0.0013217229046804538,0.6329787234042553
917,1544,형편/Noun,187,18,169,0.0002000755841095525,0.0018770686629495524,0.9037433155080212
918,1545,본방/Noun,187,166,21,0.0018451414978992067,0.00023324521847302128,0.8877005347593583
919,1546,감명/Noun,187,164,23,0.0018229108774425891,0.0002554590488037852,0.8770053475935828
920,1547,하다니/Verb,187,53,134,0.000589111442100349,0.0014883266321611835,0.7165775401069518
921,1548,뮤지컬/Noun,187,117,70,0.0013004912967120913,0.0007774840615767378,0.6256684491978609
922,1551,펑펑/Noun,186,179,7,0.0019896405308672165,7.774840615767377e-05,0.9623655913978496
923,1552,예쁜/Adjective,186,129,57,0.0014338750194517929,0.0006330941644267722,0.6935483870967742
924,1553,의문/Noun,186,67,119,0.0007447257852966678,0.0013217229046804538,0.6397849462365591
925,1554,이연걸/Noun,186,117,69,0.0013004912967120913,0.0007663771464113557,0.6290322580645161
926,1561,그다지/Noun,185,18,167,0.0002000755841095525,0.0018548548326187888,0.9027027027027028
927,1562,빼고는/Verb,185,41,144,0.00045572771936064734,0.0015993957838150033,0.7783783783783784
928,1563,토/Noun,185,44,141,0.0004890736500455726,0.0015660750383188573,0.7621621621621621
929,1564,인가요/Josa,185,57,128,0.0006335726830135829,0.0014216851411688915,0.6918918918918919
930,1565,결과/Noun,185,64,121,0.0007113798546117423,0.001343936735011218,0.6540540540540539
931,1567,넘치는/Adjective,184,148,36,0.0016450659137896538,0.00039984894595375083,0.8043478260869565
932,1568,불가/Noun,184,41,143,0.00045572771936064734,0.0015882888686496212,0.7771739130434783
933,1569,죽는줄/Verb,184,48,136,0.0005335348909588066,0.0015105404624919474,0.7391304347826086
934,1570,자유/Noun,184,128,56,0.0014227597092234846,0.0006219872492613901,0.6956521739130435
935,1571,암튼/Adverb,184,123,61,0.001367183158081942,0.0006775218250882999,0.6684782608695652
936,1572,새벽/Noun,184,122,62,0.0013560678478536335,0.0006886287402536821,0.6630434782608695
937,1574,꼴/Noun,183,23,160,0.00025565213525109487,0.0017771064264611148,0.8743169398907104
938,1575,표절/Noun,183,24,159,0.0002667674454794033,0.0017659995112957324,0.8688524590163934
939,1576,아픈/Adjective,183,153,30,0.0017006424649311962,0.000333207454961459,0.8360655737704918
940,1577,행복/Noun,183,153,30,0.0017006424649311962,0.000333207454961459,0.8360655737704918
941,1578,지도/Noun,183,60,123,0.0006669186136985082,0.001366150565341982,0.6721311475409836
942,1579,느와르/Noun,183,123,60,0.001367183158081942,0.000666414909922918,0.6721311475409836
943,1580,않/Verb,183,67,116,0.0007447257852966678,0.0012884021591843082,0.6338797814207651
944,1582,글쎄/Noun,182,21,161,0.00023342151479447792,0.001788213341626497,0.8846153846153846
945,1583,기본/Noun,182,50,132,0.0005557655114154236,0.0014661128018304194,0.7252747252747253
946,1584,오버/Noun,182,51,131,0.0005668808216437321,0.0014550058866650375,0.7197802197802198
947,1585,차이/Noun,182,68,114,0.0007558410955249762,0.001266188328853544,0.6263736263736264
948,1590,에만/Josa,181,44,137,0.0004890736500455726,0.0015216473776573296,0.7569060773480663
949,1591,보인다/Verb,181,58,123,0.0006446879932418914,0.001366150565341982,0.6795580110497238
950,1592,에게는/Josa,181,120,61,0.0013338372273970164,0.0006775218250882999,0.6629834254143646
951,1593,따위/Noun,181,63,118,0.0007002645443834338,0.001310615989515072,0.6519337016574586
952,1594,가면/Noun,181,65,116,0.0007224951648400508,0.0012884021591843082,0.6408839779005525
953,1599,멋지다/Adjective,180,171,9,0.001900718049040749,9.996223648843771e-05,0.95
954,1600,쓰래/Noun,180,10,170,0.00011115310228308472,0.0018881755781149344,0.9444444444444444
955,1601,까진/Josa,180,62,118,0.0006891492341551253,0.001310615989515072,0.6555555555555556
956,1602,악당/Noun,180,65,115,0.0007224951648400508,0.0012772952440189265,0.6388888888888888
957,1603,드럽게/Adjective,179,7,172,7.78071715981593e-05,0.0019103894084456985,0.9608938547486032
958,1604,보지마/Verb,179,13,166,0.00014449903296801013,0.0018437479174534066,0.9273743016759776
959,1605,뻔하고/Adjective,179,18,161,0.0002000755841095525,0.001788213341626497,0.8994413407821229
960,1606,높다/Adjective,179,20,159,0.00022230620456616945,0.0017659995112957324,0.888268156424581
961,1607,않지만/Verb,179,133,46,0.0014783362603650269,0.0005109180976075704,0.7430167597765364
962,1608,갑니다/Verb,179,119,60,0.0013227219171687082,0.000666414909922918,0.6648044692737429
963,1609,모/Modifier,179,67,112,0.0007447257852966678,0.0012439744985227805,0.6256983240223464
964,1616,그렇다고/Conjunction,178,34,144,0.0003779205477624881,0.0015993957838150033,0.8089887640449438
965,1617,모르게/Verb,178,134,44,0.001489451570593335,0.0004887042672768067,0.7528089887640449
966,1618,그걸/Adverb,178,70,108,0.000778071715981593,0.0011995468378612525,0.6067415730337079
967,1622,잊혀지지/Verb,177,165,12,0.0018340261876708976,0.0001332829819845836,0.9322033898305084
968,1623,이제야/Noun,177,157,20,0.00174510370584443,0.00022213830330763932,0.8870056497175142
969,1624,반복/Noun,177,68,109,0.0007558410955249762,0.0012106537530266347,0.615819209039548
970,1625,공/Modifier,177,70,107,0.000778071715981593,0.0011884399226958706,0.6045197740112994
971,1630,긴장/Noun,176,134,42,0.001489451570593335,0.00046649043694604257,0.7613636363636364
972,1631,게이/Noun,176,47,129,0.0005224195807304982,0.0014327920563342734,0.7329545454545454
973,1632,어쩔/Adverb,176,57,119,0.0006335726830135829,0.0013217229046804538,0.6761363636363636
974,1633,외국/Noun,176,57,119,0.0006335726830135829,0.0013217229046804538,0.6761363636363636
975,1636,재미있었다/Adjective,175,158,17,0.0017562190160727387,0.00018881755781149343,0.9028571428571428
976,1637,좋겠어요/Adjective,175,142,33,0.0015783740524198029,0.00036652820045760486,0.8114285714285714
977,1638,언제나/Adverb,175,128,47,0.0014227597092234846,0.0005220250127729526,0.7314285714285714
978,1639,쓰고/Verb,175,50,125,0.0005557655114154236,0.001388364395672746,0.7142857142857143
979,1640,북한/Noun,175,65,110,0.0007224951648400508,0.0012217606681920164,0.6285714285714286
980,1644,열정/Noun,174,148,26,0.0016450659137896538,0.00028877979429993113,0.8505747126436781
981,1647,아픔/Noun,173,146,27,0.0016228352933330367,0.0002998867094653131,0.8439306358381503
982,1648,창/Noun,173,31,142,0.00034457461707756266,0.0015771819534842392,0.8208092485549133
983,1649,하려는/Verb,173,43,130,0.00047795833981726434,0.0014438989714996556,0.7514450867052023
984,1650,선생님/Noun,173,129,44,0.0014338750194517929,0.0004887042672768067,0.7456647398843931
985,1651,병/Noun,173,51,122,0.0005668808216437321,0.0013550436501765998,0.7052023121387283
986,1652,쇼/Noun,173,55,118,0.000611342062556966,0.001310615989515072,0.6820809248554913
987,1655,짝/Noun,172,34,138,0.0003779205477624881,0.0015327542928227115,0.8023255813953488
988,1656,양/Modifier,172,52,120,0.0005779961318720405,0.001332829819845836,0.6976744186046512
989,1657,디즈니/Noun,172,114,58,0.0012671453660271655,0.0006442010795921541,0.6627906976744186
990,1658,보길/Verb,172,108,64,0.001200453504657315,0.0007108425705844457,0.627906976744186
991,1664,재미있었어요/Adjective,171,171,0,0.001900718049040749,0.0,1.0
992,1665,질리/Noun,171,160,11,0.0017784496365293556,0.00012217606681920164,0.935672514619883
993,1666,쩝/Adverb,171,28,143,0.0003112286863926372,0.0015882888686496212,0.8362573099415205
994,1667,극치/Noun,171,28,143,0.0003112286863926372,0.0015882888686496212,0.8362573099415205
995,1668,까지도/Josa,171,135,36,0.0015005668808216438,0.00039984894595375083,0.7894736842105263
996,1669,밥/Noun,171,47,124,0.0005224195807304982,0.0013772574805073642,0.7251461988304093
997,1670,좋/Adjective,171,121,50,0.001344952537625325,0.0005553457582690984,0.7076023391812866
998,1671,걸까/Verb,171,52,119,0.0005779961318720405,0.0013217229046804538,0.6959064327485379
999,1672,희생/Noun,171,112,59,0.0012449147455705488,0.000655307994757536,0.6549707602339181
1000,1675,무섭지도/Adjective,170,5,165,5.557655114154236e-05,0.0018326410022880247,0.9705882352941176
1001,1676,주기도/Noun,170,6,164,6.669186136985083e-05,0.0018215340871226425,0.9647058823529412
1002,1677,노답/Noun,170,14,156,0.0001556143431963186,0.0017326787657995868,0.9176470588235294
1003,1678,이었습니다/Verb,170,144,26,0.00160060467287642,0.00028877979429993113,0.8470588235294118
1004,1679,남편/Noun,170,55,115,0.000611342062556966,0.0012772952440189265,0.6764705882352942
1005,1680,한다고/Verb,170,61,109,0.0006780339239268168,0.0012106537530266347,0.6411764705882353
1006,1681,분노/Noun,170,67,103,0.0007447257852966678,0.0011440122620343426,0.6058823529411764
1007,1685,가는줄/Verb,169,165,4,0.0018340261876708976,4.4427660661527865e-05,0.9763313609467456
1008,1686,죄다/Adverb,169,19,150,0.00021119089433786097,0.001666037274807295,0.8875739644970414
1009,1687,싸구려/Noun,169,21,148,0.00023342151479447792,0.001643823444476531,0.8757396449704142
1010,1688,할말이/Verb,169,28,141,0.0003112286863926372,0.0015660750383188573,0.8343195266272192
1011,1689,에로/Josa,169,39,130,0.0004334970989040304,0.0014438989714996556,0.7692307692307693
1012,1690,마저/Josa,169,51,118,0.0005668808216437321,0.001310615989515072,0.6982248520710059
1013,1691,헐리우드/Noun,169,52,117,0.0005779961318720405,0.0012995090743496902,0.6923076923076923
1014,1692,되서/Verb,169,109,60,0.0012115688148856235,0.000666414909922918,0.6449704142011834
1015,1693,작은/Adjective,169,106,63,0.001178222884200698,0.0006997356554190639,0.6272189349112426
1016,1696,짜증난다/Adjective,168,6,162,6.669186136985083e-05,0.0017993202567918784,0.9642857142857144
1017,1697,어머니/Noun,168,123,45,0.001367183158081942,0.0004998111824421885,0.7321428571428571
1018,1698,=/Punctuation,168,55,113,0.000611342062556966,0.0012550814136881624,0.6726190476190477
1019,1699,청소년/Noun,168,62,106,0.0006891492341551253,0.0011773330075304884,0.6309523809523809
1020,1700,시각/Noun,168,102,66,0.0011337616432874642,0.0007330564009152097,0.6071428571428571
1021,1705,제로/Noun,167,16,151,0.00017784496365293558,0.001677144189972677,0.9041916167664672
1022,1706,유발/Noun,167,21,146,0.00023342151479447792,0.0016216096141457672,0.8742514970059879
1023,1707,보지마라/Verb,167,21,146,0.00023342151479447792,0.0016216096141457672,0.8742514970059879
1024,1708,딱히/Adjective,167,27,140,0.0003001133761643288,0.0015549681231534756,0.8383233532934131
1025,1709,필름/Noun,167,34,133,0.0003779205477624881,0.0014772197169958016,0.7964071856287425
1026,1710,조절/Noun,167,40,127,0.0004446124091323389,0.0014105782260035095,0.7604790419161677
1027,1711,본인/Noun,167,56,111,0.0006224573727852744,0.0012328675833573985,0.6646706586826348
1028,1712,_/Punctuation,167,106,61,0.001178222884200698,0.0006775218250882999,0.6347305389221557
1029,1713,떠나서/Verb,167,63,104,0.0007002645443834338,0.0011551191771997243,0.6227544910179641
1030,1714,싸움/Noun,167,66,101,0.0007336104750683593,0.0011217984317035787,0.6047904191616766
1031,1720,재미없어요/Adjective,166,2,164,2.2230620456616947e-05,0.0018215340871226425,0.9879518072289156
1032,1721,사랑스러운/Adjective,166,162,4,0.0018006802569859727,4.4427660661527865e-05,0.9759036144578314
1033,1722,꺼/Verb,166,12,154,0.00013338372273970166,0.0017104649354688231,0.927710843373494
1034,1723,미드/Noun,166,111,55,0.0012337994353422404,0.0006108803340960082,0.6686746987951807
1035,1724,실력/Noun,166,57,109,0.0006335726830135829,0.0012106537530266347,0.6566265060240963
1036,1728,좋았던/Adjective,165,156,9,0.0017339883956161216,9.996223648843771e-05,0.9454545454545454
1037,1729,기대했는데/Adjective,165,11,154,0.00012226841251139318,0.0017104649354688231,0.9333333333333332
1038,1730,호러/Noun,165,58,107,0.0006446879932418914,0.0011884399226958706,0.6484848484848484
1039,1731,방금/Noun,165,104,61,0.001155992263744081,0.0006775218250882999,0.6303030303030303
1040,1732,금/Noun,165,61,104,0.0006780339239268168,0.0011551191771997243,0.6303030303030303
1041,1733,라인/Noun,165,63,102,0.0007002645443834338,0.0011329053468689607,0.6181818181818182
1042,1737,굿굿/Noun,164,161,3,0.001789564946757664,3.33207454961459e-05,0.9817073170731708
1043,1738,없어요/Adjective,164,44,120,0.0004890736500455726,0.001332829819845836,0.7317073170731707
1044,1739,젊은/Adjective,164,111,53,0.0012337994353422404,0.0005886665037652442,0.6768292682926829
1045,1740,맨날/Adverb,164,58,106,0.0006446879932418914,0.0011773330075304884,0.6463414634146342
1046,1741,쫌/Noun,164,59,105,0.0006558033034701999,0.0011662260923651065,0.6402439024390244
1047,1747,어휴/Exclamation,163,21,142,0.00023342151479447792,0.0015771819534842392,0.8711656441717791
1048,1748,실패/Noun,163,27,136,0.0003001133761643288,0.0015105404624919474,0.8343558282208589
1049,1749,뛰어난/Adjective,163,124,39,0.0013782984683102506,0.0004331696914498967,0.7607361963190185
1050,1750,아줌마/Noun,163,46,117,0.0005113042705021896,0.0012995090743496902,0.7177914110429447
1051,1751,싶네요/Verb,163,113,50,0.0012560300557988573,0.0005553457582690984,0.6932515337423313
1052,1757,하고자/Verb,162,33,129,0.00036680523753417966,0.0014327920563342734,0.7962962962962963
1053,1758,은근/Noun,162,127,35,0.001411644398995176,0.0003887420307883688,0.7839506172839507
1054,1759,심장/Noun,162,126,36,0.0014005290887668675,0.00039984894595375083,0.7777777777777778
1055,1760,조합/Noun,162,98,64,0.0010893004023742304,0.0007108425705844457,0.6049382716049383
1056,1762,탄탄한/Adjective,161,146,15,0.0016228352933330367,0.0001666037274807295,0.906832298136646
1057,1763,나오네/Verb,161,32,129,0.00035568992730587116,0.0014327920563342734,0.8012422360248447
1058,1764,빠진/Verb,161,51,110,0.0005668808216437321,0.0012217606681920164,0.6832298136645962
1059,1765,아쉽네요/Adjective,161,106,55,0.001178222884200698,0.0006108803340960082,0.6583850931677019
1060,1766,인해/Adjective,161,102,59,0.0011337616432874642,0.000655307994757536,0.6335403726708074
1061,1770,1시간/Number,160,35,125,0.0003890358579907965,0.001388364395672746,0.78125
1062,1771,아이돌/Noun,160,54,106,0.0006002267523286575,0.0011773330075304884,0.6625
1063,1772,한국인/Noun,160,57,103,0.0006335726830135829,0.0011440122620343426,0.64375
1064,1773,히어로/Noun,160,97,63,0.0010781850921459217,0.0006997356554190639,0.60625
1065,1776,잔잔하고/Adjective,159,148,11,0.0016450659137896538,0.00012217606681920164,0.9308176100628932
1066,1777,명품/Noun,159,135,24,0.0015005668808216438,0.0002665659639691672,0.8490566037735849
1067,1778,존경/Noun,159,126,33,0.0014005290887668675,0.00036652820045760486,0.7924528301886793
1068,1779,찍은/Verb,159,45,114,0.0005001889602738814,0.001266188328853544,0.7169811320754716
1069,1780,본다면/Verb,159,99,60,0.0011004157126025386,0.000666414909922918,0.6226415094339622
1070,1781,따뜻해지는/Adjective,158,156,2,0.0017339883956161216,2.2213830330763933e-05,0.9873417721518988
1071,1782,시트콤/Noun,158,109,49,0.0012115688148856235,0.0005442388431037163,0.689873417721519
1072,1783,어쩔/Modifier,158,50,108,0.0005557655114154236,0.0011995468378612525,0.6835443037974683
1073,1784,성/Noun,158,56,102,0.0006224573727852744,0.0011329053468689607,0.6455696202531646
1074,1785,대부분/Noun,158,60,98,0.0006669186136985082,0.001088477686207433,0.620253164556962
1075,1786,좋지만/Adjective,158,63,95,0.0007002645443834338,0.0010551569407112867,0.6012658227848101
1076,1788,생각나는/Verb,157,138,19,0.0015339128115065689,0.00021103138814225735,0.8789808917197452
1077,1789,푹/Noun,157,137,20,0.0015227975012782607,0.00022213830330763932,0.8726114649681529
1078,1790,신선하고/Adjective,157,137,20,0.0015227975012782607,0.00022213830330763932,0.8726114649681529
1079,1791,만족/Noun,157,113,44,0.0012560300557988573,0.0004887042672768067,0.7197452229299363
1080,1792,이니/Josa,157,56,101,0.0006224573727852744,0.0011217984317035787,0.643312101910828
1081,1793,주말/Noun,157,99,58,0.0011004157126025386,0.0006442010795921541,0.6305732484076433
1082,1794,신분/Noun,157,99,58,0.0011004157126025386,0.0006442010795921541,0.6305732484076433
1083,1799,웃기지도/Verb,156,3,153,3.334593068492541e-05,0.001699358020303441,0.9807692307692308
1084,1800,쵝오/Noun,156,151,5,0.0016784118444745793,5.5534575826909837e-05,0.9679487179487181
1085,1801,성한/Adjective,156,10,146,0.00011115310228308472,0.0016216096141457672,0.935897435897436
1086,1802,봤더니/Verb,156,46,110,0.0005113042705021896,0.0012217606681920164,0.7051282051282052
1087,1803,보고나면/Verb,156,97,59,0.0010781850921459217,0.000655307994757536,0.6217948717948718
1088,1809,즐겁게/Adjective,155,143,12,0.0015894893626481115,0.0001332829819845836,0.9225806451612903
1089,1810,아름다/Adjective,155,128,27,0.0014227597092234846,0.0002998867094653131,0.8258064516129032
1090,1811,전개도/Noun,155,54,101,0.0006002267523286575,0.0011217984317035787,0.6516129032258065
1091,1812,30/Number,155,98,57,0.0010893004023742304,0.0006330941644267722,0.6322580645161291
1092,1817,짝퉁/Noun,154,7,147,7.78071715981593e-05,0.0016327165293111491,0.9545454545454546
1093,1818,개뿔/Noun,154,7,147,7.78071715981593e-05,0.0016327165293111491,0.9545454545454546
1094,1819,왠만하면/Adjective,154,11,143,0.00012226841251139318,0.0015882888686496212,0.9285714285714286
1095,1820,보겠다/Verb,154,12,142,0.00013338372273970166,0.0015771819534842392,0.9220779220779219
1096,1821,양심/Noun,154,28,126,0.0003112286863926372,0.0013994713108381278,0.8181818181818182
1097,1822,챙겨/Verb,154,122,32,0.0013560678478536335,0.00035542128529222287,0.7922077922077922
1098,1823,????/Punctuation,154,36,118,0.000400151168219105,0.001310615989515072,0.7662337662337663
1099,1824,누군가/Noun,154,118,36,0.0013116066069403995,0.00039984894595375083,0.7662337662337663
1100,1825,보았다/Verb,154,114,40,0.0012671453660271655,0.0004442766066152787,0.7402597402597403
1101,1826,그거/Noun,154,45,109,0.0005001889602738814,0.0012106537530266347,0.7077922077922078
1102,1827,개념/Noun,154,49,105,0.0005446502011871152,0.0011662260923651065,0.6818181818181818
1103,1828,이자/Noun,154,103,51,0.0011448769535157724,0.0005664526734344802,0.6688311688311688
1104,1829,으로만/Josa,154,55,99,0.000611342062556966,0.0010995846013728146,0.6428571428571429
1105,1830,끼/Noun,154,58,96,0.0006446879932418914,0.0010662638558766688,0.6233766233766234
1106,1832,망/Noun,153,19,134,0.00021119089433786097,0.0014883266321611835,0.8758169934640523
1107,1833,연예인/Noun,153,27,126,0.0003001133761643288,0.0013994713108381278,0.8235294117647058
1108,1834,도안/Noun,153,38,115,0.000422381788675722,0.0012772952440189265,0.7516339869281046
1109,1835,가요/Noun,153,39,114,0.0004334970989040304,0.001266188328853544,0.7450980392156863
1110,1836,했는지/Verb,153,40,113,0.0004446124091323389,0.0012550814136881624,0.7385620915032679
1111,1837,전반/Noun,153,49,104,0.0005446502011871152,0.0011551191771997243,0.6797385620915033
1112,1838,진리/Noun,153,101,52,0.0011226463330591557,0.0005775595885998622,0.6601307189542484
1113,1839,이정/Noun,153,60,93,0.0006669186136985082,0.001032943110380523,0.6078431372549019
1114,1843,잼있어요/Verb,152,144,8,0.00160060467287642,8.885532132305573e-05,0.9473684210526316
1115,1844,내고/Verb,152,19,133,0.00021119089433786097,0.0014772197169958016,0.875
1116,1845,의외로/Adverb,152,129,23,0.0014338750194517929,0.0002554590488037852,0.8486842105263158
1117,1846,여행/Noun,152,104,48,0.001155992263744081,0.0005331319279383344,0.6842105263157895
1118,1847,향/Noun,152,100,52,0.0011115310228308473,0.0005775595885998622,0.6578947368421053
1119,1848,19/Number,152,56,96,0.0006224573727852744,0.0010662638558766688,0.631578947368421
1120,1851,지루했다/Adjective,151,7,144,7.78071715981593e-05,0.0015993957838150033,0.9536423841059604
1121,1852,사기/Noun,151,33,118,0.00036680523753417966,0.001310615989515072,0.7814569536423841
1122,1853,과장/Noun,151,51,100,0.0005668808216437321,0.0011106915165381968,0.6622516556291391
1123,1854,보려고/Verb,151,59,92,0.0006558033034701999,0.0010218361952151409,0.6092715231788081
1124,1862,라지/Noun,150,18,132,0.0002000755841095525,0.0014661128018304194,0.88
1125,1863,그렇다/Adjective,150,25,125,0.0002778827557077118,0.001388364395672746,0.8333333333333334
1126,1864,보며/Verb,150,116,34,0.0012893759864837828,0.00037763511562298685,0.7733333333333333
1127,1865,더불어/Verb,150,111,39,0.0012337994353422404,0.0004331696914498967,0.74
1128,1866,하는건/Verb,150,47,103,0.0005224195807304982,0.0011440122620343426,0.6866666666666666
1129,1867,갈등/Noun,150,95,55,0.0010559544716893046,0.0006108803340960082,0.6333333333333333
1130,1875,울었다/Verb,149,137,12,0.0015227975012782607,0.0001332829819845836,0.9194630872483222
1131,1876,살다/Verb,149,15,134,0.00016672965342462708,0.0014883266321611835,0.8993288590604027
1132,1877,단연/Noun,149,128,21,0.0014227597092234846,0.00023324521847302128,0.8590604026845637
1133,1878,무척/Noun,149,114,35,0.0012671453660271655,0.0003887420307883688,0.7651006711409396
1134,1879,성장/Noun,149,110,39,0.001222684125113932,0.0004331696914498967,0.7382550335570469
1135,1880,......../Punctuation,149,45,104,0.0005001889602738814,0.0011551191771997243,0.6979865771812079
1136,1881,번째/Suffix,149,95,54,0.0010559544716893046,0.0005997734189306263,0.6375838926174496
1137,1882,초등학생/Noun,149,56,93,0.0006224573727852744,0.001032943110380523,0.6241610738255033
1138,1883,연속/Noun,149,59,90,0.0006558033034701999,0.000999622364884377,0.6040268456375839
1139,1889,이도/Noun,148,5,143,5.557655114154236e-05,0.0015882888686496212,0.9662162162162162
1140,1890,모르겠고/Verb,148,20,128,0.00022230620456616945,0.0014216851411688915,0.8648648648648649
1141,1891,재밌다고/Adjective,148,29,119,0.0003223439966209457,0.0013217229046804538,0.8040540540540541
1142,1892,상/Noun,148,44,104,0.0004890736500455726,0.0011551191771997243,0.7027027027027027
1143,1893,피해자/Noun,148,44,104,0.0004890736500455726,0.0011551191771997243,0.7027027027027027
1144,1894,감히/Noun,148,97,51,0.0010781850921459217,0.0005664526734344802,0.6554054054054054
1145,1895,뒷/Modifier,148,53,95,0.000589111442100349,0.0010551569407112867,0.6418918918918919
1146,1896,나쁘지/Adjective,148,94,54,0.0010448391614609964,0.0005997734189306263,0.6351351351351351
1147,1899,유쾌하고/Adjective,147,140,7,0.001556143431963186,7.774840615767377e-05,0.9523809523809524
1148,1900,꽝/Noun,147,8,139,8.892248182646779e-05,0.0015438612079880936,0.9455782312925172
1149,1901,멋있다/Adjective,147,137,10,0.0015227975012782607,0.00011106915165381967,0.9319727891156464
1150,1902,버림/Verb,147,20,127,0.00022230620456616945,0.0014105782260035095,0.8639455782312925
1151,1903,라이/Noun,147,28,119,0.0003112286863926372,0.0013217229046804538,0.8095238095238095
1152,1904,편견/Noun,147,103,44,0.0011448769535157724,0.0004887042672768067,0.7006802721088435
1153,1905,베스트/Noun,147,97,50,0.0010781850921459217,0.0005553457582690984,0.6598639455782312
1154,1911,사수/Noun,146,132,14,0.0014672209501367186,0.0001554968123153475,0.9041095890410958
1155,1912,행복한/Adjective,146,128,18,0.0014227597092234846,0.00019992447297687542,0.8767123287671232
1156,1913,허세/Noun,146,18,128,0.0002000755841095525,0.0014216851411688915,0.8767123287671232
1157,1914,와우/Noun,146,125,21,0.001389413778538559,0.00023324521847302128,0.8561643835616438
1158,1915,명성/Noun,146,25,121,0.0002778827557077118,0.001343936735011218,0.8287671232876712
1159,1916,힘들다/Adjective,146,31,115,0.00034457461707756266,0.0012772952440189265,0.7876712328767124
1160,1917,빠져/Verb,146,111,35,0.0012337994353422404,0.0003887420307883688,0.7602739726027398
1161,1918,얘/Noun,146,40,106,0.0004446124091323389,0.0011773330075304884,0.726027397260274
1162,1919,확/Noun,146,50,96,0.0005557655114154236,0.0010662638558766688,0.6575342465753424
1163,1927,개막/Noun,145,9,136,0.00010003779205477625,0.0015105404624919474,0.9379310344827586
1164,1928,^/Punctuation,145,102,43,0.0011337616432874642,0.0004775973521114245,0.7034482758620689
1165,1929,연결/Noun,145,50,95,0.0005557655114154236,0.0010551569407112867,0.6551724137931034
1166,1930,이쁘다/Adjective,145,92,53,0.0010226085410043797,0.0005886665037652442,0.6344827586206897
1167,1931,먹는/Verb,145,55,90,0.000611342062556966,0.000999622364884377,0.6206896551724138
1168,1936,마이너스/Noun,144,7,137,7.78071715981593e-05,0.0015216473776573296,0.9513888888888888
1169,1937,만들어도/Verb,144,18,126,0.0002000755841095525,0.0013994713108381278,0.875
1170,1938,멍청한/Adjective,144,24,120,0.0002667674454794033,0.001332829819845836,0.8333333333333334
1171,1939,답답하고/Adjective,144,25,119,0.0002778827557077118,0.0013217229046804538,0.8263888888888888
1172,1940,묘/Noun,144,118,26,0.0013116066069403995,0.00028877979429993113,0.8194444444444444
1173,1941,그려/Verb,144,113,31,0.0012560300557988573,0.00034431437012684104,0.7847222222222222
1174,1942,...?/Punctuation,144,54,90,0.0006002267523286575,0.000999622364884377,0.625
1175,1943,만큼은/Josa,144,90,54,0.0010003779205477628,0.0005997734189306263,0.625
1176,1944,쪽/Noun,144,57,87,0.0006335726830135829,0.0009663016193882313,0.6041666666666666
1177,1947,저/Modifier,143,26,117,0.00028899806593602026,0.0012995090743496902,0.8181818181818182
1178,1948,더러운/Adjective,143,26,117,0.00028899806593602026,0.0012995090743496902,0.8181818181818182
1179,1949,위대한/Adjective,143,109,34,0.0012115688148856235,0.00037763511562298685,0.7622377622377622
1180,1950,쓰는/Verb,143,37,106,0.00041126647844741344,0.0011773330075304884,0.7412587412587412
1181,1951,풍경/Noun,143,101,42,0.0011226463330591557,0.00046649043694604257,0.7062937062937062
1182,1952,처/Noun,143,44,99,0.0004890736500455726,0.0010995846013728146,0.6923076923076923
1183,1953,봐야지/Verb,143,98,45,0.0010893004023742304,0.0004998111824421885,0.6853146853146853
1184,1954,무언가/Noun,143,97,46,0.0010781850921459217,0.0005109180976075704,0.6783216783216783
1185,1955,보자/Verb,143,55,88,0.000611342062556966,0.000977408534553613,0.6153846153846154
1186,1958,재밌던데/Adjective,142,138,4,0.0015339128115065689,4.4427660661527865e-05,0.9718309859154929
1187,1959,ㅉㅉㅉ/KoreanParticle,142,15,127,0.00016672965342462708,0.0014105782260035095,0.8943661971830986
1188,1960,싸이코/Noun,142,29,113,0.0003223439966209457,0.0012550814136881624,0.7957746478873241
1189,1961,만들기/Noun,142,30,112,0.00033345930684925416,0.0012439744985227805,0.7887323943661971
1190,1962,빼면/Verb,142,46,96,0.0005113042705021896,0.0010662638558766688,0.676056338028169
1191,1963,개성/Noun,142,87,55,0.0009670319898628369,0.0006108803340960082,0.6126760563380281
1192,1966,달달/Noun,141,125,16,0.001389413778538559,0.00017771064264611146,0.8865248226950354
1193,1967,어린시절/Noun,141,123,18,0.001367183158081942,0.00019992447297687542,0.8723404255319149
1194,1968,하려고/Verb,141,25,116,0.0002778827557077118,0.0012884021591843082,0.8226950354609929
1195,1969,정체/Noun,141,30,111,0.00033345930684925416,0.0012328675833573985,0.7872340425531915
1196,1970,막장드라마/Noun,141,32,109,0.00035568992730587116,0.0012106537530266347,0.7730496453900709
1197,1971,왠/Modifier,141,33,108,0.00036680523753417966,0.0011995468378612525,0.7659574468085106
1198,1972,하길래/Verb,141,40,101,0.0004446124091323389,0.0011217984317035787,0.7163120567375887
1199,1973,좋았지만/Adjective,141,45,96,0.0005001889602738814,0.0010662638558766688,0.6808510638297872
1200,1974,없게/Adjective,141,47,94,0.0005224195807304982,0.0010440500255459052,0.6666666666666666
1201,1975,흔한/Adjective,141,49,92,0.0005446502011871152,0.0010218361952151409,0.6524822695035462
1202,1976,마이클/Noun,141,91,50,0.001011493230776071,0.0005553457582690984,0.6453900709219859
1203,1985,♥♥/Foreign,140,140,0,0.001556143431963186,0.0,1.0
1204,1986,지루하게/Adjective,140,20,120,0.00022230620456616945,0.001332829819845836,0.8571428571428571
1205,1987,맞지/Verb,140,22,118,0.00024453682502278637,0.001310615989515072,0.8428571428571429
1206,1988,보았습니다/Verb,140,116,24,0.0012893759864837828,0.0002665659639691672,0.8285714285714286
1207,1989,세월/Noun,140,105,35,0.0011671075739723895,0.0003887420307883688,0.75
1208,1990,캐리/Noun,140,104,36,0.001155992263744081,0.00039984894595375083,0.7428571428571429
1209,1991,느끼는/Verb,140,103,37,0.0011448769535157724,0.0004109558611191328,0.7357142857142858
1210,1992,변화/Noun,140,91,49,0.001011493230776071,0.0005442388431037163,0.65
1211,1993,않네요/Verb,140,86,54,0.0009559166796345287,0.0005997734189306263,0.6142857142857143
1212,1999,일품/Noun,139,126,13,0.0014005290887668675,0.00014438989714996554,0.9064748201438848
1213,2000,젠장/Noun,139,22,117,0.00024453682502278637,0.0012995090743496902,0.8417266187050358
1214,2001,기회/Noun,139,106,33,0.001178222884200698,0.00036652820045760486,0.7625899280575541
1215,2002,카리스마/Noun,139,105,34,0.0011671075739723895,0.00037763511562298685,0.7553956834532374
1216,2003,남아/Noun,139,97,42,0.0010781850921459217,0.00046649043694604257,0.6978417266187049
1217,2005,좋았으나/Adjective,138,12,126,0.00013338372273970166,0.0013994713108381278,0.9130434782608696
1218,2006,아/Noun,138,27,111,0.0003001133761643288,0.0012328675833573985,0.8043478260869565
1219,2007,칼/Noun,138,41,97,0.00045572771936064734,0.0010773707710420508,0.7028985507246377
1220,2008,신경/Noun,138,42,96,0.00046684302958895584,0.0010662638558766688,0.6956521739130435
1221,2009,자살/Noun,138,43,95,0.00047795833981726434,0.0010551569407112867,0.6884057971014492
1222,2010,오빠/Noun,138,95,43,0.0010559544716893046,0.0004775973521114245,0.6884057971014492
1223,2011,넘게/Verb,138,94,44,0.0010448391614609964,0.0004887042672768067,0.6811594202898551
1224,2012,맨/Modifier,138,51,87,0.0005668808216437321,0.0009663016193882313,0.6304347826086957
1225,2013,야한다/Adjective,138,86,52,0.0009559166796345287,0.0005775595885998622,0.6231884057971014
1226,2014,면서/Noun,138,84,54,0.0009336860591779117,0.0005997734189306263,0.6086956521739131
1227,2021,포르노/Noun,137,16,121,0.00017784496365293558,0.001343936735011218,0.8832116788321168
1228,2022,C/Alpha,137,16,121,0.00017784496365293558,0.001343936735011218,0.8832116788321168
1229,2023,응원/Noun,137,116,21,0.0012893759864837828,0.00023324521847302128,0.8467153284671532
1230,2024,겨/Noun,137,26,111,0.00028899806593602026,0.0012328675833573985,0.8102189781021898
1231,2025,압권/Noun,137,111,26,0.0012337994353422404,0.00028877979429993113,0.8102189781021898
1232,2026,야하는/Adjective,137,105,32,0.0011671075739723895,0.00035542128529222287,0.7664233576642335
1233,2027,형사/Noun,137,43,94,0.00047795833981726434,0.0010440500255459052,0.6861313868613139
1234,2028,만해/Noun,137,91,46,0.001011493230776071,0.0005109180976075704,0.6642335766423357
1235,2029,하기엔/Verb,137,48,89,0.0005335348909588066,0.0009885154497189948,0.6496350364963503
1236,2030,",,,,/Punctuation",137,50,87,0.0005557655114154236,0.0009663016193882313,0.635036496350365
1237,2031,잠깐/Noun,137,52,85,0.0005779961318720405,0.0009440877890574672,0.6204379562043796
1238,2036,유치하다/Adjective,136,5,131,5.557655114154236e-05,0.0014550058866650375,0.9632352941176472
1239,2037,모르겠음/Verb,136,20,116,0.00022230620456616945,0.0012884021591843082,0.8529411764705882
1240,2038,세번/Noun,136,110,26,0.001222684125113932,0.00028877979429993113,0.8088235294117647
1241,2039,냥/Josa,136,31,105,0.00034457461707756266,0.0011662260923651065,0.7720588235294118
1242,2040,만에/Josa,136,101,35,0.0011226463330591557,0.0003887420307883688,0.7426470588235294
1243,2041,내면/Noun,136,99,37,0.0011004157126025386,0.0004109558611191328,0.7279411764705882
1244,2042,성격/Noun,136,41,95,0.00045572771936064734,0.0010551569407112867,0.6985294117647058
1245,2043,선물/Noun,136,95,41,0.0010559544716893046,0.00045538352178066063,0.6985294117647058
1246,2044,동시/Noun,136,90,46,0.0010003779205477628,0.0005109180976075704,0.6617647058823529
1247,2045,다시는/Verb,136,47,89,0.0005224195807304982,0.0009885154497189948,0.6544117647058824
1248,2046,있었지만/Adjective,136,85,51,0.0009448013694062199,0.0005664526734344802,0.625
1249,2054,에로영화/Noun,135,22,113,0.00024453682502278637,0.0012550814136881624,0.837037037037037
1250,2055,겨우/Noun,135,22,113,0.00024453682502278637,0.0012550814136881624,0.837037037037037
1251,2056,빼곤/Verb,135,26,109,0.00028899806593602026,0.0012106537530266347,0.8074074074074075
1252,2057,적임/Noun,135,96,39,0.0010670697819176133,0.0004331696914498967,0.7111111111111111
1253,2058,없/Adjective,135,42,93,0.00046684302958895584,0.001032943110380523,0.6888888888888889
1254,2059,형제/Noun,135,91,44,0.001011493230776071,0.0004887042672768067,0.674074074074074
1255,2060,할머니/Noun,135,87,48,0.0009670319898628369,0.0005331319279383344,0.6444444444444445
1256,2061,시킨/Verb,135,54,81,0.0006002267523286575,0.0008996601283959392,0.6
1257,2067,낮지/Adjective,134,129,5,0.0014338750194517929,5.5534575826909837e-05,0.9626865671641792
1258,2068,야동/Noun,134,25,109,0.0002778827557077118,0.0012106537530266347,0.8134328358208955
1259,2069,롭고/Josa,134,108,26,0.001200453504657315,0.00028877979429993113,0.8059701492537313
1260,2070,했나/Verb,134,28,106,0.0003112286863926372,0.0011773330075304884,0.7910447761194029
1261,2071,당/Suffix,134,44,90,0.0004890736500455726,0.000999622364884377,0.6716417910447762
1262,2072,[/Punctuation,134,44,90,0.0004890736500455726,0.000999622364884377,0.6716417910447762
1263,2073,스럽지/Josa,134,87,47,0.0009670319898628369,0.0005220250127729526,0.6492537313432836
1264,2079,재미있습니다/Adjective,133,128,5,0.0014227597092234846,5.5534575826909837e-05,0.962406015037594
1265,2080,답답한/Adjective,133,19,114,0.00021119089433786097,0.001266188328853544,0.8571428571428571
1266,2081,투자/Noun,133,20,113,0.00022230620456616945,0.0012550814136881624,0.849624060150376
1267,2082,보네/Verb,133,24,109,0.0002667674454794033,0.0012106537530266347,0.8195488721804511
1268,2083,레전드/Noun,133,108,25,0.001200453504657315,0.0002776728791345492,0.8120300751879699
1269,2084,했으나/Verb,133,30,103,0.00033345930684925416,0.0011440122620343426,0.7744360902255639
1270,2085,끝나는/Verb,133,32,101,0.00035568992730587116,0.0011217984317035787,0.7593984962406015
1271,2086,고통/Noun,133,95,38,0.0010559544716893046,0.0004220627762845148,0.7142857142857143
1272,2087,비현실적/Noun,133,41,92,0.00045572771936064734,0.0010218361952151409,0.6917293233082706
1273,2088,욕망/Noun,133,90,43,0.0010003779205477628,0.0004775973521114245,0.6766917293233082
1274,2089,쉬/Noun,133,90,43,0.0010003779205477628,0.0004775973521114245,0.6766917293233082
1275,2090,방영/Noun,133,85,48,0.0009448013694062199,0.0005331319279383344,0.6390977443609023
1276,2091,영혼/Noun,133,82,51,0.0009114554387212947,0.0005664526734344802,0.6165413533834586
1277,2098,잊지/Verb,132,114,18,0.0012671453660271655,0.00019992447297687542,0.8636363636363636
1278,2099,즐거운/Adjective,132,110,22,0.001222684125113932,0.00024435213363840333,0.8333333333333334
1279,2100,초등학교/Noun,132,99,33,0.0011004157126025386,0.00036652820045760486,0.75
1280,2101,학년/Noun,132,96,36,0.0010670697819176133,0.00039984894595375083,0.7272727272727273
1281,2102,로그인/Noun,132,41,91,0.00045572771936064734,0.001010729280049759,0.6893939393939394
1282,2103,하긴/Verb,132,44,88,0.0004890736500455726,0.000977408534553613,0.6666666666666666
1283,2104,베/Noun,132,45,87,0.0005001889602738814,0.0009663016193882313,0.6590909090909091
1284,2105,을/Foreign,132,45,87,0.0005001889602738814,0.0009663016193882313,0.6590909090909091
1285,2106,특수/Noun,132,48,84,0.0005335348909588066,0.0009329808738920851,0.6363636363636364
1286,2107,감안/Noun,132,51,81,0.0005668808216437321,0.0008996601283959392,0.6136363636363636
1287,2117,높아/Adjective,131,2,129,2.2230620456616947e-05,0.0014327920563342734,0.9847328244274808
1288,2118,M/Alpha,131,5,126,5.557655114154236e-05,0.0013994713108381278,0.9618320610687024
1289,2119,감흥/Noun,131,19,112,0.00021119089433786097,0.0012439744985227805,0.8549618320610687
1290,2120,예쁘고/Adjective,131,110,21,0.001222684125113932,0.00023324521847302128,0.8396946564885496
1291,2121,설득/Noun,131,30,101,0.00033345930684925416,0.0011217984317035787,0.7709923664122137
1292,2122,따로/Adverb,131,31,100,0.00034457461707756266,0.0011106915165381968,0.7633587786259542
1293,2123,]/Punctuation,131,38,93,0.000422381788675722,0.001032943110380523,0.7099236641221374
1294,2124,권/Suffix,131,84,47,0.0009336860591779117,0.0005220250127729526,0.6412213740458015
1295,2130,점준/Noun,130,23,107,0.00025565213525109487,0.0011884399226958706,0.823076923076923
1296,2131,인지도/Noun,130,26,104,0.00028899806593602026,0.0011551191771997243,0.8
1297,2132,x/Alpha,130,34,96,0.0003779205477624881,0.0010662638558766688,0.7384615384615385
1298,2133,루/Noun,130,36,94,0.000400151168219105,0.0010440500255459052,0.7230769230769231
1299,2134,최강/Noun,130,88,42,0.0009781473000911457,0.00046649043694604257,0.676923076923077
1300,2135,주성치/Noun,130,81,49,0.0009003401284929863,0.0005442388431037163,0.6230769230769231
1301,2140,아깝고/Adjective,129,0,129,0.0,0.0014327920563342734,1.0
1302,2141,재미없게/Adjective,129,8,121,8.892248182646779e-05,0.001343936735011218,0.9379844961240309
1303,2142,잼있다/Verb,129,115,14,0.0012782606762554744,0.0001554968123153475,0.8914728682170543
1304,2143,안습/Noun,129,16,113,0.00017784496365293558,0.0012550814136881624,0.875968992248062
1305,2144,우려/Noun,129,18,111,0.0002000755841095525,0.0012328675833573985,0.8604651162790697
1306,2145,기만/Noun,129,25,104,0.0002778827557077118,0.0011551191771997243,0.8062015503875969
1307,2146,조작/Noun,129,25,104,0.0002778827557077118,0.0011551191771997243,0.8062015503875969
1308,2147,똑같은/Adjective,129,30,99,0.00033345930684925416,0.0010995846013728146,0.7674418604651163
1309,2148,오랫/Modifier,129,97,32,0.0010781850921459217,0.00035542128529222287,0.751937984496124
1310,2149,스트레스/Noun,129,35,94,0.0003890358579907965,0.0010440500255459052,0.7286821705426356
1311,2150,죽는/Verb,129,37,92,0.00041126647844741344,0.0010218361952151409,0.7131782945736435
1312,2151,색감/Noun,129,91,38,0.001011493230776071,0.0004220627762845148,0.7054263565891473
1313,2152,그럴/Adjective,129,38,91,0.000422381788675722,0.001010729280049759,0.7054263565891473
1314,2153,끔/Verb,129,41,88,0.00045572771936064734,0.000977408534553613,0.6821705426356589
1315,2154,받을/Verb,129,81,48,0.0009003401284929863,0.0005331319279383344,0.627906976744186
1316,2155,알수/Verb,129,50,79,0.0005557655114154236,0.0008774462980651753,0.6124031007751938
1317,2160,공짜/Noun,128,5,123,5.557655114154236e-05,0.001366150565341982,0.9609375
1318,2161,망한/Adjective,128,15,113,0.00016672965342462708,0.0012550814136881624,0.8828125
1319,2162,만들다니/Verb,128,24,104,0.0002667674454794033,0.0011551191771997243,0.8125
1320,2163,18/Number,128,28,100,0.0003112286863926372,0.0011106915165381968,0.78125
1321,2164,해야지/Verb,128,30,98,0.00033345930684925416,0.001088477686207433,0.765625
1322,2165,데리/Noun,128,41,87,0.00045572771936064734,0.0009663016193882313,0.6796875
1323,2166,포인트/Noun,128,42,86,0.00046684302958895584,0.0009551947042228492,0.671875
1324,2167,ㄱ/KoreanParticle,128,45,83,0.0005001889602738814,0.0009218739587267033,0.6484375
1325,2168,갑/Noun,128,83,45,0.0009225707489496033,0.0004998111824421885,0.6484375
1326,2169,서는/Verb,128,48,80,0.0005335348909588066,0.0008885532132305574,0.625
1327,2174,짜증나서/Adjective,127,5,122,5.557655114154236e-05,0.0013550436501765998,0.9606299212598424
1328,2175,떨어진다/Verb,127,11,116,0.00012226841251139318,0.0012884021591843082,0.9133858267716536
1329,2176,정신병/Noun,127,21,106,0.00023342151479447792,0.0011773330075304884,0.8346456692913385
1330,2177,아예/Noun,127,26,101,0.00028899806593602026,0.0011217984317035787,0.7952755905511811
1331,2178,깨닫게/Verb,127,99,28,0.0011004157126025386,0.000310993624630695,0.7795275590551181
1332,2179,여러가지/Noun,127,95,32,0.0010559544716893046,0.00035542128529222287,0.7480314960629921
1333,2180,지루할/Adjective,127,95,32,0.0010559544716893046,0.00035542128529222287,0.7480314960629921
1334,2181,미가/Noun,127,94,33,0.0010448391614609964,0.00036652820045760486,0.7401574803149606
1335,2182,갖고/Verb,127,48,79,0.0005335348909588066,0.0008774462980651753,0.6220472440944882
1336,2192,틈/Noun,126,106,20,0.001178222884200698,0.00022213830330763932,0.8412698412698413
1337,2193,영원히/Adjective,126,102,24,0.0011337616432874642,0.0002665659639691672,0.8095238095238095
1338,2194,;;;;/Punctuation,126,26,100,0.00028899806593602026,0.0011106915165381968,0.7936507936507936
1339,2195,껏/Noun,126,28,98,0.0003112286863926372,0.001088477686207433,0.7777777777777778
1340,2196,위로/Noun,126,91,35,0.001011493230776071,0.0003887420307883688,0.7222222222222222
1341,2197,전쟁영화/Noun,126,88,38,0.0009781473000911457,0.0004220627762845148,0.6984126984126984
1342,2198,다룬/Verb,126,83,43,0.0009225707489496033,0.0004775973521114245,0.6587301587301587
1343,2199,치는/Verb,126,45,81,0.0005001889602738814,0.0008996601283959392,0.6428571428571429
1344,2200,좋을/Adjective,126,79,47,0.0008781095080363692,0.0005220250127729526,0.6269841269841271
1345,2201,어울리는/Verb,126,78,48,0.0008669941978080608,0.0005331319279383344,0.6190476190476191
1346,2202,잔/Noun,126,49,77,0.0005446502011871152,0.0008552324677344116,0.6111111111111112
1347,2210,생각나서/Verb,125,102,23,0.0011337616432874642,0.0002554590488037852,0.816
1348,2211,효/Noun,125,24,101,0.0002667674454794033,0.0011217984317035787,0.8079999999999999
1349,2212,용기/Noun,125,98,27,0.0010893004023742304,0.0002998867094653131,0.784
1350,2213,잇는/Verb,125,88,37,0.0009781473000911457,0.0004109558611191328,0.7040000000000001
1351,2214,패/Noun,125,38,87,0.000422381788675722,0.0009663016193882313,0.696
1352,2215,공포물/Noun,125,40,85,0.0004446124091323389,0.0009440877890574672,0.68
1353,2216,바랍니다/Verb,125,84,41,0.0009336860591779117,0.00045538352178066063,0.672
1354,2217,근래/Noun,125,84,41,0.0009336860591779117,0.00045538352178066063,0.672
1355,2218,수고/Noun,125,82,43,0.0009114554387212947,0.0004775973521114245,0.6559999999999999
1356,2219,만남/Noun,125,80,45,0.0008892248182646778,0.0004998111824421885,0.64
1357,2222,거지같은/Adjective,124,11,113,0.00012226841251139318,0.0012550814136881624,0.9112903225806452
1358,2223,하겠다/Verb,124,28,96,0.0003112286863926372,0.0010662638558766688,0.7741935483870968
1359,2224,운명/Noun,124,93,31,0.0010337238512326881,0.00034431437012684104,0.75
1360,2225,연인/Noun,124,91,33,0.001011493230776071,0.00036652820045760486,0.7338709677419355
1361,2226,이용/Noun,124,38,86,0.000422381788675722,0.0009551947042228492,0.6935483870967742
1362,2227,",./Punctuation",124,41,83,0.00045572771936064734,0.0009218739587267033,0.6693548387096774
1363,2228,007/Number,124,79,45,0.0008781095080363692,0.0004998111824421885,0.6370967741935484
1364,2229,DVD/Alpha,124,79,45,0.0008781095080363692,0.0004998111824421885,0.6370967741935484
1365,2230,거짓말/Noun,124,46,78,0.0005113042705021896,0.0008663393828997934,0.6290322580645161
1366,2231,영화계/Noun,124,47,77,0.0005224195807304982,0.0008552324677344116,0.6209677419354839
1367,2239,재밌어서/Adjective,123,99,24,0.0011004157126025386,0.0002665659639691672,0.8048780487804879
1368,2240,씀/Verb,123,92,31,0.0010226085410043797,0.00034431437012684104,0.7479674796747967
1369,2241,확인/Noun,123,35,88,0.0003890358579907965,0.000977408534553613,0.7154471544715447
1370,2242,해결/Noun,123,42,81,0.00046684302958895584,0.0008996601283959392,0.6585365853658537
1371,2243,군/Noun,123,46,77,0.0005113042705021896,0.0008552324677344116,0.6260162601626016
1372,2253,알겠는데/Verb,122,5,117,5.557655114154236e-05,0.0012995090743496902,0.9590163934426228
1373,2254,았/Noun,122,13,109,0.00014449903296801013,0.0012106537530266347,0.8934426229508197
1374,2255,번은/Noun,122,102,20,0.0011337616432874642,0.00022213830330763932,0.8360655737704918
1375,2256,심하게/Adjective,122,22,100,0.00024453682502278637,0.0011106915165381968,0.819672131147541
1376,2257,설마/Noun,122,22,100,0.00024453682502278637,0.0011106915165381968,0.819672131147541
1377,2258,만들면/Verb,122,25,97,0.0002778827557077118,0.0010773707710420508,0.7950819672131147
1378,2259,낮다/Adjective,122,95,27,0.0010559544716893046,0.0002998867094653131,0.7786885245901639
1379,2260,결코/Noun,122,91,31,0.001011493230776071,0.00034431437012684104,0.7459016393442623
1380,2261,원/Noun,122,31,91,0.00034457461707756266,0.001010729280049759,0.7459016393442623
1381,2262,갠/Noun,122,84,38,0.0009336860591779117,0.0004220627762845148,0.6885245901639344
1382,2263,전에/Foreign,122,79,43,0.0008781095080363692,0.0004775973521114245,0.6475409836065574
1383,2264,줘/Verb,122,45,77,0.0005001889602738814,0.0008552324677344116,0.6311475409836066
1384,2273,진부하고/Adjective,121,9,112,0.00010003779205477625,0.0012439744985227805,0.9256198347107438
1385,2274,셈/Noun,121,20,101,0.00022230620456616945,0.0011217984317035787,0.8347107438016529
1386,2275,변태/Noun,121,21,100,0.00023342151479447792,0.0011106915165381968,0.8264462809917356
1387,2276,심지어/Noun,121,31,90,0.00034457461707756266,0.000999622364884377,0.743801652892562
1388,2277,갔다/Verb,121,40,81,0.0004446124091323389,0.0008996601283959392,0.6694214876033058
1389,2278,아닙니다/Adjective,121,46,75,0.0005113042705021896,0.0008330186374036475,0.6198347107438017
1390,2282,잔뜩/Noun,120,15,105,0.00016672965342462708,0.0011662260923651065,0.875
1391,2283,5분/Number,120,18,102,0.0002000755841095525,0.0011329053468689607,0.85
1392,2284,높게/Adjective,120,29,91,0.0003223439966209457,0.001010729280049759,0.7583333333333333
1393,2285,크리스마스/Noun,120,89,31,0.000989262610319454,0.00034431437012684104,0.7416666666666667
1394,2286,X/Alpha,120,31,89,0.00034457461707756266,0.0009885154497189948,0.7416666666666667
1395,2287,스런/Josa,120,39,81,0.0004334970989040304,0.0008996601283959392,0.675
1396,2288,여러/Noun,120,79,41,0.0008781095080363692,0.00045538352178066063,0.6583333333333333
1397,2289,편도/Noun,120,77,43,0.0008558788875797522,0.0004775973521114245,0.6416666666666667
1398,2290,이래서/Josa,120,46,74,0.0005113042705021896,0.0008219117222382655,0.6166666666666667
1399,2297,잊을/Verb,119,113,6,0.0012560300557988573,6.66414909922918e-05,0.9495798319327732
1400,2298,전율/Noun,119,110,9,0.001222684125113932,9.996223648843771e-05,0.9243697478991596
1401,2299,둘째/Noun,119,14,105,0.0001556143431963186,0.0011662260923651065,0.8823529411764706
1402,2300,려고/Noun,119,23,96,0.00025565213525109487,0.0010662638558766688,0.8067226890756303
1403,2301,아동/Noun,119,28,91,0.0003112286863926372,0.001010729280049759,0.7647058823529411
1404,2302,탓/Noun,119,35,84,0.0003890358579907965,0.0009329808738920851,0.7058823529411765
1405,2303,낮게/Adjective,119,79,40,0.0008781095080363692,0.0004442766066152787,0.6638655462184874
1406,2304,제외/Noun,119,43,76,0.00047795833981726434,0.0008441255525690295,0.6386554621848739
1407,2305,자주/Noun,119,76,43,0.0008447635773514439,0.0004775973521114245,0.6386554621848739
1408,2317,아까울/Adjective,118,6,112,6.669186136985083e-05,0.0012439744985227805,0.9491525423728814
1409,2318,훌륭하다/Adjective,118,107,11,0.0011893381944290064,0.00012217606681920164,0.9067796610169492
1410,2319,오빠/Suffix,118,106,12,0.001178222884200698,0.0001332829819845836,0.8983050847457628
1411,2320,잼나게/Verb,118,104,14,0.001155992263744081,0.0001554968123153475,0.8813559322033898
1412,2321,작위/Noun,118,17,101,0.00018896027388124405,0.0011217984317035787,0.8559322033898306
1413,2322,훈훈한/Adjective,118,101,17,0.0011226463330591557,0.00018881755781149343,0.8559322033898306
1414,2323,대본/Noun,118,24,94,0.0002667674454794033,0.0010440500255459052,0.7966101694915254
1415,2324,부모님/Noun,118,89,29,0.000989262610319454,0.00032210053979607705,0.7542372881355932
1416,2325,톰/Noun,118,83,35,0.0009225707489496033,0.0003887420307883688,0.7033898305084746
1417,2326,두번째/Noun,118,81,37,0.0009003401284929863,0.0004109558611191328,0.6864406779661016
1418,2327,에나/Josa,118,38,80,0.000422381788675722,0.0008885532132305574,0.6779661016949152
1419,2328,할듯/Verb,118,43,75,0.00047795833981726434,0.0008330186374036475,0.6355932203389829
1420,2329,짜임새/Noun,118,71,47,0.0007891870262099014,0.0005220250127729526,0.6016949152542372
1421,2333,:)/Punctuation,117,114,3,0.0012671453660271655,3.33207454961459e-05,0.9743589743589745
1422,2334,한개/Modifier,117,10,107,0.00011115310228308472,0.0011884399226958706,0.9145299145299144
1423,2335,지나치게/Verb,117,18,99,0.0002000755841095525,0.0010995846013728146,0.8461538461538461
1424,2336,소소한/Adjective,117,96,21,0.0010670697819176133,0.00023324521847302128,0.8205128205128205
1425,2337,하나같이/Adverb,117,28,89,0.0003112286863926372,0.0009885154497189948,0.7606837606837606
1426,2338,본듯/Verb,117,85,32,0.0009448013694062199,0.00035542128529222287,0.7264957264957265
1427,2339,하지마라/Verb,117,34,83,0.0003779205477624881,0.0009218739587267033,0.7094017094017094
1428,2340,가족영화/Noun,117,77,40,0.0008558788875797522,0.0004442766066152787,0.6581196581196581
1429,2341,케릭/Noun,117,44,73,0.0004890736500455726,0.0008108048070728836,0.6239316239316239
1430,2342,사상/Noun,117,46,71,0.0005113042705021896,0.0007885909767421196,0.6068376068376068
1431,2351,아쉽지만/Adjective,116,111,5,0.0012337994353422404,5.5534575826909837e-05,0.956896551724138
1432,2352,만들었는지/Verb,116,8,108,8.892248182646779e-05,0.0011995468378612525,0.9310344827586208
1433,2353,그만/Modifier,116,9,107,0.00010003779205477625,0.0011884399226958706,0.9224137931034484
1434,2354,색다른/Adjective,116,95,21,0.0010559544716893046,0.00023324521847302128,0.8189655172413793
1435,2355,하자/Noun,116,24,92,0.0002667674454794033,0.0010218361952151409,0.7931034482758621
1436,2356,정작/Noun,116,29,87,0.0003223439966209457,0.0009663016193882313,0.75
1437,2357,부족하다/Adjective,116,29,87,0.0003223439966209457,0.0009663016193882313,0.75
1438,2358,거나/Noun,116,33,83,0.00036680523753417966,0.0009218739587267033,0.7155172413793104
1439,2359,신의/Noun,116,79,37,0.0008781095080363692,0.0004109558611191328,0.6810344827586207
1440,2360,있는지/Adjective,116,37,79,0.00041126647844741344,0.0008774462980651753,0.6810344827586207
1441,2361,장가/Noun,116,37,79,0.00041126647844741344,0.0008774462980651753,0.6810344827586207
1442,2362,무료/Noun,116,40,76,0.0004446124091323389,0.0008441255525690295,0.6551724137931034
1443,2363,예/Noun,116,40,76,0.0004446124091323389,0.0008441255525690295,0.6551724137931034
1444,2364,꺼/Suffix,116,40,76,0.0004446124091323389,0.0008441255525690295,0.6551724137931034
1445,2365,했을까/Verb,116,45,71,0.0005001889602738814,0.0007885909767421196,0.6120689655172413
1446,2372,따뜻하고/Adjective,115,111,4,0.0012337994353422404,4.4427660661527865e-05,0.9652173913043478
1447,2373,한심한/Adjective,115,7,108,7.78071715981593e-05,0.0011995468378612525,0.9391304347826088
1448,2374,식상한/Adjective,115,11,104,0.00012226841251139318,0.0011551191771997243,0.9043478260869564
1449,2375,대놓고/Adverb,115,17,98,0.00018896027388124405,0.001088477686207433,0.8521739130434782
1450,2376,재밌다는/Adjective,115,18,97,0.0002000755841095525,0.0010773707710420508,0.8434782608695652
1451,2377,죽여/Verb,115,24,91,0.0002667674454794033,0.001010729280049759,0.7913043478260869
1452,2378,없으면/Adjective,115,25,90,0.0002778827557077118,0.000999622364884377,0.7826086956521741
1453,2379,좋겠네요/Adjective,115,89,26,0.000989262610319454,0.00028877979429993113,0.7739130434782608
1454,2380,ㅠㅜ/KoreanParticle,115,89,26,0.000989262610319454,0.00028877979429993113,0.7739130434782608
1455,2381,했네/Verb,115,28,87,0.0003112286863926372,0.0009663016193882313,0.7565217391304347
1456,2382,소년/Noun,115,84,31,0.0009336860591779117,0.00034431437012684104,0.7304347826086957
1457,2383,느꼈다/Verb,115,82,33,0.0009114554387212947,0.00036652820045760486,0.7130434782608696
1458,2384,열연/Noun,115,80,35,0.0008892248182646778,0.0003887420307883688,0.6956521739130435
1459,2385,성은/Noun,115,36,79,0.000400151168219105,0.0008774462980651753,0.6869565217391305
1460,2386,목적/Noun,115,37,78,0.00041126647844741344,0.0008663393828997934,0.6782608695652174
1461,2387,의심/Noun,115,40,75,0.0004446124091323389,0.0008330186374036475,0.6521739130434783
1462,2388,메/Noun,115,75,40,0.0008336482671231353,0.0004442766066152787,0.6521739130434783
1463,2389,낫/Noun,115,43,72,0.00047795833981726434,0.0007996978919075017,0.6260869565217392
1464,2390,으리/Noun,115,71,44,0.0007891870262099014,0.0004887042672768067,0.6173913043478261
1465,2396,낮네/Adjective,114,112,2,0.0012449147455705488,2.2213830330763933e-05,0.9824561403508772
1466,2397,어설프고/Adjective,114,3,111,3.334593068492541e-05,0.0012328675833573985,0.9736842105263158
1467,2398,볼수있는/Verb,114,91,23,0.001011493230776071,0.0002554590488037852,0.7982456140350878
1468,2399,패러디/Noun,114,36,78,0.000400151168219105,0.0008663393828997934,0.6842105263157895
1469,2400,느낀/Verb,114,75,39,0.0008336482671231353,0.0004331696914498967,0.6578947368421053
1470,2401,the/Alpha,114,71,43,0.0007891870262099014,0.0004775973521114245,0.6228070175438597
1471,2402,구나/Noun,114,44,70,0.0004890736500455726,0.0007774840615767378,0.6140350877192983
1472,2403,15/Number,114,45,69,0.0005001889602738814,0.0007663771464113557,0.6052631578947368
1473,2411,높아서/Adjective,113,3,110,3.334593068492541e-05,0.0012217606681920164,0.9734513274336284
1474,2412,유치함/Adjective,113,6,107,6.669186136985083e-05,0.0011884399226958706,0.9469026548672568
1475,2413,귀여워/Adjective,113,106,7,0.001178222884200698,7.774840615767377e-05,0.9380530973451328
1476,2414,마시길/Verb,113,11,102,0.00012226841251139318,0.0011329053468689607,0.9026548672566372
1477,2415,20분/Number,113,18,95,0.0002000755841095525,0.0010551569407112867,0.8407079646017699
1478,2416,ㅜㅜㅜ/KoreanParticle,113,83,30,0.0009225707489496033,0.000333207454961459,0.7345132743362832
1479,2417,..;;/Punctuation,113,31,82,0.00034457461707756266,0.0009107670435613213,0.7256637168141593
1480,2418,다양한/Adjective,113,79,34,0.0008781095080363692,0.00037763511562298685,0.6991150442477876
1481,2419,같지만/Adjective,113,77,36,0.0008558788875797522,0.00039984894595375083,0.6814159292035398
1482,2426,이었어요/Verb,112,97,15,0.0010781850921459217,0.0001666037274807295,0.8660714285714286
1483,2427,명화/Noun,112,90,22,0.0010003779205477628,0.00024435213363840333,0.8035714285714286
1484,2428,싶지/Verb,112,23,89,0.00025565213525109487,0.0009885154497189948,0.7946428571428571
1485,2429,값/Noun,112,27,85,0.0003001133761643288,0.0009440877890574672,0.7589285714285714
1486,2430,감각/Noun,112,73,39,0.0008114176466665183,0.0004331696914498967,0.6517857142857143
1487,2431,필요한/Adjective,112,72,40,0.00080030233643821,0.0004442766066152787,0.6428571428571429
1488,2432,부부/Noun,112,68,44,0.0007558410955249762,0.0004887042672768067,0.6071428571428571
1489,2442,아깝네/Adjective,111,2,109,2.2230620456616947e-05,0.0012106537530266347,0.981981981981982
1490,2443,재미없었다/Adjective,111,2,109,2.2230620456616947e-05,0.0012106537530266347,0.981981981981982
1491,2444,낚였다/Noun,111,2,109,2.2230620456616947e-05,0.0012106537530266347,0.981981981981982
1492,2445,떨어지고/Verb,111,3,108,3.334593068492541e-05,0.0011995468378612525,0.972972972972973
1493,2446,참나/Noun,111,10,101,0.00011115310228308472,0.0011217984317035787,0.90990990990991
1494,2447,지나도/Verb,111,100,11,0.0011115310228308473,0.00012217606681920164,0.9009009009009008
1495,2448,싶어요/Verb,111,98,13,0.0010893004023742304,0.00014438989714996554,0.8828828828828829
1496,2449,많은걸/Adjective,111,92,19,0.0010226085410043797,0.00021103138814225735,0.8288288288288288
1497,2450,오래전/Adverb,111,85,26,0.0009448013694062199,0.00028877979429993113,0.7657657657657657
1498,2451,!!!!!/Punctuation,111,81,30,0.0009003401284929863,0.000333207454961459,0.7297297297297297
1499,2452,기는/Verb,111,32,79,0.00035568992730587116,0.0008774462980651753,0.7117117117117117
1500,2453,뇌/Noun,111,37,74,0.00041126647844741344,0.0008219117222382655,0.6666666666666666
1501,2454,시켜/Verb,111,39,72,0.0004334970989040304,0.0007996978919075017,0.6486486486486487
1502,2455,웃고/Verb,111,71,40,0.0007891870262099014,0.0004442766066152787,0.6396396396396397
1503,2456,죽은/Verb,111,42,69,0.00046684302958895584,0.0007663771464113557,0.6216216216216216
1504,2457,시기/Noun,111,68,43,0.0007558410955249762,0.0004775973521114245,0.6126126126126126
1505,2461,울컥/Adverb,110,108,2,0.001200453504657315,2.2213830330763933e-05,0.9818181818181818
1506,2462,신파/Noun,110,16,94,0.00017784496365293558,0.0010440500255459052,0.8545454545454545
1507,2463,첫사랑/Noun,110,90,20,0.0010003779205477628,0.00022213830330763932,0.8181818181818182
1508,2464,느낄수/Verb,110,88,22,0.0009781473000911457,0.00024435213363840333,0.8
1509,2465,아니야/Adjective,110,23,87,0.00025565213525109487,0.0009663016193882313,0.7909090909090909
1510,2466,본지/Verb,110,81,29,0.0009003401284929863,0.00032210053979607705,0.7363636363636363
1511,2467,몇몇/Noun,110,33,77,0.00036680523753417966,0.0008552324677344116,0.7
1512,2468,모양/Noun,110,36,74,0.000400151168219105,0.0008219117222382655,0.6727272727272727
1513,2469,70년/Number,110,37,73,0.00041126647844741344,0.0008108048070728836,0.6636363636363637
1514,2470,담배/Noun,110,40,70,0.0004446124091323389,0.0007774840615767378,0.6363636363636364
1515,2471,할아버지/Noun,110,67,43,0.0007447257852966678,0.0004775973521114245,0.6090909090909091
1516,2472,탑/Noun,110,66,44,0.0007336104750683593,0.0004887042672768067,0.6
1517,2474,한숨/Noun,109,12,97,0.00013338372273970166,0.0010773707710420508,0.8899082568807339
1518,2475,소중한/Adjective,109,86,23,0.0009559166796345287,0.0002554590488037852,0.7889908256880734
1519,2476,고전/Noun,109,80,29,0.0008892248182646778,0.00032210053979607705,0.7339449541284404
1520,2477,삭제/Noun,109,31,78,0.00034457461707756266,0.0008663393828997934,0.7155963302752294
1521,2478,빵빵/Noun,109,77,32,0.0008558788875797522,0.00035542128529222287,0.7064220183486238
1522,2479,졸/Noun,109,33,76,0.00036680523753417966,0.0008441255525690295,0.6972477064220184
1523,2480,맞아/Verb,109,34,75,0.0003779205477624881,0.0008330186374036475,0.6880733944954128
1524,2481,배우는/Verb,109,34,75,0.0003779205477624881,0.0008330186374036475,0.6880733944954128
1525,2482,철/Noun,109,35,74,0.0003890358579907965,0.0008219117222382655,0.6788990825688074
1526,2489,아까웠다/Adjective,108,3,105,3.334593068492541e-05,0.0011662260923651065,0.9722222222222222
1527,2490,짜증남/Adjective,108,5,103,5.557655114154236e-05,0.0011440122620343426,0.9537037037037036
1528,2491,할말/Verb,108,8,100,8.892248182646779e-05,0.0011106915165381968,0.925925925925926
1529,2492,.^^/Punctuation,108,97,11,0.0010781850921459217,0.00012217606681920164,0.8981481481481481
1530,2493,말고는/Josa,108,11,97,0.00012226841251139318,0.0010773707710420508,0.8981481481481481
1531,2494,같네/Adjective,108,31,77,0.00034457461707756266,0.0008552324677344116,0.7129629629629629
1532,2495,십/Modifier,108,76,32,0.0008447635773514439,0.00035542128529222287,0.7037037037037037
1533,2496,나왔다/Verb,108,32,76,0.00035568992730587116,0.0008441255525690295,0.7037037037037037
1534,2497,그만큼/Adverb,108,76,32,0.0008447635773514439,0.00035542128529222287,0.7037037037037037
1535,2498,태어나서/Verb,108,37,71,0.00041126647844741344,0.0007885909767421196,0.6574074074074074
1536,2499,최대/Noun,108,37,71,0.00041126647844741344,0.0007885909767421196,0.6574074074074074
1537,2500,언니/Noun,108,69,39,0.0007669564057532844,0.0004331696914498967,0.6388888888888888
1538,2501,화의/Noun,108,39,69,0.0004334970989040304,0.0007663771464113557,0.6388888888888888
1539,2502,마이/Noun,108,40,68,0.0004446124091323389,0.0007552702312459737,0.6296296296296297
1540,2503,탈/Noun,108,40,68,0.0004446124091323389,0.0007552702312459737,0.6296296296296297
1541,2504,누나/Noun,108,65,43,0.0007224951648400508,0.0004775973521114245,0.6018518518518519
1542,2505,하니/Verb,108,43,65,0.00047795833981726434,0.0007219494857498278,0.6018518518518519
1543,2506,포스/Noun,108,65,43,0.0007224951648400508,0.0004775973521114245,0.6018518518518519
1544,2513,재미없어서/Adjective,107,5,102,5.557655114154236e-05,0.0011329053468689607,0.9532710280373832
1545,2514,잼있음/Verb,107,97,10,0.0010781850921459217,0.00011106915165381967,0.9065420560747663
1546,2515,숨겨진/Verb,107,91,16,0.001011493230776071,0.00017771064264611146,0.8504672897196262
1547,2516,볼려고/Verb,107,36,71,0.000400151168219105,0.0007885909767421196,0.6635514018691588
1548,2521,적이네요/Verb,106,103,3,0.0011448769535157724,3.33207454961459e-05,0.9716981132075472
1549,2522,이상하고/Adjective,106,7,99,7.78071715981593e-05,0.0010995846013728146,0.9339622641509434
1550,2523,어처구니/Noun,106,11,95,0.00012226841251139318,0.0010551569407112867,0.8962264150943396
1551,2524,..^^/Punctuation,106,92,14,0.0010226085410043797,0.0001554968123153475,0.8679245283018868
1552,2525,맞고/Verb,106,17,89,0.00018896027388124405,0.0009885154497189948,0.8396226415094341
1553,2526,중독/Noun,106,87,19,0.0009670319898628369,0.00021103138814225735,0.8207547169811321
1554,2527,단순히/Adjective,106,78,28,0.0008669941978080608,0.000310993624630695,0.7358490566037735
1555,2528,폐지/Noun,106,30,76,0.00033345930684925416,0.0008441255525690295,0.7169811320754716
1556,2529,흑/Adverb,106,72,34,0.00080030233643821,0.00037763511562298685,0.6792452830188679
1557,2530,보다니/Verb,106,68,38,0.0007558410955249762,0.0004220627762845148,0.6415094339622641
1558,2531,하시는/Verb,106,64,42,0.0007113798546117423,0.00046649043694604257,0.6037735849056604
1559,2535,선동/Noun,105,10,95,0.00011115310228308472,0.0010551569407112867,0.9047619047619048
1560,2536,팔이/Noun,105,11,94,0.00012226841251139318,0.0010440500255459052,0.8952380952380953
1561,2537,여름/Noun,105,85,20,0.0009448013694062199,0.00022213830330763932,0.8095238095238095
1562,2538,안감/Noun,105,22,83,0.00024453682502278637,0.0009218739587267033,0.7904761904761904
1563,2539,또다른/Modifier,105,78,27,0.0008669941978080608,0.0002998867094653131,0.7428571428571429
1564,2540,중학교/Noun,105,77,28,0.0008558788875797522,0.000310993624630695,0.7333333333333333
1565,2541,해준다/Verb,105,75,30,0.0008336482671231353,0.000333207454961459,0.7142857142857143
1566,2542,바탕/Noun,105,73,32,0.0008114176466665183,0.00035542128529222287,0.6952380952380952
1567,2543,목숨/Noun,105,70,35,0.000778071715981593,0.0003887420307883688,0.6666666666666666
1568,2544,있/Adjective,105,70,35,0.000778071715981593,0.0003887420307883688,0.6666666666666666
1569,2545,잡/Noun,105,36,69,0.000400151168219105,0.0007663771464113557,0.6571428571428571
1570,2546,버전/Noun,105,38,67,0.000422381788675722,0.0007441633160805918,0.6380952380952379
1571,2547,없나요/Adjective,105,41,64,0.00045572771936064734,0.0007108425705844457,0.6095238095238096
1572,2554,성하고/Adjective,104,2,102,2.2230620456616947e-05,0.0011329053468689607,0.9807692307692308
1573,2555,메이드/Noun,104,91,13,0.001011493230776071,0.00014438989714996554,0.875
1574,2556,캬/Noun,104,89,15,0.000989262610319454,0.0001666037274807295,0.8557692307692307
1575,2557,어쩌/Noun,104,16,88,0.00017784496365293558,0.000977408534553613,0.8461538461538461
1576,2558,구리/Noun,104,16,88,0.00017784496365293558,0.000977408534553613,0.8461538461538461
1577,2559,호구/Noun,104,17,87,0.00018896027388124405,0.0009663016193882313,0.8365384615384616
1578,2560,없었음/Adjective,104,19,85,0.00021119089433786097,0.0009440877890574672,0.8173076923076923
1579,2561,부터가/Josa,104,22,82,0.00024453682502278637,0.0009107670435613213,0.7884615384615384
1580,2562,하아/Exclamation,104,23,81,0.00025565213525109487,0.0008996601283959392,0.7788461538461539
1581,2563,~!!!/Punctuation,104,79,25,0.0008781095080363692,0.0002776728791345492,0.7596153846153846
1582,2564,강한/Adjective,104,76,28,0.0008447635773514439,0.000310993624630695,0.7307692307692307
1583,2565,장국영/Noun,104,73,31,0.0008114176466665183,0.00034431437012684104,0.7019230769230769
1584,2566,예쁘다/Adjective,104,73,31,0.0008114176466665183,0.00034431437012684104,0.7019230769230769
1585,2567,졸리/Noun,104,33,71,0.00036680523753417966,0.0007885909767421196,0.6826923076923077
1586,2568,표현/Modifier,104,68,36,0.0007558410955249762,0.00039984894595375083,0.6538461538461539
1587,2569,야구/Noun,104,66,38,0.0007336104750683593,0.0004220627762845148,0.6346153846153846
1588,2570,틱/Suffix,104,39,65,0.0004334970989040304,0.0007219494857498278,0.625
1589,2571,고등학교/Noun,104,65,39,0.0007224951648400508,0.0004331696914498967,0.625
1590,2572,따름/Noun,104,41,63,0.00045572771936064734,0.0006997356554190639,0.6057692307692307
1591,2579,귀엽다/Adjective,103,89,14,0.000989262610319454,0.0001554968123153475,0.8640776699029126
1592,2580,있냐/Adjective,103,17,86,0.00018896027388124405,0.0009551947042228492,0.8349514563106796
1593,2581,하도/Verb,103,27,76,0.0003001133761643288,0.0008441255525690295,0.7378640776699029
1594,2582,이어서/Josa,103,75,28,0.0008336482671231353,0.000310993624630695,0.7281553398058253
1595,2583,불쌍하다/Adjective,103,30,73,0.00033345930684925416,0.0008108048070728836,0.7087378640776699
1596,2584,했네요/Verb,103,72,31,0.00080030233643821,0.00034431437012684104,0.6990291262135923
1597,2585,이었던/Verb,103,70,33,0.000778071715981593,0.00036652820045760486,0.6796116504854369
1598,2586,알았음/Verb,103,33,70,0.00036680523753417966,0.0007774840615767378,0.6796116504854369
1599,2587,로버트/Noun,103,70,33,0.000778071715981593,0.00036652820045760486,0.6796116504854369
1600,2588,보이지/Noun,103,36,67,0.000400151168219105,0.0007441633160805918,0.6504854368932039
1601,2589,유일하게/Adjective,103,66,37,0.0007336104750683593,0.0004109558611191328,0.6407766990291263
1602,2590,배경음악/Noun,103,64,39,0.0007113798546117423,0.0004331696914498967,0.6213592233009708
1603,2591,욕심/Noun,103,39,64,0.0004334970989040304,0.0007108425705844457,0.6213592233009708
1604,2592,웃/Noun,103,64,39,0.0007113798546117423,0.0004331696914498967,0.6213592233009708
1605,2596,빵점/Noun,102,2,100,2.2230620456616947e-05,0.0011106915165381968,0.9803921568627452
1606,2597,하품/Noun,102,2,100,2.2230620456616947e-05,0.0011106915165381968,0.9803921568627452
1607,2598,남네요/Verb,102,96,6,0.0010670697819176133,6.66414909922918e-05,0.9411764705882352
1608,2599,지경/Noun,102,14,88,0.0001556143431963186,0.000977408534553613,0.8627450980392157
1609,2600,재미나/Noun,102,87,15,0.0009670319898628369,0.0001666037274807295,0.8529411764705882
1610,2601,억지스러운/Adjective,102,16,86,0.00017784496365293558,0.0009551947042228492,0.8431372549019608
1611,2602,조화/Noun,102,82,20,0.0009114554387212947,0.00022213830330763932,0.8039215686274509
1612,2603,그립다/Verb,102,79,23,0.0008781095080363692,0.0002554590488037852,0.7745098039215687
1613,2604,곡/Noun,102,78,24,0.0008669941978080608,0.0002665659639691672,0.7647058823529411
1614,2605,팔/Modifier,102,24,78,0.0002667674454794033,0.0008663393828997934,0.7647058823529411
1615,2606,로코/Noun,102,75,27,0.0008336482671231353,0.0002998867094653131,0.7352941176470589
1616,2607,숨/Noun,102,75,27,0.0008336482671231353,0.0002998867094653131,0.7352941176470589
1617,2608,봤지/Verb,102,36,66,0.000400151168219105,0.0007330564009152097,0.6470588235294118
1618,2609,절정/Noun,102,64,38,0.0007113798546117423,0.0004220627762845148,0.6274509803921569
1619,2610,클레멘타인/Noun,102,39,63,0.0004334970989040304,0.0006997356554190639,0.6176470588235294
1620,2617,어색하고/Adjective,101,6,95,6.669186136985083e-05,0.0010551569407112867,0.9405940594059404
1621,2618,인내심/Noun,101,8,93,8.892248182646779e-05,0.001032943110380523,0.9207920792079208
1622,2619,잠시/Noun,101,75,26,0.0008336482671231353,0.00028877979429993113,0.7425742574257426
1623,2620,보소/Verb,101,29,72,0.0003223439966209457,0.0007996978919075017,0.7128712871287128
1624,2621,아니지/Adjective,101,31,70,0.00034457461707756266,0.0007774840615767378,0.6930693069306929
1625,2622,사운드/Noun,101,67,34,0.0007447257852966678,0.00037763511562298685,0.6633663366336634
1626,2623,그동안/Noun,101,65,36,0.0007224951648400508,0.00039984894595375083,0.6435643564356436
1627,2624,린다/Noun,101,64,37,0.0007113798546117423,0.0004109558611191328,0.6336633663366337
1628,2625,조니뎁/Noun,101,63,38,0.0007002645443834338,0.0004220627762845148,0.6237623762376238
1629,2626,들은/Verb,101,39,62,0.0004334970989040304,0.0006886287402536821,0.6138613861386139
1630,2627,틴/Noun,101,40,61,0.0004446124091323389,0.0006775218250882999,0.6039603960396039
1631,2644,잤다/Verb,100,1,99,1.1115310228308474e-05,0.0010995846013728146,0.99
1632,2645,아깝네요/Adjective,100,5,95,5.557655114154236e-05,0.0010551569407112867,0.95
1633,2646,앞뒤/Noun,100,11,89,0.00012226841251139318,0.0009885154497189948,0.89
1634,2647,울면/Noun,100,87,13,0.0009670319898628369,0.00014438989714996554,0.87
1635,2648,아냐/Verb,100,17,83,0.00018896027388124405,0.0009218739587267033,0.83
1636,2649,괜찮음/Adjective,100,76,24,0.0008447635773514439,0.0002665659639691672,0.76
1637,2650,아무런/Adjective,100,26,74,0.00028899806593602026,0.0008219117222382655,0.74
1638,2651,좋아할/Adjective,100,29,71,0.0003223439966209457,0.0007885909767421196,0.71
1639,2652,플롯/Noun,100,29,71,0.0003223439966209457,0.0007885909767421196,0.71
1640,2653,일본인/Noun,100,30,70,0.00033345930684925416,0.0007774840615767378,0.7
1641,2654,........./Punctuation,100,31,69,0.00034457461707756266,0.0007663771464113557,0.69
1642,2655,쓸/Verb,100,34,66,0.0003779205477624881,0.0007330564009152097,0.66
1643,2656,놀랍다/Verb,100,64,36,0.0007113798546117423,0.00039984894595375083,0.64
1644,2657,만이/Noun,100,37,63,0.00041126647844741344,0.0006997356554190639,0.63
1645,2658,남은/Verb,100,60,40,0.0006669186136985082,0.0004442766066152787,0.6
