,Unnamed: 0,parameter,counts,counts_H,counts_NH,p_from_H,p_from_NH,priority
0,3,의/Josa,29457,17487,11970,0.19437342996243026,0.13294977452962214,0.593644974029942
1,8,.../Punctuation,22073,9139,12934,0.10158282017651113,0.14365684074905036,0.5859647533185339
2,9,은/Josa,19690,7739,11951,0.08602138585687928,0.13273874314147988,0.6069578466226511
3,10,도/Josa,18990,7903,11087,0.08784429673432186,0.12314236843858985,0.5838335966298052
4,15,이/Determiner,12373,4495,7878,0.04996331947624658,0.08750027767287913,0.6367089630647378
5,17,?/Punctuation,11319,3302,8017,0.036702754373874574,0.08904413888086722,0.7082781164413817
6,18,정말/Noun,10702,7082,3620,0.0787186270368806,0.04020703289868272,0.6617454681367969
7,19,것/Noun,10293,4088,6205,0.045439388213325035,0.06891840860119511,0.6028368794326241
8,22,적/Suffix,9003,5486,3517,0.060978591912500275,0.039063020636648384,0.6093524380761969
9,24,!/Punctuation,8565,6415,2150,0.07130471511459885,0.023879867605571228,0.7489784004670169
10,27,점/Noun,7843,3227,4616,0.03586910610675144,0.051269520403403164,0.5885502996302435
11,28,만/Josa,7745,2412,5333,0.026810128270680036,0.05923317857698202,0.6885732730794061
12,31,과/Josa,6768,4231,2537,0.04702887757597315,0.02817824377457405,0.6251477541371159
13,32,최고/Noun,6671,6143,528,0.06828135073249894,0.005864451207321679,0.9208514465597362
14,34,왜/Noun,6247,2241,4006,0.024909410221639287,0.04449430215252016,0.6412678085481031
15,35,스토리/Noun,6075,2176,3899,0.02418691505679924,0.043305862229824285,0.6418106995884774
16,37,생각/Noun,6005,3771,2234,0.04191583487095125,0.024812848479463315,0.6279766860949209
17,38,~/Punctuation,6003,4016,1987,0.04463908587688682,0.02206944043361397,0.6689988339163752
18,42,감동/Noun,5597,4442,1155,0.04937420803414623,0.012828487016016172,0.7936394497051992
19,43,..../Punctuation,5580,2218,3362,0.02465375808638819,0.03734144878601417,0.6025089605734767
20,45,1/Number,5284,1409,3875,0.015661472111686642,0.04303929626585512,0.7333459500378501
21,47,보고/Noun,5209,3038,2171,0.03376831247360114,0.02411311282404425,0.5832213476674986
22,50,드라마/Noun,5005,3017,1988,0.033534890958806664,0.02208054734877935,0.6027972027972028
23,52,때/Noun,4940,3220,1720,0.03579129893515328,0.019103894084456983,0.6518218623481782
24,55,거/Noun,4783,1959,2824,0.021774892737256298,0.03136592842703868,0.5904244198201966
25,56,와/Josa,4779,2774,2005,0.0308338705733277,0.022269364906590844,0.5804561623770663
26,57,감독/Noun,4688,1515,3173,0.016839694995887337,0.03524224181975698,0.6768344709897611
27,58,ㅋㅋ/KoreanParticle,4594,2777,1817,0.030867216504012626,0.020181264855499037,0.6044841097083152
28,59,재미/Noun,4538,1752,2786,0.019474023519996442,0.030943865650754163,0.6139268400176289
29,60,내용/Noun,4529,1407,3122,0.01563924149123002,0.0346757891463225,0.6893353941267388
30,61,뭐/Noun,4491,831,3660,0.009236822799724341,0.040651309505298,0.8149632598530394
31,62,못/VerbPrefix,4418,1474,2944,0.016383967276526686,0.032698758246884514,0.666364870982345
32,63,그냥/Noun,4406,1187,3219,0.013193873241002156,0.03575315991736455,0.7305946436677259
33,64,고/Josa,4377,1761,2616,0.01957406131205122,0.029055690072639227,0.5976696367374914
34,66,게/Josa,4340,1723,2617,0.019151679523375497,0.029066796987804608,0.6029953917050691
35,67,안/VerbPrefix,4262,1318,2944,0.014649978880910566,0.032698758246884514,0.6907555138432661
36,69,좀/Noun,4111,1455,2656,0.016172776382188826,0.029499966679254506,0.6460715154463634
37,70,그/Noun,4099,2400,1699,0.02667674454794033,0.01887064886598396,0.5855086606489388
38,71,없는/Adjective,4090,1373,2717,0.015261320943467532,0.0301774885043428,0.6643031784841076
39,73,!!/Punctuation,4005,3088,917,0.03432407798501656,0.010185041206655265,0.7710362047440699
40,74,시간/Noun,3956,1077,2879,0.011971189115888223,0.03197680876113468,0.7277553083923155
41,75,한/Determiner,3920,1604,2316,0.01782895760620679,0.02572361552302464,0.5908163265306122
42,76,쓰레기/Noun,3739,209,3530,0.002323099837716471,0.03920741053379834,0.9441027012570206
43,78,수/Noun,3698,2475,1223,0.02751039281506347,0.013583757247262143,0.6692806922660898
44,80,아/Exclamation,3469,1327,2142,0.014750016672965344,0.02379101228424817,0.6174690112424329
45,83,없다/Adjective,3324,873,2451,0.009703665829313295,0.0272230490703512,0.7373646209386282
46,84,작품/Noun,3308,2050,1258,0.02278638596803237,0.013972499278050514,0.6197097944377267
47,85,다시/Noun,3289,2763,526,0.030711602160816313,0.005842237376990914,0.8400729705077531
48,86,잘/Verb,3274,2363,911,0.02626547806949292,0.010118399715662972,0.7217470983506414
49,87,10/Number,3248,2158,1090,0.023986839472689682,0.012106537530266344,0.6644088669950738
50,88,마지막/Noun,3201,2151,1050,0.023909032301091523,0.011662260923651064,0.6719775070290535
51,90,사랑/Noun,3190,2523,667,0.028043927706022275,0.007408312415309772,0.7909090909090909
52,91,잘/VerbPrefix,3151,2150,1001,0.023897916990863216,0.011118022080547348,0.682323072040622
53,92,본/Verb,3099,1949,1150,0.02166373963497321,0.012772952440189262,0.6289125524362698
54,93,하나/Noun,3087,1267,1820,0.014083098059266837,0.02021458560099518,0.5895691609977324
55,95,요/Josa,3013,1950,1063,0.021674854945201518,0.011806650820801031,0.6471954862263525
56,96,좋은/Adjective,3009,2156,853,0.023964608852233067,0.009474198636070815,0.7165171153207045
57,99,나/Josa,2916,1029,1887,0.011437654224929416,0.02095874891707577,0.647119341563786
58,101,있는/Adjective,2899,2055,844,0.02284196251917391,0.00937423639958238,0.7088651259054847
59,102,입니다/Adjective,2888,2167,721,0.02408687726474446,0.008008085834240399,0.7503462603878116
60,105,ㅋ/KoreanParticle,2712,1574,1138,0.017495498299357534,0.012639669458204678,0.5803834808259587
61,106,주인공/Noun,2708,1083,1625,0.012037880977258077,0.01804873714374569,0.6000738552437223
62,111,중/Suffix,2597,1568,1029,0.017428806437987686,0.011429015705178043,0.6037735849056604
63,112,지금/Noun,2596,1843,753,0.020485516750772512,0.00836350711953262,0.7099383667180277
64,113,ㅠㅠ/KoreanParticle,2589,1842,747,0.0204744014405442,0.00829686562854033,0.7114716106604867
65,114,최악/Noun,2549,32,2517,0.00035568992730587116,0.02795610547126641,0.9874460572773636
66,115,지/Josa,2511,993,1518,0.011037503056710312,0.016860297221049824,0.6045400238948626
67,117,재밌게/Adjective,2508,2195,313,0.024398105951137096,0.0034764644467645558,0.8751993620414673
68,118,걸/Noun,2493,777,1716,0.008636596047395683,0.019059466423795454,0.6883273164861613
69,119,3/Number,2481,918,1563,0.010203854789587177,0.017360108403492013,0.6299879081015719
70,121,연출/Noun,2454,975,1479,0.010837427472600759,0.01642712752959993,0.6026894865525673
71,122,별로/Noun,2438,320,2118,0.003556899273058711,0.02352444632027901,0.8687448728465955
72,123,끝/Noun,2438,862,1576,0.009581397416801902,0.01750449830064198,0.6464315012305168
73,124,돈/Noun,2433,279,2154,0.003101171553698064,0.02392429526623276,0.8853267570900123
74,128,라/Josa,2373,987,1386,0.01097081119534046,0.015394184419219406,0.584070796460177
75,129,그리고/Conjunction,2339,1419,920,0.015772625213969722,0.010218361952151409,0.6066695168875588
76,130,역시/Noun,2323,1623,700,0.01804014850054465,0.007774840615767376,0.6986655187257856
77,131,봐도/Verb,2322,1795,527,0.01995198185981371,0.0058533442921562965,0.773040482342808
78,132,개/Noun,2277,671,1606,0.007458373163194984,0.01783770575560344,0.7053140096618358
79,133,명작/Noun,2259,1976,283,0.02196385301113754,0.0031432569918030968,0.8747233289065959
80,134,이런/Modifier,2201,819,1382,0.00910343907698464,0.01534975675855788,0.6278964107223989
81,136,이해/Noun,2164,866,1298,0.009625858657715135,0.01441677588466579,0.5998151571164511
82,137,^^/Punctuation,2162,1921,241,0.021352510948580573,0.002676766554857054,0.8885291396854764
83,138,라고/Josa,2147,777,1370,0.008636596047395683,0.015216473776573296,0.6380996739636703
84,139,ㅡㅡ/KoreanParticle,2128,211,1917,0.002345330458173088,0.02129195637203723,0.9008458646616542
85,140,없고/Adjective,2122,205,1917,0.002278638596803237,0.02129195637203723,0.9033930254476908
86,142,안/Noun,2100,842,1258,0.009359091212235734,0.013972499278050514,0.599047619047619
87,145,때문/Noun,2060,810,1250,0.009003401284929862,0.013883643956727459,0.6067961165048543
88,146,!!!/Punctuation,2038,1392,646,0.01547251183780539,0.00717506719683675,0.6830225711481845
89,147,또/Noun,2013,1348,665,0.014983438187759818,0.007386098584979008,0.6696472925981123
90,149,중/Noun,1957,1139,818,0.01266033835004335,0.00908545660528245,0.5820132856412877
91,150,아깝다/Adjective,1949,47,1902,0.0005224195807304982,0.021125352644556502,0.9758850692662904
92,151,여자/Noun,1944,757,1187,0.008414289842829513,0.013183908301308394,0.61059670781893
93,152,난/Noun,1928,1196,732,0.01329391103305693,0.0081302619010596,0.6203319502074689
94,153,꼭/Noun,1920,1594,326,0.0177178045039237,0.003620854343914521,0.8302083333333333
95,155,에게/Josa,1907,1144,763,0.012715914901184892,0.00847457627118644,0.5998951232302046
96,161,마음/Noun,1810,1497,313,0.016639619411777783,0.0034764644467645558,0.8270718232044199
97,162,인생/Noun,1810,1304,506,0.014494364537714247,0.0056200990736832756,0.7204419889502762
98,165,기억/Noun,1794,1237,557,0.01374963875241758,0.006186551747117756,0.6895206243032329
99,166,부터/Josa,1791,743,1048,0.008258675499633194,0.011640047093320302,0.5851479620323842
100,167,결말/Noun,1777,729,1048,0.008103061156436877,0.011640047093320302,0.5897580191333709
101,169,ㅎㅎ/KoreanParticle,1744,1498,246,0.01665073472200609,0.002732301130683964,0.8589449541284404
102,171,못/Noun,1720,544,1176,0.00604672876419981,0.013061732234489191,0.6837209302325581
103,173,소재/Noun,1714,594,1120,0.0066024942756152324,0.012439744985227805,0.6534422403733956
104,174,이나/Josa,1704,527,1177,0.005857768490318565,0.013072839149654573,0.6907276995305164
105,176,애/Noun,1670,576,1094,0.00640241869150568,0.012150965190927872,0.6550898203592814
106,178,수준/Noun,1658,273,1385,0.003034479692328213,0.015383077504054024,0.8353437876960192
107,179,한번/Noun,1640,1136,504,0.012626992419358423,0.005597885243352511,0.6926829268292682
108,181,네/Josa,1608,469,1139,0.0052130804970766725,0.01265077637337006,0.7083333333333334
109,182,넘/Verb,1591,1126,465,0.01251583931707534,0.005164715551902614,0.7077309868007542
110,184,현실/Noun,1587,1041,546,0.01157103794766912,0.006064375680298554,0.6559546313799622
111,185,전개/Noun,1586,418,1168,0.004646199675432942,0.012972876913166138,0.7364438839848676
112,186,매력/Noun,1586,1153,433,0.012815952693239669,0.00480929426661039,0.7269861286254728
113,188,가슴/Noun,1575,1376,199,0.015294666874152455,0.0022102761179110114,0.8736507936507937
114,189,하게/Verb,1574,1130,444,0.012560300557988574,0.004931470333429593,0.7179161372299873
115,190,되는/Verb,1569,977,592,0.010859658093057377,0.006575293777906124,0.6226896112173359
116,191,~~/Punctuation,1556,1038,518,0.011537692016984194,0.00575338205566786,0.6670951156812339
117,192,야/Josa,1543,373,1170,0.00414601071515906,0.012995090743496902,0.7582631237848347
118,194,님/Suffix,1536,948,588,0.010537314096436429,0.006530866117244597,0.6171875
119,196,가장/Noun,1534,1006,528,0.011182002089678324,0.005864451207321679,0.6558018252933507
120,197,;;/Punctuation,1523,373,1150,0.00414601071515906,0.012772952440189262,0.7550886408404465
121,198,저/Noun,1522,907,615,0.010081586377075784,0.00683075282670991,0.5959264126149802
122,199,??/Punctuation,1503,455,1048,0.005057466153880355,0.011640047093320302,0.697272122421823
123,202,아/Josa,1457,606,851,0.006735877998354935,0.009451984805740056,0.5840768702814001
124,204,음악/Noun,1452,1077,375,0.011971189115888223,0.0041650931870182385,0.7417355371900827
125,206,성/Suffix,1445,496,949,0.0055131938732410025,0.010540462491947487,0.6567474048442906
126,207,만든/Verb,1445,521,924,0.005791076628948714,0.010262789612812935,0.6394463667820071
127,208,아이/Noun,1436,944,492,0.010492852855523198,0.005464602261367928,0.6573816155988857
128,211,봤다/Verb,1414,872,542,0.009692550519084988,0.006019948019637026,0.6166902404526167
129,213,무슨/Noun,1408,215,1193,0.002389791699086321,0.013250549792300687,0.8473011363636364
130,214,추천/Noun,1403,1037,366,0.011526576706755885,0.0040651309505298,0.7391304347826086
131,215,만/Noun,1401,947,454,0.010526198786208123,0.005042539485083413,0.6759457530335474
132,216,냐/Josa,1392,169,1223,0.001878487428584132,0.013583757247262143,0.8785919540229885
133,217,인지/Josa,1383,425,958,0.004724006847031101,0.010640424728435923,0.6926970354302241
134,218,게/Noun,1380,485,895,0.005390925460729609,0.009940689073016859,0.6485507246376812
135,219,눈물/Noun,1378,1156,222,0.012849298623924595,0.002465735166714797,0.8388969521044993
136,220,인가/Josa,1378,446,932,0.004957428361825579,0.010351644934135993,0.6763425253991292
137,222,번/Noun,1370,945,425,0.010503968165751507,0.004720438945287336,0.6897810218978102
138,223,ㅠ/KoreanParticle,1361,899,462,0.009992663895249316,0.005131394806406469,0.6605437178545187
139,224,합니다/Verb,1360,1010,350,0.011226463330591557,0.003887420307883689,0.7426470588235294
140,226,저/Determiner,1355,471,884,0.005235311117533291,0.009818513006197658,0.6523985239852399
141,227,우리/Noun,1346,996,350,0.011070848987395238,0.003887420307883689,0.7399702823179792
142,228,인간/Noun,1346,839,507,0.009325745281550809,0.005631205988848657,0.6233283803863299
143,229,네/Suffix,1337,913,424,0.010148278238445637,0.004709332030121954,0.6828721017202692
144,233,지만/Josa,1312,784,528,0.008714403218993843,0.005864451207321679,0.5975609756097561
145,234,속/Noun,1307,819,488,0.00910343907698464,0.005420174600706399,0.6266258607498087
146,237,재밌다/Adjective,1294,1174,120,0.013049374208034144,0.001332829819845836,0.9072642967542504
147,239,원작/Noun,1275,429,846,0.0047684680879443355,0.009396450229913143,0.6635294117647059
148,240,솔직히/Adjective,1253,412,841,0.0045795078140630895,0.009340915654086237,0.6711891460494812
149,241,그래도/Adverb,1246,736,510,0.008180868328035036,0.005664526734344803,0.5906902086677368
150,243,뭔가/Noun,1237,502,735,0.005579885734610853,0.008163582646555746,0.5941794664510913
151,244,좋다/Adjective,1236,1070,166,0.011893381944290064,0.0018437479174534066,0.8656957928802589
152,245,코미디/Noun,1235,485,750,0.005390925460729609,0.008330186374036475,0.6072874493927125
153,248,있다/Adjective,1212,777,435,0.008636596047395683,0.0048315080969411565,0.6410891089108911
154,249,여운/Noun,1210,1139,71,0.01266033835004335,0.0007885909767421196,0.9413223140495868
155,251,움/Noun,1204,432,772,0.00480181401862926,0.00857453850767488,0.6411960132890365
156,253,전혀/Noun,1199,338,861,0.003756974857168264,0.009563053957393873,0.7180984153461217
157,254,기대/Noun,1198,745,453,0.008280906120089812,0.005031432569918031,0.6218697829716193
158,255,모두/Noun,1194,810,384,0.009003401284929862,0.004265055423506675,0.6783919597989949
159,256,대박/Noun,1180,975,205,0.010837427472600759,0.002276917608903303,0.826271186440678
160,257,대한/Noun,1173,715,458,0.007947446813240557,0.005086967145744941,0.6095481670929241
161,259,씨/Suffix,1170,706,464,0.007847409021185782,0.005153608636737233,0.6034188034188034
162,261,별/Noun,1164,304,860,0.003379054309405776,0.009551947042228491,0.7388316151202751
163,262,계속/Noun,1161,707,454,0.007858524331414091,0.005042539485083413,0.6089577950043066
164,263,굿/Noun,1156,1072,84,0.01191561256474668,0.0009329808738920851,0.9273356401384084
165,264,아주/Noun,1152,682,470,0.007580641575706378,0.005220250127729524,0.5920138888888888
166,265,어떻게/Adjective,1149,466,683,0.005179734566391748,0.007586023057955883,0.5944299390774587
167,267,모습/Noun,1142,842,300,0.009359091212235734,0.00333207454961459,0.7373029772329247
168,268,별/Modifier,1142,316,826,0.003512438032145477,0.009174311926605505,0.7232924693520141
169,271,하면/Verb,1127,461,666,0.005124158015250207,0.007397205500144391,0.5909494232475601
170,272,전/Noun,1126,674,452,0.007491719093879909,0.00502032565475265,0.5985790408525755
171,273,허/Verb,1121,125,996,0.001389413778538559,0.011062487504720437,0.8884924174843889
172,274,실망/Noun,1118,115,1003,0.0012782606762554744,0.011140235910878113,0.8971377459749553
173,277,요/Noun,1099,666,433,0.007402796612053442,0.00480929426661039,0.6060054595086443
174,279,일본/Noun,1098,391,707,0.0043460862992686115,0.00785258902192505,0.6438979963570127
175,280,보지/Noun,1094,324,770,0.0036013605139719454,0.008552324677344115,0.7038391224862889
176,281,진심/Noun,1094,415,679,0.004612853744748016,0.007541595397294354,0.6206581352833638
177,284,재미있게/Adjective,1086,979,107,0.010881888713513994,0.0011884399226958706,0.9014732965009208
178,289,일/Modifier,1074,387,687,0.004301625058355379,0.007630450718617411,0.6396648044692738
179,291,제목/Noun,1073,405,668,0.004501700642464931,0.007419419330475155,0.6225535880708295
180,292,였다/Verb,1071,709,362,0.007880754951870706,0.004020703289868272,0.6619981325863679
181,293,없음/Adjective,1069,179,890,0.0019896405308672165,0.00988515449718995,0.8325537885874649
182,294,많은/Adjective,1069,790,279,0.008781095080363692,0.003098829331141569,0.7390084190832554
183,296,몰입/Noun,1061,631,430,0.0070137607540626465,0.004775973521114246,0.5947219604147032
184,298,봤습니다/Verb,1059,961,98,0.010681813129404442,0.001088477686207433,0.9074598677998112
185,299,나오는/Verb,1058,434,624,0.0048240446390858775,0.006930715063198347,0.5897920604914934
186,300,밖에/Josa,1056,430,626,0.004779583398172643,0.0069529288935291115,0.5928030303030303
187,303,뿐/Noun,1051,311,740,0.0034568614810039353,0.008219117222382655,0.7040913415794482
188,306,재밌어요/Adjective,1049,1012,37,0.011248693951048171,0.0004109558611191328,0.9647283126787416
189,307,ㅎ/KoreanParticle,1048,840,208,0.009336860591779116,0.0023102383543994486,0.8015267175572519
190,308,;/Punctuation,1045,287,758,0.0031900940355245318,0.008419041695359529,0.7253588516746412
191,309,보다/Verb,1045,365,680,0.004057088233332592,0.0075527023124597375,0.6507177033492823
192,310,표현/Noun,1042,681,361,0.007569526265478068,0.00400959637470289,0.6535508637236085
193,312,아니다/Adjective,1036,293,743,0.0032567858968943824,0.008252437967878801,0.7171814671814671
194,313,재미없다/Adjective,1035,22,1013,0.00024453682502278637,0.01125130506253193,0.978743961352657
195,314,OO/Alpha,1033,220,813,0.002445368250227864,0.009029922029455541,0.7870280735721199
196,316,가족/Noun,1031,710,321,0.007891870262099015,0.0035653197680876117,0.6886517943743938
197,319,요즘/Noun,1013,643,370,0.007147144476802349,0.004109558611191328,0.6347482724580454
198,321,점도/Noun,1011,91,920,0.001011493230776071,0.010218361952151409,0.9099901088031652
199,324,봐/Verb,1003,601,402,0.006680301447213392,0.004464979896483551,0.5992023928215354
200,326,용/Noun,999,295,704,0.0032790165173509998,0.007819268276428905,0.7047047047047047
201,328,ㅜㅜ/KoreanParticle,996,633,363,0.007035991374519263,0.0040318102050336535,0.6355421686746988
202,329,모든/Noun,986,630,356,0.0070026454438343365,0.003954061798875979,0.6389452332657201
203,330,4/Number,981,333,648,0.003701398306026721,0.0071972810271675155,0.6605504587155964
204,332,급/Noun,974,237,737,0.0026343285241091077,0.00818579647688651,0.7566735112936345
205,334,하다/Verb,970,367,603,0.0040793188537892105,0.0066974698447253254,0.6216494845360825
206,335,조금/Noun,967,582,385,0.006469110552875531,0.004276162338672057,0.6018614270941055
207,336,특히/Adverb,966,665,301,0.007391681301825134,0.003343181464779972,0.6884057971014492
208,340,개인/Noun,957,633,324,0.007035991374519263,0.003598640513583757,0.6614420062695925
209,343,아닌/Adjective,953,398,555,0.004423893470866772,0.0061643379167869924,0.5823714585519413
210,344,공포/Noun,951,319,632,0.0035457839628304025,0.007019570384521403,0.6645636172450052
211,347,건지/Verb,933,160,773,0.0017784496365293556,0.008585645422840259,0.8285101822079314
212,348,건/Noun,932,292,640,0.0032456705866660733,0.007108425705844459,0.6866952789699571
213,349,한테/Josa,931,317,614,0.003523553342373785,0.006819645911544527,0.6595059076262084
214,350,작가/Noun,929,209,720,0.002323099837716471,0.007996978919075016,0.77502691065662
215,351,이유/Noun,928,364,564,0.004045972923104284,0.006264300153275429,0.6077586206896551
216,352,나름/Noun,923,600,323,0.006669186136985084,0.003587533598418375,0.6500541711809318
217,355,아까운/Adjective,917,63,854,0.0007002645443834338,0.0094853055512362,0.931297709923664
218,356,아니고/Adjective,914,147,767,0.0016339506035613453,0.008519003931847971,0.8391684901531729
219,357,보다가/Verb,913,186,727,0.0020674477024653763,0.00807472732523269,0.7962760131434831
220,358,욕/Noun,910,166,744,0.0018451414978992067,0.008263544883044184,0.8175824175824176
221,359,차라리/Noun,909,59,850,0.0006558033034701999,0.009440877890574672,0.935093509350935
222,360,노래/Noun,909,604,305,0.006713647377898317,0.0033876091254415,0.6644664466446645
223,361,제대로/Noun,907,366,541,0.0040682035435609006,0.006008841104471644,0.5964718853362734
224,362,짱/Noun,905,842,63,0.009359091212235734,0.0006997356554190639,0.9303867403314916
225,363,중간/Noun,905,328,577,0.0036458217548851783,0.0064086900504253955,0.6375690607734806
226,364,알바/Noun,897,104,793,0.001155992263744081,0.0088077837261479,0.8840579710144928
227,366,아름다운/Adjective,890,799,91,0.008881132872418469,0.001010729280049759,0.8977528089887641
228,367,0/Number,888,77,811,0.0008558788875797522,0.009007708199124777,0.9132882882882885
229,369,삶/Noun,883,770,113,0.008558788875797524,0.0012550814136881624,0.8720271800679502
230,372,...../Punctuation,877,327,550,0.003634706444656871,0.006108803340960082,0.6271379703534777
231,373,제/Noun,874,553,321,0.006146766556254586,0.0035653197680876117,0.6327231121281465
232,374,오랜/Modifier,870,699,171,0.007769601849587622,0.0018992824932803163,0.8034482758620691
233,375,기/Noun,869,240,629,0.002667674454794033,0.006986249639025257,0.7238204833141542
234,376,보게/Verb,865,698,167,0.007758486539359314,0.0018548548326187888,0.8069364161849711
235,377,제일/Noun,865,507,358,0.0056354622857523965,0.003976275629206745,0.5861271676300578
236,378,당시/Noun,862,550,312,0.00611342062556966,0.0034653575315991736,0.6380510440835266
237,379,점수/Noun,857,271,586,0.003012249071871596,0.006508652286913832,0.6837806301050176
238,382,보세요/Verb,847,583,264,0.006480225863103839,0.0029322256036608393,0.6883116883116883
239,384,놈/Noun,846,250,596,0.002778827557077118,0.006619721438567652,0.7044917257683215
240,385,봤어요/Verb,843,794,49,0.008825556321276927,0.0005442388431037163,0.9418742586002372
241,386,아직도/Adverb,841,631,210,0.0070137607540626465,0.002332452184730213,0.7502972651605232
242,387,막장/Noun,834,144,690,0.00160060467287642,0.007663771464113556,0.8273381294964028
243,388,력/Suffix,830,347,483,0.00385701264922304,0.0053646400248794895,0.5819277108433735
244,391,세상/Noun,824,533,291,0.005924460351688416,0.0032321123131261523,0.6468446601941747
245,393,좋고/Adjective,819,740,79,0.008225329568948269,0.0008774462980651753,0.9035409035409036
246,395,이지/Josa,815,332,483,0.0036902829957984134,0.0053646400248794895,0.5926380368098161
247,396,이라고/Josa,815,342,473,0.003801436098081498,0.005253570873225671,0.5803680981595092
248,397,공포영화/Noun,809,293,516,0.0032567858968943824,0.005731168225337095,0.6378244746600742
249,400,도대체/Noun,805,101,704,0.0011226463330591557,0.007819268276428905,0.8745341614906832
250,402,앞/Noun,797,485,312,0.005390925460729609,0.0034653575315991736,0.6085319949811794
251,403,재밌음/Adjective,795,735,60,0.008169753017806727,0.000666414909922918,0.9245283018867924
252,404,뻔한/Adjective,795,199,596,0.002211946735433386,0.006619721438567652,0.7496855345911949
253,405,좋아하는/Adjective,792,528,264,0.0058688838005468745,0.0029322256036608393,0.6666666666666666
254,406,류/Noun,790,141,649,0.0015672587421914947,0.007208387942332897,0.8215189873417722
255,407,나도/Verb,790,498,292,0.005535424493697619,0.0032432192282915344,0.6303797468354431
256,411,있고/Adjective,787,619,168,0.006880377031322943,0.0018659617477841703,0.7865311308767471
257,412,절대/Noun,787,263,524,0.002923326590045128,0.005820023546660151,0.6658195679796697
258,413,뭘/Noun,782,175,607,0.0019451792899539827,0.006741897505386854,0.7762148337595908
259,415,물/Noun,777,295,482,0.0032790165173509998,0.005353533109714108,0.6203346203346203
260,416,제/Modifier,775,314,461,0.00349020741168886,0.0051202878912410855,0.5948387096774194
261,419,수작/Noun,766,696,70,0.007736255918902695,0.0007774840615767378,0.908616187989556
262,420,엄청/Adverb,766,465,301,0.00516861925616344,0.003343181464779972,0.6070496083550914
263,421,걍/Adverb,765,208,557,0.002311984527488162,0.006186551747117756,0.7281045751633987
264,422,설정/Noun,762,139,623,0.0015450281217348775,0.006919608148032965,0.8175853018372703
265,423,초반/Noun,761,265,496,0.002945557210501745,0.005509029922029457,0.6517739816031537
266,424,된다/Verb,761,462,299,0.005135273325478514,0.0033209676344492078,0.607095926412615
267,427,준다/Verb,748,271,477,0.003012249071871596,0.005297998533887197,0.6377005347593583
268,428,주고/Verb,747,183,564,0.0020341017717804503,0.006264300153275429,0.7550200803212851
269,429,남는/Verb,744,598,146,0.006646955516528465,0.0016216096141457672,0.803763440860215
270,430,시나리오/Noun,742,207,535,0.002300869217259854,0.005942199613479352,0.7210242587601078
271,431,딱/Adverb,742,251,491,0.0027899428673054264,0.005453495346202546,0.6617250673854448
272,432,이란/Josa,742,435,307,0.004835159949314186,0.003409822955772264,0.5862533692722371
273,435,출연/Noun,740,226,514,0.0025120601115977146,0.005708954395006331,0.6945945945945946
274,437,좋았다/Adjective,733,600,133,0.006669186136985084,0.0014772197169958016,0.8185538881309686
275,438,관객/Noun,732,188,544,0.0020896783229219927,0.00604216184996779,0.7431693989071039
276,439,주는/Verb,731,477,254,0.005302002978903141,0.0028211564520070195,0.6525307797537621
277,440,한국영/Noun,731,295,436,0.0032790165173509998,0.004842615012106539,0.5964432284541724
278,441,안되는/Adjective,730,161,569,0.001789564946757664,0.006319834729102339,0.7794520547945205
279,442,이야/Josa,730,298,432,0.003312362448035925,0.00479818735144501,0.5917808219178082
280,443,가지/Noun,725,278,447,0.003090056243469755,0.004964791078925739,0.616551724137931
281,444,노잼/Noun,724,17,707,0.00018896027388124405,0.00785258902192505,0.9765193370165746
282,446,뭔/Modifier,722,104,618,0.001155992263744081,0.006864073572206054,0.8559556786703602
283,447,분위기/Noun,721,443,278,0.004924082431140653,0.0030877224159761873,0.6144244105409153
284,448,시대/Noun,719,474,245,0.0052686570482182145,0.002721194215518582,0.6592489568845619
285,450,장난/Noun,714,182,532,0.002022986461552142,0.005908878867983206,0.7450980392156863
286,451,최고다/Noun,711,679,32,0.007547295645021453,0.00035542128529222287,0.9549929676511956
287,452,봤던/Verb,711,560,151,0.006224573727852744,0.001677144189972677,0.7876230661040787
288,454,OOO/Alpha,708,91,617,0.001011493230776071,0.006852966657040674,0.8714689265536724
289,455,같아요/Adjective,708,559,149,0.006213458417624436,0.001654930359641913,0.7895480225988699
290,456,결국/Adverb,708,253,455,0.0028121734877620433,0.005053646400248795,0.6426553672316384
291,457,지루함/Noun,707,100,607,0.0011115310228308473,0.006741897505386854,0.8585572842998586
292,458,추억/Noun,707,576,131,0.00640241869150568,0.0014550058866650375,0.8147100424328148
293,460,소리/Noun,705,202,503,0.0022452926661183114,0.005586778328187129,0.7134751773049646
294,461,니/Josa,705,294,411,0.003267901207122691,0.004564942132971988,0.5829787234042553
295,462,이딴/Modifier,703,26,677,0.00028899806593602026,0.007519381566963592,0.9630156472261736
296,463,지루하고/Adjective,702,38,664,0.000422381788675722,0.0073749916698136265,0.945868945868946
297,465,좋아요/Adjective,696,653,43,0.007258297579085431,0.0004775973521114245,0.9382183908045976
298,467,마다/Josa,694,480,214,0.005335348909588066,0.002376879845391741,0.69164265129683
299,468,살/Noun,690,420,270,0.004668430295889558,0.002998867094653131,0.6086956521739131
300,469,인상/Noun,689,547,142,0.006080074694884734,0.0015771819534842392,0.7939042089985486
301,470,이지만/Josa,687,427,260,0.004746237467487717,0.002887797942999312,0.6215429403202329
302,471,오늘/Noun,685,462,223,0.005135273325478514,0.002476842081880179,0.6744525547445256
303,472,감정/Noun,684,445,239,0.004946313051597271,0.0026545527245262907,0.6505847953216374
304,473,전/Modifier,680,199,481,0.002211946735433386,0.005342426194548726,0.7073529411764706
305,474,정신/Noun,678,183,495,0.0020341017717804503,0.0054979230068640745,0.7300884955752213
306,475,엔딩/Noun,678,431,247,0.004790698708400951,0.0027434080458493453,0.6356932153392331
307,478,접/Noun,676,122,554,0.0013560678478536335,0.006153231001621609,0.8195266272189349
308,480,졸작/Noun,672,34,638,0.0003779205477624881,0.007086211875513696,0.949404761904762
309,481,제발/Noun,671,179,492,0.0019896405308672165,0.005464602261367928,0.7332339791356185
310,482,자신/Noun,671,422,249,0.004690660916346175,0.002765621876180109,0.6289120715350224
311,485,아무리/Adverb,666,114,552,0.0012671453660271655,0.006131017171290846,0.8288288288288288
312,486,그저/Adverb,666,221,445,0.0024564835604561725,0.004942577248594975,0.6681681681681682
313,488,♥/Foreign,660,651,9,0.007236066958628815,9.996223648843771e-05,0.9863636363636364
314,490,킬링타임/Noun,659,186,473,0.0020674477024653763,0.005253570873225671,0.7177541729893778
315,491,어릴/Verb,658,548,110,0.006091190005113043,0.0012217606681920164,0.8328267477203647
316,492,~~~/Punctuation,657,400,257,0.004446124091323389,0.0028544771975031647,0.60882800608828
317,493,함께/Adverb,656,544,112,0.00604672876419981,0.0012439744985227805,0.8292682926829268
318,494,그렇게/Adverb,656,251,405,0.0027899428673054264,0.004498300641979696,0.6173780487804879
319,496,캐스팅/Noun,653,219,434,0.0024342529399995552,0.004820401181775774,0.664624808575804
320,497,8/Number,653,388,265,0.004312740368583687,0.002943332518826221,0.5941807044410413
321,498,대해/Noun,651,506,145,0.0056243469755240865,0.001610502698980385,0.7772657450076805
322,501,재밌는/Adjective,647,549,98,0.006102305315341351,0.001088477686207433,0.848531684698609
323,502,멋진/Adjective,643,560,83,0.006224573727852744,0.0009218739587267033,0.8709175738724728
324,503,괜찮은/Adjective,643,487,156,0.005413156081186226,0.0017326787657995868,0.7573872472783826
325,504,포스터/Noun,642,205,437,0.002278638596803237,0.00485372192727192,0.6806853582554517
326,505,몰입도/Noun,638,412,226,0.0045795078140630895,0.002510162827376325,0.64576802507837
327,507,엉/Exclamation,636,103,533,0.0011448769535157724,0.005919985783148589,0.8380503144654088
328,508,자/Suffix,632,213,419,0.0023675610786297045,0.004653797454295044,0.6629746835443038
329,509,갈수록/Noun,631,192,439,0.0021341395638352265,0.0048759357576026825,0.6957210776545166
330,510,아니/Adjective,631,205,426,0.002278638596803237,0.004731545860452718,0.6751188589540412
331,511,스릴/Noun,631,370,261,0.004112664784474134,0.002898904858164693,0.5863708399366085
332,512,개연/Noun,630,55,575,0.000611342062556966,0.006386476220094631,0.9126984126984128
333,513,애니메이션/Noun,630,418,212,0.004646199675432942,0.002354666015060977,0.6634920634920635
334,514,했던/Verb,627,391,236,0.0043460862992686115,0.002621231979030144,0.6236044657097288
335,516,배경/Noun,625,369,256,0.004101549474245826,0.002843370282337784,0.5904
336,517,같은데/Adjective,624,244,380,0.002712135695707267,0.0042206277628451475,0.6089743589743589
337,520,!!!!/Punctuation,622,460,162,0.005113042705021898,0.0017993202567918784,0.7395498392282959
338,523,문제/Noun,619,201,418,0.0022341773558900027,0.004642690539129663,0.6752827140549273
339,524,이름/Noun,617,239,378,0.002656559144565725,0.004198413932514383,0.6126418152350082
340,525,지/Modifier,617,246,371,0.002734366316163884,0.00412066552635671,0.6012965964343598
341,527,하/Exclamation,614,213,401,0.0023675610786297045,0.0044538729813181676,0.6530944625407166
342,528,ㅠㅠㅠ/KoreanParticle,611,496,115,0.0055131938732410025,0.0012772952440189265,0.8117839607201309
343,529,싶은/Verb,611,359,252,0.00399039637196274,0.002798942621676256,0.5875613747954174
344,530,충격/Noun,610,399,211,0.00443500878109508,0.002343559099895595,0.6540983606557377
345,531,맘/Noun,609,373,236,0.00414601071515906,0.002621231979030144,0.6124794745484401
346,533,머리/Noun,603,235,368,0.002612097903652491,0.004087344780860563,0.6102819237147595
347,535,보단/Josa,600,239,361,0.002656559144565725,0.00400959637470289,0.6016666666666667
348,536,질/Noun,599,104,495,0.001155992263744081,0.0054979230068640745,0.8263772954924875
349,545,적/Noun,593,406,187,0.004512815952693239,0.002076993135926428,0.684654300168634
350,547,지루한/Adjective,592,100,492,0.0011115310228308473,0.005464602261367928,0.8310810810810809
351,551,강추/Noun,590,547,43,0.006080074694884734,0.0004775973521114245,0.9271186440677966
352,552,얘기/Noun,590,217,373,0.0024120223195429388,0.0041428793566874724,0.6322033898305085
353,553,대/Foreign,587,217,370,0.0024120223195429388,0.004109558611191328,0.6303236797274276
354,555,장르/Noun,583,201,382,0.0022341773558900027,0.004242841593175911,0.6552315608919382
355,557,더빙/Noun,582,150,432,0.0016672965342462707,0.00479818735144501,0.7422680412371134
356,558,재밌고/Adjective,581,533,48,0.005924460351688416,0.0005331319279383344,0.9173838209982788
357,559,모르겠다/Verb,581,115,466,0.0012782606762554744,0.005175822467067996,0.8020654044750429
358,561,어디/Noun,579,237,342,0.0026343285241091077,0.0037985649865606326,0.5906735751295337
359,562,주연/Noun,577,225,352,0.0025009448013694068,0.003909634138214452,0.6100519930675911
360,563,얼굴/Noun,576,199,377,0.002211946735433386,0.004187307017349001,0.6545138888888888
361,568,웃기/Noun,571,344,227,0.0038236667185381134,0.0025212697425417065,0.6024518388791593
362,569,머/Noun,570,97,473,0.0010781850921459217,0.005253570873225671,0.8298245614035088
363,571,비/Noun,563,225,338,0.0025009448013694068,0.003754137325899105,0.6003552397868561
364,572,여기/Noun,563,228,335,0.0025342907320543315,0.0037208165804029593,0.5950266429840142
365,573,꽤/Noun,562,441,121,0.004901851810684036,0.001343936735011218,0.7846975088967971
366,574,하는데/Verb,562,199,363,0.002211946735433386,0.0040318102050336535,0.6459074733096085
367,576,짜증/Noun,558,23,535,0.00025565213525109487,0.005942199613479352,0.9587813620071683
368,577,보는데/Verb,558,219,339,0.0024342529399995552,0.0037652442410644866,0.6075268817204301
369,578,9/Number,557,382,175,0.0042460485072138366,0.0019437101539418445,0.6858168761220825
370,579,매우/Noun,557,343,214,0.003812551408309806,0.002376879845391741,0.6157989228007181
371,580,지루하다/Adjective,556,14,542,0.0001556143431963186,0.006019948019637026,0.974820143884892
372,581,ㅡ/KoreanParticle,556,157,399,0.00174510370584443,0.004431659150987405,0.7176258992805755
373,582,날/Noun,556,337,219,0.0037458595469399545,0.0024324144212186506,0.6061151079136691
374,583,ㅎㅎㅎ/KoreanParticle,555,434,121,0.0048240446390858775,0.001343936735011218,0.781981981981982
375,584,너무나/Adverb,552,365,187,0.004057088233332592,0.002076993135926428,0.6612318840579711
376,585,이리/Adverb,552,199,353,0.002211946735433386,0.0039207410533798346,0.6394927536231884
377,586,진/Noun,552,216,336,0.00240090700931463,0.0037319234955683405,0.6086956521739131
378,588,???/Punctuation,551,142,409,0.0015783740524198029,0.004542728302641225,0.7422867513611615
379,589,두/Noun,551,362,189,0.004023742302647667,0.002099206966257192,0.6569872958257713
380,591,전쟁/Noun,549,326,223,0.003623591134428562,0.002476842081880179,0.5938069216757741
381,592,건가/Noun,546,124,422,0.0013782984683102506,0.00468711819979119,0.7728937728937729
382,593,아직/Adverb,546,363,183,0.004034857612875975,0.0020325654752649,0.6648351648351648
383,596,작/Modifier,544,183,361,0.0020341017717804503,0.00400959637470289,0.6636029411764706
384,598,소름/Noun,540,437,103,0.004857390569770802,0.0011440122620343426,0.8092592592592592
385,599,글/Noun,538,195,343,0.002167485494520152,0.0038096719017260148,0.6375464684014871
386,600,않다/Verb,537,191,346,0.0021230242536069183,0.0038429926472221604,0.6443202979515829
387,601,식/Suffix,534,210,324,0.002334215147944779,0.003598640513583757,0.6067415730337079
388,602,재미없음/Adjective,533,9,524,0.00010003779205477625,0.005820023546660151,0.9831144465290806
389,603,걸작/Noun,533,459,74,0.005101927394793589,0.0008219117222382655,0.8611632270168855
390,604,그나마/Adverb,532,40,492,0.0004446124091323389,0.005464602261367928,0.924812030075188
391,605,본다/Verb,529,198,331,0.002200831425205077,0.003676388919741431,0.6257088846880907
392,606,억지/Noun,527,72,455,0.00080030233643821,0.005053646400248795,0.8633776091081594
393,607,대체/Noun,527,89,438,0.000989262610319454,0.004864828842437301,0.8311195445920304
394,609,마세요/Verb,526,73,453,0.0008114176466665183,0.005031432569918031,0.8612167300380228
395,610,시절/Noun,526,397,129,0.004412778160638464,0.0014327920563342734,0.7547528517110266
396,612,존나/Noun,525,122,403,0.0013560678478536335,0.004476086811648933,0.7676190476190476
397,613,약간/Noun,525,357,168,0.003968165751506125,0.0018659617477841703,0.68
398,614,역사/Noun,525,318,207,0.0035346686526020947,0.0022991314392340674,0.6057142857142858
399,615,분들/Suffix,524,307,217,0.003412400240090701,0.002410200590887887,0.5858778625954199
400,619,아님/Adjective,522,147,375,0.0016339506035613453,0.0041650931870182385,0.7183908045977011
401,620,실화/Noun,522,331,191,0.003679167685570104,0.0021214207965879555,0.6340996168582376
402,624,해도/Noun,520,170,350,0.0018896027388124407,0.003887420307883689,0.6730769230769231
403,625,봤음/Verb,519,357,162,0.003968165751506125,0.0017993202567918784,0.6878612716763006
404,626,이었다/Verb,518,357,161,0.003968165751506125,0.001788213341626497,0.6891891891891891
405,627,아무/Modifier,518,169,349,0.001878487428584132,0.0038763133927183055,0.6737451737451737
406,630,B/Alpha,514,133,381,0.0014783362603650269,0.00423173467801053,0.7412451361867705
407,631,한마디/Noun,514,156,358,0.0017339883956161216,0.003976275629206745,0.6964980544747081
408,634,휴/Exclamation,506,86,420,0.0009559166796345287,0.004664904369460426,0.8300395256916996
409,635,자기/Noun,506,160,346,0.0017784496365293556,0.0038429926472221604,0.6837944664031621
410,636,하기/Verb,506,196,310,0.0021786008047484607,0.0034431437012684093,0.6126482213438735
411,637,없네/Adjective,504,70,434,0.000778071715981593,0.004820401181775774,0.8611111111111112
412,638,누가/Noun,504,180,324,0.002000755841095525,0.003598640513583757,0.6428571428571429
413,639,급/Suffix,504,211,293,0.002345330458173088,0.003254326143456916,0.5813492063492064
414,641,없어/Adjective,503,126,377,0.0014005290887668675,0.004187307017349001,0.7495029821073559
415,646,만점/Noun,501,423,78,0.004701776226574484,0.0008663393828997934,0.844311377245509
416,647,초딩/Noun,501,192,309,0.0021341395638352265,0.003432036786103028,0.6167664670658682
417,652,간만/Noun,496,400,96,0.004446124091323389,0.0010662638558766688,0.8064516129032258
418,656,없었다/Adjective,490,186,304,0.0020674477024653763,0.003376502210276118,0.6204081632653061
419,657,자/Noun,489,199,290,0.002211946735433386,0.00322100539796077,0.5930470347648262
420,658,라도/Josa,488,145,343,0.0016117199831047284,0.0038096719017260148,0.7028688524590164
421,659,~!/Punctuation,487,385,102,0.004279394437898762,0.0011329053468689607,0.7905544147843943
422,660,CG/Alpha,487,126,361,0.0014005290887668675,0.00400959637470289,0.7412731006160165
423,661,재밌네요/Adjective,486,466,20,0.005179734566391748,0.00022213830330763932,0.9588477366255144
424,662,전체/Noun,486,158,328,0.0017562190160727387,0.003643068174245285,0.6748971193415638
425,664,아까/Adjective,484,11,473,0.00012226841251139318,0.005253570873225671,0.9772727272727272
426,665,같음/Adjective,483,193,290,0.002145254874063535,0.00322100539796077,0.6004140786749482
427,666,뿐/Suffix,482,150,332,0.0016672965342462707,0.0036874958349068132,0.6887966804979253
428,667,감성/Noun,482,311,171,0.0034568614810039353,0.0018992824932803163,0.6452282157676349
429,668,다음/Noun,482,299,183,0.0033234777582642327,0.0020325654752649,0.6203319502074689
430,669,사회/Noun,481,337,144,0.0037458595469399545,0.0015993957838150033,0.7006237006237006
431,670,오/Modifier,481,187,294,0.0020785630126936845,0.0032654330586222983,0.6112266112266113
432,671,네이버/Noun,480,179,301,0.0019896405308672165,0.003343181464779972,0.6270833333333333
433,673,발연기/Noun,477,34,443,0.0003779205477624881,0.004920363418264211,0.9287211740041929
434,674,무슨/Modifier,476,124,352,0.0013782984683102506,0.003909634138214452,0.7394957983193278
435,675,그런/Modifier,475,189,286,0.002100793633150301,0.0031765777372992424,0.6021052631578947
436,676,ㅜ/KoreanParticle,474,275,199,0.00305671031278483,0.0022102761179110114,0.5801687763713079
437,677,였습니다/Verb,472,394,78,0.004379432229953538,0.0008663393828997934,0.8347457627118644
438,682,ㅉㅉ/KoreanParticle,466,72,394,0.00080030233643821,0.004376124575160495,0.8454935622317596
439,683,없어서/Adjective,466,135,331,0.0015005668808216438,0.003676388919741431,0.7103004291845494
440,685,꿈/Noun,465,353,112,0.003923704510592891,0.0012439744985227805,0.7591397849462366
441,686,재미있어요/Adjective,464,452,12,0.005024120223195429,0.0001332829819845836,0.9741379310344828
442,687,주제/Noun,463,191,272,0.0021230242536069183,0.003021080924983895,0.5874730021598272
443,689,에요/Josa,461,357,104,0.003968165751506125,0.0011551191771997243,0.7744034707158352
444,690,나이/Noun,460,314,146,0.00349020741168886,0.0016216096141457672,0.6826086956521739
445,692,어렸을/Verb,459,394,65,0.004379432229953538,0.0007219494857498278,0.8583877995642701
446,694,이/Foreign,458,326,132,0.003623591134428562,0.0014661128018304194,0.7117903930131004
447,695,하네요/Verb,458,296,162,0.003290131827579308,0.0017993202567918784,0.6462882096069869
448,697,;;;/Punctuation,457,106,351,0.001178222884200698,0.0038985272230490703,0.7680525164113785
449,698,교훈/Noun,454,274,180,0.0030455950025565213,0.001999244729768754,0.6035242290748899
450,700,좋은데/Adjective,453,172,281,0.0019118333592690567,0.0031210431614723325,0.6203090507726269
451,703,소설/Noun,449,173,276,0.0019229486694973656,0.003065508585645423,0.6146993318485523
452,705,이라도/Josa,446,106,340,0.001178222884200698,0.0037763511562298687,0.7623318385650224
453,706,힘/Noun,443,266,177,0.0029566725207300537,0.001965923984272608,0.6004514672686229
454,708,시즌/Noun,442,315,127,0.003501322721917169,0.0014105782260035095,0.7126696832579186
455,709,낸/Verb,442,299,143,0.0033234777582642327,0.0015882888686496212,0.6764705882352942
456,711,너/Noun,438,183,255,0.0020341017717804503,0.0028322633671724017,0.5821917808219178
457,712,어설픈/Adjective,437,36,401,0.000400151168219105,0.0044538729813181676,0.9176201372997712
458,715,방송/Noun,436,131,305,0.0014561056399084098,0.0033876091254415,0.6995412844036697
459,716,상당히/Adjective,436,259,177,0.0028788653491318944,0.001965923984272608,0.5940366972477065
460,718,모든/Modifier,434,259,175,0.0028788653491318944,0.0019437101539418445,0.5967741935483871
461,719,존재/Noun,434,257,177,0.002856634728675277,0.001965923984272608,0.5921658986175116
462,721,삼류/Noun,433,33,400,0.00036680523753417966,0.004442766066152787,0.9237875288683602
463,722,잔잔한/Adjective,432,371,61,0.004123780094702443,0.0006775218250882999,0.8587962962962963
464,723,몇번/Noun,431,334,97,0.00371251361625503,0.0010773707710420508,0.7749419953596288
465,724,보여주는/Verb,431,260,171,0.002889980659360202,0.0018992824932803163,0.6032482598607889
466,726,죽/Noun,428,138,290,0.0015339128115065689,0.00322100539796077,0.677570093457944
467,727,....../Punctuation,427,155,272,0.0017228730853878133,0.003021080924983895,0.6370023419203747
468,728,있지만/Adjective,427,271,156,0.003012249071871596,0.0017326787657995868,0.6346604215456675
469,730,+/Punctuation,426,174,252,0.0019340639797256738,0.002798942621676256,0.5915492957746479
470,732,여주/Noun,424,130,294,0.001444990329680101,0.0032654330586222983,0.6933962264150944
471,733,진정한/Adjective,423,309,114,0.003434630860547318,0.001266188328853544,0.7304964539007093
472,735,질질/Noun,419,72,347,0.00080030233643821,0.003854099562387543,0.8281622911694511
473,736,미친/Adjective,419,132,287,0.0014672209501367186,0.0031876846524646245,0.684964200477327
474,737,지/Verb,418,120,298,0.0013338372273970164,0.003309860719283826,0.7129186602870813
475,738,전부/Noun,418,133,285,0.0014783362603650269,0.003165470822133861,0.6818181818181818
476,739,바/Noun,418,165,253,0.0018340261876708976,0.0028100495368416373,0.6052631578947368
477,740,줄거리/Noun,417,136,281,0.0015116821910499524,0.0031210431614723325,0.6738609112709832
478,742,되고/Verb,416,243,173,0.002701020385478959,0.0019214963236110802,0.5841346153846154
479,745,점주/Noun,415,98,317,0.0010893004023742304,0.0035208921074260835,0.763855421686747
480,746,실제/Noun,415,250,165,0.002778827557077118,0.0018326410022880247,0.6024096385542169
481,747,답/Noun,413,100,313,0.0011115310228308473,0.0034764644467645558,0.7578692493946732
482,748,재미있다/Adjective,412,357,55,0.003968165751506125,0.0006108803340960082,0.866504854368932
483,749,되어/Verb,411,249,162,0.002767712246848809,0.0017993202567918784,0.6058394160583942
484,751,좋아/Adjective,409,337,72,0.0037458595469399545,0.0007996978919075017,0.8239608801955991
485,753,낭비/Noun,408,8,400,8.892248182646779e-05,0.004442766066152787,0.9803921568627452
486,754,굉장히/Adjective,408,277,131,0.003078940933241447,0.0014550058866650375,0.678921568627451
487,755,버린/Verb,408,133,275,0.0014783362603650269,0.003054401670480041,0.6740196078431373
488,756,으로도/Josa,408,240,168,0.002667674454794033,0.0018659617477841703,0.5882352941176471
489,758,각본/Noun,407,121,286,0.001344952537625325,0.0031765777372992424,0.7027027027027027
490,760,같네요/Adjective,406,244,162,0.002712135695707267,0.0017993202567918784,0.6009852216748769
491,761,먹/Verb,402,321,81,0.0035680145832870194,0.0008996601283959392,0.7985074626865671
492,762,재/Noun,401,255,146,0.002834404108218661,0.0016216096141457672,0.6359102244389028
493,765,성룡/Noun,398,235,163,0.002612097903652491,0.001810427171957261,0.5904522613065326
494,767,순간/Noun,397,263,134,0.002923326590045128,0.0014883266321611835,0.6624685138539043
495,768,어른/Noun,397,249,148,0.002767712246848809,0.001643823444476531,0.6272040302267002
496,769,평론가/Noun,397,239,158,0.002656559144565725,0.0017548925961303507,0.6020151133501259
497,770,갑자기/Noun,396,103,293,0.0011448769535157724,0.003254326143456916,0.73989898989899
498,771,제작/Noun,396,143,253,0.0015894893626481115,0.0028100495368416373,0.6388888888888888
499,773,이하/Noun,395,34,361,0.0003779205477624881,0.00400959637470289,0.9139240506329114
500,776,쳐/Verb,393,97,296,0.0010781850921459217,0.003287646888953062,0.7531806615776081
501,778,간다/Noun,392,151,241,0.0016784118444745793,0.002676766554857054,0.6147959183673469
502,779,하며/Verb,391,248,143,0.0027565969366205013,0.0015882888686496212,0.6342710997442456
503,780,의도/Noun,390,66,324,0.0007336104750683593,0.003598640513583757,0.8307692307692308
504,781,발/Noun,390,81,309,0.0009003401284929863,0.003432036786103028,0.7923076923076923
505,782,영/Noun,390,107,283,0.0011893381944290064,0.0031432569918030968,0.7256410256410256
506,784,나온다/Verb,389,112,277,0.0012449147455705488,0.003076615500810805,0.7120822622107971
507,787,밑/Noun,388,119,269,0.0013227219171687082,0.0029877601794877488,0.6932989690721649
508,788,TV/Alpha,388,158,230,0.0017562190160727387,0.002554590488037853,0.5927835051546392
509,789,재미있는/Adjective,387,327,60,0.003634706444656871,0.000666414909922918,0.8449612403100775
510,790,땜/Noun,387,126,261,0.0014005290887668675,0.002898904858164693,0.6744186046511628
511,792,해주는/Verb,386,304,82,0.003379054309405776,0.0009107670435613213,0.7875647668393783
512,793,하네/Verb,385,114,271,0.0012671453660271655,0.003009974009818513,0.7038961038961039
513,794,아버지/Noun,385,261,124,0.0029010959695885113,0.0013772574805073642,0.6779220779220779
514,798,비해/Verb,384,123,261,0.001367183158081942,0.002898904858164693,0.6796875
515,799,한편/Noun,384,232,152,0.0025787519729675657,0.001688251105138059,0.6041666666666666
516,800,피/Noun,384,156,228,0.0017339883956161216,0.0025323766577070887,0.59375
517,802,봤네요/Verb,381,343,38,0.003812551408309806,0.0004220627762845148,0.9002624671916011
518,803,재밌는데/Adjective,381,339,42,0.003768090167396572,0.00046649043694604257,0.8897637795275591
519,804,좋음/Adjective,381,311,70,0.0034568614810039353,0.0007774840615767378,0.8162729658792651
520,806,볼때/Noun,380,276,104,0.0030678256230131378,0.0011551191771997243,0.7263157894736842
521,807,되지/Verb,378,150,228,0.0016672965342462707,0.0025323766577070887,0.6031746031746031
522,809,있어서/Adjective,377,285,92,0.0031678634150679144,0.0010218361952151409,0.7559681697612732
523,812,10년/Number,376,276,100,0.0030678256230131378,0.0011106915165381968,0.7340425531914894
524,813,는데/Verb,376,226,150,0.0025120601115977146,0.001666037274807295,0.6010638297872339
525,814,세계/Noun,376,224,152,0.0024898294911410977,0.001688251105138059,0.5957446808510638
526,815,있을까/Adjective,375,249,126,0.002767712246848809,0.0013994713108381278,0.664
527,817,훌륭한/Adjective,374,295,79,0.0032790165173509998,0.0008774462980651753,0.7887700534759359
528,818,첨/Adverb,374,111,263,0.0012337994353422404,0.002921118688495457,0.7032085561497327
529,819,봐야/Verb,374,262,112,0.0029122112798168195,0.0012439744985227805,0.7005347593582888
530,820,막/Noun,373,133,240,0.0014783362603650269,0.002665659639691672,0.6434316353887399
531,823,모르고/Verb,372,277,95,0.003078940933241447,0.0010551569407112867,0.7446236559139785
532,825,좋네요/Adjective,371,346,25,0.003845897338994731,0.0002776728791345492,0.9326145552560648
533,826,슬픈/Adjective,371,315,56,0.003501322721917169,0.0006219872492613901,0.8490566037735849
534,827,그때/Noun,371,269,102,0.002990018451414979,0.0011329053468689607,0.7250673854447439
535,828,항상/Noun,371,247,124,0.002745481626392193,0.0013772574805073642,0.6657681940700808
536,829,좀비/Noun,370,127,243,0.001411644398995176,0.002698980385187818,0.6567567567567567
537,831,치고/Josa,368,112,256,0.0012449147455705488,0.002843370282337784,0.6956521739130435
538,833,뻔/Noun,367,98,269,0.0010893004023742304,0.0029877601794877488,0.7329700272479565
539,836,거지/Noun,366,99,267,0.0011004157126025386,0.0029655463491569853,0.7295081967213115
540,837,곳/Noun,365,245,120,0.002723251005935576,0.001332829819845836,0.6712328767123288
541,841,없네요/Adjective,362,111,251,0.0012337994353422404,0.002787835706510873,0.6933701657458563
542,843,짱/Suffix,361,320,41,0.003556899273058711,0.00045538352178066063,0.8864265927977839
543,844,성/Modifier,361,130,231,0.001444990329680101,0.0025656974032032343,0.6398891966759003
544,845,진행/Noun,360,97,263,0.0010781850921459217,0.002921118688495457,0.7305555555555555
545,849,이에요/Josa,358,286,72,0.003178978725296223,0.0007996978919075017,0.7988826815642458
546,850,더욱/Noun,358,281,77,0.0031234021741546806,0.0008552324677344116,0.7849162011173184
547,851,tv/Alpha,358,103,255,0.0011448769535157724,0.0028322633671724017,0.7122905027932961
548,852,낫다/Noun,358,124,234,0.0013782984683102506,0.0025990181486993803,0.6536312849162011
549,853,초/Noun,357,148,209,0.0016450659137896538,0.002321345269564831,0.5854341736694678
550,855,더럽게/Adjective,356,17,339,0.00018896027388124405,0.0037652442410644866,0.952247191011236
551,856,어이/Noun,355,29,326,0.0003223439966209457,0.003620854343914521,0.9183098591549296
552,857,상미/Noun,355,237,118,0.0026343285241091077,0.001310615989515072,0.6676056338028169
553,858,래/Josa,355,138,217,0.0015339128115065689,0.002410200590887887,0.6112676056338028
554,859,참고/Noun,354,65,289,0.0007224951648400508,0.003209898482795389,0.8163841807909604
555,860,중국/Noun,354,122,232,0.0013560678478536335,0.0025768043183686164,0.655367231638418
556,861,완성/Noun,354,212,142,0.002356445768401396,0.0015771819534842392,0.5988700564971752
557,863,몇/Noun,353,222,131,0.0024675988706844808,0.0014550058866650375,0.6288951841359773
558,864,그녀/Noun,352,266,86,0.0029566725207300537,0.0009551947042228492,0.7556818181818182
559,869,대단한/Adjective,348,246,102,0.002734366316163884,0.0011329053468689607,0.7068965517241379
560,870,거기/Noun,348,120,228,0.0013338372273970164,0.0025323766577070887,0.6551724137931034
561,871,깊은/Adjective,347,303,44,0.0033679389991774673,0.0004887042672768067,0.8731988472622478
562,872,점점/Noun,347,138,209,0.0015339128115065689,0.002321345269564831,0.6023054755043228
563,873,굳/Adjective,346,330,16,0.003668052375341796,0.00017771064264611146,0.9537572254335259
564,875,이냐/Josa,345,47,298,0.0005224195807304982,0.003309860719283826,0.8637681159420291
565,877,재미없는/Adjective,344,18,326,0.0002000755841095525,0.003620854343914521,0.9476744186046512
566,878,보는게/Verb,344,55,289,0.000611342062556966,0.003209898482795389,0.8401162790697675
567,879,짜리/Verb,344,134,210,0.001489451570593335,0.002332452184730213,0.6104651162790697
568,880,아까워/Adjective,343,16,327,0.00017784496365293558,0.0036319612590799033,0.9533527696793004
569,881,충분히/Adjective,343,272,71,0.003023364382099905,0.0007885909767421196,0.793002915451895
570,882,어디서/Adverb,343,123,220,0.001367183158081942,0.0024435213363840328,0.641399416909621
571,885,술/Noun,342,58,284,0.0006446879932418914,0.0031543639069684785,0.8304093567251462
572,886,전형/Noun,342,64,278,0.0007113798546117423,0.0030877224159761873,0.8128654970760234
573,887,좋겠다/Adjective,342,240,102,0.002667674454794033,0.0011329053468689607,0.7017543859649122
574,888,따뜻한/Adjective,340,312,28,0.003467976791232243,0.000310993624630695,0.9176470588235294
575,889,편집/Noun,340,103,237,0.0011448769535157724,0.0026323388941955268,0.6970588235294117
576,891,잠/Noun,339,82,257,0.0009114554387212947,0.0028544771975031647,0.7581120943952803
577,892,나옴/Verb,339,83,256,0.0009225707489496033,0.002843370282337784,0.7551622418879056
578,895,해준/Verb,337,275,62,0.00305671031278483,0.0006886287402536821,0.8160237388724035
579,896,하는게/Verb,337,103,234,0.0011448769535157724,0.0025990181486993803,0.6943620178041543
580,897,사건/Noun,337,130,207,0.001444990329680101,0.0022991314392340674,0.6142433234421365
581,898,쯤/Suffix,336,199,137,0.002211946735433386,0.0015216473776573296,0.5922619047619048
582,899,였어요/Verb,335,281,54,0.0031234021741546806,0.0005997734189306263,0.8388059701492537
583,900,화보/Noun,335,124,211,0.0013782984683102506,0.002343559099895595,0.6298507462686567
584,901,화이팅/Noun,334,296,38,0.003290131827579308,0.0004220627762845148,0.8862275449101796
585,905,새로운/Adjective,332,247,85,0.002745481626392193,0.0009440877890574672,0.7439759036144579
586,906,안된다/Adjective,331,76,255,0.0008447635773514439,0.0028322633671724017,0.770392749244713
587,907,꿀잼/Noun,330,316,14,0.003512438032145477,0.0001554968123153475,0.9575757575757576
588,908,똥/Noun,330,29,301,0.0003223439966209457,0.003343181464779972,0.912121212121212
589,909,그게/Noun,330,91,239,0.001011493230776071,0.0026545527245262907,0.7242424242424242
590,912,중반/Noun,328,125,203,0.001389413778538559,0.002254703778572539,0.6189024390243902
591,913,취향/Noun,328,127,201,0.001411644398995176,0.0022324899482417753,0.6128048780487805
592,916,-_-/Punctuation,327,38,289,0.000422381788675722,0.003209898482795389,0.8837920489296636
593,917,개그/Noun,327,99,228,0.0011004157126025386,0.0025323766577070887,0.6972477064220184
594,921,엉망/Noun,326,22,304,0.00024453682502278637,0.003376502210276118,0.9325153374233128
595,922,병맛/Noun,326,57,269,0.0006335726830135829,0.0029877601794877488,0.8251533742331288
596,923,티/Noun,325,91,234,0.001011493230776071,0.0025990181486993803,0.72
597,924,복수/Noun,325,128,197,0.0014227597092234846,0.0021880622875802475,0.6061538461538462
598,928,관/Noun,324,221,103,0.0024564835604561725,0.0011440122620343426,0.6820987654320988
599,929,ㄷㄷ/KoreanParticle,324,200,124,0.0022230620456616945,0.0013772574805073642,0.6172839506172839
600,930,액션영화/Noun,324,192,132,0.0021341395638352265,0.0014661128018304194,0.5925925925925926
601,933,미화/Noun,323,44,279,0.0004890736500455726,0.003098829331141569,0.8637770897832817
602,934,~!!/Punctuation,323,253,70,0.0028121734877620433,0.0007774840615767378,0.7832817337461301
603,935,아닌가/Adjective,323,112,211,0.0012449147455705488,0.002343559099895595,0.6532507739938079
604,936,흥미/Noun,323,125,198,0.001389413778538559,0.0021991692027456293,0.6130030959752322
605,937,//Punctuation,323,130,193,0.001444990329680101,0.00214363462691872,0.5975232198142415
606,940,몸/Noun,322,132,190,0.0014672209501367186,0.0021103138814225733,0.5900621118012422
607,944,흥미진진/Noun,321,276,45,0.0030678256230131378,0.0004998111824421885,0.8598130841121495
608,947,있게/Adjective,320,243,77,0.002701020385478959,0.0008552324677344116,0.759375
609,948,알았다/Verb,320,94,226,0.0010448391614609964,0.002510162827376325,0.70625
610,950,여서/Josa,319,132,187,0.0014672209501367186,0.002076993135926428,0.5862068965517241
611,951,잘만/Noun,318,239,79,0.002656559144565725,0.0008774462980651753,0.7515723270440252
612,952,좋았어요/Adjective,317,311,6,0.0034568614810039353,6.66414909922918e-05,0.9810725552050472
613,953,에겐/Josa,317,194,123,0.0021563701842918434,0.001366150565341982,0.61198738170347
614,954,노력/Noun,317,132,185,0.0014672209501367186,0.002054779305595664,0.583596214511041
615,955,재밌었다/Adjective,316,296,20,0.003290131827579308,0.00022213830330763932,0.9367088607594936
616,956,만으로도/Josa,316,285,31,0.0031678634150679144,0.00034431437012684104,0.9018987341772152
617,957,학교/Noun,316,192,124,0.0021341395638352265,0.0013772574805073642,0.6075949367088608
618,958,괜히/Adverb,315,80,235,0.0008892248182646778,0.002610125063864762,0.7460317460317459
619,959,또한/Noun,315,208,107,0.002311984527488162,0.0011884399226958706,0.6603174603174603
620,960,엄청난/Adjective,315,207,108,0.002300869217259854,0.0011995468378612525,0.6571428571428571
621,961,과거/Noun,315,196,119,0.0021786008047484607,0.0013217229046804538,0.6222222222222222
622,964,그래픽/Noun,314,78,236,0.0008669941978080608,0.002621231979030144,0.7515923566878981
623,965,ost/Alpha,313,265,48,0.002945557210501745,0.0005331319279383344,0.8466453674121406
624,966,기대하고/Adjective,313,53,260,0.000589111442100349,0.002887797942999312,0.8306709265175719
625,967,그냥/Modifier,313,87,226,0.0009670319898628369,0.002510162827376325,0.7220447284345048
626,968,이라니/Josa,313,116,197,0.0012893759864837828,0.0021880622875802475,0.6293929712460063
627,969,무/Noun,313,127,186,0.001411644398995176,0.002065886220761046,0.5942492012779552
628,970,그만/Adverb,312,21,291,0.00023342151479447792,0.0032321123131261523,0.9326923076923076
629,971,장/Suffix,312,89,223,0.000989262610319454,0.002476842081880179,0.7147435897435898
630,972,20/Number,312,211,101,0.002345330458173088,0.0011217984317035787,0.6762820512820513
631,973,바보/Noun,311,85,226,0.0009448013694062199,0.002510162827376325,0.7266881028938906
632,974,성우/Noun,310,70,240,0.000778071715981593,0.002665659639691672,0.7741935483870968
633,975,헐/Verb,309,87,222,0.0009670319898628369,0.002465735166714797,0.7184466019417476
634,976,봣/Noun,308,207,101,0.002300869217259854,0.0011217984317035787,0.6720779220779219
635,977,나오고/Verb,307,81,226,0.0009003401284929863,0.002510162827376325,0.7361563517915309
636,978,죽음/Noun,307,206,101,0.0022897539070315448,0.0011217984317035787,0.6710097719869706
637,979,대한민국/Noun,307,185,122,0.002056332392237067,0.0013550436501765998,0.6026058631921825
638,981,유치/Noun,306,21,285,0.00023342151479447792,0.003165470822133861,0.931372549019608
639,982,나쁜/Adjective,306,100,206,0.0011115310228308473,0.002288024524068685,0.673202614379085
640,983,해도/Verb,306,100,206,0.0011115310228308473,0.002288024524068685,0.673202614379085
641,985,도저히/Noun,305,26,279,0.00028899806593602026,0.003098829331141569,0.9147540983606556
642,986,식/Noun,305,72,233,0.00080030233643821,0.002587911233533998,0.7639344262295082
643,987,속편/Noun,305,99,206,0.0011004157126025386,0.002288024524068685,0.6754098360655738
644,991,울/Noun,304,228,76,0.0025342907320543315,0.0008441255525690295,0.75
645,992,무조건/Noun,304,193,111,0.002145254874063535,0.0012328675833573985,0.6348684210526315
646,993,야할/Adjective,303,233,70,0.002589867283195874,0.0007774840615767378,0.768976897689769
647,994,전달/Noun,303,115,188,0.0012782606762554744,0.0020881000510918103,0.6204620462046204
648,995,땐/Noun,303,183,120,0.0020341017717804503,0.001332829819845836,0.6039603960396039
649,998,하는지/Verb,302,93,209,0.0010337238512326881,0.002321345269564831,0.6920529801324503
650,999,않음/Verb,302,97,205,0.0010781850921459217,0.002276917608903303,0.6788079470198676
651,1001,안됨/Adjective,301,50,251,0.0005557655114154236,0.002787835706510873,0.8338870431893688
652,1002,천재/Noun,301,236,65,0.0026232132138807995,0.0007219494857498278,0.7840531561461794
653,1004,억지로/Noun,300,42,258,0.00046684302958895584,0.002865584112668547,0.86
654,1005,우연히/Adverb,300,258,42,0.0028677500389035857,0.00046649043694604257,0.86
655,1006,같습니다/Adjective,300,233,67,0.002589867283195874,0.0007441633160805918,0.7766666666666666
656,1007,심리/Noun,300,207,93,0.002300869217259854,0.001032943110380523,0.69
