,Unnamed: 0,parameter,counts,counts_H,counts_NH,p_from_H,p_from_NH,priority
0,0,./Punctuation,52431,26334,26097,0.2927105795522753,0.2898571650709732,0.5022601132917549
1,1,영화/Noun,50383,25791,24592,0.2866749660983038,0.2731412577470733,0.5118988547724431
2,2,이/Josa,38256,20012,18244,0.22243958828890914,0.2026345602772286,0.5231074864073609
3,3,보다/Verb,38094,21677,16417,0.24094657981904274,0.18234222627007574,0.5690397437916732
4,4,하다/Verb,38002,18125,19877,0.20146499788809105,0.22077215274229736,0.5230514183464028
5,5,의/Josa,29457,17487,11970,0.19437342996243026,0.13294977452962214,0.593644974029942
6,6,가/Josa,27737,12332,15405,0.13707400573550008,0.1711020281227092,0.5553953203302447
7,7,에/Josa,27391,14054,13337,0.15621456994864727,0.1481329275606993,0.5130882406629915
8,8,../Punctuation,25849,11706,14143,0.13011582153257895,0.15708510118399716,0.547139154319316
9,9,을/Josa,23027,12500,10527,0.1389413778538559,0.11692249594597595,0.5428410127241934
10,10,.../Punctuation,22073,9139,12934,0.10158282017651113,0.14365684074905036,0.5859647533185339
11,11,은/Josa,19690,7739,11951,0.08602138585687928,0.13273874314147988,0.6069578466226511
12,12,도/Josa,18990,7903,11087,0.08784429673432186,0.12314236843858985,0.5838335966298052
13,13,들/Suffix,18507,8922,9585,0.09917079785696817,0.10645978186018616,0.5179121413519209
14,14,는/Josa,18035,7669,10366,0.08524331414089767,0.11513428260434945,0.5747712780704186
15,15,없다/Adjective,16914,5001,11913,0.05558766645177067,0.13231668036519534,0.7043277758070238
16,16,를/Josa,16639,8276,8363,0.09199030744948092,0.0928871315280894,0.5026143398040748
17,17,",/Punctuation",14719,7561,7158,0.08404286063624036,0.07950329875380413,0.513689788708472
18,18,있다/Adjective,13419,8187,5232,0.09100104483916148,0.05811138014527845,0.6101050748938073
19,19,좋다/Adjective,13043,9370,3673,0.10415045683925038,0.04079569940244796,0.7183930077436173
20,20,이/Determiner,12373,4495,7878,0.04996331947624658,0.08750027767287913,0.6367089630647378
21,21,너무/Adverb,11905,6629,5276,0.07368339150345686,0.058600084412555264,0.55682486350273
22,22,재밌다/Adjective,11789,9955,1834,0.11065291332281084,0.02037008241331053,0.8444312494698448
23,23,?/Punctuation,11319,3302,8017,0.036702754373874574,0.08904413888086722,0.7082781164413817
24,24,정말/Noun,10702,7082,3620,0.0787186270368806,0.04020703289868272,0.6617454681367969
25,25,것/Noun,10293,4088,6205,0.045439388213325035,0.06891840860119511,0.6028368794326241
26,26,되다/Verb,9887,5453,4434,0.0606117866749661,0.04924806184330364,0.5515323151613231
27,27,같다/Adjective,9325,4691,4634,0.052141920280995034,0.051469444876380034,0.5030563002680966
28,28,진짜/Noun,9220,4526,4694,0.05030789409332415,0.05213585978630295,0.5091106290672451
29,29,이/Noun,9081,4359,4722,0.04845163728519663,0.05244685341093365,0.5199867855963
30,30,적/Suffix,9003,5486,3517,0.060978591912500275,0.039063020636648384,0.6093524380761969
31,31,으로/Josa,8921,4168,4753,0.04632861303158972,0.05279116778106049,0.5327878040578411
32,32,아니다/Adjective,8754,3210,5544,0.035680145832870186,0.06157673767687762,0.6333104866346813
33,33,않다/Verb,8640,4350,4290,0.048351599493141856,0.047648666059488635,0.5034722222222222
34,34,!/Punctuation,8565,6415,2150,0.07130471511459885,0.023879867605571228,0.7489784004670169
35,35,로/Josa,7951,3351,4600,0.03724740457506169,0.05109180976075705,0.5785435794239718
36,36,에서/Josa,7910,4218,3692,0.04688437854300514,0.041006730790590216,0.5332490518331227
37,37,점/Noun,7843,3227,4616,0.03586910610675144,0.051269520403403164,0.5885502996302435
38,38,만/Josa,7745,2412,5333,0.026810128270680036,0.05923317857698202,0.6885732730794061
39,39,나오다/Verb,7213,2894,4319,0.03216770780072472,0.04797076659928472,0.5987799805906003
40,40,만들다/Verb,7199,2506,4693,0.027854967432141036,0.05212475287113757,0.6518960966800944
41,41,연기/Noun,7089,4106,2983,0.04563946379743459,0.033131927938334416,0.5792072224573283
42,42,평점/Noun,7068,2994,4074,0.03327923882355557,0.04524957238376613,0.5764006791171478
43,43,과/Josa,6768,4231,2537,0.04702887757597315,0.02817824377457405,0.6251477541371159
44,44,최고/Noun,6671,6143,528,0.06828135073249894,0.005864451207321679,0.9208514465597362
45,45,한/Josa,6635,3102,3533,0.03447969232821288,0.039240731279294484,0.5324792765636774
46,46,이다/Verb,6524,4043,2481,0.04493919925305116,0.02755625652531266,0.6197118332311465
47,47,왜/Noun,6247,2241,4006,0.024909410221639287,0.04449430215252016,0.6412678085481031
48,48,스토리/Noun,6075,2176,3899,0.02418691505679924,0.043305862229824285,0.6418106995884774
49,49,인/Josa,6018,3216,2802,0.035746837694240044,0.031121576293400267,0.5343968095712861
50,50,생각/Noun,6005,3771,2234,0.04191583487095125,0.024812848479463315,0.6279766860949209
51,51,~/Punctuation,6003,4016,1987,0.04463908587688682,0.02206944043361397,0.6689988339163752
52,52,다/Josa,5815,2885,2930,0.03206767000866994,0.03254326143456916,0.5038693035253654
53,53,다/Adverb,5790,2454,3336,0.02727697130026899,0.037052668991714235,0.5761658031088083
54,54,이다/Josa,5692,2965,2727,0.03295689482693462,0.030288557655996626,0.5209065354884048
55,55,감동/Noun,5597,4442,1155,0.04937420803414623,0.012828487016016172,0.7936394497051992
56,56,..../Punctuation,5580,2218,3362,0.02465375808638819,0.03734144878601417,0.6025089605734767
57,57,1/Number,5284,1409,3875,0.015661472111686642,0.04303929626585512,0.7333459500378501
58,58,사람/Noun,5259,2583,2676,0.028710846319720783,0.029722104982562145,0.5088419851682829
59,59,이렇다/Adjective,5240,2243,2997,0.0249316408420959,0.033287424750649754,0.5719465648854962
60,60,보고/Noun,5209,3038,2171,0.03376831247360114,0.02411311282404425,0.5832213476674986
61,61,말/Noun,5179,2468,2711,0.027432585643465308,0.03011084701335051,0.5234601274377293
62,62,아깝다/Adjective,5167,374,4793,0.004157126025387369,0.053235444387675766,0.9276175730598026
63,63,더/Noun,5026,2595,2431,0.02884423004246048,0.02700091076704356,0.5163151611619579
64,64,드라마/Noun,5005,3017,1988,0.033534890958806664,0.02208054734877935,0.6027972027972028
65,65,내/Noun,4988,2441,2547,0.02713247226730098,0.02828931292622787,0.510625501202887
66,66,때/Noun,4940,3220,1720,0.03579129893515328,0.019103894084456983,0.6518218623481782
67,67,배우/Noun,4882,2357,2525,0.02619878620812307,0.02804496079258947,0.5172060630888979
68,68,ㅋㅋㅋ/KoreanParticle,4833,2528,2305,0.02809950425716382,0.025601439456205438,0.5230705565901097
69,69,재미있다/Adjective,4787,4102,685,0.04559500255652135,0.0076082368882866465,0.8569041153123041
70,70,거/Noun,4783,1959,2824,0.021774892737256298,0.03136592842703868,0.5904244198201966
71,71,와/Josa,4779,2774,2005,0.0308338705733277,0.022269364906590844,0.5804561623770663
72,72,감독/Noun,4688,1515,3173,0.016839694995887337,0.03524224181975698,0.6768344709897611
73,73,ㅋㅋ/KoreanParticle,4594,2777,1817,0.030867216504012626,0.020181264855499037,0.6044841097083152
74,74,재미/Noun,4538,1752,2786,0.019474023519996442,0.030943865650754163,0.6139268400176289
75,75,내용/Noun,4529,1407,3122,0.01563924149123002,0.0346757891463225,0.6893353941267388
76,76,뭐/Noun,4491,831,3660,0.009236822799724341,0.040651309505298,0.8149632598530394
77,77,못/VerbPrefix,4418,1474,2944,0.016383967276526686,0.032698758246884514,0.666364870982345
78,78,그냥/Noun,4406,1187,3219,0.013193873241002156,0.03575315991736455,0.7305946436677259
79,79,고/Josa,4377,1761,2616,0.01957406131205122,0.029055690072639227,0.5976696367374914
80,80,까지/Josa,4353,2076,2277,0.023075384033968388,0.025290445831574738,0.5230875258442453
81,81,게/Josa,4340,1723,2617,0.019151679523375497,0.029066796987804608,0.6029953917050691
82,82,주다/Verb,4321,1728,2593,0.01920725607451704,0.028800231023835436,0.6000925711640824
83,83,안/VerbPrefix,4262,1318,2944,0.014649978880910566,0.032698758246884514,0.6907555138432661
84,84,재미없다/Adjective,4205,307,3898,0.003412400240090701,0.043294755314658914,0.9269916765755052
85,85,자다/Verb,4114,2658,1456,0.029544494586843918,0.016171668480796143,0.6460865337870686
86,86,좀/Noun,4111,1455,2656,0.016172776382188826,0.029499966679254506,0.6460715154463634
87,87,그/Noun,4099,2400,1699,0.02667674454794033,0.01887064886598396,0.5855086606489388
88,88,지루하다/Adjective,4057,872,3185,0.009692550519084988,0.03537552480174157,0.7850628543258565
89,89,하고/Josa,4024,1896,2128,0.021074628192872858,0.023635515471932825,0.5288270377733598
90,90,가다/Verb,4006,1941,2065,0.021574817153146745,0.022935779816513763,0.5154767848227658
91,91,!!/Punctuation,4005,3088,917,0.03432407798501656,0.010185041206655265,0.7710362047440699
92,92,시간/Noun,3956,1077,2879,0.011971189115888223,0.03197680876113468,0.7277553083923155
93,93,한/Determiner,3920,1604,2316,0.01782895760620679,0.02572361552302464,0.5908163265306122
94,94,쓰레기/Noun,3739,209,3530,0.002323099837716471,0.03920741053379834,0.9441027012570206
95,95,들다/Verb,3702,1859,1843,0.02066336171442545,0.02047004464979896,0.5021609940572663
96,96,수/Noun,3698,2475,1223,0.02751039281506347,0.013583757247262143,0.6692806922660898
97,97,모르다/Verb,3669,1654,2015,0.018384723117622213,0.022380434058244664,0.5491959662033251
98,98,싶다/Verb,3517,1833,1684,0.020374363648489432,0.018704045138503232,0.5211828262723912
99,99,그렇다/Adjective,3501,1397,2104,0.015528088388946938,0.023368949507963657,0.6009711510996858
100,100,나/Noun,3501,1853,1648,0.0205966698530556,0.01830419619254948,0.5292773493287632
101,101,아/Exclamation,3469,1327,2142,0.014750016672965344,0.02379101228424817,0.6174690112424329
102,102,알다/Verb,3393,1393,2000,0.0154836271480337,0.02221383033076393,0.5894488653109343
103,103,볼/Noun,3386,1865,1521,0.020730053575795302,0.016893617966545968,0.5507974010632014
104,104,작품/Noun,3308,2050,1258,0.02278638596803237,0.013972499278050514,0.6197097944377267
105,105,다시/Noun,3289,2763,526,0.030711602160816313,0.005842237376990914,0.8400729705077531
106,106,10/Number,3248,2158,1090,0.023986839472689682,0.012106537530266344,0.6644088669950738
107,107,마지막/Noun,3201,2151,1050,0.023909032301091523,0.011662260923651064,0.6719775070290535
108,108,보다/Josa,3196,1681,1515,0.018684836493786543,0.01682697647555368,0.5259699624530664
109,109,사랑/Noun,3190,2523,667,0.028043927706022275,0.007408312415309772,0.7909090909090909
110,110,잘/VerbPrefix,3151,2150,1001,0.023897916990863216,0.011118022080547348,0.682323072040622
111,111,하나/Noun,3087,1267,1820,0.014083098059266837,0.02021458560099518,0.5895691609977324
112,112,오다/Verb,3064,1619,1445,0.017995687259631417,0.01604949241397694,0.5283942558746736
113,113,이렇게/Adverb,3042,1309,1733,0.014549941088855791,0.01924828398160695,0.5696909927679158
114,114,요/Josa,3013,1950,1063,0.021674854945201518,0.011806650820801031,0.6471954862263525
115,115,처음/Noun,2995,1342,1653,0.014916746326389969,0.01835973076837639,0.5519198664440734
116,116,이다/Adjective,2942,2200,742,0.02445368250227864,0.00824133105271342,0.7477906186267845
117,117,나/Josa,2916,1029,1887,0.011437654224929416,0.02095874891707577,0.647119341563786
118,118,정도/Noun,2909,1293,1616,0.014372096125202852,0.01794877490725726,0.5555173599174974
119,119,2/Number,2878,1225,1653,0.013616255029677879,0.01835973076837639,0.5743571924947879
120,120,많다/Adjective,2857,1696,1161,0.018851566147211167,0.012895128507008463,0.5936296814840742
121,121,완전/Noun,2851,1545,1306,0.017173154302736592,0.014505631205988847,0.5419151175026307
122,122,ㅋ/KoreanParticle,2712,1574,1138,0.017495498299357534,0.012639669458204678,0.5803834808259587
123,123,주인공/Noun,2708,1083,1625,0.012037880977258077,0.01804873714374569,0.6000738552437223
124,124,안되다/Adjective,2683,658,2025,0.007313874130226975,0.022491503209898484,0.7547521431233694
125,125,액션/Noun,2660,1278,1382,0.014205366471778228,0.01534975675855788,0.5195488721804511
126,126,나다/Verb,2654,1340,1314,0.014894515705933354,0.014594486527311903,0.5048982667671439
127,127,차다/Verb,2646,1269,1377,0.014105328679723453,0.015294222182730969,0.5204081632653061
128,128,인데/Josa,2629,1242,1387,0.013805215303559123,0.015405291334384787,0.5275770254849753
129,129,장면/Noun,2611,1425,1186,0.015839317075339573,0.013172801386143013,0.5457679050172348
130,130,중/Suffix,2597,1568,1029,0.017428806437987686,0.011429015705178043,0.6037735849056604
131,131,지금/Noun,2596,1843,753,0.020485516750772512,0.00836350711953262,0.7099383667180277
132,132,ㅠㅠ/KoreanParticle,2589,1842,747,0.0204744014405442,0.00829686562854033,0.7114716106604867
133,133,최악/Noun,2549,32,2517,0.00035568992730587116,0.02795610547126641,0.9874460572773636
134,134,지/Josa,2511,993,1518,0.011037503056710312,0.016860297221049824,0.6045400238948626
135,135,임/Noun,2511,1059,1452,0.011771113531778671,0.016127240820134614,0.5782556750298686
136,136,걸/Noun,2493,777,1716,0.008636596047395683,0.019059466423795454,0.6883273164861613
137,137,3/Number,2481,918,1563,0.010203854789587177,0.017360108403492013,0.6299879081015719
138,138,이야기/Noun,2465,1372,1093,0.015250205633239224,0.012139858275762487,0.5565922920892495
139,139,연출/Noun,2454,975,1479,0.010837427472600759,0.01642712752959993,0.6026894865525673
140,140,별로/Noun,2438,320,2118,0.003556899273058711,0.02352444632027901,0.8687448728465955
141,141,끝/Noun,2438,862,1576,0.009581397416801902,0.01750449830064198,0.6464315012305168
142,142,돈/Noun,2433,279,2154,0.003101171553698064,0.02392429526623276,0.8853267570900123
143,143,느낌/Noun,2411,1154,1257,0.012827068003467976,0.013961392362885131,0.5213604313562837
144,144,좋아하다/Adjective,2390,1427,963,0.015861547695796188,0.010695959304262832,0.597071129707113
145,145,듯/Noun,2374,1137,1237,0.01263810772958673,0.013739254059577492,0.52106149957877
146,146,라/Josa,2373,987,1386,0.01097081119534046,0.015394184419219406,0.584070796460177
147,147,그리고/Conjunction,2339,1419,920,0.015772625213969722,0.010218361952151409,0.6066695168875588
148,148,역시/Noun,2323,1623,700,0.01804014850054465,0.007774840615767376,0.6986655187257856
149,149,넘다/Verb,2286,1520,766,0.016895271547028873,0.008507897016682586,0.6649168853893264
150,150,개/Noun,2277,671,1606,0.007458373163194984,0.01783770575560344,0.7053140096618358
151,151,명작/Noun,2259,1976,283,0.02196385301113754,0.0031432569918030968,0.8747233289065959
152,152,받다/Verb,2250,1080,1170,0.01200453504657315,0.012995090743496902,0.52
153,153,남다/Verb,2231,1452,779,0.0161394304515039,0.008652286913832552,0.6508292245629762
154,154,이런/Modifier,2201,819,1382,0.00910343907698464,0.01534975675855788,0.6278964107223989
155,155,그/Determiner,2183,1013,1170,0.01125980926127648,0.012995090743496902,0.5359596885020614
156,156,이해/Noun,2164,866,1298,0.009625858657715135,0.01441677588466579,0.5998151571164511
157,157,^^/Punctuation,2162,1921,241,0.021352510948580573,0.002676766554857054,0.8885291396854764
158,158,라고/Josa,2147,777,1370,0.008636596047395683,0.015216473776573296,0.6380996739636703
159,159,괜찮다/Adjective,2129,1444,685,0.016050507969677434,0.0076082368882866465,0.6782527007984971
160,160,ㅡㅡ/KoreanParticle,2128,211,1917,0.002345330458173088,0.02129195637203723,0.9008458646616542
161,161,이영화/Noun,2102,1147,955,0.012749260831869818,0.010607103982939778,0.5456707897240723
162,162,안/Noun,2100,842,1258,0.009359091212235734,0.013972499278050514,0.599047619047619
163,163,버리다/Verb,2073,660,1413,0.00733610475068359,0.01569407112868472,0.6816208393632417
164,164,느끼다/Verb,2066,1442,624,0.016028277349220816,0.006930715063198347,0.6979670861568248
165,165,많이/Adverb,2064,1130,934,0.012560300557988574,0.010373858764466757,0.5474806201550387
166,166,때문/Noun,2060,810,1250,0.009003401284929862,0.013883643956727459,0.6067961165048543
167,167,!!!/Punctuation,2038,1392,646,0.01547251183780539,0.00717506719683675,0.6830225711481845
168,168,또/Noun,2013,1348,665,0.014983438187759818,0.007386098584979008,0.6696472925981123
169,169,중/Noun,1957,1139,818,0.01266033835004335,0.00908545660528245,0.5820132856412877
170,170,해주다/Verb,1945,1324,621,0.014716670742280415,0.0068973943177022025,0.680719794344473
171,171,여자/Noun,1944,757,1187,0.008414289842829513,0.013183908301308394,0.61059670781893
172,172,난/Noun,1928,1196,732,0.01329391103305693,0.0081302619010596,0.6203319502074689
173,173,꼭/Noun,1920,1594,326,0.0177178045039237,0.003620854343914521,0.8302083333333333
174,174,내/Determiner,1911,839,1072,0.009325745281550809,0.011906613057289468,0.5609628466771324
175,175,에게/Josa,1907,1144,763,0.012715914901184892,0.00847457627118644,0.5998951232302046
176,176,보기/Noun,1903,847,1056,0.009414667763377276,0.011728902414643355,0.5549132947976878
177,177,아름답다/Adjective,1901,1659,242,0.01844029966876376,0.002687873470022436,0.8726985796948974
178,178,하/Suffix,1862,787,1075,0.008747749149678767,0.011939933802785614,0.5773361976369495
179,179,이고/Josa,1836,960,876,0.010670697819176131,0.009729657684874602,0.5228758169934641
180,180,어떻다/Adjective,1819,805,1014,0.00894782473378832,0.011262411977697314,0.5574491478834525
181,181,마음/Noun,1810,1497,313,0.016639619411777783,0.0034764644467645558,0.8270718232044199
182,182,인생/Noun,1810,1304,506,0.014494364537714247,0.0056200990736832756,0.7204419889502762
183,183,서/Josa,1808,876,932,0.009737011759998221,0.010351644934135993,0.5154867256637168
184,184,엔/Josa,1801,827,974,0.009192361558811106,0.010818135371082036,0.5408106607440311
185,185,기억/Noun,1794,1237,557,0.01374963875241758,0.006186551747117756,0.6895206243032329
186,186,부터/Josa,1791,743,1048,0.008258675499633194,0.011640047093320302,0.5851479620323842
187,187,결말/Noun,1777,729,1048,0.008103061156436877,0.011640047093320302,0.5897580191333709
188,188,끄다/Verb,1754,541,1213,0.006013382833514882,0.013472688095608323,0.6915621436716077
189,189,아쉽다/Adjective,1746,1186,560,0.013182757930773848,0.006219872492613902,0.6792668957617412
190,190,면/Josa,1746,896,850,0.00995931796456439,0.009440877890574672,0.5131729667812142
191,191,ㅎㅎ/KoreanParticle,1744,1498,246,0.01665073472200609,0.002732301130683964,0.8589449541284404
192,192,보여주다/Verb,1738,936,802,0.01040393037369673,0.008907745962636337,0.5385500575373993
193,193,랑/Josa,1721,744,977,0.008269790809861503,0.010851456116578182,0.5676932016269611
194,194,못/Noun,1720,544,1176,0.00604672876419981,0.013061732234489191,0.6837209302325581
195,195,소재/Noun,1714,594,1120,0.0066024942756152324,0.012439744985227805,0.6534422403733956
196,196,이나/Josa,1704,527,1177,0.005857768490318565,0.013072839149654573,0.6907276995305164
197,197,어리다/Verb,1690,1270,420,0.014116443989951759,0.004664904369460426,0.7514792899408284
198,198,재다/Verb,1675,1417,258,0.015750394593513104,0.002865584112668547,0.8459701492537314
199,199,없이/Adverb,1675,902,773,0.010026009825934242,0.008585645422840259,0.5385074626865671
200,200,뻔하다/Adjective,1670,457,1213,0.005079696774336972,0.013472688095608323,0.7263473053892215
201,201,애/Noun,1670,576,1094,0.00640241869150568,0.012150965190927872,0.6550898203592814
202,202,수준/Noun,1658,273,1385,0.003034479692328213,0.015383077504054024,0.8353437876960192
203,203,맞다/Verb,1649,477,1172,0.005302002978903141,0.013017304573827665,0.7107337780473014
204,204,한번/Noun,1640,1136,504,0.012626992419358423,0.005597885243352511,0.6926829268292682
205,205,편/Noun,1613,721,892,0.008014138674610408,0.009907368327520715,0.5530068195908245
206,206,네/Josa,1608,469,1139,0.0052130804970766725,0.01265077637337006,0.7083333333333334
207,207,먹다/Verb,1594,709,885,0.007880754951870706,0.009829619921363041,0.5552070263488079
208,208,웃기다/Verb,1590,781,809,0.008681057288308917,0.008985494368794011,0.5088050314465409
209,209,라는/Josa,1588,783,805,0.008703287908765534,0.00894106670813248,0.506926952141058
210,210,현실/Noun,1587,1041,546,0.01157103794766912,0.006064375680298554,0.6559546313799622
211,211,전개/Noun,1586,418,1168,0.004646199675432942,0.012972876913166138,0.7364438839848676
212,212,매력/Noun,1586,1153,433,0.012815952693239669,0.00480929426661039,0.7269861286254728
213,213,무섭다/Adjective,1580,677,903,0.007525065024564835,0.010029544394339916,0.5715189873417722
214,214,되어다/Verb,1577,1073,504,0.01192672787497499,0.005597885243352511,0.6804058338617628
215,215,가슴/Noun,1575,1376,199,0.015294666874152455,0.0022102761179110114,0.8736507936507937
216,216,낮다/Adjective,1560,1254,306,0.013938599026298824,0.003398716040606882,0.8038461538461539
217,217,말다/Verb,1559,338,1221,0.003756974857168264,0.01356154341693138,0.7831943553559975
218,218,끝나다/Verb,1557,666,891,0.007402796612053442,0.00989626141235533,0.5722543352601156
219,219,~~/Punctuation,1556,1038,518,0.011537692016984194,0.00575338205566786,0.6670951156812339
220,220,야/Josa,1543,373,1170,0.00414601071515906,0.012995090743496902,0.7582631237848347
221,221,한국/Noun,1543,817,726,0.009081208456528022,0.008063620410067309,0.5294880103694103
222,222,높다/Adjective,1536,327,1209,0.003634706444656871,0.013428260434946798,0.787109375
223,223,님/Suffix,1536,948,588,0.010537314096436429,0.006530866117244597,0.6171875
224,224,알/Noun,1535,886,649,0.009848164862281308,0.007208387942332897,0.5771986970684039
225,225,가장/Noun,1534,1006,528,0.011182002089678324,0.005864451207321679,0.6558018252933507
226,226,;;/Punctuation,1523,373,1150,0.00414601071515906,0.012772952440189262,0.7550886408404465
227,227,저/Noun,1522,907,615,0.010081586377075784,0.00683075282670991,0.5959264126149802
228,228,슬프다/Adjective,1504,1292,212,0.014360980814974547,0.002354666015060977,0.8590425531914894
229,229,??/Punctuation,1503,455,1048,0.005057466153880355,0.011640047093320302,0.697272122421823
230,230,본/Modifier,1496,741,755,0.008236444879176578,0.008385720949863385,0.5046791443850267
231,231,멋지다/Adjective,1475,1271,204,0.014127559300180068,0.002265810693737921,0.8616949152542372
232,232,남자/Noun,1459,711,748,0.007902985572327324,0.008307972543705711,0.5126799177518848
233,233,아/Josa,1457,606,851,0.006735877998354935,0.009451984805740056,0.5840768702814001
234,234,하지만/Conjunction,1453,772,681,0.00858101949625414,0.0075638092276251205,0.5313145216792843
235,235,음악/Noun,1452,1077,375,0.011971189115888223,0.0041650931870182385,0.7417355371900827
236,236,반전/Noun,1452,767,685,0.008525442945112599,0.0076082368882866465,0.528236914600551
237,237,성/Suffix,1445,496,949,0.0055131938732410025,0.010540462491947487,0.6567474048442906
238,238,늘다/Verb,1443,678,765,0.007536180334793144,0.008496790101517205,0.5301455301455301
239,239,유치하다/Adjective,1442,282,1160,0.003134517484382989,0.01288402159184308,0.8044382801664355
240,240,아이/Noun,1436,944,492,0.010492852855523198,0.005464602261367928,0.6573816155988857
241,241,죽다/Verb,1435,475,960,0.005279772358446525,0.010662638558766688,0.6689895470383276
242,242,함/Noun,1425,758,667,0.008425405153057822,0.007408312415309772,0.5319298245614035
243,243,기/Modifier,1424,720,704,0.0080030233643821,0.007819268276428905,0.5056179775280899
244,244,솔직하다/Adjective,1420,500,920,0.005557655114154236,0.010218361952151409,0.647887323943662
245,245,크다/Verb,1413,727,686,0.008080830535980259,0.0076193438034520295,0.5145081387119603
246,246,줄/Noun,1411,605,806,0.006724762688126626,0.008952173623297865,0.5712260807937632
247,247,무슨/Noun,1408,215,1193,0.002389791699086321,0.013250549792300687,0.8473011363636364
248,248,추천/Noun,1403,1037,366,0.011526576706755885,0.0040651309505298,0.7391304347826086
249,249,만/Noun,1401,947,454,0.010526198786208123,0.005042539485083413,0.6759457530335474
250,250,냐/Josa,1392,169,1223,0.001878487428584132,0.013583757247262143,0.8785919540229885
251,251,인지/Josa,1383,425,958,0.004724006847031101,0.010640424728435923,0.6926970354302241
252,252,쓰다/Verb,1383,430,953,0.004779583398172643,0.010584890152609014,0.6890817064352857
253,253,게/Noun,1380,485,895,0.005390925460729609,0.009940689073016859,0.6485507246376812
254,254,눈물/Noun,1378,1156,222,0.012849298623924595,0.002465735166714797,0.8388969521044993
255,255,인가/Josa,1378,446,932,0.004957428361825579,0.010351644934135993,0.6763425253991292
256,256,도/Noun,1374,658,716,0.007313874130226975,0.007952551258413489,0.5211062590975255
257,257,번/Noun,1370,945,425,0.010503968165751507,0.004720438945287336,0.6897810218978102
258,258,내다/Verb,1366,686,680,0.007625102816619612,0.0075527023124597375,0.5021961932650073
259,259,ㅠ/KoreanParticle,1361,899,462,0.009992663895249316,0.005131394806406469,0.6605437178545187
260,260,자체/Noun,1360,582,778,0.006469110552875531,0.00864117999866717,0.5720588235294117
261,261,저/Determiner,1355,471,884,0.005235311117533291,0.009818513006197658,0.6523985239852399
262,262,우리/Noun,1346,996,350,0.011070848987395238,0.003887420307883689,0.7399702823179792
263,263,인간/Noun,1346,839,507,0.009325745281550809,0.005631205988848657,0.6233283803863299
264,264,네/Suffix,1337,913,424,0.010148278238445637,0.004709332030121954,0.6828721017202692
265,265,야하다/Adjective,1322,769,553,0.008547673565569215,0.006142124086456227,0.5816944024205749
266,266,'/Punctuation,1314,678,636,0.007536180334793144,0.00706399804518293,0.5159817351598174
267,267,지만/Josa,1312,784,528,0.008714403218993843,0.005864451207321679,0.5975609756097561
268,268,속/Noun,1307,819,488,0.00910343907698464,0.005420174600706399,0.6266258607498087
269,269,영/Modifier,1305,619,686,0.006880377031322943,0.0076193438034520295,0.5256704980842912
270,270,허다/Verb,1294,206,1088,0.0022897539070315448,0.01208432369993558,0.8408037094281299
271,271,눈/Noun,1292,674,618,0.007491719093879909,0.006864073572206054,0.521671826625387
272,272,원작/Noun,1275,429,846,0.0047684680879443355,0.009396450229913143,0.6635294117647059
273,273,짜증나다/Adjective,1251,81,1170,0.0009003401284929863,0.012995090743496902,0.9352517985611509
274,274,그래도/Adverb,1246,736,510,0.008180868328035036,0.005664526734344803,0.5906902086677368
275,275,살다/Verb,1239,732,507,0.008136407087121801,0.005631205988848657,0.5907990314769975
276,276,뭔가/Noun,1237,502,735,0.005579885734610853,0.008163582646555746,0.5941794664510913
277,277,코미디/Noun,1235,485,750,0.005390925460729609,0.008330186374036475,0.6072874493927125
278,278,찍다/Verb,1231,259,972,0.0028788653491318944,0.010795921540751272,0.7896019496344435
279,279,보이다/Verb,1231,504,727,0.00560211635506747,0.00807472732523269,0.5905767668562144
280,280,연기력/Noun,1225,680,545,0.007558410955249761,0.006053268765133172,0.5551020408163265
281,281,캐릭터/Noun,1225,562,663,0.006246804348309361,0.007363884754648243,0.5412244897959184
282,282,기대하다/Adjective,1222,341,881,0.003790320787853189,0.009785192260701512,0.7209492635024549
283,283,돼다/Verb,1217,575,642,0.006391303381277372,0.007130639536175223,0.5275267050123253
284,284,여운/Noun,1210,1139,71,0.01266033835004335,0.0007885909767421196,0.9413223140495868
285,285,이상/Noun,1209,637,572,0.007080452615432497,0.006353155474598485,0.5268817204301075
286,286,움/Noun,1204,432,772,0.00480181401862926,0.00857453850767488,0.6411960132890365
287,287,이네/Josa,1200,505,695,0.005613231665295778,0.007719306039940467,0.5791666666666667
288,288,전혀/Noun,1199,338,861,0.003756974857168264,0.009563053957393873,0.7180984153461217
289,289,기대/Noun,1198,745,453,0.008280906120089812,0.005031432569918031,0.6218697829716193
290,290,지다/Verb,1197,523,674,0.005813307249405332,0.007486060821467445,0.5630743525480367
291,291,모두/Noun,1194,810,384,0.009003401284929862,0.004265055423506675,0.6783919597989949
292,292,대박/Noun,1180,975,205,0.010837427472600759,0.002276917608903303,0.826271186440678
293,293,대한/Noun,1173,715,458,0.007947446813240557,0.005086967145744941,0.6095481670929241
294,294,공감/Noun,1172,643,529,0.007147144476802349,0.005875558122487061,0.5486348122866894
295,295,씨/Suffix,1170,706,464,0.007847409021185782,0.005153608636737233,0.6034188034188034
296,296,근데/Adverb,1165,632,533,0.007024876064290955,0.005919985783148589,0.5424892703862659
297,297,별/Noun,1164,304,860,0.003379054309405776,0.009551947042228491,0.7388316151202751
298,298,이쁘다/Adjective,1161,733,428,0.00814752239735011,0.004753759690783481,0.6313522825150732
299,299,계속/Noun,1161,707,454,0.007858524331414091,0.005042539485083413,0.6089577950043066
300,300,굿/Noun,1156,1072,84,0.01191561256474668,0.0009329808738920851,0.9273356401384084
301,301,아주/Noun,1152,682,470,0.007580641575706378,0.005220250127729524,0.5920138888888888
302,302,시리즈/Noun,1149,660,489,0.00733610475068359,0.005431281515871782,0.5744125326370757
303,303,모습/Noun,1142,842,300,0.009359091212235734,0.00333207454961459,0.7373029772329247
304,304,별/Modifier,1142,316,826,0.003512438032145477,0.009174311926605505,0.7232924693520141
305,305,미치다/Adjective,1139,415,724,0.004612853744748016,0.008041406579736544,0.6356453028972783
306,306,개봉/Noun,1138,496,642,0.0055131938732410025,0.007130639536175223,0.5641476274165202
307,307,에는/Josa,1137,526,611,0.005846653180090256,0.006786325166048382,0.5373790677220757
308,308,전/Noun,1126,674,452,0.007491719093879909,0.00502032565475265,0.5985790408525755
309,309,치다/Verb,1122,345,777,0.0038347820287664225,0.008630073083501789,0.6925133689839572
310,310,실망/Noun,1118,115,1003,0.0012782606762554744,0.011140235910878113,0.8971377459749553
311,311,영상/Noun,1114,626,488,0.006958184202921104,0.005420174600706399,0.5619389587073609
312,312,대/Modifier,1114,550,564,0.00611342062556966,0.006264300153275429,0.5062836624775583
313,313,요/Noun,1099,666,433,0.007402796612053442,0.00480929426661039,0.6060054595086443
314,314,내내/Noun,1099,548,551,0.006091190005113043,0.006119910256125464,0.5013648771610555
315,315,일본/Noun,1098,391,707,0.0043460862992686115,0.00785258902192505,0.6438979963570127
316,316,시키다/Verb,1097,384,713,0.004268279127670453,0.007919230512917342,0.649954421148587
317,317,보지/Noun,1094,324,770,0.0036013605139719454,0.008552324677344115,0.7038391224862889
318,318,진심/Noun,1094,415,679,0.004612853744748016,0.007541595397294354,0.6206581352833638
319,319,건지다/Verb,1093,195,898,0.002167485494520152,0.009974009818513006,0.8215919487648673
320,320,부분/Noun,1092,565,527,0.006280150278994287,0.0058533442921562965,0.5173992673992674
321,321,화/Suffix,1089,474,615,0.0052686570482182145,0.00683075282670991,0.5647382920110193
322,322,이제/Noun,1082,522,560,0.0058021919391770226,0.006219872492613902,0.5175600739371534
323,323,다른/Noun,1077,615,462,0.006835915790409711,0.005131394806406469,0.5710306406685237
324,324,이랑/Josa,1077,470,607,0.005224195807304982,0.006741897505386854,0.5636025998142989
325,325,일/Modifier,1074,387,687,0.004301625058355379,0.007630450718617411,0.6396648044692738
326,326,제목/Noun,1073,405,668,0.004501700642464931,0.007419419330475155,0.6225535880708295
327,327,귀엽다/Adjective,1069,881,188,0.009792588311139765,0.0020881000510918103,0.8241347053320861
328,328,이라/Josa,1066,537,529,0.00596892159260165,0.005875558122487061,0.5037523452157598
329,329,몰입/Noun,1061,631,430,0.0070137607540626465,0.004775973521114246,0.5947219604147032
330,330,(/Punctuation,1060,510,550,0.005668808216437321,0.006108803340960082,0.5188679245283019
331,331,대단하다/Adjective,1057,751,306,0.008347597981459662,0.003398716040606882,0.7105014191106906
332,332,밖에/Josa,1056,430,626,0.004779583398172643,0.0069529288935291115,0.5928030303030303
333,333,)/Punctuation,1054,502,552,0.005579885734610853,0.006131017171290846,0.523719165085389
334,334,기분/Noun,1053,521,532,0.005791076628948714,0.005908878867983206,0.5052231718898386
335,335,뿐/Noun,1051,311,740,0.0034568614810039353,0.008219117222382655,0.7040913415794482
336,336,두/Determiner,1051,585,466,0.006502456483560457,0.005175822467067996,0.5566127497621313
337,337,무엇/Noun,1050,539,511,0.005991152213058267,0.005675633649510186,0.5133333333333333
338,338,ㅎ/KoreanParticle,1048,840,208,0.009336860591779116,0.0023102383543994486,0.8015267175572519
339,339,;/Punctuation,1045,287,758,0.0031900940355245318,0.008419041695359529,0.7253588516746412
340,340,표현/Noun,1042,681,361,0.007569526265478068,0.00400959637470289,0.6535508637236085
341,341,OO/Alpha,1033,220,813,0.002445368250227864,0.009029922029455541,0.7870280735721199
342,342,후/Noun,1032,499,533,0.005546539803925927,0.005919985783148589,0.5164728682170543
343,343,가족/Noun,1031,710,321,0.007891870262099015,0.0035653197680876117,0.6886517943743938
344,344,믿다/Verb,1028,528,500,0.0058688838005468745,0.005553457582690984,0.5136186770428015
345,345,잔잔하다/Adjective,1023,897,126,0.0099704332747927,0.0013994713108381278,0.8768328445747801
346,346,처럼/Josa,1023,537,486,0.00596892159260165,0.005397960770375636,0.5249266862170088
347,347,요즘/Noun,1013,643,370,0.007147144476802349,0.004109558611191328,0.6347482724580454
348,348,감/Noun,1013,542,471,0.006024498143743192,0.005231357042894906,0.5350444225074038
349,349,점도/Noun,1011,91,920,0.001011493230776071,0.010218361952151409,0.9099901088031652
350,350,이/Suffix,1007,511,496,0.0056799235266656286,0.005509029922029457,0.5074478649453823
351,351,긴장감/Noun,1001,507,494,0.0056354622857523965,0.005486816091698691,0.5064935064935064
352,352,용/Noun,999,295,704,0.0032790165173509998,0.007819268276428905,0.7047047047047047
353,353,떨어지다/Verb,997,207,790,0.002300869217259854,0.008774462980651754,0.7923771313941825
354,354,ㅜㅜ/KoreanParticle,996,633,363,0.007035991374519263,0.0040318102050336535,0.6355421686746988
355,355,모든/Noun,986,630,356,0.0070026454438343365,0.003954061798875979,0.6389452332657201
356,356,4/Number,981,333,648,0.003701398306026721,0.0071972810271675155,0.6605504587155964
357,357,이라는/Josa,981,510,471,0.005668808216437321,0.005231357042894906,0.5198776758409785
358,358,급/Noun,974,237,737,0.0026343285241091077,0.00818579647688651,0.7566735112936345
359,359,웃다/Verb,974,598,376,0.006646955516528465,0.004176200102183621,0.6139630390143738
360,360,위/Noun,973,445,528,0.004946313051597271,0.005864451207321679,0.5426515930113053
361,361,조금/Noun,967,582,385,0.006469110552875531,0.004276162338672057,0.6018614270941055
362,362,특히/Adverb,966,665,301,0.007391681301825134,0.003343181464779972,0.6884057971014492
363,363,여/Modifier,966,412,554,0.0045795078140630895,0.006153231001621609,0.5734989648033126
364,364,빠지다/Verb,964,602,362,0.0066914167574417,0.004020703289868272,0.6244813278008299
365,365,대사/Noun,960,476,484,0.005290887668674833,0.005375746940044872,0.5041666666666667
366,366,개인/Noun,957,633,324,0.007035991374519263,0.003598640513583757,0.6614420062695925
367,367,분/Noun,957,530,427,0.00589111442100349,0.0047426527756181,0.5538140020898642
368,368,스릴러/Noun,954,424,530,0.004712891536802792,0.005886665037652442,0.5555555555555556
369,369,공포/Noun,951,319,632,0.0035457839628304025,0.007019570384521403,0.6645636172450052
370,370,짜다/Verb,947,361,586,0.004012626992419359,0.006508652286913832,0.6187961985216474
371,371,극장/Noun,938,444,494,0.0049351977413689616,0.005486816091698691,0.5266524520255863
372,372,건/Noun,932,292,640,0.0032456705866660733,0.007108425705844459,0.6866952789699571
373,373,한테/Josa,931,317,614,0.003523553342373785,0.006819645911544527,0.6595059076262084
374,374,작가/Noun,929,209,720,0.002323099837716471,0.007996978919075016,0.77502691065662
375,375,이유/Noun,928,364,564,0.004045972923104284,0.006264300153275429,0.6077586206896551
376,376,나름/Noun,923,600,323,0.006669186136985084,0.003587533598418375,0.6500541711809318
377,377,잼/Noun,923,524,399,0.005824422559633639,0.004431659150987405,0.5677139761646804
378,378,시작/Noun,922,432,490,0.00480181401862926,0.005442388431037164,0.5314533622559653
379,379,욕/Noun,910,166,744,0.0018451414978992067,0.008263544883044184,0.8175824175824176
380,380,차라리/Noun,909,59,850,0.0006558033034701999,0.009440877890574672,0.935093509350935
381,381,이상하다/Adjective,909,232,677,0.0025787519729675657,0.007519381566963592,0.7447744774477447
382,382,노래/Noun,909,604,305,0.006713647377898317,0.0033876091254415,0.6644664466446645
383,383,깊다/Adjective,907,808,99,0.008981170664473246,0.0010995846013728146,0.8908489525909592
384,384,제대로/Noun,907,366,541,0.0040682035435609006,0.006008841104471644,0.5964718853362734
385,385,짱/Noun,905,842,63,0.009359091212235734,0.0006997356554190639,0.9303867403314916
386,386,중간/Noun,905,328,577,0.0036458217548851783,0.0064086900504253955,0.6375690607734806
387,387,울다/Verb,900,695,205,0.007725140608674388,0.002276917608903303,0.7722222222222223
388,388,알바/Noun,897,104,793,0.001155992263744081,0.0088077837261479,0.8840579710144928
389,389,-/Punctuation,894,421,473,0.004679545606117867,0.005253570873225671,0.529082774049217
390,390,0/Number,888,77,811,0.0008558788875797522,0.009007708199124777,0.9132882882882885
391,391,애니/Noun,888,446,442,0.004957428361825579,0.004909256503098829,0.5022522522522522
392,392,따뜻하다/Adjective,884,833,51,0.009259053420180956,0.0005664526734344802,0.9423076923076924
393,393,느껴지다/Verb,884,553,331,0.006146766556254586,0.003676388919741431,0.6255656108597285
394,394,삶/Noun,883,770,113,0.008558788875797524,0.0012550814136881624,0.8720271800679502
395,395,에도/Josa,881,473,408,0.005257541737989907,0.004531621387475843,0.5368898978433598
396,396,",,/Punctuation",879,413,466,0.0045906231242913995,0.005175822467067996,0.5301478953356087
397,397,...../Punctuation,877,327,550,0.003634706444656871,0.006108803340960082,0.6271379703534777
398,398,제/Noun,874,553,321,0.006146766556254586,0.0035653197680876117,0.6327231121281465
399,399,오랜/Modifier,870,699,171,0.007769601849587622,0.0018992824932803163,0.8034482758620691
400,400,기/Noun,869,240,629,0.002667674454794033,0.006986249639025257,0.7238204833141542
401,401,예쁘다/Adjective,865,571,294,0.006346842140364138,0.0032654330586222983,0.6601156069364161
402,402,제일/Noun,865,507,358,0.0056354622857523965,0.003976275629206745,0.5861271676300578
403,403,당시/Noun,862,550,312,0.00611342062556966,0.0034653575315991736,0.6380510440835266
404,404,빼다/Verb,861,250,611,0.002778827557077118,0.006786325166048382,0.7096399535423926
405,405,점수/Noun,857,271,586,0.003012249071871596,0.006508652286913832,0.6837806301050176
406,406,해보다/Verb,855,496,359,0.0055131938732410025,0.003987382544372126,0.5801169590643275
407,407,의미/Noun,854,412,442,0.0045795078140630895,0.004909256503098829,0.5175644028103045
408,408,영화로/Noun,847,377,470,0.004190471956072294,0.005220250127729524,0.5548996458087367
409,409,놈/Noun,846,250,596,0.002778827557077118,0.006619721438567652,0.7044917257683215
410,410,아직도/Adverb,841,631,210,0.0070137607540626465,0.002332452184730213,0.7502972651605232
411,411,어설프다/Adjective,834,79,755,0.0008781095080363692,0.008385720949863385,0.9052757793764988
412,412,막장/Noun,834,144,690,0.00160060467287642,0.007663771464113556,0.8273381294964028
413,413,력/Suffix,830,347,483,0.00385701264922304,0.0053646400248794895,0.5819277108433735
414,414,연/Modifier,829,393,436,0.00436831691972523,0.004842615012106539,0.525934861278649
415,415,친구/Noun,827,432,395,0.00480181401862926,0.004387231490325877,0.5223700120918985
416,416,훌륭하다/Adjective,825,663,162,0.007369450681368517,0.0017993202567918784,0.8036363636363636
417,417,세상/Noun,824,533,291,0.005924460351688416,0.0032321123131261523,0.6468446601941747
418,418,이지/Josa,815,332,483,0.0036902829957984134,0.0053646400248794895,0.5926380368098161
419,419,이라고/Josa,815,342,473,0.003801436098081498,0.005253570873225671,0.5803680981595092
420,420,공포영화/Noun,809,293,516,0.0032567858968943824,0.005731168225337095,0.6378244746600742
421,421,위해/Noun,809,386,423,0.00429050974812707,0.0046982251149565715,0.5228677379480839
422,422,도대체/Noun,805,101,704,0.0011226463330591557,0.007819268276428905,0.8745341614906832
423,423,웃음/Noun,805,380,425,0.004223817886757218,0.004720438945287336,0.5279503105590062
424,424,힘들다/Adjective,799,310,489,0.0034457461707756267,0.005431281515871782,0.6120150187734669
425,425,앞/Noun,797,485,312,0.005390925460729609,0.0034653575315991736,0.6085319949811794
426,426,생각나다/Verb,795,647,148,0.007191605717715582,0.001643823444476531,0.8138364779874214
427,427,류/Noun,790,141,649,0.0015672587421914947,0.007208387942332897,0.8215189873417722
428,428,로/Noun,790,335,455,0.0037236289264833385,0.005053646400248795,0.5759493670886076
429,429,7/Number,790,388,402,0.004312740368583687,0.004464979896483551,0.5088607594936709
430,430,의/Noun,788,444,344,0.0049351977413689616,0.003820778816891397,0.5634517766497462
431,431,절대/Noun,787,263,524,0.002923326590045128,0.005820023546660151,0.6658195679796697
432,432,그리다/Verb,785,442,343,0.004912967120912345,0.0038096719017260148,0.5630573248407643
433,433,뭘/Noun,782,175,607,0.0019451792899539827,0.006741897505386854,0.7762148337595908
434,434,잇다/Verb,780,524,256,0.005824422559633639,0.002843370282337784,0.6717948717948717
435,435,우리나라/Noun,778,423,355,0.004701776226574484,0.003942954883710598,0.5437017994858612
436,436,다르다/Adjective,778,400,378,0.004446124091323389,0.004198413932514383,0.5141388174807198
437,437,물/Noun,777,295,482,0.0032790165173509998,0.005353533109714108,0.6203346203346203
438,438,제/Modifier,775,314,461,0.00349020741168886,0.0051202878912410855,0.5948387096774194
439,439,미국/Noun,774,361,413,0.004012626992419359,0.004587155963302753,0.5335917312661499
440,440,써다/Verb,768,243,525,0.002701020385478959,0.005831130461825532,0.68359375
441,441,수작/Noun,766,696,70,0.007736255918902695,0.0007774840615767378,0.908616187989556
442,442,엄청/Adverb,766,465,301,0.00516861925616344,0.003343181464779972,0.6070496083550914
443,443,걍/Adverb,765,208,557,0.002311984527488162,0.006186551747117756,0.7281045751633987
444,444,설정/Noun,762,139,623,0.0015450281217348775,0.006919608148032965,0.8175853018372703
445,445,초반/Noun,761,265,496,0.002945557210501745,0.005509029922029457,0.6517739816031537
446,446,찾다/Verb,758,431,327,0.004790698708400951,0.0036319612590799033,0.5686015831134564
447,447,5/Number,758,346,412,0.003845897338994731,0.00457604904813737,0.5435356200527705
448,448,놓다/Verb,755,225,530,0.0025009448013694068,0.005886665037652442,0.7019867549668874
449,449,필요없다/Adjective,754,630,124,0.0070026454438343365,0.0013772574805073642,0.8355437665782494
450,450,일/Noun,751,400,351,0.004446124091323389,0.0038985272230490703,0.5326231691078562
451,451,신선하다/Adjective,748,507,241,0.0056354622857523965,0.002676766554857054,0.6778074866310161
452,452,싫다/Adjective,746,130,616,0.001444990329680101,0.006841859741875293,0.8257372654155496
453,453,시나리오/Noun,742,207,535,0.002300869217259854,0.005942199613479352,0.7210242587601078
454,454,딱/Adverb,742,251,491,0.0027899428673054264,0.005453495346202546,0.6617250673854448
455,455,이란/Josa,742,435,307,0.004835159949314186,0.003409822955772264,0.5862533692722371
456,456,사실/Noun,742,429,313,0.0047684680879443355,0.0034764644467645558,0.578167115902965
457,457,해/Noun,741,351,390,0.0039014738901362736,0.004331696914498967,0.5263157894736842
458,458,출연/Noun,740,226,514,0.0025120601115977146,0.005708954395006331,0.6945945945945946
459,459,남/Noun,740,366,374,0.0040682035435609006,0.004153986271852856,0.5054054054054054
460,460,대다/Verb,739,359,380,0.00399039637196274,0.0042206277628451475,0.5142083897158322
461,461,멋있다/Adjective,732,615,117,0.006835915790409711,0.0012995090743496902,0.8401639344262295
462,462,관객/Noun,732,188,544,0.0020896783229219927,0.00604216184996779,0.7431693989071039
463,463,한국영/Noun,731,295,436,0.0032790165173509998,0.004842615012106539,0.5964432284541724
464,464,이야/Josa,730,298,432,0.003312362448035925,0.00479818735144501,0.5917808219178082
465,465,가지/Noun,725,278,447,0.003090056243469755,0.004964791078925739,0.616551724137931
466,466,노잼/Noun,724,17,707,0.00018896027388124405,0.00785258902192505,0.9765193370165746
467,467,"""/Punctuation",724,358,366,0.003979281061734433,0.0040651309505298,0.505524861878453
468,468,뭔/Modifier,722,104,618,0.001155992263744081,0.006864073572206054,0.8559556786703602
469,469,분위기/Noun,721,443,278,0.004924082431140653,0.0030877224159761873,0.6144244105409153
470,470,답답하다/Adjective,719,131,588,0.0014561056399084098,0.006530866117244597,0.8178025034770514
471,471,아프다/Adjective,719,559,160,0.006213458417624436,0.0017771064264611148,0.7774687065368567
472,472,시대/Noun,719,474,245,0.0052686570482182145,0.002721194215518582,0.6592489568845619
473,473,봄/Noun,718,398,320,0.004423893470866772,0.003554212852922229,0.5543175487465181
474,474,장난/Noun,714,182,532,0.002022986461552142,0.005908878867983206,0.7450980392156863
475,475,죽이다/Verb,713,198,515,0.002200831425205077,0.005720061310171713,0.7223001402524544
476,476,기다/Verb,712,351,361,0.0039014738901362736,0.00400959637470289,0.5070224719101124
477,477,최고다/Noun,711,679,32,0.007547295645021453,0.00035542128529222287,0.9549929676511956
478,478,스럽다/Adjective,711,238,473,0.0026454438343374164,0.005253570873225671,0.6652601969057665
479,479,명/Noun,711,303,408,0.0033679389991774673,0.004531621387475843,0.5738396624472574
480,480,OOO/Alpha,708,91,617,0.001011493230776071,0.006852966657040674,0.8714689265536724
481,481,결국/Adverb,708,253,455,0.0028121734877620433,0.005053646400248795,0.6426553672316384
482,482,지루함/Noun,707,100,607,0.0011115310228308473,0.006741897505386854,0.8585572842998586
483,483,추억/Noun,707,576,131,0.00640241869150568,0.0014550058866650375,0.8147100424328148
484,484,나쁘다/Adjective,707,269,438,0.002990018451414979,0.004864828842437301,0.6195190947666195
485,485,대/Suffix,707,376,331,0.0041793566458439855,0.003676388919741431,0.5318246110325319
486,486,소리/Noun,705,202,503,0.0022452926661183114,0.005586778328187129,0.7134751773049646
487,487,니/Josa,705,294,411,0.003267901207122691,0.004564942132971988,0.5829787234042553
488,488,따다/Verb,704,382,322,0.0042460485072138366,0.003576426683252993,0.5426136363636364
489,489,이딴/Modifier,703,26,677,0.00028899806593602026,0.007519381566963592,0.9630156472261736
490,490,더럽다/Adjective,701,81,620,0.0009003401284929863,0.00688628740253682,0.8844507845934381
491,491,준/Noun,699,391,308,0.0043460862992686115,0.0034209298709376463,0.5593705293276109
492,492,영화관/Noun,695,298,397,0.003312362448035925,0.004409445320656641,0.5712230215827339
493,493,마다/Josa,694,480,214,0.005335348909588066,0.002376879845391741,0.69164265129683
494,494,살/Noun,690,420,270,0.004668430295889558,0.002998867094653131,0.6086956521739131
495,495,인상/Noun,689,547,142,0.006080074694884734,0.0015771819534842392,0.7939042089985486
496,496,이지만/Josa,687,427,260,0.004746237467487717,0.002887797942999312,0.6215429403202329
497,497,어이없다/Adjective,686,55,631,0.000611342062556966,0.007008463469356021,0.9198250728862972
498,498,오늘/Noun,685,462,223,0.005135273325478514,0.002476842081880179,0.6744525547445256
499,499,감정/Noun,684,445,239,0.004946313051597271,0.0026545527245262907,0.6505847953216374
500,500,서다/Verb,684,373,311,0.00414601071515906,0.0034542506164337923,0.5453216374269005
501,501,부족하다/Adjective,681,215,466,0.002389791699086321,0.005175822467067996,0.6842878120411159
502,502,안타깝다/Adjective,681,384,297,0.004268279127670453,0.0032987538041184443,0.5638766519823789
503,503,전/Modifier,680,199,481,0.002211946735433386,0.005342426194548726,0.7073529411764706
504,504,정신/Noun,678,183,495,0.0020341017717804503,0.0054979230068640745,0.7300884955752213
505,505,엔딩/Noun,678,431,247,0.004790698708400951,0.0027434080458493453,0.6356932153392331
506,506,라면/Noun,678,389,289,0.004323855678811996,0.003209898482795389,0.5737463126843658
507,507,접/Noun,676,122,554,0.0013560678478536335,0.006153231001621609,0.8195266272189349
508,508,팬/Noun,676,366,310,0.0040682035435609006,0.0034431437012684093,0.5414201183431953
509,509,잊다/Verb,674,570,104,0.006335726830135829,0.0011551191771997243,0.8456973293768546
510,510,졸작/Noun,672,34,638,0.0003779205477624881,0.007086211875513696,0.949404761904762
511,511,제발/Noun,671,179,492,0.0019896405308672165,0.005464602261367928,0.7332339791356185
512,512,자신/Noun,671,422,249,0.004690660916346175,0.002765621876180109,0.6289120715350224
513,513,니까/Josa,668,282,386,0.003134517484382989,0.00428726925383744,0.5778443113772455
514,514,아무리/Adverb,666,114,552,0.0012671453660271655,0.006131017171290846,0.8288288288288288
515,515,그저/Adverb,666,221,445,0.0024564835604561725,0.004942577248594975,0.6681681681681682
516,516,코믹/Noun,662,371,291,0.004123780094702443,0.0032321123131261523,0.5604229607250756
517,517,♥/Foreign,660,651,9,0.007236066958628815,9.996223648843771e-05,0.9863636363636364
518,518,평가/Noun,660,352,308,0.003912589200364582,0.0034209298709376463,0.5333333333333333
519,519,킬링타임/Noun,659,186,473,0.0020674477024653763,0.005253570873225671,0.7177541729893778
520,520,~~~/Punctuation,657,400,257,0.004446124091323389,0.0028544771975031647,0.60882800608828
521,521,함께/Adverb,656,544,112,0.00604672876419981,0.0012439744985227805,0.8292682926829268
522,522,그렇게/Adverb,656,251,405,0.0027899428673054264,0.004498300641979696,0.6173780487804879
523,523,음/Noun,654,290,364,0.003223439966209457,0.004042917120199036,0.5565749235474006
524,524,배우다/Verb,654,334,320,0.00371251361625503,0.003554212852922229,0.5107033639143731
525,525,캐스팅/Noun,653,219,434,0.0024342529399995552,0.004820401181775774,0.664624808575804
526,526,8/Number,653,388,265,0.004312740368583687,0.002943332518826221,0.5941807044410413
527,527,대해/Noun,651,506,145,0.0056243469755240865,0.001610502698980385,0.7772657450076805
528,528,얼마나/Noun,649,330,319,0.003668052375341796,0.003543105937756848,0.5084745762711864
529,529,어색하다/Adjective,642,123,519,0.001367183158081942,0.005764488970833241,0.8084112149532711
530,530,포스터/Noun,642,205,437,0.002278638596803237,0.00485372192727192,0.6806853582554517
531,531,적다/Verb,641,432,209,0.00480181401862926,0.002321345269564831,0.6739469578783152
532,532,몰입도/Noun,638,412,226,0.0045795078140630895,0.002510162827376325,0.64576802507837
533,533,뒤/Noun,637,294,343,0.003267901207122691,0.0038096719017260148,0.5384615384615384
534,534,엉/Exclamation,636,103,533,0.0011448769535157724,0.005919985783148589,0.8380503144654088
535,535,쓸다/Verb,636,162,474,0.0018006802569859727,0.0052646777883910536,0.7452830188679245
536,536,자/Suffix,632,213,419,0.0023675610786297045,0.004653797454295044,0.6629746835443038
537,537,갈수록/Noun,631,192,439,0.0021341395638352265,0.0048759357576026825,0.6957210776545166
538,538,스릴/Noun,631,370,261,0.004112664784474134,0.002898904858164693,0.5863708399366085
539,539,개연/Noun,630,55,575,0.000611342062556966,0.006386476220094631,0.9126984126984128
540,540,망하다/Adjective,630,89,541,0.000989262610319454,0.006008841104471644,0.8587301587301587
541,541,애니메이션/Noun,630,418,212,0.004646199675432942,0.002354666015060977,0.6634920634920635
542,542,시/Modifier,626,284,342,0.0031567481048396058,0.0037985649865606326,0.5463258785942492
543,543,배경/Noun,625,369,256,0.004101549474245826,0.002843370282337784,0.5904
544,544,데/Noun,624,271,353,0.003012249071871596,0.0039207410533798346,0.5657051282051282
545,545,든/Josa,623,361,262,0.004012626992419359,0.0029100117733300754,0.579454253611557
546,546,!!!!/Punctuation,622,460,162,0.005113042705021898,0.0017993202567918784,0.7395498392282959
547,547,엄마/Noun,622,344,278,0.0038236667185381134,0.0030877224159761873,0.5530546623794212
548,548,티비/Noun,621,299,322,0.0033234777582642327,0.003576426683252993,0.5185185185185185
549,549,문제/Noun,619,201,418,0.0022341773558900027,0.004642690539129663,0.6752827140549273
550,550,진부하다/Adjective,618,109,509,0.0012115688148856235,0.005653419819179421,0.8236245954692557
551,551,살리다/Verb,618,260,358,0.002889980659360202,0.003976275629206745,0.5792880258899676
552,552,이름/Noun,617,239,378,0.002656559144565725,0.004198413932514383,0.6126418152350082
553,553,지/Modifier,617,246,371,0.002734366316163884,0.00412066552635671,0.6012965964343598
554,554,하/Exclamation,614,213,401,0.0023675610786297045,0.0044538729813181676,0.6530944625407166
555,555,ㅠㅠㅠ/KoreanParticle,611,496,115,0.0055131938732410025,0.0012772952440189265,0.8117839607201309
556,556,두다/Verb,611,285,326,0.0031678634150679144,0.003620854343914521,0.5335515548281505
557,557,나가다/Verb,610,191,419,0.0021230242536069183,0.004653797454295044,0.6868852459016394
558,558,충격/Noun,610,399,211,0.00443500878109508,0.002343559099895595,0.6540983606557377
559,559,비다/Verb,610,253,357,0.0028121734877620433,0.0039651687140413614,0.5852459016393443
560,560,맘/Noun,609,373,236,0.00414601071515906,0.002621231979030144,0.6124794745484401
561,561,구성/Noun,605,285,320,0.0031678634150679144,0.003554212852922229,0.5289256198347108
562,562,유쾌하다/Adjective,603,554,49,0.006157881866482894,0.0005442388431037163,0.9187396351575456
563,563,머리/Noun,603,235,368,0.002612097903652491,0.004087344780860563,0.6102819237147595
564,564,옛날/Noun,602,317,285,0.003523553342373785,0.003165470822133861,0.5265780730897011
565,565,보단/Josa,600,239,361,0.002656559144565725,0.00400959637470289,0.6016666666666667
566,566,완벽하다/Adjective,599,512,87,0.0056910388368939385,0.0009663016193882313,0.8547579298831386
567,567,질/Noun,599,104,495,0.001155992263744081,0.0054979230068640745,0.8263772954924875
568,568,여/Josa,598,263,335,0.002923326590045128,0.0037208165804029593,0.560200668896321
569,569,를/Noun,597,280,317,0.003112286863926372,0.0035208921074260835,0.5309882747068677
570,570,영화인/Noun,596,336,260,0.0037347442367116467,0.002887797942999312,0.5637583892617449
571,571,이후/Noun,596,301,295,0.00334570837872085,0.00327653997378768,0.5050335570469798
572,572,만화/Noun,595,266,329,0.0029566725207300537,0.003654175089410667,0.5529411764705883
573,573,그래서/Adverb,595,288,307,0.00320120934575284,0.003409822955772264,0.5159663865546219
574,574,놀라다/Verb,594,366,228,0.0040682035435609006,0.0025323766577070887,0.6161616161616161
575,575,적/Noun,593,406,187,0.004512815952693239,0.002076993135926428,0.684654300168634
576,576,예술/Noun,593,258,335,0.0028677500389035857,0.0037208165804029593,0.5649241146711635
577,577,기도/Noun,591,342,249,0.003801436098081498,0.002765621876180109,0.5786802030456852
578,578,강추/Noun,590,547,43,0.006080074694884734,0.0004775973521114245,0.9271186440677966
579,579,행복하다/Adjective,590,524,66,0.005824422559633639,0.0007330564009152097,0.8881355932203391
580,580,얘기/Noun,590,217,373,0.0024120223195429388,0.0041428793566874724,0.6322033898305085
581,581,대/Foreign,587,217,370,0.0024120223195429388,0.004109558611191328,0.6303236797274276
582,582,후회/Noun,587,289,298,0.0032123246559811486,0.003309860719283826,0.5076660988074957
583,583,장르/Noun,583,201,382,0.0022341773558900027,0.004242841593175911,0.6552315608919382
584,584,집/Noun,583,280,303,0.003112286863926372,0.003365395295110736,0.5197255574614065
585,585,더빙/Noun,582,150,432,0.0016672965342462707,0.00479818735144501,0.7422680412371134
586,586,어울리다/Verb,581,319,262,0.0035457839628304025,0.0029100117733300754,0.5490533562822719
587,587,만/Suffix,580,315,265,0.003501322721917169,0.002943332518826221,0.5431034482758621
588,588,어디/Noun,579,237,342,0.0026343285241091077,0.0037985649865606326,0.5906735751295337
589,589,주연/Noun,577,225,352,0.0025009448013694068,0.003909634138214452,0.6100519930675911
590,590,얼굴/Noun,576,199,377,0.002211946735433386,0.004187307017349001,0.6545138888888888
591,591,은/Noun,576,256,320,0.0028455194184469693,0.003554212852922229,0.5555555555555556
592,592,후반/Noun,574,266,308,0.0029566725207300537,0.0034209298709376463,0.5365853658536586
593,593,즐겁다/Adjective,573,495,78,0.0055020785630126925,0.0008663393828997934,0.8638743455497382
594,594,들이다/Verb,573,233,340,0.002589867283195874,0.0037763511562298687,0.5933682373472949
595,595,같이/Adverb,572,327,245,0.003634706444656871,0.002721194215518582,0.5716783216783217
596,596,웃기/Noun,571,344,227,0.0038236667185381134,0.0025212697425417065,0.6024518388791593
597,597,머/Noun,570,97,473,0.0010781850921459217,0.005253570873225671,0.8298245614035088
598,598,집중/Noun,568,252,316,0.002801058177533735,0.0035097851922607014,0.5563380281690141
599,599,비/Noun,563,225,338,0.0025009448013694068,0.003754137325899105,0.6003552397868561
600,600,여기/Noun,563,228,335,0.0025342907320543315,0.0037208165804029593,0.5950266429840142
601,601,꽤/Noun,562,441,121,0.004901851810684036,0.001343936735011218,0.7846975088967971
602,602,그것/Noun,559,278,281,0.003090056243469755,0.0031210431614723325,0.5026833631484794
603,603,짜증/Noun,558,23,535,0.00025565213525109487,0.005942199613479352,0.9587813620071683
604,604,9/Number,557,382,175,0.0042460485072138366,0.0019437101539418445,0.6858168761220825
605,605,매우/Noun,557,343,214,0.003812551408309806,0.002376879845391741,0.6157989228007181
606,606,ㅡ/KoreanParticle,556,157,399,0.00174510370584443,0.004431659150987405,0.7176258992805755
607,607,날/Noun,556,337,219,0.0037458595469399545,0.0024324144212186506,0.6061151079136691
608,608,ㅎㅎㅎ/KoreanParticle,555,434,121,0.0048240446390858775,0.001343936735011218,0.781981981981982
609,609,읽다/Verb,555,242,313,0.00268990507525065,0.0034764644467645558,0.563963963963964
610,610,너무나/Adverb,552,365,187,0.004057088233332592,0.002076993135926428,0.6612318840579711
611,611,이리/Adverb,552,199,353,0.002211946735433386,0.0039207410533798346,0.6394927536231884
612,612,진/Noun,552,216,336,0.00240090700931463,0.0037319234955683405,0.6086956521739131
613,613,누구/Noun,552,311,241,0.0034568614810039353,0.002676766554857054,0.5634057971014492
614,614,???/Punctuation,551,142,409,0.0015783740524198029,0.004542728302641225,0.7422867513611615
615,615,두/Noun,551,362,189,0.004023742302647667,0.002099206966257192,0.6569872958257713
616,616,다운/Noun,551,275,276,0.00305671031278483,0.003065508585645423,0.5009074410163339
617,617,새롭다/Adjective,549,377,172,0.004190471956072294,0.0019103894084456985,0.6867030965391621
618,618,전쟁/Noun,549,326,223,0.003623591134428562,0.002476842081880179,0.5938069216757741
619,619,건가/Noun,546,124,422,0.0013782984683102506,0.00468711819979119,0.7728937728937729
620,620,아직/Adverb,546,363,183,0.004034857612875975,0.0020325654752649,0.6648351648351648
621,621,생기다/Verb,545,190,355,0.002111908943378609,0.003942954883710598,0.6513761467889908
622,622,상황/Noun,545,243,302,0.002701020385478959,0.003354288379945354,0.5541284403669725
623,623,언제/Noun,545,290,255,0.003223439966209457,0.0028322633671724017,0.5321100917431193
624,624,멀다/Adjective,544,178,366,0.001978525220638908,0.0040651309505298,0.6727941176470589
625,625,작/Modifier,544,183,361,0.0020341017717804503,0.00400959637470289,0.6636029411764706
626,626,소름/Noun,540,437,103,0.004857390569770802,0.0011440122620343426,0.8092592592592592
627,627,심하다/Adjective,539,81,458,0.0009003401284929863,0.005086967145744941,0.8497217068645642
628,628,충분하다/Adjective,539,414,125,0.004601738434519708,0.001388364395672746,0.7680890538033395
629,629,불쌍하다/Adjective,539,206,333,0.0022897539070315448,0.0036986027500721954,0.6178107606679035
630,630,글/Noun,538,195,343,0.002167485494520152,0.0038096719017260148,0.6375464684014871
631,631,식/Suffix,534,210,324,0.002334215147944779,0.003598640513583757,0.6067415730337079
632,632,걸작/Noun,533,459,74,0.005101927394793589,0.0008219117222382655,0.8611632270168855
633,633,그나마/Adverb,532,40,492,0.0004446124091323389,0.005464602261367928,0.924812030075188
634,634,억지/Noun,527,72,455,0.00080030233643821,0.005053646400248795,0.8633776091081594
635,635,대체/Noun,527,89,438,0.000989262610319454,0.004864828842437301,0.8311195445920304
636,636,다큐/Noun,527,223,304,0.002478714180912789,0.003376502210276118,0.5768500948766604
637,637,비슷하다/Adjective,527,264,263,0.0029344419002734373,0.002921118688495457,0.5009487666034156
638,638,시절/Noun,526,397,129,0.004412778160638464,0.0014327920563342734,0.7547528517110266
639,639,등/Noun,526,266,260,0.0029566725207300537,0.002887797942999312,0.5057034220532319
640,640,존나/Noun,525,122,403,0.0013560678478536335,0.004476086811648933,0.7676190476190476
641,641,약간/Noun,525,357,168,0.003968165751506125,0.0018659617477841703,0.68
642,642,역사/Noun,525,318,207,0.0035346686526020947,0.0022991314392340674,0.6057142857142858
643,643,궁금하다/Adjective,524,199,325,0.002211946735433386,0.003609747428749139,0.6202290076335878
644,644,분들/Suffix,524,307,217,0.003412400240090701,0.002410200590887887,0.5858778625954199
645,645,밉다/Adjective,524,257,267,0.002856634728675277,0.0029655463491569853,0.5095419847328244
646,646,실화/Noun,522,331,191,0.003679167685570104,0.0021214207965879555,0.6340996168582376
647,647,인물/Noun,521,236,285,0.0026232132138807995,0.003165470822133861,0.5470249520153551
648,648,예전/Noun,521,277,244,0.003078940933241447,0.0027100873003532,0.5316698656429942
649,649,훨씬/Adverb,521,249,272,0.002767712246848809,0.003021080924983895,0.5220729366602687
650,650,해도/Noun,520,170,350,0.0018896027388124407,0.003887420307883689,0.6730769230769231
651,651,아무/Modifier,518,169,349,0.001878487428584132,0.0038763133927183055,0.6737451737451737
652,652,극/Modifier,518,220,298,0.002445368250227864,0.003309860719283826,0.5752895752895753
653,653,씬/Noun,515,279,236,0.003101171553698064,0.002621231979030144,0.541747572815534
654,654,B/Alpha,514,133,381,0.0014783362603650269,0.00423173467801053,0.7412451361867705
655,655,한마디/Noun,514,156,358,0.0017339883956161216,0.003976275629206745,0.6964980544747081
656,656,6/Number,513,237,276,0.0026343285241091077,0.003065508585645423,0.5380116959064327
657,657,그대로/Noun,512,274,238,0.0030455950025565213,0.0026434458093609076,0.53515625
658,658,어렵다/Adjective,511,267,244,0.002967787830958362,0.0027100873003532,0.5225048923679061
659,659,순수하다/Adjective,506,433,73,0.0048129293288575676,0.0008108048070728836,0.8557312252964426
660,660,휴/Exclamation,506,86,420,0.0009559166796345287,0.004664904369460426,0.8300395256916996
661,661,자기/Noun,506,160,346,0.0017784496365293556,0.0038429926472221604,0.6837944664031621
662,662,누가/Noun,504,180,324,0.002000755841095525,0.003598640513583757,0.6428571428571429
663,663,급/Suffix,504,211,293,0.002345330458173088,0.003254326143456916,0.5813492063492064
664,664,비교/Noun,504,220,284,0.002445368250227864,0.0031543639069684785,0.5634920634920635
665,665,상당하다/Adjective,503,306,197,0.0034012849298623925,0.0021880622875802475,0.6083499005964215
666,666,작/Noun,503,224,279,0.0024898294911410977,0.003098829331141569,0.5546719681908548
667,667,",,,/Punctuation",503,232,271,0.0025787519729675657,0.003009974009818513,0.5387673956262425
668,668,보/Noun,502,287,215,0.0031900940355245318,0.002387986760557123,0.5717131474103586
669,669,니/Noun,502,220,282,0.002445368250227864,0.0031321500766377146,0.5617529880478087
670,670,만점/Noun,501,423,78,0.004701776226574484,0.0008663393828997934,0.844311377245509
671,671,초딩/Noun,501,192,309,0.0021341395638352265,0.003432036786103028,0.6167664670658682
672,672,주/Modifier,501,217,284,0.0024120223195429388,0.0031543639069684785,0.5668662674650699
673,673,비디오/Noun,500,226,274,0.0025120601115977146,0.003043294755314659,0.5479999999999999
674,674,책/Noun,499,238,261,0.0026454438343374164,0.002898904858164693,0.5230460921843687
675,675,간만/Noun,496,400,96,0.004446124091323389,0.0010662638558766688,0.8064516129032258
676,676,쉬다/Verb,496,257,239,0.002856634728675277,0.0026545527245262907,0.5181451612903226
677,677,몇/Modifier,495,218,277,0.002423137629771247,0.003076615500810805,0.5595959595959596
678,678,드리다/Verb,495,270,225,0.0030011337616432875,0.002499055912210943,0.5454545454545454
679,679,필요하다/Adjective,494,325,169,0.003612475824200253,0.0018770686629495524,0.6578947368421053
680,680,부/Noun,494,227,267,0.0025231754218260232,0.0029655463491569853,0.5404858299595142
681,681,만나다/Verb,491,299,192,0.0033234777582642327,0.0021325277117533376,0.6089613034623218
682,682,자/Noun,489,199,290,0.002211946735433386,0.00322100539796077,0.5930470347648262
683,683,라도/Josa,488,145,343,0.0016117199831047284,0.0038096719017260148,0.7028688524590164
684,684,~!/Punctuation,487,385,102,0.004279394437898762,0.0011329053468689607,0.7905544147843943
685,685,CG/Alpha,487,126,361,0.0014005290887668675,0.00400959637470289,0.7412731006160165
686,686,굉장하다/Adjective,486,338,148,0.003756974857168264,0.001643823444476531,0.6954732510288066
687,687,전체/Noun,486,158,328,0.0017562190160727387,0.003643068174245285,0.6748971193415638
688,688,로맨스/Noun,486,243,243,0.002701020385478959,0.002698980385187818,0.5
689,689,떠나다/Verb,484,271,213,0.003012249071871596,0.002365772930226359,0.5599173553719008
690,690,뿐/Suffix,482,150,332,0.0016672965342462707,0.0036874958349068132,0.6887966804979253
691,691,감성/Noun,482,311,171,0.0034568614810039353,0.0018992824932803163,0.6452282157676349
692,692,다음/Noun,482,299,183,0.0033234777582642327,0.0020325654752649,0.6203319502074689
693,693,사회/Noun,481,337,144,0.0037458595469399545,0.0015993957838150033,0.7006237006237006
694,694,오/Modifier,481,187,294,0.0020785630126936845,0.0032654330586222983,0.6112266112266113
695,695,네이버/Noun,480,179,301,0.0019896405308672165,0.003343181464779972,0.6270833333333333
696,696,아들/Noun,480,261,219,0.0029010959695885113,0.0024324144212186506,0.54375
697,697,발연기/Noun,477,34,443,0.0003779205477624881,0.004920363418264211,0.9287211740041929
698,698,무슨/Modifier,476,124,352,0.0013782984683102506,0.003909634138214452,0.7394957983193278
699,699,그런/Modifier,475,189,286,0.002100793633150301,0.0031765777372992424,0.6021052631578947
700,700,ㅜ/KoreanParticle,474,275,199,0.00305671031278483,0.0022102761179110114,0.5801687763713079
701,701,당하다/Adjective,473,184,289,0.002045217082008759,0.003209898482795389,0.6109936575052854
702,702,네/Determiner,472,250,222,0.002778827557077118,0.002465735166714797,0.5296610169491526
703,703,남기다/Verb,471,253,218,0.0028121734877620433,0.0024213075060532693,0.5371549893842887
704,704,따르다/Verb,470,174,296,0.0019340639797256738,0.003287646888953062,0.6297872340425532
705,705,바로/Noun,469,253,216,0.0028121734877620433,0.002399093675722505,0.5394456289978679
706,706,판/Noun,468,203,265,0.00225640797634662,0.002943332518826221,0.5662393162393162
707,707,ㅉㅉ/KoreanParticle,466,72,394,0.00080030233643821,0.004376124575160495,0.8454935622317596
708,708,이르다/Verb,466,177,289,0.0019674099104106,0.003209898482795389,0.6201716738197425
709,709,여배우/Noun,466,198,268,0.002200831425205077,0.002976653264322367,0.575107296137339
710,710,꿈/Noun,465,353,112,0.003923704510592891,0.0012439744985227805,0.7591397849462366
711,711,돌리다/Verb,463,161,302,0.001789564946757664,0.003354288379945354,0.652267818574514
712,712,주제/Noun,463,191,272,0.0021230242536069183,0.003021080924983895,0.5874730021598272
713,713,혼자/Noun,462,213,249,0.0023675610786297045,0.002765621876180109,0.5389610389610391
714,714,에요/Josa,461,357,104,0.003968165751506125,0.0011551191771997243,0.7744034707158352
715,715,나이/Noun,460,314,146,0.00349020741168886,0.0016216096141457672,0.6826086956521739
716,716,반/Modifier,460,206,254,0.0022897539070315448,0.0028211564520070195,0.5521739130434783
717,717,보다는/Josa,459,233,226,0.002589867283195874,0.002510162827376325,0.5076252723311547
718,718,이/Foreign,458,326,132,0.003623591134428562,0.0014661128018304194,0.7117903930131004
719,719,터지다/Verb,458,267,191,0.002967787830958362,0.0021214207965879555,0.5829694323144105
720,720,코/Noun,458,203,255,0.00225640797634662,0.0028322633671724017,0.5567685589519651
721,721,화려하다/Adjective,458,251,207,0.0027899428673054264,0.0022991314392340674,0.5480349344978166
722,722,;;;/Punctuation,457,106,351,0.001178222884200698,0.0038985272230490703,0.7680525164113785
723,723,사랑스럽다/Adjective,456,433,23,0.0048129293288575676,0.0002554590488037852,0.949561403508772
724,724,돋다/Verb,454,348,106,0.0038681279594513476,0.0011773330075304884,0.7665198237885462
725,725,교훈/Noun,454,274,180,0.0030455950025565213,0.001999244729768754,0.6035242290748899
726,726,엄청나다/Adjective,453,290,163,0.003223439966209457,0.001810427171957261,0.6401766004415012
727,727,편이/Noun,450,237,213,0.0026343285241091077,0.002365772930226359,0.5266666666666666
728,728,소설/Noun,449,173,276,0.0019229486694973656,0.003065508585645423,0.6146993318485523
729,729,죠/Josa,448,250,198,0.002778827557077118,0.0021991692027456293,0.5580357142857143
730,730,이라도/Josa,446,106,340,0.001178222884200698,0.0037763511562298687,0.7623318385650224
731,731,잔인하다/Adjective,446,190,256,0.002111908943378609,0.002843370282337784,0.5739910313901345
732,732,감사하다/Verb,445,404,41,0.004490585332236623,0.00045538352178066063,0.907865168539326
733,733,바라다/Verb,444,271,173,0.003012249071871596,0.0019214963236110802,0.6103603603603603
734,734,힘/Noun,443,266,177,0.0029566725207300537,0.001965923984272608,0.6004514672686229
735,735,거의/Noun,443,201,242,0.0022341773558900027,0.002687873470022436,0.54627539503386
736,736,시즌/Noun,442,315,127,0.003501322721917169,0.0014105782260035095,0.7126696832579186
737,737,안보/Noun,442,216,226,0.00240090700931463,0.002510162827376325,0.5113122171945701
738,738,너/Noun,438,183,255,0.0020341017717804503,0.0028322633671724017,0.5821917808219178
739,739,빨리/Adverb,437,191,246,0.0021230242536069183,0.002732301130683964,0.562929061784897
740,740,어/Suffix,437,220,217,0.002445368250227864,0.002410200590887887,0.5034324942791762
741,741,방송/Noun,436,131,305,0.0014561056399084098,0.0033876091254415,0.6995412844036697
742,742,지나다/Verb,435,309,126,0.003434630860547318,0.0013994713108381278,0.7103448275862069
743,743,모든/Modifier,434,259,175,0.0028788653491318944,0.0019437101539418445,0.5967741935483871
744,744,존재/Noun,434,257,177,0.002856634728675277,0.001965923984272608,0.5921658986175116
745,745,년/Noun,434,223,211,0.002478714180912789,0.002343559099895595,0.5138248847926268
746,746,삼류/Noun,433,33,400,0.00036680523753417966,0.004442766066152787,0.9237875288683602
747,747,몇번/Noun,431,334,97,0.00371251361625503,0.0010773707710420508,0.7749419953596288
748,748,진정하다/Adjective,431,313,118,0.003479092101460552,0.001310615989515072,0.7262180974477959
749,749,말고/Josa,431,182,249,0.002022986461552142,0.002765621876180109,0.5777262180974478
750,750,타다/Verb,431,214,217,0.0023786763888580128,0.002410200590887887,0.5034802784222738
751,751,독특하다/Adjective,429,293,136,0.0032567858968943824,0.0015105404624919474,0.6829836829836831
752,752,잡다/Verb,429,149,280,0.0016561812240179624,0.003109936246306951,0.6526806526806527
753,753,죽/Noun,428,138,290,0.0015339128115065689,0.00322100539796077,0.677570093457944
754,754,....../Punctuation,427,155,272,0.0017228730853878133,0.003021080924983895,0.6370023419203747
755,755,당신/Noun,427,243,184,0.002701020385478959,0.0020436723904302817,0.5690866510538641
756,756,+/Punctuation,426,174,252,0.0019340639797256738,0.002798942621676256,0.5915492957746479
757,757,목소리/Noun,426,184,242,0.002045217082008759,0.002687873470022436,0.5680751173708921
758,758,여주/Noun,424,130,294,0.001444990329680101,0.0032654330586222983,0.6933962264150944
759,759,담다/Verb,424,278,146,0.003090056243469755,0.0016216096141457672,0.6556603773584906
760,760,가볍다/Adjective,423,287,136,0.0031900940355245318,0.0015105404624919474,0.6784869976359338
761,761,만하/Noun,422,212,210,0.002356445768401396,0.002332452184730213,0.5023696682464455
762,762,질질/Noun,419,72,347,0.00080030233643821,0.003854099562387543,0.8281622911694511
763,763,전부/Noun,418,133,285,0.0014783362603650269,0.003165470822133861,0.6818181818181818
764,764,바/Noun,418,165,253,0.0018340261876708976,0.0028100495368416373,0.6052631578947368
765,765,줄거리/Noun,417,136,281,0.0015116821910499524,0.0031210431614723325,0.6738609112709832
766,766,맛/Noun,417,190,227,0.002111908943378609,0.0025212697425417065,0.5443645083932853
767,767,흥미롭다/Adjective,417,215,202,0.002389791699086321,0.0022435968634071574,0.5155875299760192
768,768,신/Noun,416,182,234,0.002022986461552142,0.0025990181486993803,0.5625
769,769,라니/Josa,416,226,190,0.0025120601115977146,0.0021103138814225733,0.5432692307692307
770,770,점주/Noun,415,98,317,0.0010893004023742304,0.0035208921074260835,0.763855421686747
771,771,실제/Noun,415,250,165,0.002778827557077118,0.0018326410022880247,0.6024096385542169
772,772,풀다/Verb,415,214,201,0.0023786763888580128,0.0022324899482417753,0.5156626506024097
773,773,망치다/Verb,414,42,372,0.00046684302958895584,0.004131772441522092,0.8985507246376812
774,774,답/Noun,413,100,313,0.0011115310228308473,0.0034764644467645558,0.7578692493946732
775,775,넘치다/Adjective,412,298,114,0.003312362448035925,0.001266188328853544,0.7233009708737864
776,776,에선/Josa,411,226,185,0.0025120601115977146,0.002054779305595664,0.5498783454987834
777,777,성하다/Adjective,410,37,373,0.00041126647844741344,0.0041428793566874724,0.9097560975609756
778,778,그러나/Conjunction,409,204,205,0.0022675232865749283,0.002276917608903303,0.5012224938875306
779,779,낭비/Noun,408,8,400,8.892248182646779e-05,0.004442766066152787,0.9803921568627452
780,780,뜨다/Verb,408,147,261,0.0016339506035613453,0.002898904858164693,0.6397058823529411
781,781,으로도/Josa,408,240,168,0.002667674454794033,0.0018659617477841703,0.5882352941176471
782,782,이번/Noun,408,215,193,0.002389791699086321,0.00214363462691872,0.5269607843137255
783,783,각본/Noun,407,121,286,0.001344952537625325,0.0031765777372992424,0.7027027027027027
784,784,나라/Noun,407,193,214,0.002145254874063535,0.002376879845391741,0.5257985257985258
785,785,맞추다/Verb,404,109,295,0.0012115688148856235,0.00327653997378768,0.7301980198019802
786,786,재/Noun,401,255,146,0.002834404108218661,0.0016216096141457672,0.6359102244389028
787,787,필요/Noun,401,226,175,0.0025120601115977146,0.0019437101539418445,0.5635910224438903
788,788,가치/Noun,401,207,194,0.002300869217259854,0.002154741542084101,0.5162094763092271
789,789,성룡/Noun,398,235,163,0.002612097903652491,0.001810427171957261,0.5904522613065326
790,790,란/Noun,398,215,183,0.002389791699086321,0.0020325654752649,0.5402010050251256
791,791,순간/Noun,397,263,134,0.002923326590045128,0.0014883266321611835,0.6624685138539043
792,792,어른/Noun,397,249,148,0.002767712246848809,0.001643823444476531,0.6272040302267002
793,793,평론가/Noun,397,239,158,0.002656559144565725,0.0017548925961303507,0.6020151133501259
794,794,갑자기/Noun,396,103,293,0.0011448769535157724,0.003254326143456916,0.73989898989899
795,795,제작/Noun,396,143,253,0.0015894893626481115,0.0028100495368416373,0.6388888888888888
796,796,판타지/Noun,396,181,215,0.0020118711513238334,0.002387986760557123,0.5429292929292929
797,797,이하/Noun,395,34,361,0.0003779205477624881,0.00400959637470289,0.9139240506329114
798,798,선/Noun,395,188,207,0.0020896783229219927,0.0022991314392340674,0.5240506329113924
799,799,상영/Noun,393,197,196,0.002189716114976769,0.0021769553724148654,0.5012722646310432
800,800,기다리다/Verb,392,279,113,0.003101171553698064,0.0012550814136881624,0.7117346938775511
801,801,간다/Noun,392,151,241,0.0016784118444745793,0.002676766554857054,0.6147959183673469
802,802,너무하다/Adjective,390,50,340,0.0005557655114154236,0.0037763511562298687,0.8717948717948718
803,803,의도/Noun,390,66,324,0.0007336104750683593,0.003598640513583757,0.8307692307692308
804,804,발/Noun,390,81,309,0.0009003401284929863,0.003432036786103028,0.7923076923076923
805,805,영/Noun,390,107,283,0.0011893381944290064,0.0031432569918030968,0.7256410256410256
806,806,시청률/Noun,390,206,184,0.0022897539070315448,0.0020436723904302817,0.5282051282051282
807,807,밑/Noun,388,119,269,0.0013227219171687082,0.0029877601794877488,0.6932989690721649
808,808,TV/Alpha,388,158,230,0.0017562190160727387,0.002554590488037853,0.5927835051546392
809,809,땜/Noun,387,126,261,0.0014005290887668675,0.002898904858164693,0.6744186046511628
810,810,넣다/Verb,385,86,299,0.0009559166796345287,0.0033209676344492078,0.7766233766233767
811,811,아버지/Noun,385,261,124,0.0029010959695885113,0.0013772574805073642,0.6779220779220779
812,812,히/Adverb,385,222,163,0.0024675988706844808,0.001810427171957261,0.5766233766233766
813,813,단순하다/Adjective,385,218,167,0.002423137629771247,0.0018548548326187888,0.5662337662337662
814,814,다른/Modifier,385,175,210,0.0019451792899539827,0.002332452184730213,0.5454545454545454
815,815,오글거리다/Verb,384,63,321,0.0007002645443834338,0.0035653197680876117,0.8359375
816,816,보내다/Verb,384,257,127,0.002856634728675277,0.0014105782260035095,0.6692708333333334
817,817,만들어지다/Verb,384,249,135,0.002767712246848809,0.0014994335473265655,0.6484375
818,818,한편/Noun,384,232,152,0.0025787519729675657,0.001688251105138059,0.6041666666666666
819,819,피/Noun,384,156,228,0.0017339883956161216,0.0025323766577070887,0.59375
820,820,상/Suffix,383,204,179,0.0022675232865749283,0.001988137814603372,0.5326370757180157
821,821,굳다/Adjective,381,349,32,0.003879243269679657,0.00035542128529222287,0.9160104986876642
822,822,요소/Noun,381,194,187,0.0021563701842918434,0.002076993135926428,0.5091863517060368
823,823,이기다/Verb,381,187,194,0.0020785630126936845,0.002154741542084101,0.5091863517060368
824,824,볼때/Noun,380,276,104,0.0030678256230131378,0.0011551191771997243,0.7263157894736842
825,825,바꾸다/Verb,379,143,236,0.0015894893626481115,0.002621231979030144,0.6226912928759895
826,826,들어가다/Verb,379,156,223,0.0017339883956161216,0.002476842081880179,0.5883905013192612
827,827,힘드다/Adjective,378,165,213,0.0018340261876708976,0.002365772930226359,0.5634920634920635
828,828,화면/Noun,378,168,210,0.0018673721183558234,0.002332452184730213,0.5555555555555556
829,829,면/Noun,377,205,172,0.002278638596803237,0.0019103894084456985,0.5437665782493368
830,830,10년/Number,376,276,100,0.0030678256230131378,0.0011106915165381968,0.7340425531914894
831,831,세계/Noun,376,224,152,0.0024898294911410977,0.001688251105138059,0.5957446808510638
832,832,달다/Verb,376,176,200,0.001956294600182291,0.0022213830330763936,0.5319148936170213
833,833,에서도/Josa,375,204,171,0.0022675232865749283,0.0018992824932803163,0.544
834,834,첨/Adverb,374,111,263,0.0012337994353422404,0.002921118688495457,0.7032085561497327
835,835,막/Noun,373,133,240,0.0014783362603650269,0.002665659639691672,0.6434316353887399
836,836,흥행/Noun,373,171,202,0.001900718049040749,0.0022435968634071574,0.5415549597855228
837,837,구/Noun,373,184,189,0.002045217082008759,0.002099206966257192,0.5067024128686327
838,838,일단/Noun,372,184,188,0.002045217082008759,0.0020881000510918103,0.5053763440860215
839,839,그때/Noun,371,269,102,0.002990018451414979,0.0011329053468689607,0.7250673854447439
840,840,항상/Noun,371,247,124,0.002745481626392193,0.0013772574805073642,0.6657681940700808
841,841,갖다/Verb,371,162,209,0.0018006802569859727,0.002321345269564831,0.5633423180592992
842,842,좀비/Noun,370,127,243,0.001411644398995176,0.002698980385187818,0.6567567567567567
843,843,평/Noun,370,164,206,0.0018229108774425891,0.002288024524068685,0.5567567567567567
844,844,치고/Josa,368,112,256,0.0012449147455705488,0.002843370282337784,0.6956521739130435
845,845,둘/Noun,368,189,179,0.002100793633150301,0.001988137814603372,0.5135869565217391
846,846,뻔/Noun,367,98,269,0.0010893004023742304,0.0029877601794877488,0.7329700272479565
847,847,선택/Noun,367,176,191,0.001956294600182291,0.0021214207965879555,0.5204359673024523
848,848,스타일/Noun,367,181,186,0.0020118711513238334,0.002065886220761046,0.5068119891008175
849,849,거지/Noun,366,99,267,0.0011004157126025386,0.0029655463491569853,0.7295081967213115
850,850,곳/Noun,365,245,120,0.002723251005935576,0.001332829819845836,0.6712328767123288
851,851,원/Modifier,364,158,206,0.0017562190160727387,0.002288024524068685,0.5659340659340659
852,852,역대/Noun,364,192,172,0.0021341395638352265,0.0019103894084456985,0.5274725274725275
853,853,인거/Josa,363,176,187,0.001956294600182291,0.002076993135926428,0.5151515151515151
854,854,에서는/Josa,362,194,168,0.0021563701842918434,0.0018659617477841703,0.5359116022099447
855,855,짱/Suffix,361,320,41,0.003556899273058711,0.00045538352178066063,0.8864265927977839
856,856,성/Modifier,361,130,231,0.001444990329680101,0.0025656974032032343,0.6398891966759003
857,857,진행/Noun,360,97,263,0.0010781850921459217,0.002921118688495457,0.7305555555555555
858,858,라서/Josa,360,173,187,0.0019229486694973656,0.002076993135926428,0.5194444444444445
859,859,멜로/Noun,360,181,179,0.0020118711513238334,0.001988137814603372,0.5027777777777778
860,860,동안/Noun,359,206,153,0.0022897539070315448,0.001699358020303441,0.5738161559888579
861,861,확실하다/Adjective,359,185,174,0.002056332392237067,0.0019326032387764625,0.5153203342618384
862,862,이에요/Josa,358,286,72,0.003178978725296223,0.0007996978919075017,0.7988826815642458
863,863,더욱/Noun,358,281,77,0.0031234021741546806,0.0008552324677344116,0.7849162011173184
864,864,tv/Alpha,358,103,255,0.0011448769535157724,0.0028322633671724017,0.7122905027932961
865,865,낫다/Noun,358,124,234,0.0013782984683102506,0.0025990181486993803,0.6536312849162011
866,866,탄탄하다/Adjective,357,320,37,0.003556899273058711,0.0004109558611191328,0.8963585434173671
867,867,돋보이다/Verb,357,275,82,0.00305671031278483,0.0009107670435613213,0.7703081232492998
868,868,초/Noun,357,148,209,0.0016450659137896538,0.002321345269564831,0.5854341736694678
869,869,극장판/Noun,357,194,163,0.0021563701842918434,0.001810427171957261,0.5434173669467787
870,870,어이/Noun,355,29,326,0.0003223439966209457,0.003620854343914521,0.9183098591549296
871,871,상미/Noun,355,237,118,0.0026343285241091077,0.001310615989515072,0.6676056338028169
872,872,래/Josa,355,138,217,0.0015339128115065689,0.002410200590887887,0.6112676056338028
873,873,가보다/Verb,355,163,192,0.001811795567214281,0.0021325277117533376,0.5408450704225352
874,874,참고/Noun,354,65,289,0.0007224951648400508,0.003209898482795389,0.8163841807909604
875,875,불편하다/Adjective,354,99,255,0.0011004157126025386,0.0028322633671724017,0.7203389830508474
876,876,중국/Noun,354,122,232,0.0013560678478536335,0.0025768043183686164,0.655367231638418
877,877,완성/Noun,354,212,142,0.002356445768401396,0.0015771819534842392,0.5988700564971752
878,878,딸/Noun,354,158,196,0.0017562190160727387,0.0021769553724148654,0.5536723163841808
879,879,몇/Noun,353,222,131,0.0024675988706844808,0.0014550058866650375,0.6288951841359773
880,880,흐르다/Verb,352,282,70,0.003134517484382989,0.0007774840615767378,0.8011363636363636
881,881,그녀/Noun,352,266,86,0.0029566725207300537,0.0009551947042228492,0.7556818181818182
882,882,억지스럽다/Adjective,351,50,301,0.0005557655114154236,0.003343181464779972,0.8575498575498576
883,883,걸리다/Verb,351,96,255,0.0010670697819176133,0.0028322633671724017,0.7264957264957265
884,884,끼다/Verb,351,101,250,0.0011226463330591557,0.002776728791345492,0.7122507122507122
885,885,올리다/Verb,351,186,165,0.0020674477024653763,0.0018326410022880247,0.5299145299145299
886,886,즐기다/Verb,350,239,111,0.002656559144565725,0.0012328675833573985,0.6828571428571428
887,887,물론/Adverb,350,195,155,0.002167485494520152,0.0017215718506342046,0.5571428571428572
888,888,세/Noun,350,161,189,0.001789564946757664,0.002099206966257192,0.54
889,889,세/Modifier,349,186,163,0.0020674477024653763,0.001810427171957261,0.5329512893982808
890,890,거기/Noun,348,120,228,0.0013338372273970164,0.0025323766577070887,0.6551724137931034
891,891,부르다/Verb,348,172,176,0.0019118333592690567,0.001954817069107226,0.5057471264367817
892,892,점점/Noun,347,138,209,0.0015339128115065689,0.002321345269564831,0.6023054755043228
893,893,듣다/Verb,346,185,161,0.002056332392237067,0.001788213341626497,0.5346820809248555
894,894,이냐/Josa,345,47,298,0.0005224195807304982,0.003309860719283826,0.8637681159420291
895,895,수가/Noun,345,151,194,0.0016784118444745793,0.002154741542084101,0.5623188405797102
896,896,허무하다/Adjective,344,85,259,0.0009448013694062199,0.002876691027833929,0.7529069767441859
897,897,어디서/Adverb,343,123,220,0.001367183158081942,0.0024435213363840328,0.641399416909621
898,898,관람/Noun,343,149,194,0.0016561812240179624,0.002154741542084101,0.5655976676384841
899,899,술/Noun,342,58,284,0.0006446879932418914,0.0031543639069684785,0.8304093567251462
900,900,전형/Noun,342,64,278,0.0007113798546117423,0.0030877224159761873,0.8128654970760234
901,901,똑같다/Adjective,341,86,255,0.0009559166796345287,0.0028322633671724017,0.7478005865102639
902,902,편집/Noun,340,103,237,0.0011448769535157724,0.0026323388941955268,0.6970588235294117
903,903,조/Modifier,340,169,171,0.001878487428584132,0.0018992824932803163,0.5029411764705882
904,904,잠/Noun,339,82,257,0.0009114554387212947,0.0028544771975031647,0.7581120943952803
905,905,프랑스/Noun,339,185,154,0.002056332392237067,0.0017104649354688231,0.5457227138643068
906,906,사건/Noun,337,130,207,0.001444990329680101,0.0022991314392340674,0.6142433234421365
907,907,쯤/Suffix,336,199,137,0.002211946735433386,0.0015216473776573296,0.5922619047619048
908,908,화보/Noun,335,124,211,0.0013782984683102506,0.002343559099895595,0.6298507462686567
909,909,잃다/Verb,335,152,183,0.0016895271547028878,0.0020325654752649,0.5462686567164179
910,910,화이팅/Noun,334,296,38,0.003290131827579308,0.0004220627762845148,0.8862275449101796
911,911,때리다/Verb,334,116,218,0.0012893759864837828,0.0024213075060532693,0.6526946107784432
912,912,짧다/Adjective,334,217,117,0.0024120223195429388,0.0012995090743496902,0.6497005988023952
913,913,드/Noun,334,183,151,0.0020341017717804503,0.001677144189972677,0.5479041916167665
914,914,에/Foreign,334,155,179,0.0017228730853878133,0.001988137814603372,0.5359281437125748
915,915,식상하다/Adjective,333,37,296,0.00041126647844741344,0.003287646888953062,0.8888888888888888
916,916,마르다/Adjective,333,116,217,0.0012893759864837828,0.002410200590887887,0.6516516516516516
917,917,리/Noun,333,148,185,0.0016450659137896538,0.002054779305595664,0.5555555555555556
918,918,메다/Verb,332,150,182,0.0016672965342462707,0.002021458560099518,0.5481927710843374
919,919,평범하다/Adjective,332,154,178,0.0017117577751595047,0.0019770308994379896,0.536144578313253
920,920,찾아보다/Verb,331,168,163,0.0018673721183558234,0.001810427171957261,0.5075528700906344
921,921,꿀잼/Noun,330,316,14,0.003512438032145477,0.0001554968123153475,0.9575757575757576
922,922,똥/Noun,330,29,301,0.0003223439966209457,0.003343181464779972,0.912121212121212
923,923,그게/Noun,330,91,239,0.001011493230776071,0.0026545527245262907,0.7242424242424242
924,924,갈다/Verb,330,170,160,0.0018896027388124407,0.0017771064264611148,0.5151515151515151
925,925,아빠/Noun,330,162,168,0.0018006802569859727,0.0018659617477841703,0.509090909090909
926,926,가지다/Verb,329,198,131,0.002200831425205077,0.0014550058866650375,0.6018237082066871
927,927,키/Noun,329,152,177,0.0016895271547028878,0.001965923984272608,0.5379939209726444
928,928,중반/Noun,328,125,203,0.001389413778538559,0.002254703778572539,0.6189024390243902
929,929,취향/Noun,328,127,201,0.001411644398995176,0.0022324899482417753,0.6128048780487805
930,930,역/Noun,328,160,168,0.0017784496365293556,0.0018659617477841703,0.5121951219512195
931,931,-_-/Punctuation,327,38,289,0.000422381788675722,0.003209898482795389,0.8837920489296636
932,932,개그/Noun,327,99,228,0.0011004157126025386,0.0025323766577070887,0.6972477064220184
933,933,싸우다/Verb,327,124,203,0.0013782984683102506,0.002254703778572539,0.6207951070336392
934,934,뭐라다/Verb,327,141,186,0.0015672587421914947,0.002065886220761046,0.5688073394495413
935,935,감상/Noun,327,185,142,0.002056332392237067,0.0015771819534842392,0.5657492354740061
936,936,마무리/Noun,327,148,179,0.0016450659137896538,0.001988137814603372,0.5474006116207951
937,937,사/Modifier,327,164,163,0.0018229108774425891,0.001810427171957261,0.5015290519877675
938,938,엉망/Noun,326,22,304,0.00024453682502278637,0.003376502210276118,0.9325153374233128
939,939,병맛/Noun,326,57,269,0.0006335726830135829,0.0029877601794877488,0.8251533742331288
940,940,티/Noun,325,91,234,0.001011493230776071,0.0025990181486993803,0.72
941,941,적당하다/Adjective,325,106,219,0.001178222884200698,0.0024324144212186506,0.6738461538461539
942,942,복수/Noun,325,128,197,0.0014227597092234846,0.0021880622875802475,0.6061538461538462
943,943,대로/Josa,325,143,182,0.0015894893626481115,0.002021458560099518,0.56
944,944,뛰어나다/Adjective,324,238,86,0.0026454438343374164,0.0009551947042228492,0.7345679012345679
945,945,관/Noun,324,221,103,0.0024564835604561725,0.0011440122620343426,0.6820987654320988
946,946,걸다/Verb,324,116,208,0.0012893759864837828,0.0023102383543994486,0.6419753086419753
947,947,ㄷㄷ/KoreanParticle,324,200,124,0.0022230620456616945,0.0013772574805073642,0.6172839506172839
948,948,액션영화/Noun,324,192,132,0.0021341395638352265,0.0014661128018304194,0.5925925925925926
949,949,난/Josa,324,152,172,0.0016895271547028878,0.0019103894084456985,0.5308641975308642
950,950,소/Modifier,324,169,155,0.001878487428584132,0.0017215718506342046,0.5216049382716049
951,951,지겹다/Adjective,323,29,294,0.0003223439966209457,0.0032654330586222983,0.9102167182662538
952,952,미화/Noun,323,44,279,0.0004890736500455726,0.003098829331141569,0.8637770897832817
953,953,~!!/Punctuation,323,253,70,0.0028121734877620433,0.0007774840615767378,0.7832817337461301
954,954,흥미/Noun,323,125,198,0.001389413778538559,0.0021991692027456293,0.6130030959752322
955,955,//Punctuation,323,130,193,0.001444990329680101,0.00214363462691872,0.5975232198142415
956,956,예상/Noun,323,138,185,0.0015339128115065689,0.002054779305595664,0.5727554179566563
957,957,자극/Noun,323,174,149,0.0019340639797256738,0.001654930359641913,0.5386996904024768
958,958,헐다/Verb,322,92,230,0.0010226085410043797,0.002554590488037853,0.7142857142857143
959,959,몸/Noun,322,132,190,0.0014672209501367186,0.0021103138814225733,0.5900621118012422
960,960,과/Noun,322,138,184,0.0015339128115065689,0.0020436723904302817,0.5714285714285714
961,961,간/Suffix,322,178,144,0.001978525220638908,0.0015993957838150033,0.5527950310559007
962,962,흥미진진/Noun,321,276,45,0.0030678256230131378,0.0004998111824421885,0.8598130841121495
963,963,거리/Noun,321,142,179,0.0015783740524198029,0.001988137814603372,0.557632398753894
964,964,원래/Noun,321,149,172,0.0016561812240179624,0.0019103894084456985,0.5358255451713395
965,965,손/Noun,320,175,145,0.0019451792899539827,0.001610502698980385,0.546875
966,966,중요하다/Adjective,320,151,169,0.0016784118444745793,0.0018770686629495524,0.528125
967,967,훈훈하다/Adjective,319,281,38,0.0031234021741546806,0.0004220627762845148,0.8808777429467085
968,968,여서/Josa,319,132,187,0.0014672209501367186,0.002076993135926428,0.5862068965517241
969,969,잘만/Noun,318,239,79,0.002656559144565725,0.0008774462980651753,0.7515723270440252
970,970,에겐/Josa,317,194,123,0.0021563701842918434,0.001366150565341982,0.61198738170347
971,971,노력/Noun,317,132,185,0.0014672209501367186,0.002054779305595664,0.583596214511041
972,972,만으로도/Josa,316,285,31,0.0031678634150679144,0.00034431437012684104,0.9018987341772152
973,973,낫다/Verb,316,91,225,0.001011493230776071,0.002499055912210943,0.7120253164556962
974,974,나르다/Verb,316,224,92,0.0024898294911410977,0.0010218361952151409,0.7088607594936709
975,975,학교/Noun,316,192,124,0.0021341395638352265,0.0013772574805073642,0.6075949367088608
976,976,비추다/Verb,315,48,267,0.0005335348909588066,0.0029655463491569853,0.8476190476190476
977,977,괜히/Adverb,315,80,235,0.0008892248182646778,0.002610125063864762,0.7460317460317459
978,978,또한/Noun,315,208,107,0.002311984527488162,0.0011884399226958706,0.6603174603174603
979,979,과거/Noun,315,196,119,0.0021786008047484607,0.0013217229046804538,0.6222222222222222
980,980,오/Noun,315,182,133,0.002022986461552142,0.0014772197169958016,0.5777777777777777
981,981,배/Noun,315,144,171,0.00160060467287642,0.0018992824932803163,0.5428571428571428
982,982,그래픽/Noun,314,78,236,0.0008669941978080608,0.002621231979030144,0.7515923566878981
983,983,ost/Alpha,313,265,48,0.002945557210501745,0.0005331319279383344,0.8466453674121406
984,984,그냥/Modifier,313,87,226,0.0009670319898628369,0.002510162827376325,0.7220447284345048
985,985,이라니/Josa,313,116,197,0.0012893759864837828,0.0021880622875802475,0.6293929712460063
986,986,무/Noun,313,127,186,0.001411644398995176,0.002065886220761046,0.5942492012779552
987,987,그만/Adverb,312,21,291,0.00023342151479447792,0.0032321123131261523,0.9326923076923076
988,988,장/Suffix,312,89,223,0.000989262610319454,0.002476842081880179,0.7147435897435898
989,989,20/Number,312,211,101,0.002345330458173088,0.0011217984317035787,0.6762820512820513
990,990,바보/Noun,311,85,226,0.0009448013694062199,0.002510162827376325,0.7266881028938906
991,991,성우/Noun,310,70,240,0.000778071715981593,0.002665659639691672,0.7741935483870968
992,992,봣/Noun,308,207,101,0.002300869217259854,0.0011217984317035787,0.6720779220779219
993,993,소중하다/Adjective,307,226,81,0.0025120601115977146,0.0008996601283959392,0.7361563517915309
994,994,죽음/Noun,307,206,101,0.0022897539070315448,0.0011217984317035787,0.6710097719869706
995,995,대한민국/Noun,307,185,122,0.002056332392237067,0.0013550436501765998,0.6026058631921825
996,996,연기자/Noun,307,153,154,0.0017006424649311962,0.0017104649354688231,0.501628664495114
997,997,유치/Noun,306,21,285,0.00023342151479447792,0.003165470822133861,0.931372549019608
998,998,나서다/Verb,306,139,167,0.0015450281217348775,0.0018548548326187888,0.5457516339869279
999,999,도저히/Noun,305,26,279,0.00028899806593602026,0.003098829331141569,0.9147540983606556
1000,1000,한심하다/Adjective,305,33,272,0.00036680523753417966,0.003021080924983895,0.8918032786885246
1001,1001,식/Noun,305,72,233,0.00080030233643821,0.002587911233533998,0.7639344262295082
1002,1002,속편/Noun,305,99,206,0.0011004157126025386,0.002288024524068685,0.6754098360655738
1003,1003,씩/Suffix,305,164,141,0.0018229108774425891,0.0015660750383188573,0.5377049180327869
1004,1004,오히려/Noun,305,154,151,0.0017117577751595047,0.001677144189972677,0.5049180327868853
1005,1005,한/Modifier,305,152,153,0.0016895271547028878,0.001699358020303441,0.5016393442622951
1006,1006,역겹다/Adjective,304,37,267,0.00041126647844741344,0.0029655463491569853,0.8782894736842105
1007,1007,울/Noun,304,228,76,0.0025342907320543315,0.0008441255525690295,0.75
1008,1008,무조건/Noun,304,193,111,0.002145254874063535,0.0012328675833573985,0.6348684210526315
1009,1009,닿다/Verb,303,192,111,0.0021341395638352265,0.0012328675833573985,0.6336633663366337
1010,1010,전달/Noun,303,115,188,0.0012782606762554744,0.0020881000510918103,0.6204620462046204
1011,1011,땐/Noun,303,183,120,0.0020341017717804503,0.001332829819845836,0.6039603960396039
1012,1012,상상/Noun,303,173,130,0.0019229486694973656,0.0014438989714996556,0.570957095709571
1013,1013,고/Noun,303,152,151,0.0016895271547028878,0.001677144189972677,0.5016501650165016
1014,1014,보이/Noun,302,130,172,0.001444990329680101,0.0019103894084456985,0.5695364238410596
1015,1015,다루다/Verb,302,158,144,0.0017562190160727387,0.0015993957838150033,0.5231788079470199
1016,1016,천재/Noun,301,236,65,0.0026232132138807995,0.0007219494857498278,0.7840531561461794
1017,1017,설명/Noun,301,133,168,0.0014783362603650269,0.0018659617477841703,0.5581395348837209
1018,1018,억지로/Noun,300,42,258,0.00046684302958895584,0.002865584112668547,0.86
1019,1019,우연히/Adverb,300,258,42,0.0028677500389035857,0.00046649043694604257,0.86
1020,1020,심리/Noun,300,207,93,0.002300869217259854,0.001032943110380523,0.69
1021,1021,화가/Noun,299,75,224,0.0008336482671231353,0.0024879489970455605,0.7491638795986622
1022,1022,강하다/Adjective,299,187,112,0.0020785630126936845,0.0012439744985227805,0.6254180602006689
1023,1023,댓글/Noun,297,75,222,0.0008336482671231353,0.002465735166714797,0.7474747474747475
1024,1024,자꾸/Noun,297,119,178,0.0013227219171687082,0.0019770308994379896,0.5993265993265994
1025,1025,한다는/Modifier,297,150,147,0.0016672965342462707,0.0016327165293111491,0.5050505050505051
1026,1026,속/Modifier,296,73,223,0.0008114176466665183,0.002476842081880179,0.7533783783783784
1027,1027,아무/Noun,296,116,180,0.0012893759864837828,0.001999244729768754,0.6081081081081081
1028,1028,타임/Noun,296,130,166,0.001444990329680101,0.0018437479174534066,0.5608108108108109
1029,1029,개다/Verb,295,73,222,0.0008114176466665183,0.002465735166714797,0.7525423728813561
1030,1030,새끼/Noun,295,80,215,0.0008892248182646778,0.002387986760557123,0.7288135593220338
1031,1031,척/Noun,294,58,236,0.0006446879932418914,0.002621231979030144,0.8027210884353742
1032,1032,예고편/Noun,294,69,225,0.0007669564057532844,0.002499055912210943,0.7653061224489796
1033,1033,다가/Noun,293,91,202,0.001011493230776071,0.0022435968634071574,0.6894197952218429
1034,1034,최근/Noun,293,195,98,0.002167485494520152,0.001088477686207433,0.6655290102389079
1035,1035,길다/Adjective,293,136,157,0.0015116821910499524,0.0017437856809649687,0.5358361774744027
1036,1036,구/Modifier,293,152,141,0.0016895271547028878,0.0015660750383188573,0.5187713310580204
1037,1037,법/Noun,293,142,151,0.0015783740524198029,0.001677144189972677,0.5153583617747439
1038,1038,현/Modifier,292,181,111,0.0020118711513238334,0.0012328675833573985,0.6198630136986302
1039,1039,good/Alpha,291,213,78,0.0023675610786297045,0.0008663393828997934,0.7319587628865979
1040,1040,어느/Modifier,291,104,187,0.001155992263744081,0.002076993135926428,0.6426116838487973
1041,1041,그림/Noun,291,164,127,0.0018229108774425891,0.0014105782260035095,0.5635738831615121
1042,1042,잊혀지다/Verb,289,255,34,0.002834404108218661,0.00037763511562298685,0.8823529411764706
1043,1043,불륜/Noun,289,75,214,0.0008336482671231353,0.002376879845391741,0.740484429065744
1044,1044,젠/Noun,289,80,209,0.0008892248182646778,0.002321345269564831,0.7231833910034602
1045,1045,터/Noun,289,126,163,0.0014005290887668675,0.001810427171957261,0.5640138408304498
1046,1046,대작/Noun,288,231,57,0.002567636662739257,0.0006330941644267722,0.8020833333333334
1047,1047,짐/Noun,288,189,99,0.002100793633150301,0.0010995846013728146,0.65625
1048,1048,다니다/Verb,288,105,183,0.0011671075739723895,0.0020325654752649,0.6354166666666666
1049,1049,무비/Noun,288,124,164,0.0013782984683102506,0.0018215340871226425,0.5694444444444444
1050,1050,불다/Verb,288,127,161,0.001411644398995176,0.001788213341626497,0.5590277777777778
1051,1051,SF/Alpha,288,149,139,0.0016561812240179624,0.0015438612079880936,0.5173611111111112
1052,1052,스타/Noun,288,147,141,0.0016339506035613453,0.0015660750383188573,0.5104166666666666
1053,1053,미안하다/Adjective,287,74,213,0.0008225329568948269,0.002365772930226359,0.7421602787456446
1054,1054,촬영/Noun,287,121,166,0.001344952537625325,0.0018437479174534066,0.5783972125435539
1055,1055,전편/Noun,287,125,162,0.001389413778538559,0.0017993202567918784,0.5644599303135889
1056,1056,열/Noun,286,78,208,0.0008669941978080608,0.0023102383543994486,0.7272727272727273
1057,1057,90년/Number,286,134,152,0.001489451570593335,0.001688251105138059,0.5314685314685315
1058,1058,올/Modifier,286,136,150,0.0015116821910499524,0.001666037274807295,0.5244755244755245
1059,1059,2시간/Number,285,95,190,0.0010559544716893046,0.0021103138814225733,0.6666666666666666
1060,1060,표정/Noun,285,161,124,0.001789564946757664,0.0013772574805073642,0.5649122807017544
1061,1061,동/Modifier,285,124,161,0.0013782984683102506,0.001788213341626497,0.5649122807017544
1062,1062,기억나다/Verb,285,157,128,0.00174510370584443,0.0014216851411688915,0.5508771929824562
1063,1063,아저씨/Noun,285,155,130,0.0017228730853878133,0.0014438989714996556,0.543859649122807
1064,1064,게임/Noun,284,97,187,0.0010781850921459217,0.002076993135926428,0.6584507042253521
1065,1065,행동/Noun,284,103,181,0.0011448769535157724,0.002010351644934136,0.6373239436619719
1066,1066,고/Modifier,284,123,161,0.001367183158081942,0.001788213341626497,0.5669014084507042
1067,1067,길/Noun,284,140,144,0.001556143431963186,0.0015993957838150033,0.5070422535211268
1068,1068,실망하다/Adjective,283,60,223,0.0006669186136985082,0.002476842081880179,0.7879858657243817
1069,1069,짓/Noun,283,70,213,0.000778071715981593,0.002365772930226359,0.7526501766784452
1070,1070,환상/Noun,283,207,76,0.002300869217259854,0.0008441255525690295,0.7314487632508834
1071,1071,여/Noun,283,178,105,0.001978525220638908,0.0011662260923651065,0.6289752650176679
1072,1072,메세지/Noun,283,143,140,0.0015894893626481115,0.0015549681231534756,0.5053003533568905
1073,1073,오래/Adverb,282,230,52,0.002556521352510949,0.0005775595885998622,0.8156028368794326
1074,1074,작다/Adjective,281,156,125,0.0017339883956161216,0.001388364395672746,0.5551601423487544
1075,1075,결혼/Noun,281,130,151,0.001444990329680101,0.001677144189972677,0.5373665480427047
1076,1076,참신하다/Adjective,281,149,132,0.0016561812240179624,0.0014661128018304194,0.5302491103202847
1077,1077,그닥/Noun,280,25,255,0.0002778827557077118,0.0028322633671724017,0.9107142857142856
1078,1078,귀신/Noun,280,71,209,0.0007891870262099014,0.002321345269564831,0.7464285714285714
1079,1079,전설/Noun,280,175,105,0.0019451792899539827,0.0011662260923651065,0.625
1080,1080,입/Noun,280,115,165,0.0012782606762554744,0.0018326410022880247,0.5892857142857143
1081,1081,조연/Noun,280,137,143,0.0015227975012782607,0.0015882888686496212,0.5107142857142857
1082,1082,산/Noun,279,67,212,0.0007447257852966678,0.002354666015060977,0.7598566308243727
1083,1083,총/Modifier,279,87,192,0.0009670319898628369,0.0021325277117533376,0.6881720430107527
1084,1084,회/Noun,279,177,102,0.0019674099104106,0.0011329053468689607,0.6344086021505376
1085,1085,빠져들다/Verb,278,264,14,0.0029344419002734373,0.0001554968123153475,0.9496402877697842
1086,1086,흘리다/Verb,278,211,67,0.002345330458173088,0.0007441633160805918,0.7589928057553957
1087,1087,전작/Noun,277,72,205,0.00080030233643821,0.002276917608903303,0.740072202166065
1088,1088,총/Noun,277,85,192,0.0009448013694062199,0.0021325277117533376,0.6931407942238267
1089,1089,유머/Noun,277,161,116,0.001789564946757664,0.0012884021591843082,0.5812274368231047
1090,1090,♡/Foreign,276,264,12,0.0029344419002734373,0.0001332829819845836,0.9565217391304348
1091,1091,돌아가다/Verb,276,167,109,0.001856256808127515,0.0012106537530266347,0.605072463768116
1092,1092,현재/Noun,275,205,70,0.002278638596803237,0.0007774840615767378,0.7454545454545455
1093,1093,극/Suffix,275,114,161,0.0012671453660271655,0.001788213341626497,0.5854545454545454
1094,1094,마/Noun,275,119,156,0.0013227219171687082,0.0017326787657995868,0.5672727272727273
1095,1095,진지하다/Adjective,275,145,130,0.0016117199831047284,0.0014438989714996556,0.5272727272727272
1096,1096,쩔다/Verb,274,216,58,0.00240090700931463,0.0006442010795921541,0.7883211678832117
1097,1097,여전하다/Adjective,274,191,83,0.0021230242536069183,0.0009218739587267033,0.6970802919708029
1098,1098,울/Modifier,274,178,96,0.001978525220638908,0.0010662638558766688,0.6496350364963503
1099,1099,제작비/Noun,273,38,235,0.000422381788675722,0.002610125063864762,0.8608058608058609
1100,1100,영원하다/Adjective,273,231,42,0.002567636662739257,0.00046649043694604257,0.8461538461538461
1101,1101,예요/Josa,273,206,67,0.0022897539070315448,0.0007441633160805918,0.7545787545787546
1102,1102,스러운/Josa,273,89,184,0.000989262610319454,0.0020436723904302817,0.6739926739926739
1103,1103,다행/Noun,273,104,169,0.001155992263744081,0.0018770686629495524,0.6190476190476191
1104,1104,흠/Noun,272,105,167,0.0011671075739723895,0.0018548548326187888,0.6139705882352942
1105,1105,나중/Noun,272,151,121,0.0016784118444745793,0.001343936735011218,0.5551470588235294
1106,1106,통해/Noun,271,217,54,0.0024120223195429388,0.0005997734189306263,0.8007380073800738
1107,1107,잘생기다/Adjective,271,198,73,0.002200831425205077,0.0008108048070728836,0.7306273062730627
1108,1108,노/Noun,271,96,175,0.0010670697819176133,0.0019437101539418445,0.6457564575645757
1109,1109,주의/Noun,271,113,158,0.0012560300557988573,0.0017548925961303507,0.5830258302583026
1110,1110,저런/Noun,271,141,130,0.0015672587421914947,0.0014438989714996556,0.5202952029520295
1111,1111,이미/Adverb,270,114,156,0.0012671453660271655,0.0017326787657995868,0.5777777777777777
1112,1112,아쉬움/Noun,269,159,110,0.0017673343263010473,0.0012217606681920164,0.5910780669144982
1113,1113,역할/Noun,269,128,141,0.0014227597092234846,0.0015660750383188573,0.5241635687732342
1114,1114,망작/Noun,268,16,252,0.00017784496365293558,0.002798942621676256,0.9402985074626866
1115,1115,억/Modifier,268,114,154,0.0012671453660271655,0.0017104649354688231,0.5746268656716418
1116,1116,소녀/Noun,268,117,151,0.0013004912967120913,0.001677144189972677,0.5634328358208955
1117,1117,그런데/Conjunction,268,133,135,0.0014783362603650269,0.0014994335473265655,0.503731343283582
1118,1118,가끔/Noun,267,174,93,0.0019340639797256738,0.001032943110380523,0.651685393258427
1119,1119,만의/Josa,267,167,100,0.001856256808127515,0.0011106915165381968,0.6254681647940075
1120,1120,드럽다/Adjective,266,24,242,0.0002667674454794033,0.002687873470022436,0.9097744360902256
1121,1121,동화/Noun,266,189,77,0.002100793633150301,0.0008552324677344116,0.7105263157894737
1122,1122,80년/Number,266,82,184,0.0009114554387212947,0.0020436723904302817,0.6917293233082706
1123,1123,:/Punctuation,266,106,160,0.001178222884200698,0.0017771064264611148,0.6015037593984962
1124,1124,사라지다/Verb,266,107,159,0.0011893381944290064,0.0017659995112957324,0.5977443609022557
1125,1125,먼저/Noun,266,153,113,0.0017006424649311962,0.0012550814136881624,0.575187969924812
1126,1126,겁나다/Verb,266,127,139,0.001411644398995176,0.0015438612079880936,0.5225563909774437
1127,1127,100/Number,265,171,94,0.001900718049040749,0.0010440500255459052,0.6452830188679245
1128,1128,묘사/Noun,265,170,95,0.0018896027388124407,0.0010551569407112867,0.6415094339622641
1129,1129,씨/Noun,265,120,145,0.0013338372273970164,0.001610502698980385,0.5471698113207547
1130,1130,예산/Noun,264,65,199,0.0007224951648400508,0.0022102761179110114,0.7537878787878788
1131,1131,으/Adverb,263,97,166,0.0010781850921459217,0.0018437479174534066,0.6311787072243346
1132,1132,여러/Modifier,263,165,98,0.0018340261876708976,0.001088477686207433,0.6273764258555133
1133,1133,화/Noun,263,125,138,0.001389413778538559,0.0015327542928227115,0.5247148288973384
1134,1134,정/Noun,263,132,131,0.0014672209501367186,0.0014550058866650375,0.5019011406844106
1135,1135,도/Foreign,263,131,132,0.0014561056399084098,0.0014661128018304194,0.5019011406844106
1136,1136,채널/Noun,262,82,180,0.0009114554387212947,0.001999244729768754,0.6870229007633588
1137,1137,살인/Noun,262,97,165,0.0010781850921459217,0.0018326410022880247,0.6297709923664122
1138,1138,멍청하다/Adjective,260,38,222,0.000422381788675722,0.002465735166714797,0.8538461538461538
1139,1139,강/Noun,260,197,63,0.002189716114976769,0.0006997356554190639,0.7576923076923077
1140,1140,인하다/Adjective,260,152,108,0.0016895271547028878,0.0011995468378612525,0.5846153846153846
1141,1141,만큼/Josa,260,150,110,0.0016672965342462707,0.0012217606681920164,0.5769230769230769
1142,1142,리메이크/Noun,260,113,147,0.0012560300557988573,0.0016327165293111491,0.5653846153846154
1143,1143,덥다/Adjective,260,123,137,0.001367183158081942,0.0015216473776573296,0.5269230769230769
1144,1144,특유/Noun,259,151,108,0.0016784118444745793,0.0011995468378612525,0.5830115830115831
1145,1145,바람/Noun,259,114,145,0.0012671453660271655,0.001610502698980385,0.5598455598455598
1146,1146,마치/Noun,259,132,127,0.0014672209501367186,0.0014105782260035095,0.5096525096525096
1147,1147,졸라/Noun,258,75,183,0.0008336482671231353,0.0020325654752649,0.7093023255813954
1148,1148,프로그램/Noun,258,102,156,0.0011337616432874642,0.0017326787657995868,0.6046511627906976
1149,1149,관계/Noun,258,137,121,0.0015227975012782607,0.001343936735011218,0.5310077519379846
1150,1150,개/Suffix,257,79,178,0.0008781095080363692,0.0019770308994379896,0.6926070038910506
1151,1151,틀다/Verb,257,149,108,0.0016561812240179624,0.0011995468378612525,0.5797665369649806
1152,1152,등장/Noun,257,108,149,0.001200453504657315,0.001654930359641913,0.5797665369649806
1153,1153,두/Josa,257,122,135,0.0013560678478536335,0.0014994335473265655,0.5252918287937743
1154,1154,너/Modifier,257,125,132,0.001389413778538559,0.0014661128018304194,0.5136186770428015
1155,1155,ㅇ/KoreanParticle,257,130,127,0.001444990329680101,0.0014105782260035095,0.5058365758754864
1156,1156,가능하다/Adjective,257,129,128,0.0014338750194517929,0.0014216851411688915,0.5019455252918288
1157,1157,외/Noun,256,70,186,0.000778071715981593,0.002065886220761046,0.7265625
1158,1158,서로/Noun,256,161,95,0.001789564946757664,0.0010551569407112867,0.62890625
1159,1159,존/Noun,256,111,145,0.0012337994353422404,0.001610502698980385,0.56640625
1160,1160,영웅/Noun,255,121,134,0.001344952537625325,0.0014883266321611835,0.5254901960784314
1161,1161,낚/Noun,254,20,234,0.00022230620456616945,0.0025990181486993803,0.9212598425196852
1162,1162,경찰/Noun,254,98,156,0.0010893004023742304,0.0017326787657995868,0.6141732283464567
1163,1163,관심/Noun,254,132,122,0.0014672209501367186,0.0013550436501765998,0.5196850393700787
1164,1164,모/Noun,253,66,187,0.0007336104750683593,0.002076993135926428,0.7391304347826086
1165,1165,프로/Noun,253,104,149,0.001155992263744081,0.001654930359641913,0.5889328063241107
1166,1166,안나/Noun,253,119,134,0.0013227219171687082,0.0014883266321611835,0.5296442687747036
1167,1167,끌다/Verb,252,68,184,0.0007558410955249762,0.0020436723904302817,0.7301587301587301
1168,1168,런가/Noun,252,97,155,0.0010781850921459217,0.0017215718506342046,0.6150793650793651
1169,1169,반개/Noun,251,5,246,5.557655114154236e-05,0.002732301130683964,0.9800796812749004
1170,1170,짱/VerbPrefix,251,225,26,0.0025009448013694068,0.00028877979429993113,0.896414342629482
1171,1171,지루/Noun,250,21,229,0.00023342151479447792,0.0025434835728724704,0.9159999999999999
1172,1172,케이블/Noun,250,126,124,0.0014005290887668675,0.0013772574805073642,0.504
1173,1173,황당하다/Adjective,249,38,211,0.000422381788675722,0.002343559099895595,0.8473895582329317
1174,1174,착하다/Adjective,249,109,140,0.0012115688148856235,0.0015549681231534756,0.5622489959839357
1175,1175,신/Modifier,249,123,126,0.001367183158081942,0.0013994713108381278,0.5060240963855421
1176,1176,약하다/Adjective,248,71,177,0.0007891870262099014,0.001965923984272608,0.7137096774193549
1177,1177,흔하다/Adjective,248,92,156,0.0010226085410043797,0.0017326787657995868,0.6290322580645161
1178,1178,과정/Noun,248,142,106,0.0015783740524198029,0.0011773330075304884,0.5725806451612904
1179,1179,철학/Noun,248,134,114,0.001489451570593335,0.001266188328853544,0.5403225806451613
1180,1180,햇/Noun,248,120,128,0.0013338372273970164,0.0014216851411688915,0.5161290322580645
1181,1181,졸리다/Verb,247,27,220,0.0003001133761643288,0.0024435213363840328,0.8906882591093117
1182,1182,용도/Noun,247,57,190,0.0006335726830135829,0.0021103138814225733,0.7692307692307693
1183,1183,희망/Noun,246,210,36,0.002334215147944779,0.00039984894595375083,0.8536585365853658
1184,1184,같이/Josa,246,108,138,0.001200453504657315,0.0015327542928227115,0.5609756097560976
1185,1185,안다/Verb,246,122,124,0.0013560678478536335,0.0013772574805073642,0.5040650406504065
1186,1186,위대하다/Adjective,245,185,60,0.002056332392237067,0.000666414909922918,0.7551020408163265
1187,1187,청춘/Noun,245,172,73,0.0019118333592690567,0.0008108048070728836,0.7020408163265306
1188,1188,......./Punctuation,245,81,164,0.0009003401284929863,0.0018215340871226425,0.6693877551020408
1189,1189,다만/Noun,245,160,85,0.0017784496365293556,0.0009440877890574672,0.6530612244897959
1190,1190,상상력/Noun,245,158,87,0.0017562190160727387,0.0009663016193882313,0.6448979591836734
1191,1191,너무나도/Adverb,245,151,94,0.0016784118444745793,0.0010440500255459052,0.6163265306122448
1192,1192,겠다/Verb,245,116,129,0.0012893759864837828,0.0014327920563342734,0.5265306122448979
1193,1193,깊이/Noun,244,172,72,0.0019118333592690567,0.0007996978919075017,0.7049180327868853
1194,1194,생애/Noun,244,140,104,0.001556143431963186,0.0011551191771997243,0.5737704918032787
1195,1195,묻다/Verb,244,139,105,0.0015450281217348775,0.0011662260923651065,0.569672131147541
1196,1196,효과/Noun,244,108,136,0.001200453504657315,0.0015105404624919474,0.5573770491803278
1197,1197,스케일/Noun,244,134,110,0.001489451570593335,0.0012217606681920164,0.5491803278688525
1198,1198,인정/Noun,244,121,123,0.001344952537625325,0.001366150565341982,0.5040983606557377
1199,1199,cg/Alpha,243,62,181,0.0006891492341551253,0.002010351644934136,0.7448559670781894
1200,1200,엇/VerbPrefix,243,144,99,0.00160060467287642,0.0010995846013728146,0.5925925925925926
1201,1201,바뀌다/Verb,243,103,140,0.0011448769535157724,0.0015549681231534756,0.5761316872427984
1202,1202,기세/Noun,242,7,235,7.78071715981593e-05,0.002610125063864762,0.9710743801652892
1203,1203,어느/Adverb,242,103,139,0.0011448769535157724,0.0015438612079880936,0.5743801652892562
1204,1204,생/Noun,242,105,137,0.0011671075739723895,0.0015216473776573296,0.5661157024793388
1205,1205,빌리다/Verb,242,107,135,0.0011893381944290064,0.0014994335473265655,0.5578512396694215
1206,1206,며/Josa,242,113,129,0.0012560300557988573,0.0014327920563342734,0.5330578512396694
1207,1207,신기하다/Adjective,242,117,125,0.0013004912967120913,0.001388364395672746,0.5165289256198347
1208,1208,형님/Noun,241,155,86,0.0017228730853878133,0.0009551947042228492,0.6431535269709544
1209,1209,깔다/Verb,241,91,150,0.001011493230776071,0.001666037274807295,0.6224066390041494
1210,1210,이며/Josa,241,142,99,0.0015783740524198029,0.0010995846013728146,0.5892116182572614
1211,1211,다소/Noun,241,140,101,0.001556143431963186,0.0011217984317035787,0.5809128630705395
1212,1212,께/Josa,241,140,101,0.001556143431963186,0.0011217984317035787,0.5809128630705395
1213,1213,노출/Noun,240,57,183,0.0006335726830135829,0.0020325654752649,0.7625
1214,1214,다시다/Verb,240,72,168,0.00080030233643821,0.0018659617477841703,0.7
1215,1215,카메라/Noun,240,73,167,0.0008114176466665183,0.0018548548326187888,0.6958333333333333
1216,1216,살아가다/Verb,239,217,22,0.0024120223195429388,0.00024435213363840333,0.9079497907949792
1217,1217,미래/Noun,239,164,75,0.0018229108774425891,0.0008330186374036475,0.6861924686192469
1218,1218,왠지/Adverb,239,138,101,0.0015339128115065689,0.0011217984317035787,0.5774058577405857
1219,1219,태어나다/Verb,239,134,105,0.001489451570593335,0.0011662260923651065,0.5606694560669456
1220,1220,쏘다/Verb,238,76,162,0.0008447635773514439,0.0017993202567918784,0.6806722689075629
1221,1221,체/Noun,238,92,146,0.0010226085410043797,0.0016216096141457672,0.6134453781512605
1222,1222,단/Noun,238,107,131,0.0011893381944290064,0.0014550058866650375,0.5504201680672269
1223,1223,>/Punctuation,238,120,118,0.0013338372273970164,0.001310615989515072,0.5042016806722689
1224,1224,대안/Noun,237,199,38,0.002211946735433386,0.0004220627762845148,0.8396624472573839
1225,1225,로는/Josa,237,110,127,0.001222684125113932,0.0014105782260035095,0.5358649789029536
1226,1226,산만하다/Adjective,236,19,217,0.00021119089433786097,0.002410200590887887,0.9194915254237288
1227,1227,능력/Noun,236,81,155,0.0009003401284929863,0.0017215718506342046,0.6567796610169492
1228,1228,미소/Noun,235,212,23,0.002356445768401396,0.0002554590488037852,0.9021276595744679
1229,1229,결론/Noun,235,63,172,0.0007002645443834338,0.0019103894084456985,0.7319148936170212
1230,1230,반/Noun,235,83,152,0.0009225707489496033,0.001688251105138059,0.6468085106382979
1231,1231,치/Noun,235,90,145,0.0010003779205477628,0.001610502698980385,0.6170212765957447
1232,1232,시/Noun,235,111,124,0.0012337994353422404,0.0013772574805073642,0.5276595744680851
1233,1233,설레다/Adjective,234,212,22,0.002356445768401396,0.00024435213363840333,0.9059829059829059
1234,1234,독립영화/Noun,234,75,159,0.0008336482671231353,0.0017659995112957324,0.6794871794871795
1235,1235,부터/Noun,234,122,112,0.0013560678478536335,0.0012439744985227805,0.5213675213675214
1236,1236,OST/Alpha,233,191,42,0.0021230242536069183,0.00046649043694604257,0.8197424892703863
1237,1237,잘못/Noun,233,83,150,0.0009225707489496033,0.001666037274807295,0.6437768240343348
1238,1238,네/Noun,233,103,130,0.0011448769535157724,0.0014438989714996556,0.5579399141630901
1239,1239,얻다/Verb,232,135,97,0.0015005668808216438,0.0010773707710420508,0.5818965517241379
1240,1240,귀/Modifier,231,137,94,0.0015227975012782607,0.0010440500255459052,0.5930735930735931
1241,1241,엿/Modifier,231,118,113,0.0013116066069403995,0.0012550814136881624,0.5108225108225108
1242,1242,지나치다/Verb,230,55,175,0.000611342062556966,0.0019437101539418445,0.7608695652173914
1243,1243,리얼/Noun,230,156,74,0.0017339883956161216,0.0008219117222382655,0.6782608695652174
1244,1244,평생/Noun,230,147,83,0.0016339506035613453,0.0009218739587267033,0.6391304347826087
1245,1245,요/Modifier,230,129,101,0.0014338750194517929,0.0011217984317035787,0.5608695652173913
1246,1246,ㅇㅇ/KoreanParticle,230,126,104,0.0014005290887668675,0.0011551191771997243,0.5478260869565217
1247,1247,젊다/Adjective,229,158,71,0.0017562190160727387,0.0007885909767421196,0.6899563318777293
1248,1248,원하다/Adjective,229,129,100,0.0014338750194517929,0.0011106915165381968,0.5633187772925764
1249,1249,왠만하다/Adjective,228,20,208,0.00022230620456616945,0.0023102383543994486,0.912280701754386
1250,1250,멋/Noun,228,174,54,0.0019340639797256738,0.0005997734189306263,0.7631578947368421
1251,1251,범인/Noun,228,62,166,0.0006891492341551253,0.0018437479174534066,0.7280701754385965
1252,1252,되게/Adverb,227,149,78,0.0016561812240179624,0.0008663393828997934,0.6563876651982379
1253,1253,어린이/Noun,227,87,140,0.0009670319898628369,0.0015549681231534756,0.6167400881057269
1254,1254,D/Alpha,227,103,124,0.0011448769535157724,0.0013772574805073642,0.5462555066079295
1255,1255,메시지/Noun,227,115,112,0.0012782606762554744,0.0012439744985227805,0.5066079295154186
1256,1256,박수/Noun,226,151,75,0.0016784118444745793,0.0008330186374036475,0.668141592920354
1257,1257,고민/Noun,226,128,98,0.0014227597092234846,0.001088477686207433,0.5663716814159292
1258,1258,얼/Noun,226,99,127,0.0011004157126025386,0.0014105782260035095,0.5619469026548672
1259,1259,으로는/Josa,226,119,107,0.0013227219171687082,0.0011884399226958706,0.5265486725663717
1260,1260,손발/Noun,225,22,203,0.00024453682502278637,0.002254703778572539,0.9022222222222224
1261,1261,고생/Noun,225,87,138,0.0009670319898628369,0.0015327542928227115,0.6133333333333333
1262,1262,고맙다/Adjective,224,180,44,0.002000755841095525,0.0004887042672768067,0.8035714285714286
1263,1263,온/Noun,224,111,113,0.0012337994353422404,0.0012550814136881624,0.5044642857142857
1264,1264,졸다/Verb,223,13,210,0.00014449903296801013,0.002332452184730213,0.9417040358744396
1265,1265,굳이/Noun,223,45,178,0.0005001889602738814,0.0019770308994379896,0.7982062780269058
1266,1266,로맨틱/Noun,223,141,82,0.0015672587421914947,0.0009107670435613213,0.6322869955156951
1267,1267,랄/Noun,223,119,104,0.0013227219171687082,0.0011551191771997243,0.5336322869955157
1268,1268,변하다/Adjective,223,114,109,0.0012671453660271655,0.0012106537530266347,0.5112107623318386
1269,1269,군/Suffix,223,112,111,0.0012449147455705488,0.0012328675833573985,0.5022421524663677
1270,1270,인/Noun,223,112,111,0.0012449147455705488,0.0012328675833573985,0.5022421524663677
1271,1271,거지같다/Adjective,222,19,203,0.00021119089433786097,0.002254703778572539,0.9144144144144144
1272,1272,떠오르다/Verb,222,164,58,0.0018229108774425891,0.0006442010795921541,0.7387387387387387
1273,1273,밤/Noun,222,158,64,0.0017562190160727387,0.0007108425705844457,0.7117117117117117
1274,1274,심심하다/Adjective,221,88,133,0.0009781473000911457,0.0014772197169958016,0.6018099547511312
1275,1275,만/Modifier,221,119,102,0.0013227219171687082,0.0011329053468689607,0.5384615384615384
1276,1276,문화/Noun,221,114,107,0.0012671453660271655,0.0011884399226958706,0.5158371040723982
1277,1277,별루/Noun,220,12,208,0.00013338372273970166,0.0023102383543994486,0.9454545454545454
1278,1278,슬픔/Noun,220,192,28,0.0021341395638352265,0.000310993624630695,0.8727272727272727
1279,1279,용이/Noun,220,69,151,0.0007669564057532844,0.001677144189972677,0.6863636363636364
1280,1280,차/Noun,220,84,136,0.0009336860591779117,0.0015105404624919474,0.6181818181818182
1281,1281,스/Noun,220,131,89,0.0014561056399084098,0.0009885154497189948,0.5954545454545455
1282,1282,저렇게/Adverb,220,91,129,0.001011493230776071,0.0014327920563342734,0.5863636363636363
1283,1283,사다/Verb,220,115,105,0.0012782606762554744,0.0011662260923651065,0.5227272727272727
1284,1284,포장/Noun,219,20,199,0.00022230620456616945,0.0022102761179110114,0.9086757990867579
1285,1285,주기/Noun,219,40,179,0.0004446124091323389,0.001988137814603372,0.817351598173516
1286,1286,시도/Noun,219,57,162,0.0006335726830135829,0.0017993202567918784,0.7397260273972602
1287,1287,ㅅㅂ/KoreanParticle,218,20,198,0.00022230620456616945,0.0021991692027456293,0.908256880733945
1288,1288,아침/Noun,218,56,162,0.0006224573727852744,0.0017993202567918784,0.7431192660550459
1289,1289,인기/Noun,218,90,128,0.0010003779205477628,0.0014216851411688915,0.5871559633027523
1290,1290,추다/Verb,218,116,102,0.0012893759864837828,0.0011329053468689607,0.5321100917431193
1291,1291,서/Modifier,218,103,115,0.0011448769535157724,0.0012772952440189265,0.5275229357798165
1292,1292,늙다/Verb,217,85,132,0.0009448013694062199,0.0014661128018304194,0.6082949308755761
1293,1293,줌/Noun,217,87,130,0.0009670319898628369,0.0014438989714996556,0.5990783410138248
1294,1294,덕분/Noun,217,122,95,0.0013560678478536335,0.0010551569407112867,0.5622119815668203
1295,1295,과연/Noun,217,113,104,0.0012560300557988573,0.0011551191771997243,0.5207373271889401
1296,1296,어찌/Noun,217,110,107,0.001222684125113932,0.0011884399226958706,0.5069124423963134
1297,1297,광고/Noun,216,47,169,0.0005224195807304982,0.0018770686629495524,0.7824074074074074
1298,1298,군대/Noun,216,97,119,0.0010781850921459217,0.0013217229046804538,0.5509259259259259
1299,1299,유명하다/Adjective,216,108,108,0.001200453504657315,0.0011995468378612525,0.5
1300,1300,짱/Modifier,215,181,34,0.0020118711513238334,0.00037763511562298685,0.8418604651162791
1301,1301,진실/Noun,215,142,73,0.0015783740524198029,0.0008108048070728836,0.6604651162790698
1302,1302,이래/Josa,215,118,97,0.0013116066069403995,0.0010773707710420508,0.5488372093023256
1303,1303,자막/Noun,215,101,114,0.0011226463330591557,0.001266188328853544,0.5302325581395348
1304,1304,여성/Noun,215,106,109,0.001178222884200698,0.0012106537530266347,0.5069767441860465
1305,1305,암/Noun,214,59,155,0.0006558033034701999,0.0017215718506342046,0.7242990654205608
1306,1306,흐름/Noun,214,83,131,0.0009225707489496033,0.0014550058866650375,0.6121495327102804
1307,1307,지키다/Verb,214,106,108,0.001178222884200698,0.0011995468378612525,0.5046728971962616
1308,1308,성인/Noun,214,108,106,0.001200453504657315,0.0011773330075304884,0.5046728971962616
1309,1309,눈물나다/Verb,213,183,30,0.0020341017717804503,0.000333207454961459,0.8591549295774648
1310,1310,젤/Noun,213,123,90,0.001367183158081942,0.000999622364884377,0.5774647887323944
1311,1311,어떤/Modifier,213,107,106,0.0011893381944290064,0.0011773330075304884,0.5023474178403756
1312,1312,성도/Noun,212,25,187,0.0002778827557077118,0.002076993135926428,0.8820754716981132
1313,1313,한계/Noun,212,38,174,0.000422381788675722,0.0019326032387764625,0.8207547169811321
1314,1314,그럭저럭/Adverb,212,52,160,0.0005779961318720405,0.0017771064264611148,0.7547169811320755
1315,1315,전/Foreign,212,157,55,0.00174510370584443,0.0006108803340960082,0.7405660377358491
1316,1316,조차/Josa,212,56,156,0.0006224573727852744,0.0017326787657995868,0.7358490566037735
1317,1317,챙기다/Verb,212,145,67,0.0016117199831047284,0.0007441633160805918,0.6839622641509434
1318,1318,심/Noun,212,73,139,0.0008114176466665183,0.0015438612079880936,0.6556603773584906
1319,1319,빠르다/Adjective,212,128,84,0.0014227597092234846,0.0009329808738920851,0.6037735849056604
1320,1320,싫어하다/Adjective,212,90,122,0.0010003779205477628,0.0013550436501765998,0.5754716981132075
1321,1321,사이/Noun,212,119,93,0.0013227219171687082,0.001032943110380523,0.5613207547169812
1322,1322,동생/Noun,212,101,111,0.0011226463330591557,0.0012328675833573985,0.5235849056603774
1323,1323,~^^/Punctuation,211,202,9,0.0022452926661183114,9.996223648843771e-05,0.957345971563981
1324,1324,진정/Noun,211,146,65,0.0016228352933330367,0.0007219494857498278,0.6919431279620853
1325,1325,..?/Punctuation,211,82,129,0.0009114554387212947,0.0014327920563342734,0.6113744075829384
1326,1326,웬만하다/Adjective,211,83,128,0.0009225707489496033,0.0014216851411688915,0.6066350710900474
1327,1327,보시/Noun,211,113,98,0.0012560300557988573,0.001088477686207433,0.5355450236966824
1328,1328,순/Noun,211,102,109,0.0011337616432874642,0.0012106537530266347,0.5165876777251185
1329,1329,깔끔하다/Adjective,210,167,43,0.001856256808127515,0.0004775973521114245,0.7952380952380952
1330,1330,살짝/Noun,210,140,70,0.001556143431963186,0.0007774840615767378,0.6666666666666666
1331,1331,희다/Adjective,210,96,114,0.0010670697819176133,0.001266188328853544,0.5428571428571428
1332,1332,만이/Josa,210,112,98,0.0012449147455705488,0.001088477686207433,0.5333333333333333
1333,1333,발견/Noun,209,175,34,0.0019451792899539827,0.00037763511562298685,0.8373205741626795
1334,1334,리뷰/Noun,209,80,129,0.0008892248182646778,0.0014327920563342734,0.6172248803827751
1335,1335,일어나다/Verb,209,129,80,0.0014338750194517929,0.0008885532132305574,0.6172248803827751
1336,1336,볼거리/Noun,209,93,116,0.0010337238512326881,0.0012884021591843082,0.5550239234449761
1337,1337,스럽게/Josa,209,111,98,0.0012337994353422404,0.001088477686207433,0.5311004784688995
1338,1338,수도/Noun,209,108,101,0.001200453504657315,0.0011217984317035787,0.5167464114832536
1339,1339,개도/Noun,208,25,183,0.0002778827557077118,0.0020325654752649,0.8798076923076923
1340,1340,쩐다/Noun,208,145,63,0.0016117199831047284,0.0006997356554190639,0.6971153846153846
1341,1341,범죄/Noun,208,72,136,0.00080030233643821,0.0015105404624919474,0.6538461538461539
1342,1342,뜻/Noun,208,122,86,0.0013560678478536335,0.0009551947042228492,0.5865384615384616
1343,1343,첫/Noun,208,116,92,0.0012893759864837828,0.0010218361952151409,0.5576923076923077
1344,1344,짱짱/Noun,207,199,8,0.002211946735433386,8.885532132305573e-05,0.961352657004831
1345,1345,부족/Noun,207,29,178,0.0003223439966209457,0.0019770308994379896,0.8599033816425121
1346,1346,지난/Noun,207,159,48,0.0017673343263010473,0.0005331319279383344,0.7681159420289855
1347,1347,20년/Number,207,142,65,0.0015783740524198029,0.0007219494857498278,0.6859903381642513
1348,1348,야/Exclamation,207,66,141,0.0007336104750683593,0.0015660750383188573,0.6811594202898551
1349,1349,오락/Noun,207,125,82,0.001389413778538559,0.0009107670435613213,0.6038647342995169
1350,1350,와는/Josa,207,118,89,0.0013116066069403995,0.0009885154497189948,0.5700483091787439
1351,1351,던지다/Verb,207,110,97,0.001222684125113932,0.0010773707710420508,0.5314009661835749
1352,1352,대충/Noun,206,37,169,0.00041126647844741344,0.0018770686629495524,0.8203883495145631
1353,1353,영환/Noun,206,64,142,0.0007113798546117423,0.0015771819534842392,0.6893203883495146
1354,1354,~~~~/Punctuation,206,123,83,0.001367183158081942,0.0009218739587267033,0.5970873786407767
1355,1355,로서/Noun,206,116,90,0.0012893759864837828,0.000999622364884377,0.5631067961165048
1356,1356,찌다/Verb,206,97,109,0.0010781850921459217,0.0012106537530266347,0.529126213592233
1357,1357,퀄리티/Noun,206,109,97,0.0012115688148856235,0.0010773707710420508,0.529126213592233
1358,1358,이면/Noun,206,97,109,0.0010781850921459217,0.0012106537530266347,0.529126213592233
1359,1359,언/Modifier,206,98,108,0.0010893004023742304,0.0011995468378612525,0.5242718446601942
1360,1360,감탄/Noun,205,177,28,0.0019674099104106,0.000310993624630695,0.8634146341463415
1361,1361,빨/Noun,205,54,151,0.0006002267523286575,0.001677144189972677,0.7365853658536585
1362,1362,자연/Noun,205,142,63,0.0015783740524198029,0.0006997356554190639,0.6926829268292682
1363,1363,커플/Noun,205,141,64,0.0015672587421914947,0.0007108425705844457,0.6878048780487804
1364,1364,시선/Noun,205,141,64,0.0015672587421914947,0.0007108425705844457,0.6878048780487804
1365,1365,정서/Noun,205,76,129,0.0008447635773514439,0.0014327920563342734,0.6292682926829268
1366,1366,정말로/Adverb,205,125,80,0.001389413778538559,0.0008885532132305574,0.6097560975609756
1367,1367,시청자/Noun,204,41,163,0.00045572771936064734,0.001810427171957261,0.7990196078431373
1368,1368,홍보/Noun,204,43,161,0.00047795833981726434,0.001788213341626497,0.7892156862745098
1369,1369,담기다/Verb,204,160,44,0.0017784496365293556,0.0004887042672768067,0.7843137254901961
1370,1370,몸매/Noun,204,67,137,0.0007447257852966678,0.0015216473776573296,0.6715686274509803
1371,1371,우울하다/Adjective,204,123,81,0.001367183158081942,0.0008996601283959392,0.6029411764705882
1372,1372,폭력/Noun,204,94,110,0.0010448391614609964,0.0012217606681920164,0.5392156862745098
1373,1373,b/Alpha,204,101,103,0.0011226463330591557,0.0011440122620343426,0.5049019607843137
1374,1374,기대다/Verb,204,103,101,0.0011448769535157724,0.0011217984317035787,0.5049019607843137
1375,1375,아오/Exclamation,203,29,174,0.0003223439966209457,0.0019326032387764625,0.8571428571428571
1376,1376,뛰다/Verb,203,88,115,0.0009781473000911457,0.0012772952440189265,0.5665024630541872
1377,1377,방/Noun,203,92,111,0.0010226085410043797,0.0012328675833573985,0.5467980295566502
1378,1378,울리다/Verb,202,175,27,0.0019451792899539827,0.0002998867094653131,0.8663366336633663
1379,1379,지르다/Verb,202,42,160,0.00046684302958895584,0.0017771064264611148,0.7920792079207921
1380,1380,소름끼치다/Verb,202,155,47,0.0017228730853878133,0.0005220250127729526,0.7673267326732673
1381,1381,더하다/Adjective,202,117,85,0.0013004912967120913,0.0009440877890574672,0.5792079207920792
1382,1382,열심히/Adverb,202,104,98,0.001155992263744081,0.001088477686207433,0.5148514851485149
1383,1383,일상/Noun,201,154,47,0.0017117577751595047,0.0005220250127729526,0.7661691542288557
1384,1384,포기/Noun,201,56,145,0.0006224573727852744,0.001610502698980385,0.7213930348258707
1385,1385,코드/Noun,201,76,125,0.0008447635773514439,0.001388364395672746,0.6218905472636815
1386,1386,첨/Noun,201,77,124,0.0008558788875797522,0.0013772574805073642,0.6169154228855721
1387,1387,유일하다/Adjective,200,119,81,0.0013227219171687082,0.0008996601283959392,0.595
1388,1388,접다/Verb,199,22,177,0.00024453682502278637,0.001965923984272608,0.8894472361809045
1389,1389,30분/Number,199,51,148,0.0005668808216437321,0.001643823444476531,0.7437185929648241
1390,1390,에서의/Josa,199,143,56,0.0015894893626481115,0.0006219872492613901,0.7185929648241206
1391,1391,일이/Noun,199,115,84,0.0012782606762554744,0.0009329808738920851,0.5778894472361809
1392,1392,용서/Noun,199,85,114,0.0009448013694062199,0.001266188328853544,0.5728643216080402
1393,1393,이따위/Modifier,198,8,190,8.892248182646779e-05,0.0021103138814225733,0.9595959595959596
1394,1394,눈빛/Noun,198,175,23,0.0019451792899539827,0.0002554590488037852,0.8838383838383839
1395,1395,10분/Number,198,36,162,0.000400151168219105,0.0017993202567918784,0.8181818181818182
1396,1396,보라/Noun,198,64,134,0.0007113798546117423,0.0014883266321611835,0.6767676767676768
1397,1397,끼리/Noun,198,71,127,0.0007891870262099014,0.0014105782260035095,0.6414141414141414
1398,1398,사극/Noun,198,123,75,0.001367183158081942,0.0008330186374036475,0.6212121212121212
1399,1399,대의/Noun,198,106,92,0.001178222884200698,0.0010218361952151409,0.5353535353535354
1400,1400,보다도/Josa,198,100,98,0.0011115310228308473,0.001088477686207433,0.5050505050505051
1401,1401,말로/Noun,197,140,57,0.001556143431963186,0.0006330941644267722,0.7106598984771574
1402,1402,들어오다/Verb,197,87,110,0.0009670319898628369,0.0012217606681920164,0.5583756345177665
1403,1403,형/Suffix,197,100,97,0.0011115310228308473,0.0010773707710420508,0.5076142131979695
1404,1404,뜬금/Noun,196,17,179,0.00018896027388124405,0.001988137814603372,0.9132653061224488
1405,1405,핵/Noun,196,37,159,0.00041126647844741344,0.0017659995112957324,0.8112244897959183
1406,1406,상처/Noun,196,143,53,0.0015894893626481115,0.0005886665037652442,0.7295918367346939
1407,1407,실감/Noun,196,128,68,0.0014227597092234846,0.0007552702312459737,0.6530612244897959
1408,1408,괴물/Noun,196,81,115,0.0009003401284929863,0.0012772952440189265,0.5867346938775511
1409,1409,달/Noun,196,89,107,0.000989262610319454,0.0011884399226958706,0.5459183673469388
1410,1410,다큐멘터리/Noun,196,92,104,0.0010226085410043797,0.0011551191771997243,0.5306122448979592
1411,1411,반성/Noun,196,92,104,0.0010226085410043797,0.0011551191771997243,0.5306122448979592
1412,1412,특별하다/Adjective,196,94,102,0.0010448391614609964,0.0011329053468689607,0.5204081632653061
1413,1413,</Punctuation,196,98,98,0.0010893004023742304,0.001088477686207433,0.5
1414,1414,끌/Noun,195,22,173,0.00024453682502278637,0.0019214963236110802,0.8871794871794871
1415,1415,힐링/Noun,195,171,24,0.001900718049040749,0.0002665659639691672,0.8769230769230769
1416,1416,혹시/Noun,195,48,147,0.0005335348909588066,0.0016327165293111491,0.7538461538461538
1417,1417,막판/Noun,195,58,137,0.0006446879932418914,0.0015216473776573296,0.7025641025641025
1418,1418,빛/Noun,195,127,68,0.001411644398995176,0.0007552702312459737,0.6512820512820513
1419,1419,당연하다/Adjective,195,106,89,0.001178222884200698,0.0009885154497189948,0.5435897435897435
1420,1420,연애/Noun,195,105,90,0.0011671075739723895,0.000999622364884377,0.5384615384615384
1421,1421,무겁다/Adjective,194,158,36,0.0017562190160727387,0.00039984894595375083,0.8144329896907216
1422,1422,우정/Noun,194,143,51,0.0015894893626481115,0.0005664526734344802,0.7371134020618557
1423,1423,해피엔딩/Noun,194,138,56,0.0015339128115065689,0.0006219872492613901,0.711340206185567
1424,1424,죄/Noun,194,67,127,0.0007447257852966678,0.0014105782260035095,0.6546391752577321
1425,1425,하루/Noun,194,110,84,0.001222684125113932,0.0009329808738920851,0.5670103092783505
1426,1426,표/Noun,194,109,85,0.0012115688148856235,0.0009440877890574672,0.5618556701030928
1427,1427,우/Adverb,194,89,105,0.000989262610319454,0.0011662260923651065,0.5412371134020618
1428,1428,크게/Noun,194,93,101,0.0010337238512326881,0.0011217984317035787,0.5206185567010311
1429,1429,내리다/Verb,194,96,98,0.0010670697819176133,0.001088477686207433,0.5051546391752577
1430,1430,참다/Verb,193,36,157,0.000400151168219105,0.0017437856809649687,0.8134715025906736
1431,1431,으론/Josa,193,112,81,0.0012449147455705488,0.0008996601283959392,0.5803108808290155
1432,1432,남녀/Noun,193,111,82,0.0012337994353422404,0.0009107670435613213,0.5751295336787565
1433,1433,정치/Noun,193,109,84,0.0012115688148856235,0.0009329808738920851,0.5647668393782384
1434,1434,이어지다/Verb,193,107,86,0.0011893381944290064,0.0009551947042228492,0.5544041450777202
1435,1435,짓다/Verb,193,102,91,0.0011337616432874642,0.001010729280049759,0.5284974093264249
1436,1436,감다/Verb,193,93,100,0.0010337238512326881,0.0011106915165381968,0.5181347150259067
1437,1437,몰다/Verb,192,64,128,0.0007113798546117423,0.0014216851411688915,0.6666666666666666
1438,1438,하하/Noun,192,96,96,0.0010670697819176133,0.0010662638558766688,0.5
1439,1439,아련하다/Adjective,191,184,7,0.002045217082008759,7.774840615767377e-05,0.9633507853403142
1440,1440,보아/Noun,191,134,57,0.001489451570593335,0.0006330941644267722,0.7015706806282722
1441,1441,게다가/Noun,191,58,133,0.0006446879932418914,0.0014772197169958016,0.6963350785340314
1442,1442,만큼/Noun,191,115,76,0.0012782606762554744,0.0008441255525690295,0.6020942408376964
1443,1443,어제/Noun,191,112,79,0.0012449147455705488,0.0008774462980651753,0.5863874345549738
1444,1444,개판/Noun,190,8,182,8.892248182646779e-05,0.002021458560099518,0.9578947368421052
1445,1445,뭐임/Noun,190,15,175,0.00016672965342462708,0.0019437101539418445,0.9210526315789472
1446,1446,나머지/Noun,190,38,152,0.000422381788675722,0.001688251105138059,0.8
1447,1447,벌써/Noun,190,146,44,0.0016228352933330367,0.0004887042672768067,0.7684210526315789
1448,1448,조폭/Noun,190,58,132,0.0006446879932418914,0.0014661128018304194,0.6947368421052632
1449,1449,간/Noun,190,72,118,0.00080030233643821,0.001310615989515072,0.6210526315789474
1450,1450,이기/Noun,190,114,76,0.0012671453660271655,0.0008441255525690295,0.6
1451,1451,만으로/Josa,190,112,78,0.0012449147455705488,0.0008663393828997934,0.5894736842105263
1452,1452,처럼/Noun,190,100,90,0.0011115310228308473,0.000999622364884377,0.5263157894736842
1453,1453,소장/Noun,189,173,16,0.0019229486694973656,0.00017771064264611146,0.9153439153439152
1454,1454,비극/Noun,189,143,46,0.0015894893626481115,0.0005109180976075704,0.7566137566137566
1455,1455,까지는/Josa,189,51,138,0.0005668808216437321,0.0015327542928227115,0.7301587301587301
1456,1456,주/Noun,189,73,116,0.0008114176466665183,0.0012884021591843082,0.6137566137566137
1457,1457,안좋다/Adjective,189,81,108,0.0009003401284929863,0.0011995468378612525,0.5714285714285714
1458,1458,(?)/Punctuation,189,86,103,0.0009559166796345287,0.0011440122620343426,0.544973544973545
1459,1459,만에/Foreign,189,93,96,0.0010337238512326881,0.0010662638558766688,0.5079365079365079
1460,1460,벗다/Verb,188,41,147,0.00045572771936064734,0.0016327165293111491,0.7819148936170213
1461,1461,난해하다/Adjective,188,45,143,0.0005001889602738814,0.0015882888686496212,0.7606382978723404
1462,1462,섹스/Noun,188,51,137,0.0005668808216437321,0.0015216473776573296,0.7287234042553191
1463,1463,부끄럽다/Adjective,188,65,123,0.0007224951648400508,0.001366150565341982,0.6542553191489362
1464,1464,등장인물/Noun,188,69,119,0.0007669564057532844,0.0013217229046804538,0.6329787234042553
1465,1465,공부/Noun,188,83,105,0.0009225707489496033,0.0011662260923651065,0.5585106382978723
1466,1466,수/Modifier,188,96,92,0.0010670697819176133,0.0010218361952151409,0.5106382978723404
1467,1467,형편/Noun,187,18,169,0.0002000755841095525,0.0018770686629495524,0.9037433155080212
1468,1468,본방/Noun,187,166,21,0.0018451414978992067,0.00023324521847302128,0.8877005347593583
1469,1469,감명/Noun,187,164,23,0.0018229108774425891,0.0002554590488037852,0.8770053475935828
1470,1470,뮤지컬/Noun,187,117,70,0.0013004912967120913,0.0007774840615767378,0.6256684491978609
1471,1471,올해/Noun,187,111,76,0.0012337994353422404,0.0008441255525690295,0.5935828877005348
1472,1472,평이/Noun,187,91,96,0.001011493230776071,0.0010662638558766688,0.5133689839572193
1473,1473,펑펑/Noun,186,179,7,0.0019896405308672165,7.774840615767377e-05,0.9623655913978496
1474,1474,끝내다/Verb,186,63,123,0.0007002645443834338,0.001366150565341982,0.6612903225806451
1475,1475,의문/Noun,186,67,119,0.0007447257852966678,0.0013217229046804538,0.6397849462365591
1476,1476,이연걸/Noun,186,117,69,0.0013004912967120913,0.0007663771464113557,0.6290322580645161
1477,1477,국민/Noun,186,106,80,0.001178222884200698,0.0008885532132305574,0.5698924731182796
1478,1478,불구/Noun,186,104,82,0.001155992263744081,0.0009107670435613213,0.5591397849462365
1479,1479,이라서/Josa,186,99,87,0.0011004157126025386,0.0009663016193882313,0.532258064516129
1480,1480,분/Suffix,186,99,87,0.0011004157126025386,0.0009663016193882313,0.532258064516129
1481,1481,러닝/Noun,186,92,94,0.0010226085410043797,0.0010440500255459052,0.5053763440860215
1482,1482,그다지/Noun,185,18,167,0.0002000755841095525,0.0018548548326187888,0.9027027027027028
1483,1483,토/Noun,185,44,141,0.0004890736500455726,0.0015660750383188573,0.7621621621621621
1484,1484,떼다/Verb,185,140,45,0.001556143431963186,0.0004998111824421885,0.7567567567567568
1485,1485,인가요/Josa,185,57,128,0.0006335726830135829,0.0014216851411688915,0.6918918918918919
1486,1486,결과/Noun,185,64,121,0.0007113798546117423,0.001343936735011218,0.6540540540540539
1487,1487,불가/Noun,184,41,143,0.00045572771936064734,0.0015882888686496212,0.7771739130434783
1488,1488,자유/Noun,184,128,56,0.0014227597092234846,0.0006219872492613901,0.6956521739130435
1489,1489,암튼/Adverb,184,123,61,0.001367183158081942,0.0006775218250882999,0.6684782608695652
1490,1490,새벽/Noun,184,122,62,0.0013560678478536335,0.0006886287402536821,0.6630434782608695
1491,1491,꼴/Noun,183,23,160,0.00025565213525109487,0.0017771064264611148,0.8743169398907104
1492,1492,표절/Noun,183,24,159,0.0002667674454794033,0.0017659995112957324,0.8688524590163934
1493,1493,행복/Noun,183,153,30,0.0017006424649311962,0.000333207454961459,0.8360655737704918
1494,1494,딱하다/Adjective,183,31,152,0.00034457461707756266,0.001688251105138059,0.8306010928961749
1495,1495,지도/Noun,183,60,123,0.0006669186136985082,0.001366150565341982,0.6721311475409836
1496,1496,느와르/Noun,183,123,60,0.001367183158081942,0.000666414909922918,0.6721311475409836
1497,1497,기적/Noun,183,104,79,0.001155992263744081,0.0008774462980651753,0.5683060109289617
1498,1498,글쎄/Noun,182,21,161,0.00023342151479447792,0.001788213341626497,0.8846153846153846
1499,1499,색다르다/Adjective,182,141,41,0.0015672587421914947,0.00045538352178066063,0.7747252747252747
1500,1500,기본/Noun,182,50,132,0.0005557655114154236,0.0014661128018304194,0.7252747252747253
1501,1501,오버/Noun,182,51,131,0.0005668808216437321,0.0014550058866650375,0.7197802197802198
1502,1502,차이/Noun,182,68,114,0.0007558410955249762,0.001266188328853544,0.6263736263736264
1503,1503,홍콩/Noun,182,82,100,0.0009114554387212947,0.0011106915165381968,0.5494505494505495
1504,1504,악역/Noun,182,94,88,0.0010448391614609964,0.000977408534553613,0.5164835164835165
1505,1505,무협/Noun,182,92,90,0.0010226085410043797,0.000999622364884377,0.5054945054945055
1506,1506,에만/Josa,181,44,137,0.0004890736500455726,0.0015216473776573296,0.7569060773480663
1507,1507,에게는/Josa,181,120,61,0.0013338372273970164,0.0006775218250882999,0.6629834254143646
1508,1508,따위/Noun,181,63,118,0.0007002645443834338,0.001310615989515072,0.6519337016574586
1509,1509,가면/Noun,181,65,116,0.0007224951648400508,0.0012884021591843082,0.6408839779005525
1510,1510,자식/Noun,181,83,98,0.0009225707489496033,0.001088477686207433,0.5414364640883977
1511,1511,발전/Noun,181,83,98,0.0009225707489496033,0.001088477686207433,0.5414364640883977
1512,1512,대가/Noun,181,89,92,0.000989262610319454,0.0010218361952151409,0.5082872928176796
1513,1513,니/Modifier,181,92,89,0.0010226085410043797,0.0009885154497189948,0.5082872928176796
1514,1514,쓰래/Noun,180,10,170,0.00011115310228308472,0.0018881755781149344,0.9444444444444444
1515,1515,불쾌하다/Adjective,180,23,157,0.00025565213525109487,0.0017437856809649687,0.8722222222222222
1516,1516,느리다/Adjective,180,42,138,0.00046684302958895584,0.0015327542928227115,0.7666666666666667
1517,1517,까진/Josa,180,62,118,0.0006891492341551253,0.001310615989515072,0.6555555555555556
1518,1518,악당/Noun,180,65,115,0.0007224951648400508,0.0012772952440189265,0.6388888888888888
1519,1519,완전하다/Adjective,180,78,102,0.0008669941978080608,0.0011329053468689607,0.5666666666666667
1520,1520,세다/Verb,180,96,84,0.0010670697819176133,0.0009329808738920851,0.5333333333333333
1521,1521,싸다/Verb,179,41,138,0.00045572771936064734,0.0015327542928227115,0.770949720670391
1522,1522,촌스럽다/Adjective,179,50,129,0.0005557655114154236,0.0014327920563342734,0.7206703910614525
1523,1523,모/Modifier,179,67,112,0.0007447257852966678,0.0012439744985227805,0.6256983240223464
1524,1524,많이/Modifier,179,99,80,0.0011004157126025386,0.0008885532132305574,0.553072625698324
1525,1525,인지/Noun,179,82,97,0.0009114554387212947,0.0010773707710420508,0.5418994413407822
1526,1526,날다/Verb,179,85,94,0.0009448013694062199,0.0010440500255459052,0.5251396648044693
1527,1527,새/Noun,179,93,86,0.0010337238512326881,0.0009551947042228492,0.5195530726256983
1528,1528,시사회/Noun,179,86,93,0.0009559166796345287,0.001032943110380523,0.5195530726256983
1529,1529,비주/Noun,179,87,92,0.0009670319898628369,0.0010218361952151409,0.5139664804469274
1530,1530,좀더/Noun,179,89,90,0.000989262610319454,0.000999622364884377,0.5027932960893855
1531,1531,그렇다고/Conjunction,178,34,144,0.0003779205477624881,0.0015993957838150033,0.8089887640449438
1532,1532,그걸/Adverb,178,70,108,0.000778071715981593,0.0011995468378612525,0.6067415730337079
1533,1533,기술/Noun,178,72,106,0.00080030233643821,0.0011773330075304884,0.5955056179775281
1534,1534,새/Modifier,178,74,104,0.0008225329568948269,0.0011551191771997243,0.5842696629213483
1535,1535,무시/Noun,178,74,104,0.0008225329568948269,0.0011551191771997243,0.5842696629213483
1536,1536,이제야/Noun,177,157,20,0.00174510370584443,0.00022213830330763932,0.8870056497175142
1537,1537,적절하다/Adjective,177,137,40,0.0015227975012782607,0.0004442766066152787,0.7740112994350282
1538,1538,깨닫다/Verb,177,133,44,0.0014783362603650269,0.0004887042672768067,0.7514124293785308
1539,1539,반복/Noun,177,68,109,0.0007558410955249762,0.0012106537530266347,0.615819209039548
1540,1540,공/Modifier,177,70,107,0.000778071715981593,0.0011884399226958706,0.6045197740112994
1541,1541,입장/Noun,177,83,94,0.0009225707489496033,0.0010440500255459052,0.5310734463276836
1542,1542,당/Modifier,177,87,90,0.0009670319898628369,0.000999622364884377,0.5084745762711864
1543,1543,오그라들다/Verb,176,19,157,0.00021119089433786097,0.0017437856809649687,0.8920454545454546
1544,1544,긴장/Noun,176,134,42,0.001489451570593335,0.00046649043694604257,0.7613636363636364
1545,1545,게이/Noun,176,47,129,0.0005224195807304982,0.0014327920563342734,0.7329545454545454
1546,1546,어쩔/Adverb,176,57,119,0.0006335726830135829,0.0013217229046804538,0.6761363636363636
1547,1547,외국/Noun,176,57,119,0.0006335726830135829,0.0013217229046804538,0.6761363636363636
1548,1548,예/Modifier,176,97,79,0.0010781850921459217,0.0008774462980651753,0.5511363636363636
1549,1549,첫/Modifier,176,88,88,0.0009781473000911457,0.000977408534553613,0.5
1550,1550,언제나/Adverb,175,128,47,0.0014227597092234846,0.0005220250127729526,0.7314285714285714
1551,1551,북한/Noun,175,65,110,0.0007224951648400508,0.0012217606681920164,0.6285714285714286
1552,1552,과는/Josa,175,101,74,0.0011226463330591557,0.0008219117222382655,0.5771428571428572
1553,1553,그린/Noun,175,93,82,0.0010337238512326881,0.0009107670435613213,0.5314285714285715
1554,1554,열정/Noun,174,148,26,0.0016450659137896538,0.00028877979429993113,0.8505747126436781
1555,1555,소소하다/Adjective,174,143,31,0.0015894893626481115,0.00034431437012684104,0.8218390804597702
1556,1556,빛나다/Verb,174,131,43,0.0014561056399084098,0.0004775973521114245,0.7528735632183908
1557,1557,이루다/Verb,174,126,48,0.0014005290887668675,0.0005331319279383344,0.7241379310344828
1558,1558,불/Noun,174,77,97,0.0008558788875797522,0.0010773707710420508,0.5574712643678161
1559,1559,아픔/Noun,173,146,27,0.0016228352933330367,0.0002998867094653131,0.8439306358381503
1560,1560,창/Noun,173,31,142,0.00034457461707756266,0.0015771819534842392,0.8208092485549133
1561,1561,선생님/Noun,173,129,44,0.0014338750194517929,0.0004887042672768067,0.7456647398843931
1562,1562,병/Noun,173,51,122,0.0005668808216437321,0.0013550436501765998,0.7052023121387283
1563,1563,쇼/Noun,173,55,118,0.000611342062556966,0.001310615989515072,0.6820809248554913
1564,1564,달라/Noun,173,81,92,0.0009003401284929863,0.0010218361952151409,0.5317919075144508
1565,1565,강렬하다/Adjective,172,147,25,0.0016339506035613453,0.0002776728791345492,0.8546511627906976
1566,1566,화나다/Verb,172,30,142,0.00033345930684925416,0.0015771819534842392,0.8255813953488372
1567,1567,짝/Noun,172,34,138,0.0003779205477624881,0.0015327542928227115,0.8023255813953488
1568,1568,양/Modifier,172,52,120,0.0005779961318720405,0.001332829819845836,0.6976744186046512
1569,1569,디즈니/Noun,172,114,58,0.0012671453660271655,0.0006442010795921541,0.6627906976744186
1570,1570,늘/Noun,172,101,71,0.0011226463330591557,0.0007885909767421196,0.5872093023255814
1571,1571,종교/Noun,172,80,92,0.0008892248182646778,0.0010218361952151409,0.5348837209302325
1572,1572,는걸/Noun,172,81,91,0.0009003401284929863,0.001010729280049759,0.5290697674418605
1573,1573,대화/Noun,172,86,86,0.0009559166796345287,0.0009551947042228492,0.5
1574,1574,질리/Noun,171,160,11,0.0017784496365293556,0.00012217606681920164,0.935672514619883
1575,1575,쩝/Adverb,171,28,143,0.0003112286863926372,0.0015882888686496212,0.8362573099415205
1576,1576,극치/Noun,171,28,143,0.0003112286863926372,0.0015882888686496212,0.8362573099415205
1577,1577,까지도/Josa,171,135,36,0.0015005668808216438,0.00039984894595375083,0.7894736842105263
1578,1578,밥/Noun,171,47,124,0.0005224195807304982,0.0013772574805073642,0.7251461988304093
1579,1579,희생/Noun,171,112,59,0.0012449147455705488,0.000655307994757536,0.6549707602339181
1580,1580,채우다/Verb,171,74,97,0.0008225329568948269,0.0010773707710420508,0.5672514619883041
1581,1581,외모/Noun,171,95,76,0.0010559544716893046,0.0008441255525690295,0.5555555555555556
1582,1582,방식/Noun,171,87,84,0.0009670319898628369,0.0009329808738920851,0.5087719298245614
1583,1583,찡하다/Adjective,170,165,5,0.0018340261876708976,5.5534575826909837e-05,0.9705882352941176
1584,1584,주기도/Noun,170,6,164,6.669186136985083e-05,0.0018215340871226425,0.9647058823529412
1585,1585,노답/Noun,170,14,156,0.0001556143431963186,0.0017326787657995868,0.9176470588235294
1586,1586,빡치다/Adjective,170,27,143,0.0003001133761643288,0.0015882888686496212,0.8411764705882353
1587,1587,남편/Noun,170,55,115,0.000611342062556966,0.0012772952440189265,0.6764705882352942
1588,1588,분노/Noun,170,67,103,0.0007447257852966678,0.0011440122620343426,0.6058823529411764
1589,1589,맡다/Verb,170,74,96,0.0008225329568948269,0.0010662638558766688,0.5647058823529412
1590,1590,대표/Noun,170,75,95,0.0008336482671231353,0.0010551569407112867,0.5588235294117647
1591,1591,흘러가다/Verb,170,75,95,0.0008336482671231353,0.0010551569407112867,0.5588235294117647
1592,1592,형/Noun,170,83,87,0.0009225707489496033,0.0009663016193882313,0.5117647058823529
1593,1593,죄다/Adverb,169,19,150,0.00021119089433786097,0.001666037274807295,0.8875739644970414
1594,1594,싸구려/Noun,169,21,148,0.00023342151479447792,0.001643823444476531,0.8757396449704142
1595,1595,때우다/Verb,169,36,133,0.000400151168219105,0.0014772197169958016,0.7869822485207101
1596,1596,에로/Josa,169,39,130,0.0004334970989040304,0.0014438989714996556,0.7692307692307693
1597,1597,마저/Josa,169,51,118,0.0005668808216437321,0.001310615989515072,0.6982248520710059
1598,1598,헐리우드/Noun,169,52,117,0.0005779961318720405,0.0012995090743496902,0.6923076923076923
1599,1599,춤/Noun,169,96,73,0.0010670697819176133,0.0008108048070728836,0.5680473372781065
1600,1600,지는/Josa,169,93,76,0.0010337238512326881,0.0008441255525690295,0.5502958579881657
1601,1601,섬세하다/Adjective,168,146,22,0.0016228352933330367,0.00024435213363840333,0.8690476190476191
1602,1602,풋풋하다/Adjective,168,144,24,0.00160060467287642,0.0002665659639691672,0.8571428571428571
1603,1603,어머니/Noun,168,123,45,0.001367183158081942,0.0004998111824421885,0.7321428571428571
1604,1604,=/Punctuation,168,55,113,0.000611342062556966,0.0012550814136881624,0.6726190476190477
1605,1605,청소년/Noun,168,62,106,0.0006891492341551253,0.0011773330075304884,0.6309523809523809
1606,1606,시각/Noun,168,102,66,0.0011337616432874642,0.0007330564009152097,0.6071428571428571
1607,1607,왕/Noun,168,75,93,0.0008336482671231353,0.001032943110380523,0.5535714285714286
1608,1608,로만/Noun,168,78,90,0.0008669941978080608,0.000999622364884377,0.5357142857142857
1609,1609,타/Modifier,168,80,88,0.0008892248182646778,0.000977408534553613,0.5238095238095238
1610,1610,계/Suffix,168,84,84,0.0009336860591779117,0.0009329808738920851,0.5
1611,1611,제로/Noun,167,16,151,0.00017784496365293558,0.001677144189972677,0.9041916167664672
1612,1612,유발/Noun,167,21,146,0.00023342151479447792,0.0016216096141457672,0.8742514970059879
1613,1613,필름/Noun,167,34,133,0.0003779205477624881,0.0014772197169958016,0.7964071856287425
1614,1614,조절/Noun,167,40,127,0.0004446124091323389,0.0014105782260035095,0.7604790419161677
1615,1615,놓치다/Verb,167,125,42,0.001389413778538559,0.00046649043694604257,0.7485029940119761
1616,1616,본인/Noun,167,56,111,0.0006224573727852744,0.0012328675833573985,0.6646706586826348
1617,1617,_/Punctuation,167,106,61,0.001178222884200698,0.0006775218250882999,0.6347305389221557
1618,1618,싸움/Noun,167,66,101,0.0007336104750683593,0.0011217984317035787,0.6047904191616766
1619,1619,이미지/Noun,167,71,96,0.0007891870262099014,0.0010662638558766688,0.5748502994011976
1620,1620,이나/Noun,167,72,95,0.00080030233643821,0.0010551569407112867,0.5688622754491018
1621,1621,열/Modifier,167,84,83,0.0009336860591779117,0.0009218739587267033,0.5029940119760479
1622,1622,미드/Noun,166,111,55,0.0012337994353422404,0.0006108803340960082,0.6686746987951807
1623,1623,실력/Noun,166,57,109,0.0006335726830135829,0.0012106537530266347,0.6566265060240963
1624,1624,학생/Noun,166,95,71,0.0010559544716893046,0.0007885909767421196,0.572289156626506
1625,1625,오래되다/Adjective,166,90,76,0.0010003779205477628,0.0008441255525690295,0.5421686746987951
1626,1626,단지/Noun,166,83,83,0.0009225707489496033,0.0009218739587267033,0.5
1627,1627,조잡하다/Adjective,165,7,158,7.78071715981593e-05,0.0017548925961303507,0.9575757575757576
1628,1628,호러/Noun,165,58,107,0.0006446879932418914,0.0011884399226958706,0.6484848484848484
1629,1629,방금/Noun,165,104,61,0.001155992263744081,0.0006775218250882999,0.6303030303030303
1630,1630,금/Noun,165,61,104,0.0006780339239268168,0.0011551191771997243,0.6303030303030303
1631,1631,라인/Noun,165,63,102,0.0007002645443834338,0.0011329053468689607,0.6181818181818182
1632,1632,깨다/Verb,165,69,96,0.0007669564057532844,0.0010662638558766688,0.5818181818181818
1633,1633,비판/Noun,165,94,71,0.0010448391614609964,0.0007885909767421196,0.5696969696969697
1634,1634,편의/Noun,165,73,92,0.0008114176466665183,0.0010218361952151409,0.5575757575757576
1635,1635,최/Noun,165,86,79,0.0009559166796345287,0.0008774462980651753,0.5212121212121212
1636,1636,굿굿/Noun,164,161,3,0.001789564946757664,3.33207454961459e-05,0.9817073170731708
1637,1637,좋아지다/Verb,164,134,30,0.001489451570593335,0.000333207454961459,0.8170731707317073
1638,1638,통쾌하다/Adjective,164,128,36,0.0014227597092234846,0.00039984894595375083,0.7804878048780488
1639,1639,심각하다/Adjective,164,43,121,0.00047795833981726434,0.001343936735011218,0.7378048780487805
1640,1640,맨날/Adverb,164,58,106,0.0006446879932418914,0.0011773330075304884,0.6463414634146342
1641,1641,쫌/Noun,164,59,105,0.0006558033034701999,0.0011662260923651065,0.6402439024390244
1642,1642,과의/Josa,164,92,72,0.0010226085410043797,0.0007996978919075017,0.5609756097560976
1643,1643,해석/Noun,164,88,76,0.0009781473000911457,0.0008441255525690295,0.5365853658536586
1644,1644,전문가/Noun,164,87,77,0.0009670319898628369,0.0008552324677344116,0.5304878048780488
1645,1645,지구/Noun,164,87,77,0.0009670319898628369,0.0008552324677344116,0.5304878048780488
1646,1646,어휴/Exclamation,163,21,142,0.00023342151479447792,0.0015771819534842392,0.8711656441717791
1647,1647,실패/Noun,163,27,136,0.0003001133761643288,0.0015105404624919474,0.8343558282208589
1648,1648,아줌마/Noun,163,46,117,0.0005113042705021896,0.0012995090743496902,0.7177914110429447
1649,1649,닮다/Verb,163,99,64,0.0011004157126025386,0.0007108425705844457,0.6073619631901841
1650,1650,동안/Foreign,163,70,93,0.000778071715981593,0.001032943110380523,0.5705521472392638
1651,1651,동물/Noun,163,92,71,0.0010226085410043797,0.0007885909767421196,0.5644171779141104
1652,1652,담/Noun,163,75,88,0.0008336482671231353,0.000977408534553613,0.5398773006134969
1653,1653,훨/Noun,163,75,88,0.0008336482671231353,0.000977408534553613,0.5398773006134969
1654,1654,다가오다/Verb,162,132,30,0.0014672209501367186,0.000333207454961459,0.8148148148148148
1655,1655,은근/Noun,162,127,35,0.001411644398995176,0.0003887420307883688,0.7839506172839507
1656,1656,심장/Noun,162,126,36,0.0014005290887668675,0.00039984894595375083,0.7777777777777778
1657,1657,바라보다/Verb,162,126,36,0.0014005290887668675,0.00039984894595375083,0.7777777777777778
1658,1658,씁쓸하다/Adjective,162,120,42,0.0013338372273970164,0.00046649043694604257,0.7407407407407407
1659,1659,편하다/Adjective,162,108,54,0.001200453504657315,0.0005997734189306263,0.6666666666666666
1660,1660,따라가다/Verb,162,56,106,0.0006224573727852744,0.0011773330075304884,0.654320987654321
1661,1661,조합/Noun,162,98,64,0.0010893004023742304,0.0007108425705844457,0.6049382716049383
1662,1662,낳다/Verb,162,89,73,0.000989262610319454,0.0008108048070728836,0.5493827160493827
1663,1663,방법/Noun,162,86,76,0.0009559166796345287,0.0008441255525690295,0.5308641975308642
1664,1664,돌다/Verb,162,85,77,0.0009448013694062199,0.0008552324677344116,0.5246913580246914
1665,1665,기르다/Verb,162,80,82,0.0008892248182646778,0.0009107670435613213,0.5061728395061729
1666,1666,없어지다/Verb,161,37,124,0.00041126647844741344,0.0013772574805073642,0.7701863354037267
1667,1667,숨다/Verb,161,121,40,0.001344952537625325,0.0004442766066152787,0.7515527950310559
1668,1668,ㄷㄷㄷ/KoreanParticle,161,96,65,0.0010670697819176133,0.0007219494857498278,0.5962732919254659
1669,1669,즈/Modifier,161,92,69,0.0010226085410043797,0.0007663771464113557,0.5714285714285714
1670,1670,인/Suffix,161,70,91,0.000778071715981593,0.001010729280049759,0.5652173913043478
1671,1671,1시간/Number,160,35,125,0.0003890358579907965,0.001388364395672746,0.78125
1672,1672,늦다/Verb,160,123,37,0.001367183158081942,0.0004109558611191328,0.76875
1673,1673,아이돌/Noun,160,54,106,0.0006002267523286575,0.0011773330075304884,0.6625
1674,1674,한국인/Noun,160,57,103,0.0006335726830135829,0.0011440122620343426,0.64375
1675,1675,입다/Verb,160,59,101,0.0006558033034701999,0.0011217984317035787,0.63125
1676,1676,히어로/Noun,160,97,63,0.0010781850921459217,0.0006997356554190639,0.60625
1677,1677,뽑다/Verb,160,68,92,0.0007558410955249762,0.0010218361952151409,0.575
1678,1678,악/Noun,160,74,86,0.0008225329568948269,0.0009551947042228492,0.5375
1679,1679,팀/Noun,160,80,80,0.0008892248182646778,0.0008885532132305574,0.5
1680,1680,명품/Noun,159,135,24,0.0015005668808216438,0.0002665659639691672,0.8490566037735849
1681,1681,존경/Noun,159,126,33,0.0014005290887668675,0.00036652820045760486,0.7924528301886793
1682,1682,더불다/Verb,159,117,42,0.0013004912967120913,0.00046649043694604257,0.7358490566037735
1683,1683,신나다/Adjective,159,111,48,0.0012337994353422404,0.0005331319279383344,0.6981132075471698
1684,1684,이끌다/Verb,159,94,65,0.0010448391614609964,0.0007219494857498278,0.5911949685534591
1685,1685,꾸다/Verb,159,83,76,0.0009225707489496033,0.0008441255525690295,0.5220125786163522
1686,1686,시트콤/Noun,158,109,49,0.0012115688148856235,0.0005442388431037163,0.689873417721519
1687,1687,어쩔/Modifier,158,50,108,0.0005557655114154236,0.0011995468378612525,0.6835443037974683
1688,1688,성/Noun,158,56,102,0.0006224573727852744,0.0011329053468689607,0.6455696202531646
1689,1689,대부분/Noun,158,60,98,0.0006669186136985082,0.001088477686207433,0.620253164556962
1690,1690,겁니다/Verb,158,93,65,0.0010337238512326881,0.0007219494857498278,0.5886075949367089
1691,1691,국내/Noun,158,87,71,0.0009670319898628369,0.0007885909767421196,0.5506329113924051
1692,1692,가깝다/Adjective,158,77,81,0.0008558788875797522,0.0008996601283959392,0.5126582278481012
1693,1693,짠하다/Adjective,157,146,11,0.0016228352933330367,0.00012217606681920164,0.929936305732484
1694,1694,푹/Noun,157,137,20,0.0015227975012782607,0.00022213830330763932,0.8726114649681529
1695,1695,만족/Noun,157,113,44,0.0012560300557988573,0.0004887042672768067,0.7197452229299363
1696,1696,이니/Josa,157,56,101,0.0006224573727852744,0.0011217984317035787,0.643312101910828
1697,1697,주말/Noun,157,99,58,0.0011004157126025386,0.0006442010795921541,0.6305732484076433
1698,1698,신분/Noun,157,99,58,0.0011004157126025386,0.0006442010795921541,0.6305732484076433
1699,1699,쵝오/Noun,156,151,5,0.0016784118444745793,5.5534575826909837e-05,0.9679487179487181
1700,1700,세기/Noun,156,90,66,0.0010003779205477628,0.0007330564009152097,0.5769230769230769
1701,1701,직접/Noun,156,87,69,0.0009670319898628369,0.0007663771464113557,0.5576923076923077
1702,1702,분명/Noun,156,73,83,0.0008114176466665183,0.0009218739587267033,0.532051282051282
1703,1703,거슬리다/Verb,155,35,120,0.0003890358579907965,0.001332829819845836,0.7741935483870968
1704,1704,전개도/Noun,155,54,101,0.0006002267523286575,0.0011217984317035787,0.6516129032258065
1705,1705,30/Number,155,98,57,0.0010893004023742304,0.0006330941644267722,0.6322580645161291
1706,1706,의리/Noun,155,89,66,0.000989262610319454,0.0007330564009152097,0.5741935483870968
1707,1707,미모/Noun,155,88,67,0.0009781473000911457,0.0007441633160805918,0.567741935483871
1708,1708,줍다/Verb,155,72,83,0.00080030233643821,0.0009218739587267033,0.535483870967742
1709,1709,짝퉁/Noun,154,7,147,7.78071715981593e-05,0.0016327165293111491,0.9545454545454546
1710,1710,개뿔/Noun,154,7,147,7.78071715981593e-05,0.0016327165293111491,0.9545454545454546
1711,1711,양심/Noun,154,28,126,0.0003112286863926372,0.0013994713108381278,0.8181818181818182
1712,1712,????/Punctuation,154,36,118,0.000400151168219105,0.001310615989515072,0.7662337662337663
1713,1713,누군가/Noun,154,118,36,0.0013116066069403995,0.00039984894595375083,0.7662337662337663
1714,1714,그거/Noun,154,45,109,0.0005001889602738814,0.0012106537530266347,0.7077922077922078
1715,1715,개념/Noun,154,49,105,0.0005446502011871152,0.0011662260923651065,0.6818181818181818
1716,1716,이자/Noun,154,103,51,0.0011448769535157724,0.0005664526734344802,0.6688311688311688
1717,1717,시원하다/Adjective,154,103,51,0.0011448769535157724,0.0005664526734344802,0.6688311688311688
1718,1718,으로만/Josa,154,55,99,0.000611342062556966,0.0010995846013728146,0.6428571428571429
1719,1719,끼/Noun,154,58,96,0.0006446879932418914,0.0010662638558766688,0.6233766233766234
1720,1720,돌아오다/Verb,154,93,61,0.0010337238512326881,0.0006775218250882999,0.6038961038961039
1721,1721,민망하다/Adjective,153,16,137,0.00017784496365293558,0.0015216473776573296,0.8954248366013072
1722,1722,망/Noun,153,19,134,0.00021119089433786097,0.0014883266321611835,0.8758169934640523
1723,1723,연예인/Noun,153,27,126,0.0003001133761643288,0.0013994713108381278,0.8235294117647058
1724,1724,도안/Noun,153,38,115,0.000422381788675722,0.0012772952440189265,0.7516339869281046
1725,1725,해내다/Verb,153,114,39,0.0012671453660271655,0.0004331696914498967,0.7450980392156863
1726,1726,가요/Noun,153,39,114,0.0004334970989040304,0.001266188328853544,0.7450980392156863
1727,1727,전반/Noun,153,49,104,0.0005446502011871152,0.0011551191771997243,0.6797385620915033
1728,1728,진리/Noun,153,101,52,0.0011226463330591557,0.0005775595885998622,0.6601307189542484
1729,1729,이정/Noun,153,60,93,0.0006669186136985082,0.001032943110380523,0.6078431372549019
1730,1730,이란/Noun,153,91,62,0.001011493230776071,0.0006886287402536821,0.5947712418300654
1731,1731,에피소드/Noun,153,70,83,0.000778071715981593,0.0009218739587267033,0.5424836601307189
1732,1732,애기/Noun,153,74,79,0.0008225329568948269,0.0008774462980651753,0.5163398692810458
1733,1733,돌아보다/Verb,152,143,9,0.0015894893626481115,9.996223648843771e-05,0.9407894736842104
1734,1734,의외로/Adverb,152,129,23,0.0014338750194517929,0.0002554590488037852,0.8486842105263158
1735,1735,여행/Noun,152,104,48,0.001155992263744081,0.0005331319279383344,0.6842105263157895
1736,1736,향/Noun,152,100,52,0.0011115310228308473,0.0005775595885998622,0.6578947368421053
1737,1737,19/Number,152,56,96,0.0006224573727852744,0.0010662638558766688,0.631578947368421
1738,1738,레알/Noun,152,63,89,0.0007002645443834338,0.0009885154497189948,0.5855263157894737
1739,1739,생활/Noun,152,87,65,0.0009670319898628369,0.0007219494857498278,0.5723684210526315
1740,1740,찝찝하다/Adjective,151,30,121,0.00033345930684925416,0.001343936735011218,0.8013245033112583
1741,1741,사기/Noun,151,33,118,0.00036680523753417966,0.001310615989515072,0.7814569536423841
1742,1742,과장/Noun,151,51,100,0.0005668808216437321,0.0011106915165381968,0.6622516556291391
1743,1743,스스로/Noun,151,86,65,0.0009559166796345287,0.0007219494857498278,0.5695364238410596
1744,1744,쩌/Noun,151,79,72,0.0008781095080363692,0.0007996978919075017,0.5231788079470199
1745,1745,봣는데/Noun,151,79,72,0.0008781095080363692,0.0007996978919075017,0.5231788079470199
1746,1746,단/Modifier,151,72,79,0.00080030233643821,0.0008774462980651753,0.5231788079470199
1747,1747,테러/Noun,151,78,73,0.0008669941978080608,0.0008108048070728836,0.5165562913907285
1748,1748,가득하다/Adjective,151,76,75,0.0008447635773514439,0.0008330186374036475,0.5033112582781457
1749,1749,신다/Verb,151,76,75,0.0008447635773514439,0.0008330186374036475,0.5033112582781457
1750,1750,라지/Noun,150,18,132,0.0002000755841095525,0.0014661128018304194,0.88
1751,1751,날리다/Verb,150,30,120,0.00033345930684925416,0.001332829819845836,0.8
1752,1752,갈등/Noun,150,95,55,0.0010559544716893046,0.0006108803340960082,0.6333333333333333
1753,1753,하나로/Noun,150,88,62,0.0009781473000911457,0.0006886287402536821,0.5866666666666667
1754,1754,한참/Noun,150,62,88,0.0006891492341551253,0.000977408534553613,0.5866666666666667
1755,1755,헐리웃/Noun,150,66,84,0.0007336104750683593,0.0009329808738920851,0.56
1756,1756,막히다/Verb,150,84,66,0.0009336860591779117,0.0007330564009152097,0.56
1757,1757,로봇/Noun,150,83,67,0.0009225707489496033,0.0007441633160805918,0.5533333333333333
1758,1758,문/Modifier,150,67,83,0.0007447257852966678,0.0009218739587267033,0.5533333333333333
1759,1759,유/Noun,150,68,82,0.0007558410955249762,0.0009107670435613213,0.5466666666666666
1760,1760,근/Modifier,150,76,74,0.0008447635773514439,0.0008219117222382655,0.5066666666666667
1761,1761,낭비하다/Adjective,149,2,147,2.2230620456616947e-05,0.0016327165293111491,0.9865771812080536
1762,1762,단연/Noun,149,128,21,0.0014227597092234846,0.00023324521847302128,0.8590604026845637
1763,1763,무척/Noun,149,114,35,0.0012671453660271655,0.0003887420307883688,0.7651006711409396
1764,1764,성장/Noun,149,110,39,0.001222684125113932,0.0004331696914498967,0.7382550335570469
1765,1765,......../Punctuation,149,45,104,0.0005001889602738814,0.0011551191771997243,0.6979865771812079
1766,1766,번째/Suffix,149,95,54,0.0010559544716893046,0.0005997734189306263,0.6375838926174496
1767,1767,초등학생/Noun,149,56,93,0.0006224573727852744,0.001032943110380523,0.6241610738255033
1768,1768,연속/Noun,149,59,90,0.0006558033034701999,0.000999622364884377,0.6040268456375839
1769,1769,주변/Noun,149,88,61,0.0009781473000911457,0.0006775218250882999,0.5906040268456376
1770,1770,경험/Noun,149,87,62,0.0009670319898628369,0.0006886287402536821,0.5838926174496645
1771,1771,한데/Eomi,149,63,86,0.0007002645443834338,0.0009551947042228492,0.5771812080536913
1772,1772,섹시하다/Adjective,149,84,65,0.0009336860591779117,0.0007219494857498278,0.5637583892617449
1773,1773,&/Punctuation,149,81,68,0.0009003401284929863,0.0007552702312459737,0.5436241610738255
1774,1774,오르다/Verb,149,81,68,0.0009003401284929863,0.0007552702312459737,0.5436241610738255
1775,1775,이도/Noun,148,5,143,5.557655114154236e-05,0.0015882888686496212,0.9662162162162162
1776,1776,상/Noun,148,44,104,0.0004890736500455726,0.0011551191771997243,0.7027027027027027
1777,1777,피해자/Noun,148,44,104,0.0004890736500455726,0.0011551191771997243,0.7027027027027027
1778,1778,감히/Noun,148,97,51,0.0010781850921459217,0.0005664526734344802,0.6554054054054054
1779,1779,뒷/Modifier,148,53,95,0.000589111442100349,0.0010551569407112867,0.6418918918918919
1780,1780,김기덕/Noun,148,63,85,0.0007002645443834338,0.0009440877890574672,0.5743243243243243
1781,1781,꽝/Noun,147,8,139,8.892248182646779e-05,0.0015438612079880936,0.9455782312925172
1782,1782,라이/Noun,147,28,119,0.0003112286863926372,0.0013217229046804538,0.8095238095238095
1783,1783,편견/Noun,147,103,44,0.0011448769535157724,0.0004887042672768067,0.7006802721088435
1784,1784,베스트/Noun,147,97,50,0.0010781850921459217,0.0005553457582690984,0.6598639455782312
1785,1785,이여/Josa,147,86,61,0.0009559166796345287,0.0006775218250882999,0.5850340136054422
1786,1786,견자단/Noun,147,68,79,0.0007558410955249762,0.0008774462980651753,0.5374149659863946
1787,1787,맨/Noun,147,77,70,0.0008558788875797522,0.0007774840615767378,0.5238095238095238
1788,1788,으로서/Josa,147,76,71,0.0008447635773514439,0.0007885909767421196,0.5170068027210885
1789,1789,사수/Noun,146,132,14,0.0014672209501367186,0.0001554968123153475,0.9041095890410958
1790,1790,허세/Noun,146,18,128,0.0002000755841095525,0.0014216851411688915,0.8767123287671232
1791,1791,와우/Noun,146,125,21,0.001389413778538559,0.00023324521847302128,0.8561643835616438
1792,1792,명성/Noun,146,25,121,0.0002778827557077118,0.001343936735011218,0.8287671232876712
1793,1793,얘/Noun,146,40,106,0.0004446124091323389,0.0011773330075304884,0.726027397260274
1794,1794,올라가다/Verb,146,98,48,0.0010893004023742304,0.0005331319279383344,0.6712328767123288
1795,1795,확/Noun,146,50,96,0.0005557655114154236,0.0010662638558766688,0.6575342465753424
1796,1796,의식/Noun,146,61,85,0.0006780339239268168,0.0009440877890574672,0.5821917808219178
1797,1797,부모/Noun,146,80,66,0.0008892248182646778,0.0007330564009152097,0.547945205479452
1798,1798,아마/Noun,146,78,68,0.0008669941978080608,0.0007552702312459737,0.5342465753424658
1799,1799,검색/Noun,146,78,68,0.0008669941978080608,0.0007552702312459737,0.5342465753424658
1800,1800,성공하다/Adjective,146,69,77,0.0007669564057532844,0.0008552324677344116,0.5273972602739726
1801,1801,카/Noun,146,76,70,0.0008447635773514439,0.0007774840615767378,0.5205479452054794
1802,1802,맥/Noun,146,76,70,0.0008447635773514439,0.0007774840615767378,0.5205479452054794
1803,1803,개막/Noun,145,9,136,0.00010003779205477625,0.0015105404624919474,0.9379310344827586
1804,1804,생생하다/Adjective,145,134,11,0.001489451570593335,0.00012217606681920164,0.9241379310344828
1805,1805,^/Punctuation,145,102,43,0.0011337616432874642,0.0004775973521114245,0.7034482758620689
1806,1806,연결/Noun,145,50,95,0.0005557655114154236,0.0010551569407112867,0.6551724137931034
1807,1807,영어/Noun,145,59,86,0.0006558033034701999,0.0009551947042228492,0.593103448275862
1808,1808,외계인/Noun,145,64,81,0.0007113798546117423,0.0008996601283959392,0.5586206896551724
1809,1809,뭉클하다/Adjective,144,139,5,0.0015450281217348775,5.5534575826909837e-05,0.9652777777777778
1810,1810,마이너스/Noun,144,7,137,7.78071715981593e-05,0.0015216473776573296,0.9513888888888888
1811,1811,밋밋하다/Adjective,144,18,126,0.0002000755841095525,0.0013994713108381278,0.875
1812,1812,묘/Noun,144,118,26,0.0013116066069403995,0.00028877979429993113,0.8194444444444444
1813,1813,...?/Punctuation,144,54,90,0.0006002267523286575,0.000999622364884377,0.625
1814,1814,만큼은/Josa,144,90,54,0.0010003779205477628,0.0005997734189306263,0.625
1815,1815,쪽/Noun,144,57,87,0.0006335726830135829,0.0009663016193882313,0.6041666666666666
1816,1816,오브/Noun,144,74,70,0.0008225329568948269,0.0007774840615767378,0.5138888888888888
1817,1817,저/Modifier,143,26,117,0.00028899806593602026,0.0012995090743496902,0.8181818181818182
1818,1818,풍경/Noun,143,101,42,0.0011226463330591557,0.00046649043694604257,0.7062937062937062
1819,1819,처/Noun,143,44,99,0.0004890736500455726,0.0010995846013728146,0.6923076923076923
1820,1820,드물다/Adjective,143,98,45,0.0010893004023742304,0.0004998111824421885,0.6853146853146853
1821,1821,무언가/Noun,143,97,46,0.0010781850921459217,0.0005109180976075704,0.6783216783216783
1822,1822,이보/Noun,143,79,64,0.0008781095080363692,0.0007108425705844457,0.5524475524475524
1823,1823,이든/Josa,143,77,66,0.0008558788875797522,0.0007330564009152097,0.5384615384615384
1824,1824,ㅉㅉㅉ/KoreanParticle,142,15,127,0.00016672965342462708,0.0014105782260035095,0.8943661971830986
1825,1825,싸이코/Noun,142,29,113,0.0003223439966209457,0.0012550814136881624,0.7957746478873241
1826,1826,만들기/Noun,142,30,112,0.00033345930684925416,0.0012439744985227805,0.7887323943661971
1827,1827,자연스럽다/Adjective,142,112,30,0.0012449147455705488,0.000333207454961459,0.7887323943661971
1828,1828,복잡하다/Adjective,142,92,50,0.0010226085410043797,0.0005553457582690984,0.647887323943662
1829,1829,개성/Noun,142,87,55,0.0009670319898628369,0.0006108803340960082,0.6126760563380281
1830,1830,도전/Noun,142,73,69,0.0008114176466665183,0.0007663771464113557,0.5140845070422535
1831,1831,달달/Noun,141,125,16,0.001389413778538559,0.00017771064264611146,0.8865248226950354
1832,1832,어린시절/Noun,141,123,18,0.001367183158081942,0.00019992447297687542,0.8723404255319149
1833,1833,정체/Noun,141,30,111,0.00033345930684925416,0.0012328675833573985,0.7872340425531915
1834,1834,막장드라마/Noun,141,32,109,0.00035568992730587116,0.0012106537530266347,0.7730496453900709
1835,1835,왠/Modifier,141,33,108,0.00036680523753417966,0.0011995468378612525,0.7659574468085106
1836,1836,마이클/Noun,141,91,50,0.001011493230776071,0.0005553457582690984,0.6453900709219859
1837,1837,옆/Noun,141,63,78,0.0007002645443834338,0.0008663393828997934,0.5531914893617021
1838,1838,무지/Noun,141,77,64,0.0008558788875797522,0.0007108425705844457,0.5460992907801419
1839,1839,조/Noun,141,65,76,0.0007224951648400508,0.0008441255525690295,0.5390070921985816
1840,1840,기준/Noun,141,75,66,0.0008336482671231353,0.0007330564009152097,0.5319148936170213
1841,1841,끌리다/Verb,141,73,68,0.0008114176466665183,0.0007552702312459737,0.5177304964539007
1842,1842,♥♥/Foreign,140,140,0,0.001556143431963186,0.0,1.0
1843,1843,숨기다/Verb,140,114,26,0.0012671453660271655,0.00028877979429993113,0.8142857142857143
1844,1844,세월/Noun,140,105,35,0.0011671075739723895,0.0003887420307883688,0.75
1845,1845,캐리/Noun,140,104,36,0.001155992263744081,0.00039984894595375083,0.7428571428571429
1846,1846,변화/Noun,140,91,49,0.001011493230776071,0.0005442388431037163,0.65
1847,1847,빨다/Verb,140,54,86,0.0006002267523286575,0.0009551947042228492,0.6142857142857143
1848,1848,으로써/Josa,140,83,57,0.0009225707489496033,0.0006330941644267722,0.5928571428571429
1849,1849,코난/Noun,140,82,58,0.0009114554387212947,0.0006442010795921541,0.5857142857142857
1850,1850,이상은/Noun,140,67,73,0.0007447257852966678,0.0008108048070728836,0.5214285714285715
1851,1851,등등/Noun,140,68,72,0.0007558410955249762,0.0007996978919075017,0.5142857142857142
1852,1852,일품/Noun,139,126,13,0.0014005290887668675,0.00014438989714996554,0.9064748201438848
1853,1853,젠장/Noun,139,22,117,0.00024453682502278637,0.0012995090743496902,0.8417266187050358
1854,1854,기회/Noun,139,106,33,0.001178222884200698,0.00036652820045760486,0.7625899280575541
1855,1855,카리스마/Noun,139,105,34,0.0011671075739723895,0.00037763511562298685,0.7553956834532374
1856,1856,남아/Noun,139,97,42,0.0010781850921459217,0.00046649043694604257,0.6978417266187049
1857,1857,깎다/Verb,139,61,78,0.0006780339239268168,0.0008663393828997934,0.5611510791366906
1858,1858,아/Noun,138,27,111,0.0003001133761643288,0.0012328675833573985,0.8043478260869565
1859,1859,칼/Noun,138,41,97,0.00045572771936064734,0.0010773707710420508,0.7028985507246377
1860,1860,신경/Noun,138,42,96,0.00046684302958895584,0.0010662638558766688,0.6956521739130435
1861,1861,자살/Noun,138,43,95,0.00047795833981726434,0.0010551569407112867,0.6884057971014492
1862,1862,오빠/Noun,138,95,43,0.0010559544716893046,0.0004775973521114245,0.6884057971014492
1863,1863,맨/Modifier,138,51,87,0.0005668808216437321,0.0009663016193882313,0.6304347826086957
1864,1864,면서/Noun,138,84,54,0.0009336860591779117,0.0005997734189306263,0.6086956521739131
1865,1865,덜/Noun,138,57,81,0.0006335726830135829,0.0008996601283959392,0.5869565217391305
1866,1866,시청/Noun,138,74,64,0.0008225329568948269,0.0007108425705844457,0.5362318840579711
1867,1867,니깐/Josa,138,74,64,0.0008225329568948269,0.0007108425705844457,0.5362318840579711
1868,1868,얼마/Noun,138,67,71,0.0007447257852966678,0.0007885909767421196,0.5144927536231884
1869,1869,포르노/Noun,137,16,121,0.00017784496365293558,0.001343936735011218,0.8832116788321168
1870,1870,C/Alpha,137,16,121,0.00017784496365293558,0.001343936735011218,0.8832116788321168
1871,1871,응원/Noun,137,116,21,0.0012893759864837828,0.00023324521847302128,0.8467153284671532
1872,1872,겨/Noun,137,26,111,0.00028899806593602026,0.0012328675833573985,0.8102189781021898
1873,1873,압권/Noun,137,111,26,0.0012337994353422404,0.00028877979429993113,0.8102189781021898
1874,1874,다양하다/Adjective,137,99,38,0.0011004157126025386,0.0004220627762845148,0.7226277372262774
1875,1875,모으다/Verb,137,39,98,0.0004334970989040304,0.001088477686207433,0.7153284671532847
1876,1876,형사/Noun,137,43,94,0.00047795833981726434,0.0010440500255459052,0.6861313868613139
1877,1877,만해/Noun,137,91,46,0.001011493230776071,0.0005109180976075704,0.6642335766423357
1878,1878,",,,,/Punctuation",137,50,87,0.0005557655114154236,0.0009663016193882313,0.635036496350365
1879,1879,잠깐/Noun,137,52,85,0.0005779961318720405,0.0009440877890574672,0.6204379562043796
1880,1880,매/Modifier,137,82,55,0.0009114554387212947,0.0006108803340960082,0.5985401459854015
1881,1881,뿐이다/Adjective,137,56,81,0.0006224573727852744,0.0008996601283959392,0.5912408759124088
1882,1882,기자/Noun,137,79,58,0.0008781095080363692,0.0006442010795921541,0.5766423357664233
1883,1883,살아나다/Verb,137,78,59,0.0008669941978080608,0.000655307994757536,0.5693430656934306
1884,1884,?!/Punctuation,137,64,73,0.0007113798546117423,0.0008108048070728836,0.5328467153284672
1885,1885,특이하다/Adjective,137,69,68,0.0007669564057532844,0.0007552702312459737,0.5036496350364964
1886,1886,시시하다/Adjective,136,23,113,0.00025565213525109487,0.0012550814136881624,0.8308823529411765
1887,1887,세번/Noun,136,110,26,0.001222684125113932,0.00028877979429993113,0.8088235294117647
1888,1888,냥/Josa,136,31,105,0.00034457461707756266,0.0011662260923651065,0.7720588235294118
1889,1889,만에/Josa,136,101,35,0.0011226463330591557,0.0003887420307883688,0.7426470588235294
1890,1890,내면/Noun,136,99,37,0.0011004157126025386,0.0004109558611191328,0.7279411764705882
1891,1891,성격/Noun,136,41,95,0.00045572771936064734,0.0010551569407112867,0.6985294117647058
1892,1892,선물/Noun,136,95,41,0.0010559544716893046,0.00045538352178066063,0.6985294117647058
1893,1893,동시/Noun,136,90,46,0.0010003779205477628,0.0005109180976075704,0.6617647058823529
1894,1894,로써/Noun,136,70,66,0.000778071715981593,0.0007330564009152097,0.5147058823529411
1895,1895,신고/Noun,136,66,70,0.0007336104750683593,0.0007774840615767378,0.5147058823529411
1896,1896,러브/Noun,136,69,67,0.0007669564057532844,0.0007441633160805918,0.5073529411764706
1897,1897,에로영화/Noun,135,22,113,0.00024453682502278637,0.0012550814136881624,0.837037037037037
1898,1898,겨우/Noun,135,22,113,0.00024453682502278637,0.0012550814136881624,0.837037037037037
1899,1899,추하다/Adjective,135,108,27,0.001200453504657315,0.0002998867094653131,0.8
1900,1900,적임/Noun,135,96,39,0.0010670697819176133,0.0004331696914498967,0.7111111111111111
1901,1901,만족하다/Adjective,135,93,42,0.0010337238512326881,0.00046649043694604257,0.6888888888888889
1902,1902,형제/Noun,135,91,44,0.001011493230776071,0.0004887042672768067,0.674074074074074
1903,1903,조용하다/Adjective,135,90,45,0.0010003779205477628,0.0004998111824421885,0.6666666666666666
1904,1904,할머니/Noun,135,87,48,0.0009670319898628369,0.0005331319279383344,0.6444444444444445
1905,1905,빈/Noun,135,57,78,0.0006335726830135829,0.0008663393828997934,0.5777777777777777
1906,1906,고양이/Noun,135,64,71,0.0007113798546117423,0.0007885909767421196,0.5259259259259259
1907,1907,아내/Noun,135,70,65,0.000778071715981593,0.0007219494857498278,0.5185185185185185
1908,1908,참으로/Noun,135,69,66,0.0007669564057532844,0.0007330564009152097,0.5111111111111111
1909,1909,가수/Noun,135,66,69,0.0007336104750683593,0.0007663771464113557,0.5111111111111111
1910,1910,야동/Noun,134,25,109,0.0002778827557077118,0.0012106537530266347,0.8134328358208955
1911,1911,롭고/Josa,134,108,26,0.001200453504657315,0.00028877979429993113,0.8059701492537313
1912,1912,당/Suffix,134,44,90,0.0004890736500455726,0.000999622364884377,0.6716417910447762
1913,1913,[/Punctuation,134,44,90,0.0004890736500455726,0.000999622364884377,0.6716417910447762
1914,1914,스럽지/Josa,134,87,47,0.0009670319898628369,0.0005220250127729526,0.6492537313432836
1915,1915,멈추다/Verb,134,84,50,0.0009336860591779117,0.0005553457582690984,0.6268656716417911
1916,1916,넌/Noun,134,54,80,0.0006002267523286575,0.0008885532132305574,0.5970149253731343
1917,1917,우와/Exclamation,134,80,54,0.0008892248182646778,0.0005997734189306263,0.5970149253731343
1918,1918,인들/Josa,134,57,77,0.0006335726830135829,0.0008552324677344116,0.5746268656716418
1919,1919,정의/Noun,134,77,57,0.0008558788875797522,0.0006330941644267722,0.5746268656716418
1920,1920,분명하다/Adjective,134,71,63,0.0007891870262099014,0.0006997356554190639,0.5298507462686567
1921,1921,벗어나다/Verb,134,63,71,0.0007002645443834338,0.0007885909767421196,0.5298507462686567
1922,1922,줄다/Verb,134,64,70,0.0007113798546117423,0.0007774840615767378,0.5223880597014925
1923,1923,장/Noun,134,65,69,0.0007224951648400508,0.0007663771464113557,0.5149253731343284
1924,1924,투자/Noun,133,20,113,0.00022230620456616945,0.0012550814136881624,0.849624060150376
1925,1925,레전드/Noun,133,108,25,0.001200453504657315,0.0002776728791345492,0.8120300751879699
1926,1926,지우다/Verb,133,30,103,0.00033345930684925416,0.0011440122620343426,0.7744360902255639
1927,1927,고통/Noun,133,95,38,0.0010559544716893046,0.0004220627762845148,0.7142857142857143
1928,1928,비현실적/Noun,133,41,92,0.00045572771936064734,0.0010218361952151409,0.6917293233082706
1929,1929,욕망/Noun,133,90,43,0.0010003779205477628,0.0004775973521114245,0.6766917293233082
1930,1930,쉬/Noun,133,90,43,0.0010003779205477628,0.0004775973521114245,0.6766917293233082
1931,1931,방영/Noun,133,85,48,0.0009448013694062199,0.0005331319279383344,0.6390977443609023
1932,1932,영혼/Noun,133,82,51,0.0009114554387212947,0.0005664526734344802,0.6165413533834586
1933,1933,관점/Noun,133,77,56,0.0008558788875797522,0.0006219872492613901,0.5789473684210527
1934,1934,온/Modifier,133,61,72,0.0006780339239268168,0.0007996978919075017,0.5413533834586466
1935,1935,투/Noun,133,68,65,0.0007558410955249762,0.0007219494857498278,0.5112781954887218
1936,1936,듬/Noun,133,68,65,0.0007558410955249762,0.0007219494857498278,0.5112781954887218
1937,1937,진하다/Adjective,132,119,13,0.0013227219171687082,0.00014438989714996554,0.9015151515151516
1938,1938,초등학교/Noun,132,99,33,0.0011004157126025386,0.00036652820045760486,0.75
1939,1939,학년/Noun,132,96,36,0.0010670697819176133,0.00039984894595375083,0.7272727272727273
1940,1940,로그인/Noun,132,41,91,0.00045572771936064734,0.001010729280049759,0.6893939393939394
1941,1941,베/Noun,132,45,87,0.0005001889602738814,0.0009663016193882313,0.6590909090909091
1942,1942,을/Foreign,132,45,87,0.0005001889602738814,0.0009663016193882313,0.6590909090909091
1943,1943,특수/Noun,132,48,84,0.0005335348909588066,0.0009329808738920851,0.6363636363636364
1944,1944,감안/Noun,132,51,81,0.0005668808216437321,0.0008996601283959392,0.6136363636363636
1945,1945,21/Number,132,79,53,0.0008781095080363692,0.0005886665037652442,0.5984848484848485
1946,1946,12/Number,132,54,78,0.0006002267523286575,0.0008663393828997934,0.5909090909090909
1947,1947,상업/Noun,132,55,77,0.000611342062556966,0.0008552324677344116,0.5833333333333334
1948,1948,타/Noun,132,76,56,0.0008447635773514439,0.0006219872492613901,0.5757575757575758
1949,1949,의/Foreign,132,70,62,0.000778071715981593,0.0006886287402536821,0.5303030303030303
1950,1950,M/Alpha,131,5,126,5.557655114154236e-05,0.0013994713108381278,0.9618320610687024
1951,1951,잠들다/Verb,131,17,114,0.00018896027388124405,0.001266188328853544,0.8702290076335878
1952,1952,감흥/Noun,131,19,112,0.00021119089433786097,0.0012439744985227805,0.8549618320610687
1953,1953,붙이다/Verb,131,21,110,0.00023342151479447792,0.0012217606681920164,0.8396946564885496
1954,1954,부럽다/Adjective,131,106,25,0.001178222884200698,0.0002776728791345492,0.8091603053435115
1955,1955,설득/Noun,131,30,101,0.00033345930684925416,0.0011217984317035787,0.7709923664122137
1956,1956,따로/Adverb,131,31,100,0.00034457461707756266,0.0011106915165381968,0.7633587786259542
1957,1957,]/Punctuation,131,38,93,0.000422381788675722,0.001032943110380523,0.7099236641221374
1958,1958,끝내주다/Adjective,131,91,40,0.001011493230776071,0.0004442766066152787,0.6946564885496184
1959,1959,놀랍다/Adjective,131,91,40,0.001011493230776071,0.0004442766066152787,0.6946564885496184
1960,1960,권/Suffix,131,84,47,0.0009336860591779117,0.0005220250127729526,0.6412213740458015
1961,1961,그건/Adverb,131,55,76,0.000611342062556966,0.0008441255525690295,0.5801526717557252
1962,1962,채/Noun,131,59,72,0.0006558033034701999,0.0007996978919075017,0.5496183206106869
1963,1963,일이/Modifier,131,62,69,0.0006891492341551253,0.0007663771464113557,0.5267175572519084
1964,1964,반하다/Adjective,130,112,18,0.0012449147455705488,0.00019992447297687542,0.8615384615384616
1965,1965,점준/Noun,130,23,107,0.00025565213525109487,0.0011884399226958706,0.823076923076923
1966,1966,인지도/Noun,130,26,104,0.00028899806593602026,0.0011551191771997243,0.8
1967,1967,x/Alpha,130,34,96,0.0003779205477624881,0.0010662638558766688,0.7384615384615385
1968,1968,루/Noun,130,36,94,0.000400151168219105,0.0010440500255459052,0.7230769230769231
1969,1969,기발하다/Adjective,130,92,38,0.0010226085410043797,0.0004220627762845148,0.7076923076923077
1970,1970,최강/Noun,130,88,42,0.0009781473000911457,0.00046649043694604257,0.676923076923077
1971,1971,주성치/Noun,130,81,49,0.0009003401284929863,0.0005442388431037163,0.6230769230769231
1972,1972,키우다/Verb,130,60,70,0.0006669186136985082,0.0007774840615767378,0.5384615384615384
1973,1973,배역/Noun,130,62,68,0.0006891492341551253,0.0007552702312459737,0.5230769230769231
1974,1974,악마/Noun,130,62,68,0.0006891492341551253,0.0007552702312459737,0.5230769230769231
1975,1975,안습/Noun,129,16,113,0.00017784496365293558,0.0012550814136881624,0.875968992248062
1976,1976,우려/Noun,129,18,111,0.0002000755841095525,0.0012328675833573985,0.8604651162790697
1977,1977,기만/Noun,129,25,104,0.0002778827557077118,0.0011551191771997243,0.8062015503875969
1978,1978,조작/Noun,129,25,104,0.0002778827557077118,0.0011551191771997243,0.8062015503875969
1979,1979,고르다/Verb,129,29,100,0.0003223439966209457,0.0011106915165381968,0.7751937984496124
1980,1980,오랫/Modifier,129,97,32,0.0010781850921459217,0.00035542128529222287,0.751937984496124
1981,1981,스트레스/Noun,129,35,94,0.0003890358579907965,0.0010440500255459052,0.7286821705426356
1982,1982,색감/Noun,129,91,38,0.001011493230776071,0.0004220627762845148,0.7054263565891473
1983,1983,결정/Noun,129,55,74,0.000611342062556966,0.0008219117222382655,0.5736434108527132
1984,1984,자리/Noun,129,74,55,0.0008225329568948269,0.0006108803340960082,0.5736434108527132
1985,1985,놀래다/Adjective,129,56,73,0.0006224573727852744,0.0008108048070728836,0.5658914728682171
1986,1986,본적/Noun,129,70,59,0.000778071715981593,0.000655307994757536,0.5426356589147286
1987,1987,모자라다/Verb,129,63,66,0.0007002645443834338,0.0007330564009152097,0.5116279069767442
1988,1988,공짜/Noun,128,5,123,5.557655114154236e-05,0.001366150565341982,0.9609375
1989,1989,18/Number,128,28,100,0.0003112286863926372,0.0011106915165381968,0.78125
1990,1990,놀다/Verb,128,36,92,0.000400151168219105,0.0010218361952151409,0.71875
1991,1991,아무렇다/Adjective,128,37,91,0.00041126647844741344,0.001010729280049759,0.7109375
1992,1992,데리/Noun,128,41,87,0.00045572771936064734,0.0009663016193882313,0.6796875
1993,1993,포인트/Noun,128,42,86,0.00046684302958895584,0.0009551947042228492,0.671875
1994,1994,ㄱ/KoreanParticle,128,45,83,0.0005001889602738814,0.0009218739587267033,0.6484375
1995,1995,저러다/Verb,128,45,83,0.0005001889602738814,0.0009218739587267033,0.6484375
1996,1996,갑/Noun,128,83,45,0.0009225707489496033,0.0004998111824421885,0.6484375
1997,1997,바다/Noun,128,75,53,0.0008336482671231353,0.0005886665037652442,0.5859375
1998,1998,홍콩영화/Noun,128,59,69,0.0006558033034701999,0.0007663771464113557,0.5390625
1999,1999,교육/Noun,128,61,67,0.0006780339239268168,0.0007441633160805918,0.5234375
2000,2000,어/Noun,128,67,61,0.0007447257852966678,0.0006775218250882999,0.5234375
2001,2001,정신병/Noun,127,21,106,0.00023342151479447792,0.0011773330075304884,0.8346456692913385
2002,2002,깨우다/Verb,127,105,22,0.0011671075739723895,0.00024435213363840333,0.8267716535433071
2003,2003,아예/Noun,127,26,101,0.00028899806593602026,0.0011217984317035787,0.7952755905511811
2004,2004,여러가지/Noun,127,95,32,0.0010559544716893046,0.00035542128529222287,0.7480314960629921
2005,2005,미가/Noun,127,94,33,0.0010448391614609964,0.00036652820045760486,0.7401574803149606
2006,2006,넘어가다/Verb,127,40,87,0.0004446124091323389,0.0009663016193882313,0.6850393700787402
2007,2007,김/Noun,127,52,75,0.0005779961318720405,0.0008330186374036475,0.5905511811023622
2008,2008,풍자/Noun,127,75,52,0.0008336482671231353,0.0005775595885998622,0.5905511811023622
2009,2009,냄새/Noun,127,55,72,0.000611342062556966,0.0007996978919075017,0.5669291338582677
2010,2010,아래/Noun,127,57,70,0.0006335726830135829,0.0007774840615767378,0.5511811023622047
2011,2011,저런/Modifier,127,66,61,0.0007336104750683593,0.0006775218250882999,0.5196850393700787
2012,2012,경/Modifier,127,62,65,0.0006891492341551253,0.0007219494857498278,0.5118110236220472
2013,2013,최초/Noun,127,65,62,0.0007224951648400508,0.0006886287402536821,0.5118110236220472
2014,2014,영국/Noun,127,63,64,0.0007002645443834338,0.0007108425705844457,0.5039370078740157
2015,2015,틈/Noun,126,106,20,0.001178222884200698,0.00022213830330763932,0.8412698412698413
2016,2016,;;;;/Punctuation,126,26,100,0.00028899806593602026,0.0011106915165381968,0.7936507936507936
2017,2017,껏/Noun,126,28,98,0.0003112286863926372,0.001088477686207433,0.7777777777777778
2018,2018,위로/Noun,126,91,35,0.001011493230776071,0.0003887420307883688,0.7222222222222222
2019,2019,전쟁영화/Noun,126,88,38,0.0009781473000911457,0.0004220627762845148,0.6984126984126984
2020,2020,보고오다/Verb,126,78,48,0.0008669941978080608,0.0005331319279383344,0.6190476190476191
2021,2021,잔/Noun,126,49,77,0.0005446502011871152,0.0008552324677344116,0.6111111111111112
2022,2022,녀/Noun,126,51,75,0.0005668808216437321,0.0008330186374036475,0.5952380952380952
2023,2023,약/Noun,126,52,74,0.0005779961318720405,0.0008219117222382655,0.5873015873015873
2024,2024,관련/Noun,126,57,69,0.0006335726830135829,0.0007663771464113557,0.5476190476190477
2025,2025,덕/Noun,126,61,65,0.0006780339239268168,0.0007219494857498278,0.5158730158730159
2026,2026,목/Noun,126,65,61,0.0007224951648400508,0.0006775218250882999,0.5158730158730159
2027,2027,효/Noun,125,24,101,0.0002667674454794033,0.0011217984317035787,0.8079999999999999
2028,2028,용기/Noun,125,98,27,0.0010893004023742304,0.0002998867094653131,0.784
2029,2029,뜨겁다/Adjective,125,97,28,0.0010781850921459217,0.000310993624630695,0.7759999999999999
2030,2030,패/Noun,125,38,87,0.000422381788675722,0.0009663016193882313,0.696
2031,2031,공포물/Noun,125,40,85,0.0004446124091323389,0.0009440877890574672,0.68
2032,2032,근래/Noun,125,84,41,0.0009336860591779117,0.00045538352178066063,0.672
2033,2033,수고/Noun,125,82,43,0.0009114554387212947,0.0004775973521114245,0.6559999999999999
2034,2034,만남/Noun,125,80,45,0.0008892248182646778,0.0004998111824421885,0.64
2035,2035,깜짝/Noun,125,73,52,0.0008114176466665183,0.0005775595885998622,0.584
2036,2036,우주/Noun,125,72,53,0.00080030233643821,0.0005886665037652442,0.5760000000000001
2037,2037,달리다/Verb,125,55,70,0.000611342062556966,0.0007774840615767378,0.56
2038,2038,나타나다/Verb,125,58,67,0.0006446879932418914,0.0007441633160805918,0.536
2039,2039,말아먹다/Verb,124,12,112,0.00013338372273970166,0.0012439744985227805,0.9032258064516128
2040,2040,운명/Noun,124,93,31,0.0010337238512326881,0.00034431437012684104,0.75
2041,2041,연인/Noun,124,91,33,0.001011493230776071,0.00036652820045760486,0.7338709677419355
2042,2042,이용/Noun,124,38,86,0.000422381788675722,0.0009551947042228492,0.6935483870967742
2043,2043,",./Punctuation",124,41,83,0.00045572771936064734,0.0009218739587267033,0.6693548387096774
2044,2044,007/Number,124,79,45,0.0008781095080363692,0.0004998111824421885,0.6370967741935484
2045,2045,DVD/Alpha,124,79,45,0.0008781095080363692,0.0004998111824421885,0.6370967741935484
2046,2046,거짓말/Noun,124,46,78,0.0005113042705021896,0.0008663393828997934,0.6290322580645161
2047,2047,영화계/Noun,124,47,77,0.0005224195807304982,0.0008552324677344116,0.6209677419354839
2048,2048,파/Noun,124,68,56,0.0007558410955249762,0.0006219872492613901,0.5483870967741935
2049,2049,심오하다/Adjective,124,68,56,0.0007558410955249762,0.0006219872492613901,0.5483870967741935
2050,2050,물이/Noun,124,58,66,0.0006446879932418914,0.0007330564009152097,0.532258064516129
2051,2051,만은/Josa,124,59,65,0.0006558033034701999,0.0007219494857498278,0.5241935483870968
2052,2052,린/Noun,124,64,60,0.0007113798546117423,0.000666414909922918,0.5161290322580645
2053,2053,썩다/Verb,123,33,90,0.00036680523753417966,0.000999622364884377,0.7317073170731707
2054,2054,확인/Noun,123,35,88,0.0003890358579907965,0.000977408534553613,0.7154471544715447
2055,2055,해결/Noun,123,42,81,0.00046684302958895584,0.0008996601283959392,0.6585365853658537
2056,2056,군/Noun,123,46,77,0.0005113042705021896,0.0008552324677344116,0.6260162601626016
2057,2057,캐/Noun,123,50,73,0.0005557655114154236,0.0008108048070728836,0.5934959349593496
2058,2058,만을/Josa,123,54,69,0.0006002267523286575,0.0007663771464113557,0.5609756097560976
2059,2059,리즈/Noun,123,55,68,0.000611342062556966,0.0007552702312459737,0.5528455284552846
2060,2060,단어/Noun,123,57,66,0.0006335726830135829,0.0007330564009152097,0.5365853658536586
2061,2061,사진/Noun,123,59,64,0.0006558033034701999,0.0007108425705844457,0.5203252032520326
2062,2062,깨/Noun,123,62,61,0.0006891492341551253,0.0006775218250882999,0.5040650406504065
2063,2063,가득/Noun,123,62,61,0.0006891492341551253,0.0006775218250882999,0.5040650406504065
2064,2064,았/Noun,122,13,109,0.00014449903296801013,0.0012106537530266347,0.8934426229508197
2065,2065,번은/Noun,122,102,20,0.0011337616432874642,0.00022213830330763932,0.8360655737704918
2066,2066,설마/Noun,122,22,100,0.00024453682502278637,0.0011106915165381968,0.819672131147541
2067,2067,결코/Noun,122,91,31,0.001011493230776071,0.00034431437012684104,0.7459016393442623
2068,2068,원/Noun,122,31,91,0.00034457461707756266,0.001010729280049759,0.7459016393442623
2069,2069,잖다/Verb,122,34,88,0.0003779205477624881,0.000977408534553613,0.7213114754098361
2070,2070,갠/Noun,122,84,38,0.0009336860591779117,0.0004220627762845148,0.6885245901639344
2071,2071,갖추다/Verb,122,82,40,0.0009114554387212947,0.0004442766066152787,0.6721311475409836
2072,2072,전에/Foreign,122,79,43,0.0008781095080363692,0.0004775973521114245,0.6475409836065574
2073,2073,예능/Noun,122,51,71,0.0005668808216437321,0.0007885909767421196,0.5819672131147541
2074,2074,점줌/Noun,122,51,71,0.0005668808216437321,0.0007885909767421196,0.5819672131147541
2075,2075,내생/Noun,122,69,53,0.0007669564057532844,0.0005886665037652442,0.5655737704918032
2076,2076,백/Modifier,122,66,56,0.0007336104750683593,0.0006219872492613901,0.5409836065573771
2077,2077,보통/Noun,122,63,59,0.0007002645443834338,0.000655307994757536,0.5163934426229508
2078,2078,낮추다/Verb,121,16,105,0.00017784496365293558,0.0011662260923651065,0.8677685950413223
2079,2079,셈/Noun,121,20,101,0.00022230620456616945,0.0011217984317035787,0.8347107438016529
2080,2080,변태/Noun,121,21,100,0.00023342151479447792,0.0011106915165381968,0.8264462809917356
2081,2081,심지어/Noun,121,31,90,0.00034457461707756266,0.000999622364884377,0.743801652892562
2082,2082,자르다/Verb,121,40,81,0.0004446124091323389,0.0008996601283959392,0.6694214876033058
2083,2083,째/Suffix,121,69,52,0.0007669564057532844,0.0005775595885998622,0.5702479338842975
2084,2084,들어서다/Verb,121,65,56,0.0007224951648400508,0.0006219872492613901,0.5371900826446281
2085,2085,트/Noun,121,63,58,0.0007002645443834338,0.0006442010795921541,0.5206611570247934
2086,2086,잔뜩/Noun,120,15,105,0.00016672965342462708,0.0011662260923651065,0.875
2087,2087,5분/Number,120,18,102,0.0002000755841095525,0.0011329053468689607,0.85
2088,2088,크리스마스/Noun,120,89,31,0.000989262610319454,0.00034431437012684104,0.7416666666666667
2089,2089,X/Alpha,120,31,89,0.00034457461707756266,0.0009885154497189948,0.7416666666666667
2090,2090,스런/Josa,120,39,81,0.0004334970989040304,0.0008996601283959392,0.675
2091,2091,여러/Noun,120,79,41,0.0008781095080363692,0.00045538352178066063,0.6583333333333333
2092,2092,넘기다/Verb,120,43,77,0.00047795833981726434,0.0008552324677344116,0.6416666666666667
2093,2093,편도/Noun,120,77,43,0.0008558788875797522,0.0004775973521114245,0.6416666666666667
2094,2094,이래서/Josa,120,46,74,0.0005113042705021896,0.0008219117222382655,0.6166666666666667
2095,2095,스크린/Noun,120,71,49,0.0007891870262099014,0.0005442388431037163,0.5916666666666667
2096,2096,상태/Noun,120,53,67,0.000589111442100349,0.0007441633160805918,0.5583333333333333
2097,2097,달리/Noun,120,54,66,0.0006002267523286575,0.0007330564009152097,0.55
2098,2098,국가/Noun,120,65,55,0.0007224951648400508,0.0006108803340960082,0.5416666666666666
2099,2099,ㅅ/KoreanParticle,120,56,64,0.0006224573727852744,0.0007108425705844457,0.5333333333333333
2100,2100,전율/Noun,119,110,9,0.001222684125113932,9.996223648843771e-05,0.9243697478991596
2101,2101,둘째/Noun,119,14,105,0.0001556143431963186,0.0011662260923651065,0.8823529411764706
2102,2102,려고/Noun,119,23,96,0.00025565213525109487,0.0010662638558766688,0.8067226890756303
2103,2103,아동/Noun,119,28,91,0.0003112286863926372,0.001010729280049759,0.7647058823529411
2104,2104,그립다/Adjective,119,86,33,0.0009559166796345287,0.00036652820045760486,0.7226890756302521
2105,2105,탓/Noun,119,35,84,0.0003890358579907965,0.0009329808738920851,0.7058823529411765
2106,2106,뛰어넘다/Verb,119,83,36,0.0009225707489496033,0.00039984894595375083,0.6974789915966386
2107,2107,제외/Noun,119,43,76,0.00047795833981726434,0.0008441255525690295,0.6386554621848739
2108,2108,자주/Noun,119,76,43,0.0008447635773514439,0.0004775973521114245,0.6386554621848739
2109,2109,옷/Noun,119,48,71,0.0005335348909588066,0.0007885909767421196,0.5966386554621849
2110,2110,통/Noun,119,49,70,0.0005446502011871152,0.0007774840615767378,0.5882352941176471
2111,2111,케/Noun,119,51,68,0.0005668808216437321,0.0007552702312459737,0.5714285714285714
2112,2112,넘어서다/Verb,119,67,52,0.0007447257852966678,0.0005775595885998622,0.5630252100840336
2113,2113,기법/Noun,119,53,66,0.000589111442100349,0.0007330564009152097,0.5546218487394958
2114,2114,의하다/Adjective,119,66,53,0.0007336104750683593,0.0005886665037652442,0.5546218487394958
2115,2115,아역/Noun,119,63,56,0.0007002645443834338,0.0006219872492613901,0.5294117647058824
2116,2116,오빠/Suffix,118,106,12,0.001178222884200698,0.0001332829819845836,0.8983050847457628
2117,2117,작위/Noun,118,17,101,0.00018896027388124405,0.0011217984317035787,0.8559322033898306
2118,2118,대본/Noun,118,24,94,0.0002667674454794033,0.0010440500255459052,0.7966101694915254
2119,2119,부모님/Noun,118,89,29,0.000989262610319454,0.00032210053979607705,0.7542372881355932
2120,2120,톰/Noun,118,83,35,0.0009225707489496033,0.0003887420307883688,0.7033898305084746
2121,2121,두번째/Noun,118,81,37,0.0009003401284929863,0.0004109558611191328,0.6864406779661016
2122,2122,에나/Josa,118,38,80,0.000422381788675722,0.0008885532132305574,0.6779661016949152
2123,2123,짜임새/Noun,118,71,47,0.0007891870262099014,0.0005220250127729526,0.6016949152542372
2124,2124,꼬마/Noun,118,67,51,0.0007447257852966678,0.0005664526734344802,0.5677966101694916
2125,2125,매니아/Noun,118,55,63,0.000611342062556966,0.0006997356554190639,0.5338983050847458
2126,2126,:)/Punctuation,117,114,3,0.0012671453660271655,3.33207454961459e-05,0.9743589743589745
2127,2127,한개/Modifier,117,10,107,0.00011115310228308472,0.0011884399226958706,0.9145299145299144
2128,2128,애쓰다/Verb,117,25,92,0.0002778827557077118,0.0010218361952151409,0.7863247863247863
2129,2129,하나같이/Adverb,117,28,89,0.0003112286863926372,0.0009885154497189948,0.7606837606837606
2130,2130,가족영화/Noun,117,77,40,0.0008558788875797522,0.0004442766066152787,0.6581196581196581
2131,2131,케릭/Noun,117,44,73,0.0004890736500455726,0.0008108048070728836,0.6239316239316239
2132,2132,사상/Noun,117,46,71,0.0005113042705021896,0.0007885909767421196,0.6068376068376068
2133,2133,흑인/Noun,117,47,70,0.0005224195807304982,0.0007774840615767378,0.5982905982905983
2134,2134,비밀/Noun,117,51,66,0.0005668808216437321,0.0007330564009152097,0.5641025641025641
2135,2135,감정이입/Noun,117,53,64,0.000589111442100349,0.0007108425705844457,0.5470085470085471
2136,2136,대중/Noun,117,54,63,0.0006002267523286575,0.0006997356554190639,0.5384615384615384
2137,2137,땅/Noun,117,62,55,0.0006891492341551253,0.0006108803340960082,0.5299145299145299
2138,2138,쥐/Noun,117,60,57,0.0006669186136985082,0.0006330941644267722,0.5128205128205128
2139,2139,그만/Modifier,116,9,107,0.00010003779205477625,0.0011884399226958706,0.9224137931034484
2140,2140,하자/Noun,116,24,92,0.0002667674454794033,0.0010218361952151409,0.7931034482758621
2141,2141,정작/Noun,116,29,87,0.0003223439966209457,0.0009663016193882313,0.75
2142,2142,거나/Noun,116,33,83,0.00036680523753417966,0.0009218739587267033,0.7155172413793104
2143,2143,신의/Noun,116,79,37,0.0008781095080363692,0.0004109558611191328,0.6810344827586207
2144,2144,장가/Noun,116,37,79,0.00041126647844741344,0.0008774462980651753,0.6810344827586207
2145,2145,무료/Noun,116,40,76,0.0004446124091323389,0.0008441255525690295,0.6551724137931034
2146,2146,예/Noun,116,40,76,0.0004446124091323389,0.0008441255525690295,0.6551724137931034
2147,2147,꺼/Suffix,116,40,76,0.0004446124091323389,0.0008441255525690295,0.6551724137931034
2148,2148,워/Noun,116,49,67,0.0005446502011871152,0.0007441633160805918,0.5775862068965517
2149,2149,박/Noun,116,64,52,0.0007113798546117423,0.0005775595885998622,0.5517241379310345
2150,2150,와의/Josa,116,64,52,0.0007113798546117423,0.0005775595885998622,0.5517241379310345
2151,2151,디/Noun,116,61,55,0.0006780339239268168,0.0006108803340960082,0.5258620689655172
2152,2152,대놓고/Adverb,115,17,98,0.00018896027388124405,0.001088477686207433,0.8521739130434782
2153,2153,ㅠㅜ/KoreanParticle,115,89,26,0.000989262610319454,0.00028877979429993113,0.7739130434782608
2154,2154,소년/Noun,115,84,31,0.0009336860591779117,0.00034431437012684104,0.7304347826086957
2155,2155,열연/Noun,115,80,35,0.0008892248182646778,0.0003887420307883688,0.6956521739130435
2156,2156,성은/Noun,115,36,79,0.000400151168219105,0.0008774462980651753,0.6869565217391305
2157,2157,목적/Noun,115,37,78,0.00041126647844741344,0.0008663393828997934,0.6782608695652174
2158,2158,충실하다/Adjective,115,77,38,0.0008558788875797522,0.0004220627762845148,0.6695652173913044
2159,2159,의심/Noun,115,40,75,0.0004446124091323389,0.0008330186374036475,0.6521739130434783
2160,2160,메/Noun,115,75,40,0.0008336482671231353,0.0004442766066152787,0.6521739130434783
2161,2161,낫/Noun,115,43,72,0.00047795833981726434,0.0007996978919075017,0.6260869565217392
2162,2162,으리/Noun,115,71,44,0.0007891870262099014,0.0004887042672768067,0.6173913043478261
2163,2163,탄생/Noun,115,63,52,0.0007002645443834338,0.0005775595885998622,0.5478260869565217
2164,2164,무술/Noun,115,53,62,0.000589111442100349,0.0006886287402536821,0.5391304347826087
2165,2165,금보/Noun,115,58,57,0.0006446879932418914,0.0006330941644267722,0.5043478260869565
2166,2166,힘내다/Verb,114,95,19,0.0010559544716893046,0.00021103138814225735,0.8333333333333334
2167,2167,겪다/Verb,114,87,27,0.0009670319898628369,0.0002998867094653131,0.7631578947368421
2168,2168,씹다/Verb,114,31,83,0.00034457461707756266,0.0009218739587267033,0.7280701754385965
2169,2169,패러디/Noun,114,36,78,0.000400151168219105,0.0008663393828997934,0.6842105263157895
2170,2170,꿈꾸다/Verb,114,77,37,0.0008558788875797522,0.0004109558611191328,0.6754385964912281
2171,2171,새다/Verb,114,42,72,0.00046684302958895584,0.0007996978919075017,0.631578947368421
2172,2172,the/Alpha,114,71,43,0.0007891870262099014,0.0004775973521114245,0.6228070175438597
2173,2173,구나/Noun,114,44,70,0.0004890736500455726,0.0007774840615767378,0.6140350877192983
2174,2174,15/Number,114,45,69,0.0005001889602738814,0.0007663771464113557,0.6052631578947368
2175,2175,지나가다/Verb,114,68,46,0.0007558410955249762,0.0005109180976075704,0.5964912280701754
2176,2176,화끈하다/Adjective,114,65,49,0.0007224951648400508,0.0005442388431037163,0.5701754385964912
2177,2177,애가/Noun,114,50,64,0.0005557655114154236,0.0007108425705844457,0.5614035087719298
2178,2178,명의/Noun,114,61,53,0.0006780339239268168,0.0005886665037652442,0.5350877192982456
2179,2179,여러분/Noun,114,58,56,0.0006446879932418914,0.0006219872492613901,0.5087719298245614
2180,2180,시점/Noun,114,58,56,0.0006446879932418914,0.0006219872492613901,0.5087719298245614
2181,2181,20분/Number,113,18,95,0.0002000755841095525,0.0010551569407112867,0.8407079646017699
2182,2182,ㅜㅜㅜ/KoreanParticle,113,83,30,0.0009225707489496033,0.000333207454961459,0.7345132743362832
2183,2183,..;;/Punctuation,113,31,82,0.00034457461707756266,0.0009107670435613213,0.7256637168141593
2184,2184,무서움/Noun,113,47,66,0.0005224195807304982,0.0007330564009152097,0.584070796460177
2185,2185,브루스/Noun,113,48,65,0.0005335348909588066,0.0007219494857498278,0.5752212389380531
2186,2186,움직이다/Verb,113,59,54,0.0006558033034701999,0.0005997734189306263,0.5221238938053098
2187,2187,블록버스터/Noun,113,58,55,0.0006446879932418914,0.0006108803340960082,0.5132743362831859
2188,2188,명화/Noun,112,90,22,0.0010003779205477628,0.00024435213363840333,0.8035714285714286
2189,2189,값/Noun,112,27,85,0.0003001133761643288,0.0009440877890574672,0.7589285714285714
2190,2190,감각/Noun,112,73,39,0.0008114176466665183,0.0004331696914498967,0.6517857142857143
2191,2191,부부/Noun,112,68,44,0.0007558410955249762,0.0004887042672768067,0.6071428571428571
2192,2192,집착/Noun,112,45,67,0.0005001889602738814,0.0007441633160805918,0.5982142857142857
2193,2193,틀/Noun,112,51,61,0.0005668808216437321,0.0006775218250882999,0.5446428571428571
2194,2194,주제가/Noun,112,51,61,0.0005668808216437321,0.0006775218250882999,0.5446428571428571
2195,2195,골/Noun,112,51,61,0.0005668808216437321,0.0006775218250882999,0.5446428571428571
2196,2196,후속작/Noun,112,53,59,0.000589111442100349,0.000655307994757536,0.5267857142857143
2197,2197,찾기/Noun,112,55,57,0.000611342062556966,0.0006330941644267722,0.5089285714285714
2198,2198,낚였다/Noun,111,2,109,2.2230620456616947e-05,0.0012106537530266347,0.981981981981982
2199,2199,참나/Noun,111,10,101,0.00011115310228308472,0.0011217984317035787,0.90990990990991
2200,2200,오래전/Adverb,111,85,26,0.0009448013694062199,0.00028877979429993113,0.7657657657657657
2201,2201,!!!!!/Punctuation,111,81,30,0.0009003401284929863,0.000333207454961459,0.7297297297297297
2202,2202,뇌/Noun,111,37,74,0.00041126647844741344,0.0008219117222382655,0.6666666666666666
2203,2203,시기/Noun,111,68,43,0.0007558410955249762,0.0004775973521114245,0.6126126126126126
2204,2204,앉다/Verb,111,44,67,0.0004890736500455726,0.0007441633160805918,0.6036036036036037
2205,2205,피다/Verb,111,48,63,0.0005335348909588066,0.0006997356554190639,0.5675675675675675
2206,2206,어둡다/Adjective,111,49,62,0.0005446502011871152,0.0006886287402536821,0.5585585585585585
2207,2207,모험/Noun,111,60,51,0.0006669186136985082,0.0005664526734344802,0.5405405405405406
2208,2208,울컥/Adverb,110,108,2,0.001200453504657315,2.2213830330763933e-05,0.9818181818181818
2209,2209,짜지다/Verb,110,12,98,0.00013338372273970166,0.001088477686207433,0.8909090909090909
2210,2210,신파/Noun,110,16,94,0.00017784496365293558,0.0010440500255459052,0.8545454545454545
2211,2211,첫사랑/Noun,110,90,20,0.0010003779205477628,0.00022213830330763932,0.8181818181818182
2212,2212,업다/Verb,110,29,81,0.0003223439966209457,0.0008996601283959392,0.7363636363636363
2213,2213,몇몇/Noun,110,33,77,0.00036680523753417966,0.0008552324677344116,0.7
2214,2214,모양/Noun,110,36,74,0.000400151168219105,0.0008219117222382655,0.6727272727272727
2215,2215,70년/Number,110,37,73,0.00041126647844741344,0.0008108048070728836,0.6636363636363637
2216,2216,담배/Noun,110,40,70,0.0004446124091323389,0.0007774840615767378,0.6363636363636364
2217,2217,할아버지/Noun,110,67,43,0.0007447257852966678,0.0004775973521114245,0.6090909090909091
2218,2218,탑/Noun,110,66,44,0.0007336104750683593,0.0004887042672768067,0.6
2219,2219,물다/Verb,110,51,59,0.0005668808216437321,0.000655307994757536,0.5363636363636364
2220,2220,타고/Noun,110,54,56,0.0006002267523286575,0.0006219872492613901,0.509090909090909
2221,2221,한숨/Noun,109,12,97,0.00013338372273970166,0.0010773707710420508,0.8899082568807339
2222,2222,시끄럽다/Adjective,109,15,94,0.00016672965342462708,0.0010440500255459052,0.8623853211009175
2223,2223,세련되다/Adjective,109,94,15,0.0010448391614609964,0.0001666037274807295,0.8623853211009175
2224,2224,고전/Noun,109,80,29,0.0008892248182646778,0.00032210053979607705,0.7339449541284404
2225,2225,삭제/Noun,109,31,78,0.00034457461707756266,0.0008663393828997934,0.7155963302752294
2226,2226,빵빵/Noun,109,77,32,0.0008558788875797522,0.00035542128529222287,0.7064220183486238
2227,2227,졸/Noun,109,33,76,0.00036680523753417966,0.0008441255525690295,0.6972477064220184
2228,2228,철/Noun,109,35,74,0.0003890358579907965,0.0008219117222382655,0.6788990825688074
2229,2229,적어도/Adverb,109,63,46,0.0007002645443834338,0.0005109180976075704,0.5779816513761468
2230,2230,어쩜/Noun,109,47,62,0.0005224195807304982,0.0006886287402536821,0.5688073394495413
2231,2231,거부/Noun,109,49,60,0.0005446502011871152,0.000666414909922918,0.5504587155963303
2232,2232,11/Number,109,52,57,0.0005779961318720405,0.0006330941644267722,0.5229357798165137
2233,2233,.^^/Punctuation,108,97,11,0.0010781850921459217,0.00012217606681920164,0.8981481481481481
2234,2234,말고는/Josa,108,11,97,0.00012226841251139318,0.0010773707710420508,0.8981481481481481
2235,2235,십/Modifier,108,76,32,0.0008447635773514439,0.00035542128529222287,0.7037037037037037
2236,2236,그만큼/Adverb,108,76,32,0.0008447635773514439,0.00035542128529222287,0.7037037037037037
2237,2237,최대/Noun,108,37,71,0.00041126647844741344,0.0007885909767421196,0.6574074074074074
2238,2238,언니/Noun,108,69,39,0.0007669564057532844,0.0004331696914498967,0.6388888888888888
2239,2239,화의/Noun,108,39,69,0.0004334970989040304,0.0007663771464113557,0.6388888888888888
2240,2240,마이/Noun,108,40,68,0.0004446124091323389,0.0007552702312459737,0.6296296296296297
2241,2241,탈/Noun,108,40,68,0.0004446124091323389,0.0007552702312459737,0.6296296296296297
2242,2242,누나/Noun,108,65,43,0.0007224951648400508,0.0004775973521114245,0.6018518518518519
2243,2243,포스/Noun,108,65,43,0.0007224951648400508,0.0004775973521114245,0.6018518518518519
2244,2244,ㅁ/KoreanParticle,108,63,45,0.0007002645443834338,0.0004998111824421885,0.5833333333333334
2245,2245,기독교/Noun,108,46,62,0.0005113042705021896,0.0006886287402536821,0.5740740740740741
2246,2246,아이디어/Noun,108,49,59,0.0005446502011871152,0.000655307994757536,0.5462962962962963
2247,2247,sf/Alpha,108,58,50,0.0006446879932418914,0.0005553457582690984,0.5370370370370371
2248,2248,빈약하다/Adjective,107,12,95,0.00013338372273970166,0.0010551569407112867,0.8878504672897196
2249,2249,떨다/Verb,107,36,71,0.000400151168219105,0.0007885909767421196,0.6635514018691588
2250,2250,여태/Noun,107,63,44,0.0007002645443834338,0.0004887042672768067,0.5887850467289719
2251,2251,하늘/Noun,107,63,44,0.0007002645443834338,0.0004887042672768067,0.5887850467289719
2252,2252,종영/Noun,107,60,47,0.0006669186136985082,0.0005220250127729526,0.5607476635514018
2253,2253,어처구니/Noun,106,11,95,0.00012226841251139318,0.0010551569407112867,0.8962264150943396
2254,2254,..^^/Punctuation,106,92,14,0.0010226085410043797,0.0001554968123153475,0.8679245283018868
2255,2255,중독/Noun,106,87,19,0.0009670319898628369,0.00021103138814225735,0.8207547169811321
2256,2256,폐지/Noun,106,30,76,0.00033345930684925416,0.0008441255525690295,0.7169811320754716
2257,2257,치밀하다/Adjective,106,73,33,0.0008114176466665183,0.00036652820045760486,0.6886792452830188
2258,2258,흑/Adverb,106,72,34,0.00080030233643821,0.00037763511562298685,0.6792452830188679
2259,2259,수많다/Adjective,106,61,45,0.0006780339239268168,0.0004998111824421885,0.5754716981132075
2260,2260,재능/Noun,106,47,59,0.0005224195807304982,0.000655307994757536,0.5566037735849056
2261,2261,바르다/Verb,106,49,57,0.0005446502011871152,0.0006330941644267722,0.5377358490566038
2262,2262,A/Alpha,106,53,53,0.000589111442100349,0.0005886665037652442,0.5
2263,2263,선동/Noun,105,10,95,0.00011115310228308472,0.0010551569407112867,0.9047619047619048
2264,2264,팔이/Noun,105,11,94,0.00012226841251139318,0.0010440500255459052,0.8952380952380953
2265,2265,여름/Noun,105,85,20,0.0009448013694062199,0.00022213830330763932,0.8095238095238095
2266,2266,안감/Noun,105,22,83,0.00024453682502278637,0.0009218739587267033,0.7904761904761904
2267,2267,늘어지다/Verb,105,24,81,0.0002667674454794033,0.0008996601283959392,0.7714285714285715
2268,2268,또다른/Modifier,105,78,27,0.0008669941978080608,0.0002998867094653131,0.7428571428571429
2269,2269,중학교/Noun,105,77,28,0.0008558788875797522,0.000310993624630695,0.7333333333333333
2270,2270,바탕/Noun,105,73,32,0.0008114176466665183,0.00035542128529222287,0.6952380952380952
2271,2271,목숨/Noun,105,70,35,0.000778071715981593,0.0003887420307883688,0.6666666666666666
2272,2272,잡/Noun,105,36,69,0.000400151168219105,0.0007663771464113557,0.6571428571428571
2273,2273,버전/Noun,105,38,67,0.000422381788675722,0.0007441633160805918,0.6380952380952379
2274,2274,보구/Noun,105,62,43,0.0006891492341551253,0.0004775973521114245,0.5904761904761905
2275,2275,대신/Noun,105,44,61,0.0004890736500455726,0.0006775218250882999,0.580952380952381
2276,2276,삼/Noun,105,45,60,0.0005001889602738814,0.000666414909922918,0.5714285714285714
2277,2277,혹은/Adverb,105,56,49,0.0006224573727852744,0.0005442388431037163,0.5333333333333333
2278,2278,마리/Noun,105,51,54,0.0005668808216437321,0.0005997734189306263,0.5142857142857142
2279,2279,여기다/Verb,105,52,53,0.0005779961318720405,0.0005886665037652442,0.5047619047619047
2280,2280,끼우다/Verb,104,10,94,0.00011115310228308472,0.0010440500255459052,0.903846153846154
2281,2281,메이드/Noun,104,91,13,0.001011493230776071,0.00014438989714996554,0.875
2282,2282,캬/Noun,104,89,15,0.000989262610319454,0.0001666037274807295,0.8557692307692307
2283,2283,어쩌/Noun,104,16,88,0.00017784496365293558,0.000977408534553613,0.8461538461538461
2284,2284,구리/Noun,104,16,88,0.00017784496365293558,0.000977408534553613,0.8461538461538461
2285,2285,호구/Noun,104,17,87,0.00018896027388124405,0.0009663016193882313,0.8365384615384616
2286,2286,부터가/Josa,104,22,82,0.00024453682502278637,0.0009107670435613213,0.7884615384615384
2287,2287,하아/Exclamation,104,23,81,0.00025565213525109487,0.0008996601283959392,0.7788461538461539
2288,2288,~!!!/Punctuation,104,79,25,0.0008781095080363692,0.0002776728791345492,0.7596153846153846
2289,2289,반갑다/Adjective,104,73,31,0.0008114176466665183,0.00034431437012684104,0.7019230769230769
2290,2290,장국영/Noun,104,73,31,0.0008114176466665183,0.00034431437012684104,0.7019230769230769
2291,2291,졸리/Noun,104,33,71,0.00036680523753417966,0.0007885909767421196,0.6826923076923077
2292,2292,표현/Modifier,104,68,36,0.0007558410955249762,0.00039984894595375083,0.6538461538461539
2293,2293,야구/Noun,104,66,38,0.0007336104750683593,0.0004220627762845148,0.6346153846153846
2294,2294,틱/Suffix,104,39,65,0.0004334970989040304,0.0007219494857498278,0.625
2295,2295,고등학교/Noun,104,65,39,0.0007224951648400508,0.0004331696914498967,0.625
2296,2296,따름/Noun,104,41,63,0.00045572771936064734,0.0006997356554190639,0.6057692307692307
2297,2297,드림/Noun,104,42,62,0.00046684302958895584,0.0006886287402536821,0.5961538461538461
2298,2298,재난영화/Noun,104,59,45,0.0006558033034701999,0.0004998111824421885,0.5673076923076923
2299,2299,라이언/Noun,104,57,47,0.0006335726830135829,0.0005220250127729526,0.5480769230769231
2300,2300,매다/Verb,104,48,56,0.0005335348909588066,0.0006219872492613901,0.5384615384615384
2301,2301,틀리다/Verb,104,50,54,0.0005557655114154236,0.0005997734189306263,0.5192307692307693
2302,2302,내놓다/Verb,103,23,80,0.00025565213525109487,0.0008885532132305574,0.7766990291262136
2303,2303,이어서/Josa,103,75,28,0.0008336482671231353,0.000310993624630695,0.7281553398058253
2304,2304,벌다/Verb,103,29,74,0.0003223439966209457,0.0008219117222382655,0.7184466019417476
2305,2305,로버트/Noun,103,70,33,0.000778071715981593,0.00036652820045760486,0.6796116504854369
2306,2306,보이지/Noun,103,36,67,0.000400151168219105,0.0007441633160805918,0.6504854368932039
2307,2307,막다/Verb,103,38,65,0.000422381788675722,0.0007219494857498278,0.6310679611650486
2308,2308,배경음악/Noun,103,64,39,0.0007113798546117423,0.0004331696914498967,0.6213592233009708
2309,2309,욕심/Noun,103,39,64,0.0004334970989040304,0.0007108425705844457,0.6213592233009708
2310,2310,웃/Noun,103,64,39,0.0007113798546117423,0.0004331696914498967,0.6213592233009708
2311,2311,정확하다/Adjective,103,45,58,0.0005001889602738814,0.0006442010795921541,0.5631067961165048
2312,2312,30년/Number,103,57,46,0.0006335726830135829,0.0005109180976075704,0.5533980582524272
2313,2313,풍/Adverb,103,50,53,0.0005557655114154236,0.0005886665037652442,0.5145631067961165
2314,2314,빵점/Noun,102,2,100,2.2230620456616947e-05,0.0011106915165381968,0.9803921568627452
2315,2315,하품/Noun,102,2,100,2.2230620456616947e-05,0.0011106915165381968,0.9803921568627452
2316,2316,편안하다/Adjective,102,90,12,0.0010003779205477628,0.0001332829819845836,0.8823529411764706
2317,2317,지경/Noun,102,14,88,0.0001556143431963186,0.000977408534553613,0.8627450980392157
2318,2318,재미나/Noun,102,87,15,0.0009670319898628369,0.0001666037274807295,0.8529411764705882
2319,2319,조화/Noun,102,82,20,0.0009114554387212947,0.00022213830330763932,0.8039215686274509
2320,2320,곡/Noun,102,78,24,0.0008669941978080608,0.0002665659639691672,0.7647058823529411
2321,2321,팔/Modifier,102,24,78,0.0002667674454794033,0.0008663393828997934,0.7647058823529411
2322,2322,로코/Noun,102,75,27,0.0008336482671231353,0.0002998867094653131,0.7352941176470589
2323,2323,숨/Noun,102,75,27,0.0008336482671231353,0.0002998867094653131,0.7352941176470589
2324,2324,곱다/Adjective,102,69,33,0.0007669564057532844,0.00036652820045760486,0.6764705882352942
2325,2325,절정/Noun,102,64,38,0.0007113798546117423,0.0004220627762845148,0.6274509803921569
2326,2326,클레멘타인/Noun,102,39,63,0.0004334970989040304,0.0006997356554190639,0.6176470588235294
2327,2327,끊다/Verb,102,39,63,0.0004334970989040304,0.0006997356554190639,0.6176470588235294
2328,2328,헤어지다/Verb,102,62,40,0.0006891492341551253,0.0004442766066152787,0.6078431372549019
2329,2329,만약/Noun,102,57,45,0.0006335726830135829,0.0004998111824421885,0.5588235294117647
2330,2330,빵/Noun,102,49,53,0.0005446502011871152,0.0005886665037652442,0.5196078431372549
2331,2331,호/Noun,102,50,52,0.0005557655114154236,0.0005775595885998622,0.5098039215686274
2332,2332,인내심/Noun,101,8,93,8.892248182646779e-05,0.001032943110380523,0.9207920792079208
2333,2333,잠시/Noun,101,75,26,0.0008336482671231353,0.00028877979429993113,0.7425742574257426
2334,2334,묻히다/Verb,101,68,33,0.0007558410955249762,0.00036652820045760486,0.6732673267326733
2335,2335,사운드/Noun,101,67,34,0.0007447257852966678,0.00037763511562298685,0.6633663366336634
2336,2336,그동안/Noun,101,65,36,0.0007224951648400508,0.00039984894595375083,0.6435643564356436
2337,2337,린다/Noun,101,64,37,0.0007113798546117423,0.0004109558611191328,0.6336633663366337
2338,2338,조니뎁/Noun,101,63,38,0.0007002645443834338,0.0004220627762845148,0.6237623762376238
2339,2339,틴/Noun,101,40,61,0.0004446124091323389,0.0006775218250882999,0.6039603960396039
2340,2340,탈출/Noun,101,56,45,0.0006224573727852744,0.0004998111824421885,0.5544554455445545
2341,2341,된거/Noun,101,55,46,0.000611342062556966,0.0005109180976075704,0.5445544554455446
2342,2342,가정/Noun,101,55,46,0.000611342062556966,0.0005109180976075704,0.5445544554455446
2343,2343,사고/Noun,101,55,46,0.000611342062556966,0.0005109180976075704,0.5445544554455446
2344,2344,승리/Noun,101,54,47,0.0006002267523286575,0.0005220250127729526,0.5346534653465347
2345,2345,공/Noun,101,48,53,0.0005335348909588066,0.0005886665037652442,0.5247524752475248
2346,2346,성공/Noun,101,52,49,0.0005779961318720405,0.0005442388431037163,0.5148514851485149
2347,2347,귀/Noun,101,52,49,0.0005779961318720405,0.0005442388431037163,0.5148514851485149
2348,2348,제이슨/Noun,101,50,51,0.0005557655114154236,0.0005664526734344802,0.504950495049505
2349,2349,색/Noun,101,50,51,0.0005557655114154236,0.0005664526734344802,0.504950495049505
2350,2350,마냥/Noun,101,50,51,0.0005557655114154236,0.0005664526734344802,0.504950495049505
2351,2351,앞뒤/Noun,100,11,89,0.00012226841251139318,0.0009885154497189948,0.89
2352,2352,울면/Noun,100,87,13,0.0009670319898628369,0.00014438989714996554,0.87
2353,2353,플롯/Noun,100,29,71,0.0003223439966209457,0.0007885909767421196,0.71
2354,2354,일본인/Noun,100,30,70,0.00033345930684925416,0.0007774840615767378,0.7
2355,2355,........./Punctuation,100,31,69,0.00034457461707756266,0.0007663771464113557,0.69
2356,2356,상관없다/Adjective,100,34,66,0.0003779205477624881,0.0007330564009152097,0.66
2357,2357,만이/Noun,100,37,63,0.00041126647844741344,0.0006997356554190639,0.63
2358,2358,딱이다/Adjective,100,59,41,0.0006558033034701999,0.00045538352178066063,0.59
2359,2359,그야말로/Adverb,100,59,41,0.0006558033034701999,0.00045538352178066063,0.59
2360,2360,나누다/Verb,100,58,42,0.0006446879932418914,0.00046649043694604257,0.58
2361,2361,추리/Noun,100,43,57,0.00047795833981726434,0.0006330941644267722,0.57
2362,2362,배다/Verb,100,45,55,0.0005001889602738814,0.0006108803340960082,0.55
2363,2363,파괴/Noun,100,46,54,0.0005113042705021896,0.0005997734189306263,0.54
2364,2364,손색/Noun,99,90,9,0.0010003779205477628,9.996223648843771e-05,0.9090909090909092
2365,2365,그만하다/Adjective,99,19,80,0.00021119089433786097,0.0008885532132305574,0.8080808080808081
2366,2366,현대/Noun,99,72,27,0.00080030233643821,0.0002998867094653131,0.7272727272727273
2367,2367,끔찍하다/Adjective,99,28,71,0.0003112286863926372,0.0007885909767421196,0.7171717171717171
2368,2368,꼬/Noun,99,31,68,0.00034457461707756266,0.0007552702312459737,0.6868686868686869
2369,2369,케빈/Noun,99,66,33,0.0007336104750683593,0.00036652820045760486,0.6666666666666666
2370,2370,공간/Noun,99,65,34,0.0007224951648400508,0.00037763511562298685,0.6565656565656566
2371,2371,착각/Noun,99,34,65,0.0003779205477624881,0.0007219494857498278,0.6565656565656566
2372,2372,돼지/Noun,99,35,64,0.0003890358579907965,0.0007108425705844457,0.6464646464646465
2373,2373,임팩트/Noun,99,40,59,0.0004446124091323389,0.000655307994757536,0.5959595959595959
2374,2374,영화제/Noun,99,58,41,0.0006446879932418914,0.00045538352178066063,0.5858585858585859
2375,2375,정이/Noun,99,55,44,0.000611342062556966,0.0004887042672768067,0.5555555555555556
2376,2376,터미네이터/Noun,99,53,46,0.000589111442100349,0.0005109180976075704,0.5353535353535354
2377,2377,저리/Noun,99,51,48,0.0005668808216437321,0.0005331319279383344,0.5151515151515151
2378,2378,센스/Noun,99,48,51,0.0005335348909588066,0.0005664526734344802,0.5151515151515151
2379,2379,이전/Noun,99,49,50,0.0005446502011871152,0.0005553457582690984,0.5050505050505051
2380,2380,나은/Noun,99,49,50,0.0005446502011871152,0.0005553457582690984,0.5050505050505051
2381,2381,어디가/Noun,98,16,82,0.00017784496365293558,0.0009107670435613213,0.8367346938775511
2382,2382,우뢰매/Noun,98,18,80,0.0002000755841095525,0.0008885532132305574,0.8163265306122449
2383,2383,토록/Josa,98,72,26,0.00080030233643821,0.00028877979429993113,0.7346938775510204
2384,2384,실패하다/Adjective,98,28,70,0.0003112286863926372,0.0007774840615767378,0.7142857142857143
2385,2385,박진/Noun,98,65,33,0.0007224951648400508,0.00036652820045760486,0.6632653061224489
2386,2386,겉/Noun,98,35,63,0.0003890358579907965,0.0006997356554190639,0.6428571428571429
2387,2387,논/Noun,98,41,57,0.00045572771936064734,0.0006330941644267722,0.5816326530612245
2388,2388,도에/Foreign,98,53,45,0.000589111442100349,0.0004998111824421885,0.5408163265306123
2389,2389,지치다/Verb,98,48,50,0.0005335348909588066,0.0005553457582690984,0.5102040816326531
2390,2390,뱀파이어/Noun,98,50,48,0.0005557655114154236,0.0005331319279383344,0.5102040816326531
2391,2391,도움/Noun,98,49,49,0.0005446502011871152,0.0005442388431037163,0.5
2392,2392,디워/Noun,97,10,87,0.00011115310228308472,0.0009663016193882313,0.8969072164948454
2393,2393,낚시/Noun,97,11,86,0.00012226841251139318,0.0009551947042228492,0.8865979381443299
2394,2394,부실하다/Adjective,97,13,84,0.00014449903296801013,0.0009329808738920851,0.865979381443299
2395,2395,쓸데없이/Adverb,97,14,83,0.0001556143431963186,0.0009218739587267033,0.8556701030927835
2396,2396,사투리/Noun,97,23,74,0.00025565213525109487,0.0008219117222382655,0.7628865979381443
2397,2397,교과서/Noun,97,73,24,0.0008114176466665183,0.0002665659639691672,0.7525773195876289
2398,2398,밝다/Verb,97,71,26,0.0007891870262099014,0.00028877979429993113,0.7319587628865979
2399,2399,이군/Noun,97,33,64,0.00036680523753417966,0.0007108425705844457,0.6597938144329897
2400,2400,인터넷/Noun,97,40,57,0.0004446124091323389,0.0006330941644267722,0.5876288659793815
2401,2401,발상/Noun,97,40,57,0.0004446124091323389,0.0006330941644267722,0.5876288659793815
2402,2402,연극/Noun,97,42,55,0.00046684302958895584,0.0006108803340960082,0.5670103092783505
2403,2403,들리다/Verb,97,51,46,0.0005668808216437321,0.0005109180976075704,0.5257731958762887
2404,2404,응/Noun,97,46,51,0.0005113042705021896,0.0005664526734344802,0.5257731958762887
2405,2405,자고/Noun,96,11,85,0.00012226841251139318,0.0009440877890574672,0.8854166666666666
2406,2406,심형래/Noun,96,13,83,0.00014449903296801013,0.0009218739587267033,0.8645833333333334
2407,2407,여친/Noun,96,23,73,0.00025565213525109487,0.0008108048070728836,0.7604166666666666
2408,2408,제임스/Noun,96,70,26,0.000778071715981593,0.00028877979429993113,0.7291666666666666
2409,2409,일부러/Noun,96,28,68,0.0003112286863926372,0.0007552702312459737,0.7083333333333334
2410,2410,유덕화/Noun,96,66,30,0.0007336104750683593,0.000333207454961459,0.6875
2411,2411,호기심/Noun,96,30,66,0.00033345930684925416,0.0007330564009152097,0.6875
2412,2412,너무도/Adverb,96,63,33,0.0007002645443834338,0.00036652820045760486,0.65625
2413,2413,대결/Noun,96,61,35,0.0006780339239268168,0.0003887420307883688,0.6354166666666666
2414,2414,대통령/Noun,96,38,58,0.000422381788675722,0.0006442010795921541,0.6041666666666666
2415,2415,무기/Noun,96,39,57,0.0004334970989040304,0.0006330941644267722,0.59375
2416,2416,고딩/Noun,96,40,56,0.0004446124091323389,0.0006219872492613901,0.5833333333333334
2417,2417,음식/Noun,96,40,56,0.0004446124091323389,0.0006219872492613901,0.5833333333333334
2418,2418,펴다/Verb,96,48,48,0.0005335348909588066,0.0005331319279383344,0.5
2419,2419,체적/Noun,95,10,85,0.00011115310228308472,0.0009440877890574672,0.8947368421052632
2420,2420,이만/Noun,95,82,13,0.0009114554387212947,0.00014438989714996554,0.8631578947368421
2421,2421,팔/Noun,95,16,79,0.00017784496365293558,0.0008774462980651753,0.8315789473684211
2422,2422,듭니/Noun,95,77,18,0.0008558788875797522,0.00019992447297687542,0.8105263157894737
2423,2423,여자애/Noun,95,21,74,0.00023342151479447792,0.0008219117222382655,0.7789473684210526
2424,2424,던데/Noun,95,26,69,0.00028899806593602026,0.0007663771464113557,0.7263157894736842
2425,2425,당황/Noun,95,26,69,0.00028899806593602026,0.0007663771464113557,0.7263157894736842
2426,2426,꽃/Noun,95,68,27,0.0007558410955249762,0.0002998867094653131,0.7157894736842105
2427,2427,에다/Josa,95,28,67,0.0003112286863926372,0.0007441633160805918,0.7052631578947368
2428,2428,평균/Noun,95,28,67,0.0003112286863926372,0.0007441633160805918,0.7052631578947368
2429,2429,조카/Noun,95,66,29,0.0007336104750683593,0.00032210053979607705,0.6947368421052632
2430,2430,100%/Number,95,62,33,0.0006891492341551253,0.00036652820045760486,0.6526315789473685
2431,2431,겁/Noun,95,33,62,0.00036680523753417966,0.0006886287402536821,0.6526315789473685
2432,2432,선정/Noun,95,33,62,0.00036680523753417966,0.0006886287402536821,0.6526315789473685
2433,2433,잡고/Noun,95,38,57,0.000422381788675722,0.0006330941644267722,0.6
2434,2434,옛/Adverb,95,54,41,0.0006002267523286575,0.00045538352178066063,0.5684210526315789
2435,2435,제니퍼/Noun,95,44,51,0.0004890736500455726,0.0005664526734344802,0.5368421052631579
2436,2436,삼/Modifier,95,45,50,0.0005001889602738814,0.0005553457582690984,0.5263157894736842
2437,2437,40/Number,95,49,46,0.0005446502011871152,0.0005109180976075704,0.5157894736842106
2438,2438,아끼다/Verb,95,46,49,0.0005113042705021896,0.0005442388431037163,0.5157894736842106
2439,2439,요리/Noun,95,46,49,0.0005113042705021896,0.0005442388431037163,0.5157894736842106
2440,2440,의상/Noun,95,47,48,0.0005224195807304982,0.0005331319279383344,0.5052631578947369
2441,2441,겨울/Noun,94,77,17,0.0008558788875797522,0.00018881755781149343,0.8191489361702128
2442,2442,말투/Noun,94,24,70,0.0002667674454794033,0.0007774840615767378,0.7446808510638298
2443,2443,상실/Noun,94,24,70,0.0002667674454794033,0.0007774840615767378,0.7446808510638298
2444,2444,ㅈ/KoreanParticle,94,27,67,0.0003001133761643288,0.0007441633160805918,0.7127659574468085
2445,2445,베드/Noun,94,29,65,0.0003223439966209457,0.0007219494857498278,0.6914893617021277
2446,2446,에게도/Josa,94,65,29,0.0007224951648400508,0.00032210053979607705,0.6914893617021277
2447,2447,루즈/Noun,94,34,60,0.0003779205477624881,0.000666414909922918,0.6382978723404256
2448,2448,난리/Noun,94,34,60,0.0003779205477624881,0.000666414909922918,0.6382978723404256
2449,2449,주지/Noun,94,36,58,0.000400151168219105,0.0006442010795921541,0.6170212765957447
2450,2450,찬/Noun,94,55,39,0.000611342062556966,0.0004331696914498967,0.5851063829787234
2451,2451,링/Noun,94,41,53,0.00045572771936064734,0.0005886665037652442,0.5638297872340425
2452,2452,니콜/Noun,94,41,53,0.00045572771936064734,0.0005886665037652442,0.5638297872340425
2453,2453,드러나다/Verb,94,51,43,0.0005668808216437321,0.0004775973521114245,0.5425531914893617
2454,2454,정보/Noun,94,51,43,0.0005668808216437321,0.0004775973521114245,0.5425531914893617
2455,2455,류작/Noun,93,5,88,5.557655114154236e-05,0.000977408534553613,0.946236559139785
2456,2456,도무지/Noun,93,7,86,7.78071715981593e-05,0.0009551947042228492,0.9247311827956988
2457,2457,I/Alpha,93,76,17,0.0008447635773514439,0.00018881755781149343,0.8172043010752689
2458,2458,녹다/Verb,93,76,17,0.0008447635773514439,0.00018881755781149343,0.8172043010752689
2459,2459,성의/Noun,93,23,70,0.00025565213525109487,0.0007774840615767378,0.7526881720430108
2460,2460,차갑다/Adjective,93,68,25,0.0007558410955249762,0.0002776728791345492,0.7311827956989247
2461,2461,애초/Noun,93,30,63,0.00033345930684925416,0.0006997356554190639,0.6774193548387096
2462,2462,반대/Noun,93,32,61,0.00035568992730587116,0.0006775218250882999,0.6559139784946236
2463,2463,거치다/Verb,93,61,32,0.0006780339239268168,0.00035542128529222287,0.6559139784946236
2464,2464,무난/Noun,93,34,59,0.0003779205477624881,0.000655307994757536,0.6344086021505376
2465,2465,단체/Noun,93,34,59,0.0003779205477624881,0.000655307994757536,0.6344086021505376
2466,2466,단순/Noun,93,38,55,0.000422381788675722,0.0006108803340960082,0.5913978494623656
2467,2467,틀어주다/Verb,93,38,55,0.000422381788675722,0.0006108803340960082,0.5913978494623656
2468,2468,레이/Noun,93,54,39,0.0006002267523286575,0.0004331696914498967,0.5806451612903226
2469,2469,치고는/Josa,93,40,53,0.0004446124091323389,0.0005886665037652442,0.5698924731182796
2470,2470,주윤발/Noun,93,42,51,0.00046684302958895584,0.0005664526734344802,0.5483870967741935
2471,2471,베다/Verb,93,50,43,0.0005557655114154236,0.0004775973521114245,0.5376344086021505
2472,2472,하이/Noun,93,48,45,0.0005335348909588066,0.0004998111824421885,0.5161290322580645
2473,2473,수입/Noun,92,12,80,0.00013338372273970166,0.0008885532132305574,0.8695652173913043
2474,2474,처절하다/Adjective,92,74,18,0.0008225329568948269,0.00019992447297687542,0.8043478260869565
2475,2475,딴/Modifier,92,19,73,0.00021119089433786097,0.0008108048070728836,0.7934782608695652
2476,2476,컨셉/Noun,92,20,72,0.00022230620456616945,0.0007996978919075017,0.7826086956521741
2477,2477,고프다/Adjective,92,71,21,0.0007891870262099014,0.00023324521847302128,0.7717391304347826
2478,2478,절/Noun,92,23,69,0.00025565213525109487,0.0007663771464113557,0.75
2479,2479,드디어/Adverb,92,68,24,0.0007558410955249762,0.0002665659639691672,0.7391304347826086
2480,2480,흥/Noun,92,66,26,0.0007336104750683593,0.00028877979429993113,0.7173913043478259
2481,2481,반드시/Noun,92,65,27,0.0007224951648400508,0.0002998867094653131,0.7065217391304348
2482,2482,진수/Noun,92,64,28,0.0007113798546117423,0.000310993624630695,0.6956521739130435
2483,2483,쥐다/Verb,92,34,58,0.0003779205477624881,0.0006442010795921541,0.6304347826086957
2484,2484,13/Number,92,34,58,0.0003779205477624881,0.0006442010795921541,0.6304347826086957
2485,2485,대사도/Noun,92,35,57,0.0003890358579907965,0.0006330941644267722,0.6195652173913043
2486,2486,속이다/Verb,92,37,55,0.00041126647844741344,0.0006108803340960082,0.5978260869565217
2487,2487,중심/Noun,92,38,54,0.000422381788675722,0.0005997734189306263,0.5869565217391305
2488,2488,다리/Noun,92,38,54,0.000422381788675722,0.0005997734189306263,0.5869565217391305
2489,2489,어/Eomi,92,38,54,0.000422381788675722,0.0005997734189306263,0.5869565217391305
2490,2490,빵터지다/Adjective,92,40,52,0.0004446124091323389,0.0005775595885998622,0.5652173913043478
2491,2491,푸다/Verb,92,40,52,0.0004446124091323389,0.0005775595885998622,0.5652173913043478
2492,2492,준비/Noun,92,48,44,0.0005335348909588066,0.0004887042672768067,0.5217391304347826
2493,2493,2014년/Number,92,47,45,0.0005224195807304982,0.0004998111824421885,0.5108695652173914
2494,2494,아기/Noun,92,47,45,0.0005224195807304982,0.0004998111824421885,0.5108695652173914
2495,2495,웰/Noun,91,86,5,0.0009559166796345287,5.5534575826909837e-05,0.9450549450549449
2496,2496,어우러지다/Verb,91,85,6,0.0009448013694062199,6.66414909922918e-05,0.934065934065934
2497,2497,만드/Noun,91,14,77,0.0001556143431963186,0.0008552324677344116,0.8461538461538461
2498,2498,혐오/Noun,91,15,76,0.00016672965342462708,0.0008441255525690295,0.8351648351648352
2499,2499,명대사/Noun,91,72,19,0.00080030233643821,0.00021103138814225735,0.7912087912087912
2500,2500,살인마/Noun,91,21,70,0.00023342151479447792,0.0007774840615767378,0.7692307692307693
2501,2501,실수/Noun,91,25,66,0.0002778827557077118,0.0007330564009152097,0.7252747252747253
2502,2502,베리/Noun,91,65,26,0.0007224951648400508,0.00028877979429993113,0.7142857142857143
2503,2503,비중/Noun,91,30,61,0.00033345930684925416,0.0006775218250882999,0.6703296703296703
2504,2504,무게/Noun,91,60,31,0.0006669186136985082,0.00034431437012684104,0.6593406593406593
2505,2505,잭/Noun,91,60,31,0.0006669186136985082,0.00034431437012684104,0.6593406593406593
2506,2506,붙다/Verb,91,31,60,0.00034457461707756266,0.000666414909922918,0.6593406593406593
2507,2507,........../Punctuation,91,34,57,0.0003779205477624881,0.0006330941644267722,0.6263736263736264
2508,2508,영향/Noun,91,56,35,0.0006224573727852744,0.0003887420307883688,0.6153846153846154
2509,2509,키드/Noun,91,39,52,0.0004334970989040304,0.0005775595885998622,0.5714285714285714
2510,2510,화란/Noun,91,39,52,0.0004334970989040304,0.0005775595885998622,0.5714285714285714
2511,2511,론/Noun,91,39,52,0.0004334970989040304,0.0005775595885998622,0.5714285714285714
2512,2512,의사/Noun,91,43,48,0.00047795833981726434,0.0005331319279383344,0.5274725274725275
2513,2513,기존/Noun,91,44,47,0.0004890736500455726,0.0005220250127729526,0.5164835164835165
2514,2514,계기/Noun,90,72,18,0.00080030233643821,0.00019992447297687542,0.8
2515,2515,논리/Noun,90,20,70,0.00022230620456616945,0.0007774840615767378,0.7777777777777778
2516,2516,최고봉/Noun,90,68,22,0.0007558410955249762,0.00024435213363840333,0.7555555555555555
2517,2517,운/Noun,90,65,25,0.0007224951648400508,0.0002776728791345492,0.7222222222222222
2518,2518,어떻/Modifier,90,25,65,0.0002778827557077118,0.0007219494857498278,0.7222222222222222
2519,2519,레/Noun,90,25,65,0.0002778827557077118,0.0007219494857498278,0.7222222222222222
2520,2520,암/Modifier,90,26,64,0.00028899806593602026,0.0007108425705844457,0.7111111111111111
2521,2521,매일/Noun,90,62,28,0.0006891492341551253,0.000310993624630695,0.6888888888888889
2522,2522,쿡/Noun,90,30,60,0.00033345930684925416,0.000666414909922918,0.6666666666666666
2523,2523,깍/Adverb,90,31,59,0.00034457461707756266,0.000655307994757536,0.6555555555555556
2524,2524,및/Noun,90,31,59,0.00034457461707756266,0.000655307994757536,0.6555555555555556
2525,2525,데뷔/Noun,90,59,31,0.0006558033034701999,0.00034431437012684104,0.6555555555555556
2526,2526,걱정/Noun,90,58,32,0.0006446879932418914,0.00035542128529222287,0.6444444444444445
2527,2527,다/Noun,90,33,57,0.00036680523753417966,0.0006330941644267722,0.6333333333333333
2528,2528,여자친구/Noun,90,33,57,0.00036680523753417966,0.0006330941644267722,0.6333333333333333
2529,2529,동성애/Noun,90,35,55,0.0003890358579907965,0.0006108803340960082,0.6111111111111112
2530,2530,자동차/Noun,90,40,50,0.0004446124091323389,0.0005553457582690984,0.5555555555555556
2531,2531,앤/Noun,90,50,40,0.0005557655114154236,0.0004442766066152787,0.5555555555555556
2532,2532,의지/Noun,90,49,41,0.0005446502011871152,0.00045538352178066063,0.5444444444444444
2533,2533,차원/Noun,90,48,42,0.0005335348909588066,0.00046649043694604257,0.5333333333333333
2534,2534,네티즌/Noun,90,45,45,0.0005001889602738814,0.0004998111824421885,0.5
2535,2535,게뭐/Noun,89,7,82,7.78071715981593e-05,0.0009107670435613213,0.9213483146067416
2536,2536,감사/Noun,89,78,11,0.0008669941978080608,0.00012217606681920164,0.8764044943820225
2537,2537,빨갱이/Noun,89,18,71,0.0002000755841095525,0.0007885909767421196,0.797752808988764
2538,2538,ㅉ/KoreanParticle,89,18,71,0.0002000755841095525,0.0007885909767421196,0.797752808988764
2539,2539,강력/Noun,89,70,19,0.000778071715981593,0.00021103138814225735,0.7865168539325843
2540,2540,아무튼/Adverb,89,62,27,0.0006891492341551253,0.0002998867094653131,0.6966292134831461
2541,2541,섞다/Verb,89,28,61,0.0003112286863926372,0.0006775218250882999,0.6853932584269663
2542,2542,박중훈/Noun,89,58,31,0.0006446879932418914,0.00034431437012684104,0.651685393258427
2543,2543,폭발/Noun,89,58,31,0.0006446879932418914,0.00034431437012684104,0.651685393258427
2544,2544,각색/Noun,89,32,57,0.00035568992730587116,0.0006330941644267722,0.6404494382022472
2545,2545,포/Noun,89,33,56,0.00036680523753417966,0.0006219872492613901,0.6292134831460674
2546,2546,dvd/Alpha,89,56,33,0.0006224573727852744,0.00036652820045760486,0.6292134831460674
2547,2547,부작/Noun,89,55,34,0.000611342062556966,0.00037763511562298685,0.6179775280898876
2548,2548,ㄴ/KoreanParticle,89,34,55,0.0003779205477624881,0.0006108803340960082,0.6179775280898876
2549,2549,필/Noun,89,35,54,0.0003890358579907965,0.0005997734189306263,0.6067415730337079
2550,2550,와도/Josa,89,51,38,0.0005668808216437321,0.0004220627762845148,0.5730337078651685
2551,2551,아아/Noun,89,48,41,0.0005335348909588066,0.00045538352178066063,0.5393258426966292
2552,2552,ㅏ/KoreanParticle,89,47,42,0.0005224195807304982,0.00046649043694604257,0.5280898876404494
2553,2553,신인/Noun,89,47,42,0.0005224195807304982,0.00046649043694604257,0.5280898876404494
2554,2554,할리우드/Noun,89,46,43,0.0005113042705021896,0.0004775973521114245,0.5168539325842697
2555,2555,과학/Noun,89,46,43,0.0005113042705021896,0.0004775973521114245,0.5168539325842697
2556,2556,리얼리티/Noun,89,46,43,0.0005113042705021896,0.0004775973521114245,0.5168539325842697
2557,2557,개그맨/Noun,88,4,84,4.4461240913233895e-05,0.0009329808738920851,0.9545454545454546
2558,2558,마음속/Noun,88,83,5,0.0009225707489496033,5.5534575826909837e-05,0.9431818181818182
2559,2559,ㅄ/KoreanParticle,88,15,73,0.00016672965342462708,0.0008108048070728836,0.8295454545454546
2560,2560,동심/Noun,88,64,24,0.0007113798546117423,0.0002665659639691672,0.7272727272727273
2561,2561,폴/Noun,88,64,24,0.0007113798546117423,0.0002665659639691672,0.7272727272727273
2562,2562,피해/Noun,88,24,64,0.0002667674454794033,0.0007108425705844457,0.7272727272727273
2563,2563,에이/Noun,88,26,62,0.00028899806593602026,0.0006886287402536821,0.7045454545454546
2564,2564,만화책/Noun,88,26,62,0.00028899806593602026,0.0006886287402536821,0.7045454545454546
2565,2565,?.../Punctuation,88,30,58,0.00033345930684925416,0.0006442010795921541,0.6590909090909091
2566,2566,출신/Noun,88,33,55,0.00036680523753417966,0.0006108803340960082,0.625
2567,2567,ㅣ/KoreanParticle,88,34,54,0.0003779205477624881,0.0005997734189306263,0.6136363636363636
2568,2568,끝내/Noun,88,34,54,0.0003779205477624881,0.0005997734189306263,0.6136363636363636
2569,2569,부정/Noun,88,54,34,0.0006002267523286575,0.00037763511562298685,0.6136363636363636
2570,2570,아놀드/Noun,88,52,36,0.0005779961318720405,0.00039984894595375083,0.5909090909090909
2571,2571,조/Suffix,88,52,36,0.0005779961318720405,0.00039984894595375083,0.5909090909090909
2572,2572,극단/Noun,88,37,51,0.00041126647844741344,0.0005664526734344802,0.5795454545454546
2573,2573,유럽/Noun,88,42,46,0.00046684302958895584,0.0005109180976075704,0.5227272727272727
2574,2574,블랙/Noun,88,45,43,0.0005001889602738814,0.0004775973521114245,0.5113636363636364
2575,2575,리지/Noun,88,43,45,0.00047795833981726434,0.0004998111824421885,0.5113636363636364
2576,2576,보신/Noun,88,45,43,0.0005001889602738814,0.0004775973521114245,0.5113636363636364
2577,2577,♥♥♥/Foreign,87,86,1,0.0009559166796345287,1.1106915165381966e-05,0.9885057471264368
2578,2578,어거지/Noun,87,8,79,8.892248182646779e-05,0.0008774462980651753,0.9080459770114944
2579,2579,난잡하다/Adjective,87,8,79,8.892248182646779e-05,0.0008774462980651753,0.9080459770114944
2580,2580,발음/Noun,87,17,70,0.00018896027388124405,0.0007774840615767378,0.8045977011494253
2581,2581,듣기/Noun,87,21,66,0.00023342151479447792,0.0007330564009152097,0.7586206896551724
2582,2582,친/Noun,87,25,62,0.0002778827557077118,0.0006886287402536821,0.7126436781609196
2583,2583,무한/Noun,87,60,27,0.0006669186136985082,0.0002998867094653131,0.6896551724137931
2584,2584,배신/Noun,87,32,55,0.00035568992730587116,0.0006108803340960082,0.632183908045977
2585,2585,알아보다/Verb,87,33,54,0.00036680523753417966,0.0005997734189306263,0.6206896551724138
2586,2586,하니/Noun,87,34,53,0.0003779205477624881,0.0005886665037652442,0.6091954022988506
2587,2587,역사상/Noun,87,52,35,0.0005779961318720405,0.0003887420307883688,0.5977011494252874
2588,2588,파리/Noun,87,50,37,0.0005557655114154236,0.0004109558611191328,0.5747126436781609
2589,2589,요새/Noun,87,50,37,0.0005557655114154236,0.0004109558611191328,0.5747126436781609
2590,2590,인게/Josa,87,38,49,0.000422381788675722,0.0005442388431037163,0.5632183908045977
2591,2591,///Punctuation,87,47,40,0.0005224195807304982,0.0004442766066152787,0.5402298850574713
2592,2592,평소/Noun,87,47,40,0.0005224195807304982,0.0004442766066152787,0.5402298850574713
2593,2593,질리다/Verb,87,41,46,0.00045572771936064734,0.0005109180976075704,0.5287356321839081
2594,2594,일반/Noun,87,41,46,0.00045572771936064734,0.0005109180976075704,0.5287356321839081
2595,2595,무대/Noun,87,43,44,0.00047795833981726434,0.0004887042672768067,0.5057471264367817
2596,2596,토나오다/Verb,86,4,82,4.4461240913233895e-05,0.0009107670435613213,0.9534883720930232
2597,2597,별하나/Noun,86,4,82,4.4461240913233895e-05,0.0009107670435613213,0.9534883720930232
2598,2598,다세포/Noun,86,8,78,8.892248182646779e-05,0.0008663393828997934,0.9069767441860463
2599,2599,개콘/Noun,86,9,77,0.00010003779205477625,0.0008552324677344116,0.8953488372093024
2600,2600,황당/Noun,86,9,77,0.00010003779205477625,0.0008552324677344116,0.8953488372093024
2601,2601,영화감독/Noun,86,14,72,0.0001556143431963186,0.0007996978919075017,0.8372093023255814
2602,2602,언니/Suffix,86,70,16,0.000778071715981593,0.00017771064264611146,0.813953488372093
2603,2603,최소한/Noun,86,18,68,0.0002000755841095525,0.0007552702312459737,0.7906976744186046
2604,2604,컴퓨터/Noun,86,20,66,0.00022230620456616945,0.0007330564009152097,0.7674418604651163
2605,2605,경우/Noun,86,27,59,0.0003001133761643288,0.000655307994757536,0.686046511627907
2606,2606,해리포터/Noun,86,57,29,0.0006335726830135829,0.00032210053979607705,0.6627906976744186
2607,2607,추/Noun,86,56,30,0.0006224573727852744,0.000333207454961459,0.6511627906976745
2608,2608,나레이션/Noun,86,30,56,0.00033345930684925416,0.0006219872492613901,0.6511627906976745
2609,2609,손가락/Noun,86,53,33,0.000589111442100349,0.00036652820045760486,0.6162790697674418
2610,2610,거장/Noun,86,52,34,0.0005779961318720405,0.00037763511562298685,0.6046511627906976
2611,2611,얼다/Verb,86,36,50,0.000400151168219105,0.0005553457582690984,0.5813953488372093
2612,2612,판단/Noun,86,49,37,0.0005446502011871152,0.0004109558611191328,0.5697674418604651
2613,2613,배트맨/Noun,86,48,38,0.0005335348909588066,0.0004220627762845148,0.5581395348837209
2614,2614,심다/Verb,86,39,47,0.0004334970989040304,0.0005220250127729526,0.5465116279069767
2615,2615,스티븐/Noun,86,39,47,0.0004334970989040304,0.0005220250127729526,0.5465116279069767
2616,2616,하지원/Noun,86,46,40,0.0005113042705021896,0.0004442766066152787,0.5348837209302325
2617,2617,인형/Noun,86,41,45,0.00045572771936064734,0.0004998111824421885,0.5232558139534884
2618,2618,한국판/Noun,86,45,41,0.0005001889602738814,0.00045538352178066063,0.5232558139534884
2619,2619,홍상수/Noun,86,44,42,0.0004890736500455726,0.00046649043694604257,0.5116279069767442
2620,2620,인류/Noun,86,44,42,0.0004890736500455726,0.00046649043694604257,0.5116279069767442
2621,2621,겉멋/Noun,85,7,78,7.78071715981593e-05,0.0008663393828997934,0.9176470588235294
2622,2622,싫어지다/Adjective,85,9,76,0.00010003779205477625,0.0008441255525690295,0.8941176470588236
2623,2623,압도/Noun,85,75,10,0.0008336482671231353,0.00011106915165381967,0.8823529411764706
2624,2624,담담하다/Adjective,85,71,14,0.0007891870262099014,0.0001554968123153475,0.8352941176470589
2625,2625,누군지/Adverb,85,21,64,0.00023342151479447792,0.0007108425705844457,0.7529411764705882
2626,2626,딱/VerbPrefix,85,23,62,0.00025565213525109487,0.0006886287402536821,0.7294117647058823
2627,2627,정말/Exclamation,85,60,25,0.0006669186136985082,0.0002776728791345492,0.7058823529411765
2628,2628,여인/Noun,85,57,28,0.0006335726830135829,0.000310993624630695,0.6705882352941176
2629,2629,환경/Noun,85,55,30,0.000611342062556966,0.000333207454961459,0.6470588235294118
2630,2630,곧/Noun,85,54,31,0.0006002267523286575,0.00034431437012684104,0.6352941176470588
2631,2631,ㄷ/KoreanParticle,85,54,31,0.0006002267523286575,0.00034431437012684104,0.6352941176470588
2632,2632,찌질하다/Adjective,85,33,52,0.00036680523753417966,0.0005775595885998622,0.611764705882353
2633,2633,누르다/Verb,85,34,51,0.0003779205477624881,0.0005664526734344802,0.6
2634,2634,밖/Noun,85,45,40,0.0005001889602738814,0.0004442766066152787,0.5294117647058824
2635,2635,션/Noun,85,43,42,0.00047795833981726434,0.00046649043694604257,0.5058823529411764
2636,2636,깨알/Noun,84,76,8,0.0008447635773514439,8.885532132305573e-05,0.9047619047619048
2637,2637,민폐/Noun,84,11,73,0.00012226841251139318,0.0008108048070728836,0.8690476190476191
2638,2638,쓸데없다/Adjective,84,14,70,0.0001556143431963186,0.0007774840615767378,0.8333333333333334
2639,2639,부리다/Verb,84,17,67,0.00018896027388124405,0.0007441633160805918,0.7976190476190477
2640,2640,이루어지다/Verb,84,66,18,0.0007336104750683593,0.00019992447297687542,0.7857142857142857
2641,2641,--/Punctuation,84,19,65,0.00021119089433786097,0.0007219494857498278,0.7738095238095238
2642,2642,어쩌면/Noun,84,62,22,0.0006891492341551253,0.00024435213363840333,0.7380952380952381
2643,2643,임창정/Noun,84,58,26,0.0006446879932418914,0.00028877979429993113,0.6904761904761905
2644,2644,화일/Noun,84,26,58,0.00028899806593602026,0.0006442010795921541,0.6904761904761905
2645,2645,성적/Noun,84,32,52,0.00035568992730587116,0.0005775595885998622,0.6190476190476191
2646,2646,이니까/Josa,84,49,35,0.0005446502011871152,0.0003887420307883688,0.5833333333333334
2647,2647,연/Noun,84,49,35,0.0005446502011871152,0.0003887420307883688,0.5833333333333334
2648,2648,오프닝/Noun,84,48,36,0.0005335348909588066,0.00039984894595375083,0.5714285714285714
2649,2649,".,/Punctuation",84,47,37,0.0005224195807304982,0.0004109558611191328,0.5595238095238095
2650,2650,남성/Noun,84,45,39,0.0005001889602738814,0.0004331696914498967,0.5357142857142857
2651,2651,단점/Noun,84,39,45,0.0004334970989040304,0.0004998111824421885,0.5357142857142857
2652,2652,러시아/Noun,84,43,41,0.00047795833981726434,0.00045538352178066063,0.5119047619047619
2653,2653,영화사/Noun,84,42,42,0.00046684302958895584,0.00046649043694604257,0.5
2654,2654,..!/Punctuation,83,74,9,0.0008225329568948269,9.996223648843771e-05,0.891566265060241
2655,2655,흉내/Noun,83,11,72,0.00012226841251139318,0.0007996978919075017,0.8674698795180723
2656,2656,달콤하다/Adjective,83,68,15,0.0007558410955249762,0.0001666037274807295,0.8192771084337349
2657,2657,방해/Noun,83,18,65,0.0002000755841095525,0.0007219494857498278,0.7831325301204819
2658,2658,김치/Noun,83,22,61,0.00024453682502278637,0.0006775218250882999,0.7349397590361446
2659,2659,분량/Noun,83,25,58,0.0002778827557077118,0.0006442010795921541,0.6987951807228916
2660,2660,향수/Noun,83,57,26,0.0006335726830135829,0.00028877979429993113,0.6867469879518072
2661,2661,코메디/Noun,83,27,56,0.0003001133761643288,0.0006219872492613901,0.6746987951807228
2662,2662,사/Noun,83,56,27,0.0006224573727852744,0.0002998867094653131,0.6746987951807228
2663,2663,매/Noun,83,53,30,0.000589111442100349,0.000333207454961459,0.6385542168674698
2664,2664,판이/Noun,83,33,50,0.00036680523753417966,0.0005553457582690984,0.6024096385542169
2665,2665,만화영화/Noun,83,47,36,0.0005224195807304982,0.00039984894595375083,0.5662650602409639
2666,2666,무너지다/Verb,83,36,47,0.000400151168219105,0.0005220250127729526,0.5662650602409639
2667,2667,쉽다/Adjective,83,37,46,0.00041126647844741344,0.0005109180976075704,0.5542168674698795
2668,2668,전하/Noun,83,38,45,0.000422381788675722,0.0004998111824421885,0.5421686746987951
2669,2669,널/Noun,83,42,41,0.00046684302958895584,0.00045538352178066063,0.5060240963855421
2670,2670,슈퍼/Noun,83,42,41,0.00046684302958895584,0.00045538352178066063,0.5060240963855421
2671,2671,키스/Noun,83,42,41,0.00046684302958895584,0.00045538352178066063,0.5060240963855421
2672,2672,명복/Noun,82,74,8,0.0008225329568948269,8.885532132305573e-05,0.902439024390244
2673,2673,거품/Noun,82,12,70,0.00013338372273970166,0.0007774840615767378,0.8536585365853658
2674,2674,동영상/Noun,82,12,70,0.00013338372273970166,0.0007774840615767378,0.8536585365853658
2675,2675,고뇌/Noun,82,57,25,0.0006335726830135829,0.0002776728791345492,0.6951219512195121
2676,2676,늘리다/Verb,82,25,57,0.0002778827557077118,0.0006330941644267722,0.6951219512195121
2677,2677,능/Noun,82,55,27,0.000611342062556966,0.0002998867094653131,0.6707317073170732
2678,2678,흡입/Noun,82,53,29,0.000589111442100349,0.00032210053979607705,0.6463414634146342
2679,2679,윌리스/Noun,82,29,53,0.0003223439966209457,0.0005886665037652442,0.6463414634146342
2680,2680,때매/Noun,82,30,52,0.00033345930684925416,0.0005775595885998622,0.6341463414634146
2681,2681,인도/Noun,82,51,31,0.0005668808216437321,0.00034431437012684104,0.6219512195121951
2682,2682,잡히다/Verb,82,31,51,0.00034457461707756266,0.0005664526734344802,0.6219512195121951
2683,2683,매끄럽다/Adjective,82,32,50,0.00035568992730587116,0.0005553457582690984,0.6097560975609756
2684,2684,든지/Josa,82,32,50,0.00035568992730587116,0.0005553457582690984,0.6097560975609756
2685,2685,길이/Noun,82,49,33,0.0005446502011871152,0.00036652820045760486,0.5975609756097561
2686,2686,중년/Noun,82,48,34,0.0005335348909588066,0.00037763511562298685,0.5853658536585366
2687,2687,부족함/Noun,82,35,47,0.0003890358579907965,0.0005220250127729526,0.573170731707317
2688,2688,일으키다/Verb,82,37,45,0.00041126647844741344,0.0004998111824421885,0.5487804878048781
2689,2689,전투/Noun,82,45,37,0.0005001889602738814,0.0004109558611191328,0.5487804878048781
2690,2690,이병헌/Noun,82,39,43,0.0004334970989040304,0.0004775973521114245,0.5243902439024389
2691,2691,슴/Noun,82,39,43,0.0004334970989040304,0.0004775973521114245,0.5243902439024389
2692,2692,섞이다/Verb,82,41,41,0.00045572771936064734,0.00045538352178066063,0.5
2693,2693,탁월하다/Adjective,81,73,8,0.0008114176466665183,8.885532132305573e-05,0.9012345679012346
2694,2694,도데/Noun,81,8,73,8.892248182646779e-05,0.0008108048070728836,0.9012345679012346
2695,2695,짜리/Foreign,81,12,69,0.00013338372273970166,0.0007663771464113557,0.8518518518518519
2696,2696,속지/Noun,81,13,68,0.00014449903296801013,0.0007552702312459737,0.8395061728395061
2697,2697,역량/Noun,81,13,68,0.00014449903296801013,0.0007552702312459737,0.8395061728395061
2698,2698,배급사/Noun,81,15,66,0.00016672965342462708,0.0007330564009152097,0.8148148148148148
2699,2699,징그럽다/Adjective,81,17,64,0.00018896027388124405,0.0007108425705844457,0.7901234567901234
2700,2700,이해도/Noun,81,17,64,0.00018896027388124405,0.0007108425705844457,0.7901234567901234
2701,2701,염/Noun,81,60,21,0.0006669186136985082,0.00023324521847302128,0.7407407407407407
2702,2702,몽환/Noun,81,59,22,0.0006558033034701999,0.00024435213363840333,0.7283950617283951
2703,2703,박다/Verb,81,22,59,0.00024453682502278637,0.000655307994757536,0.7283950617283951
2704,2704,짜이다/Verb,81,56,25,0.0006224573727852744,0.0002776728791345492,0.6913580246913579
2705,2705,약/Modifier,81,26,55,0.00028899806593602026,0.0006108803340960082,0.6790123456790124
2706,2706,그렇지만/Conjunction,81,55,26,0.000611342062556966,0.00028877979429993113,0.6790123456790124
2707,2707,옴/Noun,81,26,55,0.00028899806593602026,0.0006108803340960082,0.6790123456790124
2708,2708,실험/Noun,81,29,52,0.0003223439966209457,0.0005775595885998622,0.6419753086419753
2709,2709,극복/Noun,81,51,30,0.0005668808216437321,0.000333207454961459,0.6296296296296297
2710,2710,사용/Noun,81,31,50,0.00034457461707756266,0.0005553457582690984,0.6172839506172839
2711,2711,1회/Number,81,49,32,0.0005446502011871152,0.00035542128529222287,0.6049382716049383
2712,2712,이소룡/Noun,81,48,33,0.0005335348909588066,0.00036652820045760486,0.5925925925925926
2713,2713,왕/Suffix,81,33,48,0.00036680523753417966,0.0005331319279383344,0.5925925925925926
2714,2714,스포/Noun,81,47,34,0.0005224195807304982,0.00037763511562298685,0.5802469135802469
2715,2715,화장실/Noun,81,34,47,0.0003779205477624881,0.0005220250127729526,0.5802469135802469
2716,2716,d/Alpha,81,35,46,0.0003890358579907965,0.0005109180976075704,0.5679012345679012
2717,2717,도시/Noun,81,46,35,0.0005113042705021896,0.0003887420307883688,0.5679012345679012
2718,2718,멍/Noun,81,36,45,0.000400151168219105,0.0004998111824421885,0.5555555555555556
2719,2719,파격/Noun,81,42,39,0.00046684302958895584,0.0004331696914498967,0.5185185185185185
2720,2720,중국영화/Noun,81,39,42,0.0004334970989040304,0.00046649043694604257,0.5185185185185185
2721,2721,천국/Noun,81,40,41,0.0004446124091323389,0.00045538352178066063,0.5061728395061729
2722,2722,담백하다/Adjective,80,75,5,0.0008336482671231353,5.5534575826909837e-05,0.9375
2723,2723,삶다/Verb,80,68,12,0.0007558410955249762,0.0001332829819845836,0.85
2724,2724,가히/Adverb,80,68,12,0.0007558410955249762,0.0001332829819845836,0.85
2725,2725,지리다/Verb,80,63,17,0.0007002645443834338,0.00018881755781149343,0.7875
2726,2726,킬링/Noun,80,22,58,0.00024453682502278637,0.0006442010795921541,0.725
2727,2727,장점/Noun,80,23,57,0.00025565213525109487,0.0006330941644267722,0.7125
2728,2728,등록/Noun,80,23,57,0.00025565213525109487,0.0006330941644267722,0.7125
2729,2729,망가지다/Verb,80,26,54,0.00028899806593602026,0.0005997734189306263,0.675
2730,2730,하정우/Noun,80,53,27,0.000589111442100349,0.0002998867094653131,0.6625
2731,2731,미녀/Noun,80,30,50,0.00033345930684925416,0.0005553457582690984,0.625
2732,2732,독일/Noun,80,48,32,0.0005335348909588066,0.00035542128529222287,0.6
2733,2733,가리다/Verb,80,33,47,0.00036680523753417966,0.0005220250127729526,0.5875
2734,2734,마약/Noun,80,33,47,0.00036680523753417966,0.0005220250127729526,0.5875
2735,2735,은/Foreign,80,33,47,0.00036680523753417966,0.0005220250127729526,0.5875
2736,2736,군인/Noun,80,34,46,0.0003779205477624881,0.0005109180976075704,0.575
2737,2737,에서만/Josa,80,35,45,0.0003890358579907965,0.0004998111824421885,0.5625
2738,2738,버튼/Noun,80,45,35,0.0005001889602738814,0.0003887420307883688,0.5625
2739,2739,액션씬/Noun,80,42,38,0.00046684302958895584,0.0004220627762845148,0.525
2740,2740,정우성/Noun,80,39,41,0.0004334970989040304,0.00045538352178066063,0.5125
2741,2741,밀려오다/Verb,80,41,39,0.00045572771936064734,0.0004331696914498967,0.5125
2742,2742,오는/Modifier,80,41,39,0.00045572771936064734,0.0004331696914498967,0.5125
2743,2743,천/Modifier,80,41,39,0.00045572771936064734,0.0004331696914498967,0.5125
2744,2744,완벽/Noun,79,71,8,0.0007891870262099014,8.885532132305573e-05,0.8987341772151899
2745,2745,그럴듯하다/Adjective,79,8,71,8.892248182646779e-05,0.0007885909767421196,0.8987341772151899
2746,2746,의외/Noun,79,65,14,0.0007224951648400508,0.0001554968123153475,0.8227848101265823
2747,2747,딱/Modifier,79,16,63,0.00017784496365293558,0.0006997356554190639,0.7974683544303798
2748,2748,분장/Noun,79,17,62,0.00018896027388124405,0.0006886287402536821,0.7848101265822784
2749,2749,언젠가/Adverb,79,59,20,0.0006558033034701999,0.00022213830330763932,0.7468354430379747
2750,2750,파다/Verb,79,24,55,0.0002667674454794033,0.0006108803340960082,0.6962025316455697
2751,2751,샘/Noun,79,53,26,0.000589111442100349,0.00028877979429993113,0.6708860759493671
2752,2752,중딩/Noun,79,27,52,0.0003001133761643288,0.0005775595885998622,0.6582278481012658
2753,2753,정상/Noun,79,27,52,0.0003001133761643288,0.0005775595885998622,0.6582278481012658
2754,2754,에다가/Josa,79,29,50,0.0003223439966209457,0.0005553457582690984,0.6329113924050633
2755,2755,라기/Josa,79,30,49,0.00033345930684925416,0.0005442388431037163,0.620253164556962
2756,2756,미도/Noun,79,48,31,0.0005335348909588066,0.00034431437012684104,0.6075949367088608
2757,2757,of/Alpha,79,48,31,0.0005335348909588066,0.00034431437012684104,0.6075949367088608
2758,2758,순/Modifier,79,45,34,0.0005001889602738814,0.00037763511562298685,0.569620253164557
2759,2759,후회되다/Adjective,79,35,44,0.0003890358579907965,0.0004887042672768067,0.5569620253164557
2760,2760,유지/Noun,79,39,40,0.0004334970989040304,0.0004442766066152787,0.5063291139240507
2761,2761,순위/Noun,79,39,40,0.0004334970989040304,0.0004442766066152787,0.5063291139240507
2762,2762,위트/Noun,78,66,12,0.0007336104750683593,0.0001332829819845836,0.8461538461538461
2763,2763,치유/Noun,78,66,12,0.0007336104750683593,0.0001332829819845836,0.8461538461538461
2764,2764,아치/Noun,78,14,64,0.0001556143431963186,0.0007108425705844457,0.8205128205128205
2765,2765,만도/Josa,78,15,63,0.00016672965342462708,0.0006997356554190639,0.8076923076923077
2766,2766,애절하다/Adjective,78,62,16,0.0006891492341551253,0.00017771064264611146,0.7948717948717948
2767,2767,알려지다/Verb,78,58,20,0.0006446879932418914,0.00022213830330763932,0.7435897435897436
2768,2768,이구만/Josa,78,20,58,0.00022230620456616945,0.0006442010795921541,0.7435897435897436
2769,2769,왜곡/Noun,78,22,56,0.00024453682502278637,0.0006219872492613901,0.7179487179487181
2770,2770,상어/Noun,78,25,53,0.0002778827557077118,0.0005886665037652442,0.6794871794871795
2771,2771,절망/Noun,78,53,25,0.000589111442100349,0.0002776728791345492,0.6794871794871795
2772,2772,서부/Noun,78,50,28,0.0005557655114154236,0.000310993624630695,0.6410256410256411
2773,2773,허허/Adverb,78,29,49,0.0003223439966209457,0.0005442388431037163,0.6282051282051282
2774,2774,계시다/Adjective,78,49,29,0.0005446502011871152,0.00032210053979607705,0.6282051282051282
2775,2775,칠/Modifier,78,29,49,0.0003223439966209457,0.0005442388431037163,0.6282051282051282
2776,2776,라스트/Noun,78,48,30,0.0005335348909588066,0.000333207454961459,0.6153846153846154
2777,2777,컷/Noun,78,30,48,0.00033345930684925416,0.0005331319279383344,0.6153846153846154
2778,2778,무리/Noun,78,30,48,0.00033345930684925416,0.0005331319279383344,0.6153846153846154
2779,2779,한순간/Noun,78,48,30,0.0005335348909588066,0.000333207454961459,0.6153846153846154
2780,2780,서도/Noun,78,47,31,0.0005224195807304982,0.00034431437012684104,0.6025641025641025
2781,2781,최소/Noun,78,47,31,0.0005224195807304982,0.00034431437012684104,0.6025641025641025
2782,2782,절로/Noun,78,45,33,0.0005001889602738814,0.00036652820045760486,0.5769230769230769
2783,2783,랑은/Josa,78,35,43,0.0003890358579907965,0.0004775973521114245,0.5512820512820513
2784,2784,들어주다/Verb,78,36,42,0.000400151168219105,0.00046649043694604257,0.5384615384615384
2785,2785,뒤죽박죽/Noun,77,9,68,0.00010003779205477625,0.0007552702312459737,0.8831168831168831
2786,2786,절제/Noun,77,64,13,0.0007113798546117423,0.00014438989714996554,0.8311688311688312
2787,2787,소화/Noun,77,62,15,0.0006891492341551253,0.0001666037274807295,0.8051948051948052
2788,2788,떠올리다/Verb,77,62,15,0.0006891492341551253,0.0001666037274807295,0.8051948051948052
2789,2789,찬양/Noun,77,19,58,0.00021119089433786097,0.0006442010795921541,0.7532467532467533
2790,2790,내일/Noun,77,56,21,0.0006224573727852744,0.00023324521847302128,0.7272727272727273
2791,2791,닥/Noun,77,21,56,0.00023342151479447792,0.0006219872492613901,0.7272727272727273
2792,2792,난무/Noun,77,22,55,0.00024453682502278637,0.0006108803340960082,0.7142857142857143
2793,2793,낼/Noun,77,53,24,0.000589111442100349,0.0002665659639691672,0.6883116883116883
2794,2794,동네/Noun,77,29,48,0.0003223439966209457,0.0005331319279383344,0.6233766233766234
2795,2795,향연/Noun,77,32,45,0.00035568992730587116,0.0004998111824421885,0.5844155844155844
2796,2796,2년/Number,77,45,32,0.0005001889602738814,0.00035542128529222287,0.5844155844155844
2797,2797,안해/Noun,77,32,45,0.00035568992730587116,0.0004998111824421885,0.5844155844155844
2798,2798,에가/Josa,77,34,43,0.0003779205477624881,0.0004775973521114245,0.5584415584415584
2799,2799,선생/Noun,77,34,43,0.0003779205477624881,0.0004775973521114245,0.5584415584415584
2800,2800,똑같이/Adverb,77,34,43,0.0003779205477624881,0.0004775973521114245,0.5584415584415584
2801,2801,우선/Noun,77,36,41,0.000400151168219105,0.00045538352178066063,0.5324675324675324
2802,2802,모로/Noun,77,37,40,0.00041126647844741344,0.0004442766066152787,0.5194805194805194
2803,2803,켜다/Verb,77,40,37,0.0004446124091323389,0.0004109558611191328,0.5194805194805194
2804,2804,버/Noun,77,37,40,0.00041126647844741344,0.0004442766066152787,0.5194805194805194
2805,2805,상대/Noun,77,39,38,0.0004334970989040304,0.0004220627762845148,0.5064935064935064
2806,2806,매미/Noun,76,4,72,4.4461240913233895e-05,0.0007996978919075017,0.9473684210526316
2807,2807,뜬금없이/Adverb,76,4,72,4.4461240913233895e-05,0.0007996978919075017,0.9473684210526316
2808,2808,미스/Noun,76,13,63,0.00014449903296801013,0.0006997356554190639,0.8289473684210527
2809,2809,욕먹다/Verb,76,13,63,0.00014449903296801013,0.0006997356554190639,0.8289473684210527
2810,2810,보임/Noun,76,16,60,0.00017784496365293558,0.000666414909922918,0.7894736842105263
2811,2811,버티다/Verb,76,17,59,0.00018896027388124405,0.000655307994757536,0.7763157894736842
2812,2812,전성기/Noun,76,59,17,0.0006558033034701999,0.00018881755781149343,0.7763157894736842
2813,2813,ㅎㄷㄷ/KoreanParticle,76,55,21,0.000611342062556966,0.00023324521847302128,0.7236842105263158
2814,2814,범/Noun,76,22,54,0.00024453682502278637,0.0005997734189306263,0.7105263157894737
2815,2815,달라지다/Verb,76,53,23,0.000589111442100349,0.0002554590488037852,0.6973684210526315
2816,2816,리가/Noun,76,24,52,0.0002667674454794033,0.0005775595885998622,0.6842105263157895
2817,2817,년도/Noun,76,25,51,0.0002778827557077118,0.0005664526734344802,0.6710526315789473
2818,2818,각자/Noun,76,50,26,0.0005557655114154236,0.00028877979429993113,0.6578947368421053
2819,2819,그대/Noun,76,50,26,0.0005557655114154236,0.00028877979429993113,0.6578947368421053
2820,2820,하라/Noun,76,28,48,0.0003112286863926372,0.0005331319279383344,0.631578947368421
2821,2821,글자/Noun,76,28,48,0.0003112286863926372,0.0005331319279383344,0.631578947368421
2822,2822,하고는/Josa,76,29,47,0.0003223439966209457,0.0005220250127729526,0.618421052631579
2823,2823,절대로/Noun,76,29,47,0.0003223439966209457,0.0005220250127729526,0.618421052631579
2824,2824,끼치다/Verb,76,46,30,0.0005113042705021896,0.000333207454961459,0.6052631578947368
2825,2825,형식/Noun,76,30,46,0.00033345930684925416,0.0005109180976075704,0.6052631578947368
2826,2826,변신/Noun,76,32,44,0.00035568992730587116,0.0004887042672768067,0.5789473684210527
2827,2827,케이/Noun,76,32,44,0.00035568992730587116,0.0004887042672768067,0.5789473684210527
2828,2828,각/Modifier,76,35,41,0.0003890358579907965,0.00045538352178066063,0.5394736842105263
2829,2829,튀다/Verb,76,35,41,0.0003890358579907965,0.00045538352178066063,0.5394736842105263
2830,2830,박히다/Verb,76,40,36,0.0004446124091323389,0.00039984894595375083,0.5263157894736842
2831,2831,서울/Noun,76,40,36,0.0004446124091323389,0.00039984894595375083,0.5263157894736842
2832,2832,잉/Noun,76,38,38,0.000422381788675722,0.0004220627762845148,0.5
2833,2833,우연/Noun,76,38,38,0.000422381788675722,0.0004220627762845148,0.5
2834,2834,과대/Noun,75,5,70,5.557655114154236e-05,0.0007774840615767378,0.9333333333333332
2835,2835,도중/Noun,75,7,68,7.78071715981593e-05,0.0007552702312459737,0.9066666666666666
2836,2836,따분하다/Adjective,75,8,67,8.892248182646779e-05,0.0007441633160805918,0.8933333333333333
2837,2837,여신/Noun,75,61,14,0.0006780339239268168,0.0001554968123153475,0.8133333333333334
2838,2838,낭만/Noun,75,57,18,0.0006335726830135829,0.00019992447297687542,0.76
2839,2839,선사/Noun,75,54,21,0.0006002267523286575,0.00023324521847302128,0.72
2840,2840,꺼지다/Verb,75,24,51,0.0002667674454794033,0.0005664526734344802,0.68
2841,2841,폭풍/Noun,75,51,24,0.0005668808216437321,0.0002665659639691672,0.68
2842,2842,공룡/Noun,75,26,49,0.00028899806593602026,0.0005442388431037163,0.6533333333333333
2843,2843,급하다/Adjective,75,26,49,0.00028899806593602026,0.0005442388431037163,0.6533333333333333
2844,2844,잔혹하다/Adjective,75,48,27,0.0005335348909588066,0.0002998867094653131,0.64
2845,2845,빠/Noun,75,27,48,0.0003001133761643288,0.0005331319279383344,0.64
2846,2846,소통/Noun,75,47,28,0.0005224195807304982,0.000310993624630695,0.6266666666666667
2847,2847,추가/Noun,75,28,47,0.0003112286863926372,0.0005220250127729526,0.6266666666666667
2848,2848,년전/Noun,75,45,30,0.0005001889602738814,0.000333207454961459,0.6
2849,2849,식이/Noun,75,30,45,0.00033345930684925416,0.0004998111824421885,0.6
2850,2850,1년/Number,75,45,30,0.0005001889602738814,0.000333207454961459,0.6
2851,2851,축구/Noun,75,30,45,0.00033345930684925416,0.0004998111824421885,0.6
2852,2852,아만다/Noun,75,44,31,0.0004890736500455726,0.00034431437012684104,0.5866666666666667
2853,2853,부활/Noun,75,44,31,0.0004890736500455726,0.00034431437012684104,0.5866666666666667
2854,2854,모이다/Verb,75,32,43,0.00035568992730587116,0.0004775973521114245,0.5733333333333334
2855,2855,용다/Verb,75,43,32,0.00047795833981726434,0.00035542128529222287,0.5733333333333334
2856,2856,직업/Noun,75,34,41,0.0003779205477624881,0.00045538352178066063,0.5466666666666666
2857,2857,예측/Noun,75,36,39,0.000400151168219105,0.0004331696914498967,0.52
2858,2858,바닥/Noun,74,9,65,0.00010003779205477625,0.0007219494857498278,0.8783783783783784
2859,2859,졸업/Noun,74,14,60,0.0001556143431963186,0.000666414909922918,0.8108108108108109
2860,2860,어지럽다/Adjective,74,16,58,0.00017784496365293558,0.0006442010795921541,0.7837837837837838
2861,2861,EBS/Alpha,74,57,17,0.0006335726830135829,0.00018881755781149343,0.7702702702702703
2862,2862,끊기다/Verb,74,17,57,0.00018896027388124405,0.0006330941644267722,0.7702702702702703
2863,2863,웬/Noun,74,19,55,0.00021119089433786097,0.0006108803340960082,0.7432432432432432
2864,2864,지나/Noun,74,53,21,0.000589111442100349,0.00023324521847302128,0.7162162162162162
2865,2865,딸리다/Verb,74,22,52,0.00024453682502278637,0.0005775595885998622,0.7027027027027027
2866,2866,드니/Noun,74,51,23,0.0005668808216437321,0.0002554590488037852,0.6891891891891891
2867,2867,한가지/Noun,74,23,51,0.00025565213525109487,0.0005664526734344802,0.6891891891891891
2868,2868,거짓/Noun,74,24,50,0.0002667674454794033,0.0005553457582690984,0.6756756756756757
2869,2869,송강호/Noun,74,50,24,0.0005557655114154236,0.0002665659639691672,0.6756756756756757
2870,2870,재난/Noun,74,25,49,0.0002778827557077118,0.0005442388431037163,0.6621621621621622
2871,2871,워낙/Noun,74,49,25,0.0005446502011871152,0.0002776728791345492,0.6621621621621622
2872,2872,a/Alpha,74,48,26,0.0005335348909588066,0.00028877979429993113,0.6486486486486487
2873,2873,가나/Noun,74,27,47,0.0003001133761643288,0.0005220250127729526,0.6351351351351351
2874,2874,일주일/Noun,74,47,27,0.0005224195807304982,0.0002998867094653131,0.6351351351351351
2875,2875,범죄자/Noun,74,28,46,0.0003112286863926372,0.0005109180976075704,0.6216216216216216
2876,2876,부탁/Noun,74,29,45,0.0003223439966209457,0.0004998111824421885,0.6081081081081081
2877,2877,이안/Noun,74,29,45,0.0003223439966209457,0.0004998111824421885,0.6081081081081081
2878,2878,캐릭/Noun,74,29,45,0.0003223439966209457,0.0004998111824421885,0.6081081081081081
2879,2879,생명/Noun,74,45,29,0.0005001889602738814,0.00032210053979607705,0.6081081081081081
2880,2880,나타내다/Verb,74,44,30,0.0004890736500455726,0.000333207454961459,0.5945945945945946
2881,2881,트리/Noun,74,31,43,0.00034457461707756266,0.0004775973521114245,0.581081081081081
2882,2882,류승범/Noun,74,42,32,0.00046684302958895584,0.00035542128529222287,0.5675675675675675
2883,2883,높이다/Verb,74,42,32,0.00046684302958895584,0.00035542128529222287,0.5675675675675675
2884,2884,극적/Noun,74,39,35,0.0004334970989040304,0.0003887420307883688,0.527027027027027
2885,2885,이구나/Josa,74,39,35,0.0004334970989040304,0.0003887420307883688,0.527027027027027
2886,2886,흔/Modifier,74,35,39,0.0003890358579907965,0.0004331696914498967,0.527027027027027
2887,2887,존스/Noun,74,37,37,0.00041126647844741344,0.0004109558611191328,0.5
2888,2888,최후/Noun,74,37,37,0.00041126647844741344,0.0004109558611191328,0.5
2889,2889,애잔하다/Adjective,73,69,4,0.0007669564057532844,4.4427660661527865e-05,0.9452054794520548
2890,2890,애매하다/Adjective,73,12,61,0.00013338372273970166,0.0006775218250882999,0.8356164383561644
2891,2891,이별/Noun,73,57,16,0.0006335726830135829,0.00017771064264611146,0.7808219178082192
2892,2892,쟁이/Suffix,73,19,54,0.00021119089433786097,0.0005997734189306263,0.7397260273972602
2893,2893,쌍/Noun,73,21,52,0.00023342151479447792,0.0005775595885998622,0.7123287671232876
2894,2894,부인/Noun,73,21,52,0.00023342151479447792,0.0005775595885998622,0.7123287671232876
2895,2895,원숭이/Noun,73,22,51,0.00024453682502278637,0.0005664526734344802,0.6986301369863014
2896,2896,단편/Noun,73,22,51,0.00024453682502278637,0.0005664526734344802,0.6986301369863014
2897,2897,시종일관/Noun,73,22,51,0.00024453682502278637,0.0005664526734344802,0.6986301369863014
2898,2898,깡패/Noun,73,23,50,0.00025565213525109487,0.0005553457582690984,0.6849315068493149
2899,2899,신하균/Noun,73,50,23,0.0005557655114154236,0.0002554590488037852,0.6849315068493149
2900,2900,본격/Noun,73,23,50,0.00025565213525109487,0.0005553457582690984,0.6849315068493149
2901,2901,에서나/Josa,73,24,49,0.0002667674454794033,0.0005442388431037163,0.6712328767123288
2902,2902,광기/Noun,73,49,24,0.0005446502011871152,0.0002665659639691672,0.6712328767123288
2903,2903,처리/Noun,73,25,48,0.0002778827557077118,0.0005331319279383344,0.6575342465753424
2904,2904,만세/Noun,73,48,25,0.0005335348909588066,0.0002776728791345492,0.6575342465753424
2905,2905,낮/Noun,73,47,26,0.0005224195807304982,0.00028877979429993113,0.6438356164383562
2906,2906,블랙코미디/Noun,73,46,27,0.0005113042705021896,0.0002998867094653131,0.6301369863013698
2907,2907,솔/Noun,73,27,46,0.0003001133761643288,0.0005109180976075704,0.6301369863013698
2908,2908,로움/Noun,73,44,29,0.0004890736500455726,0.00032210053979607705,0.6027397260273972
2909,2909,바치다/Verb,73,43,30,0.00047795833981726434,0.000333207454961459,0.589041095890411
2910,2910,스타워즈/Noun,73,43,30,0.00047795833981726434,0.000333207454961459,0.589041095890411
2911,2911,중학생/Noun,73,42,31,0.00046684302958895584,0.00034431437012684104,0.5753424657534246
2912,2912,50/Number,73,41,32,0.00045572771936064734,0.00035542128529222287,0.5616438356164384
2913,2913,매번/Noun,73,41,32,0.00045572771936064734,0.00035542128529222287,0.5616438356164384
2914,2914,녀석/Noun,73,33,40,0.00036680523753417966,0.0004442766066152787,0.547945205479452
2915,2915,흔들다/Verb,73,39,34,0.0004334970989040304,0.00037763511562298685,0.5342465753424658
2916,2916,풀리다/Verb,73,39,34,0.0004334970989040304,0.00037763511562298685,0.5342465753424658
2917,2917,갈리다/Verb,73,38,35,0.000422381788675722,0.0003887420307883688,0.5205479452054794
2918,2918,맛있다/Adjective,73,37,36,0.00041126647844741344,0.00039984894595375083,0.5068493150684932
2919,2919,지옥/Noun,73,36,37,0.000400151168219105,0.0004109558611191328,0.5068493150684932
2920,2920,익숙하다/Adjective,73,37,36,0.00041126647844741344,0.00039984894595375083,0.5068493150684932
2921,2921,답답/Noun,72,2,70,2.2230620456616947e-05,0.0007774840615767378,0.9722222222222222
2922,2922,Good/Alpha,72,69,3,0.0007669564057532844,3.33207454961459e-05,0.9583333333333334
2923,2923,어색/Noun,72,3,69,3.334593068492541e-05,0.0007663771464113557,0.9583333333333334
2924,2924,명불허전/Noun,72,64,8,0.0007113798546117423,8.885532132305573e-05,0.8888888888888888
2925,2925,비록/Noun,72,64,8,0.0007113798546117423,8.885532132305573e-05,0.8888888888888888
2926,2926,애틋하다/Adjective,72,61,11,0.0006780339239268168,0.00012217606681920164,0.8472222222222222
2927,2927,광구/Noun,72,12,60,0.00013338372273970166,0.000666414909922918,0.8333333333333334
2928,2928,쓴다/Verb,72,12,60,0.00013338372273970166,0.000666414909922918,0.8333333333333334
2929,2929,짜릿하다/Adjective,72,59,13,0.0006558033034701999,0.00014438989714996554,0.8194444444444444
2930,2930,땀/Noun,72,58,14,0.0006446879932418914,0.0001554968123153475,0.8055555555555556
2931,2931,배꼽/Noun,72,58,14,0.0006446879932418914,0.0001554968123153475,0.8055555555555556
2932,2932,뎅/Noun,72,57,15,0.0006335726830135829,0.0001666037274807295,0.7916666666666666
2933,2933,누나/Suffix,72,56,16,0.0006224573727852744,0.00017771064264611146,0.7777777777777778
2934,2934,아무나/Noun,72,17,55,0.00018896027388124405,0.0006108803340960082,0.7638888888888888
2935,2935,기획/Noun,72,22,50,0.00024453682502278637,0.0005553457582690984,0.6944444444444444
2936,2936,호흡/Noun,72,49,23,0.0005446502011871152,0.0002554590488037852,0.6805555555555556
2937,2937,고전/Modifier,72,49,23,0.0005446502011871152,0.0002554590488037852,0.6805555555555556
2938,2938,대부/Noun,72,46,26,0.0005113042705021896,0.00028877979429993113,0.6388888888888888
2939,2939,일지/Noun,72,46,26,0.0005113042705021896,0.00028877979429993113,0.6388888888888888
2940,2940,못자다/Verb,72,26,46,0.00028899806593602026,0.0005109180976075704,0.6388888888888888
2941,2941,구분/Noun,72,27,45,0.0003001133761643288,0.0004998111824421885,0.625
2942,2942,이지/Noun,72,27,45,0.0003001133761643288,0.0004998111824421885,0.625
2943,2943,수록/Noun,72,44,28,0.0004890736500455726,0.000310993624630695,0.6111111111111112
2944,2944,풀/Noun,72,28,44,0.0003112286863926372,0.0004887042672768067,0.6111111111111112
2945,2945,본질/Noun,72,44,28,0.0004890736500455726,0.000310993624630695,0.6111111111111112
2946,2946,찾아가다/Verb,72,42,30,0.00046684302958895584,0.000333207454961459,0.5833333333333334
2947,2947,객관/Noun,72,30,42,0.00033345930684925416,0.00046649043694604257,0.5833333333333334
2948,2948,혼란/Noun,72,33,39,0.00036680523753417966,0.0004331696914498967,0.5416666666666666
2949,2949,말씀/Noun,72,38,34,0.000422381788675722,0.00037763511562298685,0.5277777777777778
2950,2950,하얗다/Adjective,72,38,34,0.000422381788675722,0.00037763511562298685,0.5277777777777778
2951,2951,비행기/Noun,72,37,35,0.00041126647844741344,0.0003887420307883688,0.5138888888888888
2952,2952,부로/Noun,72,37,35,0.00041126647844741344,0.0003887420307883688,0.5138888888888888
2953,2953,아마추어/Noun,71,5,66,5.557655114154236e-05,0.0007330564009152097,0.9295774647887324
2954,2954,케미/Noun,71,66,5,0.0007336104750683593,5.5534575826909837e-05,0.9295774647887324
2955,2955,오글오글/Adverb,71,6,65,6.669186136985083e-05,0.0007219494857498278,0.9154929577464788
2956,2956,...^^/Punctuation,71,65,6,0.0007224951648400508,6.66414909922918e-05,0.9154929577464788
2957,2957,쓸쓸하다/Adjective,71,63,8,0.0007002645443834338,8.885532132305573e-05,0.8873239436619719
2958,2958,15년/Number,71,60,11,0.0006669186136985082,0.00012217606681920164,0.8450704225352113
2959,2959,고인/Noun,71,60,11,0.0006669186136985082,0.00012217606681920164,0.8450704225352113
2960,2960,데리다/Verb,71,12,59,0.00013338372273970166,0.000655307994757536,0.8309859154929577
2961,2961,제작자/Noun,71,12,59,0.00013338372273970166,0.000655307994757536,0.8309859154929577
2962,2962,정점/Noun,71,55,16,0.000611342062556966,0.00017771064264611146,0.7746478873239436
2963,2963,상식/Noun,71,16,55,0.00017784496365293558,0.0006108803340960082,0.7746478873239436
2964,2964,명장/Noun,71,52,19,0.0005779961318720405,0.00021103138814225735,0.7323943661971831
2965,2965,ㅜㅠ/KoreanParticle,71,50,21,0.0005557655114154236,0.00023324521847302128,0.7042253521126759
2966,2966,고증/Noun,71,21,50,0.00023342151479447792,0.0005553457582690984,0.7042253521126759
2967,2967,괴롭다/Adjective,71,22,49,0.00024453682502278637,0.0005442388431037163,0.6901408450704225
2968,2968,살이/Noun,71,45,26,0.0005001889602738814,0.00028877979429993113,0.6338028169014085
2969,2969,회사/Noun,71,26,45,0.00028899806593602026,0.0004998111824421885,0.6338028169014085
2970,2970,커버/Noun,71,44,27,0.0004890736500455726,0.0002998867094653131,0.6197183098591549
2971,2971,별거/Noun,71,28,43,0.0003112286863926372,0.0004775973521114245,0.6056338028169014
2972,2972,합/Noun,71,28,43,0.0003112286863926372,0.0004775973521114245,0.6056338028169014
2973,2973,돌/Noun,71,29,42,0.0003223439966209457,0.00046649043694604257,0.5915492957746479
2974,2974,안기다/Verb,71,42,29,0.00046684302958895584,0.00032210053979607705,0.5915492957746479
2975,2975,공유/Noun,71,42,29,0.00046684302958895584,0.00032210053979607705,0.5915492957746479
2976,2976,두운/Noun,71,42,29,0.00046684302958895584,0.00032210053979607705,0.5915492957746479
2977,2977,님/Noun,71,40,31,0.0004446124091323389,0.00034431437012684104,0.5633802816901409
2978,2978,기괴하다/Adjective,71,40,31,0.0004446124091323389,0.00034431437012684104,0.5633802816901409
2979,2979,노인/Noun,71,31,40,0.00034457461707756266,0.0004442766066152787,0.5633802816901409
2980,2980,받아들이다/Verb,71,38,33,0.000422381788675722,0.00036652820045760486,0.5352112676056338
2981,2981,스릴러물/Noun,71,38,33,0.000422381788675722,0.00036652820045760486,0.5352112676056338
2982,2982,잔인함/Noun,71,37,34,0.00041126647844741344,0.00037763511562298685,0.5211267605633803
2983,2983,아오이/Noun,71,36,35,0.000400151168219105,0.0003887420307883688,0.5070422535211268
2984,2984,진창/Noun,70,4,66,4.4461240913233895e-05,0.0007330564009152097,0.9428571428571428
2985,2985,돌려주다/Verb,70,6,64,6.669186136985083e-05,0.0007108425705844457,0.9142857142857144
2986,2986,찬사/Noun,70,61,9,0.0006780339239268168,9.996223648843771e-05,0.8714285714285714
2987,2987,you/Alpha,70,59,11,0.0006558033034701999,0.00012217606681920164,0.8428571428571429
2988,2988,일반인/Noun,70,11,59,0.00012226841251139318,0.000655307994757536,0.8428571428571429
2989,2989,의심스럽다/Adjective,70,11,59,0.00012226841251139318,0.000655307994757536,0.8428571428571429
2990,2990,티나/Noun,70,14,56,0.0001556143431963186,0.0006219872492613901,0.8
2991,2991,피아노/Noun,70,56,14,0.0006224573727852744,0.0001554968123153475,0.8
2992,2992,이기도/Josa,70,55,15,0.000611342062556966,0.0001666037274807295,0.7857142857142857
2993,2993,90분/Number,70,15,55,0.00016672965342462708,0.0006108803340960082,0.7857142857142857
2994,2994,미스터리/Noun,70,17,53,0.00018896027388124405,0.0005886665037652442,0.7571428571428571
2995,2995,믿음/Noun,70,52,18,0.0005779961318720405,0.00019992447297687542,0.7428571428571429
2996,2996,디테일/Noun,70,50,20,0.0005557655114154236,0.00022213830330763932,0.7142857142857143
2997,2997,닥치고/Noun,70,49,21,0.0005446502011871152,0.00023324521847302128,0.7
2998,2998,위험하다/Adjective,70,22,48,0.00024453682502278637,0.0005331319279383344,0.6857142857142857
2999,2999,멜로영화/Noun,70,46,24,0.0005113042705021896,0.0002665659639691672,0.6571428571428571
3000,3000,오로지/Adverb,70,24,46,0.0002667674454794033,0.0005109180976075704,0.6571428571428571
3001,3001,스필버그/Noun,70,46,24,0.0005113042705021896,0.0002665659639691672,0.6571428571428571
3002,3002,놀란/Noun,70,46,24,0.0005113042705021896,0.0002665659639691672,0.6571428571428571
3003,3003,업/Noun,70,26,44,0.00028899806593602026,0.0004887042672768067,0.6285714285714286
3004,3004,남자배우/Noun,70,28,42,0.0003112286863926372,0.00046649043694604257,0.6
3005,3005,본능/Noun,70,41,29,0.00045572771936064734,0.00032210053979607705,0.5857142857142857
3006,3006,고등학생/Noun,70,40,30,0.0004446124091323389,0.000333207454961459,0.5714285714285714
3007,3007,가르치다/Verb,70,39,31,0.0004334970989040304,0.00034431437012684104,0.5571428571428572
3008,3008,만큼이나/Josa,70,39,31,0.0004334970989040304,0.00034431437012684104,0.5571428571428572
3009,3009,아누/Noun,70,38,32,0.000422381788675722,0.00035542128529222287,0.5428571428571428
3010,3010,다해/Noun,70,32,38,0.00035568992730587116,0.0004220627762845148,0.5428571428571428
3011,3011,권상우/Noun,70,38,32,0.000422381788675722,0.00035542128529222287,0.5428571428571428
3012,3012,그치다/Verb,70,37,33,0.00041126647844741344,0.00036652820045760486,0.5285714285714286
3013,3013,가야/Noun,70,33,37,0.00036680523753417966,0.0004109558611191328,0.5285714285714286
3014,3014,실/Noun,70,37,33,0.00041126647844741344,0.00036652820045760486,0.5285714285714286
3015,3015,1등/Number,70,33,37,0.00036680523753417966,0.0004109558611191328,0.5285714285714286
3016,3016,국산/Noun,70,34,36,0.0003779205477624881,0.00039984894595375083,0.5142857142857142
3017,3017,정부/Noun,70,36,34,0.000400151168219105,0.00037763511562298685,0.5142857142857142
3018,3018,수면제/Noun,69,3,66,3.334593068492541e-05,0.0007330564009152097,0.9565217391304348
3019,3019,짬뽕/Noun,69,4,65,4.4461240913233895e-05,0.0007219494857498278,0.9420289855072465
3020,3020,비호감/Noun,69,7,62,7.78071715981593e-05,0.0006886287402536821,0.8985507246376812
3021,3021,명연기/Noun,69,61,8,0.0006780339239268168,8.885532132305573e-05,0.8840579710144928
3022,3022,꿀/Noun,69,61,8,0.0006780339239268168,8.885532132305573e-05,0.8840579710144928
3023,3023,국어/Noun,69,9,60,0.00010003779205477625,0.000666414909922918,0.8695652173913043
3024,3024,전문/Noun,69,13,56,0.00014449903296801013,0.0006219872492613901,0.8115942028985508
3025,3025,많아지다/Verb,69,55,14,0.000611342062556966,0.0001554968123153475,0.7971014492753623
3026,3026,순수/Noun,69,54,15,0.0006002267523286575,0.0001666037274807295,0.7826086956521741
3027,3027,초월/Noun,69,53,16,0.000589111442100349,0.00017771064264611146,0.7681159420289855
3028,3028,연관/Noun,69,16,53,0.00017784496365293558,0.0005886665037652442,0.7681159420289855
3029,3029,출연자/Noun,69,17,52,0.00018896027388124405,0.0005775595885998622,0.7536231884057971
3030,3030,저지르다/Verb,69,18,51,0.0002000755841095525,0.0005664526734344802,0.7391304347826086
3031,3031,혁명/Noun,69,50,19,0.0005557655114154236,0.00021103138814225735,0.7246376811594203
3032,3032,하나님/Noun,69,48,21,0.0005335348909588066,0.00023324521847302128,0.6956521739130435
3033,3033,마찬가지/Noun,69,21,48,0.00023342151479447792,0.0005331319279383344,0.6956521739130435
3034,3034,스포츠/Noun,69,47,22,0.0005224195807304982,0.00024435213363840333,0.6811594202898551
3035,3035,가까이/Noun,69,47,22,0.0005224195807304982,0.00024435213363840333,0.6811594202898551
3036,3036,빌다/Verb,69,46,23,0.0005113042705021896,0.0002554590488037852,0.6666666666666666
3037,3037,엽기/Noun,69,26,43,0.00028899806593602026,0.0004775973521114245,0.6231884057971014
3038,3038,계/Noun,69,26,43,0.00028899806593602026,0.0004775973521114245,0.6231884057971014
3039,3039,선수/Noun,69,42,27,0.00046684302958895584,0.0002998867094653131,0.6086956521739131
3040,3040,홀로/Noun,69,42,27,0.00046684302958895584,0.0002998867094653131,0.6086956521739131
3041,3041,애정/Noun,69,41,28,0.00045572771936064734,0.000310993624630695,0.5942028985507246
3042,3042,정리/Noun,69,28,41,0.0003112286863926372,0.00045538352178066063,0.5942028985507246
3043,3043,민족/Noun,69,40,29,0.0004446124091323389,0.00032210053979607705,0.5797101449275363
3044,3044,2000년/Number,69,29,40,0.0003223439966209457,0.0004442766066152787,0.5797101449275363
3045,3045,뎀/Noun,69,38,31,0.000422381788675722,0.00034431437012684104,0.5507246376811594
3046,3046,부터는/Josa,69,32,37,0.00035568992730587116,0.0004109558611191328,0.5362318840579711
3047,3047,무어/Noun,69,32,37,0.00035568992730587116,0.0004109558611191328,0.5362318840579711
3048,3048,밀/Noun,69,37,32,0.00041126647844741344,0.00035542128529222287,0.5362318840579711
3049,3049,잃어버리다/Verb,69,32,37,0.00035568992730587116,0.0004109558611191328,0.5362318840579711
3050,3050,교회/Noun,69,36,33,0.000400151168219105,0.00036652820045760486,0.5217391304347826
3051,3051,가능성/Noun,69,36,33,0.000400151168219105,0.00036652820045760486,0.5217391304347826
3052,3052,~~^^/Punctuation,68,65,3,0.0007224951648400508,3.33207454961459e-05,0.9558823529411764
3053,3053,유아/Noun,68,8,60,8.892248182646779e-05,0.000666414909922918,0.8823529411764706
3054,3054,게스트/Noun,68,10,58,0.00011115310228308472,0.0006442010795921541,0.8529411764705882
3055,3055,대박나다/Verb,68,58,10,0.0006446879932418914,0.00011106915165381967,0.8529411764705882
3056,3056,알파/Noun,68,56,12,0.0006224573727852744,0.0001332829819845836,0.8235294117647058
3057,3057,세대/Noun,68,54,14,0.0006002267523286575,0.0001554968123153475,0.7941176470588235
3058,3058,즐거움/Noun,68,53,15,0.000589111442100349,0.0001666037274807295,0.7794117647058824
3059,3059,고문/Noun,68,15,53,0.00016672965342462708,0.0005886665037652442,0.7794117647058824
3060,3060,연습/Noun,68,16,52,0.00017784496365293558,0.0005775595885998622,0.7647058823529411
3061,3061,40분/Number,68,16,52,0.00017784496365293558,0.0005775595885998622,0.7647058823529411
3062,3062,숨막히다/Adjective,68,52,16,0.0005779961318720405,0.00017771064264611146,0.7647058823529411
3063,3063,무식하다/Adjective,68,17,51,0.00018896027388124405,0.0005664526734344802,0.75
3064,3064,떡/Noun,68,19,49,0.00021119089433786097,0.0005442388431037163,0.7205882352941176
3065,3065,농담/Noun,68,19,49,0.00021119089433786097,0.0005442388431037163,0.7205882352941176
3066,3066,미스테리/Noun,68,19,49,0.00021119089433786097,0.0005442388431037163,0.7205882352941176
3067,3067,로빈/Noun,68,48,20,0.0005335348909588066,0.00022213830330763932,0.7058823529411765
3068,3068,미학/Noun,68,48,20,0.0005335348909588066,0.00022213830330763932,0.7058823529411765
3069,3069,뺏다/Verb,68,20,48,0.00022230620456616945,0.0005331319279383344,0.7058823529411765
3070,3070,쏟다/Verb,68,46,22,0.0005113042705021896,0.00024435213363840333,0.6764705882352942
3071,3071,타란티노/Noun,68,45,23,0.0005001889602738814,0.0002554590488037852,0.6617647058823529
3072,3072,반영/Noun,68,44,24,0.0004890736500455726,0.0002665659639691672,0.6470588235294118
3073,3073,자세하다/Adjective,68,44,24,0.0004890736500455726,0.0002665659639691672,0.6470588235294118
3074,3074,세트/Noun,68,25,43,0.0002778827557077118,0.0004775973521114245,0.6323529411764706
3075,3075,위주/Noun,68,25,43,0.0002778827557077118,0.0004775973521114245,0.6323529411764706
3076,3076,다른사람/Noun,68,25,43,0.0002778827557077118,0.0004775973521114245,0.6323529411764706
3077,3077,쭉/Noun,68,43,25,0.00047795833981726434,0.0002776728791345492,0.6323529411764706
3078,3078,스텝/Noun,68,28,40,0.0003112286863926372,0.0004442766066152787,0.5882352941176471
3079,3079,상이/Noun,68,40,28,0.0004446124091323389,0.000310993624630695,0.5882352941176471
3080,3080,소개/Noun,68,30,38,0.00033345930684925416,0.0004220627762845148,0.5588235294117647
3081,3081,?../Punctuation,68,30,38,0.00033345930684925416,0.0004220627762845148,0.5588235294117647
3082,3082,춤추다/Verb,68,36,32,0.000400151168219105,0.00035542128529222287,0.5294117647058824
3083,3083,기전/Noun,68,33,35,0.00036680523753417966,0.0003887420307883688,0.5147058823529411
3084,3084,암울하다/Adjective,68,35,33,0.0003890358579907965,0.00036652820045760486,0.5147058823529411
3085,3085,나무/Noun,68,34,34,0.0003779205477624881,0.00037763511562298685,0.5
3086,3086,국/Noun,68,34,34,0.0003779205477624881,0.00037763511562298685,0.5
3087,3087,굿굿굿/Noun,67,67,0,0.0007447257852966678,0.0,1.0
3088,3088,부자연스럽다/Adjective,67,8,59,8.892248182646779e-05,0.000655307994757536,0.8805970149253731
3089,3089,~~!!/Punctuation,67,55,12,0.000611342062556966,0.0001332829819845836,0.8208955223880597
3090,3090,강간/Noun,67,12,55,0.00013338372273970166,0.0006108803340960082,0.8208955223880597
3091,3091,뭣/Noun,67,15,52,0.00016672965342462708,0.0005775595885998622,0.7761194029850746
3092,3092,한동안/Adverb,67,51,16,0.0005668808216437321,0.00017771064264611146,0.7611940298507462
3093,3093,까지만/Josa,67,16,51,0.00017784496365293558,0.0005664526734344802,0.7611940298507462
3094,3094,간지/Noun,67,50,17,0.0005557655114154236,0.00018881755781149343,0.746268656716418
3095,3095,외국인/Noun,67,18,49,0.0002000755841095525,0.0005442388431037163,0.7313432835820896
3096,3096,ㅈㄴ/KoreanParticle,67,18,49,0.0002000755841095525,0.0005442388431037163,0.7313432835820896
3097,3097,s/Alpha,67,47,20,0.0005224195807304982,0.00022213830330763932,0.7014925373134329
3098,3098,마저도/Josa,67,21,46,0.00023342151479447792,0.0005109180976075704,0.6865671641791045
3099,3099,칭찬/Noun,67,22,45,0.00024453682502278637,0.0004998111824421885,0.6716417910447762
3100,3100,리도/Noun,67,22,45,0.00024453682502278637,0.0004998111824421885,0.6716417910447762
3101,3101,유치원/Noun,67,22,45,0.00024453682502278637,0.0004998111824421885,0.6716417910447762
3102,3102,권력/Noun,67,44,23,0.0004890736500455726,0.0002554590488037852,0.6567164179104478
3103,3103,데이빗/Noun,67,43,24,0.00047795833981726434,0.0002665659639691672,0.6417910447761194
3104,3104,원/Suffix,67,25,42,0.0002778827557077118,0.00046649043694604257,0.6268656716417911
3105,3105,능가/Noun,67,42,25,0.00046684302958895584,0.0002776728791345492,0.6268656716417911
3106,3106,우린/Noun,67,42,25,0.00046684302958895584,0.0002776728791345492,0.6268656716417911
3107,3107,데이/Noun,67,42,25,0.00046684302958895584,0.0002776728791345492,0.6268656716417911
3108,3108,문/Noun,67,26,41,0.00028899806593602026,0.00045538352178066063,0.6119402985074627
3109,3109,나로/Noun,67,26,41,0.00028899806593602026,0.00045538352178066063,0.6119402985074627
3110,3110,지식/Noun,67,40,27,0.0004446124091323389,0.0002998867094653131,0.5970149253731343
3111,3111,베일/Noun,67,38,29,0.000422381788675722,0.00032210053979607705,0.5671641791044776
3112,3112,박보영/Noun,67,36,31,0.000400151168219105,0.00034431437012684104,0.5373134328358209
3113,3113,쯤/Noun,67,35,32,0.0003890358579907965,0.00035542128529222287,0.5223880597014925
3114,3114,성과/Noun,67,35,32,0.0003890358579907965,0.00035542128529222287,0.5223880597014925
3115,3115,떨어뜨리다/Verb,66,4,62,4.4461240913233895e-05,0.0006886287402536821,0.9393939393939394
3116,3116,칠하다/Adjective,66,8,58,8.892248182646779e-05,0.0006442010795921541,0.8787878787878788
3117,3117,영구/Noun,66,10,56,0.00011115310228308472,0.0006219872492613901,0.8484848484848485
3118,3118,디카프리오/Noun,66,56,10,0.0006224573727852744,0.00011106915165381967,0.8484848484848485
3119,3119,콩/Noun,66,10,56,0.00011115310228308472,0.0006219872492613901,0.8484848484848485
3120,3120,화중/Noun,66,54,12,0.0006002267523286575,0.0001332829819845836,0.8181818181818182
3121,3121,한석규/Noun,66,54,12,0.0006002267523286575,0.0001332829819845836,0.8181818181818182
3122,3122,외롭다/Adjective,66,49,17,0.0005446502011871152,0.00018881755781149343,0.7424242424242424
3123,3123,머릿속/Noun,66,47,19,0.0005224195807304982,0.00021103138814225735,0.7121212121212122
3124,3124,상징/Noun,66,45,21,0.0005001889602738814,0.00023324521847302128,0.6818181818181818
3125,3125,커서/Noun,66,44,22,0.0004890736500455726,0.00024435213363840333,0.6666666666666666
3126,3126,이따/Noun,66,23,43,0.00025565213525109487,0.0004775973521114245,0.6515151515151515
3127,3127,억울하다/Adjective,66,23,43,0.00025565213525109487,0.0004775973521114245,0.6515151515151515
3128,3128,견디다/Verb,66,24,42,0.0002667674454794033,0.00046649043694604257,0.6363636363636364
3129,3129,포함/Noun,66,24,42,0.0002667674454794033,0.00046649043694604257,0.6363636363636364
3130,3130,강아지/Noun,66,41,25,0.00045572771936064734,0.0002776728791345492,0.6212121212121212
3131,3131,호불호/Noun,66,41,25,0.00045572771936064734,0.0002776728791345492,0.6212121212121212
3132,3132,드네/Noun,66,39,27,0.0004334970989040304,0.0002998867094653131,0.5909090909090909
3133,3133,장애인/Noun,66,38,28,0.000422381788675722,0.000310993624630695,0.5757575757575758
3134,3134,반응/Noun,66,28,38,0.0003112286863926372,0.0004220627762845148,0.5757575757575758
3135,3135,부산/Noun,66,38,28,0.000422381788675722,0.000310993624630695,0.5757575757575758
3136,3136,너희/Noun,66,29,37,0.0003223439966209457,0.0004109558611191328,0.5606060606060606
3137,3137,당장/Noun,66,36,30,0.000400151168219105,0.000333207454961459,0.5454545454545454
3138,3138,옳다/Adjective,66,30,36,0.00033345930684925416,0.00039984894595375083,0.5454545454545454
3139,3139,해봤다/Verb,66,35,31,0.0003890358579907965,0.00034431437012684104,0.5303030303030303
3140,3140,니콜라스/Noun,66,31,35,0.00034457461707756266,0.0003887420307883688,0.5303030303030303
3141,3141,주인/Noun,66,33,33,0.00036680523753417966,0.00036652820045760486,0.5
3142,3142,빠순이/Noun,65,5,60,5.557655114154236e-05,0.000666414909922918,0.9230769230769232
3143,3143,적당/Noun,65,9,56,0.00010003779205477625,0.0006219872492613901,0.8615384615384616
3144,3144,아우/Noun,65,10,55,0.00011115310228308472,0.0006108803340960082,0.8461538461538461
3145,3145,다시금/Noun,65,54,11,0.0006002267523286575,0.00012217606681920164,0.8307692307692308
3146,3146,마누라/Noun,65,12,53,0.00013338372273970166,0.0005886665037652442,0.8153846153846154
3147,3147,미스캐스팅/Noun,65,12,53,0.00013338372273970166,0.0005886665037652442,0.8153846153846154
3148,3148,올려주다/Verb,65,51,14,0.0005668808216437321,0.0001554968123153475,0.7846153846153846
3149,3149,시체/Noun,65,16,49,0.00017784496365293558,0.0005442388431037163,0.7538461538461538
3150,3150,죄송하다/Adjective,65,17,48,0.00018896027388124405,0.0005331319279383344,0.7384615384615385
3151,3151,거임/Noun,65,18,47,0.0002000755841095525,0.0005220250127729526,0.7230769230769231
3152,3152,마다/Noun,65,45,20,0.0005001889602738814,0.00022213830330763932,0.6923076923076923
3153,3153,안쓰럽다/Adjective,65,22,43,0.00024453682502278637,0.0004775973521114245,0.6615384615384615
3154,3154,차승원/Noun,65,43,22,0.00047795833981726434,0.00024435213363840333,0.6615384615384615
3155,3155,백인/Noun,65,22,43,0.00024453682502278637,0.0004775973521114245,0.6615384615384615
3156,3156,도와주다/Verb,65,23,42,0.00025565213525109487,0.00046649043694604257,0.6461538461538462
3157,3157,구만/Noun,65,23,42,0.00025565213525109487,0.00046649043694604257,0.6461538461538462
3158,3158,.........../Punctuation,65,24,41,0.0002667674454794033,0.00045538352178066063,0.6307692307692307
3159,3159,인식/Noun,65,26,39,0.00028899806593602026,0.0004331696914498967,0.6
3160,3160,어쨌든/Noun,65,38,27,0.000422381788675722,0.0002998867094653131,0.5846153846153846
3161,3161,동감/Noun,65,27,38,0.0003001133761643288,0.0004220627762845148,0.5846153846153846
3162,3162,일부/Noun,65,29,36,0.0003223439966209457,0.00039984894595375083,0.5538461538461539
3163,3163,어차피/Noun,65,29,36,0.0003223439966209457,0.00039984894595375083,0.5538461538461539
3164,3164,공주/Noun,65,36,29,0.000400151168219105,0.00032210053979607705,0.5538461538461539
3165,3165,이드/Noun,65,35,30,0.0003890358579907965,0.000333207454961459,0.5384615384615384
3166,3166,연상/Noun,65,33,32,0.00036680523753417966,0.00035542128529222287,0.5076923076923077
3167,3167,없애다/Verb,65,33,32,0.00036680523753417966,0.00035542128529222287,0.5076923076923077
3168,3168,역작/Noun,64,59,5,0.0006558033034701999,5.5534575826909837e-05,0.921875
3169,3169,싱겁다/Adjective,64,7,57,7.78071715981593e-05,0.0006330941644267722,0.890625
3170,3170,치노/Noun,64,53,11,0.000589111442100349,0.00012217606681920164,0.828125
3171,3171,잘나가다/Verb,64,11,53,0.00012226841251139318,0.0005886665037652442,0.828125
3172,3172,뒤늦다/Adjective,64,52,12,0.0005779961318720405,0.0001332829819845836,0.8125
3173,3173,납득/Noun,64,12,52,0.00013338372273970166,0.0005775595885998622,0.8125
3174,3174,조차/Noun,64,13,51,0.00014449903296801013,0.0005664526734344802,0.796875
3175,3175,사람과/Noun,64,51,13,0.0005668808216437321,0.00014438989714996554,0.796875
3176,3176,클래식/Noun,64,50,14,0.0005557655114154236,0.0001554968123153475,0.78125
3177,3177,...!/Punctuation,64,48,16,0.0005335348909588066,0.00017771064264611146,0.75
3178,3178,재방/Noun,64,48,16,0.0005335348909588066,0.00017771064264611146,0.75
3179,3179,우드/Noun,64,48,16,0.0005335348909588066,0.00017771064264611146,0.75
3180,3180,두렵다/Adjective,64,48,16,0.0005335348909588066,0.00017771064264611146,0.75
3181,3181,떨리다/Verb,64,47,17,0.0005224195807304982,0.00018881755781149343,0.734375
3182,3182,차리다/Verb,64,17,47,0.00018896027388124405,0.0005220250127729526,0.734375
3183,3183,!!!!!!/Punctuation,64,47,17,0.0005224195807304982,0.00018881755781149343,0.734375
3184,3184,찍/Noun,64,18,46,0.0002000755841095525,0.0005109180976075704,0.71875
3185,3185,신화/Noun,64,46,18,0.0005113042705021896,0.00019992447297687542,0.71875
3186,3186,난후/Noun,64,44,20,0.0004890736500455726,0.00022213830330763932,0.6875
3187,3187,발랄하다/Adjective,64,44,20,0.0004890736500455726,0.00022213830330763932,0.6875
3188,3188,스펙/Noun,64,43,21,0.00047795833981726434,0.00023324521847302128,0.671875
3189,3189,인걸/Josa,64,22,42,0.00024453682502278637,0.00046649043694604257,0.65625
3190,3190,세계관/Noun,64,22,42,0.00024453682502278637,0.00046649043694604257,0.65625
3191,3191,찌르다/Verb,64,22,42,0.00024453682502278637,0.00046649043694604257,0.65625
3192,3192,화질/Noun,64,23,41,0.00025565213525109487,0.00045538352178066063,0.640625
3193,3193,설/Noun,64,24,40,0.0002667674454794033,0.0004442766066152787,0.625
3194,3194,화하다/Adjective,64,27,37,0.0003001133761643288,0.0004109558611191328,0.578125
3195,3195,추격/Noun,64,36,28,0.000400151168219105,0.000310993624630695,0.5625
3196,3196,리암/Noun,64,36,28,0.000400151168219105,0.000310993624630695,0.5625
3197,3197,도르다/Verb,64,29,35,0.0003223439966209457,0.0003887420307883688,0.546875
3198,3198,각/Noun,64,34,30,0.0003779205477624881,0.000333207454961459,0.53125
3199,3199,구조/Noun,64,30,34,0.00033345930684925416,0.00037763511562298685,0.53125
3200,3200,열다/Verb,64,34,30,0.0003779205477624881,0.000333207454961459,0.53125
3201,3201,한지/Noun,64,30,34,0.00033345930684925416,0.00037763511562298685,0.53125
3202,3202,보나/Noun,64,33,31,0.00036680523753417966,0.00034431437012684104,0.515625
3203,3203,로맨틱코미디/Noun,64,32,32,0.00035568992730587116,0.00035542128529222287,0.5
3204,3204,4.44/Number,63,9,54,0.00010003779205477625,0.0005997734189306263,0.8571428571428571
3205,3205,-_-;;/Punctuation,63,9,54,0.00010003779205477625,0.0005997734189306263,0.8571428571428571
3206,3206,재앙/Noun,63,10,53,0.00011115310228308472,0.0005886665037652442,0.8412698412698413
3207,3207,해지/Noun,63,51,12,0.0005668808216437321,0.0001332829819845836,0.8095238095238095
3208,3208,다치다/Verb,63,16,47,0.00017784496365293558,0.0005220250127729526,0.7460317460317459
3209,3209,허무/Noun,63,16,47,0.00017784496365293558,0.0005220250127729526,0.7460317460317459
3210,3210,앙/Adverb,63,45,18,0.0005001889602738814,0.00019992447297687542,0.7142857142857143
3211,3211,승부/Noun,63,18,45,0.0002000755841095525,0.0004998111824421885,0.7142857142857143
3212,3212,김희선/Noun,63,20,43,0.00022230620456616945,0.0004775973521114245,0.6825396825396826
3213,3213,벌어지다/Verb,63,42,21,0.00046684302958895584,0.00023324521847302128,0.6666666666666666
3214,3214,첨으로/Adverb,63,22,41,0.00024453682502278637,0.00045538352178066063,0.6507936507936508
3215,3215,만화가/Noun,63,22,41,0.00024453682502278637,0.00045538352178066063,0.6507936507936508
3216,3216,작화/Noun,63,40,23,0.0004446124091323389,0.0002554590488037852,0.6349206349206349
3217,3217,거듭/Noun,63,40,23,0.0004446124091323389,0.0002554590488037852,0.6349206349206349
3218,3218,메이/Noun,63,40,23,0.0004446124091323389,0.0002554590488037852,0.6349206349206349
3219,3219,오직/Noun,63,24,39,0.0002667674454794033,0.0004331696914498967,0.6190476190476191
3220,3220,강동원/Noun,63,39,24,0.0004334970989040304,0.0002665659639691672,0.6190476190476191
3221,3221,장진/Noun,63,26,37,0.00028899806593602026,0.0004109558611191328,0.5873015873015873
3222,3222,비쥬/Noun,63,26,37,0.00028899806593602026,0.0004109558611191328,0.5873015873015873
3223,3223,3시간/Number,63,36,27,0.000400151168219105,0.0002998867094653131,0.5714285714285714
3224,3224,섬/Noun,63,36,27,0.000400151168219105,0.0002998867094653131,0.5714285714285714
3225,3225,깜놀/Noun,63,36,27,0.000400151168219105,0.0002998867094653131,0.5714285714285714
3226,3226,주가/Noun,63,28,35,0.0003112286863926372,0.0003887420307883688,0.5555555555555556
3227,3227,슈퍼맨/Noun,63,28,35,0.0003112286863926372,0.0003887420307883688,0.5555555555555556
3228,3228,열자/Noun,63,28,35,0.0003112286863926372,0.0003887420307883688,0.5555555555555556
3229,3229,오해/Noun,63,34,29,0.0003779205477624881,0.00032210053979607705,0.5396825396825397
3230,3230,산다/Noun,63,32,31,0.00035568992730587116,0.00034431437012684104,0.5079365079365079
3231,3231,bb/Alpha,62,59,3,0.0006558033034701999,3.33207454961459e-05,0.9516129032258064
3232,3232,에로물/Noun,62,6,56,6.669186136985083e-05,0.0006219872492613901,0.9032258064516128
3233,3233,살때/Noun,62,54,8,0.0006002267523286575,8.885532132305573e-05,0.8709677419354839
3234,3234,알바생/Noun,62,8,54,8.892248182646779e-05,0.0005997734189306263,0.8709677419354839
3235,3235,벅차다/Adjective,62,53,9,0.000589111442100349,9.996223648843771e-05,0.8548387096774194
3236,3236,로운/Josa,62,51,11,0.0005668808216437321,0.00012217606681920164,0.8225806451612904
3237,3237,^-^/Punctuation,62,50,12,0.0005557655114154236,0.0001332829819845836,0.8064516129032258
3238,3238,꼽/Noun,62,49,13,0.0005446502011871152,0.00014438989714996554,0.7903225806451613
3239,3239,관대하다/Adjective,62,14,48,0.0001556143431963186,0.0005331319279383344,0.7741935483870968
3240,3240,뿌리다/Verb,62,14,48,0.0001556143431963186,0.0005331319279383344,0.7741935483870968
3241,3241,페이크/Noun,62,14,48,0.0001556143431963186,0.0005331319279383344,0.7741935483870968
3242,3242,망치/Noun,62,16,46,0.00017784496365293558,0.0005109180976075704,0.7419354838709677
3243,3243,올레/Noun,62,16,46,0.00017784496365293558,0.0005109180976075704,0.7419354838709677
3244,3244,강요/Noun,62,16,46,0.00017784496365293558,0.0005109180976075704,0.7419354838709677
3245,3245,밀다/Verb,62,17,45,0.00018896027388124405,0.0004998111824421885,0.7258064516129032
3246,3246,다섯/Determiner,62,45,17,0.0005001889602738814,0.00018881755781149343,0.7258064516129032
3247,3247,짜내다/Verb,62,18,44,0.0002000755841095525,0.0004887042672768067,0.7096774193548387
3248,3248,가짜/Noun,62,19,43,0.00021119089433786097,0.0004775973521114245,0.6935483870967742
3249,3249,소품/Noun,62,20,42,0.00022230620456616945,0.00046649043694604257,0.6774193548387096
3250,3250,아담/Noun,62,42,20,0.00046684302958895584,0.00022213830330763932,0.6774193548387096
3251,3251,다녀오다/Verb,62,42,20,0.00046684302958895584,0.00022213830330763932,0.6774193548387096
3252,3252,만난/Noun,62,41,21,0.00045572771936064734,0.00023324521847302128,0.6612903225806451
3253,3253,원조/Noun,62,41,21,0.00045572771936064734,0.00023324521847302128,0.6612903225806451
3254,3254,구석/Noun,62,21,41,0.00023342151479447792,0.00045538352178066063,0.6612903225806451
3255,3255,드러내다/Verb,62,40,22,0.0004446124091323389,0.00024435213363840333,0.6451612903225806
3256,3256,섬뜩하다/Adjective,62,39,23,0.0004334970989040304,0.0002554590488037852,0.6290322580645161
3257,3257,흑백/Noun,62,38,24,0.000422381788675722,0.0002665659639691672,0.6129032258064516
3258,3258,가라/Noun,62,24,38,0.0002667674454794033,0.0004220627762845148,0.6129032258064516
3259,3259,행/Noun,62,38,24,0.000422381788675722,0.0002665659639691672,0.6129032258064516
3260,3260,철저하다/Adjective,62,24,38,0.0002667674454794033,0.0004220627762845148,0.6129032258064516
3261,3261,지지/Noun,62,24,38,0.0002667674454794033,0.0004220627762845148,0.6129032258064516
3262,3262,곤/Noun,62,25,37,0.0002778827557077118,0.0004109558611191328,0.5967741935483871
3263,3263,파워/Noun,62,26,36,0.00028899806593602026,0.00039984894595375083,0.5806451612903226
3264,3264,대에/Foreign,62,26,36,0.00028899806593602026,0.00039984894595375083,0.5806451612903226
3265,3265,옥/Noun,62,36,26,0.000400151168219105,0.00028877979429993113,0.5806451612903226
3266,3266,외면/Noun,62,35,27,0.0003890358579907965,0.0002998867094653131,0.5645161290322581
3267,3267,갓/Noun,62,28,34,0.0003112286863926372,0.00037763511562298685,0.5483870967741935
3268,3268,최민수/Noun,62,33,29,0.00036680523753417966,0.00032210053979607705,0.532258064516129
3269,3269,가게/Noun,62,30,32,0.00033345930684925416,0.00035542128529222287,0.5161290322580645
3270,3270,쏘우/Noun,62,32,30,0.00035568992730587116,0.000333207454961459,0.5161290322580645
3271,3271,장소/Noun,62,30,32,0.00033345930684925416,0.00035542128529222287,0.5161290322580645
3272,3272,시험/Noun,62,31,31,0.00034457461707756266,0.00034431437012684104,0.5
3273,3273,두고두고/Noun,61,55,6,0.000611342062556966,6.66414909922918e-05,0.9016393442622952
3274,3274,짱짱맨/Noun,61,52,9,0.0005779961318720405,9.996223648843771e-05,0.8524590163934426
3275,3275,관리/Noun,61,11,50,0.00012226841251139318,0.0005553457582690984,0.819672131147541
3276,3276,창피하다/Adjective,61,12,49,0.00013338372273970166,0.0005442388431037163,0.8032786885245902
3277,3277,과도/Noun,61,15,46,0.00016672965342462708,0.0005109180976075704,0.7540983606557377
3278,3278,싸하다/Adjective,61,15,46,0.00016672965342462708,0.0005109180976075704,0.7540983606557377
3279,3279,남친/Noun,61,16,45,0.00017784496365293558,0.0004998111824421885,0.7377049180327869
3280,3280,공연/Noun,61,45,16,0.0005001889602738814,0.00017771064264611146,0.7377049180327869
3281,3281,떠들다/Verb,61,17,44,0.00018896027388124405,0.0004887042672768067,0.7213114754098361
3282,3282,방황/Noun,61,43,18,0.00047795833981726434,0.00019992447297687542,0.7049180327868853
3283,3283,덩어리/Noun,61,18,43,0.0002000755841095525,0.0004775973521114245,0.7049180327868853
3284,3284,태국/Noun,61,18,43,0.0002000755841095525,0.0004775973521114245,0.7049180327868853
3285,3285,밝혀지다/Verb,61,19,42,0.00021119089433786097,0.00046649043694604257,0.6885245901639344
3286,3286,톤/Noun,61,20,41,0.00022230620456616945,0.00045538352178066063,0.6721311475409836
3287,3287,타인/Noun,61,41,20,0.00045572771936064734,0.00022213830330763932,0.6721311475409836
3288,3288,음향/Noun,61,20,41,0.00022230620456616945,0.00045538352178066063,0.6721311475409836
3289,3289,볼라/Noun,61,21,40,0.00023342151479447792,0.0004442766066152787,0.6557377049180327
3290,3290,지내다/Verb,61,40,21,0.0004446124091323389,0.00023324521847302128,0.6557377049180327
3291,3291,택시/Noun,61,23,38,0.00025565213525109487,0.0004220627762845148,0.6229508196721312
3292,3292,특집/Noun,61,23,38,0.00025565213525109487,0.0004220627762845148,0.6229508196721312
3293,3293,여지/Noun,61,37,24,0.00041126647844741344,0.0002665659639691672,0.6065573770491803
3294,3294,층/Noun,61,25,36,0.0002778827557077118,0.00039984894595375083,0.5901639344262295
3295,3295,띄다/Verb,61,25,36,0.0002778827557077118,0.00039984894595375083,0.5901639344262295
3296,3296,엄정화/Noun,61,36,25,0.000400151168219105,0.0002776728791345492,0.5901639344262295
3297,3297,포드/Noun,61,35,26,0.0003890358579907965,0.00028877979429993113,0.5737704918032787
3298,3298,밝히다/Verb,61,26,35,0.00028899806593602026,0.0003887420307883688,0.5737704918032787
3299,3299,해오다/Verb,61,34,27,0.0003779205477624881,0.0002998867094653131,0.5573770491803278
3300,3300,언어/Noun,61,34,27,0.0003779205477624881,0.0002998867094653131,0.5573770491803278
3301,3301,킬러/Noun,61,27,34,0.0003001133761643288,0.00037763511562298685,0.5573770491803278
3302,3302,정선/Noun,61,33,28,0.00036680523753417966,0.000310993624630695,0.5409836065573771
3303,3303,찬란하다/Adjective,61,29,32,0.0003223439966209457,0.00035542128529222287,0.5245901639344263
3304,3304,복선/Noun,61,29,32,0.0003223439966209457,0.00035542128529222287,0.5245901639344263
3305,3305,종/Noun,61,29,32,0.0003223439966209457,0.00035542128529222287,0.5245901639344263
3306,3306,엉뚱하다/Adjective,61,30,31,0.00033345930684925416,0.00034431437012684104,0.5081967213114754
3307,3307,OOOO/Alpha,60,2,58,2.2230620456616947e-05,0.0006442010795921541,0.9666666666666668
3308,3308,쯧쯧/Noun,60,3,57,3.334593068492541e-05,0.0006330941644267722,0.95
3309,3309,모욕/Noun,60,4,56,4.4461240913233895e-05,0.0006219872492613901,0.9333333333333332
3310,3310,홧팅/Noun,60,56,4,0.0006224573727852744,4.4427660661527865e-05,0.9333333333333332
3311,3311,심사/Noun,60,5,55,5.557655114154236e-05,0.0006108803340960082,0.9166666666666666
3312,3312,울림/Noun,60,55,5,0.000611342062556966,5.5534575826909837e-05,0.9166666666666666
3313,3313,고독/Noun,60,51,9,0.0005668808216437321,9.996223648843771e-05,0.85
3314,3314,깨달음/Noun,60,49,11,0.0005446502011871152,0.00012217606681920164,0.8166666666666667
3315,3315,어째/Noun,60,12,48,0.00013338372273970166,0.0005331319279383344,0.8
3316,3316,상큼/Noun,60,48,12,0.0005335348909588066,0.0001332829819845836,0.8
3317,3317,..!!/Punctuation,60,47,13,0.0005224195807304982,0.00014438989714996554,0.7833333333333333
3318,3318,젊은이/Noun,60,47,13,0.0005224195807304982,0.00014438989714996554,0.7833333333333333
3319,3319,자랑/Noun,60,14,46,0.0001556143431963186,0.0005109180976075704,0.7666666666666667
3320,3320,맙시/Noun,60,15,45,0.00016672965342462708,0.0004998111824421885,0.75
3321,3321,짙다/Adjective,60,44,16,0.0004890736500455726,0.00017771064264611146,0.7333333333333333
3322,3322,ㅂ/KoreanParticle,60,18,42,0.0002000755841095525,0.00046649043694604257,0.7
3323,3323,사과/Noun,60,18,42,0.0002000755841095525,0.00046649043694604257,0.7
3324,3324,떄/Noun,60,41,19,0.00045572771936064734,0.00021103138814225735,0.6833333333333333
3325,3325,신비/Noun,60,41,19,0.00045572771936064734,0.00021103138814225735,0.6833333333333333
3326,3326,백배/Noun,60,40,20,0.0004446124091323389,0.00022213830330763932,0.6666666666666666
3327,3327,다이하드/Noun,60,21,39,0.00023342151479447792,0.0004331696914498967,0.65
3328,3328,에바/Noun,60,22,38,0.00024453682502278637,0.0004220627762845148,0.6333333333333333
3329,3329,유익하다/Adjective,60,37,23,0.00041126647844741344,0.0002554590488037852,0.6166666666666667
3330,3330,애니매이션/Noun,60,37,23,0.00041126647844741344,0.0002554590488037852,0.6166666666666667
3331,3331,김혜수/Noun,60,36,24,0.000400151168219105,0.0002665659639691672,0.6
3332,3332,덮다/Verb,60,24,36,0.0002667674454794033,0.00039984894595375083,0.6
3333,3333,슨/Noun,60,36,24,0.000400151168219105,0.0002665659639691672,0.6
3334,3334,박하다/Adjective,60,35,25,0.0003890358579907965,0.0002776728791345492,0.5833333333333334
3335,3335,넹/Noun,60,25,35,0.0002778827557077118,0.0003887420307883688,0.5833333333333334
3336,3336,무간도/Noun,60,25,35,0.0002778827557077118,0.0003887420307883688,0.5833333333333334
3337,3337,조선/Noun,60,25,35,0.0002778827557077118,0.0003887420307883688,0.5833333333333334
3338,3338,주위/Noun,60,34,26,0.0003779205477624881,0.00028877979429993113,0.5666666666666667
3339,3339,인권/Noun,60,34,26,0.0003779205477624881,0.00028877979429993113,0.5666666666666667
3340,3340,집다/Verb,60,26,34,0.00028899806593602026,0.00037763511562298685,0.5666666666666667
3341,3341,도둑/Noun,60,27,33,0.0003001133761643288,0.00036652820045760486,0.55
3342,3342,자본/Noun,60,28,32,0.0003112286863926372,0.00035542128529222287,0.5333333333333333
3343,3343,혹/Noun,60,28,32,0.0003112286863926372,0.00035542128529222287,0.5333333333333333
3344,3344,차별/Noun,60,32,28,0.00035568992730587116,0.000310993624630695,0.5333333333333333
3345,3345,침/Noun,60,28,32,0.0003112286863926372,0.00035542128529222287,0.5333333333333333
3346,3346,참여/Noun,60,29,31,0.0003223439966209457,0.00034431437012684104,0.5166666666666667
3347,3347,광/Noun,60,29,31,0.0003223439966209457,0.00034431437012684104,0.5166666666666667
3348,3348,소/Noun,60,29,31,0.0003223439966209457,0.00034431437012684104,0.5166666666666667
3349,3349,걷다/Verb,60,31,29,0.00034457461707756266,0.00032210053979607705,0.5166666666666667
3350,3350,볼일/Noun,59,3,56,3.334593068492541e-05,0.0006219872492613901,0.9491525423728814
3351,3351,미달/Noun,59,4,55,4.4461240913233895e-05,0.0006108803340960082,0.9322033898305084
3352,3352,거북하다/Adjective,59,5,54,5.557655114154236e-05,0.0005997734189306263,0.9152542372881356
3353,3353,군더더기/Noun,59,54,5,0.0006002267523286575,5.5534575826909837e-05,0.9152542372881356
3354,3354,bad/Alpha,59,5,54,5.557655114154236e-05,0.0005997734189306263,0.9152542372881356
3355,3355,모독/Noun,59,7,52,7.78071715981593e-05,0.0005775595885998622,0.8813559322033898
3356,3356,폼/Noun,59,11,48,0.00012226841251139318,0.0005331319279383344,0.8135593220338984
3357,3357,먹기/Noun,59,11,48,0.00012226841251139318,0.0005331319279383344,0.8135593220338984
3358,3358,천사/Noun,59,48,11,0.0005335348909588066,0.00012217606681920164,0.8135593220338984
3359,3359,부담/Noun,59,46,13,0.0005113042705021896,0.00014438989714996554,0.7796610169491526
3360,3360,엔딩크레딧/Noun,59,46,13,0.0005113042705021896,0.00014438989714996554,0.7796610169491526
3361,3361,누님/Noun,59,45,14,0.0005001889602738814,0.0001554968123153475,0.7627118644067796
3362,3362,칠/Noun,59,14,45,0.0001556143431963186,0.0004998111824421885,0.7627118644067796
3363,3363,짓/VerbPrefix,59,15,44,0.00016672965342462708,0.0004887042672768067,0.7457627118644068
3364,3364,반감/Noun,59,15,44,0.00016672965342462708,0.0004887042672768067,0.7457627118644068
3365,3365,성형/Noun,59,16,43,0.00017784496365293558,0.0004775973521114245,0.7288135593220338
3366,3366,뉴스/Noun,59,17,42,0.00018896027388124405,0.00046649043694604257,0.7118644067796609
3367,3367,떡밥/Noun,59,18,41,0.0002000755841095525,0.00045538352178066063,0.6949152542372882
3368,3368,인연/Noun,59,40,19,0.0004446124091323389,0.00021103138814225735,0.6779661016949152
3369,3369,고작/Noun,59,19,40,0.00021119089433786097,0.0004442766066152787,0.6779661016949152
3370,3370,눈치/Noun,59,19,40,0.00021119089433786097,0.0004442766066152787,0.6779661016949152
3371,3371,찾아오다/Verb,59,38,21,0.000422381788675722,0.00023324521847302128,0.6440677966101694
3372,3372,토니/Noun,59,37,22,0.00041126647844741344,0.00024435213363840333,0.6271186440677966
3373,3373,스콧/Noun,59,37,22,0.00041126647844741344,0.00024435213363840333,0.6271186440677966
3374,3374,테이큰/Noun,59,36,23,0.000400151168219105,0.0002554590488037852,0.6101694915254238
3375,3375,리기/Noun,59,36,23,0.000400151168219105,0.0002554590488037852,0.6101694915254238
3376,3376,밖에는/Josa,59,24,35,0.0002667674454794033,0.0003887420307883688,0.5932203389830508
3377,3377,스파이더맨/Noun,59,35,24,0.0003890358579907965,0.0002665659639691672,0.5932203389830508
3378,3378,나루토/Noun,59,35,24,0.0003890358579907965,0.0002665659639691672,0.5932203389830508
3379,3379,그려지다/Verb,59,35,24,0.0003890358579907965,0.0002665659639691672,0.5932203389830508
3380,3380,아이유/Noun,59,34,25,0.0003779205477624881,0.0002776728791345492,0.576271186440678
3381,3381,뒤지다/Verb,59,25,34,0.0002778827557077118,0.00037763511562298685,0.576271186440678
3382,3382,박평/Noun,59,34,25,0.0003779205477624881,0.0002776728791345492,0.576271186440678
3383,3383,기사/Noun,59,25,34,0.0002778827557077118,0.00037763511562298685,0.576271186440678
3384,3384,버스/Noun,59,33,26,0.00036680523753417966,0.00028877979429993113,0.559322033898305
3385,3385,흔들리다/Verb,59,26,33,0.00028899806593602026,0.00036652820045760486,0.559322033898305
3386,3386,불가능하다/Adjective,59,26,33,0.00028899806593602026,0.00036652820045760486,0.559322033898305
3387,3387,쓰이다/Verb,59,27,32,0.0003001133761643288,0.00035542128529222287,0.5423728813559322
3388,3388,징/Noun,59,27,32,0.0003001133761643288,0.00035542128529222287,0.5423728813559322
3389,3389,클라스/Noun,59,32,27,0.00035568992730587116,0.0002998867094653131,0.5423728813559322
3390,3390,던/Noun,59,27,32,0.0003001133761643288,0.00035542128529222287,0.5423728813559322
3391,3391,가하다/Verb,59,28,31,0.0003112286863926372,0.00034431437012684104,0.5254237288135594
3392,3392,하고도/Josa,59,29,30,0.0003223439966209457,0.000333207454961459,0.5084745762711864
3393,3393,킹/Noun,59,29,30,0.0003223439966209457,0.000333207454961459,0.5084745762711864
3394,3394,로드/Noun,59,30,29,0.00033345930684925416,0.00032210053979607705,0.5084745762711864
3395,3395,새록새록/Noun,58,57,1,0.0006335726830135829,1.1106915165381966e-05,0.9827586206896552
3396,3396,우롱/Noun,58,3,55,3.334593068492541e-05,0.0006108803340960082,0.9482758620689656
3397,3397,개똥/Noun,58,4,54,4.4461240913233895e-05,0.0005997734189306263,0.9310344827586208
3398,3398,진영화/Noun,58,53,5,0.000589111442100349,5.5534575826909837e-05,0.913793103448276
3399,3399,아기자기하다/Adjective,58,51,7,0.0005668808216437321,7.774840615767377e-05,0.8793103448275862
3400,3400,렉/Noun,58,8,50,8.892248182646779e-05,0.0005553457582690984,0.8620689655172413
3401,3401,기쁘다/Adjective,58,49,9,0.0005446502011871152,9.996223648843771e-05,0.8448275862068966
3402,3402,남고/Noun,58,48,10,0.0005335348909588066,0.00011106915165381967,0.8275862068965517
3403,3403,문득/Noun,58,47,11,0.0005224195807304982,0.00012217606681920164,0.8103448275862069
3404,3404,성장하다/Adjective,58,44,14,0.0004890736500455726,0.0001554968123153475,0.7586206896551724
3405,3405,향기/Noun,58,44,14,0.0004890736500455726,0.0001554968123153475,0.7586206896551724
3406,3406,왕조현/Noun,58,43,15,0.00047795833981726434,0.0001666037274807295,0.7413793103448276
3407,3407,타이틀/Noun,58,15,43,0.00016672965342462708,0.0004775973521114245,0.7413793103448276
3408,3408,사이코/Noun,58,15,43,0.00016672965342462708,0.0004775973521114245,0.7413793103448276
3409,3409,벌/Noun,58,16,42,0.00017784496365293558,0.00046649043694604257,0.7241379310344828
3410,3410,기승/Noun,58,16,42,0.00017784496365293558,0.00046649043694604257,0.7241379310344828
3411,3411,습/Noun,58,41,17,0.00045572771936064734,0.00018881755781149343,0.7068965517241379
3412,3412,레이첼/Noun,58,40,18,0.0004446124091323389,0.00019992447297687542,0.6896551724137931
3413,3413,영활/Noun,58,18,40,0.0002000755841095525,0.0004442766066152787,0.6896551724137931
3414,3414,".""/Punctuation",58,40,18,0.0004446124091323389,0.00019992447297687542,0.6896551724137931
3415,3415,디테/Noun,58,39,19,0.0004334970989040304,0.00021103138814225735,0.6724137931034483
3416,3416,썩/Noun,58,19,39,0.00021119089433786097,0.0004331696914498967,0.6724137931034483
3417,3417,피곤하다/Adjective,58,20,38,0.00022230620456616945,0.0004220627762845148,0.6551724137931034
3418,3418,어떠하다/Adjective,58,38,20,0.000422381788675722,0.00022213830330763932,0.6551724137931034
3419,3419,양/Suffix,58,37,21,0.00041126647844741344,0.00023324521847302128,0.6379310344827587
3420,3420,...(/Punctuation,58,21,37,0.00023342151479447792,0.0004109558611191328,0.6379310344827587
3421,3421,지켜보다/Verb,58,37,21,0.00041126647844741344,0.00023324521847302128,0.6379310344827587
3422,3422,평화/Noun,58,36,22,0.000400151168219105,0.00024435213363840333,0.6206896551724138
3423,3423,합치다/Verb,58,23,35,0.00025565213525109487,0.0003887420307883688,0.603448275862069
3424,3424,황정민/Noun,58,35,23,0.0003890358579907965,0.0002554590488037852,0.603448275862069
3425,3425,시골/Noun,58,34,24,0.0003779205477624881,0.0002665659639691672,0.5862068965517241
3426,3426,해외/Noun,58,25,33,0.0002778827557077118,0.00036652820045760486,0.5689655172413793
3427,3427,김수현/Noun,58,32,26,0.00035568992730587116,0.00028877979429993113,0.5517241379310345
3428,3428,까맣다/Adjective,58,32,26,0.00035568992730587116,0.00028877979429993113,0.5517241379310345
3429,3429,손예진/Noun,58,27,31,0.0003001133761643288,0.00034431437012684104,0.5344827586206896
3430,3430,한효주/Noun,58,27,31,0.0003001133761643288,0.00034431437012684104,0.5344827586206896
3431,3431,제시카/Noun,58,27,31,0.0003001133761643288,0.00034431437012684104,0.5344827586206896
3432,3432,맺다/Verb,58,31,27,0.00034457461707756266,0.0002998867094653131,0.5344827586206896
3433,3433,제왕/Noun,58,28,30,0.0003112286863926372,0.000333207454961459,0.5172413793103449
3434,3434,동양/Noun,58,30,28,0.00033345930684925416,0.000310993624630695,0.5172413793103449
3435,3435,멀리/Noun,58,29,29,0.0003223439966209457,0.00032210053979607705,0.5
3436,3436,반도/Noun,57,2,55,2.2230620456616947e-05,0.0006108803340960082,0.9649122807017544
3437,3437,커녕/Noun,57,3,54,3.334593068492541e-05,0.0005997734189306263,0.9473684210526316
3438,3438,헛웃음/Noun,57,4,53,4.4461240913233895e-05,0.0005886665037652442,0.9298245614035088
3439,3439,차분하다/Adjective,57,48,9,0.0005335348909588066,9.996223648843771e-05,0.8421052631578947
3440,3440,어지간하다/Adjective,57,11,46,0.00012226841251139318,0.0005109180976075704,0.8070175438596491
3441,3441,압/Noun,57,46,11,0.0005113042705021896,0.00012217606681920164,0.8070175438596491
3442,3442,학창시절/Noun,57,44,13,0.0004890736500455726,0.00014438989714996554,0.7719298245614035
3443,3443,더욱더/Noun,57,44,13,0.0004890736500455726,0.00014438989714996554,0.7719298245614035
3444,3444,주온/Noun,57,14,43,0.0001556143431963186,0.0004775973521114245,0.7543859649122807
3445,3445,적극/Noun,57,42,15,0.00046684302958895584,0.0001666037274807295,0.7368421052631579
3446,3446,새삼/Noun,57,41,16,0.00045572771936064734,0.00017771064264611146,0.7192982456140351
3447,3447,환자/Noun,57,18,39,0.0002000755841095525,0.0004331696914498967,0.6842105263157895
3448,3448,쎄다/Adjective,57,18,39,0.0002000755841095525,0.0004331696914498967,0.6842105263157895
3449,3449,미장센/Noun,57,38,19,0.000422381788675722,0.00021103138814225735,0.6666666666666666
3450,3450,각각/Noun,57,38,19,0.000422381788675722,0.00021103138814225735,0.6666666666666666
3451,3451,대학생/Noun,57,20,37,0.00022230620456616945,0.0004109558611191328,0.6491228070175439
3452,3452,겨울왕국/Noun,57,37,20,0.00041126647844741344,0.00022213830330763932,0.6491228070175439
3453,3453,내려가다/Verb,57,20,37,0.00022230620456616945,0.0004109558611191328,0.6491228070175439
3454,3454,청년/Noun,57,37,20,0.00041126647844741344,0.00022213830330763932,0.6491228070175439
3455,3455,5년/Number,57,36,21,0.000400151168219105,0.00023324521847302128,0.631578947368421
3456,3456,T/Alpha,57,36,21,0.000400151168219105,0.00023324521847302128,0.631578947368421
3457,3457,스파이/Noun,57,36,21,0.000400151168219105,0.00023324521847302128,0.631578947368421
3458,3458,오지/Noun,57,22,35,0.00024453682502278637,0.0003887420307883688,0.6140350877192983
3459,3459,신세계/Noun,57,35,22,0.0003890358579907965,0.00024435213363840333,0.6140350877192983
3460,3460,송승헌/Noun,57,23,34,0.00025565213525109487,0.00037763511562298685,0.5964912280701754
3461,3461,쿨하다/Adjective,57,34,23,0.0003779205477624881,0.0002554590488037852,0.5964912280701754
3462,3462,색깔/Noun,57,34,23,0.0003779205477624881,0.0002554590488037852,0.5964912280701754
3463,3463,질문/Noun,57,33,24,0.00036680523753417966,0.0002665659639691672,0.5789473684210527
3464,3464,대학/Noun,57,24,33,0.0002667674454794033,0.00036652820045760486,0.5789473684210527
3465,3465,이정재/Noun,57,33,24,0.00036680523753417966,0.0002665659639691672,0.5789473684210527
3466,3466,이나/Foreign,57,25,32,0.0002778827557077118,0.00035542128529222287,0.5614035087719298
3467,3467,장애/Noun,57,25,32,0.0002778827557077118,0.00035542128529222287,0.5614035087719298
3468,3468,무리다/Adjective,57,25,32,0.0002778827557077118,0.00035542128529222287,0.5614035087719298
3469,3469,60년/Number,57,26,31,0.00028899806593602026,0.00034431437012684104,0.543859649122807
3470,3470,롱/Noun,57,31,26,0.00034457461707756266,0.00028877979429993113,0.543859649122807
3471,3471,재현/Noun,57,31,26,0.00034457461707756266,0.00028877979429993113,0.543859649122807
3472,3472,자라다/Verb,57,31,26,0.00034457461707756266,0.00028877979429993113,0.543859649122807
3473,3473,래야/Noun,57,26,31,0.00028899806593602026,0.00034431437012684104,0.543859649122807
3474,3474,설경구/Noun,57,30,27,0.00033345930684925416,0.0002998867094653131,0.5263157894736842
3475,3475,완젼/Noun,57,30,27,0.00033345930684925416,0.0002998867094653131,0.5263157894736842
3476,3476,찌/Noun,57,28,29,0.0003112286863926372,0.00032210053979607705,0.5087719298245614
3477,3477,시장/Noun,57,29,28,0.0003223439966209457,0.000310993624630695,0.5087719298245614
3478,3478,원주율/Noun,56,2,54,2.2230620456616947e-05,0.0005997734189306263,0.9642857142857144
3479,3479,난국/Noun,56,2,54,2.2230620456616947e-05,0.0005997734189306263,0.9642857142857144
3480,3480,묵직하다/Adjective,56,49,7,0.0005446502011871152,7.774840615767377e-05,0.875
3481,3481,오랫동안/Adverb,56,49,7,0.0005446502011871152,7.774840615767377e-05,0.875
3482,3482,손꼽다/Verb,56,45,11,0.0005001889602738814,0.00012217606681920164,0.8035714285714286
3483,3483,절반/Noun,56,11,45,0.00012226841251139318,0.0004998111824421885,0.8035714285714286
3484,3484,비싸다/Adjective,56,11,45,0.00012226841251139318,0.0004998111824421885,0.8035714285714286
3485,3485,아이고/Exclamation,56,12,44,0.00013338372273970166,0.0004887042672768067,0.7857142857142857
3486,3486,에드/Noun,56,44,12,0.0004890736500455726,0.0001332829819845836,0.7857142857142857
3487,3487,!~/Punctuation,56,43,13,0.00047795833981726434,0.00014438989714996554,0.7678571428571429
3488,3488,의견/Noun,56,15,41,0.00016672965342462708,0.00045538352178066063,0.7321428571428571
3489,3489,덤/Noun,56,40,16,0.0004446124091323389,0.00017771064264611146,0.7142857142857143
3490,3490,싸이코패스/Noun,56,16,40,0.00017784496365293558,0.0004442766066152787,0.7142857142857143
3491,3491,집안/Noun,56,16,40,0.00017784496365293558,0.0004442766066152787,0.7142857142857143
3492,3492,귀찮다/Adjective,56,17,39,0.00018896027388124405,0.0004331696914498967,0.6964285714285714
3493,3493,유행/Noun,56,17,39,0.00018896027388124405,0.0004331696914498967,0.6964285714285714
3494,3494,공식/Noun,56,17,39,0.00018896027388124405,0.0004331696914498967,0.6964285714285714
3495,3495,사장/Noun,56,18,38,0.0002000755841095525,0.0004220627762845148,0.6785714285714286
3496,3496,빼놓다/Verb,56,38,18,0.000422381788675722,0.00019992447297687542,0.6785714285714286
3497,3497,방향/Noun,56,18,38,0.0002000755841095525,0.0004220627762845148,0.6785714285714286
3498,3498,영웅본색/Noun,56,19,37,0.00021119089433786097,0.0004109558611191328,0.6607142857142857
3499,3499,대하/Noun,56,37,19,0.00041126647844741344,0.00021103138814225735,0.6607142857142857
3500,3500,크레딧/Noun,56,37,19,0.00041126647844741344,0.00021103138814225735,0.6607142857142857
3501,3501,펼치다/Verb,56,37,19,0.00041126647844741344,0.00021103138814225735,0.6607142857142857
3502,3502,추악하다/Adjective,56,36,20,0.000400151168219105,0.00022213830330763932,0.6428571428571429
3503,3503,사무라이/Noun,56,20,36,0.00022230620456616945,0.00039984894595375083,0.6428571428571429
3504,3504,잘나다/Adjective,56,20,36,0.00022230620456616945,0.00039984894595375083,0.6428571428571429
3505,3505,주관/Noun,56,20,36,0.00022230620456616945,0.00039984894595375083,0.6428571428571429
3506,3506,고해/Noun,56,20,36,0.00022230620456616945,0.00039984894595375083,0.6428571428571429
3507,3507,유혹/Noun,56,20,36,0.00022230620456616945,0.00039984894595375083,0.6428571428571429
3508,3508,적나라하다/Adjective,56,35,21,0.0003890358579907965,0.00023324521847302128,0.625
3509,3509,장혁/Noun,56,35,21,0.0003890358579907965,0.00023324521847302128,0.625
3510,3510,콜린/Noun,56,35,21,0.0003890358579907965,0.00023324521847302128,0.625
3511,3511,옮기다/Verb,56,22,34,0.00024453682502278637,0.00037763511562298685,0.6071428571428571
3512,3512,전지현/Noun,56,22,34,0.00024453682502278637,0.00037763511562298685,0.6071428571428571
3513,3513,눕다/Verb,56,22,34,0.00024453682502278637,0.00037763511562298685,0.6071428571428571
3514,3514,박찬욱/Noun,56,22,34,0.00024453682502278637,0.00037763511562298685,0.6071428571428571
3515,3515,따지다/Verb,56,33,23,0.00036680523753417966,0.0002554590488037852,0.5892857142857143
3516,3516,훔치다/Verb,56,23,33,0.00025565213525109487,0.00036652820045760486,0.5892857142857143
3517,3517,지대/Noun,56,23,33,0.00025565213525109487,0.00036652820045760486,0.5892857142857143
3518,3518,걸이/Noun,56,23,33,0.00025565213525109487,0.00036652820045760486,0.5892857142857143
3519,3519,명/Suffix,56,24,32,0.0002667674454794033,0.00035542128529222287,0.5714285714285714
3520,3520,아바타/Noun,56,32,24,0.00035568992730587116,0.0002665659639691672,0.5714285714285714
3521,3521,회상/Noun,56,31,25,0.00034457461707756266,0.0002776728791345492,0.5535714285714286
3522,3522,공허하다/Adjective,56,31,25,0.00034457461707756266,0.0002776728791345492,0.5535714285714286
3523,3523,애인/Noun,56,26,30,0.00028899806593602026,0.000333207454961459,0.5357142857142857
3524,3524,엑스맨/Noun,56,30,26,0.00033345930684925416,0.00028877979429993113,0.5357142857142857
3525,3525,왕자/Noun,56,30,26,0.00033345930684925416,0.00028877979429993113,0.5357142857142857
3526,3526,섹시/Noun,56,30,26,0.00033345930684925416,0.00028877979429993113,0.5357142857142857
3527,3527,부다/Adjective,56,27,29,0.0003001133761643288,0.00032210053979607705,0.5178571428571429
3528,3528,당당하다/Adjective,56,29,27,0.0003223439966209457,0.0002998867094653131,0.5178571428571429
3529,3529,유령/Noun,56,27,29,0.0003001133761643288,0.00032210053979607705,0.5178571428571429
3530,3530,열리다/Verb,56,29,27,0.0003223439966209457,0.0002998867094653131,0.5178571428571429
3531,3531,트랜스포머/Noun,56,28,28,0.0003112286863926372,0.000310993624630695,0.5
3532,3532,따스하다/Adjective,55,54,1,0.0006002267523286575,1.1106915165381966e-05,0.9818181818181818
3533,3533,만족스럽다/Adjective,55,50,5,0.0005557655114154236,5.5534575826909837e-05,0.9090909090909092
3534,3534,흠잡다/Adjective,55,50,5,0.0005557655114154236,5.5534575826909837e-05,0.9090909090909092
3535,3535,투성이/Noun,55,6,49,6.669186136985083e-05,0.0005442388431037163,0.8909090909090909
3536,3536,어정쩡하다/Adjective,55,6,49,6.669186136985083e-05,0.0005442388431037163,0.8909090909090909
3537,3537,정화/Noun,55,47,8,0.0005224195807304982,8.885532132305573e-05,0.8545454545454545
3538,3538,도망가다/Verb,55,9,46,0.00010003779205477625,0.0005109180976075704,0.8363636363636363
3539,3539,멀쩡하다/Adjective,55,11,44,0.00012226841251139318,0.0004887042672768067,0.8
3540,3540,출현/Noun,55,13,42,0.00014449903296801013,0.00046649043694604257,0.7636363636363637
3541,3541,덜하다/Adjective,55,41,14,0.00045572771936064734,0.0001554968123153475,0.7454545454545455
3542,3542,꼬이다/Adjective,55,15,40,0.00016672965342462708,0.0004442766066152787,0.7272727272727273
3543,3543,촌/Noun,55,38,17,0.000422381788675722,0.00018881755781149343,0.6909090909090909
3544,3544,러셀/Noun,55,38,17,0.000422381788675722,0.00018881755781149343,0.6909090909090909
3545,3545,..;/Punctuation,55,17,38,0.00018896027388124405,0.0004220627762845148,0.6909090909090909
3546,3546,하고프다/Verb,55,37,18,0.00041126647844741344,0.00019992447297687542,0.6727272727272727
3547,3547,지독하다/Adjective,55,37,18,0.00041126647844741344,0.00019992447297687542,0.6727272727272727
3548,3548,is/Alpha,55,37,18,0.00041126647844741344,0.00019992447297687542,0.6727272727272727
3549,3549,가식/Noun,55,20,35,0.00022230620456616945,0.0003887420307883688,0.6363636363636364
3550,3550,재방송/Noun,55,35,20,0.0003890358579907965,0.00022213830330763932,0.6363636363636364
3551,3551,다크나이트/Noun,55,35,20,0.0003890358579907965,0.00022213830330763932,0.6363636363636364
3552,3552,끝판/Noun,55,20,35,0.00022230620456616945,0.0003887420307883688,0.6363636363636364
3553,3553,신부/Noun,55,35,20,0.0003890358579907965,0.00022213830330763932,0.6363636363636364
3554,3554,번역/Noun,55,20,35,0.00022230620456616945,0.0003887420307883688,0.6363636363636364
3555,3555,작년/Noun,55,35,20,0.0003890358579907965,0.00022213830330763932,0.6363636363636364
3556,3556,스피드/Noun,55,23,32,0.00025565213525109487,0.00035542128529222287,0.5818181818181818
3557,3557,조지/Noun,55,31,24,0.00034457461707756266,0.0002665659639691672,0.5636363636363636
3558,3558,어딘가/Noun,55,31,24,0.00034457461707756266,0.0002665659639691672,0.5636363636363636
3559,3559,기타/Noun,55,30,25,0.00033345930684925416,0.0002776728791345492,0.5454545454545454
3560,3560,폰/Noun,55,25,30,0.0002778827557077118,0.000333207454961459,0.5454545454545454
3561,3561,대상/Noun,55,25,30,0.0002778827557077118,0.000333207454961459,0.5454545454545454
3562,3562,마디/Noun,55,25,30,0.0002778827557077118,0.000333207454961459,0.5454545454545454
3563,3563,픽션/Noun,55,25,30,0.0002778827557077118,0.000333207454961459,0.5454545454545454
3564,3564,람보/Noun,55,30,25,0.00033345930684925416,0.0002776728791345492,0.5454545454545454
3565,3565,지극히/Adverb,55,29,26,0.0003223439966209457,0.00028877979429993113,0.5272727272727272
3566,3566,완죤/Noun,55,28,27,0.0003112286863926372,0.0002998867094653131,0.509090909090909
3567,3567,준영/Noun,55,27,28,0.0003001133761643288,0.000310993624630695,0.509090909090909
3568,3568,외로움/Noun,54,52,2,0.0005779961318720405,2.2213830330763933e-05,0.9629629629629628
3569,3569,흑역사/Noun,54,2,52,2.2230620456616947e-05,0.0005775595885998622,0.9629629629629628
3570,3570,개꿀잼/Noun,54,51,3,0.0005668808216437321,3.33207454961459e-05,0.9444444444444444
3571,3571,쪽팔리다/Verb,54,6,48,6.669186136985083e-05,0.0005331319279383344,0.8888888888888888
3572,3572,3분/Number,54,8,46,8.892248182646779e-05,0.0005109180976075704,0.8518518518518519
3573,3573,주행/Noun,54,46,8,0.0005113042705021896,8.885532132305573e-05,0.8518518518518519
3574,3574,온갖/Noun,54,9,45,0.00010003779205477625,0.0004998111824421885,0.8333333333333334
3575,3575,대역/Noun,54,10,44,0.00011115310228308472,0.0004887042672768067,0.8148148148148148
3576,3576,색채/Noun,54,43,11,0.00047795833981726434,0.00012217606681920164,0.7962962962962963
3577,3577,개발/Noun,54,12,42,0.00013338372273970166,0.00046649043694604257,0.7777777777777778
3578,3578,전라도/Noun,54,12,42,0.00013338372273970166,0.00046649043694604257,0.7777777777777778
3579,3579,차마/Noun,54,13,41,0.00014449903296801013,0.00045538352178066063,0.7592592592592593
3580,3580,구경/Noun,54,13,41,0.00014449903296801013,0.00045538352178066063,0.7592592592592593
3581,3581,관람객/Noun,54,14,40,0.0001556143431963186,0.0004442766066152787,0.7407407407407407
3582,3582,혀/Noun,54,14,40,0.0001556143431963186,0.0004442766066152787,0.7407407407407407
3583,3583,일찍/Noun,54,39,15,0.0004334970989040304,0.0001666037274807295,0.7222222222222222
3584,3584,피디/Noun,54,15,39,0.00016672965342462708,0.0004331696914498967,0.7222222222222222
3585,3585,본성/Noun,54,38,16,0.000422381788675722,0.00017771064264611146,0.7037037037037037
3586,3586,말리다/Verb,54,16,38,0.00017784496365293558,0.0004220627762845148,0.7037037037037037
3587,3587,절절/Noun,54,38,16,0.000422381788675722,0.00017771064264611146,0.7037037037037037
3588,3588,기용/Noun,54,16,38,0.00017784496365293558,0.0004220627762845148,0.7037037037037037
3589,3589,살기/Noun,54,38,16,0.000422381788675722,0.00017771064264611146,0.7037037037037037
3590,3590,크리스/Noun,54,38,16,0.000422381788675722,0.00017771064264611146,0.7037037037037037
3591,3591,팍팍/Adverb,54,17,37,0.00018896027388124405,0.0004109558611191328,0.6851851851851852
3592,3592,거야/Eomi,54,17,37,0.00018896027388124405,0.0004109558611191328,0.6851851851851852
3593,3593,차태현/Noun,54,37,17,0.00041126647844741344,0.00018881755781149343,0.6851851851851852
3594,3594,그나저나/Adverb,54,35,19,0.0003890358579907965,0.00021103138814225735,0.6481481481481481
3595,3595,권/Noun,54,35,19,0.0003890358579907965,0.00021103138814225735,0.6481481481481481
3596,3596,가기/Noun,54,20,34,0.00022230620456616945,0.00037763511562298685,0.6296296296296297
3597,3597,잭슨/Noun,54,34,20,0.0003779205477624881,0.00022213830330763932,0.6296296296296297
3598,3598,거대하다/Adjective,54,34,20,0.0003779205477624881,0.00022213830330763932,0.6296296296296297
3599,3599,버그/Noun,54,34,20,0.0003779205477624881,0.00022213830330763932,0.6296296296296297
3600,3600,밟다/Verb,54,21,33,0.00023342151479447792,0.00036652820045760486,0.6111111111111112
3601,3601,상관/Noun,54,21,33,0.00023342151479447792,0.00036652820045760486,0.6111111111111112
3602,3602,격/Noun,54,21,33,0.00023342151479447792,0.00036652820045760486,0.6111111111111112
3603,3603,다운로드/Noun,54,21,33,0.00023342151479447792,0.00036652820045760486,0.6111111111111112
3604,3604,밀리다/Verb,54,22,32,0.00024453682502278637,0.00035542128529222287,0.5925925925925926
3605,3605,가안/Noun,54,22,32,0.00024453682502278637,0.00035542128529222287,0.5925925925925926
3606,3606,호감/Noun,54,32,22,0.00035568992730587116,0.00024435213363840333,0.5925925925925926
3607,3607,마블/Noun,54,31,23,0.00034457461707756266,0.0002554590488037852,0.5740740740740741
3608,3608,막상/Noun,54,24,30,0.0002667674454794033,0.000333207454961459,0.5555555555555556
3609,3609,픽사/Noun,54,25,29,0.0002778827557077118,0.00032210053979607705,0.5370370370370371
3610,3610,만큼의/Josa,54,29,25,0.0003223439966209457,0.0002776728791345492,0.5370370370370371
3611,3611,디젤/Noun,54,28,26,0.0003112286863926372,0.00028877979429993113,0.5185185185185185
3612,3612,ㅓ/KoreanParticle,54,26,28,0.00028899806593602026,0.000310993624630695,0.5185185185185185
3613,3613,치료/Noun,54,26,28,0.00028899806593602026,0.000310993624630695,0.5185185185185185
3614,3614,유지태/Noun,54,28,26,0.0003112286863926372,0.00028877979429993113,0.5185185185185185
3615,3615,냉정하다/Adjective,54,26,28,0.00028899806593602026,0.000310993624630695,0.5185185185185185
3616,3616,중후/Noun,54,27,27,0.0003001133761643288,0.0002998867094653131,0.5
3617,3617,헛/Noun,53,5,48,5.557655114154236e-05,0.0005331319279383344,0.9056603773584906
3618,3618,팝콘/Noun,53,6,47,6.669186136985083e-05,0.0005220250127729526,0.8867924528301887
3619,3619,흐지부지/Noun,53,6,47,6.669186136985083e-05,0.0005220250127729526,0.8867924528301887
3620,3620,납치/Noun,53,7,46,7.78071715981593e-05,0.0005109180976075704,0.8679245283018868
3621,3621,오유/Noun,53,7,46,7.78071715981593e-05,0.0005109180976075704,0.8679245283018868
3622,3622,서정/Noun,53,45,8,0.0005001889602738814,8.885532132305573e-05,0.8490566037735849
3623,3623,c/Alpha,53,8,45,8.892248182646779e-05,0.0004998111824421885,0.8490566037735849
3624,3624,^^*/Punctuation,53,45,8,0.0005001889602738814,8.885532132305573e-05,0.8490566037735849
3625,3625,클라라/Noun,53,9,44,0.00010003779205477625,0.0004887042672768067,0.8301886792452831
3626,3626,최민식/Noun,53,42,11,0.00046684302958895584,0.00012217606681920164,0.7924528301886793
3627,3627,벌리다/Verb,53,11,42,0.00012226841251139318,0.00046649043694604257,0.7924528301886793
3628,3628,살인자/Noun,53,11,42,0.00012226841251139318,0.00046649043694604257,0.7924528301886793
3629,3629,옛/Modifier,53,41,12,0.00045572771936064734,0.0001332829819845836,0.7735849056603774
3630,3630,나머진/Noun,53,12,41,0.00013338372273970166,0.00045538352178066063,0.7735849056603774
3631,3631,눈요기/Noun,53,12,41,0.00013338372273970166,0.00045538352178066063,0.7735849056603774
3632,3632,깨끗하다/Adjective,53,40,13,0.0004446124091323389,0.00014438989714996554,0.7547169811320755
3633,3633,재치/Noun,53,39,14,0.0004334970989040304,0.0001554968123153475,0.7358490566037735
3634,3634,한국어/Noun,53,14,39,0.0001556143431963186,0.0004331696914498967,0.7358490566037735
3635,3635,께서/Josa,53,38,15,0.000422381788675722,0.0001666037274807295,0.7169811320754716
3636,3636,이외/Noun,53,15,38,0.00016672965342462708,0.0004220627762845148,0.7169811320754716
3637,3637,조차도/Josa,53,15,38,0.00016672965342462708,0.0004220627762845148,0.7169811320754716
3638,3638,정석/Noun,53,37,16,0.00041126647844741344,0.00017771064264611146,0.6981132075471698
3639,3639,movie/Alpha,53,37,16,0.00041126647844741344,0.00017771064264611146,0.6981132075471698
3640,3640,틀림없다/Adjective,53,37,16,0.00041126647844741344,0.00017771064264611146,0.6981132075471698
3641,3641,네/Modifier,53,16,37,0.00017784496365293558,0.0004109558611191328,0.6981132075471698
3642,3642,예고/Noun,53,16,37,0.00017784496365293558,0.0004109558611191328,0.6981132075471698
3643,3643,저렇다/Adjective,53,16,37,0.00017784496365293558,0.0004109558611191328,0.6981132075471698
3644,3644,멘탈/Noun,53,16,37,0.00017784496365293558,0.0004109558611191328,0.6981132075471698
3645,3645,1분/Number,53,17,36,0.00018896027388124405,0.00039984894595375083,0.6792452830188679
3646,3646,무의미하다/Adjective,53,17,36,0.00018896027388124405,0.00039984894595375083,0.6792452830188679
3647,3647,★/Foreign,53,35,18,0.0003890358579907965,0.00019992447297687542,0.660377358490566
3648,3648,잘알다/Verb,53,35,18,0.0003890358579907965,0.00019992447297687542,0.660377358490566
3649,3649,부터/Foreign,53,35,18,0.0003890358579907965,0.00019992447297687542,0.660377358490566
3650,3650,레옹/Noun,53,18,35,0.0002000755841095525,0.0003887420307883688,0.660377358490566
3651,3651,신도/Noun,53,18,35,0.0002000755841095525,0.0003887420307883688,0.660377358490566
3652,3652,볼걸/Noun,53,18,35,0.0002000755841095525,0.0003887420307883688,0.660377358490566
3653,3653,일리/Noun,53,34,19,0.0003779205477624881,0.00021103138814225735,0.6415094339622641
3654,3654,긴박/Noun,53,19,34,0.00021119089433786097,0.00037763511562298685,0.6415094339622641
3655,3655,이의/Noun,53,33,20,0.00036680523753417966,0.00022213830330763932,0.6226415094339622
3656,3656,꼽히다/Verb,53,33,20,0.00036680523753417966,0.00022213830330763932,0.6226415094339622
3657,3657,태도/Noun,53,20,33,0.00022230620456616945,0.00036652820045760486,0.6226415094339622
3658,3658,감옥/Noun,53,21,32,0.00023342151479447792,0.00035542128529222287,0.6037735849056604
3659,3659,할배/Noun,53,21,32,0.00023342151479447792,0.00035542128529222287,0.6037735849056604
3660,3660,사귀다/Verb,53,21,32,0.00023342151479447792,0.00035542128529222287,0.6037735849056604
3661,3661,신데렐라/Noun,53,22,31,0.00024453682502278637,0.00034431437012684104,0.5849056603773585
3662,3662,꺼내다/Verb,53,31,22,0.00034457461707756266,0.00024435213363840333,0.5849056603773585
3663,3663,작전/Noun,53,22,31,0.00024453682502278637,0.00034431437012684104,0.5849056603773585
3664,3664,공원/Noun,53,22,31,0.00024453682502278637,0.00034431437012684104,0.5849056603773585
3665,3665,어서/Noun,53,31,22,0.00034457461707756266,0.00024435213363840333,0.5849056603773585
3666,3666,프리/Noun,53,31,22,0.00034457461707756266,0.00024435213363840333,0.5849056603773585
3667,3667,당/Noun,53,30,23,0.00033345930684925416,0.0002554590488037852,0.5660377358490566
3668,3668,꾸미다/Verb,53,30,23,0.00033345930684925416,0.0002554590488037852,0.5660377358490566
3669,3669,늑대/Noun,53,24,29,0.0002667674454794033,0.00032210053979607705,0.5471698113207547
3670,3670,마법/Noun,53,29,24,0.0003223439966209457,0.0002665659639691672,0.5471698113207547
3671,3671,반지/Noun,53,29,24,0.0003223439966209457,0.0002665659639691672,0.5471698113207547
3672,3672,함부로/Noun,53,25,28,0.0002778827557077118,0.000310993624630695,0.5283018867924528
3673,3673,외치다/Verb,53,25,28,0.0002778827557077118,0.000310993624630695,0.5283018867924528
3674,3674,러브스토리/Noun,53,28,25,0.0003112286863926372,0.0002776728791345492,0.5283018867924528
3675,3675,마을/Noun,53,26,27,0.00028899806593602026,0.0002998867094653131,0.5094339622641509
3676,3676,기록/Noun,53,26,27,0.00028899806593602026,0.0002998867094653131,0.5094339622641509
3677,3677,크리스찬/Noun,53,27,26,0.0003001133761643288,0.00028877979429993113,0.5094339622641509
3678,3678,집단/Noun,53,27,26,0.0003001133761643288,0.00028877979429993113,0.5094339622641509
3679,3679,...;;/Punctuation,52,4,48,4.4461240913233895e-05,0.0005331319279383344,0.9230769230769232
3680,3680,ㅗ/KoreanParticle,52,7,45,7.78071715981593e-05,0.0004998111824421885,0.8653846153846154
3681,3681,엉터리/Noun,52,7,45,7.78071715981593e-05,0.0004998111824421885,0.8653846153846154
3682,3682,성찰/Noun,52,43,9,0.00047795833981726434,9.996223648843771e-05,0.8269230769230769
3683,3683,모방/Noun,52,10,42,0.00011115310228308472,0.00046649043694604257,0.8076923076923077
3684,3684,매주/Adverb,52,42,10,0.00046684302958895584,0.00011106915165381967,0.8076923076923077
3685,3685,파라/Noun,52,11,41,0.00012226841251139318,0.00045538352178066063,0.7884615384615384
3686,3686,더니/Noun,52,11,41,0.00012226841251139318,0.00045538352178066063,0.7884615384615384
3687,3687,안남/Noun,52,13,39,0.00014449903296801013,0.0004331696914498967,0.75
3688,3688,어쩌다/Adverb,52,13,39,0.00014449903296801013,0.0004331696914498967,0.75
3689,3689,노튼/Noun,52,38,14,0.000422381788675722,0.0001554968123153475,0.7307692307692307
3690,3690,베이/Noun,52,38,14,0.000422381788675722,0.0001554968123153475,0.7307692307692307
3691,3691,!?/Punctuation,52,15,37,0.00016672965342462708,0.0004109558611191328,0.7115384615384616
3692,3692,펼쳐지다/Verb,52,37,15,0.00041126647844741344,0.0001666037274807295,0.7115384615384616
3693,3693,고어/Noun,52,16,36,0.00017784496365293558,0.00039984894595375083,0.6923076923076923
3694,3694,어딜/Adverb,52,17,35,0.00018896027388124405,0.0003887420307883688,0.6730769230769231
3695,3695,빨갛다/Adjective,52,35,17,0.0003890358579907965,0.00018881755781149343,0.6730769230769231
3696,3696,수없이/Adverb,52,17,35,0.00018896027388124405,0.0003887420307883688,0.6730769230769231
3697,3697,몇개/Noun,52,18,34,0.0002000755841095525,0.00037763511562298685,0.6538461538461539
3698,3698,조명/Noun,52,34,18,0.0003779205477624881,0.00019992447297687542,0.6538461538461539
3699,3699,주네/Noun,52,34,18,0.0003779205477624881,0.00019992447297687542,0.6538461538461539
3700,3700,금지/Noun,52,19,33,0.00021119089433786097,0.00036652820045760486,0.6346153846153846
3701,3701,예수/Noun,52,19,33,0.00021119089433786097,0.00036652820045760486,0.6346153846153846
3702,3702,커피/Noun,52,33,19,0.00036680523753417966,0.00021103138814225735,0.6346153846153846
3703,3703,불만/Noun,52,20,32,0.00022230620456616945,0.00035542128529222287,0.6153846153846154
3704,3704,장이/Suffix,52,20,32,0.00022230620456616945,0.00035542128529222287,0.6153846153846154
3705,3705,헉/Adverb,52,20,32,0.00022230620456616945,0.00035542128529222287,0.6153846153846154
3706,3706,MBC/Alpha,52,20,32,0.00022230620456616945,0.00035542128529222287,0.6153846153846154
3707,3707,성유리/Noun,52,32,20,0.00035568992730587116,0.00022213830330763932,0.6153846153846154
3708,3708,일수/Noun,52,31,21,0.00034457461707756266,0.00023324521847302128,0.5961538461538461
3709,3709,님들/Noun,52,21,31,0.00023342151479447792,0.00034431437012684104,0.5961538461538461
3710,3710,여유/Noun,52,31,21,0.00034457461707756266,0.00023324521847302128,0.5961538461538461
3711,3711,국제/Noun,52,30,22,0.00033345930684925416,0.00024435213363840333,0.5769230769230769
3712,3712,인도영화/Noun,52,30,22,0.00033345930684925416,0.00024435213363840333,0.5769230769230769
3713,3713,라스/Noun,52,29,23,0.0003223439966209457,0.0002554590488037852,0.5576923076923077
3714,3714,경악/Noun,52,23,29,0.00025565213525109487,0.00032210053979607705,0.5576923076923077
3715,3715,극본/Noun,52,23,29,0.00025565213525109487,0.00032210053979607705,0.5576923076923077
3716,3716,또는/Adverb,52,24,28,0.0002667674454794033,0.000310993624630695,0.5384615384615384
3717,3717,실상/Noun,52,24,28,0.0002667674454794033,0.000310993624630695,0.5384615384615384
3718,3718,비참하다/Adjective,52,28,24,0.0003112286863926372,0.0002665659639691672,0.5384615384615384
3719,3719,지네/Noun,52,26,26,0.00028899806593602026,0.00028877979429993113,0.5
3720,3720,끈/Noun,52,26,26,0.00028899806593602026,0.00028877979429993113,0.5
3721,3721,어수선하다/Adjective,51,3,48,3.334593068492541e-05,0.0005331319279383344,0.9411764705882352
3722,3722,저급하다/Adjective,51,5,46,5.557655114154236e-05,0.0005109180976075704,0.9019607843137256
3723,3723,씨발/Noun,51,5,46,5.557655114154236e-05,0.0005109180976075704,0.9019607843137256
3724,3724,가관/Noun,51,6,45,6.669186136985083e-05,0.0004998111824421885,0.8823529411764706
3725,3725,불필요하다/Adjective,51,7,44,7.78071715981593e-05,0.0004887042672768067,0.8627450980392157
3726,3726,.!/Punctuation,51,44,7,0.0004890736500455726,7.774840615767377e-05,0.8627450980392157
3727,3727,양반/Noun,51,8,43,8.892248182646779e-05,0.0004775973521114245,0.8431372549019608
3728,3728,파이팅/Noun,51,42,9,0.00046684302958895584,9.996223648843771e-05,0.8235294117647058
3729,3729,뚝뚝/Noun,51,9,42,0.00010003779205477625,0.00046649043694604257,0.8235294117647058
3730,3730,땡/Noun,51,9,42,0.00010003779205477625,0.00046649043694604257,0.8235294117647058
3731,3731,모두/Modifier,51,40,11,0.0004446124091323389,0.00012217606681920164,0.7843137254901961
3732,3732,잠자다/Verb,51,11,40,0.00012226841251139318,0.0004442766066152787,0.7843137254901961
3733,3733,덜덜/Noun,51,40,11,0.0004446124091323389,0.00012217606681920164,0.7843137254901961
3734,3734,먼지/Noun,51,12,39,0.00013338372273970166,0.0004331696914498967,0.7647058823529411
3735,3735,임청하/Noun,51,39,12,0.0004334970989040304,0.0001332829819845836,0.7647058823529411
3736,3736,다니엘/Noun,51,39,12,0.0004334970989040304,0.0001332829819845836,0.7647058823529411
3737,3737,불과하다/Adjective,51,14,37,0.0001556143431963186,0.0004109558611191328,0.7254901960784313
3738,3738,피식/Adverb,51,15,36,0.00016672965342462708,0.00039984894595375083,0.7058823529411765
3739,3739,텐데/Eomi,51,16,35,0.00017784496365293558,0.0003887420307883688,0.6862745098039216
3740,3740,마틴/Noun,51,35,16,0.0003890358579907965,0.00017771064264611146,0.6862745098039216
3741,3741,첩보/Noun,51,35,16,0.0003890358579907965,0.00017771064264611146,0.6862745098039216
3742,3742,취급/Noun,51,17,34,0.00018896027388124405,0.00037763511562298685,0.6666666666666666
3743,3743,허구/Noun,51,18,33,0.0002000755841095525,0.00036652820045760486,0.6470588235294118
3744,3744,vs/Alpha,51,18,33,0.0002000755841095525,0.00036652820045760486,0.6470588235294118
3745,3745,흔적/Noun,51,18,33,0.0002000755841095525,0.00036652820045760486,0.6470588235294118
3746,3746,7.5/Number,51,33,18,0.00036680523753417966,0.00019992447297687542,0.6470588235294118
3747,3747,리스/Noun,51,32,19,0.00035568992730587116,0.00021103138814225735,0.6274509803921569
3748,3748,이은주/Noun,51,32,19,0.00035568992730587116,0.00021103138814225735,0.6274509803921569
3749,3749,7년/Number,51,31,20,0.00034457461707756266,0.00022213830330763932,0.6078431372549019
3750,3750,생기/Noun,51,20,31,0.00022230620456616945,0.00034431437012684104,0.6078431372549019
3751,3751,와중/Noun,51,20,31,0.00022230620456616945,0.00034431437012684104,0.6078431372549019
3752,3752,장치/Noun,51,30,21,0.00033345930684925416,0.00023324521847302128,0.5882352941176471
3753,3753,밖엔/Josa,51,21,30,0.00023342151479447792,0.000333207454961459,0.5882352941176471
3754,3754,후기/Noun,51,21,30,0.00023342151479447792,0.000333207454961459,0.5882352941176471
3755,3755,체험/Noun,51,21,30,0.00023342151479447792,0.000333207454961459,0.5882352941176471
3756,3756,파악/Noun,51,21,30,0.00023342151479447792,0.000333207454961459,0.5882352941176471
3757,3757,간/Foreign,51,22,29,0.00024453682502278637,0.00032210053979607705,0.5686274509803921
3758,3758,특/Noun,51,29,22,0.0003223439966209457,0.00024435213363840333,0.5686274509803921
3759,3759,누/Noun,51,22,29,0.00024453682502278637,0.00032210053979607705,0.5686274509803921
3760,3760,장동건/Noun,51,22,29,0.00024453682502278637,0.00032210053979607705,0.5686274509803921
3761,3761,활동/Noun,51,22,29,0.00024453682502278637,0.00032210053979607705,0.5686274509803921
3762,3762,답지/Noun,51,24,27,0.0002667674454794033,0.0002998867094653131,0.5294117647058824
3763,3763,전투씬/Noun,51,25,26,0.0002778827557077118,0.00028877979429993113,0.5098039215686274
3764,3764,지인/Noun,51,26,25,0.00028899806593602026,0.0002776728791345492,0.5098039215686274
3765,3765,이/Modifier,51,26,25,0.00028899806593602026,0.0002776728791345492,0.5098039215686274
3766,3766,어중간하다/Adjective,50,2,48,2.2230620456616947e-05,0.0005331319279383344,0.96
3767,3767,어쩌라고/Adverb,50,3,47,3.334593068492541e-05,0.0005220250127729526,0.94
3768,3768,극혐/Noun,50,5,45,5.557655114154236e-05,0.0004998111824421885,0.9
3769,3769,전해지다/Verb,50,43,7,0.00047795833981726434,7.774840615767377e-05,0.86
3770,3770,재수없다/Adjective,50,8,42,8.892248182646779e-05,0.00046649043694604257,0.84
3771,3771,위원회/Noun,50,8,42,8.892248182646779e-05,0.00046649043694604257,0.84
3772,3772,어의/Noun,50,9,41,0.00010003779205477625,0.00045538352178066063,0.82
3773,3773,절묘하다/Adjective,50,39,11,0.0004334970989040304,0.00012217606681920164,0.78
3774,3774,먹히다/Verb,50,12,38,0.00013338372273970166,0.0004220627762845148,0.76
3775,3775,연주/Noun,50,38,12,0.000422381788675722,0.0001332829819845836,0.76
3776,3776,이연희/Noun,50,37,13,0.00041126647844741344,0.00014438989714996554,0.74
3777,3777,생존/Noun,50,36,14,0.000400151168219105,0.0001554968123153475,0.72
3778,3778,망설이다/Verb,50,36,14,0.000400151168219105,0.0001554968123153475,0.72
3779,3779,원피스/Noun,50,36,14,0.000400151168219105,0.0001554968123153475,0.72
3780,3780,역다/Adjective,50,14,36,0.0001556143431963186,0.00039984894595375083,0.72
3781,3781,여기저기/Noun,50,14,36,0.0001556143431963186,0.00039984894595375083,0.72
3782,3782,에드워드/Noun,50,35,15,0.0003890358579907965,0.0001666037274807295,0.7
3783,3783,고스/Noun,50,35,15,0.0003890358579907965,0.0001666037274807295,0.7
3784,3784,강력하다/Adjective,50,34,16,0.0003779205477624881,0.00017771064264611146,0.68
3785,3785,오우삼/Noun,50,17,33,0.00018896027388124405,0.00036652820045760486,0.66
3786,3786,안성기/Noun,50,33,17,0.00036680523753417966,0.00018881755781149343,0.66
3787,3787,까지/Foreign,50,17,33,0.00018896027388124405,0.00036652820045760486,0.66
3788,3788,전도연/Noun,50,33,17,0.00036680523753417966,0.00018881755781149343,0.66
3789,3789,엿보다/Verb,50,33,17,0.00036680523753417966,0.00018881755781149343,0.66
3790,3790,영광/Noun,50,33,17,0.00036680523753417966,0.00018881755781149343,0.66
3791,3791,바쁘다/Adjective,50,17,33,0.00018896027388124405,0.00036652820045760486,0.66
3792,3792,전화/Noun,50,17,33,0.00018896027388124405,0.00036652820045760486,0.66
3793,3793,닷/Noun,50,33,17,0.00036680523753417966,0.00018881755781149343,0.66
3794,3794,증명/Noun,50,18,32,0.0002000755841095525,0.00035542128529222287,0.64
3795,3795,구도/Noun,50,18,32,0.0002000755841095525,0.00035542128529222287,0.64
3796,3796,종합/Noun,50,18,32,0.0002000755841095525,0.00035542128529222287,0.64
3797,3797,검사/Noun,50,19,31,0.00021119089433786097,0.00034431437012684104,0.62
3798,3798,소지섭/Noun,50,31,19,0.00034457461707756266,0.00021103138814225735,0.62
3799,3799,추구/Noun,50,31,19,0.00034457461707756266,0.00021103138814225735,0.62
3800,3800,로버츠/Noun,50,30,20,0.00033345930684925416,0.00022213830330763932,0.6
3801,3801,카메론/Noun,50,30,20,0.00033345930684925416,0.00022213830330763932,0.6
3802,3802,장근석/Noun,50,20,30,0.00022230620456616945,0.000333207454961459,0.6
3803,3803,언론/Noun,50,30,20,0.00033345930684925416,0.00022213830330763932,0.6
3804,3804,구혜선/Noun,50,20,30,0.00022230620456616945,0.000333207454961459,0.6
3805,3805,나니/Noun,50,29,21,0.0003223439966209457,0.00023324521847302128,0.58
3806,3806,유의/Noun,50,29,21,0.0003223439966209457,0.00023324521847302128,0.58
3807,3807,역활/Noun,50,22,28,0.00024453682502278637,0.000310993624630695,0.56
3808,3808,죽지/Noun,50,28,22,0.0003112286863926372,0.00024435213363840333,0.56
3809,3809,심정/Noun,50,22,28,0.00024453682502278637,0.000310993624630695,0.56
3810,3810,멤버/Noun,50,28,22,0.0003112286863926372,0.00024435213363840333,0.56
3811,3811,댄스/Noun,50,22,28,0.00024453682502278637,0.000310993624630695,0.56
3812,3812,지적/Noun,50,28,22,0.0003112286863926372,0.00024435213363840333,0.56
3813,3813,출발/Noun,50,23,27,0.00025565213525109487,0.0002998867094653131,0.54
3814,3814,단역/Noun,50,24,26,0.0002667674454794033,0.00028877979429993113,0.52
3815,3815,스페인/Noun,50,26,24,0.00028899806593602026,0.0002665659639691672,0.52
3816,3816,서양/Noun,50,24,26,0.0002667674454794033,0.00028877979429993113,0.52
3817,3817,곰/Noun,50,26,24,0.00028899806593602026,0.0002665659639691672,0.52
3818,3818,자격/Noun,50,25,25,0.0002778827557077118,0.0002776728791345492,0.5
