,Unnamed: 0,parameter,counts,counts_H,counts_NH,p_from_H,p_from_NH,priority
0,15,없다/Adjective,16914,5001,11913,0.05558766645177067,0.13231668036519534,0.7043277758070238
1,18,있다/Adjective,13419,8187,5232,0.09100104483916148,0.05811138014527845,0.6101050748938073
2,19,좋다/Adjective,13043,9370,3673,0.10415045683925038,0.04079569940244796,0.7183930077436173
3,20,이/Determiner,12373,4495,7878,0.04996331947624658,0.08750027767287913,0.6367089630647378
4,22,재밌다/Adjective,11789,9955,1834,0.11065291332281084,0.02037008241331053,0.8444312494698448
5,23,?/Punctuation,11319,3302,8017,0.036702754373874574,0.08904413888086722,0.7082781164413817
6,24,정말/Noun,10702,7082,3620,0.0787186270368806,0.04020703289868272,0.6617454681367969
7,32,아니다/Adjective,8754,3210,5544,0.035680145832870186,0.06157673767687762,0.6333104866346813
8,34,!/Punctuation,8565,6415,2150,0.07130471511459885,0.023879867605571228,0.7489784004670169
9,38,만/Josa,7745,2412,5333,0.026810128270680036,0.05923317857698202,0.6885732730794061
10,40,만들다/Verb,7199,2506,4693,0.027854967432141036,0.05212475287113757,0.6518960966800944
11,43,과/Josa,6768,4231,2537,0.04702887757597315,0.02817824377457405,0.6251477541371159
12,44,최고/Noun,6671,6143,528,0.06828135073249894,0.005864451207321679,0.9208514465597362
13,46,이다/Verb,6524,4043,2481,0.04493919925305116,0.02755625652531266,0.6197118332311465
14,47,왜/Noun,6247,2241,4006,0.024909410221639287,0.04449430215252016,0.6412678085481031
15,48,스토리/Noun,6075,2176,3899,0.02418691505679924,0.043305862229824285,0.6418106995884774
16,50,생각/Noun,6005,3771,2234,0.04191583487095125,0.024812848479463315,0.6279766860949209
17,51,~/Punctuation,6003,4016,1987,0.04463908587688682,0.02206944043361397,0.6689988339163752
18,55,감동/Noun,5597,4442,1155,0.04937420803414623,0.012828487016016172,0.7936394497051992
19,57,1/Number,5284,1409,3875,0.015661472111686642,0.04303929626585512,0.7333459500378501
20,62,아깝다/Adjective,5167,374,4793,0.004157126025387369,0.053235444387675766,0.9276175730598026
21,66,때/Noun,4940,3220,1720,0.03579129893515328,0.019103894084456983,0.6518218623481782
22,69,재미있다/Adjective,4787,4102,685,0.04559500255652135,0.0076082368882866465,0.8569041153123041
23,72,감독/Noun,4688,1515,3173,0.016839694995887337,0.03524224181975698,0.6768344709897611
24,74,재미/Noun,4538,1752,2786,0.019474023519996442,0.030943865650754163,0.6139268400176289
25,75,내용/Noun,4529,1407,3122,0.01563924149123002,0.0346757891463225,0.6893353941267388
26,76,뭐/Noun,4491,831,3660,0.009236822799724341,0.040651309505298,0.8149632598530394
27,77,못/VerbPrefix,4418,1474,2944,0.016383967276526686,0.032698758246884514,0.666364870982345
28,78,그냥/Noun,4406,1187,3219,0.013193873241002156,0.03575315991736455,0.7305946436677259
29,83,안/VerbPrefix,4262,1318,2944,0.014649978880910566,0.032698758246884514,0.6907555138432661
30,84,재미없다/Adjective,4205,307,3898,0.003412400240090701,0.043294755314658914,0.9269916765755052
31,85,자다/Verb,4114,2658,1456,0.029544494586843918,0.016171668480796143,0.6460865337870686
32,86,좀/Noun,4111,1455,2656,0.016172776382188826,0.029499966679254506,0.6460715154463634
33,88,지루하다/Adjective,4057,872,3185,0.009692550519084988,0.03537552480174157,0.7850628543258565
34,91,!!/Punctuation,4005,3088,917,0.03432407798501656,0.010185041206655265,0.7710362047440699
35,92,시간/Noun,3956,1077,2879,0.011971189115888223,0.03197680876113468,0.7277553083923155
36,94,쓰레기/Noun,3739,209,3530,0.002323099837716471,0.03920741053379834,0.9441027012570206
37,96,수/Noun,3698,2475,1223,0.02751039281506347,0.013583757247262143,0.6692806922660898
38,101,아/Exclamation,3469,1327,2142,0.014750016672965344,0.02379101228424817,0.6174690112424329
39,104,작품/Noun,3308,2050,1258,0.02278638596803237,0.013972499278050514,0.6197097944377267
40,105,다시/Noun,3289,2763,526,0.030711602160816313,0.005842237376990914,0.8400729705077531
41,106,10/Number,3248,2158,1090,0.023986839472689682,0.012106537530266344,0.6644088669950738
42,107,마지막/Noun,3201,2151,1050,0.023909032301091523,0.011662260923651064,0.6719775070290535
43,109,사랑/Noun,3190,2523,667,0.028043927706022275,0.007408312415309772,0.7909090909090909
44,110,잘/VerbPrefix,3151,2150,1001,0.023897916990863216,0.011118022080547348,0.682323072040622
45,114,요/Josa,3013,1950,1063,0.021674854945201518,0.011806650820801031,0.6471954862263525
46,116,이다/Adjective,2942,2200,742,0.02445368250227864,0.00824133105271342,0.7477906186267845
47,117,나/Josa,2916,1029,1887,0.011437654224929416,0.02095874891707577,0.647119341563786
48,124,안되다/Adjective,2683,658,2025,0.007313874130226975,0.022491503209898484,0.7547521431233694
49,131,지금/Noun,2596,1843,753,0.020485516750772512,0.00836350711953262,0.7099383667180277
50,132,ㅠㅠ/KoreanParticle,2589,1842,747,0.0204744014405442,0.00829686562854033,0.7114716106604867
51,133,최악/Noun,2549,32,2517,0.00035568992730587116,0.02795610547126641,0.9874460572773636
52,136,걸/Noun,2493,777,1716,0.008636596047395683,0.019059466423795454,0.6883273164861613
53,137,3/Number,2481,918,1563,0.010203854789587177,0.017360108403492013,0.6299879081015719
54,140,별로/Noun,2438,320,2118,0.003556899273058711,0.02352444632027901,0.8687448728465955
55,141,끝/Noun,2438,862,1576,0.009581397416801902,0.01750449830064198,0.6464315012305168
56,142,돈/Noun,2433,279,2154,0.003101171553698064,0.02392429526623276,0.8853267570900123
57,148,역시/Noun,2323,1623,700,0.01804014850054465,0.007774840615767376,0.6986655187257856
58,149,넘다/Verb,2286,1520,766,0.016895271547028873,0.008507897016682586,0.6649168853893264
59,150,개/Noun,2277,671,1606,0.007458373163194984,0.01783770575560344,0.7053140096618358
60,151,명작/Noun,2259,1976,283,0.02196385301113754,0.0031432569918030968,0.8747233289065959
61,153,남다/Verb,2231,1452,779,0.0161394304515039,0.008652286913832552,0.6508292245629762
62,154,이런/Modifier,2201,819,1382,0.00910343907698464,0.01534975675855788,0.6278964107223989
63,157,^^/Punctuation,2162,1921,241,0.021352510948580573,0.002676766554857054,0.8885291396854764
64,158,라고/Josa,2147,777,1370,0.008636596047395683,0.015216473776573296,0.6380996739636703
65,159,괜찮다/Adjective,2129,1444,685,0.016050507969677434,0.0076082368882866465,0.6782527007984971
66,160,ㅡㅡ/KoreanParticle,2128,211,1917,0.002345330458173088,0.02129195637203723,0.9008458646616542
67,163,버리다/Verb,2073,660,1413,0.00733610475068359,0.01569407112868472,0.6816208393632417
68,164,느끼다/Verb,2066,1442,624,0.016028277349220816,0.006930715063198347,0.6979670861568248
69,167,!!!/Punctuation,2038,1392,646,0.01547251183780539,0.00717506719683675,0.6830225711481845
70,168,또/Noun,2013,1348,665,0.014983438187759818,0.007386098584979008,0.6696472925981123
71,170,해주다/Verb,1945,1324,621,0.014716670742280415,0.0068973943177022025,0.680719794344473
72,171,여자/Noun,1944,757,1187,0.008414289842829513,0.013183908301308394,0.61059670781893
73,172,난/Noun,1928,1196,732,0.01329391103305693,0.0081302619010596,0.6203319502074689
74,173,꼭/Noun,1920,1594,326,0.0177178045039237,0.003620854343914521,0.8302083333333333
75,177,아름답다/Adjective,1901,1659,242,0.01844029966876376,0.002687873470022436,0.8726985796948974
76,181,마음/Noun,1810,1497,313,0.016639619411777783,0.0034764644467645558,0.8270718232044199
77,182,인생/Noun,1810,1304,506,0.014494364537714247,0.0056200990736832756,0.7204419889502762
78,185,기억/Noun,1794,1237,557,0.01374963875241758,0.006186551747117756,0.6895206243032329
79,188,끄다/Verb,1754,541,1213,0.006013382833514882,0.013472688095608323,0.6915621436716077
80,189,아쉽다/Adjective,1746,1186,560,0.013182757930773848,0.006219872492613902,0.6792668957617412
81,191,ㅎㅎ/KoreanParticle,1744,1498,246,0.01665073472200609,0.002732301130683964,0.8589449541284404
82,194,못/Noun,1720,544,1176,0.00604672876419981,0.013061732234489191,0.6837209302325581
83,195,소재/Noun,1714,594,1120,0.0066024942756152324,0.012439744985227805,0.6534422403733956
84,196,이나/Josa,1704,527,1177,0.005857768490318565,0.013072839149654573,0.6907276995305164
85,197,어리다/Verb,1690,1270,420,0.014116443989951759,0.004664904369460426,0.7514792899408284
86,198,재다/Verb,1675,1417,258,0.015750394593513104,0.002865584112668547,0.8459701492537314
87,200,뻔하다/Adjective,1670,457,1213,0.005079696774336972,0.013472688095608323,0.7263473053892215
88,201,애/Noun,1670,576,1094,0.00640241869150568,0.012150965190927872,0.6550898203592814
89,202,수준/Noun,1658,273,1385,0.003034479692328213,0.015383077504054024,0.8353437876960192
90,203,맞다/Verb,1649,477,1172,0.005302002978903141,0.013017304573827665,0.7107337780473014
91,204,한번/Noun,1640,1136,504,0.012626992419358423,0.005597885243352511,0.6926829268292682
92,206,네/Josa,1608,469,1139,0.0052130804970766725,0.01265077637337006,0.7083333333333334
93,210,현실/Noun,1587,1041,546,0.01157103794766912,0.006064375680298554,0.6559546313799622
94,211,전개/Noun,1586,418,1168,0.004646199675432942,0.012972876913166138,0.7364438839848676
95,212,매력/Noun,1586,1153,433,0.012815952693239669,0.00480929426661039,0.7269861286254728
96,214,되어다/Verb,1577,1073,504,0.01192672787497499,0.005597885243352511,0.6804058338617628
97,215,가슴/Noun,1575,1376,199,0.015294666874152455,0.0022102761179110114,0.8736507936507937
98,216,낮다/Adjective,1560,1254,306,0.013938599026298824,0.003398716040606882,0.8038461538461539
99,217,말다/Verb,1559,338,1221,0.003756974857168264,0.01356154341693138,0.7831943553559975
100,219,~~/Punctuation,1556,1038,518,0.011537692016984194,0.00575338205566786,0.6670951156812339
101,220,야/Josa,1543,373,1170,0.00414601071515906,0.012995090743496902,0.7582631237848347
102,222,높다/Adjective,1536,327,1209,0.003634706444656871,0.013428260434946798,0.787109375
103,223,님/Suffix,1536,948,588,0.010537314096436429,0.006530866117244597,0.6171875
104,225,가장/Noun,1534,1006,528,0.011182002089678324,0.005864451207321679,0.6558018252933507
105,226,;;/Punctuation,1523,373,1150,0.00414601071515906,0.012772952440189262,0.7550886408404465
106,228,슬프다/Adjective,1504,1292,212,0.014360980814974547,0.002354666015060977,0.8590425531914894
107,229,??/Punctuation,1503,455,1048,0.005057466153880355,0.011640047093320302,0.697272122421823
108,231,멋지다/Adjective,1475,1271,204,0.014127559300180068,0.002265810693737921,0.8616949152542372
109,235,음악/Noun,1452,1077,375,0.011971189115888223,0.0041650931870182385,0.7417355371900827
110,237,성/Suffix,1445,496,949,0.0055131938732410025,0.010540462491947487,0.6567474048442906
111,239,유치하다/Adjective,1442,282,1160,0.003134517484382989,0.01288402159184308,0.8044382801664355
112,240,아이/Noun,1436,944,492,0.010492852855523198,0.005464602261367928,0.6573816155988857
113,241,죽다/Verb,1435,475,960,0.005279772358446525,0.010662638558766688,0.6689895470383276
114,244,솔직하다/Adjective,1420,500,920,0.005557655114154236,0.010218361952151409,0.647887323943662
115,247,무슨/Noun,1408,215,1193,0.002389791699086321,0.013250549792300687,0.8473011363636364
116,248,추천/Noun,1403,1037,366,0.011526576706755885,0.0040651309505298,0.7391304347826086
117,249,만/Noun,1401,947,454,0.010526198786208123,0.005042539485083413,0.6759457530335474
118,250,냐/Josa,1392,169,1223,0.001878487428584132,0.013583757247262143,0.8785919540229885
119,251,인지/Josa,1383,425,958,0.004724006847031101,0.010640424728435923,0.6926970354302241
120,252,쓰다/Verb,1383,430,953,0.004779583398172643,0.010584890152609014,0.6890817064352857
121,253,게/Noun,1380,485,895,0.005390925460729609,0.009940689073016859,0.6485507246376812
122,254,눈물/Noun,1378,1156,222,0.012849298623924595,0.002465735166714797,0.8388969521044993
123,255,인가/Josa,1378,446,932,0.004957428361825579,0.010351644934135993,0.6763425253991292
124,257,번/Noun,1370,945,425,0.010503968165751507,0.004720438945287336,0.6897810218978102
125,259,ㅠ/KoreanParticle,1361,899,462,0.009992663895249316,0.005131394806406469,0.6605437178545187
126,261,저/Determiner,1355,471,884,0.005235311117533291,0.009818513006197658,0.6523985239852399
127,262,우리/Noun,1346,996,350,0.011070848987395238,0.003887420307883689,0.7399702823179792
128,263,인간/Noun,1346,839,507,0.009325745281550809,0.005631205988848657,0.6233283803863299
129,264,네/Suffix,1337,913,424,0.010148278238445637,0.004709332030121954,0.6828721017202692
130,268,속/Noun,1307,819,488,0.00910343907698464,0.005420174600706399,0.6266258607498087
131,270,허다/Verb,1294,206,1088,0.0022897539070315448,0.01208432369993558,0.8408037094281299
132,272,원작/Noun,1275,429,846,0.0047684680879443355,0.009396450229913143,0.6635294117647059
133,273,짜증나다/Adjective,1251,81,1170,0.0009003401284929863,0.012995090743496902,0.9352517985611509
134,278,찍다/Verb,1231,259,972,0.0028788653491318944,0.010795921540751272,0.7896019496344435
135,282,기대하다/Adjective,1222,341,881,0.003790320787853189,0.009785192260701512,0.7209492635024549
136,284,여운/Noun,1210,1139,71,0.01266033835004335,0.0007885909767421196,0.9413223140495868
137,286,움/Noun,1204,432,772,0.00480181401862926,0.00857453850767488,0.6411960132890365
138,288,전혀/Noun,1199,338,861,0.003756974857168264,0.009563053957393873,0.7180984153461217
139,289,기대/Noun,1198,745,453,0.008280906120089812,0.005031432569918031,0.6218697829716193
140,291,모두/Noun,1194,810,384,0.009003401284929862,0.004265055423506675,0.6783919597989949
141,292,대박/Noun,1180,975,205,0.010837427472600759,0.002276917608903303,0.826271186440678
142,297,별/Noun,1164,304,860,0.003379054309405776,0.009551947042228491,0.7388316151202751
143,298,이쁘다/Adjective,1161,733,428,0.00814752239735011,0.004753759690783481,0.6313522825150732
144,300,굿/Noun,1156,1072,84,0.01191561256474668,0.0009329808738920851,0.9273356401384084
145,303,모습/Noun,1142,842,300,0.009359091212235734,0.00333207454961459,0.7373029772329247
146,304,별/Modifier,1142,316,826,0.003512438032145477,0.009174311926605505,0.7232924693520141
147,305,미치다/Adjective,1139,415,724,0.004612853744748016,0.008041406579736544,0.6356453028972783
148,309,치다/Verb,1122,345,777,0.0038347820287664225,0.008630073083501789,0.6925133689839572
149,310,실망/Noun,1118,115,1003,0.0012782606762554744,0.011140235910878113,0.8971377459749553
150,315,일본/Noun,1098,391,707,0.0043460862992686115,0.00785258902192505,0.6438979963570127
151,316,시키다/Verb,1097,384,713,0.004268279127670453,0.007919230512917342,0.649954421148587
152,317,보지/Noun,1094,324,770,0.0036013605139719454,0.008552324677344115,0.7038391224862889
153,318,진심/Noun,1094,415,679,0.004612853744748016,0.007541595397294354,0.6206581352833638
154,319,건지다/Verb,1093,195,898,0.002167485494520152,0.009974009818513006,0.8215919487648673
155,325,일/Modifier,1074,387,687,0.004301625058355379,0.007630450718617411,0.6396648044692738
156,326,제목/Noun,1073,405,668,0.004501700642464931,0.007419419330475155,0.6225535880708295
157,327,귀엽다/Adjective,1069,881,188,0.009792588311139765,0.0020881000510918103,0.8241347053320861
158,331,대단하다/Adjective,1057,751,306,0.008347597981459662,0.003398716040606882,0.7105014191106906
159,335,뿐/Noun,1051,311,740,0.0034568614810039353,0.008219117222382655,0.7040913415794482
160,338,ㅎ/KoreanParticle,1048,840,208,0.009336860591779116,0.0023102383543994486,0.8015267175572519
161,339,;/Punctuation,1045,287,758,0.0031900940355245318,0.008419041695359529,0.7253588516746412
162,340,표현/Noun,1042,681,361,0.007569526265478068,0.00400959637470289,0.6535508637236085
163,341,OO/Alpha,1033,220,813,0.002445368250227864,0.009029922029455541,0.7870280735721199
164,343,가족/Noun,1031,710,321,0.007891870262099015,0.0035653197680876117,0.6886517943743938
165,345,잔잔하다/Adjective,1023,897,126,0.0099704332747927,0.0013994713108381278,0.8768328445747801
166,347,요즘/Noun,1013,643,370,0.007147144476802349,0.004109558611191328,0.6347482724580454
167,349,점도/Noun,1011,91,920,0.001011493230776071,0.010218361952151409,0.9099901088031652
168,352,용/Noun,999,295,704,0.0032790165173509998,0.007819268276428905,0.7047047047047047
169,353,떨어지다/Verb,997,207,790,0.002300869217259854,0.008774462980651754,0.7923771313941825
170,354,ㅜㅜ/KoreanParticle,996,633,363,0.007035991374519263,0.0040318102050336535,0.6355421686746988
171,355,모든/Noun,986,630,356,0.0070026454438343365,0.003954061798875979,0.6389452332657201
172,356,4/Number,981,333,648,0.003701398306026721,0.0071972810271675155,0.6605504587155964
173,358,급/Noun,974,237,737,0.0026343285241091077,0.00818579647688651,0.7566735112936345
174,359,웃다/Verb,974,598,376,0.006646955516528465,0.004176200102183621,0.6139630390143738
175,362,특히/Adverb,966,665,301,0.007391681301825134,0.003343181464779972,0.6884057971014492
176,364,빠지다/Verb,964,602,362,0.0066914167574417,0.004020703289868272,0.6244813278008299
177,366,개인/Noun,957,633,324,0.007035991374519263,0.003598640513583757,0.6614420062695925
178,369,공포/Noun,951,319,632,0.0035457839628304025,0.007019570384521403,0.6645636172450052
179,370,짜다/Verb,947,361,586,0.004012626992419359,0.006508652286913832,0.6187961985216474
180,372,건/Noun,932,292,640,0.0032456705866660733,0.007108425705844459,0.6866952789699571
181,373,한테/Josa,931,317,614,0.003523553342373785,0.006819645911544527,0.6595059076262084
182,374,작가/Noun,929,209,720,0.002323099837716471,0.007996978919075016,0.77502691065662
183,376,나름/Noun,923,600,323,0.006669186136985084,0.003587533598418375,0.6500541711809318
184,379,욕/Noun,910,166,744,0.0018451414978992067,0.008263544883044184,0.8175824175824176
185,380,차라리/Noun,909,59,850,0.0006558033034701999,0.009440877890574672,0.935093509350935
186,381,이상하다/Adjective,909,232,677,0.0025787519729675657,0.007519381566963592,0.7447744774477447
187,382,노래/Noun,909,604,305,0.006713647377898317,0.0033876091254415,0.6644664466446645
188,383,깊다/Adjective,907,808,99,0.008981170664473246,0.0010995846013728146,0.8908489525909592
189,385,짱/Noun,905,842,63,0.009359091212235734,0.0006997356554190639,0.9303867403314916
190,386,중간/Noun,905,328,577,0.0036458217548851783,0.0064086900504253955,0.6375690607734806
191,387,울다/Verb,900,695,205,0.007725140608674388,0.002276917608903303,0.7722222222222223
192,388,알바/Noun,897,104,793,0.001155992263744081,0.0088077837261479,0.8840579710144928
193,390,0/Number,888,77,811,0.0008558788875797522,0.009007708199124777,0.9132882882882885
194,392,따뜻하다/Adjective,884,833,51,0.009259053420180956,0.0005664526734344802,0.9423076923076924
195,393,느껴지다/Verb,884,553,331,0.006146766556254586,0.003676388919741431,0.6255656108597285
196,394,삶/Noun,883,770,113,0.008558788875797524,0.0012550814136881624,0.8720271800679502
197,397,...../Punctuation,877,327,550,0.003634706444656871,0.006108803340960082,0.6271379703534777
198,398,제/Noun,874,553,321,0.006146766556254586,0.0035653197680876117,0.6327231121281465
199,399,오랜/Modifier,870,699,171,0.007769601849587622,0.0018992824932803163,0.8034482758620691
200,400,기/Noun,869,240,629,0.002667674454794033,0.006986249639025257,0.7238204833141542
201,401,예쁘다/Adjective,865,571,294,0.006346842140364138,0.0032654330586222983,0.6601156069364161
202,403,당시/Noun,862,550,312,0.00611342062556966,0.0034653575315991736,0.6380510440835266
203,404,빼다/Verb,861,250,611,0.002778827557077118,0.006786325166048382,0.7096399535423926
204,405,점수/Noun,857,271,586,0.003012249071871596,0.006508652286913832,0.6837806301050176
205,409,놈/Noun,846,250,596,0.002778827557077118,0.006619721438567652,0.7044917257683215
206,410,아직도/Adverb,841,631,210,0.0070137607540626465,0.002332452184730213,0.7502972651605232
207,411,어설프다/Adjective,834,79,755,0.0008781095080363692,0.008385720949863385,0.9052757793764988
208,412,막장/Noun,834,144,690,0.00160060467287642,0.007663771464113556,0.8273381294964028
209,416,훌륭하다/Adjective,825,663,162,0.007369450681368517,0.0017993202567918784,0.8036363636363636
210,417,세상/Noun,824,533,291,0.005924460351688416,0.0032321123131261523,0.6468446601941747
211,420,공포영화/Noun,809,293,516,0.0032567858968943824,0.005731168225337095,0.6378244746600742
212,422,도대체/Noun,805,101,704,0.0011226463330591557,0.007819268276428905,0.8745341614906832
213,424,힘들다/Adjective,799,310,489,0.0034457461707756267,0.005431281515871782,0.6120150187734669
214,426,생각나다/Verb,795,647,148,0.007191605717715582,0.001643823444476531,0.8138364779874214
215,427,류/Noun,790,141,649,0.0015672587421914947,0.007208387942332897,0.8215189873417722
216,431,절대/Noun,787,263,524,0.002923326590045128,0.005820023546660151,0.6658195679796697
217,433,뭘/Noun,782,175,607,0.0019451792899539827,0.006741897505386854,0.7762148337595908
218,434,잇다/Verb,780,524,256,0.005824422559633639,0.002843370282337784,0.6717948717948717
219,437,물/Noun,777,295,482,0.0032790165173509998,0.005353533109714108,0.6203346203346203
220,440,써다/Verb,768,243,525,0.002701020385478959,0.005831130461825532,0.68359375
221,441,수작/Noun,766,696,70,0.007736255918902695,0.0007774840615767378,0.908616187989556
222,443,걍/Adverb,765,208,557,0.002311984527488162,0.006186551747117756,0.7281045751633987
223,444,설정/Noun,762,139,623,0.0015450281217348775,0.006919608148032965,0.8175853018372703
224,445,초반/Noun,761,265,496,0.002945557210501745,0.005509029922029457,0.6517739816031537
225,448,놓다/Verb,755,225,530,0.0025009448013694068,0.005886665037652442,0.7019867549668874
226,449,필요없다/Adjective,754,630,124,0.0070026454438343365,0.0013772574805073642,0.8355437665782494
227,451,신선하다/Adjective,748,507,241,0.0056354622857523965,0.002676766554857054,0.6778074866310161
228,452,싫다/Adjective,746,130,616,0.001444990329680101,0.006841859741875293,0.8257372654155496
229,453,시나리오/Noun,742,207,535,0.002300869217259854,0.005942199613479352,0.7210242587601078
230,454,딱/Adverb,742,251,491,0.0027899428673054264,0.005453495346202546,0.6617250673854448
231,458,출연/Noun,740,226,514,0.0025120601115977146,0.005708954395006331,0.6945945945945946
232,461,멋있다/Adjective,732,615,117,0.006835915790409711,0.0012995090743496902,0.8401639344262295
233,462,관객/Noun,732,188,544,0.0020896783229219927,0.00604216184996779,0.7431693989071039
234,465,가지/Noun,725,278,447,0.003090056243469755,0.004964791078925739,0.616551724137931
235,466,노잼/Noun,724,17,707,0.00018896027388124405,0.00785258902192505,0.9765193370165746
236,468,뭔/Modifier,722,104,618,0.001155992263744081,0.006864073572206054,0.8559556786703602
237,469,분위기/Noun,721,443,278,0.004924082431140653,0.0030877224159761873,0.6144244105409153
238,470,답답하다/Adjective,719,131,588,0.0014561056399084098,0.006530866117244597,0.8178025034770514
239,471,아프다/Adjective,719,559,160,0.006213458417624436,0.0017771064264611148,0.7774687065368567
240,472,시대/Noun,719,474,245,0.0052686570482182145,0.002721194215518582,0.6592489568845619
241,474,장난/Noun,714,182,532,0.002022986461552142,0.005908878867983206,0.7450980392156863
242,475,죽이다/Verb,713,198,515,0.002200831425205077,0.005720061310171713,0.7223001402524544
243,477,최고다/Noun,711,679,32,0.007547295645021453,0.00035542128529222287,0.9549929676511956
244,478,스럽다/Adjective,711,238,473,0.0026454438343374164,0.005253570873225671,0.6652601969057665
245,480,OOO/Alpha,708,91,617,0.001011493230776071,0.006852966657040674,0.8714689265536724
246,481,결국/Adverb,708,253,455,0.0028121734877620433,0.005053646400248795,0.6426553672316384
247,482,지루함/Noun,707,100,607,0.0011115310228308473,0.006741897505386854,0.8585572842998586
248,483,추억/Noun,707,576,131,0.00640241869150568,0.0014550058866650375,0.8147100424328148
249,484,나쁘다/Adjective,707,269,438,0.002990018451414979,0.004864828842437301,0.6195190947666195
250,486,소리/Noun,705,202,503,0.0022452926661183114,0.005586778328187129,0.7134751773049646
251,489,이딴/Modifier,703,26,677,0.00028899806593602026,0.007519381566963592,0.9630156472261736
252,490,더럽다/Adjective,701,81,620,0.0009003401284929863,0.00688628740253682,0.8844507845934381
253,493,마다/Josa,694,480,214,0.005335348909588066,0.002376879845391741,0.69164265129683
254,495,인상/Noun,689,547,142,0.006080074694884734,0.0015771819534842392,0.7939042089985486
255,496,이지만/Josa,687,427,260,0.004746237467487717,0.002887797942999312,0.6215429403202329
256,497,어이없다/Adjective,686,55,631,0.000611342062556966,0.007008463469356021,0.9198250728862972
257,498,오늘/Noun,685,462,223,0.005135273325478514,0.002476842081880179,0.6744525547445256
258,499,감정/Noun,684,445,239,0.004946313051597271,0.0026545527245262907,0.6505847953216374
259,501,부족하다/Adjective,681,215,466,0.002389791699086321,0.005175822467067996,0.6842878120411159
260,503,전/Modifier,680,199,481,0.002211946735433386,0.005342426194548726,0.7073529411764706
261,504,정신/Noun,678,183,495,0.0020341017717804503,0.0054979230068640745,0.7300884955752213
262,505,엔딩/Noun,678,431,247,0.004790698708400951,0.0027434080458493453,0.6356932153392331
263,507,접/Noun,676,122,554,0.0013560678478536335,0.006153231001621609,0.8195266272189349
264,509,잊다/Verb,674,570,104,0.006335726830135829,0.0011551191771997243,0.8456973293768546
265,510,졸작/Noun,672,34,638,0.0003779205477624881,0.007086211875513696,0.949404761904762
266,511,제발/Noun,671,179,492,0.0019896405308672165,0.005464602261367928,0.7332339791356185
267,512,자신/Noun,671,422,249,0.004690660916346175,0.002765621876180109,0.6289120715350224
268,514,아무리/Adverb,666,114,552,0.0012671453660271655,0.006131017171290846,0.8288288288288288
269,515,그저/Adverb,666,221,445,0.0024564835604561725,0.004942577248594975,0.6681681681681682
270,517,♥/Foreign,660,651,9,0.007236066958628815,9.996223648843771e-05,0.9863636363636364
271,519,킬링타임/Noun,659,186,473,0.0020674477024653763,0.005253570873225671,0.7177541729893778
272,521,함께/Adverb,656,544,112,0.00604672876419981,0.0012439744985227805,0.8292682926829268
273,522,그렇게/Adverb,656,251,405,0.0027899428673054264,0.004498300641979696,0.6173780487804879
274,525,캐스팅/Noun,653,219,434,0.0024342529399995552,0.004820401181775774,0.664624808575804
275,527,대해/Noun,651,506,145,0.0056243469755240865,0.001610502698980385,0.7772657450076805
276,529,어색하다/Adjective,642,123,519,0.001367183158081942,0.005764488970833241,0.8084112149532711
277,530,포스터/Noun,642,205,437,0.002278638596803237,0.00485372192727192,0.6806853582554517
278,531,적다/Verb,641,432,209,0.00480181401862926,0.002321345269564831,0.6739469578783152
279,532,몰입도/Noun,638,412,226,0.0045795078140630895,0.002510162827376325,0.64576802507837
280,534,엉/Exclamation,636,103,533,0.0011448769535157724,0.005919985783148589,0.8380503144654088
281,535,쓸다/Verb,636,162,474,0.0018006802569859727,0.0052646777883910536,0.7452830188679245
282,536,자/Suffix,632,213,419,0.0023675610786297045,0.004653797454295044,0.6629746835443038
283,537,갈수록/Noun,631,192,439,0.0021341395638352265,0.0048759357576026825,0.6957210776545166
284,539,개연/Noun,630,55,575,0.000611342062556966,0.006386476220094631,0.9126984126984128
285,540,망하다/Adjective,630,89,541,0.000989262610319454,0.006008841104471644,0.8587301587301587
286,541,애니메이션/Noun,630,418,212,0.004646199675432942,0.002354666015060977,0.6634920634920635
287,546,!!!!/Punctuation,622,460,162,0.005113042705021898,0.0017993202567918784,0.7395498392282959
288,549,문제/Noun,619,201,418,0.0022341773558900027,0.004642690539129663,0.6752827140549273
289,550,진부하다/Adjective,618,109,509,0.0012115688148856235,0.005653419819179421,0.8236245954692557
290,552,이름/Noun,617,239,378,0.002656559144565725,0.004198413932514383,0.6126418152350082
291,554,하/Exclamation,614,213,401,0.0023675610786297045,0.0044538729813181676,0.6530944625407166
292,555,ㅠㅠㅠ/KoreanParticle,611,496,115,0.0055131938732410025,0.0012772952440189265,0.8117839607201309
293,557,나가다/Verb,610,191,419,0.0021230242536069183,0.004653797454295044,0.6868852459016394
294,558,충격/Noun,610,399,211,0.00443500878109508,0.002343559099895595,0.6540983606557377
295,560,맘/Noun,609,373,236,0.00414601071515906,0.002621231979030144,0.6124794745484401
296,562,유쾌하다/Adjective,603,554,49,0.006157881866482894,0.0005442388431037163,0.9187396351575456
297,563,머리/Noun,603,235,368,0.002612097903652491,0.004087344780860563,0.6102819237147595
298,566,완벽하다/Adjective,599,512,87,0.0056910388368939385,0.0009663016193882313,0.8547579298831386
299,567,질/Noun,599,104,495,0.001155992263744081,0.0054979230068640745,0.8263772954924875
300,574,놀라다/Verb,594,366,228,0.0040682035435609006,0.0025323766577070887,0.6161616161616161
301,575,적/Noun,593,406,187,0.004512815952693239,0.002076993135926428,0.684654300168634
302,578,강추/Noun,590,547,43,0.006080074694884734,0.0004775973521114245,0.9271186440677966
303,579,행복하다/Adjective,590,524,66,0.005824422559633639,0.0007330564009152097,0.8881355932203391
304,580,얘기/Noun,590,217,373,0.0024120223195429388,0.0041428793566874724,0.6322033898305085
305,581,대/Foreign,587,217,370,0.0024120223195429388,0.004109558611191328,0.6303236797274276
306,583,장르/Noun,583,201,382,0.0022341773558900027,0.004242841593175911,0.6552315608919382
307,585,더빙/Noun,582,150,432,0.0016672965342462707,0.00479818735144501,0.7422680412371134
308,589,주연/Noun,577,225,352,0.0025009448013694068,0.003909634138214452,0.6100519930675911
309,590,얼굴/Noun,576,199,377,0.002211946735433386,0.004187307017349001,0.6545138888888888
310,593,즐겁다/Adjective,573,495,78,0.0055020785630126925,0.0008663393828997934,0.8638743455497382
311,597,머/Noun,570,97,473,0.0010781850921459217,0.005253570873225671,0.8298245614035088
312,601,꽤/Noun,562,441,121,0.004901851810684036,0.001343936735011218,0.7846975088967971
313,603,짜증/Noun,558,23,535,0.00025565213525109487,0.005942199613479352,0.9587813620071683
314,604,9/Number,557,382,175,0.0042460485072138366,0.0019437101539418445,0.6858168761220825
315,605,매우/Noun,557,343,214,0.003812551408309806,0.002376879845391741,0.6157989228007181
316,606,ㅡ/KoreanParticle,556,157,399,0.00174510370584443,0.004431659150987405,0.7176258992805755
317,608,ㅎㅎㅎ/KoreanParticle,555,434,121,0.0048240446390858775,0.001343936735011218,0.781981981981982
318,610,너무나/Adverb,552,365,187,0.004057088233332592,0.002076993135926428,0.6612318840579711
319,611,이리/Adverb,552,199,353,0.002211946735433386,0.0039207410533798346,0.6394927536231884
320,614,???/Punctuation,551,142,409,0.0015783740524198029,0.004542728302641225,0.7422867513611615
321,615,두/Noun,551,362,189,0.004023742302647667,0.002099206966257192,0.6569872958257713
322,617,새롭다/Adjective,549,377,172,0.004190471956072294,0.0019103894084456985,0.6867030965391621
323,619,건가/Noun,546,124,422,0.0013782984683102506,0.00468711819979119,0.7728937728937729
324,620,아직/Adverb,546,363,183,0.004034857612875975,0.0020325654752649,0.6648351648351648
325,621,생기다/Verb,545,190,355,0.002111908943378609,0.003942954883710598,0.6513761467889908
326,624,멀다/Adjective,544,178,366,0.001978525220638908,0.0040651309505298,0.6727941176470589
327,625,작/Modifier,544,183,361,0.0020341017717804503,0.00400959637470289,0.6636029411764706
328,626,소름/Noun,540,437,103,0.004857390569770802,0.0011440122620343426,0.8092592592592592
329,627,심하다/Adjective,539,81,458,0.0009003401284929863,0.005086967145744941,0.8497217068645642
330,628,충분하다/Adjective,539,414,125,0.004601738434519708,0.001388364395672746,0.7680890538033395
331,629,불쌍하다/Adjective,539,206,333,0.0022897539070315448,0.0036986027500721954,0.6178107606679035
332,630,글/Noun,538,195,343,0.002167485494520152,0.0038096719017260148,0.6375464684014871
333,632,걸작/Noun,533,459,74,0.005101927394793589,0.0008219117222382655,0.8611632270168855
334,633,그나마/Adverb,532,40,492,0.0004446124091323389,0.005464602261367928,0.924812030075188
335,634,억지/Noun,527,72,455,0.00080030233643821,0.005053646400248795,0.8633776091081594
336,635,대체/Noun,527,89,438,0.000989262610319454,0.004864828842437301,0.8311195445920304
337,638,시절/Noun,526,397,129,0.004412778160638464,0.0014327920563342734,0.7547528517110266
338,640,존나/Noun,525,122,403,0.0013560678478536335,0.004476086811648933,0.7676190476190476
339,641,약간/Noun,525,357,168,0.003968165751506125,0.0018659617477841703,0.68
340,643,궁금하다/Adjective,524,199,325,0.002211946735433386,0.003609747428749139,0.6202290076335878
341,646,실화/Noun,522,331,191,0.003679167685570104,0.0021214207965879555,0.6340996168582376
342,650,해도/Noun,520,170,350,0.0018896027388124407,0.003887420307883689,0.6730769230769231
343,651,아무/Modifier,518,169,349,0.001878487428584132,0.0038763133927183055,0.6737451737451737
344,654,B/Alpha,514,133,381,0.0014783362603650269,0.00423173467801053,0.7412451361867705
345,655,한마디/Noun,514,156,358,0.0017339883956161216,0.003976275629206745,0.6964980544747081
346,659,순수하다/Adjective,506,433,73,0.0048129293288575676,0.0008108048070728836,0.8557312252964426
347,660,휴/Exclamation,506,86,420,0.0009559166796345287,0.004664904369460426,0.8300395256916996
348,661,자기/Noun,506,160,346,0.0017784496365293556,0.0038429926472221604,0.6837944664031621
349,662,누가/Noun,504,180,324,0.002000755841095525,0.003598640513583757,0.6428571428571429
350,670,만점/Noun,501,423,78,0.004701776226574484,0.0008663393828997934,0.844311377245509
351,671,초딩/Noun,501,192,309,0.0021341395638352265,0.003432036786103028,0.6167664670658682
352,675,간만/Noun,496,400,96,0.004446124091323389,0.0010662638558766688,0.8064516129032258
353,679,필요하다/Adjective,494,325,169,0.003612475824200253,0.0018770686629495524,0.6578947368421053
354,683,라도/Josa,488,145,343,0.0016117199831047284,0.0038096719017260148,0.7028688524590164
355,684,~!/Punctuation,487,385,102,0.004279394437898762,0.0011329053468689607,0.7905544147843943
356,685,CG/Alpha,487,126,361,0.0014005290887668675,0.00400959637470289,0.7412731006160165
357,686,굉장하다/Adjective,486,338,148,0.003756974857168264,0.001643823444476531,0.6954732510288066
358,687,전체/Noun,486,158,328,0.0017562190160727387,0.003643068174245285,0.6748971193415638
359,690,뿐/Suffix,482,150,332,0.0016672965342462707,0.0036874958349068132,0.6887966804979253
360,691,감성/Noun,482,311,171,0.0034568614810039353,0.0018992824932803163,0.6452282157676349
361,692,다음/Noun,482,299,183,0.0033234777582642327,0.0020325654752649,0.6203319502074689
362,693,사회/Noun,481,337,144,0.0037458595469399545,0.0015993957838150033,0.7006237006237006
363,694,오/Modifier,481,187,294,0.0020785630126936845,0.0032654330586222983,0.6112266112266113
364,695,네이버/Noun,480,179,301,0.0019896405308672165,0.003343181464779972,0.6270833333333333
365,697,발연기/Noun,477,34,443,0.0003779205477624881,0.004920363418264211,0.9287211740041929
366,698,무슨/Modifier,476,124,352,0.0013782984683102506,0.003909634138214452,0.7394957983193278
367,701,당하다/Adjective,473,184,289,0.002045217082008759,0.003209898482795389,0.6109936575052854
368,704,따르다/Verb,470,174,296,0.0019340639797256738,0.003287646888953062,0.6297872340425532
369,707,ㅉㅉ/KoreanParticle,466,72,394,0.00080030233643821,0.004376124575160495,0.8454935622317596
370,708,이르다/Verb,466,177,289,0.0019674099104106,0.003209898482795389,0.6201716738197425
371,710,꿈/Noun,465,353,112,0.003923704510592891,0.0012439744985227805,0.7591397849462366
372,711,돌리다/Verb,463,161,302,0.001789564946757664,0.003354288379945354,0.652267818574514
373,714,에요/Josa,461,357,104,0.003968165751506125,0.0011551191771997243,0.7744034707158352
374,715,나이/Noun,460,314,146,0.00349020741168886,0.0016216096141457672,0.6826086956521739
375,718,이/Foreign,458,326,132,0.003623591134428562,0.0014661128018304194,0.7117903930131004
376,722,;;;/Punctuation,457,106,351,0.001178222884200698,0.0038985272230490703,0.7680525164113785
377,723,사랑스럽다/Adjective,456,433,23,0.0048129293288575676,0.0002554590488037852,0.949561403508772
378,724,돋다/Verb,454,348,106,0.0038681279594513476,0.0011773330075304884,0.7665198237885462
379,726,엄청나다/Adjective,453,290,163,0.003223439966209457,0.001810427171957261,0.6401766004415012
380,728,소설/Noun,449,173,276,0.0019229486694973656,0.003065508585645423,0.6146993318485523
381,730,이라도/Josa,446,106,340,0.001178222884200698,0.0037763511562298687,0.7623318385650224
382,732,감사하다/Verb,445,404,41,0.004490585332236623,0.00045538352178066063,0.907865168539326
383,733,바라다/Verb,444,271,173,0.003012249071871596,0.0019214963236110802,0.6103603603603603
384,736,시즌/Noun,442,315,127,0.003501322721917169,0.0014105782260035095,0.7126696832579186
385,741,방송/Noun,436,131,305,0.0014561056399084098,0.0033876091254415,0.6995412844036697
386,742,지나다/Verb,435,309,126,0.003434630860547318,0.0013994713108381278,0.7103448275862069
387,746,삼류/Noun,433,33,400,0.00036680523753417966,0.004442766066152787,0.9237875288683602
388,747,몇번/Noun,431,334,97,0.00371251361625503,0.0010773707710420508,0.7749419953596288
389,748,진정하다/Adjective,431,313,118,0.003479092101460552,0.001310615989515072,0.7262180974477959
390,751,독특하다/Adjective,429,293,136,0.0032567858968943824,0.0015105404624919474,0.6829836829836831
391,752,잡다/Verb,429,149,280,0.0016561812240179624,0.003109936246306951,0.6526806526806527
392,753,죽/Noun,428,138,290,0.0015339128115065689,0.00322100539796077,0.677570093457944
393,754,....../Punctuation,427,155,272,0.0017228730853878133,0.003021080924983895,0.6370023419203747
394,758,여주/Noun,424,130,294,0.001444990329680101,0.0032654330586222983,0.6933962264150944
395,759,담다/Verb,424,278,146,0.003090056243469755,0.0016216096141457672,0.6556603773584906
396,760,가볍다/Adjective,423,287,136,0.0031900940355245318,0.0015105404624919474,0.6784869976359338
397,762,질질/Noun,419,72,347,0.00080030233643821,0.003854099562387543,0.8281622911694511
398,763,전부/Noun,418,133,285,0.0014783362603650269,0.003165470822133861,0.6818181818181818
399,765,줄거리/Noun,417,136,281,0.0015116821910499524,0.0031210431614723325,0.6738609112709832
400,770,점주/Noun,415,98,317,0.0010893004023742304,0.0035208921074260835,0.763855421686747
401,773,망치다/Verb,414,42,372,0.00046684302958895584,0.004131772441522092,0.8985507246376812
402,774,답/Noun,413,100,313,0.0011115310228308473,0.0034764644467645558,0.7578692493946732
403,775,넘치다/Adjective,412,298,114,0.003312362448035925,0.001266188328853544,0.7233009708737864
404,777,성하다/Adjective,410,37,373,0.00041126647844741344,0.0041428793566874724,0.9097560975609756
405,779,낭비/Noun,408,8,400,8.892248182646779e-05,0.004442766066152787,0.9803921568627452
406,780,뜨다/Verb,408,147,261,0.0016339506035613453,0.002898904858164693,0.6397058823529411
407,783,각본/Noun,407,121,286,0.001344952537625325,0.0031765777372992424,0.7027027027027027
408,785,맞추다/Verb,404,109,295,0.0012115688148856235,0.00327653997378768,0.7301980198019802
409,786,재/Noun,401,255,146,0.002834404108218661,0.0016216096141457672,0.6359102244389028
410,791,순간/Noun,397,263,134,0.002923326590045128,0.0014883266321611835,0.6624685138539043
411,792,어른/Noun,397,249,148,0.002767712246848809,0.001643823444476531,0.6272040302267002
412,794,갑자기/Noun,396,103,293,0.0011448769535157724,0.003254326143456916,0.73989898989899
413,795,제작/Noun,396,143,253,0.0015894893626481115,0.0028100495368416373,0.6388888888888888
414,797,이하/Noun,395,34,361,0.0003779205477624881,0.00400959637470289,0.9139240506329114
415,800,기다리다/Verb,392,279,113,0.003101171553698064,0.0012550814136881624,0.7117346938775511
416,801,간다/Noun,392,151,241,0.0016784118444745793,0.002676766554857054,0.6147959183673469
417,802,너무하다/Adjective,390,50,340,0.0005557655114154236,0.0037763511562298687,0.8717948717948718
418,803,의도/Noun,390,66,324,0.0007336104750683593,0.003598640513583757,0.8307692307692308
419,804,발/Noun,390,81,309,0.0009003401284929863,0.003432036786103028,0.7923076923076923
420,805,영/Noun,390,107,283,0.0011893381944290064,0.0031432569918030968,0.7256410256410256
421,807,밑/Noun,388,119,269,0.0013227219171687082,0.0029877601794877488,0.6932989690721649
422,809,땜/Noun,387,126,261,0.0014005290887668675,0.002898904858164693,0.6744186046511628
423,810,넣다/Verb,385,86,299,0.0009559166796345287,0.0033209676344492078,0.7766233766233767
424,811,아버지/Noun,385,261,124,0.0029010959695885113,0.0013772574805073642,0.6779220779220779
425,815,오글거리다/Verb,384,63,321,0.0007002645443834338,0.0035653197680876117,0.8359375
426,816,보내다/Verb,384,257,127,0.002856634728675277,0.0014105782260035095,0.6692708333333334
427,817,만들어지다/Verb,384,249,135,0.002767712246848809,0.0014994335473265655,0.6484375
428,821,굳다/Adjective,381,349,32,0.003879243269679657,0.00035542128529222287,0.9160104986876642
429,824,볼때/Noun,380,276,104,0.0030678256230131378,0.0011551191771997243,0.7263157894736842
430,825,바꾸다/Verb,379,143,236,0.0015894893626481115,0.002621231979030144,0.6226912928759895
431,830,10년/Number,376,276,100,0.0030678256230131378,0.0011106915165381968,0.7340425531914894
432,834,첨/Adverb,374,111,263,0.0012337994353422404,0.002921118688495457,0.7032085561497327
433,835,막/Noun,373,133,240,0.0014783362603650269,0.002665659639691672,0.6434316353887399
434,839,그때/Noun,371,269,102,0.002990018451414979,0.0011329053468689607,0.7250673854447439
435,840,항상/Noun,371,247,124,0.002745481626392193,0.0013772574805073642,0.6657681940700808
436,842,좀비/Noun,370,127,243,0.001411644398995176,0.002698980385187818,0.6567567567567567
437,844,치고/Josa,368,112,256,0.0012449147455705488,0.002843370282337784,0.6956521739130435
438,846,뻔/Noun,367,98,269,0.0010893004023742304,0.0029877601794877488,0.7329700272479565
439,849,거지/Noun,366,99,267,0.0011004157126025386,0.0029655463491569853,0.7295081967213115
440,850,곳/Noun,365,245,120,0.002723251005935576,0.001332829819845836,0.6712328767123288
441,855,짱/Suffix,361,320,41,0.003556899273058711,0.00045538352178066063,0.8864265927977839
442,856,성/Modifier,361,130,231,0.001444990329680101,0.0025656974032032343,0.6398891966759003
443,857,진행/Noun,360,97,263,0.0010781850921459217,0.002921118688495457,0.7305555555555555
444,862,이에요/Josa,358,286,72,0.003178978725296223,0.0007996978919075017,0.7988826815642458
445,863,더욱/Noun,358,281,77,0.0031234021741546806,0.0008552324677344116,0.7849162011173184
446,864,tv/Alpha,358,103,255,0.0011448769535157724,0.0028322633671724017,0.7122905027932961
447,865,낫다/Noun,358,124,234,0.0013782984683102506,0.0025990181486993803,0.6536312849162011
448,866,탄탄하다/Adjective,357,320,37,0.003556899273058711,0.0004109558611191328,0.8963585434173671
449,867,돋보이다/Verb,357,275,82,0.00305671031278483,0.0009107670435613213,0.7703081232492998
450,870,어이/Noun,355,29,326,0.0003223439966209457,0.003620854343914521,0.9183098591549296
451,871,상미/Noun,355,237,118,0.0026343285241091077,0.001310615989515072,0.6676056338028169
452,872,래/Josa,355,138,217,0.0015339128115065689,0.002410200590887887,0.6112676056338028
453,874,참고/Noun,354,65,289,0.0007224951648400508,0.003209898482795389,0.8163841807909604
454,875,불편하다/Adjective,354,99,255,0.0011004157126025386,0.0028322633671724017,0.7203389830508474
455,876,중국/Noun,354,122,232,0.0013560678478536335,0.0025768043183686164,0.655367231638418
456,879,몇/Noun,353,222,131,0.0024675988706844808,0.0014550058866650375,0.6288951841359773
457,880,흐르다/Verb,352,282,70,0.003134517484382989,0.0007774840615767378,0.8011363636363636
458,881,그녀/Noun,352,266,86,0.0029566725207300537,0.0009551947042228492,0.7556818181818182
459,882,억지스럽다/Adjective,351,50,301,0.0005557655114154236,0.003343181464779972,0.8575498575498576
460,883,걸리다/Verb,351,96,255,0.0010670697819176133,0.0028322633671724017,0.7264957264957265
461,884,끼다/Verb,351,101,250,0.0011226463330591557,0.002776728791345492,0.7122507122507122
462,886,즐기다/Verb,350,239,111,0.002656559144565725,0.0012328675833573985,0.6828571428571428
463,890,거기/Noun,348,120,228,0.0013338372273970164,0.0025323766577070887,0.6551724137931034
464,894,이냐/Josa,345,47,298,0.0005224195807304982,0.003309860719283826,0.8637681159420291
465,896,허무하다/Adjective,344,85,259,0.0009448013694062199,0.002876691027833929,0.7529069767441859
466,897,어디서/Adverb,343,123,220,0.001367183158081942,0.0024435213363840328,0.641399416909621
467,899,술/Noun,342,58,284,0.0006446879932418914,0.0031543639069684785,0.8304093567251462
468,900,전형/Noun,342,64,278,0.0007113798546117423,0.0030877224159761873,0.8128654970760234
469,901,똑같다/Adjective,341,86,255,0.0009559166796345287,0.0028322633671724017,0.7478005865102639
470,902,편집/Noun,340,103,237,0.0011448769535157724,0.0026323388941955268,0.6970588235294117
471,904,잠/Noun,339,82,257,0.0009114554387212947,0.0028544771975031647,0.7581120943952803
472,906,사건/Noun,337,130,207,0.001444990329680101,0.0022991314392340674,0.6142433234421365
473,908,화보/Noun,335,124,211,0.0013782984683102506,0.002343559099895595,0.6298507462686567
474,910,화이팅/Noun,334,296,38,0.003290131827579308,0.0004220627762845148,0.8862275449101796
475,911,때리다/Verb,334,116,218,0.0012893759864837828,0.0024213075060532693,0.6526946107784432
476,912,짧다/Adjective,334,217,117,0.0024120223195429388,0.0012995090743496902,0.6497005988023952
477,915,식상하다/Adjective,333,37,296,0.00041126647844741344,0.003287646888953062,0.8888888888888888
478,916,마르다/Adjective,333,116,217,0.0012893759864837828,0.002410200590887887,0.6516516516516516
479,921,꿀잼/Noun,330,316,14,0.003512438032145477,0.0001554968123153475,0.9575757575757576
480,922,똥/Noun,330,29,301,0.0003223439966209457,0.003343181464779972,0.912121212121212
481,923,그게/Noun,330,91,239,0.001011493230776071,0.0026545527245262907,0.7242424242424242
482,928,중반/Noun,328,125,203,0.001389413778538559,0.002254703778572539,0.6189024390243902
483,929,취향/Noun,328,127,201,0.001411644398995176,0.0022324899482417753,0.6128048780487805
484,931,-_-/Punctuation,327,38,289,0.000422381788675722,0.003209898482795389,0.8837920489296636
485,932,개그/Noun,327,99,228,0.0011004157126025386,0.0025323766577070887,0.6972477064220184
486,933,싸우다/Verb,327,124,203,0.0013782984683102506,0.002254703778572539,0.6207951070336392
487,938,엉망/Noun,326,22,304,0.00024453682502278637,0.003376502210276118,0.9325153374233128
488,939,병맛/Noun,326,57,269,0.0006335726830135829,0.0029877601794877488,0.8251533742331288
489,940,티/Noun,325,91,234,0.001011493230776071,0.0025990181486993803,0.72
490,941,적당하다/Adjective,325,106,219,0.001178222884200698,0.0024324144212186506,0.6738461538461539
491,944,뛰어나다/Adjective,324,238,86,0.0026454438343374164,0.0009551947042228492,0.7345679012345679
492,945,관/Noun,324,221,103,0.0024564835604561725,0.0011440122620343426,0.6820987654320988
493,946,걸다/Verb,324,116,208,0.0012893759864837828,0.0023102383543994486,0.6419753086419753
494,947,ㄷㄷ/KoreanParticle,324,200,124,0.0022230620456616945,0.0013772574805073642,0.6172839506172839
495,951,지겹다/Adjective,323,29,294,0.0003223439966209457,0.0032654330586222983,0.9102167182662538
496,952,미화/Noun,323,44,279,0.0004890736500455726,0.003098829331141569,0.8637770897832817
497,953,~!!/Punctuation,323,253,70,0.0028121734877620433,0.0007774840615767378,0.7832817337461301
498,954,흥미/Noun,323,125,198,0.001389413778538559,0.0021991692027456293,0.6130030959752322
499,958,헐다/Verb,322,92,230,0.0010226085410043797,0.002554590488037853,0.7142857142857143
500,962,흥미진진/Noun,321,276,45,0.0030678256230131378,0.0004998111824421885,0.8598130841121495
501,967,훈훈하다/Adjective,319,281,38,0.0031234021741546806,0.0004220627762845148,0.8808777429467085
502,969,잘만/Noun,318,239,79,0.002656559144565725,0.0008774462980651753,0.7515723270440252
503,970,에겐/Josa,317,194,123,0.0021563701842918434,0.001366150565341982,0.61198738170347
504,972,만으로도/Josa,316,285,31,0.0031678634150679144,0.00034431437012684104,0.9018987341772152
505,973,낫다/Verb,316,91,225,0.001011493230776071,0.002499055912210943,0.7120253164556962
506,974,나르다/Verb,316,224,92,0.0024898294911410977,0.0010218361952151409,0.7088607594936709
507,976,비추다/Verb,315,48,267,0.0005335348909588066,0.0029655463491569853,0.8476190476190476
508,977,괜히/Adverb,315,80,235,0.0008892248182646778,0.002610125063864762,0.7460317460317459
509,978,또한/Noun,315,208,107,0.002311984527488162,0.0011884399226958706,0.6603174603174603
510,979,과거/Noun,315,196,119,0.0021786008047484607,0.0013217229046804538,0.6222222222222222
511,982,그래픽/Noun,314,78,236,0.0008669941978080608,0.002621231979030144,0.7515923566878981
512,983,ost/Alpha,313,265,48,0.002945557210501745,0.0005331319279383344,0.8466453674121406
513,984,그냥/Modifier,313,87,226,0.0009670319898628369,0.002510162827376325,0.7220447284345048
514,985,이라니/Josa,313,116,197,0.0012893759864837828,0.0021880622875802475,0.6293929712460063
515,987,그만/Adverb,312,21,291,0.00023342151479447792,0.0032321123131261523,0.9326923076923076
516,988,장/Suffix,312,89,223,0.000989262610319454,0.002476842081880179,0.7147435897435898
517,989,20/Number,312,211,101,0.002345330458173088,0.0011217984317035787,0.6762820512820513
518,990,바보/Noun,311,85,226,0.0009448013694062199,0.002510162827376325,0.7266881028938906
519,991,성우/Noun,310,70,240,0.000778071715981593,0.002665659639691672,0.7741935483870968
520,992,봣/Noun,308,207,101,0.002300869217259854,0.0011217984317035787,0.6720779220779219
521,993,소중하다/Adjective,307,226,81,0.0025120601115977146,0.0008996601283959392,0.7361563517915309
522,994,죽음/Noun,307,206,101,0.0022897539070315448,0.0011217984317035787,0.6710097719869706
523,997,유치/Noun,306,21,285,0.00023342151479447792,0.003165470822133861,0.931372549019608
524,999,도저히/Noun,305,26,279,0.00028899806593602026,0.003098829331141569,0.9147540983606556
525,1000,한심하다/Adjective,305,33,272,0.00036680523753417966,0.003021080924983895,0.8918032786885246
526,1001,식/Noun,305,72,233,0.00080030233643821,0.002587911233533998,0.7639344262295082
527,1002,속편/Noun,305,99,206,0.0011004157126025386,0.002288024524068685,0.6754098360655738
528,1006,역겹다/Adjective,304,37,267,0.00041126647844741344,0.0029655463491569853,0.8782894736842105
529,1007,울/Noun,304,228,76,0.0025342907320543315,0.0008441255525690295,0.75
530,1008,무조건/Noun,304,193,111,0.002145254874063535,0.0012328675833573985,0.6348684210526315
531,1009,닿다/Verb,303,192,111,0.0021341395638352265,0.0012328675833573985,0.6336633663366337
532,1010,전달/Noun,303,115,188,0.0012782606762554744,0.0020881000510918103,0.6204620462046204
533,1016,천재/Noun,301,236,65,0.0026232132138807995,0.0007219494857498278,0.7840531561461794
534,1018,억지로/Noun,300,42,258,0.00046684302958895584,0.002865584112668547,0.86
535,1019,우연히/Adverb,300,258,42,0.0028677500389035857,0.00046649043694604257,0.86
536,1020,심리/Noun,300,207,93,0.002300869217259854,0.001032943110380523,0.69
537,1021,화가/Noun,299,75,224,0.0008336482671231353,0.0024879489970455605,0.7491638795986622
538,1022,강하다/Adjective,299,187,112,0.0020785630126936845,0.0012439744985227805,0.6254180602006689
539,1023,댓글/Noun,297,75,222,0.0008336482671231353,0.002465735166714797,0.7474747474747475
540,1026,속/Modifier,296,73,223,0.0008114176466665183,0.002476842081880179,0.7533783783783784
541,1029,개다/Verb,295,73,222,0.0008114176466665183,0.002465735166714797,0.7525423728813561
542,1030,새끼/Noun,295,80,215,0.0008892248182646778,0.002387986760557123,0.7288135593220338
543,1031,척/Noun,294,58,236,0.0006446879932418914,0.002621231979030144,0.8027210884353742
544,1032,예고편/Noun,294,69,225,0.0007669564057532844,0.002499055912210943,0.7653061224489796
545,1033,다가/Noun,293,91,202,0.001011493230776071,0.0022435968634071574,0.6894197952218429
546,1034,최근/Noun,293,195,98,0.002167485494520152,0.001088477686207433,0.6655290102389079
547,1038,현/Modifier,292,181,111,0.0020118711513238334,0.0012328675833573985,0.6198630136986302
548,1039,good/Alpha,291,213,78,0.0023675610786297045,0.0008663393828997934,0.7319587628865979
549,1040,어느/Modifier,291,104,187,0.001155992263744081,0.002076993135926428,0.6426116838487973
550,1042,잊혀지다/Verb,289,255,34,0.002834404108218661,0.00037763511562298685,0.8823529411764706
551,1043,불륜/Noun,289,75,214,0.0008336482671231353,0.002376879845391741,0.740484429065744
552,1044,젠/Noun,289,80,209,0.0008892248182646778,0.002321345269564831,0.7231833910034602
553,1046,대작/Noun,288,231,57,0.002567636662739257,0.0006330941644267722,0.8020833333333334
554,1047,짐/Noun,288,189,99,0.002100793633150301,0.0010995846013728146,0.65625
555,1048,다니다/Verb,288,105,183,0.0011671075739723895,0.0020325654752649,0.6354166666666666
556,1053,미안하다/Adjective,287,74,213,0.0008225329568948269,0.002365772930226359,0.7421602787456446
557,1056,열/Noun,286,78,208,0.0008669941978080608,0.0023102383543994486,0.7272727272727273
558,1059,2시간/Number,285,95,190,0.0010559544716893046,0.0021103138814225733,0.6666666666666666
559,1064,게임/Noun,284,97,187,0.0010781850921459217,0.002076993135926428,0.6584507042253521
560,1065,행동/Noun,284,103,181,0.0011448769535157724,0.002010351644934136,0.6373239436619719
561,1068,실망하다/Adjective,283,60,223,0.0006669186136985082,0.002476842081880179,0.7879858657243817
562,1069,짓/Noun,283,70,213,0.000778071715981593,0.002365772930226359,0.7526501766784452
563,1070,환상/Noun,283,207,76,0.002300869217259854,0.0008441255525690295,0.7314487632508834
564,1071,여/Noun,283,178,105,0.001978525220638908,0.0011662260923651065,0.6289752650176679
565,1073,오래/Adverb,282,230,52,0.002556521352510949,0.0005775595885998622,0.8156028368794326
566,1077,그닥/Noun,280,25,255,0.0002778827557077118,0.0028322633671724017,0.9107142857142856
567,1078,귀신/Noun,280,71,209,0.0007891870262099014,0.002321345269564831,0.7464285714285714
568,1079,전설/Noun,280,175,105,0.0019451792899539827,0.0011662260923651065,0.625
569,1082,산/Noun,279,67,212,0.0007447257852966678,0.002354666015060977,0.7598566308243727
570,1083,총/Modifier,279,87,192,0.0009670319898628369,0.0021325277117533376,0.6881720430107527
571,1084,회/Noun,279,177,102,0.0019674099104106,0.0011329053468689607,0.6344086021505376
572,1085,빠져들다/Verb,278,264,14,0.0029344419002734373,0.0001554968123153475,0.9496402877697842
573,1086,흘리다/Verb,278,211,67,0.002345330458173088,0.0007441633160805918,0.7589928057553957
574,1087,전작/Noun,277,72,205,0.00080030233643821,0.002276917608903303,0.740072202166065
575,1088,총/Noun,277,85,192,0.0009448013694062199,0.0021325277117533376,0.6931407942238267
576,1090,♡/Foreign,276,264,12,0.0029344419002734373,0.0001332829819845836,0.9565217391304348
577,1092,현재/Noun,275,205,70,0.002278638596803237,0.0007774840615767378,0.7454545454545455
578,1096,쩔다/Verb,274,216,58,0.00240090700931463,0.0006442010795921541,0.7883211678832117
579,1097,여전하다/Adjective,274,191,83,0.0021230242536069183,0.0009218739587267033,0.6970802919708029
580,1098,울/Modifier,274,178,96,0.001978525220638908,0.0010662638558766688,0.6496350364963503
581,1099,제작비/Noun,273,38,235,0.000422381788675722,0.002610125063864762,0.8608058608058609
582,1100,영원하다/Adjective,273,231,42,0.002567636662739257,0.00046649043694604257,0.8461538461538461
583,1101,예요/Josa,273,206,67,0.0022897539070315448,0.0007441633160805918,0.7545787545787546
584,1102,스러운/Josa,273,89,184,0.000989262610319454,0.0020436723904302817,0.6739926739926739
585,1103,다행/Noun,273,104,169,0.001155992263744081,0.0018770686629495524,0.6190476190476191
586,1104,흠/Noun,272,105,167,0.0011671075739723895,0.0018548548326187888,0.6139705882352942
587,1106,통해/Noun,271,217,54,0.0024120223195429388,0.0005997734189306263,0.8007380073800738
588,1107,잘생기다/Adjective,271,198,73,0.002200831425205077,0.0008108048070728836,0.7306273062730627
589,1108,노/Noun,271,96,175,0.0010670697819176133,0.0019437101539418445,0.6457564575645757
590,1114,망작/Noun,268,16,252,0.00017784496365293558,0.002798942621676256,0.9402985074626866
591,1118,가끔/Noun,267,174,93,0.0019340639797256738,0.001032943110380523,0.651685393258427
592,1119,만의/Josa,267,167,100,0.001856256808127515,0.0011106915165381968,0.6254681647940075
593,1120,드럽다/Adjective,266,24,242,0.0002667674454794033,0.002687873470022436,0.9097744360902256
594,1121,동화/Noun,266,189,77,0.002100793633150301,0.0008552324677344116,0.7105263157894737
595,1122,80년/Number,266,82,184,0.0009114554387212947,0.0020436723904302817,0.6917293233082706
596,1127,100/Number,265,171,94,0.001900718049040749,0.0010440500255459052,0.6452830188679245
597,1128,묘사/Noun,265,170,95,0.0018896027388124407,0.0010551569407112867,0.6415094339622641
598,1130,예산/Noun,264,65,199,0.0007224951648400508,0.0022102761179110114,0.7537878787878788
599,1131,으/Adverb,263,97,166,0.0010781850921459217,0.0018437479174534066,0.6311787072243346
600,1132,여러/Modifier,263,165,98,0.0018340261876708976,0.001088477686207433,0.6273764258555133
601,1136,채널/Noun,262,82,180,0.0009114554387212947,0.001999244729768754,0.6870229007633588
602,1137,살인/Noun,262,97,165,0.0010781850921459217,0.0018326410022880247,0.6297709923664122
603,1138,멍청하다/Adjective,260,38,222,0.000422381788675722,0.002465735166714797,0.8538461538461538
604,1139,강/Noun,260,197,63,0.002189716114976769,0.0006997356554190639,0.7576923076923077
605,1147,졸라/Noun,258,75,183,0.0008336482671231353,0.0020325654752649,0.7093023255813954
606,1150,개/Suffix,257,79,178,0.0008781095080363692,0.0019770308994379896,0.6926070038910506
607,1157,외/Noun,256,70,186,0.000778071715981593,0.002065886220761046,0.7265625
608,1158,서로/Noun,256,161,95,0.001789564946757664,0.0010551569407112867,0.62890625
609,1161,낚/Noun,254,20,234,0.00022230620456616945,0.0025990181486993803,0.9212598425196852
610,1162,경찰/Noun,254,98,156,0.0010893004023742304,0.0017326787657995868,0.6141732283464567
611,1164,모/Noun,253,66,187,0.0007336104750683593,0.002076993135926428,0.7391304347826086
612,1167,끌다/Verb,252,68,184,0.0007558410955249762,0.0020436723904302817,0.7301587301587301
613,1168,런가/Noun,252,97,155,0.0010781850921459217,0.0017215718506342046,0.6150793650793651
614,1169,반개/Noun,251,5,246,5.557655114154236e-05,0.002732301130683964,0.9800796812749004
615,1170,짱/VerbPrefix,251,225,26,0.0025009448013694068,0.00028877979429993113,0.896414342629482
616,1171,지루/Noun,250,21,229,0.00023342151479447792,0.0025434835728724704,0.9159999999999999
617,1173,황당하다/Adjective,249,38,211,0.000422381788675722,0.002343559099895595,0.8473895582329317
618,1176,약하다/Adjective,248,71,177,0.0007891870262099014,0.001965923984272608,0.7137096774193549
619,1177,흔하다/Adjective,248,92,156,0.0010226085410043797,0.0017326787657995868,0.6290322580645161
620,1181,졸리다/Verb,247,27,220,0.0003001133761643288,0.0024435213363840328,0.8906882591093117
621,1182,용도/Noun,247,57,190,0.0006335726830135829,0.0021103138814225733,0.7692307692307693
622,1183,희망/Noun,246,210,36,0.002334215147944779,0.00039984894595375083,0.8536585365853658
623,1186,위대하다/Adjective,245,185,60,0.002056332392237067,0.000666414909922918,0.7551020408163265
624,1187,청춘/Noun,245,172,73,0.0019118333592690567,0.0008108048070728836,0.7020408163265306
625,1188,......./Punctuation,245,81,164,0.0009003401284929863,0.0018215340871226425,0.6693877551020408
626,1189,다만/Noun,245,160,85,0.0017784496365293556,0.0009440877890574672,0.6530612244897959
627,1190,상상력/Noun,245,158,87,0.0017562190160727387,0.0009663016193882313,0.6448979591836734
628,1191,너무나도/Adverb,245,151,94,0.0016784118444745793,0.0010440500255459052,0.6163265306122448
629,1193,깊이/Noun,244,172,72,0.0019118333592690567,0.0007996978919075017,0.7049180327868853
630,1199,cg/Alpha,243,62,181,0.0006891492341551253,0.002010351644934136,0.7448559670781894
631,1202,기세/Noun,242,7,235,7.78071715981593e-05,0.002610125063864762,0.9710743801652892
632,1208,형님/Noun,241,155,86,0.0017228730853878133,0.0009551947042228492,0.6431535269709544
633,1209,깔다/Verb,241,91,150,0.001011493230776071,0.001666037274807295,0.6224066390041494
634,1213,노출/Noun,240,57,183,0.0006335726830135829,0.0020325654752649,0.7625
635,1214,다시다/Verb,240,72,168,0.00080030233643821,0.0018659617477841703,0.7
636,1215,카메라/Noun,240,73,167,0.0008114176466665183,0.0018548548326187888,0.6958333333333333
637,1216,살아가다/Verb,239,217,22,0.0024120223195429388,0.00024435213363840333,0.9079497907949792
638,1217,미래/Noun,239,164,75,0.0018229108774425891,0.0008330186374036475,0.6861924686192469
639,1220,쏘다/Verb,238,76,162,0.0008447635773514439,0.0017993202567918784,0.6806722689075629
640,1221,체/Noun,238,92,146,0.0010226085410043797,0.0016216096141457672,0.6134453781512605
641,1224,대안/Noun,237,199,38,0.002211946735433386,0.0004220627762845148,0.8396624472573839
642,1226,산만하다/Adjective,236,19,217,0.00021119089433786097,0.002410200590887887,0.9194915254237288
643,1227,능력/Noun,236,81,155,0.0009003401284929863,0.0017215718506342046,0.6567796610169492
644,1228,미소/Noun,235,212,23,0.002356445768401396,0.0002554590488037852,0.9021276595744679
645,1229,결론/Noun,235,63,172,0.0007002645443834338,0.0019103894084456985,0.7319148936170212
646,1230,반/Noun,235,83,152,0.0009225707489496033,0.001688251105138059,0.6468085106382979
647,1231,치/Noun,235,90,145,0.0010003779205477628,0.001610502698980385,0.6170212765957447
648,1233,설레다/Adjective,234,212,22,0.002356445768401396,0.00024435213363840333,0.9059829059829059
649,1234,독립영화/Noun,234,75,159,0.0008336482671231353,0.0017659995112957324,0.6794871794871795
650,1236,OST/Alpha,233,191,42,0.0021230242536069183,0.00046649043694604257,0.8197424892703863
651,1237,잘못/Noun,233,83,150,0.0009225707489496033,0.001666037274807295,0.6437768240343348
652,1242,지나치다/Verb,230,55,175,0.000611342062556966,0.0019437101539418445,0.7608695652173914
653,1243,리얼/Noun,230,156,74,0.0017339883956161216,0.0008219117222382655,0.6782608695652174
654,1244,평생/Noun,230,147,83,0.0016339506035613453,0.0009218739587267033,0.6391304347826087
655,1247,젊다/Adjective,229,158,71,0.0017562190160727387,0.0007885909767421196,0.6899563318777293
656,1249,왠만하다/Adjective,228,20,208,0.00022230620456616945,0.0023102383543994486,0.912280701754386
657,1250,멋/Noun,228,174,54,0.0019340639797256738,0.0005997734189306263,0.7631578947368421
658,1251,범인/Noun,228,62,166,0.0006891492341551253,0.0018437479174534066,0.7280701754385965
659,1252,되게/Adverb,227,149,78,0.0016561812240179624,0.0008663393828997934,0.6563876651982379
660,1253,어린이/Noun,227,87,140,0.0009670319898628369,0.0015549681231534756,0.6167400881057269
661,1256,박수/Noun,226,151,75,0.0016784118444745793,0.0008330186374036475,0.668141592920354
662,1260,손발/Noun,225,22,203,0.00024453682502278637,0.002254703778572539,0.9022222222222224
663,1261,고생/Noun,225,87,138,0.0009670319898628369,0.0015327542928227115,0.6133333333333333
664,1262,고맙다/Adjective,224,180,44,0.002000755841095525,0.0004887042672768067,0.8035714285714286
665,1264,졸다/Verb,223,13,210,0.00014449903296801013,0.002332452184730213,0.9417040358744396
666,1265,굳이/Noun,223,45,178,0.0005001889602738814,0.0019770308994379896,0.7982062780269058
667,1266,로맨틱/Noun,223,141,82,0.0015672587421914947,0.0009107670435613213,0.6322869955156951
668,1271,거지같다/Adjective,222,19,203,0.00021119089433786097,0.002254703778572539,0.9144144144144144
669,1272,떠오르다/Verb,222,164,58,0.0018229108774425891,0.0006442010795921541,0.7387387387387387
670,1273,밤/Noun,222,158,64,0.0017562190160727387,0.0007108425705844457,0.7117117117117117
671,1277,별루/Noun,220,12,208,0.00013338372273970166,0.0023102383543994486,0.9454545454545454
672,1278,슬픔/Noun,220,192,28,0.0021341395638352265,0.000310993624630695,0.8727272727272727
673,1279,용이/Noun,220,69,151,0.0007669564057532844,0.001677144189972677,0.6863636363636364
674,1280,차/Noun,220,84,136,0.0009336860591779117,0.0015105404624919474,0.6181818181818182
675,1284,포장/Noun,219,20,199,0.00022230620456616945,0.0022102761179110114,0.9086757990867579
676,1285,주기/Noun,219,40,179,0.0004446124091323389,0.001988137814603372,0.817351598173516
677,1286,시도/Noun,219,57,162,0.0006335726830135829,0.0017993202567918784,0.7397260273972602
678,1287,ㅅㅂ/KoreanParticle,218,20,198,0.00022230620456616945,0.0021991692027456293,0.908256880733945
679,1288,아침/Noun,218,56,162,0.0006224573727852744,0.0017993202567918784,0.7431192660550459
680,1297,광고/Noun,216,47,169,0.0005224195807304982,0.0018770686629495524,0.7824074074074074
681,1300,짱/Modifier,215,181,34,0.0020118711513238334,0.00037763511562298685,0.8418604651162791
682,1301,진실/Noun,215,142,73,0.0015783740524198029,0.0008108048070728836,0.6604651162790698
683,1305,암/Noun,214,59,155,0.0006558033034701999,0.0017215718506342046,0.7242990654205608
684,1306,흐름/Noun,214,83,131,0.0009225707489496033,0.0014550058866650375,0.6121495327102804
685,1309,눈물나다/Verb,213,183,30,0.0020341017717804503,0.000333207454961459,0.8591549295774648
686,1312,성도/Noun,212,25,187,0.0002778827557077118,0.002076993135926428,0.8820754716981132
687,1313,한계/Noun,212,38,174,0.000422381788675722,0.0019326032387764625,0.8207547169811321
688,1314,그럭저럭/Adverb,212,52,160,0.0005779961318720405,0.0017771064264611148,0.7547169811320755
689,1315,전/Foreign,212,157,55,0.00174510370584443,0.0006108803340960082,0.7405660377358491
690,1316,조차/Josa,212,56,156,0.0006224573727852744,0.0017326787657995868,0.7358490566037735
691,1317,챙기다/Verb,212,145,67,0.0016117199831047284,0.0007441633160805918,0.6839622641509434
692,1318,심/Noun,212,73,139,0.0008114176466665183,0.0015438612079880936,0.6556603773584906
693,1323,~^^/Punctuation,211,202,9,0.0022452926661183114,9.996223648843771e-05,0.957345971563981
694,1324,진정/Noun,211,146,65,0.0016228352933330367,0.0007219494857498278,0.6919431279620853
695,1325,..?/Punctuation,211,82,129,0.0009114554387212947,0.0014327920563342734,0.6113744075829384
696,1329,깔끔하다/Adjective,210,167,43,0.001856256808127515,0.0004775973521114245,0.7952380952380952
697,1330,살짝/Noun,210,140,70,0.001556143431963186,0.0007774840615767378,0.6666666666666666
698,1333,발견/Noun,209,175,34,0.0019451792899539827,0.00037763511562298685,0.8373205741626795
699,1334,리뷰/Noun,209,80,129,0.0008892248182646778,0.0014327920563342734,0.6172248803827751
700,1335,일어나다/Verb,209,129,80,0.0014338750194517929,0.0008885532132305574,0.6172248803827751
701,1339,개도/Noun,208,25,183,0.0002778827557077118,0.0020325654752649,0.8798076923076923
702,1340,쩐다/Noun,208,145,63,0.0016117199831047284,0.0006997356554190639,0.6971153846153846
703,1341,범죄/Noun,208,72,136,0.00080030233643821,0.0015105404624919474,0.6538461538461539
704,1344,짱짱/Noun,207,199,8,0.002211946735433386,8.885532132305573e-05,0.961352657004831
705,1345,부족/Noun,207,29,178,0.0003223439966209457,0.0019770308994379896,0.8599033816425121
706,1346,지난/Noun,207,159,48,0.0017673343263010473,0.0005331319279383344,0.7681159420289855
707,1347,20년/Number,207,142,65,0.0015783740524198029,0.0007219494857498278,0.6859903381642513
708,1348,야/Exclamation,207,66,141,0.0007336104750683593,0.0015660750383188573,0.6811594202898551
709,1352,대충/Noun,206,37,169,0.00041126647844741344,0.0018770686629495524,0.8203883495145631
710,1353,영환/Noun,206,64,142,0.0007113798546117423,0.0015771819534842392,0.6893203883495146
711,1360,감탄/Noun,205,177,28,0.0019674099104106,0.000310993624630695,0.8634146341463415
712,1361,빨/Noun,205,54,151,0.0006002267523286575,0.001677144189972677,0.7365853658536585
713,1362,자연/Noun,205,142,63,0.0015783740524198029,0.0006997356554190639,0.6926829268292682
714,1363,커플/Noun,205,141,64,0.0015672587421914947,0.0007108425705844457,0.6878048780487804
715,1364,시선/Noun,205,141,64,0.0015672587421914947,0.0007108425705844457,0.6878048780487804
716,1365,정서/Noun,205,76,129,0.0008447635773514439,0.0014327920563342734,0.6292682926829268
717,1367,시청자/Noun,204,41,163,0.00045572771936064734,0.001810427171957261,0.7990196078431373
718,1368,홍보/Noun,204,43,161,0.00047795833981726434,0.001788213341626497,0.7892156862745098
719,1369,담기다/Verb,204,160,44,0.0017784496365293556,0.0004887042672768067,0.7843137254901961
720,1370,몸매/Noun,204,67,137,0.0007447257852966678,0.0015216473776573296,0.6715686274509803
721,1375,아오/Exclamation,203,29,174,0.0003223439966209457,0.0019326032387764625,0.8571428571428571
722,1378,울리다/Verb,202,175,27,0.0019451792899539827,0.0002998867094653131,0.8663366336633663
723,1379,지르다/Verb,202,42,160,0.00046684302958895584,0.0017771064264611148,0.7920792079207921
724,1380,소름끼치다/Verb,202,155,47,0.0017228730853878133,0.0005220250127729526,0.7673267326732673
725,1383,일상/Noun,201,154,47,0.0017117577751595047,0.0005220250127729526,0.7661691542288557
726,1384,포기/Noun,201,56,145,0.0006224573727852744,0.001610502698980385,0.7213930348258707
727,1385,코드/Noun,201,76,125,0.0008447635773514439,0.001388364395672746,0.6218905472636815
728,1386,첨/Noun,201,77,124,0.0008558788875797522,0.0013772574805073642,0.6169154228855721
729,1388,접다/Verb,199,22,177,0.00024453682502278637,0.001965923984272608,0.8894472361809045
730,1389,30분/Number,199,51,148,0.0005668808216437321,0.001643823444476531,0.7437185929648241
731,1390,에서의/Josa,199,143,56,0.0015894893626481115,0.0006219872492613901,0.7185929648241206
732,1393,이따위/Modifier,198,8,190,8.892248182646779e-05,0.0021103138814225733,0.9595959595959596
733,1394,눈빛/Noun,198,175,23,0.0019451792899539827,0.0002554590488037852,0.8838383838383839
734,1395,10분/Number,198,36,162,0.000400151168219105,0.0017993202567918784,0.8181818181818182
735,1396,보라/Noun,198,64,134,0.0007113798546117423,0.0014883266321611835,0.6767676767676768
736,1397,끼리/Noun,198,71,127,0.0007891870262099014,0.0014105782260035095,0.6414141414141414
737,1398,사극/Noun,198,123,75,0.001367183158081942,0.0008330186374036475,0.6212121212121212
738,1401,말로/Noun,197,140,57,0.001556143431963186,0.0006330941644267722,0.7106598984771574
739,1404,뜬금/Noun,196,17,179,0.00018896027388124405,0.001988137814603372,0.9132653061224488
740,1405,핵/Noun,196,37,159,0.00041126647844741344,0.0017659995112957324,0.8112244897959183
741,1406,상처/Noun,196,143,53,0.0015894893626481115,0.0005886665037652442,0.7295918367346939
742,1407,실감/Noun,196,128,68,0.0014227597092234846,0.0007552702312459737,0.6530612244897959
743,1414,끌/Noun,195,22,173,0.00024453682502278637,0.0019214963236110802,0.8871794871794871
744,1415,힐링/Noun,195,171,24,0.001900718049040749,0.0002665659639691672,0.8769230769230769
745,1416,혹시/Noun,195,48,147,0.0005335348909588066,0.0016327165293111491,0.7538461538461538
746,1417,막판/Noun,195,58,137,0.0006446879932418914,0.0015216473776573296,0.7025641025641025
747,1418,빛/Noun,195,127,68,0.001411644398995176,0.0007552702312459737,0.6512820512820513
748,1421,무겁다/Adjective,194,158,36,0.0017562190160727387,0.00039984894595375083,0.8144329896907216
749,1422,우정/Noun,194,143,51,0.0015894893626481115,0.0005664526734344802,0.7371134020618557
750,1423,해피엔딩/Noun,194,138,56,0.0015339128115065689,0.0006219872492613901,0.711340206185567
751,1424,죄/Noun,194,67,127,0.0007447257852966678,0.0014105782260035095,0.6546391752577321
752,1430,참다/Verb,193,36,157,0.000400151168219105,0.0017437856809649687,0.8134715025906736
753,1437,몰다/Verb,192,64,128,0.0007113798546117423,0.0014216851411688915,0.6666666666666666
754,1439,아련하다/Adjective,191,184,7,0.002045217082008759,7.774840615767377e-05,0.9633507853403142
755,1440,보아/Noun,191,134,57,0.001489451570593335,0.0006330941644267722,0.7015706806282722
756,1441,게다가/Noun,191,58,133,0.0006446879932418914,0.0014772197169958016,0.6963350785340314
757,1444,개판/Noun,190,8,182,8.892248182646779e-05,0.002021458560099518,0.9578947368421052
758,1445,뭐임/Noun,190,15,175,0.00016672965342462708,0.0019437101539418445,0.9210526315789472
759,1446,나머지/Noun,190,38,152,0.000422381788675722,0.001688251105138059,0.8
760,1447,벌써/Noun,190,146,44,0.0016228352933330367,0.0004887042672768067,0.7684210526315789
761,1448,조폭/Noun,190,58,132,0.0006446879932418914,0.0014661128018304194,0.6947368421052632
762,1449,간/Noun,190,72,118,0.00080030233643821,0.001310615989515072,0.6210526315789474
763,1453,소장/Noun,189,173,16,0.0019229486694973656,0.00017771064264611146,0.9153439153439152
764,1454,비극/Noun,189,143,46,0.0015894893626481115,0.0005109180976075704,0.7566137566137566
765,1455,까지는/Josa,189,51,138,0.0005668808216437321,0.0015327542928227115,0.7301587301587301
766,1456,주/Noun,189,73,116,0.0008114176466665183,0.0012884021591843082,0.6137566137566137
767,1460,벗다/Verb,188,41,147,0.00045572771936064734,0.0016327165293111491,0.7819148936170213
768,1461,난해하다/Adjective,188,45,143,0.0005001889602738814,0.0015882888686496212,0.7606382978723404
769,1462,섹스/Noun,188,51,137,0.0005668808216437321,0.0015216473776573296,0.7287234042553191
770,1463,부끄럽다/Adjective,188,65,123,0.0007224951648400508,0.001366150565341982,0.6542553191489362
771,1464,등장인물/Noun,188,69,119,0.0007669564057532844,0.0013217229046804538,0.6329787234042553
772,1467,형편/Noun,187,18,169,0.0002000755841095525,0.0018770686629495524,0.9037433155080212
773,1468,본방/Noun,187,166,21,0.0018451414978992067,0.00023324521847302128,0.8877005347593583
774,1469,감명/Noun,187,164,23,0.0018229108774425891,0.0002554590488037852,0.8770053475935828
775,1470,뮤지컬/Noun,187,117,70,0.0013004912967120913,0.0007774840615767378,0.6256684491978609
776,1473,펑펑/Noun,186,179,7,0.0019896405308672165,7.774840615767377e-05,0.9623655913978496
777,1474,끝내다/Verb,186,63,123,0.0007002645443834338,0.001366150565341982,0.6612903225806451
778,1475,의문/Noun,186,67,119,0.0007447257852966678,0.0013217229046804538,0.6397849462365591
779,1476,이연걸/Noun,186,117,69,0.0013004912967120913,0.0007663771464113557,0.6290322580645161
780,1482,그다지/Noun,185,18,167,0.0002000755841095525,0.0018548548326187888,0.9027027027027028
781,1483,토/Noun,185,44,141,0.0004890736500455726,0.0015660750383188573,0.7621621621621621
782,1484,떼다/Verb,185,140,45,0.001556143431963186,0.0004998111824421885,0.7567567567567568
783,1485,인가요/Josa,185,57,128,0.0006335726830135829,0.0014216851411688915,0.6918918918918919
784,1486,결과/Noun,185,64,121,0.0007113798546117423,0.001343936735011218,0.6540540540540539
785,1487,불가/Noun,184,41,143,0.00045572771936064734,0.0015882888686496212,0.7771739130434783
786,1488,자유/Noun,184,128,56,0.0014227597092234846,0.0006219872492613901,0.6956521739130435
787,1489,암튼/Adverb,184,123,61,0.001367183158081942,0.0006775218250882999,0.6684782608695652
788,1490,새벽/Noun,184,122,62,0.0013560678478536335,0.0006886287402536821,0.6630434782608695
789,1491,꼴/Noun,183,23,160,0.00025565213525109487,0.0017771064264611148,0.8743169398907104
790,1492,표절/Noun,183,24,159,0.0002667674454794033,0.0017659995112957324,0.8688524590163934
791,1493,행복/Noun,183,153,30,0.0017006424649311962,0.000333207454961459,0.8360655737704918
792,1494,딱하다/Adjective,183,31,152,0.00034457461707756266,0.001688251105138059,0.8306010928961749
793,1495,지도/Noun,183,60,123,0.0006669186136985082,0.001366150565341982,0.6721311475409836
794,1496,느와르/Noun,183,123,60,0.001367183158081942,0.000666414909922918,0.6721311475409836
795,1498,글쎄/Noun,182,21,161,0.00023342151479447792,0.001788213341626497,0.8846153846153846
796,1499,색다르다/Adjective,182,141,41,0.0015672587421914947,0.00045538352178066063,0.7747252747252747
797,1500,기본/Noun,182,50,132,0.0005557655114154236,0.0014661128018304194,0.7252747252747253
798,1501,오버/Noun,182,51,131,0.0005668808216437321,0.0014550058866650375,0.7197802197802198
799,1502,차이/Noun,182,68,114,0.0007558410955249762,0.001266188328853544,0.6263736263736264
800,1506,에만/Josa,181,44,137,0.0004890736500455726,0.0015216473776573296,0.7569060773480663
801,1507,에게는/Josa,181,120,61,0.0013338372273970164,0.0006775218250882999,0.6629834254143646
802,1508,따위/Noun,181,63,118,0.0007002645443834338,0.001310615989515072,0.6519337016574586
803,1509,가면/Noun,181,65,116,0.0007224951648400508,0.0012884021591843082,0.6408839779005525
804,1514,쓰래/Noun,180,10,170,0.00011115310228308472,0.0018881755781149344,0.9444444444444444
805,1515,불쾌하다/Adjective,180,23,157,0.00025565213525109487,0.0017437856809649687,0.8722222222222222
806,1516,느리다/Adjective,180,42,138,0.00046684302958895584,0.0015327542928227115,0.7666666666666667
807,1517,까진/Josa,180,62,118,0.0006891492341551253,0.001310615989515072,0.6555555555555556
808,1518,악당/Noun,180,65,115,0.0007224951648400508,0.0012772952440189265,0.6388888888888888
809,1521,싸다/Verb,179,41,138,0.00045572771936064734,0.0015327542928227115,0.770949720670391
810,1522,촌스럽다/Adjective,179,50,129,0.0005557655114154236,0.0014327920563342734,0.7206703910614525
811,1523,모/Modifier,179,67,112,0.0007447257852966678,0.0012439744985227805,0.6256983240223464
812,1531,그렇다고/Conjunction,178,34,144,0.0003779205477624881,0.0015993957838150033,0.8089887640449438
813,1536,이제야/Noun,177,157,20,0.00174510370584443,0.00022213830330763932,0.8870056497175142
814,1537,적절하다/Adjective,177,137,40,0.0015227975012782607,0.0004442766066152787,0.7740112994350282
815,1538,깨닫다/Verb,177,133,44,0.0014783362603650269,0.0004887042672768067,0.7514124293785308
816,1539,반복/Noun,177,68,109,0.0007558410955249762,0.0012106537530266347,0.615819209039548
817,1543,오그라들다/Verb,176,19,157,0.00021119089433786097,0.0017437856809649687,0.8920454545454546
818,1544,긴장/Noun,176,134,42,0.001489451570593335,0.00046649043694604257,0.7613636363636364
819,1545,게이/Noun,176,47,129,0.0005224195807304982,0.0014327920563342734,0.7329545454545454
820,1546,어쩔/Adverb,176,57,119,0.0006335726830135829,0.0013217229046804538,0.6761363636363636
821,1547,외국/Noun,176,57,119,0.0006335726830135829,0.0013217229046804538,0.6761363636363636
822,1550,언제나/Adverb,175,128,47,0.0014227597092234846,0.0005220250127729526,0.7314285714285714
823,1551,북한/Noun,175,65,110,0.0007224951648400508,0.0012217606681920164,0.6285714285714286
824,1554,열정/Noun,174,148,26,0.0016450659137896538,0.00028877979429993113,0.8505747126436781
825,1555,소소하다/Adjective,174,143,31,0.0015894893626481115,0.00034431437012684104,0.8218390804597702
826,1556,빛나다/Verb,174,131,43,0.0014561056399084098,0.0004775973521114245,0.7528735632183908
827,1557,이루다/Verb,174,126,48,0.0014005290887668675,0.0005331319279383344,0.7241379310344828
828,1559,아픔/Noun,173,146,27,0.0016228352933330367,0.0002998867094653131,0.8439306358381503
829,1560,창/Noun,173,31,142,0.00034457461707756266,0.0015771819534842392,0.8208092485549133
830,1561,선생님/Noun,173,129,44,0.0014338750194517929,0.0004887042672768067,0.7456647398843931
831,1562,병/Noun,173,51,122,0.0005668808216437321,0.0013550436501765998,0.7052023121387283
832,1563,쇼/Noun,173,55,118,0.000611342062556966,0.001310615989515072,0.6820809248554913
833,1565,강렬하다/Adjective,172,147,25,0.0016339506035613453,0.0002776728791345492,0.8546511627906976
834,1566,화나다/Verb,172,30,142,0.00033345930684925416,0.0015771819534842392,0.8255813953488372
835,1567,짝/Noun,172,34,138,0.0003779205477624881,0.0015327542928227115,0.8023255813953488
836,1568,양/Modifier,172,52,120,0.0005779961318720405,0.001332829819845836,0.6976744186046512
837,1569,디즈니/Noun,172,114,58,0.0012671453660271655,0.0006442010795921541,0.6627906976744186
838,1574,질리/Noun,171,160,11,0.0017784496365293556,0.00012217606681920164,0.935672514619883
839,1575,쩝/Adverb,171,28,143,0.0003112286863926372,0.0015882888686496212,0.8362573099415205
840,1576,극치/Noun,171,28,143,0.0003112286863926372,0.0015882888686496212,0.8362573099415205
841,1577,까지도/Josa,171,135,36,0.0015005668808216438,0.00039984894595375083,0.7894736842105263
842,1578,밥/Noun,171,47,124,0.0005224195807304982,0.0013772574805073642,0.7251461988304093
843,1579,희생/Noun,171,112,59,0.0012449147455705488,0.000655307994757536,0.6549707602339181
844,1583,찡하다/Adjective,170,165,5,0.0018340261876708976,5.5534575826909837e-05,0.9705882352941176
845,1584,주기도/Noun,170,6,164,6.669186136985083e-05,0.0018215340871226425,0.9647058823529412
846,1585,노답/Noun,170,14,156,0.0001556143431963186,0.0017326787657995868,0.9176470588235294
847,1586,빡치다/Adjective,170,27,143,0.0003001133761643288,0.0015882888686496212,0.8411764705882353
848,1587,남편/Noun,170,55,115,0.000611342062556966,0.0012772952440189265,0.6764705882352942
849,1593,죄다/Adverb,169,19,150,0.00021119089433786097,0.001666037274807295,0.8875739644970414
850,1594,싸구려/Noun,169,21,148,0.00023342151479447792,0.001643823444476531,0.8757396449704142
851,1595,때우다/Verb,169,36,133,0.000400151168219105,0.0014772197169958016,0.7869822485207101
852,1596,에로/Josa,169,39,130,0.0004334970989040304,0.0014438989714996556,0.7692307692307693
853,1597,마저/Josa,169,51,118,0.0005668808216437321,0.001310615989515072,0.6982248520710059
854,1598,헐리우드/Noun,169,52,117,0.0005779961318720405,0.0012995090743496902,0.6923076923076923
855,1601,섬세하다/Adjective,168,146,22,0.0016228352933330367,0.00024435213363840333,0.8690476190476191
856,1602,풋풋하다/Adjective,168,144,24,0.00160060467287642,0.0002665659639691672,0.8571428571428571
857,1603,어머니/Noun,168,123,45,0.001367183158081942,0.0004998111824421885,0.7321428571428571
858,1604,=/Punctuation,168,55,113,0.000611342062556966,0.0012550814136881624,0.6726190476190477
859,1605,청소년/Noun,168,62,106,0.0006891492341551253,0.0011773330075304884,0.6309523809523809
860,1611,제로/Noun,167,16,151,0.00017784496365293558,0.001677144189972677,0.9041916167664672
861,1612,유발/Noun,167,21,146,0.00023342151479447792,0.0016216096141457672,0.8742514970059879
862,1613,필름/Noun,167,34,133,0.0003779205477624881,0.0014772197169958016,0.7964071856287425
863,1614,조절/Noun,167,40,127,0.0004446124091323389,0.0014105782260035095,0.7604790419161677
864,1615,놓치다/Verb,167,125,42,0.001389413778538559,0.00046649043694604257,0.7485029940119761
865,1616,본인/Noun,167,56,111,0.0006224573727852744,0.0012328675833573985,0.6646706586826348
866,1617,_/Punctuation,167,106,61,0.001178222884200698,0.0006775218250882999,0.6347305389221557
867,1622,미드/Noun,166,111,55,0.0012337994353422404,0.0006108803340960082,0.6686746987951807
868,1623,실력/Noun,166,57,109,0.0006335726830135829,0.0012106537530266347,0.6566265060240963
869,1627,조잡하다/Adjective,165,7,158,7.78071715981593e-05,0.0017548925961303507,0.9575757575757576
870,1628,호러/Noun,165,58,107,0.0006446879932418914,0.0011884399226958706,0.6484848484848484
871,1629,방금/Noun,165,104,61,0.001155992263744081,0.0006775218250882999,0.6303030303030303
872,1630,금/Noun,165,61,104,0.0006780339239268168,0.0011551191771997243,0.6303030303030303
873,1631,라인/Noun,165,63,102,0.0007002645443834338,0.0011329053468689607,0.6181818181818182
874,1636,굿굿/Noun,164,161,3,0.001789564946757664,3.33207454961459e-05,0.9817073170731708
875,1637,좋아지다/Verb,164,134,30,0.001489451570593335,0.000333207454961459,0.8170731707317073
876,1638,통쾌하다/Adjective,164,128,36,0.0014227597092234846,0.00039984894595375083,0.7804878048780488
877,1639,심각하다/Adjective,164,43,121,0.00047795833981726434,0.001343936735011218,0.7378048780487805
878,1640,맨날/Adverb,164,58,106,0.0006446879932418914,0.0011773330075304884,0.6463414634146342
879,1641,쫌/Noun,164,59,105,0.0006558033034701999,0.0011662260923651065,0.6402439024390244
880,1646,어휴/Exclamation,163,21,142,0.00023342151479447792,0.0015771819534842392,0.8711656441717791
881,1647,실패/Noun,163,27,136,0.0003001133761643288,0.0015105404624919474,0.8343558282208589
882,1648,아줌마/Noun,163,46,117,0.0005113042705021896,0.0012995090743496902,0.7177914110429447
883,1654,다가오다/Verb,162,132,30,0.0014672209501367186,0.000333207454961459,0.8148148148148148
884,1655,은근/Noun,162,127,35,0.001411644398995176,0.0003887420307883688,0.7839506172839507
885,1656,심장/Noun,162,126,36,0.0014005290887668675,0.00039984894595375083,0.7777777777777778
886,1657,바라보다/Verb,162,126,36,0.0014005290887668675,0.00039984894595375083,0.7777777777777778
887,1658,씁쓸하다/Adjective,162,120,42,0.0013338372273970164,0.00046649043694604257,0.7407407407407407
888,1659,편하다/Adjective,162,108,54,0.001200453504657315,0.0005997734189306263,0.6666666666666666
889,1660,따라가다/Verb,162,56,106,0.0006224573727852744,0.0011773330075304884,0.654320987654321
890,1666,없어지다/Verb,161,37,124,0.00041126647844741344,0.0013772574805073642,0.7701863354037267
891,1667,숨다/Verb,161,121,40,0.001344952537625325,0.0004442766066152787,0.7515527950310559
892,1671,1시간/Number,160,35,125,0.0003890358579907965,0.001388364395672746,0.78125
893,1672,늦다/Verb,160,123,37,0.001367183158081942,0.0004109558611191328,0.76875
894,1673,아이돌/Noun,160,54,106,0.0006002267523286575,0.0011773330075304884,0.6625
895,1674,한국인/Noun,160,57,103,0.0006335726830135829,0.0011440122620343426,0.64375
896,1675,입다/Verb,160,59,101,0.0006558033034701999,0.0011217984317035787,0.63125
897,1680,명품/Noun,159,135,24,0.0015005668808216438,0.0002665659639691672,0.8490566037735849
898,1681,존경/Noun,159,126,33,0.0014005290887668675,0.00036652820045760486,0.7924528301886793
899,1682,더불다/Verb,159,117,42,0.0013004912967120913,0.00046649043694604257,0.7358490566037735
900,1683,신나다/Adjective,159,111,48,0.0012337994353422404,0.0005331319279383344,0.6981132075471698
901,1686,시트콤/Noun,158,109,49,0.0012115688148856235,0.0005442388431037163,0.689873417721519
902,1687,어쩔/Modifier,158,50,108,0.0005557655114154236,0.0011995468378612525,0.6835443037974683
903,1688,성/Noun,158,56,102,0.0006224573727852744,0.0011329053468689607,0.6455696202531646
904,1689,대부분/Noun,158,60,98,0.0006669186136985082,0.001088477686207433,0.620253164556962
905,1693,짠하다/Adjective,157,146,11,0.0016228352933330367,0.00012217606681920164,0.929936305732484
906,1694,푹/Noun,157,137,20,0.0015227975012782607,0.00022213830330763932,0.8726114649681529
907,1695,만족/Noun,157,113,44,0.0012560300557988573,0.0004887042672768067,0.7197452229299363
908,1696,이니/Josa,157,56,101,0.0006224573727852744,0.0011217984317035787,0.643312101910828
909,1697,주말/Noun,157,99,58,0.0011004157126025386,0.0006442010795921541,0.6305732484076433
910,1698,신분/Noun,157,99,58,0.0011004157126025386,0.0006442010795921541,0.6305732484076433
911,1699,쵝오/Noun,156,151,5,0.0016784118444745793,5.5534575826909837e-05,0.9679487179487181
912,1703,거슬리다/Verb,155,35,120,0.0003890358579907965,0.001332829819845836,0.7741935483870968
913,1704,전개도/Noun,155,54,101,0.0006002267523286575,0.0011217984317035787,0.6516129032258065
914,1705,30/Number,155,98,57,0.0010893004023742304,0.0006330941644267722,0.6322580645161291
915,1709,짝퉁/Noun,154,7,147,7.78071715981593e-05,0.0016327165293111491,0.9545454545454546
916,1710,개뿔/Noun,154,7,147,7.78071715981593e-05,0.0016327165293111491,0.9545454545454546
917,1711,양심/Noun,154,28,126,0.0003112286863926372,0.0013994713108381278,0.8181818181818182
918,1712,????/Punctuation,154,36,118,0.000400151168219105,0.001310615989515072,0.7662337662337663
919,1713,누군가/Noun,154,118,36,0.0013116066069403995,0.00039984894595375083,0.7662337662337663
920,1714,그거/Noun,154,45,109,0.0005001889602738814,0.0012106537530266347,0.7077922077922078
921,1715,개념/Noun,154,49,105,0.0005446502011871152,0.0011662260923651065,0.6818181818181818
922,1716,이자/Noun,154,103,51,0.0011448769535157724,0.0005664526734344802,0.6688311688311688
923,1717,시원하다/Adjective,154,103,51,0.0011448769535157724,0.0005664526734344802,0.6688311688311688
924,1718,으로만/Josa,154,55,99,0.000611342062556966,0.0010995846013728146,0.6428571428571429
925,1719,끼/Noun,154,58,96,0.0006446879932418914,0.0010662638558766688,0.6233766233766234
926,1721,민망하다/Adjective,153,16,137,0.00017784496365293558,0.0015216473776573296,0.8954248366013072
927,1722,망/Noun,153,19,134,0.00021119089433786097,0.0014883266321611835,0.8758169934640523
928,1723,연예인/Noun,153,27,126,0.0003001133761643288,0.0013994713108381278,0.8235294117647058
929,1724,도안/Noun,153,38,115,0.000422381788675722,0.0012772952440189265,0.7516339869281046
930,1725,해내다/Verb,153,114,39,0.0012671453660271655,0.0004331696914498967,0.7450980392156863
931,1726,가요/Noun,153,39,114,0.0004334970989040304,0.001266188328853544,0.7450980392156863
932,1727,전반/Noun,153,49,104,0.0005446502011871152,0.0011551191771997243,0.6797385620915033
933,1728,진리/Noun,153,101,52,0.0011226463330591557,0.0005775595885998622,0.6601307189542484
934,1733,돌아보다/Verb,152,143,9,0.0015894893626481115,9.996223648843771e-05,0.9407894736842104
935,1734,의외로/Adverb,152,129,23,0.0014338750194517929,0.0002554590488037852,0.8486842105263158
936,1735,여행/Noun,152,104,48,0.001155992263744081,0.0005331319279383344,0.6842105263157895
937,1736,향/Noun,152,100,52,0.0011115310228308473,0.0005775595885998622,0.6578947368421053
938,1737,19/Number,152,56,96,0.0006224573727852744,0.0010662638558766688,0.631578947368421
939,1740,찝찝하다/Adjective,151,30,121,0.00033345930684925416,0.001343936735011218,0.8013245033112583
940,1741,사기/Noun,151,33,118,0.00036680523753417966,0.001310615989515072,0.7814569536423841
941,1742,과장/Noun,151,51,100,0.0005668808216437321,0.0011106915165381968,0.6622516556291391
942,1750,라지/Noun,150,18,132,0.0002000755841095525,0.0014661128018304194,0.88
943,1751,날리다/Verb,150,30,120,0.00033345930684925416,0.001332829819845836,0.8
944,1752,갈등/Noun,150,95,55,0.0010559544716893046,0.0006108803340960082,0.6333333333333333
945,1761,낭비하다/Adjective,149,2,147,2.2230620456616947e-05,0.0016327165293111491,0.9865771812080536
946,1762,단연/Noun,149,128,21,0.0014227597092234846,0.00023324521847302128,0.8590604026845637
947,1763,무척/Noun,149,114,35,0.0012671453660271655,0.0003887420307883688,0.7651006711409396
948,1764,성장/Noun,149,110,39,0.001222684125113932,0.0004331696914498967,0.7382550335570469
949,1765,......../Punctuation,149,45,104,0.0005001889602738814,0.0011551191771997243,0.6979865771812079
950,1766,번째/Suffix,149,95,54,0.0010559544716893046,0.0005997734189306263,0.6375838926174496
951,1767,초등학생/Noun,149,56,93,0.0006224573727852744,0.001032943110380523,0.6241610738255033
952,1775,이도/Noun,148,5,143,5.557655114154236e-05,0.0015882888686496212,0.9662162162162162
953,1776,상/Noun,148,44,104,0.0004890736500455726,0.0011551191771997243,0.7027027027027027
954,1777,피해자/Noun,148,44,104,0.0004890736500455726,0.0011551191771997243,0.7027027027027027
955,1778,감히/Noun,148,97,51,0.0010781850921459217,0.0005664526734344802,0.6554054054054054
956,1779,뒷/Modifier,148,53,95,0.000589111442100349,0.0010551569407112867,0.6418918918918919
957,1781,꽝/Noun,147,8,139,8.892248182646779e-05,0.0015438612079880936,0.9455782312925172
958,1782,라이/Noun,147,28,119,0.0003112286863926372,0.0013217229046804538,0.8095238095238095
959,1783,편견/Noun,147,103,44,0.0011448769535157724,0.0004887042672768067,0.7006802721088435
960,1784,베스트/Noun,147,97,50,0.0010781850921459217,0.0005553457582690984,0.6598639455782312
961,1789,사수/Noun,146,132,14,0.0014672209501367186,0.0001554968123153475,0.9041095890410958
962,1790,허세/Noun,146,18,128,0.0002000755841095525,0.0014216851411688915,0.8767123287671232
963,1791,와우/Noun,146,125,21,0.001389413778538559,0.00023324521847302128,0.8561643835616438
964,1792,명성/Noun,146,25,121,0.0002778827557077118,0.001343936735011218,0.8287671232876712
965,1793,얘/Noun,146,40,106,0.0004446124091323389,0.0011773330075304884,0.726027397260274
966,1794,올라가다/Verb,146,98,48,0.0010893004023742304,0.0005331319279383344,0.6712328767123288
967,1795,확/Noun,146,50,96,0.0005557655114154236,0.0010662638558766688,0.6575342465753424
968,1803,개막/Noun,145,9,136,0.00010003779205477625,0.0015105404624919474,0.9379310344827586
969,1804,생생하다/Adjective,145,134,11,0.001489451570593335,0.00012217606681920164,0.9241379310344828
970,1805,^/Punctuation,145,102,43,0.0011337616432874642,0.0004775973521114245,0.7034482758620689
971,1806,연결/Noun,145,50,95,0.0005557655114154236,0.0010551569407112867,0.6551724137931034
972,1809,뭉클하다/Adjective,144,139,5,0.0015450281217348775,5.5534575826909837e-05,0.9652777777777778
973,1810,마이너스/Noun,144,7,137,7.78071715981593e-05,0.0015216473776573296,0.9513888888888888
974,1811,밋밋하다/Adjective,144,18,126,0.0002000755841095525,0.0013994713108381278,0.875
975,1812,묘/Noun,144,118,26,0.0013116066069403995,0.00028877979429993113,0.8194444444444444
976,1813,...?/Punctuation,144,54,90,0.0006002267523286575,0.000999622364884377,0.625
977,1814,만큼은/Josa,144,90,54,0.0010003779205477628,0.0005997734189306263,0.625
978,1817,저/Modifier,143,26,117,0.00028899806593602026,0.0012995090743496902,0.8181818181818182
979,1818,풍경/Noun,143,101,42,0.0011226463330591557,0.00046649043694604257,0.7062937062937062
980,1819,처/Noun,143,44,99,0.0004890736500455726,0.0010995846013728146,0.6923076923076923
981,1820,드물다/Adjective,143,98,45,0.0010893004023742304,0.0004998111824421885,0.6853146853146853
982,1821,무언가/Noun,143,97,46,0.0010781850921459217,0.0005109180976075704,0.6783216783216783
983,1824,ㅉㅉㅉ/KoreanParticle,142,15,127,0.00016672965342462708,0.0014105782260035095,0.8943661971830986
984,1825,싸이코/Noun,142,29,113,0.0003223439966209457,0.0012550814136881624,0.7957746478873241
985,1826,만들기/Noun,142,30,112,0.00033345930684925416,0.0012439744985227805,0.7887323943661971
986,1827,자연스럽다/Adjective,142,112,30,0.0012449147455705488,0.000333207454961459,0.7887323943661971
987,1828,복잡하다/Adjective,142,92,50,0.0010226085410043797,0.0005553457582690984,0.647887323943662
988,1829,개성/Noun,142,87,55,0.0009670319898628369,0.0006108803340960082,0.6126760563380281
989,1831,달달/Noun,141,125,16,0.001389413778538559,0.00017771064264611146,0.8865248226950354
990,1832,어린시절/Noun,141,123,18,0.001367183158081942,0.00019992447297687542,0.8723404255319149
991,1833,정체/Noun,141,30,111,0.00033345930684925416,0.0012328675833573985,0.7872340425531915
992,1834,막장드라마/Noun,141,32,109,0.00035568992730587116,0.0012106537530266347,0.7730496453900709
993,1835,왠/Modifier,141,33,108,0.00036680523753417966,0.0011995468378612525,0.7659574468085106
994,1836,마이클/Noun,141,91,50,0.001011493230776071,0.0005553457582690984,0.6453900709219859
995,1842,♥♥/Foreign,140,140,0,0.001556143431963186,0.0,1.0
996,1843,숨기다/Verb,140,114,26,0.0012671453660271655,0.00028877979429993113,0.8142857142857143
997,1844,세월/Noun,140,105,35,0.0011671075739723895,0.0003887420307883688,0.75
998,1845,캐리/Noun,140,104,36,0.001155992263744081,0.00039984894595375083,0.7428571428571429
999,1846,변화/Noun,140,91,49,0.001011493230776071,0.0005442388431037163,0.65
1000,1847,빨다/Verb,140,54,86,0.0006002267523286575,0.0009551947042228492,0.6142857142857143
1001,1852,일품/Noun,139,126,13,0.0014005290887668675,0.00014438989714996554,0.9064748201438848
1002,1853,젠장/Noun,139,22,117,0.00024453682502278637,0.0012995090743496902,0.8417266187050358
1003,1854,기회/Noun,139,106,33,0.001178222884200698,0.00036652820045760486,0.7625899280575541
1004,1855,카리스마/Noun,139,105,34,0.0011671075739723895,0.00037763511562298685,0.7553956834532374
1005,1856,남아/Noun,139,97,42,0.0010781850921459217,0.00046649043694604257,0.6978417266187049
1006,1858,아/Noun,138,27,111,0.0003001133761643288,0.0012328675833573985,0.8043478260869565
1007,1859,칼/Noun,138,41,97,0.00045572771936064734,0.0010773707710420508,0.7028985507246377
1008,1860,신경/Noun,138,42,96,0.00046684302958895584,0.0010662638558766688,0.6956521739130435
1009,1861,자살/Noun,138,43,95,0.00047795833981726434,0.0010551569407112867,0.6884057971014492
1010,1862,오빠/Noun,138,95,43,0.0010559544716893046,0.0004775973521114245,0.6884057971014492
1011,1863,맨/Modifier,138,51,87,0.0005668808216437321,0.0009663016193882313,0.6304347826086957
1012,1869,포르노/Noun,137,16,121,0.00017784496365293558,0.001343936735011218,0.8832116788321168
1013,1870,C/Alpha,137,16,121,0.00017784496365293558,0.001343936735011218,0.8832116788321168
1014,1871,응원/Noun,137,116,21,0.0012893759864837828,0.00023324521847302128,0.8467153284671532
1015,1872,겨/Noun,137,26,111,0.00028899806593602026,0.0012328675833573985,0.8102189781021898
1016,1873,압권/Noun,137,111,26,0.0012337994353422404,0.00028877979429993113,0.8102189781021898
1017,1874,다양하다/Adjective,137,99,38,0.0011004157126025386,0.0004220627762845148,0.7226277372262774
1018,1875,모으다/Verb,137,39,98,0.0004334970989040304,0.001088477686207433,0.7153284671532847
1019,1876,형사/Noun,137,43,94,0.00047795833981726434,0.0010440500255459052,0.6861313868613139
1020,1877,만해/Noun,137,91,46,0.001011493230776071,0.0005109180976075704,0.6642335766423357
1021,1878,",,,,/Punctuation",137,50,87,0.0005557655114154236,0.0009663016193882313,0.635036496350365
1022,1879,잠깐/Noun,137,52,85,0.0005779961318720405,0.0009440877890574672,0.6204379562043796
1023,1886,시시하다/Adjective,136,23,113,0.00025565213525109487,0.0012550814136881624,0.8308823529411765
1024,1887,세번/Noun,136,110,26,0.001222684125113932,0.00028877979429993113,0.8088235294117647
1025,1888,냥/Josa,136,31,105,0.00034457461707756266,0.0011662260923651065,0.7720588235294118
1026,1889,만에/Josa,136,101,35,0.0011226463330591557,0.0003887420307883688,0.7426470588235294
1027,1890,내면/Noun,136,99,37,0.0011004157126025386,0.0004109558611191328,0.7279411764705882
1028,1891,성격/Noun,136,41,95,0.00045572771936064734,0.0010551569407112867,0.6985294117647058
1029,1892,선물/Noun,136,95,41,0.0010559544716893046,0.00045538352178066063,0.6985294117647058
1030,1893,동시/Noun,136,90,46,0.0010003779205477628,0.0005109180976075704,0.6617647058823529
1031,1897,에로영화/Noun,135,22,113,0.00024453682502278637,0.0012550814136881624,0.837037037037037
1032,1898,겨우/Noun,135,22,113,0.00024453682502278637,0.0012550814136881624,0.837037037037037
1033,1899,추하다/Adjective,135,108,27,0.001200453504657315,0.0002998867094653131,0.8
1034,1900,적임/Noun,135,96,39,0.0010670697819176133,0.0004331696914498967,0.7111111111111111
1035,1901,만족하다/Adjective,135,93,42,0.0010337238512326881,0.00046649043694604257,0.6888888888888889
1036,1902,형제/Noun,135,91,44,0.001011493230776071,0.0004887042672768067,0.674074074074074
1037,1903,조용하다/Adjective,135,90,45,0.0010003779205477628,0.0004998111824421885,0.6666666666666666
1038,1904,할머니/Noun,135,87,48,0.0009670319898628369,0.0005331319279383344,0.6444444444444445
1039,1910,야동/Noun,134,25,109,0.0002778827557077118,0.0012106537530266347,0.8134328358208955
1040,1911,롭고/Josa,134,108,26,0.001200453504657315,0.00028877979429993113,0.8059701492537313
1041,1912,당/Suffix,134,44,90,0.0004890736500455726,0.000999622364884377,0.6716417910447762
1042,1913,[/Punctuation,134,44,90,0.0004890736500455726,0.000999622364884377,0.6716417910447762
1043,1914,스럽지/Josa,134,87,47,0.0009670319898628369,0.0005220250127729526,0.6492537313432836
1044,1915,멈추다/Verb,134,84,50,0.0009336860591779117,0.0005553457582690984,0.6268656716417911
1045,1924,투자/Noun,133,20,113,0.00022230620456616945,0.0012550814136881624,0.849624060150376
1046,1925,레전드/Noun,133,108,25,0.001200453504657315,0.0002776728791345492,0.8120300751879699
1047,1926,지우다/Verb,133,30,103,0.00033345930684925416,0.0011440122620343426,0.7744360902255639
1048,1927,고통/Noun,133,95,38,0.0010559544716893046,0.0004220627762845148,0.7142857142857143
1049,1928,비현실적/Noun,133,41,92,0.00045572771936064734,0.0010218361952151409,0.6917293233082706
1050,1929,욕망/Noun,133,90,43,0.0010003779205477628,0.0004775973521114245,0.6766917293233082
1051,1930,쉬/Noun,133,90,43,0.0010003779205477628,0.0004775973521114245,0.6766917293233082
1052,1931,방영/Noun,133,85,48,0.0009448013694062199,0.0005331319279383344,0.6390977443609023
1053,1932,영혼/Noun,133,82,51,0.0009114554387212947,0.0005664526734344802,0.6165413533834586
1054,1937,진하다/Adjective,132,119,13,0.0013227219171687082,0.00014438989714996554,0.9015151515151516
1055,1938,초등학교/Noun,132,99,33,0.0011004157126025386,0.00036652820045760486,0.75
1056,1939,학년/Noun,132,96,36,0.0010670697819176133,0.00039984894595375083,0.7272727272727273
1057,1940,로그인/Noun,132,41,91,0.00045572771936064734,0.001010729280049759,0.6893939393939394
1058,1941,베/Noun,132,45,87,0.0005001889602738814,0.0009663016193882313,0.6590909090909091
1059,1942,을/Foreign,132,45,87,0.0005001889602738814,0.0009663016193882313,0.6590909090909091
1060,1943,특수/Noun,132,48,84,0.0005335348909588066,0.0009329808738920851,0.6363636363636364
1061,1944,감안/Noun,132,51,81,0.0005668808216437321,0.0008996601283959392,0.6136363636363636
1062,1950,M/Alpha,131,5,126,5.557655114154236e-05,0.0013994713108381278,0.9618320610687024
1063,1951,잠들다/Verb,131,17,114,0.00018896027388124405,0.001266188328853544,0.8702290076335878
1064,1952,감흥/Noun,131,19,112,0.00021119089433786097,0.0012439744985227805,0.8549618320610687
1065,1953,붙이다/Verb,131,21,110,0.00023342151479447792,0.0012217606681920164,0.8396946564885496
1066,1954,부럽다/Adjective,131,106,25,0.001178222884200698,0.0002776728791345492,0.8091603053435115
1067,1955,설득/Noun,131,30,101,0.00033345930684925416,0.0011217984317035787,0.7709923664122137
1068,1956,따로/Adverb,131,31,100,0.00034457461707756266,0.0011106915165381968,0.7633587786259542
1069,1957,]/Punctuation,131,38,93,0.000422381788675722,0.001032943110380523,0.7099236641221374
1070,1958,끝내주다/Adjective,131,91,40,0.001011493230776071,0.0004442766066152787,0.6946564885496184
1071,1959,놀랍다/Adjective,131,91,40,0.001011493230776071,0.0004442766066152787,0.6946564885496184
1072,1960,권/Suffix,131,84,47,0.0009336860591779117,0.0005220250127729526,0.6412213740458015
1073,1964,반하다/Adjective,130,112,18,0.0012449147455705488,0.00019992447297687542,0.8615384615384616
1074,1965,점준/Noun,130,23,107,0.00025565213525109487,0.0011884399226958706,0.823076923076923
1075,1966,인지도/Noun,130,26,104,0.00028899806593602026,0.0011551191771997243,0.8
1076,1967,x/Alpha,130,34,96,0.0003779205477624881,0.0010662638558766688,0.7384615384615385
1077,1968,루/Noun,130,36,94,0.000400151168219105,0.0010440500255459052,0.7230769230769231
1078,1969,기발하다/Adjective,130,92,38,0.0010226085410043797,0.0004220627762845148,0.7076923076923077
1079,1970,최강/Noun,130,88,42,0.0009781473000911457,0.00046649043694604257,0.676923076923077
1080,1971,주성치/Noun,130,81,49,0.0009003401284929863,0.0005442388431037163,0.6230769230769231
1081,1975,안습/Noun,129,16,113,0.00017784496365293558,0.0012550814136881624,0.875968992248062
1082,1976,우려/Noun,129,18,111,0.0002000755841095525,0.0012328675833573985,0.8604651162790697
1083,1977,기만/Noun,129,25,104,0.0002778827557077118,0.0011551191771997243,0.8062015503875969
1084,1978,조작/Noun,129,25,104,0.0002778827557077118,0.0011551191771997243,0.8062015503875969
1085,1979,고르다/Verb,129,29,100,0.0003223439966209457,0.0011106915165381968,0.7751937984496124
1086,1980,오랫/Modifier,129,97,32,0.0010781850921459217,0.00035542128529222287,0.751937984496124
1087,1981,스트레스/Noun,129,35,94,0.0003890358579907965,0.0010440500255459052,0.7286821705426356
1088,1982,색감/Noun,129,91,38,0.001011493230776071,0.0004220627762845148,0.7054263565891473
1089,1988,공짜/Noun,128,5,123,5.557655114154236e-05,0.001366150565341982,0.9609375
1090,1989,18/Number,128,28,100,0.0003112286863926372,0.0011106915165381968,0.78125
1091,1990,놀다/Verb,128,36,92,0.000400151168219105,0.0010218361952151409,0.71875
1092,1991,아무렇다/Adjective,128,37,91,0.00041126647844741344,0.001010729280049759,0.7109375
1093,1992,데리/Noun,128,41,87,0.00045572771936064734,0.0009663016193882313,0.6796875
1094,1993,포인트/Noun,128,42,86,0.00046684302958895584,0.0009551947042228492,0.671875
1095,1994,ㄱ/KoreanParticle,128,45,83,0.0005001889602738814,0.0009218739587267033,0.6484375
1096,1995,저러다/Verb,128,45,83,0.0005001889602738814,0.0009218739587267033,0.6484375
1097,1996,갑/Noun,128,83,45,0.0009225707489496033,0.0004998111824421885,0.6484375
1098,2001,정신병/Noun,127,21,106,0.00023342151479447792,0.0011773330075304884,0.8346456692913385
1099,2002,깨우다/Verb,127,105,22,0.0011671075739723895,0.00024435213363840333,0.8267716535433071
1100,2003,아예/Noun,127,26,101,0.00028899806593602026,0.0011217984317035787,0.7952755905511811
1101,2004,여러가지/Noun,127,95,32,0.0010559544716893046,0.00035542128529222287,0.7480314960629921
1102,2005,미가/Noun,127,94,33,0.0010448391614609964,0.00036652820045760486,0.7401574803149606
1103,2006,넘어가다/Verb,127,40,87,0.0004446124091323389,0.0009663016193882313,0.6850393700787402
1104,2015,틈/Noun,126,106,20,0.001178222884200698,0.00022213830330763932,0.8412698412698413
1105,2016,;;;;/Punctuation,126,26,100,0.00028899806593602026,0.0011106915165381968,0.7936507936507936
1106,2017,껏/Noun,126,28,98,0.0003112286863926372,0.001088477686207433,0.7777777777777778
1107,2018,위로/Noun,126,91,35,0.001011493230776071,0.0003887420307883688,0.7222222222222222
1108,2019,전쟁영화/Noun,126,88,38,0.0009781473000911457,0.0004220627762845148,0.6984126984126984
1109,2020,보고오다/Verb,126,78,48,0.0008669941978080608,0.0005331319279383344,0.6190476190476191
1110,2021,잔/Noun,126,49,77,0.0005446502011871152,0.0008552324677344116,0.6111111111111112
1111,2027,효/Noun,125,24,101,0.0002667674454794033,0.0011217984317035787,0.8079999999999999
1112,2028,용기/Noun,125,98,27,0.0010893004023742304,0.0002998867094653131,0.784
1113,2029,뜨겁다/Adjective,125,97,28,0.0010781850921459217,0.000310993624630695,0.7759999999999999
1114,2030,패/Noun,125,38,87,0.000422381788675722,0.0009663016193882313,0.696
1115,2031,공포물/Noun,125,40,85,0.0004446124091323389,0.0009440877890574672,0.68
1116,2032,근래/Noun,125,84,41,0.0009336860591779117,0.00045538352178066063,0.672
1117,2033,수고/Noun,125,82,43,0.0009114554387212947,0.0004775973521114245,0.6559999999999999
1118,2034,만남/Noun,125,80,45,0.0008892248182646778,0.0004998111824421885,0.64
1119,2039,말아먹다/Verb,124,12,112,0.00013338372273970166,0.0012439744985227805,0.9032258064516128
1120,2040,운명/Noun,124,93,31,0.0010337238512326881,0.00034431437012684104,0.75
1121,2041,연인/Noun,124,91,33,0.001011493230776071,0.00036652820045760486,0.7338709677419355
1122,2042,이용/Noun,124,38,86,0.000422381788675722,0.0009551947042228492,0.6935483870967742
1123,2043,",./Punctuation",124,41,83,0.00045572771936064734,0.0009218739587267033,0.6693548387096774
1124,2044,007/Number,124,79,45,0.0008781095080363692,0.0004998111824421885,0.6370967741935484
1125,2045,DVD/Alpha,124,79,45,0.0008781095080363692,0.0004998111824421885,0.6370967741935484
1126,2046,거짓말/Noun,124,46,78,0.0005113042705021896,0.0008663393828997934,0.6290322580645161
1127,2047,영화계/Noun,124,47,77,0.0005224195807304982,0.0008552324677344116,0.6209677419354839
1128,2053,썩다/Verb,123,33,90,0.00036680523753417966,0.000999622364884377,0.7317073170731707
1129,2054,확인/Noun,123,35,88,0.0003890358579907965,0.000977408534553613,0.7154471544715447
1130,2055,해결/Noun,123,42,81,0.00046684302958895584,0.0008996601283959392,0.6585365853658537
1131,2056,군/Noun,123,46,77,0.0005113042705021896,0.0008552324677344116,0.6260162601626016
1132,2064,았/Noun,122,13,109,0.00014449903296801013,0.0012106537530266347,0.8934426229508197
1133,2065,번은/Noun,122,102,20,0.0011337616432874642,0.00022213830330763932,0.8360655737704918
1134,2066,설마/Noun,122,22,100,0.00024453682502278637,0.0011106915165381968,0.819672131147541
1135,2067,결코/Noun,122,91,31,0.001011493230776071,0.00034431437012684104,0.7459016393442623
1136,2068,원/Noun,122,31,91,0.00034457461707756266,0.001010729280049759,0.7459016393442623
1137,2069,잖다/Verb,122,34,88,0.0003779205477624881,0.000977408534553613,0.7213114754098361
1138,2070,갠/Noun,122,84,38,0.0009336860591779117,0.0004220627762845148,0.6885245901639344
1139,2071,갖추다/Verb,122,82,40,0.0009114554387212947,0.0004442766066152787,0.6721311475409836
1140,2072,전에/Foreign,122,79,43,0.0008781095080363692,0.0004775973521114245,0.6475409836065574
1141,2078,낮추다/Verb,121,16,105,0.00017784496365293558,0.0011662260923651065,0.8677685950413223
1142,2079,셈/Noun,121,20,101,0.00022230620456616945,0.0011217984317035787,0.8347107438016529
1143,2080,변태/Noun,121,21,100,0.00023342151479447792,0.0011106915165381968,0.8264462809917356
1144,2081,심지어/Noun,121,31,90,0.00034457461707756266,0.000999622364884377,0.743801652892562
1145,2082,자르다/Verb,121,40,81,0.0004446124091323389,0.0008996601283959392,0.6694214876033058
1146,2086,잔뜩/Noun,120,15,105,0.00016672965342462708,0.0011662260923651065,0.875
1147,2087,5분/Number,120,18,102,0.0002000755841095525,0.0011329053468689607,0.85
1148,2088,크리스마스/Noun,120,89,31,0.000989262610319454,0.00034431437012684104,0.7416666666666667
1149,2089,X/Alpha,120,31,89,0.00034457461707756266,0.0009885154497189948,0.7416666666666667
1150,2090,스런/Josa,120,39,81,0.0004334970989040304,0.0008996601283959392,0.675
1151,2091,여러/Noun,120,79,41,0.0008781095080363692,0.00045538352178066063,0.6583333333333333
1152,2092,넘기다/Verb,120,43,77,0.00047795833981726434,0.0008552324677344116,0.6416666666666667
1153,2093,편도/Noun,120,77,43,0.0008558788875797522,0.0004775973521114245,0.6416666666666667
1154,2094,이래서/Josa,120,46,74,0.0005113042705021896,0.0008219117222382655,0.6166666666666667
1155,2100,전율/Noun,119,110,9,0.001222684125113932,9.996223648843771e-05,0.9243697478991596
1156,2101,둘째/Noun,119,14,105,0.0001556143431963186,0.0011662260923651065,0.8823529411764706
1157,2102,려고/Noun,119,23,96,0.00025565213525109487,0.0010662638558766688,0.8067226890756303
1158,2103,아동/Noun,119,28,91,0.0003112286863926372,0.001010729280049759,0.7647058823529411
1159,2104,그립다/Adjective,119,86,33,0.0009559166796345287,0.00036652820045760486,0.7226890756302521
1160,2105,탓/Noun,119,35,84,0.0003890358579907965,0.0009329808738920851,0.7058823529411765
1161,2106,뛰어넘다/Verb,119,83,36,0.0009225707489496033,0.00039984894595375083,0.6974789915966386
1162,2107,제외/Noun,119,43,76,0.00047795833981726434,0.0008441255525690295,0.6386554621848739
1163,2108,자주/Noun,119,76,43,0.0008447635773514439,0.0004775973521114245,0.6386554621848739
1164,2116,오빠/Suffix,118,106,12,0.001178222884200698,0.0001332829819845836,0.8983050847457628
1165,2117,작위/Noun,118,17,101,0.00018896027388124405,0.0011217984317035787,0.8559322033898306
1166,2118,대본/Noun,118,24,94,0.0002667674454794033,0.0010440500255459052,0.7966101694915254
1167,2119,부모님/Noun,118,89,29,0.000989262610319454,0.00032210053979607705,0.7542372881355932
1168,2120,톰/Noun,118,83,35,0.0009225707489496033,0.0003887420307883688,0.7033898305084746
1169,2121,두번째/Noun,118,81,37,0.0009003401284929863,0.0004109558611191328,0.6864406779661016
1170,2122,에나/Josa,118,38,80,0.000422381788675722,0.0008885532132305574,0.6779661016949152
1171,2126,:)/Punctuation,117,114,3,0.0012671453660271655,3.33207454961459e-05,0.9743589743589745
1172,2127,한개/Modifier,117,10,107,0.00011115310228308472,0.0011884399226958706,0.9145299145299144
1173,2128,애쓰다/Verb,117,25,92,0.0002778827557077118,0.0010218361952151409,0.7863247863247863
1174,2129,하나같이/Adverb,117,28,89,0.0003112286863926372,0.0009885154497189948,0.7606837606837606
1175,2130,가족영화/Noun,117,77,40,0.0008558788875797522,0.0004442766066152787,0.6581196581196581
1176,2131,케릭/Noun,117,44,73,0.0004890736500455726,0.0008108048070728836,0.6239316239316239
1177,2139,그만/Modifier,116,9,107,0.00010003779205477625,0.0011884399226958706,0.9224137931034484
1178,2140,하자/Noun,116,24,92,0.0002667674454794033,0.0010218361952151409,0.7931034482758621
1179,2141,정작/Noun,116,29,87,0.0003223439966209457,0.0009663016193882313,0.75
1180,2142,거나/Noun,116,33,83,0.00036680523753417966,0.0009218739587267033,0.7155172413793104
1181,2143,신의/Noun,116,79,37,0.0008781095080363692,0.0004109558611191328,0.6810344827586207
1182,2144,장가/Noun,116,37,79,0.00041126647844741344,0.0008774462980651753,0.6810344827586207
1183,2145,무료/Noun,116,40,76,0.0004446124091323389,0.0008441255525690295,0.6551724137931034
1184,2146,예/Noun,116,40,76,0.0004446124091323389,0.0008441255525690295,0.6551724137931034
1185,2147,꺼/Suffix,116,40,76,0.0004446124091323389,0.0008441255525690295,0.6551724137931034
1186,2152,대놓고/Adverb,115,17,98,0.00018896027388124405,0.001088477686207433,0.8521739130434782
1187,2153,ㅠㅜ/KoreanParticle,115,89,26,0.000989262610319454,0.00028877979429993113,0.7739130434782608
1188,2154,소년/Noun,115,84,31,0.0009336860591779117,0.00034431437012684104,0.7304347826086957
1189,2155,열연/Noun,115,80,35,0.0008892248182646778,0.0003887420307883688,0.6956521739130435
1190,2156,성은/Noun,115,36,79,0.000400151168219105,0.0008774462980651753,0.6869565217391305
1191,2157,목적/Noun,115,37,78,0.00041126647844741344,0.0008663393828997934,0.6782608695652174
1192,2158,충실하다/Adjective,115,77,38,0.0008558788875797522,0.0004220627762845148,0.6695652173913044
1193,2159,의심/Noun,115,40,75,0.0004446124091323389,0.0008330186374036475,0.6521739130434783
1194,2160,메/Noun,115,75,40,0.0008336482671231353,0.0004442766066152787,0.6521739130434783
1195,2161,낫/Noun,115,43,72,0.00047795833981726434,0.0007996978919075017,0.6260869565217392
1196,2162,으리/Noun,115,71,44,0.0007891870262099014,0.0004887042672768067,0.6173913043478261
1197,2166,힘내다/Verb,114,95,19,0.0010559544716893046,0.00021103138814225735,0.8333333333333334
1198,2167,겪다/Verb,114,87,27,0.0009670319898628369,0.0002998867094653131,0.7631578947368421
1199,2168,씹다/Verb,114,31,83,0.00034457461707756266,0.0009218739587267033,0.7280701754385965
