,Unnamed: 0,parameter,counts,counts_H,counts_NH,p_from_H,p_from_NH,priority
0,22,재밌다/Adjective,11789,9955,1834,0.11065291332281084,0.02037008241331053,0.8444312494698448
1,44,최고/Noun,6671,6143,528,0.06828135073249894,0.005864451207321679,0.9208514465597362
2,55,감동/Noun,5597,4442,1155,0.04937420803414623,0.012828487016016172,0.7936394497051992
3,62,아깝다/Adjective,5167,374,4793,0.004157126025387369,0.053235444387675766,0.9276175730598026
4,69,재미있다/Adjective,4787,4102,685,0.04559500255652135,0.0076082368882866465,0.8569041153123041
5,76,뭐/Noun,4491,831,3660,0.009236822799724341,0.040651309505298,0.8149632598530394
6,84,재미없다/Adjective,4205,307,3898,0.003412400240090701,0.043294755314658914,0.9269916765755052
7,88,지루하다/Adjective,4057,872,3185,0.009692550519084988,0.03537552480174157,0.7850628543258565
8,91,!!/Punctuation,4005,3088,917,0.03432407798501656,0.010185041206655265,0.7710362047440699
9,94,쓰레기/Noun,3739,209,3530,0.002323099837716471,0.03920741053379834,0.9441027012570206
10,105,다시/Noun,3289,2763,526,0.030711602160816313,0.005842237376990914,0.8400729705077531
11,109,사랑/Noun,3190,2523,667,0.028043927706022275,0.007408312415309772,0.7909090909090909
12,124,안되다/Adjective,2683,658,2025,0.007313874130226975,0.022491503209898484,0.7547521431233694
13,133,최악/Noun,2549,32,2517,0.00035568992730587116,0.02795610547126641,0.9874460572773636
14,140,별로/Noun,2438,320,2118,0.003556899273058711,0.02352444632027901,0.8687448728465955
15,142,돈/Noun,2433,279,2154,0.003101171553698064,0.02392429526623276,0.8853267570900123
16,151,명작/Noun,2259,1976,283,0.02196385301113754,0.0031432569918030968,0.8747233289065959
17,157,^^/Punctuation,2162,1921,241,0.021352510948580573,0.002676766554857054,0.8885291396854764
18,160,ㅡㅡ/KoreanParticle,2128,211,1917,0.002345330458173088,0.02129195637203723,0.9008458646616542
19,173,꼭/Noun,1920,1594,326,0.0177178045039237,0.003620854343914521,0.8302083333333333
20,177,아름답다/Adjective,1901,1659,242,0.01844029966876376,0.002687873470022436,0.8726985796948974
21,181,마음/Noun,1810,1497,313,0.016639619411777783,0.0034764644467645558,0.8270718232044199
22,191,ㅎㅎ/KoreanParticle,1744,1498,246,0.01665073472200609,0.002732301130683964,0.8589449541284404
23,197,어리다/Verb,1690,1270,420,0.014116443989951759,0.004664904369460426,0.7514792899408284
24,198,재다/Verb,1675,1417,258,0.015750394593513104,0.002865584112668547,0.8459701492537314
25,202,수준/Noun,1658,273,1385,0.003034479692328213,0.015383077504054024,0.8353437876960192
26,215,가슴/Noun,1575,1376,199,0.015294666874152455,0.0022102761179110114,0.8736507936507937
27,216,낮다/Adjective,1560,1254,306,0.013938599026298824,0.003398716040606882,0.8038461538461539
28,217,말다/Verb,1559,338,1221,0.003756974857168264,0.01356154341693138,0.7831943553559975
29,220,야/Josa,1543,373,1170,0.00414601071515906,0.012995090743496902,0.7582631237848347
30,222,높다/Adjective,1536,327,1209,0.003634706444656871,0.013428260434946798,0.787109375
31,226,;;/Punctuation,1523,373,1150,0.00414601071515906,0.012772952440189262,0.7550886408404465
32,228,슬프다/Adjective,1504,1292,212,0.014360980814974547,0.002354666015060977,0.8590425531914894
33,231,멋지다/Adjective,1475,1271,204,0.014127559300180068,0.002265810693737921,0.8616949152542372
34,239,유치하다/Adjective,1442,282,1160,0.003134517484382989,0.01288402159184308,0.8044382801664355
35,247,무슨/Noun,1408,215,1193,0.002389791699086321,0.013250549792300687,0.8473011363636364
36,250,냐/Josa,1392,169,1223,0.001878487428584132,0.013583757247262143,0.8785919540229885
37,254,눈물/Noun,1378,1156,222,0.012849298623924595,0.002465735166714797,0.8388969521044993
38,270,허다/Verb,1294,206,1088,0.0022897539070315448,0.01208432369993558,0.8408037094281299
39,273,짜증나다/Adjective,1251,81,1170,0.0009003401284929863,0.012995090743496902,0.9352517985611509
40,278,찍다/Verb,1231,259,972,0.0028788653491318944,0.010795921540751272,0.7896019496344435
41,284,여운/Noun,1210,1139,71,0.01266033835004335,0.0007885909767421196,0.9413223140495868
42,292,대박/Noun,1180,975,205,0.010837427472600759,0.002276917608903303,0.826271186440678
43,300,굿/Noun,1156,1072,84,0.01191561256474668,0.0009329808738920851,0.9273356401384084
44,310,실망/Noun,1118,115,1003,0.0012782606762554744,0.011140235910878113,0.8971377459749553
45,319,건지다/Verb,1093,195,898,0.002167485494520152,0.009974009818513006,0.8215919487648673
46,327,귀엽다/Adjective,1069,881,188,0.009792588311139765,0.0020881000510918103,0.8241347053320861
47,338,ㅎ/KoreanParticle,1048,840,208,0.009336860591779116,0.0023102383543994486,0.8015267175572519
48,341,OO/Alpha,1033,220,813,0.002445368250227864,0.009029922029455541,0.7870280735721199
49,345,잔잔하다/Adjective,1023,897,126,0.0099704332747927,0.0013994713108381278,0.8768328445747801
50,349,점도/Noun,1011,91,920,0.001011493230776071,0.010218361952151409,0.9099901088031652
51,353,떨어지다/Verb,997,207,790,0.002300869217259854,0.008774462980651754,0.7923771313941825
52,358,급/Noun,974,237,737,0.0026343285241091077,0.00818579647688651,0.7566735112936345
53,374,작가/Noun,929,209,720,0.002323099837716471,0.007996978919075016,0.77502691065662
54,379,욕/Noun,910,166,744,0.0018451414978992067,0.008263544883044184,0.8175824175824176
55,380,차라리/Noun,909,59,850,0.0006558033034701999,0.009440877890574672,0.935093509350935
56,383,깊다/Adjective,907,808,99,0.008981170664473246,0.0010995846013728146,0.8908489525909592
57,385,짱/Noun,905,842,63,0.009359091212235734,0.0006997356554190639,0.9303867403314916
58,387,울다/Verb,900,695,205,0.007725140608674388,0.002276917608903303,0.7722222222222223
59,388,알바/Noun,897,104,793,0.001155992263744081,0.0088077837261479,0.8840579710144928
60,390,0/Number,888,77,811,0.0008558788875797522,0.009007708199124777,0.9132882882882885
61,392,따뜻하다/Adjective,884,833,51,0.009259053420180956,0.0005664526734344802,0.9423076923076924
62,394,삶/Noun,883,770,113,0.008558788875797524,0.0012550814136881624,0.8720271800679502
63,399,오랜/Modifier,870,699,171,0.007769601849587622,0.0018992824932803163,0.8034482758620691
64,410,아직도/Adverb,841,631,210,0.0070137607540626465,0.002332452184730213,0.7502972651605232
65,411,어설프다/Adjective,834,79,755,0.0008781095080363692,0.008385720949863385,0.9052757793764988
66,412,막장/Noun,834,144,690,0.00160060467287642,0.007663771464113556,0.8273381294964028
67,416,훌륭하다/Adjective,825,663,162,0.007369450681368517,0.0017993202567918784,0.8036363636363636
68,422,도대체/Noun,805,101,704,0.0011226463330591557,0.007819268276428905,0.8745341614906832
69,426,생각나다/Verb,795,647,148,0.007191605717715582,0.001643823444476531,0.8138364779874214
70,427,류/Noun,790,141,649,0.0015672587421914947,0.007208387942332897,0.8215189873417722
71,433,뭘/Noun,782,175,607,0.0019451792899539827,0.006741897505386854,0.7762148337595908
72,441,수작/Noun,766,696,70,0.007736255918902695,0.0007774840615767378,0.908616187989556
73,444,설정/Noun,762,139,623,0.0015450281217348775,0.006919608148032965,0.8175853018372703
74,449,필요없다/Adjective,754,630,124,0.0070026454438343365,0.0013772574805073642,0.8355437665782494
75,452,싫다/Adjective,746,130,616,0.001444990329680101,0.006841859741875293,0.8257372654155496
76,461,멋있다/Adjective,732,615,117,0.006835915790409711,0.0012995090743496902,0.8401639344262295
77,466,노잼/Noun,724,17,707,0.00018896027388124405,0.00785258902192505,0.9765193370165746
78,468,뭔/Modifier,722,104,618,0.001155992263744081,0.006864073572206054,0.8559556786703602
79,470,답답하다/Adjective,719,131,588,0.0014561056399084098,0.006530866117244597,0.8178025034770514
80,471,아프다/Adjective,719,559,160,0.006213458417624436,0.0017771064264611148,0.7774687065368567
81,477,최고다/Noun,711,679,32,0.007547295645021453,0.00035542128529222287,0.9549929676511956
82,480,OOO/Alpha,708,91,617,0.001011493230776071,0.006852966657040674,0.8714689265536724
83,482,지루함/Noun,707,100,607,0.0011115310228308473,0.006741897505386854,0.8585572842998586
84,483,추억/Noun,707,576,131,0.00640241869150568,0.0014550058866650375,0.8147100424328148
85,489,이딴/Modifier,703,26,677,0.00028899806593602026,0.007519381566963592,0.9630156472261736
86,490,더럽다/Adjective,701,81,620,0.0009003401284929863,0.00688628740253682,0.8844507845934381
87,495,인상/Noun,689,547,142,0.006080074694884734,0.0015771819534842392,0.7939042089985486
88,497,어이없다/Adjective,686,55,631,0.000611342062556966,0.007008463469356021,0.9198250728862972
89,507,접/Noun,676,122,554,0.0013560678478536335,0.006153231001621609,0.8195266272189349
90,509,잊다/Verb,674,570,104,0.006335726830135829,0.0011551191771997243,0.8456973293768546
91,510,졸작/Noun,672,34,638,0.0003779205477624881,0.007086211875513696,0.949404761904762
92,514,아무리/Adverb,666,114,552,0.0012671453660271655,0.006131017171290846,0.8288288288288288
93,517,♥/Foreign,660,651,9,0.007236066958628815,9.996223648843771e-05,0.9863636363636364
94,521,함께/Adverb,656,544,112,0.00604672876419981,0.0012439744985227805,0.8292682926829268
95,527,대해/Noun,651,506,145,0.0056243469755240865,0.001610502698980385,0.7772657450076805
96,529,어색하다/Adjective,642,123,519,0.001367183158081942,0.005764488970833241,0.8084112149532711
97,534,엉/Exclamation,636,103,533,0.0011448769535157724,0.005919985783148589,0.8380503144654088
98,539,개연/Noun,630,55,575,0.000611342062556966,0.006386476220094631,0.9126984126984128
99,540,망하다/Adjective,630,89,541,0.000989262610319454,0.006008841104471644,0.8587301587301587
100,550,진부하다/Adjective,618,109,509,0.0012115688148856235,0.005653419819179421,0.8236245954692557
101,555,ㅠㅠㅠ/KoreanParticle,611,496,115,0.0055131938732410025,0.0012772952440189265,0.8117839607201309
102,562,유쾌하다/Adjective,603,554,49,0.006157881866482894,0.0005442388431037163,0.9187396351575456
103,566,완벽하다/Adjective,599,512,87,0.0056910388368939385,0.0009663016193882313,0.8547579298831386
104,567,질/Noun,599,104,495,0.001155992263744081,0.0054979230068640745,0.8263772954924875
105,578,강추/Noun,590,547,43,0.006080074694884734,0.0004775973521114245,0.9271186440677966
106,579,행복하다/Adjective,590,524,66,0.005824422559633639,0.0007330564009152097,0.8881355932203391
107,593,즐겁다/Adjective,573,495,78,0.0055020785630126925,0.0008663393828997934,0.8638743455497382
108,597,머/Noun,570,97,473,0.0010781850921459217,0.005253570873225671,0.8298245614035088
109,601,꽤/Noun,562,441,121,0.004901851810684036,0.001343936735011218,0.7846975088967971
110,603,짜증/Noun,558,23,535,0.00025565213525109487,0.005942199613479352,0.9587813620071683
111,608,ㅎㅎㅎ/KoreanParticle,555,434,121,0.0048240446390858775,0.001343936735011218,0.781981981981982
112,619,건가/Noun,546,124,422,0.0013782984683102506,0.00468711819979119,0.7728937728937729
113,626,소름/Noun,540,437,103,0.004857390569770802,0.0011440122620343426,0.8092592592592592
114,627,심하다/Adjective,539,81,458,0.0009003401284929863,0.005086967145744941,0.8497217068645642
115,628,충분하다/Adjective,539,414,125,0.004601738434519708,0.001388364395672746,0.7680890538033395
116,632,걸작/Noun,533,459,74,0.005101927394793589,0.0008219117222382655,0.8611632270168855
117,633,그나마/Adverb,532,40,492,0.0004446124091323389,0.005464602261367928,0.924812030075188
118,634,억지/Noun,527,72,455,0.00080030233643821,0.005053646400248795,0.8633776091081594
119,635,대체/Noun,527,89,438,0.000989262610319454,0.004864828842437301,0.8311195445920304
120,638,시절/Noun,526,397,129,0.004412778160638464,0.0014327920563342734,0.7547528517110266
121,640,존나/Noun,525,122,403,0.0013560678478536335,0.004476086811648933,0.7676190476190476
122,659,순수하다/Adjective,506,433,73,0.0048129293288575676,0.0008108048070728836,0.8557312252964426
123,660,휴/Exclamation,506,86,420,0.0009559166796345287,0.004664904369460426,0.8300395256916996
124,670,만점/Noun,501,423,78,0.004701776226574484,0.0008663393828997934,0.844311377245509
125,675,간만/Noun,496,400,96,0.004446124091323389,0.0010662638558766688,0.8064516129032258
126,684,~!/Punctuation,487,385,102,0.004279394437898762,0.0011329053468689607,0.7905544147843943
127,697,발연기/Noun,477,34,443,0.0003779205477624881,0.004920363418264211,0.9287211740041929
128,707,ㅉㅉ/KoreanParticle,466,72,394,0.00080030233643821,0.004376124575160495,0.8454935622317596
129,710,꿈/Noun,465,353,112,0.003923704510592891,0.0012439744985227805,0.7591397849462366
130,714,에요/Josa,461,357,104,0.003968165751506125,0.0011551191771997243,0.7744034707158352
131,722,;;;/Punctuation,457,106,351,0.001178222884200698,0.0038985272230490703,0.7680525164113785
132,723,사랑스럽다/Adjective,456,433,23,0.0048129293288575676,0.0002554590488037852,0.949561403508772
133,724,돋다/Verb,454,348,106,0.0038681279594513476,0.0011773330075304884,0.7665198237885462
134,730,이라도/Josa,446,106,340,0.001178222884200698,0.0037763511562298687,0.7623318385650224
135,732,감사하다/Verb,445,404,41,0.004490585332236623,0.00045538352178066063,0.907865168539326
136,746,삼류/Noun,433,33,400,0.00036680523753417966,0.004442766066152787,0.9237875288683602
137,747,몇번/Noun,431,334,97,0.00371251361625503,0.0010773707710420508,0.7749419953596288
138,762,질질/Noun,419,72,347,0.00080030233643821,0.003854099562387543,0.8281622911694511
139,770,점주/Noun,415,98,317,0.0010893004023742304,0.0035208921074260835,0.763855421686747
140,773,망치다/Verb,414,42,372,0.00046684302958895584,0.004131772441522092,0.8985507246376812
141,774,답/Noun,413,100,313,0.0011115310228308473,0.0034764644467645558,0.7578692493946732
142,777,성하다/Adjective,410,37,373,0.00041126647844741344,0.0041428793566874724,0.9097560975609756
143,779,낭비/Noun,408,8,400,8.892248182646779e-05,0.004442766066152787,0.9803921568627452
144,797,이하/Noun,395,34,361,0.0003779205477624881,0.00400959637470289,0.9139240506329114
145,802,너무하다/Adjective,390,50,340,0.0005557655114154236,0.0037763511562298687,0.8717948717948718
146,803,의도/Noun,390,66,324,0.0007336104750683593,0.003598640513583757,0.8307692307692308
147,804,발/Noun,390,81,309,0.0009003401284929863,0.003432036786103028,0.7923076923076923
148,810,넣다/Verb,385,86,299,0.0009559166796345287,0.0033209676344492078,0.7766233766233767
149,815,오글거리다/Verb,384,63,321,0.0007002645443834338,0.0035653197680876117,0.8359375
150,821,굳다/Adjective,381,349,32,0.003879243269679657,0.00035542128529222287,0.9160104986876642
151,855,짱/Suffix,361,320,41,0.003556899273058711,0.00045538352178066063,0.8864265927977839
152,862,이에요/Josa,358,286,72,0.003178978725296223,0.0007996978919075017,0.7988826815642458
153,863,더욱/Noun,358,281,77,0.0031234021741546806,0.0008552324677344116,0.7849162011173184
154,866,탄탄하다/Adjective,357,320,37,0.003556899273058711,0.0004109558611191328,0.8963585434173671
155,867,돋보이다/Verb,357,275,82,0.00305671031278483,0.0009107670435613213,0.7703081232492998
156,870,어이/Noun,355,29,326,0.0003223439966209457,0.003620854343914521,0.9183098591549296
157,874,참고/Noun,354,65,289,0.0007224951648400508,0.003209898482795389,0.8163841807909604
158,880,흐르다/Verb,352,282,70,0.003134517484382989,0.0007774840615767378,0.8011363636363636
159,881,그녀/Noun,352,266,86,0.0029566725207300537,0.0009551947042228492,0.7556818181818182
160,882,억지스럽다/Adjective,351,50,301,0.0005557655114154236,0.003343181464779972,0.8575498575498576
161,894,이냐/Josa,345,47,298,0.0005224195807304982,0.003309860719283826,0.8637681159420291
162,896,허무하다/Adjective,344,85,259,0.0009448013694062199,0.002876691027833929,0.7529069767441859
163,899,술/Noun,342,58,284,0.0006446879932418914,0.0031543639069684785,0.8304093567251462
164,900,전형/Noun,342,64,278,0.0007113798546117423,0.0030877224159761873,0.8128654970760234
165,904,잠/Noun,339,82,257,0.0009114554387212947,0.0028544771975031647,0.7581120943952803
166,910,화이팅/Noun,334,296,38,0.003290131827579308,0.0004220627762845148,0.8862275449101796
167,915,식상하다/Adjective,333,37,296,0.00041126647844741344,0.003287646888953062,0.8888888888888888
168,921,꿀잼/Noun,330,316,14,0.003512438032145477,0.0001554968123153475,0.9575757575757576
169,922,똥/Noun,330,29,301,0.0003223439966209457,0.003343181464779972,0.912121212121212
170,931,-_-/Punctuation,327,38,289,0.000422381788675722,0.003209898482795389,0.8837920489296636
171,938,엉망/Noun,326,22,304,0.00024453682502278637,0.003376502210276118,0.9325153374233128
172,939,병맛/Noun,326,57,269,0.0006335726830135829,0.0029877601794877488,0.8251533742331288
173,951,지겹다/Adjective,323,29,294,0.0003223439966209457,0.0032654330586222983,0.9102167182662538
174,952,미화/Noun,323,44,279,0.0004890736500455726,0.003098829331141569,0.8637770897832817
175,953,~!!/Punctuation,323,253,70,0.0028121734877620433,0.0007774840615767378,0.7832817337461301
176,962,흥미진진/Noun,321,276,45,0.0030678256230131378,0.0004998111824421885,0.8598130841121495
177,967,훈훈하다/Adjective,319,281,38,0.0031234021741546806,0.0004220627762845148,0.8808777429467085
178,969,잘만/Noun,318,239,79,0.002656559144565725,0.0008774462980651753,0.7515723270440252
179,972,만으로도/Josa,316,285,31,0.0031678634150679144,0.00034431437012684104,0.9018987341772152
180,976,비추다/Verb,315,48,267,0.0005335348909588066,0.0029655463491569853,0.8476190476190476
181,982,그래픽/Noun,314,78,236,0.0008669941978080608,0.002621231979030144,0.7515923566878981
182,983,ost/Alpha,313,265,48,0.002945557210501745,0.0005331319279383344,0.8466453674121406
183,987,그만/Adverb,312,21,291,0.00023342151479447792,0.0032321123131261523,0.9326923076923076
184,991,성우/Noun,310,70,240,0.000778071715981593,0.002665659639691672,0.7741935483870968
185,997,유치/Noun,306,21,285,0.00023342151479447792,0.003165470822133861,0.931372549019608
186,999,도저히/Noun,305,26,279,0.00028899806593602026,0.003098829331141569,0.9147540983606556
187,1000,한심하다/Adjective,305,33,272,0.00036680523753417966,0.003021080924983895,0.8918032786885246
188,1001,식/Noun,305,72,233,0.00080030233643821,0.002587911233533998,0.7639344262295082
189,1006,역겹다/Adjective,304,37,267,0.00041126647844741344,0.0029655463491569853,0.8782894736842105
190,1007,울/Noun,304,228,76,0.0025342907320543315,0.0008441255525690295,0.75
191,1016,천재/Noun,301,236,65,0.0026232132138807995,0.0007219494857498278,0.7840531561461794
192,1018,억지로/Noun,300,42,258,0.00046684302958895584,0.002865584112668547,0.86
193,1019,우연히/Adverb,300,258,42,0.0028677500389035857,0.00046649043694604257,0.86
194,1026,속/Modifier,296,73,223,0.0008114176466665183,0.002476842081880179,0.7533783783783784
195,1029,개다/Verb,295,73,222,0.0008114176466665183,0.002465735166714797,0.7525423728813561
196,1031,척/Noun,294,58,236,0.0006446879932418914,0.002621231979030144,0.8027210884353742
197,1032,예고편/Noun,294,69,225,0.0007669564057532844,0.002499055912210943,0.7653061224489796
198,1042,잊혀지다/Verb,289,255,34,0.002834404108218661,0.00037763511562298685,0.8823529411764706
199,1046,대작/Noun,288,231,57,0.002567636662739257,0.0006330941644267722,0.8020833333333334
200,1068,실망하다/Adjective,283,60,223,0.0006669186136985082,0.002476842081880179,0.7879858657243817
201,1069,짓/Noun,283,70,213,0.000778071715981593,0.002365772930226359,0.7526501766784452
202,1073,오래/Adverb,282,230,52,0.002556521352510949,0.0005775595885998622,0.8156028368794326
203,1077,그닥/Noun,280,25,255,0.0002778827557077118,0.0028322633671724017,0.9107142857142856
204,1082,산/Noun,279,67,212,0.0007447257852966678,0.002354666015060977,0.7598566308243727
205,1085,빠져들다/Verb,278,264,14,0.0029344419002734373,0.0001554968123153475,0.9496402877697842
206,1086,흘리다/Verb,278,211,67,0.002345330458173088,0.0007441633160805918,0.7589928057553957
207,1090,♡/Foreign,276,264,12,0.0029344419002734373,0.0001332829819845836,0.9565217391304348
208,1096,쩔다/Verb,274,216,58,0.00240090700931463,0.0006442010795921541,0.7883211678832117
209,1099,제작비/Noun,273,38,235,0.000422381788675722,0.002610125063864762,0.8608058608058609
210,1100,영원하다/Adjective,273,231,42,0.002567636662739257,0.00046649043694604257,0.8461538461538461
211,1101,예요/Josa,273,206,67,0.0022897539070315448,0.0007441633160805918,0.7545787545787546
212,1106,통해/Noun,271,217,54,0.0024120223195429388,0.0005997734189306263,0.8007380073800738
213,1114,망작/Noun,268,16,252,0.00017784496365293558,0.002798942621676256,0.9402985074626866
214,1120,드럽다/Adjective,266,24,242,0.0002667674454794033,0.002687873470022436,0.9097744360902256
215,1130,예산/Noun,264,65,199,0.0007224951648400508,0.0022102761179110114,0.7537878787878788
216,1138,멍청하다/Adjective,260,38,222,0.000422381788675722,0.002465735166714797,0.8538461538461538
217,1139,강/Noun,260,197,63,0.002189716114976769,0.0006997356554190639,0.7576923076923077
218,1161,낚/Noun,254,20,234,0.00022230620456616945,0.0025990181486993803,0.9212598425196852
219,1169,반개/Noun,251,5,246,5.557655114154236e-05,0.002732301130683964,0.9800796812749004
220,1170,짱/VerbPrefix,251,225,26,0.0025009448013694068,0.00028877979429993113,0.896414342629482
221,1171,지루/Noun,250,21,229,0.00023342151479447792,0.0025434835728724704,0.9159999999999999
222,1173,황당하다/Adjective,249,38,211,0.000422381788675722,0.002343559099895595,0.8473895582329317
223,1181,졸리다/Verb,247,27,220,0.0003001133761643288,0.0024435213363840328,0.8906882591093117
224,1182,용도/Noun,247,57,190,0.0006335726830135829,0.0021103138814225733,0.7692307692307693
225,1183,희망/Noun,246,210,36,0.002334215147944779,0.00039984894595375083,0.8536585365853658
226,1186,위대하다/Adjective,245,185,60,0.002056332392237067,0.000666414909922918,0.7551020408163265
227,1202,기세/Noun,242,7,235,7.78071715981593e-05,0.002610125063864762,0.9710743801652892
228,1213,노출/Noun,240,57,183,0.0006335726830135829,0.0020325654752649,0.7625
229,1216,살아가다/Verb,239,217,22,0.0024120223195429388,0.00024435213363840333,0.9079497907949792
230,1224,대안/Noun,237,199,38,0.002211946735433386,0.0004220627762845148,0.8396624472573839
231,1226,산만하다/Adjective,236,19,217,0.00021119089433786097,0.002410200590887887,0.9194915254237288
232,1228,미소/Noun,235,212,23,0.002356445768401396,0.0002554590488037852,0.9021276595744679
233,1233,설레다/Adjective,234,212,22,0.002356445768401396,0.00024435213363840333,0.9059829059829059
234,1236,OST/Alpha,233,191,42,0.0021230242536069183,0.00046649043694604257,0.8197424892703863
235,1242,지나치다/Verb,230,55,175,0.000611342062556966,0.0019437101539418445,0.7608695652173914
236,1249,왠만하다/Adjective,228,20,208,0.00022230620456616945,0.0023102383543994486,0.912280701754386
237,1250,멋/Noun,228,174,54,0.0019340639797256738,0.0005997734189306263,0.7631578947368421
238,1260,손발/Noun,225,22,203,0.00024453682502278637,0.002254703778572539,0.9022222222222224
239,1262,고맙다/Adjective,224,180,44,0.002000755841095525,0.0004887042672768067,0.8035714285714286
240,1264,졸다/Verb,223,13,210,0.00014449903296801013,0.002332452184730213,0.9417040358744396
241,1265,굳이/Noun,223,45,178,0.0005001889602738814,0.0019770308994379896,0.7982062780269058
242,1271,거지같다/Adjective,222,19,203,0.00021119089433786097,0.002254703778572539,0.9144144144144144
243,1277,별루/Noun,220,12,208,0.00013338372273970166,0.0023102383543994486,0.9454545454545454
244,1278,슬픔/Noun,220,192,28,0.0021341395638352265,0.000310993624630695,0.8727272727272727
245,1284,포장/Noun,219,20,199,0.00022230620456616945,0.0022102761179110114,0.9086757990867579
246,1285,주기/Noun,219,40,179,0.0004446124091323389,0.001988137814603372,0.817351598173516
247,1287,ㅅㅂ/KoreanParticle,218,20,198,0.00022230620456616945,0.0021991692027456293,0.908256880733945
248,1297,광고/Noun,216,47,169,0.0005224195807304982,0.0018770686629495524,0.7824074074074074
249,1300,짱/Modifier,215,181,34,0.0020118711513238334,0.00037763511562298685,0.8418604651162791
250,1309,눈물나다/Verb,213,183,30,0.0020341017717804503,0.000333207454961459,0.8591549295774648
251,1312,성도/Noun,212,25,187,0.0002778827557077118,0.002076993135926428,0.8820754716981132
252,1313,한계/Noun,212,38,174,0.000422381788675722,0.0019326032387764625,0.8207547169811321
253,1314,그럭저럭/Adverb,212,52,160,0.0005779961318720405,0.0017771064264611148,0.7547169811320755
254,1323,~^^/Punctuation,211,202,9,0.0022452926661183114,9.996223648843771e-05,0.957345971563981
255,1329,깔끔하다/Adjective,210,167,43,0.001856256808127515,0.0004775973521114245,0.7952380952380952
256,1333,발견/Noun,209,175,34,0.0019451792899539827,0.00037763511562298685,0.8373205741626795
257,1339,개도/Noun,208,25,183,0.0002778827557077118,0.0020325654752649,0.8798076923076923
258,1344,짱짱/Noun,207,199,8,0.002211946735433386,8.885532132305573e-05,0.961352657004831
259,1345,부족/Noun,207,29,178,0.0003223439966209457,0.0019770308994379896,0.8599033816425121
260,1346,지난/Noun,207,159,48,0.0017673343263010473,0.0005331319279383344,0.7681159420289855
261,1352,대충/Noun,206,37,169,0.00041126647844741344,0.0018770686629495524,0.8203883495145631
262,1360,감탄/Noun,205,177,28,0.0019674099104106,0.000310993624630695,0.8634146341463415
263,1367,시청자/Noun,204,41,163,0.00045572771936064734,0.001810427171957261,0.7990196078431373
264,1368,홍보/Noun,204,43,161,0.00047795833981726434,0.001788213341626497,0.7892156862745098
265,1369,담기다/Verb,204,160,44,0.0017784496365293556,0.0004887042672768067,0.7843137254901961
266,1375,아오/Exclamation,203,29,174,0.0003223439966209457,0.0019326032387764625,0.8571428571428571
267,1378,울리다/Verb,202,175,27,0.0019451792899539827,0.0002998867094653131,0.8663366336633663
268,1379,지르다/Verb,202,42,160,0.00046684302958895584,0.0017771064264611148,0.7920792079207921
269,1380,소름끼치다/Verb,202,155,47,0.0017228730853878133,0.0005220250127729526,0.7673267326732673
270,1383,일상/Noun,201,154,47,0.0017117577751595047,0.0005220250127729526,0.7661691542288557
271,1388,접다/Verb,199,22,177,0.00024453682502278637,0.001965923984272608,0.8894472361809045
272,1393,이따위/Modifier,198,8,190,8.892248182646779e-05,0.0021103138814225733,0.9595959595959596
273,1394,눈빛/Noun,198,175,23,0.0019451792899539827,0.0002554590488037852,0.8838383838383839
274,1395,10분/Number,198,36,162,0.000400151168219105,0.0017993202567918784,0.8181818181818182
275,1404,뜬금/Noun,196,17,179,0.00018896027388124405,0.001988137814603372,0.9132653061224488
276,1405,핵/Noun,196,37,159,0.00041126647844741344,0.0017659995112957324,0.8112244897959183
277,1414,끌/Noun,195,22,173,0.00024453682502278637,0.0019214963236110802,0.8871794871794871
278,1415,힐링/Noun,195,171,24,0.001900718049040749,0.0002665659639691672,0.8769230769230769
279,1416,혹시/Noun,195,48,147,0.0005335348909588066,0.0016327165293111491,0.7538461538461538
280,1421,무겁다/Adjective,194,158,36,0.0017562190160727387,0.00039984894595375083,0.8144329896907216
281,1430,참다/Verb,193,36,157,0.000400151168219105,0.0017437856809649687,0.8134715025906736
282,1439,아련하다/Adjective,191,184,7,0.002045217082008759,7.774840615767377e-05,0.9633507853403142
283,1444,개판/Noun,190,8,182,8.892248182646779e-05,0.002021458560099518,0.9578947368421052
284,1445,뭐임/Noun,190,15,175,0.00016672965342462708,0.0019437101539418445,0.9210526315789472
285,1446,나머지/Noun,190,38,152,0.000422381788675722,0.001688251105138059,0.8
286,1447,벌써/Noun,190,146,44,0.0016228352933330367,0.0004887042672768067,0.7684210526315789
287,1453,소장/Noun,189,173,16,0.0019229486694973656,0.00017771064264611146,0.9153439153439152
288,1454,비극/Noun,189,143,46,0.0015894893626481115,0.0005109180976075704,0.7566137566137566
289,1460,벗다/Verb,188,41,147,0.00045572771936064734,0.0016327165293111491,0.7819148936170213
290,1461,난해하다/Adjective,188,45,143,0.0005001889602738814,0.0015882888686496212,0.7606382978723404
291,1467,형편/Noun,187,18,169,0.0002000755841095525,0.0018770686629495524,0.9037433155080212
292,1468,본방/Noun,187,166,21,0.0018451414978992067,0.00023324521847302128,0.8877005347593583
293,1469,감명/Noun,187,164,23,0.0018229108774425891,0.0002554590488037852,0.8770053475935828
294,1473,펑펑/Noun,186,179,7,0.0019896405308672165,7.774840615767377e-05,0.9623655913978496
295,1482,그다지/Noun,185,18,167,0.0002000755841095525,0.0018548548326187888,0.9027027027027028
296,1483,토/Noun,185,44,141,0.0004890736500455726,0.0015660750383188573,0.7621621621621621
297,1484,떼다/Verb,185,140,45,0.001556143431963186,0.0004998111824421885,0.7567567567567568
298,1487,불가/Noun,184,41,143,0.00045572771936064734,0.0015882888686496212,0.7771739130434783
299,1491,꼴/Noun,183,23,160,0.00025565213525109487,0.0017771064264611148,0.8743169398907104
300,1492,표절/Noun,183,24,159,0.0002667674454794033,0.0017659995112957324,0.8688524590163934
301,1493,행복/Noun,183,153,30,0.0017006424649311962,0.000333207454961459,0.8360655737704918
302,1494,딱하다/Adjective,183,31,152,0.00034457461707756266,0.001688251105138059,0.8306010928961749
303,1498,글쎄/Noun,182,21,161,0.00023342151479447792,0.001788213341626497,0.8846153846153846
304,1499,색다르다/Adjective,182,141,41,0.0015672587421914947,0.00045538352178066063,0.7747252747252747
305,1506,에만/Josa,181,44,137,0.0004890736500455726,0.0015216473776573296,0.7569060773480663
306,1514,쓰래/Noun,180,10,170,0.00011115310228308472,0.0018881755781149344,0.9444444444444444
307,1515,불쾌하다/Adjective,180,23,157,0.00025565213525109487,0.0017437856809649687,0.8722222222222222
308,1516,느리다/Adjective,180,42,138,0.00046684302958895584,0.0015327542928227115,0.7666666666666667
309,1521,싸다/Verb,179,41,138,0.00045572771936064734,0.0015327542928227115,0.770949720670391
310,1531,그렇다고/Conjunction,178,34,144,0.0003779205477624881,0.0015993957838150033,0.8089887640449438
311,1536,이제야/Noun,177,157,20,0.00174510370584443,0.00022213830330763932,0.8870056497175142
312,1537,적절하다/Adjective,177,137,40,0.0015227975012782607,0.0004442766066152787,0.7740112994350282
313,1538,깨닫다/Verb,177,133,44,0.0014783362603650269,0.0004887042672768067,0.7514124293785308
314,1543,오그라들다/Verb,176,19,157,0.00021119089433786097,0.0017437856809649687,0.8920454545454546
315,1544,긴장/Noun,176,134,42,0.001489451570593335,0.00046649043694604257,0.7613636363636364
316,1554,열정/Noun,174,148,26,0.0016450659137896538,0.00028877979429993113,0.8505747126436781
317,1555,소소하다/Adjective,174,143,31,0.0015894893626481115,0.00034431437012684104,0.8218390804597702
318,1556,빛나다/Verb,174,131,43,0.0014561056399084098,0.0004775973521114245,0.7528735632183908
319,1559,아픔/Noun,173,146,27,0.0016228352933330367,0.0002998867094653131,0.8439306358381503
320,1560,창/Noun,173,31,142,0.00034457461707756266,0.0015771819534842392,0.8208092485549133
321,1565,강렬하다/Adjective,172,147,25,0.0016339506035613453,0.0002776728791345492,0.8546511627906976
322,1566,화나다/Verb,172,30,142,0.00033345930684925416,0.0015771819534842392,0.8255813953488372
323,1567,짝/Noun,172,34,138,0.0003779205477624881,0.0015327542928227115,0.8023255813953488
324,1574,질리/Noun,171,160,11,0.0017784496365293556,0.00012217606681920164,0.935672514619883
325,1575,쩝/Adverb,171,28,143,0.0003112286863926372,0.0015882888686496212,0.8362573099415205
326,1576,극치/Noun,171,28,143,0.0003112286863926372,0.0015882888686496212,0.8362573099415205
327,1577,까지도/Josa,171,135,36,0.0015005668808216438,0.00039984894595375083,0.7894736842105263
328,1583,찡하다/Adjective,170,165,5,0.0018340261876708976,5.5534575826909837e-05,0.9705882352941176
329,1584,주기도/Noun,170,6,164,6.669186136985083e-05,0.0018215340871226425,0.9647058823529412
330,1585,노답/Noun,170,14,156,0.0001556143431963186,0.0017326787657995868,0.9176470588235294
331,1586,빡치다/Adjective,170,27,143,0.0003001133761643288,0.0015882888686496212,0.8411764705882353
332,1593,죄다/Adverb,169,19,150,0.00021119089433786097,0.001666037274807295,0.8875739644970414
333,1594,싸구려/Noun,169,21,148,0.00023342151479447792,0.001643823444476531,0.8757396449704142
334,1595,때우다/Verb,169,36,133,0.000400151168219105,0.0014772197169958016,0.7869822485207101
335,1596,에로/Josa,169,39,130,0.0004334970989040304,0.0014438989714996556,0.7692307692307693
336,1601,섬세하다/Adjective,168,146,22,0.0016228352933330367,0.00024435213363840333,0.8690476190476191
337,1602,풋풋하다/Adjective,168,144,24,0.00160060467287642,0.0002665659639691672,0.8571428571428571
338,1611,제로/Noun,167,16,151,0.00017784496365293558,0.001677144189972677,0.9041916167664672
339,1612,유발/Noun,167,21,146,0.00023342151479447792,0.0016216096141457672,0.8742514970059879
340,1613,필름/Noun,167,34,133,0.0003779205477624881,0.0014772197169958016,0.7964071856287425
341,1614,조절/Noun,167,40,127,0.0004446124091323389,0.0014105782260035095,0.7604790419161677
342,1627,조잡하다/Adjective,165,7,158,7.78071715981593e-05,0.0017548925961303507,0.9575757575757576
343,1636,굿굿/Noun,164,161,3,0.001789564946757664,3.33207454961459e-05,0.9817073170731708
344,1637,좋아지다/Verb,164,134,30,0.001489451570593335,0.000333207454961459,0.8170731707317073
345,1638,통쾌하다/Adjective,164,128,36,0.0014227597092234846,0.00039984894595375083,0.7804878048780488
346,1646,어휴/Exclamation,163,21,142,0.00023342151479447792,0.0015771819534842392,0.8711656441717791
347,1647,실패/Noun,163,27,136,0.0003001133761643288,0.0015105404624919474,0.8343558282208589
348,1654,다가오다/Verb,162,132,30,0.0014672209501367186,0.000333207454961459,0.8148148148148148
349,1655,은근/Noun,162,127,35,0.001411644398995176,0.0003887420307883688,0.7839506172839507
350,1656,심장/Noun,162,126,36,0.0014005290887668675,0.00039984894595375083,0.7777777777777778
351,1657,바라보다/Verb,162,126,36,0.0014005290887668675,0.00039984894595375083,0.7777777777777778
352,1666,없어지다/Verb,161,37,124,0.00041126647844741344,0.0013772574805073642,0.7701863354037267
353,1667,숨다/Verb,161,121,40,0.001344952537625325,0.0004442766066152787,0.7515527950310559
354,1671,1시간/Number,160,35,125,0.0003890358579907965,0.001388364395672746,0.78125
355,1672,늦다/Verb,160,123,37,0.001367183158081942,0.0004109558611191328,0.76875
356,1680,명품/Noun,159,135,24,0.0015005668808216438,0.0002665659639691672,0.8490566037735849
357,1681,존경/Noun,159,126,33,0.0014005290887668675,0.00036652820045760486,0.7924528301886793
358,1693,짠하다/Adjective,157,146,11,0.0016228352933330367,0.00012217606681920164,0.929936305732484
359,1694,푹/Noun,157,137,20,0.0015227975012782607,0.00022213830330763932,0.8726114649681529
360,1699,쵝오/Noun,156,151,5,0.0016784118444745793,5.5534575826909837e-05,0.9679487179487181
361,1703,거슬리다/Verb,155,35,120,0.0003890358579907965,0.001332829819845836,0.7741935483870968
362,1709,짝퉁/Noun,154,7,147,7.78071715981593e-05,0.0016327165293111491,0.9545454545454546
363,1710,개뿔/Noun,154,7,147,7.78071715981593e-05,0.0016327165293111491,0.9545454545454546
364,1711,양심/Noun,154,28,126,0.0003112286863926372,0.0013994713108381278,0.8181818181818182
365,1712,????/Punctuation,154,36,118,0.000400151168219105,0.001310615989515072,0.7662337662337663
366,1713,누군가/Noun,154,118,36,0.0013116066069403995,0.00039984894595375083,0.7662337662337663
367,1721,민망하다/Adjective,153,16,137,0.00017784496365293558,0.0015216473776573296,0.8954248366013072
368,1722,망/Noun,153,19,134,0.00021119089433786097,0.0014883266321611835,0.8758169934640523
369,1723,연예인/Noun,153,27,126,0.0003001133761643288,0.0013994713108381278,0.8235294117647058
370,1724,도안/Noun,153,38,115,0.000422381788675722,0.0012772952440189265,0.7516339869281046
371,1733,돌아보다/Verb,152,143,9,0.0015894893626481115,9.996223648843771e-05,0.9407894736842104
372,1734,의외로/Adverb,152,129,23,0.0014338750194517929,0.0002554590488037852,0.8486842105263158
373,1740,찝찝하다/Adjective,151,30,121,0.00033345930684925416,0.001343936735011218,0.8013245033112583
374,1741,사기/Noun,151,33,118,0.00036680523753417966,0.001310615989515072,0.7814569536423841
375,1750,라지/Noun,150,18,132,0.0002000755841095525,0.0014661128018304194,0.88
376,1751,날리다/Verb,150,30,120,0.00033345930684925416,0.001332829819845836,0.8
377,1761,낭비하다/Adjective,149,2,147,2.2230620456616947e-05,0.0016327165293111491,0.9865771812080536
378,1762,단연/Noun,149,128,21,0.0014227597092234846,0.00023324521847302128,0.8590604026845637
379,1763,무척/Noun,149,114,35,0.0012671453660271655,0.0003887420307883688,0.7651006711409396
380,1775,이도/Noun,148,5,143,5.557655114154236e-05,0.0015882888686496212,0.9662162162162162
381,1781,꽝/Noun,147,8,139,8.892248182646779e-05,0.0015438612079880936,0.9455782312925172
382,1782,라이/Noun,147,28,119,0.0003112286863926372,0.0013217229046804538,0.8095238095238095
383,1789,사수/Noun,146,132,14,0.0014672209501367186,0.0001554968123153475,0.9041095890410958
384,1790,허세/Noun,146,18,128,0.0002000755841095525,0.0014216851411688915,0.8767123287671232
385,1791,와우/Noun,146,125,21,0.001389413778538559,0.00023324521847302128,0.8561643835616438
386,1792,명성/Noun,146,25,121,0.0002778827557077118,0.001343936735011218,0.8287671232876712
387,1803,개막/Noun,145,9,136,0.00010003779205477625,0.0015105404624919474,0.9379310344827586
388,1804,생생하다/Adjective,145,134,11,0.001489451570593335,0.00012217606681920164,0.9241379310344828
389,1809,뭉클하다/Adjective,144,139,5,0.0015450281217348775,5.5534575826909837e-05,0.9652777777777778
390,1810,마이너스/Noun,144,7,137,7.78071715981593e-05,0.0015216473776573296,0.9513888888888888
391,1811,밋밋하다/Adjective,144,18,126,0.0002000755841095525,0.0013994713108381278,0.875
392,1812,묘/Noun,144,118,26,0.0013116066069403995,0.00028877979429993113,0.8194444444444444
393,1817,저/Modifier,143,26,117,0.00028899806593602026,0.0012995090743496902,0.8181818181818182
394,1824,ㅉㅉㅉ/KoreanParticle,142,15,127,0.00016672965342462708,0.0014105782260035095,0.8943661971830986
395,1825,싸이코/Noun,142,29,113,0.0003223439966209457,0.0012550814136881624,0.7957746478873241
396,1826,만들기/Noun,142,30,112,0.00033345930684925416,0.0012439744985227805,0.7887323943661971
397,1827,자연스럽다/Adjective,142,112,30,0.0012449147455705488,0.000333207454961459,0.7887323943661971
398,1831,달달/Noun,141,125,16,0.001389413778538559,0.00017771064264611146,0.8865248226950354
399,1832,어린시절/Noun,141,123,18,0.001367183158081942,0.00019992447297687542,0.8723404255319149
400,1833,정체/Noun,141,30,111,0.00033345930684925416,0.0012328675833573985,0.7872340425531915
401,1834,막장드라마/Noun,141,32,109,0.00035568992730587116,0.0012106537530266347,0.7730496453900709
402,1835,왠/Modifier,141,33,108,0.00036680523753417966,0.0011995468378612525,0.7659574468085106
403,1842,♥♥/Foreign,140,140,0,0.001556143431963186,0.0,1.0
404,1843,숨기다/Verb,140,114,26,0.0012671453660271655,0.00028877979429993113,0.8142857142857143
405,1844,세월/Noun,140,105,35,0.0011671075739723895,0.0003887420307883688,0.75
406,1852,일품/Noun,139,126,13,0.0014005290887668675,0.00014438989714996554,0.9064748201438848
407,1853,젠장/Noun,139,22,117,0.00024453682502278637,0.0012995090743496902,0.8417266187050358
408,1854,기회/Noun,139,106,33,0.001178222884200698,0.00036652820045760486,0.7625899280575541
409,1855,카리스마/Noun,139,105,34,0.0011671075739723895,0.00037763511562298685,0.7553956834532374
410,1858,아/Noun,138,27,111,0.0003001133761643288,0.0012328675833573985,0.8043478260869565
411,1869,포르노/Noun,137,16,121,0.00017784496365293558,0.001343936735011218,0.8832116788321168
412,1870,C/Alpha,137,16,121,0.00017784496365293558,0.001343936735011218,0.8832116788321168
413,1871,응원/Noun,137,116,21,0.0012893759864837828,0.00023324521847302128,0.8467153284671532
414,1872,겨/Noun,137,26,111,0.00028899806593602026,0.0012328675833573985,0.8102189781021898
415,1873,압권/Noun,137,111,26,0.0012337994353422404,0.00028877979429993113,0.8102189781021898
416,1886,시시하다/Adjective,136,23,113,0.00025565213525109487,0.0012550814136881624,0.8308823529411765
417,1887,세번/Noun,136,110,26,0.001222684125113932,0.00028877979429993113,0.8088235294117647
418,1888,냥/Josa,136,31,105,0.00034457461707756266,0.0011662260923651065,0.7720588235294118
419,1897,에로영화/Noun,135,22,113,0.00024453682502278637,0.0012550814136881624,0.837037037037037
420,1898,겨우/Noun,135,22,113,0.00024453682502278637,0.0012550814136881624,0.837037037037037
421,1899,추하다/Adjective,135,108,27,0.001200453504657315,0.0002998867094653131,0.8
422,1910,야동/Noun,134,25,109,0.0002778827557077118,0.0012106537530266347,0.8134328358208955
423,1911,롭고/Josa,134,108,26,0.001200453504657315,0.00028877979429993113,0.8059701492537313
424,1924,투자/Noun,133,20,113,0.00022230620456616945,0.0012550814136881624,0.849624060150376
425,1925,레전드/Noun,133,108,25,0.001200453504657315,0.0002776728791345492,0.8120300751879699
426,1926,지우다/Verb,133,30,103,0.00033345930684925416,0.0011440122620343426,0.7744360902255639
427,1937,진하다/Adjective,132,119,13,0.0013227219171687082,0.00014438989714996554,0.9015151515151516
428,1938,초등학교/Noun,132,99,33,0.0011004157126025386,0.00036652820045760486,0.75
429,1950,M/Alpha,131,5,126,5.557655114154236e-05,0.0013994713108381278,0.9618320610687024
430,1951,잠들다/Verb,131,17,114,0.00018896027388124405,0.001266188328853544,0.8702290076335878
431,1952,감흥/Noun,131,19,112,0.00021119089433786097,0.0012439744985227805,0.8549618320610687
432,1953,붙이다/Verb,131,21,110,0.00023342151479447792,0.0012217606681920164,0.8396946564885496
433,1954,부럽다/Adjective,131,106,25,0.001178222884200698,0.0002776728791345492,0.8091603053435115
434,1955,설득/Noun,131,30,101,0.00033345930684925416,0.0011217984317035787,0.7709923664122137
435,1956,따로/Adverb,131,31,100,0.00034457461707756266,0.0011106915165381968,0.7633587786259542
436,1964,반하다/Adjective,130,112,18,0.0012449147455705488,0.00019992447297687542,0.8615384615384616
437,1965,점준/Noun,130,23,107,0.00025565213525109487,0.0011884399226958706,0.823076923076923
438,1966,인지도/Noun,130,26,104,0.00028899806593602026,0.0011551191771997243,0.8
439,1975,안습/Noun,129,16,113,0.00017784496365293558,0.0012550814136881624,0.875968992248062
440,1976,우려/Noun,129,18,111,0.0002000755841095525,0.0012328675833573985,0.8604651162790697
441,1977,기만/Noun,129,25,104,0.0002778827557077118,0.0011551191771997243,0.8062015503875969
442,1978,조작/Noun,129,25,104,0.0002778827557077118,0.0011551191771997243,0.8062015503875969
443,1979,고르다/Verb,129,29,100,0.0003223439966209457,0.0011106915165381968,0.7751937984496124
444,1980,오랫/Modifier,129,97,32,0.0010781850921459217,0.00035542128529222287,0.751937984496124
445,1988,공짜/Noun,128,5,123,5.557655114154236e-05,0.001366150565341982,0.9609375
446,1989,18/Number,128,28,100,0.0003112286863926372,0.0011106915165381968,0.78125
447,2001,정신병/Noun,127,21,106,0.00023342151479447792,0.0011773330075304884,0.8346456692913385
448,2002,깨우다/Verb,127,105,22,0.0011671075739723895,0.00024435213363840333,0.8267716535433071
449,2003,아예/Noun,127,26,101,0.00028899806593602026,0.0011217984317035787,0.7952755905511811
450,2015,틈/Noun,126,106,20,0.001178222884200698,0.00022213830330763932,0.8412698412698413
451,2016,;;;;/Punctuation,126,26,100,0.00028899806593602026,0.0011106915165381968,0.7936507936507936
452,2017,껏/Noun,126,28,98,0.0003112286863926372,0.001088477686207433,0.7777777777777778
453,2027,효/Noun,125,24,101,0.0002667674454794033,0.0011217984317035787,0.8079999999999999
454,2028,용기/Noun,125,98,27,0.0010893004023742304,0.0002998867094653131,0.784
455,2029,뜨겁다/Adjective,125,97,28,0.0010781850921459217,0.000310993624630695,0.7759999999999999
456,2039,말아먹다/Verb,124,12,112,0.00013338372273970166,0.0012439744985227805,0.9032258064516128
457,2040,운명/Noun,124,93,31,0.0010337238512326881,0.00034431437012684104,0.75
458,2064,았/Noun,122,13,109,0.00014449903296801013,0.0012106537530266347,0.8934426229508197
459,2065,번은/Noun,122,102,20,0.0011337616432874642,0.00022213830330763932,0.8360655737704918
460,2066,설마/Noun,122,22,100,0.00024453682502278637,0.0011106915165381968,0.819672131147541
461,2078,낮추다/Verb,121,16,105,0.00017784496365293558,0.0011662260923651065,0.8677685950413223
462,2079,셈/Noun,121,20,101,0.00022230620456616945,0.0011217984317035787,0.8347107438016529
463,2080,변태/Noun,121,21,100,0.00023342151479447792,0.0011106915165381968,0.8264462809917356
464,2086,잔뜩/Noun,120,15,105,0.00016672965342462708,0.0011662260923651065,0.875
465,2087,5분/Number,120,18,102,0.0002000755841095525,0.0011329053468689607,0.85
466,2100,전율/Noun,119,110,9,0.001222684125113932,9.996223648843771e-05,0.9243697478991596
467,2101,둘째/Noun,119,14,105,0.0001556143431963186,0.0011662260923651065,0.8823529411764706
468,2102,려고/Noun,119,23,96,0.00025565213525109487,0.0010662638558766688,0.8067226890756303
469,2103,아동/Noun,119,28,91,0.0003112286863926372,0.001010729280049759,0.7647058823529411
470,2116,오빠/Suffix,118,106,12,0.001178222884200698,0.0001332829819845836,0.8983050847457628
471,2117,작위/Noun,118,17,101,0.00018896027388124405,0.0011217984317035787,0.8559322033898306
472,2118,대본/Noun,118,24,94,0.0002667674454794033,0.0010440500255459052,0.7966101694915254
473,2119,부모님/Noun,118,89,29,0.000989262610319454,0.00032210053979607705,0.7542372881355932
474,2126,:)/Punctuation,117,114,3,0.0012671453660271655,3.33207454961459e-05,0.9743589743589745
475,2127,한개/Modifier,117,10,107,0.00011115310228308472,0.0011884399226958706,0.9145299145299144
476,2128,애쓰다/Verb,117,25,92,0.0002778827557077118,0.0010218361952151409,0.7863247863247863
477,2129,하나같이/Adverb,117,28,89,0.0003112286863926372,0.0009885154497189948,0.7606837606837606
478,2139,그만/Modifier,116,9,107,0.00010003779205477625,0.0011884399226958706,0.9224137931034484
479,2140,하자/Noun,116,24,92,0.0002667674454794033,0.0010218361952151409,0.7931034482758621
480,2141,정작/Noun,116,29,87,0.0003223439966209457,0.0009663016193882313,0.75
481,2152,대놓고/Adverb,115,17,98,0.00018896027388124405,0.001088477686207433,0.8521739130434782
482,2153,ㅠㅜ/KoreanParticle,115,89,26,0.000989262610319454,0.00028877979429993113,0.7739130434782608
483,2166,힘내다/Verb,114,95,19,0.0010559544716893046,0.00021103138814225735,0.8333333333333334
484,2167,겪다/Verb,114,87,27,0.0009670319898628369,0.0002998867094653131,0.7631578947368421
485,2181,20분/Number,113,18,95,0.0002000755841095525,0.0010551569407112867,0.8407079646017699
486,2188,명화/Noun,112,90,22,0.0010003779205477628,0.00024435213363840333,0.8035714285714286
487,2189,값/Noun,112,27,85,0.0003001133761643288,0.0009440877890574672,0.7589285714285714
488,2198,낚였다/Noun,111,2,109,2.2230620456616947e-05,0.0012106537530266347,0.981981981981982
489,2199,참나/Noun,111,10,101,0.00011115310228308472,0.0011217984317035787,0.90990990990991
490,2200,오래전/Adverb,111,85,26,0.0009448013694062199,0.00028877979429993113,0.7657657657657657
491,2208,울컥/Adverb,110,108,2,0.001200453504657315,2.2213830330763933e-05,0.9818181818181818
492,2209,짜지다/Verb,110,12,98,0.00013338372273970166,0.001088477686207433,0.8909090909090909
493,2210,신파/Noun,110,16,94,0.00017784496365293558,0.0010440500255459052,0.8545454545454545
494,2211,첫사랑/Noun,110,90,20,0.0010003779205477628,0.00022213830330763932,0.8181818181818182
495,2221,한숨/Noun,109,12,97,0.00013338372273970166,0.0010773707710420508,0.8899082568807339
496,2222,시끄럽다/Adjective,109,15,94,0.00016672965342462708,0.0010440500255459052,0.8623853211009175
497,2223,세련되다/Adjective,109,94,15,0.0010448391614609964,0.0001666037274807295,0.8623853211009175
498,2233,.^^/Punctuation,108,97,11,0.0010781850921459217,0.00012217606681920164,0.8981481481481481
499,2234,말고는/Josa,108,11,97,0.00012226841251139318,0.0010773707710420508,0.8981481481481481
500,2248,빈약하다/Adjective,107,12,95,0.00013338372273970166,0.0010551569407112867,0.8878504672897196
501,2253,어처구니/Noun,106,11,95,0.00012226841251139318,0.0010551569407112867,0.8962264150943396
502,2254,..^^/Punctuation,106,92,14,0.0010226085410043797,0.0001554968123153475,0.8679245283018868
503,2255,중독/Noun,106,87,19,0.0009670319898628369,0.00021103138814225735,0.8207547169811321
504,2263,선동/Noun,105,10,95,0.00011115310228308472,0.0010551569407112867,0.9047619047619048
505,2264,팔이/Noun,105,11,94,0.00012226841251139318,0.0010440500255459052,0.8952380952380953
506,2265,여름/Noun,105,85,20,0.0009448013694062199,0.00022213830330763932,0.8095238095238095
507,2266,안감/Noun,105,22,83,0.00024453682502278637,0.0009218739587267033,0.7904761904761904
508,2267,늘어지다/Verb,105,24,81,0.0002667674454794033,0.0008996601283959392,0.7714285714285715
509,2280,끼우다/Verb,104,10,94,0.00011115310228308472,0.0010440500255459052,0.903846153846154
510,2281,메이드/Noun,104,91,13,0.001011493230776071,0.00014438989714996554,0.875
511,2282,캬/Noun,104,89,15,0.000989262610319454,0.0001666037274807295,0.8557692307692307
512,2283,어쩌/Noun,104,16,88,0.00017784496365293558,0.000977408534553613,0.8461538461538461
513,2284,구리/Noun,104,16,88,0.00017784496365293558,0.000977408534553613,0.8461538461538461
514,2285,호구/Noun,104,17,87,0.00018896027388124405,0.0009663016193882313,0.8365384615384616
515,2286,부터가/Josa,104,22,82,0.00024453682502278637,0.0009107670435613213,0.7884615384615384
516,2287,하아/Exclamation,104,23,81,0.00025565213525109487,0.0008996601283959392,0.7788461538461539
517,2288,~!!!/Punctuation,104,79,25,0.0008781095080363692,0.0002776728791345492,0.7596153846153846
518,2302,내놓다/Verb,103,23,80,0.00025565213525109487,0.0008885532132305574,0.7766990291262136
519,2314,빵점/Noun,102,2,100,2.2230620456616947e-05,0.0011106915165381968,0.9803921568627452
520,2315,하품/Noun,102,2,100,2.2230620456616947e-05,0.0011106915165381968,0.9803921568627452
521,2316,편안하다/Adjective,102,90,12,0.0010003779205477628,0.0001332829819845836,0.8823529411764706
522,2317,지경/Noun,102,14,88,0.0001556143431963186,0.000977408534553613,0.8627450980392157
523,2318,재미나/Noun,102,87,15,0.0009670319898628369,0.0001666037274807295,0.8529411764705882
524,2319,조화/Noun,102,82,20,0.0009114554387212947,0.00022213830330763932,0.8039215686274509
525,2320,곡/Noun,102,78,24,0.0008669941978080608,0.0002665659639691672,0.7647058823529411
526,2321,팔/Modifier,102,24,78,0.0002667674454794033,0.0008663393828997934,0.7647058823529411
527,2332,인내심/Noun,101,8,93,8.892248182646779e-05,0.001032943110380523,0.9207920792079208
528,2351,앞뒤/Noun,100,11,89,0.00012226841251139318,0.0009885154497189948,0.89
529,2352,울면/Noun,100,87,13,0.0009670319898628369,0.00014438989714996554,0.87
