,Unnamed: 0,parameter,counts,counts_H,counts_NH,p_from_H,p_from_NH,priority
0,15,없다/Adjective,16914,5001,11913,0.05558766645177067,0.13231668036519534,0.7043277758070238
1,19,좋다/Adjective,13043,9370,3673,0.10415045683925038,0.04079569940244796,0.7183930077436173
2,22,재밌다/Adjective,11789,9955,1834,0.11065291332281084,0.02037008241331053,0.8444312494698448
3,23,?/Punctuation,11319,3302,8017,0.036702754373874574,0.08904413888086722,0.7082781164413817
4,34,!/Punctuation,8565,6415,2150,0.07130471511459885,0.023879867605571228,0.7489784004670169
5,44,최고/Noun,6671,6143,528,0.06828135073249894,0.005864451207321679,0.9208514465597362
6,55,감동/Noun,5597,4442,1155,0.04937420803414623,0.012828487016016172,0.7936394497051992
7,57,1/Number,5284,1409,3875,0.015661472111686642,0.04303929626585512,0.7333459500378501
8,62,아깝다/Adjective,5167,374,4793,0.004157126025387369,0.053235444387675766,0.9276175730598026
9,69,재미있다/Adjective,4787,4102,685,0.04559500255652135,0.0076082368882866465,0.8569041153123041
10,76,뭐/Noun,4491,831,3660,0.009236822799724341,0.040651309505298,0.8149632598530394
11,78,그냥/Noun,4406,1187,3219,0.013193873241002156,0.03575315991736455,0.7305946436677259
12,84,재미없다/Adjective,4205,307,3898,0.003412400240090701,0.043294755314658914,0.9269916765755052
13,88,지루하다/Adjective,4057,872,3185,0.009692550519084988,0.03537552480174157,0.7850628543258565
14,91,!!/Punctuation,4005,3088,917,0.03432407798501656,0.010185041206655265,0.7710362047440699
15,92,시간/Noun,3956,1077,2879,0.011971189115888223,0.03197680876113468,0.7277553083923155
16,94,쓰레기/Noun,3739,209,3530,0.002323099837716471,0.03920741053379834,0.9441027012570206
17,105,다시/Noun,3289,2763,526,0.030711602160816313,0.005842237376990914,0.8400729705077531
18,109,사랑/Noun,3190,2523,667,0.028043927706022275,0.007408312415309772,0.7909090909090909
19,116,이다/Adjective,2942,2200,742,0.02445368250227864,0.00824133105271342,0.7477906186267845
20,124,안되다/Adjective,2683,658,2025,0.007313874130226975,0.022491503209898484,0.7547521431233694
21,131,지금/Noun,2596,1843,753,0.020485516750772512,0.00836350711953262,0.7099383667180277
22,132,ㅠㅠ/KoreanParticle,2589,1842,747,0.0204744014405442,0.00829686562854033,0.7114716106604867
23,133,최악/Noun,2549,32,2517,0.00035568992730587116,0.02795610547126641,0.9874460572773636
24,140,별로/Noun,2438,320,2118,0.003556899273058711,0.02352444632027901,0.8687448728465955
25,142,돈/Noun,2433,279,2154,0.003101171553698064,0.02392429526623276,0.8853267570900123
26,150,개/Noun,2277,671,1606,0.007458373163194984,0.01783770575560344,0.7053140096618358
27,151,명작/Noun,2259,1976,283,0.02196385301113754,0.0031432569918030968,0.8747233289065959
28,157,^^/Punctuation,2162,1921,241,0.021352510948580573,0.002676766554857054,0.8885291396854764
29,160,ㅡㅡ/KoreanParticle,2128,211,1917,0.002345330458173088,0.02129195637203723,0.9008458646616542
30,173,꼭/Noun,1920,1594,326,0.0177178045039237,0.003620854343914521,0.8302083333333333
31,177,아름답다/Adjective,1901,1659,242,0.01844029966876376,0.002687873470022436,0.8726985796948974
32,181,마음/Noun,1810,1497,313,0.016639619411777783,0.0034764644467645558,0.8270718232044199
33,182,인생/Noun,1810,1304,506,0.014494364537714247,0.0056200990736832756,0.7204419889502762
34,191,ㅎㅎ/KoreanParticle,1744,1498,246,0.01665073472200609,0.002732301130683964,0.8589449541284404
35,197,어리다/Verb,1690,1270,420,0.014116443989951759,0.004664904369460426,0.7514792899408284
36,198,재다/Verb,1675,1417,258,0.015750394593513104,0.002865584112668547,0.8459701492537314
37,200,뻔하다/Adjective,1670,457,1213,0.005079696774336972,0.013472688095608323,0.7263473053892215
38,202,수준/Noun,1658,273,1385,0.003034479692328213,0.015383077504054024,0.8353437876960192
39,203,맞다/Verb,1649,477,1172,0.005302002978903141,0.013017304573827665,0.7107337780473014
40,206,네/Josa,1608,469,1139,0.0052130804970766725,0.01265077637337006,0.7083333333333334
41,211,전개/Noun,1586,418,1168,0.004646199675432942,0.012972876913166138,0.7364438839848676
42,212,매력/Noun,1586,1153,433,0.012815952693239669,0.00480929426661039,0.7269861286254728
43,215,가슴/Noun,1575,1376,199,0.015294666874152455,0.0022102761179110114,0.8736507936507937
44,216,낮다/Adjective,1560,1254,306,0.013938599026298824,0.003398716040606882,0.8038461538461539
45,217,말다/Verb,1559,338,1221,0.003756974857168264,0.01356154341693138,0.7831943553559975
46,220,야/Josa,1543,373,1170,0.00414601071515906,0.012995090743496902,0.7582631237848347
47,222,높다/Adjective,1536,327,1209,0.003634706444656871,0.013428260434946798,0.787109375
48,226,;;/Punctuation,1523,373,1150,0.00414601071515906,0.012772952440189262,0.7550886408404465
49,228,슬프다/Adjective,1504,1292,212,0.014360980814974547,0.002354666015060977,0.8590425531914894
50,231,멋지다/Adjective,1475,1271,204,0.014127559300180068,0.002265810693737921,0.8616949152542372
51,235,음악/Noun,1452,1077,375,0.011971189115888223,0.0041650931870182385,0.7417355371900827
52,239,유치하다/Adjective,1442,282,1160,0.003134517484382989,0.01288402159184308,0.8044382801664355
53,247,무슨/Noun,1408,215,1193,0.002389791699086321,0.013250549792300687,0.8473011363636364
54,248,추천/Noun,1403,1037,366,0.011526576706755885,0.0040651309505298,0.7391304347826086
55,250,냐/Josa,1392,169,1223,0.001878487428584132,0.013583757247262143,0.8785919540229885
56,254,눈물/Noun,1378,1156,222,0.012849298623924595,0.002465735166714797,0.8388969521044993
57,262,우리/Noun,1346,996,350,0.011070848987395238,0.003887420307883689,0.7399702823179792
58,270,허다/Verb,1294,206,1088,0.0022897539070315448,0.01208432369993558,0.8408037094281299
59,273,짜증나다/Adjective,1251,81,1170,0.0009003401284929863,0.012995090743496902,0.9352517985611509
60,278,찍다/Verb,1231,259,972,0.0028788653491318944,0.010795921540751272,0.7896019496344435
61,282,기대하다/Adjective,1222,341,881,0.003790320787853189,0.009785192260701512,0.7209492635024549
62,284,여운/Noun,1210,1139,71,0.01266033835004335,0.0007885909767421196,0.9413223140495868
63,288,전혀/Noun,1199,338,861,0.003756974857168264,0.009563053957393873,0.7180984153461217
64,292,대박/Noun,1180,975,205,0.010837427472600759,0.002276917608903303,0.826271186440678
65,297,별/Noun,1164,304,860,0.003379054309405776,0.009551947042228491,0.7388316151202751
66,300,굿/Noun,1156,1072,84,0.01191561256474668,0.0009329808738920851,0.9273356401384084
67,303,모습/Noun,1142,842,300,0.009359091212235734,0.00333207454961459,0.7373029772329247
68,304,별/Modifier,1142,316,826,0.003512438032145477,0.009174311926605505,0.7232924693520141
69,310,실망/Noun,1118,115,1003,0.0012782606762554744,0.011140235910878113,0.8971377459749553
70,317,보지/Noun,1094,324,770,0.0036013605139719454,0.008552324677344115,0.7038391224862889
71,319,건지다/Verb,1093,195,898,0.002167485494520152,0.009974009818513006,0.8215919487648673
72,327,귀엽다/Adjective,1069,881,188,0.009792588311139765,0.0020881000510918103,0.8241347053320861
73,331,대단하다/Adjective,1057,751,306,0.008347597981459662,0.003398716040606882,0.7105014191106906
74,335,뿐/Noun,1051,311,740,0.0034568614810039353,0.008219117222382655,0.7040913415794482
75,338,ㅎ/KoreanParticle,1048,840,208,0.009336860591779116,0.0023102383543994486,0.8015267175572519
76,339,;/Punctuation,1045,287,758,0.0031900940355245318,0.008419041695359529,0.7253588516746412
77,341,OO/Alpha,1033,220,813,0.002445368250227864,0.009029922029455541,0.7870280735721199
78,345,잔잔하다/Adjective,1023,897,126,0.0099704332747927,0.0013994713108381278,0.8768328445747801
79,349,점도/Noun,1011,91,920,0.001011493230776071,0.010218361952151409,0.9099901088031652
80,352,용/Noun,999,295,704,0.0032790165173509998,0.007819268276428905,0.7047047047047047
81,353,떨어지다/Verb,997,207,790,0.002300869217259854,0.008774462980651754,0.7923771313941825
82,358,급/Noun,974,237,737,0.0026343285241091077,0.00818579647688651,0.7566735112936345
83,374,작가/Noun,929,209,720,0.002323099837716471,0.007996978919075016,0.77502691065662
84,379,욕/Noun,910,166,744,0.0018451414978992067,0.008263544883044184,0.8175824175824176
85,380,차라리/Noun,909,59,850,0.0006558033034701999,0.009440877890574672,0.935093509350935
86,381,이상하다/Adjective,909,232,677,0.0025787519729675657,0.007519381566963592,0.7447744774477447
87,383,깊다/Adjective,907,808,99,0.008981170664473246,0.0010995846013728146,0.8908489525909592
88,385,짱/Noun,905,842,63,0.009359091212235734,0.0006997356554190639,0.9303867403314916
89,387,울다/Verb,900,695,205,0.007725140608674388,0.002276917608903303,0.7722222222222223
90,388,알바/Noun,897,104,793,0.001155992263744081,0.0088077837261479,0.8840579710144928
91,390,0/Number,888,77,811,0.0008558788875797522,0.009007708199124777,0.9132882882882885
92,392,따뜻하다/Adjective,884,833,51,0.009259053420180956,0.0005664526734344802,0.9423076923076924
93,394,삶/Noun,883,770,113,0.008558788875797524,0.0012550814136881624,0.8720271800679502
94,399,오랜/Modifier,870,699,171,0.007769601849587622,0.0018992824932803163,0.8034482758620691
95,400,기/Noun,869,240,629,0.002667674454794033,0.006986249639025257,0.7238204833141542
96,404,빼다/Verb,861,250,611,0.002778827557077118,0.006786325166048382,0.7096399535423926
97,409,놈/Noun,846,250,596,0.002778827557077118,0.006619721438567652,0.7044917257683215
98,410,아직도/Adverb,841,631,210,0.0070137607540626465,0.002332452184730213,0.7502972651605232
99,411,어설프다/Adjective,834,79,755,0.0008781095080363692,0.008385720949863385,0.9052757793764988
100,412,막장/Noun,834,144,690,0.00160060467287642,0.007663771464113556,0.8273381294964028
101,416,훌륭하다/Adjective,825,663,162,0.007369450681368517,0.0017993202567918784,0.8036363636363636
102,422,도대체/Noun,805,101,704,0.0011226463330591557,0.007819268276428905,0.8745341614906832
103,426,생각나다/Verb,795,647,148,0.007191605717715582,0.001643823444476531,0.8138364779874214
104,427,류/Noun,790,141,649,0.0015672587421914947,0.007208387942332897,0.8215189873417722
105,433,뭘/Noun,782,175,607,0.0019451792899539827,0.006741897505386854,0.7762148337595908
106,441,수작/Noun,766,696,70,0.007736255918902695,0.0007774840615767378,0.908616187989556
107,443,걍/Adverb,765,208,557,0.002311984527488162,0.006186551747117756,0.7281045751633987
108,444,설정/Noun,762,139,623,0.0015450281217348775,0.006919608148032965,0.8175853018372703
109,448,놓다/Verb,755,225,530,0.0025009448013694068,0.005886665037652442,0.7019867549668874
110,449,필요없다/Adjective,754,630,124,0.0070026454438343365,0.0013772574805073642,0.8355437665782494
111,452,싫다/Adjective,746,130,616,0.001444990329680101,0.006841859741875293,0.8257372654155496
112,453,시나리오/Noun,742,207,535,0.002300869217259854,0.005942199613479352,0.7210242587601078
113,461,멋있다/Adjective,732,615,117,0.006835915790409711,0.0012995090743496902,0.8401639344262295
114,462,관객/Noun,732,188,544,0.0020896783229219927,0.00604216184996779,0.7431693989071039
115,466,노잼/Noun,724,17,707,0.00018896027388124405,0.00785258902192505,0.9765193370165746
116,468,뭔/Modifier,722,104,618,0.001155992263744081,0.006864073572206054,0.8559556786703602
117,470,답답하다/Adjective,719,131,588,0.0014561056399084098,0.006530866117244597,0.8178025034770514
118,471,아프다/Adjective,719,559,160,0.006213458417624436,0.0017771064264611148,0.7774687065368567
119,474,장난/Noun,714,182,532,0.002022986461552142,0.005908878867983206,0.7450980392156863
120,475,죽이다/Verb,713,198,515,0.002200831425205077,0.005720061310171713,0.7223001402524544
121,477,최고다/Noun,711,679,32,0.007547295645021453,0.00035542128529222287,0.9549929676511956
122,480,OOO/Alpha,708,91,617,0.001011493230776071,0.006852966657040674,0.8714689265536724
123,482,지루함/Noun,707,100,607,0.0011115310228308473,0.006741897505386854,0.8585572842998586
124,483,추억/Noun,707,576,131,0.00640241869150568,0.0014550058866650375,0.8147100424328148
125,486,소리/Noun,705,202,503,0.0022452926661183114,0.005586778328187129,0.7134751773049646
126,489,이딴/Modifier,703,26,677,0.00028899806593602026,0.007519381566963592,0.9630156472261736
127,490,더럽다/Adjective,701,81,620,0.0009003401284929863,0.00688628740253682,0.8844507845934381
128,495,인상/Noun,689,547,142,0.006080074694884734,0.0015771819534842392,0.7939042089985486
129,497,어이없다/Adjective,686,55,631,0.000611342062556966,0.007008463469356021,0.9198250728862972
130,503,전/Modifier,680,199,481,0.002211946735433386,0.005342426194548726,0.7073529411764706
131,504,정신/Noun,678,183,495,0.0020341017717804503,0.0054979230068640745,0.7300884955752213
132,507,접/Noun,676,122,554,0.0013560678478536335,0.006153231001621609,0.8195266272189349
133,509,잊다/Verb,674,570,104,0.006335726830135829,0.0011551191771997243,0.8456973293768546
134,510,졸작/Noun,672,34,638,0.0003779205477624881,0.007086211875513696,0.949404761904762
135,511,제발/Noun,671,179,492,0.0019896405308672165,0.005464602261367928,0.7332339791356185
136,514,아무리/Adverb,666,114,552,0.0012671453660271655,0.006131017171290846,0.8288288288288288
137,517,♥/Foreign,660,651,9,0.007236066958628815,9.996223648843771e-05,0.9863636363636364
138,519,킬링타임/Noun,659,186,473,0.0020674477024653763,0.005253570873225671,0.7177541729893778
139,521,함께/Adverb,656,544,112,0.00604672876419981,0.0012439744985227805,0.8292682926829268
140,527,대해/Noun,651,506,145,0.0056243469755240865,0.001610502698980385,0.7772657450076805
141,529,어색하다/Adjective,642,123,519,0.001367183158081942,0.005764488970833241,0.8084112149532711
142,534,엉/Exclamation,636,103,533,0.0011448769535157724,0.005919985783148589,0.8380503144654088
143,535,쓸다/Verb,636,162,474,0.0018006802569859727,0.0052646777883910536,0.7452830188679245
144,539,개연/Noun,630,55,575,0.000611342062556966,0.006386476220094631,0.9126984126984128
145,540,망하다/Adjective,630,89,541,0.000989262610319454,0.006008841104471644,0.8587301587301587
146,546,!!!!/Punctuation,622,460,162,0.005113042705021898,0.0017993202567918784,0.7395498392282959
147,550,진부하다/Adjective,618,109,509,0.0012115688148856235,0.005653419819179421,0.8236245954692557
148,555,ㅠㅠㅠ/KoreanParticle,611,496,115,0.0055131938732410025,0.0012772952440189265,0.8117839607201309
149,562,유쾌하다/Adjective,603,554,49,0.006157881866482894,0.0005442388431037163,0.9187396351575456
150,566,완벽하다/Adjective,599,512,87,0.0056910388368939385,0.0009663016193882313,0.8547579298831386
151,567,질/Noun,599,104,495,0.001155992263744081,0.0054979230068640745,0.8263772954924875
152,578,강추/Noun,590,547,43,0.006080074694884734,0.0004775973521114245,0.9271186440677966
153,579,행복하다/Adjective,590,524,66,0.005824422559633639,0.0007330564009152097,0.8881355932203391
154,585,더빙/Noun,582,150,432,0.0016672965342462707,0.00479818735144501,0.7422680412371134
155,593,즐겁다/Adjective,573,495,78,0.0055020785630126925,0.0008663393828997934,0.8638743455497382
156,597,머/Noun,570,97,473,0.0010781850921459217,0.005253570873225671,0.8298245614035088
157,601,꽤/Noun,562,441,121,0.004901851810684036,0.001343936735011218,0.7846975088967971
158,603,짜증/Noun,558,23,535,0.00025565213525109487,0.005942199613479352,0.9587813620071683
159,606,ㅡ/KoreanParticle,556,157,399,0.00174510370584443,0.004431659150987405,0.7176258992805755
160,608,ㅎㅎㅎ/KoreanParticle,555,434,121,0.0048240446390858775,0.001343936735011218,0.781981981981982
161,614,???/Punctuation,551,142,409,0.0015783740524198029,0.004542728302641225,0.7422867513611615
162,619,건가/Noun,546,124,422,0.0013782984683102506,0.00468711819979119,0.7728937728937729
163,626,소름/Noun,540,437,103,0.004857390569770802,0.0011440122620343426,0.8092592592592592
164,627,심하다/Adjective,539,81,458,0.0009003401284929863,0.005086967145744941,0.8497217068645642
165,628,충분하다/Adjective,539,414,125,0.004601738434519708,0.001388364395672746,0.7680890538033395
166,632,걸작/Noun,533,459,74,0.005101927394793589,0.0008219117222382655,0.8611632270168855
167,633,그나마/Adverb,532,40,492,0.0004446124091323389,0.005464602261367928,0.924812030075188
168,634,억지/Noun,527,72,455,0.00080030233643821,0.005053646400248795,0.8633776091081594
169,635,대체/Noun,527,89,438,0.000989262610319454,0.004864828842437301,0.8311195445920304
170,638,시절/Noun,526,397,129,0.004412778160638464,0.0014327920563342734,0.7547528517110266
171,640,존나/Noun,525,122,403,0.0013560678478536335,0.004476086811648933,0.7676190476190476
172,654,B/Alpha,514,133,381,0.0014783362603650269,0.00423173467801053,0.7412451361867705
173,659,순수하다/Adjective,506,433,73,0.0048129293288575676,0.0008108048070728836,0.8557312252964426
174,660,휴/Exclamation,506,86,420,0.0009559166796345287,0.004664904369460426,0.8300395256916996
175,670,만점/Noun,501,423,78,0.004701776226574484,0.0008663393828997934,0.844311377245509
176,675,간만/Noun,496,400,96,0.004446124091323389,0.0010662638558766688,0.8064516129032258
177,683,라도/Josa,488,145,343,0.0016117199831047284,0.0038096719017260148,0.7028688524590164
178,684,~!/Punctuation,487,385,102,0.004279394437898762,0.0011329053468689607,0.7905544147843943
179,685,CG/Alpha,487,126,361,0.0014005290887668675,0.00400959637470289,0.7412731006160165
180,693,사회/Noun,481,337,144,0.0037458595469399545,0.0015993957838150033,0.7006237006237006
181,697,발연기/Noun,477,34,443,0.0003779205477624881,0.004920363418264211,0.9287211740041929
182,698,무슨/Modifier,476,124,352,0.0013782984683102506,0.003909634138214452,0.7394957983193278
183,707,ㅉㅉ/KoreanParticle,466,72,394,0.00080030233643821,0.004376124575160495,0.8454935622317596
184,710,꿈/Noun,465,353,112,0.003923704510592891,0.0012439744985227805,0.7591397849462366
185,714,에요/Josa,461,357,104,0.003968165751506125,0.0011551191771997243,0.7744034707158352
186,718,이/Foreign,458,326,132,0.003623591134428562,0.0014661128018304194,0.7117903930131004
187,722,;;;/Punctuation,457,106,351,0.001178222884200698,0.0038985272230490703,0.7680525164113785
188,723,사랑스럽다/Adjective,456,433,23,0.0048129293288575676,0.0002554590488037852,0.949561403508772
189,724,돋다/Verb,454,348,106,0.0038681279594513476,0.0011773330075304884,0.7665198237885462
190,730,이라도/Josa,446,106,340,0.001178222884200698,0.0037763511562298687,0.7623318385650224
191,732,감사하다/Verb,445,404,41,0.004490585332236623,0.00045538352178066063,0.907865168539326
192,736,시즌/Noun,442,315,127,0.003501322721917169,0.0014105782260035095,0.7126696832579186
193,742,지나다/Verb,435,309,126,0.003434630860547318,0.0013994713108381278,0.7103448275862069
194,746,삼류/Noun,433,33,400,0.00036680523753417966,0.004442766066152787,0.9237875288683602
195,747,몇번/Noun,431,334,97,0.00371251361625503,0.0010773707710420508,0.7749419953596288
196,748,진정하다/Adjective,431,313,118,0.003479092101460552,0.001310615989515072,0.7262180974477959
197,762,질질/Noun,419,72,347,0.00080030233643821,0.003854099562387543,0.8281622911694511
198,770,점주/Noun,415,98,317,0.0010893004023742304,0.0035208921074260835,0.763855421686747
199,773,망치다/Verb,414,42,372,0.00046684302958895584,0.004131772441522092,0.8985507246376812
200,774,답/Noun,413,100,313,0.0011115310228308473,0.0034764644467645558,0.7578692493946732
201,775,넘치다/Adjective,412,298,114,0.003312362448035925,0.001266188328853544,0.7233009708737864
202,777,성하다/Adjective,410,37,373,0.00041126647844741344,0.0041428793566874724,0.9097560975609756
203,779,낭비/Noun,408,8,400,8.892248182646779e-05,0.004442766066152787,0.9803921568627452
204,783,각본/Noun,407,121,286,0.001344952537625325,0.0031765777372992424,0.7027027027027027
205,785,맞추다/Verb,404,109,295,0.0012115688148856235,0.00327653997378768,0.7301980198019802
206,794,갑자기/Noun,396,103,293,0.0011448769535157724,0.003254326143456916,0.73989898989899
207,797,이하/Noun,395,34,361,0.0003779205477624881,0.00400959637470289,0.9139240506329114
208,800,기다리다/Verb,392,279,113,0.003101171553698064,0.0012550814136881624,0.7117346938775511
209,802,너무하다/Adjective,390,50,340,0.0005557655114154236,0.0037763511562298687,0.8717948717948718
210,803,의도/Noun,390,66,324,0.0007336104750683593,0.003598640513583757,0.8307692307692308
211,804,발/Noun,390,81,309,0.0009003401284929863,0.003432036786103028,0.7923076923076923
212,805,영/Noun,390,107,283,0.0011893381944290064,0.0031432569918030968,0.7256410256410256
213,810,넣다/Verb,385,86,299,0.0009559166796345287,0.0033209676344492078,0.7766233766233767
214,815,오글거리다/Verb,384,63,321,0.0007002645443834338,0.0035653197680876117,0.8359375
215,821,굳다/Adjective,381,349,32,0.003879243269679657,0.00035542128529222287,0.9160104986876642
216,824,볼때/Noun,380,276,104,0.0030678256230131378,0.0011551191771997243,0.7263157894736842
217,830,10년/Number,376,276,100,0.0030678256230131378,0.0011106915165381968,0.7340425531914894
218,834,첨/Adverb,374,111,263,0.0012337994353422404,0.002921118688495457,0.7032085561497327
219,839,그때/Noun,371,269,102,0.002990018451414979,0.0011329053468689607,0.7250673854447439
220,846,뻔/Noun,367,98,269,0.0010893004023742304,0.0029877601794877488,0.7329700272479565
221,849,거지/Noun,366,99,267,0.0011004157126025386,0.0029655463491569853,0.7295081967213115
222,855,짱/Suffix,361,320,41,0.003556899273058711,0.00045538352178066063,0.8864265927977839
223,857,진행/Noun,360,97,263,0.0010781850921459217,0.002921118688495457,0.7305555555555555
224,862,이에요/Josa,358,286,72,0.003178978725296223,0.0007996978919075017,0.7988826815642458
225,863,더욱/Noun,358,281,77,0.0031234021741546806,0.0008552324677344116,0.7849162011173184
226,864,tv/Alpha,358,103,255,0.0011448769535157724,0.0028322633671724017,0.7122905027932961
227,866,탄탄하다/Adjective,357,320,37,0.003556899273058711,0.0004109558611191328,0.8963585434173671
228,867,돋보이다/Verb,357,275,82,0.00305671031278483,0.0009107670435613213,0.7703081232492998
229,870,어이/Noun,355,29,326,0.0003223439966209457,0.003620854343914521,0.9183098591549296
230,874,참고/Noun,354,65,289,0.0007224951648400508,0.003209898482795389,0.8163841807909604
231,875,불편하다/Adjective,354,99,255,0.0011004157126025386,0.0028322633671724017,0.7203389830508474
232,880,흐르다/Verb,352,282,70,0.003134517484382989,0.0007774840615767378,0.8011363636363636
233,881,그녀/Noun,352,266,86,0.0029566725207300537,0.0009551947042228492,0.7556818181818182
234,882,억지스럽다/Adjective,351,50,301,0.0005557655114154236,0.003343181464779972,0.8575498575498576
235,883,걸리다/Verb,351,96,255,0.0010670697819176133,0.0028322633671724017,0.7264957264957265
236,884,끼다/Verb,351,101,250,0.0011226463330591557,0.002776728791345492,0.7122507122507122
237,894,이냐/Josa,345,47,298,0.0005224195807304982,0.003309860719283826,0.8637681159420291
238,896,허무하다/Adjective,344,85,259,0.0009448013694062199,0.002876691027833929,0.7529069767441859
239,899,술/Noun,342,58,284,0.0006446879932418914,0.0031543639069684785,0.8304093567251462
240,900,전형/Noun,342,64,278,0.0007113798546117423,0.0030877224159761873,0.8128654970760234
241,901,똑같다/Adjective,341,86,255,0.0009559166796345287,0.0028322633671724017,0.7478005865102639
242,904,잠/Noun,339,82,257,0.0009114554387212947,0.0028544771975031647,0.7581120943952803
243,910,화이팅/Noun,334,296,38,0.003290131827579308,0.0004220627762845148,0.8862275449101796
244,915,식상하다/Adjective,333,37,296,0.00041126647844741344,0.003287646888953062,0.8888888888888888
245,921,꿀잼/Noun,330,316,14,0.003512438032145477,0.0001554968123153475,0.9575757575757576
246,922,똥/Noun,330,29,301,0.0003223439966209457,0.003343181464779972,0.912121212121212
247,923,그게/Noun,330,91,239,0.001011493230776071,0.0026545527245262907,0.7242424242424242
248,931,-_-/Punctuation,327,38,289,0.000422381788675722,0.003209898482795389,0.8837920489296636
249,938,엉망/Noun,326,22,304,0.00024453682502278637,0.003376502210276118,0.9325153374233128
250,939,병맛/Noun,326,57,269,0.0006335726830135829,0.0029877601794877488,0.8251533742331288
251,940,티/Noun,325,91,234,0.001011493230776071,0.0025990181486993803,0.72
252,944,뛰어나다/Adjective,324,238,86,0.0026454438343374164,0.0009551947042228492,0.7345679012345679
253,951,지겹다/Adjective,323,29,294,0.0003223439966209457,0.0032654330586222983,0.9102167182662538
254,952,미화/Noun,323,44,279,0.0004890736500455726,0.003098829331141569,0.8637770897832817
255,953,~!!/Punctuation,323,253,70,0.0028121734877620433,0.0007774840615767378,0.7832817337461301
256,958,헐다/Verb,322,92,230,0.0010226085410043797,0.002554590488037853,0.7142857142857143
257,962,흥미진진/Noun,321,276,45,0.0030678256230131378,0.0004998111824421885,0.8598130841121495
258,967,훈훈하다/Adjective,319,281,38,0.0031234021741546806,0.0004220627762845148,0.8808777429467085
259,969,잘만/Noun,318,239,79,0.002656559144565725,0.0008774462980651753,0.7515723270440252
260,972,만으로도/Josa,316,285,31,0.0031678634150679144,0.00034431437012684104,0.9018987341772152
261,973,낫다/Verb,316,91,225,0.001011493230776071,0.002499055912210943,0.7120253164556962
262,974,나르다/Verb,316,224,92,0.0024898294911410977,0.0010218361952151409,0.7088607594936709
263,976,비추다/Verb,315,48,267,0.0005335348909588066,0.0029655463491569853,0.8476190476190476
264,977,괜히/Adverb,315,80,235,0.0008892248182646778,0.002610125063864762,0.7460317460317459
265,982,그래픽/Noun,314,78,236,0.0008669941978080608,0.002621231979030144,0.7515923566878981
266,983,ost/Alpha,313,265,48,0.002945557210501745,0.0005331319279383344,0.8466453674121406
267,984,그냥/Modifier,313,87,226,0.0009670319898628369,0.002510162827376325,0.7220447284345048
268,987,그만/Adverb,312,21,291,0.00023342151479447792,0.0032321123131261523,0.9326923076923076
269,988,장/Suffix,312,89,223,0.000989262610319454,0.002476842081880179,0.7147435897435898
270,990,바보/Noun,311,85,226,0.0009448013694062199,0.002510162827376325,0.7266881028938906
271,991,성우/Noun,310,70,240,0.000778071715981593,0.002665659639691672,0.7741935483870968
272,993,소중하다/Adjective,307,226,81,0.0025120601115977146,0.0008996601283959392,0.7361563517915309
273,997,유치/Noun,306,21,285,0.00023342151479447792,0.003165470822133861,0.931372549019608
274,999,도저히/Noun,305,26,279,0.00028899806593602026,0.003098829331141569,0.9147540983606556
275,1000,한심하다/Adjective,305,33,272,0.00036680523753417966,0.003021080924983895,0.8918032786885246
276,1001,식/Noun,305,72,233,0.00080030233643821,0.002587911233533998,0.7639344262295082
277,1006,역겹다/Adjective,304,37,267,0.00041126647844741344,0.0029655463491569853,0.8782894736842105
278,1007,울/Noun,304,228,76,0.0025342907320543315,0.0008441255525690295,0.75
279,1016,천재/Noun,301,236,65,0.0026232132138807995,0.0007219494857498278,0.7840531561461794
280,1018,억지로/Noun,300,42,258,0.00046684302958895584,0.002865584112668547,0.86
281,1019,우연히/Adverb,300,258,42,0.0028677500389035857,0.00046649043694604257,0.86
282,1021,화가/Noun,299,75,224,0.0008336482671231353,0.0024879489970455605,0.7491638795986622
283,1023,댓글/Noun,297,75,222,0.0008336482671231353,0.002465735166714797,0.7474747474747475
284,1026,속/Modifier,296,73,223,0.0008114176466665183,0.002476842081880179,0.7533783783783784
285,1029,개다/Verb,295,73,222,0.0008114176466665183,0.002465735166714797,0.7525423728813561
286,1030,새끼/Noun,295,80,215,0.0008892248182646778,0.002387986760557123,0.7288135593220338
287,1031,척/Noun,294,58,236,0.0006446879932418914,0.002621231979030144,0.8027210884353742
288,1032,예고편/Noun,294,69,225,0.0007669564057532844,0.002499055912210943,0.7653061224489796
289,1039,good/Alpha,291,213,78,0.0023675610786297045,0.0008663393828997934,0.7319587628865979
290,1042,잊혀지다/Verb,289,255,34,0.002834404108218661,0.00037763511562298685,0.8823529411764706
291,1043,불륜/Noun,289,75,214,0.0008336482671231353,0.002376879845391741,0.740484429065744
292,1044,젠/Noun,289,80,209,0.0008892248182646778,0.002321345269564831,0.7231833910034602
293,1046,대작/Noun,288,231,57,0.002567636662739257,0.0006330941644267722,0.8020833333333334
294,1053,미안하다/Adjective,287,74,213,0.0008225329568948269,0.002365772930226359,0.7421602787456446
295,1056,열/Noun,286,78,208,0.0008669941978080608,0.0023102383543994486,0.7272727272727273
296,1068,실망하다/Adjective,283,60,223,0.0006669186136985082,0.002476842081880179,0.7879858657243817
297,1069,짓/Noun,283,70,213,0.000778071715981593,0.002365772930226359,0.7526501766784452
298,1070,환상/Noun,283,207,76,0.002300869217259854,0.0008441255525690295,0.7314487632508834
299,1073,오래/Adverb,282,230,52,0.002556521352510949,0.0005775595885998622,0.8156028368794326
300,1077,그닥/Noun,280,25,255,0.0002778827557077118,0.0028322633671724017,0.9107142857142856
301,1078,귀신/Noun,280,71,209,0.0007891870262099014,0.002321345269564831,0.7464285714285714
302,1082,산/Noun,279,67,212,0.0007447257852966678,0.002354666015060977,0.7598566308243727
303,1085,빠져들다/Verb,278,264,14,0.0029344419002734373,0.0001554968123153475,0.9496402877697842
304,1086,흘리다/Verb,278,211,67,0.002345330458173088,0.0007441633160805918,0.7589928057553957
305,1087,전작/Noun,277,72,205,0.00080030233643821,0.002276917608903303,0.740072202166065
306,1090,♡/Foreign,276,264,12,0.0029344419002734373,0.0001332829819845836,0.9565217391304348
307,1092,현재/Noun,275,205,70,0.002278638596803237,0.0007774840615767378,0.7454545454545455
308,1096,쩔다/Verb,274,216,58,0.00240090700931463,0.0006442010795921541,0.7883211678832117
309,1099,제작비/Noun,273,38,235,0.000422381788675722,0.002610125063864762,0.8608058608058609
310,1100,영원하다/Adjective,273,231,42,0.002567636662739257,0.00046649043694604257,0.8461538461538461
311,1101,예요/Josa,273,206,67,0.0022897539070315448,0.0007441633160805918,0.7545787545787546
312,1106,통해/Noun,271,217,54,0.0024120223195429388,0.0005997734189306263,0.8007380073800738
313,1107,잘생기다/Adjective,271,198,73,0.002200831425205077,0.0008108048070728836,0.7306273062730627
314,1114,망작/Noun,268,16,252,0.00017784496365293558,0.002798942621676256,0.9402985074626866
315,1120,드럽다/Adjective,266,24,242,0.0002667674454794033,0.002687873470022436,0.9097744360902256
316,1121,동화/Noun,266,189,77,0.002100793633150301,0.0008552324677344116,0.7105263157894737
317,1130,예산/Noun,264,65,199,0.0007224951648400508,0.0022102761179110114,0.7537878787878788
318,1138,멍청하다/Adjective,260,38,222,0.000422381788675722,0.002465735166714797,0.8538461538461538
319,1139,강/Noun,260,197,63,0.002189716114976769,0.0006997356554190639,0.7576923076923077
320,1147,졸라/Noun,258,75,183,0.0008336482671231353,0.0020325654752649,0.7093023255813954
321,1157,외/Noun,256,70,186,0.000778071715981593,0.002065886220761046,0.7265625
322,1161,낚/Noun,254,20,234,0.00022230620456616945,0.0025990181486993803,0.9212598425196852
323,1164,모/Noun,253,66,187,0.0007336104750683593,0.002076993135926428,0.7391304347826086
324,1167,끌다/Verb,252,68,184,0.0007558410955249762,0.0020436723904302817,0.7301587301587301
325,1169,반개/Noun,251,5,246,5.557655114154236e-05,0.002732301130683964,0.9800796812749004
326,1170,짱/VerbPrefix,251,225,26,0.0025009448013694068,0.00028877979429993113,0.896414342629482
327,1171,지루/Noun,250,21,229,0.00023342151479447792,0.0025434835728724704,0.9159999999999999
328,1173,황당하다/Adjective,249,38,211,0.000422381788675722,0.002343559099895595,0.8473895582329317
329,1176,약하다/Adjective,248,71,177,0.0007891870262099014,0.001965923984272608,0.7137096774193549
330,1181,졸리다/Verb,247,27,220,0.0003001133761643288,0.0024435213363840328,0.8906882591093117
331,1182,용도/Noun,247,57,190,0.0006335726830135829,0.0021103138814225733,0.7692307692307693
332,1183,희망/Noun,246,210,36,0.002334215147944779,0.00039984894595375083,0.8536585365853658
333,1186,위대하다/Adjective,245,185,60,0.002056332392237067,0.000666414909922918,0.7551020408163265
334,1187,청춘/Noun,245,172,73,0.0019118333592690567,0.0008108048070728836,0.7020408163265306
335,1193,깊이/Noun,244,172,72,0.0019118333592690567,0.0007996978919075017,0.7049180327868853
336,1199,cg/Alpha,243,62,181,0.0006891492341551253,0.002010351644934136,0.7448559670781894
337,1202,기세/Noun,242,7,235,7.78071715981593e-05,0.002610125063864762,0.9710743801652892
338,1213,노출/Noun,240,57,183,0.0006335726830135829,0.0020325654752649,0.7625
339,1214,다시다/Verb,240,72,168,0.00080030233643821,0.0018659617477841703,0.7
340,1216,살아가다/Verb,239,217,22,0.0024120223195429388,0.00024435213363840333,0.9079497907949792
341,1224,대안/Noun,237,199,38,0.002211946735433386,0.0004220627762845148,0.8396624472573839
342,1226,산만하다/Adjective,236,19,217,0.00021119089433786097,0.002410200590887887,0.9194915254237288
343,1228,미소/Noun,235,212,23,0.002356445768401396,0.0002554590488037852,0.9021276595744679
344,1229,결론/Noun,235,63,172,0.0007002645443834338,0.0019103894084456985,0.7319148936170212
345,1233,설레다/Adjective,234,212,22,0.002356445768401396,0.00024435213363840333,0.9059829059829059
346,1236,OST/Alpha,233,191,42,0.0021230242536069183,0.00046649043694604257,0.8197424892703863
347,1242,지나치다/Verb,230,55,175,0.000611342062556966,0.0019437101539418445,0.7608695652173914
348,1249,왠만하다/Adjective,228,20,208,0.00022230620456616945,0.0023102383543994486,0.912280701754386
349,1250,멋/Noun,228,174,54,0.0019340639797256738,0.0005997734189306263,0.7631578947368421
350,1251,범인/Noun,228,62,166,0.0006891492341551253,0.0018437479174534066,0.7280701754385965
351,1260,손발/Noun,225,22,203,0.00024453682502278637,0.002254703778572539,0.9022222222222224
352,1262,고맙다/Adjective,224,180,44,0.002000755841095525,0.0004887042672768067,0.8035714285714286
353,1264,졸다/Verb,223,13,210,0.00014449903296801013,0.002332452184730213,0.9417040358744396
354,1265,굳이/Noun,223,45,178,0.0005001889602738814,0.0019770308994379896,0.7982062780269058
355,1271,거지같다/Adjective,222,19,203,0.00021119089433786097,0.002254703778572539,0.9144144144144144
356,1272,떠오르다/Verb,222,164,58,0.0018229108774425891,0.0006442010795921541,0.7387387387387387
357,1273,밤/Noun,222,158,64,0.0017562190160727387,0.0007108425705844457,0.7117117117117117
358,1277,별루/Noun,220,12,208,0.00013338372273970166,0.0023102383543994486,0.9454545454545454
359,1278,슬픔/Noun,220,192,28,0.0021341395638352265,0.000310993624630695,0.8727272727272727
360,1284,포장/Noun,219,20,199,0.00022230620456616945,0.0022102761179110114,0.9086757990867579
361,1285,주기/Noun,219,40,179,0.0004446124091323389,0.001988137814603372,0.817351598173516
362,1286,시도/Noun,219,57,162,0.0006335726830135829,0.0017993202567918784,0.7397260273972602
363,1287,ㅅㅂ/KoreanParticle,218,20,198,0.00022230620456616945,0.0021991692027456293,0.908256880733945
364,1288,아침/Noun,218,56,162,0.0006224573727852744,0.0017993202567918784,0.7431192660550459
365,1297,광고/Noun,216,47,169,0.0005224195807304982,0.0018770686629495524,0.7824074074074074
366,1300,짱/Modifier,215,181,34,0.0020118711513238334,0.00037763511562298685,0.8418604651162791
367,1305,암/Noun,214,59,155,0.0006558033034701999,0.0017215718506342046,0.7242990654205608
368,1309,눈물나다/Verb,213,183,30,0.0020341017717804503,0.000333207454961459,0.8591549295774648
369,1312,성도/Noun,212,25,187,0.0002778827557077118,0.002076993135926428,0.8820754716981132
370,1313,한계/Noun,212,38,174,0.000422381788675722,0.0019326032387764625,0.8207547169811321
371,1314,그럭저럭/Adverb,212,52,160,0.0005779961318720405,0.0017771064264611148,0.7547169811320755
372,1315,전/Foreign,212,157,55,0.00174510370584443,0.0006108803340960082,0.7405660377358491
373,1316,조차/Josa,212,56,156,0.0006224573727852744,0.0017326787657995868,0.7358490566037735
374,1323,~^^/Punctuation,211,202,9,0.0022452926661183114,9.996223648843771e-05,0.957345971563981
375,1329,깔끔하다/Adjective,210,167,43,0.001856256808127515,0.0004775973521114245,0.7952380952380952
376,1333,발견/Noun,209,175,34,0.0019451792899539827,0.00037763511562298685,0.8373205741626795
377,1339,개도/Noun,208,25,183,0.0002778827557077118,0.0020325654752649,0.8798076923076923
378,1344,짱짱/Noun,207,199,8,0.002211946735433386,8.885532132305573e-05,0.961352657004831
379,1345,부족/Noun,207,29,178,0.0003223439966209457,0.0019770308994379896,0.8599033816425121
380,1346,지난/Noun,207,159,48,0.0017673343263010473,0.0005331319279383344,0.7681159420289855
381,1352,대충/Noun,206,37,169,0.00041126647844741344,0.0018770686629495524,0.8203883495145631
382,1360,감탄/Noun,205,177,28,0.0019674099104106,0.000310993624630695,0.8634146341463415
383,1361,빨/Noun,205,54,151,0.0006002267523286575,0.001677144189972677,0.7365853658536585
384,1367,시청자/Noun,204,41,163,0.00045572771936064734,0.001810427171957261,0.7990196078431373
385,1368,홍보/Noun,204,43,161,0.00047795833981726434,0.001788213341626497,0.7892156862745098
386,1369,담기다/Verb,204,160,44,0.0017784496365293556,0.0004887042672768067,0.7843137254901961
387,1375,아오/Exclamation,203,29,174,0.0003223439966209457,0.0019326032387764625,0.8571428571428571
388,1378,울리다/Verb,202,175,27,0.0019451792899539827,0.0002998867094653131,0.8663366336633663
389,1379,지르다/Verb,202,42,160,0.00046684302958895584,0.0017771064264611148,0.7920792079207921
390,1380,소름끼치다/Verb,202,155,47,0.0017228730853878133,0.0005220250127729526,0.7673267326732673
391,1383,일상/Noun,201,154,47,0.0017117577751595047,0.0005220250127729526,0.7661691542288557
392,1384,포기/Noun,201,56,145,0.0006224573727852744,0.001610502698980385,0.7213930348258707
393,1388,접다/Verb,199,22,177,0.00024453682502278637,0.001965923984272608,0.8894472361809045
394,1389,30분/Number,199,51,148,0.0005668808216437321,0.001643823444476531,0.7437185929648241
395,1390,에서의/Josa,199,143,56,0.0015894893626481115,0.0006219872492613901,0.7185929648241206
396,1393,이따위/Modifier,198,8,190,8.892248182646779e-05,0.0021103138814225733,0.9595959595959596
397,1394,눈빛/Noun,198,175,23,0.0019451792899539827,0.0002554590488037852,0.8838383838383839
398,1395,10분/Number,198,36,162,0.000400151168219105,0.0017993202567918784,0.8181818181818182
399,1401,말로/Noun,197,140,57,0.001556143431963186,0.0006330941644267722,0.7106598984771574
400,1404,뜬금/Noun,196,17,179,0.00018896027388124405,0.001988137814603372,0.9132653061224488
401,1405,핵/Noun,196,37,159,0.00041126647844741344,0.0017659995112957324,0.8112244897959183
402,1406,상처/Noun,196,143,53,0.0015894893626481115,0.0005886665037652442,0.7295918367346939
403,1414,끌/Noun,195,22,173,0.00024453682502278637,0.0019214963236110802,0.8871794871794871
404,1415,힐링/Noun,195,171,24,0.001900718049040749,0.0002665659639691672,0.8769230769230769
405,1416,혹시/Noun,195,48,147,0.0005335348909588066,0.0016327165293111491,0.7538461538461538
406,1417,막판/Noun,195,58,137,0.0006446879932418914,0.0015216473776573296,0.7025641025641025
407,1421,무겁다/Adjective,194,158,36,0.0017562190160727387,0.00039984894595375083,0.8144329896907216
408,1422,우정/Noun,194,143,51,0.0015894893626481115,0.0005664526734344802,0.7371134020618557
409,1423,해피엔딩/Noun,194,138,56,0.0015339128115065689,0.0006219872492613901,0.711340206185567
410,1430,참다/Verb,193,36,157,0.000400151168219105,0.0017437856809649687,0.8134715025906736
411,1439,아련하다/Adjective,191,184,7,0.002045217082008759,7.774840615767377e-05,0.9633507853403142
412,1440,보아/Noun,191,134,57,0.001489451570593335,0.0006330941644267722,0.7015706806282722
413,1444,개판/Noun,190,8,182,8.892248182646779e-05,0.002021458560099518,0.9578947368421052
414,1445,뭐임/Noun,190,15,175,0.00016672965342462708,0.0019437101539418445,0.9210526315789472
415,1446,나머지/Noun,190,38,152,0.000422381788675722,0.001688251105138059,0.8
416,1447,벌써/Noun,190,146,44,0.0016228352933330367,0.0004887042672768067,0.7684210526315789
417,1453,소장/Noun,189,173,16,0.0019229486694973656,0.00017771064264611146,0.9153439153439152
418,1454,비극/Noun,189,143,46,0.0015894893626481115,0.0005109180976075704,0.7566137566137566
419,1455,까지는/Josa,189,51,138,0.0005668808216437321,0.0015327542928227115,0.7301587301587301
420,1460,벗다/Verb,188,41,147,0.00045572771936064734,0.0016327165293111491,0.7819148936170213
421,1461,난해하다/Adjective,188,45,143,0.0005001889602738814,0.0015882888686496212,0.7606382978723404
422,1462,섹스/Noun,188,51,137,0.0005668808216437321,0.0015216473776573296,0.7287234042553191
423,1467,형편/Noun,187,18,169,0.0002000755841095525,0.0018770686629495524,0.9037433155080212
424,1468,본방/Noun,187,166,21,0.0018451414978992067,0.00023324521847302128,0.8877005347593583
425,1469,감명/Noun,187,164,23,0.0018229108774425891,0.0002554590488037852,0.8770053475935828
426,1473,펑펑/Noun,186,179,7,0.0019896405308672165,7.774840615767377e-05,0.9623655913978496
427,1482,그다지/Noun,185,18,167,0.0002000755841095525,0.0018548548326187888,0.9027027027027028
428,1483,토/Noun,185,44,141,0.0004890736500455726,0.0015660750383188573,0.7621621621621621
429,1484,떼다/Verb,185,140,45,0.001556143431963186,0.0004998111824421885,0.7567567567567568
430,1487,불가/Noun,184,41,143,0.00045572771936064734,0.0015882888686496212,0.7771739130434783
431,1491,꼴/Noun,183,23,160,0.00025565213525109487,0.0017771064264611148,0.8743169398907104
432,1492,표절/Noun,183,24,159,0.0002667674454794033,0.0017659995112957324,0.8688524590163934
433,1493,행복/Noun,183,153,30,0.0017006424649311962,0.000333207454961459,0.8360655737704918
434,1494,딱하다/Adjective,183,31,152,0.00034457461707756266,0.001688251105138059,0.8306010928961749
435,1498,글쎄/Noun,182,21,161,0.00023342151479447792,0.001788213341626497,0.8846153846153846
436,1499,색다르다/Adjective,182,141,41,0.0015672587421914947,0.00045538352178066063,0.7747252747252747
437,1500,기본/Noun,182,50,132,0.0005557655114154236,0.0014661128018304194,0.7252747252747253
438,1501,오버/Noun,182,51,131,0.0005668808216437321,0.0014550058866650375,0.7197802197802198
439,1506,에만/Josa,181,44,137,0.0004890736500455726,0.0015216473776573296,0.7569060773480663
440,1514,쓰래/Noun,180,10,170,0.00011115310228308472,0.0018881755781149344,0.9444444444444444
441,1515,불쾌하다/Adjective,180,23,157,0.00025565213525109487,0.0017437856809649687,0.8722222222222222
442,1516,느리다/Adjective,180,42,138,0.00046684302958895584,0.0015327542928227115,0.7666666666666667
443,1521,싸다/Verb,179,41,138,0.00045572771936064734,0.0015327542928227115,0.770949720670391
444,1522,촌스럽다/Adjective,179,50,129,0.0005557655114154236,0.0014327920563342734,0.7206703910614525
445,1531,그렇다고/Conjunction,178,34,144,0.0003779205477624881,0.0015993957838150033,0.8089887640449438
446,1536,이제야/Noun,177,157,20,0.00174510370584443,0.00022213830330763932,0.8870056497175142
447,1537,적절하다/Adjective,177,137,40,0.0015227975012782607,0.0004442766066152787,0.7740112994350282
448,1538,깨닫다/Verb,177,133,44,0.0014783362603650269,0.0004887042672768067,0.7514124293785308
449,1543,오그라들다/Verb,176,19,157,0.00021119089433786097,0.0017437856809649687,0.8920454545454546
450,1544,긴장/Noun,176,134,42,0.001489451570593335,0.00046649043694604257,0.7613636363636364
451,1545,게이/Noun,176,47,129,0.0005224195807304982,0.0014327920563342734,0.7329545454545454
452,1550,언제나/Adverb,175,128,47,0.0014227597092234846,0.0005220250127729526,0.7314285714285714
453,1554,열정/Noun,174,148,26,0.0016450659137896538,0.00028877979429993113,0.8505747126436781
454,1555,소소하다/Adjective,174,143,31,0.0015894893626481115,0.00034431437012684104,0.8218390804597702
455,1556,빛나다/Verb,174,131,43,0.0014561056399084098,0.0004775973521114245,0.7528735632183908
456,1557,이루다/Verb,174,126,48,0.0014005290887668675,0.0005331319279383344,0.7241379310344828
457,1559,아픔/Noun,173,146,27,0.0016228352933330367,0.0002998867094653131,0.8439306358381503
458,1560,창/Noun,173,31,142,0.00034457461707756266,0.0015771819534842392,0.8208092485549133
459,1561,선생님/Noun,173,129,44,0.0014338750194517929,0.0004887042672768067,0.7456647398843931
460,1562,병/Noun,173,51,122,0.0005668808216437321,0.0013550436501765998,0.7052023121387283
461,1565,강렬하다/Adjective,172,147,25,0.0016339506035613453,0.0002776728791345492,0.8546511627906976
462,1566,화나다/Verb,172,30,142,0.00033345930684925416,0.0015771819534842392,0.8255813953488372
463,1567,짝/Noun,172,34,138,0.0003779205477624881,0.0015327542928227115,0.8023255813953488
464,1574,질리/Noun,171,160,11,0.0017784496365293556,0.00012217606681920164,0.935672514619883
465,1575,쩝/Adverb,171,28,143,0.0003112286863926372,0.0015882888686496212,0.8362573099415205
466,1576,극치/Noun,171,28,143,0.0003112286863926372,0.0015882888686496212,0.8362573099415205
467,1577,까지도/Josa,171,135,36,0.0015005668808216438,0.00039984894595375083,0.7894736842105263
468,1578,밥/Noun,171,47,124,0.0005224195807304982,0.0013772574805073642,0.7251461988304093
469,1583,찡하다/Adjective,170,165,5,0.0018340261876708976,5.5534575826909837e-05,0.9705882352941176
470,1584,주기도/Noun,170,6,164,6.669186136985083e-05,0.0018215340871226425,0.9647058823529412
471,1585,노답/Noun,170,14,156,0.0001556143431963186,0.0017326787657995868,0.9176470588235294
472,1586,빡치다/Adjective,170,27,143,0.0003001133761643288,0.0015882888686496212,0.8411764705882353
473,1593,죄다/Adverb,169,19,150,0.00021119089433786097,0.001666037274807295,0.8875739644970414
474,1594,싸구려/Noun,169,21,148,0.00023342151479447792,0.001643823444476531,0.8757396449704142
475,1595,때우다/Verb,169,36,133,0.000400151168219105,0.0014772197169958016,0.7869822485207101
476,1596,에로/Josa,169,39,130,0.0004334970989040304,0.0014438989714996556,0.7692307692307693
477,1601,섬세하다/Adjective,168,146,22,0.0016228352933330367,0.00024435213363840333,0.8690476190476191
478,1602,풋풋하다/Adjective,168,144,24,0.00160060467287642,0.0002665659639691672,0.8571428571428571
479,1603,어머니/Noun,168,123,45,0.001367183158081942,0.0004998111824421885,0.7321428571428571
480,1611,제로/Noun,167,16,151,0.00017784496365293558,0.001677144189972677,0.9041916167664672
481,1612,유발/Noun,167,21,146,0.00023342151479447792,0.0016216096141457672,0.8742514970059879
482,1613,필름/Noun,167,34,133,0.0003779205477624881,0.0014772197169958016,0.7964071856287425
483,1614,조절/Noun,167,40,127,0.0004446124091323389,0.0014105782260035095,0.7604790419161677
484,1615,놓치다/Verb,167,125,42,0.001389413778538559,0.00046649043694604257,0.7485029940119761
485,1627,조잡하다/Adjective,165,7,158,7.78071715981593e-05,0.0017548925961303507,0.9575757575757576
486,1636,굿굿/Noun,164,161,3,0.001789564946757664,3.33207454961459e-05,0.9817073170731708
487,1637,좋아지다/Verb,164,134,30,0.001489451570593335,0.000333207454961459,0.8170731707317073
488,1638,통쾌하다/Adjective,164,128,36,0.0014227597092234846,0.00039984894595375083,0.7804878048780488
489,1639,심각하다/Adjective,164,43,121,0.00047795833981726434,0.001343936735011218,0.7378048780487805
490,1646,어휴/Exclamation,163,21,142,0.00023342151479447792,0.0015771819534842392,0.8711656441717791
491,1647,실패/Noun,163,27,136,0.0003001133761643288,0.0015105404624919474,0.8343558282208589
492,1648,아줌마/Noun,163,46,117,0.0005113042705021896,0.0012995090743496902,0.7177914110429447
493,1654,다가오다/Verb,162,132,30,0.0014672209501367186,0.000333207454961459,0.8148148148148148
494,1655,은근/Noun,162,127,35,0.001411644398995176,0.0003887420307883688,0.7839506172839507
495,1656,심장/Noun,162,126,36,0.0014005290887668675,0.00039984894595375083,0.7777777777777778
496,1657,바라보다/Verb,162,126,36,0.0014005290887668675,0.00039984894595375083,0.7777777777777778
497,1658,씁쓸하다/Adjective,162,120,42,0.0013338372273970164,0.00046649043694604257,0.7407407407407407
498,1666,없어지다/Verb,161,37,124,0.00041126647844741344,0.0013772574805073642,0.7701863354037267
499,1667,숨다/Verb,161,121,40,0.001344952537625325,0.0004442766066152787,0.7515527950310559
500,1671,1시간/Number,160,35,125,0.0003890358579907965,0.001388364395672746,0.78125
501,1672,늦다/Verb,160,123,37,0.001367183158081942,0.0004109558611191328,0.76875
502,1680,명품/Noun,159,135,24,0.0015005668808216438,0.0002665659639691672,0.8490566037735849
503,1681,존경/Noun,159,126,33,0.0014005290887668675,0.00036652820045760486,0.7924528301886793
504,1682,더불다/Verb,159,117,42,0.0013004912967120913,0.00046649043694604257,0.7358490566037735
505,1693,짠하다/Adjective,157,146,11,0.0016228352933330367,0.00012217606681920164,0.929936305732484
506,1694,푹/Noun,157,137,20,0.0015227975012782607,0.00022213830330763932,0.8726114649681529
507,1695,만족/Noun,157,113,44,0.0012560300557988573,0.0004887042672768067,0.7197452229299363
508,1699,쵝오/Noun,156,151,5,0.0016784118444745793,5.5534575826909837e-05,0.9679487179487181
509,1703,거슬리다/Verb,155,35,120,0.0003890358579907965,0.001332829819845836,0.7741935483870968
510,1709,짝퉁/Noun,154,7,147,7.78071715981593e-05,0.0016327165293111491,0.9545454545454546
511,1710,개뿔/Noun,154,7,147,7.78071715981593e-05,0.0016327165293111491,0.9545454545454546
512,1711,양심/Noun,154,28,126,0.0003112286863926372,0.0013994713108381278,0.8181818181818182
513,1712,????/Punctuation,154,36,118,0.000400151168219105,0.001310615989515072,0.7662337662337663
514,1713,누군가/Noun,154,118,36,0.0013116066069403995,0.00039984894595375083,0.7662337662337663
515,1714,그거/Noun,154,45,109,0.0005001889602738814,0.0012106537530266347,0.7077922077922078
516,1721,민망하다/Adjective,153,16,137,0.00017784496365293558,0.0015216473776573296,0.8954248366013072
517,1722,망/Noun,153,19,134,0.00021119089433786097,0.0014883266321611835,0.8758169934640523
518,1723,연예인/Noun,153,27,126,0.0003001133761643288,0.0013994713108381278,0.8235294117647058
519,1724,도안/Noun,153,38,115,0.000422381788675722,0.0012772952440189265,0.7516339869281046
520,1725,해내다/Verb,153,114,39,0.0012671453660271655,0.0004331696914498967,0.7450980392156863
521,1726,가요/Noun,153,39,114,0.0004334970989040304,0.001266188328853544,0.7450980392156863
522,1733,돌아보다/Verb,152,143,9,0.0015894893626481115,9.996223648843771e-05,0.9407894736842104
523,1734,의외로/Adverb,152,129,23,0.0014338750194517929,0.0002554590488037852,0.8486842105263158
524,1740,찝찝하다/Adjective,151,30,121,0.00033345930684925416,0.001343936735011218,0.8013245033112583
525,1741,사기/Noun,151,33,118,0.00036680523753417966,0.001310615989515072,0.7814569536423841
526,1750,라지/Noun,150,18,132,0.0002000755841095525,0.0014661128018304194,0.88
527,1751,날리다/Verb,150,30,120,0.00033345930684925416,0.001332829819845836,0.8
528,1761,낭비하다/Adjective,149,2,147,2.2230620456616947e-05,0.0016327165293111491,0.9865771812080536
529,1762,단연/Noun,149,128,21,0.0014227597092234846,0.00023324521847302128,0.8590604026845637
530,1763,무척/Noun,149,114,35,0.0012671453660271655,0.0003887420307883688,0.7651006711409396
531,1764,성장/Noun,149,110,39,0.001222684125113932,0.0004331696914498967,0.7382550335570469
532,1775,이도/Noun,148,5,143,5.557655114154236e-05,0.0015882888686496212,0.9662162162162162
533,1776,상/Noun,148,44,104,0.0004890736500455726,0.0011551191771997243,0.7027027027027027
534,1777,피해자/Noun,148,44,104,0.0004890736500455726,0.0011551191771997243,0.7027027027027027
535,1781,꽝/Noun,147,8,139,8.892248182646779e-05,0.0015438612079880936,0.9455782312925172
536,1782,라이/Noun,147,28,119,0.0003112286863926372,0.0013217229046804538,0.8095238095238095
537,1783,편견/Noun,147,103,44,0.0011448769535157724,0.0004887042672768067,0.7006802721088435
538,1789,사수/Noun,146,132,14,0.0014672209501367186,0.0001554968123153475,0.9041095890410958
539,1790,허세/Noun,146,18,128,0.0002000755841095525,0.0014216851411688915,0.8767123287671232
540,1791,와우/Noun,146,125,21,0.001389413778538559,0.00023324521847302128,0.8561643835616438
541,1792,명성/Noun,146,25,121,0.0002778827557077118,0.001343936735011218,0.8287671232876712
542,1793,얘/Noun,146,40,106,0.0004446124091323389,0.0011773330075304884,0.726027397260274
543,1803,개막/Noun,145,9,136,0.00010003779205477625,0.0015105404624919474,0.9379310344827586
544,1804,생생하다/Adjective,145,134,11,0.001489451570593335,0.00012217606681920164,0.9241379310344828
545,1805,^/Punctuation,145,102,43,0.0011337616432874642,0.0004775973521114245,0.7034482758620689
546,1809,뭉클하다/Adjective,144,139,5,0.0015450281217348775,5.5534575826909837e-05,0.9652777777777778
547,1810,마이너스/Noun,144,7,137,7.78071715981593e-05,0.0015216473776573296,0.9513888888888888
548,1811,밋밋하다/Adjective,144,18,126,0.0002000755841095525,0.0013994713108381278,0.875
549,1812,묘/Noun,144,118,26,0.0013116066069403995,0.00028877979429993113,0.8194444444444444
550,1817,저/Modifier,143,26,117,0.00028899806593602026,0.0012995090743496902,0.8181818181818182
551,1818,풍경/Noun,143,101,42,0.0011226463330591557,0.00046649043694604257,0.7062937062937062
552,1824,ㅉㅉㅉ/KoreanParticle,142,15,127,0.00016672965342462708,0.0014105782260035095,0.8943661971830986
553,1825,싸이코/Noun,142,29,113,0.0003223439966209457,0.0012550814136881624,0.7957746478873241
554,1826,만들기/Noun,142,30,112,0.00033345930684925416,0.0012439744985227805,0.7887323943661971
555,1827,자연스럽다/Adjective,142,112,30,0.0012449147455705488,0.000333207454961459,0.7887323943661971
556,1831,달달/Noun,141,125,16,0.001389413778538559,0.00017771064264611146,0.8865248226950354
557,1832,어린시절/Noun,141,123,18,0.001367183158081942,0.00019992447297687542,0.8723404255319149
558,1833,정체/Noun,141,30,111,0.00033345930684925416,0.0012328675833573985,0.7872340425531915
559,1834,막장드라마/Noun,141,32,109,0.00035568992730587116,0.0012106537530266347,0.7730496453900709
560,1835,왠/Modifier,141,33,108,0.00036680523753417966,0.0011995468378612525,0.7659574468085106
561,1842,♥♥/Foreign,140,140,0,0.001556143431963186,0.0,1.0
562,1843,숨기다/Verb,140,114,26,0.0012671453660271655,0.00028877979429993113,0.8142857142857143
563,1844,세월/Noun,140,105,35,0.0011671075739723895,0.0003887420307883688,0.75
564,1845,캐리/Noun,140,104,36,0.001155992263744081,0.00039984894595375083,0.7428571428571429
565,1852,일품/Noun,139,126,13,0.0014005290887668675,0.00014438989714996554,0.9064748201438848
566,1853,젠장/Noun,139,22,117,0.00024453682502278637,0.0012995090743496902,0.8417266187050358
567,1854,기회/Noun,139,106,33,0.001178222884200698,0.00036652820045760486,0.7625899280575541
568,1855,카리스마/Noun,139,105,34,0.0011671075739723895,0.00037763511562298685,0.7553956834532374
569,1858,아/Noun,138,27,111,0.0003001133761643288,0.0012328675833573985,0.8043478260869565
570,1859,칼/Noun,138,41,97,0.00045572771936064734,0.0010773707710420508,0.7028985507246377
571,1869,포르노/Noun,137,16,121,0.00017784496365293558,0.001343936735011218,0.8832116788321168
572,1870,C/Alpha,137,16,121,0.00017784496365293558,0.001343936735011218,0.8832116788321168
573,1871,응원/Noun,137,116,21,0.0012893759864837828,0.00023324521847302128,0.8467153284671532
574,1872,겨/Noun,137,26,111,0.00028899806593602026,0.0012328675833573985,0.8102189781021898
575,1873,압권/Noun,137,111,26,0.0012337994353422404,0.00028877979429993113,0.8102189781021898
576,1874,다양하다/Adjective,137,99,38,0.0011004157126025386,0.0004220627762845148,0.7226277372262774
577,1875,모으다/Verb,137,39,98,0.0004334970989040304,0.001088477686207433,0.7153284671532847
578,1886,시시하다/Adjective,136,23,113,0.00025565213525109487,0.0012550814136881624,0.8308823529411765
579,1887,세번/Noun,136,110,26,0.001222684125113932,0.00028877979429993113,0.8088235294117647
580,1888,냥/Josa,136,31,105,0.00034457461707756266,0.0011662260923651065,0.7720588235294118
581,1889,만에/Josa,136,101,35,0.0011226463330591557,0.0003887420307883688,0.7426470588235294
582,1890,내면/Noun,136,99,37,0.0011004157126025386,0.0004109558611191328,0.7279411764705882
583,1897,에로영화/Noun,135,22,113,0.00024453682502278637,0.0012550814136881624,0.837037037037037
584,1898,겨우/Noun,135,22,113,0.00024453682502278637,0.0012550814136881624,0.837037037037037
585,1899,추하다/Adjective,135,108,27,0.001200453504657315,0.0002998867094653131,0.8
586,1900,적임/Noun,135,96,39,0.0010670697819176133,0.0004331696914498967,0.7111111111111111
587,1910,야동/Noun,134,25,109,0.0002778827557077118,0.0012106537530266347,0.8134328358208955
588,1911,롭고/Josa,134,108,26,0.001200453504657315,0.00028877979429993113,0.8059701492537313
589,1924,투자/Noun,133,20,113,0.00022230620456616945,0.0012550814136881624,0.849624060150376
590,1925,레전드/Noun,133,108,25,0.001200453504657315,0.0002776728791345492,0.8120300751879699
591,1926,지우다/Verb,133,30,103,0.00033345930684925416,0.0011440122620343426,0.7744360902255639
592,1927,고통/Noun,133,95,38,0.0010559544716893046,0.0004220627762845148,0.7142857142857143
593,1937,진하다/Adjective,132,119,13,0.0013227219171687082,0.00014438989714996554,0.9015151515151516
594,1938,초등학교/Noun,132,99,33,0.0011004157126025386,0.00036652820045760486,0.75
595,1939,학년/Noun,132,96,36,0.0010670697819176133,0.00039984894595375083,0.7272727272727273
596,1950,M/Alpha,131,5,126,5.557655114154236e-05,0.0013994713108381278,0.9618320610687024
597,1951,잠들다/Verb,131,17,114,0.00018896027388124405,0.001266188328853544,0.8702290076335878
598,1952,감흥/Noun,131,19,112,0.00021119089433786097,0.0012439744985227805,0.8549618320610687
599,1953,붙이다/Verb,131,21,110,0.00023342151479447792,0.0012217606681920164,0.8396946564885496
600,1954,부럽다/Adjective,131,106,25,0.001178222884200698,0.0002776728791345492,0.8091603053435115
601,1955,설득/Noun,131,30,101,0.00033345930684925416,0.0011217984317035787,0.7709923664122137
602,1956,따로/Adverb,131,31,100,0.00034457461707756266,0.0011106915165381968,0.7633587786259542
603,1957,]/Punctuation,131,38,93,0.000422381788675722,0.001032943110380523,0.7099236641221374
604,1964,반하다/Adjective,130,112,18,0.0012449147455705488,0.00019992447297687542,0.8615384615384616
605,1965,점준/Noun,130,23,107,0.00025565213525109487,0.0011884399226958706,0.823076923076923
606,1966,인지도/Noun,130,26,104,0.00028899806593602026,0.0011551191771997243,0.8
607,1967,x/Alpha,130,34,96,0.0003779205477624881,0.0010662638558766688,0.7384615384615385
608,1968,루/Noun,130,36,94,0.000400151168219105,0.0010440500255459052,0.7230769230769231
609,1969,기발하다/Adjective,130,92,38,0.0010226085410043797,0.0004220627762845148,0.7076923076923077
610,1975,안습/Noun,129,16,113,0.00017784496365293558,0.0012550814136881624,0.875968992248062
611,1976,우려/Noun,129,18,111,0.0002000755841095525,0.0012328675833573985,0.8604651162790697
612,1977,기만/Noun,129,25,104,0.0002778827557077118,0.0011551191771997243,0.8062015503875969
613,1978,조작/Noun,129,25,104,0.0002778827557077118,0.0011551191771997243,0.8062015503875969
614,1979,고르다/Verb,129,29,100,0.0003223439966209457,0.0011106915165381968,0.7751937984496124
615,1980,오랫/Modifier,129,97,32,0.0010781850921459217,0.00035542128529222287,0.751937984496124
616,1981,스트레스/Noun,129,35,94,0.0003890358579907965,0.0010440500255459052,0.7286821705426356
617,1982,색감/Noun,129,91,38,0.001011493230776071,0.0004220627762845148,0.7054263565891473
618,1988,공짜/Noun,128,5,123,5.557655114154236e-05,0.001366150565341982,0.9609375
619,1989,18/Number,128,28,100,0.0003112286863926372,0.0011106915165381968,0.78125
620,1990,놀다/Verb,128,36,92,0.000400151168219105,0.0010218361952151409,0.71875
621,1991,아무렇다/Adjective,128,37,91,0.00041126647844741344,0.001010729280049759,0.7109375
622,2001,정신병/Noun,127,21,106,0.00023342151479447792,0.0011773330075304884,0.8346456692913385
623,2002,깨우다/Verb,127,105,22,0.0011671075739723895,0.00024435213363840333,0.8267716535433071
624,2003,아예/Noun,127,26,101,0.00028899806593602026,0.0011217984317035787,0.7952755905511811
625,2004,여러가지/Noun,127,95,32,0.0010559544716893046,0.00035542128529222287,0.7480314960629921
626,2005,미가/Noun,127,94,33,0.0010448391614609964,0.00036652820045760486,0.7401574803149606
627,2015,틈/Noun,126,106,20,0.001178222884200698,0.00022213830330763932,0.8412698412698413
628,2016,;;;;/Punctuation,126,26,100,0.00028899806593602026,0.0011106915165381968,0.7936507936507936
629,2017,껏/Noun,126,28,98,0.0003112286863926372,0.001088477686207433,0.7777777777777778
630,2018,위로/Noun,126,91,35,0.001011493230776071,0.0003887420307883688,0.7222222222222222
631,2027,효/Noun,125,24,101,0.0002667674454794033,0.0011217984317035787,0.8079999999999999
632,2028,용기/Noun,125,98,27,0.0010893004023742304,0.0002998867094653131,0.784
633,2029,뜨겁다/Adjective,125,97,28,0.0010781850921459217,0.000310993624630695,0.7759999999999999
634,2039,말아먹다/Verb,124,12,112,0.00013338372273970166,0.0012439744985227805,0.9032258064516128
635,2040,운명/Noun,124,93,31,0.0010337238512326881,0.00034431437012684104,0.75
636,2041,연인/Noun,124,91,33,0.001011493230776071,0.00036652820045760486,0.7338709677419355
637,2053,썩다/Verb,123,33,90,0.00036680523753417966,0.000999622364884377,0.7317073170731707
638,2054,확인/Noun,123,35,88,0.0003890358579907965,0.000977408534553613,0.7154471544715447
639,2064,았/Noun,122,13,109,0.00014449903296801013,0.0012106537530266347,0.8934426229508197
640,2065,번은/Noun,122,102,20,0.0011337616432874642,0.00022213830330763932,0.8360655737704918
641,2066,설마/Noun,122,22,100,0.00024453682502278637,0.0011106915165381968,0.819672131147541
642,2067,결코/Noun,122,91,31,0.001011493230776071,0.00034431437012684104,0.7459016393442623
643,2068,원/Noun,122,31,91,0.00034457461707756266,0.001010729280049759,0.7459016393442623
644,2069,잖다/Verb,122,34,88,0.0003779205477624881,0.000977408534553613,0.7213114754098361
645,2078,낮추다/Verb,121,16,105,0.00017784496365293558,0.0011662260923651065,0.8677685950413223
646,2079,셈/Noun,121,20,101,0.00022230620456616945,0.0011217984317035787,0.8347107438016529
647,2080,변태/Noun,121,21,100,0.00023342151479447792,0.0011106915165381968,0.8264462809917356
648,2081,심지어/Noun,121,31,90,0.00034457461707756266,0.000999622364884377,0.743801652892562
649,2086,잔뜩/Noun,120,15,105,0.00016672965342462708,0.0011662260923651065,0.875
650,2087,5분/Number,120,18,102,0.0002000755841095525,0.0011329053468689607,0.85
651,2088,크리스마스/Noun,120,89,31,0.000989262610319454,0.00034431437012684104,0.7416666666666667
652,2089,X/Alpha,120,31,89,0.00034457461707756266,0.0009885154497189948,0.7416666666666667
653,2100,전율/Noun,119,110,9,0.001222684125113932,9.996223648843771e-05,0.9243697478991596
654,2101,둘째/Noun,119,14,105,0.0001556143431963186,0.0011662260923651065,0.8823529411764706
655,2102,려고/Noun,119,23,96,0.00025565213525109487,0.0010662638558766688,0.8067226890756303
656,2103,아동/Noun,119,28,91,0.0003112286863926372,0.001010729280049759,0.7647058823529411
657,2104,그립다/Adjective,119,86,33,0.0009559166796345287,0.00036652820045760486,0.7226890756302521
658,2105,탓/Noun,119,35,84,0.0003890358579907965,0.0009329808738920851,0.7058823529411765
659,2116,오빠/Suffix,118,106,12,0.001178222884200698,0.0001332829819845836,0.8983050847457628
660,2117,작위/Noun,118,17,101,0.00018896027388124405,0.0011217984317035787,0.8559322033898306
661,2118,대본/Noun,118,24,94,0.0002667674454794033,0.0010440500255459052,0.7966101694915254
662,2119,부모님/Noun,118,89,29,0.000989262610319454,0.00032210053979607705,0.7542372881355932
663,2120,톰/Noun,118,83,35,0.0009225707489496033,0.0003887420307883688,0.7033898305084746
664,2126,:)/Punctuation,117,114,3,0.0012671453660271655,3.33207454961459e-05,0.9743589743589745
665,2127,한개/Modifier,117,10,107,0.00011115310228308472,0.0011884399226958706,0.9145299145299144
666,2128,애쓰다/Verb,117,25,92,0.0002778827557077118,0.0010218361952151409,0.7863247863247863
667,2129,하나같이/Adverb,117,28,89,0.0003112286863926372,0.0009885154497189948,0.7606837606837606
668,2139,그만/Modifier,116,9,107,0.00010003779205477625,0.0011884399226958706,0.9224137931034484
669,2140,하자/Noun,116,24,92,0.0002667674454794033,0.0010218361952151409,0.7931034482758621
670,2141,정작/Noun,116,29,87,0.0003223439966209457,0.0009663016193882313,0.75
671,2142,거나/Noun,116,33,83,0.00036680523753417966,0.0009218739587267033,0.7155172413793104
672,2152,대놓고/Adverb,115,17,98,0.00018896027388124405,0.001088477686207433,0.8521739130434782
673,2153,ㅠㅜ/KoreanParticle,115,89,26,0.000989262610319454,0.00028877979429993113,0.7739130434782608
674,2154,소년/Noun,115,84,31,0.0009336860591779117,0.00034431437012684104,0.7304347826086957
675,2166,힘내다/Verb,114,95,19,0.0010559544716893046,0.00021103138814225735,0.8333333333333334
676,2167,겪다/Verb,114,87,27,0.0009670319898628369,0.0002998867094653131,0.7631578947368421
677,2168,씹다/Verb,114,31,83,0.00034457461707756266,0.0009218739587267033,0.7280701754385965
678,2181,20분/Number,113,18,95,0.0002000755841095525,0.0010551569407112867,0.8407079646017699
679,2182,ㅜㅜㅜ/KoreanParticle,113,83,30,0.0009225707489496033,0.000333207454961459,0.7345132743362832
680,2183,..;;/Punctuation,113,31,82,0.00034457461707756266,0.0009107670435613213,0.7256637168141593
681,2188,명화/Noun,112,90,22,0.0010003779205477628,0.00024435213363840333,0.8035714285714286
682,2189,값/Noun,112,27,85,0.0003001133761643288,0.0009440877890574672,0.7589285714285714
683,2198,낚였다/Noun,111,2,109,2.2230620456616947e-05,0.0012106537530266347,0.981981981981982
684,2199,참나/Noun,111,10,101,0.00011115310228308472,0.0011217984317035787,0.90990990990991
685,2200,오래전/Adverb,111,85,26,0.0009448013694062199,0.00028877979429993113,0.7657657657657657
686,2201,!!!!!/Punctuation,111,81,30,0.0009003401284929863,0.000333207454961459,0.7297297297297297
687,2208,울컥/Adverb,110,108,2,0.001200453504657315,2.2213830330763933e-05,0.9818181818181818
688,2209,짜지다/Verb,110,12,98,0.00013338372273970166,0.001088477686207433,0.8909090909090909
689,2210,신파/Noun,110,16,94,0.00017784496365293558,0.0010440500255459052,0.8545454545454545
690,2211,첫사랑/Noun,110,90,20,0.0010003779205477628,0.00022213830330763932,0.8181818181818182
691,2212,업다/Verb,110,29,81,0.0003223439966209457,0.0008996601283959392,0.7363636363636363
692,2213,몇몇/Noun,110,33,77,0.00036680523753417966,0.0008552324677344116,0.7
693,2221,한숨/Noun,109,12,97,0.00013338372273970166,0.0010773707710420508,0.8899082568807339
694,2222,시끄럽다/Adjective,109,15,94,0.00016672965342462708,0.0010440500255459052,0.8623853211009175
695,2223,세련되다/Adjective,109,94,15,0.0010448391614609964,0.0001666037274807295,0.8623853211009175
696,2224,고전/Noun,109,80,29,0.0008892248182646778,0.00032210053979607705,0.7339449541284404
697,2225,삭제/Noun,109,31,78,0.00034457461707756266,0.0008663393828997934,0.7155963302752294
698,2226,빵빵/Noun,109,77,32,0.0008558788875797522,0.00035542128529222287,0.7064220183486238
699,2233,.^^/Punctuation,108,97,11,0.0010781850921459217,0.00012217606681920164,0.8981481481481481
700,2234,말고는/Josa,108,11,97,0.00012226841251139318,0.0010773707710420508,0.8981481481481481
701,2235,십/Modifier,108,76,32,0.0008447635773514439,0.00035542128529222287,0.7037037037037037
702,2236,그만큼/Adverb,108,76,32,0.0008447635773514439,0.00035542128529222287,0.7037037037037037
703,2248,빈약하다/Adjective,107,12,95,0.00013338372273970166,0.0010551569407112867,0.8878504672897196
704,2253,어처구니/Noun,106,11,95,0.00012226841251139318,0.0010551569407112867,0.8962264150943396
705,2254,..^^/Punctuation,106,92,14,0.0010226085410043797,0.0001554968123153475,0.8679245283018868
706,2255,중독/Noun,106,87,19,0.0009670319898628369,0.00021103138814225735,0.8207547169811321
707,2256,폐지/Noun,106,30,76,0.00033345930684925416,0.0008441255525690295,0.7169811320754716
708,2263,선동/Noun,105,10,95,0.00011115310228308472,0.0010551569407112867,0.9047619047619048
709,2264,팔이/Noun,105,11,94,0.00012226841251139318,0.0010440500255459052,0.8952380952380953
710,2265,여름/Noun,105,85,20,0.0009448013694062199,0.00022213830330763932,0.8095238095238095
711,2266,안감/Noun,105,22,83,0.00024453682502278637,0.0009218739587267033,0.7904761904761904
712,2267,늘어지다/Verb,105,24,81,0.0002667674454794033,0.0008996601283959392,0.7714285714285715
713,2268,또다른/Modifier,105,78,27,0.0008669941978080608,0.0002998867094653131,0.7428571428571429
714,2269,중학교/Noun,105,77,28,0.0008558788875797522,0.000310993624630695,0.7333333333333333
715,2280,끼우다/Verb,104,10,94,0.00011115310228308472,0.0010440500255459052,0.903846153846154
716,2281,메이드/Noun,104,91,13,0.001011493230776071,0.00014438989714996554,0.875
717,2282,캬/Noun,104,89,15,0.000989262610319454,0.0001666037274807295,0.8557692307692307
718,2283,어쩌/Noun,104,16,88,0.00017784496365293558,0.000977408534553613,0.8461538461538461
719,2284,구리/Noun,104,16,88,0.00017784496365293558,0.000977408534553613,0.8461538461538461
720,2285,호구/Noun,104,17,87,0.00018896027388124405,0.0009663016193882313,0.8365384615384616
721,2286,부터가/Josa,104,22,82,0.00024453682502278637,0.0009107670435613213,0.7884615384615384
722,2287,하아/Exclamation,104,23,81,0.00025565213525109487,0.0008996601283959392,0.7788461538461539
723,2288,~!!!/Punctuation,104,79,25,0.0008781095080363692,0.0002776728791345492,0.7596153846153846
724,2289,반갑다/Adjective,104,73,31,0.0008114176466665183,0.00034431437012684104,0.7019230769230769
725,2290,장국영/Noun,104,73,31,0.0008114176466665183,0.00034431437012684104,0.7019230769230769
726,2302,내놓다/Verb,103,23,80,0.00025565213525109487,0.0008885532132305574,0.7766990291262136
727,2303,이어서/Josa,103,75,28,0.0008336482671231353,0.000310993624630695,0.7281553398058253
728,2304,벌다/Verb,103,29,74,0.0003223439966209457,0.0008219117222382655,0.7184466019417476
729,2314,빵점/Noun,102,2,100,2.2230620456616947e-05,0.0011106915165381968,0.9803921568627452
730,2315,하품/Noun,102,2,100,2.2230620456616947e-05,0.0011106915165381968,0.9803921568627452
731,2316,편안하다/Adjective,102,90,12,0.0010003779205477628,0.0001332829819845836,0.8823529411764706
732,2317,지경/Noun,102,14,88,0.0001556143431963186,0.000977408534553613,0.8627450980392157
733,2318,재미나/Noun,102,87,15,0.0009670319898628369,0.0001666037274807295,0.8529411764705882
734,2319,조화/Noun,102,82,20,0.0009114554387212947,0.00022213830330763932,0.8039215686274509
735,2320,곡/Noun,102,78,24,0.0008669941978080608,0.0002665659639691672,0.7647058823529411
736,2321,팔/Modifier,102,24,78,0.0002667674454794033,0.0008663393828997934,0.7647058823529411
737,2322,로코/Noun,102,75,27,0.0008336482671231353,0.0002998867094653131,0.7352941176470589
738,2323,숨/Noun,102,75,27,0.0008336482671231353,0.0002998867094653131,0.7352941176470589
739,2332,인내심/Noun,101,8,93,8.892248182646779e-05,0.001032943110380523,0.9207920792079208
740,2333,잠시/Noun,101,75,26,0.0008336482671231353,0.00028877979429993113,0.7425742574257426
741,2351,앞뒤/Noun,100,11,89,0.00012226841251139318,0.0009885154497189948,0.89
742,2352,울면/Noun,100,87,13,0.0009670319898628369,0.00014438989714996554,0.87
743,2353,플롯/Noun,100,29,71,0.0003223439966209457,0.0007885909767421196,0.71
744,2354,일본인/Noun,100,30,70,0.00033345930684925416,0.0007774840615767378,0.7
